iterCounter, dimersInMT, activeDimersInMT, inactiveDimersInMT, activeDimersFree,inactiveDimersFree, longestProtoFilament, lengthOfMT, totalGTPs, activeGTPs,inactiveGTPs, mtRepresentation, DeHydro Katanins, Hydro Katanins, Bonded Katanins

21,0,0,0,0,0,0,0,0,0,0,XXXXXXXXXXXXXXXXXXXXXXXXXXXXXXXXXXXXXXXXXXXXXXXXXXXXXXXXXXXXXXXXXXXXXXXXXXXXXXXXXXXXXXXXXXXXXXXXXXXXXXXXXXXXXXXXXXXXXXXXXXXXXXXXXXXXXXXXXXXXXXXXXXXXXXXXXXXXXXXXXXXXXXXXXXXXXXXXXXXXXXXXXXXXXXXXXXXXXXXXXXXXXXXXXXXXXXXXXXXXXXXXXXXXXXXXXXXXXXXXXXXXXXXXXXXXXXXXXXXX,0,0,0
42,0,0,0,0,0,0,0,0,0,0,XXXXXXXXXXXXXXXXXXXXXXXXXXXXXXXXXXXXXXXXXXXXXXXXXXXXXXXXXXXXXXXXXXXXXXXXXXXXXXXXXXXXXXXXXXXXXXXXXXXXXXXXXXXXXXXXXXXXXXXXXXXXXXXXXXXXXXXXXXXXXXXXXXXXXXXXXXXXXXXXXXXXXXXXXXXXXXXXXXXXXXXXXXXXXXXXXXXXXXXXXXXXXXXXXXXXXXXXXXXXXXXXXXXXXXXXXXXXXXXXXXXXXXXXXXXXXXXXXXXX,0,0,0
63,0,0,0,0,0,0,0,0,0,0,XXXXXXXXXXXXXXXXXXXXXXXXXXXXXXXXXXXXXXXXXXXXXXXXXXXXXXXXXXXXXXXXXXXXXXXXXXXXXXXXXXXXXXXXXXXXXXXXXXXXXXXXXXXXXXXXXXXXXXXXXXXXXXXXXXXXXXXXXXXXXXXXXXXXXXXXXXXXXXXXXXXXXXXXXXXXXXXXXXXXXXXXXXXXXXXXXXXXXXXXXXXXXXXXXXXXXXXXXXXXXXXXXXXXXXXXXXXXXXXXXXXXXXXXXXXXXXXXXXXX,0,0,0
84,0,0,0,0,0,0,0,0,0,0,XXXXXXXXXXXXXXXXXXXXXXXXXXXXXXXXXXXXXXXXXXXXXXXXXXXXXXXXXXXXXXXXXXXXXXXXXXXXXXXXXXXXXXXXXXXXXXXXXXXXXXXXXXXXXXXXXXXXXXXXXXXXXXXXXXXXXXXXXXXXXXXXXXXXXXXXXXXXXXXXXXXXXXXXXXXXXXXXXXXXXXXXXXXXXXXXXXXXXXXXXXXXXXXXXXXXXXXXXXXXXXXXXXXXXXXXXXXXXXXXXXXXXXXXXXXXXXXXXXXX,0,0,0

105,1,1,0,599,0,0,0,600,0,600,XXXXXXXXXXXXXXXXXXXXXXXXXXXXXXXXXXXXXXXXXXXXXXXXXXXXXXXXXXXXXXXXXXXXXXXXXXXXXXXXXXXXXXXXXXXXXXXXXXXXXXXXXXXXXXXXXXXXXXXXXXXXXXXXXXXXXXXXXXXXXXXXXXXXXXXXXXXXXXXXXXXXXXXXXXXXXXXXXXXXXXXXXXXXXXXXXXXXXXXXXXXXXXXXXXXXXXXXXXXXXXXXXXXXXXXXXXXXXXXXGXXXXXXXXXXXXXXXXXXX,0,0,0
126,5,5,0,595,0,0,0,600,0,600,GXXXXXXXXXXXXXXXXXXXGXXXXXXXXXXXXXXXXXXXXXXXXXXXXXXXXXXXXXXXXXXXXXXXXXXXXXXXXXXXGXXXXXXXXXXXXXXXXXXXXXXXXXXXXXXXXXXXXXXXXXXXXXXXXXXXXXXXXXXXXXXXXXXXXXXXXXXXXXXXXXXXXXXXXXXXXXXXXXXXXXXXXXXXXXXXXXXXXXXXGXXXXXXXXXXXXXXXXXXXXXXXXXXXXXXXXXXXXXXXGXXXXXXXXXXXXXXXXXXX,0,0,0
147,8,8,0,592,0,0,0,600,0,600,GXXXXXXXXXXXXXXXXXXXGXXXXXXXXXXXXXXXXXXXXXXXXXXXXXXXXXXXXXXXXXXXXXXXXXXXXXXXXXXXGXXXXXXXXXXXXXXXXXXXGXXXXXXXXXXXXXXXXXXXGXXXXXXXXXXXXXXXXXXXXXXXXXXXXXXXXXXXXXXXXXXXXXXXXXXXXXXXXXXXGXXXXXXXXXXXXXXXXXXXGXXXXXXXXXXXXXXXXXXXXXXXXXXXXXXXXXXXXXXXGXXXXXXXXXXXXXXXXXXX,0,0,0
168,11,11,0,589,0,0,0,600,0,600,GAXXXXXXXXXXXXXXXXXXGXXXXXXXXXXXXXXXXXXXXXXXXXXXXXXXXXXXXXXXXXXXXXXXXXXXXXXXXXXXGAXXXXXXXXXXXXXXXXXXGXXXXXXXXXXXXXXXXXXXGXXXXXXXXXXXXXXXXXXXXXXXXXXXXXXXXXXXXXXXGXXXXXXXXXXXXXXXXXXXGXXXXXXXXXXXXXXXXXXXGXXXXXXXXXXXXXXXXXXXXXXXXXXXXXXXXXXXXXXXGXXXXXXXXXXXXXXXXXXX,0,0,0
189,13,13,0,587,0,0,0,600,0,600,GAXXXXXXXXXXXXXXXXXXGXXXXXXXXXXXXXXXXXXXXXXXXXXXXXXXXXXXXXXXXXXXXXXXXXXXXXXXXXXXGAXXXXXXXXXXXXXXXXXXGXXXXXXXXXXXXXXXXXXXGXXXXXXXXXXXXXXXXXXXGXXXXXXXXXXXXXXXXXXXGXXXXXXXXXXXXXXXXXXXGXXXXXXXXXXXXXXXXXXXGXXXXXXXXXXXXXXXXXXXGXXXXXXXXXXXXXXXXXXXGXXXXXXXXXXXXXXXXXXX,0,0,0

210,13,13,0,587,0,0,0,600,0,600,GAXXXXXXXXXXXXXXXXXXGXXXXXXXXXXXXXXXXXXXXXXXXXXXXXXXXXXXXXXXXXXXXXXXXXXXXXXXXXXXGAXXXXXXXXXXXXXXXXXXGXXXXXXXXXXXXXXXXXXXGXXXXXXXXXXXXXXXXXXXGXXXXXXXXXXXXXXXXXXXGXXXXXXXXXXXXXXXXXXXGXXXXXXXXXXXXXXXXXXXGXXXXXXXXXXXXXXXXXXXGXXXXXXXXXXXXXXXXXXXGXXXXXXXXXXXXXXXXXXX,0,0,0
231,13,13,0,587,0,0,0,600,0,600,GAXXXXXXXXXXXXXXXXXXGXXXXXXXXXXXXXXXXXXXXXXXXXXXXXXXXXXXXXXXXXXXXXXXXXXXXXXXXXXXGAXXXXXXXXXXXXXXXXXXGXXXXXXXXXXXXXXXXXXXGXXXXXXXXXXXXXXXXXXXGXXXXXXXXXXXXXXXXXXXGXXXXXXXXXXXXXXXXXXXGXXXXXXXXXXXXXXXXXXXGXXXXXXXXXXXXXXXXXXXGXXXXXXXXXXXXXXXXXXXGXXXXXXXXXXXXXXXXXXX,0,0,0
252,16,16,0,584,0,0,0,600,0,600,GAXXXXXXXXXXXXXXXXXXGXXXXXXXXXXXXXXXXXXXGXXXXXXXXXXXXXXXXXXXXXXXXXXXXXXXXXXXXXXXGAAXXXXXXXXXXXXXXXXXGXXXXXXXXXXXXXXXXXXXGXXXXXXXXXXXXXXXXXXXGAXXXXXXXXXXXXXXXXXXGXXXXXXXXXXXXXXXXXXXGXXXXXXXXXXXXXXXXXXXGXXXXXXXXXXXXXXXXXXXGXXXXXXXXXXXXXXXXXXXGXXXXXXXXXXXXXXXXXXX,0,0,0
273,18,18,0,582,0,0,0,600,0,600,GAXXXXXXXXXXXXXXXXXXGXXXXXXXXXXXXXXXXXXXGXXXXXXXXXXXXXXXXXXXGXXXXXXXXXXXXXXXXXXXGAAXXXXXXXXXXXXXXXXXGXXXXXXXXXXXXXXXXXXXGXXXXXXXXXXXXXXXXXXXGAXXXXXXXXXXXXXXXXXXGXXXXXXXXXXXXXXXXXXXGXXXXXXXXXXXXXXXXXXXGXXXXXXXXXXXXXXXXXXXGAXXXXXXXXXXXXXXXXXXGXXXXXXXXXXXXXXXXXXX,0,0,0
294,19,19,0,581,0,0,0,600,0,600,GAXXXXXXXXXXXXXXXXXXGXXXXXXXXXXXXXXXXXXXGXXXXXXXXXXXXXXXXXXXGAXXXXXXXXXXXXXXXXXXGAAXXXXXXXXXXXXXXXXXGXXXXXXXXXXXXXXXXXXXGXXXXXXXXXXXXXXXXXXXGAXXXXXXXXXXXXXXXXXXGXXXXXXXXXXXXXXXXXXXGXXXXXXXXXXXXXXXXXXXGXXXXXXXXXXXXXXXXXXXGAXXXXXXXXXXXXXXXXXXGXXXXXXXXXXXXXXXXXXX,0,0,0

315,19,19,0,553,28,0,0,600,36,564,GAXXXXXXXXXXXXXXXXXXGXXXXXXXXXXXXXXXXXXXGXXXXXXXXXXXXXXXXXXXGAXXXXXXXXXXXXXXXXXXGAAXXXXXXXXXXXXXXXXXGXXXXXXXXXXXXXXXXXXXGXXXXXXXXXXXXXXXXXXXGAXXXXXXXXXXXXXXXXXXGXXXXXXXXXXXXXXXXXXXGXXXXXXXXXXXXXXXXXXXGXXXXXXXXXXXXXXXXXXXGAXXXXXXXXXXXXXXXXXXGXXXXXXXXXXXXXXXXXXX,0,0,0
336,19,17,2,528,53,0,0,592,72,520,GAXXXXXXXXXXXXXXXXXXGXXXXXXXXXXXXXXXXXXXGXXXXXXXXXXXXXXXXXXXGAXXXXXXXXXXXXXXXXXXGAAXXXXXXXXXXXXXXXXXGXXXXXXXXXXXXXXXXXXXGXXXXXXXXXXXXXXXXXXXGAXXXXXXXXXXXXXXXXXXGXXXXXXXXXXXXXXXXXXXGXXXXXXXXXXXXXXXXXXXGXXXXXXXXXXXXXXXXXXXGAXXXXXXXXXXXXXXXXXXGXXXXXXXXXXXXXXXXXXX,0,0,0
357,19,16,3,494,87,0,0,586,103,483,GAXXXXXXXXXXXXXXXXXXGXXXXXXXXXXXXXXXXXXXGXXXXXXXXXXXXXXXXXXXGAXXXXXXXXXXXXXXXXXXGAAXXXXXXXXXXXXXXXXXGXXXXXXXXXXXXXXXXXXXGXXXXXXXXXXXXXXXXXXXGAXXXXXXXXXXXXXXXXXXGXXXXXXXXXXXXXXXXXXXGXXXXXXXXXXXXXXXXXXXGXXXXXXXXXXXXXXXXXXXGAXXXXXXXXXXXXXXXXXXGXXXXXXXXXXXXXXXXXXX,0,0,0
378,19,12,7,466,115,0,0,572,136,436,GAXXXXXXXXXXXXXXXXXXGXXXXXXXXXXXXXXXXXXXGXXXXXXXXXXXXXXXXXXXGOXXXXXXXXXXXXXXXXXXGOAXXXXXXXXXXXXXXXXXGXXXXXXXXXXXXXXXXXXXGXXXXXXXXXXXXXXXXXXXGAXXXXXXXXXXXXXXXXXXGXXXXXXXXXXXXXXXXXXXGXXXXXXXXXXXXXXXXXXXGXXXXXXXXXXXXXXXXXXXGAXXXXXXXXXXXXXXXXXXGXXXXXXXXXXXXXXXXXXX,0,0,0
399,19,12,7,455,126,0,0,543,155,388,GAXXXXXXXXXXXXXXXXXXGXXXXXXXXXXXXXXXXXXXGXXXXXXXXXXXXXXXXXXXGOXXXXXXXXXXXXXXXXXXGOAXXXXXXXXXXXXXXXXXGXXXXXXXXXXXXXXXXXXXGXXXXXXXXXXXXXXXXXXXGAXXXXXXXXXXXXXXXXXXGXXXXXXXXXXXXXXXXXXXGXXXXXXXXXXXXXXXXXXXGXXXXXXXXXXXXXXXXXXXGAXXXXXXXXXXXXXXXXXXGXXXXXXXXXXXXXXXXXXX,0,0,0

420,17,11,6,446,137,0,0,512,165,347,GOXXXXXXXXXXXXXXXXXXGXXXXXXXXXXXXXXXXXXXGXXXXXXXXXXXXXXXXXXXGXXXXXXXXXXXXXXXXXXXGXAXXXXXXXXXXXXXXXXXGXXXXXXXXXXXXXXXXXXXGXXXXXXXXXXXXXXXXXXXGAXXXXXXXXXXXXXXXXXXGXXXXXXXXXXXXXXXXXXXGXXXXXXXXXXXXXXXXXXXGXXXXXXXXXXXXXXXXXXXGAXXXXXXXXXXXXXXXXXXGXXXXXXXXXXXXXXXXXXX,0,0,0
441,16,10,6,441,143,0,0,477,169,308,GOXXXXXXXXXXXXXXXXXXGXXXXXXXXXXXXXXXXXXXGXXXXXXXXXXXXXXXXXXXGXXXXXXXXXXXXXXXXXXXGXXXXXXXXXXXXXXXXXXXGXXXXXXXXXXXXXXXXXXXGXXXXXXXXXXXXXXXXXXXGAXXXXXXXXXXXXXXXXXXGXXXXXXXXXXXXXXXXXXXGXXXXXXXXXXXXXXXXXXXGXXXXXXXXXXXXXXXXXXXGAXXXXXXXXXXXXXXXXXXGXXXXXXXXXXXXXXXXXXX,0,0,0
462,16,11,5,413,171,0,0,444,174,270,GXAXXXXXXXXXXXXXXXXXGXXXXXXXXXXXXXXXXXXXGXXXXXXXXXXXXXXXXXXXGXXXXXXXXXXXXXXXXXXXGXXXXXXXXXXXXXXXXXXXGXXXXXXXXXXXXXXXXXXXGXXXXXXXXXXXXXXXXXXXGXXXXXXXXXXXXXXXXXXXGXXXXXXXXXXXXXXXXXXXGXXXXXXXXXXXXXXXXXXXGXXXXXXXXXXXXXXXXXXXGAXXXXXXXXXXXXXXXXXXGAXXXXXXXXXXXXXXXXXX,0,0,0
483,16,8,8,423,161,0,0,402,176,226,GXAXXXXXXXXXXXXXXXXXGXXXXXXXXXXXXXXXXXXXGXXXXXXXXXXXXXXXXXXXGXXXXXXXXXXXXXXXXXXXGXXXXXXXXXXXXXXXXXXXGXXXXXXXXXXXXXXXXXXXGXXXXXXXXXXXXXXXXXXXGXXXXXXXXXXXXXXXXXXXGXXXXXXXXXXXXXXXXXXXGXXXXXXXXXXXXXXXXXXXGXXXXXXXXXXXXXXXXXXXGAXXXXXXXXXXXXXXXXXXGOXXXXXXXXXXXXXXXXXX,0,0,0
504,17,7,10,429,154,0,0,369,190,179,GXAXXXXXXXXXXXXXXXXXGXXXXXXXXXXXXXXXXXXXGXXXXXXXXXXXXXXXXXXXGXXXXXXXXXXXXXXXXXXXGXXXXXXXXXXXXXXXXXXXGXXXXXXXXXXXXXXXXXXXGXXXXXXXXXXXXXXXXXXXGXXXXXXXXXXXXXXXXXXXGXXXXXXXXXXXXXXXXXXXGAXXXXXXXXXXXXXXXXXXGXXXXXXXXXXXXXXXXXXXGAXXXXXXXXXXXXXXXXXXGOXXXXXXXXXXXXXXXXXX,0,0,0

525,17,6,11,421,162,0,0,330,195,135,GXAXXXXXXXXXXXXXXXXXGXXXXXXXXXXXXXXXXXXXGXXXXXXXXXXXXXXXXXXXGXXXXXXXXXXXXXXXXXXXGXXXXXXXXXXXXXXXXXXXGXXXXXXXXXXXXXXXXXXXGXXXXXXXXXXXXXXXXXXXGXXXXXXXXXXXXXXXXXXXGXXXXXXXXXXXXXXXXXXXGAXXXXXXXXXXXXXXXXXXGXXXXXXXXXXXXXXXXXXXGAXXXXXXXXXXXXXXXXXXGOXXXXXXXXXXXXXXXXXX,0,0,0
546,18,5,13,407,175,0,0,304,194,110,GXOXXXXXXXXXXXXXXXXXGAXXXXXXXXXXXXXXXXXXGXXXXXXXXXXXXXXXXXXXGXXXXXXXXXXXXXXXXXXXGXXXXXXXXXXXXXXXXXXXGXXXXXXXXXXXXXXXXXXXGXXXXXXXXXXXXXXXXXXXGXXXXXXXXXXXXXXXXXXXGXXXXXXXXXXXXXXXXXXXGAXXXXXXXXXXXXXXXXXXGXXXXXXXXXXXXXXXXXXXGAXXXXXXXXXXXXXXXXXXGOXXXXXXXXXXXXXXXXXX,0,0,0
567,16,3,13,393,191,0,0,279,208,71,GXXXXXXXXXXXXXXXXXXXGAXXXXXXXXXXXXXXXXXXGXXXXXXXXXXXXXXXXXXXGXXXXXXXXXXXXXXXXXXXGXXXXXXXXXXXXXXXXXXXGXXXXXXXXXXXXXXXXXXXGXXXXXXXXXXXXXXXXXXXGXXXXXXXXXXXXXXXXXXXGXXXXXXXXXXXXXXXXXXXGAXXXXXXXXXXXXXXXXXXGXXXXXXXXXXXXXXXXXXXGAXXXXXXXXXXXXXXXXXXGXXXXXXXXXXXXXXXXXXX,0,0,0
588,16,2,14,379,205,0,0,246,189,57,GXXXXXXXXXXXXXXXXXXXGAXXXXXXXXXXXXXXXXXXGXXXXXXXXXXXXXXXXXXXGXXXXXXXXXXXXXXXXXXXGXXXXXXXXXXXXXXXXXXXGXXXXXXXXXXXXXXXXXXXGXXXXXXXXXXXXXXXXXXXGXXXXXXXXXXXXXXXXXXXGXXXXXXXXXXXXXXXXXXXGAXXXXXXXXXXXXXXXXXXGXXXXXXXXXXXXXXXXXXXGOXXXXXXXXXXXXXXXXXXGXXXXXXXXXXXXXXXXXXX,0,0,0
609,15,2,13,388,197,0,0,210,176,34,GXXXXXXXXXXXXXXXXXXXGAXXXXXXXXXXXXXXXXXXGXXXXXXXXXXXXXXXXXXXGXXXXXXXXXXXXXXXXXXXGXXXXXXXXXXXXXXXXXXXGXXXXXXXXXXXXXXXXXXXGXXXXXXXXXXXXXXXXXXXGXXXXXXXXXXXXXXXXXXXGXXXXXXXXXXXXXXXXXXXGAXXXXXXXXXXXXXXXXXXGXXXXXXXXXXXXXXXXXXXGXXXXXXXXXXXXXXXXXXXGXXXXXXXXXXXXXXXXXXX,0,0,0

630,15,2,13,406,179,0,0,192,147,45,GXXXXXXXXXXXXXXXXXXXGAXXXXXXXXXXXXXXXXXXGXXXXXXXXXXXXXXXXXXXGXXXXXXXXXXXXXXXXXXXGXXXXXXXXXXXXXXXXXXXGXXXXXXXXXXXXXXXXXXXGXXXXXXXXXXXXXXXXXXXGXXXXXXXXXXXXXXXXXXXGXXXXXXXXXXXXXXXXXXXGAXXXXXXXXXXXXXXXXXXGXXXXXXXXXXXXXXXXXXXGXXXXXXXXXXXXXXXXXXXGXXXXXXXXXXXXXXXXXXX,0,0,0
651,15,2,13,417,168,0,0,181,123,58,GXXXXXXXXXXXXXXXXXXXGAXXXXXXXXXXXXXXXXXXGXXXXXXXXXXXXXXXXXXXGXXXXXXXXXXXXXXXXXXXGXXXXXXXXXXXXXXXXXXXGXXXXXXXXXXXXXXXXXXXGXXXXXXXXXXXXXXXXXXXGXXXXXXXXXXXXXXXXXXXGXXXXXXXXXXXXXXXXXXXGAXXXXXXXXXXXXXXXXXXGXXXXXXXXXXXXXXXXXXXGXXXXXXXXXXXXXXXXXXXGXXXXXXXXXXXXXXXXXXX,0,0,0
672,16,3,13,413,171,0,0,183,103,80,GXXXXXXXXXXXXXXXXXXXGAXXXXXXXXXXXXXXXXXXGXXXXXXXXXXXXXXXXXXXGAXXXXXXXXXXXXXXXXXXGXXXXXXXXXXXXXXXXXXXGXXXXXXXXXXXXXXXXXXXGXXXXXXXXXXXXXXXXXXXGXXXXXXXXXXXXXXXXXXXGXXXXXXXXXXXXXXXXXXXGAXXXXXXXXXXXXXXXXXXGXXXXXXXXXXXXXXXXXXXGXXXXXXXXXXXXXXXXXXXGXXXXXXXXXXXXXXXXXXX,0,0,0
693,16,3,13,406,178,0,0,188,90,98,GXXXXXXXXXXXXXXXXXXXGAXXXXXXXXXXXXXXXXXXGXXXXXXXXXXXXXXXXXXXGAXXXXXXXXXXXXXXXXXXGXXXXXXXXXXXXXXXXXXXGXXXXXXXXXXXXXXXXXXXGXXXXXXXXXXXXXXXXXXXGXXXXXXXXXXXXXXXXXXXGXXXXXXXXXXXXXXXXXXXGAXXXXXXXXXXXXXXXXXXGXXXXXXXXXXXXXXXXXXXGXXXXXXXXXXXXXXXXXXXGXXXXXXXXXXXXXXXXXXX,0,0,0
714,18,5,13,403,179,0,0,192,71,121,GXXXXXXXXXXXXXXXXXXXGAXXXXXXXXXXXXXXXXXXGXXXXXXXXXXXXXXXXXXXGAXXXXXXXXXXXXXXXXXXGXXXXXXXXXXXXXXXXXXXGXXXXXXXXXXXXXXXXXXXGAXXXXXXXXXXXXXXXXXXGXXXXXXXXXXXXXXXXXXXGXXXXXXXXXXXXXXXXXXXGAXXXXXXXXXXXXXXXXXXGXXXXXXXXXXXXXXXXXXXGXXXXXXXXXXXXXXXXXXXGAXXXXXXXXXXXXXXXXXX,0,0,0

735,19,6,13,379,202,0,0,211,67,144,GXXXXXXXXXXXXXXXXXXXGAXXXXXXXXXXXXXXXXXXGXXXXXXXXXXXXXXXXXXXGAXXXXXXXXXXXXXXXXXXGXXXXXXXXXXXXXXXXXXXGXXXXXXXXXXXXXXXXXXXGAXXXXXXXXXXXXXXXXXXGXXXXXXXXXXXXXXXXXXXGXXXXXXXXXXXXXXXXXXXGAXXXXXXXXXXXXXXXXXXGXXXXXXXXXXXXXXXXXXXGXXXXXXXXXXXXXXXXXXXGAAXXXXXXXXXXXXXXXXX,0,0,0
756,20,7,13,358,222,0,0,233,53,180,GXXXXXXXXXXXXXXXXXXXGAXXXXXXXXXXXXXXXXXXGXXXXXXXXXXXXXXXXXXXGAXXXXXXXXXXXXXXXXXXGXXXXXXXXXXXXXXXXXXXGXXXXXXXXXXXXXXXXXXXGAXXXXXXXXXXXXXXXXXXGXXXXXXXXXXXXXXXXXXXGXXXXXXXXXXXXXXXXXXXGAXXXXXXXXXXXXXXXXXXGXXXXXXXXXXXXXXXXXXXGXXXXXXXXXXXXXXXXXXXGAAAXXXXXXXXXXXXXXXX,0,0,0
777,20,7,13,342,238,0,0,251,46,205,GXXXXXXXXXXXXXXXXXXXGAXXXXXXXXXXXXXXXXXXGXXXXXXXXXXXXXXXXXXXGAXXXXXXXXXXXXXXXXXXGXXXXXXXXXXXXXXXXXXXGXXXXXXXXXXXXXXXXXXXGAXXXXXXXXXXXXXXXXXXGXXXXXXXXXXXXXXXXXXXGXXXXXXXXXXXXXXXXXXXGAXXXXXXXXXXXXXXXXXXGXXXXXXXXXXXXXXXXXXXGXXXXXXXXXXXXXXXXXXXGAAAXXXXXXXXXXXXXXXX,0,0,0
798,21,7,14,303,276,0,0,287,41,246,GXXXXXXXXXXXXXXXXXXXGAAXXXXXXXXXXXXXXXXXGXXXXXXXXXXXXXXXXXXXGOXXXXXXXXXXXXXXXXXXGXXXXXXXXXXXXXXXXXXXGXXXXXXXXXXXXXXXXXXXGAXXXXXXXXXXXXXXXXXXGXXXXXXXXXXXXXXXXXXXGXXXXXXXXXXXXXXXXXXXGAXXXXXXXXXXXXXXXXXXGXXXXXXXXXXXXXXXXXXXGXXXXXXXXXXXXXXXXXXXGAAAXXXXXXXXXXXXXXXX,0,0,0
819,19,6,13,270,311,0,0,321,33,288,GXXXXXXXXXXXXXXXXXXXGAAXXXXXXXXXXXXXXXXXGXXXXXXXXXXXXXXXXXXXGXXXXXXXXXXXXXXXXXXXGXXXXXXXXXXXXXXXXXXXGXXXXXXXXXXXXXXXXXXXGXXXXXXXXXXXXXXXXXXXGXXXXXXXXXXXXXXXXXXXGXXXXXXXXXXXXXXXXXXXGAXXXXXXXXXXXXXXXXXXGXXXXXXXXXXXXXXXXXXXGXXXXXXXXXXXXXXXXXXXGAAAXXXXXXXXXXXXXXXX,0,0,0

840,19,3,16,248,333,0,0,344,30,314,GXXXXXXXXXXXXXXXXXXXGOAXXXXXXXXXXXXXXXXXGXXXXXXXXXXXXXXXXXXXGXXXXXXXXXXXXXXXXXXXGXXXXXXXXXXXXXXXXXXXGXXXXXXXXXXXXXXXXXXXGXXXXXXXXXXXXXXXXXXXGXXXXXXXXXXXXXXXXXXXGXXXXXXXXXXXXXXXXXXXGAXXXXXXXXXXXXXXXXXXGXXXXXXXXXXXXXXXXXXXGXXXXXXXXXXXXXXXXXXXGOAOXXXXXXXXXXXXXXXX,0,0,0
861,16,3,13,227,357,0,0,370,32,338,GXXXXXXXXXXXXXXXXXXXGXAXXXXXXXXXXXXXXXXXGXXXXXXXXXXXXXXXXXXXGXXXXXXXXXXXXXXXXXXXGXXXXXXXXXXXXXXXXXXXGXXXXXXXXXXXXXXXXXXXGXXXXXXXXXXXXXXXXXXXGXXXXXXXXXXXXXXXXXXXGXXXXXXXXXXXXXXXXXXXGAXXXXXXXXXXXXXXXXXXGXXXXXXXXXXXXXXXXXXXGXXXXXXXXXXXXXXXXXXXGXAXXXXXXXXXXXXXXXXX,0,0,0
882,14,1,13,201,385,0,0,398,31,367,GXXXXXXXXXXXXXXXXXXXGXXXXXXXXXXXXXXXXXXXGXXXXXXXXXXXXXXXXXXXGXXXXXXXXXXXXXXXXXXXGXXXXXXXXXXXXXXXXXXXGXXXXXXXXXXXXXXXXXXXGXXXXXXXXXXXXXXXXXXXGXXXXXXXXXXXXXXXXXXXGXXXXXXXXXXXXXXXXXXXGAXXXXXXXXXXXXXXXXXXGXXXXXXXXXXXXXXXXXXXGXXXXXXXXXXXXXXXXXXXGXXXXXXXXXXXXXXXXXXX,0,0,0
903,15,2,13,183,402,0,0,415,28,387,GXXXXXXXXXXXXXXXXXXXGXXXXXXXXXXXXXXXXXXXGXXXXXXXXXXXXXXXXXXXGXXXXXXXXXXXXXXXXXXXGXXXXXXXXXXXXXXXXXXXGXXXXXXXXXXXXXXXXXXXGXXXXXXXXXXXXXXXXXXXGXXXXXXXXXXXXXXXXXXXGAXXXXXXXXXXXXXXXXXXGAXXXXXXXXXXXXXXXXXXGXXXXXXXXXXXXXXXXXXXGXXXXXXXXXXXXXXXXXXXGXXXXXXXXXXXXXXXXXXX,0,0,0
924,15,1,14,168,417,0,0,430,29,401,GXXXXXXXXXXXXXXXXXXXGXXXXXXXXXXXXXXXXXXXGXXXXXXXXXXXXXXXXXXXGXXXXXXXXXXXXXXXXXXXGXXXXXXXXXXXXXXXXXXXGXXXXXXXXXXXXXXXXXXXGXXXXXXXXXXXXXXXXXXXGXXXXXXXXXXXXXXXXXXXGAXXXXXXXXXXXXXXXXXXGOXXXXXXXXXXXXXXXXXXGXXXXXXXXXXXXXXXXXXXGXXXXXXXXXXXXXXXXXXXGXXXXXXXXXXXXXXXXXXX,0,0,0

945,15,1,14,163,422,0,0,435,33,402,GXXXXXXXXXXXXXXXXXXXGXXXXXXXXXXXXXXXXXXXGXXXXXXXXXXXXXXXXXXXGXXXXXXXXXXXXXXXXXXXGXXXXXXXXXXXXXXXXXXXGXXXXXXXXXXXXXXXXXXXGXXXXXXXXXXXXXXXXXXXGXXXXXXXXXXXXXXXXXXXGAXXXXXXXXXXXXXXXXXXGOXXXXXXXXXXXXXXXXXXGXXXXXXXXXXXXXXXXXXXGXXXXXXXXXXXXXXXXXXXGXXXXXXXXXXXXXXXXXXX,0,0,0
966,13,0,13,151,436,0,0,448,39,409,GXXXXXXXXXXXXXXXXXXXGXXXXXXXXXXXXXXXXXXXGXXXXXXXXXXXXXXXXXXXGXXXXXXXXXXXXXXXXXXXGXXXXXXXXXXXXXXXXXXXGXXXXXXXXXXXXXXXXXXXGXXXXXXXXXXXXXXXXXXXGXXXXXXXXXXXXXXXXXXXGXXXXXXXXXXXXXXXXXXXGXXXXXXXXXXXXXXXXXXXGXXXXXXXXXXXXXXXXXXXGXXXXXXXXXXXXXXXXXXXGXXXXXXXXXXXXXXXXXXX,0,0,0
987,13,0,13,150,437,0,0,450,41,409,GXXXXXXXXXXXXXXXXXXXGXXXXXXXXXXXXXXXXXXXGXXXXXXXXXXXXXXXXXXXGXXXXXXXXXXXXXXXXXXXGXXXXXXXXXXXXXXXXXXXGXXXXXXXXXXXXXXXXXXXGXXXXXXXXXXXXXXXXXXXGXXXXXXXXXXXXXXXXXXXGXXXXXXXXXXXXXXXXXXXGXXXXXXXXXXXXXXXXXXXGXXXXXXXXXXXXXXXXXXXGXXXXXXXXXXXXXXXXXXXGXXXXXXXXXXXXXXXXXXX,0,0,0
1008,13,0,13,140,447,0,0,460,48,412,GXXXXXXXXXXXXXXXXXXXGXXXXXXXXXXXXXXXXXXXGXXXXXXXXXXXXXXXXXXXGXXXXXXXXXXXXXXXXXXXGXXXXXXXXXXXXXXXXXXXGXXXXXXXXXXXXXXXXXXXGXXXXXXXXXXXXXXXXXXXGXXXXXXXXXXXXXXXXXXXGXXXXXXXXXXXXXXXXXXXGXXXXXXXXXXXXXXXXXXXGXXXXXXXXXXXXXXXXXXXGXXXXXXXXXXXXXXXXXXXGXXXXXXXXXXXXXXXXXXX,10,0,0
1029,13,0,13,130,457,0,0,468,53,415,GXXXXXXXXXXXXXXXXXXXGXXXXXXXXXXXXXXXXXXXGXXXXXXXXXXXXXXXXXXXGXXXXXXXXXXXXXXXXXXXGXXXXXXXXXXXXXXXXXXXGXXXXXXXXXXXXXXXXXXXGXXXXXXXXXXXXXXXXXXXGXXXXXXXXXXXXXXXXXXXGXXXXXXXXXXXXXXXXXXXGXXXXXXXXXXXXXXXXXXXGXXXXXXXXXXXXXXXXXXXGXXXXXXXXXXXXXXXXXXXGXXXXXXXXXXXXXXXXXXX,10,0,0

1050,13,0,13,131,456,0,0,468,49,419,GXXXXXXXXXXXXXXXXXXXGXXXXXXXXXXXXXXXXXXXGXXXXXXXXXXXXXXXXXXXGXXXXXXXXXXXXXXXXXXXGXXXXXXXXXXXXXXXXXXXGXXXXXXXXXXXXXXXXXXXGXXXXXXXXXXXXXXXXXXXGXXXXXXXXXXXXXXXXXXXGXXXXXXXXXXXXXXXXXXXGXXXXXXXXXXXXXXXXXXXGXXXXXXXXXXXXXXXXXXXGXXXXXXXXXXXXXXXXXXXGXXXXXXXXXXXXXXXXXXX,10,0,0
1071,13,0,13,121,466,0,0,480,51,429,GXXXXXXXXXXXXXXXXXXXGXXXXXXXXXXXXXXXXXXXGXXXXXXXXXXXXXXXXXXXGXXXXXXXXXXXXXXXXXXXGXXXXXXXXXXXXXXXXXXXGXXXXXXXXXXXXXXXXXXXGXXXXXXXXXXXXXXXXXXXGXXXXXXXXXXXXXXXXXXXGXXXXXXXXXXXXXXXXXXXGXXXXXXXXXXXXXXXXXXXGXXXXXXXXXXXXXXXXXXXGXXXXXXXXXXXXXXXXXXXGXXXXXXXXXXXXXXXXXXX,10,0,0
1092,13,0,13,134,453,0,0,469,55,414,GXXXXXXXXXXXXXXXXXXXGXXXXXXXXXXXXXXXXXXXGXXXXXXXXXXXXXXXXXXXGXXXXXXXXXXXXXXXXXXXGXXXXXXXXXXXXXXXXXXXGXXXXXXXXXXXXXXXXXXXGXXXXXXXXXXXXXXXXXXXGXXXXXXXXXXXXXXXXXXXGXXXXXXXXXXXXXXXXXXXGXXXXXXXXXXXXXXXXXXXGXXXXXXXXXXXXXXXXXXXGXXXXXXXXXXXXXXXXXXXGXXXXXXXXXXXXXXXXXXX,10,0,0
1113,14,1,13,144,442,0,0,457,67,390,GAXXXXXXXXXXXXXXXXXXGXXXXXXXXXXXXXXXXXXXGXXXXXXXXXXXXXXXXXXXGXXXXXXXXXXXXXXXXXXXGXXXXXXXXXXXXXXXXXXXGXXXXXXXXXXXXXXXXXXXGXXXXXXXXXXXXXXXXXXXGXXXXXXXXXXXXXXXXXXXGXXXXXXXXXXXXXXXXXXXGXXXXXXXXXXXXXXXXXXXGXXXXXXXXXXXXXXXXXXXGXXXXXXXXXXXXXXXXXXXGXXXXXXXXXXXXXXXXXXX,10,0,0
1134,14,1,13,168,418,0,0,433,62,371,GAXXXXXXXXXXXXXXXXXXGXXXXXXXXXXXXXXXXXXXGXXXXXXXXXXXXXXXXXXXGXXXXXXXXXXXXXXXXXXXGXXXXXXXXXXXXXXXXXXXGXXXXXXXXXXXXXXXXXXXGXXXXXXXXXXXXXXXXXXXGXXXXXXXXXXXXXXXXXXXGXXXXXXXXXXXXXXXXXXXGXXXXXXXXXXXXXXXXXXXGXXXXXXXXXXXXXXXXXXXGXXXXXXXXXXXXXXXXXXXGXXXXXXXXXXXXXXXXXXX,10,0,0

1155,14,1,13,172,414,0,0,429,75,354,GAXXXXXXXXXXXXXXXXXXGXXXXXXXXXXXXXXXXXXXGXXXXXXXXXXXXXXXXXXXGXXXXXXXXXXXXXXXXXXXGXXXXXXXXXXXXXXXXXXXGXXXXXXXXXXXXXXXXXXXGXXXXXXXXXXXXXXXXXXXGXXXXXXXXXXXXXXXXXXXGXXXXXXXXXXXXXXXXXXXGXXXXXXXXXXXXXXXXXXXGXXXXXXXXXXXXXXXXXXXGXXXXXXXXXXXXXXXXXXXGXXXXXXXXXXXXXXXXXXX,10,0,0
1176,15,1,14,193,392,0,0,407,75,332,GOXXXXXXXXXXXXXXXXXXGXXXXXXXXXXXXXXXXXXXGXXXXXXXXXXXXXXXXXXXGXXXXXXXXXXXXXXXXXXXGXXXXXXXXXXXXXXXXXXXGXXXXXXXXXXXXXXXXXXXGXXXXXXXXXXXXXXXXXXXGXXXXXXXXXXXXXXXXXXXGAXXXXXXXXXXXXXXXXXXGXXXXXXXXXXXXXXXXXXXGXXXXXXXXXXXXXXXXXXXGXXXXXXXXXXXXXXXXXXXGXXXXXXXXXXXXXXXXXXX,10,0,0
1197,15,1,14,194,391,0,0,403,76,327,GOXXXXXXXXXXXXXXXXXXGXXXXXXXXXXXXXXXXXXXGXXXXXXXXXXXXXXXXXXXGXXXXXXXXXXXXXXXXXXXGXXXXXXXXXXXXXXXXXXXGXXXXXXXXXXXXXXXXXXXGXXXXXXXXXXXXXXXXXXXGXXXXXXXXXXXXXXXXXXXGAXXXXXXXXXXXXXXXXXXGXXXXXXXXXXXXXXXXXXXGXXXXXXXXXXXXXXXXXXXGXXXXXXXXXXXXXXXXXXXGXXXXXXXXXXXXXXXXXXX,10,0,0
1218,15,1,14,200,385,0,0,400,66,334,GXXXXXXXXXXXXXXXXXXXGXXXXXXXXXXXXXXXXXXXGXXXXXXXXXXXXXXXXXXXGXXXXXXXXXXXXXXXXXXXGXXXXXXXXXXXXXXXXXXXGAXXXXXXXXXXXXXXXXXXGXXXXXXXXXXXXXXXXXXXGXXXXXXXXXXXXXXXXXXXGOXXXXXXXXXXXXXXXXXXGXXXXXXXXXXXXXXXXXXXGXXXXXXXXXXXXXXXXXXXGXXXXXXXXXXXXXXXXXXXGXXXXXXXXXXXXXXXXXXX,10,0,0
1239,15,1,14,204,381,0,0,395,71,324,GXXXXXXXXXXXXXXXXXXXGXXXXXXXXXXXXXXXXXXXGXXXXXXXXXXXXXXXXXXXGXXXXXXXXXXXXXXXXXXXGXXXXXXXXXXXXXXXXXXXGAXXXXXXXXXXXXXXXXXXGXXXXXXXXXXXXXXXXXXXGXXXXXXXXXXXXXXXXXXXGOXXXXXXXXXXXXXXXXXXGXXXXXXXXXXXXXXXXXXXGXXXXXXXXXXXXXXXXXXXGXXXXXXXXXXXXXXXXXXXGXXXXXXXXXXXXXXXXXXX,10,0,0

1260,14,1,13,206,380,0,0,392,80,312,GXXXXXXXXXXXXXXXXXXXGXXXXXXXXXXXXXXXXXXXGXXXXXXXXXXXXXXXXXXXGXXXXXXXXXXXXXXXXXXXGXXXXXXXXXXXXXXXXXXXGAXXXXXXXXXXXXXXXXXXGXXXXXXXXXXXXXXXXXXXGXXXXXXXXXXXXXXXXXXXGXXXXXXXXXXXXXXXXXXXGXXXXXXXXXXXXXXXXXXXGXXXXXXXXXXXXXXXXXXXGXXXXXXXXXXXXXXXXXXXGXXXXXXXXXXXXXXXXXXX,10,0,0
1281,14,0,14,219,367,0,0,379,76,303,GXXXXXXXXXXXXXXXXXXXGXXXXXXXXXXXXXXXXXXXGXXXXXXXXXXXXXXXXXXXGXXXXXXXXXXXXXXXXXXXGXXXXXXXXXXXXXXXXXXXGOXXXXXXXXXXXXXXXXXXGXXXXXXXXXXXXXXXXXXXGXXXXXXXXXXXXXXXXXXXGXXXXXXXXXXXXXXXXXXXGXXXXXXXXXXXXXXXXXXXGXXXXXXXXXXXXXXXXXXXGXXXXXXXXXXXXXXXXXXXGXXXXXXXXXXXXXXXXXXX,10,0,0
1302,13,0,13,230,357,0,0,372,70,302,GXXXXXXXXXXXXXXXXXXXGXXXXXXXXXXXXXXXXXXXGXXXXXXXXXXXXXXXXXXXGXXXXXXXXXXXXXXXXXXXGXXXXXXXXXXXXXXXXXXXGXXXXXXXXXXXXXXXXXXXGXXXXXXXXXXXXXXXXXXXGXXXXXXXXXXXXXXXXXXXGXXXXXXXXXXXXXXXXXXXGXXXXXXXXXXXXXXXXXXXGXXXXXXXXXXXXXXXXXXXGXXXXXXXXXXXXXXXXXXXGXXXXXXXXXXXXXXXXXXX,10,0,0
1323,13,0,13,239,348,0,0,363,74,289,GXXXXXXXXXXXXXXXXXXXGXXXXXXXXXXXXXXXXXXXGXXXXXXXXXXXXXXXXXXXGXXXXXXXXXXXXXXXXXXXGXXXXXXXXXXXXXXXXXXXGXXXXXXXXXXXXXXXXXXXGXXXXXXXXXXXXXXXXXXXGXXXXXXXXXXXXXXXXXXXGXXXXXXXXXXXXXXXXXXXGXXXXXXXXXXXXXXXXXXXGXXXXXXXXXXXXXXXXXXXGXXXXXXXXXXXXXXXXXXXGXXXXXXXXXXXXXXXXXXX,10,0,0
1344,13,0,13,240,347,0,0,361,70,291,GXXXXXXXXXXXXXXXXXXXGXXXXXXXXXXXXXXXXXXXGXXXXXXXXXXXXXXXXXXXGXXXXXXXXXXXXXXXXXXXGXXXXXXXXXXXXXXXXXXXGXXXXXXXXXXXXXXXXXXXGXXXXXXXXXXXXXXXXXXXGXXXXXXXXXXXXXXXXXXXGXXXXXXXXXXXXXXXXXXXGXXXXXXXXXXXXXXXXXXXGXXXXXXXXXXXXXXXXXXXGXXXXXXXXXXXXXXXXXXXGXXXXXXXXXXXXXXXXXXX,10,0,0

1365,13,0,13,239,348,0,0,363,75,288,GXXXXXXXXXXXXXXXXXXXGXXXXXXXXXXXXXXXXXXXGXXXXXXXXXXXXXXXXXXXGXXXXXXXXXXXXXXXXXXXGXXXXXXXXXXXXXXXXXXXGXXXXXXXXXXXXXXXXXXXGXXXXXXXXXXXXXXXXXXXGXXXXXXXXXXXXXXXXXXXGXXXXXXXXXXXXXXXXXXXGXXXXXXXXXXXXXXXXXXXGXXXXXXXXXXXXXXXXXXXGXXXXXXXXXXXXXXXXXXXGXXXXXXXXXXXXXXXXXXX,10,0,0
1386,13,0,13,241,346,0,0,362,64,298,GXXXXXXXXXXXXXXXXXXXGXXXXXXXXXXXXXXXXXXXGXXXXXXXXXXXXXXXXXXXGXXXXXXXXXXXXXXXXXXXGXXXXXXXXXXXXXXXXXXXGXXXXXXXXXXXXXXXXXXXGXXXXXXXXXXXXXXXXXXXGXXXXXXXXXXXXXXXXXXXGXXXXXXXXXXXXXXXXXXXGXXXXXXXXXXXXXXXXXXXGXXXXXXXXXXXXXXXXXXXGXXXXXXXXXXXXXXXXXXXGXXXXXXXXXXXXXXXXXXX,10,0,0
1407,14,1,13,241,345,0,0,359,59,300,GXXXXXXXXXXXXXXXXXXXGXXXXXXXXXXXXXXXXXXXGXXXXXXXXXXXXXXXXXXXGXXXXXXXXXXXXXXXXXXXGXXXXXXXXXXXXXXXXXXXGXXXXXXXXXXXXXXXXXXXGXXXXXXXXXXXXXXXXXXXGAXXXXXXXXXXXXXXXXXXGXXXXXXXXXXXXXXXXXXXGXXXXXXXXXXXXXXXXXXXGXXXXXXXXXXXXXXXXXXXGXXXXXXXXXXXXXXXXXXXGXXXXXXXXXXXXXXXXXXX,10,0,0
1428,14,1,13,239,347,0,0,361,58,303,GXXXXXXXXXXXXXXXXXXXGXXXXXXXXXXXXXXXXXXXGXXXXXXXXXXXXXXXXXXXGXXXXXXXXXXXXXXXXXXXGXXXXXXXXXXXXXXXXXXXGXXXXXXXXXXXXXXXXXXXGXXXXXXXXXXXXXXXXXXXGAXXXXXXXXXXXXXXXXXXGXXXXXXXXXXXXXXXXXXXGXXXXXXXXXXXXXXXXXXXGXXXXXXXXXXXXXXXXXXXGXXXXXXXXXXXXXXXXXXXGXXXXXXXXXXXXXXXXXXX,10,0,0
1449,14,1,13,233,353,0,0,367,59,308,GXXXXXXXXXXXXXXXXXXXGXXXXXXXXXXXXXXXXXXXGXXXXXXXXXXXXXXXXXXXGXXXXXXXXXXXXXXXXXXXGXXXXXXXXXXXXXXXXXXXGXXXXXXXXXXXXXXXXXXXGXXXXXXXXXXXXXXXXXXXGAXXXXXXXXXXXXXXXXXXGXXXXXXXXXXXXXXXXXXXGXXXXXXXXXXXXXXXXXXXGXXXXXXXXXXXXXXXXXXXGXXXXXXXXXXXXXXXXXXXGXXXXXXXXXXXXXXXXXXX,10,0,0

1470,14,1,13,235,351,0,0,366,51,315,GXXXXXXXXXXXXXXXXXXXGXXXXXXXXXXXXXXXXXXXGXXXXXXXXXXXXXXXXXXXGXXXXXXXXXXXXXXXXXXXGXXXXXXXXXXXXXXXXXXXGXXXXXXXXXXXXXXXXXXXGXXXXXXXXXXXXXXXXXXXGAXXXXXXXXXXXXXXXXXXGXXXXXXXXXXXXXXXXXXXGXXXXXXXXXXXXXXXXXXXGXXXXXXXXXXXXXXXXXXXGXXXXXXXXXXXXXXXXXXXGXXXXXXXXXXXXXXXXXXX,10,0,0
1491,15,2,13,220,365,0,0,378,56,322,GXXXXXXXXXXXXXXXXXXXGXXXXXXXXXXXXXXXXXXXGXXXXXXXXXXXXXXXXXXXGXXXXXXXXXXXXXXXXXXXGXXXXXXXXXXXXXXXXXXXGXXXXXXXXXXXXXXXXXXXGXXXXXXXXXXXXXXXXXXXGAXXXXXXXXXXXXXXXXXXGXXXXXXXXXXXXXXXXXXXGXXXXXXXXXXXXXXXXXXXGAXXXXXXXXXXXXXXXXXXGXXXXXXXXXXXXXXXXXXXGXXXXXXXXXXXXXXXXXXX,10,0,0
1512,15,2,13,216,369,0,0,385,58,327,GXXXXXXXXXXXXXXXXXXXGXXXXXXXXXXXXXXXXXXXGXXXXXXXXXXXXXXXXXXXGXXXXXXXXXXXXXXXXXXXGXXXXXXXXXXXXXXXXXXXGXXXXXXXXXXXXXXXXXXXGXXXXXXXXXXXXXXXXXXXGAXXXXXXXXXXXXXXXXXXGXXXXXXXXXXXXXXXXXXXGXXXXXXXXXXXXXXXXXXXGAXXXXXXXXXXXXXXXXXXGXXXXXXXXXXXXXXXXXXXGXXXXXXXXXXXXXXXXXXX,10,0,0
1533,15,2,13,214,371,0,0,389,61,328,GXXXXXXXXXXXXXXXXXXXGXXXXXXXXXXXXXXXXXXXGXXXXXXXXXXXXXXXXXXXGXXXXXXXXXXXXXXXXXXXGXXXXXXXXXXXXXXXXXXXGXXXXXXXXXXXXXXXXXXXGXXXXXXXXXXXXXXXXXXXGAXXXXXXXXXXXXXXXXXXGXXXXXXXXXXXXXXXXXXXGXXXXXXXXXXXXXXXXXXXGAXXXXXXXXXXXXXXXXXXGXXXXXXXXXXXXXXXXXXXGXXXXXXXXXXXXXXXXXXX,10,0,0
1554,15,1,14,216,369,0,0,387,58,329,GXXXXXXXXXXXXXXXXXXXGXXXXXXXXXXXXXXXXXXXGXXXXXXXXXXXXXXXXXXXGXXXXXXXXXXXXXXXXXXXGXXXXXXXXXXXXXXXXXXXGXXXXXXXXXXXXXXXXXXXGXXXXXXXXXXXXXXXXXXXGOXXXXXXXXXXXXXXXXXXGXXXXXXXXXXXXXXXXXXXGXXXXXXXXXXXXXXXXXXXGAXXXXXXXXXXXXXXXXXXGXXXXXXXXXXXXXXXXXXXGXXXXXXXXXXXXXXXXXXX,10,0,0

1575,15,1,14,203,382,0,0,397,56,341,GXXXXXXXXXXXXXXXXXXXGXXXXXXXXXXXXXXXXXXXGXXXXXXXXXXXXXXXXXXXGXXXXXXXXXXXXXXXXXXXGXXXXXXXXXXXXXXXXXXXGXXXXXXXXXXXXXXXXXXXGXXXXXXXXXXXXXXXXXXXGOXXXXXXXXXXXXXXXXXXGXXXXXXXXXXXXXXXXXXXGXXXXXXXXXXXXXXXXXXXGAXXXXXXXXXXXXXXXXXXGXXXXXXXXXXXXXXXXXXXGXXXXXXXXXXXXXXXXXXX,10,0,0
1596,15,1,14,206,379,0,0,395,55,340,GXXXXXXXXXXXXXXXXXXXGXXXXXXXXXXXXXXXXXXXGXXXXXXXXXXXXXXXXXXXGXXXXXXXXXXXXXXXXXXXGXXXXXXXXXXXXXXXXXXXGXXXXXXXXXXXXXXXXXXXGXXXXXXXXXXXXXXXXXXXGOXXXXXXXXXXXXXXXXXXGXXXXXXXXXXXXXXXXXXXGXXXXXXXXXXXXXXXXXXXGAXXXXXXXXXXXXXXXXXXGXXXXXXXXXXXXXXXXXXXGXXXXXXXXXXXXXXXXXXX,10,0,0
1617,15,2,13,194,391,0,0,406,55,351,GXXXXXXXXXXXXXXXXXXXGXXXXXXXXXXXXXXXXXXXGXXXXXXXXXXXXXXXXXXXGXXXXXXXXXXXXXXXXXXXGXXXXXXXXXXXXXXXXXXXGXXXXXXXXXXXXXXXXXXXGXXXXXXXXXXXXXXXXXXXGXXXXXXXXXXXXXXXXXXXGXXXXXXXXXXXXXXXXXXXGXXXXXXXXXXXXXXXXXXXGAXXXXXXXXXXXXXXXXXXGXXXXXXXXXXXXXXXXXXXGAXXXXXXXXXXXXXXXXXX,9,1,0
1638,15,2,13,187,398,0,0,412,51,361,GXXXXXXXXXXXXXXXXXXXGXXXXXXXXXXXXXXXXXXXGXXXXXXXXXXXXXXXXXXXGXXXXXXXXXXXXXXXXXXXGXXXXXXXXXXXXXXXXXXXGXXXXXXXXXXXXXXXXXXXGXXXXXXXXXXXXXXXXXXXGXXXXXXXXXXXXXXXXXXXGXXXXXXXXXXXXXXXXXXXGXXXXXXXXXXXXXXXXXXXGAXXXXXXXXXXXXXXXXXXGXXXXXXXXXXXXXXXXXXXGAXXXXXXXXXXXXXXXXXX,9,1,0
1659,15,1,14,178,407,0,0,424,54,370,GXXXXXXXXXXXXXXXXXXXGXXXXXXXXXXXXXXXXXXXGXXXXXXXXXXXXXXXXXXXGXXXXXXXXXXXXXXXXXXXGXXXXXXXXXXXXXXXXXXXGXXXXXXXXXXXXXXXXXXXGXXXXXXXXXXXXXXXXXXXGXXXXXXXXXXXXXXXXXXXGXXXXXXXXXXXXXXXXXXXGXXXXXXXXXXXXXXXXXXXGAXXXXXXXXXXXXXXXXXXGXXXXXXXXXXXXXXXXXXXGOXXXXXXXXXXXXXXXXXX,9,1,0

1680,15,1,14,177,408,0,0,424,70,354,GXXXXXXXXXXXXXXXXXXXGXXXXXXXXXXXXXXXXXXXGXXXXXXXXXXXXXXXXXXXGXXXXXXXXXXXXXXXXXXXGXXXXXXXXXXXXXXXXXXXGXXXXXXXXXXXXXXXXXXXGXXXXXXXXXXXXXXXXXXXGXXXXXXXXXXXXXXXXXXXGXXXXXXXXXXXXXXXXXXXGXXXXXXXXXXXXXXXXXXXGAXXXXXXXXXXXXXXXXXXGXXXXXXXXXXXXXXXXXXXGOXXXXXXXXXXXXXXXXXX,8,2,0
1701,14,1,13,179,407,0,0,422,73,349,GXXXXXXXXXXXXXXXXXXXGXXXXXXXXXXXXXXXXXXXGXXXXXXXXXXXXXXXXXXXGXXXXXXXXXXXXXXXXXXXGXXXXXXXXXXXXXXXXXXXGXXXXXXXXXXXXXXXXXXXGXXXXXXXXXXXXXXXXXXXGXXXXXXXXXXXXXXXXXXXGXXXXXXXXXXXXXXXXXXXGXXXXXXXXXXXXXXXXXXXGAXXXXXXXXXXXXXXXXXXGXXXXXXXXXXXXXXXXXXXGXXXXXXXXXXXXXXXXXXX,8,2,0
1722,14,1,13,185,401,0,0,416,74,342,GXXXXXXXXXXXXXXXXXXXGXXXXXXXXXXXXXXXXXXXGXXXXXXXXXXXXXXXXXXXGXXXXXXXXXXXXXXXXXXXGXXXXXXXXXXXXXXXXXXXGXXXXXXXXXXXXXXXXXXXGXXXXXXXXXXXXXXXXXXXGXXXXXXXXXXXXXXXXXXXGXXXXXXXXXXXXXXXXXXXGXXXXXXXXXXXXXXXXXXXGAXXXXXXXXXXXXXXXXXXGXXXXXXXXXXXXXXXXXXXGXXXXXXXXXXXXXXXXXXX,7,3,0
1743,14,0,14,187,399,0,0,415,74,341,GXXXXXXXXXXXXXXXXXXXGXXXXXXXXXXXXXXXXXXXGXXXXXXXXXXXXXXXXXXXGXXXXXXXXXXXXXXXXXXXGXXXXXXXXXXXXXXXXXXXGXXXXXXXXXXXXXXXXXXXGXXXXXXXXXXXXXXXXXXXGXXXXXXXXXXXXXXXXXXXGXXXXXXXXXXXXXXXXXXXGXXXXXXXXXXXXXXXXXXXGOXXXXXXXXXXXXXXXXXXGXXXXXXXXXXXXXXXXXXXGXXXXXXXXXXXXXXXXXXX,6,4,0
1764,13,0,13,194,393,0,0,407,69,338,GXXXXXXXXXXXXXXXXXXXGXXXXXXXXXXXXXXXXXXXGXXXXXXXXXXXXXXXXXXXGXXXXXXXXXXXXXXXXXXXGXXXXXXXXXXXXXXXXXXXGXXXXXXXXXXXXXXXXXXXGXXXXXXXXXXXXXXXXXXXGXXXXXXXXXXXXXXXXXXXGXXXXXXXXXXXXXXXXXXXGXXXXXXXXXXXXXXXXXXXGXXXXXXXXXXXXXXXXXXXGXXXXXXXXXXXXXXXXXXXGXXXXXXXXXXXXXXXXXXX,6,4,0

1785,13,0,13,202,385,0,0,401,76,325,GXXXXXXXXXXXXXXXXXXXGXXXXXXXXXXXXXXXXXXXGXXXXXXXXXXXXXXXXXXXGXXXXXXXXXXXXXXXXXXXGXXXXXXXXXXXXXXXXXXXGXXXXXXXXXXXXXXXXXXXGXXXXXXXXXXXXXXXXXXXGXXXXXXXXXXXXXXXXXXXGXXXXXXXXXXXXXXXXXXXGXXXXXXXXXXXXXXXXXXXGXXXXXXXXXXXXXXXXXXXGXXXXXXXXXXXXXXXXXXXGXXXXXXXXXXXXXXXXXXX,6,4,0
1806,13,0,13,213,374,0,0,390,75,315,GXXXXXXXXXXXXXXXXXXXGXXXXXXXXXXXXXXXXXXXGXXXXXXXXXXXXXXXXXXXGXXXXXXXXXXXXXXXXXXXGXXXXXXXXXXXXXXXXXXXGXXXXXXXXXXXXXXXXXXXGXXXXXXXXXXXXXXXXXXXGXXXXXXXXXXXXXXXXXXXGXXXXXXXXXXXXXXXXXXXGXXXXXXXXXXXXXXXXXXXGXXXXXXXXXXXXXXXXXXXGXXXXXXXXXXXXXXXXXXXGXXXXXXXXXXXXXXXXXXX,5,5,0
1827,14,1,13,216,370,0,0,386,70,316,GXXXXXXXXXXXXXXXXXXXGAXXXXXXXXXXXXXXXXXXGXXXXXXXXXXXXXXXXXXXGXXXXXXXXXXXXXXXXXXXGXXXXXXXXXXXXXXXXXXXGXXXXXXXXXXXXXXXXXXXGXXXXXXXXXXXXXXXXXXXGXXXXXXXXXXXXXXXXXXXGXXXXXXXXXXXXXXXXXXXGXXXXXXXXXXXXXXXXXXXGXXXXXXXXXXXXXXXXXXXGXXXXXXXXXXXXXXXXXXXGXXXXXXXXXXXXXXXXXXX,4,6,0
1848,14,1,13,221,365,0,0,383,74,309,GXXXXXXXXXXXXXXXXXXXGAXXXXXXXXXXXXXXXXXXGXXXXXXXXXXXXXXXXXXXGXXXXXXXXXXXXXXXXXXXGXXXXXXXXXXXXXXXXXXXGXXXXXXXXXXXXXXXXXXXGXXXXXXXXXXXXXXXXXXXGXXXXXXXXXXXXXXXXXXXGXXXXXXXXXXXXXXXXXXXGXXXXXXXXXXXXXXXXXXXGXXXXXXXXXXXXXXXXXXXGXXXXXXXXXXXXXXXXXXXGXXXXXXXXXXXXXXXXXXX,4,6,0
1869,15,2,13,220,365,0,0,382,63,319,GXXXXXXXXXXXXXXXXXXXGAAXXXXXXXXXXXXXXXXXGXXXXXXXXXXXXXXXXXXXGXXXXXXXXXXXXXXXXXXXGXXXXXXXXXXXXXXXXXXXGXXXXXXXXXXXXXXXXXXXGXXXXXXXXXXXXXXXXXXXGXXXXXXXXXXXXXXXXXXXGXXXXXXXXXXXXXXXXXXXGXXXXXXXXXXXXXXXXXXXGXXXXXXXXXXXXXXXXXXXGXXXXXXXXXXXXXXXXXXXGXXXXXXXXXXXXXXXXXXX,4,6,0

1890,16,3,13,223,361,0,0,379,58,321,GXXXXXXXXXXXXXXXXXXXGAAXXXXXXXXXXXXXXXXXGAXXXXXXXXXXXXXXXXXXGXXXXXXXXXXXXXXXXXXXGXXXXXXXXXXXXXXXXXXXGXXXXXXXXXXXXXXXXXXXGXXXXXXXXXXXXXXXXXXXGXXXXXXXXXXXXXXXXXXXGXXXXXXXXXXXXXXXXXXXGXXXXXXXXXXXXXXXXXXXGXXXXXXXXXXXXXXXXXXXGXXXXXXXXXXXXXXXXXXXGXXXXXXXXXXXXXXXXXXX,3,7,0
1911,16,3,13,217,367,0,0,385,59,326,GXXXXXXXXXXXXXXXXXXXGAAXXXXXXXXXXXXXXXXXGAXXXXXXXXXXXXXXXXXXGXXXXXXXXXXXXXXXXXXXGXXXXXXXXXXXXXXXXXXXGXXXXXXXXXXXXXXXXXXXGXXXXXXXXXXXXXXXXXXXGXXXXXXXXXXXXXXXXXXXGXXXXXXXXXXXXXXXXXXXGXXXXXXXXXXXXXXXXXXXGXXXXXXXXXXXXXXXXXXXGXXXXXXXXXXXXXXXXXXXGXXXXXXXXXXXXXXXXXXX,3,7,0
1932,16,2,14,217,367,0,0,384,60,324,GXXXXXXXXXXXXXXXXXXXGOAXXXXXXXXXXXXXXXXXGAXXXXXXXXXXXXXXXXXXGXXXXXXXXXXXXXXXXXXXGXXXXXXXXXXXXXXXXXXXGXXXXXXXXXXXXXXXXXXXGXXXXXXXXXXXXXXXXXXXGXXXXXXXXXXXXXXXXXXXGXXXXXXXXXXXXXXXXXXXGXXXXXXXXXXXXXXXXXXXGXXXXXXXXXXXXXXXXXXXGXXXXXXXXXXXXXXXXXXXGXXXXXXXXXXXXXXXXXXX,2,8,0
1953,15,2,13,218,367,0,0,382,56,326,GXXXXXXXXXXXXXXXXXXXGXAXXXXXXXXXXXXXXXXXGAXXXXXXXXXXXXXXXXXXGXXXXXXXXXXXXXXXXXXXGXXXXXXXXXXXXXXXXXXXGXXXXXXXXXXXXXXXXXXXGXXXXXXXXXXXXXXXXXXXGXXXXXXXXXXXXXXXXXXXGXXXXXXXXXXXXXXXXXXXGXXXXXXXXXXXXXXXXXXXGXXXXXXXXXXXXXXXXXXXGXXXXXXXXXXXXXXXXXXXGXXXXXXXXXXXXXXXXXXX,2,8,0
1974,16,3,13,209,375,0,0,390,56,334,GXXXXXXXXXXXXXXXXXXXGXAAXXXXXXXXXXXXXXXXGAXXXXXXXXXXXXXXXXXXGXXXXXXXXXXXXXXXXXXXGXXXXXXXXXXXXXXXXXXXGXXXXXXXXXXXXXXXXXXXGXXXXXXXXXXXXXXXXXXXGXXXXXXXXXXXXXXXXXXXGXXXXXXXXXXXXXXXXXXXGXXXXXXXXXXXXXXXXXXXGXXXXXXXXXXXXXXXXXXXGXXXXXXXXXXXXXXXXXXXGXXXXXXXXXXXXXXXXXXX,2,8,0

1995,14,1,13,206,380,0,0,394,63,331,GXXXXXXXXXXXXXXXXXXXGXXXXXXXXXXXXXXXXXXXGAXXXXXXXXXXXXXXXXXXGXXXXXXXXXXXXXXXXXXXGXXXXXXXXXXXXXXXXXXXGXXXXXXXXXXXXXXXXXXXGXXXXXXXXXXXXXXXXXXXGXXXXXXXXXXXXXXXXXXXGXXXXXXXXXXXXXXXXXXXGXXXXXXXXXXXXXXXXXXXGXXXXXXXXXXXXXXXXXXXGXXXXXXXXXXXXXXXXXXXGXXXXXXXXXXXXXXXXXXX,0,10,0
2016,14,1,13,204,382,0,0,396,65,331,GXXXXXXXXXXXXXXXXXXXGXXXXXXXXXXXXXXXXXXXGAXXXXXXXXXXXXXXXXXXGXXXXXXXXXXXXXXXXXXXGXXXXXXXXXXXXXXXXXXXGXXXXXXXXXXXXXXXXXXXGXXXXXXXXXXXXXXXXXXXGXXXXXXXXXXXXXXXXXXXGXXXXXXXXXXXXXXXXXXXGXXXXXXXXXXXXXXXXXXXGXXXXXXXXXXXXXXXXXXXGXXXXXXXXXXXXXXXXXXXGXXXXXXXXXXXXXXXXXXX,0,10,0
2037,14,1,13,202,384,0,0,397,69,328,GXXXXXXXXXXXXXXXXXXXGXXXXXXXXXXXXXXXXXXXGAXXXXXXXXXXXXXXXXXXGXXXXXXXXXXXXXXXXXXXGXXXXXXXXXXXXXXXXXXXGXXXXXXXXXXXXXXXXXXXGXXXXXXXXXXXXXXXXXXXGXXXXXXXXXXXXXXXXXXXGXXXXXXXXXXXXXXXXXXXGXXXXXXXXXXXXXXXXXXXGXXXXXXXXXXXXXXXXXXXGXXXXXXXXXXXXXXXXXXXGXXXXXXXXXXXXXXXXXXX,0,10,0
2058,14,1,13,193,393,0,0,405,67,338,GXXXXXXXXXXXXXXXXXXXGXXXXXXXXXXXXXXXXXXXGAXXXXXXXXXXXXXXXXXXGXXXXXXXXXXXXXXXXXXXGXXXXXXXXXXXXXXXXXXXGXXXXXXXXXXXXXXXXXXXGXXXXXXXXXXXXXXXXXXXGXXXXXXXXXXXXXXXXXXXGXXXXXXXXXXXXXXXXXXXGXXXXXXXXXXXXXXXXXXXGXXXXXXXXXXXXXXXXXXXGXXXXXXXXXXXXXXXXXXXGXXXXXXXXXXXXXXXXXXX,0,10,0
2079,14,1,13,189,397,0,0,412,62,350,GXXXXXXXXXXXXXXXXXXXGXXXXXXXXXXXXXXXXXXXGAXXXXXXXXXXXXXXXXXXGXXXXXXXXXXXXXXXXXXXGXXXXXXXXXXXXXXXXXXXGXXXXXXXXXXXXXXXXXXXGXXXXXXXXXXXXXXXXXXXGXXXXXXXXXXXXXXXXXXXGXXXXXXXXXXXXXXXXXXXGXXXXXXXXXXXXXXXXXXXGXXXXXXXXXXXXXXXXXXXGXXXXXXXXXXXXXXXXXXXGXXXXXXXXXXXXXXXXXXX,0,10,0

2100,14,1,13,192,394,0,0,409,68,341,GXXXXXXXXXXXXXXXXXXXGXXXXXXXXXXXXXXXXXXXGAXXXXXXXXXXXXXXXXXXGXXXXXXXXXXXXXXXXXXXGXXXXXXXXXXXXXXXXXXXGXXXXXXXXXXXXXXXXXXXGXXXXXXXXXXXXXXXXXXXGXXXXXXXXXXXXXXXXXXXGXXXXXXXXXXXXXXXXXXXGXXXXXXXXXXXXXXXXXXXGXXXXXXXXXXXXXXXXXXXGXXXXXXXXXXXXXXXXXXXGXXXXXXXXXXXXXXXXXXX,0,10,0
2121,14,0,14,189,397,0,0,413,64,349,GXXXXXXXXXXXXXXXXXXXGXXXXXXXXXXXXXXXXXXXGOXXXXXXXXXXXXXXXXXXGXXXXXXXXXXXXXXXXXXXGXXXXXXXXXXXXXXXXXXXGXXXXXXXXXXXXXXXXXXXGXXXXXXXXXXXXXXXXXXXGXXXXXXXXXXXXXXXXXXXGXXXXXXXXXXXXXXXXXXXGXXXXXXXXXXXXXXXXXXXGXXXXXXXXXXXXXXXXXXXGXXXXXXXXXXXXXXXXXXXGXXXXXXXXXXXXXXXXXXX,0,10,0
2142,14,0,14,187,399,0,0,413,65,348,GXXXXXXXXXXXXXXXXXXXGXXXXXXXXXXXXXXXXXXXGOXXXXXXXXXXXXXXXXXXGXXXXXXXXXXXXXXXXXXXGXXXXXXXXXXXXXXXXXXXGXXXXXXXXXXXXXXXXXXXGXXXXXXXXXXXXXXXXXXXGXXXXXXXXXXXXXXXXXXXGXXXXXXXXXXXXXXXXXXXGXXXXXXXXXXXXXXXXXXXGXXXXXXXXXXXXXXXXXXXGXXXXXXXXXXXXXXXXXXXGXXXXXXXXXXXXXXXXXXX,0,10,0
2163,14,1,13,196,390,0,0,405,63,342,GXXXXXXXXXXXXXXXXXXXGXXXXXXXXXXXXXXXXXXXGXXXXXXXXXXXXXXXXXXXGXXXXXXXXXXXXXXXXXXXGXXXXXXXXXXXXXXXXXXXGXXXXXXXXXXXXXXXXXXXGXXXXXXXXXXXXXXXXXXXGXXXXXXXXXXXXXXXXXXXGXXXXXXXXXXXXXXXXXXXGXXXXXXXXXXXXXXXXXXXGXXXXXXXXXXXXXXXXXXXGAXXXXXXXXXXXXXXXXXXGXXXXXXXXXXXXXXXXXXX,0,10,0
2184,14,1,13,203,383,0,0,399,59,340,GXXXXXXXXXXXXXXXXXXXGXXXXXXXXXXXXXXXXXXXGXXXXXXXXXXXXXXXXXXXGXXXXXXXXXXXXXXXXXXXGXXXXXXXXXXXXXXXXXXXGXXXXXXXXXXXXXXXXXXXGXXXXXXXXXXXXXXXXXXXGXXXXXXXXXXXXXXXXXXXGXXXXXXXXXXXXXXXXXXXGXXXXXXXXXXXXXXXXXXXGXXXXXXXXXXXXXXXXXXXGAXXXXXXXXXXXXXXXXXXGXXXXXXXXXXXXXXXXXXX,0,10,0

2205,14,1,13,201,385,0,0,401,66,335,GXXXXXXXXXXXXXXXXXXXGXXXXXXXXXXXXXXXXXXXGXXXXXXXXXXXXXXXXXXXGXXXXXXXXXXXXXXXXXXXGXXXXXXXXXXXXXXXXXXXGXXXXXXXXXXXXXXXXXXXGXXXXXXXXXXXXXXXXXXXGXXXXXXXXXXXXXXXXXXXGXXXXXXXXXXXXXXXXXXXGXXXXXXXXXXXXXXXXXXXGXXXXXXXXXXXXXXXXXXXGAXXXXXXXXXXXXXXXXXXGXXXXXXXXXXXXXXXXXXX,0,10,0
2226,14,1,13,204,382,0,0,397,71,326,GXXXXXXXXXXXXXXXXXXXGXXXXXXXXXXXXXXXXXXXGXXXXXXXXXXXXXXXXXXXGXXXXXXXXXXXXXXXXXXXGXXXXXXXXXXXXXXXXXXXGXXXXXXXXXXXXXXXXXXXGXXXXXXXXXXXXXXXXXXXGXXXXXXXXXXXXXXXXXXXGXXXXXXXXXXXXXXXXXXXGXXXXXXXXXXXXXXXXXXXGXXXXXXXXXXXXXXXXXXXGAXXXXXXXXXXXXXXXXXXGXXXXXXXXXXXXXXXXXXX,0,10,0
2247,14,1,13,207,379,0,0,394,67,327,GXXXXXXXXXXXXXXXXXXXGXXXXXXXXXXXXXXXXXXXGXXXXXXXXXXXXXXXXXXXGXXXXXXXXXXXXXXXXXXXGXXXXXXXXXXXXXXXXXXXGXXXXXXXXXXXXXXXXXXXGXXXXXXXXXXXXXXXXXXXGXXXXXXXXXXXXXXXXXXXGXXXXXXXXXXXXXXXXXXXGXXXXXXXXXXXXXXXXXXXGXXXXXXXXXXXXXXXXXXXGAXXXXXXXXXXXXXXXXXXGXXXXXXXXXXXXXXXXXXX,0,10,0
2268,14,0,14,197,389,0,0,404,71,333,GXXXXXXXXXXXXXXXXXXXGXXXXXXXXXXXXXXXXXXXGXXXXXXXXXXXXXXXXXXXGXXXXXXXXXXXXXXXXXXXGXXXXXXXXXXXXXXXXXXXGXXXXXXXXXXXXXXXXXXXGXXXXXXXXXXXXXXXXXXXGXXXXXXXXXXXXXXXXXXXGXXXXXXXXXXXXXXXXXXXGXXXXXXXXXXXXXXXXXXXGXXXXXXXXXXXXXXXXXXXGOXXXXXXXXXXXXXXXXXXGXXXXXXXXXXXXXXXXXXX,0,10,0
2289,14,0,14,210,376,0,0,392,66,326,GXXXXXXXXXXXXXXXXXXXGXXXXXXXXXXXXXXXXXXXGXXXXXXXXXXXXXXXXXXXGXXXXXXXXXXXXXXXXXXXGXXXXXXXXXXXXXXXXXXXGXXXXXXXXXXXXXXXXXXXGXXXXXXXXXXXXXXXXXXXGXXXXXXXXXXXXXXXXXXXGXXXXXXXXXXXXXXXXXXXGXXXXXXXXXXXXXXXXXXXGXXXXXXXXXXXXXXXXXXXGOXXXXXXXXXXXXXXXXXXGXXXXXXXXXXXXXXXXXXX,0,10,0

2310,13,0,13,204,383,0,0,398,71,327,GXXXXXXXXXXXXXXXXXXXGXXXXXXXXXXXXXXXXXXXGXXXXXXXXXXXXXXXXXXXGXXXXXXXXXXXXXXXXXXXGXXXXXXXXXXXXXXXXXXXGXXXXXXXXXXXXXXXXXXXGXXXXXXXXXXXXXXXXXXXGXXXXXXXXXXXXXXXXXXXGXXXXXXXXXXXXXXXXXXXGXXXXXXXXXXXXXXXXXXXGXXXXXXXXXXXXXXXXXXXGXXXXXXXXXXXXXXXXXXXGXXXXXXXXXXXXXXXXXXX,0,10,0
2331,13,0,13,209,378,0,0,393,70,323,GXXXXXXXXXXXXXXXXXXXGXXXXXXXXXXXXXXXXXXXGXXXXXXXXXXXXXXXXXXXGXXXXXXXXXXXXXXXXXXXGXXXXXXXXXXXXXXXXXXXGXXXXXXXXXXXXXXXXXXXGXXXXXXXXXXXXXXXXXXXGXXXXXXXXXXXXXXXXXXXGXXXXXXXXXXXXXXXXXXXGXXXXXXXXXXXXXXXXXXXGXXXXXXXXXXXXXXXXXXXGXXXXXXXXXXXXXXXXXXXGXXXXXXXXXXXXXXXXXXX,0,10,0
2352,13,0,13,212,375,0,0,389,71,318,GXXXXXXXXXXXXXXXXXXXGXXXXXXXXXXXXXXXXXXXGXXXXXXXXXXXXXXXXXXXGXXXXXXXXXXXXXXXXXXXGXXXXXXXXXXXXXXXXXXXGXXXXXXXXXXXXXXXXXXXGXXXXXXXXXXXXXXXXXXXGXXXXXXXXXXXXXXXXXXXGXXXXXXXXXXXXXXXXXXXGXXXXXXXXXXXXXXXXXXXGXXXXXXXXXXXXXXXXXXXGXXXXXXXXXXXXXXXXXXXGXXXXXXXXXXXXXXXXXXX,0,10,0
2373,13,0,13,219,368,0,0,384,66,318,GXXXXXXXXXXXXXXXXXXXGXXXXXXXXXXXXXXXXXXXGXXXXXXXXXXXXXXXXXXXGXXXXXXXXXXXXXXXXXXXGXXXXXXXXXXXXXXXXXXXGXXXXXXXXXXXXXXXXXXXGXXXXXXXXXXXXXXXXXXXGXXXXXXXXXXXXXXXXXXXGXXXXXXXXXXXXXXXXXXXGXXXXXXXXXXXXXXXXXXXGXXXXXXXXXXXXXXXXXXXGXXXXXXXXXXXXXXXXXXXGXXXXXXXXXXXXXXXXXXX,0,10,0
2394,13,0,13,207,380,0,0,396,69,327,GXXXXXXXXXXXXXXXXXXXGXXXXXXXXXXXXXXXXXXXGXXXXXXXXXXXXXXXXXXXGXXXXXXXXXXXXXXXXXXXGXXXXXXXXXXXXXXXXXXXGXXXXXXXXXXXXXXXXXXXGXXXXXXXXXXXXXXXXXXXGXXXXXXXXXXXXXXXXXXXGXXXXXXXXXXXXXXXXXXXGXXXXXXXXXXXXXXXXXXXGXXXXXXXXXXXXXXXXXXXGXXXXXXXXXXXXXXXXXXXGXXXXXXXXXXXXXXXXXXX,0,10,0

2415,13,0,13,205,382,0,0,397,66,331,GXXXXXXXXXXXXXXXXXXXGXXXXXXXXXXXXXXXXXXXGXXXXXXXXXXXXXXXXXXXGXXXXXXXXXXXXXXXXXXXGXXXXXXXXXXXXXXXXXXXGXXXXXXXXXXXXXXXXXXXGXXXXXXXXXXXXXXXXXXXGXXXXXXXXXXXXXXXXXXXGXXXXXXXXXXXXXXXXXXXGXXXXXXXXXXXXXXXXXXXGXXXXXXXXXXXXXXXXXXXGXXXXXXXXXXXXXXXXXXXGXXXXXXXXXXXXXXXXXXX,0,10,0
2436,13,0,13,201,386,0,0,398,71,327,GXXXXXXXXXXXXXXXXXXXGXXXXXXXXXXXXXXXXXXXGXXXXXXXXXXXXXXXXXXXGXXXXXXXXXXXXXXXXXXXGXXXXXXXXXXXXXXXXXXXGXXXXXXXXXXXXXXXXXXXGXXXXXXXXXXXXXXXXXXXGXXXXXXXXXXXXXXXXXXXGXXXXXXXXXXXXXXXXXXXGXXXXXXXXXXXXXXXXXXXGXXXXXXXXXXXXXXXXXXXGXXXXXXXXXXXXXXXXXXXGXXXXXXXXXXXXXXXXXXX,0,10,0
2457,14,1,13,201,385,0,0,399,78,321,GXXXXXXXXXXXXXXXXXXXGXXXXXXXXXXXXXXXXXXXGXXXXXXXXXXXXXXXXXXXGXXXXXXXXXXXXXXXXXXXGXXXXXXXXXXXXXXXXXXXGXXXXXXXXXXXXXXXXXXXGAXXXXXXXXXXXXXXXXXXGXXXXXXXXXXXXXXXXXXXGXXXXXXXXXXXXXXXXXXXGXXXXXXXXXXXXXXXXXXXGXXXXXXXXXXXXXXXXXXXGXXXXXXXXXXXXXXXXXXXGXXXXXXXXXXXXXXXXXXX,0,10,0
2478,14,1,13,199,387,0,0,400,82,318,GXXXXXXXXXXXXXXXXXXXGXXXXXXXXXXXXXXXXXXXGXXXXXXXXXXXXXXXXXXXGXXXXXXXXXXXXXXXXXXXGXXXXXXXXXXXXXXXXXXXGXXXXXXXXXXXXXXXXXXXGAXXXXXXXXXXXXXXXXXXGXXXXXXXXXXXXXXXXXXXGXXXXXXXXXXXXXXXXXXXGXXXXXXXXXXXXXXXXXXXGXXXXXXXXXXXXXXXXXXXGXXXXXXXXXXXXXXXXXXXGXXXXXXXXXXXXXXXXXXX,0,10,0
2499,14,1,13,205,381,0,0,393,74,319,GXXXXXXXXXXXXXXXXXXXGXXXXXXXXXXXXXXXXXXXGXXXXXXXXXXXXXXXXXXXGXXXXXXXXXXXXXXXXXXXGXXXXXXXXXXXXXXXXXXXGXXXXXXXXXXXXXXXXXXXGAXXXXXXXXXXXXXXXXXXGXXXXXXXXXXXXXXXXXXXGXXXXXXXXXXXXXXXXXXXGXXXXXXXXXXXXXXXXXXXGXXXXXXXXXXXXXXXXXXXGXXXXXXXXXXXXXXXXXXXGXXXXXXXXXXXXXXXXXXX,0,10,0

2520,14,1,13,201,385,0,0,399,80,319,GXXXXXXXXXXXXXXXXXXXGXXXXXXXXXXXXXXXXXXXGXXXXXXXXXXXXXXXXXXXGXXXXXXXXXXXXXXXXXXXGXXXXXXXXXXXXXXXXXXXGXXXXXXXXXXXXXXXXXXXGAXXXXXXXXXXXXXXXXXXGXXXXXXXXXXXXXXXXXXXGXXXXXXXXXXXXXXXXXXXGXXXXXXXXXXXXXXXXXXXGXXXXXXXXXXXXXXXXXXXGXXXXXXXXXXXXXXXXXXXGXXXXXXXXXXXXXXXXXXX,0,10,0
2541,15,2,13,197,388,0,0,402,85,317,GXXXXXXXXXXXXXXXXXXXGXXXXXXXXXXXXXXXXXXXGXXXXXXXXXXXXXXXXXXXGXXXXXXXXXXXXXXXXXXXGXXXXXXXXXXXXXXXXXXXGXXXXXXXXXXXXXXXXXXXGAXXXXXXXXXXXXXXXXXXGAXXXXXXXXXXXXXXXXXXGXXXXXXXXXXXXXXXXXXXGXXXXXXXXXXXXXXXXXXXGXXXXXXXXXXXXXXXXXXXGXXXXXXXXXXXXXXXXXXXGXXXXXXXXXXXXXXXXXXX,0,10,0
2562,16,3,13,201,383,0,0,397,87,310,GXXXXXXXXXXXXXXXXXXXGXXXXXXXXXXXXXXXXXXXGXXXXXXXXXXXXXXXXXXXGXXXXXXXXXXXXXXXXXXXGXXXXXXXXXXXXXXXXXXXGXXXXXXXXXXXXXXXXXXXGAXXXXXXXXXXXXXXXXXXGAXXXXXXXXXXXXXXXXXXGXXXXXXXXXXXXXXXXXXXGXXXXXXXXXXXXXXXXXXXGAXXXXXXXXXXXXXXXXXXGXXXXXXXXXXXXXXXXXXXGXXXXXXXXXXXXXXXXXXX,0,10,0
2583,16,3,13,203,381,0,0,395,86,309,GXXXXXXXXXXXXXXXXXXXGXXXXXXXXXXXXXXXXXXXGXXXXXXXXXXXXXXXXXXXGXXXXXXXXXXXXXXXXXXXGXXXXXXXXXXXXXXXXXXXGXXXXXXXXXXXXXXXXXXXGAXXXXXXXXXXXXXXXXXXGAXXXXXXXXXXXXXXXXXXGXXXXXXXXXXXXXXXXXXXGXXXXXXXXXXXXXXXXXXXGAXXXXXXXXXXXXXXXXXXGXXXXXXXXXXXXXXXXXXXGXXXXXXXXXXXXXXXXXXX,0,10,0
2604,16,3,13,202,382,0,0,396,80,316,GXXXXXXXXXXXXXXXXXXXGXXXXXXXXXXXXXXXXXXXGXXXXXXXXXXXXXXXXXXXGXXXXXXXXXXXXXXXXXXXGXXXXXXXXXXXXXXXXXXXGXXXXXXXXXXXXXXXXXXXGAXXXXXXXXXXXXXXXXXXGAXXXXXXXXXXXXXXXXXXGXXXXXXXXXXXXXXXXXXXGXXXXXXXXXXXXXXXXXXXGAXXXXXXXXXXXXXXXXXXGXXXXXXXXXXXXXXXXXXXGXXXXXXXXXXXXXXXXXXX,0,10,0

2625,16,3,13,201,383,0,0,396,83,313,GXXXXXXXXXXXXXXXXXXXGXXXXXXXXXXXXXXXXXXXGXXXXXXXXXXXXXXXXXXXGXXXXXXXXXXXXXXXXXXXGXXXXXXXXXXXXXXXXXXXGXXXXXXXXXXXXXXXXXXXGAXXXXXXXXXXXXXXXXXXGAXXXXXXXXXXXXXXXXXXGXXXXXXXXXXXXXXXXXXXGXXXXXXXXXXXXXXXXXXXGAXXXXXXXXXXXXXXXXXXGXXXXXXXXXXXXXXXXXXXGXXXXXXXXXXXXXXXXXXX,0,10,0
2646,16,3,13,201,383,0,0,397,81,316,GXXXXXXXXXXXXXXXXXXXGXXXXXXXXXXXXXXXXXXXGXXXXXXXXXXXXXXXXXXXGXXXXXXXXXXXXXXXXXXXGXXXXXXXXXXXXXXXXXXXGXXXXXXXXXXXXXXXXXXXGAXXXXXXXXXXXXXXXXXXGAXXXXXXXXXXXXXXXXXXGXXXXXXXXXXXXXXXXXXXGXXXXXXXXXXXXXXXXXXXGAXXXXXXXXXXXXXXXXXXGXXXXXXXXXXXXXXXXXXXGXXXXXXXXXXXXXXXXXXX,0,10,0
2667,16,3,13,192,392,0,0,405,69,336,GXXXXXXXXXXXXXXXXXXXGXXXXXXXXXXXXXXXXXXXGXXXXXXXXXXXXXXXXXXXGXXXXXXXXXXXXXXXXXXXGXXXXXXXXXXXXXXXXXXXGXXXXXXXXXXXXXXXXXXXGAXXXXXXXXXXXXXXXXXXGAXXXXXXXXXXXXXXXXXXGXXXXXXXXXXXXXXXXXXXGXXXXXXXXXXXXXXXXXXXGAXXXXXXXXXXXXXXXXXXGXXXXXXXXXXXXXXXXXXXGXXXXXXXXXXXXXXXXXXX,0,10,0
2688,17,2,15,198,385,0,0,400,77,323,GXXXXXXXXXXXXXXXXXXXGXXXXXXXXXXXXXXXXXXXGXXXXXXXXXXXXXXXXXXXGXXXXXXXXXXXXXXXXXXXGXXXXXXXXXXXXXXXXXXXGXXXXXXXXXXXXXXXXXXXGAXXXXXXXXXXXXXXXXXXGOXXXXXXXXXXXXXXXXXXGXXXXXXXXXXXXXXXXXXXGXXXXXXXXXXXXXXXXXXXGOAXXXXXXXXXXXXXXXXXGXXXXXXXXXXXXXXXXXXXGXXXXXXXXXXXXXXXXXXX,0,10,0
2709,15,2,13,203,382,0,0,397,75,322,GXXXXXXXXXXXXXXXXXXXGXXXXXXXXXXXXXXXXXXXGXXXXXXXXXXXXXXXXXXXGXXXXXXXXXXXXXXXXXXXGXXXXXXXXXXXXXXXXXXXGXXXXXXXXXXXXXXXXXXXGAXXXXXXXXXXXXXXXXXXGXXXXXXXXXXXXXXXXXXXGXXXXXXXXXXXXXXXXXXXGXXXXXXXXXXXXXXXXXXXGXAXXXXXXXXXXXXXXXXXGXXXXXXXXXXXXXXXXXXXGXXXXXXXXXXXXXXXXXXX,0,10,0

2730,15,1,14,209,376,0,0,391,74,317,GXXXXXXXXXXXXXXXXXXXGXXXXXXXXXXXXXXXXXXXGXXXXXXXXXXXXXXXXXXXGXXXXXXXXXXXXXXXXXXXGXXXXXXXXXXXXXXXXXXXGXXXXXXXXXXXXXXXXXXXGOXXXXXXXXXXXXXXXXXXGXXXXXXXXXXXXXXXXXXXGXXXXXXXXXXXXXXXXXXXGXXXXXXXXXXXXXXXXXXXGXAXXXXXXXXXXXXXXXXXGXXXXXXXXXXXXXXXXXXXGXXXXXXXXXXXXXXXXXXX,0,10,0
2751,14,0,14,210,376,0,0,390,69,321,GXXXXXXXXXXXXXXXXXXXGXXXXXXXXXXXXXXXXXXXGXXXXXXXXXXXXXXXXXXXGXXXXXXXXXXXXXXXXXXXGXXXXXXXXXXXXXXXXXXXGXXXXXXXXXXXXXXXXXXXGOXXXXXXXXXXXXXXXXXXGXXXXXXXXXXXXXXXXXXXGXXXXXXXXXXXXXXXXXXXGXXXXXXXXXXXXXXXXXXXGXXXXXXXXXXXXXXXXXXXGXXXXXXXXXXXXXXXXXXXGXXXXXXXXXXXXXXXXXXX,0,10,0
2772,14,1,13,202,384,0,0,399,75,324,GXXXXXXXXXXXXXXXXXXXGXXXXXXXXXXXXXXXXXXXGXXXXXXXXXXXXXXXXXXXGXXXXXXXXXXXXXXXXXXXGXXXXXXXXXXXXXXXXXXXGXXXXXXXXXXXXXXXXXXXGXAXXXXXXXXXXXXXXXXXGXXXXXXXXXXXXXXXXXXXGXXXXXXXXXXXXXXXXXXXGXXXXXXXXXXXXXXXXXXXGXXXXXXXXXXXXXXXXXXXGXXXXXXXXXXXXXXXXXXXGXXXXXXXXXXXXXXXXXXX,0,10,0
2793,14,1,13,204,382,0,0,397,72,325,GXXXXXXXXXXXXXXXXXXXGXXXXXXXXXXXXXXXXXXXGXXXXXXXXXXXXXXXXXXXGXXXXXXXXXXXXXXXXXXXGXXXXXXXXXXXXXXXXXXXGXXXXXXXXXXXXXXXXXXXGXAXXXXXXXXXXXXXXXXXGXXXXXXXXXXXXXXXXXXXGXXXXXXXXXXXXXXXXXXXGXXXXXXXXXXXXXXXXXXXGXXXXXXXXXXXXXXXXXXXGXXXXXXXXXXXXXXXXXXXGXXXXXXXXXXXXXXXXXXX,0,10,0
2814,13,0,13,200,387,0,0,402,80,322,GXXXXXXXXXXXXXXXXXXXGXXXXXXXXXXXXXXXXXXXGXXXXXXXXXXXXXXXXXXXGXXXXXXXXXXXXXXXXXXXGXXXXXXXXXXXXXXXXXXXGXXXXXXXXXXXXXXXXXXXGXXXXXXXXXXXXXXXXXXXGXXXXXXXXXXXXXXXXXXXGXXXXXXXXXXXXXXXXXXXGXXXXXXXXXXXXXXXXXXXGXXXXXXXXXXXXXXXXXXXGXXXXXXXXXXXXXXXXXXXGXXXXXXXXXXXXXXXXXXX,0,10,0

2835,13,0,13,189,398,0,0,415,72,343,GXXXXXXXXXXXXXXXXXXXGXXXXXXXXXXXXXXXXXXXGXXXXXXXXXXXXXXXXXXXGXXXXXXXXXXXXXXXXXXXGXXXXXXXXXXXXXXXXXXXGXXXXXXXXXXXXXXXXXXXGXXXXXXXXXXXXXXXXXXXGXXXXXXXXXXXXXXXXXXXGXXXXXXXXXXXXXXXXXXXGXXXXXXXXXXXXXXXXXXXGXXXXXXXXXXXXXXXXXXXGXXXXXXXXXXXXXXXXXXXGXXXXXXXXXXXXXXXXXXX,0,10,0
2856,13,0,13,188,399,0,0,415,81,334,GXXXXXXXXXXXXXXXXXXXGXXXXXXXXXXXXXXXXXXXGXXXXXXXXXXXXXXXXXXXGXXXXXXXXXXXXXXXXXXXGXXXXXXXXXXXXXXXXXXXGXXXXXXXXXXXXXXXXXXXGXXXXXXXXXXXXXXXXXXXGXXXXXXXXXXXXXXXXXXXGXXXXXXXXXXXXXXXXXXXGXXXXXXXXXXXXXXXXXXXGXXXXXXXXXXXXXXXXXXXGXXXXXXXXXXXXXXXXXXXGXXXXXXXXXXXXXXXXXXX,0,10,0
2877,13,0,13,186,401,0,0,418,82,336,GXXXXXXXXXXXXXXXXXXXGXXXXXXXXXXXXXXXXXXXGXXXXXXXXXXXXXXXXXXXGXXXXXXXXXXXXXXXXXXXGXXXXXXXXXXXXXXXXXXXGXXXXXXXXXXXXXXXXXXXGXXXXXXXXXXXXXXXXXXXGXXXXXXXXXXXXXXXXXXXGXXXXXXXXXXXXXXXXXXXGXXXXXXXXXXXXXXXXXXXGXXXXXXXXXXXXXXXXXXXGXXXXXXXXXXXXXXXXXXXGXXXXXXXXXXXXXXXXXXX,0,10,0
2898,13,0,13,181,406,0,0,424,87,337,GXXXXXXXXXXXXXXXXXXXGXXXXXXXXXXXXXXXXXXXGXXXXXXXXXXXXXXXXXXXGXXXXXXXXXXXXXXXXXXXGXXXXXXXXXXXXXXXXXXXGXXXXXXXXXXXXXXXXXXXGXXXXXXXXXXXXXXXXXXXGXXXXXXXXXXXXXXXXXXXGXXXXXXXXXXXXXXXXXXXGXXXXXXXXXXXXXXXXXXXGXXXXXXXXXXXXXXXXXXXGXXXXXXXXXXXXXXXXXXXGXXXXXXXXXXXXXXXXXXX,0,10,0
2919,13,0,13,190,397,0,0,412,80,332,GXXXXXXXXXXXXXXXXXXXGXXXXXXXXXXXXXXXXXXXGXXXXXXXXXXXXXXXXXXXGXXXXXXXXXXXXXXXXXXXGXXXXXXXXXXXXXXXXXXXGXXXXXXXXXXXXXXXXXXXGXXXXXXXXXXXXXXXXXXXGXXXXXXXXXXXXXXXXXXXGXXXXXXXXXXXXXXXXXXXGXXXXXXXXXXXXXXXXXXXGXXXXXXXXXXXXXXXXXXXGXXXXXXXXXXXXXXXXXXXGXXXXXXXXXXXXXXXXXXX,0,10,0

2940,13,0,13,193,394,0,0,409,77,332,GXXXXXXXXXXXXXXXXXXXGXXXXXXXXXXXXXXXXXXXGXXXXXXXXXXXXXXXXXXXGXXXXXXXXXXXXXXXXXXXGXXXXXXXXXXXXXXXXXXXGXXXXXXXXXXXXXXXXXXXGXXXXXXXXXXXXXXXXXXXGXXXXXXXXXXXXXXXXXXXGXXXXXXXXXXXXXXXXXXXGXXXXXXXXXXXXXXXXXXXGXXXXXXXXXXXXXXXXXXXGXXXXXXXXXXXXXXXXXXXGXXXXXXXXXXXXXXXXXXX,0,10,0
2961,13,0,13,190,397,0,0,412,72,340,GXXXXXXXXXXXXXXXXXXXGXXXXXXXXXXXXXXXXXXXGXXXXXXXXXXXXXXXXXXXGXXXXXXXXXXXXXXXXXXXGXXXXXXXXXXXXXXXXXXXGXXXXXXXXXXXXXXXXXXXGXXXXXXXXXXXXXXXXXXXGXXXXXXXXXXXXXXXXXXXGXXXXXXXXXXXXXXXXXXXGXXXXXXXXXXXXXXXXXXXGXXXXXXXXXXXXXXXXXXXGXXXXXXXXXXXXXXXXXXXGXXXXXXXXXXXXXXXXXXX,0,10,0
2982,14,1,13,192,394,0,0,408,77,331,GAXXXXXXXXXXXXXXXXXXGXXXXXXXXXXXXXXXXXXXGXXXXXXXXXXXXXXXXXXXGXXXXXXXXXXXXXXXXXXXGXXXXXXXXXXXXXXXXXXXGXXXXXXXXXXXXXXXXXXXGXXXXXXXXXXXXXXXXXXXGXXXXXXXXXXXXXXXXXXXGXXXXXXXXXXXXXXXXXXXGXXXXXXXXXXXXXXXXXXXGXXXXXXXXXXXXXXXXXXXGXXXXXXXXXXXXXXXXXXXGXXXXXXXXXXXXXXXXXXX,0,10,0
3003,15,2,13,196,389,0,0,404,82,322,GAXXXXXXXXXXXXXXXXXXGXXXXXXXXXXXXXXXXXXXGAXXXXXXXXXXXXXXXXXXGXXXXXXXXXXXXXXXXXXXGXXXXXXXXXXXXXXXXXXXGXXXXXXXXXXXXXXXXXXXGXXXXXXXXXXXXXXXXXXXGXXXXXXXXXXXXXXXXXXXGXXXXXXXXXXXXXXXXXXXGXXXXXXXXXXXXXXXXXXXGXXXXXXXXXXXXXXXXXXXGXXXXXXXXXXXXXXXXXXXGXXXXXXXXXXXXXXXXXXX,0,10,0
3024,15,2,13,194,391,0,0,406,83,323,GAXXXXXXXXXXXXXXXXXXGXXXXXXXXXXXXXXXXXXXGAXXXXXXXXXXXXXXXXXXGXXXXXXXXXXXXXXXXXXXGXXXXXXXXXXXXXXXXXXXGXXXXXXXXXXXXXXXXXXXGXXXXXXXXXXXXXXXXXXXGXXXXXXXXXXXXXXXXXXXGXXXXXXXXXXXXXXXXXXXGXXXXXXXXXXXXXXXXXXXGXXXXXXXXXXXXXXXXXXXGXXXXXXXXXXXXXXXXXXXGXXXXXXXXXXXXXXXXXXX,0,10,0

3045,17,4,13,196,387,0,0,402,85,317,GAXXXXXXXXXXXXXXXXXXGXXXXXXXXXXXXXXXXXXXGAXXXXXXXXXXXXXXXXXXGAXXXXXXXXXXXXXXXXXXGXXXXXXXXXXXXXXXXXXXGXXXXXXXXXXXXXXXXXXXGXXXXXXXXXXXXXXXXXXXGAXXXXXXXXXXXXXXXXXXGXXXXXXXXXXXXXXXXXXXGXXXXXXXXXXXXXXXXXXXGXXXXXXXXXXXXXXXXXXXGXXXXXXXXXXXXXXXXXXXGXXXXXXXXXXXXXXXXXXX,0,10,0
3066,18,4,14,202,380,0,0,396,86,310,GOXXXXXXXXXXXXXXXXXXGXXXXXXXXXXXXXXXXXXXGAXXXXXXXXXXXXXXXXXXGAXXXXXXXXXXXXXXXXXXGXXXXXXXXXXXXXXXXXXXGXXXXXXXXXXXXXXXXXXXGXXXXXXXXXXXXXXXXXXXGAXXXXXXXXXXXXXXXXXXGXXXXXXXXXXXXXXXXXXXGXXXXXXXXXXXXXXXXXXXGXXXXXXXXXXXXXXXXXXXGXXXXXXXXXXXXXXXXXXXGAXXXXXXXXXXXXXXXXXX,0,10,0
3087,18,4,14,216,366,0,0,384,78,306,GOXXXXXXXXXXXXXXXXXXGXXXXXXXXXXXXXXXXXXXGAXXXXXXXXXXXXXXXXXXGAXXXXXXXXXXXXXXXXXXGXXXXXXXXXXXXXXXXXXXGXXXXXXXXXXXXXXXXXXXGXXXXXXXXXXXXXXXXXXXGAXXXXXXXXXXXXXXXXXXGXXXXXXXXXXXXXXXXXXXGXXXXXXXXXXXXXXXXXXXGXXXXXXXXXXXXXXXXXXXGXXXXXXXXXXXXXXXXXXXGAXXXXXXXXXXXXXXXXXX,0,10,0
3108,18,4,14,217,365,0,0,383,88,295,GOXXXXXXXXXXXXXXXXXXGXXXXXXXXXXXXXXXXXXXGAXXXXXXXXXXXXXXXXXXGAXXXXXXXXXXXXXXXXXXGXXXXXXXXXXXXXXXXXXXGXXXXXXXXXXXXXXXXXXXGXXXXXXXXXXXXXXXXXXXGAXXXXXXXXXXXXXXXXXXGXXXXXXXXXXXXXXXXXXXGXXXXXXXXXXXXXXXXXXXGXXXXXXXXXXXXXXXXXXXGXXXXXXXXXXXXXXXXXXXGAXXXXXXXXXXXXXXXXXX,0,10,0
3129,18,4,14,213,369,0,0,387,87,300,GOXXXXXXXXXXXXXXXXXXGXXXXXXXXXXXXXXXXXXXGAXXXXXXXXXXXXXXXXXXGAXXXXXXXXXXXXXXXXXXGXXXXXXXXXXXXXXXXXXXGXXXXXXXXXXXXXXXXXXXGXXXXXXXXXXXXXXXXXXXGAXXXXXXXXXXXXXXXXXXGXXXXXXXXXXXXXXXXXXXGXXXXXXXXXXXXXXXXXXXGXXXXXXXXXXXXXXXXXXXGXXXXXXXXXXXXXXXXXXXGAXXXXXXXXXXXXXXXXXX,0,10,0

3150,18,4,14,213,369,0,0,382,87,295,GOXXXXXXXXXXXXXXXXXXGXXXXXXXXXXXXXXXXXXXGAXXXXXXXXXXXXXXXXXXGAXXXXXXXXXXXXXXXXXXGXXXXXXXXXXXXXXXXXXXGXXXXXXXXXXXXXXXXXXXGXXXXXXXXXXXXXXXXXXXGAXXXXXXXXXXXXXXXXXXGXXXXXXXXXXXXXXXXXXXGXXXXXXXXXXXXXXXXXXXGXXXXXXXXXXXXXXXXXXXGXXXXXXXXXXXXXXXXXXXGAXXXXXXXXXXXXXXXXXX,0,10,0
3171,17,4,13,224,359,0,0,375,87,288,GXXXXXXXXXXXXXXXXXXXGXXXXXXXXXXXXXXXXXXXGAXXXXXXXXXXXXXXXXXXGAXXXXXXXXXXXXXXXXXXGXXXXXXXXXXXXXXXXXXXGXXXXXXXXXXXXXXXXXXXGXXXXXXXXXXXXXXXXXXXGAXXXXXXXXXXXXXXXXXXGXXXXXXXXXXXXXXXXXXXGXXXXXXXXXXXXXXXXXXXGXXXXXXXXXXXXXXXXXXXGXXXXXXXXXXXXXXXXXXXGAXXXXXXXXXXXXXXXXXX,0,10,0
3192,17,2,15,226,357,0,0,375,88,287,GXXXXXXXXXXXXXXXXXXXGXXXXXXXXXXXXXXXXXXXGOXXXXXXXXXXXXXXXXXXGOXXXXXXXXXXXXXXXXXXGXXXXXXXXXXXXXXXXXXXGXXXXXXXXXXXXXXXXXXXGXXXXXXXXXXXXXXXXXXXGAXXXXXXXXXXXXXXXXXXGXXXXXXXXXXXXXXXXXXXGXXXXXXXXXXXXXXXXXXXGXXXXXXXXXXXXXXXXXXXGXXXXXXXXXXXXXXXXXXXGAXXXXXXXXXXXXXXXXXX,0,10,0
3213,16,3,13,220,364,0,0,380,84,296,GXXXXXXXXXXXXXXXXXXXGXXXXXXXXXXXXXXXXXXXGXXXXXXXXXXXXXXXXXXXGXXXXXXXXXXXXXXXXXXXGXXXXXXXXXXXXXXXXXXXGXXXXXXXXXXXXXXXXXXXGAXXXXXXXXXXXXXXXXXXGAXXXXXXXXXXXXXXXXXXGXXXXXXXXXXXXXXXXXXXGXXXXXXXXXXXXXXXXXXXGXXXXXXXXXXXXXXXXXXXGXXXXXXXXXXXXXXXXXXXGAXXXXXXXXXXXXXXXXXX,0,10,0
3234,16,2,14,212,372,0,0,390,91,299,GXXXXXXXXXXXXXXXXXXXGXXXXXXXXXXXXXXXXXXXGXXXXXXXXXXXXXXXXXXXGXXXXXXXXXXXXXXXXXXXGXXXXXXXXXXXXXXXXXXXGXXXXXXXXXXXXXXXXXXXGOXXXXXXXXXXXXXXXXXXGAXXXXXXXXXXXXXXXXXXGXXXXXXXXXXXXXXXXXXXGXXXXXXXXXXXXXXXXXXXGXXXXXXXXXXXXXXXXXXXGXXXXXXXXXXXXXXXXXXXGAXXXXXXXXXXXXXXXXXX,0,10,0

3255,14,1,13,204,382,0,0,397,93,304,GXXXXXXXXXXXXXXXXXXXGXXXXXXXXXXXXXXXXXXXGXXXXXXXXXXXXXXXXXXXGXXXXXXXXXXXXXXXXXXXGXXXXXXXXXXXXXXXXXXXGXXXXXXXXXXXXXXXXXXXGXXXXXXXXXXXXXXXXXXXGAXXXXXXXXXXXXXXXXXXGXXXXXXXXXXXXXXXXXXXGXXXXXXXXXXXXXXXXXXXGXXXXXXXXXXXXXXXXXXXGXXXXXXXXXXXXXXXXXXXGXXXXXXXXXXXXXXXXXXX,0,10,0
3276,14,1,13,211,375,0,0,391,83,308,GXXXXXXXXXXXXXXXXXXXGXXXXXXXXXXXXXXXXXXXGXXXXXXXXXXXXXXXXXXXGXXXXXXXXXXXXXXXXXXXGXXXXXXXXXXXXXXXXXXXGXXXXXXXXXXXXXXXXXXXGXXXXXXXXXXXXXXXXXXXGAXXXXXXXXXXXXXXXXXXGXXXXXXXXXXXXXXXXXXXGXXXXXXXXXXXXXXXXXXXGXXXXXXXXXXXXXXXXXXXGXXXXXXXXXXXXXXXXXXXGXXXXXXXXXXXXXXXXXXX,0,10,0
3297,14,0,14,213,373,0,0,387,78,309,GXXXXXXXXXXXXXXXXXXXGXXXXXXXXXXXXXXXXXXXGXXXXXXXXXXXXXXXXXXXGXXXXXXXXXXXXXXXXXXXGXXXXXXXXXXXXXXXXXXXGXXXXXXXXXXXXXXXXXXXGXXXXXXXXXXXXXXXXXXXGOXXXXXXXXXXXXXXXXXXGXXXXXXXXXXXXXXXXXXXGXXXXXXXXXXXXXXXXXXXGXXXXXXXXXXXXXXXXXXXGXXXXXXXXXXXXXXXXXXXGXXXXXXXXXXXXXXXXXXX,0,10,0
3318,14,1,13,212,374,0,0,390,72,318,GAXXXXXXXXXXXXXXXXXXGXXXXXXXXXXXXXXXXXXXGXXXXXXXXXXXXXXXXXXXGXXXXXXXXXXXXXXXXXXXGXXXXXXXXXXXXXXXXXXXGXXXXXXXXXXXXXXXXXXXGXXXXXXXXXXXXXXXXXXXGXXXXXXXXXXXXXXXXXXXGXXXXXXXXXXXXXXXXXXXGXXXXXXXXXXXXXXXXXXXGXXXXXXXXXXXXXXXXXXXGXXXXXXXXXXXXXXXXXXXGXXXXXXXXXXXXXXXXXXX,0,10,0
3339,14,1,13,208,378,0,0,394,73,321,GAXXXXXXXXXXXXXXXXXXGXXXXXXXXXXXXXXXXXXXGXXXXXXXXXXXXXXXXXXXGXXXXXXXXXXXXXXXXXXXGXXXXXXXXXXXXXXXXXXXGXXXXXXXXXXXXXXXXXXXGXXXXXXXXXXXXXXXXXXXGXXXXXXXXXXXXXXXXXXXGXXXXXXXXXXXXXXXXXXXGXXXXXXXXXXXXXXXXXXXGXXXXXXXXXXXXXXXXXXXGXXXXXXXXXXXXXXXXXXXGXXXXXXXXXXXXXXXXXXX,0,10,0

3360,14,1,13,205,381,0,0,397,68,329,GAXXXXXXXXXXXXXXXXXXGXXXXXXXXXXXXXXXXXXXGXXXXXXXXXXXXXXXXXXXGXXXXXXXXXXXXXXXXXXXGXXXXXXXXXXXXXXXXXXXGXXXXXXXXXXXXXXXXXXXGXXXXXXXXXXXXXXXXXXXGXXXXXXXXXXXXXXXXXXXGXXXXXXXXXXXXXXXXXXXGXXXXXXXXXXXXXXXXXXXGXXXXXXXXXXXXXXXXXXXGXXXXXXXXXXXXXXXXXXXGXXXXXXXXXXXXXXXXXXX,0,10,0
3381,14,1,13,211,375,0,0,390,73,317,GAXXXXXXXXXXXXXXXXXXGXXXXXXXXXXXXXXXXXXXGXXXXXXXXXXXXXXXXXXXGXXXXXXXXXXXXXXXXXXXGXXXXXXXXXXXXXXXXXXXGXXXXXXXXXXXXXXXXXXXGXXXXXXXXXXXXXXXXXXXGXXXXXXXXXXXXXXXXXXXGXXXXXXXXXXXXXXXXXXXGXXXXXXXXXXXXXXXXXXXGXXXXXXXXXXXXXXXXXXXGXXXXXXXXXXXXXXXXXXXGXXXXXXXXXXXXXXXXXXX,0,10,0
3402,15,2,13,203,382,0,0,396,72,324,GAXXXXXXXXXXXXXXXXXXGXXXXXXXXXXXXXXXXXXXGXXXXXXXXXXXXXXXXXXXGXXXXXXXXXXXXXXXXXXXGXXXXXXXXXXXXXXXXXXXGXXXXXXXXXXXXXXXXXXXGXXXXXXXXXXXXXXXXXXXGXXXXXXXXXXXXXXXXXXXGXXXXXXXXXXXXXXXXXXXGXXXXXXXXXXXXXXXXXXXGXXXXXXXXXXXXXXXXXXXGXXXXXXXXXXXXXXXXXXXGAXXXXXXXXXXXXXXXXXX,0,10,0
3423,15,1,14,199,386,0,0,401,73,328,GAXXXXXXXXXXXXXXXXXXGXXXXXXXXXXXXXXXXXXXGXXXXXXXXXXXXXXXXXXXGXXXXXXXXXXXXXXXXXXXGXXXXXXXXXXXXXXXXXXXGXXXXXXXXXXXXXXXXXXXGXXXXXXXXXXXXXXXXXXXGXXXXXXXXXXXXXXXXXXXGXXXXXXXXXXXXXXXXXXXGXXXXXXXXXXXXXXXXXXXGXXXXXXXXXXXXXXXXXXXGXXXXXXXXXXXXXXXXXXXGOXXXXXXXXXXXXXXXXXX,0,10,0
3444,16,2,14,189,395,0,0,410,76,334,GAXXXXXXXXXXXXXXXXXXGXXXXXXXXXXXXXXXXXXXGXXXXXXXXXXXXXXXXXXXGXXXXXXXXXXXXXXXXXXXGXXXXXXXXXXXXXXXXXXXGXXXXXXXXXXXXXXXXXXXGXXXXXXXXXXXXXXXXXXXGXXXXXXXXXXXXXXXXXXXGXXXXXXXXXXXXXXXXXXXGAXXXXXXXXXXXXXXXXXXGXXXXXXXXXXXXXXXXXXXGXXXXXXXXXXXXXXXXXXXGOXXXXXXXXXXXXXXXXXX,0,10,0

3465,15,2,13,190,395,0,0,409,77,332,GXXXXXXXXXXXXXXXXXXXGXXXXXXXXXXXXXXXXXXXGAXXXXXXXXXXXXXXXXXXGXXXXXXXXXXXXXXXXXXXGXXXXXXXXXXXXXXXXXXXGXXXXXXXXXXXXXXXXXXXGXXXXXXXXXXXXXXXXXXXGXXXXXXXXXXXXXXXXXXXGXXXXXXXXXXXXXXXXXXXGAXXXXXXXXXXXXXXXXXXGXXXXXXXXXXXXXXXXXXXGXXXXXXXXXXXXXXXXXXXGXXXXXXXXXXXXXXXXXXX,0,10,0
3486,15,1,14,187,398,0,0,413,81,332,GXXXXXXXXXXXXXXXXXXXGXXXXXXXXXXXXXXXXXXXGAXXXXXXXXXXXXXXXXXXGXXXXXXXXXXXXXXXXXXXGXXXXXXXXXXXXXXXXXXXGXXXXXXXXXXXXXXXXXXXGXXXXXXXXXXXXXXXXXXXGXXXXXXXXXXXXXXXXXXXGXXXXXXXXXXXXXXXXXXXGOXXXXXXXXXXXXXXXXXXGXXXXXXXXXXXXXXXXXXXGXXXXXXXXXXXXXXXXXXXGXXXXXXXXXXXXXXXXXXX,0,10,0
3507,14,1,13,182,404,0,0,418,79,339,GXXXXXXXXXXXXXXXXXXXGXXXXXXXXXXXXXXXXXXXGAXXXXXXXXXXXXXXXXXXGXXXXXXXXXXXXXXXXXXXGXXXXXXXXXXXXXXXXXXXGXXXXXXXXXXXXXXXXXXXGXXXXXXXXXXXXXXXXXXXGXXXXXXXXXXXXXXXXXXXGXXXXXXXXXXXXXXXXXXXGXXXXXXXXXXXXXXXXXXXGXXXXXXXXXXXXXXXXXXXGXXXXXXXXXXXXXXXXXXXGXXXXXXXXXXXXXXXXXXX,0,10,0
3528,14,1,13,185,401,0,0,415,81,334,GXXXXXXXXXXXXXXXXXXXGXXXXXXXXXXXXXXXXXXXGAXXXXXXXXXXXXXXXXXXGXXXXXXXXXXXXXXXXXXXGXXXXXXXXXXXXXXXXXXXGXXXXXXXXXXXXXXXXXXXGXXXXXXXXXXXXXXXXXXXGXXXXXXXXXXXXXXXXXXXGXXXXXXXXXXXXXXXXXXXGXXXXXXXXXXXXXXXXXXXGXXXXXXXXXXXXXXXXXXXGXXXXXXXXXXXXXXXXXXXGXXXXXXXXXXXXXXXXXXX,0,10,0
3549,14,1,13,188,398,0,0,412,82,330,GXXXXXXXXXXXXXXXXXXXGXXXXXXXXXXXXXXXXXXXGAXXXXXXXXXXXXXXXXXXGXXXXXXXXXXXXXXXXXXXGXXXXXXXXXXXXXXXXXXXGXXXXXXXXXXXXXXXXXXXGXXXXXXXXXXXXXXXXXXXGXXXXXXXXXXXXXXXXXXXGXXXXXXXXXXXXXXXXXXXGXXXXXXXXXXXXXXXXXXXGXXXXXXXXXXXXXXXXXXXGXXXXXXXXXXXXXXXXXXXGXXXXXXXXXXXXXXXXXXX,0,10,0

3570,14,1,13,186,400,0,0,413,85,328,GXXXXXXXXXXXXXXXXXXXGXXXXXXXXXXXXXXXXXXXGAXXXXXXXXXXXXXXXXXXGXXXXXXXXXXXXXXXXXXXGXXXXXXXXXXXXXXXXXXXGXXXXXXXXXXXXXXXXXXXGXXXXXXXXXXXXXXXXXXXGXXXXXXXXXXXXXXXXXXXGXXXXXXXXXXXXXXXXXXXGXXXXXXXXXXXXXXXXXXXGXXXXXXXXXXXXXXXXXXXGXXXXXXXXXXXXXXXXXXXGXXXXXXXXXXXXXXXXXXX,0,10,0
3591,14,0,14,193,393,0,0,406,86,320,GXXXXXXXXXXXXXXXXXXXGXXXXXXXXXXXXXXXXXXXGOXXXXXXXXXXXXXXXXXXGXXXXXXXXXXXXXXXXXXXGXXXXXXXXXXXXXXXXXXXGXXXXXXXXXXXXXXXXXXXGXXXXXXXXXXXXXXXXXXXGXXXXXXXXXXXXXXXXXXXGXXXXXXXXXXXXXXXXXXXGXXXXXXXXXXXXXXXXXXXGXXXXXXXXXXXXXXXXXXXGXXXXXXXXXXXXXXXXXXXGXXXXXXXXXXXXXXXXXXX,0,10,0
3612,14,1,13,198,388,0,0,403,86,317,GXXXXXXXXXXXXXXXXXXXGXXXXXXXXXXXXXXXXXXXGXXXXXXXXXXXXXXXXXXXGXXXXXXXXXXXXXXXXXXXGXXXXXXXXXXXXXXXXXXXGXXXXXXXXXXXXXXXXXXXGXXXXXXXXXXXXXXXXXXXGXXXXXXXXXXXXXXXXXXXGXXXXXXXXXXXXXXXXXXXGXXXXXXXXXXXXXXXXXXXGAXXXXXXXXXXXXXXXXXXGXXXXXXXXXXXXXXXXXXXGXXXXXXXXXXXXXXXXXXX,0,10,0
3633,14,1,13,202,384,0,0,399,78,321,GXXXXXXXXXXXXXXXXXXXGXXXXXXXXXXXXXXXXXXXGXXXXXXXXXXXXXXXXXXXGXXXXXXXXXXXXXXXXXXXGXXXXXXXXXXXXXXXXXXXGXXXXXXXXXXXXXXXXXXXGXXXXXXXXXXXXXXXXXXXGXXXXXXXXXXXXXXXXXXXGXXXXXXXXXXXXXXXXXXXGXXXXXXXXXXXXXXXXXXXGAXXXXXXXXXXXXXXXXXXGXXXXXXXXXXXXXXXXXXXGXXXXXXXXXXXXXXXXXXX,0,10,0
3654,14,1,13,205,381,0,0,393,84,309,GXXXXXXXXXXXXXXXXXXXGXXXXXXXXXXXXXXXXXXXGXXXXXXXXXXXXXXXXXXXGXXXXXXXXXXXXXXXXXXXGXXXXXXXXXXXXXXXXXXXGXXXXXXXXXXXXXXXXXXXGXXXXXXXXXXXXXXXXXXXGXXXXXXXXXXXXXXXXXXXGXXXXXXXXXXXXXXXXXXXGXXXXXXXXXXXXXXXXXXXGAXXXXXXXXXXXXXXXXXXGXXXXXXXXXXXXXXXXXXXGXXXXXXXXXXXXXXXXXXX,0,10,0

3675,15,2,13,204,381,0,0,391,86,305,GXXXXXXXXXXXXXXXXXXXGXXXXXXXXXXXXXXXXXXXGXXXXXXXXXXXXXXXXXXXGXXXXXXXXXXXXXXXXXXXGXXXXXXXXXXXXXXXXXXXGXXXXXXXXXXXXXXXXXXXGXXXXXXXXXXXXXXXXXXXGAXXXXXXXXXXXXXXXXXXGXXXXXXXXXXXXXXXXXXXGXXXXXXXXXXXXXXXXXXXGAXXXXXXXXXXXXXXXXXXGXXXXXXXXXXXXXXXXXXXGXXXXXXXXXXXXXXXXXXX,0,10,0
3696,15,2,13,210,375,0,0,387,84,303,GXXXXXXXXXXXXXXXXXXXGXXXXXXXXXXXXXXXXXXXGXXXXXXXXXXXXXXXXXXXGXXXXXXXXXXXXXXXXXXXGXXXXXXXXXXXXXXXXXXXGXXXXXXXXXXXXXXXXXXXGXXXXXXXXXXXXXXXXXXXGAXXXXXXXXXXXXXXXXXXGXXXXXXXXXXXXXXXXXXXGXXXXXXXXXXXXXXXXXXXGAXXXXXXXXXXXXXXXXXXGXXXXXXXXXXXXXXXXXXXGXXXXXXXXXXXXXXXXXXX,0,10,0
3717,15,2,13,211,374,0,0,389,89,300,GXXXXXXXXXXXXXXXXXXXGXXXXXXXXXXXXXXXXXXXGXXXXXXXXXXXXXXXXXXXGXXXXXXXXXXXXXXXXXXXGXXXXXXXXXXXXXXXXXXXGXXXXXXXXXXXXXXXXXXXGXXXXXXXXXXXXXXXXXXXGAXXXXXXXXXXXXXXXXXXGXXXXXXXXXXXXXXXXXXXGXXXXXXXXXXXXXXXXXXXGAXXXXXXXXXXXXXXXXXXGXXXXXXXXXXXXXXXXXXXGXXXXXXXXXXXXXXXXXXX,0,10,0
3738,15,2,13,213,372,0,0,387,86,301,GXXXXXXXXXXXXXXXXXXXGXXXXXXXXXXXXXXXXXXXGXXXXXXXXXXXXXXXXXXXGXXXXXXXXXXXXXXXXXXXGXXXXXXXXXXXXXXXXXXXGXXXXXXXXXXXXXXXXXXXGXXXXXXXXXXXXXXXXXXXGAXXXXXXXXXXXXXXXXXXGXXXXXXXXXXXXXXXXXXXGXXXXXXXXXXXXXXXXXXXGAXXXXXXXXXXXXXXXXXXGXXXXXXXXXXXXXXXXXXXGXXXXXXXXXXXXXXXXXXX,0,10,0
3759,14,1,13,220,366,0,0,380,78,302,GXXXXXXXXXXXXXXXXXXXGXXXXXXXXXXXXXXXXXXXGXXXXXXXXXXXXXXXXXXXGXXXXXXXXXXXXXXXXXXXGXXXXXXXXXXXXXXXXXXXGXXXXXXXXXXXXXXXXXXXGXXXXXXXXXXXXXXXXXXXGAXXXXXXXXXXXXXXXXXXGXXXXXXXXXXXXXXXXXXXGXXXXXXXXXXXXXXXXXXXGXXXXXXXXXXXXXXXXXXXGXXXXXXXXXXXXXXXXXXXGXXXXXXXXXXXXXXXXXXX,0,10,0

3780,14,1,13,209,377,0,0,392,84,308,GXXXXXXXXXXXXXXXXXXXGXXXXXXXXXXXXXXXXXXXGXXXXXXXXXXXXXXXXXXXGXXXXXXXXXXXXXXXXXXXGXXXXXXXXXXXXXXXXXXXGXXXXXXXXXXXXXXXXXXXGXXXXXXXXXXXXXXXXXXXGAXXXXXXXXXXXXXXXXXXGXXXXXXXXXXXXXXXXXXXGXXXXXXXXXXXXXXXXXXXGXXXXXXXXXXXXXXXXXXXGXXXXXXXXXXXXXXXXXXXGXXXXXXXXXXXXXXXXXXX,0,10,0
3801,14,1,13,206,380,0,0,394,84,310,GXXXXXXXXXXXXXXXXXXXGXXXXXXXXXXXXXXXXXXXGXXXXXXXXXXXXXXXXXXXGXXXXXXXXXXXXXXXXXXXGXXXXXXXXXXXXXXXXXXXGXXXXXXXXXXXXXXXXXXXGXXXXXXXXXXXXXXXXXXXGAXXXXXXXXXXXXXXXXXXGXXXXXXXXXXXXXXXXXXXGXXXXXXXXXXXXXXXXXXXGXXXXXXXXXXXXXXXXXXXGXXXXXXXXXXXXXXXXXXXGXXXXXXXXXXXXXXXXXXX,0,10,0
3822,14,1,13,204,382,0,0,397,83,314,GXXXXXXXXXXXXXXXXXXXGXXXXXXXXXXXXXXXXXXXGXXXXXXXXXXXXXXXXXXXGXXXXXXXXXXXXXXXXXXXGXXXXXXXXXXXXXXXXXXXGXXXXXXXXXXXXXXXXXXXGXXXXXXXXXXXXXXXXXXXGAXXXXXXXXXXXXXXXXXXGXXXXXXXXXXXXXXXXXXXGXXXXXXXXXXXXXXXXXXXGXXXXXXXXXXXXXXXXXXXGXXXXXXXXXXXXXXXXXXXGXXXXXXXXXXXXXXXXXXX,0,10,0
3843,14,0,14,196,390,0,0,406,93,313,GXXXXXXXXXXXXXXXXXXXGXXXXXXXXXXXXXXXXXXXGXXXXXXXXXXXXXXXXXXXGXXXXXXXXXXXXXXXXXXXGXXXXXXXXXXXXXXXXXXXGXXXXXXXXXXXXXXXXXXXGXXXXXXXXXXXXXXXXXXXGOXXXXXXXXXXXXXXXXXXGXXXXXXXXXXXXXXXXXXXGXXXXXXXXXXXXXXXXXXXGXXXXXXXXXXXXXXXXXXXGXXXXXXXXXXXXXXXXXXXGXXXXXXXXXXXXXXXXXXX,0,10,0
3864,13,0,13,201,386,0,0,405,81,324,GXXXXXXXXXXXXXXXXXXXGXXXXXXXXXXXXXXXXXXXGXXXXXXXXXXXXXXXXXXXGXXXXXXXXXXXXXXXXXXXGXXXXXXXXXXXXXXXXXXXGXXXXXXXXXXXXXXXXXXXGXXXXXXXXXXXXXXXXXXXGXXXXXXXXXXXXXXXXXXXGXXXXXXXXXXXXXXXXXXXGXXXXXXXXXXXXXXXXXXXGXXXXXXXXXXXXXXXXXXXGXXXXXXXXXXXXXXXXXXXGXXXXXXXXXXXXXXXXXXX,0,10,0

3885,14,1,13,185,401,0,0,414,89,325,GXXXXXXXXXXXXXXXXXXXGXXXXXXXXXXXXXXXXXXXGXXXXXXXXXXXXXXXXXXXGXXXXXXXXXXXXXXXXXXXGXXXXXXXXXXXXXXXXXXXGXXXXXXXXXXXXXXXXXXXGXXXXXXXXXXXXXXXXXXXGXXXXXXXXXXXXXXXXXXXGXXXXXXXXXXXXXXXXXXXGXXXXXXXXXXXXXXXXXXXGXXXXXXXXXXXXXXXXXXXGXXXXXXXXXXXXXXXXXXXGAXXXXXXXXXXXXXXXXXX,0,10,0
3906,14,1,13,192,394,0,0,410,94,316,GXXXXXXXXXXXXXXXXXXXGXXXXXXXXXXXXXXXXXXXGXXXXXXXXXXXXXXXXXXXGXXXXXXXXXXXXXXXXXXXGXXXXXXXXXXXXXXXXXXXGXXXXXXXXXXXXXXXXXXXGXXXXXXXXXXXXXXXXXXXGXXXXXXXXXXXXXXXXXXXGXXXXXXXXXXXXXXXXXXXGXXXXXXXXXXXXXXXXXXXGXXXXXXXXXXXXXXXXXXXGXXXXXXXXXXXXXXXXXXXGAXXXXXXXXXXXXXXXXXX,0,10,0
3927,14,1,13,196,390,0,0,406,88,318,GXXXXXXXXXXXXXXXXXXXGXXXXXXXXXXXXXXXXXXXGXXXXXXXXXXXXXXXXXXXGXXXXXXXXXXXXXXXXXXXGXXXXXXXXXXXXXXXXXXXGXXXXXXXXXXXXXXXXXXXGXXXXXXXXXXXXXXXXXXXGXXXXXXXXXXXXXXXXXXXGXXXXXXXXXXXXXXXXXXXGXXXXXXXXXXXXXXXXXXXGXXXXXXXXXXXXXXXXXXXGXXXXXXXXXXXXXXXXXXXGAXXXXXXXXXXXXXXXXXX,0,10,0
3948,14,1,13,199,387,0,0,403,87,316,GXXXXXXXXXXXXXXXXXXXGXXXXXXXXXXXXXXXXXXXGXXXXXXXXXXXXXXXXXXXGXXXXXXXXXXXXXXXXXXXGXXXXXXXXXXXXXXXXXXXGXXXXXXXXXXXXXXXXXXXGXXXXXXXXXXXXXXXXXXXGXXXXXXXXXXXXXXXXXXXGXXXXXXXXXXXXXXXXXXXGXXXXXXXXXXXXXXXXXXXGXXXXXXXXXXXXXXXXXXXGXXXXXXXXXXXXXXXXXXXGAXXXXXXXXXXXXXXXXXX,0,10,0
3969,15,2,13,200,385,0,0,400,88,312,GXXXXXXXXXXXXXXXXXXXGXXXXXXXXXXXXXXXXXXXGXXXXXXXXXXXXXXXXXXXGXXXXXXXXXXXXXXXXXXXGXXXXXXXXXXXXXXXXXXXGXXXXXXXXXXXXXXXXXXXGXXXXXXXXXXXXXXXXXXXGAXXXXXXXXXXXXXXXXXXGXXXXXXXXXXXXXXXXXXXGXXXXXXXXXXXXXXXXXXXGXXXXXXXXXXXXXXXXXXXGXXXXXXXXXXXXXXXXXXXGAXXXXXXXXXXXXXXXXXX,0,10,0

3990,16,3,13,195,389,0,0,404,83,321,GXXXXXXXXXXXXXXXXXXXGXXXXXXXXXXXXXXXXXXXGXXXXXXXXXXXXXXXXXXXGXXXXXXXXXXXXXXXXXXXGXXXXXXXXXXXXXXXXXXXGXXXXXXXXXXXXXXXXXXXGXXXXXXXXXXXXXXXXXXXGAXXXXXXXXXXXXXXXXXXGXXXXXXXXXXXXXXXXXXXGXXXXXXXXXXXXXXXXXXXGAXXXXXXXXXXXXXXXXXXGXXXXXXXXXXXXXXXXXXXGAXXXXXXXXXXXXXXXXXX,0,10,0
4011,16,3,13,191,393,0,0,406,84,322,GXXXXXXXXXXXXXXXXXXXGXXXXXXXXXXXXXXXXXXXGXXXXXXXXXXXXXXXXXXXGXXXXXXXXXXXXXXXXXXXGXXXXXXXXXXXXXXXXXXXGXXXXXXXXXXXXXXXXXXXGXXXXXXXXXXXXXXXXXXXGAXXXXXXXXXXXXXXXXXXGXXXXXXXXXXXXXXXXXXXGXXXXXXXXXXXXXXXXXXXGAXXXXXXXXXXXXXXXXXXGXXXXXXXXXXXXXXXXXXXGAXXXXXXXXXXXXXXXXXX,0,10,0
4032,16,3,13,178,406,0,0,417,85,332,GXXXXXXXXXXXXXXXXXXXGXXXXXXXXXXXXXXXXXXXGXXXXXXXXXXXXXXXXXXXGXXXXXXXXXXXXXXXXXXXGXXXXXXXXXXXXXXXXXXXGXXXXXXXXXXXXXXXXXXXGXXXXXXXXXXXXXXXXXXXGAXXXXXXXXXXXXXXXXXXGXXXXXXXXXXXXXXXXXXXGXXXXXXXXXXXXXXXXXXXGAXXXXXXXXXXXXXXXXXXGXXXXXXXXXXXXXXXXXXXGAXXXXXXXXXXXXXXXXXX,0,10,0
4053,14,1,13,168,418,0,0,432,91,341,GXXXXXXXXXXXXXXXXXXXGXXXXXXXXXXXXXXXXXXXGXXXXXXXXXXXXXXXXXXXGXXXXXXXXXXXXXXXXXXXGXXXXXXXXXXXXXXXXXXXGXXXXXXXXXXXXXXXXXXXGXXXXXXXXXXXXXXXXXXXGXXXXXXXXXXXXXXXXXXXGXXXXXXXXXXXXXXXXXXXGXXXXXXXXXXXXXXXXXXXGAXXXXXXXXXXXXXXXXXXGXXXXXXXXXXXXXXXXXXXGXXXXXXXXXXXXXXXXXXX,0,10,0
4074,14,1,13,166,420,0,0,434,85,349,GXXXXXXXXXXXXXXXXXXXGXXXXXXXXXXXXXXXXXXXGXXXXXXXXXXXXXXXXXXXGXXXXXXXXXXXXXXXXXXXGXXXXXXXXXXXXXXXXXXXGXXXXXXXXXXXXXXXXXXXGXXXXXXXXXXXXXXXXXXXGXXXXXXXXXXXXXXXXXXXGXXXXXXXXXXXXXXXXXXXGXXXXXXXXXXXXXXXXXXXGAXXXXXXXXXXXXXXXXXXGXXXXXXXXXXXXXXXXXXXGXXXXXXXXXXXXXXXXXXX,0,10,0

4095,14,1,13,168,418,0,0,430,85,345,GXXXXXXXXXXXXXXXXXXXGXXXXXXXXXXXXXXXXXXXGXXXXXXXXXXXXXXXXXXXGXXXXXXXXXXXXXXXXXXXGXXXXXXXXXXXXXXXXXXXGXXXXXXXXXXXXXXXXXXXGXXXXXXXXXXXXXXXXXXXGXXXXXXXXXXXXXXXXXXXGXXXXXXXXXXXXXXXXXXXGXXXXXXXXXXXXXXXXXXXGAXXXXXXXXXXXXXXXXXXGXXXXXXXXXXXXXXXXXXXGXXXXXXXXXXXXXXXXXXX,0,10,0
4116,14,1,13,171,415,0,0,429,90,339,GXXXXXXXXXXXXXXXXXXXGXXXXXXXXXXXXXXXXXXXGXXXXXXXXXXXXXXXXXXXGXXXXXXXXXXXXXXXXXXXGXXXXXXXXXXXXXXXXXXXGXXXXXXXXXXXXXXXXXXXGXXXXXXXXXXXXXXXXXXXGXXXXXXXXXXXXXXXXXXXGXXXXXXXXXXXXXXXXXXXGXXXXXXXXXXXXXXXXXXXGAXXXXXXXXXXXXXXXXXXGXXXXXXXXXXXXXXXXXXXGXXXXXXXXXXXXXXXXXXX,0,10,0
4137,14,1,13,177,409,0,0,424,88,336,GXXXXXXXXXXXXXXXXXXXGXXXXXXXXXXXXXXXXXXXGXXXXXXXXXXXXXXXXXXXGXXXXXXXXXXXXXXXXXXXGXXXXXXXXXXXXXXXXXXXGXXXXXXXXXXXXXXXXXXXGXXXXXXXXXXXXXXXXXXXGXXXXXXXXXXXXXXXXXXXGXXXXXXXXXXXXXXXXXXXGXXXXXXXXXXXXXXXXXXXGAXXXXXXXXXXXXXXXXXXGXXXXXXXXXXXXXXXXXXXGXXXXXXXXXXXXXXXXXXX,0,10,0
4158,14,1,13,178,408,0,0,419,87,332,GXXXXXXXXXXXXXXXXXXXGXXXXXXXXXXXXXXXXXXXGXXXXXXXXXXXXXXXXXXXGXXXXXXXXXXXXXXXXXXXGXXXXXXXXXXXXXXXXXXXGXXXXXXXXXXXXXXXXXXXGXXXXXXXXXXXXXXXXXXXGXXXXXXXXXXXXXXXXXXXGXXXXXXXXXXXXXXXXXXXGXXXXXXXXXXXXXXXXXXXGAXXXXXXXXXXXXXXXXXXGXXXXXXXXXXXXXXXXXXXGXXXXXXXXXXXXXXXXXXX,0,10,0
4179,15,2,13,179,406,0,0,421,90,331,GXXXXXXXXXXXXXXXXXXXGXXXXXXXXXXXXXXXXXXXGXXXXXXXXXXXXXXXXXXXGXXXXXXXXXXXXXXXXXXXGAXXXXXXXXXXXXXXXXXXGXXXXXXXXXXXXXXXXXXXGXXXXXXXXXXXXXXXXXXXGXXXXXXXXXXXXXXXXXXXGXXXXXXXXXXXXXXXXXXXGXXXXXXXXXXXXXXXXXXXGAXXXXXXXXXXXXXXXXXXGXXXXXXXXXXXXXXXXXXXGXXXXXXXXXXXXXXXXXXX,0,10,0

4200,16,3,13,178,406,0,0,417,93,324,GXXXXXXXXXXXXXXXXXXXGXXXXXXXXXXXXXXXXXXXGXXXXXXXXXXXXXXXXXXXGXXXXXXXXXXXXXXXXXXXGAXXXXXXXXXXXXXXXXXXGXXXXXXXXXXXXXXXXXXXGXXXXXXXXXXXXXXXXXXXGXXXXXXXXXXXXXXXXXXXGXXXXXXXXXXXXXXXXXXXGXXXXXXXXXXXXXXXXXXXGAXXXXXXXXXXXXXXXXXXGXXXXXXXXXXXXXXXXXXXGAXXXXXXXXXXXXXXXXXX,0,10,0
4221,16,3,13,181,403,0,0,415,96,319,GXXXXXXXXXXXXXXXXXXXGXXXXXXXXXXXXXXXXXXXGXXXXXXXXXXXXXXXXXXXGXXXXXXXXXXXXXXXXXXXGAXXXXXXXXXXXXXXXXXXGXXXXXXXXXXXXXXXXXXXGXXXXXXXXXXXXXXXXXXXGXXXXXXXXXXXXXXXXXXXGXXXXXXXXXXXXXXXXXXXGXXXXXXXXXXXXXXXXXXXGAXXXXXXXXXXXXXXXXXXGXXXXXXXXXXXXXXXXXXXGAXXXXXXXXXXXXXXXXXX,0,10,0
4242,16,3,13,181,403,0,0,415,99,316,GXXXXXXXXXXXXXXXXXXXGXXXXXXXXXXXXXXXXXXXGXXXXXXXXXXXXXXXXXXXGXXXXXXXXXXXXXXXXXXXGAXXXXXXXXXXXXXXXXXXGXXXXXXXXXXXXXXXXXXXGXXXXXXXXXXXXXXXXXXXGXXXXXXXXXXXXXXXXXXXGXXXXXXXXXXXXXXXXXXXGXXXXXXXXXXXXXXXXXXXGAXXXXXXXXXXXXXXXXXXGXXXXXXXXXXXXXXXXXXXGAXXXXXXXXXXXXXXXXXX,0,10,0
4263,16,2,14,185,399,0,0,411,101,310,GXXXXXXXXXXXXXXXXXXXGXXXXXXXXXXXXXXXXXXXGXXXXXXXXXXXXXXXXXXXGXXXXXXXXXXXXXXXXXXXGAXXXXXXXXXXXXXXXXXXGXXXXXXXXXXXXXXXXXXXGXXXXXXXXXXXXXXXXXXXGXXXXXXXXXXXXXXXXXXXGXXXXXXXXXXXXXXXXXXXGXXXXXXXXXXXXXXXXXXXGOXXXXXXXXXXXXXXXXXXGXXXXXXXXXXXXXXXXXXXGAXXXXXXXXXXXXXXXXXX,0,10,0
4284,16,2,14,191,393,0,0,408,104,304,GXXXXXXXXXXXXXXXXXXXGXXXXXXXXXXXXXXXXXXXGXXXXXXXXXXXXXXXXXXXGXXXXXXXXXXXXXXXXXXXGAXXXXXXXXXXXXXXXXXXGXXXXXXXXXXXXXXXXXXXGXXXXXXXXXXXXXXXXXXXGXXXXXXXXXXXXXXXXXXXGXXXXXXXXXXXXXXXXXXXGXXXXXXXXXXXXXXXXXXXGOXXXXXXXXXXXXXXXXXXGXXXXXXXXXXXXXXXXXXXGAXXXXXXXXXXXXXXXXXX,0,10,0

4305,15,2,13,204,381,0,0,394,104,290,GXXXXXXXXXXXXXXXXXXXGXXXXXXXXXXXXXXXXXXXGAXXXXXXXXXXXXXXXXXXGXXXXXXXXXXXXXXXXXXXGAXXXXXXXXXXXXXXXXXXGXXXXXXXXXXXXXXXXXXXGXXXXXXXXXXXXXXXXXXXGXXXXXXXXXXXXXXXXXXXGXXXXXXXXXXXXXXXXXXXGXXXXXXXXXXXXXXXXXXXGXXXXXXXXXXXXXXXXXXXGXXXXXXXXXXXXXXXXXXXGXXXXXXXXXXXXXXXXXXX,0,10,0
4326,15,2,13,209,376,0,0,393,103,290,GXXXXXXXXXXXXXXXXXXXGXXXXXXXXXXXXXXXXXXXGAXXXXXXXXXXXXXXXXXXGXXXXXXXXXXXXXXXXXXXGAXXXXXXXXXXXXXXXXXXGXXXXXXXXXXXXXXXXXXXGXXXXXXXXXXXXXXXXXXXGXXXXXXXXXXXXXXXXXXXGXXXXXXXXXXXXXXXXXXXGXXXXXXXXXXXXXXXXXXXGXXXXXXXXXXXXXXXXXXXGXXXXXXXXXXXXXXXXXXXGXXXXXXXXXXXXXXXXXXX,0,10,0
4347,15,2,13,217,368,0,0,382,95,287,GXXXXXXXXXXXXXXXXXXXGXXXXXXXXXXXXXXXXXXXGAXXXXXXXXXXXXXXXXXXGXXXXXXXXXXXXXXXXXXXGAXXXXXXXXXXXXXXXXXXGXXXXXXXXXXXXXXXXXXXGXXXXXXXXXXXXXXXXXXXGXXXXXXXXXXXXXXXXXXXGXXXXXXXXXXXXXXXXXXXGXXXXXXXXXXXXXXXXXXXGXXXXXXXXXXXXXXXXXXXGXXXXXXXXXXXXXXXXXXXGXXXXXXXXXXXXXXXXXXX,0,10,0
4368,15,2,13,213,372,0,0,385,89,296,GXXXXXXXXXXXXXXXXXXXGXXXXXXXXXXXXXXXXXXXGAXXXXXXXXXXXXXXXXXXGXXXXXXXXXXXXXXXXXXXGAXXXXXXXXXXXXXXXXXXGXXXXXXXXXXXXXXXXXXXGXXXXXXXXXXXXXXXXXXXGXXXXXXXXXXXXXXXXXXXGXXXXXXXXXXXXXXXXXXXGXXXXXXXXXXXXXXXXXXXGXXXXXXXXXXXXXXXXXXXGXXXXXXXXXXXXXXXXXXXGXXXXXXXXXXXXXXXXXXX,0,10,0
4389,15,2,13,214,371,0,0,384,90,294,GXXXXXXXXXXXXXXXXXXXGXXXXXXXXXXXXXXXXXXXGAXXXXXXXXXXXXXXXXXXGXXXXXXXXXXXXXXXXXXXGAXXXXXXXXXXXXXXXXXXGXXXXXXXXXXXXXXXXXXXGXXXXXXXXXXXXXXXXXXXGXXXXXXXXXXXXXXXXXXXGXXXXXXXXXXXXXXXXXXXGXXXXXXXXXXXXXXXXXXXGXXXXXXXXXXXXXXXXXXXGXXXXXXXXXXXXXXXXXXXGXXXXXXXXXXXXXXXXXXX,0,10,0

4410,15,2,13,198,387,0,0,400,100,300,GXXXXXXXXXXXXXXXXXXXGXXXXXXXXXXXXXXXXXXXGAXXXXXXXXXXXXXXXXXXGXXXXXXXXXXXXXXXXXXXGAXXXXXXXXXXXXXXXXXXGXXXXXXXXXXXXXXXXXXXGXXXXXXXXXXXXXXXXXXXGXXXXXXXXXXXXXXXXXXXGXXXXXXXXXXXXXXXXXXXGXXXXXXXXXXXXXXXXXXXGXXXXXXXXXXXXXXXXXXXGXXXXXXXXXXXXXXXXXXXGXXXXXXXXXXXXXXXXXXX,0,10,0
4431,15,1,14,205,380,0,0,392,96,296,GXXXXXXXXXXXXXXXXXXXGXXXXXXXXXXXXXXXXXXXGOXXXXXXXXXXXXXXXXXXGXXXXXXXXXXXXXXXXXXXGAXXXXXXXXXXXXXXXXXXGXXXXXXXXXXXXXXXXXXXGXXXXXXXXXXXXXXXXXXXGXXXXXXXXXXXXXXXXXXXGXXXXXXXXXXXXXXXXXXXGXXXXXXXXXXXXXXXXXXXGXXXXXXXXXXXXXXXXXXXGXXXXXXXXXXXXXXXXXXXGXXXXXXXXXXXXXXXXXXX,0,10,0
4452,14,1,13,205,381,0,0,394,102,292,GXXXXXXXXXXXXXXXXXXXGXXXXXXXXXXXXXXXXXXXGXXXXXXXXXXXXXXXXXXXGXXXXXXXXXXXXXXXXXXXGAXXXXXXXXXXXXXXXXXXGXXXXXXXXXXXXXXXXXXXGXXXXXXXXXXXXXXXXXXXGXXXXXXXXXXXXXXXXXXXGXXXXXXXXXXXXXXXXXXXGXXXXXXXXXXXXXXXXXXXGXXXXXXXXXXXXXXXXXXXGXXXXXXXXXXXXXXXXXXXGXXXXXXXXXXXXXXXXXXX,0,10,0
4473,14,1,13,208,378,0,0,392,94,298,GXXXXXXXXXXXXXXXXXXXGXXXXXXXXXXXXXXXXXXXGXXXXXXXXXXXXXXXXXXXGXXXXXXXXXXXXXXXXXXXGAXXXXXXXXXXXXXXXXXXGXXXXXXXXXXXXXXXXXXXGXXXXXXXXXXXXXXXXXXXGXXXXXXXXXXXXXXXXXXXGXXXXXXXXXXXXXXXXXXXGXXXXXXXXXXXXXXXXXXXGXXXXXXXXXXXXXXXXXXXGXXXXXXXXXXXXXXXXXXXGXXXXXXXXXXXXXXXXXXX,0,10,0
4494,14,1,13,196,390,0,0,404,100,304,GXXXXXXXXXXXXXXXXXXXGXXXXXXXXXXXXXXXXXXXGXXXXXXXXXXXXXXXXXXXGXXXXXXXXXXXXXXXXXXXGAXXXXXXXXXXXXXXXXXXGXXXXXXXXXXXXXXXXXXXGXXXXXXXXXXXXXXXXXXXGXXXXXXXXXXXXXXXXXXXGXXXXXXXXXXXXXXXXXXXGXXXXXXXXXXXXXXXXXXXGXXXXXXXXXXXXXXXXXXXGXXXXXXXXXXXXXXXXXXXGXXXXXXXXXXXXXXXXXXX,0,10,0

4515,14,1,13,197,389,0,0,401,98,303,GXXXXXXXXXXXXXXXXXXXGXXXXXXXXXXXXXXXXXXXGXXXXXXXXXXXXXXXXXXXGXXXXXXXXXXXXXXXXXXXGAXXXXXXXXXXXXXXXXXXGXXXXXXXXXXXXXXXXXXXGXXXXXXXXXXXXXXXXXXXGXXXXXXXXXXXXXXXXXXXGXXXXXXXXXXXXXXXXXXXGXXXXXXXXXXXXXXXXXXXGXXXXXXXXXXXXXXXXXXXGXXXXXXXXXXXXXXXXXXXGXXXXXXXXXXXXXXXXXXX,0,10,0
4536,14,1,13,184,402,0,0,415,92,323,GXXXXXXXXXXXXXXXXXXXGXXXXXXXXXXXXXXXXXXXGXXXXXXXXXXXXXXXXXXXGXXXXXXXXXXXXXXXXXXXGAXXXXXXXXXXXXXXXXXXGXXXXXXXXXXXXXXXXXXXGXXXXXXXXXXXXXXXXXXXGXXXXXXXXXXXXXXXXXXXGXXXXXXXXXXXXXXXXXXXGXXXXXXXXXXXXXXXXXXXGXXXXXXXXXXXXXXXXXXXGXXXXXXXXXXXXXXXXXXXGXXXXXXXXXXXXXXXXXXX,0,10,0
4557,14,1,13,182,404,0,0,418,98,320,GXXXXXXXXXXXXXXXXXXXGXXXXXXXXXXXXXXXXXXXGXXXXXXXXXXXXXXXXXXXGXXXXXXXXXXXXXXXXXXXGAXXXXXXXXXXXXXXXXXXGXXXXXXXXXXXXXXXXXXXGXXXXXXXXXXXXXXXXXXXGXXXXXXXXXXXXXXXXXXXGXXXXXXXXXXXXXXXXXXXGXXXXXXXXXXXXXXXXXXXGXXXXXXXXXXXXXXXXXXXGXXXXXXXXXXXXXXXXXXXGXXXXXXXXXXXXXXXXXXX,0,10,0
4578,14,0,14,184,402,0,0,415,96,319,GXXXXXXXXXXXXXXXXXXXGXXXXXXXXXXXXXXXXXXXGXXXXXXXXXXXXXXXXXXXGXXXXXXXXXXXXXXXXXXXGOXXXXXXXXXXXXXXXXXXGXXXXXXXXXXXXXXXXXXXGXXXXXXXXXXXXXXXXXXXGXXXXXXXXXXXXXXXXXXXGXXXXXXXXXXXXXXXXXXXGXXXXXXXXXXXXXXXXXXXGXXXXXXXXXXXXXXXXXXXGXXXXXXXXXXXXXXXXXXXGXXXXXXXXXXXXXXXXXXX,0,10,0
4599,14,0,14,182,404,0,0,417,88,329,GXXXXXXXXXXXXXXXXXXXGXXXXXXXXXXXXXXXXXXXGXXXXXXXXXXXXXXXXXXXGXXXXXXXXXXXXXXXXXXXGOXXXXXXXXXXXXXXXXXXGXXXXXXXXXXXXXXXXXXXGXXXXXXXXXXXXXXXXXXXGXXXXXXXXXXXXXXXXXXXGXXXXXXXXXXXXXXXXXXXGXXXXXXXXXXXXXXXXXXXGXXXXXXXXXXXXXXXXXXXGXXXXXXXXXXXXXXXXXXXGXXXXXXXXXXXXXXXXXXX,0,10,0

4620,13,0,13,181,406,0,0,420,87,333,GXXXXXXXXXXXXXXXXXXXGXXXXXXXXXXXXXXXXXXXGXXXXXXXXXXXXXXXXXXXGXXXXXXXXXXXXXXXXXXXGXXXXXXXXXXXXXXXXXXXGXXXXXXXXXXXXXXXXXXXGXXXXXXXXXXXXXXXXXXXGXXXXXXXXXXXXXXXXXXXGXXXXXXXXXXXXXXXXXXXGXXXXXXXXXXXXXXXXXXXGXXXXXXXXXXXXXXXXXXXGXXXXXXXXXXXXXXXXXXXGXXXXXXXXXXXXXXXXXXX,0,10,0
4641,14,1,13,178,408,0,0,422,85,337,GXXXXXXXXXXXXXXXXXXXGXXXXXXXXXXXXXXXXXXXGXXXXXXXXXXXXXXXXXXXGXXXXXXXXXXXXXXXXXXXGXXXXXXXXXXXXXXXXXXXGXXXXXXXXXXXXXXXXXXXGXXXXXXXXXXXXXXXXXXXGXXXXXXXXXXXXXXXXXXXGXXXXXXXXXXXXXXXXXXXGAXXXXXXXXXXXXXXXXXXGXXXXXXXXXXXXXXXXXXXGXXXXXXXXXXXXXXXXXXXGXXXXXXXXXXXXXXXXXXX,0,10,0
4662,14,1,13,169,417,0,0,433,96,337,GXXXXXXXXXXXXXXXXXXXGXXXXXXXXXXXXXXXXXXXGXXXXXXXXXXXXXXXXXXXGXXXXXXXXXXXXXXXXXXXGXXXXXXXXXXXXXXXXXXXGXXXXXXXXXXXXXXXXXXXGXXXXXXXXXXXXXXXXXXXGXXXXXXXXXXXXXXXXXXXGXXXXXXXXXXXXXXXXXXXGAXXXXXXXXXXXXXXXXXXGXXXXXXXXXXXXXXXXXXXGXXXXXXXXXXXXXXXXXXXGXXXXXXXXXXXXXXXXXXX,0,10,0
4683,14,1,13,167,419,0,0,435,106,329,GXXXXXXXXXXXXXXXXXXXGXXXXXXXXXXXXXXXXXXXGXXXXXXXXXXXXXXXXXXXGXXXXXXXXXXXXXXXXXXXGXXXXXXXXXXXXXXXXXXXGXXXXXXXXXXXXXXXXXXXGXXXXXXXXXXXXXXXXXXXGXXXXXXXXXXXXXXXXXXXGXXXXXXXXXXXXXXXXXXXGAXXXXXXXXXXXXXXXXXXGXXXXXXXXXXXXXXXXXXXGXXXXXXXXXXXXXXXXXXXGXXXXXXXXXXXXXXXXXXX,0,10,0
4704,14,1,13,167,419,0,0,434,104,330,GXXXXXXXXXXXXXXXXXXXGXXXXXXXXXXXXXXXXXXXGXXXXXXXXXXXXXXXXXXXGXXXXXXXXXXXXXXXXXXXGXXXXXXXXXXXXXXXXXXXGXXXXXXXXXXXXXXXXXXXGXXXXXXXXXXXXXXXXXXXGXXXXXXXXXXXXXXXXXXXGXXXXXXXXXXXXXXXXXXXGAXXXXXXXXXXXXXXXXXXGXXXXXXXXXXXXXXXXXXXGXXXXXXXXXXXXXXXXXXXGXXXXXXXXXXXXXXXXXXX,0,10,0

4725,14,1,13,169,417,0,0,432,104,328,GXXXXXXXXXXXXXXXXXXXGXXXXXXXXXXXXXXXXXXXGXXXXXXXXXXXXXXXXXXXGXXXXXXXXXXXXXXXXXXXGXXXXXXXXXXXXXXXXXXXGXXXXXXXXXXXXXXXXXXXGXXXXXXXXXXXXXXXXXXXGXXXXXXXXXXXXXXXXXXXGXXXXXXXXXXXXXXXXXXXGAXXXXXXXXXXXXXXXXXXGXXXXXXXXXXXXXXXXXXXGXXXXXXXXXXXXXXXXXXXGXXXXXXXXXXXXXXXXXXX,0,10,0
4746,14,1,13,171,415,0,0,429,104,325,GXXXXXXXXXXXXXXXXXXXGXXXXXXXXXXXXXXXXXXXGXXXXXXXXXXXXXXXXXXXGXXXXXXXXXXXXXXXXXXXGXXXXXXXXXXXXXXXXXXXGXXXXXXXXXXXXXXXXXXXGXXXXXXXXXXXXXXXXXXXGXXXXXXXXXXXXXXXXXXXGXXXXXXXXXXXXXXXXXXXGAXXXXXXXXXXXXXXXXXXGXXXXXXXXXXXXXXXXXXXGXXXXXXXXXXXXXXXXXXXGXXXXXXXXXXXXXXXXXXX,0,10,0
4767,14,1,13,173,413,0,0,428,105,323,GXXXXXXXXXXXXXXXXXXXGXXXXXXXXXXXXXXXXXXXGXXXXXXXXXXXXXXXXXXXGXXXXXXXXXXXXXXXXXXXGXXXXXXXXXXXXXXXXXXXGXXXXXXXXXXXXXXXXXXXGXXXXXXXXXXXXXXXXXXXGXXXXXXXXXXXXXXXXXXXGXXXXXXXXXXXXXXXXXXXGAXXXXXXXXXXXXXXXXXXGXXXXXXXXXXXXXXXXXXXGXXXXXXXXXXXXXXXXXXXGXXXXXXXXXXXXXXXXXXX,0,10,0
4788,14,1,13,177,409,0,0,425,114,311,GXXXXXXXXXXXXXXXXXXXGXXXXXXXXXXXXXXXXXXXGXXXXXXXXXXXXXXXXXXXGXXXXXXXXXXXXXXXXXXXGXXXXXXXXXXXXXXXXXXXGXXXXXXXXXXXXXXXXXXXGXXXXXXXXXXXXXXXXXXXGXXXXXXXXXXXXXXXXXXXGXXXXXXXXXXXXXXXXXXXGAXXXXXXXXXXXXXXXXXXGXXXXXXXXXXXXXXXXXXXGXXXXXXXXXXXXXXXXXXXGXXXXXXXXXXXXXXXXXXX,0,10,0
4809,14,1,13,181,405,0,0,419,113,306,GXXXXXXXXXXXXXXXXXXXGXXXXXXXXXXXXXXXXXXXGXXXXXXXXXXXXXXXXXXXGXXXXXXXXXXXXXXXXXXXGXXXXXXXXXXXXXXXXXXXGXXXXXXXXXXXXXXXXXXXGXXXXXXXXXXXXXXXXXXXGXXXXXXXXXXXXXXXXXXXGXXXXXXXXXXXXXXXXXXXGAXXXXXXXXXXXXXXXXXXGXXXXXXXXXXXXXXXXXXXGXXXXXXXXXXXXXXXXXXXGXXXXXXXXXXXXXXXXXXX,0,10,0

4830,14,1,13,186,400,0,0,411,111,300,GXXXXXXXXXXXXXXXXXXXGXXXXXXXXXXXXXXXXXXXGXXXXXXXXXXXXXXXXXXXGXXXXXXXXXXXXXXXXXXXGXXXXXXXXXXXXXXXXXXXGXXXXXXXXXXXXXXXXXXXGXXXXXXXXXXXXXXXXXXXGXXXXXXXXXXXXXXXXXXXGXXXXXXXXXXXXXXXXXXXGAXXXXXXXXXXXXXXXXXXGXXXXXXXXXXXXXXXXXXXGXXXXXXXXXXXXXXXXXXXGXXXXXXXXXXXXXXXXXXX,0,10,0
4851,14,1,13,197,389,0,0,403,109,294,GXXXXXXXXXXXXXXXXXXXGXXXXXXXXXXXXXXXXXXXGXXXXXXXXXXXXXXXXXXXGXXXXXXXXXXXXXXXXXXXGXXXXXXXXXXXXXXXXXXXGXXXXXXXXXXXXXXXXXXXGXXXXXXXXXXXXXXXXXXXGXXXXXXXXXXXXXXXXXXXGXXXXXXXXXXXXXXXXXXXGAXXXXXXXXXXXXXXXXXXGXXXXXXXXXXXXXXXXXXXGXXXXXXXXXXXXXXXXXXXGXXXXXXXXXXXXXXXXXXX,0,10,0
4872,15,2,13,195,390,0,0,402,110,292,GXXXXXXXXXXXXXXXXXXXGXXXXXXXXXXXXXXXXXXXGXXXXXXXXXXXXXXXXXXXGAXXXXXXXXXXXXXXXXXXGXXXXXXXXXXXXXXXXXXXGXXXXXXXXXXXXXXXXXXXGXXXXXXXXXXXXXXXXXXXGXXXXXXXXXXXXXXXXXXXGXXXXXXXXXXXXXXXXXXXGAXXXXXXXXXXXXXXXXXXGXXXXXXXXXXXXXXXXXXXGXXXXXXXXXXXXXXXXXXXGXXXXXXXXXXXXXXXXXXX,0,10,0
4893,15,2,13,195,390,0,0,402,102,300,GXXXXXXXXXXXXXXXXXXXGXXXXXXXXXXXXXXXXXXXGXXXXXXXXXXXXXXXXXXXGAXXXXXXXXXXXXXXXXXXGXXXXXXXXXXXXXXXXXXXGXXXXXXXXXXXXXXXXXXXGXXXXXXXXXXXXXXXXXXXGXXXXXXXXXXXXXXXXXXXGXXXXXXXXXXXXXXXXXXXGAXXXXXXXXXXXXXXXXXXGXXXXXXXXXXXXXXXXXXXGXXXXXXXXXXXXXXXXXXXGXXXXXXXXXXXXXXXXXXX,0,10,0
4914,15,2,13,196,389,0,0,401,106,295,GXXXXXXXXXXXXXXXXXXXGXXXXXXXXXXXXXXXXXXXGXXXXXXXXXXXXXXXXXXXGAXXXXXXXXXXXXXXXXXXGXXXXXXXXXXXXXXXXXXXGXXXXXXXXXXXXXXXXXXXGXXXXXXXXXXXXXXXXXXXGXXXXXXXXXXXXXXXXXXXGXXXXXXXXXXXXXXXXXXXGAXXXXXXXXXXXXXXXXXXGXXXXXXXXXXXXXXXXXXXGXXXXXXXXXXXXXXXXXXXGXXXXXXXXXXXXXXXXXXX,0,10,0

4935,15,2,13,202,383,0,0,396,107,289,GXXXXXXXXXXXXXXXXXXXGXXXXXXXXXXXXXXXXXXXGXXXXXXXXXXXXXXXXXXXGAXXXXXXXXXXXXXXXXXXGXXXXXXXXXXXXXXXXXXXGXXXXXXXXXXXXXXXXXXXGXXXXXXXXXXXXXXXXXXXGXXXXXXXXXXXXXXXXXXXGXXXXXXXXXXXXXXXXXXXGAXXXXXXXXXXXXXXXXXXGXXXXXXXXXXXXXXXXXXXGXXXXXXXXXXXXXXXXXXXGXXXXXXXXXXXXXXXXXXX,0,10,0
4956,15,2,13,197,388,0,0,401,106,295,GXXXXXXXXXXXXXXXXXXXGXXXXXXXXXXXXXXXXXXXGXXXXXXXXXXXXXXXXXXXGAXXXXXXXXXXXXXXXXXXGXXXXXXXXXXXXXXXXXXXGXXXXXXXXXXXXXXXXXXXGXXXXXXXXXXXXXXXXXXXGXXXXXXXXXXXXXXXXXXXGXXXXXXXXXXXXXXXXXXXGAXXXXXXXXXXXXXXXXXXGXXXXXXXXXXXXXXXXXXXGXXXXXXXXXXXXXXXXXXXGXXXXXXXXXXXXXXXXXXX,0,10,0
4977,15,2,13,189,396,0,0,406,112,294,GXXXXXXXXXXXXXXXXXXXGXXXXXXXXXXXXXXXXXXXGXXXXXXXXXXXXXXXXXXXGAXXXXXXXXXXXXXXXXXXGXXXXXXXXXXXXXXXXXXXGXXXXXXXXXXXXXXXXXXXGXXXXXXXXXXXXXXXXXXXGXXXXXXXXXXXXXXXXXXXGXXXXXXXXXXXXXXXXXXXGAXXXXXXXXXXXXXXXXXXGXXXXXXXXXXXXXXXXXXXGXXXXXXXXXXXXXXXXXXXGXXXXXXXXXXXXXXXXXXX,0,10,0
4998,15,2,13,190,395,0,0,408,120,288,GXXXXXXXXXXXXXXXXXXXGXXXXXXXXXXXXXXXXXXXGXXXXXXXXXXXXXXXXXXXGAXXXXXXXXXXXXXXXXXXGXXXXXXXXXXXXXXXXXXXGXXXXXXXXXXXXXXXXXXXGXXXXXXXXXXXXXXXXXXXGXXXXXXXXXXXXXXXXXXXGXXXXXXXXXXXXXXXXXXXGAXXXXXXXXXXXXXXXXXXGXXXXXXXXXXXXXXXXXXXGXXXXXXXXXXXXXXXXXXXGXXXXXXXXXXXXXXXXXXX,0,10,0
5019,15,2,13,193,392,0,0,403,109,294,GXXXXXXXXXXXXXXXXXXXGXXXXXXXXXXXXXXXXXXXGXXXXXXXXXXXXXXXXXXXGAXXXXXXXXXXXXXXXXXXGXXXXXXXXXXXXXXXXXXXGXXXXXXXXXXXXXXXXXXXGXXXXXXXXXXXXXXXXXXXGXXXXXXXXXXXXXXXXXXXGXXXXXXXXXXXXXXXXXXXGAXXXXXXXXXXXXXXXXXXGXXXXXXXXXXXXXXXXXXXGXXXXXXXXXXXXXXXXXXXGXXXXXXXXXXXXXXXXXXX,0,10,0

5040,14,1,13,191,395,0,0,408,110,298,GXXXXXXXXXXXXXXXXXXXGXXXXXXXXXXXXXXXXXXXGXXXXXXXXXXXXXXXXXXXGAXXXXXXXXXXXXXXXXXXGXXXXXXXXXXXXXXXXXXXGXXXXXXXXXXXXXXXXXXXGXXXXXXXXXXXXXXXXXXXGXXXXXXXXXXXXXXXXXXXGXXXXXXXXXXXXXXXXXXXGXXXXXXXXXXXXXXXXXXXGXXXXXXXXXXXXXXXXXXXGXXXXXXXXXXXXXXXXXXXGXXXXXXXXXXXXXXXXXXX,0,10,0
5061,15,2,13,195,390,0,0,402,112,290,GXXXXXXXXXXXXXXXXXXXGXXXXXXXXXXXXXXXXXXXGXXXXXXXXXXXXXXXXXXXGAXXXXXXXXXXXXXXXXXXGXXXXXXXXXXXXXXXXXXXGAXXXXXXXXXXXXXXXXXXGXXXXXXXXXXXXXXXXXXXGXXXXXXXXXXXXXXXXXXXGXXXXXXXXXXXXXXXXXXXGXXXXXXXXXXXXXXXXXXXGXXXXXXXXXXXXXXXXXXXGXXXXXXXXXXXXXXXXXXXGXXXXXXXXXXXXXXXXXXX,0,10,0
5082,15,2,13,187,398,0,0,409,111,298,GXXXXXXXXXXXXXXXXXXXGXXXXXXXXXXXXXXXXXXXGXXXXXXXXXXXXXXXXXXXGAXXXXXXXXXXXXXXXXXXGXXXXXXXXXXXXXXXXXXXGAXXXXXXXXXXXXXXXXXXGXXXXXXXXXXXXXXXXXXXGXXXXXXXXXXXXXXXXXXXGXXXXXXXXXXXXXXXXXXXGXXXXXXXXXXXXXXXXXXXGXXXXXXXXXXXXXXXXXXXGXXXXXXXXXXXXXXXXXXXGXXXXXXXXXXXXXXXXXXX,0,10,0
5103,14,1,13,183,403,0,0,415,112,303,GXXXXXXXXXXXXXXXXXXXGXXXXXXXXXXXXXXXXXXXGXXXXXXXXXXXXXXXXXXXGAXXXXXXXXXXXXXXXXXXGXXXXXXXXXXXXXXXXXXXGXXXXXXXXXXXXXXXXXXXGXXXXXXXXXXXXXXXXXXXGXXXXXXXXXXXXXXXXXXXGXXXXXXXXXXXXXXXXXXXGXXXXXXXXXXXXXXXXXXXGXXXXXXXXXXXXXXXXXXXGXXXXXXXXXXXXXXXXXXXGXXXXXXXXXXXXXXXXXXX,0,10,0
5124,14,1,13,174,412,0,0,427,115,312,GXXXXXXXXXXXXXXXXXXXGXXXXXXXXXXXXXXXXXXXGXXXXXXXXXXXXXXXXXXXGAXXXXXXXXXXXXXXXXXXGXXXXXXXXXXXXXXXXXXXGXXXXXXXXXXXXXXXXXXXGXXXXXXXXXXXXXXXXXXXGXXXXXXXXXXXXXXXXXXXGXXXXXXXXXXXXXXXXXXXGXXXXXXXXXXXXXXXXXXXGXXXXXXXXXXXXXXXXXXXGXXXXXXXXXXXXXXXXXXXGXXXXXXXXXXXXXXXXXXX,0,10,0

5145,15,2,13,173,412,0,0,428,109,319,GXXXXXXXXXXXXXXXXXXXGXXXXXXXXXXXXXXXXXXXGXXXXXXXXXXXXXXXXXXXGAXXXXXXXXXXXXXXXXXXGXXXXXXXXXXXXXXXXXXXGXXXXXXXXXXXXXXXXXXXGXXXXXXXXXXXXXXXXXXXGXXXXXXXXXXXXXXXXXXXGXXXXXXXXXXXXXXXXXXXGXXXXXXXXXXXXXXXXXXXGXXXXXXXXXXXXXXXXXXXGAXXXXXXXXXXXXXXXXXXGXXXXXXXXXXXXXXXXXXX,0,10,0
5166,15,0,15,173,412,0,0,428,106,322,GXXXXXXXXXXXXXXXXXXXGXXXXXXXXXXXXXXXXXXXGXXXXXXXXXXXXXXXXXXXGOXXXXXXXXXXXXXXXXXXGXXXXXXXXXXXXXXXXXXXGXXXXXXXXXXXXXXXXXXXGXXXXXXXXXXXXXXXXXXXGXXXXXXXXXXXXXXXXXXXGXXXXXXXXXXXXXXXXXXXGXXXXXXXXXXXXXXXXXXXGXXXXXXXXXXXXXXXXXXXGOXXXXXXXXXXXXXXXXXXGXXXXXXXXXXXXXXXXXXX,0,10,0
5187,15,0,15,171,414,0,0,429,106,323,GXXXXXXXXXXXXXXXXXXXGXXXXXXXXXXXXXXXXXXXGXXXXXXXXXXXXXXXXXXXGOXXXXXXXXXXXXXXXXXXGXXXXXXXXXXXXXXXXXXXGXXXXXXXXXXXXXXXXXXXGXXXXXXXXXXXXXXXXXXXGXXXXXXXXXXXXXXXXXXXGXXXXXXXXXXXXXXXXXXXGXXXXXXXXXXXXXXXXXXXGXXXXXXXXXXXXXXXXXXXGOXXXXXXXXXXXXXXXXXXGXXXXXXXXXXXXXXXXXXX,0,10,0
5208,13,0,13,173,414,0,0,429,105,324,GXXXXXXXXXXXXXXXXXXXGXXXXXXXXXXXXXXXXXXXGXXXXXXXXXXXXXXXXXXXGXXXXXXXXXXXXXXXXXXXGXXXXXXXXXXXXXXXXXXXGXXXXXXXXXXXXXXXXXXXGXXXXXXXXXXXXXXXXXXXGXXXXXXXXXXXXXXXXXXXGXXXXXXXXXXXXXXXXXXXGXXXXXXXXXXXXXXXXXXXGXXXXXXXXXXXXXXXXXXXGXXXXXXXXXXXXXXXXXXXGXXXXXXXXXXXXXXXXXXX,0,10,0
5229,13,0,13,164,423,0,0,438,115,323,GXXXXXXXXXXXXXXXXXXXGXXXXXXXXXXXXXXXXXXXGXXXXXXXXXXXXXXXXXXXGXXXXXXXXXXXXXXXXXXXGXXXXXXXXXXXXXXXXXXXGXXXXXXXXXXXXXXXXXXXGXXXXXXXXXXXXXXXXXXXGXXXXXXXXXXXXXXXXXXXGXXXXXXXXXXXXXXXXXXXGXXXXXXXXXXXXXXXXXXXGXXXXXXXXXXXXXXXXXXXGXXXXXXXXXXXXXXXXXXXGXXXXXXXXXXXXXXXXXXX,0,10,0

5250,13,0,13,171,416,0,0,430,113,317,GXXXXXXXXXXXXXXXXXXXGXXXXXXXXXXXXXXXXXXXGXXXXXXXXXXXXXXXXXXXGXXXXXXXXXXXXXXXXXXXGXXXXXXXXXXXXXXXXXXXGXXXXXXXXXXXXXXXXXXXGXXXXXXXXXXXXXXXXXXXGXXXXXXXXXXXXXXXXXXXGXXXXXXXXXXXXXXXXXXXGXXXXXXXXXXXXXXXXXXXGXXXXXXXXXXXXXXXXXXXGXXXXXXXXXXXXXXXXXXXGXXXXXXXXXXXXXXXXXXX,0,10,0
5271,13,0,13,178,409,0,0,422,100,322,GXXXXXXXXXXXXXXXXXXXGXXXXXXXXXXXXXXXXXXXGXXXXXXXXXXXXXXXXXXXGXXXXXXXXXXXXXXXXXXXGXXXXXXXXXXXXXXXXXXXGXXXXXXXXXXXXXXXXXXXGXXXXXXXXXXXXXXXXXXXGXXXXXXXXXXXXXXXXXXXGXXXXXXXXXXXXXXXXXXXGXXXXXXXXXXXXXXXXXXXGXXXXXXXXXXXXXXXXXXXGXXXXXXXXXXXXXXXXXXXGXXXXXXXXXXXXXXXXXXX,0,10,0
5292,13,0,13,174,413,0,0,427,100,327,GXXXXXXXXXXXXXXXXXXXGXXXXXXXXXXXXXXXXXXXGXXXXXXXXXXXXXXXXXXXGXXXXXXXXXXXXXXXXXXXGXXXXXXXXXXXXXXXXXXXGXXXXXXXXXXXXXXXXXXXGXXXXXXXXXXXXXXXXXXXGXXXXXXXXXXXXXXXXXXXGXXXXXXXXXXXXXXXXXXXGXXXXXXXXXXXXXXXXXXXGXXXXXXXXXXXXXXXXXXXGXXXXXXXXXXXXXXXXXXXGXXXXXXXXXXXXXXXXXXX,0,10,0
5313,13,0,13,174,413,0,0,426,103,323,GXXXXXXXXXXXXXXXXXXXGXXXXXXXXXXXXXXXXXXXGXXXXXXXXXXXXXXXXXXXGXXXXXXXXXXXXXXXXXXXGXXXXXXXXXXXXXXXXXXXGXXXXXXXXXXXXXXXXXXXGXXXXXXXXXXXXXXXXXXXGXXXXXXXXXXXXXXXXXXXGXXXXXXXXXXXXXXXXXXXGXXXXXXXXXXXXXXXXXXXGXXXXXXXXXXXXXXXXXXXGXXXXXXXXXXXXXXXXXXXGXXXXXXXXXXXXXXXXXXX,0,10,0
5334,14,1,13,176,410,0,0,424,108,316,GXXXXXXXXXXXXXXXXXXXGXXXXXXXXXXXXXXXXXXXGXXXXXXXXXXXXXXXXXXXGXXXXXXXXXXXXXXXXXXXGXXXXXXXXXXXXXXXXXXXGXXXXXXXXXXXXXXXXXXXGXXXXXXXXXXXXXXXXXXXGXXXXXXXXXXXXXXXXXXXGXXXXXXXXXXXXXXXXXXXGXXXXXXXXXXXXXXXXXXXGXXXXXXXXXXXXXXXXXXXGXXXXXXXXXXXXXXXXXXXGAXXXXXXXXXXXXXXXXXX,0,10,0

5355,14,1,13,175,411,0,0,425,101,324,GXXXXXXXXXXXXXXXXXXXGXXXXXXXXXXXXXXXXXXXGXXXXXXXXXXXXXXXXXXXGXXXXXXXXXXXXXXXXXXXGXXXXXXXXXXXXXXXXXXXGXXXXXXXXXXXXXXXXXXXGXXXXXXXXXXXXXXXXXXXGXXXXXXXXXXXXXXXXXXXGXXXXXXXXXXXXXXXXXXXGXXXXXXXXXXXXXXXXXXXGXXXXXXXXXXXXXXXXXXXGXXXXXXXXXXXXXXXXXXXGAXXXXXXXXXXXXXXXXXX,0,10,0
5376,14,0,14,173,413,0,0,427,106,321,GXXXXXXXXXXXXXXXXXXXGXXXXXXXXXXXXXXXXXXXGXXXXXXXXXXXXXXXXXXXGXXXXXXXXXXXXXXXXXXXGXXXXXXXXXXXXXXXXXXXGXXXXXXXXXXXXXXXXXXXGXXXXXXXXXXXXXXXXXXXGXXXXXXXXXXXXXXXXXXXGXXXXXXXXXXXXXXXXXXXGXXXXXXXXXXXXXXXXXXXGXXXXXXXXXXXXXXXXXXXGXXXXXXXXXXXXXXXXXXXGOXXXXXXXXXXXXXXXXXX,0,10,0
5397,14,0,14,163,423,0,0,434,107,327,GXXXXXXXXXXXXXXXXXXXGXXXXXXXXXXXXXXXXXXXGXXXXXXXXXXXXXXXXXXXGXXXXXXXXXXXXXXXXXXXGXXXXXXXXXXXXXXXXXXXGXXXXXXXXXXXXXXXXXXXGXXXXXXXXXXXXXXXXXXXGXXXXXXXXXXXXXXXXXXXGXXXXXXXXXXXXXXXXXXXGXXXXXXXXXXXXXXXXXXXGXXXXXXXXXXXXXXXXXXXGXXXXXXXXXXXXXXXXXXXGOXXXXXXXXXXXXXXXXXX,0,10,0
5418,13,0,13,169,418,0,0,432,114,318,GXXXXXXXXXXXXXXXXXXXGXXXXXXXXXXXXXXXXXXXGXXXXXXXXXXXXXXXXXXXGXXXXXXXXXXXXXXXXXXXGXXXXXXXXXXXXXXXXXXXGXXXXXXXXXXXXXXXXXXXGXXXXXXXXXXXXXXXXXXXGXXXXXXXXXXXXXXXXXXXGXXXXXXXXXXXXXXXXXXXGXXXXXXXXXXXXXXXXXXXGXXXXXXXXXXXXXXXXXXXGXXXXXXXXXXXXXXXXXXXGXXXXXXXXXXXXXXXXXXX,0,10,0
5439,13,0,13,166,421,0,0,434,121,313,GXXXXXXXXXXXXXXXXXXXGXXXXXXXXXXXXXXXXXXXGXXXXXXXXXXXXXXXXXXXGXXXXXXXXXXXXXXXXXXXGXXXXXXXXXXXXXXXXXXXGXXXXXXXXXXXXXXXXXXXGXXXXXXXXXXXXXXXXXXXGXXXXXXXXXXXXXXXXXXXGXXXXXXXXXXXXXXXXXXXGXXXXXXXXXXXXXXXXXXXGXXXXXXXXXXXXXXXXXXXGXXXXXXXXXXXXXXXXXXXGXXXXXXXXXXXXXXXXXXX,0,10,0

5460,15,2,13,177,408,0,0,420,120,300,GXXXXXXXXXXXXXXXXXXXGXXXXXXXXXXXXXXXXXXXGXXXXXXXXXXXXXXXXXXXGXXXXXXXXXXXXXXXXXXXGXXXXXXXXXXXXXXXXXXXGXXXXXXXXXXXXXXXXXXXGXXXXXXXXXXXXXXXXXXXGAXXXXXXXXXXXXXXXXXXGXXXXXXXXXXXXXXXXXXXGXXXXXXXXXXXXXXXXXXXGXXXXXXXXXXXXXXXXXXXGXXXXXXXXXXXXXXXXXXXGAXXXXXXXXXXXXXXXXXX,0,10,0
5481,15,1,14,176,409,0,0,421,122,299,GXXXXXXXXXXXXXXXXXXXGXXXXXXXXXXXXXXXXXXXGXXXXXXXXXXXXXXXXXXXGXXXXXXXXXXXXXXXXXXXGXXXXXXXXXXXXXXXXXXXGXXXXXXXXXXXXXXXXXXXGXXXXXXXXXXXXXXXXXXXGOXXXXXXXXXXXXXXXXXXGXXXXXXXXXXXXXXXXXXXGXXXXXXXXXXXXXXXXXXXGXXXXXXXXXXXXXXXXXXXGXXXXXXXXXXXXXXXXXXXGAXXXXXXXXXXXXXXXXXX,0,10,0
5502,14,1,13,173,413,0,0,426,121,305,GXXXXXXXXXXXXXXXXXXXGXXXXXXXXXXXXXXXXXXXGXXXXXXXXXXXXXXXXXXXGXXXXXXXXXXXXXXXXXXXGXXXXXXXXXXXXXXXXXXXGXXXXXXXXXXXXXXXXXXXGXXXXXXXXXXXXXXXXXXXGXXXXXXXXXXXXXXXXXXXGXXXXXXXXXXXXXXXXXXXGXXXXXXXXXXXXXXXXXXXGXXXXXXXXXXXXXXXXXXXGXXXXXXXXXXXXXXXXXXXGAXXXXXXXXXXXXXXXXXX,0,10,0
5523,14,1,13,180,406,0,0,420,125,295,GXXXXXXXXXXXXXXXXXXXGXXXXXXXXXXXXXXXXXXXGXXXXXXXXXXXXXXXXXXXGXXXXXXXXXXXXXXXXXXXGXXXXXXXXXXXXXXXXXXXGXXXXXXXXXXXXXXXXXXXGXXXXXXXXXXXXXXXXXXXGXXXXXXXXXXXXXXXXXXXGXXXXXXXXXXXXXXXXXXXGXXXXXXXXXXXXXXXXXXXGXXXXXXXXXXXXXXXXXXXGXXXXXXXXXXXXXXXXXXXGAXXXXXXXXXXXXXXXXXX,0,10,0
5544,14,0,14,178,408,0,0,419,121,298,GXXXXXXXXXXXXXXXXXXXGXXXXXXXXXXXXXXXXXXXGXXXXXXXXXXXXXXXXXXXGXXXXXXXXXXXXXXXXXXXGXXXXXXXXXXXXXXXXXXXGXXXXXXXXXXXXXXXXXXXGXXXXXXXXXXXXXXXXXXXGXXXXXXXXXXXXXXXXXXXGXXXXXXXXXXXXXXXXXXXGXXXXXXXXXXXXXXXXXXXGXXXXXXXXXXXXXXXXXXXGXXXXXXXXXXXXXXXXXXXGOXXXXXXXXXXXXXXXXXX,0,10,0

5565,13,0,13,182,405,0,0,418,119,299,GXXXXXXXXXXXXXXXXXXXGXXXXXXXXXXXXXXXXXXXGXXXXXXXXXXXXXXXXXXXGXXXXXXXXXXXXXXXXXXXGXXXXXXXXXXXXXXXXXXXGXXXXXXXXXXXXXXXXXXXGXXXXXXXXXXXXXXXXXXXGXXXXXXXXXXXXXXXXXXXGXXXXXXXXXXXXXXXXXXXGXXXXXXXXXXXXXXXXXXXGXXXXXXXXXXXXXXXXXXXGXXXXXXXXXXXXXXXXXXXGXXXXXXXXXXXXXXXXXXX,0,10,0
5586,13,0,13,182,405,0,0,420,119,301,GXXXXXXXXXXXXXXXXXXXGXXXXXXXXXXXXXXXXXXXGXXXXXXXXXXXXXXXXXXXGXXXXXXXXXXXXXXXXXXXGXXXXXXXXXXXXXXXXXXXGXXXXXXXXXXXXXXXXXXXGXXXXXXXXXXXXXXXXXXXGXXXXXXXXXXXXXXXXXXXGXXXXXXXXXXXXXXXXXXXGXXXXXXXXXXXXXXXXXXXGXXXXXXXXXXXXXXXXXXXGXXXXXXXXXXXXXXXXXXXGXXXXXXXXXXXXXXXXXXX,0,10,0
5607,13,0,13,186,401,0,0,416,112,304,GXXXXXXXXXXXXXXXXXXXGXXXXXXXXXXXXXXXXXXXGXXXXXXXXXXXXXXXXXXXGXXXXXXXXXXXXXXXXXXXGXXXXXXXXXXXXXXXXXXXGXXXXXXXXXXXXXXXXXXXGXXXXXXXXXXXXXXXXXXXGXXXXXXXXXXXXXXXXXXXGXXXXXXXXXXXXXXXXXXXGXXXXXXXXXXXXXXXXXXXGXXXXXXXXXXXXXXXXXXXGXXXXXXXXXXXXXXXXXXXGXXXXXXXXXXXXXXXXXXX,0,10,0
5628,13,0,13,194,393,0,0,409,115,294,GXXXXXXXXXXXXXXXXXXXGXXXXXXXXXXXXXXXXXXXGXXXXXXXXXXXXXXXXXXXGXXXXXXXXXXXXXXXXXXXGXXXXXXXXXXXXXXXXXXXGXXXXXXXXXXXXXXXXXXXGXXXXXXXXXXXXXXXXXXXGXXXXXXXXXXXXXXXXXXXGXXXXXXXXXXXXXXXXXXXGXXXXXXXXXXXXXXXXXXXGXXXXXXXXXXXXXXXXXXXGXXXXXXXXXXXXXXXXXXXGXXXXXXXXXXXXXXXXXXX,0,10,0
5649,14,0,14,196,390,0,0,402,106,296,GOXXXXXXXXXXXXXXXXXXGXXXXXXXXXXXXXXXXXXXGXXXXXXXXXXXXXXXXXXXGXXXXXXXXXXXXXXXXXXXGXXXXXXXXXXXXXXXXXXXGXXXXXXXXXXXXXXXXXXXGXXXXXXXXXXXXXXXXXXXGXXXXXXXXXXXXXXXXXXXGXXXXXXXXXXXXXXXXXXXGXXXXXXXXXXXXXXXXXXXGXXXXXXXXXXXXXXXXXXXGXXXXXXXXXXXXXXXXXXXGXXXXXXXXXXXXXXXXXXX,0,10,0

5670,13,0,13,181,406,0,0,418,114,304,GXXXXXXXXXXXXXXXXXXXGXXXXXXXXXXXXXXXXXXXGXXXXXXXXXXXXXXXXXXXGXXXXXXXXXXXXXXXXXXXGXXXXXXXXXXXXXXXXXXXGXXXXXXXXXXXXXXXXXXXGXXXXXXXXXXXXXXXXXXXGXXXXXXXXXXXXXXXXXXXGXXXXXXXXXXXXXXXXXXXGXXXXXXXXXXXXXXXXXXXGXXXXXXXXXXXXXXXXXXXGXXXXXXXXXXXXXXXXXXXGXXXXXXXXXXXXXXXXXXX,0,10,0
5691,13,0,13,176,411,0,0,422,115,307,GXXXXXXXXXXXXXXXXXXXGXXXXXXXXXXXXXXXXXXXGXXXXXXXXXXXXXXXXXXXGXXXXXXXXXXXXXXXXXXXGXXXXXXXXXXXXXXXXXXXGXXXXXXXXXXXXXXXXXXXGXXXXXXXXXXXXXXXXXXXGXXXXXXXXXXXXXXXXXXXGXXXXXXXXXXXXXXXXXXXGXXXXXXXXXXXXXXXXXXXGXXXXXXXXXXXXXXXXXXXGXXXXXXXXXXXXXXXXXXXGXXXXXXXXXXXXXXXXXXX,0,10,0
5712,13,0,13,169,418,0,0,431,124,307,GXXXXXXXXXXXXXXXXXXXGXXXXXXXXXXXXXXXXXXXGXXXXXXXXXXXXXXXXXXXGXXXXXXXXXXXXXXXXXXXGXXXXXXXXXXXXXXXXXXXGXXXXXXXXXXXXXXXXXXXGXXXXXXXXXXXXXXXXXXXGXXXXXXXXXXXXXXXXXXXGXXXXXXXXXXXXXXXXXXXGXXXXXXXXXXXXXXXXXXXGXXXXXXXXXXXXXXXXXXXGXXXXXXXXXXXXXXXXXXXGXXXXXXXXXXXXXXXXXXX,0,10,0
5733,13,0,13,175,412,0,0,425,117,308,GXXXXXXXXXXXXXXXXXXXGXXXXXXXXXXXXXXXXXXXGXXXXXXXXXXXXXXXXXXXGXXXXXXXXXXXXXXXXXXXGXXXXXXXXXXXXXXXXXXXGXXXXXXXXXXXXXXXXXXXGXXXXXXXXXXXXXXXXXXXGXXXXXXXXXXXXXXXXXXXGXXXXXXXXXXXXXXXXXXXGXXXXXXXXXXXXXXXXXXXGXXXXXXXXXXXXXXXXXXXGXXXXXXXXXXXXXXXXXXXGXXXXXXXXXXXXXXXXXXX,0,10,0
5754,13,0,13,170,417,0,0,431,116,315,GXXXXXXXXXXXXXXXXXXXGXXXXXXXXXXXXXXXXXXXGXXXXXXXXXXXXXXXXXXXGXXXXXXXXXXXXXXXXXXXGXXXXXXXXXXXXXXXXXXXGXXXXXXXXXXXXXXXXXXXGXXXXXXXXXXXXXXXXXXXGXXXXXXXXXXXXXXXXXXXGXXXXXXXXXXXXXXXXXXXGXXXXXXXXXXXXXXXXXXXGXXXXXXXXXXXXXXXXXXXGXXXXXXXXXXXXXXXXXXXGXXXXXXXXXXXXXXXXXXX,0,10,0

5775,14,1,13,169,417,0,0,430,121,309,GXXXXXXXXXXXXXXXXXXXGXXXXXXXXXXXXXXXXXXXGXXXXXXXXXXXXXXXXXXXGXXXXXXXXXXXXXXXXXXXGXXXXXXXXXXXXXXXXXXXGXXXXXXXXXXXXXXXXXXXGXXXXXXXXXXXXXXXXXXXGXXXXXXXXXXXXXXXXXXXGXXXXXXXXXXXXXXXXXXXGAXXXXXXXXXXXXXXXXXXGXXXXXXXXXXXXXXXXXXXGXXXXXXXXXXXXXXXXXXXGXXXXXXXXXXXXXXXXXXX,0,10,0
5796,15,2,13,170,415,0,0,426,117,309,GXXXXXXXXXXXXXXXXXXXGXXXXXXXXXXXXXXXXXXXGXXXXXXXXXXXXXXXXXXXGXXXXXXXXXXXXXXXXXXXGXXXXXXXXXXXXXXXXXXXGXXXXXXXXXXXXXXXXXXXGXXXXXXXXXXXXXXXXXXXGXXXXXXXXXXXXXXXXXXXGAXXXXXXXXXXXXXXXXXXGAXXXXXXXXXXXXXXXXXXGXXXXXXXXXXXXXXXXXXXGXXXXXXXXXXXXXXXXXXXGXXXXXXXXXXXXXXXXXXX,0,10,0
5817,16,2,14,169,415,0,0,428,124,304,GXXXXXXXXXXXXXXXXXXXGXXXXXXXXXXXXXXXXXXXGXXXXXXXXXXXXXXXXXXXGXXXXXXXXXXXXXXXXXXXGXXXXXXXXXXXXXXXXXXXGXXXXXXXXXXXXXXXXXXXGAXXXXXXXXXXXXXXXXXXGXXXXXXXXXXXXXXXXXXXGAXXXXXXXXXXXXXXXXXXGOXXXXXXXXXXXXXXXXXXGXXXXXXXXXXXXXXXXXXXGXXXXXXXXXXXXXXXXXXXGXXXXXXXXXXXXXXXXXXX,0,10,0
5838,16,1,15,175,409,0,0,424,113,311,GXXXXXXXXXXXXXXXXXXXGXXXXXXXXXXXXXXXXXXXGXXXXXXXXXXXXXXXXXXXGXXXXXXXXXXXXXXXXXXXGXXXXXXXXXXXXXXXXXXXGXXXXXXXXXXXXXXXXXXXGAXXXXXXXXXXXXXXXXXXGXXXXXXXXXXXXXXXXXXXGOXXXXXXXXXXXXXXXXXXGOXXXXXXXXXXXXXXXXXXGXXXXXXXXXXXXXXXXXXXGXXXXXXXXXXXXXXXXXXXGXXXXXXXXXXXXXXXXXXX,0,10,0
5859,15,1,14,168,417,0,0,432,108,324,GXXXXXXXXXXXXXXXXXXXGXXXXXXXXXXXXXXXXXXXGXXXXXXXXXXXXXXXXXXXGXXXXXXXXXXXXXXXXXXXGXXXXXXXXXXXXXXXXXXXGXXXXXXXXXXXXXXXXXXXGAXXXXXXXXXXXXXXXXXXGXXXXXXXXXXXXXXXXXXXGOXXXXXXXXXXXXXXXXXXGXXXXXXXXXXXXXXXXXXXGXXXXXXXXXXXXXXXXXXXGXXXXXXXXXXXXXXXXXXXGXXXXXXXXXXXXXXXXXXX,0,10,0

5880,15,1,14,171,414,0,0,429,110,319,GXXXXXXXXXXXXXXXXXXXGXXXXXXXXXXXXXXXXXXXGXXXXXXXXXXXXXXXXXXXGXXXXXXXXXXXXXXXXXXXGXXXXXXXXXXXXXXXXXXXGXXXXXXXXXXXXXXXXXXXGAXXXXXXXXXXXXXXXXXXGXXXXXXXXXXXXXXXXXXXGOXXXXXXXXXXXXXXXXXXGXXXXXXXXXXXXXXXXXXXGXXXXXXXXXXXXXXXXXXXGXXXXXXXXXXXXXXXXXXXGXXXXXXXXXXXXXXXXXXX,0,10,0
5901,14,1,13,173,413,0,0,425,110,315,GXXXXXXXXXXXXXXXXXXXGXXXXXXXXXXXXXXXXXXXGXXXXXXXXXXXXXXXXXXXGXXXXXXXXXXXXXXXXXXXGXXXXXXXXXXXXXXXXXXXGXXXXXXXXXXXXXXXXXXXGAXXXXXXXXXXXXXXXXXXGXXXXXXXXXXXXXXXXXXXGXXXXXXXXXXXXXXXXXXXGXXXXXXXXXXXXXXXXXXXGXXXXXXXXXXXXXXXXXXXGXXXXXXXXXXXXXXXXXXXGXXXXXXXXXXXXXXXXXXX,0,10,0
5922,16,3,13,172,412,0,0,426,112,314,GXXXXXXXXXXXXXXXXXXXGXXXXXXXXXXXXXXXXXXXGXXXXXXXXXXXXXXXXXXXGXXXXXXXXXXXXXXXXXXXGXXXXXXXXXXXXXXXXXXXGAXXXXXXXXXXXXXXXXXXGAXXXXXXXXXXXXXXXXXXGXXXXXXXXXXXXXXXXXXXGXXXXXXXXXXXXXXXXXXXGXXXXXXXXXXXXXXXXXXXGAXXXXXXXXXXXXXXXXXXGXXXXXXXXXXXXXXXXXXXGXXXXXXXXXXXXXXXXXXX,0,10,0
5943,16,3,13,164,420,0,0,434,118,316,GXXXXXXXXXXXXXXXXXXXGXXXXXXXXXXXXXXXXXXXGXXXXXXXXXXXXXXXXXXXGXXXXXXXXXXXXXXXXXXXGXXXXXXXXXXXXXXXXXXXGAXXXXXXXXXXXXXXXXXXGAXXXXXXXXXXXXXXXXXXGXXXXXXXXXXXXXXXXXXXGXXXXXXXXXXXXXXXXXXXGXXXXXXXXXXXXXXXXXXXGAXXXXXXXXXXXXXXXXXXGXXXXXXXXXXXXXXXXXXXGXXXXXXXXXXXXXXXXXXX,0,10,0
5964,15,2,13,168,417,0,0,429,118,311,GXXXXXXXXXXXXXXXXXXXGXXXXXXXXXXXXXXXXXXXGXXXXXXXXXXXXXXXXXXXGXXXXXXXXXXXXXXXXXXXGXXXXXXXXXXXXXXXXXXXGAXXXXXXXXXXXXXXXXXXGAXXXXXXXXXXXXXXXXXXGXXXXXXXXXXXXXXXXXXXGXXXXXXXXXXXXXXXXXXXGXXXXXXXXXXXXXXXXXXXGXXXXXXXXXXXXXXXXXXXGXXXXXXXXXXXXXXXXXXXGXXXXXXXXXXXXXXXXXXX,0,10,0

5985,15,2,13,175,410,0,0,423,120,303,GXXXXXXXXXXXXXXXXXXXGXXXXXXXXXXXXXXXXXXXGXXXXXXXXXXXXXXXXXXXGXXXXXXXXXXXXXXXXXXXGXXXXXXXXXXXXXXXXXXXGAXXXXXXXXXXXXXXXXXXGAXXXXXXXXXXXXXXXXXXGXXXXXXXXXXXXXXXXXXXGXXXXXXXXXXXXXXXXXXXGXXXXXXXXXXXXXXXXXXXGXXXXXXXXXXXXXXXXXXXGXXXXXXXXXXXXXXXXXXXGXXXXXXXXXXXXXXXXXXX,0,10,0
6006,14,1,13,176,410,0,0,422,121,301,GXXXXXXXXXXXXXXXXXXXGXXXXXXXXXXXXXXXXXXXGXXXXXXXXXXXXXXXXXXXGXXXXXXXXXXXXXXXXXXXGXXXXXXXXXXXXXXXXXXXGAXXXXXXXXXXXXXXXXXXGXXXXXXXXXXXXXXXXXXXGXXXXXXXXXXXXXXXXXXXGXXXXXXXXXXXXXXXXXXXGXXXXXXXXXXXXXXXXXXXGXXXXXXXXXXXXXXXXXXXGXXXXXXXXXXXXXXXXXXXGXXXXXXXXXXXXXXXXXXX,0,10,0
6027,14,1,13,170,416,0,0,430,120,310,GXXXXXXXXXXXXXXXXXXXGXXXXXXXXXXXXXXXXXXXGXXXXXXXXXXXXXXXXXXXGXXXXXXXXXXXXXXXXXXXGXXXXXXXXXXXXXXXXXXXGAXXXXXXXXXXXXXXXXXXGXXXXXXXXXXXXXXXXXXXGXXXXXXXXXXXXXXXXXXXGXXXXXXXXXXXXXXXXXXXGXXXXXXXXXXXXXXXXXXXGXXXXXXXXXXXXXXXXXXXGXXXXXXXXXXXXXXXXXXXGXXXXXXXXXXXXXXXXXXX,0,10,0
6048,14,1,13,181,405,0,0,420,117,303,GXXXXXXXXXXXXXXXXXXXGXXXXXXXXXXXXXXXXXXXGXXXXXXXXXXXXXXXXXXXGXXXXXXXXXXXXXXXXXXXGXXXXXXXXXXXXXXXXXXXGAXXXXXXXXXXXXXXXXXXGXXXXXXXXXXXXXXXXXXXGXXXXXXXXXXXXXXXXXXXGXXXXXXXXXXXXXXXXXXXGXXXXXXXXXXXXXXXXXXXGXXXXXXXXXXXXXXXXXXXGXXXXXXXXXXXXXXXXXXXGXXXXXXXXXXXXXXXXXXX,0,10,0
6069,14,1,13,181,405,0,0,420,113,307,GXXXXXXXXXXXXXXXXXXXGXXXXXXXXXXXXXXXXXXXGXXXXXXXXXXXXXXXXXXXGXXXXXXXXXXXXXXXXXXXGXXXXXXXXXXXXXXXXXXXGAXXXXXXXXXXXXXXXXXXGXXXXXXXXXXXXXXXXXXXGXXXXXXXXXXXXXXXXXXXGXXXXXXXXXXXXXXXXXXXGXXXXXXXXXXXXXXXXXXXGXXXXXXXXXXXXXXXXXXXGXXXXXXXXXXXXXXXXXXXGXXXXXXXXXXXXXXXXXXX,0,10,0

6090,15,2,13,172,413,0,0,428,117,311,GXXXXXXXXXXXXXXXXXXXGXXXXXXXXXXXXXXXXXXXGXXXXXXXXXXXXXXXXXXXGXXXXXXXXXXXXXXXXXXXGAXXXXXXXXXXXXXXXXXXGAXXXXXXXXXXXXXXXXXXGXXXXXXXXXXXXXXXXXXXGXXXXXXXXXXXXXXXXXXXGXXXXXXXXXXXXXXXXXXXGXXXXXXXXXXXXXXXXXXXGXXXXXXXXXXXXXXXXXXXGXXXXXXXXXXXXXXXXXXXGXXXXXXXXXXXXXXXXXXX,0,10,0
6111,15,2,13,167,418,0,0,434,129,305,GXXXXXXXXXXXXXXXXXXXGXXXXXXXXXXXXXXXXXXXGXXXXXXXXXXXXXXXXXXXGXXXXXXXXXXXXXXXXXXXGAXXXXXXXXXXXXXXXXXXGAXXXXXXXXXXXXXXXXXXGXXXXXXXXXXXXXXXXXXXGXXXXXXXXXXXXXXXXXXXGXXXXXXXXXXXXXXXXXXXGXXXXXXXXXXXXXXXXXXXGXXXXXXXXXXXXXXXXXXXGXXXXXXXXXXXXXXXXXXXGXXXXXXXXXXXXXXXXXXX,0,10,0
6132,15,2,13,169,416,0,0,430,129,301,GXXXXXXXXXXXXXXXXXXXGXXXXXXXXXXXXXXXXXXXGXXXXXXXXXXXXXXXXXXXGXXXXXXXXXXXXXXXXXXXGAXXXXXXXXXXXXXXXXXXGAXXXXXXXXXXXXXXXXXXGXXXXXXXXXXXXXXXXXXXGXXXXXXXXXXXXXXXXXXXGXXXXXXXXXXXXXXXXXXXGXXXXXXXXXXXXXXXXXXXGXXXXXXXXXXXXXXXXXXXGXXXXXXXXXXXXXXXXXXXGXXXXXXXXXXXXXXXXXXX,0,10,0
6153,14,1,13,180,406,0,0,419,123,296,GXXXXXXXXXXXXXXXXXXXGXXXXXXXXXXXXXXXXXXXGXXXXXXXXXXXXXXXXXXXGXXXXXXXXXXXXXXXXXXXGAXXXXXXXXXXXXXXXXXXGXXXXXXXXXXXXXXXXXXXGXXXXXXXXXXXXXXXXXXXGXXXXXXXXXXXXXXXXXXXGXXXXXXXXXXXXXXXXXXXGXXXXXXXXXXXXXXXXXXXGXXXXXXXXXXXXXXXXXXXGXXXXXXXXXXXXXXXXXXXGXXXXXXXXXXXXXXXXXXX,0,10,0
6174,14,1,13,180,406,0,0,422,126,296,GXXXXXXXXXXXXXXXXXXXGXXXXXXXXXXXXXXXXXXXGXXXXXXXXXXXXXXXXXXXGXXXXXXXXXXXXXXXXXXXGAXXXXXXXXXXXXXXXXXXGXXXXXXXXXXXXXXXXXXXGXXXXXXXXXXXXXXXXXXXGXXXXXXXXXXXXXXXXXXXGXXXXXXXXXXXXXXXXXXXGXXXXXXXXXXXXXXXXXXXGXXXXXXXXXXXXXXXXXXXGXXXXXXXXXXXXXXXXXXXGXXXXXXXXXXXXXXXXXXX,0,10,0

6195,15,1,14,176,409,0,0,423,128,295,GXXXXXXXXXXXXXXXXXXXGXXXXXXXXXXXXXXXXXXXGXXXXXXXXXXXXXXXXXXXGXXXXXXXXXXXXXXXXXXXGOXXXXXXXXXXXXXXXXXXGXXXXXXXXXXXXXXXXXXXGXXXXXXXXXXXXXXXXXXXGAXXXXXXXXXXXXXXXXXXGXXXXXXXXXXXXXXXXXXXGXXXXXXXXXXXXXXXXXXXGXXXXXXXXXXXXXXXXXXXGXXXXXXXXXXXXXXXXXXXGXXXXXXXXXXXXXXXXXXX,0,10,0
6216,14,1,13,181,405,0,0,418,129,289,GXXXXXXXXXXXXXXXXXXXGXXXXXXXXXXXXXXXXXXXGXXXXXXXXXXXXXXXXXXXGXXXXXXXXXXXXXXXXXXXGXXXXXXXXXXXXXXXXXXXGXXXXXXXXXXXXXXXXXXXGXXXXXXXXXXXXXXXXXXXGAXXXXXXXXXXXXXXXXXXGXXXXXXXXXXXXXXXXXXXGXXXXXXXXXXXXXXXXXXXGXXXXXXXXXXXXXXXXXXXGXXXXXXXXXXXXXXXXXXXGXXXXXXXXXXXXXXXXXXX,0,10,0
6237,14,1,13,177,409,0,0,421,132,289,GXXXXXXXXXXXXXXXXXXXGXXXXXXXXXXXXXXXXXXXGXXXXXXXXXXXXXXXXXXXGXXXXXXXXXXXXXXXXXXXGXXXXXXXXXXXXXXXXXXXGXXXXXXXXXXXXXXXXXXXGXXXXXXXXXXXXXXXXXXXGAXXXXXXXXXXXXXXXXXXGXXXXXXXXXXXXXXXXXXXGXXXXXXXXXXXXXXXXXXXGXXXXXXXXXXXXXXXXXXXGXXXXXXXXXXXXXXXXXXXGXXXXXXXXXXXXXXXXXXX,0,10,0
6258,14,1,13,187,399,0,0,412,122,290,GXXXXXXXXXXXXXXXXXXXGXXXXXXXXXXXXXXXXXXXGXXXXXXXXXXXXXXXXXXXGXXXXXXXXXXXXXXXXXXXGXXXXXXXXXXXXXXXXXXXGXXXXXXXXXXXXXXXXXXXGXXXXXXXXXXXXXXXXXXXGAXXXXXXXXXXXXXXXXXXGXXXXXXXXXXXXXXXXXXXGXXXXXXXXXXXXXXXXXXXGXXXXXXXXXXXXXXXXXXXGXXXXXXXXXXXXXXXXXXXGXXXXXXXXXXXXXXXXXXX,0,10,0
6279,14,1,13,182,404,0,0,416,119,297,GXXXXXXXXXXXXXXXXXXXGXXXXXXXXXXXXXXXXXXXGXXXXXXXXXXXXXXXXXXXGXXXXXXXXXXXXXXXXXXXGXXXXXXXXXXXXXXXXXXXGXXXXXXXXXXXXXXXXXXXGXXXXXXXXXXXXXXXXXXXGAXXXXXXXXXXXXXXXXXXGXXXXXXXXXXXXXXXXXXXGXXXXXXXXXXXXXXXXXXXGXXXXXXXXXXXXXXXXXXXGXXXXXXXXXXXXXXXXXXXGXXXXXXXXXXXXXXXXXXX,0,10,0

6300,14,1,13,173,413,0,0,426,122,304,GXXXXXXXXXXXXXXXXXXXGXXXXXXXXXXXXXXXXXXXGXXXXXXXXXXXXXXXXXXXGXXXXXXXXXXXXXXXXXXXGXXXXXXXXXXXXXXXXXXXGXXXXXXXXXXXXXXXXXXXGXXXXXXXXXXXXXXXXXXXGAXXXXXXXXXXXXXXXXXXGXXXXXXXXXXXXXXXXXXXGXXXXXXXXXXXXXXXXXXXGXXXXXXXXXXXXXXXXXXXGXXXXXXXXXXXXXXXXXXXGXXXXXXXXXXXXXXXXXXX,0,10,0
6321,14,1,13,174,412,0,0,425,124,301,GXXXXXXXXXXXXXXXXXXXGXXXXXXXXXXXXXXXXXXXGXXXXXXXXXXXXXXXXXXXGXXXXXXXXXXXXXXXXXXXGXXXXXXXXXXXXXXXXXXXGXXXXXXXXXXXXXXXXXXXGXXXXXXXXXXXXXXXXXXXGAXXXXXXXXXXXXXXXXXXGXXXXXXXXXXXXXXXXXXXGXXXXXXXXXXXXXXXXXXXGXXXXXXXXXXXXXXXXXXXGXXXXXXXXXXXXXXXXXXXGXXXXXXXXXXXXXXXXXXX,0,10,0
6342,14,1,13,171,415,0,0,429,129,300,GXXXXXXXXXXXXXXXXXXXGXXXXXXXXXXXXXXXXXXXGXXXXXXXXXXXXXXXXXXXGXXXXXXXXXXXXXXXXXXXGXXXXXXXXXXXXXXXXXXXGXXXXXXXXXXXXXXXXXXXGXXXXXXXXXXXXXXXXXXXGAXXXXXXXXXXXXXXXXXXGXXXXXXXXXXXXXXXXXXXGXXXXXXXXXXXXXXXXXXXGXXXXXXXXXXXXXXXXXXXGXXXXXXXXXXXXXXXXXXXGXXXXXXXXXXXXXXXXXXX,0,10,0
6363,14,1,13,168,418,0,0,432,129,303,GXXXXXXXXXXXXXXXXXXXGXXXXXXXXXXXXXXXXXXXGAXXXXXXXXXXXXXXXXXXGXXXXXXXXXXXXXXXXXXXGXXXXXXXXXXXXXXXXXXXGXXXXXXXXXXXXXXXXXXXGXXXXXXXXXXXXXXXXXXXGXXXXXXXXXXXXXXXXXXXGXXXXXXXXXXXXXXXXXXXGXXXXXXXXXXXXXXXXXXXGXXXXXXXXXXXXXXXXXXXGXXXXXXXXXXXXXXXXXXXGXXXXXXXXXXXXXXXXXXX,0,10,0
6384,14,1,13,181,405,0,0,416,120,296,GXXXXXXXXXXXXXXXXXXXGXXXXXXXXXXXXXXXXXXXGAXXXXXXXXXXXXXXXXXXGXXXXXXXXXXXXXXXXXXXGXXXXXXXXXXXXXXXXXXXGXXXXXXXXXXXXXXXXXXXGXXXXXXXXXXXXXXXXXXXGXXXXXXXXXXXXXXXXXXXGXXXXXXXXXXXXXXXXXXXGXXXXXXXXXXXXXXXXXXXGXXXXXXXXXXXXXXXXXXXGXXXXXXXXXXXXXXXXXXXGXXXXXXXXXXXXXXXXXXX,0,10,0

6405,13,0,13,186,401,0,0,416,116,300,GXXXXXXXXXXXXXXXXXXXGXXXXXXXXXXXXXXXXXXXGXXXXXXXXXXXXXXXXXXXGXXXXXXXXXXXXXXXXXXXGXXXXXXXXXXXXXXXXXXXGXXXXXXXXXXXXXXXXXXXGXXXXXXXXXXXXXXXXXXXGXXXXXXXXXXXXXXXXXXXGXXXXXXXXXXXXXXXXXXXGXXXXXXXXXXXXXXXXXXXGXXXXXXXXXXXXXXXXXXXGXXXXXXXXXXXXXXXXXXXGXXXXXXXXXXXXXXXXXXX,0,10,0
6426,13,0,13,186,401,0,0,413,116,297,GXXXXXXXXXXXXXXXXXXXGXXXXXXXXXXXXXXXXXXXGXXXXXXXXXXXXXXXXXXXGXXXXXXXXXXXXXXXXXXXGXXXXXXXXXXXXXXXXXXXGXXXXXXXXXXXXXXXXXXXGXXXXXXXXXXXXXXXXXXXGXXXXXXXXXXXXXXXXXXXGXXXXXXXXXXXXXXXXXXXGXXXXXXXXXXXXXXXXXXXGXXXXXXXXXXXXXXXXXXXGXXXXXXXXXXXXXXXXXXXGXXXXXXXXXXXXXXXXXXX,0,10,0
6447,13,0,13,185,402,0,0,414,125,289,GXXXXXXXXXXXXXXXXXXXGXXXXXXXXXXXXXXXXXXXGXXXXXXXXXXXXXXXXXXXGXXXXXXXXXXXXXXXXXXXGXXXXXXXXXXXXXXXXXXXGXXXXXXXXXXXXXXXXXXXGXXXXXXXXXXXXXXXXXXXGXXXXXXXXXXXXXXXXXXXGXXXXXXXXXXXXXXXXXXXGXXXXXXXXXXXXXXXXXXXGXXXXXXXXXXXXXXXXXXXGXXXXXXXXXXXXXXXXXXXGXXXXXXXXXXXXXXXXXXX,0,10,0
6468,13,0,13,191,396,0,0,410,121,289,GXXXXXXXXXXXXXXXXXXXGXXXXXXXXXXXXXXXXXXXGXXXXXXXXXXXXXXXXXXXGXXXXXXXXXXXXXXXXXXXGXXXXXXXXXXXXXXXXXXXGXXXXXXXXXXXXXXXXXXXGXXXXXXXXXXXXXXXXXXXGXXXXXXXXXXXXXXXXXXXGXXXXXXXXXXXXXXXXXXXGXXXXXXXXXXXXXXXXXXXGXXXXXXXXXXXXXXXXXXXGXXXXXXXXXXXXXXXXXXXGXXXXXXXXXXXXXXXXXXX,0,10,0
6489,13,0,13,189,398,0,0,412,122,290,GXXXXXXXXXXXXXXXXXXXGXXXXXXXXXXXXXXXXXXXGXXXXXXXXXXXXXXXXXXXGXXXXXXXXXXXXXXXXXXXGXXXXXXXXXXXXXXXXXXXGXXXXXXXXXXXXXXXXXXXGXXXXXXXXXXXXXXXXXXXGXXXXXXXXXXXXXXXXXXXGXXXXXXXXXXXXXXXXXXXGXXXXXXXXXXXXXXXXXXXGXXXXXXXXXXXXXXXXXXXGXXXXXXXXXXXXXXXXXXXGXXXXXXXXXXXXXXXXXXX,0,10,0

6510,13,0,13,188,399,0,0,408,126,282,GXXXXXXXXXXXXXXXXXXXGXXXXXXXXXXXXXXXXXXXGXXXXXXXXXXXXXXXXXXXGXXXXXXXXXXXXXXXXXXXGXXXXXXXXXXXXXXXXXXXGXXXXXXXXXXXXXXXXXXXGXXXXXXXXXXXXXXXXXXXGXXXXXXXXXXXXXXXXXXXGXXXXXXXXXXXXXXXXXXXGXXXXXXXXXXXXXXXXXXXGXXXXXXXXXXXXXXXXXXXGXXXXXXXXXXXXXXXXXXXGXXXXXXXXXXXXXXXXXXX,0,10,0
6531,13,0,13,185,402,0,0,414,132,282,GXXXXXXXXXXXXXXXXXXXGXXXXXXXXXXXXXXXXXXXGXXXXXXXXXXXXXXXXXXXGXXXXXXXXXXXXXXXXXXXGXXXXXXXXXXXXXXXXXXXGXXXXXXXXXXXXXXXXXXXGXXXXXXXXXXXXXXXXXXXGXXXXXXXXXXXXXXXXXXXGXXXXXXXXXXXXXXXXXXXGXXXXXXXXXXXXXXXXXXXGXXXXXXXXXXXXXXXXXXXGXXXXXXXXXXXXXXXXXXXGXXXXXXXXXXXXXXXXXXX,0,10,0
6552,13,0,13,183,404,0,0,415,135,280,GXXXXXXXXXXXXXXXXXXXGXXXXXXXXXXXXXXXXXXXGXXXXXXXXXXXXXXXXXXXGXXXXXXXXXXXXXXXXXXXGXXXXXXXXXXXXXXXXXXXGXXXXXXXXXXXXXXXXXXXGXXXXXXXXXXXXXXXXXXXGXXXXXXXXXXXXXXXXXXXGXXXXXXXXXXXXXXXXXXXGXXXXXXXXXXXXXXXXXXXGXXXXXXXXXXXXXXXXXXXGXXXXXXXXXXXXXXXXXXXGXXXXXXXXXXXXXXXXXXX,0,10,0
6573,13,0,13,183,404,0,0,416,124,292,GXXXXXXXXXXXXXXXXXXXGXXXXXXXXXXXXXXXXXXXGXXXXXXXXXXXXXXXXXXXGXXXXXXXXXXXXXXXXXXXGXXXXXXXXXXXXXXXXXXXGXXXXXXXXXXXXXXXXXXXGXXXXXXXXXXXXXXXXXXXGXXXXXXXXXXXXXXXXXXXGXXXXXXXXXXXXXXXXXXXGXXXXXXXXXXXXXXXXXXXGXXXXXXXXXXXXXXXXXXXGXXXXXXXXXXXXXXXXXXXGXXXXXXXXXXXXXXXXXXX,0,10,0
6594,13,0,13,180,407,0,0,420,124,296,GXXXXXXXXXXXXXXXXXXXGXXXXXXXXXXXXXXXXXXXGXXXXXXXXXXXXXXXXXXXGXXXXXXXXXXXXXXXXXXXGXXXXXXXXXXXXXXXXXXXGXXXXXXXXXXXXXXXXXXXGXXXXXXXXXXXXXXXXXXXGXXXXXXXXXXXXXXXXXXXGXXXXXXXXXXXXXXXXXXXGXXXXXXXXXXXXXXXXXXXGXXXXXXXXXXXXXXXXXXXGXXXXXXXXXXXXXXXXXXXGXXXXXXXXXXXXXXXXXXX,0,10,0

6615,13,0,13,175,412,0,0,426,122,304,GXXXXXXXXXXXXXXXXXXXGXXXXXXXXXXXXXXXXXXXGXXXXXXXXXXXXXXXXXXXGXXXXXXXXXXXXXXXXXXXGXXXXXXXXXXXXXXXXXXXGXXXXXXXXXXXXXXXXXXXGXXXXXXXXXXXXXXXXXXXGXXXXXXXXXXXXXXXXXXXGXXXXXXXXXXXXXXXXXXXGXXXXXXXXXXXXXXXXXXXGXXXXXXXXXXXXXXXXXXXGXXXXXXXXXXXXXXXXXXXGXXXXXXXXXXXXXXXXXXX,0,10,0
6636,13,0,13,171,416,0,0,431,125,306,GXXXXXXXXXXXXXXXXXXXGXXXXXXXXXXXXXXXXXXXGXXXXXXXXXXXXXXXXXXXGXXXXXXXXXXXXXXXXXXXGXXXXXXXXXXXXXXXXXXXGXXXXXXXXXXXXXXXXXXXGXXXXXXXXXXXXXXXXXXXGXXXXXXXXXXXXXXXXXXXGXXXXXXXXXXXXXXXXXXXGXXXXXXXXXXXXXXXXXXXGXXXXXXXXXXXXXXXXXXXGXXXXXXXXXXXXXXXXXXXGXXXXXXXXXXXXXXXXXXX,0,10,0
6657,14,1,13,166,420,0,0,434,130,304,GXXXXXXXXXXXXXXXXXXXGXXXXXXXXXXXXXXXXXXXGXXXXXXXXXXXXXXXXXXXGAXXXXXXXXXXXXXXXXXXGXXXXXXXXXXXXXXXXXXXGXXXXXXXXXXXXXXXXXXXGXXXXXXXXXXXXXXXXXXXGXXXXXXXXXXXXXXXXXXXGXXXXXXXXXXXXXXXXXXXGXXXXXXXXXXXXXXXXXXXGXXXXXXXXXXXXXXXXXXXGXXXXXXXXXXXXXXXXXXXGXXXXXXXXXXXXXXXXXXX,0,10,0
6678,14,1,13,169,417,0,0,431,132,299,GXXXXXXXXXXXXXXXXXXXGXXXXXXXXXXXXXXXXXXXGXXXXXXXXXXXXXXXXXXXGAXXXXXXXXXXXXXXXXXXGXXXXXXXXXXXXXXXXXXXGXXXXXXXXXXXXXXXXXXXGXXXXXXXXXXXXXXXXXXXGXXXXXXXXXXXXXXXXXXXGXXXXXXXXXXXXXXXXXXXGXXXXXXXXXXXXXXXXXXXGXXXXXXXXXXXXXXXXXXXGXXXXXXXXXXXXXXXXXXXGXXXXXXXXXXXXXXXXXXX,0,10,0
6699,15,2,13,165,420,0,0,435,125,310,GXXXXXXXXXXXXXXXXXXXGXXXXXXXXXXXXXXXXXXXGXXXXXXXXXXXXXXXXXXXGAAXXXXXXXXXXXXXXXXXGXXXXXXXXXXXXXXXXXXXGXXXXXXXXXXXXXXXXXXXGXXXXXXXXXXXXXXXXXXXGXXXXXXXXXXXXXXXXXXXGXXXXXXXXXXXXXXXXXXXGXXXXXXXXXXXXXXXXXXXGXXXXXXXXXXXXXXXXXXXGXXXXXXXXXXXXXXXXXXXGXXXXXXXXXXXXXXXXXXX,0,10,0

6720,15,2,13,158,427,0,0,441,133,308,GXXXXXXXXXXXXXXXXXXXGXXXXXXXXXXXXXXXXXXXGXXXXXXXXXXXXXXXXXXXGAAXXXXXXXXXXXXXXXXXGXXXXXXXXXXXXXXXXXXXGXXXXXXXXXXXXXXXXXXXGXXXXXXXXXXXXXXXXXXXGXXXXXXXXXXXXXXXXXXXGXXXXXXXXXXXXXXXXXXXGXXXXXXXXXXXXXXXXXXXGXXXXXXXXXXXXXXXXXXXGXXXXXXXXXXXXXXXXXXXGXXXXXXXXXXXXXXXXXXX,0,10,0
6741,15,2,13,167,418,0,0,433,136,297,GXXXXXXXXXXXXXXXXXXXGXXXXXXXXXXXXXXXXXXXGXXXXXXXXXXXXXXXXXXXGAAXXXXXXXXXXXXXXXXXGXXXXXXXXXXXXXXXXXXXGXXXXXXXXXXXXXXXXXXXGXXXXXXXXXXXXXXXXXXXGXXXXXXXXXXXXXXXXXXXGXXXXXXXXXXXXXXXXXXXGXXXXXXXXXXXXXXXXXXXGXXXXXXXXXXXXXXXXXXXGXXXXXXXXXXXXXXXXXXXGXXXXXXXXXXXXXXXXXXX,0,10,0
6762,15,2,13,168,417,0,0,432,134,298,GXXXXXXXXXXXXXXXXXXXGXXXXXXXXXXXXXXXXXXXGXXXXXXXXXXXXXXXXXXXGAAXXXXXXXXXXXXXXXXXGXXXXXXXXXXXXXXXXXXXGXXXXXXXXXXXXXXXXXXXGXXXXXXXXXXXXXXXXXXXGXXXXXXXXXXXXXXXXXXXGXXXXXXXXXXXXXXXXXXXGXXXXXXXXXXXXXXXXXXXGXXXXXXXXXXXXXXXXXXXGXXXXXXXXXXXXXXXXXXXGXXXXXXXXXXXXXXXXXXX,0,10,0
6783,16,3,13,161,423,0,0,440,128,312,GXXXXXXXXXXXXXXXXXXXGXXXXXXXXXXXXXXXXXXXGXXXXXXXXXXXXXXXXXXXGAAXXXXXXXXXXXXXXXXXGXXXXXXXXXXXXXXXXXXXGAXXXXXXXXXXXXXXXXXXGXXXXXXXXXXXXXXXXXXXGXXXXXXXXXXXXXXXXXXXGXXXXXXXXXXXXXXXXXXXGXXXXXXXXXXXXXXXXXXXGXXXXXXXXXXXXXXXXXXXGXXXXXXXXXXXXXXXXXXXGXXXXXXXXXXXXXXXXXXX,0,10,0
6804,16,3,13,163,421,0,0,438,127,311,GXXXXXXXXXXXXXXXXXXXGXXXXXXXXXXXXXXXXXXXGXXXXXXXXXXXXXXXXXXXGAAXXXXXXXXXXXXXXXXXGXXXXXXXXXXXXXXXXXXXGAXXXXXXXXXXXXXXXXXXGXXXXXXXXXXXXXXXXXXXGXXXXXXXXXXXXXXXXXXXGXXXXXXXXXXXXXXXXXXXGXXXXXXXXXXXXXXXXXXXGXXXXXXXXXXXXXXXXXXXGXXXXXXXXXXXXXXXXXXXGXXXXXXXXXXXXXXXXXXX,0,10,0

6825,16,3,13,168,416,0,0,431,125,306,GXXXXXXXXXXXXXXXXXXXGXXXXXXXXXXXXXXXXXXXGXXXXXXXXXXXXXXXXXXXGAAXXXXXXXXXXXXXXXXXGXXXXXXXXXXXXXXXXXXXGAXXXXXXXXXXXXXXXXXXGXXXXXXXXXXXXXXXXXXXGXXXXXXXXXXXXXXXXXXXGXXXXXXXXXXXXXXXXXXXGXXXXXXXXXXXXXXXXXXXGXXXXXXXXXXXXXXXXXXXGXXXXXXXXXXXXXXXXXXXGXXXXXXXXXXXXXXXXXXX,0,10,0
6846,16,3,13,173,411,0,0,425,126,299,GXXXXXXXXXXXXXXXXXXXGXXXXXXXXXXXXXXXXXXXGXXXXXXXXXXXXXXXXXXXGAAXXXXXXXXXXXXXXXXXGXXXXXXXXXXXXXXXXXXXGAXXXXXXXXXXXXXXXXXXGXXXXXXXXXXXXXXXXXXXGXXXXXXXXXXXXXXXXXXXGXXXXXXXXXXXXXXXXXXXGXXXXXXXXXXXXXXXXXXXGXXXXXXXXXXXXXXXXXXXGXXXXXXXXXXXXXXXXXXXGXXXXXXXXXXXXXXXXXXX,0,10,0
6867,16,3,13,165,419,0,0,433,131,302,GXXXXXXXXXXXXXXXXXXXGXXXXXXXXXXXXXXXXXXXGXXXXXXXXXXXXXXXXXXXGAAXXXXXXXXXXXXXXXXXGXXXXXXXXXXXXXXXXXXXGAXXXXXXXXXXXXXXXXXXGXXXXXXXXXXXXXXXXXXXGXXXXXXXXXXXXXXXXXXXGXXXXXXXXXXXXXXXXXXXGXXXXXXXXXXXXXXXXXXXGXXXXXXXXXXXXXXXXXXXGXXXXXXXXXXXXXXXXXXXGXXXXXXXXXXXXXXXXXXX,0,10,0
6888,16,3,13,165,419,0,0,433,124,309,GXXXXXXXXXXXXXXXXXXXGXXXXXXXXXXXXXXXXXXXGXXXXXXXXXXXXXXXXXXXGAAXXXXXXXXXXXXXXXXXGXXXXXXXXXXXXXXXXXXXGAXXXXXXXXXXXXXXXXXXGXXXXXXXXXXXXXXXXXXXGXXXXXXXXXXXXXXXXXXXGXXXXXXXXXXXXXXXXXXXGXXXXXXXXXXXXXXXXXXXGXXXXXXXXXXXXXXXXXXXGXXXXXXXXXXXXXXXXXXXGXXXXXXXXXXXXXXXXXXX,0,10,0
6909,16,2,14,161,423,0,0,436,128,308,GXXXXXXXXXXXXXXXXXXXGXXXXXXXXXXXXXXXXXXXGXXXXXXXXXXXXXXXXXXXGOAXXXXXXXXXXXXXXXXXGXXXXXXXXXXXXXXXXXXXGAXXXXXXXXXXXXXXXXXXGXXXXXXXXXXXXXXXXXXXGXXXXXXXXXXXXXXXXXXXGXXXXXXXXXXXXXXXXXXXGXXXXXXXXXXXXXXXXXXXGXXXXXXXXXXXXXXXXXXXGXXXXXXXXXXXXXXXXXXXGXXXXXXXXXXXXXXXXXXX,0,10,0

6930,15,2,13,149,436,0,0,447,136,311,GXXXXXXXXXXXXXXXXXXXGXXXXXXXXXXXXXXXXXXXGXXXXXXXXXXXXXXXXXXXGXAXXXXXXXXXXXXXXXXXGXXXXXXXXXXXXXXXXXXXGAXXXXXXXXXXXXXXXXXXGXXXXXXXXXXXXXXXXXXXGXXXXXXXXXXXXXXXXXXXGXXXXXXXXXXXXXXXXXXXGXXXXXXXXXXXXXXXXXXXGXXXXXXXXXXXXXXXXXXXGXXXXXXXXXXXXXXXXXXXGXXXXXXXXXXXXXXXXXXX,0,10,0
6951,14,1,13,157,429,0,0,442,137,305,GXXXXXXXXXXXXXXXXXXXGXXXXXXXXXXXXXXXXXXXGXXXXXXXXXXXXXXXXXXXGXXXXXXXXXXXXXXXXXXXGXXXXXXXXXXXXXXXXXXXGAXXXXXXXXXXXXXXXXXXGXXXXXXXXXXXXXXXXXXXGXXXXXXXXXXXXXXXXXXXGXXXXXXXXXXXXXXXXXXXGXXXXXXXXXXXXXXXXXXXGXXXXXXXXXXXXXXXXXXXGXXXXXXXXXXXXXXXXXXXGXXXXXXXXXXXXXXXXXXX,0,10,0
6972,14,1,13,156,430,0,0,443,145,298,GXXXXXXXXXXXXXXXXXXXGXXXXXXXXXXXXXXXXXXXGXXXXXXXXXXXXXXXXXXXGXXXXXXXXXXXXXXXXXXXGXXXXXXXXXXXXXXXXXXXGAXXXXXXXXXXXXXXXXXXGXXXXXXXXXXXXXXXXXXXGXXXXXXXXXXXXXXXXXXXGXXXXXXXXXXXXXXXXXXXGXXXXXXXXXXXXXXXXXXXGXXXXXXXXXXXXXXXXXXXGXXXXXXXXXXXXXXXXXXXGXXXXXXXXXXXXXXXXXXX,0,10,0
6993,14,1,13,163,423,0,0,434,140,294,GXXXXXXXXXXXXXXXXXXXGXXXXXXXXXXXXXXXXXXXGXXXXXXXXXXXXXXXXXXXGXXXXXXXXXXXXXXXXXXXGXXXXXXXXXXXXXXXXXXXGAXXXXXXXXXXXXXXXXXXGXXXXXXXXXXXXXXXXXXXGXXXXXXXXXXXXXXXXXXXGXXXXXXXXXXXXXXXXXXXGXXXXXXXXXXXXXXXXXXXGXXXXXXXXXXXXXXXXXXXGXXXXXXXXXXXXXXXXXXXGXXXXXXXXXXXXXXXXXXX,0,10,0
7014,14,1,13,170,416,0,0,429,143,286,GXXXXXXXXXXXXXXXXXXXGXXXXXXXXXXXXXXXXXXXGXXXXXXXXXXXXXXXXXXXGXXXXXXXXXXXXXXXXXXXGXXXXXXXXXXXXXXXXXXXGAXXXXXXXXXXXXXXXXXXGXXXXXXXXXXXXXXXXXXXGXXXXXXXXXXXXXXXXXXXGXXXXXXXXXXXXXXXXXXXGXXXXXXXXXXXXXXXXXXXGXXXXXXXXXXXXXXXXXXXGXXXXXXXXXXXXXXXXXXXGXXXXXXXXXXXXXXXXXXX,0,10,0

7035,14,1,13,171,415,0,0,428,139,289,GXXXXXXXXXXXXXXXXXXXGXXXXXXXXXXXXXXXXXXXGXXXXXXXXXXXXXXXXXXXGXXXXXXXXXXXXXXXXXXXGXXXXXXXXXXXXXXXXXXXGAXXXXXXXXXXXXXXXXXXGXXXXXXXXXXXXXXXXXXXGXXXXXXXXXXXXXXXXXXXGXXXXXXXXXXXXXXXXXXXGXXXXXXXXXXXXXXXXXXXGXXXXXXXXXXXXXXXXXXXGXXXXXXXXXXXXXXXXXXXGXXXXXXXXXXXXXXXXXXX,0,10,0
7056,14,1,13,188,398,0,0,412,136,276,GXXXXXXXXXXXXXXXXXXXGXXXXXXXXXXXXXXXXXXXGXXXXXXXXXXXXXXXXXXXGXXXXXXXXXXXXXXXXXXXGXXXXXXXXXXXXXXXXXXXGAXXXXXXXXXXXXXXXXXXGXXXXXXXXXXXXXXXXXXXGXXXXXXXXXXXXXXXXXXXGXXXXXXXXXXXXXXXXXXXGXXXXXXXXXXXXXXXXXXXGXXXXXXXXXXXXXXXXXXXGXXXXXXXXXXXXXXXXXXXGXXXXXXXXXXXXXXXXXXX,0,10,0
7077,14,1,13,197,389,0,0,403,130,273,GXXXXXXXXXXXXXXXXXXXGXXXXXXXXXXXXXXXXXXXGXXXXXXXXXXXXXXXXXXXGXXXXXXXXXXXXXXXXXXXGXXXXXXXXXXXXXXXXXXXGAXXXXXXXXXXXXXXXXXXGXXXXXXXXXXXXXXXXXXXGXXXXXXXXXXXXXXXXXXXGXXXXXXXXXXXXXXXXXXXGXXXXXXXXXXXXXXXXXXXGXXXXXXXXXXXXXXXXXXXGXXXXXXXXXXXXXXXXXXXGXXXXXXXXXXXXXXXXXXX,0,10,0
7098,14,0,14,195,391,0,0,404,125,279,GXXXXXXXXXXXXXXXXXXXGXXXXXXXXXXXXXXXXXXXGXXXXXXXXXXXXXXXXXXXGXXXXXXXXXXXXXXXXXXXGXXXXXXXXXXXXXXXXXXXGOXXXXXXXXXXXXXXXXXXGXXXXXXXXXXXXXXXXXXXGXXXXXXXXXXXXXXXXXXXGXXXXXXXXXXXXXXXXXXXGXXXXXXXXXXXXXXXXXXXGXXXXXXXXXXXXXXXXXXXGXXXXXXXXXXXXXXXXXXXGXXXXXXXXXXXXXXXXXXX,0,10,0
7119,13,0,13,194,393,0,0,407,127,280,GXXXXXXXXXXXXXXXXXXXGXXXXXXXXXXXXXXXXXXXGXXXXXXXXXXXXXXXXXXXGXXXXXXXXXXXXXXXXXXXGXXXXXXXXXXXXXXXXXXXGXXXXXXXXXXXXXXXXXXXGXXXXXXXXXXXXXXXXXXXGXXXXXXXXXXXXXXXXXXXGXXXXXXXXXXXXXXXXXXXGXXXXXXXXXXXXXXXXXXXGXXXXXXXXXXXXXXXXXXXGXXXXXXXXXXXXXXXXXXXGXXXXXXXXXXXXXXXXXXX,0,10,0

7140,13,0,13,192,395,0,0,407,131,276,GXXXXXXXXXXXXXXXXXXXGXXXXXXXXXXXXXXXXXXXGXXXXXXXXXXXXXXXXXXXGXXXXXXXXXXXXXXXXXXXGXXXXXXXXXXXXXXXXXXXGXXXXXXXXXXXXXXXXXXXGXXXXXXXXXXXXXXXXXXXGXXXXXXXXXXXXXXXXXXXGXXXXXXXXXXXXXXXXXXXGXXXXXXXXXXXXXXXXXXXGXXXXXXXXXXXXXXXXXXXGXXXXXXXXXXXXXXXXXXXGXXXXXXXXXXXXXXXXXXX,0,10,0
7161,13,0,13,186,401,0,0,413,139,274,GXXXXXXXXXXXXXXXXXXXGXXXXXXXXXXXXXXXXXXXGXXXXXXXXXXXXXXXXXXXGXXXXXXXXXXXXXXXXXXXGXXXXXXXXXXXXXXXXXXXGXXXXXXXXXXXXXXXXXXXGXXXXXXXXXXXXXXXXXXXGXXXXXXXXXXXXXXXXXXXGXXXXXXXXXXXXXXXXXXXGXXXXXXXXXXXXXXXXXXXGXXXXXXXXXXXXXXXXXXXGXXXXXXXXXXXXXXXXXXXGXXXXXXXXXXXXXXXXXXX,0,10,0
7182,13,0,13,195,392,0,0,407,130,277,GXXXXXXXXXXXXXXXXXXXGXXXXXXXXXXXXXXXXXXXGXXXXXXXXXXXXXXXXXXXGXXXXXXXXXXXXXXXXXXXGXXXXXXXXXXXXXXXXXXXGXXXXXXXXXXXXXXXXXXXGXXXXXXXXXXXXXXXXXXXGXXXXXXXXXXXXXXXXXXXGXXXXXXXXXXXXXXXXXXXGXXXXXXXXXXXXXXXXXXXGXXXXXXXXXXXXXXXXXXXGXXXXXXXXXXXXXXXXXXXGXXXXXXXXXXXXXXXXXXX,0,10,0
7203,13,0,13,198,389,0,0,404,131,273,GXXXXXXXXXXXXXXXXXXXGXXXXXXXXXXXXXXXXXXXGXXXXXXXXXXXXXXXXXXXGXXXXXXXXXXXXXXXXXXXGXXXXXXXXXXXXXXXXXXXGXXXXXXXXXXXXXXXXXXXGXXXXXXXXXXXXXXXXXXXGXXXXXXXXXXXXXXXXXXXGXXXXXXXXXXXXXXXXXXXGXXXXXXXXXXXXXXXXXXXGXXXXXXXXXXXXXXXXXXXGXXXXXXXXXXXXXXXXXXXGXXXXXXXXXXXXXXXXXXX,0,10,0
7224,13,0,13,197,390,0,0,404,123,281,GXXXXXXXXXXXXXXXXXXXGXXXXXXXXXXXXXXXXXXXGXXXXXXXXXXXXXXXXXXXGXXXXXXXXXXXXXXXXXXXGXXXXXXXXXXXXXXXXXXXGXXXXXXXXXXXXXXXXXXXGXXXXXXXXXXXXXXXXXXXGXXXXXXXXXXXXXXXXXXXGXXXXXXXXXXXXXXXXXXXGXXXXXXXXXXXXXXXXXXXGXXXXXXXXXXXXXXXXXXXGXXXXXXXXXXXXXXXXXXXGXXXXXXXXXXXXXXXXXXX,0,10,0

7245,14,1,13,183,403,0,0,418,128,290,GXXXXXXXXXXXXXXXXXXXGXXXXXXXXXXXXXXXXXXXGXXXXXXXXXXXXXXXXXXXGXXXXXXXXXXXXXXXXXXXGXXXXXXXXXXXXXXXXXXXGXXXXXXXXXXXXXXXXXXXGXXXXXXXXXXXXXXXXXXXGXXXXXXXXXXXXXXXXXXXGAXXXXXXXXXXXXXXXXXXGXXXXXXXXXXXXXXXXXXXGXXXXXXXXXXXXXXXXXXXGXXXXXXXXXXXXXXXXXXXGXXXXXXXXXXXXXXXXXXX,0,10,0
7266,14,0,14,186,400,0,0,415,130,285,GXXXXXXXXXXXXXXXXXXXGXXXXXXXXXXXXXXXXXXXGXXXXXXXXXXXXXXXXXXXGXXXXXXXXXXXXXXXXXXXGXXXXXXXXXXXXXXXXXXXGXXXXXXXXXXXXXXXXXXXGXXXXXXXXXXXXXXXXXXXGXXXXXXXXXXXXXXXXXXXGOXXXXXXXXXXXXXXXXXXGXXXXXXXXXXXXXXXXXXXGXXXXXXXXXXXXXXXXXXXGXXXXXXXXXXXXXXXXXXXGXXXXXXXXXXXXXXXXXXX,0,10,0
7287,14,0,14,190,396,0,0,411,128,283,GXXXXXXXXXXXXXXXXXXXGXXXXXXXXXXXXXXXXXXXGXXXXXXXXXXXXXXXXXXXGXXXXXXXXXXXXXXXXXXXGXXXXXXXXXXXXXXXXXXXGXXXXXXXXXXXXXXXXXXXGXXXXXXXXXXXXXXXXXXXGXXXXXXXXXXXXXXXXXXXGOXXXXXXXXXXXXXXXXXXGXXXXXXXXXXXXXXXXXXXGXXXXXXXXXXXXXXXXXXXGXXXXXXXXXXXXXXXXXXXGXXXXXXXXXXXXXXXXXXX,0,10,0
7308,13,0,13,186,401,0,0,416,125,291,GXXXXXXXXXXXXXXXXXXXGXXXXXXXXXXXXXXXXXXXGXXXXXXXXXXXXXXXXXXXGXXXXXXXXXXXXXXXXXXXGXXXXXXXXXXXXXXXXXXXGXXXXXXXXXXXXXXXXXXXGXXXXXXXXXXXXXXXXXXXGXXXXXXXXXXXXXXXXXXXGXXXXXXXXXXXXXXXXXXXGXXXXXXXXXXXXXXXXXXXGXXXXXXXXXXXXXXXXXXXGXXXXXXXXXXXXXXXXXXXGXXXXXXXXXXXXXXXXXXX,0,10,0
7329,13,0,13,178,409,0,0,422,128,294,GXXXXXXXXXXXXXXXXXXXGXXXXXXXXXXXXXXXXXXXGXXXXXXXXXXXXXXXXXXXGXXXXXXXXXXXXXXXXXXXGXXXXXXXXXXXXXXXXXXXGXXXXXXXXXXXXXXXXXXXGXXXXXXXXXXXXXXXXXXXGXXXXXXXXXXXXXXXXXXXGXXXXXXXXXXXXXXXXXXXGXXXXXXXXXXXXXXXXXXXGXXXXXXXXXXXXXXXXXXXGXXXXXXXXXXXXXXXXXXXGXXXXXXXXXXXXXXXXXXX,0,10,0

7350,14,0,14,170,416,0,0,432,136,296,GXXXXXXXXXXXXXXXXXXXGXXXXXXXXXXXXXXXXXXXGXXXXXXXXXXXXXXXXXXXGXXXXXXXXXXXXXXXXXXXGXXXXXXXXXXXXXXXXXXXGXXXXXXXXXXXXXXXXXXXGXXXXXXXXXXXXXXXXXXXGXXXXXXXXXXXXXXXXXXXGOXXXXXXXXXXXXXXXXXXGXXXXXXXXXXXXXXXXXXXGXXXXXXXXXXXXXXXXXXXGXXXXXXXXXXXXXXXXXXXGXXXXXXXXXXXXXXXXXXX,0,10,0
7371,14,1,13,173,413,0,0,429,135,294,GXXXXXXXXXXXXXXXXXXXGXXXXXXXXXXXXXXXXXXXGXXXXXXXXXXXXXXXXXXXGXXXXXXXXXXXXXXXXXXXGXXXXXXXXXXXXXXXXXXXGAXXXXXXXXXXXXXXXXXXGXXXXXXXXXXXXXXXXXXXGXXXXXXXXXXXXXXXXXXXGXXXXXXXXXXXXXXXXXXXGXXXXXXXXXXXXXXXXXXXGXXXXXXXXXXXXXXXXXXXGXXXXXXXXXXXXXXXXXXXGXXXXXXXXXXXXXXXXXXX,0,10,0
7392,14,0,14,176,410,0,0,422,134,288,GXXXXXXXXXXXXXXXXXXXGXXXXXXXXXXXXXXXXXXXGXXXXXXXXXXXXXXXXXXXGXXXXXXXXXXXXXXXXXXXGXXXXXXXXXXXXXXXXXXXGOXXXXXXXXXXXXXXXXXXGXXXXXXXXXXXXXXXXXXXGXXXXXXXXXXXXXXXXXXXGXXXXXXXXXXXXXXXXXXXGXXXXXXXXXXXXXXXXXXXGXXXXXXXXXXXXXXXXXXXGXXXXXXXXXXXXXXXXXXXGXXXXXXXXXXXXXXXXXXX,0,10,0
7413,13,0,13,180,407,0,0,420,133,287,GXXXXXXXXXXXXXXXXXXXGXXXXXXXXXXXXXXXXXXXGXXXXXXXXXXXXXXXXXXXGXXXXXXXXXXXXXXXXXXXGXXXXXXXXXXXXXXXXXXXGXXXXXXXXXXXXXXXXXXXGXXXXXXXXXXXXXXXXXXXGXXXXXXXXXXXXXXXXXXXGXXXXXXXXXXXXXXXXXXXGXXXXXXXXXXXXXXXXXXXGXXXXXXXXXXXXXXXXXXXGXXXXXXXXXXXXXXXXXXXGXXXXXXXXXXXXXXXXXXX,0,10,0
7434,13,0,13,173,414,0,0,430,129,301,GXXXXXXXXXXXXXXXXXXXGXXXXXXXXXXXXXXXXXXXGXXXXXXXXXXXXXXXXXXXGXXXXXXXXXXXXXXXXXXXGXXXXXXXXXXXXXXXXXXXGXXXXXXXXXXXXXXXXXXXGXXXXXXXXXXXXXXXXXXXGXXXXXXXXXXXXXXXXXXXGXXXXXXXXXXXXXXXXXXXGXXXXXXXXXXXXXXXXXXXGXXXXXXXXXXXXXXXXXXXGXXXXXXXXXXXXXXXXXXXGXXXXXXXXXXXXXXXXXXX,0,10,0

7455,13,0,13,177,410,0,0,426,122,304,GXXXXXXXXXXXXXXXXXXXGXXXXXXXXXXXXXXXXXXXGXXXXXXXXXXXXXXXXXXXGXXXXXXXXXXXXXXXXXXXGXXXXXXXXXXXXXXXXXXXGXXXXXXXXXXXXXXXXXXXGXXXXXXXXXXXXXXXXXXXGXXXXXXXXXXXXXXXXXXXGXXXXXXXXXXXXXXXXXXXGXXXXXXXXXXXXXXXXXXXGXXXXXXXXXXXXXXXXXXXGXXXXXXXXXXXXXXXXXXXGXXXXXXXXXXXXXXXXXXX,0,10,0
7476,14,1,13,181,405,0,0,421,128,293,GXXXXXXXXXXXXXXXXXXXGXXXXXXXXXXXXXXXXXXXGXXXXXXXXXXXXXXXXXXXGXXXXXXXXXXXXXXXXXXXGAXXXXXXXXXXXXXXXXXXGXXXXXXXXXXXXXXXXXXXGXXXXXXXXXXXXXXXXXXXGXXXXXXXXXXXXXXXXXXXGXXXXXXXXXXXXXXXXXXXGXXXXXXXXXXXXXXXXXXXGXXXXXXXXXXXXXXXXXXXGXXXXXXXXXXXXXXXXXXXGXXXXXXXXXXXXXXXXXXX,0,10,0
7497,14,1,13,185,401,0,0,418,125,293,GXXXXXXXXXXXXXXXXXXXGXXXXXXXXXXXXXXXXXXXGXXXXXXXXXXXXXXXXXXXGXXXXXXXXXXXXXXXXXXXGAXXXXXXXXXXXXXXXXXXGXXXXXXXXXXXXXXXXXXXGXXXXXXXXXXXXXXXXXXXGXXXXXXXXXXXXXXXXXXXGXXXXXXXXXXXXXXXXXXXGXXXXXXXXXXXXXXXXXXXGXXXXXXXXXXXXXXXXXXXGXXXXXXXXXXXXXXXXXXXGXXXXXXXXXXXXXXXXXXX,0,10,0
7518,15,2,13,177,408,0,0,425,124,301,GXXXXXXXXXXXXXXXXXXXGXXXXXXXXXXXXXXXXXXXGXXXXXXXXXXXXXXXXXXXGXXXXXXXXXXXXXXXXXXXGAXXXXXXXXXXXXXXXXXXGXXXXXXXXXXXXXXXXXXXGXXXXXXXXXXXXXXXXXXXGAXXXXXXXXXXXXXXXXXXGXXXXXXXXXXXXXXXXXXXGXXXXXXXXXXXXXXXXXXXGXXXXXXXXXXXXXXXXXXXGXXXXXXXXXXXXXXXXXXXGXXXXXXXXXXXXXXXXXXX,0,10,0
7539,16,2,14,168,416,0,0,433,124,309,GXXXXXXXXXXXXXXXXXXXGXXXXXXXXXXXXXXXXXXXGXXXXXXXXXXXXXXXXXXXGXXXXXXXXXXXXXXXXXXXGAXXXXXXXXXXXXXXXXXXGXXXXXXXXXXXXXXXXXXXGXXXXXXXXXXXXXXXXXXXGAXXXXXXXXXXXXXXXXXXGOXXXXXXXXXXXXXXXXXXGXXXXXXXXXXXXXXXXXXXGXXXXXXXXXXXXXXXXXXXGXXXXXXXXXXXXXXXXXXXGXXXXXXXXXXXXXXXXXXX,0,10,0

7560,15,2,13,164,421,0,0,436,133,303,GXXXXXXXXXXXXXXXXXXXGXXXXXXXXXXXXXXXXXXXGXXXXXXXXXXXXXXXXXXXGXXXXXXXXXXXXXXXXXXXGAXXXXXXXXXXXXXXXXXXGXXXXXXXXXXXXXXXXXXXGXXXXXXXXXXXXXXXXXXXGAXXXXXXXXXXXXXXXXXXGXXXXXXXXXXXXXXXXXXXGXXXXXXXXXXXXXXXXXXXGXXXXXXXXXXXXXXXXXXXGXXXXXXXXXXXXXXXXXXXGXXXXXXXXXXXXXXXXXXX,0,10,0
7581,15,2,13,164,421,0,0,437,130,307,GXXXXXXXXXXXXXXXXXXXGXXXXXXXXXXXXXXXXXXXGXXXXXXXXXXXXXXXXXXXGXXXXXXXXXXXXXXXXXXXGAXXXXXXXXXXXXXXXXXXGXXXXXXXXXXXXXXXXXXXGXXXXXXXXXXXXXXXXXXXGAXXXXXXXXXXXXXXXXXXGXXXXXXXXXXXXXXXXXXXGXXXXXXXXXXXXXXXXXXXGXXXXXXXXXXXXXXXXXXXGXXXXXXXXXXXXXXXXXXXGXXXXXXXXXXXXXXXXXXX,0,10,0
7602,15,1,14,160,425,0,0,440,139,301,GXXXXXXXXXXXXXXXXXXXGXXXXXXXXXXXXXXXXXXXGXXXXXXXXXXXXXXXXXXXGXXXXXXXXXXXXXXXXXXXGOXXXXXXXXXXXXXXXXXXGXXXXXXXXXXXXXXXXXXXGXXXXXXXXXXXXXXXXXXXGAXXXXXXXXXXXXXXXXXXGXXXXXXXXXXXXXXXXXXXGXXXXXXXXXXXXXXXXXXXGXXXXXXXXXXXXXXXXXXXGXXXXXXXXXXXXXXXXXXXGXXXXXXXXXXXXXXXXXXX,0,10,0
7623,15,1,14,173,412,0,0,428,135,293,GXXXXXXXXXXXXXXXXXXXGXXXXXXXXXXXXXXXXXXXGXXXXXXXXXXXXXXXXXXXGXXXXXXXXXXXXXXXXXXXGOXXXXXXXXXXXXXXXXXXGXXXXXXXXXXXXXXXXXXXGXXXXXXXXXXXXXXXXXXXGAXXXXXXXXXXXXXXXXXXGXXXXXXXXXXXXXXXXXXXGXXXXXXXXXXXXXXXXXXXGXXXXXXXXXXXXXXXXXXXGXXXXXXXXXXXXXXXXXXXGXXXXXXXXXXXXXXXXXXX,0,10,0
7644,16,2,14,169,415,0,0,431,141,290,GXXXXXXXXXXXXXXXXXXXGXXXXXXXXXXXXXXXXXXXGXXXXXXXXXXXXXXXXXXXGXXXXXXXXXXXXXXXXXXXGOXXXXXXXXXXXXXXXXXXGXXXXXXXXXXXXXXXXXXXGXXXXXXXXXXXXXXXXXXXGAXXXXXXXXXXXXXXXXXXGXXXXXXXXXXXXXXXXXXXGXXXXXXXXXXXXXXXXXXXGXXXXXXXXXXXXXXXXXXXGXXXXXXXXXXXXXXXXXXXGAXXXXXXXXXXXXXXXXXX,0,10,0

7665,15,2,13,171,414,0,0,427,140,287,GXXXXXXXXXXXXXXXXXXXGXXXXXXXXXXXXXXXXXXXGXXXXXXXXXXXXXXXXXXXGXXXXXXXXXXXXXXXXXXXGXXXXXXXXXXXXXXXXXXXGXXXXXXXXXXXXXXXXXXXGXXXXXXXXXXXXXXXXXXXGAXXXXXXXXXXXXXXXXXXGXXXXXXXXXXXXXXXXXXXGXXXXXXXXXXXXXXXXXXXGXXXXXXXXXXXXXXXXXXXGXXXXXXXXXXXXXXXXXXXGAXXXXXXXXXXXXXXXXXX,0,10,0
7686,15,2,13,176,409,0,0,422,139,283,GXXXXXXXXXXXXXXXXXXXGXXXXXXXXXXXXXXXXXXXGXXXXXXXXXXXXXXXXXXXGXXXXXXXXXXXXXXXXXXXGXXXXXXXXXXXXXXXXXXXGXXXXXXXXXXXXXXXXXXXGXXXXXXXXXXXXXXXXXXXGAXXXXXXXXXXXXXXXXXXGXXXXXXXXXXXXXXXXXXXGXXXXXXXXXXXXXXXXXXXGXXXXXXXXXXXXXXXXXXXGXXXXXXXXXXXXXXXXXXXGAXXXXXXXXXXXXXXXXXX,0,10,0
7707,15,2,13,171,414,0,0,426,136,290,GXXXXXXXXXXXXXXXXXXXGXXXXXXXXXXXXXXXXXXXGXXXXXXXXXXXXXXXXXXXGXXXXXXXXXXXXXXXXXXXGXXXXXXXXXXXXXXXXXXXGXXXXXXXXXXXXXXXXXXXGXXXXXXXXXXXXXXXXXXXGAXXXXXXXXXXXXXXXXXXGXXXXXXXXXXXXXXXXXXXGXXXXXXXXXXXXXXXXXXXGXXXXXXXXXXXXXXXXXXXGXXXXXXXXXXXXXXXXXXXGAXXXXXXXXXXXXXXXXXX,0,10,0
7728,15,1,14,174,411,0,0,427,132,295,GXXXXXXXXXXXXXXXXXXXGXXXXXXXXXXXXXXXXXXXGXXXXXXXXXXXXXXXXXXXGXXXXXXXXXXXXXXXXXXXGXXXXXXXXXXXXXXXXXXXGXXXXXXXXXXXXXXXXXXXGXXXXXXXXXXXXXXXXXXXGAXXXXXXXXXXXXXXXXXXGXXXXXXXXXXXXXXXXXXXGXXXXXXXXXXXXXXXXXXXGXXXXXXXXXXXXXXXXXXXGXXXXXXXXXXXXXXXXXXXGOXXXXXXXXXXXXXXXXXX,0,10,0
7749,15,1,14,163,422,0,0,437,139,298,GXXXXXXXXXXXXXXXXXXXGXXXXXXXXXXXXXXXXXXXGXXXXXXXXXXXXXXXXXXXGXXXXXXXXXXXXXXXXXXXGXXXXXXXXXXXXXXXXXXXGXXXXXXXXXXXXXXXXXXXGXXXXXXXXXXXXXXXXXXXGAXXXXXXXXXXXXXXXXXXGXXXXXXXXXXXXXXXXXXXGXXXXXXXXXXXXXXXXXXXGXXXXXXXXXXXXXXXXXXXGXXXXXXXXXXXXXXXXXXXGOXXXXXXXXXXXXXXXXXX,0,10,0

7770,15,2,13,171,414,0,0,428,136,292,GXXXXXXXXXXXXXXXXXXXGAXXXXXXXXXXXXXXXXXXGXXXXXXXXXXXXXXXXXXXGXXXXXXXXXXXXXXXXXXXGXXXXXXXXXXXXXXXXXXXGXXXXXXXXXXXXXXXXXXXGXXXXXXXXXXXXXXXXXXXGAXXXXXXXXXXXXXXXXXXGXXXXXXXXXXXXXXXXXXXGXXXXXXXXXXXXXXXXXXXGXXXXXXXXXXXXXXXXXXXGXXXXXXXXXXXXXXXXXXXGXXXXXXXXXXXXXXXXXXX,0,10,0
7791,15,2,13,169,416,0,0,431,144,287,GXXXXXXXXXXXXXXXXXXXGAXXXXXXXXXXXXXXXXXXGXXXXXXXXXXXXXXXXXXXGXXXXXXXXXXXXXXXXXXXGXXXXXXXXXXXXXXXXXXXGXXXXXXXXXXXXXXXXXXXGXXXXXXXXXXXXXXXXXXXGAXXXXXXXXXXXXXXXXXXGXXXXXXXXXXXXXXXXXXXGXXXXXXXXXXXXXXXXXXXGXXXXXXXXXXXXXXXXXXXGXXXXXXXXXXXXXXXXXXXGXXXXXXXXXXXXXXXXXXX,0,10,0
7812,15,2,13,177,408,0,0,421,135,286,GXXXXXXXXXXXXXXXXXXXGAXXXXXXXXXXXXXXXXXXGXXXXXXXXXXXXXXXXXXXGXXXXXXXXXXXXXXXXXXXGXXXXXXXXXXXXXXXXXXXGXXXXXXXXXXXXXXXXXXXGXXXXXXXXXXXXXXXXXXXGAXXXXXXXXXXXXXXXXXXGXXXXXXXXXXXXXXXXXXXGXXXXXXXXXXXXXXXXXXXGXXXXXXXXXXXXXXXXXXXGXXXXXXXXXXXXXXXXXXXGXXXXXXXXXXXXXXXXXXX,0,10,0
7833,15,2,13,172,413,0,0,428,142,286,GXXXXXXXXXXXXXXXXXXXGAXXXXXXXXXXXXXXXXXXGXXXXXXXXXXXXXXXXXXXGXXXXXXXXXXXXXXXXXXXGXXXXXXXXXXXXXXXXXXXGXXXXXXXXXXXXXXXXXXXGXXXXXXXXXXXXXXXXXXXGAXXXXXXXXXXXXXXXXXXGXXXXXXXXXXXXXXXXXXXGXXXXXXXXXXXXXXXXXXXGXXXXXXXXXXXXXXXXXXXGXXXXXXXXXXXXXXXXXXXGXXXXXXXXXXXXXXXXXXX,0,10,0
7854,15,2,13,179,406,0,0,423,143,280,GXXXXXXXXXXXXXXXXXXXGAXXXXXXXXXXXXXXXXXXGXXXXXXXXXXXXXXXXXXXGXXXXXXXXXXXXXXXXXXXGXXXXXXXXXXXXXXXXXXXGXXXXXXXXXXXXXXXXXXXGXXXXXXXXXXXXXXXXXXXGAXXXXXXXXXXXXXXXXXXGXXXXXXXXXXXXXXXXXXXGXXXXXXXXXXXXXXXXXXXGXXXXXXXXXXXXXXXXXXXGXXXXXXXXXXXXXXXXXXXGXXXXXXXXXXXXXXXXXXX,0,10,0

7875,15,1,14,182,403,0,0,420,138,282,GXXXXXXXXXXXXXXXXXXXGAXXXXXXXXXXXXXXXXXXGXXXXXXXXXXXXXXXXXXXGXXXXXXXXXXXXXXXXXXXGXXXXXXXXXXXXXXXXXXXGXXXXXXXXXXXXXXXXXXXGXXXXXXXXXXXXXXXXXXXGOXXXXXXXXXXXXXXXXXXGXXXXXXXXXXXXXXXXXXXGXXXXXXXXXXXXXXXXXXXGXXXXXXXXXXXXXXXXXXXGXXXXXXXXXXXXXXXXXXXGXXXXXXXXXXXXXXXXXXX,0,10,0
7896,15,1,14,169,416,0,0,432,135,297,GXXXXXXXXXXXXXXXXXXXGAXXXXXXXXXXXXXXXXXXGXXXXXXXXXXXXXXXXXXXGXXXXXXXXXXXXXXXXXXXGXXXXXXXXXXXXXXXXXXXGXXXXXXXXXXXXXXXXXXXGXXXXXXXXXXXXXXXXXXXGOXXXXXXXXXXXXXXXXXXGXXXXXXXXXXXXXXXXXXXGXXXXXXXXXXXXXXXXXXXGXXXXXXXXXXXXXXXXXXXGXXXXXXXXXXXXXXXXXXXGXXXXXXXXXXXXXXXXXXX,0,10,0
7917,14,1,13,167,419,0,0,436,132,304,GXXXXXXXXXXXXXXXXXXXGAXXXXXXXXXXXXXXXXXXGXXXXXXXXXXXXXXXXXXXGXXXXXXXXXXXXXXXXXXXGXXXXXXXXXXXXXXXXXXXGXXXXXXXXXXXXXXXXXXXGXXXXXXXXXXXXXXXXXXXGXXXXXXXXXXXXXXXXXXXGXXXXXXXXXXXXXXXXXXXGXXXXXXXXXXXXXXXXXXXGXXXXXXXXXXXXXXXXXXXGXXXXXXXXXXXXXXXXXXXGXXXXXXXXXXXXXXXXXXX,0,10,0
7938,14,1,13,160,426,0,0,441,141,300,GXXXXXXXXXXXXXXXXXXXGAXXXXXXXXXXXXXXXXXXGXXXXXXXXXXXXXXXXXXXGXXXXXXXXXXXXXXXXXXXGXXXXXXXXXXXXXXXXXXXGXXXXXXXXXXXXXXXXXXXGXXXXXXXXXXXXXXXXXXXGXXXXXXXXXXXXXXXXXXXGXXXXXXXXXXXXXXXXXXXGXXXXXXXXXXXXXXXXXXXGXXXXXXXXXXXXXXXXXXXGXXXXXXXXXXXXXXXXXXXGXXXXXXXXXXXXXXXXXXX,0,10,0
7959,14,1,13,161,425,0,0,440,140,300,GXXXXXXXXXXXXXXXXXXXGAXXXXXXXXXXXXXXXXXXGXXXXXXXXXXXXXXXXXXXGXXXXXXXXXXXXXXXXXXXGXXXXXXXXXXXXXXXXXXXGXXXXXXXXXXXXXXXXXXXGXXXXXXXXXXXXXXXXXXXGXXXXXXXXXXXXXXXXXXXGXXXXXXXXXXXXXXXXXXXGXXXXXXXXXXXXXXXXXXXGXXXXXXXXXXXXXXXXXXXGXXXXXXXXXXXXXXXXXXXGXXXXXXXXXXXXXXXXXXX,0,10,0

7980,14,1,13,162,424,0,0,439,136,303,GXXXXXXXXXXXXXXXXXXXGAXXXXXXXXXXXXXXXXXXGXXXXXXXXXXXXXXXXXXXGXXXXXXXXXXXXXXXXXXXGXXXXXXXXXXXXXXXXXXXGXXXXXXXXXXXXXXXXXXXGXXXXXXXXXXXXXXXXXXXGXXXXXXXXXXXXXXXXXXXGXXXXXXXXXXXXXXXXXXXGXXXXXXXXXXXXXXXXXXXGXXXXXXXXXXXXXXXXXXXGXXXXXXXXXXXXXXXXXXXGXXXXXXXXXXXXXXXXXXX,0,10,0
8001,14,1,13,161,425,0,0,440,138,302,GXXXXXXXXXXXXXXXXXXXGAXXXXXXXXXXXXXXXXXXGXXXXXXXXXXXXXXXXXXXGXXXXXXXXXXXXXXXXXXXGXXXXXXXXXXXXXXXXXXXGXXXXXXXXXXXXXXXXXXXGXXXXXXXXXXXXXXXXXXXGXXXXXXXXXXXXXXXXXXXGXXXXXXXXXXXXXXXXXXXGXXXXXXXXXXXXXXXXXXXGXXXXXXXXXXXXXXXXXXXGXXXXXXXXXXXXXXXXXXXGXXXXXXXXXXXXXXXXXXX,0,10,0
8022,14,1,13,166,420,0,0,436,133,303,GXXXXXXXXXXXXXXXXXXXGAXXXXXXXXXXXXXXXXXXGXXXXXXXXXXXXXXXXXXXGXXXXXXXXXXXXXXXXXXXGXXXXXXXXXXXXXXXXXXXGXXXXXXXXXXXXXXXXXXXGXXXXXXXXXXXXXXXXXXXGXXXXXXXXXXXXXXXXXXXGXXXXXXXXXXXXXXXXXXXGXXXXXXXXXXXXXXXXXXXGXXXXXXXXXXXXXXXXXXXGXXXXXXXXXXXXXXXXXXXGXXXXXXXXXXXXXXXXXXX,0,10,0
8043,14,1,13,166,420,0,0,435,136,299,GXXXXXXXXXXXXXXXXXXXGAXXXXXXXXXXXXXXXXXXGXXXXXXXXXXXXXXXXXXXGXXXXXXXXXXXXXXXXXXXGXXXXXXXXXXXXXXXXXXXGXXXXXXXXXXXXXXXXXXXGXXXXXXXXXXXXXXXXXXXGXXXXXXXXXXXXXXXXXXXGXXXXXXXXXXXXXXXXXXXGXXXXXXXXXXXXXXXXXXXGXXXXXXXXXXXXXXXXXXXGXXXXXXXXXXXXXXXXXXXGXXXXXXXXXXXXXXXXXXX,0,10,0
8064,16,3,13,164,420,0,0,437,138,299,GXXXXXXXXXXXXXXXXXXXGAXXXXXXXXXXXXXXXXXXGXXXXXXXXXXXXXXXXXXXGXXXXXXXXXXXXXXXXXXXGXXXXXXXXXXXXXXXXXXXGXXXXXXXXXXXXXXXXXXXGXXXXXXXXXXXXXXXXXXXGAXXXXXXXXXXXXXXXXXXGXXXXXXXXXXXXXXXXXXXGXXXXXXXXXXXXXXXXXXXGXXXXXXXXXXXXXXXXXXXGAXXXXXXXXXXXXXXXXXXGXXXXXXXXXXXXXXXXXXX,0,10,0

8085,15,2,13,160,425,0,0,443,139,304,GXXXXXXXXXXXXXXXXXXXGAXXXXXXXXXXXXXXXXXXGXXXXXXXXXXXXXXXXXXXGXXXXXXXXXXXXXXXXXXXGXXXXXXXXXXXXXXXXXXXGXXXXXXXXXXXXXXXXXXXGXXXXXXXXXXXXXXXXXXXGAXXXXXXXXXXXXXXXXXXGXXXXXXXXXXXXXXXXXXXGXXXXXXXXXXXXXXXXXXXGXXXXXXXXXXXXXXXXXXXGXXXXXXXXXXXXXXXXXXXGXXXXXXXXXXXXXXXXXXX,0,10,0
8106,15,2,13,157,428,0,0,446,146,300,GXXXXXXXXXXXXXXXXXXXGAXXXXXXXXXXXXXXXXXXGXXXXXXXXXXXXXXXXXXXGXXXXXXXXXXXXXXXXXXXGXXXXXXXXXXXXXXXXXXXGXXXXXXXXXXXXXXXXXXXGXXXXXXXXXXXXXXXXXXXGAXXXXXXXXXXXXXXXXXXGXXXXXXXXXXXXXXXXXXXGXXXXXXXXXXXXXXXXXXXGXXXXXXXXXXXXXXXXXXXGXXXXXXXXXXXXXXXXXXXGXXXXXXXXXXXXXXXXXXX,0,10,0
8127,15,2,13,152,433,0,0,448,149,299,GXXXXXXXXXXXXXXXXXXXGAXXXXXXXXXXXXXXXXXXGXXXXXXXXXXXXXXXXXXXGXXXXXXXXXXXXXXXXXXXGXXXXXXXXXXXXXXXXXXXGXXXXXXXXXXXXXXXXXXXGXXXXXXXXXXXXXXXXXXXGAXXXXXXXXXXXXXXXXXXGXXXXXXXXXXXXXXXXXXXGXXXXXXXXXXXXXXXXXXXGXXXXXXXXXXXXXXXXXXXGXXXXXXXXXXXXXXXXXXXGXXXXXXXXXXXXXXXXXXX,0,10,0
8148,15,2,13,159,426,0,0,442,141,301,GXXXXXXXXXXXXXXXXXXXGAXXXXXXXXXXXXXXXXXXGXXXXXXXXXXXXXXXXXXXGXXXXXXXXXXXXXXXXXXXGXXXXXXXXXXXXXXXXXXXGXXXXXXXXXXXXXXXXXXXGXXXXXXXXXXXXXXXXXXXGAXXXXXXXXXXXXXXXXXXGXXXXXXXXXXXXXXXXXXXGXXXXXXXXXXXXXXXXXXXGXXXXXXXXXXXXXXXXXXXGXXXXXXXXXXXXXXXXXXXGXXXXXXXXXXXXXXXXXXX,0,10,0
8169,15,2,13,160,425,0,0,440,139,301,GXXXXXXXXXXXXXXXXXXXGAXXXXXXXXXXXXXXXXXXGXXXXXXXXXXXXXXXXXXXGXXXXXXXXXXXXXXXXXXXGXXXXXXXXXXXXXXXXXXXGXXXXXXXXXXXXXXXXXXXGXXXXXXXXXXXXXXXXXXXGAXXXXXXXXXXXXXXXXXXGXXXXXXXXXXXXXXXXXXXGXXXXXXXXXXXXXXXXXXXGXXXXXXXXXXXXXXXXXXXGXXXXXXXXXXXXXXXXXXXGXXXXXXXXXXXXXXXXXXX,0,10,0

8190,16,3,13,153,431,0,0,446,141,305,GXXXXXXXXXXXXXXXXXXXGAXXXXXXXXXXXXXXXXXXGXXXXXXXXXXXXXXXXXXXGXXXXXXXXXXXXXXXXXXXGXXXXXXXXXXXXXXXXXXXGAXXXXXXXXXXXXXXXXXXGXXXXXXXXXXXXXXXXXXXGAXXXXXXXXXXXXXXXXXXGXXXXXXXXXXXXXXXXXXXGXXXXXXXXXXXXXXXXXXXGXXXXXXXXXXXXXXXXXXXGXXXXXXXXXXXXXXXXXXXGXXXXXXXXXXXXXXXXXXX,0,10,0
8211,16,3,13,152,432,0,0,448,143,305,GXXXXXXXXXXXXXXXXXXXGAXXXXXXXXXXXXXXXXXXGXXXXXXXXXXXXXXXXXXXGXXXXXXXXXXXXXXXXXXXGXXXXXXXXXXXXXXXXXXXGAXXXXXXXXXXXXXXXXXXGXXXXXXXXXXXXXXXXXXXGAXXXXXXXXXXXXXXXXXXGXXXXXXXXXXXXXXXXXXXGXXXXXXXXXXXXXXXXXXXGXXXXXXXXXXXXXXXXXXXGXXXXXXXXXXXXXXXXXXXGXXXXXXXXXXXXXXXXXXX,0,10,0
8232,16,2,14,157,427,0,0,441,144,297,GXXXXXXXXXXXXXXXXXXXGOXXXXXXXXXXXXXXXXXXGXXXXXXXXXXXXXXXXXXXGXXXXXXXXXXXXXXXXXXXGXXXXXXXXXXXXXXXXXXXGAXXXXXXXXXXXXXXXXXXGXXXXXXXXXXXXXXXXXXXGAXXXXXXXXXXXXXXXXXXGXXXXXXXXXXXXXXXXXXXGXXXXXXXXXXXXXXXXXXXGXXXXXXXXXXXXXXXXXXXGXXXXXXXXXXXXXXXXXXXGXXXXXXXXXXXXXXXXXXX,0,10,0
8253,15,2,13,160,425,0,0,440,142,298,GXXXXXXXXXXXXXXXXXXXGXXXXXXXXXXXXXXXXXXXGXXXXXXXXXXXXXXXXXXXGXXXXXXXXXXXXXXXXXXXGAXXXXXXXXXXXXXXXXXXGAXXXXXXXXXXXXXXXXXXGXXXXXXXXXXXXXXXXXXXGXXXXXXXXXXXXXXXXXXXGXXXXXXXXXXXXXXXXXXXGXXXXXXXXXXXXXXXXXXXGXXXXXXXXXXXXXXXXXXXGXXXXXXXXXXXXXXXXXXXGXXXXXXXXXXXXXXXXXXX,0,10,0
8274,15,2,13,167,418,0,0,432,139,293,GXXXXXXXXXXXXXXXXXXXGXXXXXXXXXXXXXXXXXXXGXXXXXXXXXXXXXXXXXXXGXXXXXXXXXXXXXXXXXXXGAXXXXXXXXXXXXXXXXXXGAXXXXXXXXXXXXXXXXXXGXXXXXXXXXXXXXXXXXXXGXXXXXXXXXXXXXXXXXXXGXXXXXXXXXXXXXXXXXXXGXXXXXXXXXXXXXXXXXXXGXXXXXXXXXXXXXXXXXXXGXXXXXXXXXXXXXXXXXXXGXXXXXXXXXXXXXXXXXXX,0,10,0

8295,15,2,13,170,415,0,0,429,140,289,GXXXXXXXXXXXXXXXXXXXGXXXXXXXXXXXXXXXXXXXGXXXXXXXXXXXXXXXXXXXGXXXXXXXXXXXXXXXXXXXGAXXXXXXXXXXXXXXXXXXGAXXXXXXXXXXXXXXXXXXGXXXXXXXXXXXXXXXXXXXGXXXXXXXXXXXXXXXXXXXGXXXXXXXXXXXXXXXXXXXGXXXXXXXXXXXXXXXXXXXGXXXXXXXXXXXXXXXXXXXGXXXXXXXXXXXXXXXXXXXGXXXXXXXXXXXXXXXXXXX,0,10,0
8316,15,2,13,175,410,0,0,425,145,280,GXXXXXXXXXXXXXXXXXXXGXXXXXXXXXXXXXXXXXXXGXXXXXXXXXXXXXXXXXXXGXXXXXXXXXXXXXXXXXXXGAXXXXXXXXXXXXXXXXXXGAXXXXXXXXXXXXXXXXXXGXXXXXXXXXXXXXXXXXXXGXXXXXXXXXXXXXXXXXXXGXXXXXXXXXXXXXXXXXXXGXXXXXXXXXXXXXXXXXXXGXXXXXXXXXXXXXXXXXXXGXXXXXXXXXXXXXXXXXXXGXXXXXXXXXXXXXXXXXXX,0,10,0
8337,16,3,13,170,414,0,0,428,146,282,GXXXXXXXXXXXXXXXXXXXGXXXXXXXXXXXXXXXXXXXGXXXXXXXXXXXXXXXXXXXGXXXXXXXXXXXXXXXXXXXGAXXXXXXXXXXXXXXXXXXGAXXXXXXXXXXXXXXXXXXGAXXXXXXXXXXXXXXXXXXGXXXXXXXXXXXXXXXXXXXGXXXXXXXXXXXXXXXXXXXGXXXXXXXXXXXXXXXXXXXGXXXXXXXXXXXXXXXXXXXGXXXXXXXXXXXXXXXXXXXGXXXXXXXXXXXXXXXXXXX,0,10,0
8358,15,2,13,179,406,0,0,422,141,281,GXXXXXXXXXXXXXXXXXXXGXXXXXXXXXXXXXXXXXXXGXXXXXXXXXXXXXXXXXXXGXXXXXXXXXXXXXXXXXXXGAXXXXXXXXXXXXXXXXXXGXXXXXXXXXXXXXXXXXXXGAXXXXXXXXXXXXXXXXXXGXXXXXXXXXXXXXXXXXXXGXXXXXXXXXXXXXXXXXXXGXXXXXXXXXXXXXXXXXXXGXXXXXXXXXXXXXXXXXXXGXXXXXXXXXXXXXXXXXXXGXXXXXXXXXXXXXXXXXXX,0,10,0
8379,15,1,14,181,404,0,0,420,142,278,GXXXXXXXXXXXXXXXXXXXGXXXXXXXXXXXXXXXXXXXGXXXXXXXXXXXXXXXXXXXGXXXXXXXXXXXXXXXXXXXGAXXXXXXXXXXXXXXXXXXGXXXXXXXXXXXXXXXXXXXGOXXXXXXXXXXXXXXXXXXGXXXXXXXXXXXXXXXXXXXGXXXXXXXXXXXXXXXXXXXGXXXXXXXXXXXXXXXXXXXGXXXXXXXXXXXXXXXXXXXGXXXXXXXXXXXXXXXXXXXGXXXXXXXXXXXXXXXXXXX,0,10,0

8400,16,2,14,180,404,0,0,418,140,278,GXXXXXXXXXXXXXXXXXXXGXXXXXXXXXXXXXXXXXXXGXXXXXXXXXXXXXXXXXXXGXXXXXXXXXXXXXXXXXXXGAXXXXXXXXXXXXXXXXXXGXXXXXXXXXXXXXXXXXXXGOXXXXXXXXXXXXXXXXXXGXXXXXXXXXXXXXXXXXXXGAXXXXXXXXXXXXXXXXXXGXXXXXXXXXXXXXXXXXXXGXXXXXXXXXXXXXXXXXXXGXXXXXXXXXXXXXXXXXXXGXXXXXXXXXXXXXXXXXXX,0,10,0
8421,15,2,13,188,397,0,0,411,140,271,GXXXXXXXXXXXXXXXXXXXGXXXXXXXXXXXXXXXXXXXGXXXXXXXXXXXXXXXXXXXGXXXXXXXXXXXXXXXXXXXGAXXXXXXXXXXXXXXXXXXGXXXXXXXXXXXXXXXXXXXGXXXXXXXXXXXXXXXXXXXGXXXXXXXXXXXXXXXXXXXGAXXXXXXXXXXXXXXXXXXGXXXXXXXXXXXXXXXXXXXGXXXXXXXXXXXXXXXXXXXGXXXXXXXXXXXXXXXXXXXGXXXXXXXXXXXXXXXXXXX,0,10,0
8442,15,2,13,184,401,0,0,417,141,276,GXXXXXXXXXXXXXXXXXXXGXXXXXXXXXXXXXXXXXXXGXXXXXXXXXXXXXXXXXXXGXXXXXXXXXXXXXXXXXXXGAXXXXXXXXXXXXXXXXXXGXXXXXXXXXXXXXXXXXXXGXXXXXXXXXXXXXXXXXXXGXXXXXXXXXXXXXXXXXXXGAXXXXXXXXXXXXXXXXXXGXXXXXXXXXXXXXXXXXXXGXXXXXXXXXXXXXXXXXXXGXXXXXXXXXXXXXXXXXXXGXXXXXXXXXXXXXXXXXXX,0,10,0
8463,15,2,13,176,409,0,0,422,141,281,GXXXXXXXXXXXXXXXXXXXGXXXXXXXXXXXXXXXXXXXGXXXXXXXXXXXXXXXXXXXGXXXXXXXXXXXXXXXXXXXGAXXXXXXXXXXXXXXXXXXGXXXXXXXXXXXXXXXXXXXGXXXXXXXXXXXXXXXXXXXGXXXXXXXXXXXXXXXXXXXGAXXXXXXXXXXXXXXXXXXGXXXXXXXXXXXXXXXXXXXGXXXXXXXXXXXXXXXXXXXGXXXXXXXXXXXXXXXXXXXGXXXXXXXXXXXXXXXXXXX,0,10,0
8484,15,2,13,173,412,0,0,423,144,279,GXXXXXXXXXXXXXXXXXXXGXXXXXXXXXXXXXXXXXXXGXXXXXXXXXXXXXXXXXXXGXXXXXXXXXXXXXXXXXXXGAXXXXXXXXXXXXXXXXXXGXXXXXXXXXXXXXXXXXXXGXXXXXXXXXXXXXXXXXXXGXXXXXXXXXXXXXXXXXXXGAXXXXXXXXXXXXXXXXXXGXXXXXXXXXXXXXXXXXXXGXXXXXXXXXXXXXXXXXXXGXXXXXXXXXXXXXXXXXXXGXXXXXXXXXXXXXXXXXXX,0,10,0

8505,15,2,13,168,417,0,0,430,154,276,GXXXXXXXXXXXXXXXXXXXGXXXXXXXXXXXXXXXXXXXGXXXXXXXXXXXXXXXXXXXGXXXXXXXXXXXXXXXXXXXGAXXXXXXXXXXXXXXXXXXGXXXXXXXXXXXXXXXXXXXGXXXXXXXXXXXXXXXXXXXGXXXXXXXXXXXXXXXXXXXGAXXXXXXXXXXXXXXXXXXGXXXXXXXXXXXXXXXXXXXGXXXXXXXXXXXXXXXXXXXGXXXXXXXXXXXXXXXXXXXGXXXXXXXXXXXXXXXXXXX,0,10,0
8526,15,2,13,176,409,0,0,424,150,274,GXXXXXXXXXXXXXXXXXXXGXXXXXXXXXXXXXXXXXXXGXXXXXXXXXXXXXXXXXXXGXXXXXXXXXXXXXXXXXXXGAXXXXXXXXXXXXXXXXXXGXXXXXXXXXXXXXXXXXXXGXXXXXXXXXXXXXXXXXXXGXXXXXXXXXXXXXXXXXXXGAXXXXXXXXXXXXXXXXXXGXXXXXXXXXXXXXXXXXXXGXXXXXXXXXXXXXXXXXXXGXXXXXXXXXXXXXXXXXXXGXXXXXXXXXXXXXXXXXXX,0,10,0
8547,15,2,13,171,414,0,0,428,153,275,GXXXXXXXXXXXXXXXXXXXGXXXXXXXXXXXXXXXXXXXGXXXXXXXXXXXXXXXXXXXGXXXXXXXXXXXXXXXXXXXGAXXXXXXXXXXXXXXXXXXGXXXXXXXXXXXXXXXXXXXGXXXXXXXXXXXXXXXXXXXGXXXXXXXXXXXXXXXXXXXGAXXXXXXXXXXXXXXXXXXGXXXXXXXXXXXXXXXXXXXGXXXXXXXXXXXXXXXXXXXGXXXXXXXXXXXXXXXXXXXGXXXXXXXXXXXXXXXXXXX,0,10,0
8568,16,2,14,182,402,0,0,416,153,263,GXXXXXXXXXXXXXXXXXXXGXXXXXXXXXXXXXXXXXXXGAXXXXXXXXXXXXXXXXXXGXXXXXXXXXXXXXXXXXXXGOXXXXXXXXXXXXXXXXXXGXXXXXXXXXXXXXXXXXXXGXXXXXXXXXXXXXXXXXXXGXXXXXXXXXXXXXXXXXXXGAXXXXXXXXXXXXXXXXXXGXXXXXXXXXXXXXXXXXXXGXXXXXXXXXXXXXXXXXXXGXXXXXXXXXXXXXXXXXXXGXXXXXXXXXXXXXXXXXXX,0,10,0
8589,16,2,14,181,403,0,0,416,142,274,GXXXXXXXXXXXXXXXXXXXGXXXXXXXXXXXXXXXXXXXGAXXXXXXXXXXXXXXXXXXGXXXXXXXXXXXXXXXXXXXGOXXXXXXXXXXXXXXXXXXGXXXXXXXXXXXXXXXXXXXGXXXXXXXXXXXXXXXXXXXGXXXXXXXXXXXXXXXXXXXGAXXXXXXXXXXXXXXXXXXGXXXXXXXXXXXXXXXXXXXGXXXXXXXXXXXXXXXXXXXGXXXXXXXXXXXXXXXXXXXGXXXXXXXXXXXXXXXXXXX,0,10,0

8610,15,2,13,179,406,0,0,421,139,282,GXXXXXXXXXXXXXXXXXXXGXXXXXXXXXXXXXXXXXXXGAXXXXXXXXXXXXXXXXXXGXXXXXXXXXXXXXXXXXXXGXXXXXXXXXXXXXXXXXXXGXXXXXXXXXXXXXXXXXXXGXXXXXXXXXXXXXXXXXXXGXXXXXXXXXXXXXXXXXXXGAXXXXXXXXXXXXXXXXXXGXXXXXXXXXXXXXXXXXXXGXXXXXXXXXXXXXXXXXXXGXXXXXXXXXXXXXXXXXXXGXXXXXXXXXXXXXXXXXXX,0,10,0
8631,15,2,13,178,407,0,0,420,144,276,GXXXXXXXXXXXXXXXXXXXGXXXXXXXXXXXXXXXXXXXGAXXXXXXXXXXXXXXXXXXGXXXXXXXXXXXXXXXXXXXGXXXXXXXXXXXXXXXXXXXGXXXXXXXXXXXXXXXXXXXGXXXXXXXXXXXXXXXXXXXGXXXXXXXXXXXXXXXXXXXGAXXXXXXXXXXXXXXXXXXGXXXXXXXXXXXXXXXXXXXGXXXXXXXXXXXXXXXXXXXGXXXXXXXXXXXXXXXXXXXGXXXXXXXXXXXXXXXXXXX,0,10,0
8652,15,2,13,178,407,0,0,420,146,274,GXXXXXXXXXXXXXXXXXXXGXXXXXXXXXXXXXXXXXXXGAXXXXXXXXXXXXXXXXXXGXXXXXXXXXXXXXXXXXXXGXXXXXXXXXXXXXXXXXXXGXXXXXXXXXXXXXXXXXXXGXXXXXXXXXXXXXXXXXXXGXXXXXXXXXXXXXXXXXXXGAXXXXXXXXXXXXXXXXXXGXXXXXXXXXXXXXXXXXXXGXXXXXXXXXXXXXXXXXXXGXXXXXXXXXXXXXXXXXXXGXXXXXXXXXXXXXXXXXXX,0,10,0
8673,15,2,13,178,407,0,0,421,142,279,GXXXXXXXXXXXXXXXXXXXGXXXXXXXXXXXXXXXXXXXGAXXXXXXXXXXXXXXXXXXGXXXXXXXXXXXXXXXXXXXGXXXXXXXXXXXXXXXXXXXGXXXXXXXXXXXXXXXXXXXGXXXXXXXXXXXXXXXXXXXGXXXXXXXXXXXXXXXXXXXGAXXXXXXXXXXXXXXXXXXGXXXXXXXXXXXXXXXXXXXGXXXXXXXXXXXXXXXXXXXGXXXXXXXXXXXXXXXXXXXGXXXXXXXXXXXXXXXXXXX,0,10,0
8694,15,2,13,174,411,0,0,427,140,287,GXXXXXXXXXXXXXXXXXXXGXXXXXXXXXXXXXXXXXXXGAXXXXXXXXXXXXXXXXXXGXXXXXXXXXXXXXXXXXXXGXXXXXXXXXXXXXXXXXXXGXXXXXXXXXXXXXXXXXXXGXXXXXXXXXXXXXXXXXXXGXXXXXXXXXXXXXXXXXXXGAXXXXXXXXXXXXXXXXXXGXXXXXXXXXXXXXXXXXXXGXXXXXXXXXXXXXXXXXXXGXXXXXXXXXXXXXXXXXXXGXXXXXXXXXXXXXXXXXXX,0,10,0

8715,16,3,13,168,416,0,0,430,146,284,GXXXXXXXXXXXXXXXXXXXGXXXXXXXXXXXXXXXXXXXGAAXXXXXXXXXXXXXXXXXGXXXXXXXXXXXXXXXXXXXGXXXXXXXXXXXXXXXXXXXGXXXXXXXXXXXXXXXXXXXGXXXXXXXXXXXXXXXXXXXGXXXXXXXXXXXXXXXXXXXGAXXXXXXXXXXXXXXXXXXGXXXXXXXXXXXXXXXXXXXGXXXXXXXXXXXXXXXXXXXGXXXXXXXXXXXXXXXXXXXGXXXXXXXXXXXXXXXXXXX,0,10,0
8736,16,3,13,170,414,0,0,430,146,284,GXXXXXXXXXXXXXXXXXXXGXXXXXXXXXXXXXXXXXXXGAAXXXXXXXXXXXXXXXXXGXXXXXXXXXXXXXXXXXXXGXXXXXXXXXXXXXXXXXXXGXXXXXXXXXXXXXXXXXXXGXXXXXXXXXXXXXXXXXXXGXXXXXXXXXXXXXXXXXXXGAXXXXXXXXXXXXXXXXXXGXXXXXXXXXXXXXXXXXXXGXXXXXXXXXXXXXXXXXXXGXXXXXXXXXXXXXXXXXXXGXXXXXXXXXXXXXXXXXXX,0,10,0
8757,15,2,13,166,419,0,0,432,142,290,GXXXXXXXXXXXXXXXXXXXGXXXXXXXXXXXXXXXXXXXGAXXXXXXXXXXXXXXXXXXGXXXXXXXXXXXXXXXXXXXGXXXXXXXXXXXXXXXXXXXGXXXXXXXXXXXXXXXXXXXGXXXXXXXXXXXXXXXXXXXGXXXXXXXXXXXXXXXXXXXGAXXXXXXXXXXXXXXXXXXGXXXXXXXXXXXXXXXXXXXGXXXXXXXXXXXXXXXXXXXGXXXXXXXXXXXXXXXXXXXGXXXXXXXXXXXXXXXXXXX,0,10,0
8778,14,0,14,166,420,0,0,433,145,288,GXXXXXXXXXXXXXXXXXXXGXXXXXXXXXXXXXXXXXXXGOXXXXXXXXXXXXXXXXXXGXXXXXXXXXXXXXXXXXXXGXXXXXXXXXXXXXXXXXXXGXXXXXXXXXXXXXXXXXXXGXXXXXXXXXXXXXXXXXXXGXXXXXXXXXXXXXXXXXXXGXXXXXXXXXXXXXXXXXXXGXXXXXXXXXXXXXXXXXXXGXXXXXXXXXXXXXXXXXXXGXXXXXXXXXXXXXXXXXXXGXXXXXXXXXXXXXXXXXXX,0,10,0
8799,14,0,14,164,422,0,0,436,142,294,GXXXXXXXXXXXXXXXXXXXGXXXXXXXXXXXXXXXXXXXGOXXXXXXXXXXXXXXXXXXGXXXXXXXXXXXXXXXXXXXGXXXXXXXXXXXXXXXXXXXGXXXXXXXXXXXXXXXXXXXGXXXXXXXXXXXXXXXXXXXGXXXXXXXXXXXXXXXXXXXGXXXXXXXXXXXXXXXXXXXGXXXXXXXXXXXXXXXXXXXGXXXXXXXXXXXXXXXXXXXGXXXXXXXXXXXXXXXXXXXGXXXXXXXXXXXXXXXXXXX,0,10,0

8820,13,0,13,160,427,0,0,441,145,296,GXXXXXXXXXXXXXXXXXXXGXXXXXXXXXXXXXXXXXXXGXXXXXXXXXXXXXXXXXXXGXXXXXXXXXXXXXXXXXXXGXXXXXXXXXXXXXXXXXXXGXXXXXXXXXXXXXXXXXXXGXXXXXXXXXXXXXXXXXXXGXXXXXXXXXXXXXXXXXXXGXXXXXXXXXXXXXXXXXXXGXXXXXXXXXXXXXXXXXXXGXXXXXXXXXXXXXXXXXXXGXXXXXXXXXXXXXXXXXXXGXXXXXXXXXXXXXXXXXXX,0,10,0
8841,13,0,13,167,420,0,0,432,148,284,GXXXXXXXXXXXXXXXXXXXGXXXXXXXXXXXXXXXXXXXGXXXXXXXXXXXXXXXXXXXGXXXXXXXXXXXXXXXXXXXGXXXXXXXXXXXXXXXXXXXGXXXXXXXXXXXXXXXXXXXGXXXXXXXXXXXXXXXXXXXGXXXXXXXXXXXXXXXXXXXGXXXXXXXXXXXXXXXXXXXGXXXXXXXXXXXXXXXXXXXGXXXXXXXXXXXXXXXXXXXGXXXXXXXXXXXXXXXXXXXGXXXXXXXXXXXXXXXXXXX,0,10,0
8862,13,0,13,170,417,0,0,428,151,277,GXXXXXXXXXXXXXXXXXXXGXXXXXXXXXXXXXXXXXXXGXXXXXXXXXXXXXXXXXXXGXXXXXXXXXXXXXXXXXXXGXXXXXXXXXXXXXXXXXXXGXXXXXXXXXXXXXXXXXXXGXXXXXXXXXXXXXXXXXXXGXXXXXXXXXXXXXXXXXXXGXXXXXXXXXXXXXXXXXXXGXXXXXXXXXXXXXXXXXXXGXXXXXXXXXXXXXXXXXXXGXXXXXXXXXXXXXXXXXXXGXXXXXXXXXXXXXXXXXXX,0,10,0
8883,13,0,13,166,421,0,0,432,145,287,GXXXXXXXXXXXXXXXXXXXGXXXXXXXXXXXXXXXXXXXGXXXXXXXXXXXXXXXXXXXGXXXXXXXXXXXXXXXXXXXGXXXXXXXXXXXXXXXXXXXGXXXXXXXXXXXXXXXXXXXGXXXXXXXXXXXXXXXXXXXGXXXXXXXXXXXXXXXXXXXGXXXXXXXXXXXXXXXXXXXGXXXXXXXXXXXXXXXXXXXGXXXXXXXXXXXXXXXXXXXGXXXXXXXXXXXXXXXXXXXGXXXXXXXXXXXXXXXXXXX,0,10,0
8904,14,1,13,170,416,0,0,429,158,271,GXXXXXXXXXXXXXXXXXXXGXXXXXXXXXXXXXXXXXXXGXXXXXXXXXXXXXXXXXXXGXXXXXXXXXXXXXXXXXXXGXXXXXXXXXXXXXXXXXXXGXXXXXXXXXXXXXXXXXXXGXXXXXXXXXXXXXXXXXXXGXXXXXXXXXXXXXXXXXXXGAXXXXXXXXXXXXXXXXXXGXXXXXXXXXXXXXXXXXXXGXXXXXXXXXXXXXXXXXXXGXXXXXXXXXXXXXXXXXXXGXXXXXXXXXXXXXXXXXXX,0,10,0

8925,14,1,13,176,410,0,0,423,160,263,GXXXXXXXXXXXXXXXXXXXGXXXXXXXXXXXXXXXXXXXGXXXXXXXXXXXXXXXXXXXGXXXXXXXXXXXXXXXXXXXGXXXXXXXXXXXXXXXXXXXGXXXXXXXXXXXXXXXXXXXGXXXXXXXXXXXXXXXXXXXGXXXXXXXXXXXXXXXXXXXGAXXXXXXXXXXXXXXXXXXGXXXXXXXXXXXXXXXXXXXGXXXXXXXXXXXXXXXXXXXGXXXXXXXXXXXXXXXXXXXGXXXXXXXXXXXXXXXXXXX,0,10,0
8946,14,1,13,171,415,0,0,427,160,267,GXXXXXXXXXXXXXXXXXXXGXXXXXXXXXXXXXXXXXXXGXXXXXXXXXXXXXXXXXXXGXXXXXXXXXXXXXXXXXXXGXXXXXXXXXXXXXXXXXXXGXXXXXXXXXXXXXXXXXXXGXXXXXXXXXXXXXXXXXXXGXXXXXXXXXXXXXXXXXXXGAXXXXXXXXXXXXXXXXXXGXXXXXXXXXXXXXXXXXXXGXXXXXXXXXXXXXXXXXXXGXXXXXXXXXXXXXXXXXXXGXXXXXXXXXXXXXXXXXXX,0,10,0
8967,14,1,13,159,427,0,0,438,154,284,GXXXXXXXXXXXXXXXXXXXGXXXXXXXXXXXXXXXXXXXGXXXXXXXXXXXXXXXXXXXGXXXXXXXXXXXXXXXXXXXGXXXXXXXXXXXXXXXXXXXGXXXXXXXXXXXXXXXXXXXGXXXXXXXXXXXXXXXXXXXGXXXXXXXXXXXXXXXXXXXGAXXXXXXXXXXXXXXXXXXGXXXXXXXXXXXXXXXXXXXGXXXXXXXXXXXXXXXXXXXGXXXXXXXXXXXXXXXXXXXGXXXXXXXXXXXXXXXXXXX,0,10,0
8988,14,1,13,157,429,0,0,443,149,294,GXXXXXXXXXXXXXXXXXXXGXXXXXXXXXXXXXXXXXXXGXXXXXXXXXXXXXXXXXXXGXXXXXXXXXXXXXXXXXXXGXXXXXXXXXXXXXXXXXXXGXXXXXXXXXXXXXXXXXXXGXXXXXXXXXXXXXXXXXXXGXXXXXXXXXXXXXXXXXXXGAXXXXXXXXXXXXXXXXXXGXXXXXXXXXXXXXXXXXXXGXXXXXXXXXXXXXXXXXXXGXXXXXXXXXXXXXXXXXXXGXXXXXXXXXXXXXXXXXXX,0,10,0
9009,14,1,13,159,427,0,0,441,148,293,GXXXXXXXXXXXXXXXXXXXGXXXXXXXXXXXXXXXXXXXGXXXXXXXXXXXXXXXXXXXGXXXXXXXXXXXXXXXXXXXGXXXXXXXXXXXXXXXXXXXGXXXXXXXXXXXXXXXXXXXGXXXXXXXXXXXXXXXXXXXGXXXXXXXXXXXXXXXXXXXGAXXXXXXXXXXXXXXXXXXGXXXXXXXXXXXXXXXXXXXGXXXXXXXXXXXXXXXXXXXGXXXXXXXXXXXXXXXXXXXGXXXXXXXXXXXXXXXXXXX,0,10,0

9030,14,0,14,163,423,0,0,436,145,291,GXXXXXXXXXXXXXXXXXXXGXXXXXXXXXXXXXXXXXXXGXXXXXXXXXXXXXXXXXXXGXXXXXXXXXXXXXXXXXXXGXXXXXXXXXXXXXXXXXXXGXXXXXXXXXXXXXXXXXXXGXXXXXXXXXXXXXXXXXXXGXXXXXXXXXXXXXXXXXXXGOXXXXXXXXXXXXXXXXXXGXXXXXXXXXXXXXXXXXXXGXXXXXXXXXXXXXXXXXXXGXXXXXXXXXXXXXXXXXXXGXXXXXXXXXXXXXXXXXXX,0,10,0
9051,14,1,13,164,422,0,0,433,147,286,GXXXXXXXXXXXXXXXXXXXGXXXXXXXXXXXXXXXXXXXGXXXXXXXXXXXXXXXXXXXGAXXXXXXXXXXXXXXXXXXGXXXXXXXXXXXXXXXXXXXGXXXXXXXXXXXXXXXXXXXGXXXXXXXXXXXXXXXXXXXGXXXXXXXXXXXXXXXXXXXGXXXXXXXXXXXXXXXXXXXGXXXXXXXXXXXXXXXXXXXGXXXXXXXXXXXXXXXXXXXGXXXXXXXXXXXXXXXXXXXGXXXXXXXXXXXXXXXXXXX,0,10,0
9072,14,1,13,164,422,0,0,435,148,287,GXXXXXXXXXXXXXXXXXXXGXXXXXXXXXXXXXXXXXXXGXXXXXXXXXXXXXXXXXXXGAXXXXXXXXXXXXXXXXXXGXXXXXXXXXXXXXXXXXXXGXXXXXXXXXXXXXXXXXXXGXXXXXXXXXXXXXXXXXXXGXXXXXXXXXXXXXXXXXXXGXXXXXXXXXXXXXXXXXXXGXXXXXXXXXXXXXXXXXXXGXXXXXXXXXXXXXXXXXXXGXXXXXXXXXXXXXXXXXXXGXXXXXXXXXXXXXXXXXXX,0,10,0
9093,14,1,13,167,419,0,0,433,147,286,GXXXXXXXXXXXXXXXXXXXGXXXXXXXXXXXXXXXXXXXGXXXXXXXXXXXXXXXXXXXGAXXXXXXXXXXXXXXXXXXGXXXXXXXXXXXXXXXXXXXGXXXXXXXXXXXXXXXXXXXGXXXXXXXXXXXXXXXXXXXGXXXXXXXXXXXXXXXXXXXGXXXXXXXXXXXXXXXXXXXGXXXXXXXXXXXXXXXXXXXGXXXXXXXXXXXXXXXXXXXGXXXXXXXXXXXXXXXXXXXGXXXXXXXXXXXXXXXXXXX,0,10,0
9114,14,1,13,167,419,0,0,433,153,280,GXXXXXXXXXXXXXXXXXXXGXXXXXXXXXXXXXXXXXXXGXXXXXXXXXXXXXXXXXXXGAXXXXXXXXXXXXXXXXXXGXXXXXXXXXXXXXXXXXXXGXXXXXXXXXXXXXXXXXXXGXXXXXXXXXXXXXXXXXXXGXXXXXXXXXXXXXXXXXXXGXXXXXXXXXXXXXXXXXXXGXXXXXXXXXXXXXXXXXXXGXXXXXXXXXXXXXXXXXXXGXXXXXXXXXXXXXXXXXXXGXXXXXXXXXXXXXXXXXXX,0,10,0

9135,14,1,13,163,423,0,0,436,162,274,GXXXXXXXXXXXXXXXXXXXGXXXXXXXXXXXXXXXXXXXGXXXXXXXXXXXXXXXXXXXGAXXXXXXXXXXXXXXXXXXGXXXXXXXXXXXXXXXXXXXGXXXXXXXXXXXXXXXXXXXGXXXXXXXXXXXXXXXXXXXGXXXXXXXXXXXXXXXXXXXGXXXXXXXXXXXXXXXXXXXGXXXXXXXXXXXXXXXXXXXGXXXXXXXXXXXXXXXXXXXGXXXXXXXXXXXXXXXXXXXGXXXXXXXXXXXXXXXXXXX,0,10,0
9156,14,1,13,175,411,0,0,424,155,269,GXXXXXXXXXXXXXXXXXXXGXXXXXXXXXXXXXXXXXXXGXXXXXXXXXXXXXXXXXXXGAXXXXXXXXXXXXXXXXXXGXXXXXXXXXXXXXXXXXXXGXXXXXXXXXXXXXXXXXXXGXXXXXXXXXXXXXXXXXXXGXXXXXXXXXXXXXXXXXXXGXXXXXXXXXXXXXXXXXXXGXXXXXXXXXXXXXXXXXXXGXXXXXXXXXXXXXXXXXXXGXXXXXXXXXXXXXXXXXXXGXXXXXXXXXXXXXXXXXXX,0,10,0
9177,14,1,13,176,410,0,0,425,151,274,GXXXXXXXXXXXXXXXXXXXGXXXXXXXXXXXXXXXXXXXGXXXXXXXXXXXXXXXXXXXGAXXXXXXXXXXXXXXXXXXGXXXXXXXXXXXXXXXXXXXGXXXXXXXXXXXXXXXXXXXGXXXXXXXXXXXXXXXXXXXGXXXXXXXXXXXXXXXXXXXGXXXXXXXXXXXXXXXXXXXGXXXXXXXXXXXXXXXXXXXGXXXXXXXXXXXXXXXXXXXGXXXXXXXXXXXXXXXXXXXGXXXXXXXXXXXXXXXXXXX,0,10,0
9198,14,1,13,171,415,0,0,430,145,285,GXXXXXXXXXXXXXXXXXXXGXXXXXXXXXXXXXXXXXXXGXXXXXXXXXXXXXXXXXXXGAXXXXXXXXXXXXXXXXXXGXXXXXXXXXXXXXXXXXXXGXXXXXXXXXXXXXXXXXXXGXXXXXXXXXXXXXXXXXXXGXXXXXXXXXXXXXXXXXXXGXXXXXXXXXXXXXXXXXXXGXXXXXXXXXXXXXXXXXXXGXXXXXXXXXXXXXXXXXXXGXXXXXXXXXXXXXXXXXXXGXXXXXXXXXXXXXXXXXXX,0,10,0
9219,16,3,13,171,413,0,0,429,143,286,GXXXXXXXXXXXXXXXXXXXGXXXXXXXXXXXXXXXXXXXGXXXXXXXXXXXXXXXXXXXGAXXXXXXXXXXXXXXXXXXGXXXXXXXXXXXXXXXXXXXGXXXXXXXXXXXXXXXXXXXGXXXXXXXXXXXXXXXXXXXGXXXXXXXXXXXXXXXXXXXGAXXXXXXXXXXXXXXXXXXGAXXXXXXXXXXXXXXXXXXGXXXXXXXXXXXXXXXXXXXGXXXXXXXXXXXXXXXXXXXGXXXXXXXXXXXXXXXXXXX,0,10,0

9240,16,3,13,168,416,0,0,432,149,283,GXXXXXXXXXXXXXXXXXXXGXXXXXXXXXXXXXXXXXXXGXXXXXXXXXXXXXXXXXXXGAXXXXXXXXXXXXXXXXXXGXXXXXXXXXXXXXXXXXXXGXXXXXXXXXXXXXXXXXXXGXXXXXXXXXXXXXXXXXXXGXXXXXXXXXXXXXXXXXXXGAXXXXXXXXXXXXXXXXXXGAXXXXXXXXXXXXXXXXXXGXXXXXXXXXXXXXXXXXXXGXXXXXXXXXXXXXXXXXXXGXXXXXXXXXXXXXXXXXXX,0,10,0
9261,16,3,13,179,405,0,0,421,151,270,GXXXXXXXXXXXXXXXXXXXGXXXXXXXXXXXXXXXXXXXGXXXXXXXXXXXXXXXXXXXGAXXXXXXXXXXXXXXXXXXGXXXXXXXXXXXXXXXXXXXGXXXXXXXXXXXXXXXXXXXGXXXXXXXXXXXXXXXXXXXGXXXXXXXXXXXXXXXXXXXGAXXXXXXXXXXXXXXXXXXGAXXXXXXXXXXXXXXXXXXGXXXXXXXXXXXXXXXXXXXGXXXXXXXXXXXXXXXXXXXGXXXXXXXXXXXXXXXXXXX,0,10,0
9282,16,2,14,171,413,0,0,429,150,279,GXXXXXXXXXXXXXXXXXXXGXXXXXXXXXXXXXXXXXXXGXXXXXXXXXXXXXXXXXXXGOXXXXXXXXXXXXXXXXXXGXXXXXXXXXXXXXXXXXXXGXXXXXXXXXXXXXXXXXXXGXXXXXXXXXXXXXXXXXXXGXXXXXXXXXXXXXXXXXXXGAXXXXXXXXXXXXXXXXXXGAXXXXXXXXXXXXXXXXXXGXXXXXXXXXXXXXXXXXXXGXXXXXXXXXXXXXXXXXXXGXXXXXXXXXXXXXXXXXXX,0,10,0
9303,16,3,13,173,411,0,0,426,148,278,GXXXXXXXXXXXXXXXXXXXGXXXXXXXXXXXXXXXXXXXGAXXXXXXXXXXXXXXXXXXGXXXXXXXXXXXXXXXXXXXGXXXXXXXXXXXXXXXXXXXGXXXXXXXXXXXXXXXXXXXGXXXXXXXXXXXXXXXXXXXGXXXXXXXXXXXXXXXXXXXGAXXXXXXXXXXXXXXXXXXGAXXXXXXXXXXXXXXXXXXGXXXXXXXXXXXXXXXXXXXGXXXXXXXXXXXXXXXXXXXGXXXXXXXXXXXXXXXXXXX,0,10,0
9324,16,2,14,164,420,0,0,436,154,282,GXXXXXXXXXXXXXXXXXXXGXXXXXXXXXXXXXXXXXXXGOXXXXXXXXXXXXXXXXXXGXXXXXXXXXXXXXXXXXXXGXXXXXXXXXXXXXXXXXXXGXXXXXXXXXXXXXXXXXXXGXXXXXXXXXXXXXXXXXXXGXXXXXXXXXXXXXXXXXXXGAXXXXXXXXXXXXXXXXXXGAXXXXXXXXXXXXXXXXXXGXXXXXXXXXXXXXXXXXXXGXXXXXXXXXXXXXXXXXXXGXXXXXXXXXXXXXXXXXXX,0,10,0

9345,16,2,14,167,417,0,0,434,155,279,GXXXXXXXXXXXXXXXXXXXGXXXXXXXXXXXXXXXXXXXGOXXXXXXXXXXXXXXXXXXGXXXXXXXXXXXXXXXXXXXGXXXXXXXXXXXXXXXXXXXGXXXXXXXXXXXXXXXXXXXGXXXXXXXXXXXXXXXXXXXGXXXXXXXXXXXXXXXXXXXGAXXXXXXXXXXXXXXXXXXGAXXXXXXXXXXXXXXXXXXGXXXXXXXXXXXXXXXXXXXGXXXXXXXXXXXXXXXXXXXGXXXXXXXXXXXXXXXXXXX,0,10,0
9366,16,1,15,175,409,0,0,426,152,274,GXXXXXXXXXXXXXXXXXXXGXXXXXXXXXXXXXXXXXXXGOXXXXXXXXXXXXXXXXXXGXXXXXXXXXXXXXXXXXXXGXXXXXXXXXXXXXXXXXXXGXXXXXXXXXXXXXXXXXXXGXXXXXXXXXXXXXXXXXXXGXXXXXXXXXXXXXXXXXXXGAXXXXXXXXXXXXXXXXXXGOXXXXXXXXXXXXXXXXXXGXXXXXXXXXXXXXXXXXXXGXXXXXXXXXXXXXXXXXXXGXXXXXXXXXXXXXXXXXXX,0,10,0
9387,17,2,15,168,415,0,0,431,156,275,GXXXXXXXXXXXXXXXXXXXGAXXXXXXXXXXXXXXXXXXGOXXXXXXXXXXXXXXXXXXGXXXXXXXXXXXXXXXXXXXGXXXXXXXXXXXXXXXXXXXGXXXXXXXXXXXXXXXXXXXGXXXXXXXXXXXXXXXXXXXGXXXXXXXXXXXXXXXXXXXGAXXXXXXXXXXXXXXXXXXGOXXXXXXXXXXXXXXXXXXGXXXXXXXXXXXXXXXXXXXGXXXXXXXXXXXXXXXXXXXGXXXXXXXXXXXXXXXXXXX,0,10,0
9408,15,2,13,161,424,0,0,442,152,290,GXXXXXXXXXXXXXXXXXXXGAXXXXXXXXXXXXXXXXXXGXXXXXXXXXXXXXXXXXXXGXXXXXXXXXXXXXXXXXXXGXXXXXXXXXXXXXXXXXXXGXXXXXXXXXXXXXXXXXXXGXXXXXXXXXXXXXXXXXXXGXXXXXXXXXXXXXXXXXXXGAXXXXXXXXXXXXXXXXXXGXXXXXXXXXXXXXXXXXXXGXXXXXXXXXXXXXXXXXXXGXXXXXXXXXXXXXXXXXXXGXXXXXXXXXXXXXXXXXXX,0,10,0
9429,15,2,13,160,425,0,0,443,156,287,GXXXXXXXXXXXXXXXXXXXGAXXXXXXXXXXXXXXXXXXGXXXXXXXXXXXXXXXXXXXGXXXXXXXXXXXXXXXXXXXGXXXXXXXXXXXXXXXXXXXGXXXXXXXXXXXXXXXXXXXGXXXXXXXXXXXXXXXXXXXGXXXXXXXXXXXXXXXXXXXGAXXXXXXXXXXXXXXXXXXGXXXXXXXXXXXXXXXXXXXGXXXXXXXXXXXXXXXXXXXGXXXXXXXXXXXXXXXXXXXGXXXXXXXXXXXXXXXXXXX,0,10,0

9450,15,1,14,165,420,0,0,437,149,288,GXXXXXXXXXXXXXXXXXXXGAXXXXXXXXXXXXXXXXXXGXXXXXXXXXXXXXXXXXXXGXXXXXXXXXXXXXXXXXXXGXXXXXXXXXXXXXXXXXXXGXXXXXXXXXXXXXXXXXXXGXXXXXXXXXXXXXXXXXXXGXXXXXXXXXXXXXXXXXXXGOXXXXXXXXXXXXXXXXXXGXXXXXXXXXXXXXXXXXXXGXXXXXXXXXXXXXXXXXXXGXXXXXXXXXXXXXXXXXXXGXXXXXXXXXXXXXXXXXXX,0,10,0
9471,14,1,13,162,424,0,0,440,156,284,GXXXXXXXXXXXXXXXXXXXGAXXXXXXXXXXXXXXXXXXGXXXXXXXXXXXXXXXXXXXGXXXXXXXXXXXXXXXXXXXGXXXXXXXXXXXXXXXXXXXGXXXXXXXXXXXXXXXXXXXGXXXXXXXXXXXXXXXXXXXGXXXXXXXXXXXXXXXXXXXGXXXXXXXXXXXXXXXXXXXGXXXXXXXXXXXXXXXXXXXGXXXXXXXXXXXXXXXXXXXGXXXXXXXXXXXXXXXXXXXGXXXXXXXXXXXXXXXXXXX,0,10,0
9492,14,1,13,167,419,0,0,436,150,286,GXXXXXXXXXXXXXXXXXXXGAXXXXXXXXXXXXXXXXXXGXXXXXXXXXXXXXXXXXXXGXXXXXXXXXXXXXXXXXXXGXXXXXXXXXXXXXXXXXXXGXXXXXXXXXXXXXXXXXXXGXXXXXXXXXXXXXXXXXXXGXXXXXXXXXXXXXXXXXXXGXXXXXXXXXXXXXXXXXXXGXXXXXXXXXXXXXXXXXXXGXXXXXXXXXXXXXXXXXXXGXXXXXXXXXXXXXXXXXXXGXXXXXXXXXXXXXXXXXXX,0,10,0
9513,13,0,13,168,419,0,0,435,149,286,GXXXXXXXXXXXXXXXXXXXGXXXXXXXXXXXXXXXXXXXGXXXXXXXXXXXXXXXXXXXGXXXXXXXXXXXXXXXXXXXGXXXXXXXXXXXXXXXXXXXGXXXXXXXXXXXXXXXXXXXGXXXXXXXXXXXXXXXXXXXGXXXXXXXXXXXXXXXXXXXGXXXXXXXXXXXXXXXXXXXGXXXXXXXXXXXXXXXXXXXGXXXXXXXXXXXXXXXXXXXGXXXXXXXXXXXXXXXXXXXGXXXXXXXXXXXXXXXXXXX,0,10,0
9534,13,0,13,169,418,0,0,433,152,281,GXXXXXXXXXXXXXXXXXXXGXXXXXXXXXXXXXXXXXXXGXXXXXXXXXXXXXXXXXXXGXXXXXXXXXXXXXXXXXXXGXXXXXXXXXXXXXXXXXXXGXXXXXXXXXXXXXXXXXXXGXXXXXXXXXXXXXXXXXXXGXXXXXXXXXXXXXXXXXXXGXXXXXXXXXXXXXXXXXXXGXXXXXXXXXXXXXXXXXXXGXXXXXXXXXXXXXXXXXXXGXXXXXXXXXXXXXXXXXXXGXXXXXXXXXXXXXXXXXXX,0,10,0

9555,15,2,13,167,418,0,0,433,153,280,GXXXXXXXXXXXXXXXXXXXGXXXXXXXXXXXXXXXXXXXGXXXXXXXXXXXXXXXXXXXGAXXXXXXXXXXXXXXXXXXGXXXXXXXXXXXXXXXXXXXGAXXXXXXXXXXXXXXXXXXGXXXXXXXXXXXXXXXXXXXGXXXXXXXXXXXXXXXXXXXGXXXXXXXXXXXXXXXXXXXGXXXXXXXXXXXXXXXXXXXGXXXXXXXXXXXXXXXXXXXGXXXXXXXXXXXXXXXXXXXGXXXXXXXXXXXXXXXXXXX,0,10,0
9576,15,1,14,160,425,0,0,440,153,287,GXXXXXXXXXXXXXXXXXXXGXXXXXXXXXXXXXXXXXXXGXXXXXXXXXXXXXXXXXXXGAXXXXXXXXXXXXXXXXXXGXXXXXXXXXXXXXXXXXXXGOXXXXXXXXXXXXXXXXXXGXXXXXXXXXXXXXXXXXXXGXXXXXXXXXXXXXXXXXXXGXXXXXXXXXXXXXXXXXXXGXXXXXXXXXXXXXXXXXXXGXXXXXXXXXXXXXXXXXXXGXXXXXXXXXXXXXXXXXXXGXXXXXXXXXXXXXXXXXXX,0,10,0
9597,15,1,14,159,426,0,0,444,161,283,GXXXXXXXXXXXXXXXXXXXGXXXXXXXXXXXXXXXXXXXGXXXXXXXXXXXXXXXXXXXGAXXXXXXXXXXXXXXXXXXGXXXXXXXXXXXXXXXXXXXGOXXXXXXXXXXXXXXXXXXGXXXXXXXXXXXXXXXXXXXGXXXXXXXXXXXXXXXXXXXGXXXXXXXXXXXXXXXXXXXGXXXXXXXXXXXXXXXXXXXGXXXXXXXXXXXXXXXXXXXGXXXXXXXXXXXXXXXXXXXGXXXXXXXXXXXXXXXXXXX,0,10,0
9618,14,1,13,154,432,0,0,450,162,288,GXXXXXXXXXXXXXXXXXXXGXXXXXXXXXXXXXXXXXXXGXXXXXXXXXXXXXXXXXXXGAXXXXXXXXXXXXXXXXXXGXXXXXXXXXXXXXXXXXXXGXXXXXXXXXXXXXXXXXXXGXXXXXXXXXXXXXXXXXXXGXXXXXXXXXXXXXXXXXXXGXXXXXXXXXXXXXXXXXXXGXXXXXXXXXXXXXXXXXXXGXXXXXXXXXXXXXXXXXXXGXXXXXXXXXXXXXXXXXXXGXXXXXXXXXXXXXXXXXXX,0,10,0
9639,13,0,13,156,431,0,0,449,159,290,GXXXXXXXXXXXXXXXXXXXGXXXXXXXXXXXXXXXXXXXGXXXXXXXXXXXXXXXXXXXGXXXXXXXXXXXXXXXXXXXGXXXXXXXXXXXXXXXXXXXGXXXXXXXXXXXXXXXXXXXGXXXXXXXXXXXXXXXXXXXGXXXXXXXXXXXXXXXXXXXGXXXXXXXXXXXXXXXXXXXGXXXXXXXXXXXXXXXXXXXGXXXXXXXXXXXXXXXXXXXGXXXXXXXXXXXXXXXXXXXGXXXXXXXXXXXXXXXXXXX,0,10,0

9660,13,0,13,154,433,0,0,450,166,284,GXXXXXXXXXXXXXXXXXXXGXXXXXXXXXXXXXXXXXXXGXXXXXXXXXXXXXXXXXXXGXXXXXXXXXXXXXXXXXXXGXXXXXXXXXXXXXXXXXXXGXXXXXXXXXXXXXXXXXXXGXXXXXXXXXXXXXXXXXXXGXXXXXXXXXXXXXXXXXXXGXXXXXXXXXXXXXXXXXXXGXXXXXXXXXXXXXXXXXXXGXXXXXXXXXXXXXXXXXXXGXXXXXXXXXXXXXXXXXXXGXXXXXXXXXXXXXXXXXXX,0,10,0
9681,14,1,13,159,427,0,0,445,160,285,GXXXXXXXXXXXXXXXXXXXGXXXXXXXXXXXXXXXXXXXGXXXXXXXXXXXXXXXXXXXGAXXXXXXXXXXXXXXXXXXGXXXXXXXXXXXXXXXXXXXGXXXXXXXXXXXXXXXXXXXGXXXXXXXXXXXXXXXXXXXGXXXXXXXXXXXXXXXXXXXGXXXXXXXXXXXXXXXXXXXGXXXXXXXXXXXXXXXXXXXGXXXXXXXXXXXXXXXXXXXGXXXXXXXXXXXXXXXXXXXGXXXXXXXXXXXXXXXXXXX,0,10,0
9702,14,1,13,159,427,0,0,446,166,280,GXXXXXXXXXXXXXXXXXXXGXXXXXXXXXXXXXXXXXXXGXXXXXXXXXXXXXXXXXXXGAXXXXXXXXXXXXXXXXXXGXXXXXXXXXXXXXXXXXXXGXXXXXXXXXXXXXXXXXXXGXXXXXXXXXXXXXXXXXXXGXXXXXXXXXXXXXXXXXXXGXXXXXXXXXXXXXXXXXXXGXXXXXXXXXXXXXXXXXXXGXXXXXXXXXXXXXXXXXXXGXXXXXXXXXXXXXXXXXXXGXXXXXXXXXXXXXXXXXXX,0,10,0
9723,13,0,13,165,422,0,0,440,166,274,GXXXXXXXXXXXXXXXXXXXGXXXXXXXXXXXXXXXXXXXGXXXXXXXXXXXXXXXXXXXGXXXXXXXXXXXXXXXXXXXGXXXXXXXXXXXXXXXXXXXGXXXXXXXXXXXXXXXXXXXGXXXXXXXXXXXXXXXXXXXGXXXXXXXXXXXXXXXXXXXGXXXXXXXXXXXXXXXXXXXGXXXXXXXXXXXXXXXXXXXGXXXXXXXXXXXXXXXXXXXGXXXXXXXXXXXXXXXXXXXGXXXXXXXXXXXXXXXXXXX,0,10,0
9744,13,0,13,169,418,0,0,435,163,272,GXXXXXXXXXXXXXXXXXXXGXXXXXXXXXXXXXXXXXXXGXXXXXXXXXXXXXXXXXXXGXXXXXXXXXXXXXXXXXXXGXXXXXXXXXXXXXXXXXXXGXXXXXXXXXXXXXXXXXXXGXXXXXXXXXXXXXXXXXXXGXXXXXXXXXXXXXXXXXXXGXXXXXXXXXXXXXXXXXXXGXXXXXXXXXXXXXXXXXXXGXXXXXXXXXXXXXXXXXXXGXXXXXXXXXXXXXXXXXXXGXXXXXXXXXXXXXXXXXXX,0,10,0

9765,13,0,13,169,418,0,0,435,160,275,GXXXXXXXXXXXXXXXXXXXGXXXXXXXXXXXXXXXXXXXGXXXXXXXXXXXXXXXXXXXGXXXXXXXXXXXXXXXXXXXGXXXXXXXXXXXXXXXXXXXGXXXXXXXXXXXXXXXXXXXGXXXXXXXXXXXXXXXXXXXGXXXXXXXXXXXXXXXXXXXGXXXXXXXXXXXXXXXXXXXGXXXXXXXXXXXXXXXXXXXGXXXXXXXXXXXXXXXXXXXGXXXXXXXXXXXXXXXXXXXGXXXXXXXXXXXXXXXXXXX,0,10,0
9786,13,0,13,171,416,0,0,433,163,270,GXXXXXXXXXXXXXXXXXXXGXXXXXXXXXXXXXXXXXXXGXXXXXXXXXXXXXXXXXXXGXXXXXXXXXXXXXXXXXXXGXXXXXXXXXXXXXXXXXXXGXXXXXXXXXXXXXXXXXXXGXXXXXXXXXXXXXXXXXXXGXXXXXXXXXXXXXXXXXXXGXXXXXXXXXXXXXXXXXXXGXXXXXXXXXXXXXXXXXXXGXXXXXXXXXXXXXXXXXXXGXXXXXXXXXXXXXXXXXXXGXXXXXXXXXXXXXXXXXXX,0,10,0
9807,13,0,13,165,422,0,0,440,162,278,GXXXXXXXXXXXXXXXXXXXGXXXXXXXXXXXXXXXXXXXGXXXXXXXXXXXXXXXXXXXGXXXXXXXXXXXXXXXXXXXGXXXXXXXXXXXXXXXXXXXGXXXXXXXXXXXXXXXXXXXGXXXXXXXXXXXXXXXXXXXGXXXXXXXXXXXXXXXXXXXGXXXXXXXXXXXXXXXXXXXGXXXXXXXXXXXXXXXXXXXGXXXXXXXXXXXXXXXXXXXGXXXXXXXXXXXXXXXXXXXGXXXXXXXXXXXXXXXXXXX,0,10,0
9828,13,0,13,156,431,0,0,449,168,281,GXXXXXXXXXXXXXXXXXXXGXXXXXXXXXXXXXXXXXXXGXXXXXXXXXXXXXXXXXXXGXXXXXXXXXXXXXXXXXXXGXXXXXXXXXXXXXXXXXXXGXXXXXXXXXXXXXXXXXXXGXXXXXXXXXXXXXXXXXXXGXXXXXXXXXXXXXXXXXXXGXXXXXXXXXXXXXXXXXXXGXXXXXXXXXXXXXXXXXXXGXXXXXXXXXXXXXXXXXXXGXXXXXXXXXXXXXXXXXXXGXXXXXXXXXXXXXXXXXXX,0,10,0
9849,13,0,13,160,427,0,0,444,168,276,GXXXXXXXXXXXXXXXXXXXGXXXXXXXXXXXXXXXXXXXGXXXXXXXXXXXXXXXXXXXGXXXXXXXXXXXXXXXXXXXGXXXXXXXXXXXXXXXXXXXGXXXXXXXXXXXXXXXXXXXGXXXXXXXXXXXXXXXXXXXGXXXXXXXXXXXXXXXXXXXGXXXXXXXXXXXXXXXXXXXGXXXXXXXXXXXXXXXXXXXGXXXXXXXXXXXXXXXXXXXGXXXXXXXXXXXXXXXXXXXGXXXXXXXXXXXXXXXXXXX,0,10,0

9870,13,0,13,161,426,0,0,443,169,274,GXXXXXXXXXXXXXXXXXXXGXXXXXXXXXXXXXXXXXXXGXXXXXXXXXXXXXXXXXXXGXXXXXXXXXXXXXXXXXXXGXXXXXXXXXXXXXXXXXXXGXXXXXXXXXXXXXXXXXXXGXXXXXXXXXXXXXXXXXXXGXXXXXXXXXXXXXXXXXXXGXXXXXXXXXXXXXXXXXXXGXXXXXXXXXXXXXXXXXXXGXXXXXXXXXXXXXXXXXXXGXXXXXXXXXXXXXXXXXXXGXXXXXXXXXXXXXXXXXXX,0,10,0
9891,13,0,13,156,431,0,0,448,165,283,GXXXXXXXXXXXXXXXXXXXGXXXXXXXXXXXXXXXXXXXGXXXXXXXXXXXXXXXXXXXGXXXXXXXXXXXXXXXXXXXGXXXXXXXXXXXXXXXXXXXGXXXXXXXXXXXXXXXXXXXGXXXXXXXXXXXXXXXXXXXGXXXXXXXXXXXXXXXXXXXGXXXXXXXXXXXXXXXXXXXGXXXXXXXXXXXXXXXXXXXGXXXXXXXXXXXXXXXXXXXGXXXXXXXXXXXXXXXXXXXGXXXXXXXXXXXXXXXXXXX,0,10,0
9912,13,0,13,158,429,0,0,445,163,282,GXXXXXXXXXXXXXXXXXXXGXXXXXXXXXXXXXXXXXXXGXXXXXXXXXXXXXXXXXXXGXXXXXXXXXXXXXXXXXXXGXXXXXXXXXXXXXXXXXXXGXXXXXXXXXXXXXXXXXXXGXXXXXXXXXXXXXXXXXXXGXXXXXXXXXXXXXXXXXXXGXXXXXXXXXXXXXXXXXXXGXXXXXXXXXXXXXXXXXXXGXXXXXXXXXXXXXXXXXXXGXXXXXXXXXXXXXXXXXXXGXXXXXXXXXXXXXXXXXXX,0,10,0
9933,13,0,13,154,433,0,0,449,162,287,GXXXXXXXXXXXXXXXXXXXGXXXXXXXXXXXXXXXXXXXGXXXXXXXXXXXXXXXXXXXGXXXXXXXXXXXXXXXXXXXGXXXXXXXXXXXXXXXXXXXGXXXXXXXXXXXXXXXXXXXGXXXXXXXXXXXXXXXXXXXGXXXXXXXXXXXXXXXXXXXGXXXXXXXXXXXXXXXXXXXGXXXXXXXXXXXXXXXXXXXGXXXXXXXXXXXXXXXXXXXGXXXXXXXXXXXXXXXXXXXGXXXXXXXXXXXXXXXXXXX,0,10,0
9954,13,0,13,154,433,0,0,447,174,273,GXXXXXXXXXXXXXXXXXXXGXXXXXXXXXXXXXXXXXXXGXXXXXXXXXXXXXXXXXXXGXXXXXXXXXXXXXXXXXXXGXXXXXXXXXXXXXXXXXXXGXXXXXXXXXXXXXXXXXXXGXXXXXXXXXXXXXXXXXXXGXXXXXXXXXXXXXXXXXXXGXXXXXXXXXXXXXXXXXXXGXXXXXXXXXXXXXXXXXXXGXXXXXXXXXXXXXXXXXXXGXXXXXXXXXXXXXXXXXXXGXXXXXXXXXXXXXXXXXXX,0,10,0

9975,13,0,13,165,422,0,0,438,171,267,GXXXXXXXXXXXXXXXXXXXGXXXXXXXXXXXXXXXXXXXGXXXXXXXXXXXXXXXXXXXGXXXXXXXXXXXXXXXXXXXGXXXXXXXXXXXXXXXXXXXGXXXXXXXXXXXXXXXXXXXGXXXXXXXXXXXXXXXXXXXGXXXXXXXXXXXXXXXXXXXGXXXXXXXXXXXXXXXXXXXGXXXXXXXXXXXXXXXXXXXGXXXXXXXXXXXXXXXXXXXGXXXXXXXXXXXXXXXXXXXGXXXXXXXXXXXXXXXXXXX,0,10,0
9996,13,0,13,171,416,0,0,433,162,271,GXXXXXXXXXXXXXXXXXXXGXXXXXXXXXXXXXXXXXXXGXXXXXXXXXXXXXXXXXXXGXXXXXXXXXXXXXXXXXXXGXXXXXXXXXXXXXXXXXXXGXXXXXXXXXXXXXXXXXXXGXXXXXXXXXXXXXXXXXXXGXXXXXXXXXXXXXXXXXXXGXXXXXXXXXXXXXXXXXXXGXXXXXXXXXXXXXXXXXXXGXXXXXXXXXXXXXXXXXXXGXXXXXXXXXXXXXXXXXXXGXXXXXXXXXXXXXXXXXXX,0,10,0
10017,13,0,13,171,416,0,0,431,163,268,GXXXXXXXXXXXXXXXXXXXGXXXXXXXXXXXXXXXXXXXGXXXXXXXXXXXXXXXXXXXGXXXXXXXXXXXXXXXXXXXGXXXXXXXXXXXXXXXXXXXGXXXXXXXXXXXXXXXXXXXGXXXXXXXXXXXXXXXXXXXGXXXXXXXXXXXXXXXXXXXGXXXXXXXXXXXXXXXXXXXGXXXXXXXXXXXXXXXXXXXGXXXXXXXXXXXXXXXXXXXGXXXXXXXXXXXXXXXXXXXGXXXXXXXXXXXXXXXXXXX,0,10,0
10038,13,0,13,170,417,0,0,434,167,267,GXXXXXXXXXXXXXXXXXXXGXXXXXXXXXXXXXXXXXXXGXXXXXXXXXXXXXXXXXXXGXXXXXXXXXXXXXXXXXXXGXXXXXXXXXXXXXXXXXXXGXXXXXXXXXXXXXXXXXXXGXXXXXXXXXXXXXXXXXXXGXXXXXXXXXXXXXXXXXXXGXXXXXXXXXXXXXXXXXXXGXXXXXXXXXXXXXXXXXXXGXXXXXXXXXXXXXXXXXXXGXXXXXXXXXXXXXXXXXXXGXXXXXXXXXXXXXXXXXXX,0,10,0
10059,13,0,13,164,423,0,0,438,168,270,GXXXXXXXXXXXXXXXXXXXGXXXXXXXXXXXXXXXXXXXGXXXXXXXXXXXXXXXXXXXGXXXXXXXXXXXXXXXXXXXGXXXXXXXXXXXXXXXXXXXGXXXXXXXXXXXXXXXXXXXGXXXXXXXXXXXXXXXXXXXGXXXXXXXXXXXXXXXXXXXGXXXXXXXXXXXXXXXXXXXGXXXXXXXXXXXXXXXXXXXGXXXXXXXXXXXXXXXXXXXGXXXXXXXXXXXXXXXXXXXGXXXXXXXXXXXXXXXXXXX,0,10,0

10080,13,0,13,169,418,0,0,432,173,259,GXXXXXXXXXXXXXXXXXXXGXXXXXXXXXXXXXXXXXXXGXXXXXXXXXXXXXXXXXXXGXXXXXXXXXXXXXXXXXXXGXXXXXXXXXXXXXXXXXXXGXXXXXXXXXXXXXXXXXXXGXXXXXXXXXXXXXXXXXXXGXXXXXXXXXXXXXXXXXXXGXXXXXXXXXXXXXXXXXXXGXXXXXXXXXXXXXXXXXXXGXXXXXXXXXXXXXXXXXXXGXXXXXXXXXXXXXXXXXXXGXXXXXXXXXXXXXXXXXXX,0,10,0
10101,14,1,13,171,415,0,0,431,170,261,GXXXXXXXXXXXXXXXXXXXGXXXXXXXXXXXXXXXXXXXGXXXXXXXXXXXXXXXXXXXGXXXXXXXXXXXXXXXXXXXGXXXXXXXXXXXXXXXXXXXGAXXXXXXXXXXXXXXXXXXGXXXXXXXXXXXXXXXXXXXGXXXXXXXXXXXXXXXXXXXGXXXXXXXXXXXXXXXXXXXGXXXXXXXXXXXXXXXXXXXGXXXXXXXXXXXXXXXXXXXGXXXXXXXXXXXXXXXXXXXGXXXXXXXXXXXXXXXXXXX,0,10,0
10122,14,1,13,173,413,0,0,429,163,266,GXXXXXXXXXXXXXXXXXXXGXXXXXXXXXXXXXXXXXXXGXXXXXXXXXXXXXXXXXXXGXXXXXXXXXXXXXXXXXXXGXXXXXXXXXXXXXXXXXXXGAXXXXXXXXXXXXXXXXXXGXXXXXXXXXXXXXXXXXXXGXXXXXXXXXXXXXXXXXXXGXXXXXXXXXXXXXXXXXXXGXXXXXXXXXXXXXXXXXXXGXXXXXXXXXXXXXXXXXXXGXXXXXXXXXXXXXXXXXXXGXXXXXXXXXXXXXXXXXXX,0,10,0
10143,14,1,13,180,406,0,0,421,164,257,GXXXXXXXXXXXXXXXXXXXGXXXXXXXXXXXXXXXXXXXGXXXXXXXXXXXXXXXXXXXGXXXXXXXXXXXXXXXXXXXGXXXXXXXXXXXXXXXXXXXGAXXXXXXXXXXXXXXXXXXGXXXXXXXXXXXXXXXXXXXGXXXXXXXXXXXXXXXXXXXGXXXXXXXXXXXXXXXXXXXGXXXXXXXXXXXXXXXXXXXGXXXXXXXXXXXXXXXXXXXGXXXXXXXXXXXXXXXXXXXGXXXXXXXXXXXXXXXXXXX,0,10,0
10164,15,2,13,183,402,0,0,417,168,249,GXXXXXXXXXXXXXXXXXXXGXXXXXXXXXXXXXXXXXXXGXXXXXXXXXXXXXXXXXXXGXXXXXXXXXXXXXXXXXXXGXXXXXXXXXXXXXXXXXXXGAAXXXXXXXXXXXXXXXXXGXXXXXXXXXXXXXXXXXXXGXXXXXXXXXXXXXXXXXXXGXXXXXXXXXXXXXXXXXXXGXXXXXXXXXXXXXXXXXXXGXXXXXXXXXXXXXXXXXXXGXXXXXXXXXXXXXXXXXXXGXXXXXXXXXXXXXXXXXXX,0,10,0

10185,15,2,13,188,397,0,0,412,170,242,GXXXXXXXXXXXXXXXXXXXGXXXXXXXXXXXXXXXXXXXGXXXXXXXXXXXXXXXXXXXGXXXXXXXXXXXXXXXXXXXGXXXXXXXXXXXXXXXXXXXGAAXXXXXXXXXXXXXXXXXGXXXXXXXXXXXXXXXXXXXGXXXXXXXXXXXXXXXXXXXGXXXXXXXXXXXXXXXXXXXGXXXXXXXXXXXXXXXXXXXGXXXXXXXXXXXXXXXXXXXGXXXXXXXXXXXXXXXXXXXGXXXXXXXXXXXXXXXXXXX,0,10,0
10206,16,3,13,186,398,0,0,414,162,252,GXXXXXXXXXXXXXXXXXXXGXXXXXXXXXXXXXXXXXXXGXXXXXXXXXXXXXXXXXXXGXXXXXXXXXXXXXXXXXXXGAXXXXXXXXXXXXXXXXXXGAAXXXXXXXXXXXXXXXXXGXXXXXXXXXXXXXXXXXXXGXXXXXXXXXXXXXXXXXXXGXXXXXXXXXXXXXXXXXXXGXXXXXXXXXXXXXXXXXXXGXXXXXXXXXXXXXXXXXXXGXXXXXXXXXXXXXXXXXXXGXXXXXXXXXXXXXXXXXXX,0,10,0
10227,16,3,13,182,402,0,0,418,171,247,GXXXXXXXXXXXXXXXXXXXGXXXXXXXXXXXXXXXXXXXGXXXXXXXXXXXXXXXXXXXGXXXXXXXXXXXXXXXXXXXGAXXXXXXXXXXXXXXXXXXGAAXXXXXXXXXXXXXXXXXGXXXXXXXXXXXXXXXXXXXGXXXXXXXXXXXXXXXXXXXGXXXXXXXXXXXXXXXXXXXGXXXXXXXXXXXXXXXXXXXGXXXXXXXXXXXXXXXXXXXGXXXXXXXXXXXXXXXXXXXGXXXXXXXXXXXXXXXXXXX,0,10,0
10248,16,3,13,175,409,0,0,424,168,256,GXXXXXXXXXXXXXXXXXXXGXXXXXXXXXXXXXXXXXXXGXXXXXXXXXXXXXXXXXXXGXXXXXXXXXXXXXXXXXXXGAXXXXXXXXXXXXXXXXXXGAAXXXXXXXXXXXXXXXXXGXXXXXXXXXXXXXXXXXXXGXXXXXXXXXXXXXXXXXXXGXXXXXXXXXXXXXXXXXXXGXXXXXXXXXXXXXXXXXXXGXXXXXXXXXXXXXXXXXXXGXXXXXXXXXXXXXXXXXXXGXXXXXXXXXXXXXXXXXXX,0,10,0
10269,16,3,13,168,416,0,0,433,170,263,GXXXXXXXXXXXXXXXXXXXGXXXXXXXXXXXXXXXXXXXGXXXXXXXXXXXXXXXXXXXGXXXXXXXXXXXXXXXXXXXGAXXXXXXXXXXXXXXXXXXGAAXXXXXXXXXXXXXXXXXGXXXXXXXXXXXXXXXXXXXGXXXXXXXXXXXXXXXXXXXGXXXXXXXXXXXXXXXXXXXGXXXXXXXXXXXXXXXXXXXGXXXXXXXXXXXXXXXXXXXGXXXXXXXXXXXXXXXXXXXGXXXXXXXXXXXXXXXXXXX,0,10,0

10290,15,2,13,170,415,0,0,430,168,262,GXXXXXXXXXXXXXXXXXXXGXXXXXXXXXXXXXXXXXXXGXXXXXXXXXXXXXXXXXXXGXXXXXXXXXXXXXXXXXXXGAXXXXXXXXXXXXXXXXXXGAXXXXXXXXXXXXXXXXXXGXXXXXXXXXXXXXXXXXXXGXXXXXXXXXXXXXXXXXXXGXXXXXXXXXXXXXXXXXXXGXXXXXXXXXXXXXXXXXXXGXXXXXXXXXXXXXXXXXXXGXXXXXXXXXXXXXXXXXXXGXXXXXXXXXXXXXXXXXXX,0,10,0
10311,15,2,13,159,426,0,0,437,164,273,GXXXXXXXXXXXXXXXXXXXGXXXXXXXXXXXXXXXXXXXGXXXXXXXXXXXXXXXXXXXGXXXXXXXXXXXXXXXXXXXGAXXXXXXXXXXXXXXXXXXGAXXXXXXXXXXXXXXXXXXGXXXXXXXXXXXXXXXXXXXGXXXXXXXXXXXXXXXXXXXGXXXXXXXXXXXXXXXXXXXGXXXXXXXXXXXXXXXXXXXGXXXXXXXXXXXXXXXXXXXGXXXXXXXXXXXXXXXXXXXGXXXXXXXXXXXXXXXXXXX,0,10,0
10332,15,2,13,160,425,0,0,440,168,272,GXXXXXXXXXXXXXXXXXXXGXXXXXXXXXXXXXXXXXXXGXXXXXXXXXXXXXXXXXXXGXXXXXXXXXXXXXXXXXXXGAXXXXXXXXXXXXXXXXXXGAXXXXXXXXXXXXXXXXXXGXXXXXXXXXXXXXXXXXXXGXXXXXXXXXXXXXXXXXXXGXXXXXXXXXXXXXXXXXXXGXXXXXXXXXXXXXXXXXXXGXXXXXXXXXXXXXXXXXXXGXXXXXXXXXXXXXXXXXXXGXXXXXXXXXXXXXXXXXXX,0,10,0
10353,16,3,13,159,425,0,0,439,166,273,GXXXXXXXXXXXXXXXXXXXGXXXXXXXXXXXXXXXXXXXGAXXXXXXXXXXXXXXXXXXGXXXXXXXXXXXXXXXXXXXGAXXXXXXXXXXXXXXXXXXGAXXXXXXXXXXXXXXXXXXGXXXXXXXXXXXXXXXXXXXGXXXXXXXXXXXXXXXXXXXGXXXXXXXXXXXXXXXXXXXGXXXXXXXXXXXXXXXXXXXGXXXXXXXXXXXXXXXXXXXGXXXXXXXXXXXXXXXXXXXGXXXXXXXXXXXXXXXXXXX,0,10,0
10374,16,3,13,160,424,0,0,439,165,274,GXXXXXXXXXXXXXXXXXXXGXXXXXXXXXXXXXXXXXXXGAXXXXXXXXXXXXXXXXXXGXXXXXXXXXXXXXXXXXXXGAXXXXXXXXXXXXXXXXXXGAXXXXXXXXXXXXXXXXXXGXXXXXXXXXXXXXXXXXXXGXXXXXXXXXXXXXXXXXXXGXXXXXXXXXXXXXXXXXXXGXXXXXXXXXXXXXXXXXXXGXXXXXXXXXXXXXXXXXXXGXXXXXXXXXXXXXXXXXXXGXXXXXXXXXXXXXXXXXXX,0,10,0

10395,17,3,14,154,429,0,0,443,169,274,GXXXXXXXXXXXXXXXXXXXGXXXXXXXXXXXXXXXXXXXGAXXXXXXXXXXXXXXXXXXGXXXXXXXXXXXXXXXXXXXGOXXXXXXXXXXXXXXXXXXGAXXXXXXXXXXXXXXXXXXGXXXXXXXXXXXXXXXXXXXGXXXXXXXXXXXXXXXXXXXGXXXXXXXXXXXXXXXXXXXGXXXXXXXXXXXXXXXXXXXGXXXXXXXXXXXXXXXXXXXGAXXXXXXXXXXXXXXXXXXGXXXXXXXXXXXXXXXXXXX,0,10,0
10416,16,3,13,153,431,0,0,446,169,277,GXXXXXXXXXXXXXXXXXXXGXXXXXXXXXXXXXXXXXXXGAXXXXXXXXXXXXXXXXXXGXXXXXXXXXXXXXXXXXXXGXXXXXXXXXXXXXXXXXXXGAXXXXXXXXXXXXXXXXXXGXXXXXXXXXXXXXXXXXXXGXXXXXXXXXXXXXXXXXXXGXXXXXXXXXXXXXXXXXXXGXXXXXXXXXXXXXXXXXXXGXXXXXXXXXXXXXXXXXXXGAXXXXXXXXXXXXXXXXXXGXXXXXXXXXXXXXXXXXXX,0,10,0
10437,16,1,15,144,440,0,0,454,173,281,GXXXXXXXXXXXXXXXXXXXGXXXXXXXXXXXXXXXXXXXGOXXXXXXXXXXXXXXXXXXGXXXXXXXXXXXXXXXXXXXGXXXXXXXXXXXXXXXXXXXGOXXXXXXXXXXXXXXXXXXGXXXXXXXXXXXXXXXXXXXGXXXXXXXXXXXXXXXXXXXGXXXXXXXXXXXXXXXXXXXGXXXXXXXXXXXXXXXXXXXGXXXXXXXXXXXXXXXXXXXGAXXXXXXXXXXXXXXXXXXGXXXXXXXXXXXXXXXXXXX,0,10,0
10458,15,1,14,144,441,0,0,458,174,284,GXXXXXXXXXXXXXXXXXXXGXXXXXXXXXXXXXXXXXXXGXXXXXXXXXXXXXXXXXXXGXXXXXXXXXXXXXXXXXXXGXXXXXXXXXXXXXXXXXXXGOXXXXXXXXXXXXXXXXXXGXXXXXXXXXXXXXXXXXXXGXXXXXXXXXXXXXXXXXXXGXXXXXXXXXXXXXXXXXXXGXXXXXXXXXXXXXXXXXXXGXXXXXXXXXXXXXXXXXXXGAXXXXXXXXXXXXXXXXXXGXXXXXXXXXXXXXXXXXXX,0,10,0
10479,15,1,14,148,437,0,0,452,181,271,GXXXXXXXXXXXXXXXXXXXGXXXXXXXXXXXXXXXXXXXGXXXXXXXXXXXXXXXXXXXGXXXXXXXXXXXXXXXXXXXGXXXXXXXXXXXXXXXXXXXGOXXXXXXXXXXXXXXXXXXGXXXXXXXXXXXXXXXXXXXGXXXXXXXXXXXXXXXXXXXGXXXXXXXXXXXXXXXXXXXGXXXXXXXXXXXXXXXXXXXGXXXXXXXXXXXXXXXXXXXGAXXXXXXXXXXXXXXXXXXGXXXXXXXXXXXXXXXXXXX,0,10,0

10500,15,0,15,143,442,0,0,455,182,273,GXXXXXXXXXXXXXXXXXXXGXXXXXXXXXXXXXXXXXXXGXXXXXXXXXXXXXXXXXXXGXXXXXXXXXXXXXXXXXXXGXXXXXXXXXXXXXXXXXXXGOXXXXXXXXXXXXXXXXXXGXXXXXXXXXXXXXXXXXXXGXXXXXXXXXXXXXXXXXXXGXXXXXXXXXXXXXXXXXXXGXXXXXXXXXXXXXXXXXXXGXXXXXXXXXXXXXXXXXXXGOXXXXXXXXXXXXXXXXXXGXXXXXXXXXXXXXXXXXXX,0,10,0
10521,14,1,13,143,443,0,0,458,181,277,GXXXXXXXXXXXXXXXXXXXGXXXXXXXXXXXXXXXXXXXGXXXXXXXXXXXXXXXXXXXGXXXXXXXXXXXXXXXXXXXGXXXXXXXXXXXXXXXXXXXGXXXXXXXXXXXXXXXXXXXGXXXXXXXXXXXXXXXXXXXGXXXXXXXXXXXXXXXXXXXGXXXXXXXXXXXXXXXXXXXGXXXXXXXXXXXXXXXXXXXGAXXXXXXXXXXXXXXXXXXGXXXXXXXXXXXXXXXXXXXGXXXXXXXXXXXXXXXXXXX,0,10,0
10542,14,1,13,143,443,0,0,454,177,277,GXXXXXXXXXXXXXXXXXXXGXXXXXXXXXXXXXXXXXXXGXXXXXXXXXXXXXXXXXXXGXXXXXXXXXXXXXXXXXXXGXXXXXXXXXXXXXXXXXXXGXXXXXXXXXXXXXXXXXXXGXXXXXXXXXXXXXXXXXXXGXXXXXXXXXXXXXXXXXXXGXXXXXXXXXXXXXXXXXXXGXXXXXXXXXXXXXXXXXXXGAXXXXXXXXXXXXXXXXXXGXXXXXXXXXXXXXXXXXXXGXXXXXXXXXXXXXXXXXXX,0,10,0
10563,14,1,13,148,438,0,0,453,174,279,GXXXXXXXXXXXXXXXXXXXGXXXXXXXXXXXXXXXXXXXGXXXXXXXXXXXXXXXXXXXGXXXXXXXXXXXXXXXXXXXGXXXXXXXXXXXXXXXXXXXGXXXXXXXXXXXXXXXXXXXGXXXXXXXXXXXXXXXXXXXGXXXXXXXXXXXXXXXXXXXGXXXXXXXXXXXXXXXXXXXGXXXXXXXXXXXXXXXXXXXGAXXXXXXXXXXXXXXXXXXGXXXXXXXXXXXXXXXXXXXGXXXXXXXXXXXXXXXXXXX,0,10,0
10584,14,1,13,145,441,0,0,455,177,278,GXXXXXXXXXXXXXXXXXXXGXXXXXXXXXXXXXXXXXXXGXXXXXXXXXXXXXXXXXXXGXXXXXXXXXXXXXXXXXXXGXXXXXXXXXXXXXXXXXXXGXXXXXXXXXXXXXXXXXXXGXXXXXXXXXXXXXXXXXXXGXXXXXXXXXXXXXXXXXXXGXXXXXXXXXXXXXXXXXXXGXXXXXXXXXXXXXXXXXXXGAXXXXXXXXXXXXXXXXXXGXXXXXXXXXXXXXXXXXXXGXXXXXXXXXXXXXXXXXXX,0,10,0

10605,14,1,13,145,441,0,0,453,175,278,GXXXXXXXXXXXXXXXXXXXGXXXXXXXXXXXXXXXXXXXGXXXXXXXXXXXXXXXXXXXGXXXXXXXXXXXXXXXXXXXGXXXXXXXXXXXXXXXXXXXGXXXXXXXXXXXXXXXXXXXGXXXXXXXXXXXXXXXXXXXGXXXXXXXXXXXXXXXXXXXGXXXXXXXXXXXXXXXXXXXGXXXXXXXXXXXXXXXXXXXGAXXXXXXXXXXXXXXXXXXGXXXXXXXXXXXXXXXXXXXGXXXXXXXXXXXXXXXXXXX,0,10,0
10626,14,1,13,146,440,0,0,454,174,280,GXXXXXXXXXXXXXXXXXXXGXXXXXXXXXXXXXXXXXXXGXXXXXXXXXXXXXXXXXXXGXXXXXXXXXXXXXXXXXXXGXXXXXXXXXXXXXXXXXXXGXXXXXXXXXXXXXXXXXXXGXXXXXXXXXXXXXXXXXXXGXXXXXXXXXXXXXXXXXXXGXXXXXXXXXXXXXXXXXXXGXXXXXXXXXXXXXXXXXXXGAXXXXXXXXXXXXXXXXXXGXXXXXXXXXXXXXXXXXXXGXXXXXXXXXXXXXXXXXXX,0,10,0
10647,14,1,13,142,444,0,0,458,177,281,GXXXXXXXXXXXXXXXXXXXGXXXXXXXXXXXXXXXXXXXGXXXXXXXXXXXXXXXXXXXGXXXXXXXXXXXXXXXXXXXGXXXXXXXXXXXXXXXXXXXGXXXXXXXXXXXXXXXXXXXGXXXXXXXXXXXXXXXXXXXGXXXXXXXXXXXXXXXXXXXGXXXXXXXXXXXXXXXXXXXGXXXXXXXXXXXXXXXXXXXGAXXXXXXXXXXXXXXXXXXGXXXXXXXXXXXXXXXXXXXGXXXXXXXXXXXXXXXXXXX,0,10,0
10668,14,1,13,143,443,0,0,459,185,274,GXXXXXXXXXXXXXXXXXXXGXXXXXXXXXXXXXXXXXXXGXXXXXXXXXXXXXXXXXXXGXXXXXXXXXXXXXXXXXXXGXXXXXXXXXXXXXXXXXXXGXXXXXXXXXXXXXXXXXXXGXXXXXXXXXXXXXXXXXXXGXXXXXXXXXXXXXXXXXXXGXXXXXXXXXXXXXXXXXXXGXXXXXXXXXXXXXXXXXXXGAXXXXXXXXXXXXXXXXXXGXXXXXXXXXXXXXXXXXXXGXXXXXXXXXXXXXXXXXXX,0,10,0
10689,14,1,13,143,443,0,0,459,188,271,GXXXXXXXXXXXXXXXXXXXGXXXXXXXXXXXXXXXXXXXGXXXXXXXXXXXXXXXXXXXGXXXXXXXXXXXXXXXXXXXGXXXXXXXXXXXXXXXXXXXGXXXXXXXXXXXXXXXXXXXGXXXXXXXXXXXXXXXXXXXGXXXXXXXXXXXXXXXXXXXGXXXXXXXXXXXXXXXXXXXGXXXXXXXXXXXXXXXXXXXGAXXXXXXXXXXXXXXXXXXGXXXXXXXXXXXXXXXXXXXGXXXXXXXXXXXXXXXXXXX,0,10,0

10710,14,1,13,147,439,0,0,453,186,267,GXXXXXXXXXXXXXXXXXXXGXXXXXXXXXXXXXXXXXXXGXXXXXXXXXXXXXXXXXXXGXXXXXXXXXXXXXXXXXXXGXXXXXXXXXXXXXXXXXXXGXXXXXXXXXXXXXXXXXXXGXXXXXXXXXXXXXXXXXXXGXXXXXXXXXXXXXXXXXXXGXXXXXXXXXXXXXXXXXXXGXXXXXXXXXXXXXXXXXXXGAXXXXXXXXXXXXXXXXXXGXXXXXXXXXXXXXXXXXXXGXXXXXXXXXXXXXXXXXXX,0,10,0
10731,14,1,13,152,434,0,0,448,183,265,GXXXXXXXXXXXXXXXXXXXGXXXXXXXXXXXXXXXXXXXGXXXXXXXXXXXXXXXXXXXGXXXXXXXXXXXXXXXXXXXGXXXXXXXXXXXXXXXXXXXGXXXXXXXXXXXXXXXXXXXGXXXXXXXXXXXXXXXXXXXGXXXXXXXXXXXXXXXXXXXGXXXXXXXXXXXXXXXXXXXGXXXXXXXXXXXXXXXXXXXGAXXXXXXXXXXXXXXXXXXGXXXXXXXXXXXXXXXXXXXGXXXXXXXXXXXXXXXXXXX,0,10,0
10752,14,1,13,153,433,0,0,447,187,260,GXXXXXXXXXXXXXXXXXXXGXXXXXXXXXXXXXXXXXXXGXXXXXXXXXXXXXXXXXXXGXXXXXXXXXXXXXXXXXXXGXXXXXXXXXXXXXXXXXXXGXXXXXXXXXXXXXXXXXXXGXXXXXXXXXXXXXXXXXXXGXXXXXXXXXXXXXXXXXXXGXXXXXXXXXXXXXXXXXXXGXXXXXXXXXXXXXXXXXXXGAXXXXXXXXXXXXXXXXXXGXXXXXXXXXXXXXXXXXXXGXXXXXXXXXXXXXXXXXXX,0,10,0
10773,14,1,13,155,431,0,0,445,191,254,GXXXXXXXXXXXXXXXXXXXGXXXXXXXXXXXXXXXXXXXGXXXXXXXXXXXXXXXXXXXGXXXXXXXXXXXXXXXXXXXGXXXXXXXXXXXXXXXXXXXGXXXXXXXXXXXXXXXXXXXGXXXXXXXXXXXXXXXXXXXGXXXXXXXXXXXXXXXXXXXGXXXXXXXXXXXXXXXXXXXGXXXXXXXXXXXXXXXXXXXGAXXXXXXXXXXXXXXXXXXGXXXXXXXXXXXXXXXXXXXGXXXXXXXXXXXXXXXXXXX,0,10,0
10794,14,0,14,159,427,0,0,443,189,254,GXXXXXXXXXXXXXXXXXXXGXXXXXXXXXXXXXXXXXXXGXXXXXXXXXXXXXXXXXXXGXXXXXXXXXXXXXXXXXXXGXXXXXXXXXXXXXXXXXXXGXXXXXXXXXXXXXXXXXXXGXXXXXXXXXXXXXXXXXXXGXXXXXXXXXXXXXXXXXXXGXXXXXXXXXXXXXXXXXXXGXXXXXXXXXXXXXXXXXXXGOXXXXXXXXXXXXXXXXXXGXXXXXXXXXXXXXXXXXXXGXXXXXXXXXXXXXXXXXXX,0,10,0

10815,13,0,13,157,430,0,0,445,192,253,GXXXXXXXXXXXXXXXXXXXGXXXXXXXXXXXXXXXXXXXGXXXXXXXXXXXXXXXXXXXGXXXXXXXXXXXXXXXXXXXGXXXXXXXXXXXXXXXXXXXGXXXXXXXXXXXXXXXXXXXGXXXXXXXXXXXXXXXXXXXGXXXXXXXXXXXXXXXXXXXGXXXXXXXXXXXXXXXXXXXGXXXXXXXXXXXXXXXXXXXGXXXXXXXXXXXXXXXXXXXGXXXXXXXXXXXXXXXXXXXGXXXXXXXXXXXXXXXXXXX,0,10,0
10836,13,0,13,161,426,0,0,441,191,250,GXXXXXXXXXXXXXXXXXXXGXXXXXXXXXXXXXXXXXXXGXXXXXXXXXXXXXXXXXXXGXXXXXXXXXXXXXXXXXXXGXXXXXXXXXXXXXXXXXXXGXXXXXXXXXXXXXXXXXXXGXXXXXXXXXXXXXXXXXXXGXXXXXXXXXXXXXXXXXXXGXXXXXXXXXXXXXXXXXXXGXXXXXXXXXXXXXXXXXXXGXXXXXXXXXXXXXXXXXXXGXXXXXXXXXXXXXXXXXXXGXXXXXXXXXXXXXXXXXXX,0,10,0
10857,13,0,13,164,423,0,0,439,180,259,GXXXXXXXXXXXXXXXXXXXGXXXXXXXXXXXXXXXXXXXGXXXXXXXXXXXXXXXXXXXGXXXXXXXXXXXXXXXXXXXGXXXXXXXXXXXXXXXXXXXGXXXXXXXXXXXXXXXXXXXGXXXXXXXXXXXXXXXXXXXGXXXXXXXXXXXXXXXXXXXGXXXXXXXXXXXXXXXXXXXGXXXXXXXXXXXXXXXXXXXGXXXXXXXXXXXXXXXXXXXGXXXXXXXXXXXXXXXXXXXGXXXXXXXXXXXXXXXXXXX,0,10,0
10878,13,0,13,153,434,0,0,450,189,261,GXXXXXXXXXXXXXXXXXXXGXXXXXXXXXXXXXXXXXXXGXXXXXXXXXXXXXXXXXXXGXXXXXXXXXXXXXXXXXXXGXXXXXXXXXXXXXXXXXXXGXXXXXXXXXXXXXXXXXXXGXXXXXXXXXXXXXXXXXXXGXXXXXXXXXXXXXXXXXXXGXXXXXXXXXXXXXXXXXXXGXXXXXXXXXXXXXXXXXXXGXXXXXXXXXXXXXXXXXXXGXXXXXXXXXXXXXXXXXXXGXXXXXXXXXXXXXXXXXXX,0,10,0
10899,13,0,13,155,432,0,0,447,184,263,GXXXXXXXXXXXXXXXXXXXGXXXXXXXXXXXXXXXXXXXGXXXXXXXXXXXXXXXXXXXGXXXXXXXXXXXXXXXXXXXGXXXXXXXXXXXXXXXXXXXGXXXXXXXXXXXXXXXXXXXGXXXXXXXXXXXXXXXXXXXGXXXXXXXXXXXXXXXXXXXGXXXXXXXXXXXXXXXXXXXGXXXXXXXXXXXXXXXXXXXGXXXXXXXXXXXXXXXXXXXGXXXXXXXXXXXXXXXXXXXGXXXXXXXXXXXXXXXXXXX,0,10,0

10920,13,0,13,160,427,0,0,442,179,263,GXXXXXXXXXXXXXXXXXXXGXXXXXXXXXXXXXXXXXXXGXXXXXXXXXXXXXXXXXXXGXXXXXXXXXXXXXXXXXXXGXXXXXXXXXXXXXXXXXXXGXXXXXXXXXXXXXXXXXXXGXXXXXXXXXXXXXXXXXXXGXXXXXXXXXXXXXXXXXXXGXXXXXXXXXXXXXXXXXXXGXXXXXXXXXXXXXXXXXXXGXXXXXXXXXXXXXXXXXXXGXXXXXXXXXXXXXXXXXXXGXXXXXXXXXXXXXXXXXXX,0,10,0
10941,13,0,13,157,430,0,0,444,177,267,GXXXXXXXXXXXXXXXXXXXGXXXXXXXXXXXXXXXXXXXGXXXXXXXXXXXXXXXXXXXGXXXXXXXXXXXXXXXXXXXGXXXXXXXXXXXXXXXXXXXGXXXXXXXXXXXXXXXXXXXGXXXXXXXXXXXXXXXXXXXGXXXXXXXXXXXXXXXXXXXGXXXXXXXXXXXXXXXXXXXGXXXXXXXXXXXXXXXXXXXGXXXXXXXXXXXXXXXXXXXGXXXXXXXXXXXXXXXXXXXGXXXXXXXXXXXXXXXXXXX,0,10,0
10962,13,0,13,144,443,0,0,456,184,272,GXXXXXXXXXXXXXXXXXXXGXXXXXXXXXXXXXXXXXXXGXXXXXXXXXXXXXXXXXXXGXXXXXXXXXXXXXXXXXXXGXXXXXXXXXXXXXXXXXXXGXXXXXXXXXXXXXXXXXXXGXXXXXXXXXXXXXXXXXXXGXXXXXXXXXXXXXXXXXXXGXXXXXXXXXXXXXXXXXXXGXXXXXXXXXXXXXXXXXXXGXXXXXXXXXXXXXXXXXXXGXXXXXXXXXXXXXXXXXXXGXXXXXXXXXXXXXXXXXXX,0,10,0
10983,13,0,13,139,448,0,0,463,186,277,GXXXXXXXXXXXXXXXXXXXGXXXXXXXXXXXXXXXXXXXGXXXXXXXXXXXXXXXXXXXGXXXXXXXXXXXXXXXXXXXGXXXXXXXXXXXXXXXXXXXGXXXXXXXXXXXXXXXXXXXGXXXXXXXXXXXXXXXXXXXGXXXXXXXXXXXXXXXXXXXGXXXXXXXXXXXXXXXXXXXGXXXXXXXXXXXXXXXXXXXGXXXXXXXXXXXXXXXXXXXGXXXXXXXXXXXXXXXXXXXGXXXXXXXXXXXXXXXXXXX,0,10,0
11004,14,1,13,135,451,0,0,467,188,279,GXXXXXXXXXXXXXXXXXXXGXXXXXXXXXXXXXXXXXXXGXXXXXXXXXXXXXXXXXXXGXXXXXXXXXXXXXXXXXXXGXXXXXXXXXXXXXXXXXXXGXXXXXXXXXXXXXXXXXXXGAXXXXXXXXXXXXXXXXXXGXXXXXXXXXXXXXXXXXXXGXXXXXXXXXXXXXXXXXXXGXXXXXXXXXXXXXXXXXXXGXXXXXXXXXXXXXXXXXXXGXXXXXXXXXXXXXXXXXXXGXXXXXXXXXXXXXXXXXXX,0,10,0

11025,14,1,13,140,446,0,0,460,193,267,GXXXXXXXXXXXXXXXXXXXGXXXXXXXXXXXXXXXXXXXGXXXXXXXXXXXXXXXXXXXGXXXXXXXXXXXXXXXXXXXGXXXXXXXXXXXXXXXXXXXGXXXXXXXXXXXXXXXXXXXGAXXXXXXXXXXXXXXXXXXGXXXXXXXXXXXXXXXXXXXGXXXXXXXXXXXXXXXXXXXGXXXXXXXXXXXXXXXXXXXGXXXXXXXXXXXXXXXXXXXGXXXXXXXXXXXXXXXXXXXGXXXXXXXXXXXXXXXXXXX,0,10,0
11046,14,1,13,151,435,0,0,451,187,264,GXXXXXXXXXXXXXXXXXXXGXXXXXXXXXXXXXXXXXXXGXXXXXXXXXXXXXXXXXXXGXXXXXXXXXXXXXXXXXXXGXXXXXXXXXXXXXXXXXXXGXXXXXXXXXXXXXXXXXXXGAXXXXXXXXXXXXXXXXXXGXXXXXXXXXXXXXXXXXXXGXXXXXXXXXXXXXXXXXXXGXXXXXXXXXXXXXXXXXXXGXXXXXXXXXXXXXXXXXXXGXXXXXXXXXXXXXXXXXXXGXXXXXXXXXXXXXXXXXXX,0,10,0
11067,14,1,13,157,429,0,0,443,185,258,GXXXXXXXXXXXXXXXXXXXGXXXXXXXXXXXXXXXXXXXGXXXXXXXXXXXXXXXXXXXGXXXXXXXXXXXXXXXXXXXGXXXXXXXXXXXXXXXXXXXGXXXXXXXXXXXXXXXXXXXGAXXXXXXXXXXXXXXXXXXGXXXXXXXXXXXXXXXXXXXGXXXXXXXXXXXXXXXXXXXGXXXXXXXXXXXXXXXXXXXGXXXXXXXXXXXXXXXXXXXGXXXXXXXXXXXXXXXXXXXGXXXXXXXXXXXXXXXXXXX,0,10,0
11088,14,1,13,155,431,0,0,445,194,251,GXXXXXXXXXXXXXXXXXXXGXXXXXXXXXXXXXXXXXXXGXXXXXXXXXXXXXXXXXXXGXXXXXXXXXXXXXXXXXXXGXXXXXXXXXXXXXXXXXXXGXXXXXXXXXXXXXXXXXXXGAXXXXXXXXXXXXXXXXXXGXXXXXXXXXXXXXXXXXXXGXXXXXXXXXXXXXXXXXXXGXXXXXXXXXXXXXXXXXXXGXXXXXXXXXXXXXXXXXXXGXXXXXXXXXXXXXXXXXXXGXXXXXXXXXXXXXXXXXXX,0,10,0
11109,14,1,13,151,435,0,0,452,200,252,GXXXXXXXXXXXXXXXXXXXGXXXXXXXXXXXXXXXXXXXGXXXXXXXXXXXXXXXXXXXGXXXXXXXXXXXXXXXXXXXGXXXXXXXXXXXXXXXXXXXGXXXXXXXXXXXXXXXXXXXGAXXXXXXXXXXXXXXXXXXGXXXXXXXXXXXXXXXXXXXGXXXXXXXXXXXXXXXXXXXGXXXXXXXXXXXXXXXXXXXGXXXXXXXXXXXXXXXXXXXGXXXXXXXXXXXXXXXXXXXGXXXXXXXXXXXXXXXXXXX,0,10,0

11130,14,1,13,152,434,0,0,451,203,248,GXXXXXXXXXXXXXXXXXXXGXXXXXXXXXXXXXXXXXXXGXXXXXXXXXXXXXXXXXXXGXXXXXXXXXXXXXXXXXXXGXXXXXXXXXXXXXXXXXXXGXXXXXXXXXXXXXXXXXXXGAXXXXXXXXXXXXXXXXXXGXXXXXXXXXXXXXXXXXXXGXXXXXXXXXXXXXXXXXXXGXXXXXXXXXXXXXXXXXXXGXXXXXXXXXXXXXXXXXXXGXXXXXXXXXXXXXXXXXXXGXXXXXXXXXXXXXXXXXXX,0,10,0
11151,15,2,13,151,434,0,0,451,202,249,GXXXXXXXXXXXXXXXXXXXGXXXXXXXXXXXXXXXXXXXGAXXXXXXXXXXXXXXXXXXGXXXXXXXXXXXXXXXXXXXGXXXXXXXXXXXXXXXXXXXGXXXXXXXXXXXXXXXXXXXGAXXXXXXXXXXXXXXXXXXGXXXXXXXXXXXXXXXXXXXGXXXXXXXXXXXXXXXXXXXGXXXXXXXXXXXXXXXXXXXGXXXXXXXXXXXXXXXXXXXGXXXXXXXXXXXXXXXXXXXGXXXXXXXXXXXXXXXXXXX,0,10,0
11172,16,3,13,156,428,0,0,444,193,251,GXXXXXXXXXXXXXXXXXXXGXXXXXXXXXXXXXXXXXXXGAXXXXXXXXXXXXXXXXXXGXXXXXXXXXXXXXXXXXXXGAXXXXXXXXXXXXXXXXXXGXXXXXXXXXXXXXXXXXXXGAXXXXXXXXXXXXXXXXXXGXXXXXXXXXXXXXXXXXXXGXXXXXXXXXXXXXXXXXXXGXXXXXXXXXXXXXXXXXXXGXXXXXXXXXXXXXXXXXXXGXXXXXXXXXXXXXXXXXXXGXXXXXXXXXXXXXXXXXXX,0,10,0
11193,16,2,14,156,428,0,0,442,189,253,GXXXXXXXXXXXXXXXXXXXGXXXXXXXXXXXXXXXXXXXGAXXXXXXXXXXXXXXXXXXGXXXXXXXXXXXXXXXXXXXGAXXXXXXXXXXXXXXXXXXGXXXXXXXXXXXXXXXXXXXGOXXXXXXXXXXXXXXXXXXGXXXXXXXXXXXXXXXXXXXGXXXXXXXXXXXXXXXXXXXGXXXXXXXXXXXXXXXXXXXGXXXXXXXXXXXXXXXXXXXGXXXXXXXXXXXXXXXXXXXGXXXXXXXXXXXXXXXXXXX,0,10,0
11214,16,3,13,161,423,0,0,437,187,250,GXXXXXXXXXXXXXXXXXXXGXXXXXXXXXXXXXXXXXXXGAXXXXXXXXXXXXXXXXXXGXXXXXXXXXXXXXXXXXXXGAAXXXXXXXXXXXXXXXXXGXXXXXXXXXXXXXXXXXXXGXXXXXXXXXXXXXXXXXXXGXXXXXXXXXXXXXXXXXXXGXXXXXXXXXXXXXXXXXXXGXXXXXXXXXXXXXXXXXXXGXXXXXXXXXXXXXXXXXXXGXXXXXXXXXXXXXXXXXXXGXXXXXXXXXXXXXXXXXXX,0,10,0

11235,16,3,13,153,431,0,0,444,190,254,GXXXXXXXXXXXXXXXXXXXGXXXXXXXXXXXXXXXXXXXGAXXXXXXXXXXXXXXXXXXGXXXXXXXXXXXXXXXXXXXGAAXXXXXXXXXXXXXXXXXGXXXXXXXXXXXXXXXXXXXGXXXXXXXXXXXXXXXXXXXGXXXXXXXXXXXXXXXXXXXGXXXXXXXXXXXXXXXXXXXGXXXXXXXXXXXXXXXXXXXGXXXXXXXXXXXXXXXXXXXGXXXXXXXXXXXXXXXXXXXGXXXXXXXXXXXXXXXXXXX,0,10,0
11256,16,3,13,143,441,0,0,456,191,265,GXXXXXXXXXXXXXXXXXXXGXXXXXXXXXXXXXXXXXXXGAXXXXXXXXXXXXXXXXXXGXXXXXXXXXXXXXXXXXXXGAAXXXXXXXXXXXXXXXXXGXXXXXXXXXXXXXXXXXXXGXXXXXXXXXXXXXXXXXXXGXXXXXXXXXXXXXXXXXXXGXXXXXXXXXXXXXXXXXXXGXXXXXXXXXXXXXXXXXXXGXXXXXXXXXXXXXXXXXXXGXXXXXXXXXXXXXXXXXXXGXXXXXXXXXXXXXXXXXXX,0,10,0
11277,16,3,13,149,435,0,0,450,188,262,GXXXXXXXXXXXXXXXXXXXGXXXXXXXXXXXXXXXXXXXGAXXXXXXXXXXXXXXXXXXGXXXXXXXXXXXXXXXXXXXGAAXXXXXXXXXXXXXXXXXGXXXXXXXXXXXXXXXXXXXGXXXXXXXXXXXXXXXXXXXGXXXXXXXXXXXXXXXXXXXGXXXXXXXXXXXXXXXXXXXGXXXXXXXXXXXXXXXXXXXGXXXXXXXXXXXXXXXXXXXGXXXXXXXXXXXXXXXXXXXGXXXXXXXXXXXXXXXXXXX,0,10,0
11298,16,3,13,147,437,0,0,453,188,265,GXXXXXXXXXXXXXXXXXXXGXXXXXXXXXXXXXXXXXXXGAXXXXXXXXXXXXXXXXXXGXXXXXXXXXXXXXXXXXXXGAAXXXXXXXXXXXXXXXXXGXXXXXXXXXXXXXXXXXXXGXXXXXXXXXXXXXXXXXXXGXXXXXXXXXXXXXXXXXXXGXXXXXXXXXXXXXXXXXXXGXXXXXXXXXXXXXXXXXXXGXXXXXXXXXXXXXXXXXXXGXXXXXXXXXXXXXXXXXXXGXXXXXXXXXXXXXXXXXXX,0,10,0
11319,16,3,13,147,437,0,0,452,186,266,GXXXXXXXXXXXXXXXXXXXGXXXXXXXXXXXXXXXXXXXGAXXXXXXXXXXXXXXXXXXGXXXXXXXXXXXXXXXXXXXGAAXXXXXXXXXXXXXXXXXGXXXXXXXXXXXXXXXXXXXGXXXXXXXXXXXXXXXXXXXGXXXXXXXXXXXXXXXXXXXGXXXXXXXXXXXXXXXXXXXGXXXXXXXXXXXXXXXXXXXGXXXXXXXXXXXXXXXXXXXGXXXXXXXXXXXXXXXXXXXGXXXXXXXXXXXXXXXXXXX,0,10,0

11340,16,3,13,144,440,0,0,455,195,260,GXXXXXXXXXXXXXXXXXXXGXXXXXXXXXXXXXXXXXXXGAXXXXXXXXXXXXXXXXXXGXXXXXXXXXXXXXXXXXXXGAAXXXXXXXXXXXXXXXXXGXXXXXXXXXXXXXXXXXXXGXXXXXXXXXXXXXXXXXXXGXXXXXXXXXXXXXXXXXXXGXXXXXXXXXXXXXXXXXXXGXXXXXXXXXXXXXXXXXXXGXXXXXXXXXXXXXXXXXXXGXXXXXXXXXXXXXXXXXXXGXXXXXXXXXXXXXXXXXXX,0,10,0
11361,15,2,13,147,438,0,0,452,191,261,GXXXXXXXXXXXXXXXXXXXGXXXXXXXXXXXXXXXXXXXGAXXXXXXXXXXXXXXXXXXGXXXXXXXXXXXXXXXXXXXGXAXXXXXXXXXXXXXXXXXGXXXXXXXXXXXXXXXXXXXGXXXXXXXXXXXXXXXXXXXGXXXXXXXXXXXXXXXXXXXGXXXXXXXXXXXXXXXXXXXGXXXXXXXXXXXXXXXXXXXGXXXXXXXXXXXXXXXXXXXGXXXXXXXXXXXXXXXXXXXGXXXXXXXXXXXXXXXXXXX,0,10,0
11382,14,1,13,142,444,0,0,458,191,267,GXXXXXXXXXXXXXXXXXXXGXXXXXXXXXXXXXXXXXXXGAXXXXXXXXXXXXXXXXXXGXXXXXXXXXXXXXXXXXXXGXXXXXXXXXXXXXXXXXXXGXXXXXXXXXXXXXXXXXXXGXXXXXXXXXXXXXXXXXXXGXXXXXXXXXXXXXXXXXXXGXXXXXXXXXXXXXXXXXXXGXXXXXXXXXXXXXXXXXXXGXXXXXXXXXXXXXXXXXXXGXXXXXXXXXXXXXXXXXXXGXXXXXXXXXXXXXXXXXXX,0,10,0
11403,14,1,13,147,439,0,0,452,189,263,GXXXXXXXXXXXXXXXXXXXGXXXXXXXXXXXXXXXXXXXGAXXXXXXXXXXXXXXXXXXGXXXXXXXXXXXXXXXXXXXGXXXXXXXXXXXXXXXXXXXGXXXXXXXXXXXXXXXXXXXGXXXXXXXXXXXXXXXXXXXGXXXXXXXXXXXXXXXXXXXGXXXXXXXXXXXXXXXXXXXGXXXXXXXXXXXXXXXXXXXGXXXXXXXXXXXXXXXXXXXGXXXXXXXXXXXXXXXXXXXGXXXXXXXXXXXXXXXXXXX,0,10,0
11424,14,1,13,142,444,0,0,456,186,270,GXXXXXXXXXXXXXXXXXXXGXXXXXXXXXXXXXXXXXXXGAXXXXXXXXXXXXXXXXXXGXXXXXXXXXXXXXXXXXXXGXXXXXXXXXXXXXXXXXXXGXXXXXXXXXXXXXXXXXXXGXXXXXXXXXXXXXXXXXXXGXXXXXXXXXXXXXXXXXXXGXXXXXXXXXXXXXXXXXXXGXXXXXXXXXXXXXXXXXXXGXXXXXXXXXXXXXXXXXXXGXXXXXXXXXXXXXXXXXXXGXXXXXXXXXXXXXXXXXXX,0,10,0

11445,14,1,13,135,451,0,0,465,193,272,GXXXXXXXXXXXXXXXXXXXGXXXXXXXXXXXXXXXXXXXGAXXXXXXXXXXXXXXXXXXGXXXXXXXXXXXXXXXXXXXGXXXXXXXXXXXXXXXXXXXGXXXXXXXXXXXXXXXXXXXGXXXXXXXXXXXXXXXXXXXGXXXXXXXXXXXXXXXXXXXGXXXXXXXXXXXXXXXXXXXGXXXXXXXXXXXXXXXXXXXGXXXXXXXXXXXXXXXXXXXGXXXXXXXXXXXXXXXXXXXGXXXXXXXXXXXXXXXXXXX,0,10,0
11466,14,1,13,125,461,0,0,473,200,273,GXXXXXXXXXXXXXXXXXXXGXXXXXXXXXXXXXXXXXXXGAXXXXXXXXXXXXXXXXXXGXXXXXXXXXXXXXXXXXXXGXXXXXXXXXXXXXXXXXXXGXXXXXXXXXXXXXXXXXXXGXXXXXXXXXXXXXXXXXXXGXXXXXXXXXXXXXXXXXXXGXXXXXXXXXXXXXXXXXXXGXXXXXXXXXXXXXXXXXXXGXXXXXXXXXXXXXXXXXXXGXXXXXXXXXXXXXXXXXXXGXXXXXXXXXXXXXXXXXXX,0,10,0
11487,14,1,13,137,449,0,0,465,189,276,GXXXXXXXXXXXXXXXXXXXGXXXXXXXXXXXXXXXXXXXGAXXXXXXXXXXXXXXXXXXGXXXXXXXXXXXXXXXXXXXGXXXXXXXXXXXXXXXXXXXGXXXXXXXXXXXXXXXXXXXGXXXXXXXXXXXXXXXXXXXGXXXXXXXXXXXXXXXXXXXGXXXXXXXXXXXXXXXXXXXGXXXXXXXXXXXXXXXXXXXGXXXXXXXXXXXXXXXXXXXGXXXXXXXXXXXXXXXXXXXGXXXXXXXXXXXXXXXXXXX,0,10,0
11508,14,1,13,136,450,0,0,465,192,273,GXXXXXXXXXXXXXXXXXXXGXXXXXXXXXXXXXXXXXXXGAXXXXXXXXXXXXXXXXXXGXXXXXXXXXXXXXXXXXXXGXXXXXXXXXXXXXXXXXXXGXXXXXXXXXXXXXXXXXXXGXXXXXXXXXXXXXXXXXXXGXXXXXXXXXXXXXXXXXXXGXXXXXXXXXXXXXXXXXXXGXXXXXXXXXXXXXXXXXXXGXXXXXXXXXXXXXXXXXXXGXXXXXXXXXXXXXXXXXXXGXXXXXXXXXXXXXXXXXXX,0,10,0
11529,14,1,13,135,451,0,0,467,197,270,GXXXXXXXXXXXXXXXXXXXGXXXXXXXXXXXXXXXXXXXGAXXXXXXXXXXXXXXXXXXGXXXXXXXXXXXXXXXXXXXGXXXXXXXXXXXXXXXXXXXGXXXXXXXXXXXXXXXXXXXGXXXXXXXXXXXXXXXXXXXGXXXXXXXXXXXXXXXXXXXGXXXXXXXXXXXXXXXXXXXGXXXXXXXXXXXXXXXXXXXGXXXXXXXXXXXXXXXXXXXGXXXXXXXXXXXXXXXXXXXGXXXXXXXXXXXXXXXXXXX,0,10,0

11550,14,1,13,138,448,0,0,464,198,266,GXXXXXXXXXXXXXXXXXXXGXXXXXXXXXXXXXXXXXXXGAXXXXXXXXXXXXXXXXXXGXXXXXXXXXXXXXXXXXXXGXXXXXXXXXXXXXXXXXXXGXXXXXXXXXXXXXXXXXXXGXXXXXXXXXXXXXXXXXXXGXXXXXXXXXXXXXXXXXXXGXXXXXXXXXXXXXXXXXXXGXXXXXXXXXXXXXXXXXXXGXXXXXXXXXXXXXXXXXXXGXXXXXXXXXXXXXXXXXXXGXXXXXXXXXXXXXXXXXXX,0,10,0
11571,14,1,13,138,448,0,0,463,196,267,GXXXXXXXXXXXXXXXXXXXGXXXXXXXXXXXXXXXXXXXGAXXXXXXXXXXXXXXXXXXGXXXXXXXXXXXXXXXXXXXGXXXXXXXXXXXXXXXXXXXGXXXXXXXXXXXXXXXXXXXGXXXXXXXXXXXXXXXXXXXGXXXXXXXXXXXXXXXXXXXGXXXXXXXXXXXXXXXXXXXGXXXXXXXXXXXXXXXXXXXGXXXXXXXXXXXXXXXXXXXGXXXXXXXXXXXXXXXXXXXGXXXXXXXXXXXXXXXXXXX,0,10,0
11592,15,2,13,130,455,0,0,469,201,268,GXXXXXXXXXXXXXXXXXXXGXXXXXXXXXXXXXXXXXXXGAXXXXXXXXXXXXXXXXXXGXXXXXXXXXXXXXXXXXXXGXXXXXXXXXXXXXXXXXXXGXXXXXXXXXXXXXXXXXXXGXXXXXXXXXXXXXXXXXXXGXXXXXXXXXXXXXXXXXXXGXXXXXXXXXXXXXXXXXXXGAXXXXXXXXXXXXXXXXXXGXXXXXXXXXXXXXXXXXXXGXXXXXXXXXXXXXXXXXXXGXXXXXXXXXXXXXXXXXXX,0,10,0
11613,15,2,13,143,442,0,0,456,193,263,GXXXXXXXXXXXXXXXXXXXGXXXXXXXXXXXXXXXXXXXGAXXXXXXXXXXXXXXXXXXGXXXXXXXXXXXXXXXXXXXGXXXXXXXXXXXXXXXXXXXGXXXXXXXXXXXXXXXXXXXGXXXXXXXXXXXXXXXXXXXGXXXXXXXXXXXXXXXXXXXGXXXXXXXXXXXXXXXXXXXGAXXXXXXXXXXXXXXXXXXGXXXXXXXXXXXXXXXXXXXGXXXXXXXXXXXXXXXXXXXGXXXXXXXXXXXXXXXXXXX,0,10,0
11634,14,1,13,147,439,0,0,454,199,255,GXXXXXXXXXXXXXXXXXXXGXXXXXXXXXXXXXXXXXXXGXXXXXXXXXXXXXXXXXXXGXXXXXXXXXXXXXXXXXXXGXXXXXXXXXXXXXXXXXXXGXXXXXXXXXXXXXXXXXXXGXXXXXXXXXXXXXXXXXXXGXXXXXXXXXXXXXXXXXXXGXXXXXXXXXXXXXXXXXXXGAXXXXXXXXXXXXXXXXXXGXXXXXXXXXXXXXXXXXXXGXXXXXXXXXXXXXXXXXXXGXXXXXXXXXXXXXXXXXXX,0,10,0

11655,14,1,13,156,430,0,0,443,197,246,GXXXXXXXXXXXXXXXXXXXGXXXXXXXXXXXXXXXXXXXGXXXXXXXXXXXXXXXXXXXGXXXXXXXXXXXXXXXXXXXGXXXXXXXXXXXXXXXXXXXGXXXXXXXXXXXXXXXXXXXGXXXXXXXXXXXXXXXXXXXGXXXXXXXXXXXXXXXXXXXGXXXXXXXXXXXXXXXXXXXGAXXXXXXXXXXXXXXXXXXGXXXXXXXXXXXXXXXXXXXGXXXXXXXXXXXXXXXXXXXGXXXXXXXXXXXXXXXXXXX,0,10,0
11676,14,0,14,156,430,0,0,444,201,243,GXXXXXXXXXXXXXXXXXXXGXXXXXXXXXXXXXXXXXXXGXXXXXXXXXXXXXXXXXXXGXXXXXXXXXXXXXXXXXXXGXXXXXXXXXXXXXXXXXXXGXXXXXXXXXXXXXXXXXXXGXXXXXXXXXXXXXXXXXXXGXXXXXXXXXXXXXXXXXXXGXXXXXXXXXXXXXXXXXXXGOXXXXXXXXXXXXXXXXXXGXXXXXXXXXXXXXXXXXXXGXXXXXXXXXXXXXXXXXXXGXXXXXXXXXXXXXXXXXXX,0,10,0
11697,14,0,14,157,429,0,0,443,203,240,GXXXXXXXXXXXXXXXXXXXGXXXXXXXXXXXXXXXXXXXGXXXXXXXXXXXXXXXXXXXGXXXXXXXXXXXXXXXXXXXGXXXXXXXXXXXXXXXXXXXGXXXXXXXXXXXXXXXXXXXGXXXXXXXXXXXXXXXXXXXGXXXXXXXXXXXXXXXXXXXGXXXXXXXXXXXXXXXXXXXGOXXXXXXXXXXXXXXXXXXGXXXXXXXXXXXXXXXXXXXGXXXXXXXXXXXXXXXXXXXGXXXXXXXXXXXXXXXXXXX,0,10,0
11718,13,0,13,161,426,0,0,440,198,242,GXXXXXXXXXXXXXXXXXXXGXXXXXXXXXXXXXXXXXXXGXXXXXXXXXXXXXXXXXXXGXXXXXXXXXXXXXXXXXXXGXXXXXXXXXXXXXXXXXXXGXXXXXXXXXXXXXXXXXXXGXXXXXXXXXXXXXXXXXXXGXXXXXXXXXXXXXXXXXXXGXXXXXXXXXXXXXXXXXXXGXXXXXXXXXXXXXXXXXXXGXXXXXXXXXXXXXXXXXXXGXXXXXXXXXXXXXXXXXXXGXXXXXXXXXXXXXXXXXXX,0,10,0
11739,13,0,13,164,423,0,0,436,200,236,GXXXXXXXXXXXXXXXXXXXGXXXXXXXXXXXXXXXXXXXGXXXXXXXXXXXXXXXXXXXGXXXXXXXXXXXXXXXXXXXGXXXXXXXXXXXXXXXXXXXGXXXXXXXXXXXXXXXXXXXGXXXXXXXXXXXXXXXXXXXGXXXXXXXXXXXXXXXXXXXGXXXXXXXXXXXXXXXXXXXGXXXXXXXXXXXXXXXXXXXGXXXXXXXXXXXXXXXXXXXGXXXXXXXXXXXXXXXXXXXGXXXXXXXXXXXXXXXXXXX,0,10,0

11760,13,0,13,163,424,0,0,437,194,243,GXXXXXXXXXXXXXXXXXXXGXXXXXXXXXXXXXXXXXXXGXXXXXXXXXXXXXXXXXXXGXXXXXXXXXXXXXXXXXXXGXXXXXXXXXXXXXXXXXXXGXXXXXXXXXXXXXXXXXXXGXXXXXXXXXXXXXXXXXXXGXXXXXXXXXXXXXXXXXXXGXXXXXXXXXXXXXXXXXXXGXXXXXXXXXXXXXXXXXXXGXXXXXXXXXXXXXXXXXXXGXXXXXXXXXXXXXXXXXXXGXXXXXXXXXXXXXXXXXXX,0,10,0
11781,13,0,13,164,423,0,0,434,193,241,GXXXXXXXXXXXXXXXXXXXGXXXXXXXXXXXXXXXXXXXGXXXXXXXXXXXXXXXXXXXGXXXXXXXXXXXXXXXXXXXGXXXXXXXXXXXXXXXXXXXGXXXXXXXXXXXXXXXXXXXGXXXXXXXXXXXXXXXXXXXGXXXXXXXXXXXXXXXXXXXGXXXXXXXXXXXXXXXXXXXGXXXXXXXXXXXXXXXXXXXGXXXXXXXXXXXXXXXXXXXGXXXXXXXXXXXXXXXXXXXGXXXXXXXXXXXXXXXXXXX,0,10,0
11802,13,0,13,154,433,0,0,446,200,246,GXXXXXXXXXXXXXXXXXXXGXXXXXXXXXXXXXXXXXXXGXXXXXXXXXXXXXXXXXXXGXXXXXXXXXXXXXXXXXXXGXXXXXXXXXXXXXXXXXXXGXXXXXXXXXXXXXXXXXXXGXXXXXXXXXXXXXXXXXXXGXXXXXXXXXXXXXXXXXXXGXXXXXXXXXXXXXXXXXXXGXXXXXXXXXXXXXXXXXXXGXXXXXXXXXXXXXXXXXXXGXXXXXXXXXXXXXXXXXXXGXXXXXXXXXXXXXXXXXXX,0,10,0
11823,13,0,13,155,432,0,0,446,200,246,GXXXXXXXXXXXXXXXXXXXGXXXXXXXXXXXXXXXXXXXGXXXXXXXXXXXXXXXXXXXGXXXXXXXXXXXXXXXXXXXGXXXXXXXXXXXXXXXXXXXGXXXXXXXXXXXXXXXXXXXGXXXXXXXXXXXXXXXXXXXGXXXXXXXXXXXXXXXXXXXGXXXXXXXXXXXXXXXXXXXGXXXXXXXXXXXXXXXXXXXGXXXXXXXXXXXXXXXXXXXGXXXXXXXXXXXXXXXXXXXGXXXXXXXXXXXXXXXXXXX,0,10,0
11844,13,0,13,151,436,0,0,450,209,241,GXXXXXXXXXXXXXXXXXXXGXXXXXXXXXXXXXXXXXXXGXXXXXXXXXXXXXXXXXXXGXXXXXXXXXXXXXXXXXXXGXXXXXXXXXXXXXXXXXXXGXXXXXXXXXXXXXXXXXXXGXXXXXXXXXXXXXXXXXXXGXXXXXXXXXXXXXXXXXXXGXXXXXXXXXXXXXXXXXXXGXXXXXXXXXXXXXXXXXXXGXXXXXXXXXXXXXXXXXXXGXXXXXXXXXXXXXXXXXXXGXXXXXXXXXXXXXXXXXXX,0,10,0

11865,13,0,13,152,435,0,0,449,208,241,GXXXXXXXXXXXXXXXXXXXGXXXXXXXXXXXXXXXXXXXGXXXXXXXXXXXXXXXXXXXGXXXXXXXXXXXXXXXXXXXGXXXXXXXXXXXXXXXXXXXGXXXXXXXXXXXXXXXXXXXGXXXXXXXXXXXXXXXXXXXGXXXXXXXXXXXXXXXXXXXGXXXXXXXXXXXXXXXXXXXGXXXXXXXXXXXXXXXXXXXGXXXXXXXXXXXXXXXXXXXGXXXXXXXXXXXXXXXXXXXGXXXXXXXXXXXXXXXXXXX,0,10,0
11886,13,0,13,152,435,0,0,449,205,244,GXXXXXXXXXXXXXXXXXXXGXXXXXXXXXXXXXXXXXXXGXXXXXXXXXXXXXXXXXXXGXXXXXXXXXXXXXXXXXXXGXXXXXXXXXXXXXXXXXXXGXXXXXXXXXXXXXXXXXXXGXXXXXXXXXXXXXXXXXXXGXXXXXXXXXXXXXXXXXXXGXXXXXXXXXXXXXXXXXXXGXXXXXXXXXXXXXXXXXXXGXXXXXXXXXXXXXXXXXXXGXXXXXXXXXXXXXXXXXXXGXXXXXXXXXXXXXXXXXXX,0,10,0
11907,13,0,13,155,432,0,0,448,203,245,GXXXXXXXXXXXXXXXXXXXGXXXXXXXXXXXXXXXXXXXGXXXXXXXXXXXXXXXXXXXGXXXXXXXXXXXXXXXXXXXGXXXXXXXXXXXXXXXXXXXGXXXXXXXXXXXXXXXXXXXGXXXXXXXXXXXXXXXXXXXGXXXXXXXXXXXXXXXXXXXGXXXXXXXXXXXXXXXXXXXGXXXXXXXXXXXXXXXXXXXGXXXXXXXXXXXXXXXXXXXGXXXXXXXXXXXXXXXXXXXGXXXXXXXXXXXXXXXXXXX,0,10,0
11928,13,0,13,163,424,0,0,440,200,240,GXXXXXXXXXXXXXXXXXXXGXXXXXXXXXXXXXXXXXXXGXXXXXXXXXXXXXXXXXXXGXXXXXXXXXXXXXXXXXXXGXXXXXXXXXXXXXXXXXXXGXXXXXXXXXXXXXXXXXXXGXXXXXXXXXXXXXXXXXXXGXXXXXXXXXXXXXXXXXXXGXXXXXXXXXXXXXXXXXXXGXXXXXXXXXXXXXXXXXXXGXXXXXXXXXXXXXXXXXXXGXXXXXXXXXXXXXXXXXXXGXXXXXXXXXXXXXXXXXXX,0,10,0
11949,13,0,13,167,420,0,0,437,200,237,GXXXXXXXXXXXXXXXXXXXGXXXXXXXXXXXXXXXXXXXGXXXXXXXXXXXXXXXXXXXGXXXXXXXXXXXXXXXXXXXGXXXXXXXXXXXXXXXXXXXGXXXXXXXXXXXXXXXXXXXGXXXXXXXXXXXXXXXXXXXGXXXXXXXXXXXXXXXXXXXGXXXXXXXXXXXXXXXXXXXGXXXXXXXXXXXXXXXXXXXGXXXXXXXXXXXXXXXXXXXGXXXXXXXXXXXXXXXXXXXGXXXXXXXXXXXXXXXXXXX,0,10,0

11970,13,0,13,161,426,0,0,443,203,240,GXXXXXXXXXXXXXXXXXXXGXXXXXXXXXXXXXXXXXXXGXXXXXXXXXXXXXXXXXXXGXXXXXXXXXXXXXXXXXXXGXXXXXXXXXXXXXXXXXXXGXXXXXXXXXXXXXXXXXXXGXXXXXXXXXXXXXXXXXXXGXXXXXXXXXXXXXXXXXXXGXXXXXXXXXXXXXXXXXXXGXXXXXXXXXXXXXXXXXXXGXXXXXXXXXXXXXXXXXXXGXXXXXXXXXXXXXXXXXXXGXXXXXXXXXXXXXXXXXXX,0,10,0
11991,13,0,13,165,422,0,0,440,201,239,GXXXXXXXXXXXXXXXXXXXGXXXXXXXXXXXXXXXXXXXGXXXXXXXXXXXXXXXXXXXGXXXXXXXXXXXXXXXXXXXGXXXXXXXXXXXXXXXXXXXGXXXXXXXXXXXXXXXXXXXGXXXXXXXXXXXXXXXXXXXGXXXXXXXXXXXXXXXXXXXGXXXXXXXXXXXXXXXXXXXGXXXXXXXXXXXXXXXXXXXGXXXXXXXXXXXXXXXXXXXGXXXXXXXXXXXXXXXXXXXGXXXXXXXXXXXXXXXXXXX,0,10,0
12012,14,1,13,168,418,0,0,435,202,233,GXXXXXXXXXXXXXXXXXXXGXXXXXXXXXXXXXXXXXXXGAXXXXXXXXXXXXXXXXXXGXXXXXXXXXXXXXXXXXXXGXXXXXXXXXXXXXXXXXXXGXXXXXXXXXXXXXXXXXXXGXXXXXXXXXXXXXXXXXXXGXXXXXXXXXXXXXXXXXXXGXXXXXXXXXXXXXXXXXXXGXXXXXXXXXXXXXXXXXXXGXXXXXXXXXXXXXXXXXXXGXXXXXXXXXXXXXXXXXXXGXXXXXXXXXXXXXXXXXXX,0,10,0
12033,14,1,13,174,412,0,0,427,193,234,GXXXXXXXXXXXXXXXXXXXGXXXXXXXXXXXXXXXXXXXGAXXXXXXXXXXXXXXXXXXGXXXXXXXXXXXXXXXXXXXGXXXXXXXXXXXXXXXXXXXGXXXXXXXXXXXXXXXXXXXGXXXXXXXXXXXXXXXXXXXGXXXXXXXXXXXXXXXXXXXGXXXXXXXXXXXXXXXXXXXGXXXXXXXXXXXXXXXXXXXGXXXXXXXXXXXXXXXXXXXGXXXXXXXXXXXXXXXXXXXGXXXXXXXXXXXXXXXXXXX,0,10,0
12054,14,1,13,165,421,0,0,434,189,245,GXXXXXXXXXXXXXXXXXXXGXXXXXXXXXXXXXXXXXXXGAXXXXXXXXXXXXXXXXXXGXXXXXXXXXXXXXXXXXXXGXXXXXXXXXXXXXXXXXXXGXXXXXXXXXXXXXXXXXXXGXXXXXXXXXXXXXXXXXXXGXXXXXXXXXXXXXXXXXXXGXXXXXXXXXXXXXXXXXXXGXXXXXXXXXXXXXXXXXXXGXXXXXXXXXXXXXXXXXXXGXXXXXXXXXXXXXXXXXXXGXXXXXXXXXXXXXXXXXXX,0,10,0

12075,14,1,13,157,429,0,0,442,189,253,GXXXXXXXXXXXXXXXXXXXGXXXXXXXXXXXXXXXXXXXGAXXXXXXXXXXXXXXXXXXGXXXXXXXXXXXXXXXXXXXGXXXXXXXXXXXXXXXXXXXGXXXXXXXXXXXXXXXXXXXGXXXXXXXXXXXXXXXXXXXGXXXXXXXXXXXXXXXXXXXGXXXXXXXXXXXXXXXXXXXGXXXXXXXXXXXXXXXXXXXGXXXXXXXXXXXXXXXXXXXGXXXXXXXXXXXXXXXXXXXGXXXXXXXXXXXXXXXXXXX,0,10,0
12096,15,2,13,144,441,0,0,458,194,264,GXXXXXXXXXXXXXXXXXXXGXXXXXXXXXXXXXXXXXXXGAXXXXXXXXXXXXXXXXXXGXXXXXXXXXXXXXXXXXXXGAXXXXXXXXXXXXXXXXXXGXXXXXXXXXXXXXXXXXXXGXXXXXXXXXXXXXXXXXXXGXXXXXXXXXXXXXXXXXXXGXXXXXXXXXXXXXXXXXXXGXXXXXXXXXXXXXXXXXXXGXXXXXXXXXXXXXXXXXXXGXXXXXXXXXXXXXXXXXXXGXXXXXXXXXXXXXXXXXXX,0,10,0
12117,15,2,13,136,449,0,0,467,195,272,GXXXXXXXXXXXXXXXXXXXGXXXXXXXXXXXXXXXXXXXGAXXXXXXXXXXXXXXXXXXGXXXXXXXXXXXXXXXXXXXGAXXXXXXXXXXXXXXXXXXGXXXXXXXXXXXXXXXXXXXGXXXXXXXXXXXXXXXXXXXGXXXXXXXXXXXXXXXXXXXGXXXXXXXXXXXXXXXXXXXGXXXXXXXXXXXXXXXXXXXGXXXXXXXXXXXXXXXXXXXGXXXXXXXXXXXXXXXXXXXGXXXXXXXXXXXXXXXXXXX,0,10,0
12138,15,2,13,132,453,0,0,470,209,261,GXXXXXXXXXXXXXXXXXXXGXXXXXXXXXXXXXXXXXXXGAXXXXXXXXXXXXXXXXXXGXXXXXXXXXXXXXXXXXXXGAXXXXXXXXXXXXXXXXXXGXXXXXXXXXXXXXXXXXXXGXXXXXXXXXXXXXXXXXXXGXXXXXXXXXXXXXXXXXXXGXXXXXXXXXXXXXXXXXXXGXXXXXXXXXXXXXXXXXXXGXXXXXXXXXXXXXXXXXXXGXXXXXXXXXXXXXXXXXXXGXXXXXXXXXXXXXXXXXXX,0,10,0
12159,15,2,13,138,447,0,0,463,205,258,GXXXXXXXXXXXXXXXXXXXGXXXXXXXXXXXXXXXXXXXGAXXXXXXXXXXXXXXXXXXGXXXXXXXXXXXXXXXXXXXGAXXXXXXXXXXXXXXXXXXGXXXXXXXXXXXXXXXXXXXGXXXXXXXXXXXXXXXXXXXGXXXXXXXXXXXXXXXXXXXGXXXXXXXXXXXXXXXXXXXGXXXXXXXXXXXXXXXXXXXGXXXXXXXXXXXXXXXXXXXGXXXXXXXXXXXXXXXXXXXGXXXXXXXXXXXXXXXXXXX,0,10,0

12180,16,3,13,134,450,0,0,464,202,262,GXXXXXXXXXXXXXXXXXXXGXXXXXXXXXXXXXXXXXXXGAXXXXXXXXXXXXXXXXXXGXXXXXXXXXXXXXXXXXXXGAXXXXXXXXXXXXXXXXXXGXXXXXXXXXXXXXXXXXXXGXXXXXXXXXXXXXXXXXXXGXXXXXXXXXXXXXXXXXXXGXXXXXXXXXXXXXXXXXXXGXXXXXXXXXXXXXXXXXXXGXXXXXXXXXXXXXXXXXXXGAXXXXXXXXXXXXXXXXXXGXXXXXXXXXXXXXXXXXXX,0,10,0
12201,15,2,13,130,455,0,0,468,198,270,GXXXXXXXXXXXXXXXXXXXGXXXXXXXXXXXXXXXXXXXGXXXXXXXXXXXXXXXXXXXGXXXXXXXXXXXXXXXXXXXGAXXXXXXXXXXXXXXXXXXGXXXXXXXXXXXXXXXXXXXGXXXXXXXXXXXXXXXXXXXGXXXXXXXXXXXXXXXXXXXGXXXXXXXXXXXXXXXXXXXGXXXXXXXXXXXXXXXXXXXGXXXXXXXXXXXXXXXXXXXGAXXXXXXXXXXXXXXXXXXGXXXXXXXXXXXXXXXXXXX,0,10,0
12222,15,2,13,125,460,0,0,473,196,277,GXXXXXXXXXXXXXXXXXXXGXXXXXXXXXXXXXXXXXXXGXXXXXXXXXXXXXXXXXXXGXXXXXXXXXXXXXXXXXXXGAXXXXXXXXXXXXXXXXXXGXXXXXXXXXXXXXXXXXXXGXXXXXXXXXXXXXXXXXXXGXXXXXXXXXXXXXXXXXXXGXXXXXXXXXXXXXXXXXXXGXXXXXXXXXXXXXXXXXXXGXXXXXXXXXXXXXXXXXXXGAXXXXXXXXXXXXXXXXXXGXXXXXXXXXXXXXXXXXXX,0,10,0
12243,15,2,13,133,452,0,0,466,199,267,GXXXXXXXXXXXXXXXXXXXGXXXXXXXXXXXXXXXXXXXGXXXXXXXXXXXXXXXXXXXGXXXXXXXXXXXXXXXXXXXGAXXXXXXXXXXXXXXXXXXGXXXXXXXXXXXXXXXXXXXGXXXXXXXXXXXXXXXXXXXGXXXXXXXXXXXXXXXXXXXGXXXXXXXXXXXXXXXXXXXGXXXXXXXXXXXXXXXXXXXGXXXXXXXXXXXXXXXXXXXGAXXXXXXXXXXXXXXXXXXGXXXXXXXXXXXXXXXXXXX,0,10,0
12264,15,2,13,134,451,0,0,464,203,261,GXXXXXXXXXXXXXXXXXXXGXXXXXXXXXXXXXXXXXXXGXXXXXXXXXXXXXXXXXXXGXXXXXXXXXXXXXXXXXXXGXXXXXXXXXXXXXXXXXXXGXXXXXXXXXXXXXXXXXXXGXXXXXXXXXXXXXXXXXXXGXXXXXXXXXXXXXXXXXXXGXXXXXXXXXXXXXXXXXXXGXXXXXXXXXXXXXXXXXXXGXXXXXXXXXXXXXXXXXXXGAAXXXXXXXXXXXXXXXXXGXXXXXXXXXXXXXXXXXXX,0,10,0

12285,15,2,13,132,453,0,0,465,205,260,GXXXXXXXXXXXXXXXXXXXGXXXXXXXXXXXXXXXXXXXGXXXXXXXXXXXXXXXXXXXGXXXXXXXXXXXXXXXXXXXGXXXXXXXXXXXXXXXXXXXGXXXXXXXXXXXXXXXXXXXGXXXXXXXXXXXXXXXXXXXGXXXXXXXXXXXXXXXXXXXGXXXXXXXXXXXXXXXXXXXGXXXXXXXXXXXXXXXXXXXGXXXXXXXXXXXXXXXXXXXGAAXXXXXXXXXXXXXXXXXGXXXXXXXXXXXXXXXXXXX,0,10,0
12306,15,2,13,142,443,0,0,455,206,249,GXXXXXXXXXXXXXXXXXXXGXXXXXXXXXXXXXXXXXXXGXXXXXXXXXXXXXXXXXXXGXXXXXXXXXXXXXXXXXXXGXXXXXXXXXXXXXXXXXXXGXXXXXXXXXXXXXXXXXXXGXXXXXXXXXXXXXXXXXXXGXXXXXXXXXXXXXXXXXXXGXXXXXXXXXXXXXXXXXXXGXXXXXXXXXXXXXXXXXXXGXXXXXXXXXXXXXXXXXXXGAAXXXXXXXXXXXXXXXXXGXXXXXXXXXXXXXXXXXXX,0,10,0
12327,15,2,13,145,440,0,0,453,198,255,GXXXXXXXXXXXXXXXXXXXGXXXXXXXXXXXXXXXXXXXGXXXXXXXXXXXXXXXXXXXGXXXXXXXXXXXXXXXXXXXGXXXXXXXXXXXXXXXXXXXGXXXXXXXXXXXXXXXXXXXGXXXXXXXXXXXXXXXXXXXGXXXXXXXXXXXXXXXXXXXGXXXXXXXXXXXXXXXXXXXGXXXXXXXXXXXXXXXXXXXGXXXXXXXXXXXXXXXXXXXGAAXXXXXXXXXXXXXXXXXGXXXXXXXXXXXXXXXXXXX,0,10,0
12348,15,2,13,142,443,0,0,456,209,247,GXXXXXXXXXXXXXXXXXXXGXXXXXXXXXXXXXXXXXXXGXXXXXXXXXXXXXXXXXXXGXXXXXXXXXXXXXXXXXXXGXXXXXXXXXXXXXXXXXXXGXXXXXXXXXXXXXXXXXXXGXXXXXXXXXXXXXXXXXXXGXXXXXXXXXXXXXXXXXXXGXXXXXXXXXXXXXXXXXXXGXXXXXXXXXXXXXXXXXXXGXXXXXXXXXXXXXXXXXXXGAAXXXXXXXXXXXXXXXXXGXXXXXXXXXXXXXXXXXXX,0,10,0
12369,15,1,14,147,438,0,0,450,208,242,GXXXXXXXXXXXXXXXXXXXGXXXXXXXXXXXXXXXXXXXGXXXXXXXXXXXXXXXXXXXGXXXXXXXXXXXXXXXXXXXGXXXXXXXXXXXXXXXXXXXGXXXXXXXXXXXXXXXXXXXGXXXXXXXXXXXXXXXXXXXGXXXXXXXXXXXXXXXXXXXGXXXXXXXXXXXXXXXXXXXGXXXXXXXXXXXXXXXXXXXGXXXXXXXXXXXXXXXXXXXGOAXXXXXXXXXXXXXXXXXGXXXXXXXXXXXXXXXXXXX,0,10,0

12390,15,1,14,153,432,0,0,443,206,237,GXXXXXXXXXXXXXXXXXXXGXXXXXXXXXXXXXXXXXXXGXXXXXXXXXXXXXXXXXXXGXXXXXXXXXXXXXXXXXXXGXXXXXXXXXXXXXXXXXXXGXXXXXXXXXXXXXXXXXXXGXXXXXXXXXXXXXXXXXXXGXXXXXXXXXXXXXXXXXXXGXXXXXXXXXXXXXXXXXXXGXXXXXXXXXXXXXXXXXXXGXXXXXXXXXXXXXXXXXXXGOAXXXXXXXXXXXXXXXXXGXXXXXXXXXXXXXXXXXXX,0,10,0
12411,14,1,13,149,437,0,0,449,201,248,GXXXXXXXXXXXXXXXXXXXGXXXXXXXXXXXXXXXXXXXGXXXXXXXXXXXXXXXXXXXGXXXXXXXXXXXXXXXXXXXGXXXXXXXXXXXXXXXXXXXGXXXXXXXXXXXXXXXXXXXGXXXXXXXXXXXXXXXXXXXGXXXXXXXXXXXXXXXXXXXGXXXXXXXXXXXXXXXXXXXGXXXXXXXXXXXXXXXXXXXGXXXXXXXXXXXXXXXXXXXGXAXXXXXXXXXXXXXXXXXGXXXXXXXXXXXXXXXXXXX,0,10,0
12432,13,0,13,150,437,0,0,449,202,247,GXXXXXXXXXXXXXXXXXXXGXXXXXXXXXXXXXXXXXXXGXXXXXXXXXXXXXXXXXXXGXXXXXXXXXXXXXXXXXXXGXXXXXXXXXXXXXXXXXXXGXXXXXXXXXXXXXXXXXXXGXXXXXXXXXXXXXXXXXXXGXXXXXXXXXXXXXXXXXXXGXXXXXXXXXXXXXXXXXXXGXXXXXXXXXXXXXXXXXXXGXXXXXXXXXXXXXXXXXXXGXXXXXXXXXXXXXXXXXXXGXXXXXXXXXXXXXXXXXXX,0,10,0
12453,13,0,13,153,434,0,0,447,199,248,GXXXXXXXXXXXXXXXXXXXGXXXXXXXXXXXXXXXXXXXGXXXXXXXXXXXXXXXXXXXGXXXXXXXXXXXXXXXXXXXGXXXXXXXXXXXXXXXXXXXGXXXXXXXXXXXXXXXXXXXGXXXXXXXXXXXXXXXXXXXGXXXXXXXXXXXXXXXXXXXGXXXXXXXXXXXXXXXXXXXGXXXXXXXXXXXXXXXXXXXGXXXXXXXXXXXXXXXXXXXGXXXXXXXXXXXXXXXXXXXGXXXXXXXXXXXXXXXXXXX,0,10,0
12474,13,0,13,151,436,0,0,449,208,241,GXXXXXXXXXXXXXXXXXXXGXXXXXXXXXXXXXXXXXXXGXXXXXXXXXXXXXXXXXXXGXXXXXXXXXXXXXXXXXXXGXXXXXXXXXXXXXXXXXXXGXXXXXXXXXXXXXXXXXXXGXXXXXXXXXXXXXXXXXXXGXXXXXXXXXXXXXXXXXXXGXXXXXXXXXXXXXXXXXXXGXXXXXXXXXXXXXXXXXXXGXXXXXXXXXXXXXXXXXXXGXXXXXXXXXXXXXXXXXXXGXXXXXXXXXXXXXXXXXXX,0,10,0

12495,13,0,13,153,434,0,0,446,217,229,GXXXXXXXXXXXXXXXXXXXGXXXXXXXXXXXXXXXXXXXGXXXXXXXXXXXXXXXXXXXGXXXXXXXXXXXXXXXXXXXGXXXXXXXXXXXXXXXXXXXGXXXXXXXXXXXXXXXXXXXGXXXXXXXXXXXXXXXXXXXGXXXXXXXXXXXXXXXXXXXGXXXXXXXXXXXXXXXXXXXGXXXXXXXXXXXXXXXXXXXGXXXXXXXXXXXXXXXXXXXGXXXXXXXXXXXXXXXXXXXGXXXXXXXXXXXXXXXXXXX,0,10,0
12516,13,0,13,168,419,0,0,430,211,219,GXXXXXXXXXXXXXXXXXXXGXXXXXXXXXXXXXXXXXXXGXXXXXXXXXXXXXXXXXXXGXXXXXXXXXXXXXXXXXXXGXXXXXXXXXXXXXXXXXXXGXXXXXXXXXXXXXXXXXXXGXXXXXXXXXXXXXXXXXXXGXXXXXXXXXXXXXXXXXXXGXXXXXXXXXXXXXXXXXXXGXXXXXXXXXXXXXXXXXXXGXXXXXXXXXXXXXXXXXXXGXXXXXXXXXXXXXXXXXXXGXXXXXXXXXXXXXXXXXXX,0,10,0
12537,13,0,13,167,420,0,0,433,211,222,GXXXXXXXXXXXXXXXXXXXGXXXXXXXXXXXXXXXXXXXGXXXXXXXXXXXXXXXXXXXGXXXXXXXXXXXXXXXXXXXGXXXXXXXXXXXXXXXXXXXGXXXXXXXXXXXXXXXXXXXGXXXXXXXXXXXXXXXXXXXGXXXXXXXXXXXXXXXXXXXGXXXXXXXXXXXXXXXXXXXGXXXXXXXXXXXXXXXXXXXGXXXXXXXXXXXXXXXXXXXGXXXXXXXXXXXXXXXXXXXGXXXXXXXXXXXXXXXXXXX,0,10,0
12558,13,0,13,162,425,0,0,436,214,222,GXXXXXXXXXXXXXXXXXXXGXXXXXXXXXXXXXXXXXXXGXXXXXXXXXXXXXXXXXXXGXXXXXXXXXXXXXXXXXXXGXXXXXXXXXXXXXXXXXXXGXXXXXXXXXXXXXXXXXXXGXXXXXXXXXXXXXXXXXXXGXXXXXXXXXXXXXXXXXXXGXXXXXXXXXXXXXXXXXXXGXXXXXXXXXXXXXXXXXXXGXXXXXXXXXXXXXXXXXXXGXXXXXXXXXXXXXXXXXXXGXXXXXXXXXXXXXXXXXXX,0,10,0
12579,14,1,13,166,420,0,0,432,203,229,GXXXXXXXXXXXXXXXXXXXGXXXXXXXXXXXXXXXXXXXGXXXXXXXXXXXXXXXXXXXGXXXXXXXXXXXXXXXXXXXGXXXXXXXXXXXXXXXXXXXGXXXXXXXXXXXXXXXXXXXGXXXXXXXXXXXXXXXXXXXGXXXXXXXXXXXXXXXXXXXGXXXXXXXXXXXXXXXXXXXGXXXXXXXXXXXXXXXXXXXGAXXXXXXXXXXXXXXXXXXGXXXXXXXXXXXXXXXXXXXGXXXXXXXXXXXXXXXXXXX,0,10,0

12600,14,1,13,159,427,0,0,439,204,235,GXXXXXXXXXXXXXXXXXXXGXXXXXXXXXXXXXXXXXXXGXXXXXXXXXXXXXXXXXXXGXXXXXXXXXXXXXXXXXXXGXXXXXXXXXXXXXXXXXXXGXXXXXXXXXXXXXXXXXXXGXXXXXXXXXXXXXXXXXXXGXXXXXXXXXXXXXXXXXXXGXXXXXXXXXXXXXXXXXXXGXXXXXXXXXXXXXXXXXXXGAXXXXXXXXXXXXXXXXXXGXXXXXXXXXXXXXXXXXXXGXXXXXXXXXXXXXXXXXXX,0,10,0
12621,14,1,13,158,428,0,0,440,200,240,GXXXXXXXXXXXXXXXXXXXGXXXXXXXXXXXXXXXXXXXGXXXXXXXXXXXXXXXXXXXGXXXXXXXXXXXXXXXXXXXGXXXXXXXXXXXXXXXXXXXGXXXXXXXXXXXXXXXXXXXGXXXXXXXXXXXXXXXXXXXGXXXXXXXXXXXXXXXXXXXGXXXXXXXXXXXXXXXXXXXGXXXXXXXXXXXXXXXXXXXGAXXXXXXXXXXXXXXXXXXGXXXXXXXXXXXXXXXXXXXGXXXXXXXXXXXXXXXXXXX,0,10,0
12642,14,1,13,142,444,0,0,458,201,257,GXXXXXXXXXXXXXXXXXXXGXXXXXXXXXXXXXXXXXXXGXXXXXXXXXXXXXXXXXXXGXXXXXXXXXXXXXXXXXXXGXXXXXXXXXXXXXXXXXXXGXXXXXXXXXXXXXXXXXXXGXXXXXXXXXXXXXXXXXXXGXXXXXXXXXXXXXXXXXXXGXXXXXXXXXXXXXXXXXXXGXXXXXXXXXXXXXXXXXXXGAXXXXXXXXXXXXXXXXXXGXXXXXXXXXXXXXXXXXXXGXXXXXXXXXXXXXXXXXXX,0,10,0
12663,14,1,13,139,447,0,0,460,201,259,GXXXXXXXXXXXXXXXXXXXGXXXXXXXXXXXXXXXXXXXGXXXXXXXXXXXXXXXXXXXGXXXXXXXXXXXXXXXXXXXGXXXXXXXXXXXXXXXXXXXGXXXXXXXXXXXXXXXXXXXGXXXXXXXXXXXXXXXXXXXGXXXXXXXXXXXXXXXXXXXGXXXXXXXXXXXXXXXXXXXGXXXXXXXXXXXXXXXXXXXGAXXXXXXXXXXXXXXXXXXGXXXXXXXXXXXXXXXXXXXGXXXXXXXXXXXXXXXXXXX,0,10,0
12684,14,1,13,134,452,0,0,466,205,261,GXXXXXXXXXXXXXXXXXXXGXXXXXXXXXXXXXXXXXXXGXXXXXXXXXXXXXXXXXXXGXXXXXXXXXXXXXXXXXXXGXXXXXXXXXXXXXXXXXXXGXXXXXXXXXXXXXXXXXXXGXXXXXXXXXXXXXXXXXXXGXXXXXXXXXXXXXXXXXXXGXXXXXXXXXXXXXXXXXXXGXXXXXXXXXXXXXXXXXXXGAXXXXXXXXXXXXXXXXXXGXXXXXXXXXXXXXXXXXXXGXXXXXXXXXXXXXXXXXXX,0,10,0

12705,14,1,13,130,456,0,0,471,212,259,GXXXXXXXXXXXXXXXXXXXGXXXXXXXXXXXXXXXXXXXGXXXXXXXXXXXXXXXXXXXGXXXXXXXXXXXXXXXXXXXGXXXXXXXXXXXXXXXXXXXGXXXXXXXXXXXXXXXXXXXGXXXXXXXXXXXXXXXXXXXGXXXXXXXXXXXXXXXXXXXGXXXXXXXXXXXXXXXXXXXGXXXXXXXXXXXXXXXXXXXGAXXXXXXXXXXXXXXXXXXGXXXXXXXXXXXXXXXXXXXGXXXXXXXXXXXXXXXXXXX,0,10,0
12726,14,1,13,133,453,0,0,467,209,258,GXXXXXXXXXXXXXXXXXXXGXXXXXXXXXXXXXXXXXXXGXXXXXXXXXXXXXXXXXXXGXXXXXXXXXXXXXXXXXXXGXXXXXXXXXXXXXXXXXXXGXXXXXXXXXXXXXXXXXXXGXXXXXXXXXXXXXXXXXXXGXXXXXXXXXXXXXXXXXXXGXXXXXXXXXXXXXXXXXXXGXXXXXXXXXXXXXXXXXXXGAXXXXXXXXXXXXXXXXXXGXXXXXXXXXXXXXXXXXXXGXXXXXXXXXXXXXXXXXXX,0,10,0
12747,14,1,13,131,455,0,0,470,210,260,GXXXXXXXXXXXXXXXXXXXGXXXXXXXXXXXXXXXXXXXGXXXXXXXXXXXXXXXXXXXGXXXXXXXXXXXXXXXXXXXGXXXXXXXXXXXXXXXXXXXGXXXXXXXXXXXXXXXXXXXGXXXXXXXXXXXXXXXXXXXGXXXXXXXXXXXXXXXXXXXGXXXXXXXXXXXXXXXXXXXGXXXXXXXXXXXXXXXXXXXGAXXXXXXXXXXXXXXXXXXGXXXXXXXXXXXXXXXXXXXGXXXXXXXXXXXXXXXXXXX,0,10,0
12768,14,1,13,124,462,0,0,476,210,266,GXXXXXXXXXXXXXXXXXXXGXXXXXXXXXXXXXXXXXXXGXXXXXXXXXXXXXXXXXXXGXXXXXXXXXXXXXXXXXXXGXXXXXXXXXXXXXXXXXXXGXXXXXXXXXXXXXXXXXXXGXXXXXXXXXXXXXXXXXXXGXXXXXXXXXXXXXXXXXXXGXXXXXXXXXXXXXXXXXXXGXXXXXXXXXXXXXXXXXXXGAXXXXXXXXXXXXXXXXXXGXXXXXXXXXXXXXXXXXXXGXXXXXXXXXXXXXXXXXXX,0,10,0
12789,14,1,13,125,461,0,0,474,213,261,GXXXXXXXXXXXXXXXXXXXGXXXXXXXXXXXXXXXXXXXGXXXXXXXXXXXXXXXXXXXGXXXXXXXXXXXXXXXXXXXGXXXXXXXXXXXXXXXXXXXGXXXXXXXXXXXXXXXXXXXGXXXXXXXXXXXXXXXXXXXGXXXXXXXXXXXXXXXXXXXGXXXXXXXXXXXXXXXXXXXGXXXXXXXXXXXXXXXXXXXGAXXXXXXXXXXXXXXXXXXGXXXXXXXXXXXXXXXXXXXGXXXXXXXXXXXXXXXXXXX,0,10,0

12810,14,1,13,127,459,0,0,472,215,257,GXXXXXXXXXXXXXXXXXXXGXXXXXXXXXXXXXXXXXXXGXXXXXXXXXXXXXXXXXXXGXXXXXXXXXXXXXXXXXXXGXXXXXXXXXXXXXXXXXXXGXXXXXXXXXXXXXXXXXXXGXXXXXXXXXXXXXXXXXXXGXXXXXXXXXXXXXXXXXXXGXXXXXXXXXXXXXXXXXXXGXXXXXXXXXXXXXXXXXXXGAXXXXXXXXXXXXXXXXXXGXXXXXXXXXXXXXXXXXXXGXXXXXXXXXXXXXXXXXXX,0,10,0
12831,14,1,13,128,458,0,0,470,216,254,GXXXXXXXXXXXXXXXXXXXGXXXXXXXXXXXXXXXXXXXGXXXXXXXXXXXXXXXXXXXGXXXXXXXXXXXXXXXXXXXGXXXXXXXXXXXXXXXXXXXGXXXXXXXXXXXXXXXXXXXGXXXXXXXXXXXXXXXXXXXGXXXXXXXXXXXXXXXXXXXGXXXXXXXXXXXXXXXXXXXGXXXXXXXXXXXXXXXXXXXGAXXXXXXXXXXXXXXXXXXGXXXXXXXXXXXXXXXXXXXGXXXXXXXXXXXXXXXXXXX,0,10,0
12852,13,0,13,126,461,0,0,474,209,265,GXXXXXXXXXXXXXXXXXXXGXXXXXXXXXXXXXXXXXXXGXXXXXXXXXXXXXXXXXXXGXXXXXXXXXXXXXXXXXXXGXXXXXXXXXXXXXXXXXXXGXXXXXXXXXXXXXXXXXXXGXXXXXXXXXXXXXXXXXXXGXXXXXXXXXXXXXXXXXXXGXXXXXXXXXXXXXXXXXXXGXXXXXXXXXXXXXXXXXXXGXXXXXXXXXXXXXXXXXXXGXXXXXXXXXXXXXXXXXXXGXXXXXXXXXXXXXXXXXXX,0,10,0
12873,13,0,13,123,464,0,0,479,208,271,GXXXXXXXXXXXXXXXXXXXGXXXXXXXXXXXXXXXXXXXGXXXXXXXXXXXXXXXXXXXGXXXXXXXXXXXXXXXXXXXGXXXXXXXXXXXXXXXXXXXGXXXXXXXXXXXXXXXXXXXGXXXXXXXXXXXXXXXXXXXGXXXXXXXXXXXXXXXXXXXGXXXXXXXXXXXXXXXXXXXGXXXXXXXXXXXXXXXXXXXGXXXXXXXXXXXXXXXXXXXGXXXXXXXXXXXXXXXXXXXGXXXXXXXXXXXXXXXXXXX,0,10,0
12894,13,0,13,126,461,0,0,476,212,264,GXXXXXXXXXXXXXXXXXXXGXXXXXXXXXXXXXXXXXXXGXXXXXXXXXXXXXXXXXXXGXXXXXXXXXXXXXXXXXXXGXXXXXXXXXXXXXXXXXXXGXXXXXXXXXXXXXXXXXXXGXXXXXXXXXXXXXXXXXXXGXXXXXXXXXXXXXXXXXXXGXXXXXXXXXXXXXXXXXXXGXXXXXXXXXXXXXXXXXXXGXXXXXXXXXXXXXXXXXXXGXXXXXXXXXXXXXXXXXXXGXXXXXXXXXXXXXXXXXXX,0,10,0

12915,13,0,13,123,464,0,0,478,213,265,GXXXXXXXXXXXXXXXXXXXGXXXXXXXXXXXXXXXXXXXGXXXXXXXXXXXXXXXXXXXGXXXXXXXXXXXXXXXXXXXGXXXXXXXXXXXXXXXXXXXGXXXXXXXXXXXXXXXXXXXGXXXXXXXXXXXXXXXXXXXGXXXXXXXXXXXXXXXXXXXGXXXXXXXXXXXXXXXXXXXGXXXXXXXXXXXXXXXXXXXGXXXXXXXXXXXXXXXXXXXGXXXXXXXXXXXXXXXXXXXGXXXXXXXXXXXXXXXXXXX,0,10,0
12936,13,0,13,126,461,0,0,476,216,260,GXXXXXXXXXXXXXXXXXXXGXXXXXXXXXXXXXXXXXXXGXXXXXXXXXXXXXXXXXXXGXXXXXXXXXXXXXXXXXXXGXXXXXXXXXXXXXXXXXXXGXXXXXXXXXXXXXXXXXXXGXXXXXXXXXXXXXXXXXXXGXXXXXXXXXXXXXXXXXXXGXXXXXXXXXXXXXXXXXXXGXXXXXXXXXXXXXXXXXXXGXXXXXXXXXXXXXXXXXXXGXXXXXXXXXXXXXXXXXXXGXXXXXXXXXXXXXXXXXXX,0,10,0
12957,13,0,13,127,460,0,0,473,213,260,GXXXXXXXXXXXXXXXXXXXGXXXXXXXXXXXXXXXXXXXGXXXXXXXXXXXXXXXXXXXGXXXXXXXXXXXXXXXXXXXGXXXXXXXXXXXXXXXXXXXGXXXXXXXXXXXXXXXXXXXGXXXXXXXXXXXXXXXXXXXGXXXXXXXXXXXXXXXXXXXGXXXXXXXXXXXXXXXXXXXGXXXXXXXXXXXXXXXXXXXGXXXXXXXXXXXXXXXXXXXGXXXXXXXXXXXXXXXXXXXGXXXXXXXXXXXXXXXXXXX,0,10,0
12978,13,0,13,138,449,0,0,464,213,251,GXXXXXXXXXXXXXXXXXXXGXXXXXXXXXXXXXXXXXXXGXXXXXXXXXXXXXXXXXXXGXXXXXXXXXXXXXXXXXXXGXXXXXXXXXXXXXXXXXXXGXXXXXXXXXXXXXXXXXXXGXXXXXXXXXXXXXXXXXXXGXXXXXXXXXXXXXXXXXXXGXXXXXXXXXXXXXXXXXXXGXXXXXXXXXXXXXXXXXXXGXXXXXXXXXXXXXXXXXXXGXXXXXXXXXXXXXXXXXXXGXXXXXXXXXXXXXXXXXXX,0,10,0
12999,13,0,13,140,447,0,0,462,215,247,GXXXXXXXXXXXXXXXXXXXGXXXXXXXXXXXXXXXXXXXGXXXXXXXXXXXXXXXXXXXGXXXXXXXXXXXXXXXXXXXGXXXXXXXXXXXXXXXXXXXGXXXXXXXXXXXXXXXXXXXGXXXXXXXXXXXXXXXXXXXGXXXXXXXXXXXXXXXXXXXGXXXXXXXXXXXXXXXXXXXGXXXXXXXXXXXXXXXXXXXGXXXXXXXXXXXXXXXXXXXGXXXXXXXXXXXXXXXXXXXGXXXXXXXXXXXXXXXXXXX,0,10,0

13020,14,1,13,144,442,0,0,459,217,242,GXXXXXXXXXXXXXXXXXXXGXXXXXXXXXXXXXXXXXXXGXXXXXXXXXXXXXXXXXXXGXXXXXXXXXXXXXXXXXXXGXXXXXXXXXXXXXXXXXXXGXXXXXXXXXXXXXXXXXXXGXXXXXXXXXXXXXXXXXXXGXXXXXXXXXXXXXXXXXXXGXXXXXXXXXXXXXXXXXXXGXXXXXXXXXXXXXXXXXXXGAXXXXXXXXXXXXXXXXXXGXXXXXXXXXXXXXXXXXXXGXXXXXXXXXXXXXXXXXXX,0,10,0
13041,14,1,13,146,440,0,0,456,217,239,GXXXXXXXXXXXXXXXXXXXGXXXXXXXXXXXXXXXXXXXGXXXXXXXXXXXXXXXXXXXGXXXXXXXXXXXXXXXXXXXGXXXXXXXXXXXXXXXXXXXGXXXXXXXXXXXXXXXXXXXGXXXXXXXXXXXXXXXXXXXGXXXXXXXXXXXXXXXXXXXGXXXXXXXXXXXXXXXXXXXGXXXXXXXXXXXXXXXXXXXGAXXXXXXXXXXXXXXXXXXGXXXXXXXXXXXXXXXXXXXGXXXXXXXXXXXXXXXXXXX,0,10,0
13062,15,1,14,144,441,0,0,458,210,248,GXXXXXXXXXXXXXXXXXXXGXXXXXXXXXXXXXXXXXXXGAXXXXXXXXXXXXXXXXXXGXXXXXXXXXXXXXXXXXXXGXXXXXXXXXXXXXXXXXXXGXXXXXXXXXXXXXXXXXXXGXXXXXXXXXXXXXXXXXXXGXXXXXXXXXXXXXXXXXXXGXXXXXXXXXXXXXXXXXXXGXXXXXXXXXXXXXXXXXXXGOXXXXXXXXXXXXXXXXXXGXXXXXXXXXXXXXXXXXXXGXXXXXXXXXXXXXXXXXXX,0,10,0
13083,14,1,13,149,437,0,0,453,210,243,GXXXXXXXXXXXXXXXXXXXGXXXXXXXXXXXXXXXXXXXGAXXXXXXXXXXXXXXXXXXGXXXXXXXXXXXXXXXXXXXGXXXXXXXXXXXXXXXXXXXGXXXXXXXXXXXXXXXXXXXGXXXXXXXXXXXXXXXXXXXGXXXXXXXXXXXXXXXXXXXGXXXXXXXXXXXXXXXXXXXGXXXXXXXXXXXXXXXXXXXGXXXXXXXXXXXXXXXXXXXGXXXXXXXXXXXXXXXXXXXGXXXXXXXXXXXXXXXXXXX,0,10,0
13104,14,1,13,140,446,0,0,461,211,250,GXXXXXXXXXXXXXXXXXXXGXXXXXXXXXXXXXXXXXXXGAXXXXXXXXXXXXXXXXXXGXXXXXXXXXXXXXXXXXXXGXXXXXXXXXXXXXXXXXXXGXXXXXXXXXXXXXXXXXXXGXXXXXXXXXXXXXXXXXXXGXXXXXXXXXXXXXXXXXXXGXXXXXXXXXXXXXXXXXXXGXXXXXXXXXXXXXXXXXXXGXXXXXXXXXXXXXXXXXXXGXXXXXXXXXXXXXXXXXXXGXXXXXXXXXXXXXXXXXXX,0,10,0

13125,14,1,13,138,448,0,0,464,212,252,GXXXXXXXXXXXXXXXXXXXGXXXXXXXXXXXXXXXXXXXGAXXXXXXXXXXXXXXXXXXGXXXXXXXXXXXXXXXXXXXGXXXXXXXXXXXXXXXXXXXGXXXXXXXXXXXXXXXXXXXGXXXXXXXXXXXXXXXXXXXGXXXXXXXXXXXXXXXXXXXGXXXXXXXXXXXXXXXXXXXGXXXXXXXXXXXXXXXXXXXGXXXXXXXXXXXXXXXXXXXGXXXXXXXXXXXXXXXXXXXGXXXXXXXXXXXXXXXXXXX,0,10,0
13146,14,0,14,139,447,0,0,462,206,256,GXXXXXXXXXXXXXXXXXXXGXXXXXXXXXXXXXXXXXXXGOXXXXXXXXXXXXXXXXXXGXXXXXXXXXXXXXXXXXXXGXXXXXXXXXXXXXXXXXXXGXXXXXXXXXXXXXXXXXXXGXXXXXXXXXXXXXXXXXXXGXXXXXXXXXXXXXXXXXXXGXXXXXXXXXXXXXXXXXXXGXXXXXXXXXXXXXXXXXXXGXXXXXXXXXXXXXXXXXXXGXXXXXXXXXXXXXXXXXXXGXXXXXXXXXXXXXXXXXXX,0,10,0
13167,13,0,13,136,451,0,0,466,212,254,GXXXXXXXXXXXXXXXXXXXGXXXXXXXXXXXXXXXXXXXGXXXXXXXXXXXXXXXXXXXGXXXXXXXXXXXXXXXXXXXGXXXXXXXXXXXXXXXXXXXGXXXXXXXXXXXXXXXXXXXGXXXXXXXXXXXXXXXXXXXGXXXXXXXXXXXXXXXXXXXGXXXXXXXXXXXXXXXXXXXGXXXXXXXXXXXXXXXXXXXGXXXXXXXXXXXXXXXXXXXGXXXXXXXXXXXXXXXXXXXGXXXXXXXXXXXXXXXXXXX,0,10,0
13188,13,0,13,143,444,0,0,459,213,246,GXXXXXXXXXXXXXXXXXXXGXXXXXXXXXXXXXXXXXXXGXXXXXXXXXXXXXXXXXXXGXXXXXXXXXXXXXXXXXXXGXXXXXXXXXXXXXXXXXXXGXXXXXXXXXXXXXXXXXXXGXXXXXXXXXXXXXXXXXXXGXXXXXXXXXXXXXXXXXXXGXXXXXXXXXXXXXXXXXXXGXXXXXXXXXXXXXXXXXXXGXXXXXXXXXXXXXXXXXXXGXXXXXXXXXXXXXXXXXXXGXXXXXXXXXXXXXXXXXXX,0,10,0
13209,13,0,13,144,443,0,0,456,216,240,GXXXXXXXXXXXXXXXXXXXGXXXXXXXXXXXXXXXXXXXGXXXXXXXXXXXXXXXXXXXGXXXXXXXXXXXXXXXXXXXGXXXXXXXXXXXXXXXXXXXGXXXXXXXXXXXXXXXXXXXGXXXXXXXXXXXXXXXXXXXGXXXXXXXXXXXXXXXXXXXGXXXXXXXXXXXXXXXXXXXGXXXXXXXXXXXXXXXXXXXGXXXXXXXXXXXXXXXXXXXGXXXXXXXXXXXXXXXXXXXGXXXXXXXXXXXXXXXXXXX,0,10,0

13230,13,0,13,146,441,0,0,455,211,244,GXXXXXXXXXXXXXXXXXXXGXXXXXXXXXXXXXXXXXXXGXXXXXXXXXXXXXXXXXXXGXXXXXXXXXXXXXXXXXXXGXXXXXXXXXXXXXXXXXXXGXXXXXXXXXXXXXXXXXXXGXXXXXXXXXXXXXXXXXXXGXXXXXXXXXXXXXXXXXXXGXXXXXXXXXXXXXXXXXXXGXXXXXXXXXXXXXXXXXXXGXXXXXXXXXXXXXXXXXXXGXXXXXXXXXXXXXXXXXXXGXXXXXXXXXXXXXXXXXXX,0,10,0
13251,14,1,13,138,448,0,0,463,213,250,GXXXXXXXXXXXXXXXXXXXGXXXXXXXXXXXXXXXXXXXGXXXXXXXXXXXXXXXXXXXGXXXXXXXXXXXXXXXXXXXGAXXXXXXXXXXXXXXXXXXGXXXXXXXXXXXXXXXXXXXGXXXXXXXXXXXXXXXXXXXGXXXXXXXXXXXXXXXXXXXGXXXXXXXXXXXXXXXXXXXGXXXXXXXXXXXXXXXXXXXGXXXXXXXXXXXXXXXXXXXGXXXXXXXXXXXXXXXXXXXGXXXXXXXXXXXXXXXXXXX,0,10,0
13272,14,1,13,141,445,0,0,460,209,251,GXXXXXXXXXXXXXXXXXXXGXXXXXXXXXXXXXXXXXXXGXXXXXXXXXXXXXXXXXXXGXXXXXXXXXXXXXXXXXXXGAXXXXXXXXXXXXXXXXXXGXXXXXXXXXXXXXXXXXXXGXXXXXXXXXXXXXXXXXXXGXXXXXXXXXXXXXXXXXXXGXXXXXXXXXXXXXXXXXXXGXXXXXXXXXXXXXXXXXXXGXXXXXXXXXXXXXXXXXXXGXXXXXXXXXXXXXXXXXXXGXXXXXXXXXXXXXXXXXXX,0,10,0
13293,14,1,13,148,438,0,0,454,208,246,GXXXXXXXXXXXXXXXXXXXGXXXXXXXXXXXXXXXXXXXGXXXXXXXXXXXXXXXXXXXGXXXXXXXXXXXXXXXXXXXGAXXXXXXXXXXXXXXXXXXGXXXXXXXXXXXXXXXXXXXGXXXXXXXXXXXXXXXXXXXGXXXXXXXXXXXXXXXXXXXGXXXXXXXXXXXXXXXXXXXGXXXXXXXXXXXXXXXXXXXGXXXXXXXXXXXXXXXXXXXGXXXXXXXXXXXXXXXXXXXGXXXXXXXXXXXXXXXXXXX,0,10,0
13314,14,1,13,147,439,0,0,455,208,247,GXXXXXXXXXXXXXXXXXXXGXXXXXXXXXXXXXXXXXXXGXXXXXXXXXXXXXXXXXXXGXXXXXXXXXXXXXXXXXXXGAXXXXXXXXXXXXXXXXXXGXXXXXXXXXXXXXXXXXXXGXXXXXXXXXXXXXXXXXXXGXXXXXXXXXXXXXXXXXXXGXXXXXXXXXXXXXXXXXXXGXXXXXXXXXXXXXXXXXXXGXXXXXXXXXXXXXXXXXXXGXXXXXXXXXXXXXXXXXXXGXXXXXXXXXXXXXXXXXXX,0,10,0

13335,14,1,13,136,450,0,0,466,214,252,GXXXXXXXXXXXXXXXXXXXGXXXXXXXXXXXXXXXXXXXGXXXXXXXXXXXXXXXXXXXGXXXXXXXXXXXXXXXXXXXGAXXXXXXXXXXXXXXXXXXGXXXXXXXXXXXXXXXXXXXGXXXXXXXXXXXXXXXXXXXGXXXXXXXXXXXXXXXXXXXGXXXXXXXXXXXXXXXXXXXGXXXXXXXXXXXXXXXXXXXGXXXXXXXXXXXXXXXXXXXGXXXXXXXXXXXXXXXXXXXGXXXXXXXXXXXXXXXXXXX,0,10,0
13356,15,2,13,141,444,0,0,460,211,249,GXXXXXXXXXXXXXXXXXXXGXXXXXXXXXXXXXXXXXXXGXXXXXXXXXXXXXXXXXXXGXXXXXXXXXXXXXXXXXXXGAXXXXXXXXXXXXXXXXXXGXXXXXXXXXXXXXXXXXXXGXXXXXXXXXXXXXXXXXXXGAXXXXXXXXXXXXXXXXXXGXXXXXXXXXXXXXXXXXXXGXXXXXXXXXXXXXXXXXXXGXXXXXXXXXXXXXXXXXXXGXXXXXXXXXXXXXXXXXXXGXXXXXXXXXXXXXXXXXXX,0,10,0
13377,16,2,14,135,449,0,0,464,212,252,GXXXXXXXXXXXXXXXXXXXGXXXXXXXXXXXXXXXXXXXGXXXXXXXXXXXXXXXXXXXGXXXXXXXXXXXXXXXXXXXGAXXXXXXXXXXXXXXXXXXGXXXXXXXXXXXXXXXXXXXGXXXXXXXXXXXXXXXXXXXGAXXXXXXXXXXXXXXXXXXGXXXXXXXXXXXXXXXXXXXGXXXXXXXXXXXXXXXXXXXGOXXXXXXXXXXXXXXXXXXGXXXXXXXXXXXXXXXXXXXGXXXXXXXXXXXXXXXXXXX,0,10,0
13398,16,2,14,140,444,0,0,460,214,246,GXXXXXXXXXXXXXXXXXXXGXXXXXXXXXXXXXXXXXXXGXXXXXXXXXXXXXXXXXXXGXXXXXXXXXXXXXXXXXXXGAXXXXXXXXXXXXXXXXXXGXXXXXXXXXXXXXXXXXXXGXXXXXXXXXXXXXXXXXXXGAXXXXXXXXXXXXXXXXXXGXXXXXXXXXXXXXXXXXXXGXXXXXXXXXXXXXXXXXXXGOXXXXXXXXXXXXXXXXXXGXXXXXXXXXXXXXXXXXXXGXXXXXXXXXXXXXXXXXXX,0,10,0
13419,15,2,13,142,443,0,0,459,221,238,GXXXXXXXXXXXXXXXXXXXGXXXXXXXXXXXXXXXXXXXGXXXXXXXXXXXXXXXXXXXGXXXXXXXXXXXXXXXXXXXGAXXXXXXXXXXXXXXXXXXGXXXXXXXXXXXXXXXXXXXGXXXXXXXXXXXXXXXXXXXGAXXXXXXXXXXXXXXXXXXGXXXXXXXXXXXXXXXXXXXGXXXXXXXXXXXXXXXXXXXGXXXXXXXXXXXXXXXXXXXGXXXXXXXXXXXXXXXXXXXGXXXXXXXXXXXXXXXXXXX,0,10,0

13440,15,2,13,139,446,0,0,461,224,237,GXXXXXXXXXXXXXXXXXXXGXXXXXXXXXXXXXXXXXXXGXXXXXXXXXXXXXXXXXXXGXXXXXXXXXXXXXXXXXXXGAXXXXXXXXXXXXXXXXXXGXXXXXXXXXXXXXXXXXXXGXXXXXXXXXXXXXXXXXXXGAXXXXXXXXXXXXXXXXXXGXXXXXXXXXXXXXXXXXXXGXXXXXXXXXXXXXXXXXXXGXXXXXXXXXXXXXXXXXXXGXXXXXXXXXXXXXXXXXXXGXXXXXXXXXXXXXXXXXXX,0,10,0
13461,15,1,14,142,443,0,0,458,219,239,GXXXXXXXXXXXXXXXXXXXGXXXXXXXXXXXXXXXXXXXGXXXXXXXXXXXXXXXXXXXGXXXXXXXXXXXXXXXXXXXGAXXXXXXXXXXXXXXXXXXGXXXXXXXXXXXXXXXXXXXGXXXXXXXXXXXXXXXXXXXGOXXXXXXXXXXXXXXXXXXGXXXXXXXXXXXXXXXXXXXGXXXXXXXXXXXXXXXXXXXGXXXXXXXXXXXXXXXXXXXGXXXXXXXXXXXXXXXXXXXGXXXXXXXXXXXXXXXXXXX,0,10,0
13482,15,1,14,142,443,0,0,459,218,241,GXXXXXXXXXXXXXXXXXXXGXXXXXXXXXXXXXXXXXXXGXXXXXXXXXXXXXXXXXXXGXXXXXXXXXXXXXXXXXXXGAXXXXXXXXXXXXXXXXXXGXXXXXXXXXXXXXXXXXXXGXXXXXXXXXXXXXXXXXXXGOXXXXXXXXXXXXXXXXXXGXXXXXXXXXXXXXXXXXXXGXXXXXXXXXXXXXXXXXXXGXXXXXXXXXXXXXXXXXXXGXXXXXXXXXXXXXXXXXXXGXXXXXXXXXXXXXXXXXXX,0,10,0
13503,14,1,13,146,440,0,0,455,213,242,GXXXXXXXXXXXXXXXXXXXGXXXXXXXXXXXXXXXXXXXGXXXXXXXXXXXXXXXXXXXGXXXXXXXXXXXXXXXXXXXGAXXXXXXXXXXXXXXXXXXGXXXXXXXXXXXXXXXXXXXGXXXXXXXXXXXXXXXXXXXGXXXXXXXXXXXXXXXXXXXGXXXXXXXXXXXXXXXXXXXGXXXXXXXXXXXXXXXXXXXGXXXXXXXXXXXXXXXXXXXGXXXXXXXXXXXXXXXXXXXGXXXXXXXXXXXXXXXXXXX,0,10,0
13524,14,1,13,137,449,0,0,466,210,256,GXXXXXXXXXXXXXXXXXXXGXXXXXXXXXXXXXXXXXXXGXXXXXXXXXXXXXXXXXXXGXXXXXXXXXXXXXXXXXXXGAXXXXXXXXXXXXXXXXXXGXXXXXXXXXXXXXXXXXXXGXXXXXXXXXXXXXXXXXXXGXXXXXXXXXXXXXXXXXXXGXXXXXXXXXXXXXXXXXXXGXXXXXXXXXXXXXXXXXXXGXXXXXXXXXXXXXXXXXXXGXXXXXXXXXXXXXXXXXXXGXXXXXXXXXXXXXXXXXXX,0,10,0

13545,14,1,13,138,448,0,0,463,214,249,GXXXXXXXXXXXXXXXXXXXGXXXXXXXXXXXXXXXXXXXGXXXXXXXXXXXXXXXXXXXGXXXXXXXXXXXXXXXXXXXGAXXXXXXXXXXXXXXXXXXGXXXXXXXXXXXXXXXXXXXGXXXXXXXXXXXXXXXXXXXGXXXXXXXXXXXXXXXXXXXGXXXXXXXXXXXXXXXXXXXGXXXXXXXXXXXXXXXXXXXGXXXXXXXXXXXXXXXXXXXGXXXXXXXXXXXXXXXXXXXGXXXXXXXXXXXXXXXXXXX,0,10,0
13566,14,1,13,140,446,0,0,462,216,246,GXXXXXXXXXXXXXXXXXXXGXXXXXXXXXXXXXXXXXXXGXXXXXXXXXXXXXXXXXXXGXXXXXXXXXXXXXXXXXXXGAXXXXXXXXXXXXXXXXXXGXXXXXXXXXXXXXXXXXXXGXXXXXXXXXXXXXXXXXXXGXXXXXXXXXXXXXXXXXXXGXXXXXXXXXXXXXXXXXXXGXXXXXXXXXXXXXXXXXXXGXXXXXXXXXXXXXXXXXXXGXXXXXXXXXXXXXXXXXXXGXXXXXXXXXXXXXXXXXXX,0,10,0
13587,14,1,13,137,449,0,0,465,221,244,GXXXXXXXXXXXXXXXXXXXGXXXXXXXXXXXXXXXXXXXGXXXXXXXXXXXXXXXXXXXGXXXXXXXXXXXXXXXXXXXGAXXXXXXXXXXXXXXXXXXGXXXXXXXXXXXXXXXXXXXGXXXXXXXXXXXXXXXXXXXGXXXXXXXXXXXXXXXXXXXGXXXXXXXXXXXXXXXXXXXGXXXXXXXXXXXXXXXXXXXGXXXXXXXXXXXXXXXXXXXGXXXXXXXXXXXXXXXXXXXGXXXXXXXXXXXXXXXXXXX,0,10,0
13608,15,2,13,138,447,0,0,463,222,241,GXXXXXXXXXXXXXXXXXXXGXXXXXXXXXXXXXXXXXXXGXXXXXXXXXXXXXXXXXXXGXXXXXXXXXXXXXXXXXXXGAXXXXXXXXXXXXXXXXXXGXXXXXXXXXXXXXXXXXXXGXXXXXXXXXXXXXXXXXXXGXXXXXXXXXXXXXXXXXXXGXXXXXXXXXXXXXXXXXXXGAXXXXXXXXXXXXXXXXXXGXXXXXXXXXXXXXXXXXXXGXXXXXXXXXXXXXXXXXXXGXXXXXXXXXXXXXXXXXXX,0,10,0
13629,17,3,14,137,446,0,0,463,217,246,GXXXXXXXXXXXXXXXXXXXGXXXXXXXXXXXXXXXXXXXGXXXXXXXXXXXXXXXXXXXGAXXXXXXXXXXXXXXXXXXGOXXXXXXXXXXXXXXXXXXGXXXXXXXXXXXXXXXXXXXGXXXXXXXXXXXXXXXXXXXGXXXXXXXXXXXXXXXXXXXGXXXXXXXXXXXXXXXXXXXGAXXXXXXXXXXXXXXXXXXGXXXXXXXXXXXXXXXXXXXGAXXXXXXXXXXXXXXXXXXGXXXXXXXXXXXXXXXXXXX,0,10,0

13650,17,3,14,133,450,0,0,468,217,251,GXXXXXXXXXXXXXXXXXXXGXXXXXXXXXXXXXXXXXXXGXXXXXXXXXXXXXXXXXXXGAXXXXXXXXXXXXXXXXXXGOXXXXXXXXXXXXXXXXXXGXXXXXXXXXXXXXXXXXXXGXXXXXXXXXXXXXXXXXXXGXXXXXXXXXXXXXXXXXXXGXXXXXXXXXXXXXXXXXXXGAXXXXXXXXXXXXXXXXXXGXXXXXXXXXXXXXXXXXXXGAXXXXXXXXXXXXXXXXXXGXXXXXXXXXXXXXXXXXXX,0,10,0
13671,16,3,13,127,457,0,0,473,223,250,GXXXXXXXXXXXXXXXXXXXGXXXXXXXXXXXXXXXXXXXGXXXXXXXXXXXXXXXXXXXGAXXXXXXXXXXXXXXXXXXGXXXXXXXXXXXXXXXXXXXGXXXXXXXXXXXXXXXXXXXGXXXXXXXXXXXXXXXXXXXGXXXXXXXXXXXXXXXXXXXGXXXXXXXXXXXXXXXXXXXGAXXXXXXXXXXXXXXXXXXGXXXXXXXXXXXXXXXXXXXGAXXXXXXXXXXXXXXXXXXGXXXXXXXXXXXXXXXXXXX,0,10,0
13692,17,4,13,131,452,0,0,469,218,251,GXXXXXXXXXXXXXXXXXXXGXXXXXXXXXXXXXXXXXXXGXXXXXXXXXXXXXXXXXXXGAXXXXXXXXXXXXXXXXXXGAXXXXXXXXXXXXXXXXXXGXXXXXXXXXXXXXXXXXXXGXXXXXXXXXXXXXXXXXXXGXXXXXXXXXXXXXXXXXXXGXXXXXXXXXXXXXXXXXXXGAXXXXXXXXXXXXXXXXXXGXXXXXXXXXXXXXXXXXXXGAXXXXXXXXXXXXXXXXXXGXXXXXXXXXXXXXXXXXXX,0,10,0
13713,17,4,13,128,455,0,0,473,220,253,GXXXXXXXXXXXXXXXXXXXGXXXXXXXXXXXXXXXXXXXGXXXXXXXXXXXXXXXXXXXGAXXXXXXXXXXXXXXXXXXGAXXXXXXXXXXXXXXXXXXGXXXXXXXXXXXXXXXXXXXGXXXXXXXXXXXXXXXXXXXGXXXXXXXXXXXXXXXXXXXGXXXXXXXXXXXXXXXXXXXGAXXXXXXXXXXXXXXXXXXGXXXXXXXXXXXXXXXXXXXGAXXXXXXXXXXXXXXXXXXGXXXXXXXXXXXXXXXXXXX,0,10,0
13734,17,3,14,133,450,0,0,467,220,247,GXXXXXXXXXXXXXXXXXXXGXXXXXXXXXXXXXXXXXXXGXXXXXXXXXXXXXXXXXXXGAXXXXXXXXXXXXXXXXXXGAXXXXXXXXXXXXXXXXXXGXXXXXXXXXXXXXXXXXXXGXXXXXXXXXXXXXXXXXXXGXXXXXXXXXXXXXXXXXXXGXXXXXXXXXXXXXXXXXXXGAXXXXXXXXXXXXXXXXXXGXXXXXXXXXXXXXXXXXXXGOXXXXXXXXXXXXXXXXXXGXXXXXXXXXXXXXXXXXXX,0,10,0

13755,15,2,13,125,460,0,0,476,217,259,GXXXXXXXXXXXXXXXXXXXGXXXXXXXXXXXXXXXXXXXGXXXXXXXXXXXXXXXXXXXGAXXXXXXXXXXXXXXXXXXGXXXXXXXXXXXXXXXXXXXGXXXXXXXXXXXXXXXXXXXGXXXXXXXXXXXXXXXXXXXGXXXXXXXXXXXXXXXXXXXGXXXXXXXXXXXXXXXXXXXGAXXXXXXXXXXXXXXXXXXGXXXXXXXXXXXXXXXXXXXGXXXXXXXXXXXXXXXXXXXGXXXXXXXXXXXXXXXXXXX,0,10,0
13776,15,2,13,126,459,0,0,475,213,262,GXXXXXXXXXXXXXXXXXXXGXXXXXXXXXXXXXXXXXXXGXXXXXXXXXXXXXXXXXXXGAXXXXXXXXXXXXXXXXXXGXXXXXXXXXXXXXXXXXXXGXXXXXXXXXXXXXXXXXXXGXXXXXXXXXXXXXXXXXXXGXXXXXXXXXXXXXXXXXXXGXXXXXXXXXXXXXXXXXXXGAXXXXXXXXXXXXXXXXXXGXXXXXXXXXXXXXXXXXXXGXXXXXXXXXXXXXXXXXXXGXXXXXXXXXXXXXXXXXXX,0,10,0
13797,15,0,15,121,464,0,0,478,218,260,GXXXXXXXXXXXXXXXXXXXGXXXXXXXXXXXXXXXXXXXGXXXXXXXXXXXXXXXXXXXGOXXXXXXXXXXXXXXXXXXGXXXXXXXXXXXXXXXXXXXGXXXXXXXXXXXXXXXXXXXGXXXXXXXXXXXXXXXXXXXGXXXXXXXXXXXXXXXXXXXGXXXXXXXXXXXXXXXXXXXGOXXXXXXXXXXXXXXXXXXGXXXXXXXXXXXXXXXXXXXGXXXXXXXXXXXXXXXXXXXGXXXXXXXXXXXXXXXXXXX,0,10,0
13818,13,0,13,126,461,0,0,475,220,255,GXXXXXXXXXXXXXXXXXXXGXXXXXXXXXXXXXXXXXXXGXXXXXXXXXXXXXXXXXXXGXXXXXXXXXXXXXXXXXXXGXXXXXXXXXXXXXXXXXXXGXXXXXXXXXXXXXXXXXXXGXXXXXXXXXXXXXXXXXXXGXXXXXXXXXXXXXXXXXXXGXXXXXXXXXXXXXXXXXXXGXXXXXXXXXXXXXXXXXXXGXXXXXXXXXXXXXXXXXXXGXXXXXXXXXXXXXXXXXXXGXXXXXXXXXXXXXXXXXXX,0,10,0
13839,13,0,13,126,461,0,0,474,218,256,GXXXXXXXXXXXXXXXXXXXGXXXXXXXXXXXXXXXXXXXGXXXXXXXXXXXXXXXXXXXGXXXXXXXXXXXXXXXXXXXGXXXXXXXXXXXXXXXXXXXGXXXXXXXXXXXXXXXXXXXGXXXXXXXXXXXXXXXXXXXGXXXXXXXXXXXXXXXXXXXGXXXXXXXXXXXXXXXXXXXGXXXXXXXXXXXXXXXXXXXGXXXXXXXXXXXXXXXXXXXGXXXXXXXXXXXXXXXXXXXGXXXXXXXXXXXXXXXXXXX,0,10,0

13860,13,0,13,124,463,0,0,478,223,255,GXXXXXXXXXXXXXXXXXXXGXXXXXXXXXXXXXXXXXXXGXXXXXXXXXXXXXXXXXXXGXXXXXXXXXXXXXXXXXXXGXXXXXXXXXXXXXXXXXXXGXXXXXXXXXXXXXXXXXXXGXXXXXXXXXXXXXXXXXXXGXXXXXXXXXXXXXXXXXXXGXXXXXXXXXXXXXXXXXXXGXXXXXXXXXXXXXXXXXXXGXXXXXXXXXXXXXXXXXXXGXXXXXXXXXXXXXXXXXXXGXXXXXXXXXXXXXXXXXXX,0,10,0
13881,13,0,13,128,459,0,0,473,229,244,GXXXXXXXXXXXXXXXXXXXGXXXXXXXXXXXXXXXXXXXGXXXXXXXXXXXXXXXXXXXGXXXXXXXXXXXXXXXXXXXGXXXXXXXXXXXXXXXXXXXGXXXXXXXXXXXXXXXXXXXGXXXXXXXXXXXXXXXXXXXGXXXXXXXXXXXXXXXXXXXGXXXXXXXXXXXXXXXXXXXGXXXXXXXXXXXXXXXXXXXGXXXXXXXXXXXXXXXXXXXGXXXXXXXXXXXXXXXXXXXGXXXXXXXXXXXXXXXXXXX,0,10,0
13902,13,0,13,136,451,0,0,466,223,243,GXXXXXXXXXXXXXXXXXXXGXXXXXXXXXXXXXXXXXXXGXXXXXXXXXXXXXXXXXXXGXXXXXXXXXXXXXXXXXXXGXXXXXXXXXXXXXXXXXXXGXXXXXXXXXXXXXXXXXXXGXXXXXXXXXXXXXXXXXXXGXXXXXXXXXXXXXXXXXXXGXXXXXXXXXXXXXXXXXXXGXXXXXXXXXXXXXXXXXXXGXXXXXXXXXXXXXXXXXXXGXXXXXXXXXXXXXXXXXXXGXXXXXXXXXXXXXXXXXXX,0,10,0
13923,13,0,13,142,445,0,0,456,226,230,GXXXXXXXXXXXXXXXXXXXGXXXXXXXXXXXXXXXXXXXGXXXXXXXXXXXXXXXXXXXGXXXXXXXXXXXXXXXXXXXGXXXXXXXXXXXXXXXXXXXGXXXXXXXXXXXXXXXXXXXGXXXXXXXXXXXXXXXXXXXGXXXXXXXXXXXXXXXXXXXGXXXXXXXXXXXXXXXXXXXGXXXXXXXXXXXXXXXXXXXGXXXXXXXXXXXXXXXXXXXGXXXXXXXXXXXXXXXXXXXGXXXXXXXXXXXXXXXXXXX,0,10,0
13944,13,0,13,145,442,0,0,455,225,230,GXXXXXXXXXXXXXXXXXXXGXXXXXXXXXXXXXXXXXXXGXXXXXXXXXXXXXXXXXXXGXXXXXXXXXXXXXXXXXXXGXXXXXXXXXXXXXXXXXXXGXXXXXXXXXXXXXXXXXXXGXXXXXXXXXXXXXXXXXXXGXXXXXXXXXXXXXXXXXXXGXXXXXXXXXXXXXXXXXXXGXXXXXXXXXXXXXXXXXXXGXXXXXXXXXXXXXXXXXXXGXXXXXXXXXXXXXXXXXXXGXXXXXXXXXXXXXXXXXXX,0,10,0

13965,13,0,13,152,435,0,0,446,219,227,GXXXXXXXXXXXXXXXXXXXGXXXXXXXXXXXXXXXXXXXGXXXXXXXXXXXXXXXXXXXGXXXXXXXXXXXXXXXXXXXGXXXXXXXXXXXXXXXXXXXGXXXXXXXXXXXXXXXXXXXGXXXXXXXXXXXXXXXXXXXGXXXXXXXXXXXXXXXXXXXGXXXXXXXXXXXXXXXXXXXGXXXXXXXXXXXXXXXXXXXGXXXXXXXXXXXXXXXXXXXGXXXXXXXXXXXXXXXXXXXGXXXXXXXXXXXXXXXXXXX,0,10,0
13986,13,0,13,148,439,0,0,453,224,229,GXXXXXXXXXXXXXXXXXXXGXXXXXXXXXXXXXXXXXXXGXXXXXXXXXXXXXXXXXXXGXXXXXXXXXXXXXXXXXXXGXXXXXXXXXXXXXXXXXXXGXXXXXXXXXXXXXXXXXXXGXXXXXXXXXXXXXXXXXXXGXXXXXXXXXXXXXXXXXXXGXXXXXXXXXXXXXXXXXXXGXXXXXXXXXXXXXXXXXXXGXXXXXXXXXXXXXXXXXXXGXXXXXXXXXXXXXXXXXXXGXXXXXXXXXXXXXXXXXXX,0,10,0
14007,13,0,13,142,445,0,0,458,224,234,GXXXXXXXXXXXXXXXXXXXGXXXXXXXXXXXXXXXXXXXGXXXXXXXXXXXXXXXXXXXGXXXXXXXXXXXXXXXXXXXGXXXXXXXXXXXXXXXXXXXGXXXXXXXXXXXXXXXXXXXGXXXXXXXXXXXXXXXXXXXGXXXXXXXXXXXXXXXXXXXGXXXXXXXXXXXXXXXXXXXGXXXXXXXXXXXXXXXXXXXGXXXXXXXXXXXXXXXXXXXGXXXXXXXXXXXXXXXXXXXGXXXXXXXXXXXXXXXXXXX,0,10,0
14028,13,0,13,155,432,0,0,446,218,228,GXXXXXXXXXXXXXXXXXXXGXXXXXXXXXXXXXXXXXXXGXXXXXXXXXXXXXXXXXXXGXXXXXXXXXXXXXXXXXXXGXXXXXXXXXXXXXXXXXXXGXXXXXXXXXXXXXXXXXXXGXXXXXXXXXXXXXXXXXXXGXXXXXXXXXXXXXXXXXXXGXXXXXXXXXXXXXXXXXXXGXXXXXXXXXXXXXXXXXXXGXXXXXXXXXXXXXXXXXXXGXXXXXXXXXXXXXXXXXXXGXXXXXXXXXXXXXXXXXXX,0,10,0
14049,13,0,13,154,433,0,0,447,222,225,GXXXXXXXXXXXXXXXXXXXGXXXXXXXXXXXXXXXXXXXGXXXXXXXXXXXXXXXXXXXGXXXXXXXXXXXXXXXXXXXGXXXXXXXXXXXXXXXXXXXGXXXXXXXXXXXXXXXXXXXGXXXXXXXXXXXXXXXXXXXGXXXXXXXXXXXXXXXXXXXGXXXXXXXXXXXXXXXXXXXGXXXXXXXXXXXXXXXXXXXGXXXXXXXXXXXXXXXXXXXGXXXXXXXXXXXXXXXXXXXGXXXXXXXXXXXXXXXXXXX,0,10,0

14070,13,0,13,152,435,0,0,448,223,225,GXXXXXXXXXXXXXXXXXXXGXXXXXXXXXXXXXXXXXXXGXXXXXXXXXXXXXXXXXXXGXXXXXXXXXXXXXXXXXXXGXXXXXXXXXXXXXXXXXXXGXXXXXXXXXXXXXXXXXXXGXXXXXXXXXXXXXXXXXXXGXXXXXXXXXXXXXXXXXXXGXXXXXXXXXXXXXXXXXXXGXXXXXXXXXXXXXXXXXXXGXXXXXXXXXXXXXXXXXXXGXXXXXXXXXXXXXXXXXXXGXXXXXXXXXXXXXXXXXXX,0,10,0
14091,13,0,13,157,430,0,0,443,224,219,GXXXXXXXXXXXXXXXXXXXGXXXXXXXXXXXXXXXXXXXGXXXXXXXXXXXXXXXXXXXGXXXXXXXXXXXXXXXXXXXGXXXXXXXXXXXXXXXXXXXGXXXXXXXXXXXXXXXXXXXGXXXXXXXXXXXXXXXXXXXGXXXXXXXXXXXXXXXXXXXGXXXXXXXXXXXXXXXXXXXGXXXXXXXXXXXXXXXXXXXGXXXXXXXXXXXXXXXXXXXGXXXXXXXXXXXXXXXXXXXGXXXXXXXXXXXXXXXXXXX,0,10,0
14112,13,0,13,145,442,0,0,455,224,231,GXXXXXXXXXXXXXXXXXXXGXXXXXXXXXXXXXXXXXXXGXXXXXXXXXXXXXXXXXXXGXXXXXXXXXXXXXXXXXXXGXXXXXXXXXXXXXXXXXXXGXXXXXXXXXXXXXXXXXXXGXXXXXXXXXXXXXXXXXXXGXXXXXXXXXXXXXXXXXXXGXXXXXXXXXXXXXXXXXXXGXXXXXXXXXXXXXXXXXXXGXXXXXXXXXXXXXXXXXXXGXXXXXXXXXXXXXXXXXXXGXXXXXXXXXXXXXXXXXXX,0,10,0
14133,13,0,13,146,441,0,0,453,219,234,GXXXXXXXXXXXXXXXXXXXGXXXXXXXXXXXXXXXXXXXGXXXXXXXXXXXXXXXXXXXGXXXXXXXXXXXXXXXXXXXGXXXXXXXXXXXXXXXXXXXGXXXXXXXXXXXXXXXXXXXGXXXXXXXXXXXXXXXXXXXGXXXXXXXXXXXXXXXXXXXGXXXXXXXXXXXXXXXXXXXGXXXXXXXXXXXXXXXXXXXGXXXXXXXXXXXXXXXXXXXGXXXXXXXXXXXXXXXXXXXGXXXXXXXXXXXXXXXXXXX,0,10,0
14154,13,0,13,144,443,0,0,455,217,238,GXXXXXXXXXXXXXXXXXXXGXXXXXXXXXXXXXXXXXXXGXXXXXXXXXXXXXXXXXXXGXXXXXXXXXXXXXXXXXXXGXXXXXXXXXXXXXXXXXXXGXXXXXXXXXXXXXXXXXXXGXXXXXXXXXXXXXXXXXXXGXXXXXXXXXXXXXXXXXXXGXXXXXXXXXXXXXXXXXXXGXXXXXXXXXXXXXXXXXXXGXXXXXXXXXXXXXXXXXXXGXXXXXXXXXXXXXXXXXXXGXXXXXXXXXXXXXXXXXXX,0,10,0

14175,14,1,13,138,448,0,0,462,220,242,GXXXXXXXXXXXXXXXXXXXGXXXXXXXXXXXXXXXXXXXGXXXXXXXXXXXXXXXXXXXGXXXXXXXXXXXXXXXXXXXGXXXXXXXXXXXXXXXXXXXGXXXXXXXXXXXXXXXXXXXGXXXXXXXXXXXXXXXXXXXGXXXXXXXXXXXXXXXXXXXGXXXXXXXXXXXXXXXXXXXGXXXXXXXXXXXXXXXXXXXGXXXXXXXXXXXXXXXXXXXGXXXXXXXXXXXXXXXXXXXGAXXXXXXXXXXXXXXXXXX,0,10,0
14196,14,0,14,139,447,0,0,461,221,240,GXXXXXXXXXXXXXXXXXXXGXXXXXXXXXXXXXXXXXXXGXXXXXXXXXXXXXXXXXXXGXXXXXXXXXXXXXXXXXXXGXXXXXXXXXXXXXXXXXXXGXXXXXXXXXXXXXXXXXXXGXXXXXXXXXXXXXXXXXXXGXXXXXXXXXXXXXXXXXXXGXXXXXXXXXXXXXXXXXXXGXXXXXXXXXXXXXXXXXXXGXXXXXXXXXXXXXXXXXXXGXXXXXXXXXXXXXXXXXXXGOXXXXXXXXXXXXXXXXXX,0,10,0
14217,13,0,13,135,452,0,0,467,223,244,GXXXXXXXXXXXXXXXXXXXGXXXXXXXXXXXXXXXXXXXGXXXXXXXXXXXXXXXXXXXGXXXXXXXXXXXXXXXXXXXGXXXXXXXXXXXXXXXXXXXGXXXXXXXXXXXXXXXXXXXGXXXXXXXXXXXXXXXXXXXGXXXXXXXXXXXXXXXXXXXGXXXXXXXXXXXXXXXXXXXGXXXXXXXXXXXXXXXXXXXGXXXXXXXXXXXXXXXXXXXGXXXXXXXXXXXXXXXXXXXGXXXXXXXXXXXXXXXXXXX,0,10,0
14238,13,0,13,138,449,0,0,462,221,241,GXXXXXXXXXXXXXXXXXXXGXXXXXXXXXXXXXXXXXXXGXXXXXXXXXXXXXXXXXXXGXXXXXXXXXXXXXXXXXXXGXXXXXXXXXXXXXXXXXXXGXXXXXXXXXXXXXXXXXXXGXXXXXXXXXXXXXXXXXXXGXXXXXXXXXXXXXXXXXXXGXXXXXXXXXXXXXXXXXXXGXXXXXXXXXXXXXXXXXXXGXXXXXXXXXXXXXXXXXXXGXXXXXXXXXXXXXXXXXXXGXXXXXXXXXXXXXXXXXXX,0,10,0
14259,13,0,13,141,446,0,0,459,222,237,GXXXXXXXXXXXXXXXXXXXGXXXXXXXXXXXXXXXXXXXGXXXXXXXXXXXXXXXXXXXGXXXXXXXXXXXXXXXXXXXGXXXXXXXXXXXXXXXXXXXGXXXXXXXXXXXXXXXXXXXGXXXXXXXXXXXXXXXXXXXGXXXXXXXXXXXXXXXXXXXGXXXXXXXXXXXXXXXXXXXGXXXXXXXXXXXXXXXXXXXGXXXXXXXXXXXXXXXXXXXGXXXXXXXXXXXXXXXXXXXGXXXXXXXXXXXXXXXXXXX,0,10,0

14280,13,0,13,141,446,0,0,460,224,236,GXXXXXXXXXXXXXXXXXXXGXXXXXXXXXXXXXXXXXXXGXXXXXXXXXXXXXXXXXXXGXXXXXXXXXXXXXXXXXXXGXXXXXXXXXXXXXXXXXXXGXXXXXXXXXXXXXXXXXXXGXXXXXXXXXXXXXXXXXXXGXXXXXXXXXXXXXXXXXXXGXXXXXXXXXXXXXXXXXXXGXXXXXXXXXXXXXXXXXXXGXXXXXXXXXXXXXXXXXXXGXXXXXXXXXXXXXXXXXXXGXXXXXXXXXXXXXXXXXXX,0,10,0
14301,13,0,13,144,443,0,0,456,219,237,GXXXXXXXXXXXXXXXXXXXGXXXXXXXXXXXXXXXXXXXGXXXXXXXXXXXXXXXXXXXGXXXXXXXXXXXXXXXXXXXGXXXXXXXXXXXXXXXXXXXGXXXXXXXXXXXXXXXXXXXGXXXXXXXXXXXXXXXXXXXGXXXXXXXXXXXXXXXXXXXGXXXXXXXXXXXXXXXXXXXGXXXXXXXXXXXXXXXXXXXGXXXXXXXXXXXXXXXXXXXGXXXXXXXXXXXXXXXXXXXGXXXXXXXXXXXXXXXXXXX,0,10,0
14322,13,0,13,130,457,0,0,471,230,241,GXXXXXXXXXXXXXXXXXXXGXXXXXXXXXXXXXXXXXXXGXXXXXXXXXXXXXXXXXXXGXXXXXXXXXXXXXXXXXXXGXXXXXXXXXXXXXXXXXXXGXXXXXXXXXXXXXXXXXXXGXXXXXXXXXXXXXXXXXXXGXXXXXXXXXXXXXXXXXXXGXXXXXXXXXXXXXXXXXXXGXXXXXXXXXXXXXXXXXXXGXXXXXXXXXXXXXXXXXXXGXXXXXXXXXXXXXXXXXXXGXXXXXXXXXXXXXXXXXXX,0,10,0
14343,13,0,13,136,451,0,0,468,229,239,GXXXXXXXXXXXXXXXXXXXGXXXXXXXXXXXXXXXXXXXGXXXXXXXXXXXXXXXXXXXGXXXXXXXXXXXXXXXXXXXGXXXXXXXXXXXXXXXXXXXGXXXXXXXXXXXXXXXXXXXGXXXXXXXXXXXXXXXXXXXGXXXXXXXXXXXXXXXXXXXGXXXXXXXXXXXXXXXXXXXGXXXXXXXXXXXXXXXXXXXGXXXXXXXXXXXXXXXXXXXGXXXXXXXXXXXXXXXXXXXGXXXXXXXXXXXXXXXXXXX,0,10,0
14364,14,1,13,134,452,0,0,468,225,243,GXXXXXXXXXXXXXXXXXXXGXXXXXXXXXXXXXXXXXXXGXXXXXXXXXXXXXXXXXXXGXXXXXXXXXXXXXXXXXXXGXXXXXXXXXXXXXXXXXXXGXXXXXXXXXXXXXXXXXXXGXXXXXXXXXXXXXXXXXXXGXXXXXXXXXXXXXXXXXXXGAXXXXXXXXXXXXXXXXXXGXXXXXXXXXXXXXXXXXXXGXXXXXXXXXXXXXXXXXXXGXXXXXXXXXXXXXXXXXXXGXXXXXXXXXXXXXXXXXXX,0,10,0

14385,14,1,13,135,451,0,0,468,222,246,GXXXXXXXXXXXXXXXXXXXGXXXXXXXXXXXXXXXXXXXGXXXXXXXXXXXXXXXXXXXGXXXXXXXXXXXXXXXXXXXGXXXXXXXXXXXXXXXXXXXGXXXXXXXXXXXXXXXXXXXGXXXXXXXXXXXXXXXXXXXGXXXXXXXXXXXXXXXXXXXGAXXXXXXXXXXXXXXXXXXGXXXXXXXXXXXXXXXXXXXGXXXXXXXXXXXXXXXXXXXGXXXXXXXXXXXXXXXXXXXGXXXXXXXXXXXXXXXXXXX,0,10,0
14406,13,0,13,133,454,0,0,468,227,241,GXXXXXXXXXXXXXXXXXXXGXXXXXXXXXXXXXXXXXXXGXXXXXXXXXXXXXXXXXXXGXXXXXXXXXXXXXXXXXXXGXXXXXXXXXXXXXXXXXXXGXXXXXXXXXXXXXXXXXXXGXXXXXXXXXXXXXXXXXXXGXXXXXXXXXXXXXXXXXXXGXXXXXXXXXXXXXXXXXXXGXXXXXXXXXXXXXXXXXXXGXXXXXXXXXXXXXXXXXXXGXXXXXXXXXXXXXXXXXXXGXXXXXXXXXXXXXXXXXXX,0,10,0
14427,13,0,13,135,452,0,0,468,225,243,GXXXXXXXXXXXXXXXXXXXGXXXXXXXXXXXXXXXXXXXGXXXXXXXXXXXXXXXXXXXGXXXXXXXXXXXXXXXXXXXGXXXXXXXXXXXXXXXXXXXGXXXXXXXXXXXXXXXXXXXGXXXXXXXXXXXXXXXXXXXGXXXXXXXXXXXXXXXXXXXGXXXXXXXXXXXXXXXXXXXGXXXXXXXXXXXXXXXXXXXGXXXXXXXXXXXXXXXXXXXGXXXXXXXXXXXXXXXXXXXGXXXXXXXXXXXXXXXXXXX,0,10,0
14448,13,0,13,134,453,0,0,469,223,246,GXXXXXXXXXXXXXXXXXXXGXXXXXXXXXXXXXXXXXXXGXXXXXXXXXXXXXXXXXXXGXXXXXXXXXXXXXXXXXXXGXXXXXXXXXXXXXXXXXXXGXXXXXXXXXXXXXXXXXXXGXXXXXXXXXXXXXXXXXXXGXXXXXXXXXXXXXXXXXXXGXXXXXXXXXXXXXXXXXXXGXXXXXXXXXXXXXXXXXXXGXXXXXXXXXXXXXXXXXXXGXXXXXXXXXXXXXXXXXXXGXXXXXXXXXXXXXXXXXXX,0,10,0
14469,13,0,13,135,452,0,0,467,228,239,GXXXXXXXXXXXXXXXXXXXGXXXXXXXXXXXXXXXXXXXGXXXXXXXXXXXXXXXXXXXGXXXXXXXXXXXXXXXXXXXGXXXXXXXXXXXXXXXXXXXGXXXXXXXXXXXXXXXXXXXGXXXXXXXXXXXXXXXXXXXGXXXXXXXXXXXXXXXXXXXGXXXXXXXXXXXXXXXXXXXGXXXXXXXXXXXXXXXXXXXGXXXXXXXXXXXXXXXXXXXGXXXXXXXXXXXXXXXXXXXGXXXXXXXXXXXXXXXXXXX,0,10,0

14490,14,1,13,135,451,0,0,465,229,236,GXXXXXXXXXXXXXXXXXXXGXXXXXXXXXXXXXXXXXXXGXXXXXXXXXXXXXXXXXXXGXXXXXXXXXXXXXXXXXXXGAXXXXXXXXXXXXXXXXXXGXXXXXXXXXXXXXXXXXXXGXXXXXXXXXXXXXXXXXXXGXXXXXXXXXXXXXXXXXXXGXXXXXXXXXXXXXXXXXXXGXXXXXXXXXXXXXXXXXXXGXXXXXXXXXXXXXXXXXXXGXXXXXXXXXXXXXXXXXXXGXXXXXXXXXXXXXXXXXXX,0,10,0
14511,14,1,13,139,447,0,0,461,226,235,GXXXXXXXXXXXXXXXXXXXGXXXXXXXXXXXXXXXXXXXGXXXXXXXXXXXXXXXXXXXGXXXXXXXXXXXXXXXXXXXGAXXXXXXXXXXXXXXXXXXGXXXXXXXXXXXXXXXXXXXGXXXXXXXXXXXXXXXXXXXGXXXXXXXXXXXXXXXXXXXGXXXXXXXXXXXXXXXXXXXGXXXXXXXXXXXXXXXXXXXGXXXXXXXXXXXXXXXXXXXGXXXXXXXXXXXXXXXXXXXGXXXXXXXXXXXXXXXXXXX,0,10,0
14532,14,1,13,147,439,0,0,454,223,231,GXXXXXXXXXXXXXXXXXXXGXXXXXXXXXXXXXXXXXXXGXXXXXXXXXXXXXXXXXXXGXXXXXXXXXXXXXXXXXXXGAXXXXXXXXXXXXXXXXXXGXXXXXXXXXXXXXXXXXXXGXXXXXXXXXXXXXXXXXXXGXXXXXXXXXXXXXXXXXXXGXXXXXXXXXXXXXXXXXXXGXXXXXXXXXXXXXXXXXXXGXXXXXXXXXXXXXXXXXXXGXXXXXXXXXXXXXXXXXXXGXXXXXXXXXXXXXXXXXXX,0,10,0
14553,13,0,13,148,439,0,0,455,228,227,GXXXXXXXXXXXXXXXXXXXGXXXXXXXXXXXXXXXXXXXGXXXXXXXXXXXXXXXXXXXGXXXXXXXXXXXXXXXXXXXGXXXXXXXXXXXXXXXXXXXGXXXXXXXXXXXXXXXXXXXGXXXXXXXXXXXXXXXXXXXGXXXXXXXXXXXXXXXXXXXGXXXXXXXXXXXXXXXXXXXGXXXXXXXXXXXXXXXXXXXGXXXXXXXXXXXXXXXXXXXGXXXXXXXXXXXXXXXXXXXGXXXXXXXXXXXXXXXXXXX,0,10,0
14574,13,0,13,140,447,0,0,460,232,228,GXXXXXXXXXXXXXXXXXXXGXXXXXXXXXXXXXXXXXXXGXXXXXXXXXXXXXXXXXXXGXXXXXXXXXXXXXXXXXXXGXXXXXXXXXXXXXXXXXXXGXXXXXXXXXXXXXXXXXXXGXXXXXXXXXXXXXXXXXXXGXXXXXXXXXXXXXXXXXXXGXXXXXXXXXXXXXXXXXXXGXXXXXXXXXXXXXXXXXXXGXXXXXXXXXXXXXXXXXXXGXXXXXXXXXXXXXXXXXXXGXXXXXXXXXXXXXXXXXXX,0,10,0

14595,14,1,13,149,437,0,0,452,234,218,GXXXXXXXXXXXXXXXXXXXGAXXXXXXXXXXXXXXXXXXGXXXXXXXXXXXXXXXXXXXGXXXXXXXXXXXXXXXXXXXGXXXXXXXXXXXXXXXXXXXGXXXXXXXXXXXXXXXXXXXGXXXXXXXXXXXXXXXXXXXGXXXXXXXXXXXXXXXXXXXGXXXXXXXXXXXXXXXXXXXGXXXXXXXXXXXXXXXXXXXGXXXXXXXXXXXXXXXXXXXGXXXXXXXXXXXXXXXXXXXGXXXXXXXXXXXXXXXXXXX,0,10,0
14616,15,2,13,148,437,0,0,452,228,224,GXXXXXXXXXXXXXXXXXXXGAXXXXXXXXXXXXXXXXXXGXXXXXXXXXXXXXXXXXXXGXXXXXXXXXXXXXXXXXXXGXXXXXXXXXXXXXXXXXXXGXXXXXXXXXXXXXXXXXXXGXXXXXXXXXXXXXXXXXXXGXXXXXXXXXXXXXXXXXXXGXXXXXXXXXXXXXXXXXXXGXXXXXXXXXXXXXXXXXXXGXXXXXXXXXXXXXXXXXXXGAXXXXXXXXXXXXXXXXXXGXXXXXXXXXXXXXXXXXXX,0,10,0
14637,16,3,13,147,437,0,0,450,227,223,GXXXXXXXXXXXXXXXXXXXGAXXXXXXXXXXXXXXXXXXGXXXXXXXXXXXXXXXXXXXGXXXXXXXXXXXXXXXXXXXGXXXXXXXXXXXXXXXXXXXGXXXXXXXXXXXXXXXXXXXGXXXXXXXXXXXXXXXXXXXGXXXXXXXXXXXXXXXXXXXGXXXXXXXXXXXXXXXXXXXGXXXXXXXXXXXXXXXXXXXGXXXXXXXXXXXXXXXXXXXGAXXXXXXXXXXXXXXXXXXGAXXXXXXXXXXXXXXXXXX,0,10,0
14658,16,3,13,146,438,0,0,454,231,223,GXXXXXXXXXXXXXXXXXXXGAXXXXXXXXXXXXXXXXXXGXXXXXXXXXXXXXXXXXXXGXXXXXXXXXXXXXXXXXXXGXXXXXXXXXXXXXXXXXXXGXXXXXXXXXXXXXXXXXXXGXXXXXXXXXXXXXXXXXXXGXXXXXXXXXXXXXXXXXXXGXXXXXXXXXXXXXXXXXXXGXXXXXXXXXXXXXXXXXXXGXXXXXXXXXXXXXXXXXXXGAXXXXXXXXXXXXXXXXXXGAXXXXXXXXXXXXXXXXXX,0,10,0
14679,16,3,13,144,440,0,0,455,226,229,GXXXXXXXXXXXXXXXXXXXGAXXXXXXXXXXXXXXXXXXGXXXXXXXXXXXXXXXXXXXGXXXXXXXXXXXXXXXXXXXGXXXXXXXXXXXXXXXXXXXGXXXXXXXXXXXXXXXXXXXGXXXXXXXXXXXXXXXXXXXGXXXXXXXXXXXXXXXXXXXGXXXXXXXXXXXXXXXXXXXGXXXXXXXXXXXXXXXXXXXGXXXXXXXXXXXXXXXXXXXGAXXXXXXXXXXXXXXXXXXGAXXXXXXXXXXXXXXXXXX,0,10,0

14700,16,3,13,140,444,0,0,461,227,234,GXXXXXXXXXXXXXXXXXXXGAXXXXXXXXXXXXXXXXXXGXXXXXXXXXXXXXXXXXXXGXXXXXXXXXXXXXXXXXXXGXXXXXXXXXXXXXXXXXXXGXXXXXXXXXXXXXXXXXXXGXXXXXXXXXXXXXXXXXXXGXXXXXXXXXXXXXXXXXXXGXXXXXXXXXXXXXXXXXXXGXXXXXXXXXXXXXXXXXXXGXXXXXXXXXXXXXXXXXXXGAXXXXXXXXXXXXXXXXXXGAXXXXXXXXXXXXXXXXXX,0,10,0
14721,16,3,13,135,449,0,0,467,229,238,GXXXXXXXXXXXXXXXXXXXGAXXXXXXXXXXXXXXXXXXGXXXXXXXXXXXXXXXXXXXGXXXXXXXXXXXXXXXXXXXGXXXXXXXXXXXXXXXXXXXGXXXXXXXXXXXXXXXXXXXGXXXXXXXXXXXXXXXXXXXGXXXXXXXXXXXXXXXXXXXGXXXXXXXXXXXXXXXXXXXGXXXXXXXXXXXXXXXXXXXGXXXXXXXXXXXXXXXXXXXGAXXXXXXXXXXXXXXXXXXGAXXXXXXXXXXXXXXXXXX,0,10,0
14742,16,3,13,125,459,0,0,476,237,239,GXXXXXXXXXXXXXXXXXXXGAXXXXXXXXXXXXXXXXXXGXXXXXXXXXXXXXXXXXXXGXXXXXXXXXXXXXXXXXXXGXXXXXXXXXXXXXXXXXXXGXXXXXXXXXXXXXXXXXXXGXXXXXXXXXXXXXXXXXXXGXXXXXXXXXXXXXXXXXXXGXXXXXXXXXXXXXXXXXXXGXXXXXXXXXXXXXXXXXXXGXXXXXXXXXXXXXXXXXXXGAXXXXXXXXXXXXXXXXXXGAXXXXXXXXXXXXXXXXXX,0,10,0
14763,16,3,13,131,453,0,0,469,231,238,GXXXXXXXXXXXXXXXXXXXGAXXXXXXXXXXXXXXXXXXGXXXXXXXXXXXXXXXXXXXGXXXXXXXXXXXXXXXXXXXGXXXXXXXXXXXXXXXXXXXGXXXXXXXXXXXXXXXXXXXGXXXXXXXXXXXXXXXXXXXGXXXXXXXXXXXXXXXXXXXGXXXXXXXXXXXXXXXXXXXGXXXXXXXXXXXXXXXXXXXGXXXXXXXXXXXXXXXXXXXGAXXXXXXXXXXXXXXXXXXGAXXXXXXXXXXXXXXXXXX,0,10,0
14784,16,3,13,131,453,0,0,469,231,238,GXXXXXXXXXXXXXXXXXXXGAXXXXXXXXXXXXXXXXXXGXXXXXXXXXXXXXXXXXXXGXXXXXXXXXXXXXXXXXXXGXXXXXXXXXXXXXXXXXXXGXXXXXXXXXXXXXXXXXXXGXXXXXXXXXXXXXXXXXXXGXXXXXXXXXXXXXXXXXXXGXXXXXXXXXXXXXXXXXXXGXXXXXXXXXXXXXXXXXXXGXXXXXXXXXXXXXXXXXXXGAXXXXXXXXXXXXXXXXXXGAXXXXXXXXXXXXXXXXXX,0,10,0

14805,16,3,13,135,449,0,0,464,240,224,GXXXXXXXXXXXXXXXXXXXGAXXXXXXXXXXXXXXXXXXGXXXXXXXXXXXXXXXXXXXGXXXXXXXXXXXXXXXXXXXGXXXXXXXXXXXXXXXXXXXGXXXXXXXXXXXXXXXXXXXGXXXXXXXXXXXXXXXXXXXGXXXXXXXXXXXXXXXXXXXGXXXXXXXXXXXXXXXXXXXGXXXXXXXXXXXXXXXXXXXGXXXXXXXXXXXXXXXXXXXGAXXXXXXXXXXXXXXXXXXGAXXXXXXXXXXXXXXXXXX,0,10,0
14826,16,2,14,137,447,0,0,463,234,229,GXXXXXXXXXXXXXXXXXXXGAXXXXXXXXXXXXXXXXXXGXXXXXXXXXXXXXXXXXXXGXXXXXXXXXXXXXXXXXXXGXXXXXXXXXXXXXXXXXXXGXXXXXXXXXXXXXXXXXXXGXXXXXXXXXXXXXXXXXXXGXXXXXXXXXXXXXXXXXXXGXXXXXXXXXXXXXXXXXXXGXXXXXXXXXXXXXXXXXXXGXXXXXXXXXXXXXXXXXXXGAXXXXXXXXXXXXXXXXXXGOXXXXXXXXXXXXXXXXXX,0,10,0
14847,16,1,15,131,453,0,0,467,230,237,GXXXXXXXXXXXXXXXXXXXGOXXXXXXXXXXXXXXXXXXGXXXXXXXXXXXXXXXXXXXGXXXXXXXXXXXXXXXXXXXGXXXXXXXXXXXXXXXXXXXGXXXXXXXXXXXXXXXXXXXGXXXXXXXXXXXXXXXXXXXGXXXXXXXXXXXXXXXXXXXGXXXXXXXXXXXXXXXXXXXGXXXXXXXXXXXXXXXXXXXGXXXXXXXXXXXXXXXXXXXGAXXXXXXXXXXXXXXXXXXGOXXXXXXXXXXXXXXXXXX,0,10,0
14868,14,1,13,133,453,0,0,468,227,241,GXXXXXXXXXXXXXXXXXXXGXXXXXXXXXXXXXXXXXXXGXXXXXXXXXXXXXXXXXXXGXXXXXXXXXXXXXXXXXXXGXXXXXXXXXXXXXXXXXXXGXXXXXXXXXXXXXXXXXXXGXXXXXXXXXXXXXXXXXXXGXXXXXXXXXXXXXXXXXXXGXXXXXXXXXXXXXXXXXXXGXXXXXXXXXXXXXXXXXXXGXXXXXXXXXXXXXXXXXXXGAXXXXXXXXXXXXXXXXXXGXXXXXXXXXXXXXXXXXXX,0,10,0
14889,14,1,13,130,456,0,0,472,233,239,GXXXXXXXXXXXXXXXXXXXGXXXXXXXXXXXXXXXXXXXGXXXXXXXXXXXXXXXXXXXGXXXXXXXXXXXXXXXXXXXGXXXXXXXXXXXXXXXXXXXGXXXXXXXXXXXXXXXXXXXGXXXXXXXXXXXXXXXXXXXGXXXXXXXXXXXXXXXXXXXGXXXXXXXXXXXXXXXXXXXGXXXXXXXXXXXXXXXXXXXGXXXXXXXXXXXXXXXXXXXGAXXXXXXXXXXXXXXXXXXGXXXXXXXXXXXXXXXXXXX,0,10,0

14910,13,0,13,128,459,0,0,473,235,238,GXXXXXXXXXXXXXXXXXXXGXXXXXXXXXXXXXXXXXXXGXXXXXXXXXXXXXXXXXXXGXXXXXXXXXXXXXXXXXXXGXXXXXXXXXXXXXXXXXXXGXXXXXXXXXXXXXXXXXXXGXXXXXXXXXXXXXXXXXXXGXXXXXXXXXXXXXXXXXXXGXXXXXXXXXXXXXXXXXXXGXXXXXXXXXXXXXXXXXXXGXXXXXXXXXXXXXXXXXXXGXXXXXXXXXXXXXXXXXXXGXXXXXXXXXXXXXXXXXXX,0,10,0
14931,13,0,13,141,446,0,0,461,225,236,GXXXXXXXXXXXXXXXXXXXGXXXXXXXXXXXXXXXXXXXGXXXXXXXXXXXXXXXXXXXGXXXXXXXXXXXXXXXXXXXGXXXXXXXXXXXXXXXXXXXGXXXXXXXXXXXXXXXXXXXGXXXXXXXXXXXXXXXXXXXGXXXXXXXXXXXXXXXXXXXGXXXXXXXXXXXXXXXXXXXGXXXXXXXXXXXXXXXXXXXGXXXXXXXXXXXXXXXXXXXGXXXXXXXXXXXXXXXXXXXGXXXXXXXXXXXXXXXXXXX,0,10,0
14952,13,0,13,137,450,0,0,463,226,237,GXXXXXXXXXXXXXXXXXXXGXXXXXXXXXXXXXXXXXXXGXXXXXXXXXXXXXXXXXXXGXXXXXXXXXXXXXXXXXXXGXXXXXXXXXXXXXXXXXXXGXXXXXXXXXXXXXXXXXXXGXXXXXXXXXXXXXXXXXXXGXXXXXXXXXXXXXXXXXXXGXXXXXXXXXXXXXXXXXXXGXXXXXXXXXXXXXXXXXXXGXXXXXXXXXXXXXXXXXXXGXXXXXXXXXXXXXXXXXXXGXXXXXXXXXXXXXXXXXXX,0,10,0
14973,13,0,13,130,457,0,0,472,235,237,GXXXXXXXXXXXXXXXXXXXGXXXXXXXXXXXXXXXXXXXGXXXXXXXXXXXXXXXXXXXGXXXXXXXXXXXXXXXXXXXGXXXXXXXXXXXXXXXXXXXGXXXXXXXXXXXXXXXXXXXGXXXXXXXXXXXXXXXXXXXGXXXXXXXXXXXXXXXXXXXGXXXXXXXXXXXXXXXXXXXGXXXXXXXXXXXXXXXXXXXGXXXXXXXXXXXXXXXXXXXGXXXXXXXXXXXXXXXXXXXGXXXXXXXXXXXXXXXXXXX,0,10,0
14994,13,0,13,134,453,0,0,469,230,239,GXXXXXXXXXXXXXXXXXXXGXXXXXXXXXXXXXXXXXXXGXXXXXXXXXXXXXXXXXXXGXXXXXXXXXXXXXXXXXXXGXXXXXXXXXXXXXXXXXXXGXXXXXXXXXXXXXXXXXXXGXXXXXXXXXXXXXXXXXXXGXXXXXXXXXXXXXXXXXXXGXXXXXXXXXXXXXXXXXXXGXXXXXXXXXXXXXXXXXXXGXXXXXXXXXXXXXXXXXXXGXXXXXXXXXXXXXXXXXXXGXXXXXXXXXXXXXXXXXXX,0,10,0

15015,13,0,13,136,451,0,0,467,230,237,GXXXXXXXXXXXXXXXXXXXGXXXXXXXXXXXXXXXXXXXGXXXXXXXXXXXXXXXXXXXGXXXXXXXXXXXXXXXXXXXGXXXXXXXXXXXXXXXXXXXGXXXXXXXXXXXXXXXXXXXGXXXXXXXXXXXXXXXXXXXGXXXXXXXXXXXXXXXXXXXGXXXXXXXXXXXXXXXXXXXGXXXXXXXXXXXXXXXXXXXGXXXXXXXXXXXXXXXXXXXGXXXXXXXXXXXXXXXXXXXGXXXXXXXXXXXXXXXXXXX,0,10,0
15036,13,0,13,139,448,0,0,464,228,236,GXXXXXXXXXXXXXXXXXXXGXXXXXXXXXXXXXXXXXXXGXXXXXXXXXXXXXXXXXXXGXXXXXXXXXXXXXXXXXXXGXXXXXXXXXXXXXXXXXXXGXXXXXXXXXXXXXXXXXXXGXXXXXXXXXXXXXXXXXXXGXXXXXXXXXXXXXXXXXXXGXXXXXXXXXXXXXXXXXXXGXXXXXXXXXXXXXXXXXXXGXXXXXXXXXXXXXXXXXXXGXXXXXXXXXXXXXXXXXXXGXXXXXXXXXXXXXXXXXXX,0,10,0
15057,13,0,13,141,446,0,0,460,230,230,GXXXXXXXXXXXXXXXXXXXGXXXXXXXXXXXXXXXXXXXGXXXXXXXXXXXXXXXXXXXGXXXXXXXXXXXXXXXXXXXGXXXXXXXXXXXXXXXXXXXGXXXXXXXXXXXXXXXXXXXGXXXXXXXXXXXXXXXXXXXGXXXXXXXXXXXXXXXXXXXGXXXXXXXXXXXXXXXXXXXGXXXXXXXXXXXXXXXXXXXGXXXXXXXXXXXXXXXXXXXGXXXXXXXXXXXXXXXXXXXGXXXXXXXXXXXXXXXXXXX,0,10,0
15078,13,0,13,139,448,0,0,464,234,230,GXXXXXXXXXXXXXXXXXXXGXXXXXXXXXXXXXXXXXXXGXXXXXXXXXXXXXXXXXXXGXXXXXXXXXXXXXXXXXXXGXXXXXXXXXXXXXXXXXXXGXXXXXXXXXXXXXXXXXXXGXXXXXXXXXXXXXXXXXXXGXXXXXXXXXXXXXXXXXXXGXXXXXXXXXXXXXXXXXXXGXXXXXXXXXXXXXXXXXXXGXXXXXXXXXXXXXXXXXXXGXXXXXXXXXXXXXXXXXXXGXXXXXXXXXXXXXXXXXXX,0,10,0
15099,14,1,13,133,453,0,0,467,235,232,GXXXXXXXXXXXXXXXXXXXGXXXXXXXXXXXXXXXXXXXGAXXXXXXXXXXXXXXXXXXGXXXXXXXXXXXXXXXXXXXGXXXXXXXXXXXXXXXXXXXGXXXXXXXXXXXXXXXXXXXGXXXXXXXXXXXXXXXXXXXGXXXXXXXXXXXXXXXXXXXGXXXXXXXXXXXXXXXXXXXGXXXXXXXXXXXXXXXXXXXGXXXXXXXXXXXXXXXXXXXGXXXXXXXXXXXXXXXXXXXGXXXXXXXXXXXXXXXXXXX,0,10,0

15120,14,1,13,137,449,0,0,465,233,232,GXXXXXXXXXXXXXXXXXXXGXXXXXXXXXXXXXXXXXXXGAXXXXXXXXXXXXXXXXXXGXXXXXXXXXXXXXXXXXXXGXXXXXXXXXXXXXXXXXXXGXXXXXXXXXXXXXXXXXXXGXXXXXXXXXXXXXXXXXXXGXXXXXXXXXXXXXXXXXXXGXXXXXXXXXXXXXXXXXXXGXXXXXXXXXXXXXXXXXXXGXXXXXXXXXXXXXXXXXXXGXXXXXXXXXXXXXXXXXXXGXXXXXXXXXXXXXXXXXXX,0,10,0
15141,14,1,13,138,448,0,0,462,225,237,GXXXXXXXXXXXXXXXXXXXGXXXXXXXXXXXXXXXXXXXGAXXXXXXXXXXXXXXXXXXGXXXXXXXXXXXXXXXXXXXGXXXXXXXXXXXXXXXXXXXGXXXXXXXXXXXXXXXXXXXGXXXXXXXXXXXXXXXXXXXGXXXXXXXXXXXXXXXXXXXGXXXXXXXXXXXXXXXXXXXGXXXXXXXXXXXXXXXXXXXGXXXXXXXXXXXXXXXXXXXGXXXXXXXXXXXXXXXXXXXGXXXXXXXXXXXXXXXXXXX,0,10,0
15162,14,1,13,126,460,0,0,477,224,253,GXXXXXXXXXXXXXXXXXXXGXXXXXXXXXXXXXXXXXXXGAXXXXXXXXXXXXXXXXXXGXXXXXXXXXXXXXXXXXXXGXXXXXXXXXXXXXXXXXXXGXXXXXXXXXXXXXXXXXXXGXXXXXXXXXXXXXXXXXXXGXXXXXXXXXXXXXXXXXXXGXXXXXXXXXXXXXXXXXXXGXXXXXXXXXXXXXXXXXXXGXXXXXXXXXXXXXXXXXXXGXXXXXXXXXXXXXXXXXXXGXXXXXXXXXXXXXXXXXXX,0,10,0
15183,14,1,13,128,458,0,0,474,227,247,GXXXXXXXXXXXXXXXXXXXGXXXXXXXXXXXXXXXXXXXGAXXXXXXXXXXXXXXXXXXGXXXXXXXXXXXXXXXXXXXGXXXXXXXXXXXXXXXXXXXGXXXXXXXXXXXXXXXXXXXGXXXXXXXXXXXXXXXXXXXGXXXXXXXXXXXXXXXXXXXGXXXXXXXXXXXXXXXXXXXGXXXXXXXXXXXXXXXXXXXGXXXXXXXXXXXXXXXXXXXGXXXXXXXXXXXXXXXXXXXGXXXXXXXXXXXXXXXXXXX,0,10,0
15204,14,1,13,131,455,0,0,471,230,241,GXXXXXXXXXXXXXXXXXXXGXXXXXXXXXXXXXXXXXXXGAXXXXXXXXXXXXXXXXXXGXXXXXXXXXXXXXXXXXXXGXXXXXXXXXXXXXXXXXXXGXXXXXXXXXXXXXXXXXXXGXXXXXXXXXXXXXXXXXXXGXXXXXXXXXXXXXXXXXXXGXXXXXXXXXXXXXXXXXXXGXXXXXXXXXXXXXXXXXXXGXXXXXXXXXXXXXXXXXXXGXXXXXXXXXXXXXXXXXXXGXXXXXXXXXXXXXXXXXXX,0,10,0

15225,14,1,13,125,461,0,0,474,228,246,GXXXXXXXXXXXXXXXXXXXGXXXXXXXXXXXXXXXXXXXGAXXXXXXXXXXXXXXXXXXGXXXXXXXXXXXXXXXXXXXGXXXXXXXXXXXXXXXXXXXGXXXXXXXXXXXXXXXXXXXGXXXXXXXXXXXXXXXXXXXGXXXXXXXXXXXXXXXXXXXGXXXXXXXXXXXXXXXXXXXGXXXXXXXXXXXXXXXXXXXGXXXXXXXXXXXXXXXXXXXGXXXXXXXXXXXXXXXXXXXGXXXXXXXXXXXXXXXXXXX,0,10,0
15246,14,1,13,126,460,0,0,475,221,254,GXXXXXXXXXXXXXXXXXXXGXXXXXXXXXXXXXXXXXXXGAXXXXXXXXXXXXXXXXXXGXXXXXXXXXXXXXXXXXXXGXXXXXXXXXXXXXXXXXXXGXXXXXXXXXXXXXXXXXXXGXXXXXXXXXXXXXXXXXXXGXXXXXXXXXXXXXXXXXXXGXXXXXXXXXXXXXXXXXXXGXXXXXXXXXXXXXXXXXXXGXXXXXXXXXXXXXXXXXXXGXXXXXXXXXXXXXXXXXXXGXXXXXXXXXXXXXXXXXXX,0,10,0
15267,14,1,13,126,460,0,0,479,222,257,GXXXXXXXXXXXXXXXXXXXGXXXXXXXXXXXXXXXXXXXGAXXXXXXXXXXXXXXXXXXGXXXXXXXXXXXXXXXXXXXGXXXXXXXXXXXXXXXXXXXGXXXXXXXXXXXXXXXXXXXGXXXXXXXXXXXXXXXXXXXGXXXXXXXXXXXXXXXXXXXGXXXXXXXXXXXXXXXXXXXGXXXXXXXXXXXXXXXXXXXGXXXXXXXXXXXXXXXXXXXGXXXXXXXXXXXXXXXXXXXGXXXXXXXXXXXXXXXXXXX,0,10,0
15288,14,1,13,131,455,0,0,474,223,251,GXXXXXXXXXXXXXXXXXXXGXXXXXXXXXXXXXXXXXXXGAXXXXXXXXXXXXXXXXXXGXXXXXXXXXXXXXXXXXXXGXXXXXXXXXXXXXXXXXXXGXXXXXXXXXXXXXXXXXXXGXXXXXXXXXXXXXXXXXXXGXXXXXXXXXXXXXXXXXXXGXXXXXXXXXXXXXXXXXXXGXXXXXXXXXXXXXXXXXXXGXXXXXXXXXXXXXXXXXXXGXXXXXXXXXXXXXXXXXXXGXXXXXXXXXXXXXXXXXXX,0,10,0
15309,14,1,13,133,453,0,0,471,226,245,GXXXXXXXXXXXXXXXXXXXGXXXXXXXXXXXXXXXXXXXGAXXXXXXXXXXXXXXXXXXGXXXXXXXXXXXXXXXXXXXGXXXXXXXXXXXXXXXXXXXGXXXXXXXXXXXXXXXXXXXGXXXXXXXXXXXXXXXXXXXGXXXXXXXXXXXXXXXXXXXGXXXXXXXXXXXXXXXXXXXGXXXXXXXXXXXXXXXXXXXGXXXXXXXXXXXXXXXXXXXGXXXXXXXXXXXXXXXXXXXGXXXXXXXXXXXXXXXXXXX,0,10,0

15330,14,1,13,133,453,0,0,471,229,242,GXXXXXXXXXXXXXXXXXXXGXXXXXXXXXXXXXXXXXXXGAXXXXXXXXXXXXXXXXXXGXXXXXXXXXXXXXXXXXXXGXXXXXXXXXXXXXXXXXXXGXXXXXXXXXXXXXXXXXXXGXXXXXXXXXXXXXXXXXXXGXXXXXXXXXXXXXXXXXXXGXXXXXXXXXXXXXXXXXXXGXXXXXXXXXXXXXXXXXXXGXXXXXXXXXXXXXXXXXXXGXXXXXXXXXXXXXXXXXXXGXXXXXXXXXXXXXXXXXXX,0,10,0
15351,14,1,13,132,454,0,0,471,230,241,GXXXXXXXXXXXXXXXXXXXGXXXXXXXXXXXXXXXXXXXGAXXXXXXXXXXXXXXXXXXGXXXXXXXXXXXXXXXXXXXGXXXXXXXXXXXXXXXXXXXGXXXXXXXXXXXXXXXXXXXGXXXXXXXXXXXXXXXXXXXGXXXXXXXXXXXXXXXXXXXGXXXXXXXXXXXXXXXXXXXGXXXXXXXXXXXXXXXXXXXGXXXXXXXXXXXXXXXXXXXGXXXXXXXXXXXXXXXXXXXGXXXXXXXXXXXXXXXXXXX,0,10,0
15372,14,1,13,130,456,0,0,472,235,237,GXXXXXXXXXXXXXXXXXXXGXXXXXXXXXXXXXXXXXXXGAXXXXXXXXXXXXXXXXXXGXXXXXXXXXXXXXXXXXXXGXXXXXXXXXXXXXXXXXXXGXXXXXXXXXXXXXXXXXXXGXXXXXXXXXXXXXXXXXXXGXXXXXXXXXXXXXXXXXXXGXXXXXXXXXXXXXXXXXXXGXXXXXXXXXXXXXXXXXXXGXXXXXXXXXXXXXXXXXXXGXXXXXXXXXXXXXXXXXXXGXXXXXXXXXXXXXXXXXXX,0,10,0
15393,13,0,13,130,457,0,0,471,236,235,GXXXXXXXXXXXXXXXXXXXGXXXXXXXXXXXXXXXXXXXGXXXXXXXXXXXXXXXXXXXGXXXXXXXXXXXXXXXXXXXGXXXXXXXXXXXXXXXXXXXGXXXXXXXXXXXXXXXXXXXGXXXXXXXXXXXXXXXXXXXGXXXXXXXXXXXXXXXXXXXGXXXXXXXXXXXXXXXXXXXGXXXXXXXXXXXXXXXXXXXGXXXXXXXXXXXXXXXXXXXGXXXXXXXXXXXXXXXXXXXGXXXXXXXXXXXXXXXXXXX,0,10,0
15414,13,0,13,135,452,0,0,468,241,227,GXXXXXXXXXXXXXXXXXXXGXXXXXXXXXXXXXXXXXXXGXXXXXXXXXXXXXXXXXXXGXXXXXXXXXXXXXXXXXXXGXXXXXXXXXXXXXXXXXXXGXXXXXXXXXXXXXXXXXXXGXXXXXXXXXXXXXXXXXXXGXXXXXXXXXXXXXXXXXXXGXXXXXXXXXXXXXXXXXXXGXXXXXXXXXXXXXXXXXXXGXXXXXXXXXXXXXXXXXXXGXXXXXXXXXXXXXXXXXXXGXXXXXXXXXXXXXXXXXXX,0,10,0

15435,13,0,13,140,447,0,0,463,232,231,GXXXXXXXXXXXXXXXXXXXGXXXXXXXXXXXXXXXXXXXGXXXXXXXXXXXXXXXXXXXGXXXXXXXXXXXXXXXXXXXGXXXXXXXXXXXXXXXXXXXGXXXXXXXXXXXXXXXXXXXGXXXXXXXXXXXXXXXXXXXGXXXXXXXXXXXXXXXXXXXGXXXXXXXXXXXXXXXXXXXGXXXXXXXXXXXXXXXXXXXGXXXXXXXXXXXXXXXXXXXGXXXXXXXXXXXXXXXXXXXGXXXXXXXXXXXXXXXXXXX,0,10,0
15456,14,1,13,146,440,0,0,456,231,225,GXXXXXXXXXXXXXXXXXXXGXXXXXXXXXXXXXXXXXXXGXXXXXXXXXXXXXXXXXXXGXXXXXXXXXXXXXXXXXXXGAXXXXXXXXXXXXXXXXXXGXXXXXXXXXXXXXXXXXXXGXXXXXXXXXXXXXXXXXXXGXXXXXXXXXXXXXXXXXXXGXXXXXXXXXXXXXXXXXXXGXXXXXXXXXXXXXXXXXXXGXXXXXXXXXXXXXXXXXXXGXXXXXXXXXXXXXXXXXXXGXXXXXXXXXXXXXXXXXXX,0,10,0
15477,14,0,14,148,438,0,0,453,233,220,GXXXXXXXXXXXXXXXXXXXGXXXXXXXXXXXXXXXXXXXGXXXXXXXXXXXXXXXXXXXGXXXXXXXXXXXXXXXXXXXGOXXXXXXXXXXXXXXXXXXGXXXXXXXXXXXXXXXXXXXGXXXXXXXXXXXXXXXXXXXGXXXXXXXXXXXXXXXXXXXGXXXXXXXXXXXXXXXXXXXGXXXXXXXXXXXXXXXXXXXGXXXXXXXXXXXXXXXXXXXGXXXXXXXXXXXXXXXXXXXGXXXXXXXXXXXXXXXXXXX,0,10,0
15498,14,0,14,145,441,0,0,456,237,219,GXXXXXXXXXXXXXXXXXXXGXXXXXXXXXXXXXXXXXXXGXXXXXXXXXXXXXXXXXXXGXXXXXXXXXXXXXXXXXXXGOXXXXXXXXXXXXXXXXXXGXXXXXXXXXXXXXXXXXXXGXXXXXXXXXXXXXXXXXXXGXXXXXXXXXXXXXXXXXXXGXXXXXXXXXXXXXXXXXXXGXXXXXXXXXXXXXXXXXXXGXXXXXXXXXXXXXXXXXXXGXXXXXXXXXXXXXXXXXXXGXXXXXXXXXXXXXXXXXXX,0,10,0
15519,13,0,13,140,447,0,0,457,231,226,GXXXXXXXXXXXXXXXXXXXGXXXXXXXXXXXXXXXXXXXGXXXXXXXXXXXXXXXXXXXGXXXXXXXXXXXXXXXXXXXGXXXXXXXXXXXXXXXXXXXGXXXXXXXXXXXXXXXXXXXGXXXXXXXXXXXXXXXXXXXGXXXXXXXXXXXXXXXXXXXGXXXXXXXXXXXXXXXXXXXGXXXXXXXXXXXXXXXXXXXGXXXXXXXXXXXXXXXXXXXGXXXXXXXXXXXXXXXXXXXGXXXXXXXXXXXXXXXXXXX,0,10,0

15540,14,0,14,138,448,0,0,460,233,227,GXXXXXXXXXXXXXXXXXXXGOXXXXXXXXXXXXXXXXXXGXXXXXXXXXXXXXXXXXXXGXXXXXXXXXXXXXXXXXXXGXXXXXXXXXXXXXXXXXXXGXXXXXXXXXXXXXXXXXXXGXXXXXXXXXXXXXXXXXXXGXXXXXXXXXXXXXXXXXXXGXXXXXXXXXXXXXXXXXXXGXXXXXXXXXXXXXXXXXXXGXXXXXXXXXXXXXXXXXXXGXXXXXXXXXXXXXXXXXXXGXXXXXXXXXXXXXXXXXXX,0,10,0
15561,13,0,13,141,446,0,0,459,227,232,GXXXXXXXXXXXXXXXXXXXGXXXXXXXXXXXXXXXXXXXGXXXXXXXXXXXXXXXXXXXGXXXXXXXXXXXXXXXXXXXGXXXXXXXXXXXXXXXXXXXGXXXXXXXXXXXXXXXXXXXGXXXXXXXXXXXXXXXXXXXGXXXXXXXXXXXXXXXXXXXGXXXXXXXXXXXXXXXXXXXGXXXXXXXXXXXXXXXXXXXGXXXXXXXXXXXXXXXXXXXGXXXXXXXXXXXXXXXXXXXGXXXXXXXXXXXXXXXXXXX,0,10,0
15582,13,0,13,142,445,0,0,458,237,221,GXXXXXXXXXXXXXXXXXXXGXXXXXXXXXXXXXXXXXXXGXXXXXXXXXXXXXXXXXXXGXXXXXXXXXXXXXXXXXXXGXXXXXXXXXXXXXXXXXXXGXXXXXXXXXXXXXXXXXXXGXXXXXXXXXXXXXXXXXXXGXXXXXXXXXXXXXXXXXXXGXXXXXXXXXXXXXXXXXXXGXXXXXXXXXXXXXXXXXXXGXXXXXXXXXXXXXXXXXXXGXXXXXXXXXXXXXXXXXXXGXXXXXXXXXXXXXXXXXXX,0,10,0
15603,14,1,13,145,441,0,0,454,234,220,GXXXXXXXXXXXXXXXXXXXGXXXXXXXXXXXXXXXXXXXGXXXXXXXXXXXXXXXXXXXGXXXXXXXXXXXXXXXXXXXGAXXXXXXXXXXXXXXXXXXGXXXXXXXXXXXXXXXXXXXGXXXXXXXXXXXXXXXXXXXGXXXXXXXXXXXXXXXXXXXGXXXXXXXXXXXXXXXXXXXGXXXXXXXXXXXXXXXXXXXGXXXXXXXXXXXXXXXXXXXGXXXXXXXXXXXXXXXXXXXGXXXXXXXXXXXXXXXXXXX,0,10,0
15624,15,2,13,141,444,0,0,456,235,221,GXXXXXXXXXXXXXXXXXXXGXXXXXXXXXXXXXXXXXXXGXXXXXXXXXXXXXXXXXXXGXXXXXXXXXXXXXXXXXXXGAXXXXXXXXXXXXXXXXXXGXXXXXXXXXXXXXXXXXXXGXXXXXXXXXXXXXXXXXXXGXXXXXXXXXXXXXXXXXXXGXXXXXXXXXXXXXXXXXXXGXXXXXXXXXXXXXXXXXXXGXXXXXXXXXXXXXXXXXXXGXXXXXXXXXXXXXXXXXXXGAXXXXXXXXXXXXXXXXXX,0,10,0

15645,15,2,13,144,441,0,0,456,233,223,GXXXXXXXXXXXXXXXXXXXGXXXXXXXXXXXXXXXXXXXGXXXXXXXXXXXXXXXXXXXGXXXXXXXXXXXXXXXXXXXGAXXXXXXXXXXXXXXXXXXGXXXXXXXXXXXXXXXXXXXGXXXXXXXXXXXXXXXXXXXGXXXXXXXXXXXXXXXXXXXGXXXXXXXXXXXXXXXXXXXGXXXXXXXXXXXXXXXXXXXGXXXXXXXXXXXXXXXXXXXGXXXXXXXXXXXXXXXXXXXGAXXXXXXXXXXXXXXXXXX,0,10,0
15666,15,1,14,149,436,0,0,451,235,216,GXXXXXXXXXXXXXXXXXXXGXXXXXXXXXXXXXXXXXXXGXXXXXXXXXXXXXXXXXXXGXXXXXXXXXXXXXXXXXXXGAXXXXXXXXXXXXXXXXXXGXXXXXXXXXXXXXXXXXXXGXXXXXXXXXXXXXXXXXXXGXXXXXXXXXXXXXXXXXXXGXXXXXXXXXXXXXXXXXXXGXXXXXXXXXXXXXXXXXXXGXXXXXXXXXXXXXXXXXXXGXXXXXXXXXXXXXXXXXXXGOXXXXXXXXXXXXXXXXXX,0,10,0
15687,15,1,14,148,437,0,0,452,235,217,GXXXXXXXXXXXXXXXXXXXGXXXXXXXXXXXXXXXXXXXGXXXXXXXXXXXXXXXXXXXGXXXXXXXXXXXXXXXXXXXGAXXXXXXXXXXXXXXXXXXGXXXXXXXXXXXXXXXXXXXGXXXXXXXXXXXXXXXXXXXGXXXXXXXXXXXXXXXXXXXGXXXXXXXXXXXXXXXXXXXGXXXXXXXXXXXXXXXXXXXGXXXXXXXXXXXXXXXXXXXGXXXXXXXXXXXXXXXXXXXGOXXXXXXXXXXXXXXXXXX,0,10,0
15708,13,0,13,146,441,0,0,454,237,217,GXXXXXXXXXXXXXXXXXXXGXXXXXXXXXXXXXXXXXXXGXXXXXXXXXXXXXXXXXXXGXXXXXXXXXXXXXXXXXXXGXXXXXXXXXXXXXXXXXXXGXXXXXXXXXXXXXXXXXXXGXXXXXXXXXXXXXXXXXXXGXXXXXXXXXXXXXXXXXXXGXXXXXXXXXXXXXXXXXXXGXXXXXXXXXXXXXXXXXXXGXXXXXXXXXXXXXXXXXXXGXXXXXXXXXXXXXXXXXXXGXXXXXXXXXXXXXXXXXXX,0,10,0
15729,13,0,13,148,439,0,0,452,236,216,GXXXXXXXXXXXXXXXXXXXGXXXXXXXXXXXXXXXXXXXGXXXXXXXXXXXXXXXXXXXGXXXXXXXXXXXXXXXXXXXGXXXXXXXXXXXXXXXXXXXGXXXXXXXXXXXXXXXXXXXGXXXXXXXXXXXXXXXXXXXGXXXXXXXXXXXXXXXXXXXGXXXXXXXXXXXXXXXXXXXGXXXXXXXXXXXXXXXXXXXGXXXXXXXXXXXXXXXXXXXGXXXXXXXXXXXXXXXXXXXGXXXXXXXXXXXXXXXXXXX,0,10,0

15750,13,0,13,143,444,0,0,457,231,226,GXXXXXXXXXXXXXXXXXXXGXXXXXXXXXXXXXXXXXXXGXXXXXXXXXXXXXXXXXXXGXXXXXXXXXXXXXXXXXXXGXXXXXXXXXXXXXXXXXXXGXXXXXXXXXXXXXXXXXXXGXXXXXXXXXXXXXXXXXXXGXXXXXXXXXXXXXXXXXXXGXXXXXXXXXXXXXXXXXXXGXXXXXXXXXXXXXXXXXXXGXXXXXXXXXXXXXXXXXXXGXXXXXXXXXXXXXXXXXXXGXXXXXXXXXXXXXXXXXXX,0,10,0
15771,13,0,13,145,442,0,0,458,224,234,GXXXXXXXXXXXXXXXXXXXGXXXXXXXXXXXXXXXXXXXGXXXXXXXXXXXXXXXXXXXGXXXXXXXXXXXXXXXXXXXGXXXXXXXXXXXXXXXXXXXGXXXXXXXXXXXXXXXXXXXGXXXXXXXXXXXXXXXXXXXGXXXXXXXXXXXXXXXXXXXGXXXXXXXXXXXXXXXXXXXGXXXXXXXXXXXXXXXXXXXGXXXXXXXXXXXXXXXXXXXGXXXXXXXXXXXXXXXXXXXGXXXXXXXXXXXXXXXXXXX,0,10,0
15792,13,0,13,138,449,0,0,464,228,236,GXXXXXXXXXXXXXXXXXXXGXXXXXXXXXXXXXXXXXXXGXXXXXXXXXXXXXXXXXXXGXXXXXXXXXXXXXXXXXXXGXXXXXXXXXXXXXXXXXXXGXXXXXXXXXXXXXXXXXXXGXXXXXXXXXXXXXXXXXXXGXXXXXXXXXXXXXXXXXXXGXXXXXXXXXXXXXXXXXXXGXXXXXXXXXXXXXXXXXXXGXXXXXXXXXXXXXXXXXXXGXXXXXXXXXXXXXXXXXXXGXXXXXXXXXXXXXXXXXXX,0,10,0
15813,13,0,13,134,453,0,0,468,233,235,GXXXXXXXXXXXXXXXXXXXGXXXXXXXXXXXXXXXXXXXGXXXXXXXXXXXXXXXXXXXGXXXXXXXXXXXXXXXXXXXGXXXXXXXXXXXXXXXXXXXGXXXXXXXXXXXXXXXXXXXGXXXXXXXXXXXXXXXXXXXGXXXXXXXXXXXXXXXXXXXGXXXXXXXXXXXXXXXXXXXGXXXXXXXXXXXXXXXXXXXGXXXXXXXXXXXXXXXXXXXGXXXXXXXXXXXXXXXXXXXGXXXXXXXXXXXXXXXXXXX,0,10,0
15834,13,0,13,136,451,0,0,467,234,233,GXXXXXXXXXXXXXXXXXXXGXXXXXXXXXXXXXXXXXXXGXXXXXXXXXXXXXXXXXXXGXXXXXXXXXXXXXXXXXXXGXXXXXXXXXXXXXXXXXXXGXXXXXXXXXXXXXXXXXXXGXXXXXXXXXXXXXXXXXXXGXXXXXXXXXXXXXXXXXXXGXXXXXXXXXXXXXXXXXXXGXXXXXXXXXXXXXXXXXXXGXXXXXXXXXXXXXXXXXXXGXXXXXXXXXXXXXXXXXXXGXXXXXXXXXXXXXXXXXXX,0,10,0

15855,13,0,13,132,455,0,0,471,233,238,GXXXXXXXXXXXXXXXXXXXGXXXXXXXXXXXXXXXXXXXGXXXXXXXXXXXXXXXXXXXGXXXXXXXXXXXXXXXXXXXGXXXXXXXXXXXXXXXXXXXGXXXXXXXXXXXXXXXXXXXGXXXXXXXXXXXXXXXXXXXGXXXXXXXXXXXXXXXXXXXGXXXXXXXXXXXXXXXXXXXGXXXXXXXXXXXXXXXXXXXGXXXXXXXXXXXXXXXXXXXGXXXXXXXXXXXXXXXXXXXGXXXXXXXXXXXXXXXXXXX,0,10,0
15876,13,0,13,139,448,0,0,463,235,228,GXXXXXXXXXXXXXXXXXXXGXXXXXXXXXXXXXXXXXXXGXXXXXXXXXXXXXXXXXXXGXXXXXXXXXXXXXXXXXXXGXXXXXXXXXXXXXXXXXXXGXXXXXXXXXXXXXXXXXXXGXXXXXXXXXXXXXXXXXXXGXXXXXXXXXXXXXXXXXXXGXXXXXXXXXXXXXXXXXXXGXXXXXXXXXXXXXXXXXXXGXXXXXXXXXXXXXXXXXXXGXXXXXXXXXXXXXXXXXXXGXXXXXXXXXXXXXXXXXXX,0,10,0
15897,13,0,13,138,449,0,0,462,230,232,GXXXXXXXXXXXXXXXXXXXGXXXXXXXXXXXXXXXXXXXGXXXXXXXXXXXXXXXXXXXGXXXXXXXXXXXXXXXXXXXGXXXXXXXXXXXXXXXXXXXGXXXXXXXXXXXXXXXXXXXGXXXXXXXXXXXXXXXXXXXGXXXXXXXXXXXXXXXXXXXGXXXXXXXXXXXXXXXXXXXGXXXXXXXXXXXXXXXXXXXGXXXXXXXXXXXXXXXXXXXGXXXXXXXXXXXXXXXXXXXGXXXXXXXXXXXXXXXXXXX,0,10,0
15918,13,0,13,136,451,0,0,466,235,231,GXXXXXXXXXXXXXXXXXXXGXXXXXXXXXXXXXXXXXXXGXXXXXXXXXXXXXXXXXXXGXXXXXXXXXXXXXXXXXXXGXXXXXXXXXXXXXXXXXXXGXXXXXXXXXXXXXXXXXXXGXXXXXXXXXXXXXXXXXXXGXXXXXXXXXXXXXXXXXXXGXXXXXXXXXXXXXXXXXXXGXXXXXXXXXXXXXXXXXXXGXXXXXXXXXXXXXXXXXXXGXXXXXXXXXXXXXXXXXXXGXXXXXXXXXXXXXXXXXXX,0,10,0
15939,13,0,13,136,451,0,0,465,230,235,GXXXXXXXXXXXXXXXXXXXGXXXXXXXXXXXXXXXXXXXGXXXXXXXXXXXXXXXXXXXGXXXXXXXXXXXXXXXXXXXGXXXXXXXXXXXXXXXXXXXGXXXXXXXXXXXXXXXXXXXGXXXXXXXXXXXXXXXXXXXGXXXXXXXXXXXXXXXXXXXGXXXXXXXXXXXXXXXXXXXGXXXXXXXXXXXXXXXXXXXGXXXXXXXXXXXXXXXXXXXGXXXXXXXXXXXXXXXXXXXGXXXXXXXXXXXXXXXXXXX,0,10,0

15960,13,0,13,134,453,0,0,466,229,237,GXXXXXXXXXXXXXXXXXXXGXXXXXXXXXXXXXXXXXXXGXXXXXXXXXXXXXXXXXXXGXXXXXXXXXXXXXXXXXXXGXXXXXXXXXXXXXXXXXXXGXXXXXXXXXXXXXXXXXXXGXXXXXXXXXXXXXXXXXXXGXXXXXXXXXXXXXXXXXXXGXXXXXXXXXXXXXXXXXXXGXXXXXXXXXXXXXXXXXXXGXXXXXXXXXXXXXXXXXXXGXXXXXXXXXXXXXXXXXXXGXXXXXXXXXXXXXXXXXXX,0,10,0
15981,13,0,13,131,456,0,0,468,234,234,GXXXXXXXXXXXXXXXXXXXGXXXXXXXXXXXXXXXXXXXGXXXXXXXXXXXXXXXXXXXGXXXXXXXXXXXXXXXXXXXGXXXXXXXXXXXXXXXXXXXGXXXXXXXXXXXXXXXXXXXGXXXXXXXXXXXXXXXXXXXGXXXXXXXXXXXXXXXXXXXGXXXXXXXXXXXXXXXXXXXGXXXXXXXXXXXXXXXXXXXGXXXXXXXXXXXXXXXXXXXGXXXXXXXXXXXXXXXXXXXGXXXXXXXXXXXXXXXXXXX,0,10,0
16002,13,0,13,129,458,0,0,470,232,238,GXXXXXXXXXXXXXXXXXXXGXXXXXXXXXXXXXXXXXXXGXXXXXXXXXXXXXXXXXXXGXXXXXXXXXXXXXXXXXXXGXXXXXXXXXXXXXXXXXXXGXXXXXXXXXXXXXXXXXXXGXXXXXXXXXXXXXXXXXXXGXXXXXXXXXXXXXXXXXXXGXXXXXXXXXXXXXXXXXXXGXXXXXXXXXXXXXXXXXXXGXXXXXXXXXXXXXXXXXXXGXXXXXXXXXXXXXXXXXXXGXXXXXXXXXXXXXXXXXXX,0,10,0
16023,14,1,13,132,454,0,0,467,235,232,GXXXXXXXXXXXXXXXXXXXGXXXXXXXXXXXXXXXXXXXGXXXXXXXXXXXXXXXXXXXGXXXXXXXXXXXXXXXXXXXGXXXXXXXXXXXXXXXXXXXGXXXXXXXXXXXXXXXXXXXGXXXXXXXXXXXXXXXXXXXGXXXXXXXXXXXXXXXXXXXGAXXXXXXXXXXXXXXXXXXGXXXXXXXXXXXXXXXXXXXGXXXXXXXXXXXXXXXXXXXGXXXXXXXXXXXXXXXXXXXGXXXXXXXXXXXXXXXXXXX,0,10,0
16044,14,1,13,127,459,0,0,472,234,238,GXXXXXXXXXXXXXXXXXXXGXXXXXXXXXXXXXXXXXXXGXXXXXXXXXXXXXXXXXXXGXXXXXXXXXXXXXXXXXXXGXXXXXXXXXXXXXXXXXXXGXXXXXXXXXXXXXXXXXXXGXXXXXXXXXXXXXXXXXXXGXXXXXXXXXXXXXXXXXXXGAXXXXXXXXXXXXXXXXXXGXXXXXXXXXXXXXXXXXXXGXXXXXXXXXXXXXXXXXXXGXXXXXXXXXXXXXXXXXXXGXXXXXXXXXXXXXXXXXXX,0,10,0

16065,14,0,14,128,458,0,0,472,235,237,GXXXXXXXXXXXXXXXXXXXGXXXXXXXXXXXXXXXXXXXGXXXXXXXXXXXXXXXXXXXGXXXXXXXXXXXXXXXXXXXGXXXXXXXXXXXXXXXXXXXGXXXXXXXXXXXXXXXXXXXGXXXXXXXXXXXXXXXXXXXGXXXXXXXXXXXXXXXXXXXGOXXXXXXXXXXXXXXXXXXGXXXXXXXXXXXXXXXXXXXGXXXXXXXXXXXXXXXXXXXGXXXXXXXXXXXXXXXXXXXGXXXXXXXXXXXXXXXXXXX,0,10,0
16086,15,1,14,126,459,0,0,470,236,234,GXXXXXXXXXXXXXXXXXXXGXXXXXXXXXXXXXXXXXXXGXXXXXXXXXXXXXXXXXXXGXXXXXXXXXXXXXXXXXXXGXXXXXXXXXXXXXXXXXXXGXXXXXXXXXXXXXXXXXXXGAXXXXXXXXXXXXXXXXXXGXXXXXXXXXXXXXXXXXXXGOXXXXXXXXXXXXXXXXXXGXXXXXXXXXXXXXXXXXXXGXXXXXXXXXXXXXXXXXXXGXXXXXXXXXXXXXXXXXXXGXXXXXXXXXXXXXXXXXXX,0,10,0
16107,14,1,13,126,460,0,0,473,237,236,GXXXXXXXXXXXXXXXXXXXGXXXXXXXXXXXXXXXXXXXGXXXXXXXXXXXXXXXXXXXGXXXXXXXXXXXXXXXXXXXGXXXXXXXXXXXXXXXXXXXGXXXXXXXXXXXXXXXXXXXGAXXXXXXXXXXXXXXXXXXGXXXXXXXXXXXXXXXXXXXGXXXXXXXXXXXXXXXXXXXGXXXXXXXXXXXXXXXXXXXGXXXXXXXXXXXXXXXXXXXGXXXXXXXXXXXXXXXXXXXGXXXXXXXXXXXXXXXXXXX,0,10,0
16128,14,1,13,133,453,0,0,468,239,229,GXXXXXXXXXXXXXXXXXXXGXXXXXXXXXXXXXXXXXXXGXXXXXXXXXXXXXXXXXXXGXXXXXXXXXXXXXXXXXXXGXXXXXXXXXXXXXXXXXXXGXXXXXXXXXXXXXXXXXXXGAXXXXXXXXXXXXXXXXXXGXXXXXXXXXXXXXXXXXXXGXXXXXXXXXXXXXXXXXXXGXXXXXXXXXXXXXXXXXXXGXXXXXXXXXXXXXXXXXXXGXXXXXXXXXXXXXXXXXXXGXXXXXXXXXXXXXXXXXXX,0,10,0
16149,14,1,13,137,449,0,0,466,239,227,GXXXXXXXXXXXXXXXXXXXGXXXXXXXXXXXXXXXXXXXGXXXXXXXXXXXXXXXXXXXGXXXXXXXXXXXXXXXXXXXGXXXXXXXXXXXXXXXXXXXGXXXXXXXXXXXXXXXXXXXGAXXXXXXXXXXXXXXXXXXGXXXXXXXXXXXXXXXXXXXGXXXXXXXXXXXXXXXXXXXGXXXXXXXXXXXXXXXXXXXGXXXXXXXXXXXXXXXXXXXGXXXXXXXXXXXXXXXXXXXGXXXXXXXXXXXXXXXXXXX,0,10,0

16170,14,1,13,139,447,0,0,463,232,231,GXXXXXXXXXXXXXXXXXXXGXXXXXXXXXXXXXXXXXXXGXXXXXXXXXXXXXXXXXXXGXXXXXXXXXXXXXXXXXXXGXXXXXXXXXXXXXXXXXXXGXXXXXXXXXXXXXXXXXXXGAXXXXXXXXXXXXXXXXXXGXXXXXXXXXXXXXXXXXXXGXXXXXXXXXXXXXXXXXXXGXXXXXXXXXXXXXXXXXXXGXXXXXXXXXXXXXXXXXXXGXXXXXXXXXXXXXXXXXXXGXXXXXXXXXXXXXXXXXXX,0,10,0
16191,14,1,13,138,448,0,0,465,239,226,GXXXXXXXXXXXXXXXXXXXGXXXXXXXXXXXXXXXXXXXGXXXXXXXXXXXXXXXXXXXGXXXXXXXXXXXXXXXXXXXGXXXXXXXXXXXXXXXXXXXGXXXXXXXXXXXXXXXXXXXGAXXXXXXXXXXXXXXXXXXGXXXXXXXXXXXXXXXXXXXGXXXXXXXXXXXXXXXXXXXGXXXXXXXXXXXXXXXXXXXGXXXXXXXXXXXXXXXXXXXGXXXXXXXXXXXXXXXXXXXGXXXXXXXXXXXXXXXXXXX,0,10,0
16212,15,2,13,137,448,0,0,465,232,233,GXXXXXXXXXXXXXXXXXXXGXXXXXXXXXXXXXXXXXXXGXXXXXXXXXXXXXXXXXXXGXXXXXXXXXXXXXXXXXXXGXXXXXXXXXXXXXXXXXXXGXXXXXXXXXXXXXXXXXXXGAAXXXXXXXXXXXXXXXXXGXXXXXXXXXXXXXXXXXXXGXXXXXXXXXXXXXXXXXXXGXXXXXXXXXXXXXXXXXXXGXXXXXXXXXXXXXXXXXXXGXXXXXXXXXXXXXXXXXXXGXXXXXXXXXXXXXXXXXXX,0,10,0
16233,16,3,13,129,455,0,0,472,233,239,GXXXXXXXXXXXXXXXXXXXGXXXXXXXXXXXXXXXXXXXGAXXXXXXXXXXXXXXXXXXGXXXXXXXXXXXXXXXXXXXGXXXXXXXXXXXXXXXXXXXGXXXXXXXXXXXXXXXXXXXGAAXXXXXXXXXXXXXXXXXGXXXXXXXXXXXXXXXXXXXGXXXXXXXXXXXXXXXXXXXGXXXXXXXXXXXXXXXXXXXGXXXXXXXXXXXXXXXXXXXGXXXXXXXXXXXXXXXXXXXGXXXXXXXXXXXXXXXXXXX,0,10,0
16254,16,3,13,126,458,0,0,475,238,237,GXXXXXXXXXXXXXXXXXXXGXXXXXXXXXXXXXXXXXXXGAXXXXXXXXXXXXXXXXXXGXXXXXXXXXXXXXXXXXXXGXXXXXXXXXXXXXXXXXXXGXXXXXXXXXXXXXXXXXXXGAAXXXXXXXXXXXXXXXXXGXXXXXXXXXXXXXXXXXXXGXXXXXXXXXXXXXXXXXXXGXXXXXXXXXXXXXXXXXXXGXXXXXXXXXXXXXXXXXXXGXXXXXXXXXXXXXXXXXXXGXXXXXXXXXXXXXXXXXXX,0,10,0

16275,16,3,13,141,443,0,0,460,237,223,GXXXXXXXXXXXXXXXXXXXGXXXXXXXXXXXXXXXXXXXGAXXXXXXXXXXXXXXXXXXGXXXXXXXXXXXXXXXXXXXGXXXXXXXXXXXXXXXXXXXGXXXXXXXXXXXXXXXXXXXGAAXXXXXXXXXXXXXXXXXGXXXXXXXXXXXXXXXXXXXGXXXXXXXXXXXXXXXXXXXGXXXXXXXXXXXXXXXXXXXGXXXXXXXXXXXXXXXXXXXGXXXXXXXXXXXXXXXXXXXGXXXXXXXXXXXXXXXXXXX,0,10,0
16296,16,3,13,139,445,0,0,460,242,218,GXXXXXXXXXXXXXXXXXXXGXXXXXXXXXXXXXXXXXXXGAXXXXXXXXXXXXXXXXXXGXXXXXXXXXXXXXXXXXXXGXXXXXXXXXXXXXXXXXXXGXXXXXXXXXXXXXXXXXXXGAAXXXXXXXXXXXXXXXXXGXXXXXXXXXXXXXXXXXXXGXXXXXXXXXXXXXXXXXXXGXXXXXXXXXXXXXXXXXXXGXXXXXXXXXXXXXXXXXXXGXXXXXXXXXXXXXXXXXXXGXXXXXXXXXXXXXXXXXXX,0,10,0
16317,16,3,13,145,439,0,0,456,235,221,GXXXXXXXXXXXXXXXXXXXGXXXXXXXXXXXXXXXXXXXGAXXXXXXXXXXXXXXXXXXGXXXXXXXXXXXXXXXXXXXGXXXXXXXXXXXXXXXXXXXGXXXXXXXXXXXXXXXXXXXGAAXXXXXXXXXXXXXXXXXGXXXXXXXXXXXXXXXXXXXGXXXXXXXXXXXXXXXXXXXGXXXXXXXXXXXXXXXXXXXGXXXXXXXXXXXXXXXXXXXGXXXXXXXXXXXXXXXXXXXGXXXXXXXXXXXXXXXXXXX,0,10,0
16338,16,3,13,141,443,0,0,457,241,216,GXXXXXXXXXXXXXXXXXXXGXXXXXXXXXXXXXXXXXXXGAXXXXXXXXXXXXXXXXXXGXXXXXXXXXXXXXXXXXXXGXXXXXXXXXXXXXXXXXXXGXXXXXXXXXXXXXXXXXXXGAAXXXXXXXXXXXXXXXXXGXXXXXXXXXXXXXXXXXXXGXXXXXXXXXXXXXXXXXXXGXXXXXXXXXXXXXXXXXXXGXXXXXXXXXXXXXXXXXXXGXXXXXXXXXXXXXXXXXXXGXXXXXXXXXXXXXXXXXXX,0,10,0
16359,17,4,13,135,448,0,0,463,252,211,GXXXXXXXXXXXXXXXXXXXGXXXXXXXXXXXXXXXXXXXGAXXXXXXXXXXXXXXXXXXGAXXXXXXXXXXXXXXXXXXGXXXXXXXXXXXXXXXXXXXGXXXXXXXXXXXXXXXXXXXGAAXXXXXXXXXXXXXXXXXGXXXXXXXXXXXXXXXXXXXGXXXXXXXXXXXXXXXXXXXGXXXXXXXXXXXXXXXXXXXGXXXXXXXXXXXXXXXXXXXGXXXXXXXXXXXXXXXXXXXGXXXXXXXXXXXXXXXXXXX,0,10,0

16380,17,4,13,137,446,0,0,459,242,217,GXXXXXXXXXXXXXXXXXXXGXXXXXXXXXXXXXXXXXXXGAXXXXXXXXXXXXXXXXXXGAXXXXXXXXXXXXXXXXXXGXXXXXXXXXXXXXXXXXXXGXXXXXXXXXXXXXXXXXXXGAAXXXXXXXXXXXXXXXXXGXXXXXXXXXXXXXXXXXXXGXXXXXXXXXXXXXXXXXXXGXXXXXXXXXXXXXXXXXXXGXXXXXXXXXXXXXXXXXXXGXXXXXXXXXXXXXXXXXXXGXXXXXXXXXXXXXXXXXXX,0,10,0
16401,15,2,13,141,444,0,0,458,236,222,GXXXXXXXXXXXXXXXXXXXGXXXXXXXXXXXXXXXXXXXGXXXXXXXXXXXXXXXXXXXGAXXXXXXXXXXXXXXXXXXGXXXXXXXXXXXXXXXXXXXGXXXXXXXXXXXXXXXXXXXGXAXXXXXXXXXXXXXXXXXGXXXXXXXXXXXXXXXXXXXGXXXXXXXXXXXXXXXXXXXGXXXXXXXXXXXXXXXXXXXGXXXXXXXXXXXXXXXXXXXGXXXXXXXXXXXXXXXXXXXGXXXXXXXXXXXXXXXXXXX,0,10,0
16422,14,1,13,147,439,0,0,455,233,222,GXXXXXXXXXXXXXXXXXXXGXXXXXXXXXXXXXXXXXXXGXXXXXXXXXXXXXXXXXXXGAXXXXXXXXXXXXXXXXXXGXXXXXXXXXXXXXXXXXXXGXXXXXXXXXXXXXXXXXXXGXXXXXXXXXXXXXXXXXXXGXXXXXXXXXXXXXXXXXXXGXXXXXXXXXXXXXXXXXXXGXXXXXXXXXXXXXXXXXXXGXXXXXXXXXXXXXXXXXXXGXXXXXXXXXXXXXXXXXXXGXXXXXXXXXXXXXXXXXXX,0,10,0
16443,14,1,13,143,443,0,0,457,236,221,GXXXXXXXXXXXXXXXXXXXGXXXXXXXXXXXXXXXXXXXGXXXXXXXXXXXXXXXXXXXGAXXXXXXXXXXXXXXXXXXGXXXXXXXXXXXXXXXXXXXGXXXXXXXXXXXXXXXXXXXGXXXXXXXXXXXXXXXXXXXGXXXXXXXXXXXXXXXXXXXGXXXXXXXXXXXXXXXXXXXGXXXXXXXXXXXXXXXXXXXGXXXXXXXXXXXXXXXXXXXGXXXXXXXXXXXXXXXXXXXGXXXXXXXXXXXXXXXXXXX,0,10,0
16464,13,0,13,136,451,0,0,466,238,228,GXXXXXXXXXXXXXXXXXXXGXXXXXXXXXXXXXXXXXXXGXXXXXXXXXXXXXXXXXXXGXXXXXXXXXXXXXXXXXXXGXXXXXXXXXXXXXXXXXXXGXXXXXXXXXXXXXXXXXXXGXXXXXXXXXXXXXXXXXXXGXXXXXXXXXXXXXXXXXXXGXXXXXXXXXXXXXXXXXXXGXXXXXXXXXXXXXXXXXXXGXXXXXXXXXXXXXXXXXXXGXXXXXXXXXXXXXXXXXXXGXXXXXXXXXXXXXXXXXXX,0,10,0

16485,13,0,13,137,450,0,0,465,230,235,GXXXXXXXXXXXXXXXXXXXGXXXXXXXXXXXXXXXXXXXGXXXXXXXXXXXXXXXXXXXGXXXXXXXXXXXXXXXXXXXGXXXXXXXXXXXXXXXXXXXGXXXXXXXXXXXXXXXXXXXGXXXXXXXXXXXXXXXXXXXGXXXXXXXXXXXXXXXXXXXGXXXXXXXXXXXXXXXXXXXGXXXXXXXXXXXXXXXXXXXGXXXXXXXXXXXXXXXXXXXGXXXXXXXXXXXXXXXXXXXGXXXXXXXXXXXXXXXXXXX,0,10,0
16506,13,0,13,136,451,0,0,465,235,230,GXXXXXXXXXXXXXXXXXXXGXXXXXXXXXXXXXXXXXXXGXXXXXXXXXXXXXXXXXXXGXXXXXXXXXXXXXXXXXXXGXXXXXXXXXXXXXXXXXXXGXXXXXXXXXXXXXXXXXXXGXXXXXXXXXXXXXXXXXXXGXXXXXXXXXXXXXXXXXXXGXXXXXXXXXXXXXXXXXXXGXXXXXXXXXXXXXXXXXXXGXXXXXXXXXXXXXXXXXXXGXXXXXXXXXXXXXXXXXXXGXXXXXXXXXXXXXXXXXXX,0,10,0
16527,13,0,13,138,449,0,0,463,235,228,GXXXXXXXXXXXXXXXXXXXGXXXXXXXXXXXXXXXXXXXGXXXXXXXXXXXXXXXXXXXGXXXXXXXXXXXXXXXXXXXGXXXXXXXXXXXXXXXXXXXGXXXXXXXXXXXXXXXXXXXGXXXXXXXXXXXXXXXXXXXGXXXXXXXXXXXXXXXXXXXGXXXXXXXXXXXXXXXXXXXGXXXXXXXXXXXXXXXXXXXGXXXXXXXXXXXXXXXXXXXGXXXXXXXXXXXXXXXXXXXGXXXXXXXXXXXXXXXXXXX,0,10,0
16548,13,0,13,137,450,0,0,464,242,222,GXXXXXXXXXXXXXXXXXXXGXXXXXXXXXXXXXXXXXXXGXXXXXXXXXXXXXXXXXXXGXXXXXXXXXXXXXXXXXXXGXXXXXXXXXXXXXXXXXXXGXXXXXXXXXXXXXXXXXXXGXXXXXXXXXXXXXXXXXXXGXXXXXXXXXXXXXXXXXXXGXXXXXXXXXXXXXXXXXXXGXXXXXXXXXXXXXXXXXXXGXXXXXXXXXXXXXXXXXXXGXXXXXXXXXXXXXXXXXXXGXXXXXXXXXXXXXXXXXXX,0,10,0
16569,13,0,13,136,451,0,0,465,235,230,GXXXXXXXXXXXXXXXXXXXGXXXXXXXXXXXXXXXXXXXGXXXXXXXXXXXXXXXXXXXGXXXXXXXXXXXXXXXXXXXGXXXXXXXXXXXXXXXXXXXGXXXXXXXXXXXXXXXXXXXGXXXXXXXXXXXXXXXXXXXGXXXXXXXXXXXXXXXXXXXGXXXXXXXXXXXXXXXXXXXGXXXXXXXXXXXXXXXXXXXGXXXXXXXXXXXXXXXXXXXGXXXXXXXXXXXXXXXXXXXGXXXXXXXXXXXXXXXXXXX,0,10,0

16590,13,0,13,137,450,0,0,464,230,234,GXXXXXXXXXXXXXXXXXXXGXXXXXXXXXXXXXXXXXXXGXXXXXXXXXXXXXXXXXXXGXXXXXXXXXXXXXXXXXXXGXXXXXXXXXXXXXXXXXXXGXXXXXXXXXXXXXXXXXXXGXXXXXXXXXXXXXXXXXXXGXXXXXXXXXXXXXXXXXXXGXXXXXXXXXXXXXXXXXXXGXXXXXXXXXXXXXXXXXXXGXXXXXXXXXXXXXXXXXXXGXXXXXXXXXXXXXXXXXXXGXXXXXXXXXXXXXXXXXXX,0,10,0
16611,13,0,13,135,452,0,0,465,232,233,GXXXXXXXXXXXXXXXXXXXGXXXXXXXXXXXXXXXXXXXGXXXXXXXXXXXXXXXXXXXGXXXXXXXXXXXXXXXXXXXGXXXXXXXXXXXXXXXXXXXGXXXXXXXXXXXXXXXXXXXGXXXXXXXXXXXXXXXXXXXGXXXXXXXXXXXXXXXXXXXGXXXXXXXXXXXXXXXXXXXGXXXXXXXXXXXXXXXXXXXGXXXXXXXXXXXXXXXXXXXGXXXXXXXXXXXXXXXXXXXGXXXXXXXXXXXXXXXXXXX,0,10,0
16632,13,0,13,134,453,0,0,466,237,229,GXXXXXXXXXXXXXXXXXXXGXXXXXXXXXXXXXXXXXXXGXXXXXXXXXXXXXXXXXXXGXXXXXXXXXXXXXXXXXXXGXXXXXXXXXXXXXXXXXXXGXXXXXXXXXXXXXXXXXXXGXXXXXXXXXXXXXXXXXXXGXXXXXXXXXXXXXXXXXXXGXXXXXXXXXXXXXXXXXXXGXXXXXXXXXXXXXXXXXXXGXXXXXXXXXXXXXXXXXXXGXXXXXXXXXXXXXXXXXXXGXXXXXXXXXXXXXXXXXXX,0,10,0
16653,14,1,13,139,447,0,0,460,241,219,GXXXXXXXXXXXXXXXXXXXGXXXXXXXXXXXXXXXXXXXGAXXXXXXXXXXXXXXXXXXGXXXXXXXXXXXXXXXXXXXGXXXXXXXXXXXXXXXXXXXGXXXXXXXXXXXXXXXXXXXGXXXXXXXXXXXXXXXXXXXGXXXXXXXXXXXXXXXXXXXGXXXXXXXXXXXXXXXXXXXGXXXXXXXXXXXXXXXXXXXGXXXXXXXXXXXXXXXXXXXGXXXXXXXXXXXXXXXXXXXGXXXXXXXXXXXXXXXXXXX,0,10,0
16674,14,1,13,132,454,0,0,466,239,227,GXXXXXXXXXXXXXXXXXXXGXXXXXXXXXXXXXXXXXXXGAXXXXXXXXXXXXXXXXXXGXXXXXXXXXXXXXXXXXXXGXXXXXXXXXXXXXXXXXXXGXXXXXXXXXXXXXXXXXXXGXXXXXXXXXXXXXXXXXXXGXXXXXXXXXXXXXXXXXXXGXXXXXXXXXXXXXXXXXXXGXXXXXXXXXXXXXXXXXXXGXXXXXXXXXXXXXXXXXXXGXXXXXXXXXXXXXXXXXXXGXXXXXXXXXXXXXXXXXXX,0,10,0

16695,14,1,13,136,450,0,0,462,239,223,GXXXXXXXXXXXXXXXXXXXGXXXXXXXXXXXXXXXXXXXGAXXXXXXXXXXXXXXXXXXGXXXXXXXXXXXXXXXXXXXGXXXXXXXXXXXXXXXXXXXGXXXXXXXXXXXXXXXXXXXGXXXXXXXXXXXXXXXXXXXGXXXXXXXXXXXXXXXXXXXGXXXXXXXXXXXXXXXXXXXGXXXXXXXXXXXXXXXXXXXGXXXXXXXXXXXXXXXXXXXGXXXXXXXXXXXXXXXXXXXGXXXXXXXXXXXXXXXXXXX,0,10,0
16716,14,1,13,139,447,0,0,458,235,223,GXXXXXXXXXXXXXXXXXXXGXXXXXXXXXXXXXXXXXXXGAXXXXXXXXXXXXXXXXXXGXXXXXXXXXXXXXXXXXXXGXXXXXXXXXXXXXXXXXXXGXXXXXXXXXXXXXXXXXXXGXXXXXXXXXXXXXXXXXXXGXXXXXXXXXXXXXXXXXXXGXXXXXXXXXXXXXXXXXXXGXXXXXXXXXXXXXXXXXXXGXXXXXXXXXXXXXXXXXXXGXXXXXXXXXXXXXXXXXXXGXXXXXXXXXXXXXXXXXXX,0,10,0
16737,14,1,13,142,444,0,0,457,234,223,GXXXXXXXXXXXXXXXXXXXGXXXXXXXXXXXXXXXXXXXGAXXXXXXXXXXXXXXXXXXGXXXXXXXXXXXXXXXXXXXGXXXXXXXXXXXXXXXXXXXGXXXXXXXXXXXXXXXXXXXGXXXXXXXXXXXXXXXXXXXGXXXXXXXXXXXXXXXXXXXGXXXXXXXXXXXXXXXXXXXGXXXXXXXXXXXXXXXXXXXGXXXXXXXXXXXXXXXXXXXGXXXXXXXXXXXXXXXXXXXGXXXXXXXXXXXXXXXXXXX,0,10,0
16758,14,1,13,136,450,0,0,463,232,231,GXXXXXXXXXXXXXXXXXXXGXXXXXXXXXXXXXXXXXXXGAXXXXXXXXXXXXXXXXXXGXXXXXXXXXXXXXXXXXXXGXXXXXXXXXXXXXXXXXXXGXXXXXXXXXXXXXXXXXXXGXXXXXXXXXXXXXXXXXXXGXXXXXXXXXXXXXXXXXXXGXXXXXXXXXXXXXXXXXXXGXXXXXXXXXXXXXXXXXXXGXXXXXXXXXXXXXXXXXXXGXXXXXXXXXXXXXXXXXXXGXXXXXXXXXXXXXXXXXXX,0,10,0
16779,14,1,13,137,449,0,0,462,234,228,GXXXXXXXXXXXXXXXXXXXGXXXXXXXXXXXXXXXXXXXGAXXXXXXXXXXXXXXXXXXGXXXXXXXXXXXXXXXXXXXGXXXXXXXXXXXXXXXXXXXGXXXXXXXXXXXXXXXXXXXGXXXXXXXXXXXXXXXXXXXGXXXXXXXXXXXXXXXXXXXGXXXXXXXXXXXXXXXXXXXGXXXXXXXXXXXXXXXXXXXGXXXXXXXXXXXXXXXXXXXGXXXXXXXXXXXXXXXXXXXGXXXXXXXXXXXXXXXXXXX,0,10,0

16800,14,1,13,138,448,0,0,462,236,226,GXXXXXXXXXXXXXXXXXXXGXXXXXXXXXXXXXXXXXXXGAXXXXXXXXXXXXXXXXXXGXXXXXXXXXXXXXXXXXXXGXXXXXXXXXXXXXXXXXXXGXXXXXXXXXXXXXXXXXXXGXXXXXXXXXXXXXXXXXXXGXXXXXXXXXXXXXXXXXXXGXXXXXXXXXXXXXXXXXXXGXXXXXXXXXXXXXXXXXXXGXXXXXXXXXXXXXXXXXXXGXXXXXXXXXXXXXXXXXXXGXXXXXXXXXXXXXXXXXXX,0,10,0
16821,13,0,13,137,450,0,0,463,236,227,GXXXXXXXXXXXXXXXXXXXGXXXXXXXXXXXXXXXXXXXGXXXXXXXXXXXXXXXXXXXGXXXXXXXXXXXXXXXXXXXGXXXXXXXXXXXXXXXXXXXGXXXXXXXXXXXXXXXXXXXGXXXXXXXXXXXXXXXXXXXGXXXXXXXXXXXXXXXXXXXGXXXXXXXXXXXXXXXXXXXGXXXXXXXXXXXXXXXXXXXGXXXXXXXXXXXXXXXXXXXGXXXXXXXXXXXXXXXXXXXGXXXXXXXXXXXXXXXXXXX,0,10,0
16842,13,0,13,137,450,0,0,465,233,232,GXXXXXXXXXXXXXXXXXXXGXXXXXXXXXXXXXXXXXXXGXXXXXXXXXXXXXXXXXXXGXXXXXXXXXXXXXXXXXXXGXXXXXXXXXXXXXXXXXXXGXXXXXXXXXXXXXXXXXXXGXXXXXXXXXXXXXXXXXXXGXXXXXXXXXXXXXXXXXXXGXXXXXXXXXXXXXXXXXXXGXXXXXXXXXXXXXXXXXXXGXXXXXXXXXXXXXXXXXXXGXXXXXXXXXXXXXXXXXXXGXXXXXXXXXXXXXXXXXXX,0,10,0
16863,13,0,13,131,456,0,0,470,235,235,GXXXXXXXXXXXXXXXXXXXGXXXXXXXXXXXXXXXXXXXGXXXXXXXXXXXXXXXXXXXGXXXXXXXXXXXXXXXXXXXGXXXXXXXXXXXXXXXXXXXGXXXXXXXXXXXXXXXXXXXGXXXXXXXXXXXXXXXXXXXGXXXXXXXXXXXXXXXXXXXGXXXXXXXXXXXXXXXXXXXGXXXXXXXXXXXXXXXXXXXGXXXXXXXXXXXXXXXXXXXGXXXXXXXXXXXXXXXXXXXGXXXXXXXXXXXXXXXXXXX,0,10,0
16884,13,0,13,126,461,0,0,474,240,234,GXXXXXXXXXXXXXXXXXXXGXXXXXXXXXXXXXXXXXXXGXXXXXXXXXXXXXXXXXXXGXXXXXXXXXXXXXXXXXXXGXXXXXXXXXXXXXXXXXXXGXXXXXXXXXXXXXXXXXXXGXXXXXXXXXXXXXXXXXXXGXXXXXXXXXXXXXXXXXXXGXXXXXXXXXXXXXXXXXXXGXXXXXXXXXXXXXXXXXXXGXXXXXXXXXXXXXXXXXXXGXXXXXXXXXXXXXXXXXXXGXXXXXXXXXXXXXXXXXXX,0,10,0

16905,13,0,13,123,464,0,0,478,243,235,GXXXXXXXXXXXXXXXXXXXGXXXXXXXXXXXXXXXXXXXGXXXXXXXXXXXXXXXXXXXGXXXXXXXXXXXXXXXXXXXGXXXXXXXXXXXXXXXXXXXGXXXXXXXXXXXXXXXXXXXGXXXXXXXXXXXXXXXXXXXGXXXXXXXXXXXXXXXXXXXGXXXXXXXXXXXXXXXXXXXGXXXXXXXXXXXXXXXXXXXGXXXXXXXXXXXXXXXXXXXGXXXXXXXXXXXXXXXXXXXGXXXXXXXXXXXXXXXXXXX,0,10,0
16926,14,1,13,119,467,0,0,481,240,241,GXXXXXXXXXXXXXXXXXXXGXXXXXXXXXXXXXXXXXXXGXXXXXXXXXXXXXXXXXXXGXXXXXXXXXXXXXXXXXXXGXXXXXXXXXXXXXXXXXXXGXXXXXXXXXXXXXXXXXXXGXXXXXXXXXXXXXXXXXXXGXXXXXXXXXXXXXXXXXXXGXXXXXXXXXXXXXXXXXXXGXXXXXXXXXXXXXXXXXXXGAXXXXXXXXXXXXXXXXXXGXXXXXXXXXXXXXXXXXXXGXXXXXXXXXXXXXXXXXXX,0,10,0
16947,14,1,13,119,467,0,0,481,246,235,GXXXXXXXXXXXXXXXXXXXGXXXXXXXXXXXXXXXXXXXGXXXXXXXXXXXXXXXXXXXGXXXXXXXXXXXXXXXXXXXGXXXXXXXXXXXXXXXXXXXGXXXXXXXXXXXXXXXXXXXGXXXXXXXXXXXXXXXXXXXGXXXXXXXXXXXXXXXXXXXGXXXXXXXXXXXXXXXXXXXGXXXXXXXXXXXXXXXXXXXGAXXXXXXXXXXXXXXXXXXGXXXXXXXXXXXXXXXXXXXGXXXXXXXXXXXXXXXXXXX,0,10,0
16968,14,1,13,121,465,0,0,478,247,231,GXXXXXXXXXXXXXXXXXXXGXXXXXXXXXXXXXXXXXXXGXXXXXXXXXXXXXXXXXXXGXXXXXXXXXXXXXXXXXXXGXXXXXXXXXXXXXXXXXXXGXXXXXXXXXXXXXXXXXXXGXXXXXXXXXXXXXXXXXXXGXXXXXXXXXXXXXXXXXXXGXXXXXXXXXXXXXXXXXXXGXXXXXXXXXXXXXXXXXXXGAXXXXXXXXXXXXXXXXXXGXXXXXXXXXXXXXXXXXXXGXXXXXXXXXXXXXXXXXXX,0,10,0
16989,14,1,13,129,457,0,0,471,247,224,GXXXXXXXXXXXXXXXXXXXGXXXXXXXXXXXXXXXXXXXGXXXXXXXXXXXXXXXXXXXGXXXXXXXXXXXXXXXXXXXGXXXXXXXXXXXXXXXXXXXGXXXXXXXXXXXXXXXXXXXGXXXXXXXXXXXXXXXXXXXGXXXXXXXXXXXXXXXXXXXGXXXXXXXXXXXXXXXXXXXGXXXXXXXXXXXXXXXXXXXGAXXXXXXXXXXXXXXXXXXGXXXXXXXXXXXXXXXXXXXGXXXXXXXXXXXXXXXXXXX,0,10,0

17010,14,0,14,124,462,0,0,475,247,228,GXXXXXXXXXXXXXXXXXXXGXXXXXXXXXXXXXXXXXXXGXXXXXXXXXXXXXXXXXXXGXXXXXXXXXXXXXXXXXXXGXXXXXXXXXXXXXXXXXXXGXXXXXXXXXXXXXXXXXXXGXXXXXXXXXXXXXXXXXXXGXXXXXXXXXXXXXXXXXXXGXXXXXXXXXXXXXXXXXXXGXXXXXXXXXXXXXXXXXXXGOXXXXXXXXXXXXXXXXXXGXXXXXXXXXXXXXXXXXXXGXXXXXXXXXXXXXXXXXXX,0,10,0
17031,14,0,14,126,460,0,0,472,242,230,GXXXXXXXXXXXXXXXXXXXGXXXXXXXXXXXXXXXXXXXGXXXXXXXXXXXXXXXXXXXGXXXXXXXXXXXXXXXXXXXGXXXXXXXXXXXXXXXXXXXGXXXXXXXXXXXXXXXXXXXGXXXXXXXXXXXXXXXXXXXGXXXXXXXXXXXXXXXXXXXGXXXXXXXXXXXXXXXXXXXGXXXXXXXXXXXXXXXXXXXGOXXXXXXXXXXXXXXXXXXGXXXXXXXXXXXXXXXXXXXGXXXXXXXXXXXXXXXXXXX,0,10,0
17052,14,1,13,121,465,0,0,478,250,228,GXXXXXXXXXXXXXXXXXXXGXXXXXXXXXXXXXXXXXXXGAXXXXXXXXXXXXXXXXXXGXXXXXXXXXXXXXXXXXXXGXXXXXXXXXXXXXXXXXXXGXXXXXXXXXXXXXXXXXXXGXXXXXXXXXXXXXXXXXXXGXXXXXXXXXXXXXXXXXXXGXXXXXXXXXXXXXXXXXXXGXXXXXXXXXXXXXXXXXXXGXXXXXXXXXXXXXXXXXXXGXXXXXXXXXXXXXXXXXXXGXXXXXXXXXXXXXXXXXXX,0,10,0
17073,14,1,13,130,456,0,0,469,249,220,GXXXXXXXXXXXXXXXXXXXGXXXXXXXXXXXXXXXXXXXGAXXXXXXXXXXXXXXXXXXGXXXXXXXXXXXXXXXXXXXGXXXXXXXXXXXXXXXXXXXGXXXXXXXXXXXXXXXXXXXGXXXXXXXXXXXXXXXXXXXGXXXXXXXXXXXXXXXXXXXGXXXXXXXXXXXXXXXXXXXGXXXXXXXXXXXXXXXXXXXGXXXXXXXXXXXXXXXXXXXGXXXXXXXXXXXXXXXXXXXGXXXXXXXXXXXXXXXXXXX,0,10,0
17094,14,1,13,134,452,0,0,465,252,213,GXXXXXXXXXXXXXXXXXXXGXXXXXXXXXXXXXXXXXXXGAXXXXXXXXXXXXXXXXXXGXXXXXXXXXXXXXXXXXXXGXXXXXXXXXXXXXXXXXXXGXXXXXXXXXXXXXXXXXXXGXXXXXXXXXXXXXXXXXXXGXXXXXXXXXXXXXXXXXXXGXXXXXXXXXXXXXXXXXXXGXXXXXXXXXXXXXXXXXXXGXXXXXXXXXXXXXXXXXXXGXXXXXXXXXXXXXXXXXXXGXXXXXXXXXXXXXXXXXXX,0,10,0

17115,14,1,13,136,450,0,0,463,252,211,GXXXXXXXXXXXXXXXXXXXGXXXXXXXXXXXXXXXXXXXGAXXXXXXXXXXXXXXXXXXGXXXXXXXXXXXXXXXXXXXGXXXXXXXXXXXXXXXXXXXGXXXXXXXXXXXXXXXXXXXGXXXXXXXXXXXXXXXXXXXGXXXXXXXXXXXXXXXXXXXGXXXXXXXXXXXXXXXXXXXGXXXXXXXXXXXXXXXXXXXGXXXXXXXXXXXXXXXXXXXGXXXXXXXXXXXXXXXXXXXGXXXXXXXXXXXXXXXXXXX,0,10,0
17136,15,2,13,141,444,0,0,457,241,216,GXXXXXXXXXXXXXXXXXXXGXXXXXXXXXXXXXXXXXXXGAXXXXXXXXXXXXXXXXXXGXXXXXXXXXXXXXXXXXXXGXXXXXXXXXXXXXXXXXXXGXXXXXXXXXXXXXXXXXXXGXXXXXXXXXXXXXXXXXXXGAXXXXXXXXXXXXXXXXXXGXXXXXXXXXXXXXXXXXXXGXXXXXXXXXXXXXXXXXXXGXXXXXXXXXXXXXXXXXXXGXXXXXXXXXXXXXXXXXXXGXXXXXXXXXXXXXXXXXXX,0,10,0
17157,15,2,13,137,448,0,0,461,241,220,GXXXXXXXXXXXXXXXXXXXGXXXXXXXXXXXXXXXXXXXGAXXXXXXXXXXXXXXXXXXGXXXXXXXXXXXXXXXXXXXGXXXXXXXXXXXXXXXXXXXGXXXXXXXXXXXXXXXXXXXGXXXXXXXXXXXXXXXXXXXGAXXXXXXXXXXXXXXXXXXGXXXXXXXXXXXXXXXXXXXGXXXXXXXXXXXXXXXXXXXGXXXXXXXXXXXXXXXXXXXGXXXXXXXXXXXXXXXXXXXGXXXXXXXXXXXXXXXXXXX,0,10,0
17178,15,2,13,134,451,0,0,463,244,219,GXXXXXXXXXXXXXXXXXXXGXXXXXXXXXXXXXXXXXXXGAXXXXXXXXXXXXXXXXXXGXXXXXXXXXXXXXXXXXXXGXXXXXXXXXXXXXXXXXXXGXXXXXXXXXXXXXXXXXXXGXXXXXXXXXXXXXXXXXXXGAXXXXXXXXXXXXXXXXXXGXXXXXXXXXXXXXXXXXXXGXXXXXXXXXXXXXXXXXXXGXXXXXXXXXXXXXXXXXXXGXXXXXXXXXXXXXXXXXXXGXXXXXXXXXXXXXXXXXXX,0,10,0
17199,15,2,13,146,439,0,0,452,240,212,GXXXXXXXXXXXXXXXXXXXGXXXXXXXXXXXXXXXXXXXGAXXXXXXXXXXXXXXXXXXGXXXXXXXXXXXXXXXXXXXGXXXXXXXXXXXXXXXXXXXGXXXXXXXXXXXXXXXXXXXGXXXXXXXXXXXXXXXXXXXGAXXXXXXXXXXXXXXXXXXGXXXXXXXXXXXXXXXXXXXGXXXXXXXXXXXXXXXXXXXGXXXXXXXXXXXXXXXXXXXGXXXXXXXXXXXXXXXXXXXGXXXXXXXXXXXXXXXXXXX,0,10,0

17220,15,2,13,134,451,0,0,463,239,224,GXXXXXXXXXXXXXXXXXXXGXXXXXXXXXXXXXXXXXXXGAXXXXXXXXXXXXXXXXXXGXXXXXXXXXXXXXXXXXXXGXXXXXXXXXXXXXXXXXXXGXXXXXXXXXXXXXXXXXXXGXXXXXXXXXXXXXXXXXXXGAXXXXXXXXXXXXXXXXXXGXXXXXXXXXXXXXXXXXXXGXXXXXXXXXXXXXXXXXXXGXXXXXXXXXXXXXXXXXXXGXXXXXXXXXXXXXXXXXXXGXXXXXXXXXXXXXXXXXXX,0,10,0
17241,15,2,13,128,457,0,0,470,244,226,GXXXXXXXXXXXXXXXXXXXGXXXXXXXXXXXXXXXXXXXGAXXXXXXXXXXXXXXXXXXGXXXXXXXXXXXXXXXXXXXGXXXXXXXXXXXXXXXXXXXGXXXXXXXXXXXXXXXXXXXGXXXXXXXXXXXXXXXXXXXGAXXXXXXXXXXXXXXXXXXGXXXXXXXXXXXXXXXXXXXGXXXXXXXXXXXXXXXXXXXGXXXXXXXXXXXXXXXXXXXGXXXXXXXXXXXXXXXXXXXGXXXXXXXXXXXXXXXXXXX,0,10,0
17262,15,2,13,128,457,0,0,469,246,223,GXXXXXXXXXXXXXXXXXXXGXXXXXXXXXXXXXXXXXXXGAXXXXXXXXXXXXXXXXXXGXXXXXXXXXXXXXXXXXXXGXXXXXXXXXXXXXXXXXXXGXXXXXXXXXXXXXXXXXXXGXXXXXXXXXXXXXXXXXXXGAXXXXXXXXXXXXXXXXXXGXXXXXXXXXXXXXXXXXXXGXXXXXXXXXXXXXXXXXXXGXXXXXXXXXXXXXXXXXXXGXXXXXXXXXXXXXXXXXXXGXXXXXXXXXXXXXXXXXXX,0,10,0
17283,16,3,13,126,458,0,0,471,251,220,GXXXXXXXXXXXXXXXXXXXGXXXXXXXXXXXXXXXXXXXGAXXXXXXXXXXXXXXXXXXGXXXXXXXXXXXXXXXXXXXGAXXXXXXXXXXXXXXXXXXGXXXXXXXXXXXXXXXXXXXGXXXXXXXXXXXXXXXXXXXGAXXXXXXXXXXXXXXXXXXGXXXXXXXXXXXXXXXXXXXGXXXXXXXXXXXXXXXXXXXGXXXXXXXXXXXXXXXXXXXGXXXXXXXXXXXXXXXXXXXGXXXXXXXXXXXXXXXXXXX,0,10,0
17304,16,3,13,123,461,0,0,474,245,229,GXXXXXXXXXXXXXXXXXXXGXXXXXXXXXXXXXXXXXXXGAXXXXXXXXXXXXXXXXXXGXXXXXXXXXXXXXXXXXXXGAXXXXXXXXXXXXXXXXXXGXXXXXXXXXXXXXXXXXXXGXXXXXXXXXXXXXXXXXXXGAXXXXXXXXXXXXXXXXXXGXXXXXXXXXXXXXXXXXXXGXXXXXXXXXXXXXXXXXXXGXXXXXXXXXXXXXXXXXXXGXXXXXXXXXXXXXXXXXXXGXXXXXXXXXXXXXXXXXXX,0,10,0

17325,16,3,13,127,457,0,0,469,238,231,GXXXXXXXXXXXXXXXXXXXGXXXXXXXXXXXXXXXXXXXGAXXXXXXXXXXXXXXXXXXGXXXXXXXXXXXXXXXXXXXGAXXXXXXXXXXXXXXXXXXGXXXXXXXXXXXXXXXXXXXGXXXXXXXXXXXXXXXXXXXGAXXXXXXXXXXXXXXXXXXGXXXXXXXXXXXXXXXXXXXGXXXXXXXXXXXXXXXXXXXGXXXXXXXXXXXXXXXXXXXGXXXXXXXXXXXXXXXXXXXGXXXXXXXXXXXXXXXXXXX,0,10,0
17346,15,2,13,126,459,0,0,472,251,221,GXXXXXXXXXXXXXXXXXXXGXXXXXXXXXXXXXXXXXXXGAXXXXXXXXXXXXXXXXXXGXXXXXXXXXXXXXXXXXXXGAXXXXXXXXXXXXXXXXXXGXXXXXXXXXXXXXXXXXXXGXXXXXXXXXXXXXXXXXXXGXXXXXXXXXXXXXXXXXXXGXXXXXXXXXXXXXXXXXXXGXXXXXXXXXXXXXXXXXXXGXXXXXXXXXXXXXXXXXXXGXXXXXXXXXXXXXXXXXXXGXXXXXXXXXXXXXXXXXXX,0,10,0
17367,15,2,13,124,461,0,0,474,253,221,GXXXXXXXXXXXXXXXXXXXGXXXXXXXXXXXXXXXXXXXGAXXXXXXXXXXXXXXXXXXGXXXXXXXXXXXXXXXXXXXGAXXXXXXXXXXXXXXXXXXGXXXXXXXXXXXXXXXXXXXGXXXXXXXXXXXXXXXXXXXGXXXXXXXXXXXXXXXXXXXGXXXXXXXXXXXXXXXXXXXGXXXXXXXXXXXXXXXXXXXGXXXXXXXXXXXXXXXXXXXGXXXXXXXXXXXXXXXXXXXGXXXXXXXXXXXXXXXXXXX,0,10,0
17388,15,2,13,130,455,0,0,469,244,225,GXXXXXXXXXXXXXXXXXXXGXXXXXXXXXXXXXXXXXXXGAXXXXXXXXXXXXXXXXXXGXXXXXXXXXXXXXXXXXXXGAXXXXXXXXXXXXXXXXXXGXXXXXXXXXXXXXXXXXXXGXXXXXXXXXXXXXXXXXXXGXXXXXXXXXXXXXXXXXXXGXXXXXXXXXXXXXXXXXXXGXXXXXXXXXXXXXXXXXXXGXXXXXXXXXXXXXXXXXXXGXXXXXXXXXXXXXXXXXXXGXXXXXXXXXXXXXXXXXXX,0,10,0
17409,15,2,13,126,459,0,0,474,244,230,GXXXXXXXXXXXXXXXXXXXGXXXXXXXXXXXXXXXXXXXGAXXXXXXXXXXXXXXXXXXGXXXXXXXXXXXXXXXXXXXGAXXXXXXXXXXXXXXXXXXGXXXXXXXXXXXXXXXXXXXGXXXXXXXXXXXXXXXXXXXGXXXXXXXXXXXXXXXXXXXGXXXXXXXXXXXXXXXXXXXGXXXXXXXXXXXXXXXXXXXGXXXXXXXXXXXXXXXXXXXGXXXXXXXXXXXXXXXXXXXGXXXXXXXXXXXXXXXXXXX,0,10,0

17430,15,2,13,123,462,0,0,477,249,228,GXXXXXXXXXXXXXXXXXXXGXXXXXXXXXXXXXXXXXXXGAXXXXXXXXXXXXXXXXXXGXXXXXXXXXXXXXXXXXXXGAXXXXXXXXXXXXXXXXXXGXXXXXXXXXXXXXXXXXXXGXXXXXXXXXXXXXXXXXXXGXXXXXXXXXXXXXXXXXXXGXXXXXXXXXXXXXXXXXXXGXXXXXXXXXXXXXXXXXXXGXXXXXXXXXXXXXXXXXXXGXXXXXXXXXXXXXXXXXXXGXXXXXXXXXXXXXXXXXXX,0,10,0
17451,15,2,13,125,460,0,0,476,250,226,GXXXXXXXXXXXXXXXXXXXGXXXXXXXXXXXXXXXXXXXGAXXXXXXXXXXXXXXXXXXGXXXXXXXXXXXXXXXXXXXGAXXXXXXXXXXXXXXXXXXGXXXXXXXXXXXXXXXXXXXGXXXXXXXXXXXXXXXXXXXGXXXXXXXXXXXXXXXXXXXGXXXXXXXXXXXXXXXXXXXGXXXXXXXXXXXXXXXXXXXGXXXXXXXXXXXXXXXXXXXGXXXXXXXXXXXXXXXXXXXGXXXXXXXXXXXXXXXXXXX,0,10,0
17472,14,1,13,126,460,0,0,474,247,227,GXXXXXXXXXXXXXXXXXXXGXXXXXXXXXXXXXXXXXXXGXXXXXXXXXXXXXXXXXXXGXXXXXXXXXXXXXXXXXXXGAXXXXXXXXXXXXXXXXXXGXXXXXXXXXXXXXXXXXXXGXXXXXXXXXXXXXXXXXXXGXXXXXXXXXXXXXXXXXXXGXXXXXXXXXXXXXXXXXXXGXXXXXXXXXXXXXXXXXXXGXXXXXXXXXXXXXXXXXXXGXXXXXXXXXXXXXXXXXXXGXXXXXXXXXXXXXXXXXXX,0,10,0
17493,14,1,13,127,459,0,0,474,246,228,GXXXXXXXXXXXXXXXXXXXGXXXXXXXXXXXXXXXXXXXGXXXXXXXXXXXXXXXXXXXGXXXXXXXXXXXXXXXXXXXGAXXXXXXXXXXXXXXXXXXGXXXXXXXXXXXXXXXXXXXGXXXXXXXXXXXXXXXXXXXGXXXXXXXXXXXXXXXXXXXGXXXXXXXXXXXXXXXXXXXGXXXXXXXXXXXXXXXXXXXGXXXXXXXXXXXXXXXXXXXGXXXXXXXXXXXXXXXXXXXGXXXXXXXXXXXXXXXXXXX,0,10,0
17514,14,1,13,125,461,0,0,475,252,223,GXXXXXXXXXXXXXXXXXXXGXXXXXXXXXXXXXXXXXXXGXXXXXXXXXXXXXXXXXXXGXXXXXXXXXXXXXXXXXXXGAXXXXXXXXXXXXXXXXXXGXXXXXXXXXXXXXXXXXXXGXXXXXXXXXXXXXXXXXXXGXXXXXXXXXXXXXXXXXXXGXXXXXXXXXXXXXXXXXXXGXXXXXXXXXXXXXXXXXXXGXXXXXXXXXXXXXXXXXXXGXXXXXXXXXXXXXXXXXXXGXXXXXXXXXXXXXXXXXXX,0,10,0

17535,14,0,14,128,458,0,0,475,251,224,GXXXXXXXXXXXXXXXXXXXGXXXXXXXXXXXXXXXXXXXGXXXXXXXXXXXXXXXXXXXGXXXXXXXXXXXXXXXXXXXGOXXXXXXXXXXXXXXXXXXGXXXXXXXXXXXXXXXXXXXGXXXXXXXXXXXXXXXXXXXGXXXXXXXXXXXXXXXXXXXGXXXXXXXXXXXXXXXXXXXGXXXXXXXXXXXXXXXXXXXGXXXXXXXXXXXXXXXXXXXGXXXXXXXXXXXXXXXXXXXGXXXXXXXXXXXXXXXXXXX,0,10,0
17556,13,0,13,124,463,0,0,478,250,228,GXXXXXXXXXXXXXXXXXXXGXXXXXXXXXXXXXXXXXXXGXXXXXXXXXXXXXXXXXXXGXXXXXXXXXXXXXXXXXXXGXXXXXXXXXXXXXXXXXXXGXXXXXXXXXXXXXXXXXXXGXXXXXXXXXXXXXXXXXXXGXXXXXXXXXXXXXXXXXXXGXXXXXXXXXXXXXXXXXXXGXXXXXXXXXXXXXXXXXXXGXXXXXXXXXXXXXXXXXXXGXXXXXXXXXXXXXXXXXXXGXXXXXXXXXXXXXXXXXXX,0,10,0
17577,13,0,13,124,463,0,0,478,252,226,GXXXXXXXXXXXXXXXXXXXGXXXXXXXXXXXXXXXXXXXGXXXXXXXXXXXXXXXXXXXGXXXXXXXXXXXXXXXXXXXGXXXXXXXXXXXXXXXXXXXGXXXXXXXXXXXXXXXXXXXGXXXXXXXXXXXXXXXXXXXGXXXXXXXXXXXXXXXXXXXGXXXXXXXXXXXXXXXXXXXGXXXXXXXXXXXXXXXXXXXGXXXXXXXXXXXXXXXXXXXGXXXXXXXXXXXXXXXXXXXGXXXXXXXXXXXXXXXXXXX,0,10,0
17598,14,1,13,119,467,0,0,483,254,229,GXXXXXXXXXXXXXXXXXXXGXXXXXXXXXXXXXXXXXXXGXXXXXXXXXXXXXXXXXXXGXXXXXXXXXXXXXXXXXXXGXXXXXXXXXXXXXXXXXXXGAXXXXXXXXXXXXXXXXXXGXXXXXXXXXXXXXXXXXXXGXXXXXXXXXXXXXXXXXXXGXXXXXXXXXXXXXXXXXXXGXXXXXXXXXXXXXXXXXXXGXXXXXXXXXXXXXXXXXXXGXXXXXXXXXXXXXXXXXXXGXXXXXXXXXXXXXXXXXXX,0,10,0
17619,14,0,14,122,464,0,0,480,249,231,GXXXXXXXXXXXXXXXXXXXGXXXXXXXXXXXXXXXXXXXGXXXXXXXXXXXXXXXXXXXGXXXXXXXXXXXXXXXXXXXGXXXXXXXXXXXXXXXXXXXGOXXXXXXXXXXXXXXXXXXGXXXXXXXXXXXXXXXXXXXGXXXXXXXXXXXXXXXXXXXGXXXXXXXXXXXXXXXXXXXGXXXXXXXXXXXXXXXXXXXGXXXXXXXXXXXXXXXXXXXGXXXXXXXXXXXXXXXXXXXGXXXXXXXXXXXXXXXXXXX,0,10,0

17640,15,1,14,112,473,0,0,488,250,238,GXXXXXXXXXXXXXXXXXXXGXXXXXXXXXXXXXXXXXXXGXXXXXXXXXXXXXXXXXXXGXXXXXXXXXXXXXXXXXXXGXXXXXXXXXXXXXXXXXXXGOXXXXXXXXXXXXXXXXXXGXXXXXXXXXXXXXXXXXXXGXXXXXXXXXXXXXXXXXXXGXXXXXXXXXXXXXXXXXXXGXXXXXXXXXXXXXXXXXXXGXXXXXXXXXXXXXXXXXXXGXXXXXXXXXXXXXXXXXXXGAXXXXXXXXXXXXXXXXXX,0,10,0
17661,14,1,13,113,473,0,0,488,258,230,GXXXXXXXXXXXXXXXXXXXGXXXXXXXXXXXXXXXXXXXGXXXXXXXXXXXXXXXXXXXGXXXXXXXXXXXXXXXXXXXGXXXXXXXXXXXXXXXXXXXGXXXXXXXXXXXXXXXXXXXGXXXXXXXXXXXXXXXXXXXGXXXXXXXXXXXXXXXXXXXGXXXXXXXXXXXXXXXXXXXGXXXXXXXXXXXXXXXXXXXGXXXXXXXXXXXXXXXXXXXGXXXXXXXXXXXXXXXXXXXGAXXXXXXXXXXXXXXXXXX,0,10,0
17682,15,2,13,120,465,0,0,480,250,230,GXXXXXXXXXXXXXXXXXXXGXXXXXXXXXXXXXXXXXXXGXXXXXXXXXXXXXXXXXXXGXXXXXXXXXXXXXXXXXXXGAXXXXXXXXXXXXXXXXXXGXXXXXXXXXXXXXXXXXXXGXXXXXXXXXXXXXXXXXXXGXXXXXXXXXXXXXXXXXXXGXXXXXXXXXXXXXXXXXXXGXXXXXXXXXXXXXXXXXXXGXXXXXXXXXXXXXXXXXXXGXXXXXXXXXXXXXXXXXXXGAXXXXXXXXXXXXXXXXXX,0,10,0
17703,15,2,13,115,470,0,0,485,246,239,GXXXXXXXXXXXXXXXXXXXGXXXXXXXXXXXXXXXXXXXGXXXXXXXXXXXXXXXXXXXGXXXXXXXXXXXXXXXXXXXGAXXXXXXXXXXXXXXXXXXGXXXXXXXXXXXXXXXXXXXGXXXXXXXXXXXXXXXXXXXGXXXXXXXXXXXXXXXXXXXGXXXXXXXXXXXXXXXXXXXGXXXXXXXXXXXXXXXXXXXGXXXXXXXXXXXXXXXXXXXGXXXXXXXXXXXXXXXXXXXGAXXXXXXXXXXXXXXXXXX,0,10,0
17724,15,1,14,117,468,0,0,483,251,232,GXXXXXXXXXXXXXXXXXXXGXXXXXXXXXXXXXXXXXXXGXXXXXXXXXXXXXXXXXXXGXXXXXXXXXXXXXXXXXXXGOXXXXXXXXXXXXXXXXXXGXXXXXXXXXXXXXXXXXXXGXXXXXXXXXXXXXXXXXXXGXXXXXXXXXXXXXXXXXXXGXXXXXXXXXXXXXXXXXXXGXXXXXXXXXXXXXXXXXXXGXXXXXXXXXXXXXXXXXXXGXXXXXXXXXXXXXXXXXXXGAXXXXXXXXXXXXXXXXXX,0,10,0

17745,15,1,14,124,461,0,0,476,250,226,GXXXXXXXXXXXXXXXXXXXGXXXXXXXXXXXXXXXXXXXGXXXXXXXXXXXXXXXXXXXGXXXXXXXXXXXXXXXXXXXGOXXXXXXXXXXXXXXXXXXGXXXXXXXXXXXXXXXXXXXGXXXXXXXXXXXXXXXXXXXGXXXXXXXXXXXXXXXXXXXGXXXXXXXXXXXXXXXXXXXGXXXXXXXXXXXXXXXXXXXGXXXXXXXXXXXXXXXXXXXGXXXXXXXXXXXXXXXXXXXGAXXXXXXXXXXXXXXXXXX,0,10,0
17766,15,1,14,124,461,0,0,476,249,227,GXXXXXXXXXXXXXXXXXXXGXXXXXXXXXXXXXXXXXXXGXXXXXXXXXXXXXXXXXXXGXXXXXXXXXXXXXXXXXXXGAXXXXXXXXXXXXXXXXXXGXXXXXXXXXXXXXXXXXXXGXXXXXXXXXXXXXXXXXXXGXXXXXXXXXXXXXXXXXXXGXXXXXXXXXXXXXXXXXXXGXXXXXXXXXXXXXXXXXXXGXXXXXXXXXXXXXXXXXXXGXXXXXXXXXXXXXXXXXXXGOXXXXXXXXXXXXXXXXXX,0,10,0
17787,15,1,14,132,453,0,0,468,256,212,GXXXXXXXXXXXXXXXXXXXGXXXXXXXXXXXXXXXXXXXGXXXXXXXXXXXXXXXXXXXGXXXXXXXXXXXXXXXXXXXGAXXXXXXXXXXXXXXXXXXGXXXXXXXXXXXXXXXXXXXGXXXXXXXXXXXXXXXXXXXGXXXXXXXXXXXXXXXXXXXGXXXXXXXXXXXXXXXXXXXGXXXXXXXXXXXXXXXXXXXGXXXXXXXXXXXXXXXXXXXGXXXXXXXXXXXXXXXXXXXGOXXXXXXXXXXXXXXXXXX,0,10,0
17808,14,1,13,130,456,0,0,471,260,211,GXXXXXXXXXXXXXXXXXXXGXXXXXXXXXXXXXXXXXXXGXXXXXXXXXXXXXXXXXXXGXXXXXXXXXXXXXXXXXXXGAXXXXXXXXXXXXXXXXXXGXXXXXXXXXXXXXXXXXXXGXXXXXXXXXXXXXXXXXXXGXXXXXXXXXXXXXXXXXXXGXXXXXXXXXXXXXXXXXXXGXXXXXXXXXXXXXXXXXXXGXXXXXXXXXXXXXXXXXXXGXXXXXXXXXXXXXXXXXXXGXXXXXXXXXXXXXXXXXXX,0,10,0
17829,14,1,13,133,453,0,0,467,256,211,GXXXXXXXXXXXXXXXXXXXGXXXXXXXXXXXXXXXXXXXGXXXXXXXXXXXXXXXXXXXGXXXXXXXXXXXXXXXXXXXGAXXXXXXXXXXXXXXXXXXGXXXXXXXXXXXXXXXXXXXGXXXXXXXXXXXXXXXXXXXGXXXXXXXXXXXXXXXXXXXGXXXXXXXXXXXXXXXXXXXGXXXXXXXXXXXXXXXXXXXGXXXXXXXXXXXXXXXXXXXGXXXXXXXXXXXXXXXXXXXGXXXXXXXXXXXXXXXXXXX,0,10,0

17850,14,1,13,134,452,0,0,466,263,203,GXXXXXXXXXXXXXXXXXXXGXXXXXXXXXXXXXXXXXXXGXXXXXXXXXXXXXXXXXXXGXXXXXXXXXXXXXXXXXXXGAXXXXXXXXXXXXXXXXXXGXXXXXXXXXXXXXXXXXXXGXXXXXXXXXXXXXXXXXXXGXXXXXXXXXXXXXXXXXXXGXXXXXXXXXXXXXXXXXXXGXXXXXXXXXXXXXXXXXXXGXXXXXXXXXXXXXXXXXXXGXXXXXXXXXXXXXXXXXXXGXXXXXXXXXXXXXXXXXXX,0,10,0
17871,14,1,13,142,444,0,0,459,249,210,GXXXXXXXXXXXXXXXXXXXGXXXXXXXXXXXXXXXXXXXGXXXXXXXXXXXXXXXXXXXGXXXXXXXXXXXXXXXXXXXGAXXXXXXXXXXXXXXXXXXGXXXXXXXXXXXXXXXXXXXGXXXXXXXXXXXXXXXXXXXGXXXXXXXXXXXXXXXXXXXGXXXXXXXXXXXXXXXXXXXGXXXXXXXXXXXXXXXXXXXGXXXXXXXXXXXXXXXXXXXGXXXXXXXXXXXXXXXXXXXGXXXXXXXXXXXXXXXXXXX,0,10,0
17892,13,0,13,142,445,0,0,460,250,210,GXXXXXXXXXXXXXXXXXXXGXXXXXXXXXXXXXXXXXXXGXXXXXXXXXXXXXXXXXXXGXXXXXXXXXXXXXXXXXXXGXXXXXXXXXXXXXXXXXXXGXXXXXXXXXXXXXXXXXXXGXXXXXXXXXXXXXXXXXXXGXXXXXXXXXXXXXXXXXXXGXXXXXXXXXXXXXXXXXXXGXXXXXXXXXXXXXXXXXXXGXXXXXXXXXXXXXXXXXXXGXXXXXXXXXXXXXXXXXXXGXXXXXXXXXXXXXXXXXXX,0,10,0
17913,13,0,13,138,449,0,0,462,254,208,GXXXXXXXXXXXXXXXXXXXGXXXXXXXXXXXXXXXXXXXGXXXXXXXXXXXXXXXXXXXGXXXXXXXXXXXXXXXXXXXGXXXXXXXXXXXXXXXXXXXGXXXXXXXXXXXXXXXXXXXGXXXXXXXXXXXXXXXXXXXGXXXXXXXXXXXXXXXXXXXGXXXXXXXXXXXXXXXXXXXGXXXXXXXXXXXXXXXXXXXGXXXXXXXXXXXXXXXXXXXGXXXXXXXXXXXXXXXXXXXGXXXXXXXXXXXXXXXXXXX,0,10,0
17934,13,0,13,142,445,0,0,457,255,202,GXXXXXXXXXXXXXXXXXXXGXXXXXXXXXXXXXXXXXXXGXXXXXXXXXXXXXXXXXXXGXXXXXXXXXXXXXXXXXXXGXXXXXXXXXXXXXXXXXXXGXXXXXXXXXXXXXXXXXXXGXXXXXXXXXXXXXXXXXXXGXXXXXXXXXXXXXXXXXXXGXXXXXXXXXXXXXXXXXXXGXXXXXXXXXXXXXXXXXXXGXXXXXXXXXXXXXXXXXXXGXXXXXXXXXXXXXXXXXXXGXXXXXXXXXXXXXXXXXXX,0,10,0

17955,14,1,13,141,445,0,0,459,257,202,GXXXXXXXXXXXXXXXXXXXGXXXXXXXXXXXXXXXXXXXGXXXXXXXXXXXXXXXXXXXGXXXXXXXXXXXXXXXXXXXGXXXXXXXXXXXXXXXXXXXGXXXXXXXXXXXXXXXXXXXGXXXXXXXXXXXXXXXXXXXGAXXXXXXXXXXXXXXXXXXGXXXXXXXXXXXXXXXXXXXGXXXXXXXXXXXXXXXXXXXGXXXXXXXXXXXXXXXXXXXGXXXXXXXXXXXXXXXXXXXGXXXXXXXXXXXXXXXXXXX,0,10,0
17976,14,1,13,151,435,0,0,450,255,195,GXXXXXXXXXXXXXXXXXXXGXXXXXXXXXXXXXXXXXXXGXXXXXXXXXXXXXXXXXXXGXXXXXXXXXXXXXXXXXXXGXXXXXXXXXXXXXXXXXXXGXXXXXXXXXXXXXXXXXXXGXXXXXXXXXXXXXXXXXXXGAXXXXXXXXXXXXXXXXXXGXXXXXXXXXXXXXXXXXXXGXXXXXXXXXXXXXXXXXXXGXXXXXXXXXXXXXXXXXXXGXXXXXXXXXXXXXXXXXXXGXXXXXXXXXXXXXXXXXXX,0,10,0
17997,14,1,13,153,433,0,0,449,251,198,GXXXXXXXXXXXXXXXXXXXGXXXXXXXXXXXXXXXXXXXGXXXXXXXXXXXXXXXXXXXGXXXXXXXXXXXXXXXXXXXGXXXXXXXXXXXXXXXXXXXGXXXXXXXXXXXXXXXXXXXGXXXXXXXXXXXXXXXXXXXGAXXXXXXXXXXXXXXXXXXGXXXXXXXXXXXXXXXXXXXGXXXXXXXXXXXXXXXXXXXGXXXXXXXXXXXXXXXXXXXGXXXXXXXXXXXXXXXXXXXGXXXXXXXXXXXXXXXXXXX,0,10,0
18018,14,1,13,147,439,0,0,453,250,203,GXXXXXXXXXXXXXXXXXXXGXXXXXXXXXXXXXXXXXXXGXXXXXXXXXXXXXXXXXXXGXXXXXXXXXXXXXXXXXXXGXXXXXXXXXXXXXXXXXXXGXXXXXXXXXXXXXXXXXXXGXXXXXXXXXXXXXXXXXXXGAXXXXXXXXXXXXXXXXXXGXXXXXXXXXXXXXXXXXXXGXXXXXXXXXXXXXXXXXXXGXXXXXXXXXXXXXXXXXXXGXXXXXXXXXXXXXXXXXXXGXXXXXXXXXXXXXXXXXXX,0,10,0
18039,14,1,13,144,442,0,0,456,248,208,GXXXXXXXXXXXXXXXXXXXGXXXXXXXXXXXXXXXXXXXGXXXXXXXXXXXXXXXXXXXGXXXXXXXXXXXXXXXXXXXGXXXXXXXXXXXXXXXXXXXGXXXXXXXXXXXXXXXXXXXGXXXXXXXXXXXXXXXXXXXGAXXXXXXXXXXXXXXXXXXGXXXXXXXXXXXXXXXXXXXGXXXXXXXXXXXXXXXXXXXGXXXXXXXXXXXXXXXXXXXGXXXXXXXXXXXXXXXXXXXGXXXXXXXXXXXXXXXXXXX,0,10,0

18060,14,1,13,143,443,0,0,458,249,209,GXXXXXXXXXXXXXXXXXXXGXXXXXXXXXXXXXXXXXXXGXXXXXXXXXXXXXXXXXXXGXXXXXXXXXXXXXXXXXXXGXXXXXXXXXXXXXXXXXXXGXXXXXXXXXXXXXXXXXXXGXXXXXXXXXXXXXXXXXXXGAXXXXXXXXXXXXXXXXXXGXXXXXXXXXXXXXXXXXXXGXXXXXXXXXXXXXXXXXXXGXXXXXXXXXXXXXXXXXXXGXXXXXXXXXXXXXXXXXXXGXXXXXXXXXXXXXXXXXXX,0,10,0
18081,14,1,13,136,450,0,0,465,252,213,GXXXXXXXXXXXXXXXXXXXGXXXXXXXXXXXXXXXXXXXGXXXXXXXXXXXXXXXXXXXGXXXXXXXXXXXXXXXXXXXGXXXXXXXXXXXXXXXXXXXGXXXXXXXXXXXXXXXXXXXGXXXXXXXXXXXXXXXXXXXGAXXXXXXXXXXXXXXXXXXGXXXXXXXXXXXXXXXXXXXGXXXXXXXXXXXXXXXXXXXGXXXXXXXXXXXXXXXXXXXGXXXXXXXXXXXXXXXXXXXGXXXXXXXXXXXXXXXXXXX,0,10,0
18102,14,1,13,131,455,0,0,469,255,214,GXXXXXXXXXXXXXXXXXXXGXXXXXXXXXXXXXXXXXXXGXXXXXXXXXXXXXXXXXXXGXXXXXXXXXXXXXXXXXXXGXXXXXXXXXXXXXXXXXXXGXXXXXXXXXXXXXXXXXXXGXXXXXXXXXXXXXXXXXXXGAXXXXXXXXXXXXXXXXXXGXXXXXXXXXXXXXXXXXXXGXXXXXXXXXXXXXXXXXXXGXXXXXXXXXXXXXXXXXXXGXXXXXXXXXXXXXXXXXXXGXXXXXXXXXXXXXXXXXXX,0,10,0
18123,14,1,13,130,456,0,0,471,253,218,GXXXXXXXXXXXXXXXXXXXGXXXXXXXXXXXXXXXXXXXGXXXXXXXXXXXXXXXXXXXGXXXXXXXXXXXXXXXXXXXGXXXXXXXXXXXXXXXXXXXGXXXXXXXXXXXXXXXXXXXGXXXXXXXXXXXXXXXXXXXGAXXXXXXXXXXXXXXXXXXGXXXXXXXXXXXXXXXXXXXGXXXXXXXXXXXXXXXXXXXGXXXXXXXXXXXXXXXXXXXGXXXXXXXXXXXXXXXXXXXGXXXXXXXXXXXXXXXXXXX,0,10,0
18144,14,1,13,131,455,0,0,468,257,211,GXXXXXXXXXXXXXXXXXXXGXXXXXXXXXXXXXXXXXXXGXXXXXXXXXXXXXXXXXXXGXXXXXXXXXXXXXXXXXXXGXXXXXXXXXXXXXXXXXXXGXXXXXXXXXXXXXXXXXXXGXXXXXXXXXXXXXXXXXXXGAXXXXXXXXXXXXXXXXXXGXXXXXXXXXXXXXXXXXXXGXXXXXXXXXXXXXXXXXXXGXXXXXXXXXXXXXXXXXXXGXXXXXXXXXXXXXXXXXXXGXXXXXXXXXXXXXXXXXXX,0,10,0

18165,14,1,13,129,457,0,0,470,255,215,GXXXXXXXXXXXXXXXXXXXGXXXXXXXXXXXXXXXXXXXGXXXXXXXXXXXXXXXXXXXGXXXXXXXXXXXXXXXXXXXGXXXXXXXXXXXXXXXXXXXGXXXXXXXXXXXXXXXXXXXGXXXXXXXXXXXXXXXXXXXGAXXXXXXXXXXXXXXXXXXGXXXXXXXXXXXXXXXXXXXGXXXXXXXXXXXXXXXXXXXGXXXXXXXXXXXXXXXXXXXGXXXXXXXXXXXXXXXXXXXGXXXXXXXXXXXXXXXXXXX,0,10,0
18186,14,1,13,135,451,0,0,464,256,208,GXXXXXXXXXXXXXXXXXXXGXXXXXXXXXXXXXXXXXXXGXXXXXXXXXXXXXXXXXXXGXXXXXXXXXXXXXXXXXXXGXXXXXXXXXXXXXXXXXXXGXXXXXXXXXXXXXXXXXXXGXXXXXXXXXXXXXXXXXXXGAXXXXXXXXXXXXXXXXXXGXXXXXXXXXXXXXXXXXXXGXXXXXXXXXXXXXXXXXXXGXXXXXXXXXXXXXXXXXXXGXXXXXXXXXXXXXXXXXXXGXXXXXXXXXXXXXXXXXXX,0,10,0
18207,14,1,13,140,446,0,0,459,255,204,GXXXXXXXXXXXXXXXXXXXGXXXXXXXXXXXXXXXXXXXGXXXXXXXXXXXXXXXXXXXGXXXXXXXXXXXXXXXXXXXGXXXXXXXXXXXXXXXXXXXGXXXXXXXXXXXXXXXXXXXGXXXXXXXXXXXXXXXXXXXGAXXXXXXXXXXXXXXXXXXGXXXXXXXXXXXXXXXXXXXGXXXXXXXXXXXXXXXXXXXGXXXXXXXXXXXXXXXXXXXGXXXXXXXXXXXXXXXXXXXGXXXXXXXXXXXXXXXXXXX,0,10,0
18228,14,1,13,137,449,0,0,464,251,213,GXXXXXXXXXXXXXXXXXXXGXXXXXXXXXXXXXXXXXXXGXXXXXXXXXXXXXXXXXXXGXXXXXXXXXXXXXXXXXXXGXXXXXXXXXXXXXXXXXXXGXXXXXXXXXXXXXXXXXXXGXXXXXXXXXXXXXXXXXXXGAXXXXXXXXXXXXXXXXXXGXXXXXXXXXXXXXXXXXXXGXXXXXXXXXXXXXXXXXXXGXXXXXXXXXXXXXXXXXXXGXXXXXXXXXXXXXXXXXXXGXXXXXXXXXXXXXXXXXXX,0,10,0
18249,14,0,14,128,458,0,0,473,248,225,GXXXXXXXXXXXXXXXXXXXGXXXXXXXXXXXXXXXXXXXGXXXXXXXXXXXXXXXXXXXGXXXXXXXXXXXXXXXXXXXGXXXXXXXXXXXXXXXXXXXGXXXXXXXXXXXXXXXXXXXGXXXXXXXXXXXXXXXXXXXGOXXXXXXXXXXXXXXXXXXGXXXXXXXXXXXXXXXXXXXGXXXXXXXXXXXXXXXXXXXGXXXXXXXXXXXXXXXXXXXGXXXXXXXXXXXXXXXXXXXGXXXXXXXXXXXXXXXXXXX,0,10,0

18270,13,0,13,122,465,0,0,476,249,227,GXXXXXXXXXXXXXXXXXXXGXXXXXXXXXXXXXXXXXXXGXXXXXXXXXXXXXXXXXXXGXXXXXXXXXXXXXXXXXXXGXXXXXXXXXXXXXXXXXXXGXXXXXXXXXXXXXXXXXXXGXXXXXXXXXXXXXXXXXXXGXXXXXXXXXXXXXXXXXXXGXXXXXXXXXXXXXXXXXXXGXXXXXXXXXXXXXXXXXXXGXXXXXXXXXXXXXXXXXXXGXXXXXXXXXXXXXXXXXXXGXXXXXXXXXXXXXXXXXXX,0,10,0
18291,13,0,13,125,462,0,0,477,248,229,GXXXXXXXXXXXXXXXXXXXGXXXXXXXXXXXXXXXXXXXGXXXXXXXXXXXXXXXXXXXGXXXXXXXXXXXXXXXXXXXGXXXXXXXXXXXXXXXXXXXGXXXXXXXXXXXXXXXXXXXGXXXXXXXXXXXXXXXXXXXGXXXXXXXXXXXXXXXXXXXGXXXXXXXXXXXXXXXXXXXGXXXXXXXXXXXXXXXXXXXGXXXXXXXXXXXXXXXXXXXGXXXXXXXXXXXXXXXXXXXGXXXXXXXXXXXXXXXXXXX,0,10,0
18312,13,0,13,119,468,0,0,482,259,223,GXXXXXXXXXXXXXXXXXXXGXXXXXXXXXXXXXXXXXXXGXXXXXXXXXXXXXXXXXXXGXXXXXXXXXXXXXXXXXXXGXXXXXXXXXXXXXXXXXXXGXXXXXXXXXXXXXXXXXXXGXXXXXXXXXXXXXXXXXXXGXXXXXXXXXXXXXXXXXXXGXXXXXXXXXXXXXXXXXXXGXXXXXXXXXXXXXXXXXXXGXXXXXXXXXXXXXXXXXXXGXXXXXXXXXXXXXXXXXXXGXXXXXXXXXXXXXXXXXXX,0,10,0
18333,13,0,13,118,469,0,0,483,251,232,GXXXXXXXXXXXXXXXXXXXGXXXXXXXXXXXXXXXXXXXGXXXXXXXXXXXXXXXXXXXGXXXXXXXXXXXXXXXXXXXGXXXXXXXXXXXXXXXXXXXGXXXXXXXXXXXXXXXXXXXGXXXXXXXXXXXXXXXXXXXGXXXXXXXXXXXXXXXXXXXGXXXXXXXXXXXXXXXXXXXGXXXXXXXXXXXXXXXXXXXGXXXXXXXXXXXXXXXXXXXGXXXXXXXXXXXXXXXXXXXGXXXXXXXXXXXXXXXXXXX,0,10,0
18354,13,0,13,114,473,0,0,487,261,226,GXXXXXXXXXXXXXXXXXXXGXXXXXXXXXXXXXXXXXXXGXXXXXXXXXXXXXXXXXXXGXXXXXXXXXXXXXXXXXXXGXXXXXXXXXXXXXXXXXXXGXXXXXXXXXXXXXXXXXXXGXXXXXXXXXXXXXXXXXXXGXXXXXXXXXXXXXXXXXXXGXXXXXXXXXXXXXXXXXXXGXXXXXXXXXXXXXXXXXXXGXXXXXXXXXXXXXXXXXXXGXXXXXXXXXXXXXXXXXXXGXXXXXXXXXXXXXXXXXXX,0,10,0

18375,13,0,13,117,470,0,0,483,261,222,GXXXXXXXXXXXXXXXXXXXGXXXXXXXXXXXXXXXXXXXGXXXXXXXXXXXXXXXXXXXGXXXXXXXXXXXXXXXXXXXGXXXXXXXXXXXXXXXXXXXGXXXXXXXXXXXXXXXXXXXGXXXXXXXXXXXXXXXXXXXGXXXXXXXXXXXXXXXXXXXGXXXXXXXXXXXXXXXXXXXGXXXXXXXXXXXXXXXXXXXGXXXXXXXXXXXXXXXXXXXGXXXXXXXXXXXXXXXXXXXGXXXXXXXXXXXXXXXXXXX,0,10,0
18396,13,0,13,124,463,0,0,477,261,216,GXXXXXXXXXXXXXXXXXXXGXXXXXXXXXXXXXXXXXXXGXXXXXXXXXXXXXXXXXXXGXXXXXXXXXXXXXXXXXXXGXXXXXXXXXXXXXXXXXXXGXXXXXXXXXXXXXXXXXXXGXXXXXXXXXXXXXXXXXXXGXXXXXXXXXXXXXXXXXXXGXXXXXXXXXXXXXXXXXXXGXXXXXXXXXXXXXXXXXXXGXXXXXXXXXXXXXXXXXXXGXXXXXXXXXXXXXXXXXXXGXXXXXXXXXXXXXXXXXXX,0,10,0
18417,13,0,13,125,462,0,0,476,263,213,GXXXXXXXXXXXXXXXXXXXGXXXXXXXXXXXXXXXXXXXGXXXXXXXXXXXXXXXXXXXGXXXXXXXXXXXXXXXXXXXGXXXXXXXXXXXXXXXXXXXGXXXXXXXXXXXXXXXXXXXGXXXXXXXXXXXXXXXXXXXGXXXXXXXXXXXXXXXXXXXGXXXXXXXXXXXXXXXXXXXGXXXXXXXXXXXXXXXXXXXGXXXXXXXXXXXXXXXXXXXGXXXXXXXXXXXXXXXXXXXGXXXXXXXXXXXXXXXXXXX,0,10,0
18438,13,0,13,123,464,0,0,478,258,220,GXXXXXXXXXXXXXXXXXXXGXXXXXXXXXXXXXXXXXXXGXXXXXXXXXXXXXXXXXXXGXXXXXXXXXXXXXXXXXXXGXXXXXXXXXXXXXXXXXXXGXXXXXXXXXXXXXXXXXXXGXXXXXXXXXXXXXXXXXXXGXXXXXXXXXXXXXXXXXXXGXXXXXXXXXXXXXXXXXXXGXXXXXXXXXXXXXXXXXXXGXXXXXXXXXXXXXXXXXXXGXXXXXXXXXXXXXXXXXXXGXXXXXXXXXXXXXXXXXXX,0,10,0
18459,14,1,13,119,467,0,0,481,263,218,GXXXXXXXXXXXXXXXXXXXGXXXXXXXXXXXXXXXXXXXGAXXXXXXXXXXXXXXXXXXGXXXXXXXXXXXXXXXXXXXGXXXXXXXXXXXXXXXXXXXGXXXXXXXXXXXXXXXXXXXGXXXXXXXXXXXXXXXXXXXGXXXXXXXXXXXXXXXXXXXGXXXXXXXXXXXXXXXXXXXGXXXXXXXXXXXXXXXXXXXGXXXXXXXXXXXXXXXXXXXGXXXXXXXXXXXXXXXXXXXGXXXXXXXXXXXXXXXXXXX,0,10,0

18480,14,1,13,123,463,0,0,477,260,217,GXXXXXXXXXXXXXXXXXXXGXXXXXXXXXXXXXXXXXXXGAXXXXXXXXXXXXXXXXXXGXXXXXXXXXXXXXXXXXXXGXXXXXXXXXXXXXXXXXXXGXXXXXXXXXXXXXXXXXXXGXXXXXXXXXXXXXXXXXXXGXXXXXXXXXXXXXXXXXXXGXXXXXXXXXXXXXXXXXXXGXXXXXXXXXXXXXXXXXXXGXXXXXXXXXXXXXXXXXXXGXXXXXXXXXXXXXXXXXXXGXXXXXXXXXXXXXXXXXXX,0,10,0
18501,15,2,13,127,458,0,0,469,254,215,GXXXXXXXXXXXXXXXXXXXGXXXXXXXXXXXXXXXXXXXGAXXXXXXXXXXXXXXXXXXGXXXXXXXXXXXXXXXXXXXGXXXXXXXXXXXXXXXXXXXGAXXXXXXXXXXXXXXXXXXGXXXXXXXXXXXXXXXXXXXGXXXXXXXXXXXXXXXXXXXGXXXXXXXXXXXXXXXXXXXGXXXXXXXXXXXXXXXXXXXGXXXXXXXXXXXXXXXXXXXGXXXXXXXXXXXXXXXXXXXGXXXXXXXXXXXXXXXXXXX,0,10,0
18522,15,2,13,123,462,0,0,476,259,217,GXXXXXXXXXXXXXXXXXXXGXXXXXXXXXXXXXXXXXXXGAXXXXXXXXXXXXXXXXXXGXXXXXXXXXXXXXXXXXXXGXXXXXXXXXXXXXXXXXXXGAXXXXXXXXXXXXXXXXXXGXXXXXXXXXXXXXXXXXXXGXXXXXXXXXXXXXXXXXXXGXXXXXXXXXXXXXXXXXXXGXXXXXXXXXXXXXXXXXXXGXXXXXXXXXXXXXXXXXXXGXXXXXXXXXXXXXXXXXXXGXXXXXXXXXXXXXXXXXXX,0,10,0
18543,15,2,13,118,467,0,0,479,259,220,GXXXXXXXXXXXXXXXXXXXGXXXXXXXXXXXXXXXXXXXGAXXXXXXXXXXXXXXXXXXGXXXXXXXXXXXXXXXXXXXGXXXXXXXXXXXXXXXXXXXGAXXXXXXXXXXXXXXXXXXGXXXXXXXXXXXXXXXXXXXGXXXXXXXXXXXXXXXXXXXGXXXXXXXXXXXXXXXXXXXGXXXXXXXXXXXXXXXXXXXGXXXXXXXXXXXXXXXXXXXGXXXXXXXXXXXXXXXXXXXGXXXXXXXXXXXXXXXXXXX,0,10,0
18564,15,2,13,121,464,0,0,477,254,223,GXXXXXXXXXXXXXXXXXXXGXXXXXXXXXXXXXXXXXXXGAXXXXXXXXXXXXXXXXXXGXXXXXXXXXXXXXXXXXXXGXXXXXXXXXXXXXXXXXXXGAXXXXXXXXXXXXXXXXXXGXXXXXXXXXXXXXXXXXXXGXXXXXXXXXXXXXXXXXXXGXXXXXXXXXXXXXXXXXXXGXXXXXXXXXXXXXXXXXXXGXXXXXXXXXXXXXXXXXXXGXXXXXXXXXXXXXXXXXXXGXXXXXXXXXXXXXXXXXXX,0,10,0

18585,15,1,14,117,468,0,0,481,257,224,GXXXXXXXXXXXXXXXXXXXGXXXXXXXXXXXXXXXXXXXGAXXXXXXXXXXXXXXXXXXGXXXXXXXXXXXXXXXXXXXGXXXXXXXXXXXXXXXXXXXGOXXXXXXXXXXXXXXXXXXGXXXXXXXXXXXXXXXXXXXGXXXXXXXXXXXXXXXXXXXGXXXXXXXXXXXXXXXXXXXGXXXXXXXXXXXXXXXXXXXGXXXXXXXXXXXXXXXXXXXGXXXXXXXXXXXXXXXXXXXGXXXXXXXXXXXXXXXXXXX,0,10,0
18606,14,1,13,111,475,0,0,488,259,229,GXXXXXXXXXXXXXXXXXXXGXXXXXXXXXXXXXXXXXXXGAXXXXXXXXXXXXXXXXXXGXXXXXXXXXXXXXXXXXXXGXXXXXXXXXXXXXXXXXXXGXXXXXXXXXXXXXXXXXXXGXXXXXXXXXXXXXXXXXXXGXXXXXXXXXXXXXXXXXXXGXXXXXXXXXXXXXXXXXXXGXXXXXXXXXXXXXXXXXXXGXXXXXXXXXXXXXXXXXXXGXXXXXXXXXXXXXXXXXXXGXXXXXXXXXXXXXXXXXXX,0,10,0
18627,14,1,13,113,473,0,0,486,254,232,GXXXXXXXXXXXXXXXXXXXGXXXXXXXXXXXXXXXXXXXGAXXXXXXXXXXXXXXXXXXGXXXXXXXXXXXXXXXXXXXGXXXXXXXXXXXXXXXXXXXGXXXXXXXXXXXXXXXXXXXGXXXXXXXXXXXXXXXXXXXGXXXXXXXXXXXXXXXXXXXGXXXXXXXXXXXXXXXXXXXGXXXXXXXXXXXXXXXXXXXGXXXXXXXXXXXXXXXXXXXGXXXXXXXXXXXXXXXXXXXGXXXXXXXXXXXXXXXXXXX,0,10,0
18648,14,1,13,111,475,0,0,488,260,228,GXXXXXXXXXXXXXXXXXXXGXXXXXXXXXXXXXXXXXXXGAXXXXXXXXXXXXXXXXXXGXXXXXXXXXXXXXXXXXXXGXXXXXXXXXXXXXXXXXXXGXXXXXXXXXXXXXXXXXXXGXXXXXXXXXXXXXXXXXXXGXXXXXXXXXXXXXXXXXXXGXXXXXXXXXXXXXXXXXXXGXXXXXXXXXXXXXXXXXXXGXXXXXXXXXXXXXXXXXXXGXXXXXXXXXXXXXXXXXXXGXXXXXXXXXXXXXXXXXXX,0,10,0
18669,14,1,13,117,469,0,0,482,257,225,GXXXXXXXXXXXXXXXXXXXGXXXXXXXXXXXXXXXXXXXGAXXXXXXXXXXXXXXXXXXGXXXXXXXXXXXXXXXXXXXGXXXXXXXXXXXXXXXXXXXGXXXXXXXXXXXXXXXXXXXGXXXXXXXXXXXXXXXXXXXGXXXXXXXXXXXXXXXXXXXGXXXXXXXXXXXXXXXXXXXGXXXXXXXXXXXXXXXXXXXGXXXXXXXXXXXXXXXXXXXGXXXXXXXXXXXXXXXXXXXGXXXXXXXXXXXXXXXXXXX,0,10,0

18690,14,1,13,113,473,0,0,489,261,228,GXXXXXXXXXXXXXXXXXXXGXXXXXXXXXXXXXXXXXXXGAXXXXXXXXXXXXXXXXXXGXXXXXXXXXXXXXXXXXXXGXXXXXXXXXXXXXXXXXXXGXXXXXXXXXXXXXXXXXXXGXXXXXXXXXXXXXXXXXXXGXXXXXXXXXXXXXXXXXXXGXXXXXXXXXXXXXXXXXXXGXXXXXXXXXXXXXXXXXXXGXXXXXXXXXXXXXXXXXXXGXXXXXXXXXXXXXXXXXXXGXXXXXXXXXXXXXXXXXXX,0,10,0
18711,15,1,14,116,469,0,0,484,260,224,GXXXXXXXXXXXXXXXXXXXGXXXXXXXXXXXXXXXXXXXGOXXXXXXXXXXXXXXXXXXGAXXXXXXXXXXXXXXXXXXGXXXXXXXXXXXXXXXXXXXGXXXXXXXXXXXXXXXXXXXGXXXXXXXXXXXXXXXXXXXGXXXXXXXXXXXXXXXXXXXGXXXXXXXXXXXXXXXXXXXGXXXXXXXXXXXXXXXXXXXGXXXXXXXXXXXXXXXXXXXGXXXXXXXXXXXXXXXXXXXGXXXXXXXXXXXXXXXXXXX,0,10,0
18732,15,0,15,118,467,0,0,482,256,226,GXXXXXXXXXXXXXXXXXXXGXXXXXXXXXXXXXXXXXXXGOXXXXXXXXXXXXXXXXXXGOXXXXXXXXXXXXXXXXXXGXXXXXXXXXXXXXXXXXXXGXXXXXXXXXXXXXXXXXXXGXXXXXXXXXXXXXXXXXXXGXXXXXXXXXXXXXXXXXXXGXXXXXXXXXXXXXXXXXXXGXXXXXXXXXXXXXXXXXXXGXXXXXXXXXXXXXXXXXXXGXXXXXXXXXXXXXXXXXXXGXXXXXXXXXXXXXXXXXXX,0,10,0
18753,13,0,13,117,470,0,0,484,269,215,GXXXXXXXXXXXXXXXXXXXGXXXXXXXXXXXXXXXXXXXGXXXXXXXXXXXXXXXXXXXGXXXXXXXXXXXXXXXXXXXGXXXXXXXXXXXXXXXXXXXGXXXXXXXXXXXXXXXXXXXGXXXXXXXXXXXXXXXXXXXGXXXXXXXXXXXXXXXXXXXGXXXXXXXXXXXXXXXXXXXGXXXXXXXXXXXXXXXXXXXGXXXXXXXXXXXXXXXXXXXGXXXXXXXXXXXXXXXXXXXGXXXXXXXXXXXXXXXXXXX,0,10,0
18774,13,0,13,121,466,0,0,482,262,220,GXXXXXXXXXXXXXXXXXXXGXXXXXXXXXXXXXXXXXXXGXXXXXXXXXXXXXXXXXXXGXXXXXXXXXXXXXXXXXXXGXXXXXXXXXXXXXXXXXXXGXXXXXXXXXXXXXXXXXXXGXXXXXXXXXXXXXXXXXXXGXXXXXXXXXXXXXXXXXXXGXXXXXXXXXXXXXXXXXXXGXXXXXXXXXXXXXXXXXXXGXXXXXXXXXXXXXXXXXXXGXXXXXXXXXXXXXXXXXXXGXXXXXXXXXXXXXXXXXXX,0,10,0

18795,13,0,13,128,459,0,0,475,261,214,GXXXXXXXXXXXXXXXXXXXGXXXXXXXXXXXXXXXXXXXGXXXXXXXXXXXXXXXXXXXGXXXXXXXXXXXXXXXXXXXGXXXXXXXXXXXXXXXXXXXGXXXXXXXXXXXXXXXXXXXGXXXXXXXXXXXXXXXXXXXGXXXXXXXXXXXXXXXXXXXGXXXXXXXXXXXXXXXXXXXGXXXXXXXXXXXXXXXXXXXGXXXXXXXXXXXXXXXXXXXGXXXXXXXXXXXXXXXXXXXGXXXXXXXXXXXXXXXXXXX,0,10,0
18816,13,0,13,132,455,0,0,471,260,211,GXXXXXXXXXXXXXXXXXXXGXXXXXXXXXXXXXXXXXXXGXXXXXXXXXXXXXXXXXXXGXXXXXXXXXXXXXXXXXXXGXXXXXXXXXXXXXXXXXXXGXXXXXXXXXXXXXXXXXXXGXXXXXXXXXXXXXXXXXXXGXXXXXXXXXXXXXXXXXXXGXXXXXXXXXXXXXXXXXXXGXXXXXXXXXXXXXXXXXXXGXXXXXXXXXXXXXXXXXXXGXXXXXXXXXXXXXXXXXXXGXXXXXXXXXXXXXXXXXXX,0,10,0
18837,13,0,13,126,461,0,0,477,261,216,GXXXXXXXXXXXXXXXXXXXGXXXXXXXXXXXXXXXXXXXGXXXXXXXXXXXXXXXXXXXGXXXXXXXXXXXXXXXXXXXGXXXXXXXXXXXXXXXXXXXGXXXXXXXXXXXXXXXXXXXGXXXXXXXXXXXXXXXXXXXGXXXXXXXXXXXXXXXXXXXGXXXXXXXXXXXXXXXXXXXGXXXXXXXXXXXXXXXXXXXGXXXXXXXXXXXXXXXXXXXGXXXXXXXXXXXXXXXXXXXGXXXXXXXXXXXXXXXXXXX,0,10,0
18858,13,0,13,123,464,0,0,481,260,221,GXXXXXXXXXXXXXXXXXXXGXXXXXXXXXXXXXXXXXXXGXXXXXXXXXXXXXXXXXXXGXXXXXXXXXXXXXXXXXXXGXXXXXXXXXXXXXXXXXXXGXXXXXXXXXXXXXXXXXXXGXXXXXXXXXXXXXXXXXXXGXXXXXXXXXXXXXXXXXXXGXXXXXXXXXXXXXXXXXXXGXXXXXXXXXXXXXXXXXXXGXXXXXXXXXXXXXXXXXXXGXXXXXXXXXXXXXXXXXXXGXXXXXXXXXXXXXXXXXXX,0,10,0
18879,13,0,13,127,460,0,0,477,259,218,GXXXXXXXXXXXXXXXXXXXGXXXXXXXXXXXXXXXXXXXGXXXXXXXXXXXXXXXXXXXGXXXXXXXXXXXXXXXXXXXGXXXXXXXXXXXXXXXXXXXGXXXXXXXXXXXXXXXXXXXGXXXXXXXXXXXXXXXXXXXGXXXXXXXXXXXXXXXXXXXGXXXXXXXXXXXXXXXXXXXGXXXXXXXXXXXXXXXXXXXGXXXXXXXXXXXXXXXXXXXGXXXXXXXXXXXXXXXXXXXGXXXXXXXXXXXXXXXXXXX,0,10,0

18900,13,0,13,128,459,0,0,475,257,218,GXXXXXXXXXXXXXXXXXXXGXXXXXXXXXXXXXXXXXXXGXXXXXXXXXXXXXXXXXXXGXXXXXXXXXXXXXXXXXXXGXXXXXXXXXXXXXXXXXXXGXXXXXXXXXXXXXXXXXXXGXXXXXXXXXXXXXXXXXXXGXXXXXXXXXXXXXXXXXXXGXXXXXXXXXXXXXXXXXXXGXXXXXXXXXXXXXXXXXXXGXXXXXXXXXXXXXXXXXXXGXXXXXXXXXXXXXXXXXXXGXXXXXXXXXXXXXXXXXXX,0,10,0
18921,13,0,13,118,469,0,0,486,262,224,GXXXXXXXXXXXXXXXXXXXGXXXXXXXXXXXXXXXXXXXGXXXXXXXXXXXXXXXXXXXGXXXXXXXXXXXXXXXXXXXGXXXXXXXXXXXXXXXXXXXGXXXXXXXXXXXXXXXXXXXGXXXXXXXXXXXXXXXXXXXGXXXXXXXXXXXXXXXXXXXGXXXXXXXXXXXXXXXXXXXGXXXXXXXXXXXXXXXXXXXGXXXXXXXXXXXXXXXXXXXGXXXXXXXXXXXXXXXXXXXGXXXXXXXXXXXXXXXXXXX,0,10,0
18942,13,0,13,104,483,0,0,496,264,232,GXXXXXXXXXXXXXXXXXXXGXXXXXXXXXXXXXXXXXXXGXXXXXXXXXXXXXXXXXXXGXXXXXXXXXXXXXXXXXXXGXXXXXXXXXXXXXXXXXXXGXXXXXXXXXXXXXXXXXXXGXXXXXXXXXXXXXXXXXXXGXXXXXXXXXXXXXXXXXXXGXXXXXXXXXXXXXXXXXXXGXXXXXXXXXXXXXXXXXXXGXXXXXXXXXXXXXXXXXXXGXXXXXXXXXXXXXXXXXXXGXXXXXXXXXXXXXXXXXXX,0,10,0
18963,13,0,13,112,475,0,0,491,269,222,GXXXXXXXXXXXXXXXXXXXGXXXXXXXXXXXXXXXXXXXGXXXXXXXXXXXXXXXXXXXGXXXXXXXXXXXXXXXXXXXGXXXXXXXXXXXXXXXXXXXGXXXXXXXXXXXXXXXXXXXGXXXXXXXXXXXXXXXXXXXGXXXXXXXXXXXXXXXXXXXGXXXXXXXXXXXXXXXXXXXGXXXXXXXXXXXXXXXXXXXGXXXXXXXXXXXXXXXXXXXGXXXXXXXXXXXXXXXXXXXGXXXXXXXXXXXXXXXXXXX,0,10,0
18984,13,0,13,115,472,0,0,489,262,227,GXXXXXXXXXXXXXXXXXXXGXXXXXXXXXXXXXXXXXXXGXXXXXXXXXXXXXXXXXXXGXXXXXXXXXXXXXXXXXXXGXXXXXXXXXXXXXXXXXXXGXXXXXXXXXXXXXXXXXXXGXXXXXXXXXXXXXXXXXXXGXXXXXXXXXXXXXXXXXXXGXXXXXXXXXXXXXXXXXXXGXXXXXXXXXXXXXXXXXXXGXXXXXXXXXXXXXXXXXXXGXXXXXXXXXXXXXXXXXXXGXXXXXXXXXXXXXXXXXXX,0,10,0

19005,13,0,13,119,468,0,0,486,258,228,GXXXXXXXXXXXXXXXXXXXGXXXXXXXXXXXXXXXXXXXGXXXXXXXXXXXXXXXXXXXGXXXXXXXXXXXXXXXXXXXGXXXXXXXXXXXXXXXXXXXGXXXXXXXXXXXXXXXXXXXGXXXXXXXXXXXXXXXXXXXGXXXXXXXXXXXXXXXXXXXGXXXXXXXXXXXXXXXXXXXGXXXXXXXXXXXXXXXXXXXGXXXXXXXXXXXXXXXXXXXGXXXXXXXXXXXXXXXXXXXGXXXXXXXXXXXXXXXXXXX,0,10,0
19026,13,0,13,123,464,0,0,482,266,216,GXXXXXXXXXXXXXXXXXXXGXXXXXXXXXXXXXXXXXXXGXXXXXXXXXXXXXXXXXXXGXXXXXXXXXXXXXXXXXXXGXXXXXXXXXXXXXXXXXXXGXXXXXXXXXXXXXXXXXXXGXXXXXXXXXXXXXXXXXXXGXXXXXXXXXXXXXXXXXXXGXXXXXXXXXXXXXXXXXXXGXXXXXXXXXXXXXXXXXXXGXXXXXXXXXXXXXXXXXXXGXXXXXXXXXXXXXXXXXXXGXXXXXXXXXXXXXXXXXXX,0,10,0
19047,13,0,13,120,467,0,0,481,266,215,GXXXXXXXXXXXXXXXXXXXGXXXXXXXXXXXXXXXXXXXGXXXXXXXXXXXXXXXXXXXGXXXXXXXXXXXXXXXXXXXGXXXXXXXXXXXXXXXXXXXGXXXXXXXXXXXXXXXXXXXGXXXXXXXXXXXXXXXXXXXGXXXXXXXXXXXXXXXXXXXGXXXXXXXXXXXXXXXXXXXGXXXXXXXXXXXXXXXXXXXGXXXXXXXXXXXXXXXXXXXGXXXXXXXXXXXXXXXXXXXGXXXXXXXXXXXXXXXXXXX,0,10,0
19068,13,0,13,127,460,0,0,475,260,215,GXXXXXXXXXXXXXXXXXXXGXXXXXXXXXXXXXXXXXXXGXXXXXXXXXXXXXXXXXXXGXXXXXXXXXXXXXXXXXXXGXXXXXXXXXXXXXXXXXXXGXXXXXXXXXXXXXXXXXXXGXXXXXXXXXXXXXXXXXXXGXXXXXXXXXXXXXXXXXXXGXXXXXXXXXXXXXXXXXXXGXXXXXXXXXXXXXXXXXXXGXXXXXXXXXXXXXXXXXXXGXXXXXXXXXXXXXXXXXXXGXXXXXXXXXXXXXXXXXXX,0,10,0
19089,13,0,13,117,470,0,0,485,262,223,GXXXXXXXXXXXXXXXXXXXGXXXXXXXXXXXXXXXXXXXGXXXXXXXXXXXXXXXXXXXGXXXXXXXXXXXXXXXXXXXGXXXXXXXXXXXXXXXXXXXGXXXXXXXXXXXXXXXXXXXGXXXXXXXXXXXXXXXXXXXGXXXXXXXXXXXXXXXXXXXGXXXXXXXXXXXXXXXXXXXGXXXXXXXXXXXXXXXXXXXGXXXXXXXXXXXXXXXXXXXGXXXXXXXXXXXXXXXXXXXGXXXXXXXXXXXXXXXXXXX,0,10,0

19110,13,0,13,125,462,0,0,478,258,220,GXXXXXXXXXXXXXXXXXXXGXXXXXXXXXXXXXXXXXXXGXXXXXXXXXXXXXXXXXXXGXXXXXXXXXXXXXXXXXXXGXXXXXXXXXXXXXXXXXXXGXXXXXXXXXXXXXXXXXXXGXXXXXXXXXXXXXXXXXXXGXXXXXXXXXXXXXXXXXXXGXXXXXXXXXXXXXXXXXXXGXXXXXXXXXXXXXXXXXXXGXXXXXXXXXXXXXXXXXXXGXXXXXXXXXXXXXXXXXXXGXXXXXXXXXXXXXXXXXXX,0,10,0
19131,14,1,13,126,460,0,0,476,260,216,GXXXXXXXXXXXXXXXXXXXGXXXXXXXXXXXXXXXXXXXGXXXXXXXXXXXXXXXXXXXGXXXXXXXXXXXXXXXXXXXGAXXXXXXXXXXXXXXXXXXGXXXXXXXXXXXXXXXXXXXGXXXXXXXXXXXXXXXXXXXGXXXXXXXXXXXXXXXXXXXGXXXXXXXXXXXXXXXXXXXGXXXXXXXXXXXXXXXXXXXGXXXXXXXXXXXXXXXXXXXGXXXXXXXXXXXXXXXXXXXGXXXXXXXXXXXXXXXXXXX,0,10,0
19152,14,1,13,126,460,0,0,474,260,214,GXXXXXXXXXXXXXXXXXXXGXXXXXXXXXXXXXXXXXXXGXXXXXXXXXXXXXXXXXXXGXXXXXXXXXXXXXXXXXXXGAXXXXXXXXXXXXXXXXXXGXXXXXXXXXXXXXXXXXXXGXXXXXXXXXXXXXXXXXXXGXXXXXXXXXXXXXXXXXXXGXXXXXXXXXXXXXXXXXXXGXXXXXXXXXXXXXXXXXXXGXXXXXXXXXXXXXXXXXXXGXXXXXXXXXXXXXXXXXXXGXXXXXXXXXXXXXXXXXXX,0,10,0
19173,14,1,13,126,460,0,0,476,265,211,GXXXXXXXXXXXXXXXXXXXGXXXXXXXXXXXXXXXXXXXGXXXXXXXXXXXXXXXXXXXGXXXXXXXXXXXXXXXXXXXGAXXXXXXXXXXXXXXXXXXGXXXXXXXXXXXXXXXXXXXGXXXXXXXXXXXXXXXXXXXGXXXXXXXXXXXXXXXXXXXGXXXXXXXXXXXXXXXXXXXGXXXXXXXXXXXXXXXXXXXGXXXXXXXXXXXXXXXXXXXGXXXXXXXXXXXXXXXXXXXGXXXXXXXXXXXXXXXXXXX,0,10,0
19194,15,2,13,122,463,0,0,480,262,218,GXXXXXXXXXXXXXXXXXXXGXXXXXXXXXXXXXXXXXXXGXXXXXXXXXXXXXXXXXXXGXXXXXXXXXXXXXXXXXXXGAXXXXXXXXXXXXXXXXXXGXXXXXXXXXXXXXXXXXXXGXXXXXXXXXXXXXXXXXXXGXXXXXXXXXXXXXXXXXXXGXXXXXXXXXXXXXXXXXXXGXXXXXXXXXXXXXXXXXXXGXXXXXXXXXXXXXXXXXXXGXXXXXXXXXXXXXXXXXXXGAXXXXXXXXXXXXXXXXXX,0,10,0

19215,14,1,13,123,463,0,0,479,265,214,GXXXXXXXXXXXXXXXXXXXGXXXXXXXXXXXXXXXXXXXGXXXXXXXXXXXXXXXXXXXGXXXXXXXXXXXXXXXXXXXGXXXXXXXXXXXXXXXXXXXGXXXXXXXXXXXXXXXXXXXGXXXXXXXXXXXXXXXXXXXGXXXXXXXXXXXXXXXXXXXGXXXXXXXXXXXXXXXXXXXGXXXXXXXXXXXXXXXXXXXGXXXXXXXXXXXXXXXXXXXGXXXXXXXXXXXXXXXXXXXGAXXXXXXXXXXXXXXXXXX,0,10,0
19236,14,1,13,126,460,0,0,477,265,212,GXXXXXXXXXXXXXXXXXXXGXXXXXXXXXXXXXXXXXXXGXXXXXXXXXXXXXXXXXXXGXXXXXXXXXXXXXXXXXXXGXXXXXXXXXXXXXXXXXXXGXXXXXXXXXXXXXXXXXXXGXXXXXXXXXXXXXXXXXXXGXXXXXXXXXXXXXXXXXXXGXXXXXXXXXXXXXXXXXXXGXXXXXXXXXXXXXXXXXXXGXXXXXXXXXXXXXXXXXXXGXXXXXXXXXXXXXXXXXXXGAXXXXXXXXXXXXXXXXXX,0,10,0
19257,14,1,13,128,458,0,0,473,264,209,GXXXXXXXXXXXXXXXXXXXGXXXXXXXXXXXXXXXXXXXGXXXXXXXXXXXXXXXXXXXGXXXXXXXXXXXXXXXXXXXGXXXXXXXXXXXXXXXXXXXGXXXXXXXXXXXXXXXXXXXGXXXXXXXXXXXXXXXXXXXGXXXXXXXXXXXXXXXXXXXGXXXXXXXXXXXXXXXXXXXGXXXXXXXXXXXXXXXXXXXGXXXXXXXXXXXXXXXXXXXGXXXXXXXXXXXXXXXXXXXGAXXXXXXXXXXXXXXXXXX,0,10,0
19278,14,1,13,116,470,0,0,486,266,220,GXXXXXXXXXXXXXXXXXXXGXXXXXXXXXXXXXXXXXXXGXXXXXXXXXXXXXXXXXXXGXXXXXXXXXXXXXXXXXXXGXXXXXXXXXXXXXXXXXXXGXXXXXXXXXXXXXXXXXXXGXXXXXXXXXXXXXXXXXXXGXXXXXXXXXXXXXXXXXXXGXXXXXXXXXXXXXXXXXXXGXXXXXXXXXXXXXXXXXXXGXXXXXXXXXXXXXXXXXXXGXXXXXXXXXXXXXXXXXXXGAXXXXXXXXXXXXXXXXXX,0,10,0
19299,14,1,13,113,473,0,0,489,268,221,GXXXXXXXXXXXXXXXXXXXGXXXXXXXXXXXXXXXXXXXGXXXXXXXXXXXXXXXXXXXGXXXXXXXXXXXXXXXXXXXGXXXXXXXXXXXXXXXXXXXGXXXXXXXXXXXXXXXXXXXGXXXXXXXXXXXXXXXXXXXGXXXXXXXXXXXXXXXXXXXGXXXXXXXXXXXXXXXXXXXGXXXXXXXXXXXXXXXXXXXGXXXXXXXXXXXXXXXXXXXGXXXXXXXXXXXXXXXXXXXGAXXXXXXXXXXXXXXXXXX,0,10,0

19320,14,1,13,115,471,0,0,486,270,216,GXXXXXXXXXXXXXXXXXXXGXXXXXXXXXXXXXXXXXXXGXXXXXXXXXXXXXXXXXXXGXXXXXXXXXXXXXXXXXXXGXXXXXXXXXXXXXXXXXXXGXXXXXXXXXXXXXXXXXXXGXXXXXXXXXXXXXXXXXXXGXXXXXXXXXXXXXXXXXXXGXXXXXXXXXXXXXXXXXXXGXXXXXXXXXXXXXXXXXXXGXXXXXXXXXXXXXXXXXXXGXXXXXXXXXXXXXXXXXXXGAXXXXXXXXXXXXXXXXXX,0,10,0
19341,14,1,13,121,465,0,0,481,270,211,GXXXXXXXXXXXXXXXXXXXGXXXXXXXXXXXXXXXXXXXGXXXXXXXXXXXXXXXXXXXGXXXXXXXXXXXXXXXXXXXGXXXXXXXXXXXXXXXXXXXGXXXXXXXXXXXXXXXXXXXGXXXXXXXXXXXXXXXXXXXGXXXXXXXXXXXXXXXXXXXGXXXXXXXXXXXXXXXXXXXGXXXXXXXXXXXXXXXXXXXGXXXXXXXXXXXXXXXXXXXGXXXXXXXXXXXXXXXXXXXGAXXXXXXXXXXXXXXXXXX,0,10,0
19362,14,1,13,127,459,0,0,475,263,212,GXXXXXXXXXXXXXXXXXXXGXXXXXXXXXXXXXXXXXXXGXXXXXXXXXXXXXXXXXXXGXXXXXXXXXXXXXXXXXXXGXXXXXXXXXXXXXXXXXXXGXXXXXXXXXXXXXXXXXXXGXXXXXXXXXXXXXXXXXXXGXXXXXXXXXXXXXXXXXXXGXXXXXXXXXXXXXXXXXXXGXXXXXXXXXXXXXXXXXXXGXXXXXXXXXXXXXXXXXXXGXXXXXXXXXXXXXXXXXXXGAXXXXXXXXXXXXXXXXXX,0,10,0
19383,14,1,13,127,459,0,0,474,266,208,GXXXXXXXXXXXXXXXXXXXGXXXXXXXXXXXXXXXXXXXGXXXXXXXXXXXXXXXXXXXGXXXXXXXXXXXXXXXXXXXGXXXXXXXXXXXXXXXXXXXGXXXXXXXXXXXXXXXXXXXGXXXXXXXXXXXXXXXXXXXGXXXXXXXXXXXXXXXXXXXGXXXXXXXXXXXXXXXXXXXGXXXXXXXXXXXXXXXXXXXGXXXXXXXXXXXXXXXXXXXGXXXXXXXXXXXXXXXXXXXGAXXXXXXXXXXXXXXXXXX,0,10,0
19404,14,1,13,125,461,0,0,475,272,203,GXXXXXXXXXXXXXXXXXXXGXXXXXXXXXXXXXXXXXXXGXXXXXXXXXXXXXXXXXXXGXXXXXXXXXXXXXXXXXXXGXXXXXXXXXXXXXXXXXXXGXXXXXXXXXXXXXXXXXXXGXXXXXXXXXXXXXXXXXXXGXXXXXXXXXXXXXXXXXXXGXXXXXXXXXXXXXXXXXXXGXXXXXXXXXXXXXXXXXXXGXXXXXXXXXXXXXXXXXXXGXXXXXXXXXXXXXXXXXXXGAXXXXXXXXXXXXXXXXXX,0,10,0

19425,14,1,13,132,454,0,0,468,274,194,GXXXXXXXXXXXXXXXXXXXGXXXXXXXXXXXXXXXXXXXGXXXXXXXXXXXXXXXXXXXGXXXXXXXXXXXXXXXXXXXGXXXXXXXXXXXXXXXXXXXGXXXXXXXXXXXXXXXXXXXGXXXXXXXXXXXXXXXXXXXGXXXXXXXXXXXXXXXXXXXGXXXXXXXXXXXXXXXXXXXGXXXXXXXXXXXXXXXXXXXGXXXXXXXXXXXXXXXXXXXGXXXXXXXXXXXXXXXXXXXGAXXXXXXXXXXXXXXXXXX,0,10,0
19446,14,1,13,131,455,0,0,467,267,200,GXXXXXXXXXXXXXXXXXXXGXXXXXXXXXXXXXXXXXXXGXXXXXXXXXXXXXXXXXXXGXXXXXXXXXXXXXXXXXXXGXXXXXXXXXXXXXXXXXXXGXXXXXXXXXXXXXXXXXXXGXXXXXXXXXXXXXXXXXXXGXXXXXXXXXXXXXXXXXXXGXXXXXXXXXXXXXXXXXXXGXXXXXXXXXXXXXXXXXXXGXXXXXXXXXXXXXXXXXXXGXXXXXXXXXXXXXXXXXXXGAXXXXXXXXXXXXXXXXXX,0,10,0
19467,13,0,13,137,450,0,0,462,264,198,GXXXXXXXXXXXXXXXXXXXGXXXXXXXXXXXXXXXXXXXGXXXXXXXXXXXXXXXXXXXGXXXXXXXXXXXXXXXXXXXGXXXXXXXXXXXXXXXXXXXGXXXXXXXXXXXXXXXXXXXGXXXXXXXXXXXXXXXXXXXGXXXXXXXXXXXXXXXXXXXGXXXXXXXXXXXXXXXXXXXGXXXXXXXXXXXXXXXXXXXGXXXXXXXXXXXXXXXXXXXGXXXXXXXXXXXXXXXXXXXGXXXXXXXXXXXXXXXXXXX,0,10,0
19488,13,0,13,132,455,0,0,467,264,203,GXXXXXXXXXXXXXXXXXXXGXXXXXXXXXXXXXXXXXXXGXXXXXXXXXXXXXXXXXXXGXXXXXXXXXXXXXXXXXXXGXXXXXXXXXXXXXXXXXXXGXXXXXXXXXXXXXXXXXXXGXXXXXXXXXXXXXXXXXXXGXXXXXXXXXXXXXXXXXXXGXXXXXXXXXXXXXXXXXXXGXXXXXXXXXXXXXXXXXXXGXXXXXXXXXXXXXXXXXXXGXXXXXXXXXXXXXXXXXXXGXXXXXXXXXXXXXXXXXXX,0,10,0
19509,14,1,13,135,451,0,0,464,263,201,GAXXXXXXXXXXXXXXXXXXGXXXXXXXXXXXXXXXXXXXGXXXXXXXXXXXXXXXXXXXGXXXXXXXXXXXXXXXXXXXGXXXXXXXXXXXXXXXXXXXGXXXXXXXXXXXXXXXXXXXGXXXXXXXXXXXXXXXXXXXGXXXXXXXXXXXXXXXXXXXGXXXXXXXXXXXXXXXXXXXGXXXXXXXXXXXXXXXXXXXGXXXXXXXXXXXXXXXXXXXGXXXXXXXXXXXXXXXXXXXGXXXXXXXXXXXXXXXXXXX,0,10,0

19530,14,1,13,127,459,0,0,471,264,207,GAXXXXXXXXXXXXXXXXXXGXXXXXXXXXXXXXXXXXXXGXXXXXXXXXXXXXXXXXXXGXXXXXXXXXXXXXXXXXXXGXXXXXXXXXXXXXXXXXXXGXXXXXXXXXXXXXXXXXXXGXXXXXXXXXXXXXXXXXXXGXXXXXXXXXXXXXXXXXXXGXXXXXXXXXXXXXXXXXXXGXXXXXXXXXXXXXXXXXXXGXXXXXXXXXXXXXXXXXXXGXXXXXXXXXXXXXXXXXXXGXXXXXXXXXXXXXXXXXXX,0,10,0
19551,14,1,13,133,453,0,0,466,271,195,GAXXXXXXXXXXXXXXXXXXGXXXXXXXXXXXXXXXXXXXGXXXXXXXXXXXXXXXXXXXGXXXXXXXXXXXXXXXXXXXGXXXXXXXXXXXXXXXXXXXGXXXXXXXXXXXXXXXXXXXGXXXXXXXXXXXXXXXXXXXGXXXXXXXXXXXXXXXXXXXGXXXXXXXXXXXXXXXXXXXGXXXXXXXXXXXXXXXXXXXGXXXXXXXXXXXXXXXXXXXGXXXXXXXXXXXXXXXXXXXGXXXXXXXXXXXXXXXXXXX,0,10,0
19572,15,2,13,136,449,0,0,463,266,197,GAXXXXXXXXXXXXXXXXXXGXXXXXXXXXXXXXXXXXXXGXXXXXXXXXXXXXXXXXXXGXXXXXXXXXXXXXXXXXXXGAXXXXXXXXXXXXXXXXXXGXXXXXXXXXXXXXXXXXXXGXXXXXXXXXXXXXXXXXXXGXXXXXXXXXXXXXXXXXXXGXXXXXXXXXXXXXXXXXXXGXXXXXXXXXXXXXXXXXXXGXXXXXXXXXXXXXXXXXXXGXXXXXXXXXXXXXXXXXXXGXXXXXXXXXXXXXXXXXXX,0,10,0
19593,15,2,13,132,453,0,0,466,267,199,GAXXXXXXXXXXXXXXXXXXGXXXXXXXXXXXXXXXXXXXGXXXXXXXXXXXXXXXXXXXGXXXXXXXXXXXXXXXXXXXGAXXXXXXXXXXXXXXXXXXGXXXXXXXXXXXXXXXXXXXGXXXXXXXXXXXXXXXXXXXGXXXXXXXXXXXXXXXXXXXGXXXXXXXXXXXXXXXXXXXGXXXXXXXXXXXXXXXXXXXGXXXXXXXXXXXXXXXXXXXGXXXXXXXXXXXXXXXXXXXGXXXXXXXXXXXXXXXXXXX,0,10,0
19614,15,2,13,137,448,0,0,462,268,194,GAXXXXXXXXXXXXXXXXXXGXXXXXXXXXXXXXXXXXXXGXXXXXXXXXXXXXXXXXXXGXXXXXXXXXXXXXXXXXXXGAXXXXXXXXXXXXXXXXXXGXXXXXXXXXXXXXXXXXXXGXXXXXXXXXXXXXXXXXXXGXXXXXXXXXXXXXXXXXXXGXXXXXXXXXXXXXXXXXXXGXXXXXXXXXXXXXXXXXXXGXXXXXXXXXXXXXXXXXXXGXXXXXXXXXXXXXXXXXXXGXXXXXXXXXXXXXXXXXXX,0,10,0

19635,15,1,14,141,444,0,0,457,265,192,GAXXXXXXXXXXXXXXXXXXGXXXXXXXXXXXXXXXXXXXGXXXXXXXXXXXXXXXXXXXGXXXXXXXXXXXXXXXXXXXGOXXXXXXXXXXXXXXXXXXGXXXXXXXXXXXXXXXXXXXGXXXXXXXXXXXXXXXXXXXGXXXXXXXXXXXXXXXXXXXGXXXXXXXXXXXXXXXXXXXGXXXXXXXXXXXXXXXXXXXGXXXXXXXXXXXXXXXXXXXGXXXXXXXXXXXXXXXXXXXGXXXXXXXXXXXXXXXXXXX,0,10,0
19656,14,1,13,138,448,0,0,458,262,196,GAXXXXXXXXXXXXXXXXXXGXXXXXXXXXXXXXXXXXXXGXXXXXXXXXXXXXXXXXXXGXXXXXXXXXXXXXXXXXXXGXXXXXXXXXXXXXXXXXXXGXXXXXXXXXXXXXXXXXXXGXXXXXXXXXXXXXXXXXXXGXXXXXXXXXXXXXXXXXXXGXXXXXXXXXXXXXXXXXXXGXXXXXXXXXXXXXXXXXXXGXXXXXXXXXXXXXXXXXXXGXXXXXXXXXXXXXXXXXXXGXXXXXXXXXXXXXXXXXXX,0,10,0
19677,14,1,13,139,447,0,0,460,260,200,GAXXXXXXXXXXXXXXXXXXGXXXXXXXXXXXXXXXXXXXGXXXXXXXXXXXXXXXXXXXGXXXXXXXXXXXXXXXXXXXGXXXXXXXXXXXXXXXXXXXGXXXXXXXXXXXXXXXXXXXGXXXXXXXXXXXXXXXXXXXGXXXXXXXXXXXXXXXXXXXGXXXXXXXXXXXXXXXXXXXGXXXXXXXXXXXXXXXXXXXGXXXXXXXXXXXXXXXXXXXGXXXXXXXXXXXXXXXXXXXGXXXXXXXXXXXXXXXXXXX,0,10,0
19698,14,1,13,131,455,0,0,468,262,206,GAXXXXXXXXXXXXXXXXXXGXXXXXXXXXXXXXXXXXXXGXXXXXXXXXXXXXXXXXXXGXXXXXXXXXXXXXXXXXXXGXXXXXXXXXXXXXXXXXXXGXXXXXXXXXXXXXXXXXXXGXXXXXXXXXXXXXXXXXXXGXXXXXXXXXXXXXXXXXXXGXXXXXXXXXXXXXXXXXXXGXXXXXXXXXXXXXXXXXXXGXXXXXXXXXXXXXXXXXXXGXXXXXXXXXXXXXXXXXXXGXXXXXXXXXXXXXXXXXXX,0,10,0
19719,14,1,13,128,458,0,0,470,260,210,GAXXXXXXXXXXXXXXXXXXGXXXXXXXXXXXXXXXXXXXGXXXXXXXXXXXXXXXXXXXGXXXXXXXXXXXXXXXXXXXGXXXXXXXXXXXXXXXXXXXGXXXXXXXXXXXXXXXXXXXGXXXXXXXXXXXXXXXXXXXGXXXXXXXXXXXXXXXXXXXGXXXXXXXXXXXXXXXXXXXGXXXXXXXXXXXXXXXXXXXGXXXXXXXXXXXXXXXXXXXGXXXXXXXXXXXXXXXXXXXGXXXXXXXXXXXXXXXXXXX,0,10,0

19740,14,1,13,112,474,0,0,488,266,222,GAXXXXXXXXXXXXXXXXXXGXXXXXXXXXXXXXXXXXXXGXXXXXXXXXXXXXXXXXXXGXXXXXXXXXXXXXXXXXXXGXXXXXXXXXXXXXXXXXXXGXXXXXXXXXXXXXXXXXXXGXXXXXXXXXXXXXXXXXXXGXXXXXXXXXXXXXXXXXXXGXXXXXXXXXXXXXXXXXXXGXXXXXXXXXXXXXXXXXXXGXXXXXXXXXXXXXXXXXXXGXXXXXXXXXXXXXXXXXXXGXXXXXXXXXXXXXXXXXXX,0,10,0
19761,15,2,13,118,467,0,0,481,265,216,GAXXXXXXXXXXXXXXXXXXGXXXXXXXXXXXXXXXXXXXGXXXXXXXXXXXXXXXXXXXGXXXXXXXXXXXXXXXXXXXGXXXXXXXXXXXXXXXXXXXGXXXXXXXXXXXXXXXXXXXGXXXXXXXXXXXXXXXXXXXGXXXXXXXXXXXXXXXXXXXGXXXXXXXXXXXXXXXXXXXGXXXXXXXXXXXXXXXXXXXGXXXXXXXXXXXXXXXXXXXGAXXXXXXXXXXXXXXXXXXGXXXXXXXXXXXXXXXXXXX,0,10,0
19782,16,3,13,120,464,0,0,479,268,211,GAXXXXXXXXXXXXXXXXXXGXXXXXXXXXXXXXXXXXXXGXXXXXXXXXXXXXXXXXXXGXXXXXXXXXXXXXXXXXXXGXXXXXXXXXXXXXXXXXXXGXXXXXXXXXXXXXXXXXXXGAXXXXXXXXXXXXXXXXXXGXXXXXXXXXXXXXXXXXXXGXXXXXXXXXXXXXXXXXXXGXXXXXXXXXXXXXXXXXXXGXXXXXXXXXXXXXXXXXXXGAXXXXXXXXXXXXXXXXXXGXXXXXXXXXXXXXXXXXXX,0,10,0
19803,16,3,13,117,467,0,0,482,272,210,GAXXXXXXXXXXXXXXXXXXGXXXXXXXXXXXXXXXXXXXGXXXXXXXXXXXXXXXXXXXGXXXXXXXXXXXXXXXXXXXGXXXXXXXXXXXXXXXXXXXGXXXXXXXXXXXXXXXXXXXGAXXXXXXXXXXXXXXXXXXGXXXXXXXXXXXXXXXXXXXGXXXXXXXXXXXXXXXXXXXGXXXXXXXXXXXXXXXXXXXGXXXXXXXXXXXXXXXXXXXGAXXXXXXXXXXXXXXXXXXGXXXXXXXXXXXXXXXXXXX,0,10,0
19824,16,3,13,126,458,0,0,473,263,210,GAXXXXXXXXXXXXXXXXXXGXXXXXXXXXXXXXXXXXXXGXXXXXXXXXXXXXXXXXXXGXXXXXXXXXXXXXXXXXXXGXXXXXXXXXXXXXXXXXXXGXXXXXXXXXXXXXXXXXXXGAXXXXXXXXXXXXXXXXXXGXXXXXXXXXXXXXXXXXXXGXXXXXXXXXXXXXXXXXXXGXXXXXXXXXXXXXXXXXXXGXXXXXXXXXXXXXXXXXXXGAXXXXXXXXXXXXXXXXXXGXXXXXXXXXXXXXXXXXXX,0,10,0

19845,17,3,14,122,461,0,0,475,260,215,GOXXXXXXXXXXXXXXXXXXGXXXXXXXXXXXXXXXXXXXGAXXXXXXXXXXXXXXXXXXGXXXXXXXXXXXXXXXXXXXGXXXXXXXXXXXXXXXXXXXGXXXXXXXXXXXXXXXXXXXGAXXXXXXXXXXXXXXXXXXGXXXXXXXXXXXXXXXXXXXGXXXXXXXXXXXXXXXXXXXGXXXXXXXXXXXXXXXXXXXGXXXXXXXXXXXXXXXXXXXGAXXXXXXXXXXXXXXXXXXGXXXXXXXXXXXXXXXXXXX,0,10,0
19866,16,3,13,118,466,0,0,479,258,221,GXXXXXXXXXXXXXXXXXXXGXXXXXXXXXXXXXXXXXXXGAXXXXXXXXXXXXXXXXXXGXXXXXXXXXXXXXXXXXXXGXXXXXXXXXXXXXXXXXXXGXXXXXXXXXXXXXXXXXXXGAXXXXXXXXXXXXXXXXXXGXXXXXXXXXXXXXXXXXXXGXXXXXXXXXXXXXXXXXXXGXXXXXXXXXXXXXXXXXXXGXXXXXXXXXXXXXXXXXXXGAXXXXXXXXXXXXXXXXXXGXXXXXXXXXXXXXXXXXXX,0,10,0
19887,16,3,13,116,468,0,0,483,268,215,GXXXXXXXXXXXXXXXXXXXGXXXXXXXXXXXXXXXXXXXGAXXXXXXXXXXXXXXXXXXGXXXXXXXXXXXXXXXXXXXGXXXXXXXXXXXXXXXXXXXGXXXXXXXXXXXXXXXXXXXGAXXXXXXXXXXXXXXXXXXGXXXXXXXXXXXXXXXXXXXGXXXXXXXXXXXXXXXXXXXGXXXXXXXXXXXXXXXXXXXGXXXXXXXXXXXXXXXXXXXGAXXXXXXXXXXXXXXXXXXGXXXXXXXXXXXXXXXXXXX,0,10,0
19908,16,3,13,117,467,0,0,481,273,208,GXXXXXXXXXXXXXXXXXXXGXXXXXXXXXXXXXXXXXXXGAXXXXXXXXXXXXXXXXXXGXXXXXXXXXXXXXXXXXXXGXXXXXXXXXXXXXXXXXXXGXXXXXXXXXXXXXXXXXXXGAXXXXXXXXXXXXXXXXXXGXXXXXXXXXXXXXXXXXXXGXXXXXXXXXXXXXXXXXXXGXXXXXXXXXXXXXXXXXXXGXXXXXXXXXXXXXXXXXXXGAXXXXXXXXXXXXXXXXXXGXXXXXXXXXXXXXXXXXXX,0,10,0
19929,16,2,14,119,465,0,0,477,271,206,GXXXXXXXXXXXXXXXXXXXGXXXXXXXXXXXXXXXXXXXGAXXXXXXXXXXXXXXXXXXGXXXXXXXXXXXXXXXXXXXGXXXXXXXXXXXXXXXXXXXGXXXXXXXXXXXXXXXXXXXGOXXXXXXXXXXXXXXXXXXGXXXXXXXXXXXXXXXXXXXGXXXXXXXXXXXXXXXXXXXGXXXXXXXXXXXXXXXXXXXGXXXXXXXXXXXXXXXXXXXGAXXXXXXXXXXXXXXXXXXGXXXXXXXXXXXXXXXXXXX,0,10,0

19950,17,2,15,122,461,0,0,475,272,203,GXXXXXXXXXXXXXXXXXXXGXXXXXXXXXXXXXXXXXXXGAXXXXXXXXXXXXXXXXXXGXXXXXXXXXXXXXXXXXXXGXXXXXXXXXXXXXXXXXXXGXXXXXXXXXXXXXXXXXXXGOXXXXXXXXXXXXXXXXXXGXXXXXXXXXXXXXXXXXXXGXXXXXXXXXXXXXXXXXXXGXXXXXXXXXXXXXXXXXXXGXXXXXXXXXXXXXXXXXXXGOXXXXXXXXXXXXXXXXXXGAXXXXXXXXXXXXXXXXXX,0,10,0
19971,15,2,13,127,458,0,0,472,268,204,GXXXXXXXXXXXXXXXXXXXGXXXXXXXXXXXXXXXXXXXGAXXXXXXXXXXXXXXXXXXGXXXXXXXXXXXXXXXXXXXGXXXXXXXXXXXXXXXXXXXGXXXXXXXXXXXXXXXXXXXGXXXXXXXXXXXXXXXXXXXGXXXXXXXXXXXXXXXXXXXGXXXXXXXXXXXXXXXXXXXGXXXXXXXXXXXXXXXXXXXGXXXXXXXXXXXXXXXXXXXGXXXXXXXXXXXXXXXXXXXGAXXXXXXXXXXXXXXXXXX,0,10,0
19992,15,1,14,122,463,0,0,476,275,201,GXXXXXXXXXXXXXXXXXXXGXXXXXXXXXXXXXXXXXXXGOXXXXXXXXXXXXXXXXXXGXXXXXXXXXXXXXXXXXXXGXXXXXXXXXXXXXXXXXXXGXXXXXXXXXXXXXXXXXXXGXXXXXXXXXXXXXXXXXXXGXXXXXXXXXXXXXXXXXXXGXXXXXXXXXXXXXXXXXXXGXXXXXXXXXXXXXXXXXXXGXXXXXXXXXXXXXXXXXXXGXXXXXXXXXXXXXXXXXXXGAXXXXXXXXXXXXXXXXXX,0,10,0
20013,14,1,13,125,461,0,0,474,268,206,GXXXXXXXXXXXXXXXXXXXGXXXXXXXXXXXXXXXXXXXGXXXXXXXXXXXXXXXXXXXGXXXXXXXXXXXXXXXXXXXGXXXXXXXXXXXXXXXXXXXGXXXXXXXXXXXXXXXXXXXGXXXXXXXXXXXXXXXXXXXGXXXXXXXXXXXXXXXXXXXGXXXXXXXXXXXXXXXXXXXGXXXXXXXXXXXXXXXXXXXGXXXXXXXXXXXXXXXXXXXGXXXXXXXXXXXXXXXXXXXGAXXXXXXXXXXXXXXXXXX,0,10,0
20034,14,1,13,131,455,0,0,469,263,206,GXXXXXXXXXXXXXXXXXXXGXXXXXXXXXXXXXXXXXXXGXXXXXXXXXXXXXXXXXXXGXXXXXXXXXXXXXXXXXXXGXXXXXXXXXXXXXXXXXXXGXXXXXXXXXXXXXXXXXXXGXXXXXXXXXXXXXXXXXXXGXXXXXXXXXXXXXXXXXXXGXXXXXXXXXXXXXXXXXXXGXXXXXXXXXXXXXXXXXXXGXXXXXXXXXXXXXXXXXXXGXXXXXXXXXXXXXXXXXXXGAXXXXXXXXXXXXXXXXXX,0,10,0

20055,14,1,13,123,463,0,0,474,267,207,GXXXXXXXXXXXXXXXXXXXGXXXXXXXXXXXXXXXXXXXGXXXXXXXXXXXXXXXXXXXGXXXXXXXXXXXXXXXXXXXGXXXXXXXXXXXXXXXXXXXGXXXXXXXXXXXXXXXXXXXGXXXXXXXXXXXXXXXXXXXGXXXXXXXXXXXXXXXXXXXGXXXXXXXXXXXXXXXXXXXGXXXXXXXXXXXXXXXXXXXGXXXXXXXXXXXXXXXXXXXGXXXXXXXXXXXXXXXXXXXGAXXXXXXXXXXXXXXXXXX,0,10,0
20076,14,1,13,127,459,0,0,473,266,207,GXXXXXXXXXXXXXXXXXXXGXXXXXXXXXXXXXXXXXXXGXXXXXXXXXXXXXXXXXXXGXXXXXXXXXXXXXXXXXXXGXXXXXXXXXXXXXXXXXXXGXXXXXXXXXXXXXXXXXXXGXXXXXXXXXXXXXXXXXXXGXXXXXXXXXXXXXXXXXXXGXXXXXXXXXXXXXXXXXXXGXXXXXXXXXXXXXXXXXXXGXXXXXXXXXXXXXXXXXXXGXXXXXXXXXXXXXXXXXXXGAXXXXXXXXXXXXXXXXXX,0,10,0
20097,14,1,13,118,468,0,0,480,264,216,GXXXXXXXXXXXXXXXXXXXGXXXXXXXXXXXXXXXXXXXGXXXXXXXXXXXXXXXXXXXGXXXXXXXXXXXXXXXXXXXGXXXXXXXXXXXXXXXXXXXGXXXXXXXXXXXXXXXXXXXGXXXXXXXXXXXXXXXXXXXGXXXXXXXXXXXXXXXXXXXGXXXXXXXXXXXXXXXXXXXGXXXXXXXXXXXXXXXXXXXGXXXXXXXXXXXXXXXXXXXGXXXXXXXXXXXXXXXXXXXGAXXXXXXXXXXXXXXXXXX,0,10,0
20118,14,1,13,117,469,0,0,482,265,217,GXXXXXXXXXXXXXXXXXXXGXXXXXXXXXXXXXXXXXXXGXXXXXXXXXXXXXXXXXXXGXXXXXXXXXXXXXXXXXXXGXXXXXXXXXXXXXXXXXXXGXXXXXXXXXXXXXXXXXXXGXXXXXXXXXXXXXXXXXXXGXXXXXXXXXXXXXXXXXXXGXXXXXXXXXXXXXXXXXXXGXXXXXXXXXXXXXXXXXXXGXXXXXXXXXXXXXXXXXXXGXXXXXXXXXXXXXXXXXXXGAXXXXXXXXXXXXXXXXXX,0,10,0
20139,14,1,13,119,467,0,0,479,271,208,GXXXXXXXXXXXXXXXXXXXGXXXXXXXXXXXXXXXXXXXGXXXXXXXXXXXXXXXXXXXGXXXXXXXXXXXXXXXXXXXGXXXXXXXXXXXXXXXXXXXGXXXXXXXXXXXXXXXXXXXGXXXXXXXXXXXXXXXXXXXGXXXXXXXXXXXXXXXXXXXGXXXXXXXXXXXXXXXXXXXGXXXXXXXXXXXXXXXXXXXGXXXXXXXXXXXXXXXXXXXGXXXXXXXXXXXXXXXXXXXGAXXXXXXXXXXXXXXXXXX,0,10,0

20160,13,0,13,112,475,0,0,486,275,211,GXXXXXXXXXXXXXXXXXXXGXXXXXXXXXXXXXXXXXXXGXXXXXXXXXXXXXXXXXXXGXXXXXXXXXXXXXXXXXXXGXXXXXXXXXXXXXXXXXXXGXXXXXXXXXXXXXXXXXXXGXXXXXXXXXXXXXXXXXXXGXXXXXXXXXXXXXXXXXXXGXXXXXXXXXXXXXXXXXXXGXXXXXXXXXXXXXXXXXXXGXXXXXXXXXXXXXXXXXXXGXXXXXXXXXXXXXXXXXXXGXXXXXXXXXXXXXXXXXXX,0,10,0
20181,13,0,13,113,474,0,0,486,271,215,GXXXXXXXXXXXXXXXXXXXGXXXXXXXXXXXXXXXXXXXGXXXXXXXXXXXXXXXXXXXGXXXXXXXXXXXXXXXXXXXGXXXXXXXXXXXXXXXXXXXGXXXXXXXXXXXXXXXXXXXGXXXXXXXXXXXXXXXXXXXGXXXXXXXXXXXXXXXXXXXGXXXXXXXXXXXXXXXXXXXGXXXXXXXXXXXXXXXXXXXGXXXXXXXXXXXXXXXXXXXGXXXXXXXXXXXXXXXXXXXGXXXXXXXXXXXXXXXXXXX,0,10,0
20202,13,0,13,111,476,0,0,489,265,224,GXXXXXXXXXXXXXXXXXXXGXXXXXXXXXXXXXXXXXXXGXXXXXXXXXXXXXXXXXXXGXXXXXXXXXXXXXXXXXXXGXXXXXXXXXXXXXXXXXXXGXXXXXXXXXXXXXXXXXXXGXXXXXXXXXXXXXXXXXXXGXXXXXXXXXXXXXXXXXXXGXXXXXXXXXXXXXXXXXXXGXXXXXXXXXXXXXXXXXXXGXXXXXXXXXXXXXXXXXXXGXXXXXXXXXXXXXXXXXXXGXXXXXXXXXXXXXXXXXXX,0,10,0
20223,13,0,13,111,476,0,0,488,267,221,GXXXXXXXXXXXXXXXXXXXGXXXXXXXXXXXXXXXXXXXGXXXXXXXXXXXXXXXXXXXGXXXXXXXXXXXXXXXXXXXGXXXXXXXXXXXXXXXXXXXGXXXXXXXXXXXXXXXXXXXGXXXXXXXXXXXXXXXXXXXGXXXXXXXXXXXXXXXXXXXGXXXXXXXXXXXXXXXXXXXGXXXXXXXXXXXXXXXXXXXGXXXXXXXXXXXXXXXXXXXGXXXXXXXXXXXXXXXXXXXGXXXXXXXXXXXXXXXXXXX,0,10,0
20244,13,0,13,114,473,0,0,486,267,219,GXXXXXXXXXXXXXXXXXXXGXXXXXXXXXXXXXXXXXXXGXXXXXXXXXXXXXXXXXXXGXXXXXXXXXXXXXXXXXXXGXXXXXXXXXXXXXXXXXXXGXXXXXXXXXXXXXXXXXXXGXXXXXXXXXXXXXXXXXXXGXXXXXXXXXXXXXXXXXXXGXXXXXXXXXXXXXXXXXXXGXXXXXXXXXXXXXXXXXXXGXXXXXXXXXXXXXXXXXXXGXXXXXXXXXXXXXXXXXXXGXXXXXXXXXXXXXXXXXXX,0,10,0

20265,13,0,13,111,476,0,0,489,271,218,GXXXXXXXXXXXXXXXXXXXGXXXXXXXXXXXXXXXXXXXGXXXXXXXXXXXXXXXXXXXGXXXXXXXXXXXXXXXXXXXGXXXXXXXXXXXXXXXXXXXGXXXXXXXXXXXXXXXXXXXGXXXXXXXXXXXXXXXXXXXGXXXXXXXXXXXXXXXXXXXGXXXXXXXXXXXXXXXXXXXGXXXXXXXXXXXXXXXXXXXGXXXXXXXXXXXXXXXXXXXGXXXXXXXXXXXXXXXXXXXGXXXXXXXXXXXXXXXXXXX,0,10,0
20286,13,0,13,112,475,0,0,487,267,220,GXXXXXXXXXXXXXXXXXXXGXXXXXXXXXXXXXXXXXXXGXXXXXXXXXXXXXXXXXXXGXXXXXXXXXXXXXXXXXXXGXXXXXXXXXXXXXXXXXXXGXXXXXXXXXXXXXXXXXXXGXXXXXXXXXXXXXXXXXXXGXXXXXXXXXXXXXXXXXXXGXXXXXXXXXXXXXXXXXXXGXXXXXXXXXXXXXXXXXXXGXXXXXXXXXXXXXXXXXXXGXXXXXXXXXXXXXXXXXXXGXXXXXXXXXXXXXXXXXXX,0,10,0
20307,13,0,13,105,482,0,0,494,265,229,GXXXXXXXXXXXXXXXXXXXGXXXXXXXXXXXXXXXXXXXGXXXXXXXXXXXXXXXXXXXGXXXXXXXXXXXXXXXXXXXGXXXXXXXXXXXXXXXXXXXGXXXXXXXXXXXXXXXXXXXGXXXXXXXXXXXXXXXXXXXGXXXXXXXXXXXXXXXXXXXGXXXXXXXXXXXXXXXXXXXGXXXXXXXXXXXXXXXXXXXGXXXXXXXXXXXXXXXXXXXGXXXXXXXXXXXXXXXXXXXGXXXXXXXXXXXXXXXXXXX,0,10,0
20328,13,0,13,100,487,0,0,501,274,227,GXXXXXXXXXXXXXXXXXXXGXXXXXXXXXXXXXXXXXXXGXXXXXXXXXXXXXXXXXXXGXXXXXXXXXXXXXXXXXXXGXXXXXXXXXXXXXXXXXXXGXXXXXXXXXXXXXXXXXXXGXXXXXXXXXXXXXXXXXXXGXXXXXXXXXXXXXXXXXXXGXXXXXXXXXXXXXXXXXXXGXXXXXXXXXXXXXXXXXXXGXXXXXXXXXXXXXXXXXXXGXXXXXXXXXXXXXXXXXXXGXXXXXXXXXXXXXXXXXXX,0,10,0
20349,13,0,13,106,481,0,0,495,276,219,GXXXXXXXXXXXXXXXXXXXGXXXXXXXXXXXXXXXXXXXGXXXXXXXXXXXXXXXXXXXGXXXXXXXXXXXXXXXXXXXGXXXXXXXXXXXXXXXXXXXGXXXXXXXXXXXXXXXXXXXGXXXXXXXXXXXXXXXXXXXGXXXXXXXXXXXXXXXXXXXGXXXXXXXXXXXXXXXXXXXGXXXXXXXXXXXXXXXXXXXGXXXXXXXXXXXXXXXXXXXGXXXXXXXXXXXXXXXXXXXGXXXXXXXXXXXXXXXXXXX,0,10,0

20370,13,0,13,112,475,0,0,489,275,214,GXXXXXXXXXXXXXXXXXXXGXXXXXXXXXXXXXXXXXXXGXXXXXXXXXXXXXXXXXXXGXXXXXXXXXXXXXXXXXXXGXXXXXXXXXXXXXXXXXXXGXXXXXXXXXXXXXXXXXXXGXXXXXXXXXXXXXXXXXXXGXXXXXXXXXXXXXXXXXXXGXXXXXXXXXXXXXXXXXXXGXXXXXXXXXXXXXXXXXXXGXXXXXXXXXXXXXXXXXXXGXXXXXXXXXXXXXXXXXXXGXXXXXXXXXXXXXXXXXXX,0,10,0
20391,13,0,13,112,475,0,0,489,267,222,GXXXXXXXXXXXXXXXXXXXGXXXXXXXXXXXXXXXXXXXGXXXXXXXXXXXXXXXXXXXGXXXXXXXXXXXXXXXXXXXGXXXXXXXXXXXXXXXXXXXGXXXXXXXXXXXXXXXXXXXGXXXXXXXXXXXXXXXXXXXGXXXXXXXXXXXXXXXXXXXGXXXXXXXXXXXXXXXXXXXGXXXXXXXXXXXXXXXXXXXGXXXXXXXXXXXXXXXXXXXGXXXXXXXXXXXXXXXXXXXGXXXXXXXXXXXXXXXXXXX,0,10,0
20412,13,0,13,114,473,0,0,487,268,219,GXXXXXXXXXXXXXXXXXXXGXXXXXXXXXXXXXXXXXXXGXXXXXXXXXXXXXXXXXXXGXXXXXXXXXXXXXXXXXXXGXXXXXXXXXXXXXXXXXXXGXXXXXXXXXXXXXXXXXXXGXXXXXXXXXXXXXXXXXXXGXXXXXXXXXXXXXXXXXXXGXXXXXXXXXXXXXXXXXXXGXXXXXXXXXXXXXXXXXXXGXXXXXXXXXXXXXXXXXXXGXXXXXXXXXXXXXXXXXXXGXXXXXXXXXXXXXXXXXXX,0,10,0
20433,13,0,13,114,473,0,0,487,266,221,GXXXXXXXXXXXXXXXXXXXGXXXXXXXXXXXXXXXXXXXGXXXXXXXXXXXXXXXXXXXGXXXXXXXXXXXXXXXXXXXGXXXXXXXXXXXXXXXXXXXGXXXXXXXXXXXXXXXXXXXGXXXXXXXXXXXXXXXXXXXGXXXXXXXXXXXXXXXXXXXGXXXXXXXXXXXXXXXXXXXGXXXXXXXXXXXXXXXXXXXGXXXXXXXXXXXXXXXXXXXGXXXXXXXXXXXXXXXXXXXGXXXXXXXXXXXXXXXXXXX,0,10,0
20454,13,0,13,114,473,0,0,487,267,220,GXXXXXXXXXXXXXXXXXXXGXXXXXXXXXXXXXXXXXXXGXXXXXXXXXXXXXXXXXXXGXXXXXXXXXXXXXXXXXXXGXXXXXXXXXXXXXXXXXXXGXXXXXXXXXXXXXXXXXXXGXXXXXXXXXXXXXXXXXXXGXXXXXXXXXXXXXXXXXXXGXXXXXXXXXXXXXXXXXXXGXXXXXXXXXXXXXXXXXXXGXXXXXXXXXXXXXXXXXXXGXXXXXXXXXXXXXXXXXXXGXXXXXXXXXXXXXXXXXXX,0,10,0

20475,13,0,13,114,473,0,0,489,268,221,GXXXXXXXXXXXXXXXXXXXGXXXXXXXXXXXXXXXXXXXGXXXXXXXXXXXXXXXXXXXGXXXXXXXXXXXXXXXXXXXGXXXXXXXXXXXXXXXXXXXGXXXXXXXXXXXXXXXXXXXGXXXXXXXXXXXXXXXXXXXGXXXXXXXXXXXXXXXXXXXGXXXXXXXXXXXXXXXXXXXGXXXXXXXXXXXXXXXXXXXGXXXXXXXXXXXXXXXXXXXGXXXXXXXXXXXXXXXXXXXGXXXXXXXXXXXXXXXXXXX,0,10,0
20496,13,0,13,113,474,0,0,489,265,224,GXXXXXXXXXXXXXXXXXXXGXXXXXXXXXXXXXXXXXXXGXXXXXXXXXXXXXXXXXXXGXXXXXXXXXXXXXXXXXXXGXXXXXXXXXXXXXXXXXXXGXXXXXXXXXXXXXXXXXXXGXXXXXXXXXXXXXXXXXXXGXXXXXXXXXXXXXXXXXXXGXXXXXXXXXXXXXXXXXXXGXXXXXXXXXXXXXXXXXXXGXXXXXXXXXXXXXXXXXXXGXXXXXXXXXXXXXXXXXXXGXXXXXXXXXXXXXXXXXXX,0,10,0
20517,13,0,13,114,473,0,0,488,269,219,GXXXXXXXXXXXXXXXXXXXGXXXXXXXXXXXXXXXXXXXGXXXXXXXXXXXXXXXXXXXGXXXXXXXXXXXXXXXXXXXGXXXXXXXXXXXXXXXXXXXGXXXXXXXXXXXXXXXXXXXGXXXXXXXXXXXXXXXXXXXGXXXXXXXXXXXXXXXXXXXGXXXXXXXXXXXXXXXXXXXGXXXXXXXXXXXXXXXXXXXGXXXXXXXXXXXXXXXXXXXGXXXXXXXXXXXXXXXXXXXGXXXXXXXXXXXXXXXXXXX,0,10,0
20538,13,0,13,125,462,0,0,477,271,206,GXXXXXXXXXXXXXXXXXXXGXXXXXXXXXXXXXXXXXXXGXXXXXXXXXXXXXXXXXXXGXXXXXXXXXXXXXXXXXXXGXXXXXXXXXXXXXXXXXXXGXXXXXXXXXXXXXXXXXXXGXXXXXXXXXXXXXXXXXXXGXXXXXXXXXXXXXXXXXXXGXXXXXXXXXXXXXXXXXXXGXXXXXXXXXXXXXXXXXXXGXXXXXXXXXXXXXXXXXXXGXXXXXXXXXXXXXXXXXXXGXXXXXXXXXXXXXXXXXXX,0,10,0
20559,13,0,13,122,465,0,0,480,270,210,GXXXXXXXXXXXXXXXXXXXGXXXXXXXXXXXXXXXXXXXGXXXXXXXXXXXXXXXXXXXGXXXXXXXXXXXXXXXXXXXGXXXXXXXXXXXXXXXXXXXGXXXXXXXXXXXXXXXXXXXGXXXXXXXXXXXXXXXXXXXGXXXXXXXXXXXXXXXXXXXGXXXXXXXXXXXXXXXXXXXGXXXXXXXXXXXXXXXXXXXGXXXXXXXXXXXXXXXXXXXGXXXXXXXXXXXXXXXXXXXGXXXXXXXXXXXXXXXXXXX,0,10,0

20580,14,1,13,117,469,0,0,486,271,215,GXXXXXXXXXXXXXXXXXXXGXXXXXXXXXXXXXXXXXXXGXXXXXXXXXXXXXXXXXXXGXXXXXXXXXXXXXXXXXXXGXXXXXXXXXXXXXXXXXXXGAXXXXXXXXXXXXXXXXXXGXXXXXXXXXXXXXXXXXXXGXXXXXXXXXXXXXXXXXXXGXXXXXXXXXXXXXXXXXXXGXXXXXXXXXXXXXXXXXXXGXXXXXXXXXXXXXXXXXXXGXXXXXXXXXXXXXXXXXXXGXXXXXXXXXXXXXXXXXXX,0,10,0
20601,14,1,13,118,468,0,0,485,274,211,GXXXXXXXXXXXXXXXXXXXGXXXXXXXXXXXXXXXXXXXGXXXXXXXXXXXXXXXXXXXGXXXXXXXXXXXXXXXXXXXGXXXXXXXXXXXXXXXXXXXGAXXXXXXXXXXXXXXXXXXGXXXXXXXXXXXXXXXXXXXGXXXXXXXXXXXXXXXXXXXGXXXXXXXXXXXXXXXXXXXGXXXXXXXXXXXXXXXXXXXGXXXXXXXXXXXXXXXXXXXGXXXXXXXXXXXXXXXXXXXGXXXXXXXXXXXXXXXXXXX,0,10,0
20622,15,2,13,115,470,0,0,488,275,213,GXXXXXXXXXXXXXXXXXXXGXXXXXXXXXXXXXXXXXXXGXXXXXXXXXXXXXXXXXXXGAXXXXXXXXXXXXXXXXXXGXXXXXXXXXXXXXXXXXXXGAXXXXXXXXXXXXXXXXXXGXXXXXXXXXXXXXXXXXXXGXXXXXXXXXXXXXXXXXXXGXXXXXXXXXXXXXXXXXXXGXXXXXXXXXXXXXXXXXXXGXXXXXXXXXXXXXXXXXXXGXXXXXXXXXXXXXXXXXXXGXXXXXXXXXXXXXXXXXXX,0,10,0
20643,15,2,13,125,460,0,0,477,281,196,GXXXXXXXXXXXXXXXXXXXGXXXXXXXXXXXXXXXXXXXGXXXXXXXXXXXXXXXXXXXGAXXXXXXXXXXXXXXXXXXGXXXXXXXXXXXXXXXXXXXGAXXXXXXXXXXXXXXXXXXGXXXXXXXXXXXXXXXXXXXGXXXXXXXXXXXXXXXXXXXGXXXXXXXXXXXXXXXXXXXGXXXXXXXXXXXXXXXXXXXGXXXXXXXXXXXXXXXXXXXGXXXXXXXXXXXXXXXXXXXGXXXXXXXXXXXXXXXXXXX,0,10,0
20664,15,2,13,138,447,0,0,462,271,191,GXXXXXXXXXXXXXXXXXXXGXXXXXXXXXXXXXXXXXXXGXXXXXXXXXXXXXXXXXXXGAXXXXXXXXXXXXXXXXXXGXXXXXXXXXXXXXXXXXXXGAXXXXXXXXXXXXXXXXXXGXXXXXXXXXXXXXXXXXXXGXXXXXXXXXXXXXXXXXXXGXXXXXXXXXXXXXXXXXXXGXXXXXXXXXXXXXXXXXXXGXXXXXXXXXXXXXXXXXXXGXXXXXXXXXXXXXXXXXXXGXXXXXXXXXXXXXXXXXXX,0,10,0

20685,15,2,13,136,449,0,0,464,271,193,GXXXXXXXXXXXXXXXXXXXGXXXXXXXXXXXXXXXXXXXGXXXXXXXXXXXXXXXXXXXGAXXXXXXXXXXXXXXXXXXGXXXXXXXXXXXXXXXXXXXGAXXXXXXXXXXXXXXXXXXGXXXXXXXXXXXXXXXXXXXGXXXXXXXXXXXXXXXXXXXGXXXXXXXXXXXXXXXXXXXGXXXXXXXXXXXXXXXXXXXGXXXXXXXXXXXXXXXXXXXGXXXXXXXXXXXXXXXXXXXGXXXXXXXXXXXXXXXXXXX,0,10,0
20706,15,2,13,131,454,0,0,467,273,194,GXXXXXXXXXXXXXXXXXXXGXXXXXXXXXXXXXXXXXXXGXXXXXXXXXXXXXXXXXXXGAXXXXXXXXXXXXXXXXXXGXXXXXXXXXXXXXXXXXXXGAXXXXXXXXXXXXXXXXXXGXXXXXXXXXXXXXXXXXXXGXXXXXXXXXXXXXXXXXXXGXXXXXXXXXXXXXXXXXXXGXXXXXXXXXXXXXXXXXXXGXXXXXXXXXXXXXXXXXXXGXXXXXXXXXXXXXXXXXXXGXXXXXXXXXXXXXXXXXXX,0,10,0
20727,14,1,13,127,459,0,0,473,275,198,GXXXXXXXXXXXXXXXXXXXGXXXXXXXXXXXXXXXXXXXGXXXXXXXXXXXXXXXXXXXGXXXXXXXXXXXXXXXXXXXGXXXXXXXXXXXXXXXXXXXGAXXXXXXXXXXXXXXXXXXGXXXXXXXXXXXXXXXXXXXGXXXXXXXXXXXXXXXXXXXGXXXXXXXXXXXXXXXXXXXGXXXXXXXXXXXXXXXXXXXGXXXXXXXXXXXXXXXXXXXGXXXXXXXXXXXXXXXXXXXGXXXXXXXXXXXXXXXXXXX,0,10,0
20748,14,1,13,129,457,0,0,469,278,191,GXXXXXXXXXXXXXXXXXXXGXXXXXXXXXXXXXXXXXXXGXXXXXXXXXXXXXXXXXXXGXXXXXXXXXXXXXXXXXXXGXXXXXXXXXXXXXXXXXXXGAXXXXXXXXXXXXXXXXXXGXXXXXXXXXXXXXXXXXXXGXXXXXXXXXXXXXXXXXXXGXXXXXXXXXXXXXXXXXXXGXXXXXXXXXXXXXXXXXXXGXXXXXXXXXXXXXXXXXXXGXXXXXXXXXXXXXXXXXXXGXXXXXXXXXXXXXXXXXXX,0,10,0
20769,14,1,13,133,453,0,0,467,274,193,GXXXXXXXXXXXXXXXXXXXGXXXXXXXXXXXXXXXXXXXGXXXXXXXXXXXXXXXXXXXGXXXXXXXXXXXXXXXXXXXGXXXXXXXXXXXXXXXXXXXGAXXXXXXXXXXXXXXXXXXGXXXXXXXXXXXXXXXXXXXGXXXXXXXXXXXXXXXXXXXGXXXXXXXXXXXXXXXXXXXGXXXXXXXXXXXXXXXXXXXGXXXXXXXXXXXXXXXXXXXGXXXXXXXXXXXXXXXXXXXGXXXXXXXXXXXXXXXXXXX,0,10,0

20790,14,0,14,123,463,0,0,475,274,201,GXXXXXXXXXXXXXXXXXXXGXXXXXXXXXXXXXXXXXXXGXXXXXXXXXXXXXXXXXXXGXXXXXXXXXXXXXXXXXXXGXXXXXXXXXXXXXXXXXXXGOXXXXXXXXXXXXXXXXXXGXXXXXXXXXXXXXXXXXXXGXXXXXXXXXXXXXXXXXXXGXXXXXXXXXXXXXXXXXXXGXXXXXXXXXXXXXXXXXXXGXXXXXXXXXXXXXXXXXXXGXXXXXXXXXXXXXXXXXXXGXXXXXXXXXXXXXXXXXXX,0,10,0
20811,13,0,13,121,466,0,0,479,280,199,GXXXXXXXXXXXXXXXXXXXGXXXXXXXXXXXXXXXXXXXGXXXXXXXXXXXXXXXXXXXGXXXXXXXXXXXXXXXXXXXGXXXXXXXXXXXXXXXXXXXGXXXXXXXXXXXXXXXXXXXGXXXXXXXXXXXXXXXXXXXGXXXXXXXXXXXXXXXXXXXGXXXXXXXXXXXXXXXXXXXGXXXXXXXXXXXXXXXXXXXGXXXXXXXXXXXXXXXXXXXGXXXXXXXXXXXXXXXXXXXGXXXXXXXXXXXXXXXXXXX,0,10,0
20832,13,0,13,126,461,0,0,474,274,200,GXXXXXXXXXXXXXXXXXXXGXXXXXXXXXXXXXXXXXXXGXXXXXXXXXXXXXXXXXXXGXXXXXXXXXXXXXXXXXXXGXXXXXXXXXXXXXXXXXXXGXXXXXXXXXXXXXXXXXXXGXXXXXXXXXXXXXXXXXXXGXXXXXXXXXXXXXXXXXXXGXXXXXXXXXXXXXXXXXXXGXXXXXXXXXXXXXXXXXXXGXXXXXXXXXXXXXXXXXXXGXXXXXXXXXXXXXXXXXXXGXXXXXXXXXXXXXXXXXXX,0,10,0
20853,13,0,13,126,461,0,0,473,277,196,GXXXXXXXXXXXXXXXXXXXGXXXXXXXXXXXXXXXXXXXGXXXXXXXXXXXXXXXXXXXGXXXXXXXXXXXXXXXXXXXGXXXXXXXXXXXXXXXXXXXGXXXXXXXXXXXXXXXXXXXGXXXXXXXXXXXXXXXXXXXGXXXXXXXXXXXXXXXXXXXGXXXXXXXXXXXXXXXXXXXGXXXXXXXXXXXXXXXXXXXGXXXXXXXXXXXXXXXXXXXGXXXXXXXXXXXXXXXXXXXGXXXXXXXXXXXXXXXXXXX,0,10,0
20874,14,1,13,126,460,0,0,473,276,197,GXXXXXXXXXXXXXXXXXXXGXXXXXXXXXXXXXXXXXXXGXXXXXXXXXXXXXXXXXXXGAXXXXXXXXXXXXXXXXXXGXXXXXXXXXXXXXXXXXXXGXXXXXXXXXXXXXXXXXXXGXXXXXXXXXXXXXXXXXXXGXXXXXXXXXXXXXXXXXXXGXXXXXXXXXXXXXXXXXXXGXXXXXXXXXXXXXXXXXXXGXXXXXXXXXXXXXXXXXXXGXXXXXXXXXXXXXXXXXXXGXXXXXXXXXXXXXXXXXXX,0,10,0

20895,14,1,13,125,461,0,0,475,270,205,GXXXXXXXXXXXXXXXXXXXGXXXXXXXXXXXXXXXXXXXGXXXXXXXXXXXXXXXXXXXGAXXXXXXXXXXXXXXXXXXGXXXXXXXXXXXXXXXXXXXGXXXXXXXXXXXXXXXXXXXGXXXXXXXXXXXXXXXXXXXGXXXXXXXXXXXXXXXXXXXGXXXXXXXXXXXXXXXXXXXGXXXXXXXXXXXXXXXXXXXGXXXXXXXXXXXXXXXXXXXGXXXXXXXXXXXXXXXXXXXGXXXXXXXXXXXXXXXXXXX,0,10,0
20916,14,1,13,119,467,0,0,481,275,206,GXXXXXXXXXXXXXXXXXXXGXXXXXXXXXXXXXXXXXXXGXXXXXXXXXXXXXXXXXXXGAXXXXXXXXXXXXXXXXXXGXXXXXXXXXXXXXXXXXXXGXXXXXXXXXXXXXXXXXXXGXXXXXXXXXXXXXXXXXXXGXXXXXXXXXXXXXXXXXXXGXXXXXXXXXXXXXXXXXXXGXXXXXXXXXXXXXXXXXXXGXXXXXXXXXXXXXXXXXXXGXXXXXXXXXXXXXXXXXXXGXXXXXXXXXXXXXXXXXXX,0,10,0
20937,14,0,14,115,471,0,0,484,275,209,GXXXXXXXXXXXXXXXXXXXGXXXXXXXXXXXXXXXXXXXGXXXXXXXXXXXXXXXXXXXGOXXXXXXXXXXXXXXXXXXGXXXXXXXXXXXXXXXXXXXGXXXXXXXXXXXXXXXXXXXGXXXXXXXXXXXXXXXXXXXGXXXXXXXXXXXXXXXXXXXGXXXXXXXXXXXXXXXXXXXGXXXXXXXXXXXXXXXXXXXGXXXXXXXXXXXXXXXXXXXGXXXXXXXXXXXXXXXXXXXGXXXXXXXXXXXXXXXXXXX,0,10,0
20958,13,0,13,111,476,0,0,489,275,214,GXXXXXXXXXXXXXXXXXXXGXXXXXXXXXXXXXXXXXXXGXXXXXXXXXXXXXXXXXXXGXXXXXXXXXXXXXXXXXXXGXXXXXXXXXXXXXXXXXXXGXXXXXXXXXXXXXXXXXXXGXXXXXXXXXXXXXXXXXXXGXXXXXXXXXXXXXXXXXXXGXXXXXXXXXXXXXXXXXXXGXXXXXXXXXXXXXXXXXXXGXXXXXXXXXXXXXXXXXXXGXXXXXXXXXXXXXXXXXXXGXXXXXXXXXXXXXXXXXXX,0,10,0
20979,13,0,13,106,481,0,0,495,271,224,GXXXXXXXXXXXXXXXXXXXGXXXXXXXXXXXXXXXXXXXGXXXXXXXXXXXXXXXXXXXGXXXXXXXXXXXXXXXXXXXGXXXXXXXXXXXXXXXXXXXGXXXXXXXXXXXXXXXXXXXGXXXXXXXXXXXXXXXXXXXGXXXXXXXXXXXXXXXXXXXGXXXXXXXXXXXXXXXXXXXGXXXXXXXXXXXXXXXXXXXGXXXXXXXXXXXXXXXXXXXGXXXXXXXXXXXXXXXXXXXGXXXXXXXXXXXXXXXXXXX,0,10,0

21000,13,0,13,100,487,0,0,500,279,221,GXXXXXXXXXXXXXXXXXXXGXXXXXXXXXXXXXXXXXXXGXXXXXXXXXXXXXXXXXXXGXXXXXXXXXXXXXXXXXXXGXXXXXXXXXXXXXXXXXXXGXXXXXXXXXXXXXXXXXXXGXXXXXXXXXXXXXXXXXXXGXXXXXXXXXXXXXXXXXXXGXXXXXXXXXXXXXXXXXXXGXXXXXXXXXXXXXXXXXXXGXXXXXXXXXXXXXXXXXXXGXXXXXXXXXXXXXXXXXXXGXXXXXXXXXXXXXXXXXXX,0,10,0
21021,13,0,13,109,478,0,0,492,274,218,GXXXXXXXXXXXXXXXXXXXGXXXXXXXXXXXXXXXXXXXGXXXXXXXXXXXXXXXXXXXGXXXXXXXXXXXXXXXXXXXGXXXXXXXXXXXXXXXXXXXGXXXXXXXXXXXXXXXXXXXGXXXXXXXXXXXXXXXXXXXGXXXXXXXXXXXXXXXXXXXGXXXXXXXXXXXXXXXXXXXGXXXXXXXXXXXXXXXXXXXGXXXXXXXXXXXXXXXXXXXGXXXXXXXXXXXXXXXXXXXGXXXXXXXXXXXXXXXXXXX,0,10,0
21042,14,1,13,109,477,0,0,490,274,216,GXXXXXXXXXXXXXXXXXXXGXXXXXXXXXXXXXXXXXXXGXXXXXXXXXXXXXXXXXXXGXXXXXXXXXXXXXXXXXXXGXXXXXXXXXXXXXXXXXXXGXXXXXXXXXXXXXXXXXXXGXXXXXXXXXXXXXXXXXXXGXXXXXXXXXXXXXXXXXXXGXXXXXXXXXXXXXXXXXXXGXXXXXXXXXXXXXXXXXXXGXXXXXXXXXXXXXXXXXXXGAXXXXXXXXXXXXXXXXXXGXXXXXXXXXXXXXXXXXXX,0,10,0
21063,14,1,13,114,472,0,0,486,271,215,GXXXXXXXXXXXXXXXXXXXGXXXXXXXXXXXXXXXXXXXGXXXXXXXXXXXXXXXXXXXGXXXXXXXXXXXXXXXXXXXGXXXXXXXXXXXXXXXXXXXGXXXXXXXXXXXXXXXXXXXGXXXXXXXXXXXXXXXXXXXGXXXXXXXXXXXXXXXXXXXGXXXXXXXXXXXXXXXXXXXGXXXXXXXXXXXXXXXXXXXGXXXXXXXXXXXXXXXXXXXGAXXXXXXXXXXXXXXXXXXGXXXXXXXXXXXXXXXXXXX,0,10,0
21084,14,1,13,111,475,0,0,489,272,217,GXXXXXXXXXXXXXXXXXXXGXXXXXXXXXXXXXXXXXXXGXXXXXXXXXXXXXXXXXXXGXXXXXXXXXXXXXXXXXXXGXXXXXXXXXXXXXXXXXXXGXXXXXXXXXXXXXXXXXXXGXXXXXXXXXXXXXXXXXXXGXXXXXXXXXXXXXXXXXXXGXXXXXXXXXXXXXXXXXXXGXXXXXXXXXXXXXXXXXXXGXXXXXXXXXXXXXXXXXXXGAXXXXXXXXXXXXXXXXXXGXXXXXXXXXXXXXXXXXXX,0,10,0

21105,14,1,13,107,479,0,0,492,275,217,GXXXXXXXXXXXXXXXXXXXGXXXXXXXXXXXXXXXXXXXGXXXXXXXXXXXXXXXXXXXGXXXXXXXXXXXXXXXXXXXGXXXXXXXXXXXXXXXXXXXGXXXXXXXXXXXXXXXXXXXGXXXXXXXXXXXXXXXXXXXGXXXXXXXXXXXXXXXXXXXGXXXXXXXXXXXXXXXXXXXGXXXXXXXXXXXXXXXXXXXGXXXXXXXXXXXXXXXXXXXGAXXXXXXXXXXXXXXXXXXGXXXXXXXXXXXXXXXXXXX,0,10,0
21126,14,1,13,98,488,0,0,502,277,225,GXXXXXXXXXXXXXXXXXXXGXXXXXXXXXXXXXXXXXXXGXXXXXXXXXXXXXXXXXXXGXXXXXXXXXXXXXXXXXXXGXXXXXXXXXXXXXXXXXXXGXXXXXXXXXXXXXXXXXXXGXXXXXXXXXXXXXXXXXXXGXXXXXXXXXXXXXXXXXXXGXXXXXXXXXXXXXXXXXXXGXXXXXXXXXXXXXXXXXXXGXXXXXXXXXXXXXXXXXXXGAXXXXXXXXXXXXXXXXXXGXXXXXXXXXXXXXXXXXXX,0,10,0
21147,14,1,13,102,484,0,0,497,279,218,GXXXXXXXXXXXXXXXXXXXGXXXXXXXXXXXXXXXXXXXGXXXXXXXXXXXXXXXXXXXGXXXXXXXXXXXXXXXXXXXGXXXXXXXXXXXXXXXXXXXGXXXXXXXXXXXXXXXXXXXGXXXXXXXXXXXXXXXXXXXGXXXXXXXXXXXXXXXXXXXGXXXXXXXXXXXXXXXXXXXGXXXXXXXXXXXXXXXXXXXGXXXXXXXXXXXXXXXXXXXGAXXXXXXXXXXXXXXXXXXGXXXXXXXXXXXXXXXXXXX,0,10,0
21168,14,1,13,97,489,0,0,503,284,219,GXXXXXXXXXXXXXXXXXXXGXXXXXXXXXXXXXXXXXXXGXXXXXXXXXXXXXXXXXXXGXXXXXXXXXXXXXXXXXXXGXXXXXXXXXXXXXXXXXXXGXXXXXXXXXXXXXXXXXXXGXXXXXXXXXXXXXXXXXXXGXXXXXXXXXXXXXXXXXXXGXXXXXXXXXXXXXXXXXXXGXXXXXXXXXXXXXXXXXXXGXXXXXXXXXXXXXXXXXXXGAXXXXXXXXXXXXXXXXXXGXXXXXXXXXXXXXXXXXXX,0,10,0
21189,14,1,13,111,475,0,0,490,286,204,GXXXXXXXXXXXXXXXXXXXGXXXXXXXXXXXXXXXXXXXGXXXXXXXXXXXXXXXXXXXGXXXXXXXXXXXXXXXXXXXGXXXXXXXXXXXXXXXXXXXGXXXXXXXXXXXXXXXXXXXGXXXXXXXXXXXXXXXXXXXGXXXXXXXXXXXXXXXXXXXGXXXXXXXXXXXXXXXXXXXGXXXXXXXXXXXXXXXXXXXGXXXXXXXXXXXXXXXXXXXGAXXXXXXXXXXXXXXXXXXGXXXXXXXXXXXXXXXXXXX,0,10,0

21210,14,1,13,117,469,0,0,483,282,201,GXXXXXXXXXXXXXXXXXXXGXXXXXXXXXXXXXXXXXXXGXXXXXXXXXXXXXXXXXXXGXXXXXXXXXXXXXXXXXXXGXXXXXXXXXXXXXXXXXXXGXXXXXXXXXXXXXXXXXXXGXXXXXXXXXXXXXXXXXXXGXXXXXXXXXXXXXXXXXXXGXXXXXXXXXXXXXXXXXXXGXXXXXXXXXXXXXXXXXXXGXXXXXXXXXXXXXXXXXXXGAXXXXXXXXXXXXXXXXXXGXXXXXXXXXXXXXXXXXXX,0,10,0
21231,14,0,14,119,467,0,0,483,279,204,GXXXXXXXXXXXXXXXXXXXGXXXXXXXXXXXXXXXXXXXGXXXXXXXXXXXXXXXXXXXGXXXXXXXXXXXXXXXXXXXGXXXXXXXXXXXXXXXXXXXGXXXXXXXXXXXXXXXXXXXGXXXXXXXXXXXXXXXXXXXGXXXXXXXXXXXXXXXXXXXGXXXXXXXXXXXXXXXXXXXGXXXXXXXXXXXXXXXXXXXGXXXXXXXXXXXXXXXXXXXGOXXXXXXXXXXXXXXXXXXGXXXXXXXXXXXXXXXXXXX,0,10,0
21252,13,0,13,117,470,0,0,487,278,209,GXXXXXXXXXXXXXXXXXXXGXXXXXXXXXXXXXXXXXXXGXXXXXXXXXXXXXXXXXXXGXXXXXXXXXXXXXXXXXXXGXXXXXXXXXXXXXXXXXXXGXXXXXXXXXXXXXXXXXXXGXXXXXXXXXXXXXXXXXXXGXXXXXXXXXXXXXXXXXXXGXXXXXXXXXXXXXXXXXXXGXXXXXXXXXXXXXXXXXXXGXXXXXXXXXXXXXXXXXXXGXXXXXXXXXXXXXXXXXXXGXXXXXXXXXXXXXXXXXXX,0,10,0
21273,13,0,13,123,464,0,0,481,275,206,GXXXXXXXXXXXXXXXXXXXGXXXXXXXXXXXXXXXXXXXGXXXXXXXXXXXXXXXXXXXGXXXXXXXXXXXXXXXXXXXGXXXXXXXXXXXXXXXXXXXGXXXXXXXXXXXXXXXXXXXGXXXXXXXXXXXXXXXXXXXGXXXXXXXXXXXXXXXXXXXGXXXXXXXXXXXXXXXXXXXGXXXXXXXXXXXXXXXXXXXGXXXXXXXXXXXXXXXXXXXGXXXXXXXXXXXXXXXXXXXGXXXXXXXXXXXXXXXXXXX,0,10,0
21294,13,0,13,114,473,0,0,489,276,213,GXXXXXXXXXXXXXXXXXXXGXXXXXXXXXXXXXXXXXXXGXXXXXXXXXXXXXXXXXXXGXXXXXXXXXXXXXXXXXXXGXXXXXXXXXXXXXXXXXXXGXXXXXXXXXXXXXXXXXXXGXXXXXXXXXXXXXXXXXXXGXXXXXXXXXXXXXXXXXXXGXXXXXXXXXXXXXXXXXXXGXXXXXXXXXXXXXXXXXXXGXXXXXXXXXXXXXXXXXXXGXXXXXXXXXXXXXXXXXXXGXXXXXXXXXXXXXXXXXXX,0,10,0

21315,13,0,13,115,472,0,0,489,280,209,GXXXXXXXXXXXXXXXXXXXGXXXXXXXXXXXXXXXXXXXGXXXXXXXXXXXXXXXXXXXGXXXXXXXXXXXXXXXXXXXGXXXXXXXXXXXXXXXXXXXGXXXXXXXXXXXXXXXXXXXGXXXXXXXXXXXXXXXXXXXGXXXXXXXXXXXXXXXXXXXGXXXXXXXXXXXXXXXXXXXGXXXXXXXXXXXXXXXXXXXGXXXXXXXXXXXXXXXXXXXGXXXXXXXXXXXXXXXXXXXGXXXXXXXXXXXXXXXXXXX,0,10,0
21336,13,0,13,117,470,0,0,488,279,209,GXXXXXXXXXXXXXXXXXXXGXXXXXXXXXXXXXXXXXXXGXXXXXXXXXXXXXXXXXXXGXXXXXXXXXXXXXXXXXXXGXXXXXXXXXXXXXXXXXXXGXXXXXXXXXXXXXXXXXXXGXXXXXXXXXXXXXXXXXXXGXXXXXXXXXXXXXXXXXXXGXXXXXXXXXXXXXXXXXXXGXXXXXXXXXXXXXXXXXXXGXXXXXXXXXXXXXXXXXXXGXXXXXXXXXXXXXXXXXXXGXXXXXXXXXXXXXXXXXXX,0,10,0
21357,13,0,13,119,468,0,0,485,274,211,GXXXXXXXXXXXXXXXXXXXGXXXXXXXXXXXXXXXXXXXGXXXXXXXXXXXXXXXXXXXGXXXXXXXXXXXXXXXXXXXGXXXXXXXXXXXXXXXXXXXGXXXXXXXXXXXXXXXXXXXGXXXXXXXXXXXXXXXXXXXGXXXXXXXXXXXXXXXXXXXGXXXXXXXXXXXXXXXXXXXGXXXXXXXXXXXXXXXXXXXGXXXXXXXXXXXXXXXXXXXGXXXXXXXXXXXXXXXXXXXGXXXXXXXXXXXXXXXXXXX,0,10,0
21378,13,0,13,111,476,0,0,493,277,216,GXXXXXXXXXXXXXXXXXXXGXXXXXXXXXXXXXXXXXXXGXXXXXXXXXXXXXXXXXXXGXXXXXXXXXXXXXXXXXXXGXXXXXXXXXXXXXXXXXXXGXXXXXXXXXXXXXXXXXXXGXXXXXXXXXXXXXXXXXXXGXXXXXXXXXXXXXXXXXXXGXXXXXXXXXXXXXXXXXXXGXXXXXXXXXXXXXXXXXXXGXXXXXXXXXXXXXXXXXXXGXXXXXXXXXXXXXXXXXXXGXXXXXXXXXXXXXXXXXXX,0,10,0
21399,13,0,13,112,475,0,0,491,270,221,GXXXXXXXXXXXXXXXXXXXGXXXXXXXXXXXXXXXXXXXGXXXXXXXXXXXXXXXXXXXGXXXXXXXXXXXXXXXXXXXGXXXXXXXXXXXXXXXXXXXGXXXXXXXXXXXXXXXXXXXGXXXXXXXXXXXXXXXXXXXGXXXXXXXXXXXXXXXXXXXGXXXXXXXXXXXXXXXXXXXGXXXXXXXXXXXXXXXXXXXGXXXXXXXXXXXXXXXXXXXGXXXXXXXXXXXXXXXXXXXGXXXXXXXXXXXXXXXXXXX,0,10,0

21420,13,0,13,107,480,0,0,496,278,218,GXXXXXXXXXXXXXXXXXXXGXXXXXXXXXXXXXXXXXXXGXXXXXXXXXXXXXXXXXXXGXXXXXXXXXXXXXXXXXXXGXXXXXXXXXXXXXXXXXXXGXXXXXXXXXXXXXXXXXXXGXXXXXXXXXXXXXXXXXXXGXXXXXXXXXXXXXXXXXXXGXXXXXXXXXXXXXXXXXXXGXXXXXXXXXXXXXXXXXXXGXXXXXXXXXXXXXXXXXXXGXXXXXXXXXXXXXXXXXXXGXXXXXXXXXXXXXXXXXXX,0,10,0
21441,13,0,13,104,483,0,0,500,280,220,GXXXXXXXXXXXXXXXXXXXGXXXXXXXXXXXXXXXXXXXGXXXXXXXXXXXXXXXXXXXGXXXXXXXXXXXXXXXXXXXGXXXXXXXXXXXXXXXXXXXGXXXXXXXXXXXXXXXXXXXGXXXXXXXXXXXXXXXXXXXGXXXXXXXXXXXXXXXXXXXGXXXXXXXXXXXXXXXXXXXGXXXXXXXXXXXXXXXXXXXGXXXXXXXXXXXXXXXXXXXGXXXXXXXXXXXXXXXXXXXGXXXXXXXXXXXXXXXXXXX,0,10,0
21462,13,0,13,110,477,0,0,490,275,215,GXXXXXXXXXXXXXXXXXXXGXXXXXXXXXXXXXXXXXXXGXXXXXXXXXXXXXXXXXXXGXXXXXXXXXXXXXXXXXXXGXXXXXXXXXXXXXXXXXXXGXXXXXXXXXXXXXXXXXXXGXXXXXXXXXXXXXXXXXXXGXXXXXXXXXXXXXXXXXXXGXXXXXXXXXXXXXXXXXXXGXXXXXXXXXXXXXXXXXXXGXXXXXXXXXXXXXXXXXXXGXXXXXXXXXXXXXXXXXXXGXXXXXXXXXXXXXXXXXXX,0,10,0
21483,13,0,13,113,474,0,0,489,277,212,GXXXXXXXXXXXXXXXXXXXGXXXXXXXXXXXXXXXXXXXGXXXXXXXXXXXXXXXXXXXGXXXXXXXXXXXXXXXXXXXGXXXXXXXXXXXXXXXXXXXGXXXXXXXXXXXXXXXXXXXGXXXXXXXXXXXXXXXXXXXGXXXXXXXXXXXXXXXXXXXGXXXXXXXXXXXXXXXXXXXGXXXXXXXXXXXXXXXXXXXGXXXXXXXXXXXXXXXXXXXGXXXXXXXXXXXXXXXXXXXGXXXXXXXXXXXXXXXXXXX,0,10,0
21504,13,0,13,120,467,0,0,483,274,209,GXXXXXXXXXXXXXXXXXXXGXXXXXXXXXXXXXXXXXXXGXXXXXXXXXXXXXXXXXXXGXXXXXXXXXXXXXXXXXXXGXXXXXXXXXXXXXXXXXXXGXXXXXXXXXXXXXXXXXXXGXXXXXXXXXXXXXXXXXXXGXXXXXXXXXXXXXXXXXXXGXXXXXXXXXXXXXXXXXXXGXXXXXXXXXXXXXXXXXXXGXXXXXXXXXXXXXXXXXXXGXXXXXXXXXXXXXXXXXXXGXXXXXXXXXXXXXXXXXXX,0,10,0

21525,13,0,13,117,470,0,0,485,275,210,GXXXXXXXXXXXXXXXXXXXGXXXXXXXXXXXXXXXXXXXGXXXXXXXXXXXXXXXXXXXGXXXXXXXXXXXXXXXXXXXGXXXXXXXXXXXXXXXXXXXGXXXXXXXXXXXXXXXXXXXGXXXXXXXXXXXXXXXXXXXGXXXXXXXXXXXXXXXXXXXGXXXXXXXXXXXXXXXXXXXGXXXXXXXXXXXXXXXXXXXGXXXXXXXXXXXXXXXXXXXGXXXXXXXXXXXXXXXXXXXGXXXXXXXXXXXXXXXXXXX,0,10,0
21546,13,0,13,113,474,0,0,488,278,210,GXXXXXXXXXXXXXXXXXXXGXXXXXXXXXXXXXXXXXXXGXXXXXXXXXXXXXXXXXXXGXXXXXXXXXXXXXXXXXXXGXXXXXXXXXXXXXXXXXXXGXXXXXXXXXXXXXXXXXXXGXXXXXXXXXXXXXXXXXXXGXXXXXXXXXXXXXXXXXXXGXXXXXXXXXXXXXXXXXXXGXXXXXXXXXXXXXXXXXXXGXXXXXXXXXXXXXXXXXXXGXXXXXXXXXXXXXXXXXXXGXXXXXXXXXXXXXXXXXXX,0,10,0
21567,13,0,13,113,474,0,0,487,283,204,GXXXXXXXXXXXXXXXXXXXGXXXXXXXXXXXXXXXXXXXGXXXXXXXXXXXXXXXXXXXGXXXXXXXXXXXXXXXXXXXGXXXXXXXXXXXXXXXXXXXGXXXXXXXXXXXXXXXXXXXGXXXXXXXXXXXXXXXXXXXGXXXXXXXXXXXXXXXXXXXGXXXXXXXXXXXXXXXXXXXGXXXXXXXXXXXXXXXXXXXGXXXXXXXXXXXXXXXXXXXGXXXXXXXXXXXXXXXXXXXGXXXXXXXXXXXXXXXXXXX,0,10,0
21588,13,0,13,125,462,0,0,476,278,198,GXXXXXXXXXXXXXXXXXXXGXXXXXXXXXXXXXXXXXXXGXXXXXXXXXXXXXXXXXXXGXXXXXXXXXXXXXXXXXXXGXXXXXXXXXXXXXXXXXXXGXXXXXXXXXXXXXXXXXXXGXXXXXXXXXXXXXXXXXXXGXXXXXXXXXXXXXXXXXXXGXXXXXXXXXXXXXXXXXXXGXXXXXXXXXXXXXXXXXXXGXXXXXXXXXXXXXXXXXXXGXXXXXXXXXXXXXXXXXXXGXXXXXXXXXXXXXXXXXXX,0,10,0
21609,13,0,13,124,463,0,0,477,281,196,GXXXXXXXXXXXXXXXXXXXGXXXXXXXXXXXXXXXXXXXGXXXXXXXXXXXXXXXXXXXGXXXXXXXXXXXXXXXXXXXGXXXXXXXXXXXXXXXXXXXGXXXXXXXXXXXXXXXXXXXGXXXXXXXXXXXXXXXXXXXGXXXXXXXXXXXXXXXXXXXGXXXXXXXXXXXXXXXXXXXGXXXXXXXXXXXXXXXXXXXGXXXXXXXXXXXXXXXXXXXGXXXXXXXXXXXXXXXXXXXGXXXXXXXXXXXXXXXXXXX,0,10,0

21630,13,0,13,125,462,0,0,476,280,196,GXXXXXXXXXXXXXXXXXXXGXXXXXXXXXXXXXXXXXXXGXXXXXXXXXXXXXXXXXXXGXXXXXXXXXXXXXXXXXXXGXXXXXXXXXXXXXXXXXXXGXXXXXXXXXXXXXXXXXXXGXXXXXXXXXXXXXXXXXXXGXXXXXXXXXXXXXXXXXXXGXXXXXXXXXXXXXXXXXXXGXXXXXXXXXXXXXXXXXXXGXXXXXXXXXXXXXXXXXXXGXXXXXXXXXXXXXXXXXXXGXXXXXXXXXXXXXXXXXXX,0,10,0
21651,13,0,13,124,463,0,0,478,280,198,GXXXXXXXXXXXXXXXXXXXGXXXXXXXXXXXXXXXXXXXGXXXXXXXXXXXXXXXXXXXGXXXXXXXXXXXXXXXXXXXGXXXXXXXXXXXXXXXXXXXGXXXXXXXXXXXXXXXXXXXGXXXXXXXXXXXXXXXXXXXGXXXXXXXXXXXXXXXXXXXGXXXXXXXXXXXXXXXXXXXGXXXXXXXXXXXXXXXXXXXGXXXXXXXXXXXXXXXXXXXGXXXXXXXXXXXXXXXXXXXGXXXXXXXXXXXXXXXXXXX,0,10,0
21672,13,0,13,128,459,0,0,475,271,204,GXXXXXXXXXXXXXXXXXXXGXXXXXXXXXXXXXXXXXXXGXXXXXXXXXXXXXXXXXXXGXXXXXXXXXXXXXXXXXXXGXXXXXXXXXXXXXXXXXXXGXXXXXXXXXXXXXXXXXXXGXXXXXXXXXXXXXXXXXXXGXXXXXXXXXXXXXXXXXXXGXXXXXXXXXXXXXXXXXXXGXXXXXXXXXXXXXXXXXXXGXXXXXXXXXXXXXXXXXXXGXXXXXXXXXXXXXXXXXXXGXXXXXXXXXXXXXXXXXXX,0,10,0
21693,13,0,13,128,459,0,0,475,270,205,GXXXXXXXXXXXXXXXXXXXGXXXXXXXXXXXXXXXXXXXGXXXXXXXXXXXXXXXXXXXGXXXXXXXXXXXXXXXXXXXGXXXXXXXXXXXXXXXXXXXGXXXXXXXXXXXXXXXXXXXGXXXXXXXXXXXXXXXXXXXGXXXXXXXXXXXXXXXXXXXGXXXXXXXXXXXXXXXXXXXGXXXXXXXXXXXXXXXXXXXGXXXXXXXXXXXXXXXXXXXGXXXXXXXXXXXXXXXXXXXGXXXXXXXXXXXXXXXXXXX,0,10,0
21714,13,0,13,115,472,0,0,486,273,213,GXXXXXXXXXXXXXXXXXXXGXXXXXXXXXXXXXXXXXXXGXXXXXXXXXXXXXXXXXXXGXXXXXXXXXXXXXXXXXXXGXXXXXXXXXXXXXXXXXXXGXXXXXXXXXXXXXXXXXXXGXXXXXXXXXXXXXXXXXXXGXXXXXXXXXXXXXXXXXXXGXXXXXXXXXXXXXXXXXXXGXXXXXXXXXXXXXXXXXXXGXXXXXXXXXXXXXXXXXXXGXXXXXXXXXXXXXXXXXXXGXXXXXXXXXXXXXXXXXXX,0,10,0

21735,13,0,13,99,488,0,0,502,280,222,GXXXXXXXXXXXXXXXXXXXGXXXXXXXXXXXXXXXXXXXGXXXXXXXXXXXXXXXXXXXGXXXXXXXXXXXXXXXXXXXGXXXXXXXXXXXXXXXXXXXGXXXXXXXXXXXXXXXXXXXGXXXXXXXXXXXXXXXXXXXGXXXXXXXXXXXXXXXXXXXGXXXXXXXXXXXXXXXXXXXGXXXXXXXXXXXXXXXXXXXGXXXXXXXXXXXXXXXXXXXGXXXXXXXXXXXXXXXXXXXGXXXXXXXXXXXXXXXXXXX,0,10,0
21756,13,0,13,102,485,0,0,498,281,217,GXXXXXXXXXXXXXXXXXXXGXXXXXXXXXXXXXXXXXXXGXXXXXXXXXXXXXXXXXXXGXXXXXXXXXXXXXXXXXXXGXXXXXXXXXXXXXXXXXXXGXXXXXXXXXXXXXXXXXXXGXXXXXXXXXXXXXXXXXXXGXXXXXXXXXXXXXXXXXXXGXXXXXXXXXXXXXXXXXXXGXXXXXXXXXXXXXXXXXXXGXXXXXXXXXXXXXXXXXXXGXXXXXXXXXXXXXXXXXXXGXXXXXXXXXXXXXXXXXXX,0,10,0
21777,13,0,13,111,476,0,0,490,280,210,GXXXXXXXXXXXXXXXXXXXGXXXXXXXXXXXXXXXXXXXGXXXXXXXXXXXXXXXXXXXGXXXXXXXXXXXXXXXXXXXGXXXXXXXXXXXXXXXXXXXGXXXXXXXXXXXXXXXXXXXGXXXXXXXXXXXXXXXXXXXGXXXXXXXXXXXXXXXXXXXGXXXXXXXXXXXXXXXXXXXGXXXXXXXXXXXXXXXXXXXGXXXXXXXXXXXXXXXXXXXGXXXXXXXXXXXXXXXXXXXGXXXXXXXXXXXXXXXXXXX,0,10,0
21798,13,0,13,102,485,0,0,497,284,213,GXXXXXXXXXXXXXXXXXXXGXXXXXXXXXXXXXXXXXXXGXXXXXXXXXXXXXXXXXXXGXXXXXXXXXXXXXXXXXXXGXXXXXXXXXXXXXXXXXXXGXXXXXXXXXXXXXXXXXXXGXXXXXXXXXXXXXXXXXXXGXXXXXXXXXXXXXXXXXXXGXXXXXXXXXXXXXXXXXXXGXXXXXXXXXXXXXXXXXXXGXXXXXXXXXXXXXXXXXXXGXXXXXXXXXXXXXXXXXXXGXXXXXXXXXXXXXXXXXXX,0,10,0
21819,13,0,13,101,486,0,0,498,280,218,GXXXXXXXXXXXXXXXXXXXGXXXXXXXXXXXXXXXXXXXGXXXXXXXXXXXXXXXXXXXGXXXXXXXXXXXXXXXXXXXGXXXXXXXXXXXXXXXXXXXGXXXXXXXXXXXXXXXXXXXGXXXXXXXXXXXXXXXXXXXGXXXXXXXXXXXXXXXXXXXGXXXXXXXXXXXXXXXXXXXGXXXXXXXXXXXXXXXXXXXGXXXXXXXXXXXXXXXXXXXGXXXXXXXXXXXXXXXXXXXGXXXXXXXXXXXXXXXXXXX,0,10,0

21840,13,0,13,102,485,0,0,498,281,217,GXXXXXXXXXXXXXXXXXXXGXXXXXXXXXXXXXXXXXXXGXXXXXXXXXXXXXXXXXXXGXXXXXXXXXXXXXXXXXXXGXXXXXXXXXXXXXXXXXXXGXXXXXXXXXXXXXXXXXXXGXXXXXXXXXXXXXXXXXXXGXXXXXXXXXXXXXXXXXXXGXXXXXXXXXXXXXXXXXXXGXXXXXXXXXXXXXXXXXXXGXXXXXXXXXXXXXXXXXXXGXXXXXXXXXXXXXXXXXXXGXXXXXXXXXXXXXXXXXXX,0,10,0
21861,13,0,13,102,485,0,0,498,278,220,GXXXXXXXXXXXXXXXXXXXGXXXXXXXXXXXXXXXXXXXGXXXXXXXXXXXXXXXXXXXGXXXXXXXXXXXXXXXXXXXGXXXXXXXXXXXXXXXXXXXGXXXXXXXXXXXXXXXXXXXGXXXXXXXXXXXXXXXXXXXGXXXXXXXXXXXXXXXXXXXGXXXXXXXXXXXXXXXXXXXGXXXXXXXXXXXXXXXXXXXGXXXXXXXXXXXXXXXXXXXGXXXXXXXXXXXXXXXXXXXGXXXXXXXXXXXXXXXXXXX,0,10,0
21882,13,0,13,98,489,0,0,502,283,219,GXXXXXXXXXXXXXXXXXXXGXXXXXXXXXXXXXXXXXXXGXXXXXXXXXXXXXXXXXXXGXXXXXXXXXXXXXXXXXXXGXXXXXXXXXXXXXXXXXXXGXXXXXXXXXXXXXXXXXXXGXXXXXXXXXXXXXXXXXXXGXXXXXXXXXXXXXXXXXXXGXXXXXXXXXXXXXXXXXXXGXXXXXXXXXXXXXXXXXXXGXXXXXXXXXXXXXXXXXXXGXXXXXXXXXXXXXXXXXXXGXXXXXXXXXXXXXXXXXXX,0,10,0
21903,13,0,13,102,485,0,0,498,275,223,GXXXXXXXXXXXXXXXXXXXGXXXXXXXXXXXXXXXXXXXGXXXXXXXXXXXXXXXXXXXGXXXXXXXXXXXXXXXXXXXGXXXXXXXXXXXXXXXXXXXGXXXXXXXXXXXXXXXXXXXGXXXXXXXXXXXXXXXXXXXGXXXXXXXXXXXXXXXXXXXGXXXXXXXXXXXXXXXXXXXGXXXXXXXXXXXXXXXXXXXGXXXXXXXXXXXXXXXXXXXGXXXXXXXXXXXXXXXXXXXGXXXXXXXXXXXXXXXXXXX,0,10,0
21924,13,0,13,103,484,0,0,496,277,219,GXXXXXXXXXXXXXXXXXXXGXXXXXXXXXXXXXXXXXXXGXXXXXXXXXXXXXXXXXXXGXXXXXXXXXXXXXXXXXXXGXXXXXXXXXXXXXXXXXXXGXXXXXXXXXXXXXXXXXXXGXXXXXXXXXXXXXXXXXXXGXXXXXXXXXXXXXXXXXXXGXXXXXXXXXXXXXXXXXXXGXXXXXXXXXXXXXXXXXXXGXXXXXXXXXXXXXXXXXXXGXXXXXXXXXXXXXXXXXXXGXXXXXXXXXXXXXXXXXXX,0,10,0

21945,13,0,13,106,481,0,0,493,286,207,GXXXXXXXXXXXXXXXXXXXGXXXXXXXXXXXXXXXXXXXGXXXXXXXXXXXXXXXXXXXGXXXXXXXXXXXXXXXXXXXGXXXXXXXXXXXXXXXXXXXGXXXXXXXXXXXXXXXXXXXGXXXXXXXXXXXXXXXXXXXGXXXXXXXXXXXXXXXXXXXGXXXXXXXXXXXXXXXXXXXGXXXXXXXXXXXXXXXXXXXGXXXXXXXXXXXXXXXXXXXGXXXXXXXXXXXXXXXXXXXGXXXXXXXXXXXXXXXXXXX,0,10,0
21966,13,0,13,110,477,0,0,490,287,203,GXXXXXXXXXXXXXXXXXXXGXXXXXXXXXXXXXXXXXXXGXXXXXXXXXXXXXXXXXXXGXXXXXXXXXXXXXXXXXXXGXXXXXXXXXXXXXXXXXXXGXXXXXXXXXXXXXXXXXXXGXXXXXXXXXXXXXXXXXXXGXXXXXXXXXXXXXXXXXXXGXXXXXXXXXXXXXXXXXXXGXXXXXXXXXXXXXXXXXXXGXXXXXXXXXXXXXXXXXXXGXXXXXXXXXXXXXXXXXXXGXXXXXXXXXXXXXXXXXXX,0,10,0
21987,13,0,13,118,469,0,0,482,285,197,GXXXXXXXXXXXXXXXXXXXGXXXXXXXXXXXXXXXXXXXGXXXXXXXXXXXXXXXXXXXGXXXXXXXXXXXXXXXXXXXGXXXXXXXXXXXXXXXXXXXGXXXXXXXXXXXXXXXXXXXGXXXXXXXXXXXXXXXXXXXGXXXXXXXXXXXXXXXXXXXGXXXXXXXXXXXXXXXXXXXGXXXXXXXXXXXXXXXXXXXGXXXXXXXXXXXXXXXXXXXGXXXXXXXXXXXXXXXXXXXGXXXXXXXXXXXXXXXXXXX,0,10,0
22008,13,0,13,118,469,0,0,483,282,201,GXXXXXXXXXXXXXXXXXXXGXXXXXXXXXXXXXXXXXXXGXXXXXXXXXXXXXXXXXXXGXXXXXXXXXXXXXXXXXXXGXXXXXXXXXXXXXXXXXXXGXXXXXXXXXXXXXXXXXXXGXXXXXXXXXXXXXXXXXXXGXXXXXXXXXXXXXXXXXXXGXXXXXXXXXXXXXXXXXXXGXXXXXXXXXXXXXXXXXXXGXXXXXXXXXXXXXXXXXXXGXXXXXXXXXXXXXXXXXXXGXXXXXXXXXXXXXXXXXXX,0,10,0
22029,13,0,13,116,471,0,0,485,282,203,GXXXXXXXXXXXXXXXXXXXGXXXXXXXXXXXXXXXXXXXGXXXXXXXXXXXXXXXXXXXGXXXXXXXXXXXXXXXXXXXGXXXXXXXXXXXXXXXXXXXGXXXXXXXXXXXXXXXXXXXGXXXXXXXXXXXXXXXXXXXGXXXXXXXXXXXXXXXXXXXGXXXXXXXXXXXXXXXXXXXGXXXXXXXXXXXXXXXXXXXGXXXXXXXXXXXXXXXXXXXGXXXXXXXXXXXXXXXXXXXGXXXXXXXXXXXXXXXXXXX,0,10,0

22050,13,0,13,111,476,0,0,488,285,203,GXXXXXXXXXXXXXXXXXXXGXXXXXXXXXXXXXXXXXXXGXXXXXXXXXXXXXXXXXXXGXXXXXXXXXXXXXXXXXXXGXXXXXXXXXXXXXXXXXXXGXXXXXXXXXXXXXXXXXXXGXXXXXXXXXXXXXXXXXXXGXXXXXXXXXXXXXXXXXXXGXXXXXXXXXXXXXXXXXXXGXXXXXXXXXXXXXXXXXXXGXXXXXXXXXXXXXXXXXXXGXXXXXXXXXXXXXXXXXXXGXXXXXXXXXXXXXXXXXXX,0,10,0
22071,14,1,13,109,477,0,0,491,280,211,GXXXXXXXXXXXXXXXXXXXGXXXXXXXXXXXXXXXXXXXGXXXXXXXXXXXXXXXXXXXGXXXXXXXXXXXXXXXXXXXGXXXXXXXXXXXXXXXXXXXGXXXXXXXXXXXXXXXXXXXGXXXXXXXXXXXXXXXXXXXGXXXXXXXXXXXXXXXXXXXGAXXXXXXXXXXXXXXXXXXGXXXXXXXXXXXXXXXXXXXGXXXXXXXXXXXXXXXXXXXGXXXXXXXXXXXXXXXXXXXGXXXXXXXXXXXXXXXXXXX,0,10,0
22092,14,1,13,103,483,0,0,497,281,216,GXXXXXXXXXXXXXXXXXXXGXXXXXXXXXXXXXXXXXXXGXXXXXXXXXXXXXXXXXXXGXXXXXXXXXXXXXXXXXXXGXXXXXXXXXXXXXXXXXXXGXXXXXXXXXXXXXXXXXXXGXXXXXXXXXXXXXXXXXXXGXXXXXXXXXXXXXXXXXXXGAXXXXXXXXXXXXXXXXXXGXXXXXXXXXXXXXXXXXXXGXXXXXXXXXXXXXXXXXXXGXXXXXXXXXXXXXXXXXXXGXXXXXXXXXXXXXXXXXXX,0,10,0
22113,13,0,13,107,480,0,0,494,286,208,GXXXXXXXXXXXXXXXXXXXGXXXXXXXXXXXXXXXXXXXGXXXXXXXXXXXXXXXXXXXGXXXXXXXXXXXXXXXXXXXGXXXXXXXXXXXXXXXXXXXGXXXXXXXXXXXXXXXXXXXGXXXXXXXXXXXXXXXXXXXGXXXXXXXXXXXXXXXXXXXGXXXXXXXXXXXXXXXXXXXGXXXXXXXXXXXXXXXXXXXGXXXXXXXXXXXXXXXXXXXGXXXXXXXXXXXXXXXXXXXGXXXXXXXXXXXXXXXXXXX,0,10,0
22134,13,0,13,120,467,0,0,480,280,200,GXXXXXXXXXXXXXXXXXXXGXXXXXXXXXXXXXXXXXXXGXXXXXXXXXXXXXXXXXXXGXXXXXXXXXXXXXXXXXXXGXXXXXXXXXXXXXXXXXXXGXXXXXXXXXXXXXXXXXXXGXXXXXXXXXXXXXXXXXXXGXXXXXXXXXXXXXXXXXXXGXXXXXXXXXXXXXXXXXXXGXXXXXXXXXXXXXXXXXXXGXXXXXXXXXXXXXXXXXXXGXXXXXXXXXXXXXXXXXXXGXXXXXXXXXXXXXXXXXXX,0,10,0

22155,13,0,13,121,466,0,0,478,283,195,GXXXXXXXXXXXXXXXXXXXGXXXXXXXXXXXXXXXXXXXGXXXXXXXXXXXXXXXXXXXGXXXXXXXXXXXXXXXXXXXGXXXXXXXXXXXXXXXXXXXGXXXXXXXXXXXXXXXXXXXGXXXXXXXXXXXXXXXXXXXGXXXXXXXXXXXXXXXXXXXGXXXXXXXXXXXXXXXXXXXGXXXXXXXXXXXXXXXXXXXGXXXXXXXXXXXXXXXXXXXGXXXXXXXXXXXXXXXXXXXGXXXXXXXXXXXXXXXXXXX,0,10,0
22176,13,0,13,113,474,0,0,485,289,196,GXXXXXXXXXXXXXXXXXXXGXXXXXXXXXXXXXXXXXXXGXXXXXXXXXXXXXXXXXXXGXXXXXXXXXXXXXXXXXXXGXXXXXXXXXXXXXXXXXXXGXXXXXXXXXXXXXXXXXXXGXXXXXXXXXXXXXXXXXXXGXXXXXXXXXXXXXXXXXXXGXXXXXXXXXXXXXXXXXXXGXXXXXXXXXXXXXXXXXXXGXXXXXXXXXXXXXXXXXXXGXXXXXXXXXXXXXXXXXXXGXXXXXXXXXXXXXXXXXXX,0,10,0
22197,13,0,13,118,469,0,0,482,283,199,GXXXXXXXXXXXXXXXXXXXGXXXXXXXXXXXXXXXXXXXGXXXXXXXXXXXXXXXXXXXGXXXXXXXXXXXXXXXXXXXGXXXXXXXXXXXXXXXXXXXGXXXXXXXXXXXXXXXXXXXGXXXXXXXXXXXXXXXXXXXGXXXXXXXXXXXXXXXXXXXGXXXXXXXXXXXXXXXXXXXGXXXXXXXXXXXXXXXXXXXGXXXXXXXXXXXXXXXXXXXGXXXXXXXXXXXXXXXXXXXGXXXXXXXXXXXXXXXXXXX,0,10,0
22218,13,0,13,110,477,0,0,490,282,208,GXXXXXXXXXXXXXXXXXXXGXXXXXXXXXXXXXXXXXXXGXXXXXXXXXXXXXXXXXXXGXXXXXXXXXXXXXXXXXXXGXXXXXXXXXXXXXXXXXXXGXXXXXXXXXXXXXXXXXXXGXXXXXXXXXXXXXXXXXXXGXXXXXXXXXXXXXXXXXXXGXXXXXXXXXXXXXXXXXXXGXXXXXXXXXXXXXXXXXXXGXXXXXXXXXXXXXXXXXXXGXXXXXXXXXXXXXXXXXXXGXXXXXXXXXXXXXXXXXXX,0,10,0
22239,13,0,13,108,479,0,0,492,280,212,GXXXXXXXXXXXXXXXXXXXGXXXXXXXXXXXXXXXXXXXGXXXXXXXXXXXXXXXXXXXGXXXXXXXXXXXXXXXXXXXGXXXXXXXXXXXXXXXXXXXGXXXXXXXXXXXXXXXXXXXGXXXXXXXXXXXXXXXXXXXGXXXXXXXXXXXXXXXXXXXGXXXXXXXXXXXXXXXXXXXGXXXXXXXXXXXXXXXXXXXGXXXXXXXXXXXXXXXXXXXGXXXXXXXXXXXXXXXXXXXGXXXXXXXXXXXXXXXXXXX,0,10,0

22260,13,0,13,108,479,0,0,492,289,203,GXXXXXXXXXXXXXXXXXXXGXXXXXXXXXXXXXXXXXXXGXXXXXXXXXXXXXXXXXXXGXXXXXXXXXXXXXXXXXXXGXXXXXXXXXXXXXXXXXXXGXXXXXXXXXXXXXXXXXXXGXXXXXXXXXXXXXXXXXXXGXXXXXXXXXXXXXXXXXXXGXXXXXXXXXXXXXXXXXXXGXXXXXXXXXXXXXXXXXXXGXXXXXXXXXXXXXXXXXXXGXXXXXXXXXXXXXXXXXXXGXXXXXXXXXXXXXXXXXXX,0,10,0
22281,13,0,13,114,473,0,0,486,281,205,GXXXXXXXXXXXXXXXXXXXGXXXXXXXXXXXXXXXXXXXGXXXXXXXXXXXXXXXXXXXGXXXXXXXXXXXXXXXXXXXGXXXXXXXXXXXXXXXXXXXGXXXXXXXXXXXXXXXXXXXGXXXXXXXXXXXXXXXXXXXGXXXXXXXXXXXXXXXXXXXGXXXXXXXXXXXXXXXXXXXGXXXXXXXXXXXXXXXXXXXGXXXXXXXXXXXXXXXXXXXGXXXXXXXXXXXXXXXXXXXGXXXXXXXXXXXXXXXXXXX,0,10,0
22302,13,0,13,111,476,0,0,489,281,208,GXXXXXXXXXXXXXXXXXXXGXXXXXXXXXXXXXXXXXXXGXXXXXXXXXXXXXXXXXXXGXXXXXXXXXXXXXXXXXXXGXXXXXXXXXXXXXXXXXXXGXXXXXXXXXXXXXXXXXXXGXXXXXXXXXXXXXXXXXXXGXXXXXXXXXXXXXXXXXXXGXXXXXXXXXXXXXXXXXXXGXXXXXXXXXXXXXXXXXXXGXXXXXXXXXXXXXXXXXXXGXXXXXXXXXXXXXXXXXXXGXXXXXXXXXXXXXXXXXXX,0,10,0
22323,13,0,13,112,475,0,0,488,283,205,GXXXXXXXXXXXXXXXXXXXGXXXXXXXXXXXXXXXXXXXGXXXXXXXXXXXXXXXXXXXGXXXXXXXXXXXXXXXXXXXGXXXXXXXXXXXXXXXXXXXGXXXXXXXXXXXXXXXXXXXGXXXXXXXXXXXXXXXXXXXGXXXXXXXXXXXXXXXXXXXGXXXXXXXXXXXXXXXXXXXGXXXXXXXXXXXXXXXXXXXGXXXXXXXXXXXXXXXXXXXGXXXXXXXXXXXXXXXXXXXGXXXXXXXXXXXXXXXXXXX,0,10,0
22344,13,0,13,110,477,0,0,490,287,203,GXXXXXXXXXXXXXXXXXXXGXXXXXXXXXXXXXXXXXXXGXXXXXXXXXXXXXXXXXXXGXXXXXXXXXXXXXXXXXXXGXXXXXXXXXXXXXXXXXXXGXXXXXXXXXXXXXXXXXXXGXXXXXXXXXXXXXXXXXXXGXXXXXXXXXXXXXXXXXXXGXXXXXXXXXXXXXXXXXXXGXXXXXXXXXXXXXXXXXXXGXXXXXXXXXXXXXXXXXXXGXXXXXXXXXXXXXXXXXXXGXXXXXXXXXXXXXXXXXXX,0,10,0

22365,13,0,13,117,470,0,0,485,288,197,GXXXXXXXXXXXXXXXXXXXGXXXXXXXXXXXXXXXXXXXGXXXXXXXXXXXXXXXXXXXGXXXXXXXXXXXXXXXXXXXGXXXXXXXXXXXXXXXXXXXGXXXXXXXXXXXXXXXXXXXGXXXXXXXXXXXXXXXXXXXGXXXXXXXXXXXXXXXXXXXGXXXXXXXXXXXXXXXXXXXGXXXXXXXXXXXXXXXXXXXGXXXXXXXXXXXXXXXXXXXGXXXXXXXXXXXXXXXXXXXGXXXXXXXXXXXXXXXXXXX,0,10,0
22386,13,0,13,121,466,0,0,480,283,197,GXXXXXXXXXXXXXXXXXXXGXXXXXXXXXXXXXXXXXXXGXXXXXXXXXXXXXXXXXXXGXXXXXXXXXXXXXXXXXXXGXXXXXXXXXXXXXXXXXXXGXXXXXXXXXXXXXXXXXXXGXXXXXXXXXXXXXXXXXXXGXXXXXXXXXXXXXXXXXXXGXXXXXXXXXXXXXXXXXXXGXXXXXXXXXXXXXXXXXXXGXXXXXXXXXXXXXXXXXXXGXXXXXXXXXXXXXXXXXXXGXXXXXXXXXXXXXXXXXXX,0,10,0
22407,13,0,13,121,466,0,0,480,286,194,GXXXXXXXXXXXXXXXXXXXGXXXXXXXXXXXXXXXXXXXGXXXXXXXXXXXXXXXXXXXGXXXXXXXXXXXXXXXXXXXGXXXXXXXXXXXXXXXXXXXGXXXXXXXXXXXXXXXXXXXGXXXXXXXXXXXXXXXXXXXGXXXXXXXXXXXXXXXXXXXGXXXXXXXXXXXXXXXXXXXGXXXXXXXXXXXXXXXXXXXGXXXXXXXXXXXXXXXXXXXGXXXXXXXXXXXXXXXXXXXGXXXXXXXXXXXXXXXXXXX,0,10,0
22428,13,0,13,112,475,0,0,488,283,205,GXXXXXXXXXXXXXXXXXXXGXXXXXXXXXXXXXXXXXXXGXXXXXXXXXXXXXXXXXXXGXXXXXXXXXXXXXXXXXXXGXXXXXXXXXXXXXXXXXXXGXXXXXXXXXXXXXXXXXXXGXXXXXXXXXXXXXXXXXXXGXXXXXXXXXXXXXXXXXXXGXXXXXXXXXXXXXXXXXXXGXXXXXXXXXXXXXXXXXXXGXXXXXXXXXXXXXXXXXXXGXXXXXXXXXXXXXXXXXXXGXXXXXXXXXXXXXXXXXXX,0,10,0
22449,13,0,13,112,475,0,0,489,285,204,GXXXXXXXXXXXXXXXXXXXGXXXXXXXXXXXXXXXXXXXGXXXXXXXXXXXXXXXXXXXGXXXXXXXXXXXXXXXXXXXGXXXXXXXXXXXXXXXXXXXGXXXXXXXXXXXXXXXXXXXGXXXXXXXXXXXXXXXXXXXGXXXXXXXXXXXXXXXXXXXGXXXXXXXXXXXXXXXXXXXGXXXXXXXXXXXXXXXXXXXGXXXXXXXXXXXXXXXXXXXGXXXXXXXXXXXXXXXXXXXGXXXXXXXXXXXXXXXXXXX,0,10,0

22470,13,0,13,115,472,0,0,486,293,193,GXXXXXXXXXXXXXXXXXXXGXXXXXXXXXXXXXXXXXXXGXXXXXXXXXXXXXXXXXXXGXXXXXXXXXXXXXXXXXXXGXXXXXXXXXXXXXXXXXXXGXXXXXXXXXXXXXXXXXXXGXXXXXXXXXXXXXXXXXXXGXXXXXXXXXXXXXXXXXXXGXXXXXXXXXXXXXXXXXXXGXXXXXXXXXXXXXXXXXXXGXXXXXXXXXXXXXXXXXXXGXXXXXXXXXXXXXXXXXXXGXXXXXXXXXXXXXXXXXXX,0,10,0
22491,13,0,13,114,473,0,0,485,294,191,GXXXXXXXXXXXXXXXXXXXGXXXXXXXXXXXXXXXXXXXGXXXXXXXXXXXXXXXXXXXGXXXXXXXXXXXXXXXXXXXGXXXXXXXXXXXXXXXXXXXGXXXXXXXXXXXXXXXXXXXGXXXXXXXXXXXXXXXXXXXGXXXXXXXXXXXXXXXXXXXGXXXXXXXXXXXXXXXXXXXGXXXXXXXXXXXXXXXXXXXGXXXXXXXXXXXXXXXXXXXGXXXXXXXXXXXXXXXXXXXGXXXXXXXXXXXXXXXXXXX,0,10,0
22512,14,1,13,117,469,0,0,483,292,191,GXXXXXXXXXXXXXXXXXXXGXXXXXXXXXXXXXXXXXXXGXXXXXXXXXXXXXXXXXXXGXXXXXXXXXXXXXXXXXXXGXXXXXXXXXXXXXXXXXXXGXXXXXXXXXXXXXXXXXXXGXXXXXXXXXXXXXXXXXXXGXXXXXXXXXXXXXXXXXXXGXXXXXXXXXXXXXXXXXXXGXXXXXXXXXXXXXXXXXXXGAXXXXXXXXXXXXXXXXXXGXXXXXXXXXXXXXXXXXXXGXXXXXXXXXXXXXXXXXXX,0,10,0
22533,14,1,13,115,471,0,0,483,290,193,GXXXXXXXXXXXXXXXXXXXGXXXXXXXXXXXXXXXXXXXGXXXXXXXXXXXXXXXXXXXGXXXXXXXXXXXXXXXXXXXGXXXXXXXXXXXXXXXXXXXGXXXXXXXXXXXXXXXXXXXGXXXXXXXXXXXXXXXXXXXGXXXXXXXXXXXXXXXXXXXGXXXXXXXXXXXXXXXXXXXGXXXXXXXXXXXXXXXXXXXGAXXXXXXXXXXXXXXXXXXGXXXXXXXXXXXXXXXXXXXGXXXXXXXXXXXXXXXXXXX,0,10,0
22554,14,1,13,116,470,0,0,483,290,193,GXXXXXXXXXXXXXXXXXXXGXXXXXXXXXXXXXXXXXXXGXXXXXXXXXXXXXXXXXXXGXXXXXXXXXXXXXXXXXXXGXXXXXXXXXXXXXXXXXXXGXXXXXXXXXXXXXXXXXXXGXXXXXXXXXXXXXXXXXXXGXXXXXXXXXXXXXXXXXXXGXXXXXXXXXXXXXXXXXXXGXXXXXXXXXXXXXXXXXXXGAXXXXXXXXXXXXXXXXXXGXXXXXXXXXXXXXXXXXXXGXXXXXXXXXXXXXXXXXXX,0,10,0

22575,14,1,13,116,470,0,0,483,289,194,GXXXXXXXXXXXXXXXXXXXGXXXXXXXXXXXXXXXXXXXGXXXXXXXXXXXXXXXXXXXGXXXXXXXXXXXXXXXXXXXGXXXXXXXXXXXXXXXXXXXGXXXXXXXXXXXXXXXXXXXGXXXXXXXXXXXXXXXXXXXGXXXXXXXXXXXXXXXXXXXGXXXXXXXXXXXXXXXXXXXGXXXXXXXXXXXXXXXXXXXGAXXXXXXXXXXXXXXXXXXGXXXXXXXXXXXXXXXXXXXGXXXXXXXXXXXXXXXXXXX,0,10,0
22596,14,1,13,119,467,0,0,478,289,189,GXXXXXXXXXXXXXXXXXXXGXXXXXXXXXXXXXXXXXXXGXXXXXXXXXXXXXXXXXXXGXXXXXXXXXXXXXXXXXXXGXXXXXXXXXXXXXXXXXXXGXXXXXXXXXXXXXXXXXXXGXXXXXXXXXXXXXXXXXXXGXXXXXXXXXXXXXXXXXXXGXXXXXXXXXXXXXXXXXXXGXXXXXXXXXXXXXXXXXXXGAXXXXXXXXXXXXXXXXXXGXXXXXXXXXXXXXXXXXXXGXXXXXXXXXXXXXXXXXXX,0,10,0
22617,14,0,14,116,470,0,0,483,287,196,GXXXXXXXXXXXXXXXXXXXGXXXXXXXXXXXXXXXXXXXGXXXXXXXXXXXXXXXXXXXGXXXXXXXXXXXXXXXXXXXGXXXXXXXXXXXXXXXXXXXGXXXXXXXXXXXXXXXXXXXGXXXXXXXXXXXXXXXXXXXGXXXXXXXXXXXXXXXXXXXGXXXXXXXXXXXXXXXXXXXGXXXXXXXXXXXXXXXXXXXGOXXXXXXXXXXXXXXXXXXGXXXXXXXXXXXXXXXXXXXGXXXXXXXXXXXXXXXXXXX,0,10,0
22638,14,0,14,109,477,0,0,490,285,205,GXXXXXXXXXXXXXXXXXXXGXXXXXXXXXXXXXXXXXXXGXXXXXXXXXXXXXXXXXXXGXXXXXXXXXXXXXXXXXXXGXXXXXXXXXXXXXXXXXXXGXXXXXXXXXXXXXXXXXXXGXXXXXXXXXXXXXXXXXXXGXXXXXXXXXXXXXXXXXXXGXXXXXXXXXXXXXXXXXXXGXXXXXXXXXXXXXXXXXXXGOXXXXXXXXXXXXXXXXXXGXXXXXXXXXXXXXXXXXXXGXXXXXXXXXXXXXXXXXXX,0,10,0
22659,13,0,13,108,479,0,0,493,286,207,GXXXXXXXXXXXXXXXXXXXGXXXXXXXXXXXXXXXXXXXGXXXXXXXXXXXXXXXXXXXGXXXXXXXXXXXXXXXXXXXGXXXXXXXXXXXXXXXXXXXGXXXXXXXXXXXXXXXXXXXGXXXXXXXXXXXXXXXXXXXGXXXXXXXXXXXXXXXXXXXGXXXXXXXXXXXXXXXXXXXGXXXXXXXXXXXXXXXXXXXGXXXXXXXXXXXXXXXXXXXGXXXXXXXXXXXXXXXXXXXGXXXXXXXXXXXXXXXXXXX,0,10,0

22680,13,0,13,104,483,0,0,496,292,204,GXXXXXXXXXXXXXXXXXXXGXXXXXXXXXXXXXXXXXXXGXXXXXXXXXXXXXXXXXXXGXXXXXXXXXXXXXXXXXXXGXXXXXXXXXXXXXXXXXXXGXXXXXXXXXXXXXXXXXXXGXXXXXXXXXXXXXXXXXXXGXXXXXXXXXXXXXXXXXXXGXXXXXXXXXXXXXXXXXXXGXXXXXXXXXXXXXXXXXXXGXXXXXXXXXXXXXXXXXXXGXXXXXXXXXXXXXXXXXXXGXXXXXXXXXXXXXXXXXXX,0,10,0
22701,13,0,13,107,480,0,0,493,288,205,GXXXXXXXXXXXXXXXXXXXGXXXXXXXXXXXXXXXXXXXGXXXXXXXXXXXXXXXXXXXGXXXXXXXXXXXXXXXXXXXGXXXXXXXXXXXXXXXXXXXGXXXXXXXXXXXXXXXXXXXGXXXXXXXXXXXXXXXXXXXGXXXXXXXXXXXXXXXXXXXGXXXXXXXXXXXXXXXXXXXGXXXXXXXXXXXXXXXXXXXGXXXXXXXXXXXXXXXXXXXGXXXXXXXXXXXXXXXXXXXGXXXXXXXXXXXXXXXXXXX,0,10,0
22722,13,0,13,111,476,0,0,488,290,198,GXXXXXXXXXXXXXXXXXXXGXXXXXXXXXXXXXXXXXXXGXXXXXXXXXXXXXXXXXXXGXXXXXXXXXXXXXXXXXXXGXXXXXXXXXXXXXXXXXXXGXXXXXXXXXXXXXXXXXXXGXXXXXXXXXXXXXXXXXXXGXXXXXXXXXXXXXXXXXXXGXXXXXXXXXXXXXXXXXXXGXXXXXXXXXXXXXXXXXXXGXXXXXXXXXXXXXXXXXXXGXXXXXXXXXXXXXXXXXXXGXXXXXXXXXXXXXXXXXXX,0,10,0
22743,13,0,13,113,474,0,0,488,291,197,GXXXXXXXXXXXXXXXXXXXGXXXXXXXXXXXXXXXXXXXGXXXXXXXXXXXXXXXXXXXGXXXXXXXXXXXXXXXXXXXGXXXXXXXXXXXXXXXXXXXGXXXXXXXXXXXXXXXXXXXGXXXXXXXXXXXXXXXXXXXGXXXXXXXXXXXXXXXXXXXGXXXXXXXXXXXXXXXXXXXGXXXXXXXXXXXXXXXXXXXGXXXXXXXXXXXXXXXXXXXGXXXXXXXXXXXXXXXXXXXGXXXXXXXXXXXXXXXXXXX,0,10,0
22764,13,0,13,114,473,0,0,487,287,200,GXXXXXXXXXXXXXXXXXXXGXXXXXXXXXXXXXXXXXXXGXXXXXXXXXXXXXXXXXXXGXXXXXXXXXXXXXXXXXXXGXXXXXXXXXXXXXXXXXXXGXXXXXXXXXXXXXXXXXXXGXXXXXXXXXXXXXXXXXXXGXXXXXXXXXXXXXXXXXXXGXXXXXXXXXXXXXXXXXXXGXXXXXXXXXXXXXXXXXXXGXXXXXXXXXXXXXXXXXXXGXXXXXXXXXXXXXXXXXXXGXXXXXXXXXXXXXXXXXXX,0,10,0

22785,13,0,13,116,471,0,0,484,290,194,GXXXXXXXXXXXXXXXXXXXGXXXXXXXXXXXXXXXXXXXGXXXXXXXXXXXXXXXXXXXGXXXXXXXXXXXXXXXXXXXGXXXXXXXXXXXXXXXXXXXGXXXXXXXXXXXXXXXXXXXGXXXXXXXXXXXXXXXXXXXGXXXXXXXXXXXXXXXXXXXGXXXXXXXXXXXXXXXXXXXGXXXXXXXXXXXXXXXXXXXGXXXXXXXXXXXXXXXXXXXGXXXXXXXXXXXXXXXXXXXGXXXXXXXXXXXXXXXXXXX,0,10,0
22806,13,0,13,119,468,0,0,482,291,191,GXXXXXXXXXXXXXXXXXXXGXXXXXXXXXXXXXXXXXXXGXXXXXXXXXXXXXXXXXXXGXXXXXXXXXXXXXXXXXXXGXXXXXXXXXXXXXXXXXXXGXXXXXXXXXXXXXXXXXXXGXXXXXXXXXXXXXXXXXXXGXXXXXXXXXXXXXXXXXXXGXXXXXXXXXXXXXXXXXXXGXXXXXXXXXXXXXXXXXXXGXXXXXXXXXXXXXXXXXXXGXXXXXXXXXXXXXXXXXXXGXXXXXXXXXXXXXXXXXXX,0,10,0
22827,13,0,13,120,467,0,0,482,287,195,GXXXXXXXXXXXXXXXXXXXGXXXXXXXXXXXXXXXXXXXGXXXXXXXXXXXXXXXXXXXGXXXXXXXXXXXXXXXXXXXGXXXXXXXXXXXXXXXXXXXGXXXXXXXXXXXXXXXXXXXGXXXXXXXXXXXXXXXXXXXGXXXXXXXXXXXXXXXXXXXGXXXXXXXXXXXXXXXXXXXGXXXXXXXXXXXXXXXXXXXGXXXXXXXXXXXXXXXXXXXGXXXXXXXXXXXXXXXXXXXGXXXXXXXXXXXXXXXXXXX,0,10,0
22848,13,0,13,119,468,0,0,483,296,187,GXXXXXXXXXXXXXXXXXXXGXXXXXXXXXXXXXXXXXXXGXXXXXXXXXXXXXXXXXXXGXXXXXXXXXXXXXXXXXXXGXXXXXXXXXXXXXXXXXXXGXXXXXXXXXXXXXXXXXXXGXXXXXXXXXXXXXXXXXXXGXXXXXXXXXXXXXXXXXXXGXXXXXXXXXXXXXXXXXXXGXXXXXXXXXXXXXXXXXXXGXXXXXXXXXXXXXXXXXXXGXXXXXXXXXXXXXXXXXXXGXXXXXXXXXXXXXXXXXXX,0,10,0
22869,13,0,13,115,472,0,0,487,300,187,GXXXXXXXXXXXXXXXXXXXGXXXXXXXXXXXXXXXXXXXGXXXXXXXXXXXXXXXXXXXGXXXXXXXXXXXXXXXXXXXGXXXXXXXXXXXXXXXXXXXGXXXXXXXXXXXXXXXXXXXGXXXXXXXXXXXXXXXXXXXGXXXXXXXXXXXXXXXXXXXGXXXXXXXXXXXXXXXXXXXGXXXXXXXXXXXXXXXXXXXGXXXXXXXXXXXXXXXXXXXGXXXXXXXXXXXXXXXXXXXGXXXXXXXXXXXXXXXXXXX,0,10,0

22890,13,0,13,123,464,0,0,479,295,184,GXXXXXXXXXXXXXXXXXXXGXXXXXXXXXXXXXXXXXXXGXXXXXXXXXXXXXXXXXXXGXXXXXXXXXXXXXXXXXXXGXXXXXXXXXXXXXXXXXXXGXXXXXXXXXXXXXXXXXXXGXXXXXXXXXXXXXXXXXXXGXXXXXXXXXXXXXXXXXXXGXXXXXXXXXXXXXXXXXXXGXXXXXXXXXXXXXXXXXXXGXXXXXXXXXXXXXXXXXXXGXXXXXXXXXXXXXXXXXXXGXXXXXXXXXXXXXXXXXXX,0,10,0
22911,13,0,13,123,464,0,0,478,290,188,GXXXXXXXXXXXXXXXXXXXGXXXXXXXXXXXXXXXXXXXGXXXXXXXXXXXXXXXXXXXGXXXXXXXXXXXXXXXXXXXGXXXXXXXXXXXXXXXXXXXGXXXXXXXXXXXXXXXXXXXGXXXXXXXXXXXXXXXXXXXGXXXXXXXXXXXXXXXXXXXGXXXXXXXXXXXXXXXXXXXGXXXXXXXXXXXXXXXXXXXGXXXXXXXXXXXXXXXXXXXGXXXXXXXXXXXXXXXXXXXGXXXXXXXXXXXXXXXXXXX,0,10,0
22932,13,0,13,125,462,0,0,475,287,188,GXXXXXXXXXXXXXXXXXXXGXXXXXXXXXXXXXXXXXXXGXXXXXXXXXXXXXXXXXXXGXXXXXXXXXXXXXXXXXXXGXXXXXXXXXXXXXXXXXXXGXXXXXXXXXXXXXXXXXXXGXXXXXXXXXXXXXXXXXXXGXXXXXXXXXXXXXXXXXXXGXXXXXXXXXXXXXXXXXXXGXXXXXXXXXXXXXXXXXXXGXXXXXXXXXXXXXXXXXXXGXXXXXXXXXXXXXXXXXXXGXXXXXXXXXXXXXXXXXXX,0,10,0
22953,14,1,13,123,463,0,0,476,289,187,GXXXXXXXXXXXXXXXXXXXGXXXXXXXXXXXXXXXXXXXGXXXXXXXXXXXXXXXXXXXGXXXXXXXXXXXXXXXXXXXGXXXXXXXXXXXXXXXXXXXGXXXXXXXXXXXXXXXXXXXGXXXXXXXXXXXXXXXXXXXGXXXXXXXXXXXXXXXXXXXGXXXXXXXXXXXXXXXXXXXGXXXXXXXXXXXXXXXXXXXGXXXXXXXXXXXXXXXXXXXGXXXXXXXXXXXXXXXXXXXGAXXXXXXXXXXXXXXXXXX,0,10,0
22974,14,1,13,121,465,0,0,479,291,188,GXXXXXXXXXXXXXXXXXXXGXXXXXXXXXXXXXXXXXXXGXXXXXXXXXXXXXXXXXXXGXXXXXXXXXXXXXXXXXXXGXXXXXXXXXXXXXXXXXXXGXXXXXXXXXXXXXXXXXXXGXXXXXXXXXXXXXXXXXXXGXXXXXXXXXXXXXXXXXXXGXXXXXXXXXXXXXXXXXXXGXXXXXXXXXXXXXXXXXXXGXXXXXXXXXXXXXXXXXXXGXXXXXXXXXXXXXXXXXXXGAXXXXXXXXXXXXXXXXXX,0,10,0

22995,14,1,13,123,463,0,0,478,290,188,GXXXXXXXXXXXXXXXXXXXGXXXXXXXXXXXXXXXXXXXGXXXXXXXXXXXXXXXXXXXGXXXXXXXXXXXXXXXXXXXGXXXXXXXXXXXXXXXXXXXGXXXXXXXXXXXXXXXXXXXGXXXXXXXXXXXXXXXXXXXGXXXXXXXXXXXXXXXXXXXGXXXXXXXXXXXXXXXXXXXGXXXXXXXXXXXXXXXXXXXGXXXXXXXXXXXXXXXXXXXGXXXXXXXXXXXXXXXXXXXGAXXXXXXXXXXXXXXXXXX,0,10,0
23016,14,1,13,127,459,0,0,475,289,186,GXXXXXXXXXXXXXXXXXXXGXXXXXXXXXXXXXXXXXXXGXXXXXXXXXXXXXXXXXXXGXXXXXXXXXXXXXXXXXXXGXXXXXXXXXXXXXXXXXXXGXXXXXXXXXXXXXXXXXXXGXXXXXXXXXXXXXXXXXXXGXXXXXXXXXXXXXXXXXXXGXXXXXXXXXXXXXXXXXXXGXXXXXXXXXXXXXXXXXXXGXXXXXXXXXXXXXXXXXXXGXXXXXXXXXXXXXXXXXXXGAXXXXXXXXXXXXXXXXXX,0,10,0
23037,14,0,14,122,464,0,0,480,289,191,GXXXXXXXXXXXXXXXXXXXGXXXXXXXXXXXXXXXXXXXGXXXXXXXXXXXXXXXXXXXGXXXXXXXXXXXXXXXXXXXGXXXXXXXXXXXXXXXXXXXGXXXXXXXXXXXXXXXXXXXGXXXXXXXXXXXXXXXXXXXGXXXXXXXXXXXXXXXXXXXGXXXXXXXXXXXXXXXXXXXGXXXXXXXXXXXXXXXXXXXGXXXXXXXXXXXXXXXXXXXGXXXXXXXXXXXXXXXXXXXGOXXXXXXXXXXXXXXXXXX,0,10,0
23058,13,0,13,109,478,0,0,492,296,196,GXXXXXXXXXXXXXXXXXXXGXXXXXXXXXXXXXXXXXXXGXXXXXXXXXXXXXXXXXXXGXXXXXXXXXXXXXXXXXXXGXXXXXXXXXXXXXXXXXXXGXXXXXXXXXXXXXXXXXXXGXXXXXXXXXXXXXXXXXXXGXXXXXXXXXXXXXXXXXXXGXXXXXXXXXXXXXXXXXXXGXXXXXXXXXXXXXXXXXXXGXXXXXXXXXXXXXXXXXXXGXXXXXXXXXXXXXXXXXXXGXXXXXXXXXXXXXXXXXXX,0,10,0
23079,13,0,13,113,474,0,0,488,300,188,GXXXXXXXXXXXXXXXXXXXGXXXXXXXXXXXXXXXXXXXGXXXXXXXXXXXXXXXXXXXGXXXXXXXXXXXXXXXXXXXGXXXXXXXXXXXXXXXXXXXGXXXXXXXXXXXXXXXXXXXGXXXXXXXXXXXXXXXXXXXGXXXXXXXXXXXXXXXXXXXGXXXXXXXXXXXXXXXXXXXGXXXXXXXXXXXXXXXXXXXGXXXXXXXXXXXXXXXXXXXGXXXXXXXXXXXXXXXXXXXGXXXXXXXXXXXXXXXXXXX,0,10,0

23100,14,1,13,111,475,0,0,488,298,190,GXXXXXXXXXXXXXXXXXXXGXXXXXXXXXXXXXXXXXXXGAXXXXXXXXXXXXXXXXXXGXXXXXXXXXXXXXXXXXXXGXXXXXXXXXXXXXXXXXXXGXXXXXXXXXXXXXXXXXXXGXXXXXXXXXXXXXXXXXXXGXXXXXXXXXXXXXXXXXXXGXXXXXXXXXXXXXXXXXXXGXXXXXXXXXXXXXXXXXXXGXXXXXXXXXXXXXXXXXXXGXXXXXXXXXXXXXXXXXXXGXXXXXXXXXXXXXXXXXXX,0,10,0
23121,14,1,13,113,473,0,0,486,302,184,GXXXXXXXXXXXXXXXXXXXGXXXXXXXXXXXXXXXXXXXGAXXXXXXXXXXXXXXXXXXGXXXXXXXXXXXXXXXXXXXGXXXXXXXXXXXXXXXXXXXGXXXXXXXXXXXXXXXXXXXGXXXXXXXXXXXXXXXXXXXGXXXXXXXXXXXXXXXXXXXGXXXXXXXXXXXXXXXXXXXGXXXXXXXXXXXXXXXXXXXGXXXXXXXXXXXXXXXXXXXGXXXXXXXXXXXXXXXXXXXGXXXXXXXXXXXXXXXXXXX,0,10,0
23142,14,0,14,119,467,0,0,480,298,182,GXXXXXXXXXXXXXXXXXXXGXXXXXXXXXXXXXXXXXXXGOXXXXXXXXXXXXXXXXXXGXXXXXXXXXXXXXXXXXXXGXXXXXXXXXXXXXXXXXXXGXXXXXXXXXXXXXXXXXXXGXXXXXXXXXXXXXXXXXXXGXXXXXXXXXXXXXXXXXXXGXXXXXXXXXXXXXXXXXXXGXXXXXXXXXXXXXXXXXXXGXXXXXXXXXXXXXXXXXXXGXXXXXXXXXXXXXXXXXXXGXXXXXXXXXXXXXXXXXXX,0,10,0
23163,13,0,13,120,467,0,0,480,294,186,GXXXXXXXXXXXXXXXXXXXGXXXXXXXXXXXXXXXXXXXGXXXXXXXXXXXXXXXXXXXGXXXXXXXXXXXXXXXXXXXGXXXXXXXXXXXXXXXXXXXGXXXXXXXXXXXXXXXXXXXGXXXXXXXXXXXXXXXXXXXGXXXXXXXXXXXXXXXXXXXGXXXXXXXXXXXXXXXXXXXGXXXXXXXXXXXXXXXXXXXGXXXXXXXXXXXXXXXXXXXGXXXXXXXXXXXXXXXXXXXGXXXXXXXXXXXXXXXXXXX,0,10,0
23184,13,0,13,119,468,0,0,481,290,191,GXXXXXXXXXXXXXXXXXXXGXXXXXXXXXXXXXXXXXXXGXXXXXXXXXXXXXXXXXXXGXXXXXXXXXXXXXXXXXXXGXXXXXXXXXXXXXXXXXXXGXXXXXXXXXXXXXXXXXXXGXXXXXXXXXXXXXXXXXXXGXXXXXXXXXXXXXXXXXXXGXXXXXXXXXXXXXXXXXXXGXXXXXXXXXXXXXXXXXXXGXXXXXXXXXXXXXXXXXXXGXXXXXXXXXXXXXXXXXXXGXXXXXXXXXXXXXXXXXXX,0,10,0

23205,13,0,13,118,469,0,0,482,291,191,GXXXXXXXXXXXXXXXXXXXGXXXXXXXXXXXXXXXXXXXGXXXXXXXXXXXXXXXXXXXGXXXXXXXXXXXXXXXXXXXGXXXXXXXXXXXXXXXXXXXGXXXXXXXXXXXXXXXXXXXGXXXXXXXXXXXXXXXXXXXGXXXXXXXXXXXXXXXXXXXGXXXXXXXXXXXXXXXXXXXGXXXXXXXXXXXXXXXXXXXGXXXXXXXXXXXXXXXXXXXGXXXXXXXXXXXXXXXXXXXGXXXXXXXXXXXXXXXXXXX,0,10,0
23226,13,0,13,115,472,0,0,485,287,198,GXXXXXXXXXXXXXXXXXXXGXXXXXXXXXXXXXXXXXXXGXXXXXXXXXXXXXXXXXXXGXXXXXXXXXXXXXXXXXXXGXXXXXXXXXXXXXXXXXXXGXXXXXXXXXXXXXXXXXXXGXXXXXXXXXXXXXXXXXXXGXXXXXXXXXXXXXXXXXXXGXXXXXXXXXXXXXXXXXXXGXXXXXXXXXXXXXXXXXXXGXXXXXXXXXXXXXXXXXXXGXXXXXXXXXXXXXXXXXXXGXXXXXXXXXXXXXXXXXXX,0,10,0
23247,13,0,13,107,480,0,0,493,295,198,GXXXXXXXXXXXXXXXXXXXGXXXXXXXXXXXXXXXXXXXGXXXXXXXXXXXXXXXXXXXGXXXXXXXXXXXXXXXXXXXGXXXXXXXXXXXXXXXXXXXGXXXXXXXXXXXXXXXXXXXGXXXXXXXXXXXXXXXXXXXGXXXXXXXXXXXXXXXXXXXGXXXXXXXXXXXXXXXXXXXGXXXXXXXXXXXXXXXXXXXGXXXXXXXXXXXXXXXXXXXGXXXXXXXXXXXXXXXXXXXGXXXXXXXXXXXXXXXXXXX,0,10,0
23268,13,0,13,109,478,0,0,491,298,193,GXXXXXXXXXXXXXXXXXXXGXXXXXXXXXXXXXXXXXXXGXXXXXXXXXXXXXXXXXXXGXXXXXXXXXXXXXXXXXXXGXXXXXXXXXXXXXXXXXXXGXXXXXXXXXXXXXXXXXXXGXXXXXXXXXXXXXXXXXXXGXXXXXXXXXXXXXXXXXXXGXXXXXXXXXXXXXXXXXXXGXXXXXXXXXXXXXXXXXXXGXXXXXXXXXXXXXXXXXXXGXXXXXXXXXXXXXXXXXXXGXXXXXXXXXXXXXXXXXXX,0,10,0
23289,14,1,13,111,475,0,0,487,296,191,GXXXXXXXXXXXXXXXXXXXGXXXXXXXXXXXXXXXXXXXGXXXXXXXXXXXXXXXXXXXGXXXXXXXXXXXXXXXXXXXGXXXXXXXXXXXXXXXXXXXGXXXXXXXXXXXXXXXXXXXGAXXXXXXXXXXXXXXXXXXGXXXXXXXXXXXXXXXXXXXGXXXXXXXXXXXXXXXXXXXGXXXXXXXXXXXXXXXXXXXGXXXXXXXXXXXXXXXXXXXGXXXXXXXXXXXXXXXXXXXGXXXXXXXXXXXXXXXXXXX,0,10,0

23310,14,1,13,110,476,0,0,487,298,189,GXXXXXXXXXXXXXXXXXXXGXXXXXXXXXXXXXXXXXXXGXXXXXXXXXXXXXXXXXXXGXXXXXXXXXXXXXXXXXXXGXXXXXXXXXXXXXXXXXXXGXXXXXXXXXXXXXXXXXXXGAXXXXXXXXXXXXXXXXXXGXXXXXXXXXXXXXXXXXXXGXXXXXXXXXXXXXXXXXXXGXXXXXXXXXXXXXXXXXXXGXXXXXXXXXXXXXXXXXXXGXXXXXXXXXXXXXXXXXXXGXXXXXXXXXXXXXXXXXXX,0,10,0
23331,14,1,13,115,471,0,0,484,295,189,GXXXXXXXXXXXXXXXXXXXGXXXXXXXXXXXXXXXXXXXGXXXXXXXXXXXXXXXXXXXGXXXXXXXXXXXXXXXXXXXGXXXXXXXXXXXXXXXXXXXGXXXXXXXXXXXXXXXXXXXGAXXXXXXXXXXXXXXXXXXGXXXXXXXXXXXXXXXXXXXGXXXXXXXXXXXXXXXXXXXGXXXXXXXXXXXXXXXXXXXGXXXXXXXXXXXXXXXXXXXGXXXXXXXXXXXXXXXXXXXGXXXXXXXXXXXXXXXXXXX,0,10,0
23352,14,1,13,115,471,0,0,485,294,191,GXXXXXXXXXXXXXXXXXXXGXXXXXXXXXXXXXXXXXXXGXXXXXXXXXXXXXXXXXXXGXXXXXXXXXXXXXXXXXXXGXXXXXXXXXXXXXXXXXXXGXXXXXXXXXXXXXXXXXXXGAXXXXXXXXXXXXXXXXXXGXXXXXXXXXXXXXXXXXXXGXXXXXXXXXXXXXXXXXXXGXXXXXXXXXXXXXXXXXXXGXXXXXXXXXXXXXXXXXXXGXXXXXXXXXXXXXXXXXXXGXXXXXXXXXXXXXXXXXXX,0,10,0
23373,14,1,13,123,463,0,0,477,290,187,GXXXXXXXXXXXXXXXXXXXGXXXXXXXXXXXXXXXXXXXGXXXXXXXXXXXXXXXXXXXGXXXXXXXXXXXXXXXXXXXGXXXXXXXXXXXXXXXXXXXGXXXXXXXXXXXXXXXXXXXGAXXXXXXXXXXXXXXXXXXGXXXXXXXXXXXXXXXXXXXGXXXXXXXXXXXXXXXXXXXGXXXXXXXXXXXXXXXXXXXGXXXXXXXXXXXXXXXXXXXGXXXXXXXXXXXXXXXXXXXGXXXXXXXXXXXXXXXXXXX,0,10,0
23394,14,1,13,119,467,0,0,481,290,191,GXXXXXXXXXXXXXXXXXXXGXXXXXXXXXXXXXXXXXXXGXXXXXXXXXXXXXXXXXXXGXXXXXXXXXXXXXXXXXXXGXXXXXXXXXXXXXXXXXXXGXXXXXXXXXXXXXXXXXXXGAXXXXXXXXXXXXXXXXXXGXXXXXXXXXXXXXXXXXXXGXXXXXXXXXXXXXXXXXXXGXXXXXXXXXXXXXXXXXXXGXXXXXXXXXXXXXXXXXXXGXXXXXXXXXXXXXXXXXXXGXXXXXXXXXXXXXXXXXXX,0,10,0

23415,14,1,13,119,467,0,0,482,294,188,GXXXXXXXXXXXXXXXXXXXGXXXXXXXXXXXXXXXXXXXGXXXXXXXXXXXXXXXXXXXGXXXXXXXXXXXXXXXXXXXGXXXXXXXXXXXXXXXXXXXGXXXXXXXXXXXXXXXXXXXGAXXXXXXXXXXXXXXXXXXGXXXXXXXXXXXXXXXXXXXGXXXXXXXXXXXXXXXXXXXGXXXXXXXXXXXXXXXXXXXGXXXXXXXXXXXXXXXXXXXGXXXXXXXXXXXXXXXXXXXGXXXXXXXXXXXXXXXXXXX,0,10,0
23436,14,1,13,120,466,0,0,481,293,188,GXXXXXXXXXXXXXXXXXXXGXXXXXXXXXXXXXXXXXXXGXXXXXXXXXXXXXXXXXXXGXXXXXXXXXXXXXXXXXXXGXXXXXXXXXXXXXXXXXXXGXXXXXXXXXXXXXXXXXXXGAXXXXXXXXXXXXXXXXXXGXXXXXXXXXXXXXXXXXXXGXXXXXXXXXXXXXXXXXXXGXXXXXXXXXXXXXXXXXXXGXXXXXXXXXXXXXXXXXXXGXXXXXXXXXXXXXXXXXXXGXXXXXXXXXXXXXXXXXXX,0,10,0
23457,15,2,13,111,474,0,0,490,296,194,GAXXXXXXXXXXXXXXXXXXGXXXXXXXXXXXXXXXXXXXGXXXXXXXXXXXXXXXXXXXGXXXXXXXXXXXXXXXXXXXGXXXXXXXXXXXXXXXXXXXGXXXXXXXXXXXXXXXXXXXGAXXXXXXXXXXXXXXXXXXGXXXXXXXXXXXXXXXXXXXGXXXXXXXXXXXXXXXXXXXGXXXXXXXXXXXXXXXXXXXGXXXXXXXXXXXXXXXXXXXGXXXXXXXXXXXXXXXXXXXGXXXXXXXXXXXXXXXXXXX,0,10,0
23478,15,1,14,113,472,0,0,486,294,192,GOXXXXXXXXXXXXXXXXXXGXXXXXXXXXXXXXXXXXXXGXXXXXXXXXXXXXXXXXXXGXXXXXXXXXXXXXXXXXXXGXXXXXXXXXXXXXXXXXXXGXXXXXXXXXXXXXXXXXXXGAXXXXXXXXXXXXXXXXXXGXXXXXXXXXXXXXXXXXXXGXXXXXXXXXXXXXXXXXXXGXXXXXXXXXXXXXXXXXXXGXXXXXXXXXXXXXXXXXXXGXXXXXXXXXXXXXXXXXXXGXXXXXXXXXXXXXXXXXXX,0,10,0
23499,15,1,14,119,466,0,0,481,295,186,GOXXXXXXXXXXXXXXXXXXGXXXXXXXXXXXXXXXXXXXGXXXXXXXXXXXXXXXXXXXGXXXXXXXXXXXXXXXXXXXGXXXXXXXXXXXXXXXXXXXGXXXXXXXXXXXXXXXXXXXGAXXXXXXXXXXXXXXXXXXGXXXXXXXXXXXXXXXXXXXGXXXXXXXXXXXXXXXXXXXGXXXXXXXXXXXXXXXXXXXGXXXXXXXXXXXXXXXXXXXGXXXXXXXXXXXXXXXXXXXGXXXXXXXXXXXXXXXXXXX,0,10,0

23520,14,1,13,115,471,0,0,484,300,184,GXXXXXXXXXXXXXXXXXXXGXXXXXXXXXXXXXXXXXXXGXXXXXXXXXXXXXXXXXXXGXXXXXXXXXXXXXXXXXXXGXXXXXXXXXXXXXXXXXXXGXXXXXXXXXXXXXXXXXXXGAXXXXXXXXXXXXXXXXXXGXXXXXXXXXXXXXXXXXXXGXXXXXXXXXXXXXXXXXXXGXXXXXXXXXXXXXXXXXXXGXXXXXXXXXXXXXXXXXXXGXXXXXXXXXXXXXXXXXXXGXXXXXXXXXXXXXXXXXXX,0,10,0
23541,15,2,13,114,471,0,0,486,297,189,GXXXXXXXXXXXXXXXXXXXGXXXXXXXXXXXXXXXXXXXGXXXXXXXXXXXXXXXXXXXGXXXXXXXXXXXXXXXXXXXGXXXXXXXXXXXXXXXXXXXGAXXXXXXXXXXXXXXXXXXGAXXXXXXXXXXXXXXXXXXGXXXXXXXXXXXXXXXXXXXGXXXXXXXXXXXXXXXXXXXGXXXXXXXXXXXXXXXXXXXGXXXXXXXXXXXXXXXXXXXGXXXXXXXXXXXXXXXXXXXGXXXXXXXXXXXXXXXXXXX,0,10,0
23562,15,2,13,113,472,0,0,487,294,193,GXXXXXXXXXXXXXXXXXXXGXXXXXXXXXXXXXXXXXXXGXXXXXXXXXXXXXXXXXXXGXXXXXXXXXXXXXXXXXXXGXXXXXXXXXXXXXXXXXXXGAXXXXXXXXXXXXXXXXXXGAXXXXXXXXXXXXXXXXXXGXXXXXXXXXXXXXXXXXXXGXXXXXXXXXXXXXXXXXXXGXXXXXXXXXXXXXXXXXXXGXXXXXXXXXXXXXXXXXXXGXXXXXXXXXXXXXXXXXXXGXXXXXXXXXXXXXXXXXXX,0,10,0
23583,16,3,13,112,472,0,0,487,298,189,GXXXXXXXXXXXXXXXXXXXGXXXXXXXXXXXXXXXXXXXGXXXXXXXXXXXXXXXXXXXGXXXXXXXXXXXXXXXXXXXGXXXXXXXXXXXXXXXXXXXGAXXXXXXXXXXXXXXXXXXGAAXXXXXXXXXXXXXXXXXGXXXXXXXXXXXXXXXXXXXGXXXXXXXXXXXXXXXXXXXGXXXXXXXXXXXXXXXXXXXGXXXXXXXXXXXXXXXXXXXGXXXXXXXXXXXXXXXXXXXGXXXXXXXXXXXXXXXXXXX,0,10,0
23604,16,3,13,110,474,0,0,489,301,188,GXXXXXXXXXXXXXXXXXXXGXXXXXXXXXXXXXXXXXXXGXXXXXXXXXXXXXXXXXXXGXXXXXXXXXXXXXXXXXXXGXXXXXXXXXXXXXXXXXXXGAXXXXXXXXXXXXXXXXXXGAAXXXXXXXXXXXXXXXXXGXXXXXXXXXXXXXXXXXXXGXXXXXXXXXXXXXXXXXXXGXXXXXXXXXXXXXXXXXXXGXXXXXXXXXXXXXXXXXXXGXXXXXXXXXXXXXXXXXXXGXXXXXXXXXXXXXXXXXXX,0,10,0

23625,15,2,13,110,475,0,0,489,302,187,GXXXXXXXXXXXXXXXXXXXGXXXXXXXXXXXXXXXXXXXGXXXXXXXXXXXXXXXXXXXGXXXXXXXXXXXXXXXXXXXGXXXXXXXXXXXXXXXXXXXGAXXXXXXXXXXXXXXXXXXGXAXXXXXXXXXXXXXXXXXGXXXXXXXXXXXXXXXXXXXGXXXXXXXXXXXXXXXXXXXGXXXXXXXXXXXXXXXXXXXGXXXXXXXXXXXXXXXXXXXGXXXXXXXXXXXXXXXXXXXGXXXXXXXXXXXXXXXXXXX,0,10,0
23646,15,2,13,116,469,0,0,486,297,189,GXXXXXXXXXXXXXXXXXXXGXXXXXXXXXXXXXXXXXXXGXXXXXXXXXXXXXXXXXXXGXXXXXXXXXXXXXXXXXXXGXXXXXXXXXXXXXXXXXXXGAXXXXXXXXXXXXXXXXXXGXAXXXXXXXXXXXXXXXXXGXXXXXXXXXXXXXXXXXXXGXXXXXXXXXXXXXXXXXXXGXXXXXXXXXXXXXXXXXXXGXXXXXXXXXXXXXXXXXXXGXXXXXXXXXXXXXXXXXXXGXXXXXXXXXXXXXXXXXXX,0,10,0
23667,14,1,13,113,473,0,0,488,296,192,GXXXXXXXXXXXXXXXXXXXGXXXXXXXXXXXXXXXXXXXGXXXXXXXXXXXXXXXXXXXGXXXXXXXXXXXXXXXXXXXGXXXXXXXXXXXXXXXXXXXGAXXXXXXXXXXXXXXXXXXGXXXXXXXXXXXXXXXXXXXGXXXXXXXXXXXXXXXXXXXGXXXXXXXXXXXXXXXXXXXGXXXXXXXXXXXXXXXXXXXGXXXXXXXXXXXXXXXXXXXGXXXXXXXXXXXXXXXXXXXGXXXXXXXXXXXXXXXXXXX,0,10,0
23688,14,1,13,109,477,0,0,491,299,192,GXXXXXXXXXXXXXXXXXXXGXXXXXXXXXXXXXXXXXXXGXXXXXXXXXXXXXXXXXXXGXXXXXXXXXXXXXXXXXXXGXXXXXXXXXXXXXXXXXXXGAXXXXXXXXXXXXXXXXXXGXXXXXXXXXXXXXXXXXXXGXXXXXXXXXXXXXXXXXXXGXXXXXXXXXXXXXXXXXXXGXXXXXXXXXXXXXXXXXXXGXXXXXXXXXXXXXXXXXXXGXXXXXXXXXXXXXXXXXXXGXXXXXXXXXXXXXXXXXXX,0,10,0
23709,13,0,13,107,480,0,0,494,292,202,GXXXXXXXXXXXXXXXXXXXGXXXXXXXXXXXXXXXXXXXGXXXXXXXXXXXXXXXXXXXGXXXXXXXXXXXXXXXXXXXGXXXXXXXXXXXXXXXXXXXGXXXXXXXXXXXXXXXXXXXGXXXXXXXXXXXXXXXXXXXGXXXXXXXXXXXXXXXXXXXGXXXXXXXXXXXXXXXXXXXGXXXXXXXXXXXXXXXXXXXGXXXXXXXXXXXXXXXXXXXGXXXXXXXXXXXXXXXXXXXGXXXXXXXXXXXXXXXXXXX,0,10,0

23730,13,0,13,104,483,0,0,496,293,203,GXXXXXXXXXXXXXXXXXXXGXXXXXXXXXXXXXXXXXXXGXXXXXXXXXXXXXXXXXXXGXXXXXXXXXXXXXXXXXXXGXXXXXXXXXXXXXXXXXXXGXXXXXXXXXXXXXXXXXXXGXXXXXXXXXXXXXXXXXXXGXXXXXXXXXXXXXXXXXXXGXXXXXXXXXXXXXXXXXXXGXXXXXXXXXXXXXXXXXXXGXXXXXXXXXXXXXXXXXXXGXXXXXXXXXXXXXXXXXXXGXXXXXXXXXXXXXXXXXXX,0,10,0
23751,13,0,13,95,492,0,0,505,295,210,GXXXXXXXXXXXXXXXXXXXGXXXXXXXXXXXXXXXXXXXGXXXXXXXXXXXXXXXXXXXGXXXXXXXXXXXXXXXXXXXGXXXXXXXXXXXXXXXXXXXGXXXXXXXXXXXXXXXXXXXGXXXXXXXXXXXXXXXXXXXGXXXXXXXXXXXXXXXXXXXGXXXXXXXXXXXXXXXXXXXGXXXXXXXXXXXXXXXXXXXGXXXXXXXXXXXXXXXXXXXGXXXXXXXXXXXXXXXXXXXGXXXXXXXXXXXXXXXXXXX,0,10,0
23772,13,0,13,92,495,0,0,507,294,213,GXXXXXXXXXXXXXXXXXXXGXXXXXXXXXXXXXXXXXXXGXXXXXXXXXXXXXXXXXXXGXXXXXXXXXXXXXXXXXXXGXXXXXXXXXXXXXXXXXXXGXXXXXXXXXXXXXXXXXXXGXXXXXXXXXXXXXXXXXXXGXXXXXXXXXXXXXXXXXXXGXXXXXXXXXXXXXXXXXXXGXXXXXXXXXXXXXXXXXXXGXXXXXXXXXXXXXXXXXXXGXXXXXXXXXXXXXXXXXXXGXXXXXXXXXXXXXXXXXXX,0,10,0
23793,13,0,13,87,500,0,0,513,298,215,GXXXXXXXXXXXXXXXXXXXGXXXXXXXXXXXXXXXXXXXGXXXXXXXXXXXXXXXXXXXGXXXXXXXXXXXXXXXXXXXGXXXXXXXXXXXXXXXXXXXGXXXXXXXXXXXXXXXXXXXGXXXXXXXXXXXXXXXXXXXGXXXXXXXXXXXXXXXXXXXGXXXXXXXXXXXXXXXXXXXGXXXXXXXXXXXXXXXXXXXGXXXXXXXXXXXXXXXXXXXGXXXXXXXXXXXXXXXXXXXGXXXXXXXXXXXXXXXXXXX,0,10,0
23814,13,0,13,89,498,0,0,511,296,215,GXXXXXXXXXXXXXXXXXXXGXXXXXXXXXXXXXXXXXXXGXXXXXXXXXXXXXXXXXXXGXXXXXXXXXXXXXXXXXXXGXXXXXXXXXXXXXXXXXXXGXXXXXXXXXXXXXXXXXXXGXXXXXXXXXXXXXXXXXXXGXXXXXXXXXXXXXXXXXXXGXXXXXXXXXXXXXXXXXXXGXXXXXXXXXXXXXXXXXXXGXXXXXXXXXXXXXXXXXXXGXXXXXXXXXXXXXXXXXXXGXXXXXXXXXXXXXXXXXXX,0,10,0

23835,13,0,13,87,500,0,0,512,297,215,GXXXXXXXXXXXXXXXXXXXGXXXXXXXXXXXXXXXXXXXGXXXXXXXXXXXXXXXXXXXGXXXXXXXXXXXXXXXXXXXGXXXXXXXXXXXXXXXXXXXGXXXXXXXXXXXXXXXXXXXGXXXXXXXXXXXXXXXXXXXGXXXXXXXXXXXXXXXXXXXGXXXXXXXXXXXXXXXXXXXGXXXXXXXXXXXXXXXXXXXGXXXXXXXXXXXXXXXXXXXGXXXXXXXXXXXXXXXXXXXGXXXXXXXXXXXXXXXXXXX,0,10,0
23856,13,0,13,87,500,0,0,514,299,215,GXXXXXXXXXXXXXXXXXXXGXXXXXXXXXXXXXXXXXXXGXXXXXXXXXXXXXXXXXXXGXXXXXXXXXXXXXXXXXXXGXXXXXXXXXXXXXXXXXXXGXXXXXXXXXXXXXXXXXXXGXXXXXXXXXXXXXXXXXXXGXXXXXXXXXXXXXXXXXXXGXXXXXXXXXXXXXXXXXXXGXXXXXXXXXXXXXXXXXXXGXXXXXXXXXXXXXXXXXXXGXXXXXXXXXXXXXXXXXXXGXXXXXXXXXXXXXXXXXXX,0,10,0
23877,13,0,13,96,491,0,0,506,293,213,GXXXXXXXXXXXXXXXXXXXGXXXXXXXXXXXXXXXXXXXGXXXXXXXXXXXXXXXXXXXGXXXXXXXXXXXXXXXXXXXGXXXXXXXXXXXXXXXXXXXGXXXXXXXXXXXXXXXXXXXGXXXXXXXXXXXXXXXXXXXGXXXXXXXXXXXXXXXXXXXGXXXXXXXXXXXXXXXXXXXGXXXXXXXXXXXXXXXXXXXGXXXXXXXXXXXXXXXXXXXGXXXXXXXXXXXXXXXXXXXGXXXXXXXXXXXXXXXXXXX,0,10,0
23898,13,0,13,93,494,0,0,507,291,216,GXXXXXXXXXXXXXXXXXXXGXXXXXXXXXXXXXXXXXXXGXXXXXXXXXXXXXXXXXXXGXXXXXXXXXXXXXXXXXXXGXXXXXXXXXXXXXXXXXXXGXXXXXXXXXXXXXXXXXXXGXXXXXXXXXXXXXXXXXXXGXXXXXXXXXXXXXXXXXXXGXXXXXXXXXXXXXXXXXXXGXXXXXXXXXXXXXXXXXXXGXXXXXXXXXXXXXXXXXXXGXXXXXXXXXXXXXXXXXXXGXXXXXXXXXXXXXXXXXXX,0,10,0
23919,13,0,13,92,495,0,0,508,294,214,GXXXXXXXXXXXXXXXXXXXGXXXXXXXXXXXXXXXXXXXGXXXXXXXXXXXXXXXXXXXGXXXXXXXXXXXXXXXXXXXGXXXXXXXXXXXXXXXXXXXGXXXXXXXXXXXXXXXXXXXGXXXXXXXXXXXXXXXXXXXGXXXXXXXXXXXXXXXXXXXGXXXXXXXXXXXXXXXXXXXGXXXXXXXXXXXXXXXXXXXGXXXXXXXXXXXXXXXXXXXGXXXXXXXXXXXXXXXXXXXGXXXXXXXXXXXXXXXXXXX,0,10,0

23940,13,0,13,97,490,0,0,505,295,210,GXXXXXXXXXXXXXXXXXXXGXXXXXXXXXXXXXXXXXXXGXXXXXXXXXXXXXXXXXXXGXXXXXXXXXXXXXXXXXXXGXXXXXXXXXXXXXXXXXXXGXXXXXXXXXXXXXXXXXXXGXXXXXXXXXXXXXXXXXXXGXXXXXXXXXXXXXXXXXXXGXXXXXXXXXXXXXXXXXXXGXXXXXXXXXXXXXXXXXXXGXXXXXXXXXXXXXXXXXXXGXXXXXXXXXXXXXXXXXXXGXXXXXXXXXXXXXXXXXXX,0,10,0
23961,13,0,13,102,485,0,0,500,296,204,GXXXXXXXXXXXXXXXXXXXGXXXXXXXXXXXXXXXXXXXGXXXXXXXXXXXXXXXXXXXGXXXXXXXXXXXXXXXXXXXGXXXXXXXXXXXXXXXXXXXGXXXXXXXXXXXXXXXXXXXGXXXXXXXXXXXXXXXXXXXGXXXXXXXXXXXXXXXXXXXGXXXXXXXXXXXXXXXXXXXGXXXXXXXXXXXXXXXXXXXGXXXXXXXXXXXXXXXXXXXGXXXXXXXXXXXXXXXXXXXGXXXXXXXXXXXXXXXXXXX,0,10,0
23982,13,0,13,105,482,0,0,497,302,195,GXXXXXXXXXXXXXXXXXXXGXXXXXXXXXXXXXXXXXXXGXXXXXXXXXXXXXXXXXXXGXXXXXXXXXXXXXXXXXXXGXXXXXXXXXXXXXXXXXXXGXXXXXXXXXXXXXXXXXXXGXXXXXXXXXXXXXXXXXXXGXXXXXXXXXXXXXXXXXXXGXXXXXXXXXXXXXXXXXXXGXXXXXXXXXXXXXXXXXXXGXXXXXXXXXXXXXXXXXXXGXXXXXXXXXXXXXXXXXXXGXXXXXXXXXXXXXXXXXXX,0,10,0
24003,13,0,13,116,471,0,0,486,297,189,GXXXXXXXXXXXXXXXXXXXGXXXXXXXXXXXXXXXXXXXGXXXXXXXXXXXXXXXXXXXGXXXXXXXXXXXXXXXXXXXGXXXXXXXXXXXXXXXXXXXGXXXXXXXXXXXXXXXXXXXGXXXXXXXXXXXXXXXXXXXGXXXXXXXXXXXXXXXXXXXGXXXXXXXXXXXXXXXXXXXGXXXXXXXXXXXXXXXXXXXGXXXXXXXXXXXXXXXXXXXGXXXXXXXXXXXXXXXXXXXGXXXXXXXXXXXXXXXXXXX,0,10,0
24024,14,1,13,106,480,0,0,495,305,190,GXXXXXXXXXXXXXXXXXXXGXXXXXXXXXXXXXXXXXXXGXXXXXXXXXXXXXXXXXXXGXXXXXXXXXXXXXXXXXXXGXXXXXXXXXXXXXXXXXXXGXXXXXXXXXXXXXXXXXXXGXXXXXXXXXXXXXXXXXXXGXXXXXXXXXXXXXXXXXXXGXXXXXXXXXXXXXXXXXXXGXXXXXXXXXXXXXXXXXXXGXXXXXXXXXXXXXXXXXXXGAXXXXXXXXXXXXXXXXXXGXXXXXXXXXXXXXXXXXXX,0,10,0

24045,14,1,13,110,476,0,0,490,305,185,GXXXXXXXXXXXXXXXXXXXGXXXXXXXXXXXXXXXXXXXGXXXXXXXXXXXXXXXXXXXGXXXXXXXXXXXXXXXXXXXGXXXXXXXXXXXXXXXXXXXGXXXXXXXXXXXXXXXXXXXGXXXXXXXXXXXXXXXXXXXGXXXXXXXXXXXXXXXXXXXGXXXXXXXXXXXXXXXXXXXGXXXXXXXXXXXXXXXXXXXGXXXXXXXXXXXXXXXXXXXGAXXXXXXXXXXXXXXXXXXGXXXXXXXXXXXXXXXXXXX,0,10,0
24066,14,1,13,106,480,0,0,493,309,184,GXXXXXXXXXXXXXXXXXXXGXXXXXXXXXXXXXXXXXXXGXXXXXXXXXXXXXXXXXXXGXXXXXXXXXXXXXXXXXXXGXXXXXXXXXXXXXXXXXXXGXXXXXXXXXXXXXXXXXXXGXXXXXXXXXXXXXXXXXXXGXXXXXXXXXXXXXXXXXXXGXXXXXXXXXXXXXXXXXXXGXXXXXXXXXXXXXXXXXXXGXXXXXXXXXXXXXXXXXXXGAXXXXXXXXXXXXXXXXXXGXXXXXXXXXXXXXXXXXXX,0,10,0
24087,14,1,13,114,472,0,0,487,302,185,GXXXXXXXXXXXXXXXXXXXGXXXXXXXXXXXXXXXXXXXGXXXXXXXXXXXXXXXXXXXGXXXXXXXXXXXXXXXXXXXGXXXXXXXXXXXXXXXXXXXGXXXXXXXXXXXXXXXXXXXGXXXXXXXXXXXXXXXXXXXGXXXXXXXXXXXXXXXXXXXGXXXXXXXXXXXXXXXXXXXGXXXXXXXXXXXXXXXXXXXGXXXXXXXXXXXXXXXXXXXGAXXXXXXXXXXXXXXXXXXGXXXXXXXXXXXXXXXXXXX,0,10,0
24108,15,2,13,120,465,0,0,479,304,175,GXXXXXXXXXXXXXXXXXXXGXXXXXXXXXXXXXXXXXXXGXXXXXXXXXXXXXXXXXXXGXXXXXXXXXXXXXXXXXXXGXXXXXXXXXXXXXXXXXXXGAXXXXXXXXXXXXXXXXXXGXXXXXXXXXXXXXXXXXXXGXXXXXXXXXXXXXXXXXXXGXXXXXXXXXXXXXXXXXXXGXXXXXXXXXXXXXXXXXXXGXXXXXXXXXXXXXXXXXXXGAXXXXXXXXXXXXXXXXXXGXXXXXXXXXXXXXXXXXXX,0,10,0
24129,15,2,13,121,464,0,0,478,307,171,GXXXXXXXXXXXXXXXXXXXGXXXXXXXXXXXXXXXXXXXGXXXXXXXXXXXXXXXXXXXGXXXXXXXXXXXXXXXXXXXGXXXXXXXXXXXXXXXXXXXGAXXXXXXXXXXXXXXXXXXGXXXXXXXXXXXXXXXXXXXGXXXXXXXXXXXXXXXXXXXGXXXXXXXXXXXXXXXXXXXGXXXXXXXXXXXXXXXXXXXGXXXXXXXXXXXXXXXXXXXGAXXXXXXXXXXXXXXXXXXGXXXXXXXXXXXXXXXXXXX,0,10,0

24150,16,3,13,125,459,0,0,473,304,169,GAXXXXXXXXXXXXXXXXXXGXXXXXXXXXXXXXXXXXXXGXXXXXXXXXXXXXXXXXXXGXXXXXXXXXXXXXXXXXXXGXXXXXXXXXXXXXXXXXXXGAXXXXXXXXXXXXXXXXXXGXXXXXXXXXXXXXXXXXXXGXXXXXXXXXXXXXXXXXXXGXXXXXXXXXXXXXXXXXXXGXXXXXXXXXXXXXXXXXXXGXXXXXXXXXXXXXXXXXXXGAXXXXXXXXXXXXXXXXXXGXXXXXXXXXXXXXXXXXXX,0,10,0
24171,16,3,13,124,460,0,0,473,303,170,GAXXXXXXXXXXXXXXXXXXGXXXXXXXXXXXXXXXXXXXGXXXXXXXXXXXXXXXXXXXGXXXXXXXXXXXXXXXXXXXGXXXXXXXXXXXXXXXXXXXGAXXXXXXXXXXXXXXXXXXGXXXXXXXXXXXXXXXXXXXGXXXXXXXXXXXXXXXXXXXGXXXXXXXXXXXXXXXXXXXGXXXXXXXXXXXXXXXXXXXGXXXXXXXXXXXXXXXXXXXGAXXXXXXXXXXXXXXXXXXGXXXXXXXXXXXXXXXXXXX,0,10,0
24192,16,3,13,124,460,0,0,476,302,174,GAXXXXXXXXXXXXXXXXXXGXXXXXXXXXXXXXXXXXXXGXXXXXXXXXXXXXXXXXXXGXXXXXXXXXXXXXXXXXXXGXXXXXXXXXXXXXXXXXXXGAXXXXXXXXXXXXXXXXXXGXXXXXXXXXXXXXXXXXXXGXXXXXXXXXXXXXXXXXXXGXXXXXXXXXXXXXXXXXXXGXXXXXXXXXXXXXXXXXXXGXXXXXXXXXXXXXXXXXXXGAXXXXXXXXXXXXXXXXXXGXXXXXXXXXXXXXXXXXXX,0,10,0
24213,15,2,13,122,463,0,0,479,298,181,GAXXXXXXXXXXXXXXXXXXGXXXXXXXXXXXXXXXXXXXGXXXXXXXXXXXXXXXXXXXGXXXXXXXXXXXXXXXXXXXGXXXXXXXXXXXXXXXXXXXGXXXXXXXXXXXXXXXXXXXGXXXXXXXXXXXXXXXXXXXGXXXXXXXXXXXXXXXXXXXGXXXXXXXXXXXXXXXXXXXGXXXXXXXXXXXXXXXXXXXGXXXXXXXXXXXXXXXXXXXGAXXXXXXXXXXXXXXXXXXGXXXXXXXXXXXXXXXXXXX,0,10,0
24234,15,2,13,120,465,0,0,481,299,182,GAXXXXXXXXXXXXXXXXXXGXXXXXXXXXXXXXXXXXXXGXXXXXXXXXXXXXXXXXXXGXXXXXXXXXXXXXXXXXXXGXXXXXXXXXXXXXXXXXXXGXXXXXXXXXXXXXXXXXXXGXXXXXXXXXXXXXXXXXXXGXXXXXXXXXXXXXXXXXXXGXXXXXXXXXXXXXXXXXXXGXXXXXXXXXXXXXXXXXXXGXXXXXXXXXXXXXXXXXXXGAXXXXXXXXXXXXXXXXXXGXXXXXXXXXXXXXXXXXXX,0,10,0

24255,14,1,13,118,468,0,0,483,302,181,GAXXXXXXXXXXXXXXXXXXGXXXXXXXXXXXXXXXXXXXGXXXXXXXXXXXXXXXXXXXGXXXXXXXXXXXXXXXXXXXGXXXXXXXXXXXXXXXXXXXGXXXXXXXXXXXXXXXXXXXGXXXXXXXXXXXXXXXXXXXGXXXXXXXXXXXXXXXXXXXGXXXXXXXXXXXXXXXXXXXGXXXXXXXXXXXXXXXXXXXGXXXXXXXXXXXXXXXXXXXGXXXXXXXXXXXXXXXXXXXGXXXXXXXXXXXXXXXXXXX,0,10,0
24276,14,1,13,113,473,0,0,490,301,189,GAXXXXXXXXXXXXXXXXXXGXXXXXXXXXXXXXXXXXXXGXXXXXXXXXXXXXXXXXXXGXXXXXXXXXXXXXXXXXXXGXXXXXXXXXXXXXXXXXXXGXXXXXXXXXXXXXXXXXXXGXXXXXXXXXXXXXXXXXXXGXXXXXXXXXXXXXXXXXXXGXXXXXXXXXXXXXXXXXXXGXXXXXXXXXXXXXXXXXXXGXXXXXXXXXXXXXXXXXXXGXXXXXXXXXXXXXXXXXXXGXXXXXXXXXXXXXXXXXXX,0,10,0
24297,14,1,13,113,473,0,0,489,302,187,GAXXXXXXXXXXXXXXXXXXGXXXXXXXXXXXXXXXXXXXGXXXXXXXXXXXXXXXXXXXGXXXXXXXXXXXXXXXXXXXGXXXXXXXXXXXXXXXXXXXGXXXXXXXXXXXXXXXXXXXGXXXXXXXXXXXXXXXXXXXGXXXXXXXXXXXXXXXXXXXGXXXXXXXXXXXXXXXXXXXGXXXXXXXXXXXXXXXXXXXGXXXXXXXXXXXXXXXXXXXGXXXXXXXXXXXXXXXXXXXGXXXXXXXXXXXXXXXXXXX,0,10,0
24318,14,1,13,109,477,0,0,492,302,190,GAXXXXXXXXXXXXXXXXXXGXXXXXXXXXXXXXXXXXXXGXXXXXXXXXXXXXXXXXXXGXXXXXXXXXXXXXXXXXXXGXXXXXXXXXXXXXXXXXXXGXXXXXXXXXXXXXXXXXXXGXXXXXXXXXXXXXXXXXXXGXXXXXXXXXXXXXXXXXXXGXXXXXXXXXXXXXXXXXXXGXXXXXXXXXXXXXXXXXXXGXXXXXXXXXXXXXXXXXXXGXXXXXXXXXXXXXXXXXXXGXXXXXXXXXXXXXXXXXXX,0,10,0
24339,14,1,13,114,472,0,0,486,297,189,GAXXXXXXXXXXXXXXXXXXGXXXXXXXXXXXXXXXXXXXGXXXXXXXXXXXXXXXXXXXGXXXXXXXXXXXXXXXXXXXGXXXXXXXXXXXXXXXXXXXGXXXXXXXXXXXXXXXXXXXGXXXXXXXXXXXXXXXXXXXGXXXXXXXXXXXXXXXXXXXGXXXXXXXXXXXXXXXXXXXGXXXXXXXXXXXXXXXXXXXGXXXXXXXXXXXXXXXXXXXGXXXXXXXXXXXXXXXXXXXGXXXXXXXXXXXXXXXXXXX,0,10,0

24360,14,1,13,114,472,0,0,486,302,184,GAXXXXXXXXXXXXXXXXXXGXXXXXXXXXXXXXXXXXXXGXXXXXXXXXXXXXXXXXXXGXXXXXXXXXXXXXXXXXXXGXXXXXXXXXXXXXXXXXXXGXXXXXXXXXXXXXXXXXXXGXXXXXXXXXXXXXXXXXXXGXXXXXXXXXXXXXXXXXXXGXXXXXXXXXXXXXXXXXXXGXXXXXXXXXXXXXXXXXXXGXXXXXXXXXXXXXXXXXXXGXXXXXXXXXXXXXXXXXXXGXXXXXXXXXXXXXXXXXXX,0,10,0
24381,14,1,13,117,469,0,0,483,299,184,GAXXXXXXXXXXXXXXXXXXGXXXXXXXXXXXXXXXXXXXGXXXXXXXXXXXXXXXXXXXGXXXXXXXXXXXXXXXXXXXGXXXXXXXXXXXXXXXXXXXGXXXXXXXXXXXXXXXXXXXGXXXXXXXXXXXXXXXXXXXGXXXXXXXXXXXXXXXXXXXGXXXXXXXXXXXXXXXXXXXGXXXXXXXXXXXXXXXXXXXGXXXXXXXXXXXXXXXXXXXGXXXXXXXXXXXXXXXXXXXGXXXXXXXXXXXXXXXXXXX,0,10,0
24402,14,1,13,121,465,0,0,479,295,184,GAXXXXXXXXXXXXXXXXXXGXXXXXXXXXXXXXXXXXXXGXXXXXXXXXXXXXXXXXXXGXXXXXXXXXXXXXXXXXXXGXXXXXXXXXXXXXXXXXXXGXXXXXXXXXXXXXXXXXXXGXXXXXXXXXXXXXXXXXXXGXXXXXXXXXXXXXXXXXXXGXXXXXXXXXXXXXXXXXXXGXXXXXXXXXXXXXXXXXXXGXXXXXXXXXXXXXXXXXXXGXXXXXXXXXXXXXXXXXXXGXXXXXXXXXXXXXXXXXXX,0,10,0
24423,14,1,13,110,476,0,0,491,297,194,GAXXXXXXXXXXXXXXXXXXGXXXXXXXXXXXXXXXXXXXGXXXXXXXXXXXXXXXXXXXGXXXXXXXXXXXXXXXXXXXGXXXXXXXXXXXXXXXXXXXGXXXXXXXXXXXXXXXXXXXGXXXXXXXXXXXXXXXXXXXGXXXXXXXXXXXXXXXXXXXGXXXXXXXXXXXXXXXXXXXGXXXXXXXXXXXXXXXXXXXGXXXXXXXXXXXXXXXXXXXGXXXXXXXXXXXXXXXXXXXGXXXXXXXXXXXXXXXXXXX,0,10,0
24444,14,1,13,107,479,0,0,495,298,197,GAXXXXXXXXXXXXXXXXXXGXXXXXXXXXXXXXXXXXXXGXXXXXXXXXXXXXXXXXXXGXXXXXXXXXXXXXXXXXXXGXXXXXXXXXXXXXXXXXXXGXXXXXXXXXXXXXXXXXXXGXXXXXXXXXXXXXXXXXXXGXXXXXXXXXXXXXXXXXXXGXXXXXXXXXXXXXXXXXXXGXXXXXXXXXXXXXXXXXXXGXXXXXXXXXXXXXXXXXXXGXXXXXXXXXXXXXXXXXXXGXXXXXXXXXXXXXXXXXXX,0,10,0

24465,14,1,13,104,482,0,0,497,310,187,GAXXXXXXXXXXXXXXXXXXGXXXXXXXXXXXXXXXXXXXGXXXXXXXXXXXXXXXXXXXGXXXXXXXXXXXXXXXXXXXGXXXXXXXXXXXXXXXXXXXGXXXXXXXXXXXXXXXXXXXGXXXXXXXXXXXXXXXXXXXGXXXXXXXXXXXXXXXXXXXGXXXXXXXXXXXXXXXXXXXGXXXXXXXXXXXXXXXXXXXGXXXXXXXXXXXXXXXXXXXGXXXXXXXXXXXXXXXXXXXGXXXXXXXXXXXXXXXXXXX,0,10,0
24486,15,2,13,110,475,0,0,489,303,186,GAXXXXXXXXXXXXXXXXXXGXXXXXXXXXXXXXXXXXXXGXXXXXXXXXXXXXXXXXXXGXXXXXXXXXXXXXXXXXXXGXXXXXXXXXXXXXXXXXXXGXXXXXXXXXXXXXXXXXXXGXXXXXXXXXXXXXXXXXXXGAXXXXXXXXXXXXXXXXXXGXXXXXXXXXXXXXXXXXXXGXXXXXXXXXXXXXXXXXXXGXXXXXXXXXXXXXXXXXXXGXXXXXXXXXXXXXXXXXXXGXXXXXXXXXXXXXXXXXXX,0,10,0
24507,15,2,13,106,479,0,0,493,303,190,GXXXXXXXXXXXXXXXXXXXGXXXXXXXXXXXXXXXXXXXGXXXXXXXXXXXXXXXXXXXGXXXXXXXXXXXXXXXXXXXGAXXXXXXXXXXXXXXXXXXGXXXXXXXXXXXXXXXXXXXGXXXXXXXXXXXXXXXXXXXGAXXXXXXXXXXXXXXXXXXGXXXXXXXXXXXXXXXXXXXGXXXXXXXXXXXXXXXXXXXGXXXXXXXXXXXXXXXXXXXGXXXXXXXXXXXXXXXXXXXGXXXXXXXXXXXXXXXXXXX,0,10,0
24528,15,2,13,113,472,0,0,487,303,184,GXXXXXXXXXXXXXXXXXXXGXXXXXXXXXXXXXXXXXXXGXXXXXXXXXXXXXXXXXXXGXXXXXXXXXXXXXXXXXXXGAXXXXXXXXXXXXXXXXXXGXXXXXXXXXXXXXXXXXXXGXXXXXXXXXXXXXXXXXXXGAXXXXXXXXXXXXXXXXXXGXXXXXXXXXXXXXXXXXXXGXXXXXXXXXXXXXXXXXXXGXXXXXXXXXXXXXXXXXXXGXXXXXXXXXXXXXXXXXXXGXXXXXXXXXXXXXXXXXXX,0,10,0
24549,14,1,13,108,478,0,0,493,308,185,GXXXXXXXXXXXXXXXXXXXGXXXXXXXXXXXXXXXXXXXGXXXXXXXXXXXXXXXXXXXGXXXXXXXXXXXXXXXXXXXGAXXXXXXXXXXXXXXXXXXGXXXXXXXXXXXXXXXXXXXGXXXXXXXXXXXXXXXXXXXGXXXXXXXXXXXXXXXXXXXGXXXXXXXXXXXXXXXXXXXGXXXXXXXXXXXXXXXXXXXGXXXXXXXXXXXXXXXXXXXGXXXXXXXXXXXXXXXXXXXGXXXXXXXXXXXXXXXXXXX,0,10,0

24570,14,0,14,108,478,0,0,494,313,181,GXXXXXXXXXXXXXXXXXXXGXXXXXXXXXXXXXXXXXXXGXXXXXXXXXXXXXXXXXXXGXXXXXXXXXXXXXXXXXXXGOXXXXXXXXXXXXXXXXXXGXXXXXXXXXXXXXXXXXXXGXXXXXXXXXXXXXXXXXXXGXXXXXXXXXXXXXXXXXXXGXXXXXXXXXXXXXXXXXXXGXXXXXXXXXXXXXXXXXXXGXXXXXXXXXXXXXXXXXXXGXXXXXXXXXXXXXXXXXXXGXXXXXXXXXXXXXXXXXXX,0,10,0
24591,14,0,14,103,483,0,0,497,310,187,GXXXXXXXXXXXXXXXXXXXGXXXXXXXXXXXXXXXXXXXGXXXXXXXXXXXXXXXXXXXGXXXXXXXXXXXXXXXXXXXGOXXXXXXXXXXXXXXXXXXGXXXXXXXXXXXXXXXXXXXGXXXXXXXXXXXXXXXXXXXGXXXXXXXXXXXXXXXXXXXGXXXXXXXXXXXXXXXXXXXGXXXXXXXXXXXXXXXXXXXGXXXXXXXXXXXXXXXXXXXGXXXXXXXXXXXXXXXXXXXGXXXXXXXXXXXXXXXXXXX,0,10,0
24612,13,0,13,102,485,0,0,499,310,189,GXXXXXXXXXXXXXXXXXXXGXXXXXXXXXXXXXXXXXXXGXXXXXXXXXXXXXXXXXXXGXXXXXXXXXXXXXXXXXXXGXXXXXXXXXXXXXXXXXXXGXXXXXXXXXXXXXXXXXXXGXXXXXXXXXXXXXXXXXXXGXXXXXXXXXXXXXXXXXXXGXXXXXXXXXXXXXXXXXXXGXXXXXXXXXXXXXXXXXXXGXXXXXXXXXXXXXXXXXXXGXXXXXXXXXXXXXXXXXXXGXXXXXXXXXXXXXXXXXXX,0,10,0
24633,13,0,13,109,478,0,0,491,308,183,GXXXXXXXXXXXXXXXXXXXGXXXXXXXXXXXXXXXXXXXGXXXXXXXXXXXXXXXXXXXGXXXXXXXXXXXXXXXXXXXGXXXXXXXXXXXXXXXXXXXGXXXXXXXXXXXXXXXXXXXGXXXXXXXXXXXXXXXXXXXGXXXXXXXXXXXXXXXXXXXGXXXXXXXXXXXXXXXXXXXGXXXXXXXXXXXXXXXXXXXGXXXXXXXXXXXXXXXXXXXGXXXXXXXXXXXXXXXXXXXGXXXXXXXXXXXXXXXXXXX,0,10,0
24654,13,0,13,104,483,0,0,498,308,190,GXXXXXXXXXXXXXXXXXXXGXXXXXXXXXXXXXXXXXXXGXXXXXXXXXXXXXXXXXXXGXXXXXXXXXXXXXXXXXXXGXXXXXXXXXXXXXXXXXXXGXXXXXXXXXXXXXXXXXXXGXXXXXXXXXXXXXXXXXXXGXXXXXXXXXXXXXXXXXXXGXXXXXXXXXXXXXXXXXXXGXXXXXXXXXXXXXXXXXXXGXXXXXXXXXXXXXXXXXXXGXXXXXXXXXXXXXXXXXXXGXXXXXXXXXXXXXXXXXXX,0,10,0

24675,13,0,13,105,482,0,0,496,309,187,GXXXXXXXXXXXXXXXXXXXGXXXXXXXXXXXXXXXXXXXGXXXXXXXXXXXXXXXXXXXGXXXXXXXXXXXXXXXXXXXGXXXXXXXXXXXXXXXXXXXGXXXXXXXXXXXXXXXXXXXGXXXXXXXXXXXXXXXXXXXGXXXXXXXXXXXXXXXXXXXGXXXXXXXXXXXXXXXXXXXGXXXXXXXXXXXXXXXXXXXGXXXXXXXXXXXXXXXXXXXGXXXXXXXXXXXXXXXXXXXGXXXXXXXXXXXXXXXXXXX,0,10,0
24696,13,0,13,104,483,0,0,497,308,189,GXXXXXXXXXXXXXXXXXXXGXXXXXXXXXXXXXXXXXXXGXXXXXXXXXXXXXXXXXXXGXXXXXXXXXXXXXXXXXXXGXXXXXXXXXXXXXXXXXXXGXXXXXXXXXXXXXXXXXXXGXXXXXXXXXXXXXXXXXXXGXXXXXXXXXXXXXXXXXXXGXXXXXXXXXXXXXXXXXXXGXXXXXXXXXXXXXXXXXXXGXXXXXXXXXXXXXXXXXXXGXXXXXXXXXXXXXXXXXXXGXXXXXXXXXXXXXXXXXXX,0,10,0
24717,13,0,13,105,482,0,0,496,305,191,GXXXXXXXXXXXXXXXXXXXGXXXXXXXXXXXXXXXXXXXGXXXXXXXXXXXXXXXXXXXGXXXXXXXXXXXXXXXXXXXGXXXXXXXXXXXXXXXXXXXGXXXXXXXXXXXXXXXXXXXGXXXXXXXXXXXXXXXXXXXGXXXXXXXXXXXXXXXXXXXGXXXXXXXXXXXXXXXXXXXGXXXXXXXXXXXXXXXXXXXGXXXXXXXXXXXXXXXXXXXGXXXXXXXXXXXXXXXXXXXGXXXXXXXXXXXXXXXXXXX,0,10,0
24738,13,0,13,101,486,0,0,499,306,193,GXXXXXXXXXXXXXXXXXXXGXXXXXXXXXXXXXXXXXXXGXXXXXXXXXXXXXXXXXXXGXXXXXXXXXXXXXXXXXXXGXXXXXXXXXXXXXXXXXXXGXXXXXXXXXXXXXXXXXXXGXXXXXXXXXXXXXXXXXXXGXXXXXXXXXXXXXXXXXXXGXXXXXXXXXXXXXXXXXXXGXXXXXXXXXXXXXXXXXXXGXXXXXXXXXXXXXXXXXXXGXXXXXXXXXXXXXXXXXXXGXXXXXXXXXXXXXXXXXXX,0,10,0
24759,13,0,13,100,487,0,0,499,305,194,GXXXXXXXXXXXXXXXXXXXGXXXXXXXXXXXXXXXXXXXGXXXXXXXXXXXXXXXXXXXGXXXXXXXXXXXXXXXXXXXGXXXXXXXXXXXXXXXXXXXGXXXXXXXXXXXXXXXXXXXGXXXXXXXXXXXXXXXXXXXGXXXXXXXXXXXXXXXXXXXGXXXXXXXXXXXXXXXXXXXGXXXXXXXXXXXXXXXXXXXGXXXXXXXXXXXXXXXXXXXGXXXXXXXXXXXXXXXXXXXGXXXXXXXXXXXXXXXXXXX,0,10,0

24780,13,0,13,101,486,0,0,500,308,192,GXXXXXXXXXXXXXXXXXXXGXXXXXXXXXXXXXXXXXXXGXXXXXXXXXXXXXXXXXXXGXXXXXXXXXXXXXXXXXXXGXXXXXXXXXXXXXXXXXXXGXXXXXXXXXXXXXXXXXXXGXXXXXXXXXXXXXXXXXXXGXXXXXXXXXXXXXXXXXXXGXXXXXXXXXXXXXXXXXXXGXXXXXXXXXXXXXXXXXXXGXXXXXXXXXXXXXXXXXXXGXXXXXXXXXXXXXXXXXXXGXXXXXXXXXXXXXXXXXXX,0,10,0
24801,13,0,13,93,494,0,0,508,311,197,GXXXXXXXXXXXXXXXXXXXGXXXXXXXXXXXXXXXXXXXGXXXXXXXXXXXXXXXXXXXGXXXXXXXXXXXXXXXXXXXGXXXXXXXXXXXXXXXXXXXGXXXXXXXXXXXXXXXXXXXGXXXXXXXXXXXXXXXXXXXGXXXXXXXXXXXXXXXXXXXGXXXXXXXXXXXXXXXXXXXGXXXXXXXXXXXXXXXXXXXGXXXXXXXXXXXXXXXXXXXGXXXXXXXXXXXXXXXXXXXGXXXXXXXXXXXXXXXXXXX,0,10,0
24822,13,0,13,104,483,0,0,496,309,187,GXXXXXXXXXXXXXXXXXXXGXXXXXXXXXXXXXXXXXXXGXXXXXXXXXXXXXXXXXXXGXXXXXXXXXXXXXXXXXXXGXXXXXXXXXXXXXXXXXXXGXXXXXXXXXXXXXXXXXXXGXXXXXXXXXXXXXXXXXXXGXXXXXXXXXXXXXXXXXXXGXXXXXXXXXXXXXXXXXXXGXXXXXXXXXXXXXXXXXXXGXXXXXXXXXXXXXXXXXXXGXXXXXXXXXXXXXXXXXXXGXXXXXXXXXXXXXXXXXXX,0,10,0
24843,13,0,13,106,481,0,0,493,311,182,GXXXXXXXXXXXXXXXXXXXGXXXXXXXXXXXXXXXXXXXGXXXXXXXXXXXXXXXXXXXGXXXXXXXXXXXXXXXXXXXGXXXXXXXXXXXXXXXXXXXGXXXXXXXXXXXXXXXXXXXGXXXXXXXXXXXXXXXXXXXGXXXXXXXXXXXXXXXXXXXGXXXXXXXXXXXXXXXXXXXGXXXXXXXXXXXXXXXXXXXGXXXXXXXXXXXXXXXXXXXGXXXXXXXXXXXXXXXXXXXGXXXXXXXXXXXXXXXXXXX,0,10,0
24864,13,0,13,111,476,0,0,489,308,181,GXXXXXXXXXXXXXXXXXXXGXXXXXXXXXXXXXXXXXXXGXXXXXXXXXXXXXXXXXXXGXXXXXXXXXXXXXXXXXXXGXXXXXXXXXXXXXXXXXXXGXXXXXXXXXXXXXXXXXXXGXXXXXXXXXXXXXXXXXXXGXXXXXXXXXXXXXXXXXXXGXXXXXXXXXXXXXXXXXXXGXXXXXXXXXXXXXXXXXXXGXXXXXXXXXXXXXXXXXXXGXXXXXXXXXXXXXXXXXXXGXXXXXXXXXXXXXXXXXXX,0,10,0

24885,14,1,13,102,484,0,0,497,305,192,GXXXXXXXXXXXXXXXXXXXGXXXXXXXXXXXXXXXXXXXGXXXXXXXXXXXXXXXXXXXGAXXXXXXXXXXXXXXXXXXGXXXXXXXXXXXXXXXXXXXGXXXXXXXXXXXXXXXXXXXGXXXXXXXXXXXXXXXXXXXGXXXXXXXXXXXXXXXXXXXGXXXXXXXXXXXXXXXXXXXGXXXXXXXXXXXXXXXXXXXGXXXXXXXXXXXXXXXXXXXGXXXXXXXXXXXXXXXXXXXGXXXXXXXXXXXXXXXXXXX,0,10,0
24906,14,1,13,105,481,0,0,494,302,192,GXXXXXXXXXXXXXXXXXXXGXXXXXXXXXXXXXXXXXXXGXXXXXXXXXXXXXXXXXXXGAXXXXXXXXXXXXXXXXXXGXXXXXXXXXXXXXXXXXXXGXXXXXXXXXXXXXXXXXXXGXXXXXXXXXXXXXXXXXXXGXXXXXXXXXXXXXXXXXXXGXXXXXXXXXXXXXXXXXXXGXXXXXXXXXXXXXXXXXXXGXXXXXXXXXXXXXXXXXXXGXXXXXXXXXXXXXXXXXXXGXXXXXXXXXXXXXXXXXXX,0,10,0
24927,14,1,13,111,475,0,0,488,303,185,GXXXXXXXXXXXXXXXXXXXGXXXXXXXXXXXXXXXXXXXGXXXXXXXXXXXXXXXXXXXGAXXXXXXXXXXXXXXXXXXGXXXXXXXXXXXXXXXXXXXGXXXXXXXXXXXXXXXXXXXGXXXXXXXXXXXXXXXXXXXGXXXXXXXXXXXXXXXXXXXGXXXXXXXXXXXXXXXXXXXGXXXXXXXXXXXXXXXXXXXGXXXXXXXXXXXXXXXXXXXGXXXXXXXXXXXXXXXXXXXGXXXXXXXXXXXXXXXXXXX,0,10,0
24948,14,1,13,100,486,0,0,499,312,187,GXXXXXXXXXXXXXXXXXXXGXXXXXXXXXXXXXXXXXXXGXXXXXXXXXXXXXXXXXXXGAXXXXXXXXXXXXXXXXXXGXXXXXXXXXXXXXXXXXXXGXXXXXXXXXXXXXXXXXXXGXXXXXXXXXXXXXXXXXXXGXXXXXXXXXXXXXXXXXXXGXXXXXXXXXXXXXXXXXXXGXXXXXXXXXXXXXXXXXXXGXXXXXXXXXXXXXXXXXXXGXXXXXXXXXXXXXXXXXXXGXXXXXXXXXXXXXXXXXXX,0,10,0
24969,14,1,13,103,483,0,0,496,309,187,GXXXXXXXXXXXXXXXXXXXGXXXXXXXXXXXXXXXXXXXGXXXXXXXXXXXXXXXXXXXGAXXXXXXXXXXXXXXXXXXGXXXXXXXXXXXXXXXXXXXGXXXXXXXXXXXXXXXXXXXGXXXXXXXXXXXXXXXXXXXGXXXXXXXXXXXXXXXXXXXGXXXXXXXXXXXXXXXXXXXGXXXXXXXXXXXXXXXXXXXGXXXXXXXXXXXXXXXXXXXGXXXXXXXXXXXXXXXXXXXGXXXXXXXXXXXXXXXXXXX,0,10,0

24990,14,0,14,102,484,0,0,497,311,186,GXXXXXXXXXXXXXXXXXXXGXXXXXXXXXXXXXXXXXXXGXXXXXXXXXXXXXXXXXXXGOXXXXXXXXXXXXXXXXXXGXXXXXXXXXXXXXXXXXXXGXXXXXXXXXXXXXXXXXXXGXXXXXXXXXXXXXXXXXXXGXXXXXXXXXXXXXXXXXXXGXXXXXXXXXXXXXXXXXXXGXXXXXXXXXXXXXXXXXXXGXXXXXXXXXXXXXXXXXXXGXXXXXXXXXXXXXXXXXXXGXXXXXXXXXXXXXXXXXXX,0,10,0
25011,13,0,13,101,486,0,0,499,312,187,GXXXXXXXXXXXXXXXXXXXGXXXXXXXXXXXXXXXXXXXGXXXXXXXXXXXXXXXXXXXGXXXXXXXXXXXXXXXXXXXGXXXXXXXXXXXXXXXXXXXGXXXXXXXXXXXXXXXXXXXGXXXXXXXXXXXXXXXXXXXGXXXXXXXXXXXXXXXXXXXGXXXXXXXXXXXXXXXXXXXGXXXXXXXXXXXXXXXXXXXGXXXXXXXXXXXXXXXXXXXGXXXXXXXXXXXXXXXXXXXGXXXXXXXXXXXXXXXXXXX,0,10,0
25032,13,0,13,108,479,0,0,493,310,183,GXXXXXXXXXXXXXXXXXXXGXXXXXXXXXXXXXXXXXXXGXXXXXXXXXXXXXXXXXXXGXXXXXXXXXXXXXXXXXXXGXXXXXXXXXXXXXXXXXXXGXXXXXXXXXXXXXXXXXXXGXXXXXXXXXXXXXXXXXXXGXXXXXXXXXXXXXXXXXXXGXXXXXXXXXXXXXXXXXXXGXXXXXXXXXXXXXXXXXXXGXXXXXXXXXXXXXXXXXXXGXXXXXXXXXXXXXXXXXXXGXXXXXXXXXXXXXXXXXXX,0,10,0
25053,13,0,13,109,478,0,0,491,310,181,GXXXXXXXXXXXXXXXXXXXGXXXXXXXXXXXXXXXXXXXGXXXXXXXXXXXXXXXXXXXGXXXXXXXXXXXXXXXXXXXGXXXXXXXXXXXXXXXXXXXGXXXXXXXXXXXXXXXXXXXGXXXXXXXXXXXXXXXXXXXGXXXXXXXXXXXXXXXXXXXGXXXXXXXXXXXXXXXXXXXGXXXXXXXXXXXXXXXXXXXGXXXXXXXXXXXXXXXXXXXGXXXXXXXXXXXXXXXXXXXGXXXXXXXXXXXXXXXXXXX,0,10,0
25074,13,0,13,107,480,0,0,491,315,176,GXXXXXXXXXXXXXXXXXXXGXXXXXXXXXXXXXXXXXXXGXXXXXXXXXXXXXXXXXXXGXXXXXXXXXXXXXXXXXXXGXXXXXXXXXXXXXXXXXXXGXXXXXXXXXXXXXXXXXXXGXXXXXXXXXXXXXXXXXXXGXXXXXXXXXXXXXXXXXXXGXXXXXXXXXXXXXXXXXXXGXXXXXXXXXXXXXXXXXXXGXXXXXXXXXXXXXXXXXXXGXXXXXXXXXXXXXXXXXXXGXXXXXXXXXXXXXXXXXXX,0,10,0

25095,13,0,13,108,479,0,0,493,305,188,GXXXXXXXXXXXXXXXXXXXGXXXXXXXXXXXXXXXXXXXGXXXXXXXXXXXXXXXXXXXGXXXXXXXXXXXXXXXXXXXGXXXXXXXXXXXXXXXXXXXGXXXXXXXXXXXXXXXXXXXGXXXXXXXXXXXXXXXXXXXGXXXXXXXXXXXXXXXXXXXGXXXXXXXXXXXXXXXXXXXGXXXXXXXXXXXXXXXXXXXGXXXXXXXXXXXXXXXXXXXGXXXXXXXXXXXXXXXXXXXGXXXXXXXXXXXXXXXXXXX,0,10,0
25116,13,0,13,100,487,0,0,501,310,191,GXXXXXXXXXXXXXXXXXXXGXXXXXXXXXXXXXXXXXXXGXXXXXXXXXXXXXXXXXXXGXXXXXXXXXXXXXXXXXXXGXXXXXXXXXXXXXXXXXXXGXXXXXXXXXXXXXXXXXXXGXXXXXXXXXXXXXXXXXXXGXXXXXXXXXXXXXXXXXXXGXXXXXXXXXXXXXXXXXXXGXXXXXXXXXXXXXXXXXXXGXXXXXXXXXXXXXXXXXXXGXXXXXXXXXXXXXXXXXXXGXXXXXXXXXXXXXXXXXXX,0,10,0
25137,13,0,13,102,485,0,0,499,315,184,GXXXXXXXXXXXXXXXXXXXGXXXXXXXXXXXXXXXXXXXGXXXXXXXXXXXXXXXXXXXGXXXXXXXXXXXXXXXXXXXGXXXXXXXXXXXXXXXXXXXGXXXXXXXXXXXXXXXXXXXGXXXXXXXXXXXXXXXXXXXGXXXXXXXXXXXXXXXXXXXGXXXXXXXXXXXXXXXXXXXGXXXXXXXXXXXXXXXXXXXGXXXXXXXXXXXXXXXXXXXGXXXXXXXXXXXXXXXXXXXGXXXXXXXXXXXXXXXXXXX,0,10,0
25158,14,1,13,106,480,0,0,493,304,189,GXXXXXXXXXXXXXXXXXXXGXXXXXXXXXXXXXXXXXXXGXXXXXXXXXXXXXXXXXXXGXXXXXXXXXXXXXXXXXXXGXXXXXXXXXXXXXXXXXXXGXXXXXXXXXXXXXXXXXXXGXXXXXXXXXXXXXXXXXXXGXXXXXXXXXXXXXXXXXXXGXXXXXXXXXXXXXXXXXXXGXXXXXXXXXXXXXXXXXXXGAXXXXXXXXXXXXXXXXXXGXXXXXXXXXXXXXXXXXXXGXXXXXXXXXXXXXXXXXXX,0,10,0
25179,14,1,13,104,482,0,0,497,307,190,GXXXXXXXXXXXXXXXXXXXGXXXXXXXXXXXXXXXXXXXGXXXXXXXXXXXXXXXXXXXGXXXXXXXXXXXXXXXXXXXGXXXXXXXXXXXXXXXXXXXGXXXXXXXXXXXXXXXXXXXGXXXXXXXXXXXXXXXXXXXGXXXXXXXXXXXXXXXXXXXGXXXXXXXXXXXXXXXXXXXGXXXXXXXXXXXXXXXXXXXGAXXXXXXXXXXXXXXXXXXGXXXXXXXXXXXXXXXXXXXGXXXXXXXXXXXXXXXXXXX,0,10,0

25200,14,1,13,100,486,0,0,501,310,191,GXXXXXXXXXXXXXXXXXXXGXXXXXXXXXXXXXXXXXXXGXXXXXXXXXXXXXXXXXXXGXXXXXXXXXXXXXXXXXXXGXXXXXXXXXXXXXXXXXXXGXXXXXXXXXXXXXXXXXXXGXXXXXXXXXXXXXXXXXXXGXXXXXXXXXXXXXXXXXXXGXXXXXXXXXXXXXXXXXXXGXXXXXXXXXXXXXXXXXXXGAXXXXXXXXXXXXXXXXXXGXXXXXXXXXXXXXXXXXXXGXXXXXXXXXXXXXXXXXXX,0,10,0
25221,14,1,13,101,485,0,0,498,309,189,GXXXXXXXXXXXXXXXXXXXGXXXXXXXXXXXXXXXXXXXGXXXXXXXXXXXXXXXXXXXGXXXXXXXXXXXXXXXXXXXGXXXXXXXXXXXXXXXXXXXGXXXXXXXXXXXXXXXXXXXGXXXXXXXXXXXXXXXXXXXGXXXXXXXXXXXXXXXXXXXGXXXXXXXXXXXXXXXXXXXGXXXXXXXXXXXXXXXXXXXGAXXXXXXXXXXXXXXXXXXGXXXXXXXXXXXXXXXXXXXGXXXXXXXXXXXXXXXXXXX,0,10,0
25242,14,1,13,98,488,0,0,503,307,196,GXXXXXXXXXXXXXXXXXXXGXXXXXXXXXXXXXXXXXXXGXXXXXXXXXXXXXXXXXXXGXXXXXXXXXXXXXXXXXXXGXXXXXXXXXXXXXXXXXXXGXXXXXXXXXXXXXXXXXXXGXXXXXXXXXXXXXXXXXXXGXXXXXXXXXXXXXXXXXXXGXXXXXXXXXXXXXXXXXXXGXXXXXXXXXXXXXXXXXXXGAXXXXXXXXXXXXXXXXXXGXXXXXXXXXXXXXXXXXXXGXXXXXXXXXXXXXXXXXXX,0,10,0
25263,14,0,14,90,496,0,0,509,311,198,GXXXXXXXXXXXXXXXXXXXGXXXXXXXXXXXXXXXXXXXGXXXXXXXXXXXXXXXXXXXGXXXXXXXXXXXXXXXXXXXGXXXXXXXXXXXXXXXXXXXGXXXXXXXXXXXXXXXXXXXGXXXXXXXXXXXXXXXXXXXGXXXXXXXXXXXXXXXXXXXGXXXXXXXXXXXXXXXXXXXGXXXXXXXXXXXXXXXXXXXGOXXXXXXXXXXXXXXXXXXGXXXXXXXXXXXXXXXXXXXGXXXXXXXXXXXXXXXXXXX,0,10,0
25284,14,0,14,94,492,0,0,505,311,194,GXXXXXXXXXXXXXXXXXXXGXXXXXXXXXXXXXXXXXXXGXXXXXXXXXXXXXXXXXXXGXXXXXXXXXXXXXXXXXXXGXXXXXXXXXXXXXXXXXXXGXXXXXXXXXXXXXXXXXXXGXXXXXXXXXXXXXXXXXXXGXXXXXXXXXXXXXXXXXXXGXXXXXXXXXXXXXXXXXXXGXXXXXXXXXXXXXXXXXXXGOXXXXXXXXXXXXXXXXXXGXXXXXXXXXXXXXXXXXXXGXXXXXXXXXXXXXXXXXXX,0,10,0

25305,13,0,13,94,493,0,0,506,307,199,GXXXXXXXXXXXXXXXXXXXGXXXXXXXXXXXXXXXXXXXGXXXXXXXXXXXXXXXXXXXGXXXXXXXXXXXXXXXXXXXGXXXXXXXXXXXXXXXXXXXGXXXXXXXXXXXXXXXXXXXGXXXXXXXXXXXXXXXXXXXGXXXXXXXXXXXXXXXXXXXGXXXXXXXXXXXXXXXXXXXGXXXXXXXXXXXXXXXXXXXGXXXXXXXXXXXXXXXXXXXGXXXXXXXXXXXXXXXXXXXGXXXXXXXXXXXXXXXXXXX,0,10,0
25326,13,0,13,91,496,0,0,509,309,200,GXXXXXXXXXXXXXXXXXXXGXXXXXXXXXXXXXXXXXXXGXXXXXXXXXXXXXXXXXXXGXXXXXXXXXXXXXXXXXXXGXXXXXXXXXXXXXXXXXXXGXXXXXXXXXXXXXXXXXXXGXXXXXXXXXXXXXXXXXXXGXXXXXXXXXXXXXXXXXXXGXXXXXXXXXXXXXXXXXXXGXXXXXXXXXXXXXXXXXXXGXXXXXXXXXXXXXXXXXXXGXXXXXXXXXXXXXXXXXXXGXXXXXXXXXXXXXXXXXXX,0,10,0
25347,13,0,13,94,493,0,0,506,312,194,GXXXXXXXXXXXXXXXXXXXGXXXXXXXXXXXXXXXXXXXGXXXXXXXXXXXXXXXXXXXGXXXXXXXXXXXXXXXXXXXGXXXXXXXXXXXXXXXXXXXGXXXXXXXXXXXXXXXXXXXGXXXXXXXXXXXXXXXXXXXGXXXXXXXXXXXXXXXXXXXGXXXXXXXXXXXXXXXXXXXGXXXXXXXXXXXXXXXXXXXGXXXXXXXXXXXXXXXXXXXGXXXXXXXXXXXXXXXXXXXGXXXXXXXXXXXXXXXXXXX,0,10,0
25368,13,0,13,99,488,0,0,501,311,190,GXXXXXXXXXXXXXXXXXXXGXXXXXXXXXXXXXXXXXXXGXXXXXXXXXXXXXXXXXXXGXXXXXXXXXXXXXXXXXXXGXXXXXXXXXXXXXXXXXXXGXXXXXXXXXXXXXXXXXXXGXXXXXXXXXXXXXXXXXXXGXXXXXXXXXXXXXXXXXXXGXXXXXXXXXXXXXXXXXXXGXXXXXXXXXXXXXXXXXXXGXXXXXXXXXXXXXXXXXXXGXXXXXXXXXXXXXXXXXXXGXXXXXXXXXXXXXXXXXXX,0,10,0
25389,13,0,13,92,495,0,0,506,320,186,GXXXXXXXXXXXXXXXXXXXGXXXXXXXXXXXXXXXXXXXGXXXXXXXXXXXXXXXXXXXGXXXXXXXXXXXXXXXXXXXGXXXXXXXXXXXXXXXXXXXGXXXXXXXXXXXXXXXXXXXGXXXXXXXXXXXXXXXXXXXGXXXXXXXXXXXXXXXXXXXGXXXXXXXXXXXXXXXXXXXGXXXXXXXXXXXXXXXXXXXGXXXXXXXXXXXXXXXXXXXGXXXXXXXXXXXXXXXXXXXGXXXXXXXXXXXXXXXXXXX,0,10,0

25410,13,0,13,94,493,0,0,504,316,188,GXXXXXXXXXXXXXXXXXXXGXXXXXXXXXXXXXXXXXXXGXXXXXXXXXXXXXXXXXXXGXXXXXXXXXXXXXXXXXXXGXXXXXXXXXXXXXXXXXXXGXXXXXXXXXXXXXXXXXXXGXXXXXXXXXXXXXXXXXXXGXXXXXXXXXXXXXXXXXXXGXXXXXXXXXXXXXXXXXXXGXXXXXXXXXXXXXXXXXXXGXXXXXXXXXXXXXXXXXXXGXXXXXXXXXXXXXXXXXXXGXXXXXXXXXXXXXXXXXXX,0,10,0
25431,13,0,13,99,488,0,0,502,315,187,GXXXXXXXXXXXXXXXXXXXGXXXXXXXXXXXXXXXXXXXGXXXXXXXXXXXXXXXXXXXGXXXXXXXXXXXXXXXXXXXGXXXXXXXXXXXXXXXXXXXGXXXXXXXXXXXXXXXXXXXGXXXXXXXXXXXXXXXXXXXGXXXXXXXXXXXXXXXXXXXGXXXXXXXXXXXXXXXXXXXGXXXXXXXXXXXXXXXXXXXGXXXXXXXXXXXXXXXXXXXGXXXXXXXXXXXXXXXXXXXGXXXXXXXXXXXXXXXXXXX,0,10,0
25452,13,0,13,106,481,0,0,495,308,187,GXXXXXXXXXXXXXXXXXXXGXXXXXXXXXXXXXXXXXXXGXXXXXXXXXXXXXXXXXXXGXXXXXXXXXXXXXXXXXXXGXXXXXXXXXXXXXXXXXXXGXXXXXXXXXXXXXXXXXXXGXXXXXXXXXXXXXXXXXXXGXXXXXXXXXXXXXXXXXXXGXXXXXXXXXXXXXXXXXXXGXXXXXXXXXXXXXXXXXXXGXXXXXXXXXXXXXXXXXXXGXXXXXXXXXXXXXXXXXXXGXXXXXXXXXXXXXXXXXXX,0,10,0
25473,13,0,13,103,484,0,0,497,316,181,GXXXXXXXXXXXXXXXXXXXGXXXXXXXXXXXXXXXXXXXGXXXXXXXXXXXXXXXXXXXGXXXXXXXXXXXXXXXXXXXGXXXXXXXXXXXXXXXXXXXGXXXXXXXXXXXXXXXXXXXGXXXXXXXXXXXXXXXXXXXGXXXXXXXXXXXXXXXXXXXGXXXXXXXXXXXXXXXXXXXGXXXXXXXXXXXXXXXXXXXGXXXXXXXXXXXXXXXXXXXGXXXXXXXXXXXXXXXXXXXGXXXXXXXXXXXXXXXXXXX,0,10,0
25494,13,0,13,105,482,0,0,497,310,187,GXXXXXXXXXXXXXXXXXXXGXXXXXXXXXXXXXXXXXXXGXXXXXXXXXXXXXXXXXXXGXXXXXXXXXXXXXXXXXXXGXXXXXXXXXXXXXXXXXXXGXXXXXXXXXXXXXXXXXXXGXXXXXXXXXXXXXXXXXXXGXXXXXXXXXXXXXXXXXXXGXXXXXXXXXXXXXXXXXXXGXXXXXXXXXXXXXXXXXXXGXXXXXXXXXXXXXXXXXXXGXXXXXXXXXXXXXXXXXXXGXXXXXXXXXXXXXXXXXXX,0,10,0

25515,13,0,13,107,480,0,0,494,310,184,GXXXXXXXXXXXXXXXXXXXGXXXXXXXXXXXXXXXXXXXGXXXXXXXXXXXXXXXXXXXGXXXXXXXXXXXXXXXXXXXGXXXXXXXXXXXXXXXXXXXGXXXXXXXXXXXXXXXXXXXGXXXXXXXXXXXXXXXXXXXGXXXXXXXXXXXXXXXXXXXGXXXXXXXXXXXXXXXXXXXGXXXXXXXXXXXXXXXXXXXGXXXXXXXXXXXXXXXXXXXGXXXXXXXXXXXXXXXXXXXGXXXXXXXXXXXXXXXXXXX,0,10,0
25536,13,0,13,102,485,0,0,501,316,185,GXXXXXXXXXXXXXXXXXXXGXXXXXXXXXXXXXXXXXXXGXXXXXXXXXXXXXXXXXXXGXXXXXXXXXXXXXXXXXXXGXXXXXXXXXXXXXXXXXXXGXXXXXXXXXXXXXXXXXXXGXXXXXXXXXXXXXXXXXXXGXXXXXXXXXXXXXXXXXXXGXXXXXXXXXXXXXXXXXXXGXXXXXXXXXXXXXXXXXXXGXXXXXXXXXXXXXXXXXXXGXXXXXXXXXXXXXXXXXXXGXXXXXXXXXXXXXXXXXXX,0,10,0
25557,13,0,13,100,487,0,0,503,317,186,GXXXXXXXXXXXXXXXXXXXGXXXXXXXXXXXXXXXXXXXGXXXXXXXXXXXXXXXXXXXGXXXXXXXXXXXXXXXXXXXGXXXXXXXXXXXXXXXXXXXGXXXXXXXXXXXXXXXXXXXGXXXXXXXXXXXXXXXXXXXGXXXXXXXXXXXXXXXXXXXGXXXXXXXXXXXXXXXXXXXGXXXXXXXXXXXXXXXXXXXGXXXXXXXXXXXXXXXXXXXGXXXXXXXXXXXXXXXXXXXGXXXXXXXXXXXXXXXXXXX,0,10,0
25578,13,0,13,100,487,0,0,503,308,195,GXXXXXXXXXXXXXXXXXXXGXXXXXXXXXXXXXXXXXXXGXXXXXXXXXXXXXXXXXXXGXXXXXXXXXXXXXXXXXXXGXXXXXXXXXXXXXXXXXXXGXXXXXXXXXXXXXXXXXXXGXXXXXXXXXXXXXXXXXXXGXXXXXXXXXXXXXXXXXXXGXXXXXXXXXXXXXXXXXXXGXXXXXXXXXXXXXXXXXXXGXXXXXXXXXXXXXXXXXXXGXXXXXXXXXXXXXXXXXXXGXXXXXXXXXXXXXXXXXXX,0,10,0
25599,13,0,13,101,486,0,0,501,314,187,GXXXXXXXXXXXXXXXXXXXGXXXXXXXXXXXXXXXXXXXGXXXXXXXXXXXXXXXXXXXGXXXXXXXXXXXXXXXXXXXGXXXXXXXXXXXXXXXXXXXGXXXXXXXXXXXXXXXXXXXGXXXXXXXXXXXXXXXXXXXGXXXXXXXXXXXXXXXXXXXGXXXXXXXXXXXXXXXXXXXGXXXXXXXXXXXXXXXXXXXGXXXXXXXXXXXXXXXXXXXGXXXXXXXXXXXXXXXXXXXGXXXXXXXXXXXXXXXXXXX,0,10,0

25620,13,0,13,105,482,0,0,497,318,179,GXXXXXXXXXXXXXXXXXXXGXXXXXXXXXXXXXXXXXXXGXXXXXXXXXXXXXXXXXXXGXXXXXXXXXXXXXXXXXXXGXXXXXXXXXXXXXXXXXXXGXXXXXXXXXXXXXXXXXXXGXXXXXXXXXXXXXXXXXXXGXXXXXXXXXXXXXXXXXXXGXXXXXXXXXXXXXXXXXXXGXXXXXXXXXXXXXXXXXXXGXXXXXXXXXXXXXXXXXXXGXXXXXXXXXXXXXXXXXXXGXXXXXXXXXXXXXXXXXXX,0,10,0
25641,13,0,13,105,482,0,0,496,311,185,GXXXXXXXXXXXXXXXXXXXGXXXXXXXXXXXXXXXXXXXGXXXXXXXXXXXXXXXXXXXGXXXXXXXXXXXXXXXXXXXGXXXXXXXXXXXXXXXXXXXGXXXXXXXXXXXXXXXXXXXGXXXXXXXXXXXXXXXXXXXGXXXXXXXXXXXXXXXXXXXGXXXXXXXXXXXXXXXXXXXGXXXXXXXXXXXXXXXXXXXGXXXXXXXXXXXXXXXXXXXGXXXXXXXXXXXXXXXXXXXGXXXXXXXXXXXXXXXXXXX,0,10,0
25662,13,0,13,106,481,0,0,494,317,177,GXXXXXXXXXXXXXXXXXXXGXXXXXXXXXXXXXXXXXXXGXXXXXXXXXXXXXXXXXXXGXXXXXXXXXXXXXXXXXXXGXXXXXXXXXXXXXXXXXXXGXXXXXXXXXXXXXXXXXXXGXXXXXXXXXXXXXXXXXXXGXXXXXXXXXXXXXXXXXXXGXXXXXXXXXXXXXXXXXXXGXXXXXXXXXXXXXXXXXXXGXXXXXXXXXXXXXXXXXXXGXXXXXXXXXXXXXXXXXXXGXXXXXXXXXXXXXXXXXXX,0,10,0
25683,13,0,13,103,484,0,0,497,320,177,GXXXXXXXXXXXXXXXXXXXGXXXXXXXXXXXXXXXXXXXGXXXXXXXXXXXXXXXXXXXGXXXXXXXXXXXXXXXXXXXGXXXXXXXXXXXXXXXXXXXGXXXXXXXXXXXXXXXXXXXGXXXXXXXXXXXXXXXXXXXGXXXXXXXXXXXXXXXXXXXGXXXXXXXXXXXXXXXXXXXGXXXXXXXXXXXXXXXXXXXGXXXXXXXXXXXXXXXXXXXGXXXXXXXXXXXXXXXXXXXGXXXXXXXXXXXXXXXXXXX,0,10,0
25704,13,0,13,111,476,0,0,490,319,171,GXXXXXXXXXXXXXXXXXXXGXXXXXXXXXXXXXXXXXXXGXXXXXXXXXXXXXXXXXXXGXXXXXXXXXXXXXXXXXXXGXXXXXXXXXXXXXXXXXXXGXXXXXXXXXXXXXXXXXXXGXXXXXXXXXXXXXXXXXXXGXXXXXXXXXXXXXXXXXXXGXXXXXXXXXXXXXXXXXXXGXXXXXXXXXXXXXXXXXXXGXXXXXXXXXXXXXXXXXXXGXXXXXXXXXXXXXXXXXXXGXXXXXXXXXXXXXXXXXXX,0,10,0

25725,13,0,13,113,474,0,0,488,317,171,GXXXXXXXXXXXXXXXXXXXGXXXXXXXXXXXXXXXXXXXGXXXXXXXXXXXXXXXXXXXGXXXXXXXXXXXXXXXXXXXGXXXXXXXXXXXXXXXXXXXGXXXXXXXXXXXXXXXXXXXGXXXXXXXXXXXXXXXXXXXGXXXXXXXXXXXXXXXXXXXGXXXXXXXXXXXXXXXXXXXGXXXXXXXXXXXXXXXXXXXGXXXXXXXXXXXXXXXXXXXGXXXXXXXXXXXXXXXXXXXGXXXXXXXXXXXXXXXXXXX,0,10,0
25746,13,0,13,114,473,0,0,487,322,165,GXXXXXXXXXXXXXXXXXXXGXXXXXXXXXXXXXXXXXXXGXXXXXXXXXXXXXXXXXXXGXXXXXXXXXXXXXXXXXXXGXXXXXXXXXXXXXXXXXXXGXXXXXXXXXXXXXXXXXXXGXXXXXXXXXXXXXXXXXXXGXXXXXXXXXXXXXXXXXXXGXXXXXXXXXXXXXXXXXXXGXXXXXXXXXXXXXXXXXXXGXXXXXXXXXXXXXXXXXXXGXXXXXXXXXXXXXXXXXXXGXXXXXXXXXXXXXXXXXXX,0,10,0
25767,13,0,13,124,463,0,0,475,312,163,GXXXXXXXXXXXXXXXXXXXGXXXXXXXXXXXXXXXXXXXGXXXXXXXXXXXXXXXXXXXGXXXXXXXXXXXXXXXXXXXGXXXXXXXXXXXXXXXXXXXGXXXXXXXXXXXXXXXXXXXGXXXXXXXXXXXXXXXXXXXGXXXXXXXXXXXXXXXXXXXGXXXXXXXXXXXXXXXXXXXGXXXXXXXXXXXXXXXXXXXGXXXXXXXXXXXXXXXXXXXGXXXXXXXXXXXXXXXXXXXGXXXXXXXXXXXXXXXXXXX,0,10,0
25788,13,0,13,120,467,0,0,479,317,162,GXXXXXXXXXXXXXXXXXXXGXXXXXXXXXXXXXXXXXXXGXXXXXXXXXXXXXXXXXXXGXXXXXXXXXXXXXXXXXXXGXXXXXXXXXXXXXXXXXXXGXXXXXXXXXXXXXXXXXXXGXXXXXXXXXXXXXXXXXXXGXXXXXXXXXXXXXXXXXXXGXXXXXXXXXXXXXXXXXXXGXXXXXXXXXXXXXXXXXXXGXXXXXXXXXXXXXXXXXXXGXXXXXXXXXXXXXXXXXXXGXXXXXXXXXXXXXXXXXXX,0,10,0
25809,13,0,13,118,469,0,0,482,311,171,GXXXXXXXXXXXXXXXXXXXGXXXXXXXXXXXXXXXXXXXGXXXXXXXXXXXXXXXXXXXGXXXXXXXXXXXXXXXXXXXGXXXXXXXXXXXXXXXXXXXGXXXXXXXXXXXXXXXXXXXGXXXXXXXXXXXXXXXXXXXGXXXXXXXXXXXXXXXXXXXGXXXXXXXXXXXXXXXXXXXGXXXXXXXXXXXXXXXXXXXGXXXXXXXXXXXXXXXXXXXGXXXXXXXXXXXXXXXXXXXGXXXXXXXXXXXXXXXXXXX,0,10,0

25830,13,0,13,113,474,0,0,486,319,167,GXXXXXXXXXXXXXXXXXXXGXXXXXXXXXXXXXXXXXXXGXXXXXXXXXXXXXXXXXXXGXXXXXXXXXXXXXXXXXXXGXXXXXXXXXXXXXXXXXXXGXXXXXXXXXXXXXXXXXXXGXXXXXXXXXXXXXXXXXXXGXXXXXXXXXXXXXXXXXXXGXXXXXXXXXXXXXXXXXXXGXXXXXXXXXXXXXXXXXXXGXXXXXXXXXXXXXXXXXXXGXXXXXXXXXXXXXXXXXXXGXXXXXXXXXXXXXXXXXXX,0,10,0
25851,13,0,13,112,475,0,0,488,317,171,GXXXXXXXXXXXXXXXXXXXGXXXXXXXXXXXXXXXXXXXGXXXXXXXXXXXXXXXXXXXGXXXXXXXXXXXXXXXXXXXGXXXXXXXXXXXXXXXXXXXGXXXXXXXXXXXXXXXXXXXGXXXXXXXXXXXXXXXXXXXGXXXXXXXXXXXXXXXXXXXGXXXXXXXXXXXXXXXXXXXGXXXXXXXXXXXXXXXXXXXGXXXXXXXXXXXXXXXXXXXGXXXXXXXXXXXXXXXXXXXGXXXXXXXXXXXXXXXXXXX,0,10,0
25872,13,0,13,112,475,0,0,488,310,178,GXXXXXXXXXXXXXXXXXXXGXXXXXXXXXXXXXXXXXXXGXXXXXXXXXXXXXXXXXXXGXXXXXXXXXXXXXXXXXXXGXXXXXXXXXXXXXXXXXXXGXXXXXXXXXXXXXXXXXXXGXXXXXXXXXXXXXXXXXXXGXXXXXXXXXXXXXXXXXXXGXXXXXXXXXXXXXXXXXXXGXXXXXXXXXXXXXXXXXXXGXXXXXXXXXXXXXXXXXXXGXXXXXXXXXXXXXXXXXXXGXXXXXXXXXXXXXXXXXXX,0,10,0
25893,13,0,13,106,481,0,0,495,313,182,GXXXXXXXXXXXXXXXXXXXGXXXXXXXXXXXXXXXXXXXGXXXXXXXXXXXXXXXXXXXGXXXXXXXXXXXXXXXXXXXGXXXXXXXXXXXXXXXXXXXGXXXXXXXXXXXXXXXXXXXGXXXXXXXXXXXXXXXXXXXGXXXXXXXXXXXXXXXXXXXGXXXXXXXXXXXXXXXXXXXGXXXXXXXXXXXXXXXXXXXGXXXXXXXXXXXXXXXXXXXGXXXXXXXXXXXXXXXXXXXGXXXXXXXXXXXXXXXXXXX,0,10,0
25914,13,0,13,103,484,0,0,497,315,182,GXXXXXXXXXXXXXXXXXXXGXXXXXXXXXXXXXXXXXXXGXXXXXXXXXXXXXXXXXXXGXXXXXXXXXXXXXXXXXXXGXXXXXXXXXXXXXXXXXXXGXXXXXXXXXXXXXXXXXXXGXXXXXXXXXXXXXXXXXXXGXXXXXXXXXXXXXXXXXXXGXXXXXXXXXXXXXXXXXXXGXXXXXXXXXXXXXXXXXXXGXXXXXXXXXXXXXXXXXXXGXXXXXXXXXXXXXXXXXXXGXXXXXXXXXXXXXXXXXXX,0,10,0

25935,14,1,13,91,495,0,0,509,313,196,GXXXXXXXXXXXXXXXXXXXGXXXXXXXXXXXXXXXXXXXGXXXXXXXXXXXXXXXXXXXGXXXXXXXXXXXXXXXXXXXGAXXXXXXXXXXXXXXXXXXGXXXXXXXXXXXXXXXXXXXGXXXXXXXXXXXXXXXXXXXGXXXXXXXXXXXXXXXXXXXGXXXXXXXXXXXXXXXXXXXGXXXXXXXXXXXXXXXXXXXGXXXXXXXXXXXXXXXXXXXGXXXXXXXXXXXXXXXXXXXGXXXXXXXXXXXXXXXXXXX,0,10,0
25956,14,1,13,88,498,0,0,511,319,192,GXXXXXXXXXXXXXXXXXXXGXXXXXXXXXXXXXXXXXXXGXXXXXXXXXXXXXXXXXXXGXXXXXXXXXXXXXXXXXXXGAXXXXXXXXXXXXXXXXXXGXXXXXXXXXXXXXXXXXXXGXXXXXXXXXXXXXXXXXXXGXXXXXXXXXXXXXXXXXXXGXXXXXXXXXXXXXXXXXXXGXXXXXXXXXXXXXXXXXXXGXXXXXXXXXXXXXXXXXXXGXXXXXXXXXXXXXXXXXXXGXXXXXXXXXXXXXXXXXXX,0,10,0
25977,14,1,13,90,496,0,0,509,317,192,GXXXXXXXXXXXXXXXXXXXGXXXXXXXXXXXXXXXXXXXGXXXXXXXXXXXXXXXXXXXGXXXXXXXXXXXXXXXXXXXGAXXXXXXXXXXXXXXXXXXGXXXXXXXXXXXXXXXXXXXGXXXXXXXXXXXXXXXXXXXGXXXXXXXXXXXXXXXXXXXGXXXXXXXXXXXXXXXXXXXGXXXXXXXXXXXXXXXXXXXGXXXXXXXXXXXXXXXXXXXGXXXXXXXXXXXXXXXXXXXGXXXXXXXXXXXXXXXXXXX,0,10,0
25998,14,1,13,85,501,0,0,515,319,196,GXXXXXXXXXXXXXXXXXXXGXXXXXXXXXXXXXXXXXXXGXXXXXXXXXXXXXXXXXXXGXXXXXXXXXXXXXXXXXXXGAXXXXXXXXXXXXXXXXXXGXXXXXXXXXXXXXXXXXXXGXXXXXXXXXXXXXXXXXXXGXXXXXXXXXXXXXXXXXXXGXXXXXXXXXXXXXXXXXXXGXXXXXXXXXXXXXXXXXXXGXXXXXXXXXXXXXXXXXXXGXXXXXXXXXXXXXXXXXXXGXXXXXXXXXXXXXXXXXXX,0,10,0
26019,14,1,13,89,497,0,0,510,322,188,GXXXXXXXXXXXXXXXXXXXGXXXXXXXXXXXXXXXXXXXGXXXXXXXXXXXXXXXXXXXGXXXXXXXXXXXXXXXXXXXGAXXXXXXXXXXXXXXXXXXGXXXXXXXXXXXXXXXXXXXGXXXXXXXXXXXXXXXXXXXGXXXXXXXXXXXXXXXXXXXGXXXXXXXXXXXXXXXXXXXGXXXXXXXXXXXXXXXXXXXGXXXXXXXXXXXXXXXXXXXGXXXXXXXXXXXXXXXXXXXGXXXXXXXXXXXXXXXXXXX,0,10,0

26040,14,1,13,91,495,0,0,508,316,192,GXXXXXXXXXXXXXXXXXXXGXXXXXXXXXXXXXXXXXXXGXXXXXXXXXXXXXXXXXXXGXXXXXXXXXXXXXXXXXXXGAXXXXXXXXXXXXXXXXXXGXXXXXXXXXXXXXXXXXXXGXXXXXXXXXXXXXXXXXXXGXXXXXXXXXXXXXXXXXXXGXXXXXXXXXXXXXXXXXXXGXXXXXXXXXXXXXXXXXXXGXXXXXXXXXXXXXXXXXXXGXXXXXXXXXXXXXXXXXXXGXXXXXXXXXXXXXXXXXXX,0,10,0
26061,14,1,13,87,499,0,0,513,325,188,GXXXXXXXXXXXXXXXXXXXGXXXXXXXXXXXXXXXXXXXGXXXXXXXXXXXXXXXXXXXGXXXXXXXXXXXXXXXXXXXGAXXXXXXXXXXXXXXXXXXGXXXXXXXXXXXXXXXXXXXGXXXXXXXXXXXXXXXXXXXGXXXXXXXXXXXXXXXXXXXGXXXXXXXXXXXXXXXXXXXGXXXXXXXXXXXXXXXXXXXGXXXXXXXXXXXXXXXXXXXGXXXXXXXXXXXXXXXXXXXGXXXXXXXXXXXXXXXXXXX,0,10,0
26082,14,1,13,92,494,0,0,508,314,194,GXXXXXXXXXXXXXXXXXXXGXXXXXXXXXXXXXXXXXXXGXXXXXXXXXXXXXXXXXXXGXXXXXXXXXXXXXXXXXXXGAXXXXXXXXXXXXXXXXXXGXXXXXXXXXXXXXXXXXXXGXXXXXXXXXXXXXXXXXXXGXXXXXXXXXXXXXXXXXXXGXXXXXXXXXXXXXXXXXXXGXXXXXXXXXXXXXXXXXXXGXXXXXXXXXXXXXXXXXXXGXXXXXXXXXXXXXXXXXXXGXXXXXXXXXXXXXXXXXXX,0,10,0
26103,15,2,13,94,491,0,0,507,308,199,GAXXXXXXXXXXXXXXXXXXGXXXXXXXXXXXXXXXXXXXGXXXXXXXXXXXXXXXXXXXGXXXXXXXXXXXXXXXXXXXGAXXXXXXXXXXXXXXXXXXGXXXXXXXXXXXXXXXXXXXGXXXXXXXXXXXXXXXXXXXGXXXXXXXXXXXXXXXXXXXGXXXXXXXXXXXXXXXXXXXGXXXXXXXXXXXXXXXXXXXGXXXXXXXXXXXXXXXXXXXGXXXXXXXXXXXXXXXXXXXGXXXXXXXXXXXXXXXXXXX,0,10,0
26124,15,2,13,90,495,0,0,510,314,196,GAXXXXXXXXXXXXXXXXXXGXXXXXXXXXXXXXXXXXXXGXXXXXXXXXXXXXXXXXXXGXXXXXXXXXXXXXXXXXXXGAXXXXXXXXXXXXXXXXXXGXXXXXXXXXXXXXXXXXXXGXXXXXXXXXXXXXXXXXXXGXXXXXXXXXXXXXXXXXXXGXXXXXXXXXXXXXXXXXXXGXXXXXXXXXXXXXXXXXXXGXXXXXXXXXXXXXXXXXXXGXXXXXXXXXXXXXXXXXXXGXXXXXXXXXXXXXXXXXXX,0,10,0

26145,15,2,13,90,495,0,0,509,320,189,GAXXXXXXXXXXXXXXXXXXGXXXXXXXXXXXXXXXXXXXGXXXXXXXXXXXXXXXXXXXGXXXXXXXXXXXXXXXXXXXGAXXXXXXXXXXXXXXXXXXGXXXXXXXXXXXXXXXXXXXGXXXXXXXXXXXXXXXXXXXGXXXXXXXXXXXXXXXXXXXGXXXXXXXXXXXXXXXXXXXGXXXXXXXXXXXXXXXXXXXGXXXXXXXXXXXXXXXXXXXGXXXXXXXXXXXXXXXXXXXGXXXXXXXXXXXXXXXXXXX,0,10,0
26166,15,2,13,89,496,0,0,510,321,189,GAXXXXXXXXXXXXXXXXXXGXXXXXXXXXXXXXXXXXXXGXXXXXXXXXXXXXXXXXXXGXXXXXXXXXXXXXXXXXXXGAXXXXXXXXXXXXXXXXXXGXXXXXXXXXXXXXXXXXXXGXXXXXXXXXXXXXXXXXXXGXXXXXXXXXXXXXXXXXXXGXXXXXXXXXXXXXXXXXXXGXXXXXXXXXXXXXXXXXXXGXXXXXXXXXXXXXXXXXXXGXXXXXXXXXXXXXXXXXXXGXXXXXXXXXXXXXXXXXXX,0,10,0
26187,15,2,13,95,490,0,0,505,321,184,GAXXXXXXXXXXXXXXXXXXGXXXXXXXXXXXXXXXXXXXGXXXXXXXXXXXXXXXXXXXGXXXXXXXXXXXXXXXXXXXGAXXXXXXXXXXXXXXXXXXGXXXXXXXXXXXXXXXXXXXGXXXXXXXXXXXXXXXXXXXGXXXXXXXXXXXXXXXXXXXGXXXXXXXXXXXXXXXXXXXGXXXXXXXXXXXXXXXXXXXGXXXXXXXXXXXXXXXXXXXGXXXXXXXXXXXXXXXXXXXGXXXXXXXXXXXXXXXXXXX,0,10,0
26208,13,0,13,95,492,0,0,507,323,184,GXXXXXXXXXXXXXXXXXXXGXXXXXXXXXXXXXXXXXXXGXXXXXXXXXXXXXXXXXXXGXXXXXXXXXXXXXXXXXXXGXXXXXXXXXXXXXXXXXXXGXXXXXXXXXXXXXXXXXXXGXXXXXXXXXXXXXXXXXXXGXXXXXXXXXXXXXXXXXXXGXXXXXXXXXXXXXXXXXXXGXXXXXXXXXXXXXXXXXXXGXXXXXXXXXXXXXXXXXXXGXXXXXXXXXXXXXXXXXXXGXXXXXXXXXXXXXXXXXXX,0,10,0
26229,13,0,13,97,490,0,0,505,324,181,GXXXXXXXXXXXXXXXXXXXGXXXXXXXXXXXXXXXXXXXGXXXXXXXXXXXXXXXXXXXGXXXXXXXXXXXXXXXXXXXGXXXXXXXXXXXXXXXXXXXGXXXXXXXXXXXXXXXXXXXGXXXXXXXXXXXXXXXXXXXGXXXXXXXXXXXXXXXXXXXGXXXXXXXXXXXXXXXXXXXGXXXXXXXXXXXXXXXXXXXGXXXXXXXXXXXXXXXXXXXGXXXXXXXXXXXXXXXXXXXGXXXXXXXXXXXXXXXXXXX,0,10,0

26250,13,0,13,106,481,0,0,496,314,182,GXXXXXXXXXXXXXXXXXXXGXXXXXXXXXXXXXXXXXXXGXXXXXXXXXXXXXXXXXXXGXXXXXXXXXXXXXXXXXXXGXXXXXXXXXXXXXXXXXXXGXXXXXXXXXXXXXXXXXXXGXXXXXXXXXXXXXXXXXXXGXXXXXXXXXXXXXXXXXXXGXXXXXXXXXXXXXXXXXXXGXXXXXXXXXXXXXXXXXXXGXXXXXXXXXXXXXXXXXXXGXXXXXXXXXXXXXXXXXXXGXXXXXXXXXXXXXXXXXXX,0,10,0
26271,13,0,13,113,474,0,0,490,314,176,GXXXXXXXXXXXXXXXXXXXGXXXXXXXXXXXXXXXXXXXGXXXXXXXXXXXXXXXXXXXGXXXXXXXXXXXXXXXXXXXGXXXXXXXXXXXXXXXXXXXGXXXXXXXXXXXXXXXXXXXGXXXXXXXXXXXXXXXXXXXGXXXXXXXXXXXXXXXXXXXGXXXXXXXXXXXXXXXXXXXGXXXXXXXXXXXXXXXXXXXGXXXXXXXXXXXXXXXXXXXGXXXXXXXXXXXXXXXXXXXGXXXXXXXXXXXXXXXXXXX,0,10,0
26292,13,0,13,113,474,0,0,490,315,175,GXXXXXXXXXXXXXXXXXXXGXXXXXXXXXXXXXXXXXXXGXXXXXXXXXXXXXXXXXXXGXXXXXXXXXXXXXXXXXXXGXXXXXXXXXXXXXXXXXXXGXXXXXXXXXXXXXXXXXXXGXXXXXXXXXXXXXXXXXXXGXXXXXXXXXXXXXXXXXXXGXXXXXXXXXXXXXXXXXXXGXXXXXXXXXXXXXXXXXXXGXXXXXXXXXXXXXXXXXXXGXXXXXXXXXXXXXXXXXXXGXXXXXXXXXXXXXXXXXXX,0,10,0
26313,13,0,13,109,478,0,0,492,321,171,GXXXXXXXXXXXXXXXXXXXGXXXXXXXXXXXXXXXXXXXGXXXXXXXXXXXXXXXXXXXGXXXXXXXXXXXXXXXXXXXGXXXXXXXXXXXXXXXXXXXGXXXXXXXXXXXXXXXXXXXGXXXXXXXXXXXXXXXXXXXGXXXXXXXXXXXXXXXXXXXGXXXXXXXXXXXXXXXXXXXGXXXXXXXXXXXXXXXXXXXGXXXXXXXXXXXXXXXXXXXGXXXXXXXXXXXXXXXXXXXGXXXXXXXXXXXXXXXXXXX,0,10,0
26334,13,0,13,107,480,0,0,495,331,164,GXXXXXXXXXXXXXXXXXXXGXXXXXXXXXXXXXXXXXXXGXXXXXXXXXXXXXXXXXXXGXXXXXXXXXXXXXXXXXXXGXXXXXXXXXXXXXXXXXXXGXXXXXXXXXXXXXXXXXXXGXXXXXXXXXXXXXXXXXXXGXXXXXXXXXXXXXXXXXXXGXXXXXXXXXXXXXXXXXXXGXXXXXXXXXXXXXXXXXXXGXXXXXXXXXXXXXXXXXXXGXXXXXXXXXXXXXXXXXXXGXXXXXXXXXXXXXXXXXXX,0,10,0

26355,13,0,13,106,481,0,0,492,325,167,GXXXXXXXXXXXXXXXXXXXGXXXXXXXXXXXXXXXXXXXGXXXXXXXXXXXXXXXXXXXGXXXXXXXXXXXXXXXXXXXGXXXXXXXXXXXXXXXXXXXGXXXXXXXXXXXXXXXXXXXGXXXXXXXXXXXXXXXXXXXGXXXXXXXXXXXXXXXXXXXGXXXXXXXXXXXXXXXXXXXGXXXXXXXXXXXXXXXXXXXGXXXXXXXXXXXXXXXXXXXGXXXXXXXXXXXXXXXXXXXGXXXXXXXXXXXXXXXXXXX,0,10,0
26376,13,0,13,109,478,0,0,492,327,165,GXXXXXXXXXXXXXXXXXXXGXXXXXXXXXXXXXXXXXXXGXXXXXXXXXXXXXXXXXXXGXXXXXXXXXXXXXXXXXXXGXXXXXXXXXXXXXXXXXXXGXXXXXXXXXXXXXXXXXXXGXXXXXXXXXXXXXXXXXXXGXXXXXXXXXXXXXXXXXXXGXXXXXXXXXXXXXXXXXXXGXXXXXXXXXXXXXXXXXXXGXXXXXXXXXXXXXXXXXXXGXXXXXXXXXXXXXXXXXXXGXXXXXXXXXXXXXXXXXXX,0,10,0
26397,13,0,13,110,477,0,0,491,324,167,GXXXXXXXXXXXXXXXXXXXGXXXXXXXXXXXXXXXXXXXGXXXXXXXXXXXXXXXXXXXGXXXXXXXXXXXXXXXXXXXGXXXXXXXXXXXXXXXXXXXGXXXXXXXXXXXXXXXXXXXGXXXXXXXXXXXXXXXXXXXGXXXXXXXXXXXXXXXXXXXGXXXXXXXXXXXXXXXXXXXGXXXXXXXXXXXXXXXXXXXGXXXXXXXXXXXXXXXXXXXGXXXXXXXXXXXXXXXXXXXGXXXXXXXXXXXXXXXXXXX,0,10,0
26418,13,0,13,118,469,0,0,483,321,162,GXXXXXXXXXXXXXXXXXXXGXXXXXXXXXXXXXXXXXXXGXXXXXXXXXXXXXXXXXXXGXXXXXXXXXXXXXXXXXXXGXXXXXXXXXXXXXXXXXXXGXXXXXXXXXXXXXXXXXXXGXXXXXXXXXXXXXXXXXXXGXXXXXXXXXXXXXXXXXXXGXXXXXXXXXXXXXXXXXXXGXXXXXXXXXXXXXXXXXXXGXXXXXXXXXXXXXXXXXXXGXXXXXXXXXXXXXXXXXXXGXXXXXXXXXXXXXXXXXXX,0,10,0
26439,13,0,13,110,477,0,0,491,314,177,GXXXXXXXXXXXXXXXXXXXGXXXXXXXXXXXXXXXXXXXGXXXXXXXXXXXXXXXXXXXGXXXXXXXXXXXXXXXXXXXGXXXXXXXXXXXXXXXXXXXGXXXXXXXXXXXXXXXXXXXGXXXXXXXXXXXXXXXXXXXGXXXXXXXXXXXXXXXXXXXGXXXXXXXXXXXXXXXXXXXGXXXXXXXXXXXXXXXXXXXGXXXXXXXXXXXXXXXXXXXGXXXXXXXXXXXXXXXXXXXGXXXXXXXXXXXXXXXXXXX,0,10,0

26460,13,0,13,99,488,0,0,503,321,182,GXXXXXXXXXXXXXXXXXXXGXXXXXXXXXXXXXXXXXXXGXXXXXXXXXXXXXXXXXXXGXXXXXXXXXXXXXXXXXXXGXXXXXXXXXXXXXXXXXXXGXXXXXXXXXXXXXXXXXXXGXXXXXXXXXXXXXXXXXXXGXXXXXXXXXXXXXXXXXXXGXXXXXXXXXXXXXXXXXXXGXXXXXXXXXXXXXXXXXXXGXXXXXXXXXXXXXXXXXXXGXXXXXXXXXXXXXXXXXXXGXXXXXXXXXXXXXXXXXXX,0,10,0
26481,13,0,13,96,491,0,0,505,323,182,GXXXXXXXXXXXXXXXXXXXGXXXXXXXXXXXXXXXXXXXGXXXXXXXXXXXXXXXXXXXGXXXXXXXXXXXXXXXXXXXGXXXXXXXXXXXXXXXXXXXGXXXXXXXXXXXXXXXXXXXGXXXXXXXXXXXXXXXXXXXGXXXXXXXXXXXXXXXXXXXGXXXXXXXXXXXXXXXXXXXGXXXXXXXXXXXXXXXXXXXGXXXXXXXXXXXXXXXXXXXGXXXXXXXXXXXXXXXXXXXGXXXXXXXXXXXXXXXXXXX,0,10,0
26502,13,0,13,102,485,0,0,500,321,179,GXXXXXXXXXXXXXXXXXXXGXXXXXXXXXXXXXXXXXXXGXXXXXXXXXXXXXXXXXXXGXXXXXXXXXXXXXXXXXXXGXXXXXXXXXXXXXXXXXXXGXXXXXXXXXXXXXXXXXXXGXXXXXXXXXXXXXXXXXXXGXXXXXXXXXXXXXXXXXXXGXXXXXXXXXXXXXXXXXXXGXXXXXXXXXXXXXXXXXXXGXXXXXXXXXXXXXXXXXXXGXXXXXXXXXXXXXXXXXXXGXXXXXXXXXXXXXXXXXXX,0,10,0
26523,13,0,13,97,490,0,0,505,322,183,GXXXXXXXXXXXXXXXXXXXGXXXXXXXXXXXXXXXXXXXGXXXXXXXXXXXXXXXXXXXGXXXXXXXXXXXXXXXXXXXGXXXXXXXXXXXXXXXXXXXGXXXXXXXXXXXXXXXXXXXGXXXXXXXXXXXXXXXXXXXGXXXXXXXXXXXXXXXXXXXGXXXXXXXXXXXXXXXXXXXGXXXXXXXXXXXXXXXXXXXGXXXXXXXXXXXXXXXXXXXGXXXXXXXXXXXXXXXXXXXGXXXXXXXXXXXXXXXXXXX,0,10,0
26544,13,0,13,102,485,0,0,499,310,189,GXXXXXXXXXXXXXXXXXXXGXXXXXXXXXXXXXXXXXXXGXXXXXXXXXXXXXXXXXXXGXXXXXXXXXXXXXXXXXXXGXXXXXXXXXXXXXXXXXXXGXXXXXXXXXXXXXXXXXXXGXXXXXXXXXXXXXXXXXXXGXXXXXXXXXXXXXXXXXXXGXXXXXXXXXXXXXXXXXXXGXXXXXXXXXXXXXXXXXXXGXXXXXXXXXXXXXXXXXXXGXXXXXXXXXXXXXXXXXXXGXXXXXXXXXXXXXXXXXXX,0,10,0

26565,13,0,13,94,493,0,0,505,316,189,GXXXXXXXXXXXXXXXXXXXGXXXXXXXXXXXXXXXXXXXGXXXXXXXXXXXXXXXXXXXGXXXXXXXXXXXXXXXXXXXGXXXXXXXXXXXXXXXXXXXGXXXXXXXXXXXXXXXXXXXGXXXXXXXXXXXXXXXXXXXGXXXXXXXXXXXXXXXXXXXGXXXXXXXXXXXXXXXXXXXGXXXXXXXXXXXXXXXXXXXGXXXXXXXXXXXXXXXXXXXGXXXXXXXXXXXXXXXXXXXGXXXXXXXXXXXXXXXXXXX,0,10,0
26586,13,0,13,89,498,0,0,511,318,193,GXXXXXXXXXXXXXXXXXXXGXXXXXXXXXXXXXXXXXXXGXXXXXXXXXXXXXXXXXXXGXXXXXXXXXXXXXXXXXXXGXXXXXXXXXXXXXXXXXXXGXXXXXXXXXXXXXXXXXXXGXXXXXXXXXXXXXXXXXXXGXXXXXXXXXXXXXXXXXXXGXXXXXXXXXXXXXXXXXXXGXXXXXXXXXXXXXXXXXXXGXXXXXXXXXXXXXXXXXXXGXXXXXXXXXXXXXXXXXXXGXXXXXXXXXXXXXXXXXXX,0,10,0
26607,13,0,13,92,495,0,0,509,318,191,GXXXXXXXXXXXXXXXXXXXGXXXXXXXXXXXXXXXXXXXGXXXXXXXXXXXXXXXXXXXGXXXXXXXXXXXXXXXXXXXGXXXXXXXXXXXXXXXXXXXGXXXXXXXXXXXXXXXXXXXGXXXXXXXXXXXXXXXXXXXGXXXXXXXXXXXXXXXXXXXGXXXXXXXXXXXXXXXXXXXGXXXXXXXXXXXXXXXXXXXGXXXXXXXXXXXXXXXXXXXGXXXXXXXXXXXXXXXXXXXGXXXXXXXXXXXXXXXXXXX,0,10,0
26628,13,0,13,87,500,0,0,514,317,197,GXXXXXXXXXXXXXXXXXXXGXXXXXXXXXXXXXXXXXXXGXXXXXXXXXXXXXXXXXXXGXXXXXXXXXXXXXXXXXXXGXXXXXXXXXXXXXXXXXXXGXXXXXXXXXXXXXXXXXXXGXXXXXXXXXXXXXXXXXXXGXXXXXXXXXXXXXXXXXXXGXXXXXXXXXXXXXXXXXXXGXXXXXXXXXXXXXXXXXXXGXXXXXXXXXXXXXXXXXXXGXXXXXXXXXXXXXXXXXXXGXXXXXXXXXXXXXXXXXXX,0,10,0
26649,13,0,13,91,496,0,0,511,316,195,GXXXXXXXXXXXXXXXXXXXGXXXXXXXXXXXXXXXXXXXGXXXXXXXXXXXXXXXXXXXGXXXXXXXXXXXXXXXXXXXGXXXXXXXXXXXXXXXXXXXGXXXXXXXXXXXXXXXXXXXGXXXXXXXXXXXXXXXXXXXGXXXXXXXXXXXXXXXXXXXGXXXXXXXXXXXXXXXXXXXGXXXXXXXXXXXXXXXXXXXGXXXXXXXXXXXXXXXXXXXGXXXXXXXXXXXXXXXXXXXGXXXXXXXXXXXXXXXXXXX,0,10,0

26670,13,0,13,88,499,0,0,513,317,196,GXXXXXXXXXXXXXXXXXXXGXXXXXXXXXXXXXXXXXXXGXXXXXXXXXXXXXXXXXXXGXXXXXXXXXXXXXXXXXXXGXXXXXXXXXXXXXXXXXXXGXXXXXXXXXXXXXXXXXXXGXXXXXXXXXXXXXXXXXXXGXXXXXXXXXXXXXXXXXXXGXXXXXXXXXXXXXXXXXXXGXXXXXXXXXXXXXXXXXXXGXXXXXXXXXXXXXXXXXXXGXXXXXXXXXXXXXXXXXXXGXXXXXXXXXXXXXXXXXXX,0,10,0
26691,13,0,13,87,500,0,0,514,315,199,GXXXXXXXXXXXXXXXXXXXGXXXXXXXXXXXXXXXXXXXGXXXXXXXXXXXXXXXXXXXGXXXXXXXXXXXXXXXXXXXGXXXXXXXXXXXXXXXXXXXGXXXXXXXXXXXXXXXXXXXGXXXXXXXXXXXXXXXXXXXGXXXXXXXXXXXXXXXXXXXGXXXXXXXXXXXXXXXXXXXGXXXXXXXXXXXXXXXXXXXGXXXXXXXXXXXXXXXXXXXGXXXXXXXXXXXXXXXXXXXGXXXXXXXXXXXXXXXXXXX,0,10,0
26712,13,0,13,82,505,0,0,519,320,199,GXXXXXXXXXXXXXXXXXXXGXXXXXXXXXXXXXXXXXXXGXXXXXXXXXXXXXXXXXXXGXXXXXXXXXXXXXXXXXXXGXXXXXXXXXXXXXXXXXXXGXXXXXXXXXXXXXXXXXXXGXXXXXXXXXXXXXXXXXXXGXXXXXXXXXXXXXXXXXXXGXXXXXXXXXXXXXXXXXXXGXXXXXXXXXXXXXXXXXXXGXXXXXXXXXXXXXXXXXXXGXXXXXXXXXXXXXXXXXXXGXXXXXXXXXXXXXXXXXXX,0,10,0
26733,13,0,13,84,503,0,0,517,314,203,GXXXXXXXXXXXXXXXXXXXGXXXXXXXXXXXXXXXXXXXGXXXXXXXXXXXXXXXXXXXGXXXXXXXXXXXXXXXXXXXGXXXXXXXXXXXXXXXXXXXGXXXXXXXXXXXXXXXXXXXGXXXXXXXXXXXXXXXXXXXGXXXXXXXXXXXXXXXXXXXGXXXXXXXXXXXXXXXXXXXGXXXXXXXXXXXXXXXXXXXGXXXXXXXXXXXXXXXXXXXGXXXXXXXXXXXXXXXXXXXGXXXXXXXXXXXXXXXXXXX,0,10,0
26754,14,1,13,85,501,0,0,514,318,196,GXXXXXXXXXXXXXXXXXXXGXXXXXXXXXXXXXXXXXXXGXXXXXXXXXXXXXXXXXXXGXXXXXXXXXXXXXXXXXXXGXXXXXXXXXXXXXXXXXXXGXXXXXXXXXXXXXXXXXXXGXXXXXXXXXXXXXXXXXXXGXXXXXXXXXXXXXXXXXXXGXXXXXXXXXXXXXXXXXXXGXXXXXXXXXXXXXXXXXXXGXXXXXXXXXXXXXXXXXXXGXXXXXXXXXXXXXXXXXXXGAXXXXXXXXXXXXXXXXXX,0,10,0

26775,14,1,13,81,505,0,0,518,316,202,GXXXXXXXXXXXXXXXXXXXGXXXXXXXXXXXXXXXXXXXGXXXXXXXXXXXXXXXXXXXGXXXXXXXXXXXXXXXXXXXGXXXXXXXXXXXXXXXXXXXGXXXXXXXXXXXXXXXXXXXGXXXXXXXXXXXXXXXXXXXGXXXXXXXXXXXXXXXXXXXGXXXXXXXXXXXXXXXXXXXGXXXXXXXXXXXXXXXXXXXGXXXXXXXXXXXXXXXXXXXGXXXXXXXXXXXXXXXXXXXGAXXXXXXXXXXXXXXXXXX,0,10,0
26796,14,1,13,86,500,0,0,514,319,195,GXXXXXXXXXXXXXXXXXXXGXXXXXXXXXXXXXXXXXXXGXXXXXXXXXXXXXXXXXXXGXXXXXXXXXXXXXXXXXXXGXXXXXXXXXXXXXXXXXXXGXXXXXXXXXXXXXXXXXXXGXXXXXXXXXXXXXXXXXXXGXXXXXXXXXXXXXXXXXXXGXXXXXXXXXXXXXXXXXXXGXXXXXXXXXXXXXXXXXXXGXXXXXXXXXXXXXXXXXXXGXXXXXXXXXXXXXXXXXXXGAXXXXXXXXXXXXXXXXXX,0,10,0
26817,14,1,13,91,495,0,0,509,317,192,GXXXXXXXXXXXXXXXXXXXGXXXXXXXXXXXXXXXXXXXGXXXXXXXXXXXXXXXXXXXGXXXXXXXXXXXXXXXXXXXGXXXXXXXXXXXXXXXXXXXGXXXXXXXXXXXXXXXXXXXGXXXXXXXXXXXXXXXXXXXGXXXXXXXXXXXXXXXXXXXGXXXXXXXXXXXXXXXXXXXGXXXXXXXXXXXXXXXXXXXGXXXXXXXXXXXXXXXXXXXGXXXXXXXXXXXXXXXXXXXGAXXXXXXXXXXXXXXXXXX,0,10,0
26838,14,1,13,94,492,0,0,507,321,186,GXXXXXXXXXXXXXXXXXXXGXXXXXXXXXXXXXXXXXXXGXXXXXXXXXXXXXXXXXXXGXXXXXXXXXXXXXXXXXXXGXXXXXXXXXXXXXXXXXXXGXXXXXXXXXXXXXXXXXXXGXXXXXXXXXXXXXXXXXXXGXXXXXXXXXXXXXXXXXXXGXXXXXXXXXXXXXXXXXXXGXXXXXXXXXXXXXXXXXXXGXXXXXXXXXXXXXXXXXXXGXXXXXXXXXXXXXXXXXXXGAXXXXXXXXXXXXXXXXXX,0,10,0
26859,14,1,13,93,493,0,0,508,320,188,GXXXXXXXXXXXXXXXXXXXGXXXXXXXXXXXXXXXXXXXGXXXXXXXXXXXXXXXXXXXGXXXXXXXXXXXXXXXXXXXGXXXXXXXXXXXXXXXXXXXGXXXXXXXXXXXXXXXXXXXGXXXXXXXXXXXXXXXXXXXGXXXXXXXXXXXXXXXXXXXGXXXXXXXXXXXXXXXXXXXGXXXXXXXXXXXXXXXXXXXGXXXXXXXXXXXXXXXXXXXGXXXXXXXXXXXXXXXXXXXGAXXXXXXXXXXXXXXXXXX,0,10,0

26880,14,1,13,92,494,0,0,509,318,191,GXXXXXXXXXXXXXXXXXXXGXXXXXXXXXXXXXXXXXXXGXXXXXXXXXXXXXXXXXXXGXXXXXXXXXXXXXXXXXXXGXXXXXXXXXXXXXXXXXXXGXXXXXXXXXXXXXXXXXXXGXXXXXXXXXXXXXXXXXXXGXXXXXXXXXXXXXXXXXXXGXXXXXXXXXXXXXXXXXXXGXXXXXXXXXXXXXXXXXXXGXXXXXXXXXXXXXXXXXXXGXXXXXXXXXXXXXXXXXXXGAXXXXXXXXXXXXXXXXXX,0,10,0
26901,14,1,13,93,493,0,0,507,319,188,GXXXXXXXXXXXXXXXXXXXGXXXXXXXXXXXXXXXXXXXGXXXXXXXXXXXXXXXXXXXGXXXXXXXXXXXXXXXXXXXGXXXXXXXXXXXXXXXXXXXGXXXXXXXXXXXXXXXXXXXGXXXXXXXXXXXXXXXXXXXGXXXXXXXXXXXXXXXXXXXGXXXXXXXXXXXXXXXXXXXGXXXXXXXXXXXXXXXXXXXGXXXXXXXXXXXXXXXXXXXGXXXXXXXXXXXXXXXXXXXGAXXXXXXXXXXXXXXXXXX,0,10,0
26922,14,1,13,85,501,0,0,515,326,189,GXXXXXXXXXXXXXXXXXXXGXXXXXXXXXXXXXXXXXXXGXXXXXXXXXXXXXXXXXXXGXXXXXXXXXXXXXXXXXXXGXXXXXXXXXXXXXXXXXXXGXXXXXXXXXXXXXXXXXXXGXXXXXXXXXXXXXXXXXXXGXXXXXXXXXXXXXXXXXXXGXXXXXXXXXXXXXXXXXXXGXXXXXXXXXXXXXXXXXXXGXXXXXXXXXXXXXXXXXXXGXXXXXXXXXXXXXXXXXXXGAXXXXXXXXXXXXXXXXXX,0,10,0
26943,14,1,13,90,496,0,0,509,328,181,GXXXXXXXXXXXXXXXXXXXGXXXXXXXXXXXXXXXXXXXGXXXXXXXXXXXXXXXXXXXGXXXXXXXXXXXXXXXXXXXGXXXXXXXXXXXXXXXXXXXGXXXXXXXXXXXXXXXXXXXGXXXXXXXXXXXXXXXXXXXGXXXXXXXXXXXXXXXXXXXGXXXXXXXXXXXXXXXXXXXGXXXXXXXXXXXXXXXXXXXGXXXXXXXXXXXXXXXXXXXGXXXXXXXXXXXXXXXXXXXGAXXXXXXXXXXXXXXXXXX,0,10,0
26964,14,1,13,97,489,0,0,503,326,177,GXXXXXXXXXXXXXXXXXXXGXXXXXXXXXXXXXXXXXXXGXXXXXXXXXXXXXXXXXXXGXXXXXXXXXXXXXXXXXXXGXXXXXXXXXXXXXXXXXXXGXXXXXXXXXXXXXXXXXXXGXXXXXXXXXXXXXXXXXXXGXXXXXXXXXXXXXXXXXXXGXXXXXXXXXXXXXXXXXXXGXXXXXXXXXXXXXXXXXXXGXXXXXXXXXXXXXXXXXXXGXXXXXXXXXXXXXXXXXXXGAXXXXXXXXXXXXXXXXXX,0,10,0

26985,14,1,13,101,485,0,0,499,326,173,GXXXXXXXXXXXXXXXXXXXGXXXXXXXXXXXXXXXXXXXGXXXXXXXXXXXXXXXXXXXGXXXXXXXXXXXXXXXXXXXGXXXXXXXXXXXXXXXXXXXGXXXXXXXXXXXXXXXXXXXGXXXXXXXXXXXXXXXXXXXGXXXXXXXXXXXXXXXXXXXGXXXXXXXXXXXXXXXXXXXGXXXXXXXXXXXXXXXXXXXGXXXXXXXXXXXXXXXXXXXGXXXXXXXXXXXXXXXXXXXGAXXXXXXXXXXXXXXXXXX,0,10,0
27006,14,1,13,109,477,0,0,491,324,167,GXXXXXXXXXXXXXXXXXXXGXXXXXXXXXXXXXXXXXXXGXXXXXXXXXXXXXXXXXXXGXXXXXXXXXXXXXXXXXXXGXXXXXXXXXXXXXXXXXXXGXXXXXXXXXXXXXXXXXXXGXXXXXXXXXXXXXXXXXXXGXXXXXXXXXXXXXXXXXXXGXXXXXXXXXXXXXXXXXXXGXXXXXXXXXXXXXXXXXXXGXXXXXXXXXXXXXXXXXXXGXXXXXXXXXXXXXXXXXXXGAXXXXXXXXXXXXXXXXXX,0,10,0
27027,14,1,13,115,471,0,0,485,320,165,GXXXXXXXXXXXXXXXXXXXGXXXXXXXXXXXXXXXXXXXGXXXXXXXXXXXXXXXXXXXGXXXXXXXXXXXXXXXXXXXGXXXXXXXXXXXXXXXXXXXGXXXXXXXXXXXXXXXXXXXGXXXXXXXXXXXXXXXXXXXGXXXXXXXXXXXXXXXXXXXGXXXXXXXXXXXXXXXXXXXGXXXXXXXXXXXXXXXXXXXGXXXXXXXXXXXXXXXXXXXGXXXXXXXXXXXXXXXXXXXGAXXXXXXXXXXXXXXXXXX,0,10,0
27048,14,1,13,118,468,0,0,481,319,162,GXXXXXXXXXXXXXXXXXXXGXXXXXXXXXXXXXXXXXXXGXXXXXXXXXXXXXXXXXXXGXXXXXXXXXXXXXXXXXXXGXXXXXXXXXXXXXXXXXXXGXXXXXXXXXXXXXXXXXXXGXXXXXXXXXXXXXXXXXXXGXXXXXXXXXXXXXXXXXXXGXXXXXXXXXXXXXXXXXXXGXXXXXXXXXXXXXXXXXXXGXXXXXXXXXXXXXXXXXXXGXXXXXXXXXXXXXXXXXXXGAXXXXXXXXXXXXXXXXXX,0,10,0
27069,14,1,13,119,467,0,0,480,319,161,GXXXXXXXXXXXXXXXXXXXGXXXXXXXXXXXXXXXXXXXGXXXXXXXXXXXXXXXXXXXGXXXXXXXXXXXXXXXXXXXGXXXXXXXXXXXXXXXXXXXGXXXXXXXXXXXXXXXXXXXGXXXXXXXXXXXXXXXXXXXGXXXXXXXXXXXXXXXXXXXGXXXXXXXXXXXXXXXXXXXGXXXXXXXXXXXXXXXXXXXGXXXXXXXXXXXXXXXXXXXGXXXXXXXXXXXXXXXXXXXGAXXXXXXXXXXXXXXXXXX,0,10,0

27090,14,1,13,111,475,0,0,487,327,160,GXXXXXXXXXXXXXXXXXXXGXXXXXXXXXXXXXXXXXXXGXXXXXXXXXXXXXXXXXXXGXXXXXXXXXXXXXXXXXXXGXXXXXXXXXXXXXXXXXXXGXXXXXXXXXXXXXXXXXXXGXXXXXXXXXXXXXXXXXXXGXXXXXXXXXXXXXXXXXXXGXXXXXXXXXXXXXXXXXXXGXXXXXXXXXXXXXXXXXXXGXXXXXXXXXXXXXXXXXXXGXXXXXXXXXXXXXXXXXXXGAXXXXXXXXXXXXXXXXXX,0,10,0
27111,14,1,13,119,467,0,0,480,320,160,GXXXXXXXXXXXXXXXXXXXGXXXXXXXXXXXXXXXXXXXGXXXXXXXXXXXXXXXXXXXGXXXXXXXXXXXXXXXXXXXGXXXXXXXXXXXXXXXXXXXGXXXXXXXXXXXXXXXXXXXGXXXXXXXXXXXXXXXXXXXGXXXXXXXXXXXXXXXXXXXGXXXXXXXXXXXXXXXXXXXGXXXXXXXXXXXXXXXXXXXGXXXXXXXXXXXXXXXXXXXGXXXXXXXXXXXXXXXXXXXGAXXXXXXXXXXXXXXXXXX,0,10,0
27132,14,1,13,123,463,0,0,475,318,157,GXXXXXXXXXXXXXXXXXXXGXXXXXXXXXXXXXXXXXXXGXXXXXXXXXXXXXXXXXXXGXXXXXXXXXXXXXXXXXXXGXXXXXXXXXXXXXXXXXXXGXXXXXXXXXXXXXXXXXXXGXXXXXXXXXXXXXXXXXXXGXXXXXXXXXXXXXXXXXXXGXXXXXXXXXXXXXXXXXXXGXXXXXXXXXXXXXXXXXXXGXXXXXXXXXXXXXXXXXXXGXXXXXXXXXXXXXXXXXXXGAXXXXXXXXXXXXXXXXXX,0,10,0
27153,14,0,14,113,473,0,0,483,327,156,GXXXXXXXXXXXXXXXXXXXGXXXXXXXXXXXXXXXXXXXGXXXXXXXXXXXXXXXXXXXGXXXXXXXXXXXXXXXXXXXGXXXXXXXXXXXXXXXXXXXGXXXXXXXXXXXXXXXXXXXGXXXXXXXXXXXXXXXXXXXGXXXXXXXXXXXXXXXXXXXGXXXXXXXXXXXXXXXXXXXGXXXXXXXXXXXXXXXXXXXGXXXXXXXXXXXXXXXXXXXGXXXXXXXXXXXXXXXXXXXGOXXXXXXXXXXXXXXXXXX,0,10,0
27174,14,0,14,116,470,0,0,482,320,162,GXXXXXXXXXXXXXXXXXXXGXXXXXXXXXXXXXXXXXXXGXXXXXXXXXXXXXXXXXXXGXXXXXXXXXXXXXXXXXXXGXXXXXXXXXXXXXXXXXXXGXXXXXXXXXXXXXXXXXXXGXXXXXXXXXXXXXXXXXXXGXXXXXXXXXXXXXXXXXXXGXXXXXXXXXXXXXXXXXXXGXXXXXXXXXXXXXXXXXXXGXXXXXXXXXXXXXXXXXXXGXXXXXXXXXXXXXXXXXXXGOXXXXXXXXXXXXXXXXXX,0,10,0

27195,14,0,14,111,475,0,0,487,320,167,GXXXXXXXXXXXXXXXXXXXGXXXXXXXXXXXXXXXXXXXGXXXXXXXXXXXXXXXXXXXGXXXXXXXXXXXXXXXXXXXGXXXXXXXXXXXXXXXXXXXGXXXXXXXXXXXXXXXXXXXGXXXXXXXXXXXXXXXXXXXGXXXXXXXXXXXXXXXXXXXGXXXXXXXXXXXXXXXXXXXGXXXXXXXXXXXXXXXXXXXGXXXXXXXXXXXXXXXXXXXGXXXXXXXXXXXXXXXXXXXGOXXXXXXXXXXXXXXXXXX,0,10,0
27216,13,0,13,107,480,0,0,492,321,171,GXXXXXXXXXXXXXXXXXXXGXXXXXXXXXXXXXXXXXXXGXXXXXXXXXXXXXXXXXXXGXXXXXXXXXXXXXXXXXXXGXXXXXXXXXXXXXXXXXXXGXXXXXXXXXXXXXXXXXXXGXXXXXXXXXXXXXXXXXXXGXXXXXXXXXXXXXXXXXXXGXXXXXXXXXXXXXXXXXXXGXXXXXXXXXXXXXXXXXXXGXXXXXXXXXXXXXXXXXXXGXXXXXXXXXXXXXXXXXXXGXXXXXXXXXXXXXXXXXXX,0,10,0
27237,13,0,13,105,482,0,0,494,323,171,GXXXXXXXXXXXXXXXXXXXGXXXXXXXXXXXXXXXXXXXGXXXXXXXXXXXXXXXXXXXGXXXXXXXXXXXXXXXXXXXGXXXXXXXXXXXXXXXXXXXGXXXXXXXXXXXXXXXXXXXGXXXXXXXXXXXXXXXXXXXGXXXXXXXXXXXXXXXXXXXGXXXXXXXXXXXXXXXXXXXGXXXXXXXXXXXXXXXXXXXGXXXXXXXXXXXXXXXXXXXGXXXXXXXXXXXXXXXXXXXGXXXXXXXXXXXXXXXXXXX,0,10,0
27258,14,1,13,99,487,0,0,498,322,176,GXXXXXXXXXXXXXXXXXXXGXXXXXXXXXXXXXXXXXXXGXXXXXXXXXXXXXXXXXXXGXXXXXXXXXXXXXXXXXXXGXXXXXXXXXXXXXXXXXXXGXXXXXXXXXXXXXXXXXXXGAXXXXXXXXXXXXXXXXXXGXXXXXXXXXXXXXXXXXXXGXXXXXXXXXXXXXXXXXXXGXXXXXXXXXXXXXXXXXXXGXXXXXXXXXXXXXXXXXXXGXXXXXXXXXXXXXXXXXXXGXXXXXXXXXXXXXXXXXXX,0,10,0
27279,14,1,13,100,486,0,0,500,317,183,GXXXXXXXXXXXXXXXXXXXGXXXXXXXXXXXXXXXXXXXGXXXXXXXXXXXXXXXXXXXGXXXXXXXXXXXXXXXXXXXGXXXXXXXXXXXXXXXXXXXGXXXXXXXXXXXXXXXXXXXGAXXXXXXXXXXXXXXXXXXGXXXXXXXXXXXXXXXXXXXGXXXXXXXXXXXXXXXXXXXGXXXXXXXXXXXXXXXXXXXGXXXXXXXXXXXXXXXXXXXGXXXXXXXXXXXXXXXXXXXGXXXXXXXXXXXXXXXXXXX,0,10,0

27300,14,1,13,105,481,0,0,493,315,178,GXXXXXXXXXXXXXXXXXXXGXXXXXXXXXXXXXXXXXXXGXXXXXXXXXXXXXXXXXXXGXXXXXXXXXXXXXXXXXXXGXXXXXXXXXXXXXXXXXXXGXXXXXXXXXXXXXXXXXXXGAXXXXXXXXXXXXXXXXXXGXXXXXXXXXXXXXXXXXXXGXXXXXXXXXXXXXXXXXXXGXXXXXXXXXXXXXXXXXXXGXXXXXXXXXXXXXXXXXXXGXXXXXXXXXXXXXXXXXXXGXXXXXXXXXXXXXXXXXXX,0,10,0
27321,13,0,13,96,491,0,0,504,317,187,GXXXXXXXXXXXXXXXXXXXGXXXXXXXXXXXXXXXXXXXGXXXXXXXXXXXXXXXXXXXGXXXXXXXXXXXXXXXXXXXGXXXXXXXXXXXXXXXXXXXGXXXXXXXXXXXXXXXXXXXGXXXXXXXXXXXXXXXXXXXGXXXXXXXXXXXXXXXXXXXGXXXXXXXXXXXXXXXXXXXGXXXXXXXXXXXXXXXXXXXGXXXXXXXXXXXXXXXXXXXGXXXXXXXXXXXXXXXXXXXGXXXXXXXXXXXXXXXXXXX,0,10,0
27342,13,0,13,87,500,0,0,513,324,189,GXXXXXXXXXXXXXXXXXXXGXXXXXXXXXXXXXXXXXXXGXXXXXXXXXXXXXXXXXXXGXXXXXXXXXXXXXXXXXXXGXXXXXXXXXXXXXXXXXXXGXXXXXXXXXXXXXXXXXXXGXXXXXXXXXXXXXXXXXXXGXXXXXXXXXXXXXXXXXXXGXXXXXXXXXXXXXXXXXXXGXXXXXXXXXXXXXXXXXXXGXXXXXXXXXXXXXXXXXXXGXXXXXXXXXXXXXXXXXXXGXXXXXXXXXXXXXXXXXXX,0,10,0
27363,14,1,13,91,495,0,0,509,320,189,GXXXXXXXXXXXXXXXXXXXGXXXXXXXXXXXXXXXXXXXGXXXXXXXXXXXXXXXXXXXGXXXXXXXXXXXXXXXXXXXGXXXXXXXXXXXXXXXXXXXGXXXXXXXXXXXXXXXXXXXGXXXXXXXXXXXXXXXXXXXGXXXXXXXXXXXXXXXXXXXGAXXXXXXXXXXXXXXXXXXGXXXXXXXXXXXXXXXXXXXGXXXXXXXXXXXXXXXXXXXGXXXXXXXXXXXXXXXXXXXGXXXXXXXXXXXXXXXXXXX,0,10,0
27384,15,2,13,89,496,0,0,509,322,187,GXXXXXXXXXXXXXXXXXXXGXXXXXXXXXXXXXXXXXXXGXXXXXXXXXXXXXXXXXXXGAXXXXXXXXXXXXXXXXXXGXXXXXXXXXXXXXXXXXXXGXXXXXXXXXXXXXXXXXXXGXXXXXXXXXXXXXXXXXXXGXXXXXXXXXXXXXXXXXXXGAXXXXXXXXXXXXXXXXXXGXXXXXXXXXXXXXXXXXXXGXXXXXXXXXXXXXXXXXXXGXXXXXXXXXXXXXXXXXXXGXXXXXXXXXXXXXXXXXXX,0,10,0

27405,15,2,13,87,498,0,0,511,325,186,GXXXXXXXXXXXXXXXXXXXGXXXXXXXXXXXXXXXXXXXGXXXXXXXXXXXXXXXXXXXGAXXXXXXXXXXXXXXXXXXGXXXXXXXXXXXXXXXXXXXGXXXXXXXXXXXXXXXXXXXGXXXXXXXXXXXXXXXXXXXGXXXXXXXXXXXXXXXXXXXGAXXXXXXXXXXXXXXXXXXGXXXXXXXXXXXXXXXXXXXGXXXXXXXXXXXXXXXXXXXGXXXXXXXXXXXXXXXXXXXGXXXXXXXXXXXXXXXXXXX,0,10,0
27426,15,1,14,79,506,0,0,518,324,194,GXXXXXXXXXXXXXXXXXXXGXXXXXXXXXXXXXXXXXXXGXXXXXXXXXXXXXXXXXXXGOXXXXXXXXXXXXXXXXXXGXXXXXXXXXXXXXXXXXXXGXXXXXXXXXXXXXXXXXXXGXXXXXXXXXXXXXXXXXXXGXXXXXXXXXXXXXXXXXXXGAXXXXXXXXXXXXXXXXXXGXXXXXXXXXXXXXXXXXXXGXXXXXXXXXXXXXXXXXXXGXXXXXXXXXXXXXXXXXXXGXXXXXXXXXXXXXXXXXXX,0,10,0
27447,15,1,14,82,503,0,0,515,320,195,GXXXXXXXXXXXXXXXXXXXGXXXXXXXXXXXXXXXXXXXGXXXXXXXXXXXXXXXXXXXGOXXXXXXXXXXXXXXXXXXGXXXXXXXXXXXXXXXXXXXGXXXXXXXXXXXXXXXXXXXGXXXXXXXXXXXXXXXXXXXGXXXXXXXXXXXXXXXXXXXGAXXXXXXXXXXXXXXXXXXGXXXXXXXXXXXXXXXXXXXGXXXXXXXXXXXXXXXXXXXGXXXXXXXXXXXXXXXXXXXGXXXXXXXXXXXXXXXXXXX,0,10,0
27468,13,0,13,88,499,0,0,512,324,188,GXXXXXXXXXXXXXXXXXXXGXXXXXXXXXXXXXXXXXXXGXXXXXXXXXXXXXXXXXXXGXXXXXXXXXXXXXXXXXXXGXXXXXXXXXXXXXXXXXXXGXXXXXXXXXXXXXXXXXXXGXXXXXXXXXXXXXXXXXXXGXXXXXXXXXXXXXXXXXXXGXXXXXXXXXXXXXXXXXXXGXXXXXXXXXXXXXXXXXXXGXXXXXXXXXXXXXXXXXXXGXXXXXXXXXXXXXXXXXXXGXXXXXXXXXXXXXXXXXXX,0,10,0
27489,13,0,13,86,501,0,0,514,325,189,GXXXXXXXXXXXXXXXXXXXGXXXXXXXXXXXXXXXXXXXGXXXXXXXXXXXXXXXXXXXGXXXXXXXXXXXXXXXXXXXGXXXXXXXXXXXXXXXXXXXGXXXXXXXXXXXXXXXXXXXGXXXXXXXXXXXXXXXXXXXGXXXXXXXXXXXXXXXXXXXGXXXXXXXXXXXXXXXXXXXGXXXXXXXXXXXXXXXXXXXGXXXXXXXXXXXXXXXXXXXGXXXXXXXXXXXXXXXXXXXGXXXXXXXXXXXXXXXXXXX,0,10,0

27510,13,0,13,87,500,0,0,513,322,191,GXXXXXXXXXXXXXXXXXXXGXXXXXXXXXXXXXXXXXXXGXXXXXXXXXXXXXXXXXXXGXXXXXXXXXXXXXXXXXXXGXXXXXXXXXXXXXXXXXXXGXXXXXXXXXXXXXXXXXXXGXXXXXXXXXXXXXXXXXXXGXXXXXXXXXXXXXXXXXXXGXXXXXXXXXXXXXXXXXXXGXXXXXXXXXXXXXXXXXXXGXXXXXXXXXXXXXXXXXXXGXXXXXXXXXXXXXXXXXXXGXXXXXXXXXXXXXXXXXXX,0,10,0
27531,13,0,13,82,505,0,0,517,327,190,GXXXXXXXXXXXXXXXXXXXGXXXXXXXXXXXXXXXXXXXGXXXXXXXXXXXXXXXXXXXGXXXXXXXXXXXXXXXXXXXGXXXXXXXXXXXXXXXXXXXGXXXXXXXXXXXXXXXXXXXGXXXXXXXXXXXXXXXXXXXGXXXXXXXXXXXXXXXXXXXGXXXXXXXXXXXXXXXXXXXGXXXXXXXXXXXXXXXXXXXGXXXXXXXXXXXXXXXXXXXGXXXXXXXXXXXXXXXXXXXGXXXXXXXXXXXXXXXXXXX,0,10,0
27552,13,0,13,87,500,0,0,513,320,193,GXXXXXXXXXXXXXXXXXXXGXXXXXXXXXXXXXXXXXXXGXXXXXXXXXXXXXXXXXXXGXXXXXXXXXXXXXXXXXXXGXXXXXXXXXXXXXXXXXXXGXXXXXXXXXXXXXXXXXXXGXXXXXXXXXXXXXXXXXXXGXXXXXXXXXXXXXXXXXXXGXXXXXXXXXXXXXXXXXXXGXXXXXXXXXXXXXXXXXXXGXXXXXXXXXXXXXXXXXXXGXXXXXXXXXXXXXXXXXXXGXXXXXXXXXXXXXXXXXXX,0,10,0
27573,13,0,13,93,494,0,0,506,324,182,GXXXXXXXXXXXXXXXXXXXGXXXXXXXXXXXXXXXXXXXGXXXXXXXXXXXXXXXXXXXGXXXXXXXXXXXXXXXXXXXGXXXXXXXXXXXXXXXXXXXGXXXXXXXXXXXXXXXXXXXGXXXXXXXXXXXXXXXXXXXGXXXXXXXXXXXXXXXXXXXGXXXXXXXXXXXXXXXXXXXGXXXXXXXXXXXXXXXXXXXGXXXXXXXXXXXXXXXXXXXGXXXXXXXXXXXXXXXXXXXGXXXXXXXXXXXXXXXXXXX,0,10,0
27594,13,0,13,95,492,0,0,505,327,178,GXXXXXXXXXXXXXXXXXXXGXXXXXXXXXXXXXXXXXXXGXXXXXXXXXXXXXXXXXXXGXXXXXXXXXXXXXXXXXXXGXXXXXXXXXXXXXXXXXXXGXXXXXXXXXXXXXXXXXXXGXXXXXXXXXXXXXXXXXXXGXXXXXXXXXXXXXXXXXXXGXXXXXXXXXXXXXXXXXXXGXXXXXXXXXXXXXXXXXXXGXXXXXXXXXXXXXXXXXXXGXXXXXXXXXXXXXXXXXXXGXXXXXXXXXXXXXXXXXXX,0,10,0

27615,13,0,13,99,488,0,0,501,327,174,GXXXXXXXXXXXXXXXXXXXGXXXXXXXXXXXXXXXXXXXGXXXXXXXXXXXXXXXXXXXGXXXXXXXXXXXXXXXXXXXGXXXXXXXXXXXXXXXXXXXGXXXXXXXXXXXXXXXXXXXGXXXXXXXXXXXXXXXXXXXGXXXXXXXXXXXXXXXXXXXGXXXXXXXXXXXXXXXXXXXGXXXXXXXXXXXXXXXXXXXGXXXXXXXXXXXXXXXXXXXGXXXXXXXXXXXXXXXXXXXGXXXXXXXXXXXXXXXXXXX,0,10,0
27636,13,0,13,105,482,0,0,495,322,173,GXXXXXXXXXXXXXXXXXXXGXXXXXXXXXXXXXXXXXXXGXXXXXXXXXXXXXXXXXXXGXXXXXXXXXXXXXXXXXXXGXXXXXXXXXXXXXXXXXXXGXXXXXXXXXXXXXXXXXXXGXXXXXXXXXXXXXXXXXXXGXXXXXXXXXXXXXXXXXXXGXXXXXXXXXXXXXXXXXXXGXXXXXXXXXXXXXXXXXXXGXXXXXXXXXXXXXXXXXXXGXXXXXXXXXXXXXXXXXXXGXXXXXXXXXXXXXXXXXXX,0,10,0
27657,13,0,13,106,481,0,0,495,319,176,GXXXXXXXXXXXXXXXXXXXGXXXXXXXXXXXXXXXXXXXGXXXXXXXXXXXXXXXXXXXGXXXXXXXXXXXXXXXXXXXGXXXXXXXXXXXXXXXXXXXGXXXXXXXXXXXXXXXXXXXGXXXXXXXXXXXXXXXXXXXGXXXXXXXXXXXXXXXXXXXGXXXXXXXXXXXXXXXXXXXGXXXXXXXXXXXXXXXXXXXGXXXXXXXXXXXXXXXXXXXGXXXXXXXXXXXXXXXXXXXGXXXXXXXXXXXXXXXXXXX,0,10,0
27678,13,0,13,104,483,0,0,497,321,176,GXXXXXXXXXXXXXXXXXXXGXXXXXXXXXXXXXXXXXXXGXXXXXXXXXXXXXXXXXXXGXXXXXXXXXXXXXXXXXXXGXXXXXXXXXXXXXXXXXXXGXXXXXXXXXXXXXXXXXXXGXXXXXXXXXXXXXXXXXXXGXXXXXXXXXXXXXXXXXXXGXXXXXXXXXXXXXXXXXXXGXXXXXXXXXXXXXXXXXXXGXXXXXXXXXXXXXXXXXXXGXXXXXXXXXXXXXXXXXXXGXXXXXXXXXXXXXXXXXXX,0,10,0
27699,13,0,13,108,479,0,0,491,320,171,GXXXXXXXXXXXXXXXXXXXGXXXXXXXXXXXXXXXXXXXGXXXXXXXXXXXXXXXXXXXGXXXXXXXXXXXXXXXXXXXGXXXXXXXXXXXXXXXXXXXGXXXXXXXXXXXXXXXXXXXGXXXXXXXXXXXXXXXXXXXGXXXXXXXXXXXXXXXXXXXGXXXXXXXXXXXXXXXXXXXGXXXXXXXXXXXXXXXXXXXGXXXXXXXXXXXXXXXXXXXGXXXXXXXXXXXXXXXXXXXGXXXXXXXXXXXXXXXXXXX,0,10,0

27720,13,0,13,108,479,0,0,493,325,168,GXXXXXXXXXXXXXXXXXXXGXXXXXXXXXXXXXXXXXXXGXXXXXXXXXXXXXXXXXXXGXXXXXXXXXXXXXXXXXXXGXXXXXXXXXXXXXXXXXXXGXXXXXXXXXXXXXXXXXXXGXXXXXXXXXXXXXXXXXXXGXXXXXXXXXXXXXXXXXXXGXXXXXXXXXXXXXXXXXXXGXXXXXXXXXXXXXXXXXXXGXXXXXXXXXXXXXXXXXXXGXXXXXXXXXXXXXXXXXXXGXXXXXXXXXXXXXXXXXXX,0,10,0
27741,14,1,13,109,477,0,0,491,333,158,GXXXXXXXXXXXXXXXXXXXGXXXXXXXXXXXXXXXXXXXGXXXXXXXXXXXXXXXXXXXGAXXXXXXXXXXXXXXXXXXGXXXXXXXXXXXXXXXXXXXGXXXXXXXXXXXXXXXXXXXGXXXXXXXXXXXXXXXXXXXGXXXXXXXXXXXXXXXXXXXGXXXXXXXXXXXXXXXXXXXGXXXXXXXXXXXXXXXXXXXGXXXXXXXXXXXXXXXXXXXGXXXXXXXXXXXXXXXXXXXGXXXXXXXXXXXXXXXXXXX,0,10,0
27762,14,1,13,110,476,0,0,490,328,162,GXXXXXXXXXXXXXXXXXXXGXXXXXXXXXXXXXXXXXXXGXXXXXXXXXXXXXXXXXXXGAXXXXXXXXXXXXXXXXXXGXXXXXXXXXXXXXXXXXXXGXXXXXXXXXXXXXXXXXXXGXXXXXXXXXXXXXXXXXXXGXXXXXXXXXXXXXXXXXXXGXXXXXXXXXXXXXXXXXXXGXXXXXXXXXXXXXXXXXXXGXXXXXXXXXXXXXXXXXXXGXXXXXXXXXXXXXXXXXXXGXXXXXXXXXXXXXXXXXXX,0,10,0
27783,14,1,13,117,469,0,0,484,327,157,GXXXXXXXXXXXXXXXXXXXGXXXXXXXXXXXXXXXXXXXGXXXXXXXXXXXXXXXXXXXGAXXXXXXXXXXXXXXXXXXGXXXXXXXXXXXXXXXXXXXGXXXXXXXXXXXXXXXXXXXGXXXXXXXXXXXXXXXXXXXGXXXXXXXXXXXXXXXXXXXGXXXXXXXXXXXXXXXXXXXGXXXXXXXXXXXXXXXXXXXGXXXXXXXXXXXXXXXXXXXGXXXXXXXXXXXXXXXXXXXGXXXXXXXXXXXXXXXXXXX,0,10,0
27804,14,1,13,118,468,0,0,482,326,156,GXXXXXXXXXXXXXXXXXXXGXXXXXXXXXXXXXXXXXXXGXXXXXXXXXXXXXXXXXXXGAXXXXXXXXXXXXXXXXXXGXXXXXXXXXXXXXXXXXXXGXXXXXXXXXXXXXXXXXXXGXXXXXXXXXXXXXXXXXXXGXXXXXXXXXXXXXXXXXXXGXXXXXXXXXXXXXXXXXXXGXXXXXXXXXXXXXXXXXXXGXXXXXXXXXXXXXXXXXXXGXXXXXXXXXXXXXXXXXXXGXXXXXXXXXXXXXXXXXXX,0,10,0

27825,14,1,13,111,475,0,0,490,324,166,GXXXXXXXXXXXXXXXXXXXGXXXXXXXXXXXXXXXXXXXGXXXXXXXXXXXXXXXXXXXGAXXXXXXXXXXXXXXXXXXGXXXXXXXXXXXXXXXXXXXGXXXXXXXXXXXXXXXXXXXGXXXXXXXXXXXXXXXXXXXGXXXXXXXXXXXXXXXXXXXGXXXXXXXXXXXXXXXXXXXGXXXXXXXXXXXXXXXXXXXGXXXXXXXXXXXXXXXXXXXGXXXXXXXXXXXXXXXXXXXGXXXXXXXXXXXXXXXXXXX,0,10,0
27846,14,1,13,100,486,0,0,499,322,177,GXXXXXXXXXXXXXXXXXXXGXXXXXXXXXXXXXXXXXXXGXXXXXXXXXXXXXXXXXXXGAXXXXXXXXXXXXXXXXXXGXXXXXXXXXXXXXXXXXXXGXXXXXXXXXXXXXXXXXXXGXXXXXXXXXXXXXXXXXXXGXXXXXXXXXXXXXXXXXXXGXXXXXXXXXXXXXXXXXXXGXXXXXXXXXXXXXXXXXXXGXXXXXXXXXXXXXXXXXXXGXXXXXXXXXXXXXXXXXXXGXXXXXXXXXXXXXXXXXXX,0,10,0
27867,14,1,13,103,483,0,0,496,322,174,GXXXXXXXXXXXXXXXXXXXGXXXXXXXXXXXXXXXXXXXGXXXXXXXXXXXXXXXXXXXGAXXXXXXXXXXXXXXXXXXGXXXXXXXXXXXXXXXXXXXGXXXXXXXXXXXXXXXXXXXGXXXXXXXXXXXXXXXXXXXGXXXXXXXXXXXXXXXXXXXGXXXXXXXXXXXXXXXXXXXGXXXXXXXXXXXXXXXXXXXGXXXXXXXXXXXXXXXXXXXGXXXXXXXXXXXXXXXXXXXGXXXXXXXXXXXXXXXXXXX,0,10,0
27888,14,1,13,98,488,0,0,503,327,176,GXXXXXXXXXXXXXXXXXXXGXXXXXXXXXXXXXXXXXXXGXXXXXXXXXXXXXXXXXXXGAXXXXXXXXXXXXXXXXXXGXXXXXXXXXXXXXXXXXXXGXXXXXXXXXXXXXXXXXXXGXXXXXXXXXXXXXXXXXXXGXXXXXXXXXXXXXXXXXXXGXXXXXXXXXXXXXXXXXXXGXXXXXXXXXXXXXXXXXXXGXXXXXXXXXXXXXXXXXXXGXXXXXXXXXXXXXXXXXXXGXXXXXXXXXXXXXXXXXXX,0,10,0
27909,14,1,13,99,487,0,0,502,325,177,GXXXXXXXXXXXXXXXXXXXGXXXXXXXXXXXXXXXXXXXGXXXXXXXXXXXXXXXXXXXGAXXXXXXXXXXXXXXXXXXGXXXXXXXXXXXXXXXXXXXGXXXXXXXXXXXXXXXXXXXGXXXXXXXXXXXXXXXXXXXGXXXXXXXXXXXXXXXXXXXGXXXXXXXXXXXXXXXXXXXGXXXXXXXXXXXXXXXXXXXGXXXXXXXXXXXXXXXXXXXGXXXXXXXXXXXXXXXXXXXGXXXXXXXXXXXXXXXXXXX,0,10,0

27930,13,0,13,102,485,0,0,500,320,180,GXXXXXXXXXXXXXXXXXXXGXXXXXXXXXXXXXXXXXXXGXXXXXXXXXXXXXXXXXXXGXXXXXXXXXXXXXXXXXXXGXXXXXXXXXXXXXXXXXXXGXXXXXXXXXXXXXXXXXXXGXXXXXXXXXXXXXXXXXXXGXXXXXXXXXXXXXXXXXXXGXXXXXXXXXXXXXXXXXXXGXXXXXXXXXXXXXXXXXXXGXXXXXXXXXXXXXXXXXXXGXXXXXXXXXXXXXXXXXXXGXXXXXXXXXXXXXXXXXXX,0,10,0
27951,13,0,13,101,486,0,0,501,323,178,GXXXXXXXXXXXXXXXXXXXGXXXXXXXXXXXXXXXXXXXGXXXXXXXXXXXXXXXXXXXGXXXXXXXXXXXXXXXXXXXGXXXXXXXXXXXXXXXXXXXGXXXXXXXXXXXXXXXXXXXGXXXXXXXXXXXXXXXXXXXGXXXXXXXXXXXXXXXXXXXGXXXXXXXXXXXXXXXXXXXGXXXXXXXXXXXXXXXXXXXGXXXXXXXXXXXXXXXXXXXGXXXXXXXXXXXXXXXXXXXGXXXXXXXXXXXXXXXXXXX,0,10,0
27972,14,1,13,102,484,0,0,499,319,180,GXXXXXXXXXXXXXXXXXXXGXXXXXXXXXXXXXXXXXXXGXXXXXXXXXXXXXXXXXXXGXXXXXXXXXXXXXXXXXXXGXXXXXXXXXXXXXXXXXXXGXXXXXXXXXXXXXXXXXXXGXXXXXXXXXXXXXXXXXXXGXXXXXXXXXXXXXXXXXXXGXXXXXXXXXXXXXXXXXXXGAXXXXXXXXXXXXXXXXXXGXXXXXXXXXXXXXXXXXXXGXXXXXXXXXXXXXXXXXXXGXXXXXXXXXXXXXXXXXXX,0,10,0
27993,15,2,13,98,487,0,0,502,323,179,GAXXXXXXXXXXXXXXXXXXGXXXXXXXXXXXXXXXXXXXGXXXXXXXXXXXXXXXXXXXGXXXXXXXXXXXXXXXXXXXGXXXXXXXXXXXXXXXXXXXGXXXXXXXXXXXXXXXXXXXGXXXXXXXXXXXXXXXXXXXGXXXXXXXXXXXXXXXXXXXGXXXXXXXXXXXXXXXXXXXGAXXXXXXXXXXXXXXXXXXGXXXXXXXXXXXXXXXXXXXGXXXXXXXXXXXXXXXXXXXGXXXXXXXXXXXXXXXXXXX,0,10,0
28014,15,2,13,94,491,0,0,505,322,183,GAXXXXXXXXXXXXXXXXXXGXXXXXXXXXXXXXXXXXXXGXXXXXXXXXXXXXXXXXXXGXXXXXXXXXXXXXXXXXXXGXXXXXXXXXXXXXXXXXXXGXXXXXXXXXXXXXXXXXXXGXXXXXXXXXXXXXXXXXXXGXXXXXXXXXXXXXXXXXXXGXXXXXXXXXXXXXXXXXXXGAXXXXXXXXXXXXXXXXXXGXXXXXXXXXXXXXXXXXXXGXXXXXXXXXXXXXXXXXXXGXXXXXXXXXXXXXXXXXXX,0,10,0

28035,15,2,13,94,491,0,0,505,331,174,GAXXXXXXXXXXXXXXXXXXGXXXXXXXXXXXXXXXXXXXGXXXXXXXXXXXXXXXXXXXGXXXXXXXXXXXXXXXXXXXGXXXXXXXXXXXXXXXXXXXGXXXXXXXXXXXXXXXXXXXGXXXXXXXXXXXXXXXXXXXGXXXXXXXXXXXXXXXXXXXGXXXXXXXXXXXXXXXXXXXGAXXXXXXXXXXXXXXXXXXGXXXXXXXXXXXXXXXXXXXGXXXXXXXXXXXXXXXXXXXGXXXXXXXXXXXXXXXXXXX,0,10,0
28056,15,2,13,96,489,0,0,503,324,179,GAXXXXXXXXXXXXXXXXXXGXXXXXXXXXXXXXXXXXXXGXXXXXXXXXXXXXXXXXXXGXXXXXXXXXXXXXXXXXXXGXXXXXXXXXXXXXXXXXXXGXXXXXXXXXXXXXXXXXXXGXXXXXXXXXXXXXXXXXXXGXXXXXXXXXXXXXXXXXXXGXXXXXXXXXXXXXXXXXXXGAXXXXXXXXXXXXXXXXXXGXXXXXXXXXXXXXXXXXXXGXXXXXXXXXXXXXXXXXXXGXXXXXXXXXXXXXXXXXXX,0,10,0
28077,15,2,13,87,498,0,0,511,328,183,GAXXXXXXXXXXXXXXXXXXGXXXXXXXXXXXXXXXXXXXGXXXXXXXXXXXXXXXXXXXGXXXXXXXXXXXXXXXXXXXGXXXXXXXXXXXXXXXXXXXGXXXXXXXXXXXXXXXXXXXGXXXXXXXXXXXXXXXXXXXGXXXXXXXXXXXXXXXXXXXGXXXXXXXXXXXXXXXXXXXGAXXXXXXXXXXXXXXXXXXGXXXXXXXXXXXXXXXXXXXGXXXXXXXXXXXXXXXXXXXGXXXXXXXXXXXXXXXXXXX,0,10,0
28098,15,2,13,87,498,0,0,512,329,183,GAXXXXXXXXXXXXXXXXXXGXXXXXXXXXXXXXXXXXXXGXXXXXXXXXXXXXXXXXXXGXXXXXXXXXXXXXXXXXXXGXXXXXXXXXXXXXXXXXXXGXXXXXXXXXXXXXXXXXXXGXXXXXXXXXXXXXXXXXXXGXXXXXXXXXXXXXXXXXXXGXXXXXXXXXXXXXXXXXXXGAXXXXXXXXXXXXXXXXXXGXXXXXXXXXXXXXXXXXXXGXXXXXXXXXXXXXXXXXXXGXXXXXXXXXXXXXXXXXXX,0,10,0
28119,15,2,13,91,494,0,0,507,324,183,GAXXXXXXXXXXXXXXXXXXGXXXXXXXXXXXXXXXXXXXGXXXXXXXXXXXXXXXXXXXGXXXXXXXXXXXXXXXXXXXGXXXXXXXXXXXXXXXXXXXGXXXXXXXXXXXXXXXXXXXGXXXXXXXXXXXXXXXXXXXGXXXXXXXXXXXXXXXXXXXGXXXXXXXXXXXXXXXXXXXGAXXXXXXXXXXXXXXXXXXGXXXXXXXXXXXXXXXXXXXGXXXXXXXXXXXXXXXXXXXGXXXXXXXXXXXXXXXXXXX,0,10,0

28140,15,2,13,91,494,0,0,507,328,179,GAXXXXXXXXXXXXXXXXXXGXXXXXXXXXXXXXXXXXXXGXXXXXXXXXXXXXXXXXXXGXXXXXXXXXXXXXXXXXXXGXXXXXXXXXXXXXXXXXXXGXXXXXXXXXXXXXXXXXXXGXXXXXXXXXXXXXXXXXXXGXXXXXXXXXXXXXXXXXXXGXXXXXXXXXXXXXXXXXXXGAXXXXXXXXXXXXXXXXXXGXXXXXXXXXXXXXXXXXXXGXXXXXXXXXXXXXXXXXXXGXXXXXXXXXXXXXXXXXXX,0,10,0
28161,14,1,13,93,493,0,0,507,326,181,GXXXXXXXXXXXXXXXXXXXGXXXXXXXXXXXXXXXXXXXGXXXXXXXXXXXXXXXXXXXGXXXXXXXXXXXXXXXXXXXGXXXXXXXXXXXXXXXXXXXGXXXXXXXXXXXXXXXXXXXGXXXXXXXXXXXXXXXXXXXGXXXXXXXXXXXXXXXXXXXGXXXXXXXXXXXXXXXXXXXGAXXXXXXXXXXXXXXXXXXGXXXXXXXXXXXXXXXXXXXGXXXXXXXXXXXXXXXXXXXGXXXXXXXXXXXXXXXXXXX,0,10,0
28182,14,1,13,90,496,0,0,509,332,177,GXXXXXXXXXXXXXXXXXXXGXXXXXXXXXXXXXXXXXXXGXXXXXXXXXXXXXXXXXXXGXXXXXXXXXXXXXXXXXXXGXXXXXXXXXXXXXXXXXXXGXXXXXXXXXXXXXXXXXXXGXXXXXXXXXXXXXXXXXXXGXXXXXXXXXXXXXXXXXXXGXXXXXXXXXXXXXXXXXXXGAXXXXXXXXXXXXXXXXXXGXXXXXXXXXXXXXXXXXXXGXXXXXXXXXXXXXXXXXXXGXXXXXXXXXXXXXXXXXXX,0,10,0
28203,14,1,13,93,493,0,0,505,330,175,GXXXXXXXXXXXXXXXXXXXGXXXXXXXXXXXXXXXXXXXGXXXXXXXXXXXXXXXXXXXGXXXXXXXXXXXXXXXXXXXGXXXXXXXXXXXXXXXXXXXGXXXXXXXXXXXXXXXXXXXGXXXXXXXXXXXXXXXXXXXGXXXXXXXXXXXXXXXXXXXGXXXXXXXXXXXXXXXXXXXGAXXXXXXXXXXXXXXXXXXGXXXXXXXXXXXXXXXXXXXGXXXXXXXXXXXXXXXXXXXGXXXXXXXXXXXXXXXXXXX,0,10,0
28224,14,0,14,99,487,0,0,499,328,171,GXXXXXXXXXXXXXXXXXXXGXXXXXXXXXXXXXXXXXXXGXXXXXXXXXXXXXXXXXXXGXXXXXXXXXXXXXXXXXXXGXXXXXXXXXXXXXXXXXXXGXXXXXXXXXXXXXXXXXXXGXXXXXXXXXXXXXXXXXXXGXXXXXXXXXXXXXXXXXXXGXXXXXXXXXXXXXXXXXXXGOXXXXXXXXXXXXXXXXXXGXXXXXXXXXXXXXXXXXXXGXXXXXXXXXXXXXXXXXXXGXXXXXXXXXXXXXXXXXXX,0,10,0

28245,15,1,14,104,481,0,0,493,328,165,GAXXXXXXXXXXXXXXXXXXGXXXXXXXXXXXXXXXXXXXGXXXXXXXXXXXXXXXXXXXGXXXXXXXXXXXXXXXXXXXGXXXXXXXXXXXXXXXXXXXGXXXXXXXXXXXXXXXXXXXGXXXXXXXXXXXXXXXXXXXGXXXXXXXXXXXXXXXXXXXGXXXXXXXXXXXXXXXXXXXGOXXXXXXXXXXXXXXXXXXGXXXXXXXXXXXXXXXXXXXGXXXXXXXXXXXXXXXXXXXGXXXXXXXXXXXXXXXXXXX,0,10,0
28266,14,1,13,104,482,0,0,495,335,160,GAXXXXXXXXXXXXXXXXXXGXXXXXXXXXXXXXXXXXXXGXXXXXXXXXXXXXXXXXXXGXXXXXXXXXXXXXXXXXXXGXXXXXXXXXXXXXXXXXXXGXXXXXXXXXXXXXXXXXXXGXXXXXXXXXXXXXXXXXXXGXXXXXXXXXXXXXXXXXXXGXXXXXXXXXXXXXXXXXXXGXXXXXXXXXXXXXXXXXXXGXXXXXXXXXXXXXXXXXXXGXXXXXXXXXXXXXXXXXXXGXXXXXXXXXXXXXXXXXXX,0,10,0
28287,14,1,13,110,476,0,0,489,329,160,GAXXXXXXXXXXXXXXXXXXGXXXXXXXXXXXXXXXXXXXGXXXXXXXXXXXXXXXXXXXGXXXXXXXXXXXXXXXXXXXGXXXXXXXXXXXXXXXXXXXGXXXXXXXXXXXXXXXXXXXGXXXXXXXXXXXXXXXXXXXGXXXXXXXXXXXXXXXXXXXGXXXXXXXXXXXXXXXXXXXGXXXXXXXXXXXXXXXXXXXGXXXXXXXXXXXXXXXXXXXGXXXXXXXXXXXXXXXXXXXGXXXXXXXXXXXXXXXXXXX,0,10,0
28308,14,1,13,107,479,0,0,492,328,164,GAXXXXXXXXXXXXXXXXXXGXXXXXXXXXXXXXXXXXXXGXXXXXXXXXXXXXXXXXXXGXXXXXXXXXXXXXXXXXXXGXXXXXXXXXXXXXXXXXXXGXXXXXXXXXXXXXXXXXXXGXXXXXXXXXXXXXXXXXXXGXXXXXXXXXXXXXXXXXXXGXXXXXXXXXXXXXXXXXXXGXXXXXXXXXXXXXXXXXXXGXXXXXXXXXXXXXXXXXXXGXXXXXXXXXXXXXXXXXXXGXXXXXXXXXXXXXXXXXXX,0,10,0
28329,14,1,13,108,478,0,0,491,331,160,GAXXXXXXXXXXXXXXXXXXGXXXXXXXXXXXXXXXXXXXGXXXXXXXXXXXXXXXXXXXGXXXXXXXXXXXXXXXXXXXGXXXXXXXXXXXXXXXXXXXGXXXXXXXXXXXXXXXXXXXGXXXXXXXXXXXXXXXXXXXGXXXXXXXXXXXXXXXXXXXGXXXXXXXXXXXXXXXXXXXGXXXXXXXXXXXXXXXXXXXGXXXXXXXXXXXXXXXXXXXGXXXXXXXXXXXXXXXXXXXGXXXXXXXXXXXXXXXXXXX,0,10,0

28350,14,1,13,107,479,0,0,492,334,158,GAXXXXXXXXXXXXXXXXXXGXXXXXXXXXXXXXXXXXXXGXXXXXXXXXXXXXXXXXXXGXXXXXXXXXXXXXXXXXXXGXXXXXXXXXXXXXXXXXXXGXXXXXXXXXXXXXXXXXXXGXXXXXXXXXXXXXXXXXXXGXXXXXXXXXXXXXXXXXXXGXXXXXXXXXXXXXXXXXXXGXXXXXXXXXXXXXXXXXXXGXXXXXXXXXXXXXXXXXXXGXXXXXXXXXXXXXXXXXXXGXXXXXXXXXXXXXXXXXXX,0,10,0
28371,14,1,13,119,467,0,0,480,330,150,GAXXXXXXXXXXXXXXXXXXGXXXXXXXXXXXXXXXXXXXGXXXXXXXXXXXXXXXXXXXGXXXXXXXXXXXXXXXXXXXGXXXXXXXXXXXXXXXXXXXGXXXXXXXXXXXXXXXXXXXGXXXXXXXXXXXXXXXXXXXGXXXXXXXXXXXXXXXXXXXGXXXXXXXXXXXXXXXXXXXGXXXXXXXXXXXXXXXXXXXGXXXXXXXXXXXXXXXXXXXGXXXXXXXXXXXXXXXXXXXGXXXXXXXXXXXXXXXXXXX,0,10,0
28392,14,0,14,115,471,0,0,484,334,150,GOXXXXXXXXXXXXXXXXXXGXXXXXXXXXXXXXXXXXXXGXXXXXXXXXXXXXXXXXXXGXXXXXXXXXXXXXXXXXXXGXXXXXXXXXXXXXXXXXXXGXXXXXXXXXXXXXXXXXXXGXXXXXXXXXXXXXXXXXXXGXXXXXXXXXXXXXXXXXXXGXXXXXXXXXXXXXXXXXXXGXXXXXXXXXXXXXXXXXXXGXXXXXXXXXXXXXXXXXXXGXXXXXXXXXXXXXXXXXXXGXXXXXXXXXXXXXXXXXXX,0,10,0
28413,13,0,13,117,470,0,0,482,333,149,GXXXXXXXXXXXXXXXXXXXGXXXXXXXXXXXXXXXXXXXGXXXXXXXXXXXXXXXXXXXGXXXXXXXXXXXXXXXXXXXGXXXXXXXXXXXXXXXXXXXGXXXXXXXXXXXXXXXXXXXGXXXXXXXXXXXXXXXXXXXGXXXXXXXXXXXXXXXXXXXGXXXXXXXXXXXXXXXXXXXGXXXXXXXXXXXXXXXXXXXGXXXXXXXXXXXXXXXXXXXGXXXXXXXXXXXXXXXXXXXGXXXXXXXXXXXXXXXXXXX,0,10,0
28434,13,0,13,110,477,0,0,490,332,158,GXXXXXXXXXXXXXXXXXXXGXXXXXXXXXXXXXXXXXXXGXXXXXXXXXXXXXXXXXXXGXXXXXXXXXXXXXXXXXXXGXXXXXXXXXXXXXXXXXXXGXXXXXXXXXXXXXXXXXXXGXXXXXXXXXXXXXXXXXXXGXXXXXXXXXXXXXXXXXXXGXXXXXXXXXXXXXXXXXXXGXXXXXXXXXXXXXXXXXXXGXXXXXXXXXXXXXXXXXXXGXXXXXXXXXXXXXXXXXXXGXXXXXXXXXXXXXXXXXXX,0,10,0

28455,13,0,13,115,472,0,0,485,330,155,GXXXXXXXXXXXXXXXXXXXGXXXXXXXXXXXXXXXXXXXGXXXXXXXXXXXXXXXXXXXGXXXXXXXXXXXXXXXXXXXGXXXXXXXXXXXXXXXXXXXGXXXXXXXXXXXXXXXXXXXGXXXXXXXXXXXXXXXXXXXGXXXXXXXXXXXXXXXXXXXGXXXXXXXXXXXXXXXXXXXGXXXXXXXXXXXXXXXXXXXGXXXXXXXXXXXXXXXXXXXGXXXXXXXXXXXXXXXXXXXGXXXXXXXXXXXXXXXXXXX,0,10,0
28476,14,1,13,109,477,0,0,489,326,163,GXXXXXXXXXXXXXXXXXXXGXXXXXXXXXXXXXXXXXXXGAXXXXXXXXXXXXXXXXXXGXXXXXXXXXXXXXXXXXXXGXXXXXXXXXXXXXXXXXXXGXXXXXXXXXXXXXXXXXXXGXXXXXXXXXXXXXXXXXXXGXXXXXXXXXXXXXXXXXXXGXXXXXXXXXXXXXXXXXXXGXXXXXXXXXXXXXXXXXXXGXXXXXXXXXXXXXXXXXXXGXXXXXXXXXXXXXXXXXXXGXXXXXXXXXXXXXXXXXXX,0,10,0
28497,14,1,13,106,480,0,0,493,324,169,GXXXXXXXXXXXXXXXXXXXGXXXXXXXXXXXXXXXXXXXGAXXXXXXXXXXXXXXXXXXGXXXXXXXXXXXXXXXXXXXGXXXXXXXXXXXXXXXXXXXGXXXXXXXXXXXXXXXXXXXGXXXXXXXXXXXXXXXXXXXGXXXXXXXXXXXXXXXXXXXGXXXXXXXXXXXXXXXXXXXGXXXXXXXXXXXXXXXXXXXGXXXXXXXXXXXXXXXXXXXGXXXXXXXXXXXXXXXXXXXGXXXXXXXXXXXXXXXXXXX,0,10,0
28518,14,1,13,98,488,0,0,501,325,176,GXXXXXXXXXXXXXXXXXXXGXXXXXXXXXXXXXXXXXXXGAXXXXXXXXXXXXXXXXXXGXXXXXXXXXXXXXXXXXXXGXXXXXXXXXXXXXXXXXXXGXXXXXXXXXXXXXXXXXXXGXXXXXXXXXXXXXXXXXXXGXXXXXXXXXXXXXXXXXXXGXXXXXXXXXXXXXXXXXXXGXXXXXXXXXXXXXXXXXXXGXXXXXXXXXXXXXXXXXXXGXXXXXXXXXXXXXXXXXXXGXXXXXXXXXXXXXXXXXXX,0,10,0
28539,13,0,13,93,494,0,0,505,328,177,GXXXXXXXXXXXXXXXXXXXGXXXXXXXXXXXXXXXXXXXGXXXXXXXXXXXXXXXXXXXGXXXXXXXXXXXXXXXXXXXGXXXXXXXXXXXXXXXXXXXGXXXXXXXXXXXXXXXXXXXGXXXXXXXXXXXXXXXXXXXGXXXXXXXXXXXXXXXXXXXGXXXXXXXXXXXXXXXXXXXGXXXXXXXXXXXXXXXXXXXGXXXXXXXXXXXXXXXXXXXGXXXXXXXXXXXXXXXXXXXGXXXXXXXXXXXXXXXXXXX,0,10,0

28560,13,0,13,94,493,0,0,506,326,180,GXXXXXXXXXXXXXXXXXXXGXXXXXXXXXXXXXXXXXXXGXXXXXXXXXXXXXXXXXXXGXXXXXXXXXXXXXXXXXXXGXXXXXXXXXXXXXXXXXXXGXXXXXXXXXXXXXXXXXXXGXXXXXXXXXXXXXXXXXXXGXXXXXXXXXXXXXXXXXXXGXXXXXXXXXXXXXXXXXXXGXXXXXXXXXXXXXXXXXXXGXXXXXXXXXXXXXXXXXXXGXXXXXXXXXXXXXXXXXXXGXXXXXXXXXXXXXXXXXXX,0,10,0
28581,13,0,13,94,493,0,0,505,332,173,GXXXXXXXXXXXXXXXXXXXGXXXXXXXXXXXXXXXXXXXGXXXXXXXXXXXXXXXXXXXGXXXXXXXXXXXXXXXXXXXGXXXXXXXXXXXXXXXXXXXGXXXXXXXXXXXXXXXXXXXGXXXXXXXXXXXXXXXXXXXGXXXXXXXXXXXXXXXXXXXGXXXXXXXXXXXXXXXXXXXGXXXXXXXXXXXXXXXXXXXGXXXXXXXXXXXXXXXXXXXGXXXXXXXXXXXXXXXXXXXGXXXXXXXXXXXXXXXXXXX,0,10,0
28602,13,0,13,90,497,0,0,509,327,182,GXXXXXXXXXXXXXXXXXXXGXXXXXXXXXXXXXXXXXXXGXXXXXXXXXXXXXXXXXXXGXXXXXXXXXXXXXXXXXXXGXXXXXXXXXXXXXXXXXXXGXXXXXXXXXXXXXXXXXXXGXXXXXXXXXXXXXXXXXXXGXXXXXXXXXXXXXXXXXXXGXXXXXXXXXXXXXXXXXXXGXXXXXXXXXXXXXXXXXXXGXXXXXXXXXXXXXXXXXXXGXXXXXXXXXXXXXXXXXXXGXXXXXXXXXXXXXXXXXXX,0,10,0
28623,13,0,13,89,498,0,0,511,326,185,GXXXXXXXXXXXXXXXXXXXGXXXXXXXXXXXXXXXXXXXGXXXXXXXXXXXXXXXXXXXGXXXXXXXXXXXXXXXXXXXGXXXXXXXXXXXXXXXXXXXGXXXXXXXXXXXXXXXXXXXGXXXXXXXXXXXXXXXXXXXGXXXXXXXXXXXXXXXXXXXGXXXXXXXXXXXXXXXXXXXGXXXXXXXXXXXXXXXXXXXGXXXXXXXXXXXXXXXXXXXGXXXXXXXXXXXXXXXXXXXGXXXXXXXXXXXXXXXXXXX,0,10,0
28644,13,0,13,87,500,0,0,513,328,185,GXXXXXXXXXXXXXXXXXXXGXXXXXXXXXXXXXXXXXXXGXXXXXXXXXXXXXXXXXXXGXXXXXXXXXXXXXXXXXXXGXXXXXXXXXXXXXXXXXXXGXXXXXXXXXXXXXXXXXXXGXXXXXXXXXXXXXXXXXXXGXXXXXXXXXXXXXXXXXXXGXXXXXXXXXXXXXXXXXXXGXXXXXXXXXXXXXXXXXXXGXXXXXXXXXXXXXXXXXXXGXXXXXXXXXXXXXXXXXXXGXXXXXXXXXXXXXXXXXXX,0,10,0

28665,13,0,13,87,500,0,0,515,331,184,GXXXXXXXXXXXXXXXXXXXGXXXXXXXXXXXXXXXXXXXGXXXXXXXXXXXXXXXXXXXGXXXXXXXXXXXXXXXXXXXGXXXXXXXXXXXXXXXXXXXGXXXXXXXXXXXXXXXXXXXGXXXXXXXXXXXXXXXXXXXGXXXXXXXXXXXXXXXXXXXGXXXXXXXXXXXXXXXXXXXGXXXXXXXXXXXXXXXXXXXGXXXXXXXXXXXXXXXXXXXGXXXXXXXXXXXXXXXXXXXGXXXXXXXXXXXXXXXXXXX,0,10,0
28686,14,1,13,94,492,0,0,506,330,176,GXXXXXXXXXXXXXXXXXXXGXXXXXXXXXXXXXXXXXXXGXXXXXXXXXXXXXXXXXXXGXXXXXXXXXXXXXXXXXXXGXXXXXXXXXXXXXXXXXXXGXXXXXXXXXXXXXXXXXXXGXXXXXXXXXXXXXXXXXXXGXXXXXXXXXXXXXXXXXXXGAXXXXXXXXXXXXXXXXXXGXXXXXXXXXXXXXXXXXXXGXXXXXXXXXXXXXXXXXXXGXXXXXXXXXXXXXXXXXXXGXXXXXXXXXXXXXXXXXXX,0,10,0
28707,14,1,13,96,490,0,0,504,331,173,GXXXXXXXXXXXXXXXXXXXGXXXXXXXXXXXXXXXXXXXGXXXXXXXXXXXXXXXXXXXGXXXXXXXXXXXXXXXXXXXGXXXXXXXXXXXXXXXXXXXGXXXXXXXXXXXXXXXXXXXGXXXXXXXXXXXXXXXXXXXGXXXXXXXXXXXXXXXXXXXGAXXXXXXXXXXXXXXXXXXGXXXXXXXXXXXXXXXXXXXGXXXXXXXXXXXXXXXXXXXGXXXXXXXXXXXXXXXXXXXGXXXXXXXXXXXXXXXXXXX,0,10,0
28728,14,1,13,100,486,0,0,501,332,169,GXXXXXXXXXXXXXXXXXXXGXXXXXXXXXXXXXXXXXXXGXXXXXXXXXXXXXXXXXXXGXXXXXXXXXXXXXXXXXXXGXXXXXXXXXXXXXXXXXXXGXXXXXXXXXXXXXXXXXXXGXXXXXXXXXXXXXXXXXXXGXXXXXXXXXXXXXXXXXXXGAXXXXXXXXXXXXXXXXXXGXXXXXXXXXXXXXXXXXXXGXXXXXXXXXXXXXXXXXXXGXXXXXXXXXXXXXXXXXXXGXXXXXXXXXXXXXXXXXXX,0,10,0
28749,14,1,13,100,486,0,0,501,331,170,GXXXXXXXXXXXXXXXXXXXGXXXXXXXXXXXXXXXXXXXGXXXXXXXXXXXXXXXXXXXGXXXXXXXXXXXXXXXXXXXGXXXXXXXXXXXXXXXXXXXGXXXXXXXXXXXXXXXXXXXGXXXXXXXXXXXXXXXXXXXGXXXXXXXXXXXXXXXXXXXGAXXXXXXXXXXXXXXXXXXGXXXXXXXXXXXXXXXXXXXGXXXXXXXXXXXXXXXXXXXGXXXXXXXXXXXXXXXXXXXGXXXXXXXXXXXXXXXXXXX,0,10,0

28770,14,0,14,102,484,0,0,500,328,172,GXXXXXXXXXXXXXXXXXXXGXXXXXXXXXXXXXXXXXXXGXXXXXXXXXXXXXXXXXXXGXXXXXXXXXXXXXXXXXXXGXXXXXXXXXXXXXXXXXXXGXXXXXXXXXXXXXXXXXXXGXXXXXXXXXXXXXXXXXXXGXXXXXXXXXXXXXXXXXXXGOXXXXXXXXXXXXXXXXXXGXXXXXXXXXXXXXXXXXXXGXXXXXXXXXXXXXXXXXXXGXXXXXXXXXXXXXXXXXXXGXXXXXXXXXXXXXXXXXXX,0,10,0
28791,14,0,14,101,485,0,0,501,329,172,GXXXXXXXXXXXXXXXXXXXGXXXXXXXXXXXXXXXXXXXGXXXXXXXXXXXXXXXXXXXGXXXXXXXXXXXXXXXXXXXGXXXXXXXXXXXXXXXXXXXGXXXXXXXXXXXXXXXXXXXGXXXXXXXXXXXXXXXXXXXGXXXXXXXXXXXXXXXXXXXGOXXXXXXXXXXXXXXXXXXGXXXXXXXXXXXXXXXXXXXGXXXXXXXXXXXXXXXXXXXGXXXXXXXXXXXXXXXXXXXGXXXXXXXXXXXXXXXXXXX,0,10,0
28812,13,0,13,104,483,0,0,499,331,168,GXXXXXXXXXXXXXXXXXXXGXXXXXXXXXXXXXXXXXXXGXXXXXXXXXXXXXXXXXXXGXXXXXXXXXXXXXXXXXXXGXXXXXXXXXXXXXXXXXXXGXXXXXXXXXXXXXXXXXXXGXXXXXXXXXXXXXXXXXXXGXXXXXXXXXXXXXXXXXXXGXXXXXXXXXXXXXXXXXXXGXXXXXXXXXXXXXXXXXXXGXXXXXXXXXXXXXXXXXXXGXXXXXXXXXXXXXXXXXXXGXXXXXXXXXXXXXXXXXXX,0,10,0
28833,13,0,13,97,490,0,0,506,336,170,GXXXXXXXXXXXXXXXXXXXGXXXXXXXXXXXXXXXXXXXGXXXXXXXXXXXXXXXXXXXGXXXXXXXXXXXXXXXXXXXGXXXXXXXXXXXXXXXXXXXGXXXXXXXXXXXXXXXXXXXGXXXXXXXXXXXXXXXXXXXGXXXXXXXXXXXXXXXXXXXGXXXXXXXXXXXXXXXXXXXGXXXXXXXXXXXXXXXXXXXGXXXXXXXXXXXXXXXXXXXGXXXXXXXXXXXXXXXXXXXGXXXXXXXXXXXXXXXXXXX,0,10,0
28854,13,0,13,93,494,0,0,509,336,173,GXXXXXXXXXXXXXXXXXXXGXXXXXXXXXXXXXXXXXXXGXXXXXXXXXXXXXXXXXXXGXXXXXXXXXXXXXXXXXXXGXXXXXXXXXXXXXXXXXXXGXXXXXXXXXXXXXXXXXXXGXXXXXXXXXXXXXXXXXXXGXXXXXXXXXXXXXXXXXXXGXXXXXXXXXXXXXXXXXXXGXXXXXXXXXXXXXXXXXXXGXXXXXXXXXXXXXXXXXXXGXXXXXXXXXXXXXXXXXXXGXXXXXXXXXXXXXXXXXXX,0,10,0

28875,13,0,13,104,483,0,0,499,331,168,GXXXXXXXXXXXXXXXXXXXGXXXXXXXXXXXXXXXXXXXGXXXXXXXXXXXXXXXXXXXGXXXXXXXXXXXXXXXXXXXGXXXXXXXXXXXXXXXXXXXGXXXXXXXXXXXXXXXXXXXGXXXXXXXXXXXXXXXXXXXGXXXXXXXXXXXXXXXXXXXGXXXXXXXXXXXXXXXXXXXGXXXXXXXXXXXXXXXXXXXGXXXXXXXXXXXXXXXXXXXGXXXXXXXXXXXXXXXXXXXGXXXXXXXXXXXXXXXXXXX,0,10,0
28896,13,0,13,104,483,0,0,497,332,165,GXXXXXXXXXXXXXXXXXXXGXXXXXXXXXXXXXXXXXXXGXXXXXXXXXXXXXXXXXXXGXXXXXXXXXXXXXXXXXXXGXXXXXXXXXXXXXXXXXXXGXXXXXXXXXXXXXXXXXXXGXXXXXXXXXXXXXXXXXXXGXXXXXXXXXXXXXXXXXXXGXXXXXXXXXXXXXXXXXXXGXXXXXXXXXXXXXXXXXXXGXXXXXXXXXXXXXXXXXXXGXXXXXXXXXXXXXXXXXXXGXXXXXXXXXXXXXXXXXXX,0,10,0
28917,13,0,13,105,482,0,0,498,331,167,GXXXXXXXXXXXXXXXXXXXGXXXXXXXXXXXXXXXXXXXGXXXXXXXXXXXXXXXXXXXGXXXXXXXXXXXXXXXXXXXGXXXXXXXXXXXXXXXXXXXGXXXXXXXXXXXXXXXXXXXGXXXXXXXXXXXXXXXXXXXGXXXXXXXXXXXXXXXXXXXGXXXXXXXXXXXXXXXXXXXGXXXXXXXXXXXXXXXXXXXGXXXXXXXXXXXXXXXXXXXGXXXXXXXXXXXXXXXXXXXGXXXXXXXXXXXXXXXXXXX,0,10,0
28938,13,0,13,103,484,0,0,500,329,171,GXXXXXXXXXXXXXXXXXXXGXXXXXXXXXXXXXXXXXXXGXXXXXXXXXXXXXXXXXXXGXXXXXXXXXXXXXXXXXXXGXXXXXXXXXXXXXXXXXXXGXXXXXXXXXXXXXXXXXXXGXXXXXXXXXXXXXXXXXXXGXXXXXXXXXXXXXXXXXXXGXXXXXXXXXXXXXXXXXXXGXXXXXXXXXXXXXXXXXXXGXXXXXXXXXXXXXXXXXXXGXXXXXXXXXXXXXXXXXXXGXXXXXXXXXXXXXXXXXXX,0,10,0
28959,13,0,13,103,484,0,0,500,336,164,GXXXXXXXXXXXXXXXXXXXGXXXXXXXXXXXXXXXXXXXGXXXXXXXXXXXXXXXXXXXGXXXXXXXXXXXXXXXXXXXGXXXXXXXXXXXXXXXXXXXGXXXXXXXXXXXXXXXXXXXGXXXXXXXXXXXXXXXXXXXGXXXXXXXXXXXXXXXXXXXGXXXXXXXXXXXXXXXXXXXGXXXXXXXXXXXXXXXXXXXGXXXXXXXXXXXXXXXXXXXGXXXXXXXXXXXXXXXXXXXGXXXXXXXXXXXXXXXXXXX,0,10,0

28980,13,0,13,97,490,0,0,506,342,164,GXXXXXXXXXXXXXXXXXXXGXXXXXXXXXXXXXXXXXXXGXXXXXXXXXXXXXXXXXXXGXXXXXXXXXXXXXXXXXXXGXXXXXXXXXXXXXXXXXXXGXXXXXXXXXXXXXXXXXXXGXXXXXXXXXXXXXXXXXXXGXXXXXXXXXXXXXXXXXXXGXXXXXXXXXXXXXXXXXXXGXXXXXXXXXXXXXXXXXXXGXXXXXXXXXXXXXXXXXXXGXXXXXXXXXXXXXXXXXXXGXXXXXXXXXXXXXXXXXXX,0,10,0
29001,13,0,13,102,485,0,0,501,338,163,GXXXXXXXXXXXXXXXXXXXGXXXXXXXXXXXXXXXXXXXGXXXXXXXXXXXXXXXXXXXGXXXXXXXXXXXXXXXXXXXGXXXXXXXXXXXXXXXXXXXGXXXXXXXXXXXXXXXXXXXGXXXXXXXXXXXXXXXXXXXGXXXXXXXXXXXXXXXXXXXGXXXXXXXXXXXXXXXXXXXGXXXXXXXXXXXXXXXXXXXGXXXXXXXXXXXXXXXXXXXGXXXXXXXXXXXXXXXXXXXGXXXXXXXXXXXXXXXXXXX,0,10,0
29022,13,0,13,100,487,0,0,502,337,165,GXXXXXXXXXXXXXXXXXXXGXXXXXXXXXXXXXXXXXXXGXXXXXXXXXXXXXXXXXXXGXXXXXXXXXXXXXXXXXXXGXXXXXXXXXXXXXXXXXXXGXXXXXXXXXXXXXXXXXXXGXXXXXXXXXXXXXXXXXXXGXXXXXXXXXXXXXXXXXXXGXXXXXXXXXXXXXXXXXXXGXXXXXXXXXXXXXXXXXXXGXXXXXXXXXXXXXXXXXXXGXXXXXXXXXXXXXXXXXXXGXXXXXXXXXXXXXXXXXXX,0,10,0
29043,13,0,13,103,484,0,0,500,340,160,GXXXXXXXXXXXXXXXXXXXGXXXXXXXXXXXXXXXXXXXGXXXXXXXXXXXXXXXXXXXGXXXXXXXXXXXXXXXXXXXGXXXXXXXXXXXXXXXXXXXGXXXXXXXXXXXXXXXXXXXGXXXXXXXXXXXXXXXXXXXGXXXXXXXXXXXXXXXXXXXGXXXXXXXXXXXXXXXXXXXGXXXXXXXXXXXXXXXXXXXGXXXXXXXXXXXXXXXXXXXGXXXXXXXXXXXXXXXXXXXGXXXXXXXXXXXXXXXXXXX,0,10,0
29064,13,0,13,112,475,0,0,492,329,163,GXXXXXXXXXXXXXXXXXXXGXXXXXXXXXXXXXXXXXXXGXXXXXXXXXXXXXXXXXXXGXXXXXXXXXXXXXXXXXXXGXXXXXXXXXXXXXXXXXXXGXXXXXXXXXXXXXXXXXXXGXXXXXXXXXXXXXXXXXXXGXXXXXXXXXXXXXXXXXXXGXXXXXXXXXXXXXXXXXXXGXXXXXXXXXXXXXXXXXXXGXXXXXXXXXXXXXXXXXXXGXXXXXXXXXXXXXXXXXXXGXXXXXXXXXXXXXXXXXXX,0,10,0

29085,13,0,13,108,479,0,0,492,330,162,GXXXXXXXXXXXXXXXXXXXGXXXXXXXXXXXXXXXXXXXGXXXXXXXXXXXXXXXXXXXGXXXXXXXXXXXXXXXXXXXGXXXXXXXXXXXXXXXXXXXGXXXXXXXXXXXXXXXXXXXGXXXXXXXXXXXXXXXXXXXGXXXXXXXXXXXXXXXXXXXGXXXXXXXXXXXXXXXXXXXGXXXXXXXXXXXXXXXXXXXGXXXXXXXXXXXXXXXXXXXGXXXXXXXXXXXXXXXXXXXGXXXXXXXXXXXXXXXXXXX,0,10,0
29106,13,0,13,97,490,0,0,503,332,171,GXXXXXXXXXXXXXXXXXXXGXXXXXXXXXXXXXXXXXXXGXXXXXXXXXXXXXXXXXXXGXXXXXXXXXXXXXXXXXXXGXXXXXXXXXXXXXXXXXXXGXXXXXXXXXXXXXXXXXXXGXXXXXXXXXXXXXXXXXXXGXXXXXXXXXXXXXXXXXXXGXXXXXXXXXXXXXXXXXXXGXXXXXXXXXXXXXXXXXXXGXXXXXXXXXXXXXXXXXXXGXXXXXXXXXXXXXXXXXXXGXXXXXXXXXXXXXXXXXXX,0,10,0
29127,13,0,13,96,491,0,0,505,330,175,GXXXXXXXXXXXXXXXXXXXGXXXXXXXXXXXXXXXXXXXGXXXXXXXXXXXXXXXXXXXGXXXXXXXXXXXXXXXXXXXGXXXXXXXXXXXXXXXXXXXGXXXXXXXXXXXXXXXXXXXGXXXXXXXXXXXXXXXXXXXGXXXXXXXXXXXXXXXXXXXGXXXXXXXXXXXXXXXXXXXGXXXXXXXXXXXXXXXXXXXGXXXXXXXXXXXXXXXXXXXGXXXXXXXXXXXXXXXXXXXGXXXXXXXXXXXXXXXXXXX,0,10,0
29148,13,0,13,93,494,0,0,509,333,176,GXXXXXXXXXXXXXXXXXXXGXXXXXXXXXXXXXXXXXXXGXXXXXXXXXXXXXXXXXXXGXXXXXXXXXXXXXXXXXXXGXXXXXXXXXXXXXXXXXXXGXXXXXXXXXXXXXXXXXXXGXXXXXXXXXXXXXXXXXXXGXXXXXXXXXXXXXXXXXXXGXXXXXXXXXXXXXXXXXXXGXXXXXXXXXXXXXXXXXXXGXXXXXXXXXXXXXXXXXXXGXXXXXXXXXXXXXXXXXXXGXXXXXXXXXXXXXXXXXXX,0,10,0
29169,13,0,13,88,499,0,0,514,332,182,GXXXXXXXXXXXXXXXXXXXGXXXXXXXXXXXXXXXXXXXGXXXXXXXXXXXXXXXXXXXGXXXXXXXXXXXXXXXXXXXGXXXXXXXXXXXXXXXXXXXGXXXXXXXXXXXXXXXXXXXGXXXXXXXXXXXXXXXXXXXGXXXXXXXXXXXXXXXXXXXGXXXXXXXXXXXXXXXXXXXGXXXXXXXXXXXXXXXXXXXGXXXXXXXXXXXXXXXXXXXGXXXXXXXXXXXXXXXXXXXGXXXXXXXXXXXXXXXXXXX,0,10,0

29190,13,0,13,89,498,0,0,514,328,186,GXXXXXXXXXXXXXXXXXXXGXXXXXXXXXXXXXXXXXXXGXXXXXXXXXXXXXXXXXXXGXXXXXXXXXXXXXXXXXXXGXXXXXXXXXXXXXXXXXXXGXXXXXXXXXXXXXXXXXXXGXXXXXXXXXXXXXXXXXXXGXXXXXXXXXXXXXXXXXXXGXXXXXXXXXXXXXXXXXXXGXXXXXXXXXXXXXXXXXXXGXXXXXXXXXXXXXXXXXXXGXXXXXXXXXXXXXXXXXXXGXXXXXXXXXXXXXXXXXXX,0,10,0
29211,13,0,13,83,504,0,0,519,333,186,GXXXXXXXXXXXXXXXXXXXGXXXXXXXXXXXXXXXXXXXGXXXXXXXXXXXXXXXXXXXGXXXXXXXXXXXXXXXXXXXGXXXXXXXXXXXXXXXXXXXGXXXXXXXXXXXXXXXXXXXGXXXXXXXXXXXXXXXXXXXGXXXXXXXXXXXXXXXXXXXGXXXXXXXXXXXXXXXXXXXGXXXXXXXXXXXXXXXXXXXGXXXXXXXXXXXXXXXXXXXGXXXXXXXXXXXXXXXXXXXGXXXXXXXXXXXXXXXXXXX,0,10,0
29232,13,0,13,92,495,0,0,508,335,173,GXXXXXXXXXXXXXXXXXXXGXXXXXXXXXXXXXXXXXXXGXXXXXXXXXXXXXXXXXXXGXXXXXXXXXXXXXXXXXXXGXXXXXXXXXXXXXXXXXXXGXXXXXXXXXXXXXXXXXXXGXXXXXXXXXXXXXXXXXXXGXXXXXXXXXXXXXXXXXXXGXXXXXXXXXXXXXXXXXXXGXXXXXXXXXXXXXXXXXXXGXXXXXXXXXXXXXXXXXXXGXXXXXXXXXXXXXXXXXXXGXXXXXXXXXXXXXXXXXXX,0,10,0
29253,14,1,13,87,499,0,0,514,338,176,GXXXXXXXXXXXXXXXXXXXGXXXXXXXXXXXXXXXXXXXGXXXXXXXXXXXXXXXXXXXGAXXXXXXXXXXXXXXXXXXGXXXXXXXXXXXXXXXXXXXGXXXXXXXXXXXXXXXXXXXGXXXXXXXXXXXXXXXXXXXGXXXXXXXXXXXXXXXXXXXGXXXXXXXXXXXXXXXXXXXGXXXXXXXXXXXXXXXXXXXGXXXXXXXXXXXXXXXXXXXGXXXXXXXXXXXXXXXXXXXGXXXXXXXXXXXXXXXXXXX,0,10,0
29274,15,2,13,88,497,0,0,512,334,178,GXXXXXXXXXXXXXXXXXXXGXXXXXXXXXXXXXXXXXXXGAXXXXXXXXXXXXXXXXXXGAXXXXXXXXXXXXXXXXXXGXXXXXXXXXXXXXXXXXXXGXXXXXXXXXXXXXXXXXXXGXXXXXXXXXXXXXXXXXXXGXXXXXXXXXXXXXXXXXXXGXXXXXXXXXXXXXXXXXXXGXXXXXXXXXXXXXXXXXXXGXXXXXXXXXXXXXXXXXXXGXXXXXXXXXXXXXXXXXXXGXXXXXXXXXXXXXXXXXXX,0,10,0

29295,15,2,13,87,498,0,0,512,332,180,GXXXXXXXXXXXXXXXXXXXGXXXXXXXXXXXXXXXXXXXGAXXXXXXXXXXXXXXXXXXGAXXXXXXXXXXXXXXXXXXGXXXXXXXXXXXXXXXXXXXGXXXXXXXXXXXXXXXXXXXGXXXXXXXXXXXXXXXXXXXGXXXXXXXXXXXXXXXXXXXGXXXXXXXXXXXXXXXXXXXGXXXXXXXXXXXXXXXXXXXGXXXXXXXXXXXXXXXXXXXGXXXXXXXXXXXXXXXXXXXGXXXXXXXXXXXXXXXXXXX,0,10,0
29316,15,2,13,86,499,0,0,513,335,178,GXXXXXXXXXXXXXXXXXXXGXXXXXXXXXXXXXXXXXXXGAXXXXXXXXXXXXXXXXXXGAXXXXXXXXXXXXXXXXXXGXXXXXXXXXXXXXXXXXXXGXXXXXXXXXXXXXXXXXXXGXXXXXXXXXXXXXXXXXXXGXXXXXXXXXXXXXXXXXXXGXXXXXXXXXXXXXXXXXXXGXXXXXXXXXXXXXXXXXXXGXXXXXXXXXXXXXXXXXXXGXXXXXXXXXXXXXXXXXXXGXXXXXXXXXXXXXXXXXXX,0,10,0
29337,15,2,13,91,494,0,0,508,337,171,GXXXXXXXXXXXXXXXXXXXGXXXXXXXXXXXXXXXXXXXGAXXXXXXXXXXXXXXXXXXGAXXXXXXXXXXXXXXXXXXGXXXXXXXXXXXXXXXXXXXGXXXXXXXXXXXXXXXXXXXGXXXXXXXXXXXXXXXXXXXGXXXXXXXXXXXXXXXXXXXGXXXXXXXXXXXXXXXXXXXGXXXXXXXXXXXXXXXXXXXGXXXXXXXXXXXXXXXXXXXGXXXXXXXXXXXXXXXXXXXGXXXXXXXXXXXXXXXXXXX,0,10,0
29358,15,2,13,93,492,0,0,505,334,171,GXXXXXXXXXXXXXXXXXXXGXXXXXXXXXXXXXXXXXXXGAXXXXXXXXXXXXXXXXXXGAXXXXXXXXXXXXXXXXXXGXXXXXXXXXXXXXXXXXXXGXXXXXXXXXXXXXXXXXXXGXXXXXXXXXXXXXXXXXXXGXXXXXXXXXXXXXXXXXXXGXXXXXXXXXXXXXXXXXXXGXXXXXXXXXXXXXXXXXXXGXXXXXXXXXXXXXXXXXXXGXXXXXXXXXXXXXXXXXXXGXXXXXXXXXXXXXXXXXXX,0,10,0
29379,15,2,13,92,493,0,0,508,342,166,GXXXXXXXXXXXXXXXXXXXGXXXXXXXXXXXXXXXXXXXGAXXXXXXXXXXXXXXXXXXGAXXXXXXXXXXXXXXXXXXGXXXXXXXXXXXXXXXXXXXGXXXXXXXXXXXXXXXXXXXGXXXXXXXXXXXXXXXXXXXGXXXXXXXXXXXXXXXXXXXGXXXXXXXXXXXXXXXXXXXGXXXXXXXXXXXXXXXXXXXGXXXXXXXXXXXXXXXXXXXGXXXXXXXXXXXXXXXXXXXGXXXXXXXXXXXXXXXXXXX,0,10,0

29400,15,1,14,95,490,0,0,505,344,161,GXXXXXXXXXXXXXXXXXXXGXXXXXXXXXXXXXXXXXXXGAXXXXXXXXXXXXXXXXXXGOXXXXXXXXXXXXXXXXXXGXXXXXXXXXXXXXXXXXXXGXXXXXXXXXXXXXXXXXXXGXXXXXXXXXXXXXXXXXXXGXXXXXXXXXXXXXXXXXXXGXXXXXXXXXXXXXXXXXXXGXXXXXXXXXXXXXXXXXXXGXXXXXXXXXXXXXXXXXXXGXXXXXXXXXXXXXXXXXXXGXXXXXXXXXXXXXXXXXXX,0,10,0
29421,14,1,13,98,488,0,0,502,341,161,GXXXXXXXXXXXXXXXXXXXGXXXXXXXXXXXXXXXXXXXGAXXXXXXXXXXXXXXXXXXGXXXXXXXXXXXXXXXXXXXGXXXXXXXXXXXXXXXXXXXGXXXXXXXXXXXXXXXXXXXGXXXXXXXXXXXXXXXXXXXGXXXXXXXXXXXXXXXXXXXGXXXXXXXXXXXXXXXXXXXGXXXXXXXXXXXXXXXXXXXGXXXXXXXXXXXXXXXXXXXGXXXXXXXXXXXXXXXXXXXGXXXXXXXXXXXXXXXXXXX,0,10,0
29442,14,1,13,103,483,0,0,497,334,163,GXXXXXXXXXXXXXXXXXXXGXXXXXXXXXXXXXXXXXXXGAXXXXXXXXXXXXXXXXXXGXXXXXXXXXXXXXXXXXXXGXXXXXXXXXXXXXXXXXXXGXXXXXXXXXXXXXXXXXXXGXXXXXXXXXXXXXXXXXXXGXXXXXXXXXXXXXXXXXXXGXXXXXXXXXXXXXXXXXXXGXXXXXXXXXXXXXXXXXXXGXXXXXXXXXXXXXXXXXXXGXXXXXXXXXXXXXXXXXXXGXXXXXXXXXXXXXXXXXXX,0,10,0
29463,14,1,13,100,486,0,0,498,334,164,GXXXXXXXXXXXXXXXXXXXGXXXXXXXXXXXXXXXXXXXGAXXXXXXXXXXXXXXXXXXGXXXXXXXXXXXXXXXXXXXGXXXXXXXXXXXXXXXXXXXGXXXXXXXXXXXXXXXXXXXGXXXXXXXXXXXXXXXXXXXGXXXXXXXXXXXXXXXXXXXGXXXXXXXXXXXXXXXXXXXGXXXXXXXXXXXXXXXXXXXGXXXXXXXXXXXXXXXXXXXGXXXXXXXXXXXXXXXXXXXGXXXXXXXXXXXXXXXXXXX,0,10,0
29484,14,1,13,105,481,0,0,495,337,158,GXXXXXXXXXXXXXXXXXXXGXXXXXXXXXXXXXXXXXXXGAXXXXXXXXXXXXXXXXXXGXXXXXXXXXXXXXXXXXXXGXXXXXXXXXXXXXXXXXXXGXXXXXXXXXXXXXXXXXXXGXXXXXXXXXXXXXXXXXXXGXXXXXXXXXXXXXXXXXXXGXXXXXXXXXXXXXXXXXXXGXXXXXXXXXXXXXXXXXXXGXXXXXXXXXXXXXXXXXXXGXXXXXXXXXXXXXXXXXXXGXXXXXXXXXXXXXXXXXXX,0,10,0

29505,14,1,13,103,483,0,0,494,337,157,GXXXXXXXXXXXXXXXXXXXGXXXXXXXXXXXXXXXXXXXGAXXXXXXXXXXXXXXXXXXGXXXXXXXXXXXXXXXXXXXGXXXXXXXXXXXXXXXXXXXGXXXXXXXXXXXXXXXXXXXGXXXXXXXXXXXXXXXXXXXGXXXXXXXXXXXXXXXXXXXGXXXXXXXXXXXXXXXXXXXGXXXXXXXXXXXXXXXXXXXGXXXXXXXXXXXXXXXXXXXGXXXXXXXXXXXXXXXXXXXGXXXXXXXXXXXXXXXXXXX,0,10,0
29526,14,1,13,102,484,0,0,497,335,162,GXXXXXXXXXXXXXXXXXXXGXXXXXXXXXXXXXXXXXXXGAXXXXXXXXXXXXXXXXXXGXXXXXXXXXXXXXXXXXXXGXXXXXXXXXXXXXXXXXXXGXXXXXXXXXXXXXXXXXXXGXXXXXXXXXXXXXXXXXXXGXXXXXXXXXXXXXXXXXXXGXXXXXXXXXXXXXXXXXXXGXXXXXXXXXXXXXXXXXXXGXXXXXXXXXXXXXXXXXXXGXXXXXXXXXXXXXXXXXXXGXXXXXXXXXXXXXXXXXXX,0,10,0
29547,14,1,13,102,484,0,0,498,333,165,GXXXXXXXXXXXXXXXXXXXGXXXXXXXXXXXXXXXXXXXGAXXXXXXXXXXXXXXXXXXGXXXXXXXXXXXXXXXXXXXGXXXXXXXXXXXXXXXXXXXGXXXXXXXXXXXXXXXXXXXGXXXXXXXXXXXXXXXXXXXGXXXXXXXXXXXXXXXXXXXGXXXXXXXXXXXXXXXXXXXGXXXXXXXXXXXXXXXXXXXGXXXXXXXXXXXXXXXXXXXGXXXXXXXXXXXXXXXXXXXGXXXXXXXXXXXXXXXXXXX,0,10,0
29568,14,1,13,90,496,0,0,511,336,175,GXXXXXXXXXXXXXXXXXXXGXXXXXXXXXXXXXXXXXXXGAXXXXXXXXXXXXXXXXXXGXXXXXXXXXXXXXXXXXXXGXXXXXXXXXXXXXXXXXXXGXXXXXXXXXXXXXXXXXXXGXXXXXXXXXXXXXXXXXXXGXXXXXXXXXXXXXXXXXXXGXXXXXXXXXXXXXXXXXXXGXXXXXXXXXXXXXXXXXXXGXXXXXXXXXXXXXXXXXXXGXXXXXXXXXXXXXXXXXXXGXXXXXXXXXXXXXXXXXXX,0,10,0
29589,14,0,14,88,498,0,0,513,335,178,GXXXXXXXXXXXXXXXXXXXGXXXXXXXXXXXXXXXXXXXGOXXXXXXXXXXXXXXXXXXGXXXXXXXXXXXXXXXXXXXGXXXXXXXXXXXXXXXXXXXGXXXXXXXXXXXXXXXXXXXGXXXXXXXXXXXXXXXXXXXGXXXXXXXXXXXXXXXXXXXGXXXXXXXXXXXXXXXXXXXGXXXXXXXXXXXXXXXXXXXGXXXXXXXXXXXXXXXXXXXGXXXXXXXXXXXXXXXXXXXGXXXXXXXXXXXXXXXXXXX,0,10,0

29610,13,0,13,90,497,0,0,512,337,175,GXXXXXXXXXXXXXXXXXXXGXXXXXXXXXXXXXXXXXXXGXXXXXXXXXXXXXXXXXXXGXXXXXXXXXXXXXXXXXXXGXXXXXXXXXXXXXXXXXXXGXXXXXXXXXXXXXXXXXXXGXXXXXXXXXXXXXXXXXXXGXXXXXXXXXXXXXXXXXXXGXXXXXXXXXXXXXXXXXXXGXXXXXXXXXXXXXXXXXXXGXXXXXXXXXXXXXXXXXXXGXXXXXXXXXXXXXXXXXXXGXXXXXXXXXXXXXXXXXXX,0,10,0
29631,13,0,13,90,497,0,0,510,339,171,GXXXXXXXXXXXXXXXXXXXGXXXXXXXXXXXXXXXXXXXGXXXXXXXXXXXXXXXXXXXGXXXXXXXXXXXXXXXXXXXGXXXXXXXXXXXXXXXXXXXGXXXXXXXXXXXXXXXXXXXGXXXXXXXXXXXXXXXXXXXGXXXXXXXXXXXXXXXXXXXGXXXXXXXXXXXXXXXXXXXGXXXXXXXXXXXXXXXXXXXGXXXXXXXXXXXXXXXXXXXGXXXXXXXXXXXXXXXXXXXGXXXXXXXXXXXXXXXXXXX,0,10,0
29652,14,1,13,86,500,0,0,515,339,176,GXXXXXXXXXXXXXXXXXXXGXXXXXXXXXXXXXXXXXXXGXXXXXXXXXXXXXXXXXXXGXXXXXXXXXXXXXXXXXXXGXXXXXXXXXXXXXXXXXXXGXXXXXXXXXXXXXXXXXXXGAXXXXXXXXXXXXXXXXXXGXXXXXXXXXXXXXXXXXXXGXXXXXXXXXXXXXXXXXXXGXXXXXXXXXXXXXXXXXXXGXXXXXXXXXXXXXXXXXXXGXXXXXXXXXXXXXXXXXXXGXXXXXXXXXXXXXXXXXXX,0,10,0
29673,15,2,13,84,501,0,0,516,340,176,GXXXXXXXXXXXXXXXXXXXGXXXXXXXXXXXXXXXXXXXGXXXXXXXXXXXXXXXXXXXGXXXXXXXXXXXXXXXXXXXGAXXXXXXXXXXXXXXXXXXGXXXXXXXXXXXXXXXXXXXGAXXXXXXXXXXXXXXXXXXGXXXXXXXXXXXXXXXXXXXGXXXXXXXXXXXXXXXXXXXGXXXXXXXXXXXXXXXXXXXGXXXXXXXXXXXXXXXXXXXGXXXXXXXXXXXXXXXXXXXGXXXXXXXXXXXXXXXXXXX,0,10,0
29694,15,1,14,78,507,0,0,522,341,181,GXXXXXXXXXXXXXXXXXXXGXXXXXXXXXXXXXXXXXXXGXXXXXXXXXXXXXXXXXXXGXXXXXXXXXXXXXXXXXXXGOXXXXXXXXXXXXXXXXXXGXXXXXXXXXXXXXXXXXXXGAXXXXXXXXXXXXXXXXXXGXXXXXXXXXXXXXXXXXXXGXXXXXXXXXXXXXXXXXXXGXXXXXXXXXXXXXXXXXXXGXXXXXXXXXXXXXXXXXXXGXXXXXXXXXXXXXXXXXXXGXXXXXXXXXXXXXXXXXXX,0,10,0

29715,14,1,13,80,506,0,0,519,342,177,GXXXXXXXXXXXXXXXXXXXGXXXXXXXXXXXXXXXXXXXGXXXXXXXXXXXXXXXXXXXGXXXXXXXXXXXXXXXXXXXGXXXXXXXXXXXXXXXXXXXGXXXXXXXXXXXXXXXXXXXGAXXXXXXXXXXXXXXXXXXGXXXXXXXXXXXXXXXXXXXGXXXXXXXXXXXXXXXXXXXGXXXXXXXXXXXXXXXXXXXGXXXXXXXXXXXXXXXXXXXGXXXXXXXXXXXXXXXXXXXGXXXXXXXXXXXXXXXXXXX,0,10,0
29736,13,0,13,86,501,0,0,515,339,176,GXXXXXXXXXXXXXXXXXXXGXXXXXXXXXXXXXXXXXXXGXXXXXXXXXXXXXXXXXXXGXXXXXXXXXXXXXXXXXXXGXXXXXXXXXXXXXXXXXXXGXXXXXXXXXXXXXXXXXXXGXXXXXXXXXXXXXXXXXXXGXXXXXXXXXXXXXXXXXXXGXXXXXXXXXXXXXXXXXXXGXXXXXXXXXXXXXXXXXXXGXXXXXXXXXXXXXXXXXXXGXXXXXXXXXXXXXXXXXXXGXXXXXXXXXXXXXXXXXXX,0,10,0
29757,14,1,13,83,503,0,0,517,346,171,GXXXXXXXXXXXXXXXXXXXGXXXXXXXXXXXXXXXXXXXGXXXXXXXXXXXXXXXXXXXGXXXXXXXXXXXXXXXXXXXGXXXXXXXXXXXXXXXXXXXGXXXXXXXXXXXXXXXXXXXGXXXXXXXXXXXXXXXXXXXGXXXXXXXXXXXXXXXXXXXGAXXXXXXXXXXXXXXXXXXGXXXXXXXXXXXXXXXXXXXGXXXXXXXXXXXXXXXXXXXGXXXXXXXXXXXXXXXXXXXGXXXXXXXXXXXXXXXXXXX,0,10,0
29778,14,1,13,86,500,0,0,513,344,169,GXXXXXXXXXXXXXXXXXXXGXXXXXXXXXXXXXXXXXXXGXXXXXXXXXXXXXXXXXXXGXXXXXXXXXXXXXXXXXXXGXXXXXXXXXXXXXXXXXXXGXXXXXXXXXXXXXXXXXXXGXXXXXXXXXXXXXXXXXXXGXXXXXXXXXXXXXXXXXXXGAXXXXXXXXXXXXXXXXXXGXXXXXXXXXXXXXXXXXXXGXXXXXXXXXXXXXXXXXXXGXXXXXXXXXXXXXXXXXXXGXXXXXXXXXXXXXXXXXXX,0,10,0
29799,14,1,13,89,497,0,0,509,344,165,GXXXXXXXXXXXXXXXXXXXGXXXXXXXXXXXXXXXXXXXGXXXXXXXXXXXXXXXXXXXGXXXXXXXXXXXXXXXXXXXGXXXXXXXXXXXXXXXXXXXGXXXXXXXXXXXXXXXXXXXGXXXXXXXXXXXXXXXXXXXGXXXXXXXXXXXXXXXXXXXGAXXXXXXXXXXXXXXXXXXGXXXXXXXXXXXXXXXXXXXGXXXXXXXXXXXXXXXXXXXGXXXXXXXXXXXXXXXXXXXGXXXXXXXXXXXXXXXXXXX,0,10,0

29820,14,1,13,86,500,0,0,514,340,174,GXXXXXXXXXXXXXXXXXXXGXXXXXXXXXXXXXXXXXXXGXXXXXXXXXXXXXXXXXXXGXXXXXXXXXXXXXXXXXXXGXXXXXXXXXXXXXXXXXXXGXXXXXXXXXXXXXXXXXXXGXXXXXXXXXXXXXXXXXXXGXXXXXXXXXXXXXXXXXXXGAXXXXXXXXXXXXXXXXXXGXXXXXXXXXXXXXXXXXXXGXXXXXXXXXXXXXXXXXXXGXXXXXXXXXXXXXXXXXXXGXXXXXXXXXXXXXXXXXXX,0,10,0
29841,14,1,13,84,502,0,0,516,344,172,GXXXXXXXXXXXXXXXXXXXGXXXXXXXXXXXXXXXXXXXGXXXXXXXXXXXXXXXXXXXGXXXXXXXXXXXXXXXXXXXGXXXXXXXXXXXXXXXXXXXGXXXXXXXXXXXXXXXXXXXGXXXXXXXXXXXXXXXXXXXGXXXXXXXXXXXXXXXXXXXGAXXXXXXXXXXXXXXXXXXGXXXXXXXXXXXXXXXXXXXGXXXXXXXXXXXXXXXXXXXGXXXXXXXXXXXXXXXXXXXGXXXXXXXXXXXXXXXXXXX,0,10,0
29862,13,0,13,92,495,0,0,510,347,163,GXXXXXXXXXXXXXXXXXXXGXXXXXXXXXXXXXXXXXXXGXXXXXXXXXXXXXXXXXXXGXXXXXXXXXXXXXXXXXXXGXXXXXXXXXXXXXXXXXXXGXXXXXXXXXXXXXXXXXXXGXXXXXXXXXXXXXXXXXXXGXXXXXXXXXXXXXXXXXXXGXXXXXXXXXXXXXXXXXXXGXXXXXXXXXXXXXXXXXXXGXXXXXXXXXXXXXXXXXXXGXXXXXXXXXXXXXXXXXXXGXXXXXXXXXXXXXXXXXXX,0,10,0
29883,13,0,13,91,496,0,0,510,344,166,GXXXXXXXXXXXXXXXXXXXGXXXXXXXXXXXXXXXXXXXGXXXXXXXXXXXXXXXXXXXGXXXXXXXXXXXXXXXXXXXGXXXXXXXXXXXXXXXXXXXGXXXXXXXXXXXXXXXXXXXGXXXXXXXXXXXXXXXXXXXGXXXXXXXXXXXXXXXXXXXGXXXXXXXXXXXXXXXXXXXGXXXXXXXXXXXXXXXXXXXGXXXXXXXXXXXXXXXXXXXGXXXXXXXXXXXXXXXXXXXGXXXXXXXXXXXXXXXXXXX,0,10,0
29904,13,0,13,92,495,0,0,510,346,164,GXXXXXXXXXXXXXXXXXXXGXXXXXXXXXXXXXXXXXXXGXXXXXXXXXXXXXXXXXXXGXXXXXXXXXXXXXXXXXXXGXXXXXXXXXXXXXXXXXXXGXXXXXXXXXXXXXXXXXXXGXXXXXXXXXXXXXXXXXXXGXXXXXXXXXXXXXXXXXXXGXXXXXXXXXXXXXXXXXXXGXXXXXXXXXXXXXXXXXXXGXXXXXXXXXXXXXXXXXXXGXXXXXXXXXXXXXXXXXXXGXXXXXXXXXXXXXXXXXXX,0,10,0

29925,13,0,13,89,498,0,0,513,346,167,GXXXXXXXXXXXXXXXXXXXGXXXXXXXXXXXXXXXXXXXGXXXXXXXXXXXXXXXXXXXGXXXXXXXXXXXXXXXXXXXGXXXXXXXXXXXXXXXXXXXGXXXXXXXXXXXXXXXXXXXGXXXXXXXXXXXXXXXXXXXGXXXXXXXXXXXXXXXXXXXGXXXXXXXXXXXXXXXXXXXGXXXXXXXXXXXXXXXXXXXGXXXXXXXXXXXXXXXXXXXGXXXXXXXXXXXXXXXXXXXGXXXXXXXXXXXXXXXXXXX,0,10,0
29946,13,0,13,86,501,0,0,516,343,173,GXXXXXXXXXXXXXXXXXXXGXXXXXXXXXXXXXXXXXXXGXXXXXXXXXXXXXXXXXXXGXXXXXXXXXXXXXXXXXXXGXXXXXXXXXXXXXXXXXXXGXXXXXXXXXXXXXXXXXXXGXXXXXXXXXXXXXXXXXXXGXXXXXXXXXXXXXXXXXXXGXXXXXXXXXXXXXXXXXXXGXXXXXXXXXXXXXXXXXXXGXXXXXXXXXXXXXXXXXXXGXXXXXXXXXXXXXXXXXXXGXXXXXXXXXXXXXXXXXXX,0,10,0
29967,14,1,13,83,503,0,0,518,343,175,GAXXXXXXXXXXXXXXXXXXGXXXXXXXXXXXXXXXXXXXGXXXXXXXXXXXXXXXXXXXGXXXXXXXXXXXXXXXXXXXGXXXXXXXXXXXXXXXXXXXGXXXXXXXXXXXXXXXXXXXGXXXXXXXXXXXXXXXXXXXGXXXXXXXXXXXXXXXXXXXGXXXXXXXXXXXXXXXXXXXGXXXXXXXXXXXXXXXXXXXGXXXXXXXXXXXXXXXXXXXGXXXXXXXXXXXXXXXXXXXGXXXXXXXXXXXXXXXXXXX,0,10,0
29988,14,1,13,83,503,0,0,518,347,171,GAXXXXXXXXXXXXXXXXXXGXXXXXXXXXXXXXXXXXXXGXXXXXXXXXXXXXXXXXXXGXXXXXXXXXXXXXXXXXXXGXXXXXXXXXXXXXXXXXXXGXXXXXXXXXXXXXXXXXXXGXXXXXXXXXXXXXXXXXXXGXXXXXXXXXXXXXXXXXXXGXXXXXXXXXXXXXXXXXXXGXXXXXXXXXXXXXXXXXXXGXXXXXXXXXXXXXXXXXXXGXXXXXXXXXXXXXXXXXXXGXXXXXXXXXXXXXXXXXXX,0,10,0
30009,14,1,13,84,502,0,0,516,348,168,GAXXXXXXXXXXXXXXXXXXGXXXXXXXXXXXXXXXXXXXGXXXXXXXXXXXXXXXXXXXGXXXXXXXXXXXXXXXXXXXGXXXXXXXXXXXXXXXXXXXGXXXXXXXXXXXXXXXXXXXGXXXXXXXXXXXXXXXXXXXGXXXXXXXXXXXXXXXXXXXGXXXXXXXXXXXXXXXXXXXGXXXXXXXXXXXXXXXXXXXGXXXXXXXXXXXXXXXXXXXGXXXXXXXXXXXXXXXXXXXGXXXXXXXXXXXXXXXXXXX,0,10,0

30030,14,1,13,83,503,0,0,518,348,170,GAXXXXXXXXXXXXXXXXXXGXXXXXXXXXXXXXXXXXXXGXXXXXXXXXXXXXXXXXXXGXXXXXXXXXXXXXXXXXXXGXXXXXXXXXXXXXXXXXXXGXXXXXXXXXXXXXXXXXXXGXXXXXXXXXXXXXXXXXXXGXXXXXXXXXXXXXXXXXXXGXXXXXXXXXXXXXXXXXXXGXXXXXXXXXXXXXXXXXXXGXXXXXXXXXXXXXXXXXXXGXXXXXXXXXXXXXXXXXXXGXXXXXXXXXXXXXXXXXXX,0,10,0
30051,14,1,13,84,502,0,0,516,353,163,GAXXXXXXXXXXXXXXXXXXGXXXXXXXXXXXXXXXXXXXGXXXXXXXXXXXXXXXXXXXGXXXXXXXXXXXXXXXXXXXGXXXXXXXXXXXXXXXXXXXGXXXXXXXXXXXXXXXXXXXGXXXXXXXXXXXXXXXXXXXGXXXXXXXXXXXXXXXXXXXGXXXXXXXXXXXXXXXXXXXGXXXXXXXXXXXXXXXXXXXGXXXXXXXXXXXXXXXXXXXGXXXXXXXXXXXXXXXXXXXGXXXXXXXXXXXXXXXXXXX,0,10,0
30072,14,1,13,94,492,0,0,506,345,161,GAXXXXXXXXXXXXXXXXXXGXXXXXXXXXXXXXXXXXXXGXXXXXXXXXXXXXXXXXXXGXXXXXXXXXXXXXXXXXXXGXXXXXXXXXXXXXXXXXXXGXXXXXXXXXXXXXXXXXXXGXXXXXXXXXXXXXXXXXXXGXXXXXXXXXXXXXXXXXXXGXXXXXXXXXXXXXXXXXXXGXXXXXXXXXXXXXXXXXXXGXXXXXXXXXXXXXXXXXXXGXXXXXXXXXXXXXXXXXXXGXXXXXXXXXXXXXXXXXXX,0,10,0
30093,14,0,14,100,486,0,0,499,341,158,GOXXXXXXXXXXXXXXXXXXGXXXXXXXXXXXXXXXXXXXGXXXXXXXXXXXXXXXXXXXGXXXXXXXXXXXXXXXXXXXGXXXXXXXXXXXXXXXXXXXGXXXXXXXXXXXXXXXXXXXGXXXXXXXXXXXXXXXXXXXGXXXXXXXXXXXXXXXXXXXGXXXXXXXXXXXXXXXXXXXGXXXXXXXXXXXXXXXXXXXGXXXXXXXXXXXXXXXXXXXGXXXXXXXXXXXXXXXXXXXGXXXXXXXXXXXXXXXXXXX,0,10,0
30114,14,1,13,98,488,0,0,500,339,161,GXXXXXXXXXXXXXXXXXXXGXXXXXXXXXXXXXXXXXXXGXXXXXXXXXXXXXXXXXXXGXXXXXXXXXXXXXXXXXXXGXXXXXXXXXXXXXXXXXXXGXXXXXXXXXXXXXXXXXXXGXXXXXXXXXXXXXXXXXXXGXXXXXXXXXXXXXXXXXXXGXXXXXXXXXXXXXXXXXXXGXXXXXXXXXXXXXXXXXXXGXXXXXXXXXXXXXXXXXXXGAXXXXXXXXXXXXXXXXXXGXXXXXXXXXXXXXXXXXXX,0,10,0

30135,14,0,14,93,493,0,0,506,345,161,GXXXXXXXXXXXXXXXXXXXGXXXXXXXXXXXXXXXXXXXGXXXXXXXXXXXXXXXXXXXGXXXXXXXXXXXXXXXXXXXGXXXXXXXXXXXXXXXXXXXGXXXXXXXXXXXXXXXXXXXGXXXXXXXXXXXXXXXXXXXGXXXXXXXXXXXXXXXXXXXGXXXXXXXXXXXXXXXXXXXGXXXXXXXXXXXXXXXXXXXGXXXXXXXXXXXXXXXXXXXGOXXXXXXXXXXXXXXXXXXGXXXXXXXXXXXXXXXXXXX,0,10,0
30156,13,0,13,89,498,0,0,511,348,163,GXXXXXXXXXXXXXXXXXXXGXXXXXXXXXXXXXXXXXXXGXXXXXXXXXXXXXXXXXXXGXXXXXXXXXXXXXXXXXXXGXXXXXXXXXXXXXXXXXXXGXXXXXXXXXXXXXXXXXXXGXXXXXXXXXXXXXXXXXXXGXXXXXXXXXXXXXXXXXXXGXXXXXXXXXXXXXXXXXXXGXXXXXXXXXXXXXXXXXXXGXXXXXXXXXXXXXXXXXXXGXXXXXXXXXXXXXXXXXXXGXXXXXXXXXXXXXXXXXXX,0,10,0
30177,13,0,13,87,500,0,0,510,346,164,GXXXXXXXXXXXXXXXXXXXGXXXXXXXXXXXXXXXXXXXGXXXXXXXXXXXXXXXXXXXGXXXXXXXXXXXXXXXXXXXGXXXXXXXXXXXXXXXXXXXGXXXXXXXXXXXXXXXXXXXGXXXXXXXXXXXXXXXXXXXGXXXXXXXXXXXXXXXXXXXGXXXXXXXXXXXXXXXXXXXGXXXXXXXXXXXXXXXXXXXGXXXXXXXXXXXXXXXXXXXGXXXXXXXXXXXXXXXXXXXGXXXXXXXXXXXXXXXXXXX,0,10,0
30198,13,0,13,88,499,0,0,510,349,161,GXXXXXXXXXXXXXXXXXXXGXXXXXXXXXXXXXXXXXXXGXXXXXXXXXXXXXXXXXXXGXXXXXXXXXXXXXXXXXXXGXXXXXXXXXXXXXXXXXXXGXXXXXXXXXXXXXXXXXXXGXXXXXXXXXXXXXXXXXXXGXXXXXXXXXXXXXXXXXXXGXXXXXXXXXXXXXXXXXXXGXXXXXXXXXXXXXXXXXXXGXXXXXXXXXXXXXXXXXXXGXXXXXXXXXXXXXXXXXXXGXXXXXXXXXXXXXXXXXXX,0,10,0
30219,13,0,13,85,502,0,0,514,347,167,GXXXXXXXXXXXXXXXXXXXGXXXXXXXXXXXXXXXXXXXGXXXXXXXXXXXXXXXXXXXGXXXXXXXXXXXXXXXXXXXGXXXXXXXXXXXXXXXXXXXGXXXXXXXXXXXXXXXXXXXGXXXXXXXXXXXXXXXXXXXGXXXXXXXXXXXXXXXXXXXGXXXXXXXXXXXXXXXXXXXGXXXXXXXXXXXXXXXXXXXGXXXXXXXXXXXXXXXXXXXGXXXXXXXXXXXXXXXXXXXGXXXXXXXXXXXXXXXXXXX,0,10,0

30240,13,0,13,86,501,0,0,515,345,170,GXXXXXXXXXXXXXXXXXXXGXXXXXXXXXXXXXXXXXXXGXXXXXXXXXXXXXXXXXXXGXXXXXXXXXXXXXXXXXXXGXXXXXXXXXXXXXXXXXXXGXXXXXXXXXXXXXXXXXXXGXXXXXXXXXXXXXXXXXXXGXXXXXXXXXXXXXXXXXXXGXXXXXXXXXXXXXXXXXXXGXXXXXXXXXXXXXXXXXXXGXXXXXXXXXXXXXXXXXXXGXXXXXXXXXXXXXXXXXXXGXXXXXXXXXXXXXXXXXXX,0,10,0
30261,13,0,13,85,502,0,0,516,345,171,GXXXXXXXXXXXXXXXXXXXGXXXXXXXXXXXXXXXXXXXGXXXXXXXXXXXXXXXXXXXGXXXXXXXXXXXXXXXXXXXGXXXXXXXXXXXXXXXXXXXGXXXXXXXXXXXXXXXXXXXGXXXXXXXXXXXXXXXXXXXGXXXXXXXXXXXXXXXXXXXGXXXXXXXXXXXXXXXXXXXGXXXXXXXXXXXXXXXXXXXGXXXXXXXXXXXXXXXXXXXGXXXXXXXXXXXXXXXXXXXGXXXXXXXXXXXXXXXXXXX,0,10,0
30282,13,0,13,86,501,0,0,515,351,164,GXXXXXXXXXXXXXXXXXXXGXXXXXXXXXXXXXXXXXXXGXXXXXXXXXXXXXXXXXXXGXXXXXXXXXXXXXXXXXXXGXXXXXXXXXXXXXXXXXXXGXXXXXXXXXXXXXXXXXXXGXXXXXXXXXXXXXXXXXXXGXXXXXXXXXXXXXXXXXXXGXXXXXXXXXXXXXXXXXXXGXXXXXXXXXXXXXXXXXXXGXXXXXXXXXXXXXXXXXXXGXXXXXXXXXXXXXXXXXXXGXXXXXXXXXXXXXXXXXXX,0,10,0
30303,13,0,13,89,498,0,0,511,348,163,GXXXXXXXXXXXXXXXXXXXGXXXXXXXXXXXXXXXXXXXGXXXXXXXXXXXXXXXXXXXGXXXXXXXXXXXXXXXXXXXGXXXXXXXXXXXXXXXXXXXGXXXXXXXXXXXXXXXXXXXGXXXXXXXXXXXXXXXXXXXGXXXXXXXXXXXXXXXXXXXGXXXXXXXXXXXXXXXXXXXGXXXXXXXXXXXXXXXXXXXGXXXXXXXXXXXXXXXXXXXGXXXXXXXXXXXXXXXXXXXGXXXXXXXXXXXXXXXXXXX,0,10,0
30324,13,0,13,87,500,0,0,514,348,166,GXXXXXXXXXXXXXXXXXXXGXXXXXXXXXXXXXXXXXXXGXXXXXXXXXXXXXXXXXXXGXXXXXXXXXXXXXXXXXXXGXXXXXXXXXXXXXXXXXXXGXXXXXXXXXXXXXXXXXXXGXXXXXXXXXXXXXXXXXXXGXXXXXXXXXXXXXXXXXXXGXXXXXXXXXXXXXXXXXXXGXXXXXXXXXXXXXXXXXXXGXXXXXXXXXXXXXXXXXXXGXXXXXXXXXXXXXXXXXXXGXXXXXXXXXXXXXXXXXXX,0,10,0

30345,13,0,13,90,497,0,0,510,351,159,GXXXXXXXXXXXXXXXXXXXGXXXXXXXXXXXXXXXXXXXGXXXXXXXXXXXXXXXXXXXGXXXXXXXXXXXXXXXXXXXGXXXXXXXXXXXXXXXXXXXGXXXXXXXXXXXXXXXXXXXGXXXXXXXXXXXXXXXXXXXGXXXXXXXXXXXXXXXXXXXGXXXXXXXXXXXXXXXXXXXGXXXXXXXXXXXXXXXXXXXGXXXXXXXXXXXXXXXXXXXGXXXXXXXXXXXXXXXXXXXGXXXXXXXXXXXXXXXXXXX,0,10,0
30366,13,0,13,91,496,0,0,508,346,162,GXXXXXXXXXXXXXXXXXXXGXXXXXXXXXXXXXXXXXXXGXXXXXXXXXXXXXXXXXXXGXXXXXXXXXXXXXXXXXXXGXXXXXXXXXXXXXXXXXXXGXXXXXXXXXXXXXXXXXXXGXXXXXXXXXXXXXXXXXXXGXXXXXXXXXXXXXXXXXXXGXXXXXXXXXXXXXXXXXXXGXXXXXXXXXXXXXXXXXXXGXXXXXXXXXXXXXXXXXXXGXXXXXXXXXXXXXXXXXXXGXXXXXXXXXXXXXXXXXXX,0,10,0
30387,13,0,13,92,495,0,0,507,341,166,GXXXXXXXXXXXXXXXXXXXGXXXXXXXXXXXXXXXXXXXGXXXXXXXXXXXXXXXXXXXGXXXXXXXXXXXXXXXXXXXGXXXXXXXXXXXXXXXXXXXGXXXXXXXXXXXXXXXXXXXGXXXXXXXXXXXXXXXXXXXGXXXXXXXXXXXXXXXXXXXGXXXXXXXXXXXXXXXXXXXGXXXXXXXXXXXXXXXXXXXGXXXXXXXXXXXXXXXXXXXGXXXXXXXXXXXXXXXXXXXGXXXXXXXXXXXXXXXXXXX,0,10,0
30408,13,0,13,84,503,0,0,517,344,173,GXXXXXXXXXXXXXXXXXXXGXXXXXXXXXXXXXXXXXXXGXXXXXXXXXXXXXXXXXXXGXXXXXXXXXXXXXXXXXXXGXXXXXXXXXXXXXXXXXXXGXXXXXXXXXXXXXXXXXXXGXXXXXXXXXXXXXXXXXXXGXXXXXXXXXXXXXXXXXXXGXXXXXXXXXXXXXXXXXXXGXXXXXXXXXXXXXXXXXXXGXXXXXXXXXXXXXXXXXXXGXXXXXXXXXXXXXXXXXXXGXXXXXXXXXXXXXXXXXXX,0,10,0
30429,13,0,13,76,511,0,0,524,345,179,GXXXXXXXXXXXXXXXXXXXGXXXXXXXXXXXXXXXXXXXGXXXXXXXXXXXXXXXXXXXGXXXXXXXXXXXXXXXXXXXGXXXXXXXXXXXXXXXXXXXGXXXXXXXXXXXXXXXXXXXGXXXXXXXXXXXXXXXXXXXGXXXXXXXXXXXXXXXXXXXGXXXXXXXXXXXXXXXXXXXGXXXXXXXXXXXXXXXXXXXGXXXXXXXXXXXXXXXXXXXGXXXXXXXXXXXXXXXXXXXGXXXXXXXXXXXXXXXXXXX,0,10,0

30450,13,0,13,81,506,0,0,520,350,170,GXXXXXXXXXXXXXXXXXXXGXXXXXXXXXXXXXXXXXXXGXXXXXXXXXXXXXXXXXXXGXXXXXXXXXXXXXXXXXXXGXXXXXXXXXXXXXXXXXXXGXXXXXXXXXXXXXXXXXXXGXXXXXXXXXXXXXXXXXXXGXXXXXXXXXXXXXXXXXXXGXXXXXXXXXXXXXXXXXXXGXXXXXXXXXXXXXXXXXXXGXXXXXXXXXXXXXXXXXXXGXXXXXXXXXXXXXXXXXXXGXXXXXXXXXXXXXXXXXXX,0,10,0
30471,13,0,13,84,503,0,0,517,355,162,GXXXXXXXXXXXXXXXXXXXGXXXXXXXXXXXXXXXXXXXGXXXXXXXXXXXXXXXXXXXGXXXXXXXXXXXXXXXXXXXGXXXXXXXXXXXXXXXXXXXGXXXXXXXXXXXXXXXXXXXGXXXXXXXXXXXXXXXXXXXGXXXXXXXXXXXXXXXXXXXGXXXXXXXXXXXXXXXXXXXGXXXXXXXXXXXXXXXXXXXGXXXXXXXXXXXXXXXXXXXGXXXXXXXXXXXXXXXXXXXGXXXXXXXXXXXXXXXXXXX,0,10,0
30492,13,0,13,89,498,0,0,512,354,158,GXXXXXXXXXXXXXXXXXXXGXXXXXXXXXXXXXXXXXXXGXXXXXXXXXXXXXXXXXXXGXXXXXXXXXXXXXXXXXXXGXXXXXXXXXXXXXXXXXXXGXXXXXXXXXXXXXXXXXXXGXXXXXXXXXXXXXXXXXXXGXXXXXXXXXXXXXXXXXXXGXXXXXXXXXXXXXXXXXXXGXXXXXXXXXXXXXXXXXXXGXXXXXXXXXXXXXXXXXXXGXXXXXXXXXXXXXXXXXXXGXXXXXXXXXXXXXXXXXXX,0,10,0
30513,13,0,13,91,496,0,0,509,352,157,GXXXXXXXXXXXXXXXXXXXGXXXXXXXXXXXXXXXXXXXGXXXXXXXXXXXXXXXXXXXGXXXXXXXXXXXXXXXXXXXGXXXXXXXXXXXXXXXXXXXGXXXXXXXXXXXXXXXXXXXGXXXXXXXXXXXXXXXXXXXGXXXXXXXXXXXXXXXXXXXGXXXXXXXXXXXXXXXXXXXGXXXXXXXXXXXXXXXXXXXGXXXXXXXXXXXXXXXXXXXGXXXXXXXXXXXXXXXXXXXGXXXXXXXXXXXXXXXXXXX,0,10,0
30534,14,1,13,84,502,0,0,515,351,164,GXXXXXXXXXXXXXXXXXXXGXXXXXXXXXXXXXXXXXXXGXXXXXXXXXXXXXXXXXXXGXXXXXXXXXXXXXXXXXXXGXXXXXXXXXXXXXXXXXXXGXXXXXXXXXXXXXXXXXXXGAXXXXXXXXXXXXXXXXXXGXXXXXXXXXXXXXXXXXXXGXXXXXXXXXXXXXXXXXXXGXXXXXXXXXXXXXXXXXXXGXXXXXXXXXXXXXXXXXXXGXXXXXXXXXXXXXXXXXXXGXXXXXXXXXXXXXXXXXXX,0,10,0

30555,14,1,13,90,496,0,0,510,346,164,GXXXXXXXXXXXXXXXXXXXGXXXXXXXXXXXXXXXXXXXGXXXXXXXXXXXXXXXXXXXGXXXXXXXXXXXXXXXXXXXGXXXXXXXXXXXXXXXXXXXGXXXXXXXXXXXXXXXXXXXGAXXXXXXXXXXXXXXXXXXGXXXXXXXXXXXXXXXXXXXGXXXXXXXXXXXXXXXXXXXGXXXXXXXXXXXXXXXXXXXGXXXXXXXXXXXXXXXXXXXGXXXXXXXXXXXXXXXXXXXGXXXXXXXXXXXXXXXXXXX,0,10,0
30576,14,1,13,87,499,0,0,514,343,171,GXXXXXXXXXXXXXXXXXXXGXXXXXXXXXXXXXXXXXXXGXXXXXXXXXXXXXXXXXXXGXXXXXXXXXXXXXXXXXXXGXXXXXXXXXXXXXXXXXXXGXXXXXXXXXXXXXXXXXXXGAXXXXXXXXXXXXXXXXXXGXXXXXXXXXXXXXXXXXXXGXXXXXXXXXXXXXXXXXXXGXXXXXXXXXXXXXXXXXXXGXXXXXXXXXXXXXXXXXXXGXXXXXXXXXXXXXXXXXXXGXXXXXXXXXXXXXXXXXXX,0,10,0
30597,14,1,13,82,504,0,0,518,345,173,GXXXXXXXXXXXXXXXXXXXGXXXXXXXXXXXXXXXXXXXGXXXXXXXXXXXXXXXXXXXGXXXXXXXXXXXXXXXXXXXGXXXXXXXXXXXXXXXXXXXGXXXXXXXXXXXXXXXXXXXGAXXXXXXXXXXXXXXXXXXGXXXXXXXXXXXXXXXXXXXGXXXXXXXXXXXXXXXXXXXGXXXXXXXXXXXXXXXXXXXGXXXXXXXXXXXXXXXXXXXGXXXXXXXXXXXXXXXXXXXGXXXXXXXXXXXXXXXXXXX,0,10,0
30618,14,1,13,80,506,0,0,521,350,171,GXXXXXXXXXXXXXXXXXXXGXXXXXXXXXXXXXXXXXXXGXXXXXXXXXXXXXXXXXXXGXXXXXXXXXXXXXXXXXXXGXXXXXXXXXXXXXXXXXXXGXXXXXXXXXXXXXXXXXXXGAXXXXXXXXXXXXXXXXXXGXXXXXXXXXXXXXXXXXXXGXXXXXXXXXXXXXXXXXXXGXXXXXXXXXXXXXXXXXXXGXXXXXXXXXXXXXXXXXXXGXXXXXXXXXXXXXXXXXXXGXXXXXXXXXXXXXXXXXXX,0,10,0
30639,14,1,13,80,506,0,0,519,347,172,GXXXXXXXXXXXXXXXXXXXGXXXXXXXXXXXXXXXXXXXGXXXXXXXXXXXXXXXXXXXGXXXXXXXXXXXXXXXXXXXGXXXXXXXXXXXXXXXXXXXGXXXXXXXXXXXXXXXXXXXGAXXXXXXXXXXXXXXXXXXGXXXXXXXXXXXXXXXXXXXGXXXXXXXXXXXXXXXXXXXGXXXXXXXXXXXXXXXXXXXGXXXXXXXXXXXXXXXXXXXGXXXXXXXXXXXXXXXXXXXGXXXXXXXXXXXXXXXXXXX,0,10,0

30660,14,1,13,85,501,0,0,516,345,171,GXXXXXXXXXXXXXXXXXXXGXXXXXXXXXXXXXXXXXXXGXXXXXXXXXXXXXXXXXXXGXXXXXXXXXXXXXXXXXXXGXXXXXXXXXXXXXXXXXXXGXXXXXXXXXXXXXXXXXXXGAXXXXXXXXXXXXXXXXXXGXXXXXXXXXXXXXXXXXXXGXXXXXXXXXXXXXXXXXXXGXXXXXXXXXXXXXXXXXXXGXXXXXXXXXXXXXXXXXXXGXXXXXXXXXXXXXXXXXXXGXXXXXXXXXXXXXXXXXXX,0,10,0
30681,14,1,13,93,493,0,0,507,349,158,GXXXXXXXXXXXXXXXXXXXGXXXXXXXXXXXXXXXXXXXGXXXXXXXXXXXXXXXXXXXGXXXXXXXXXXXXXXXXXXXGXXXXXXXXXXXXXXXXXXXGXXXXXXXXXXXXXXXXXXXGAXXXXXXXXXXXXXXXXXXGXXXXXXXXXXXXXXXXXXXGXXXXXXXXXXXXXXXXXXXGXXXXXXXXXXXXXXXXXXXGXXXXXXXXXXXXXXXXXXXGXXXXXXXXXXXXXXXXXXXGXXXXXXXXXXXXXXXXXXX,0,10,0
30702,14,1,13,86,500,0,0,514,354,160,GXXXXXXXXXXXXXXXXXXXGXXXXXXXXXXXXXXXXXXXGXXXXXXXXXXXXXXXXXXXGXXXXXXXXXXXXXXXXXXXGXXXXXXXXXXXXXXXXXXXGXXXXXXXXXXXXXXXXXXXGAXXXXXXXXXXXXXXXXXXGXXXXXXXXXXXXXXXXXXXGXXXXXXXXXXXXXXXXXXXGXXXXXXXXXXXXXXXXXXXGXXXXXXXXXXXXXXXXXXXGXXXXXXXXXXXXXXXXXXXGXXXXXXXXXXXXXXXXXXX,0,10,0
30723,14,1,13,88,498,0,0,511,350,161,GXXXXXXXXXXXXXXXXXXXGXXXXXXXXXXXXXXXXXXXGXXXXXXXXXXXXXXXXXXXGXXXXXXXXXXXXXXXXXXXGXXXXXXXXXXXXXXXXXXXGXXXXXXXXXXXXXXXXXXXGAXXXXXXXXXXXXXXXXXXGXXXXXXXXXXXXXXXXXXXGXXXXXXXXXXXXXXXXXXXGXXXXXXXXXXXXXXXXXXXGXXXXXXXXXXXXXXXXXXXGXXXXXXXXXXXXXXXXXXXGXXXXXXXXXXXXXXXXXXX,0,10,0
30744,14,1,13,98,488,0,0,502,344,158,GXXXXXXXXXXXXXXXXXXXGXXXXXXXXXXXXXXXXXXXGXXXXXXXXXXXXXXXXXXXGXXXXXXXXXXXXXXXXXXXGXXXXXXXXXXXXXXXXXXXGXXXXXXXXXXXXXXXXXXXGAXXXXXXXXXXXXXXXXXXGXXXXXXXXXXXXXXXXXXXGXXXXXXXXXXXXXXXXXXXGXXXXXXXXXXXXXXXXXXXGXXXXXXXXXXXXXXXXXXXGXXXXXXXXXXXXXXXXXXXGXXXXXXXXXXXXXXXXXXX,0,10,0

30765,13,0,13,96,491,0,0,506,344,162,GXXXXXXXXXXXXXXXXXXXGXXXXXXXXXXXXXXXXXXXGXXXXXXXXXXXXXXXXXXXGXXXXXXXXXXXXXXXXXXXGXXXXXXXXXXXXXXXXXXXGXXXXXXXXXXXXXXXXXXXGXXXXXXXXXXXXXXXXXXXGXXXXXXXXXXXXXXXXXXXGXXXXXXXXXXXXXXXXXXXGXXXXXXXXXXXXXXXXXXXGXXXXXXXXXXXXXXXXXXXGXXXXXXXXXXXXXXXXXXXGXXXXXXXXXXXXXXXXXXX,0,10,0
30786,13,0,13,89,498,0,0,512,348,164,GXXXXXXXXXXXXXXXXXXXGXXXXXXXXXXXXXXXXXXXGXXXXXXXXXXXXXXXXXXXGXXXXXXXXXXXXXXXXXXXGXXXXXXXXXXXXXXXXXXXGXXXXXXXXXXXXXXXXXXXGXXXXXXXXXXXXXXXXXXXGXXXXXXXXXXXXXXXXXXXGXXXXXXXXXXXXXXXXXXXGXXXXXXXXXXXXXXXXXXXGXXXXXXXXXXXXXXXXXXXGXXXXXXXXXXXXXXXXXXXGXXXXXXXXXXXXXXXXXXX,0,10,0
30807,13,0,13,86,501,0,0,514,350,164,GXXXXXXXXXXXXXXXXXXXGXXXXXXXXXXXXXXXXXXXGXXXXXXXXXXXXXXXXXXXGXXXXXXXXXXXXXXXXXXXGXXXXXXXXXXXXXXXXXXXGXXXXXXXXXXXXXXXXXXXGXXXXXXXXXXXXXXXXXXXGXXXXXXXXXXXXXXXXXXXGXXXXXXXXXXXXXXXXXXXGXXXXXXXXXXXXXXXXXXXGXXXXXXXXXXXXXXXXXXXGXXXXXXXXXXXXXXXXXXXGXXXXXXXXXXXXXXXXXXX,0,10,0
30828,13,0,13,80,507,0,0,522,351,171,GXXXXXXXXXXXXXXXXXXXGXXXXXXXXXXXXXXXXXXXGXXXXXXXXXXXXXXXXXXXGXXXXXXXXXXXXXXXXXXXGXXXXXXXXXXXXXXXXXXXGXXXXXXXXXXXXXXXXXXXGXXXXXXXXXXXXXXXXXXXGXXXXXXXXXXXXXXXXXXXGXXXXXXXXXXXXXXXXXXXGXXXXXXXXXXXXXXXXXXXGXXXXXXXXXXXXXXXXXXXGXXXXXXXXXXXXXXXXXXXGXXXXXXXXXXXXXXXXXXX,0,10,0
30849,13,0,13,80,507,0,0,523,352,171,GXXXXXXXXXXXXXXXXXXXGXXXXXXXXXXXXXXXXXXXGXXXXXXXXXXXXXXXXXXXGXXXXXXXXXXXXXXXXXXXGXXXXXXXXXXXXXXXXXXXGXXXXXXXXXXXXXXXXXXXGXXXXXXXXXXXXXXXXXXXGXXXXXXXXXXXXXXXXXXXGXXXXXXXXXXXXXXXXXXXGXXXXXXXXXXXXXXXXXXXGXXXXXXXXXXXXXXXXXXXGXXXXXXXXXXXXXXXXXXXGXXXXXXXXXXXXXXXXXXX,0,10,0

30870,13,0,13,84,503,0,0,519,349,170,GXXXXXXXXXXXXXXXXXXXGXXXXXXXXXXXXXXXXXXXGXXXXXXXXXXXXXXXXXXXGXXXXXXXXXXXXXXXXXXXGXXXXXXXXXXXXXXXXXXXGXXXXXXXXXXXXXXXXXXXGXXXXXXXXXXXXXXXXXXXGXXXXXXXXXXXXXXXXXXXGXXXXXXXXXXXXXXXXXXXGXXXXXXXXXXXXXXXXXXXGXXXXXXXXXXXXXXXXXXXGXXXXXXXXXXXXXXXXXXXGXXXXXXXXXXXXXXXXXXX,0,10,0
30891,13,0,13,84,503,0,0,518,355,163,GXXXXXXXXXXXXXXXXXXXGXXXXXXXXXXXXXXXXXXXGXXXXXXXXXXXXXXXXXXXGXXXXXXXXXXXXXXXXXXXGXXXXXXXXXXXXXXXXXXXGXXXXXXXXXXXXXXXXXXXGXXXXXXXXXXXXXXXXXXXGXXXXXXXXXXXXXXXXXXXGXXXXXXXXXXXXXXXXXXXGXXXXXXXXXXXXXXXXXXXGXXXXXXXXXXXXXXXXXXXGXXXXXXXXXXXXXXXXXXXGXXXXXXXXXXXXXXXXXXX,0,10,0
30912,13,0,13,93,494,0,0,509,344,165,GXXXXXXXXXXXXXXXXXXXGXXXXXXXXXXXXXXXXXXXGXXXXXXXXXXXXXXXXXXXGXXXXXXXXXXXXXXXXXXXGXXXXXXXXXXXXXXXXXXXGXXXXXXXXXXXXXXXXXXXGXXXXXXXXXXXXXXXXXXXGXXXXXXXXXXXXXXXXXXXGXXXXXXXXXXXXXXXXXXXGXXXXXXXXXXXXXXXXXXXGXXXXXXXXXXXXXXXXXXXGXXXXXXXXXXXXXXXXXXXGXXXXXXXXXXXXXXXXXXX,0,10,0
30933,13,0,13,89,498,0,0,514,348,166,GXXXXXXXXXXXXXXXXXXXGXXXXXXXXXXXXXXXXXXXGXXXXXXXXXXXXXXXXXXXGXXXXXXXXXXXXXXXXXXXGXXXXXXXXXXXXXXXXXXXGXXXXXXXXXXXXXXXXXXXGXXXXXXXXXXXXXXXXXXXGXXXXXXXXXXXXXXXXXXXGXXXXXXXXXXXXXXXXXXXGXXXXXXXXXXXXXXXXXXXGXXXXXXXXXXXXXXXXXXXGXXXXXXXXXXXXXXXXXXXGXXXXXXXXXXXXXXXXXXX,0,10,0
30954,13,0,13,83,504,0,0,519,353,166,GXXXXXXXXXXXXXXXXXXXGXXXXXXXXXXXXXXXXXXXGXXXXXXXXXXXXXXXXXXXGXXXXXXXXXXXXXXXXXXXGXXXXXXXXXXXXXXXXXXXGXXXXXXXXXXXXXXXXXXXGXXXXXXXXXXXXXXXXXXXGXXXXXXXXXXXXXXXXXXXGXXXXXXXXXXXXXXXXXXXGXXXXXXXXXXXXXXXXXXXGXXXXXXXXXXXXXXXXXXXGXXXXXXXXXXXXXXXXXXXGXXXXXXXXXXXXXXXXXXX,0,10,0

30975,13,0,13,84,503,0,0,517,353,164,GXXXXXXXXXXXXXXXXXXXGXXXXXXXXXXXXXXXXXXXGXXXXXXXXXXXXXXXXXXXGXXXXXXXXXXXXXXXXXXXGXXXXXXXXXXXXXXXXXXXGXXXXXXXXXXXXXXXXXXXGXXXXXXXXXXXXXXXXXXXGXXXXXXXXXXXXXXXXXXXGXXXXXXXXXXXXXXXXXXXGXXXXXXXXXXXXXXXXXXXGXXXXXXXXXXXXXXXXXXXGXXXXXXXXXXXXXXXXXXXGXXXXXXXXXXXXXXXXXXX,0,10,0
30996,13,0,13,87,500,0,0,515,352,163,GXXXXXXXXXXXXXXXXXXXGXXXXXXXXXXXXXXXXXXXGXXXXXXXXXXXXXXXXXXXGXXXXXXXXXXXXXXXXXXXGXXXXXXXXXXXXXXXXXXXGXXXXXXXXXXXXXXXXXXXGXXXXXXXXXXXXXXXXXXXGXXXXXXXXXXXXXXXXXXXGXXXXXXXXXXXXXXXXXXXGXXXXXXXXXXXXXXXXXXXGXXXXXXXXXXXXXXXXXXXGXXXXXXXXXXXXXXXXXXXGXXXXXXXXXXXXXXXXXXX,0,10,0
31017,13,0,13,85,502,0,0,516,352,164,GXXXXXXXXXXXXXXXXXXXGXXXXXXXXXXXXXXXXXXXGXXXXXXXXXXXXXXXXXXXGXXXXXXXXXXXXXXXXXXXGXXXXXXXXXXXXXXXXXXXGXXXXXXXXXXXXXXXXXXXGXXXXXXXXXXXXXXXXXXXGXXXXXXXXXXXXXXXXXXXGXXXXXXXXXXXXXXXXXXXGXXXXXXXXXXXXXXXXXXXGXXXXXXXXXXXXXXXXXXXGXXXXXXXXXXXXXXXXXXXGXXXXXXXXXXXXXXXXXXX,0,10,0
31038,13,0,13,86,501,0,0,514,349,165,GXXXXXXXXXXXXXXXXXXXGXXXXXXXXXXXXXXXXXXXGXXXXXXXXXXXXXXXXXXXGXXXXXXXXXXXXXXXXXXXGXXXXXXXXXXXXXXXXXXXGXXXXXXXXXXXXXXXXXXXGXXXXXXXXXXXXXXXXXXXGXXXXXXXXXXXXXXXXXXXGXXXXXXXXXXXXXXXXXXXGXXXXXXXXXXXXXXXXXXXGXXXXXXXXXXXXXXXXXXXGXXXXXXXXXXXXXXXXXXXGXXXXXXXXXXXXXXXXXXX,0,10,0
31059,13,0,13,83,504,0,0,517,358,159,GXXXXXXXXXXXXXXXXXXXGXXXXXXXXXXXXXXXXXXXGXXXXXXXXXXXXXXXXXXXGXXXXXXXXXXXXXXXXXXXGXXXXXXXXXXXXXXXXXXXGXXXXXXXXXXXXXXXXXXXGXXXXXXXXXXXXXXXXXXXGXXXXXXXXXXXXXXXXXXXGXXXXXXXXXXXXXXXXXXXGXXXXXXXXXXXXXXXXXXXGXXXXXXXXXXXXXXXXXXXGXXXXXXXXXXXXXXXXXXXGXXXXXXXXXXXXXXXXXXX,0,10,0

31080,13,0,13,85,502,0,0,516,354,162,GXXXXXXXXXXXXXXXXXXXGXXXXXXXXXXXXXXXXXXXGXXXXXXXXXXXXXXXXXXXGXXXXXXXXXXXXXXXXXXXGXXXXXXXXXXXXXXXXXXXGXXXXXXXXXXXXXXXXXXXGXXXXXXXXXXXXXXXXXXXGXXXXXXXXXXXXXXXXXXXGXXXXXXXXXXXXXXXXXXXGXXXXXXXXXXXXXXXXXXXGXXXXXXXXXXXXXXXXXXXGXXXXXXXXXXXXXXXXXXXGXXXXXXXXXXXXXXXXXXX,0,10,0
31101,13,0,13,84,503,0,0,516,353,163,GXXXXXXXXXXXXXXXXXXXGXXXXXXXXXXXXXXXXXXXGXXXXXXXXXXXXXXXXXXXGXXXXXXXXXXXXXXXXXXXGXXXXXXXXXXXXXXXXXXXGXXXXXXXXXXXXXXXXXXXGXXXXXXXXXXXXXXXXXXXGXXXXXXXXXXXXXXXXXXXGXXXXXXXXXXXXXXXXXXXGXXXXXXXXXXXXXXXXXXXGXXXXXXXXXXXXXXXXXXXGXXXXXXXXXXXXXXXXXXXGXXXXXXXXXXXXXXXXXXX,0,10,0
31122,13,0,13,80,507,0,0,520,353,167,GXXXXXXXXXXXXXXXXXXXGXXXXXXXXXXXXXXXXXXXGXXXXXXXXXXXXXXXXXXXGXXXXXXXXXXXXXXXXXXXGXXXXXXXXXXXXXXXXXXXGXXXXXXXXXXXXXXXXXXXGXXXXXXXXXXXXXXXXXXXGXXXXXXXXXXXXXXXXXXXGXXXXXXXXXXXXXXXXXXXGXXXXXXXXXXXXXXXXXXXGXXXXXXXXXXXXXXXXXXXGXXXXXXXXXXXXXXXXXXXGXXXXXXXXXXXXXXXXXXX,0,10,0
31143,13,0,13,82,505,0,0,519,352,167,GXXXXXXXXXXXXXXXXXXXGXXXXXXXXXXXXXXXXXXXGXXXXXXXXXXXXXXXXXXXGXXXXXXXXXXXXXXXXXXXGXXXXXXXXXXXXXXXXXXXGXXXXXXXXXXXXXXXXXXXGXXXXXXXXXXXXXXXXXXXGXXXXXXXXXXXXXXXXXXXGXXXXXXXXXXXXXXXXXXXGXXXXXXXXXXXXXXXXXXXGXXXXXXXXXXXXXXXXXXXGXXXXXXXXXXXXXXXXXXXGXXXXXXXXXXXXXXXXXXX,0,10,0
31164,13,0,13,86,501,0,0,515,354,161,GXXXXXXXXXXXXXXXXXXXGXXXXXXXXXXXXXXXXXXXGXXXXXXXXXXXXXXXXXXXGXXXXXXXXXXXXXXXXXXXGXXXXXXXXXXXXXXXXXXXGXXXXXXXXXXXXXXXXXXXGXXXXXXXXXXXXXXXXXXXGXXXXXXXXXXXXXXXXXXXGXXXXXXXXXXXXXXXXXXXGXXXXXXXXXXXXXXXXXXXGXXXXXXXXXXXXXXXXXXXGXXXXXXXXXXXXXXXXXXXGXXXXXXXXXXXXXXXXXXX,0,10,0

31185,13,0,13,85,502,0,0,516,355,161,GXXXXXXXXXXXXXXXXXXXGXXXXXXXXXXXXXXXXXXXGXXXXXXXXXXXXXXXXXXXGXXXXXXXXXXXXXXXXXXXGXXXXXXXXXXXXXXXXXXXGXXXXXXXXXXXXXXXXXXXGXXXXXXXXXXXXXXXXXXXGXXXXXXXXXXXXXXXXXXXGXXXXXXXXXXXXXXXXXXXGXXXXXXXXXXXXXXXXXXXGXXXXXXXXXXXXXXXXXXXGXXXXXXXXXXXXXXXXXXXGXXXXXXXXXXXXXXXXXXX,0,10,0
31206,14,1,13,86,500,0,0,514,355,159,GXXXXXXXXXXXXXXXXXXXGXXXXXXXXXXXXXXXXXXXGXXXXXXXXXXXXXXXXXXXGXXXXXXXXXXXXXXXXXXXGXXXXXXXXXXXXXXXXXXXGXXXXXXXXXXXXXXXXXXXGXXXXXXXXXXXXXXXXXXXGXXXXXXXXXXXXXXXXXXXGAXXXXXXXXXXXXXXXXXXGXXXXXXXXXXXXXXXXXXXGXXXXXXXXXXXXXXXXXXXGXXXXXXXXXXXXXXXXXXXGXXXXXXXXXXXXXXXXXXX,0,10,0
31227,14,1,13,92,494,0,0,509,354,155,GXXXXXXXXXXXXXXXXXXXGXXXXXXXXXXXXXXXXXXXGXXXXXXXXXXXXXXXXXXXGXXXXXXXXXXXXXXXXXXXGXXXXXXXXXXXXXXXXXXXGXXXXXXXXXXXXXXXXXXXGXXXXXXXXXXXXXXXXXXXGXXXXXXXXXXXXXXXXXXXGAXXXXXXXXXXXXXXXXXXGXXXXXXXXXXXXXXXXXXXGXXXXXXXXXXXXXXXXXXXGXXXXXXXXXXXXXXXXXXXGXXXXXXXXXXXXXXXXXXX,0,10,0
31248,14,1,13,97,489,0,0,504,356,148,GXXXXXXXXXXXXXXXXXXXGXXXXXXXXXXXXXXXXXXXGXXXXXXXXXXXXXXXXXXXGXXXXXXXXXXXXXXXXXXXGXXXXXXXXXXXXXXXXXXXGXXXXXXXXXXXXXXXXXXXGXXXXXXXXXXXXXXXXXXXGXXXXXXXXXXXXXXXXXXXGAXXXXXXXXXXXXXXXXXXGXXXXXXXXXXXXXXXXXXXGXXXXXXXXXXXXXXXXXXXGXXXXXXXXXXXXXXXXXXXGXXXXXXXXXXXXXXXXXXX,0,10,0
31269,14,1,13,90,496,0,0,512,357,155,GXXXXXXXXXXXXXXXXXXXGXXXXXXXXXXXXXXXXXXXGXXXXXXXXXXXXXXXXXXXGXXXXXXXXXXXXXXXXXXXGXXXXXXXXXXXXXXXXXXXGXXXXXXXXXXXXXXXXXXXGXXXXXXXXXXXXXXXXXXXGXXXXXXXXXXXXXXXXXXXGAXXXXXXXXXXXXXXXXXXGXXXXXXXXXXXXXXXXXXXGXXXXXXXXXXXXXXXXXXXGXXXXXXXXXXXXXXXXXXXGXXXXXXXXXXXXXXXXXXX,0,10,0

31290,14,1,13,97,489,0,0,505,351,154,GXXXXXXXXXXXXXXXXXXXGXXXXXXXXXXXXXXXXXXXGXXXXXXXXXXXXXXXXXXXGXXXXXXXXXXXXXXXXXXXGXXXXXXXXXXXXXXXXXXXGXXXXXXXXXXXXXXXXXXXGXXXXXXXXXXXXXXXXXXXGXXXXXXXXXXXXXXXXXXXGAXXXXXXXXXXXXXXXXXXGXXXXXXXXXXXXXXXXXXXGXXXXXXXXXXXXXXXXXXXGXXXXXXXXXXXXXXXXXXXGXXXXXXXXXXXXXXXXXXX,0,10,0
31311,14,1,13,91,495,0,0,509,354,155,GXXXXXXXXXXXXXXXXXXXGXXXXXXXXXXXXXXXXXXXGXXXXXXXXXXXXXXXXXXXGXXXXXXXXXXXXXXXXXXXGXXXXXXXXXXXXXXXXXXXGXXXXXXXXXXXXXXXXXXXGXXXXXXXXXXXXXXXXXXXGXXXXXXXXXXXXXXXXXXXGAXXXXXXXXXXXXXXXXXXGXXXXXXXXXXXXXXXXXXXGXXXXXXXXXXXXXXXXXXXGXXXXXXXXXXXXXXXXXXXGXXXXXXXXXXXXXXXXXXX,0,10,0
31332,15,2,13,90,495,0,0,509,357,152,GXXXXXXXXXXXXXXXXXXXGXXXXXXXXXXXXXXXXXXXGAXXXXXXXXXXXXXXXXXXGXXXXXXXXXXXXXXXXXXXGXXXXXXXXXXXXXXXXXXXGXXXXXXXXXXXXXXXXXXXGXXXXXXXXXXXXXXXXXXXGXXXXXXXXXXXXXXXXXXXGAXXXXXXXXXXXXXXXXXXGXXXXXXXXXXXXXXXXXXXGXXXXXXXXXXXXXXXXXXXGXXXXXXXXXXXXXXXXXXXGXXXXXXXXXXXXXXXXXXX,0,10,0
31353,14,1,13,93,493,0,0,506,353,153,GXXXXXXXXXXXXXXXXXXXGXXXXXXXXXXXXXXXXXXXGAXXXXXXXXXXXXXXXXXXGXXXXXXXXXXXXXXXXXXXGXXXXXXXXXXXXXXXXXXXGXXXXXXXXXXXXXXXXXXXGXXXXXXXXXXXXXXXXXXXGXXXXXXXXXXXXXXXXXXXGXXXXXXXXXXXXXXXXXXXGXXXXXXXXXXXXXXXXXXXGXXXXXXXXXXXXXXXXXXXGXXXXXXXXXXXXXXXXXXXGXXXXXXXXXXXXXXXXXXX,0,10,0
31374,15,2,13,89,496,0,0,509,354,155,GXXXXXXXXXXXXXXXXXXXGXXXXXXXXXXXXXXXXXXXGAXXXXXXXXXXXXXXXXXXGXXXXXXXXXXXXXXXXXXXGXXXXXXXXXXXXXXXXXXXGXXXXXXXXXXXXXXXXXXXGXXXXXXXXXXXXXXXXXXXGXXXXXXXXXXXXXXXXXXXGAXXXXXXXXXXXXXXXXXXGXXXXXXXXXXXXXXXXXXXGXXXXXXXXXXXXXXXXXXXGXXXXXXXXXXXXXXXXXXXGXXXXXXXXXXXXXXXXXXX,0,10,0

31395,15,2,13,87,498,0,0,512,354,158,GXXXXXXXXXXXXXXXXXXXGXXXXXXXXXXXXXXXXXXXGAXXXXXXXXXXXXXXXXXXGXXXXXXXXXXXXXXXXXXXGXXXXXXXXXXXXXXXXXXXGXXXXXXXXXXXXXXXXXXXGXXXXXXXXXXXXXXXXXXXGXXXXXXXXXXXXXXXXXXXGAXXXXXXXXXXXXXXXXXXGXXXXXXXXXXXXXXXXXXXGXXXXXXXXXXXXXXXXXXXGXXXXXXXXXXXXXXXXXXXGXXXXXXXXXXXXXXXXXXX,0,10,0
31416,15,2,13,82,503,0,0,517,354,163,GXXXXXXXXXXXXXXXXXXXGXXXXXXXXXXXXXXXXXXXGAXXXXXXXXXXXXXXXXXXGXXXXXXXXXXXXXXXXXXXGXXXXXXXXXXXXXXXXXXXGXXXXXXXXXXXXXXXXXXXGXXXXXXXXXXXXXXXXXXXGXXXXXXXXXXXXXXXXXXXGAXXXXXXXXXXXXXXXXXXGXXXXXXXXXXXXXXXXXXXGXXXXXXXXXXXXXXXXXXXGXXXXXXXXXXXXXXXXXXXGXXXXXXXXXXXXXXXXXXX,0,10,0
31437,15,2,13,84,501,0,0,515,355,160,GXXXXXXXXXXXXXXXXXXXGXXXXXXXXXXXXXXXXXXXGAXXXXXXXXXXXXXXXXXXGXXXXXXXXXXXXXXXXXXXGXXXXXXXXXXXXXXXXXXXGXXXXXXXXXXXXXXXXXXXGXXXXXXXXXXXXXXXXXXXGXXXXXXXXXXXXXXXXXXXGAXXXXXXXXXXXXXXXXXXGXXXXXXXXXXXXXXXXXXXGXXXXXXXXXXXXXXXXXXXGXXXXXXXXXXXXXXXXXXXGXXXXXXXXXXXXXXXXXXX,0,10,0
31458,15,2,13,83,502,0,0,517,355,162,GXXXXXXXXXXXXXXXXXXXGXXXXXXXXXXXXXXXXXXXGAXXXXXXXXXXXXXXXXXXGXXXXXXXXXXXXXXXXXXXGXXXXXXXXXXXXXXXXXXXGXXXXXXXXXXXXXXXXXXXGXXXXXXXXXXXXXXXXXXXGXXXXXXXXXXXXXXXXXXXGAXXXXXXXXXXXXXXXXXXGXXXXXXXXXXXXXXXXXXXGXXXXXXXXXXXXXXXXXXXGXXXXXXXXXXXXXXXXXXXGXXXXXXXXXXXXXXXXXXX,0,10,0
31479,15,2,13,84,501,0,0,513,356,157,GXXXXXXXXXXXXXXXXXXXGXXXXXXXXXXXXXXXXXXXGAXXXXXXXXXXXXXXXXXXGXXXXXXXXXXXXXXXXXXXGXXXXXXXXXXXXXXXXXXXGXXXXXXXXXXXXXXXXXXXGXXXXXXXXXXXXXXXXXXXGXXXXXXXXXXXXXXXXXXXGAXXXXXXXXXXXXXXXXXXGXXXXXXXXXXXXXXXXXXXGXXXXXXXXXXXXXXXXXXXGXXXXXXXXXXXXXXXXXXXGXXXXXXXXXXXXXXXXXXX,0,10,0

31500,15,2,13,90,495,0,0,508,358,150,GXXXXXXXXXXXXXXXXXXXGXXXXXXXXXXXXXXXXXXXGAXXXXXXXXXXXXXXXXXXGXXXXXXXXXXXXXXXXXXXGXXXXXXXXXXXXXXXXXXXGXXXXXXXXXXXXXXXXXXXGXXXXXXXXXXXXXXXXXXXGXXXXXXXXXXXXXXXXXXXGAXXXXXXXXXXXXXXXXXXGXXXXXXXXXXXXXXXXXXXGXXXXXXXXXXXXXXXXXXXGXXXXXXXXXXXXXXXXXXXGXXXXXXXXXXXXXXXXXXX,0,10,0
31521,15,2,13,88,497,0,0,510,358,152,GXXXXXXXXXXXXXXXXXXXGXXXXXXXXXXXXXXXXXXXGAXXXXXXXXXXXXXXXXXXGXXXXXXXXXXXXXXXXXXXGXXXXXXXXXXXXXXXXXXXGXXXXXXXXXXXXXXXXXXXGXXXXXXXXXXXXXXXXXXXGXXXXXXXXXXXXXXXXXXXGAXXXXXXXXXXXXXXXXXXGXXXXXXXXXXXXXXXXXXXGXXXXXXXXXXXXXXXXXXXGXXXXXXXXXXXXXXXXXXXGXXXXXXXXXXXXXXXXXXX,0,10,0
31542,15,1,14,92,493,0,0,506,356,150,GXXXXXXXXXXXXXXXXXXXGXXXXXXXXXXXXXXXXXXXGOXXXXXXXXXXXXXXXXXXGXXXXXXXXXXXXXXXXXXXGXXXXXXXXXXXXXXXXXXXGXXXXXXXXXXXXXXXXXXXGXXXXXXXXXXXXXXXXXXXGXXXXXXXXXXXXXXXXXXXGAXXXXXXXXXXXXXXXXXXGXXXXXXXXXXXXXXXXXXXGXXXXXXXXXXXXXXXXXXXGXXXXXXXXXXXXXXXXXXXGXXXXXXXXXXXXXXXXXXX,0,10,0
31563,14,1,13,99,487,0,0,500,353,147,GXXXXXXXXXXXXXXXXXXXGXXXXXXXXXXXXXXXXXXXGXXXXXXXXXXXXXXXXXXXGXXXXXXXXXXXXXXXXXXXGXXXXXXXXXXXXXXXXXXXGXXXXXXXXXXXXXXXXXXXGXXXXXXXXXXXXXXXXXXXGXXXXXXXXXXXXXXXXXXXGAXXXXXXXXXXXXXXXXXXGXXXXXXXXXXXXXXXXXXXGXXXXXXXXXXXXXXXXXXXGXXXXXXXXXXXXXXXXXXXGXXXXXXXXXXXXXXXXXXX,0,10,0
31584,14,1,13,97,489,0,0,502,352,150,GXXXXXXXXXXXXXXXXXXXGXXXXXXXXXXXXXXXXXXXGXXXXXXXXXXXXXXXXXXXGXXXXXXXXXXXXXXXXXXXGXXXXXXXXXXXXXXXXXXXGXXXXXXXXXXXXXXXXXXXGXXXXXXXXXXXXXXXXXXXGXXXXXXXXXXXXXXXXXXXGAXXXXXXXXXXXXXXXXXXGXXXXXXXXXXXXXXXXXXXGXXXXXXXXXXXXXXXXXXXGXXXXXXXXXXXXXXXXXXXGXXXXXXXXXXXXXXXXXXX,0,10,0

31605,14,1,13,101,485,0,0,500,350,150,GXXXXXXXXXXXXXXXXXXXGXXXXXXXXXXXXXXXXXXXGXXXXXXXXXXXXXXXXXXXGXXXXXXXXXXXXXXXXXXXGXXXXXXXXXXXXXXXXXXXGXXXXXXXXXXXXXXXXXXXGXXXXXXXXXXXXXXXXXXXGXXXXXXXXXXXXXXXXXXXGAXXXXXXXXXXXXXXXXXXGXXXXXXXXXXXXXXXXXXXGXXXXXXXXXXXXXXXXXXXGXXXXXXXXXXXXXXXXXXXGXXXXXXXXXXXXXXXXXXX,0,10,0
31626,14,1,13,97,489,0,0,504,351,153,GXXXXXXXXXXXXXXXXXXXGXXXXXXXXXXXXXXXXXXXGXXXXXXXXXXXXXXXXXXXGXXXXXXXXXXXXXXXXXXXGXXXXXXXXXXXXXXXXXXXGXXXXXXXXXXXXXXXXXXXGXXXXXXXXXXXXXXXXXXXGXXXXXXXXXXXXXXXXXXXGAXXXXXXXXXXXXXXXXXXGXXXXXXXXXXXXXXXXXXXGXXXXXXXXXXXXXXXXXXXGXXXXXXXXXXXXXXXXXXXGXXXXXXXXXXXXXXXXXXX,0,10,0
31647,14,1,13,99,487,0,0,503,356,147,GXXXXXXXXXXXXXXXXXXXGXXXXXXXXXXXXXXXXXXXGXXXXXXXXXXXXXXXXXXXGXXXXXXXXXXXXXXXXXXXGXXXXXXXXXXXXXXXXXXXGXXXXXXXXXXXXXXXXXXXGXXXXXXXXXXXXXXXXXXXGXXXXXXXXXXXXXXXXXXXGAXXXXXXXXXXXXXXXXXXGXXXXXXXXXXXXXXXXXXXGXXXXXXXXXXXXXXXXXXXGXXXXXXXXXXXXXXXXXXXGXXXXXXXXXXXXXXXXXXX,0,10,0
31668,14,1,13,88,498,0,0,512,353,159,GXXXXXXXXXXXXXXXXXXXGXXXXXXXXXXXXXXXXXXXGXXXXXXXXXXXXXXXXXXXGXXXXXXXXXXXXXXXXXXXGXXXXXXXXXXXXXXXXXXXGXXXXXXXXXXXXXXXXXXXGXXXXXXXXXXXXXXXXXXXGXXXXXXXXXXXXXXXXXXXGAXXXXXXXXXXXXXXXXXXGXXXXXXXXXXXXXXXXXXXGXXXXXXXXXXXXXXXXXXXGXXXXXXXXXXXXXXXXXXXGXXXXXXXXXXXXXXXXXXX,0,10,0
31689,14,1,13,90,496,0,0,512,353,159,GXXXXXXXXXXXXXXXXXXXGXXXXXXXXXXXXXXXXXXXGXXXXXXXXXXXXXXXXXXXGXXXXXXXXXXXXXXXXXXXGXXXXXXXXXXXXXXXXXXXGXXXXXXXXXXXXXXXXXXXGXXXXXXXXXXXXXXXXXXXGXXXXXXXXXXXXXXXXXXXGAXXXXXXXXXXXXXXXXXXGXXXXXXXXXXXXXXXXXXXGXXXXXXXXXXXXXXXXXXXGXXXXXXXXXXXXXXXXXXXGXXXXXXXXXXXXXXXXXXX,0,10,0

31710,14,1,13,90,496,0,0,511,350,161,GXXXXXXXXXXXXXXXXXXXGXXXXXXXXXXXXXXXXXXXGXXXXXXXXXXXXXXXXXXXGXXXXXXXXXXXXXXXXXXXGXXXXXXXXXXXXXXXXXXXGXXXXXXXXXXXXXXXXXXXGXXXXXXXXXXXXXXXXXXXGXXXXXXXXXXXXXXXXXXXGAXXXXXXXXXXXXXXXXXXGXXXXXXXXXXXXXXXXXXXGXXXXXXXXXXXXXXXXXXXGXXXXXXXXXXXXXXXXXXXGXXXXXXXXXXXXXXXXXXX,0,10,0
31731,14,1,13,94,492,0,0,509,353,156,GXXXXXXXXXXXXXXXXXXXGXXXXXXXXXXXXXXXXXXXGXXXXXXXXXXXXXXXXXXXGXXXXXXXXXXXXXXXXXXXGXXXXXXXXXXXXXXXXXXXGXXXXXXXXXXXXXXXXXXXGXXXXXXXXXXXXXXXXXXXGXXXXXXXXXXXXXXXXXXXGAXXXXXXXXXXXXXXXXXXGXXXXXXXXXXXXXXXXXXXGXXXXXXXXXXXXXXXXXXXGXXXXXXXXXXXXXXXXXXXGXXXXXXXXXXXXXXXXXXX,0,10,0
31752,15,2,13,93,492,0,0,508,351,157,GXXXXXXXXXXXXXXXXXXXGXXXXXXXXXXXXXXXXXXXGXXXXXXXXXXXXXXXXXXXGXXXXXXXXXXXXXXXXXXXGXXXXXXXXXXXXXXXXXXXGXXXXXXXXXXXXXXXXXXXGXXXXXXXXXXXXXXXXXXXGXXXXXXXXXXXXXXXXXXXGAAXXXXXXXXXXXXXXXXXGXXXXXXXXXXXXXXXXXXXGXXXXXXXXXXXXXXXXXXXGXXXXXXXXXXXXXXXXXXXGXXXXXXXXXXXXXXXXXXX,0,10,0
31773,15,2,13,91,494,0,0,507,350,157,GXXXXXXXXXXXXXXXXXXXGXXXXXXXXXXXXXXXXXXXGXXXXXXXXXXXXXXXXXXXGXXXXXXXXXXXXXXXXXXXGXXXXXXXXXXXXXXXXXXXGXXXXXXXXXXXXXXXXXXXGXXXXXXXXXXXXXXXXXXXGXXXXXXXXXXXXXXXXXXXGAAXXXXXXXXXXXXXXXXXGXXXXXXXXXXXXXXXXXXXGXXXXXXXXXXXXXXXXXXXGXXXXXXXXXXXXXXXXXXXGXXXXXXXXXXXXXXXXXXX,0,10,0
31794,13,0,13,87,500,0,0,513,357,156,GXXXXXXXXXXXXXXXXXXXGXXXXXXXXXXXXXXXXXXXGXXXXXXXXXXXXXXXXXXXGXXXXXXXXXXXXXXXXXXXGXXXXXXXXXXXXXXXXXXXGXXXXXXXXXXXXXXXXXXXGXXXXXXXXXXXXXXXXXXXGXXXXXXXXXXXXXXXXXXXGXXXXXXXXXXXXXXXXXXXGXXXXXXXXXXXXXXXXXXXGXXXXXXXXXXXXXXXXXXXGXXXXXXXXXXXXXXXXXXXGXXXXXXXXXXXXXXXXXXX,0,10,0

31815,13,0,13,77,510,0,0,524,358,166,GXXXXXXXXXXXXXXXXXXXGXXXXXXXXXXXXXXXXXXXGXXXXXXXXXXXXXXXXXXXGXXXXXXXXXXXXXXXXXXXGXXXXXXXXXXXXXXXXXXXGXXXXXXXXXXXXXXXXXXXGXXXXXXXXXXXXXXXXXXXGXXXXXXXXXXXXXXXXXXXGXXXXXXXXXXXXXXXXXXXGXXXXXXXXXXXXXXXXXXXGXXXXXXXXXXXXXXXXXXXGXXXXXXXXXXXXXXXXXXXGXXXXXXXXXXXXXXXXXXX,0,10,0
31836,13,0,13,77,510,0,0,524,358,166,GXXXXXXXXXXXXXXXXXXXGXXXXXXXXXXXXXXXXXXXGXXXXXXXXXXXXXXXXXXXGXXXXXXXXXXXXXXXXXXXGXXXXXXXXXXXXXXXXXXXGXXXXXXXXXXXXXXXXXXXGXXXXXXXXXXXXXXXXXXXGXXXXXXXXXXXXXXXXXXXGXXXXXXXXXXXXXXXXXXXGXXXXXXXXXXXXXXXXXXXGXXXXXXXXXXXXXXXXXXXGXXXXXXXXXXXXXXXXXXXGXXXXXXXXXXXXXXXXXXX,0,10,0
31857,13,0,13,85,502,0,0,516,354,162,GXXXXXXXXXXXXXXXXXXXGXXXXXXXXXXXXXXXXXXXGXXXXXXXXXXXXXXXXXXXGXXXXXXXXXXXXXXXXXXXGXXXXXXXXXXXXXXXXXXXGXXXXXXXXXXXXXXXXXXXGXXXXXXXXXXXXXXXXXXXGXXXXXXXXXXXXXXXXXXXGXXXXXXXXXXXXXXXXXXXGXXXXXXXXXXXXXXXXXXXGXXXXXXXXXXXXXXXXXXXGXXXXXXXXXXXXXXXXXXXGXXXXXXXXXXXXXXXXXXX,0,10,0
31878,15,1,14,83,502,0,0,513,359,154,GXXXXXXXXXXXXXXXXXXXGXXXXXXXXXXXXXXXXXXXGXXXXXXXXXXXXXXXXXXXGXXXXXXXXXXXXXXXXXXXGOXXXXXXXXXXXXXXXXXXGXXXXXXXXXXXXXXXXXXXGXXXXXXXXXXXXXXXXXXXGAXXXXXXXXXXXXXXXXXXGXXXXXXXXXXXXXXXXXXXGXXXXXXXXXXXXXXXXXXXGXXXXXXXXXXXXXXXXXXXGXXXXXXXXXXXXXXXXXXXGXXXXXXXXXXXXXXXXXXX,0,10,0
31899,15,1,14,87,498,0,0,511,356,155,GXXXXXXXXXXXXXXXXXXXGXXXXXXXXXXXXXXXXXXXGXXXXXXXXXXXXXXXXXXXGXXXXXXXXXXXXXXXXXXXGOXXXXXXXXXXXXXXXXXXGXXXXXXXXXXXXXXXXXXXGXXXXXXXXXXXXXXXXXXXGAXXXXXXXXXXXXXXXXXXGXXXXXXXXXXXXXXXXXXXGXXXXXXXXXXXXXXXXXXXGXXXXXXXXXXXXXXXXXXXGXXXXXXXXXXXXXXXXXXXGXXXXXXXXXXXXXXXXXXX,0,10,0

31920,14,1,13,92,494,0,0,508,357,151,GXXXXXXXXXXXXXXXXXXXGXXXXXXXXXXXXXXXXXXXGXXXXXXXXXXXXXXXXXXXGXXXXXXXXXXXXXXXXXXXGXXXXXXXXXXXXXXXXXXXGXXXXXXXXXXXXXXXXXXXGXXXXXXXXXXXXXXXXXXXGAXXXXXXXXXXXXXXXXXXGXXXXXXXXXXXXXXXXXXXGXXXXXXXXXXXXXXXXXXXGXXXXXXXXXXXXXXXXXXXGXXXXXXXXXXXXXXXXXXXGXXXXXXXXXXXXXXXXXXX,0,10,0
31941,14,1,13,96,490,0,0,504,353,151,GXXXXXXXXXXXXXXXXXXXGXXXXXXXXXXXXXXXXXXXGXXXXXXXXXXXXXXXXXXXGXXXXXXXXXXXXXXXXXXXGXXXXXXXXXXXXXXXXXXXGXXXXXXXXXXXXXXXXXXXGXXXXXXXXXXXXXXXXXXXGAXXXXXXXXXXXXXXXXXXGXXXXXXXXXXXXXXXXXXXGXXXXXXXXXXXXXXXXXXXGXXXXXXXXXXXXXXXXXXXGXXXXXXXXXXXXXXXXXXXGXXXXXXXXXXXXXXXXXXX,0,10,0
31962,14,1,13,90,496,0,0,510,358,152,GXXXXXXXXXXXXXXXXXXXGXXXXXXXXXXXXXXXXXXXGXXXXXXXXXXXXXXXXXXXGXXXXXXXXXXXXXXXXXXXGXXXXXXXXXXXXXXXXXXXGXXXXXXXXXXXXXXXXXXXGXXXXXXXXXXXXXXXXXXXGAXXXXXXXXXXXXXXXXXXGXXXXXXXXXXXXXXXXXXXGXXXXXXXXXXXXXXXXXXXGXXXXXXXXXXXXXXXXXXXGXXXXXXXXXXXXXXXXXXXGXXXXXXXXXXXXXXXXXXX,0,10,0
31983,14,1,13,87,499,0,0,514,358,156,GXXXXXXXXXXXXXXXXXXXGXXXXXXXXXXXXXXXXXXXGXXXXXXXXXXXXXXXXXXXGXXXXXXXXXXXXXXXXXXXGXXXXXXXXXXXXXXXXXXXGXXXXXXXXXXXXXXXXXXXGXXXXXXXXXXXXXXXXXXXGAXXXXXXXXXXXXXXXXXXGXXXXXXXXXXXXXXXXXXXGXXXXXXXXXXXXXXXXXXXGXXXXXXXXXXXXXXXXXXXGXXXXXXXXXXXXXXXXXXXGXXXXXXXXXXXXXXXXXXX,0,10,0
32004,13,0,13,83,504,0,0,518,357,161,GXXXXXXXXXXXXXXXXXXXGXXXXXXXXXXXXXXXXXXXGXXXXXXXXXXXXXXXXXXXGXXXXXXXXXXXXXXXXXXXGXXXXXXXXXXXXXXXXXXXGXXXXXXXXXXXXXXXXXXXGXXXXXXXXXXXXXXXXXXXGXXXXXXXXXXXXXXXXXXXGXXXXXXXXXXXXXXXXXXXGXXXXXXXXXXXXXXXXXXXGXXXXXXXXXXXXXXXXXXXGXXXXXXXXXXXXXXXXXXXGXXXXXXXXXXXXXXXXXXX,0,10,0

32025,13,0,13,80,507,0,0,520,357,163,GXXXXXXXXXXXXXXXXXXXGXXXXXXXXXXXXXXXXXXXGXXXXXXXXXXXXXXXXXXXGXXXXXXXXXXXXXXXXXXXGXXXXXXXXXXXXXXXXXXXGXXXXXXXXXXXXXXXXXXXGXXXXXXXXXXXXXXXXXXXGXXXXXXXXXXXXXXXXXXXGXXXXXXXXXXXXXXXXXXXGXXXXXXXXXXXXXXXXXXXGXXXXXXXXXXXXXXXXXXXGXXXXXXXXXXXXXXXXXXXGXXXXXXXXXXXXXXXXXXX,0,10,0
32046,13,0,13,83,504,0,0,518,356,162,GXXXXXXXXXXXXXXXXXXXGXXXXXXXXXXXXXXXXXXXGXXXXXXXXXXXXXXXXXXXGXXXXXXXXXXXXXXXXXXXGXXXXXXXXXXXXXXXXXXXGXXXXXXXXXXXXXXXXXXXGXXXXXXXXXXXXXXXXXXXGXXXXXXXXXXXXXXXXXXXGXXXXXXXXXXXXXXXXXXXGXXXXXXXXXXXXXXXXXXXGXXXXXXXXXXXXXXXXXXXGXXXXXXXXXXXXXXXXXXXGXXXXXXXXXXXXXXXXXXX,0,10,0
32067,13,0,13,86,501,0,0,515,361,154,GXXXXXXXXXXXXXXXXXXXGXXXXXXXXXXXXXXXXXXXGXXXXXXXXXXXXXXXXXXXGXXXXXXXXXXXXXXXXXXXGXXXXXXXXXXXXXXXXXXXGXXXXXXXXXXXXXXXXXXXGXXXXXXXXXXXXXXXXXXXGXXXXXXXXXXXXXXXXXXXGXXXXXXXXXXXXXXXXXXXGXXXXXXXXXXXXXXXXXXXGXXXXXXXXXXXXXXXXXXXGXXXXXXXXXXXXXXXXXXXGXXXXXXXXXXXXXXXXXXX,0,10,0
32088,13,0,13,90,497,0,0,512,357,155,GXXXXXXXXXXXXXXXXXXXGXXXXXXXXXXXXXXXXXXXGXXXXXXXXXXXXXXXXXXXGXXXXXXXXXXXXXXXXXXXGXXXXXXXXXXXXXXXXXXXGXXXXXXXXXXXXXXXXXXXGXXXXXXXXXXXXXXXXXXXGXXXXXXXXXXXXXXXXXXXGXXXXXXXXXXXXXXXXXXXGXXXXXXXXXXXXXXXXXXXGXXXXXXXXXXXXXXXXXXXGXXXXXXXXXXXXXXXXXXXGXXXXXXXXXXXXXXXXXXX,0,10,0
32109,13,0,13,90,497,0,0,512,361,151,GXXXXXXXXXXXXXXXXXXXGXXXXXXXXXXXXXXXXXXXGXXXXXXXXXXXXXXXXXXXGXXXXXXXXXXXXXXXXXXXGXXXXXXXXXXXXXXXXXXXGXXXXXXXXXXXXXXXXXXXGXXXXXXXXXXXXXXXXXXXGXXXXXXXXXXXXXXXXXXXGXXXXXXXXXXXXXXXXXXXGXXXXXXXXXXXXXXXXXXXGXXXXXXXXXXXXXXXXXXXGXXXXXXXXXXXXXXXXXXXGXXXXXXXXXXXXXXXXXXX,0,10,0

32130,13,0,13,83,504,0,0,518,360,158,GXXXXXXXXXXXXXXXXXXXGXXXXXXXXXXXXXXXXXXXGXXXXXXXXXXXXXXXXXXXGXXXXXXXXXXXXXXXXXXXGXXXXXXXXXXXXXXXXXXXGXXXXXXXXXXXXXXXXXXXGXXXXXXXXXXXXXXXXXXXGXXXXXXXXXXXXXXXXXXXGXXXXXXXXXXXXXXXXXXXGXXXXXXXXXXXXXXXXXXXGXXXXXXXXXXXXXXXXXXXGXXXXXXXXXXXXXXXXXXXGXXXXXXXXXXXXXXXXXXX,0,10,0
32151,13,0,13,82,505,0,0,519,362,157,GXXXXXXXXXXXXXXXXXXXGXXXXXXXXXXXXXXXXXXXGXXXXXXXXXXXXXXXXXXXGXXXXXXXXXXXXXXXXXXXGXXXXXXXXXXXXXXXXXXXGXXXXXXXXXXXXXXXXXXXGXXXXXXXXXXXXXXXXXXXGXXXXXXXXXXXXXXXXXXXGXXXXXXXXXXXXXXXXXXXGXXXXXXXXXXXXXXXXXXXGXXXXXXXXXXXXXXXXXXXGXXXXXXXXXXXXXXXXXXXGXXXXXXXXXXXXXXXXXXX,0,10,0
32172,13,0,13,80,507,0,0,520,358,162,GXXXXXXXXXXXXXXXXXXXGXXXXXXXXXXXXXXXXXXXGXXXXXXXXXXXXXXXXXXXGXXXXXXXXXXXXXXXXXXXGXXXXXXXXXXXXXXXXXXXGXXXXXXXXXXXXXXXXXXXGXXXXXXXXXXXXXXXXXXXGXXXXXXXXXXXXXXXXXXXGXXXXXXXXXXXXXXXXXXXGXXXXXXXXXXXXXXXXXXXGXXXXXXXXXXXXXXXXXXXGXXXXXXXXXXXXXXXXXXXGXXXXXXXXXXXXXXXXXXX,0,10,0
32193,13,0,13,79,508,0,0,521,358,163,GXXXXXXXXXXXXXXXXXXXGXXXXXXXXXXXXXXXXXXXGXXXXXXXXXXXXXXXXXXXGXXXXXXXXXXXXXXXXXXXGXXXXXXXXXXXXXXXXXXXGXXXXXXXXXXXXXXXXXXXGXXXXXXXXXXXXXXXXXXXGXXXXXXXXXXXXXXXXXXXGXXXXXXXXXXXXXXXXXXXGXXXXXXXXXXXXXXXXXXXGXXXXXXXXXXXXXXXXXXXGXXXXXXXXXXXXXXXXXXXGXXXXXXXXXXXXXXXXXXX,0,10,0
32214,13,0,13,83,504,0,0,516,356,160,GXXXXXXXXXXXXXXXXXXXGXXXXXXXXXXXXXXXXXXXGXXXXXXXXXXXXXXXXXXXGXXXXXXXXXXXXXXXXXXXGXXXXXXXXXXXXXXXXXXXGXXXXXXXXXXXXXXXXXXXGXXXXXXXXXXXXXXXXXXXGXXXXXXXXXXXXXXXXXXXGXXXXXXXXXXXXXXXXXXXGXXXXXXXXXXXXXXXXXXXGXXXXXXXXXXXXXXXXXXXGXXXXXXXXXXXXXXXXXXXGXXXXXXXXXXXXXXXXXXX,0,10,0

32235,13,0,13,85,502,0,0,516,355,161,GXXXXXXXXXXXXXXXXXXXGXXXXXXXXXXXXXXXXXXXGXXXXXXXXXXXXXXXXXXXGXXXXXXXXXXXXXXXXXXXGXXXXXXXXXXXXXXXXXXXGXXXXXXXXXXXXXXXXXXXGXXXXXXXXXXXXXXXXXXXGXXXXXXXXXXXXXXXXXXXGXXXXXXXXXXXXXXXXXXXGXXXXXXXXXXXXXXXXXXXGXXXXXXXXXXXXXXXXXXXGXXXXXXXXXXXXXXXXXXXGXXXXXXXXXXXXXXXXXXX,0,10,0
32256,13,0,13,85,502,0,0,516,361,155,GXXXXXXXXXXXXXXXXXXXGXXXXXXXXXXXXXXXXXXXGXXXXXXXXXXXXXXXXXXXGXXXXXXXXXXXXXXXXXXXGXXXXXXXXXXXXXXXXXXXGXXXXXXXXXXXXXXXXXXXGXXXXXXXXXXXXXXXXXXXGXXXXXXXXXXXXXXXXXXXGXXXXXXXXXXXXXXXXXXXGXXXXXXXXXXXXXXXXXXXGXXXXXXXXXXXXXXXXXXXGXXXXXXXXXXXXXXXXXXXGXXXXXXXXXXXXXXXXXXX,0,10,0
32277,13,0,13,82,505,0,0,519,359,160,GXXXXXXXXXXXXXXXXXXXGXXXXXXXXXXXXXXXXXXXGXXXXXXXXXXXXXXXXXXXGXXXXXXXXXXXXXXXXXXXGXXXXXXXXXXXXXXXXXXXGXXXXXXXXXXXXXXXXXXXGXXXXXXXXXXXXXXXXXXXGXXXXXXXXXXXXXXXXXXXGXXXXXXXXXXXXXXXXXXXGXXXXXXXXXXXXXXXXXXXGXXXXXXXXXXXXXXXXXXXGXXXXXXXXXXXXXXXXXXXGXXXXXXXXXXXXXXXXXXX,0,10,0
32298,13,0,13,82,505,0,0,520,362,158,GXXXXXXXXXXXXXXXXXXXGXXXXXXXXXXXXXXXXXXXGXXXXXXXXXXXXXXXXXXXGXXXXXXXXXXXXXXXXXXXGXXXXXXXXXXXXXXXXXXXGXXXXXXXXXXXXXXXXXXXGXXXXXXXXXXXXXXXXXXXGXXXXXXXXXXXXXXXXXXXGXXXXXXXXXXXXXXXXXXXGXXXXXXXXXXXXXXXXXXXGXXXXXXXXXXXXXXXXXXXGXXXXXXXXXXXXXXXXXXXGXXXXXXXXXXXXXXXXXXX,0,10,0
32319,13,0,13,87,500,0,0,515,359,156,GXXXXXXXXXXXXXXXXXXXGXXXXXXXXXXXXXXXXXXXGXXXXXXXXXXXXXXXXXXXGXXXXXXXXXXXXXXXXXXXGXXXXXXXXXXXXXXXXXXXGXXXXXXXXXXXXXXXXXXXGXXXXXXXXXXXXXXXXXXXGXXXXXXXXXXXXXXXXXXXGXXXXXXXXXXXXXXXXXXXGXXXXXXXXXXXXXXXXXXXGXXXXXXXXXXXXXXXXXXXGXXXXXXXXXXXXXXXXXXXGXXXXXXXXXXXXXXXXXXX,0,10,0

32340,13,0,13,83,504,0,0,517,359,158,GXXXXXXXXXXXXXXXXXXXGXXXXXXXXXXXXXXXXXXXGXXXXXXXXXXXXXXXXXXXGXXXXXXXXXXXXXXXXXXXGXXXXXXXXXXXXXXXXXXXGXXXXXXXXXXXXXXXXXXXGXXXXXXXXXXXXXXXXXXXGXXXXXXXXXXXXXXXXXXXGXXXXXXXXXXXXXXXXXXXGXXXXXXXXXXXXXXXXXXXGXXXXXXXXXXXXXXXXXXXGXXXXXXXXXXXXXXXXXXXGXXXXXXXXXXXXXXXXXXX,0,10,0
32361,13,0,13,82,505,0,0,519,362,157,GXXXXXXXXXXXXXXXXXXXGXXXXXXXXXXXXXXXXXXXGXXXXXXXXXXXXXXXXXXXGXXXXXXXXXXXXXXXXXXXGXXXXXXXXXXXXXXXXXXXGXXXXXXXXXXXXXXXXXXXGXXXXXXXXXXXXXXXXXXXGXXXXXXXXXXXXXXXXXXXGXXXXXXXXXXXXXXXXXXXGXXXXXXXXXXXXXXXXXXXGXXXXXXXXXXXXXXXXXXXGXXXXXXXXXXXXXXXXXXXGXXXXXXXXXXXXXXXXXXX,0,10,0
32382,13,0,13,80,507,0,0,521,364,157,GXXXXXXXXXXXXXXXXXXXGXXXXXXXXXXXXXXXXXXXGXXXXXXXXXXXXXXXXXXXGXXXXXXXXXXXXXXXXXXXGXXXXXXXXXXXXXXXXXXXGXXXXXXXXXXXXXXXXXXXGXXXXXXXXXXXXXXXXXXXGXXXXXXXXXXXXXXXXXXXGXXXXXXXXXXXXXXXXXXXGXXXXXXXXXXXXXXXXXXXGXXXXXXXXXXXXXXXXXXXGXXXXXXXXXXXXXXXXXXXGXXXXXXXXXXXXXXXXXXX,0,10,0
32403,13,0,13,89,498,0,0,512,368,144,GXXXXXXXXXXXXXXXXXXXGXXXXXXXXXXXXXXXXXXXGXXXXXXXXXXXXXXXXXXXGXXXXXXXXXXXXXXXXXXXGXXXXXXXXXXXXXXXXXXXGXXXXXXXXXXXXXXXXXXXGXXXXXXXXXXXXXXXXXXXGXXXXXXXXXXXXXXXXXXXGXXXXXXXXXXXXXXXXXXXGXXXXXXXXXXXXXXXXXXXGXXXXXXXXXXXXXXXXXXXGXXXXXXXXXXXXXXXXXXXGXXXXXXXXXXXXXXXXXXX,0,10,0
32424,13,0,13,93,494,0,0,507,367,140,GXXXXXXXXXXXXXXXXXXXGXXXXXXXXXXXXXXXXXXXGXXXXXXXXXXXXXXXXXXXGXXXXXXXXXXXXXXXXXXXGXXXXXXXXXXXXXXXXXXXGXXXXXXXXXXXXXXXXXXXGXXXXXXXXXXXXXXXXXXXGXXXXXXXXXXXXXXXXXXXGXXXXXXXXXXXXXXXXXXXGXXXXXXXXXXXXXXXXXXXGXXXXXXXXXXXXXXXXXXXGXXXXXXXXXXXXXXXXXXXGXXXXXXXXXXXXXXXXXXX,0,10,0

32445,13,0,13,100,487,0,0,500,367,133,GXXXXXXXXXXXXXXXXXXXGXXXXXXXXXXXXXXXXXXXGXXXXXXXXXXXXXXXXXXXGXXXXXXXXXXXXXXXXXXXGXXXXXXXXXXXXXXXXXXXGXXXXXXXXXXXXXXXXXXXGXXXXXXXXXXXXXXXXXXXGXXXXXXXXXXXXXXXXXXXGXXXXXXXXXXXXXXXXXXXGXXXXXXXXXXXXXXXXXXXGXXXXXXXXXXXXXXXXXXXGXXXXXXXXXXXXXXXXXXXGXXXXXXXXXXXXXXXXXXX,0,10,0
32466,13,0,13,105,482,0,0,496,363,133,GXXXXXXXXXXXXXXXXXXXGXXXXXXXXXXXXXXXXXXXGXXXXXXXXXXXXXXXXXXXGXXXXXXXXXXXXXXXXXXXGXXXXXXXXXXXXXXXXXXXGXXXXXXXXXXXXXXXXXXXGXXXXXXXXXXXXXXXXXXXGXXXXXXXXXXXXXXXXXXXGXXXXXXXXXXXXXXXXXXXGXXXXXXXXXXXXXXXXXXXGXXXXXXXXXXXXXXXXXXXGXXXXXXXXXXXXXXXXXXXGXXXXXXXXXXXXXXXXXXX,0,10,0
32487,14,1,13,109,477,0,0,491,361,130,GXXXXXXXXXXXXXXXXXXXGXXXXXXXXXXXXXXXXXXXGXXXXXXXXXXXXXXXXXXXGXXXXXXXXXXXXXXXXXXXGXXXXXXXXXXXXXXXXXXXGAXXXXXXXXXXXXXXXXXXGXXXXXXXXXXXXXXXXXXXGXXXXXXXXXXXXXXXXXXXGXXXXXXXXXXXXXXXXXXXGXXXXXXXXXXXXXXXXXXXGXXXXXXXXXXXXXXXXXXXGXXXXXXXXXXXXXXXXXXXGXXXXXXXXXXXXXXXXXXX,0,10,0
32508,13,0,13,104,483,0,0,497,360,137,GXXXXXXXXXXXXXXXXXXXGXXXXXXXXXXXXXXXXXXXGXXXXXXXXXXXXXXXXXXXGXXXXXXXXXXXXXXXXXXXGXXXXXXXXXXXXXXXXXXXGXXXXXXXXXXXXXXXXXXXGXXXXXXXXXXXXXXXXXXXGXXXXXXXXXXXXXXXXXXXGXXXXXXXXXXXXXXXXXXXGXXXXXXXXXXXXXXXXXXXGXXXXXXXXXXXXXXXXXXXGXXXXXXXXXXXXXXXXXXXGXXXXXXXXXXXXXXXXXXX,0,10,0
32529,13,0,13,100,487,0,0,500,363,137,GXXXXXXXXXXXXXXXXXXXGXXXXXXXXXXXXXXXXXXXGXXXXXXXXXXXXXXXXXXXGXXXXXXXXXXXXXXXXXXXGXXXXXXXXXXXXXXXXXXXGXXXXXXXXXXXXXXXXXXXGXXXXXXXXXXXXXXXXXXXGXXXXXXXXXXXXXXXXXXXGXXXXXXXXXXXXXXXXXXXGXXXXXXXXXXXXXXXXXXXGXXXXXXXXXXXXXXXXXXXGXXXXXXXXXXXXXXXXXXXGXXXXXXXXXXXXXXXXXXX,0,10,0

32550,14,1,13,92,494,0,0,508,357,151,GXXXXXXXXXXXXXXXXXXXGXXXXXXXXXXXXXXXXXXXGXXXXXXXXXXXXXXXXXXXGXXXXXXXXXXXXXXXXXXXGXXXXXXXXXXXXXXXXXXXGXXXXXXXXXXXXXXXXXXXGAXXXXXXXXXXXXXXXXXXGXXXXXXXXXXXXXXXXXXXGXXXXXXXXXXXXXXXXXXXGXXXXXXXXXXXXXXXXXXXGXXXXXXXXXXXXXXXXXXXGXXXXXXXXXXXXXXXXXXXGXXXXXXXXXXXXXXXXXXX,0,10,0
32571,14,1,13,81,505,0,0,515,359,156,GXXXXXXXXXXXXXXXXXXXGXXXXXXXXXXXXXXXXXXXGXXXXXXXXXXXXXXXXXXXGXXXXXXXXXXXXXXXXXXXGXXXXXXXXXXXXXXXXXXXGXXXXXXXXXXXXXXXXXXXGAXXXXXXXXXXXXXXXXXXGXXXXXXXXXXXXXXXXXXXGXXXXXXXXXXXXXXXXXXXGXXXXXXXXXXXXXXXXXXXGXXXXXXXXXXXXXXXXXXXGXXXXXXXXXXXXXXXXXXXGXXXXXXXXXXXXXXXXXXX,0,10,0
32592,14,1,13,80,506,0,0,520,364,156,GXXXXXXXXXXXXXXXXXXXGXXXXXXXXXXXXXXXXXXXGXXXXXXXXXXXXXXXXXXXGXXXXXXXXXXXXXXXXXXXGXXXXXXXXXXXXXXXXXXXGXXXXXXXXXXXXXXXXXXXGAXXXXXXXXXXXXXXXXXXGXXXXXXXXXXXXXXXXXXXGXXXXXXXXXXXXXXXXXXXGXXXXXXXXXXXXXXXXXXXGXXXXXXXXXXXXXXXXXXXGXXXXXXXXXXXXXXXXXXXGXXXXXXXXXXXXXXXXXXX,0,10,0
32613,14,1,13,77,509,0,0,523,368,155,GXXXXXXXXXXXXXXXXXXXGXXXXXXXXXXXXXXXXXXXGXXXXXXXXXXXXXXXXXXXGXXXXXXXXXXXXXXXXXXXGXXXXXXXXXXXXXXXXXXXGXXXXXXXXXXXXXXXXXXXGAXXXXXXXXXXXXXXXXXXGXXXXXXXXXXXXXXXXXXXGXXXXXXXXXXXXXXXXXXXGXXXXXXXXXXXXXXXXXXXGXXXXXXXXXXXXXXXXXXXGXXXXXXXXXXXXXXXXXXXGXXXXXXXXXXXXXXXXXXX,0,10,0
32634,14,1,13,84,502,0,0,517,364,153,GXXXXXXXXXXXXXXXXXXXGXXXXXXXXXXXXXXXXXXXGXXXXXXXXXXXXXXXXXXXGXXXXXXXXXXXXXXXXXXXGXXXXXXXXXXXXXXXXXXXGXXXXXXXXXXXXXXXXXXXGAXXXXXXXXXXXXXXXXXXGXXXXXXXXXXXXXXXXXXXGXXXXXXXXXXXXXXXXXXXGXXXXXXXXXXXXXXXXXXXGXXXXXXXXXXXXXXXXXXXGXXXXXXXXXXXXXXXXXXXGXXXXXXXXXXXXXXXXXXX,0,10,0

32655,14,1,13,86,500,0,0,514,363,151,GXXXXXXXXXXXXXXXXXXXGXXXXXXXXXXXXXXXXXXXGXXXXXXXXXXXXXXXXXXXGXXXXXXXXXXXXXXXXXXXGXXXXXXXXXXXXXXXXXXXGXXXXXXXXXXXXXXXXXXXGAXXXXXXXXXXXXXXXXXXGXXXXXXXXXXXXXXXXXXXGXXXXXXXXXXXXXXXXXXXGXXXXXXXXXXXXXXXXXXXGXXXXXXXXXXXXXXXXXXXGXXXXXXXXXXXXXXXXXXXGXXXXXXXXXXXXXXXXXXX,0,10,0
32676,14,1,13,84,502,0,0,517,359,158,GXXXXXXXXXXXXXXXXXXXGXXXXXXXXXXXXXXXXXXXGXXXXXXXXXXXXXXXXXXXGXXXXXXXXXXXXXXXXXXXGXXXXXXXXXXXXXXXXXXXGXXXXXXXXXXXXXXXXXXXGAXXXXXXXXXXXXXXXXXXGXXXXXXXXXXXXXXXXXXXGXXXXXXXXXXXXXXXXXXXGXXXXXXXXXXXXXXXXXXXGXXXXXXXXXXXXXXXXXXXGXXXXXXXXXXXXXXXXXXXGXXXXXXXXXXXXXXXXXXX,0,10,0
32697,14,1,13,81,505,0,0,520,358,162,GXXXXXXXXXXXXXXXXXXXGXXXXXXXXXXXXXXXXXXXGXXXXXXXXXXXXXXXXXXXGXXXXXXXXXXXXXXXXXXXGXXXXXXXXXXXXXXXXXXXGXXXXXXXXXXXXXXXXXXXGAXXXXXXXXXXXXXXXXXXGXXXXXXXXXXXXXXXXXXXGXXXXXXXXXXXXXXXXXXXGXXXXXXXXXXXXXXXXXXXGXXXXXXXXXXXXXXXXXXXGXXXXXXXXXXXXXXXXXXXGXXXXXXXXXXXXXXXXXXX,0,10,0
32718,13,0,13,83,504,0,0,520,362,158,GXXXXXXXXXXXXXXXXXXXGXXXXXXXXXXXXXXXXXXXGXXXXXXXXXXXXXXXXXXXGXXXXXXXXXXXXXXXXXXXGXXXXXXXXXXXXXXXXXXXGXXXXXXXXXXXXXXXXXXXGXXXXXXXXXXXXXXXXXXXGXXXXXXXXXXXXXXXXXXXGXXXXXXXXXXXXXXXXXXXGXXXXXXXXXXXXXXXXXXXGXXXXXXXXXXXXXXXXXXXGXXXXXXXXXXXXXXXXXXXGXXXXXXXXXXXXXXXXXXX,0,10,0
32739,13,0,13,78,509,0,0,524,361,163,GXXXXXXXXXXXXXXXXXXXGXXXXXXXXXXXXXXXXXXXGXXXXXXXXXXXXXXXXXXXGXXXXXXXXXXXXXXXXXXXGXXXXXXXXXXXXXXXXXXXGXXXXXXXXXXXXXXXXXXXGXXXXXXXXXXXXXXXXXXXGXXXXXXXXXXXXXXXXXXXGXXXXXXXXXXXXXXXXXXXGXXXXXXXXXXXXXXXXXXXGXXXXXXXXXXXXXXXXXXXGXXXXXXXXXXXXXXXXXXXGXXXXXXXXXXXXXXXXXXX,0,10,0

32760,13,0,13,74,513,0,0,527,366,161,GXXXXXXXXXXXXXXXXXXXGXXXXXXXXXXXXXXXXXXXGXXXXXXXXXXXXXXXXXXXGXXXXXXXXXXXXXXXXXXXGXXXXXXXXXXXXXXXXXXXGXXXXXXXXXXXXXXXXXXXGXXXXXXXXXXXXXXXXXXXGXXXXXXXXXXXXXXXXXXXGXXXXXXXXXXXXXXXXXXXGXXXXXXXXXXXXXXXXXXXGXXXXXXXXXXXXXXXXXXXGXXXXXXXXXXXXXXXXXXXGXXXXXXXXXXXXXXXXXXX,0,10,0
32781,14,0,14,73,513,0,0,527,363,164,GXXXXXXXXXXXXXXXXXXXGXXXXXXXXXXXXXXXXXXXGXXXXXXXXXXXXXXXXXXXGXXXXXXXXXXXXXXXXXXXGXXXXXXXXXXXXXXXXXXXGXXXXXXXXXXXXXXXXXXXGXXXXXXXXXXXXXXXXXXXGOXXXXXXXXXXXXXXXXXXGXXXXXXXXXXXXXXXXXXXGXXXXXXXXXXXXXXXXXXXGXXXXXXXXXXXXXXXXXXXGXXXXXXXXXXXXXXXXXXXGXXXXXXXXXXXXXXXXXXX,0,10,0
32802,13,0,13,71,516,0,0,530,369,161,GXXXXXXXXXXXXXXXXXXXGXXXXXXXXXXXXXXXXXXXGXXXXXXXXXXXXXXXXXXXGXXXXXXXXXXXXXXXXXXXGXXXXXXXXXXXXXXXXXXXGXXXXXXXXXXXXXXXXXXXGXXXXXXXXXXXXXXXXXXXGXXXXXXXXXXXXXXXXXXXGXXXXXXXXXXXXXXXXXXXGXXXXXXXXXXXXXXXXXXXGXXXXXXXXXXXXXXXXXXXGXXXXXXXXXXXXXXXXXXXGXXXXXXXXXXXXXXXXXXX,0,10,0
32823,14,1,13,76,510,0,0,525,363,162,GXXXXXXXXXXXXXXXXXXXGXXXXXXXXXXXXXXXXXXXGXXXXXXXXXXXXXXXXXXXGXXXXXXXXXXXXXXXXXXXGXXXXXXXXXXXXXXXXXXXGXXXXXXXXXXXXXXXXXXXGXXXXXXXXXXXXXXXXXXXGXXXXXXXXXXXXXXXXXXXGAXXXXXXXXXXXXXXXXXXGXXXXXXXXXXXXXXXXXXXGXXXXXXXXXXXXXXXXXXXGXXXXXXXXXXXXXXXXXXXGXXXXXXXXXXXXXXXXXXX,0,10,0
32844,14,1,13,80,506,0,0,521,361,160,GXXXXXXXXXXXXXXXXXXXGXXXXXXXXXXXXXXXXXXXGXXXXXXXXXXXXXXXXXXXGXXXXXXXXXXXXXXXXXXXGXXXXXXXXXXXXXXXXXXXGXXXXXXXXXXXXXXXXXXXGXXXXXXXXXXXXXXXXXXXGXXXXXXXXXXXXXXXXXXXGAXXXXXXXXXXXXXXXXXXGXXXXXXXXXXXXXXXXXXXGXXXXXXXXXXXXXXXXXXXGXXXXXXXXXXXXXXXXXXXGXXXXXXXXXXXXXXXXXXX,0,10,0

32865,15,2,13,75,510,0,0,525,360,165,GXXXXXXXXXXXXXXXXXXXGXXXXXXXXXXXXXXXXXXXGXXXXXXXXXXXXXXXXXXXGXXXXXXXXXXXXXXXXXXXGXXXXXXXXXXXXXXXXXXXGXXXXXXXXXXXXXXXXXXXGAXXXXXXXXXXXXXXXXXXGXXXXXXXXXXXXXXXXXXXGAXXXXXXXXXXXXXXXXXXGXXXXXXXXXXXXXXXXXXXGXXXXXXXXXXXXXXXXXXXGXXXXXXXXXXXXXXXXXXXGXXXXXXXXXXXXXXXXXXX,0,10,0
32886,15,2,13,78,507,0,0,522,359,163,GXXXXXXXXXXXXXXXXXXXGXXXXXXXXXXXXXXXXXXXGXXXXXXXXXXXXXXXXXXXGXXXXXXXXXXXXXXXXXXXGXXXXXXXXXXXXXXXXXXXGXXXXXXXXXXXXXXXXXXXGAXXXXXXXXXXXXXXXXXXGXXXXXXXXXXXXXXXXXXXGAXXXXXXXXXXXXXXXXXXGXXXXXXXXXXXXXXXXXXXGXXXXXXXXXXXXXXXXXXXGXXXXXXXXXXXXXXXXXXXGXXXXXXXXXXXXXXXXXXX,0,10,0
32907,15,1,14,76,509,0,0,522,360,162,GXXXXXXXXXXXXXXXXXXXGXXXXXXXXXXXXXXXXXXXGXXXXXXXXXXXXXXXXXXXGXXXXXXXXXXXXXXXXXXXGXXXXXXXXXXXXXXXXXXXGXXXXXXXXXXXXXXXXXXXGOXXXXXXXXXXXXXXXXXXGXXXXXXXXXXXXXXXXXXXGAXXXXXXXXXXXXXXXXXXGXXXXXXXXXXXXXXXXXXXGXXXXXXXXXXXXXXXXXXXGXXXXXXXXXXXXXXXXXXXGXXXXXXXXXXXXXXXXXXX,0,10,0
32928,15,1,14,71,514,0,0,527,363,164,GXXXXXXXXXXXXXXXXXXXGXXXXXXXXXXXXXXXXXXXGXXXXXXXXXXXXXXXXXXXGXXXXXXXXXXXXXXXXXXXGXXXXXXXXXXXXXXXXXXXGXXXXXXXXXXXXXXXXXXXGOXXXXXXXXXXXXXXXXXXGXXXXXXXXXXXXXXXXXXXGAXXXXXXXXXXXXXXXXXXGXXXXXXXXXXXXXXXXXXXGXXXXXXXXXXXXXXXXXXXGXXXXXXXXXXXXXXXXXXXGXXXXXXXXXXXXXXXXXXX,0,10,0
32949,15,0,15,66,519,0,0,532,374,158,GXXXXXXXXXXXXXXXXXXXGXXXXXXXXXXXXXXXXXXXGXXXXXXXXXXXXXXXXXXXGXXXXXXXXXXXXXXXXXXXGXXXXXXXXXXXXXXXXXXXGXXXXXXXXXXXXXXXXXXXGOXXXXXXXXXXXXXXXXXXGXXXXXXXXXXXXXXXXXXXGOXXXXXXXXXXXXXXXXXXGXXXXXXXXXXXXXXXXXXXGXXXXXXXXXXXXXXXXXXXGXXXXXXXXXXXXXXXXXXXGXXXXXXXXXXXXXXXXXXX,0,10,0

32970,14,1,13,79,507,0,0,521,365,156,GXXXXXXXXXXXXXXXXXXXGXXXXXXXXXXXXXXXXXXXGXXXXXXXXXXXXXXXXXXXGAXXXXXXXXXXXXXXXXXXGXXXXXXXXXXXXXXXXXXXGXXXXXXXXXXXXXXXXXXXGXXXXXXXXXXXXXXXXXXXGXXXXXXXXXXXXXXXXXXXGXXXXXXXXXXXXXXXXXXXGXXXXXXXXXXXXXXXXXXXGXXXXXXXXXXXXXXXXXXXGXXXXXXXXXXXXXXXXXXXGXXXXXXXXXXXXXXXXXXX,0,10,0
32991,14,0,14,76,510,0,0,523,364,159,GXXXXXXXXXXXXXXXXXXXGXXXXXXXXXXXXXXXXXXXGXXXXXXXXXXXXXXXXXXXGOXXXXXXXXXXXXXXXXXXGXXXXXXXXXXXXXXXXXXXGXXXXXXXXXXXXXXXXXXXGXXXXXXXXXXXXXXXXXXXGXXXXXXXXXXXXXXXXXXXGXXXXXXXXXXXXXXXXXXXGXXXXXXXXXXXXXXXXXXXGXXXXXXXXXXXXXXXXXXXGXXXXXXXXXXXXXXXXXXXGXXXXXXXXXXXXXXXXXXX,0,10,0
33012,13,0,13,73,514,0,0,529,370,159,GXXXXXXXXXXXXXXXXXXXGXXXXXXXXXXXXXXXXXXXGXXXXXXXXXXXXXXXXXXXGXXXXXXXXXXXXXXXXXXXGXXXXXXXXXXXXXXXXXXXGXXXXXXXXXXXXXXXXXXXGXXXXXXXXXXXXXXXXXXXGXXXXXXXXXXXXXXXXXXXGXXXXXXXXXXXXXXXXXXXGXXXXXXXXXXXXXXXXXXXGXXXXXXXXXXXXXXXXXXXGXXXXXXXXXXXXXXXXXXXGXXXXXXXXXXXXXXXXXXX,0,10,0
33033,13,0,13,75,512,0,0,527,371,156,GXXXXXXXXXXXXXXXXXXXGXXXXXXXXXXXXXXXXXXXGXXXXXXXXXXXXXXXXXXXGXXXXXXXXXXXXXXXXXXXGXXXXXXXXXXXXXXXXXXXGXXXXXXXXXXXXXXXXXXXGXXXXXXXXXXXXXXXXXXXGXXXXXXXXXXXXXXXXXXXGXXXXXXXXXXXXXXXXXXXGXXXXXXXXXXXXXXXXXXXGXXXXXXXXXXXXXXXXXXXGXXXXXXXXXXXXXXXXXXXGXXXXXXXXXXXXXXXXXXX,0,10,0
33054,13,0,13,78,509,0,0,524,370,154,GXXXXXXXXXXXXXXXXXXXGXXXXXXXXXXXXXXXXXXXGXXXXXXXXXXXXXXXXXXXGXXXXXXXXXXXXXXXXXXXGXXXXXXXXXXXXXXXXXXXGXXXXXXXXXXXXXXXXXXXGXXXXXXXXXXXXXXXXXXXGXXXXXXXXXXXXXXXXXXXGXXXXXXXXXXXXXXXXXXXGXXXXXXXXXXXXXXXXXXXGXXXXXXXXXXXXXXXXXXXGXXXXXXXXXXXXXXXXXXXGXXXXXXXXXXXXXXXXXXX,0,10,0

33075,13,0,13,80,507,0,0,522,368,154,GXXXXXXXXXXXXXXXXXXXGXXXXXXXXXXXXXXXXXXXGXXXXXXXXXXXXXXXXXXXGXXXXXXXXXXXXXXXXXXXGXXXXXXXXXXXXXXXXXXXGXXXXXXXXXXXXXXXXXXXGXXXXXXXXXXXXXXXXXXXGXXXXXXXXXXXXXXXXXXXGXXXXXXXXXXXXXXXXXXXGXXXXXXXXXXXXXXXXXXXGXXXXXXXXXXXXXXXXXXXGXXXXXXXXXXXXXXXXXXXGXXXXXXXXXXXXXXXXXXX,0,10,0
33096,13,0,13,84,503,0,0,517,362,155,GXXXXXXXXXXXXXXXXXXXGXXXXXXXXXXXXXXXXXXXGXXXXXXXXXXXXXXXXXXXGXXXXXXXXXXXXXXXXXXXGXXXXXXXXXXXXXXXXXXXGXXXXXXXXXXXXXXXXXXXGXXXXXXXXXXXXXXXXXXXGXXXXXXXXXXXXXXXXXXXGXXXXXXXXXXXXXXXXXXXGXXXXXXXXXXXXXXXXXXXGXXXXXXXXXXXXXXXXXXXGXXXXXXXXXXXXXXXXXXXGXXXXXXXXXXXXXXXXXXX,0,10,0
33117,13,0,13,88,499,0,0,512,359,153,GXXXXXXXXXXXXXXXXXXXGXXXXXXXXXXXXXXXXXXXGXXXXXXXXXXXXXXXXXXXGXXXXXXXXXXXXXXXXXXXGXXXXXXXXXXXXXXXXXXXGXXXXXXXXXXXXXXXXXXXGXXXXXXXXXXXXXXXXXXXGXXXXXXXXXXXXXXXXXXXGXXXXXXXXXXXXXXXXXXXGXXXXXXXXXXXXXXXXXXXGXXXXXXXXXXXXXXXXXXXGXXXXXXXXXXXXXXXXXXXGXXXXXXXXXXXXXXXXXXX,0,10,0
33138,13,0,13,86,501,0,0,515,360,155,GXXXXXXXXXXXXXXXXXXXGXXXXXXXXXXXXXXXXXXXGXXXXXXXXXXXXXXXXXXXGXXXXXXXXXXXXXXXXXXXGXXXXXXXXXXXXXXXXXXXGXXXXXXXXXXXXXXXXXXXGXXXXXXXXXXXXXXXXXXXGXXXXXXXXXXXXXXXXXXXGXXXXXXXXXXXXXXXXXXXGXXXXXXXXXXXXXXXXXXXGXXXXXXXXXXXXXXXXXXXGXXXXXXXXXXXXXXXXXXXGXXXXXXXXXXXXXXXXXXX,0,10,0
33159,13,0,13,84,503,0,0,516,364,152,GXXXXXXXXXXXXXXXXXXXGXXXXXXXXXXXXXXXXXXXGXXXXXXXXXXXXXXXXXXXGXXXXXXXXXXXXXXXXXXXGXXXXXXXXXXXXXXXXXXXGXXXXXXXXXXXXXXXXXXXGXXXXXXXXXXXXXXXXXXXGXXXXXXXXXXXXXXXXXXXGXXXXXXXXXXXXXXXXXXXGXXXXXXXXXXXXXXXXXXXGXXXXXXXXXXXXXXXXXXXGXXXXXXXXXXXXXXXXXXXGXXXXXXXXXXXXXXXXXXX,0,10,0

33180,13,0,13,81,506,0,0,519,361,158,GXXXXXXXXXXXXXXXXXXXGXXXXXXXXXXXXXXXXXXXGXXXXXXXXXXXXXXXXXXXGXXXXXXXXXXXXXXXXXXXGXXXXXXXXXXXXXXXXXXXGXXXXXXXXXXXXXXXXXXXGXXXXXXXXXXXXXXXXXXXGXXXXXXXXXXXXXXXXXXXGXXXXXXXXXXXXXXXXXXXGXXXXXXXXXXXXXXXXXXXGXXXXXXXXXXXXXXXXXXXGXXXXXXXXXXXXXXXXXXXGXXXXXXXXXXXXXXXXXXX,0,10,0
33201,13,0,13,85,502,0,0,514,367,147,GXXXXXXXXXXXXXXXXXXXGXXXXXXXXXXXXXXXXXXXGXXXXXXXXXXXXXXXXXXXGXXXXXXXXXXXXXXXXXXXGXXXXXXXXXXXXXXXXXXXGXXXXXXXXXXXXXXXXXXXGXXXXXXXXXXXXXXXXXXXGXXXXXXXXXXXXXXXXXXXGXXXXXXXXXXXXXXXXXXXGXXXXXXXXXXXXXXXXXXXGXXXXXXXXXXXXXXXXXXXGXXXXXXXXXXXXXXXXXXXGXXXXXXXXXXXXXXXXXXX,0,10,0
33222,13,0,13,82,505,0,0,517,369,148,GXXXXXXXXXXXXXXXXXXXGXXXXXXXXXXXXXXXXXXXGXXXXXXXXXXXXXXXXXXXGXXXXXXXXXXXXXXXXXXXGXXXXXXXXXXXXXXXXXXXGXXXXXXXXXXXXXXXXXXXGXXXXXXXXXXXXXXXXXXXGXXXXXXXXXXXXXXXXXXXGXXXXXXXXXXXXXXXXXXXGXXXXXXXXXXXXXXXXXXXGXXXXXXXXXXXXXXXXXXXGXXXXXXXXXXXXXXXXXXXGXXXXXXXXXXXXXXXXXXX,0,10,0
33243,13,0,13,85,502,0,0,516,366,150,GXXXXXXXXXXXXXXXXXXXGXXXXXXXXXXXXXXXXXXXGXXXXXXXXXXXXXXXXXXXGXXXXXXXXXXXXXXXXXXXGXXXXXXXXXXXXXXXXXXXGXXXXXXXXXXXXXXXXXXXGXXXXXXXXXXXXXXXXXXXGXXXXXXXXXXXXXXXXXXXGXXXXXXXXXXXXXXXXXXXGXXXXXXXXXXXXXXXXXXXGXXXXXXXXXXXXXXXXXXXGXXXXXXXXXXXXXXXXXXXGXXXXXXXXXXXXXXXXXXX,0,10,0
33264,13,0,13,83,504,0,0,518,367,151,GXXXXXXXXXXXXXXXXXXXGXXXXXXXXXXXXXXXXXXXGXXXXXXXXXXXXXXXXXXXGXXXXXXXXXXXXXXXXXXXGXXXXXXXXXXXXXXXXXXXGXXXXXXXXXXXXXXXXXXXGXXXXXXXXXXXXXXXXXXXGXXXXXXXXXXXXXXXXXXXGXXXXXXXXXXXXXXXXXXXGXXXXXXXXXXXXXXXXXXXGXXXXXXXXXXXXXXXXXXXGXXXXXXXXXXXXXXXXXXXGXXXXXXXXXXXXXXXXXXX,0,10,0

33285,13,0,13,83,504,0,0,518,367,151,GXXXXXXXXXXXXXXXXXXXGXXXXXXXXXXXXXXXXXXXGXXXXXXXXXXXXXXXXXXXGXXXXXXXXXXXXXXXXXXXGXXXXXXXXXXXXXXXXXXXGXXXXXXXXXXXXXXXXXXXGXXXXXXXXXXXXXXXXXXXGXXXXXXXXXXXXXXXXXXXGXXXXXXXXXXXXXXXXXXXGXXXXXXXXXXXXXXXXXXXGXXXXXXXXXXXXXXXXXXXGXXXXXXXXXXXXXXXXXXXGXXXXXXXXXXXXXXXXXXX,0,10,0
33306,13,0,13,91,496,0,0,511,361,150,GXXXXXXXXXXXXXXXXXXXGXXXXXXXXXXXXXXXXXXXGXXXXXXXXXXXXXXXXXXXGXXXXXXXXXXXXXXXXXXXGXXXXXXXXXXXXXXXXXXXGXXXXXXXXXXXXXXXXXXXGXXXXXXXXXXXXXXXXXXXGXXXXXXXXXXXXXXXXXXXGXXXXXXXXXXXXXXXXXXXGXXXXXXXXXXXXXXXXXXXGXXXXXXXXXXXXXXXXXXXGXXXXXXXXXXXXXXXXXXXGXXXXXXXXXXXXXXXXXXX,0,10,0
33327,13,0,13,84,503,0,0,517,365,152,GXXXXXXXXXXXXXXXXXXXGXXXXXXXXXXXXXXXXXXXGXXXXXXXXXXXXXXXXXXXGXXXXXXXXXXXXXXXXXXXGXXXXXXXXXXXXXXXXXXXGXXXXXXXXXXXXXXXXXXXGXXXXXXXXXXXXXXXXXXXGXXXXXXXXXXXXXXXXXXXGXXXXXXXXXXXXXXXXXXXGXXXXXXXXXXXXXXXXXXXGXXXXXXXXXXXXXXXXXXXGXXXXXXXXXXXXXXXXXXXGXXXXXXXXXXXXXXXXXXX,0,10,0
33348,13,0,13,90,497,0,0,511,368,143,GXXXXXXXXXXXXXXXXXXXGXXXXXXXXXXXXXXXXXXXGXXXXXXXXXXXXXXXXXXXGXXXXXXXXXXXXXXXXXXXGXXXXXXXXXXXXXXXXXXXGXXXXXXXXXXXXXXXXXXXGXXXXXXXXXXXXXXXXXXXGXXXXXXXXXXXXXXXXXXXGXXXXXXXXXXXXXXXXXXXGXXXXXXXXXXXXXXXXXXXGXXXXXXXXXXXXXXXXXXXGXXXXXXXXXXXXXXXXXXXGXXXXXXXXXXXXXXXXXXX,0,10,0
33369,13,0,13,88,499,0,0,512,367,145,GXXXXXXXXXXXXXXXXXXXGXXXXXXXXXXXXXXXXXXXGXXXXXXXXXXXXXXXXXXXGXXXXXXXXXXXXXXXXXXXGXXXXXXXXXXXXXXXXXXXGXXXXXXXXXXXXXXXXXXXGXXXXXXXXXXXXXXXXXXXGXXXXXXXXXXXXXXXXXXXGXXXXXXXXXXXXXXXXXXXGXXXXXXXXXXXXXXXXXXXGXXXXXXXXXXXXXXXXXXXGXXXXXXXXXXXXXXXXXXXGXXXXXXXXXXXXXXXXXXX,0,10,0

33390,13,0,13,92,495,0,0,509,365,144,GXXXXXXXXXXXXXXXXXXXGXXXXXXXXXXXXXXXXXXXGXXXXXXXXXXXXXXXXXXXGXXXXXXXXXXXXXXXXXXXGXXXXXXXXXXXXXXXXXXXGXXXXXXXXXXXXXXXXXXXGXXXXXXXXXXXXXXXXXXXGXXXXXXXXXXXXXXXXXXXGXXXXXXXXXXXXXXXXXXXGXXXXXXXXXXXXXXXXXXXGXXXXXXXXXXXXXXXXXXXGXXXXXXXXXXXXXXXXXXXGXXXXXXXXXXXXXXXXXXX,0,10,0
33411,13,0,13,90,497,0,0,509,366,143,GXXXXXXXXXXXXXXXXXXXGXXXXXXXXXXXXXXXXXXXGXXXXXXXXXXXXXXXXXXXGXXXXXXXXXXXXXXXXXXXGXXXXXXXXXXXXXXXXXXXGXXXXXXXXXXXXXXXXXXXGXXXXXXXXXXXXXXXXXXXGXXXXXXXXXXXXXXXXXXXGXXXXXXXXXXXXXXXXXXXGXXXXXXXXXXXXXXXXXXXGXXXXXXXXXXXXXXXXXXXGXXXXXXXXXXXXXXXXXXXGXXXXXXXXXXXXXXXXXXX,0,10,0
33432,13,0,13,84,503,0,0,516,367,149,GXXXXXXXXXXXXXXXXXXXGXXXXXXXXXXXXXXXXXXXGXXXXXXXXXXXXXXXXXXXGXXXXXXXXXXXXXXXXXXXGXXXXXXXXXXXXXXXXXXXGXXXXXXXXXXXXXXXXXXXGXXXXXXXXXXXXXXXXXXXGXXXXXXXXXXXXXXXXXXXGXXXXXXXXXXXXXXXXXXXGXXXXXXXXXXXXXXXXXXXGXXXXXXXXXXXXXXXXXXXGXXXXXXXXXXXXXXXXXXXGXXXXXXXXXXXXXXXXXXX,0,10,0
33453,13,0,13,81,506,0,0,517,369,148,GXXXXXXXXXXXXXXXXXXXGXXXXXXXXXXXXXXXXXXXGXXXXXXXXXXXXXXXXXXXGXXXXXXXXXXXXXXXXXXXGXXXXXXXXXXXXXXXXXXXGXXXXXXXXXXXXXXXXXXXGXXXXXXXXXXXXXXXXXXXGXXXXXXXXXXXXXXXXXXXGXXXXXXXXXXXXXXXXXXXGXXXXXXXXXXXXXXXXXXXGXXXXXXXXXXXXXXXXXXXGXXXXXXXXXXXXXXXXXXXGXXXXXXXXXXXXXXXXXXX,0,10,0
33474,13,0,13,81,506,0,0,520,368,152,GXXXXXXXXXXXXXXXXXXXGXXXXXXXXXXXXXXXXXXXGXXXXXXXXXXXXXXXXXXXGXXXXXXXXXXXXXXXXXXXGXXXXXXXXXXXXXXXXXXXGXXXXXXXXXXXXXXXXXXXGXXXXXXXXXXXXXXXXXXXGXXXXXXXXXXXXXXXXXXXGXXXXXXXXXXXXXXXXXXXGXXXXXXXXXXXXXXXXXXXGXXXXXXXXXXXXXXXXXXXGXXXXXXXXXXXXXXXXXXXGXXXXXXXXXXXXXXXXXXX,0,10,0

33495,14,1,13,82,504,0,0,518,363,155,GXXXXXXXXXXXXXXXXXXXGXXXXXXXXXXXXXXXXXXXGXXXXXXXXXXXXXXXXXXXGXXXXXXXXXXXXXXXXXXXGAXXXXXXXXXXXXXXXXXXGXXXXXXXXXXXXXXXXXXXGXXXXXXXXXXXXXXXXXXXGXXXXXXXXXXXXXXXXXXXGXXXXXXXXXXXXXXXXXXXGXXXXXXXXXXXXXXXXXXXGXXXXXXXXXXXXXXXXXXXGXXXXXXXXXXXXXXXXXXXGXXXXXXXXXXXXXXXXXXX,0,10,0
33516,14,1,13,79,507,0,0,521,370,151,GXXXXXXXXXXXXXXXXXXXGXXXXXXXXXXXXXXXXXXXGXXXXXXXXXXXXXXXXXXXGXXXXXXXXXXXXXXXXXXXGAXXXXXXXXXXXXXXXXXXGXXXXXXXXXXXXXXXXXXXGXXXXXXXXXXXXXXXXXXXGXXXXXXXXXXXXXXXXXXXGXXXXXXXXXXXXXXXXXXXGXXXXXXXXXXXXXXXXXXXGXXXXXXXXXXXXXXXXXXXGXXXXXXXXXXXXXXXXXXXGXXXXXXXXXXXXXXXXXXX,0,10,0
33537,14,1,13,78,508,0,0,522,365,157,GXXXXXXXXXXXXXXXXXXXGXXXXXXXXXXXXXXXXXXXGXXXXXXXXXXXXXXXXXXXGXXXXXXXXXXXXXXXXXXXGAXXXXXXXXXXXXXXXXXXGXXXXXXXXXXXXXXXXXXXGXXXXXXXXXXXXXXXXXXXGXXXXXXXXXXXXXXXXXXXGXXXXXXXXXXXXXXXXXXXGXXXXXXXXXXXXXXXXXXXGXXXXXXXXXXXXXXXXXXXGXXXXXXXXXXXXXXXXXXXGXXXXXXXXXXXXXXXXXXX,0,10,0
33558,14,1,13,77,509,0,0,523,369,154,GXXXXXXXXXXXXXXXXXXXGXXXXXXXXXXXXXXXXXXXGXXXXXXXXXXXXXXXXXXXGXXXXXXXXXXXXXXXXXXXGAXXXXXXXXXXXXXXXXXXGXXXXXXXXXXXXXXXXXXXGXXXXXXXXXXXXXXXXXXXGXXXXXXXXXXXXXXXXXXXGXXXXXXXXXXXXXXXXXXXGXXXXXXXXXXXXXXXXXXXGXXXXXXXXXXXXXXXXXXXGXXXXXXXXXXXXXXXXXXXGXXXXXXXXXXXXXXXXXXX,0,10,0
33579,14,1,13,79,507,0,0,522,368,154,GXXXXXXXXXXXXXXXXXXXGXXXXXXXXXXXXXXXXXXXGXXXXXXXXXXXXXXXXXXXGXXXXXXXXXXXXXXXXXXXGAXXXXXXXXXXXXXXXXXXGXXXXXXXXXXXXXXXXXXXGXXXXXXXXXXXXXXXXXXXGXXXXXXXXXXXXXXXXXXXGXXXXXXXXXXXXXXXXXXXGXXXXXXXXXXXXXXXXXXXGXXXXXXXXXXXXXXXXXXXGXXXXXXXXXXXXXXXXXXXGXXXXXXXXXXXXXXXXXXX,0,10,0

33600,14,1,13,80,506,0,0,520,368,152,GXXXXXXXXXXXXXXXXXXXGXXXXXXXXXXXXXXXXXXXGXXXXXXXXXXXXXXXXXXXGXXXXXXXXXXXXXXXXXXXGAXXXXXXXXXXXXXXXXXXGXXXXXXXXXXXXXXXXXXXGXXXXXXXXXXXXXXXXXXXGXXXXXXXXXXXXXXXXXXXGXXXXXXXXXXXXXXXXXXXGXXXXXXXXXXXXXXXXXXXGXXXXXXXXXXXXXXXXXXXGXXXXXXXXXXXXXXXXXXXGXXXXXXXXXXXXXXXXXXX,0,10,0
33621,15,2,13,82,503,0,0,518,369,149,GXXXXXXXXXXXXXXXXXXXGXXXXXXXXXXXXXXXXXXXGXXXXXXXXXXXXXXXXXXXGXXXXXXXXXXXXXXXXXXXGAXXXXXXXXXXXXXXXXXXGXXXXXXXXXXXXXXXXXXXGXXXXXXXXXXXXXXXXXXXGXXXXXXXXXXXXXXXXXXXGXXXXXXXXXXXXXXXXXXXGXXXXXXXXXXXXXXXXXXXGXXXXXXXXXXXXXXXXXXXGAXXXXXXXXXXXXXXXXXXGXXXXXXXXXXXXXXXXXXX,0,10,0
33642,15,2,13,82,503,0,0,518,367,151,GXXXXXXXXXXXXXXXXXXXGXXXXXXXXXXXXXXXXXXXGXXXXXXXXXXXXXXXXXXXGXXXXXXXXXXXXXXXXXXXGAXXXXXXXXXXXXXXXXXXGXXXXXXXXXXXXXXXXXXXGXXXXXXXXXXXXXXXXXXXGXXXXXXXXXXXXXXXXXXXGXXXXXXXXXXXXXXXXXXXGXXXXXXXXXXXXXXXXXXXGXXXXXXXXXXXXXXXXXXXGAXXXXXXXXXXXXXXXXXXGXXXXXXXXXXXXXXXXXXX,0,10,0
33663,15,1,14,81,504,0,0,520,372,148,GXXXXXXXXXXXXXXXXXXXGXXXXXXXXXXXXXXXXXXXGXXXXXXXXXXXXXXXXXXXGXXXXXXXXXXXXXXXXXXXGAXXXXXXXXXXXXXXXXXXGXXXXXXXXXXXXXXXXXXXGXXXXXXXXXXXXXXXXXXXGXXXXXXXXXXXXXXXXXXXGXXXXXXXXXXXXXXXXXXXGXXXXXXXXXXXXXXXXXXXGXXXXXXXXXXXXXXXXXXXGOXXXXXXXXXXXXXXXXXXGXXXXXXXXXXXXXXXXXXX,0,10,0
33684,15,1,14,90,495,0,0,510,367,143,GXXXXXXXXXXXXXXXXXXXGXXXXXXXXXXXXXXXXXXXGXXXXXXXXXXXXXXXXXXXGXXXXXXXXXXXXXXXXXXXGAXXXXXXXXXXXXXXXXXXGXXXXXXXXXXXXXXXXXXXGXXXXXXXXXXXXXXXXXXXGXXXXXXXXXXXXXXXXXXXGXXXXXXXXXXXXXXXXXXXGXXXXXXXXXXXXXXXXXXXGXXXXXXXXXXXXXXXXXXXGOXXXXXXXXXXXXXXXXXXGXXXXXXXXXXXXXXXXXXX,0,10,0

33705,15,2,13,82,503,0,0,517,365,152,GXXXXXXXXXXXXXXXXXXXGXXXXXXXXXXXXXXXXXXXGXXXXXXXXXXXXXXXXXXXGXXXXXXXXXXXXXXXXXXXGAAXXXXXXXXXXXXXXXXXGXXXXXXXXXXXXXXXXXXXGXXXXXXXXXXXXXXXXXXXGXXXXXXXXXXXXXXXXXXXGXXXXXXXXXXXXXXXXXXXGXXXXXXXXXXXXXXXXXXXGXXXXXXXXXXXXXXXXXXXGXXXXXXXXXXXXXXXXXXXGXXXXXXXXXXXXXXXXXXX,0,10,0
33726,15,1,14,82,503,0,0,518,366,152,GXXXXXXXXXXXXXXXXXXXGXXXXXXXXXXXXXXXXXXXGXXXXXXXXXXXXXXXXXXXGXXXXXXXXXXXXXXXXXXXGOAXXXXXXXXXXXXXXXXXGXXXXXXXXXXXXXXXXXXXGXXXXXXXXXXXXXXXXXXXGXXXXXXXXXXXXXXXXXXXGXXXXXXXXXXXXXXXXXXXGXXXXXXXXXXXXXXXXXXXGXXXXXXXXXXXXXXXXXXXGXXXXXXXXXXXXXXXXXXXGXXXXXXXXXXXXXXXXXXX,0,10,0
33747,15,1,14,77,508,0,0,522,368,154,GXXXXXXXXXXXXXXXXXXXGXXXXXXXXXXXXXXXXXXXGXXXXXXXXXXXXXXXXXXXGXXXXXXXXXXXXXXXXXXXGOAXXXXXXXXXXXXXXXXXGXXXXXXXXXXXXXXXXXXXGXXXXXXXXXXXXXXXXXXXGXXXXXXXXXXXXXXXXXXXGXXXXXXXXXXXXXXXXXXXGXXXXXXXXXXXXXXXXXXXGXXXXXXXXXXXXXXXXXXXGXXXXXXXXXXXXXXXXXXXGXXXXXXXXXXXXXXXXXXX,0,10,0
33768,15,2,13,78,507,0,0,522,372,150,GXXXXXXXXXXXXXXXXXXXGXXXXXXXXXXXXXXXXXXXGAXXXXXXXXXXXXXXXXXXGXXXXXXXXXXXXXXXXXXXGXAXXXXXXXXXXXXXXXXXGXXXXXXXXXXXXXXXXXXXGXXXXXXXXXXXXXXXXXXXGXXXXXXXXXXXXXXXXXXXGXXXXXXXXXXXXXXXXXXXGXXXXXXXXXXXXXXXXXXXGXXXXXXXXXXXXXXXXXXXGXXXXXXXXXXXXXXXXXXXGXXXXXXXXXXXXXXXXXXX,0,10,0
33789,14,1,13,79,507,0,0,522,367,155,GXXXXXXXXXXXXXXXXXXXGXXXXXXXXXXXXXXXXXXXGAXXXXXXXXXXXXXXXXXXGXXXXXXXXXXXXXXXXXXXGXXXXXXXXXXXXXXXXXXXGXXXXXXXXXXXXXXXXXXXGXXXXXXXXXXXXXXXXXXXGXXXXXXXXXXXXXXXXXXXGXXXXXXXXXXXXXXXXXXXGXXXXXXXXXXXXXXXXXXXGXXXXXXXXXXXXXXXXXXXGXXXXXXXXXXXXXXXXXXXGXXXXXXXXXXXXXXXXXXX,0,10,0

33810,14,1,13,79,507,0,0,522,365,157,GXXXXXXXXXXXXXXXXXXXGXXXXXXXXXXXXXXXXXXXGAXXXXXXXXXXXXXXXXXXGXXXXXXXXXXXXXXXXXXXGXXXXXXXXXXXXXXXXXXXGXXXXXXXXXXXXXXXXXXXGXXXXXXXXXXXXXXXXXXXGXXXXXXXXXXXXXXXXXXXGXXXXXXXXXXXXXXXXXXXGXXXXXXXXXXXXXXXXXXXGXXXXXXXXXXXXXXXXXXXGXXXXXXXXXXXXXXXXXXXGXXXXXXXXXXXXXXXXXXX,0,10,0
33831,14,1,13,76,510,0,0,525,370,155,GXXXXXXXXXXXXXXXXXXXGXXXXXXXXXXXXXXXXXXXGAXXXXXXXXXXXXXXXXXXGXXXXXXXXXXXXXXXXXXXGXXXXXXXXXXXXXXXXXXXGXXXXXXXXXXXXXXXXXXXGXXXXXXXXXXXXXXXXXXXGXXXXXXXXXXXXXXXXXXXGXXXXXXXXXXXXXXXXXXXGXXXXXXXXXXXXXXXXXXXGXXXXXXXXXXXXXXXXXXXGXXXXXXXXXXXXXXXXXXXGXXXXXXXXXXXXXXXXXXX,0,10,0
33852,14,1,13,77,509,0,0,524,370,154,GXXXXXXXXXXXXXXXXXXXGXXXXXXXXXXXXXXXXXXXGAXXXXXXXXXXXXXXXXXXGXXXXXXXXXXXXXXXXXXXGXXXXXXXXXXXXXXXXXXXGXXXXXXXXXXXXXXXXXXXGXXXXXXXXXXXXXXXXXXXGXXXXXXXXXXXXXXXXXXXGXXXXXXXXXXXXXXXXXXXGXXXXXXXXXXXXXXXXXXXGXXXXXXXXXXXXXXXXXXXGXXXXXXXXXXXXXXXXXXXGXXXXXXXXXXXXXXXXXXX,0,10,0
33873,14,1,13,81,505,0,0,521,367,154,GXXXXXXXXXXXXXXXXXXXGXXXXXXXXXXXXXXXXXXXGAXXXXXXXXXXXXXXXXXXGXXXXXXXXXXXXXXXXXXXGXXXXXXXXXXXXXXXXXXXGXXXXXXXXXXXXXXXXXXXGXXXXXXXXXXXXXXXXXXXGXXXXXXXXXXXXXXXXXXXGXXXXXXXXXXXXXXXXXXXGXXXXXXXXXXXXXXXXXXXGXXXXXXXXXXXXXXXXXXXGXXXXXXXXXXXXXXXXXXXGXXXXXXXXXXXXXXXXXXX,0,10,0
33894,14,1,13,81,505,0,0,518,371,147,GXXXXXXXXXXXXXXXXXXXGXXXXXXXXXXXXXXXXXXXGAXXXXXXXXXXXXXXXXXXGXXXXXXXXXXXXXXXXXXXGXXXXXXXXXXXXXXXXXXXGXXXXXXXXXXXXXXXXXXXGXXXXXXXXXXXXXXXXXXXGXXXXXXXXXXXXXXXXXXXGXXXXXXXXXXXXXXXXXXXGXXXXXXXXXXXXXXXXXXXGXXXXXXXXXXXXXXXXXXXGXXXXXXXXXXXXXXXXXXXGXXXXXXXXXXXXXXXXXXX,0,10,0

33915,14,1,13,80,506,0,0,519,372,147,GXXXXXXXXXXXXXXXXXXXGXXXXXXXXXXXXXXXXXXXGXXXXXXXXXXXXXXXXXXXGXXXXXXXXXXXXXXXXXXXGXXXXXXXXXXXXXXXXXXXGXXXXXXXXXXXXXXXXXXXGXXXXXXXXXXXXXXXXXXXGXXXXXXXXXXXXXXXXXXXGXXXXXXXXXXXXXXXXXXXGXXXXXXXXXXXXXXXXXXXGXXXXXXXXXXXXXXXXXXXGAXXXXXXXXXXXXXXXXXXGXXXXXXXXXXXXXXXXXXX,0,10,0
33936,14,1,13,84,502,0,0,514,369,145,GXXXXXXXXXXXXXXXXXXXGXXXXXXXXXXXXXXXXXXXGXXXXXXXXXXXXXXXXXXXGXXXXXXXXXXXXXXXXXXXGXXXXXXXXXXXXXXXXXXXGXXXXXXXXXXXXXXXXXXXGXXXXXXXXXXXXXXXXXXXGXXXXXXXXXXXXXXXXXXXGXXXXXXXXXXXXXXXXXXXGXXXXXXXXXXXXXXXXXXXGXXXXXXXXXXXXXXXXXXXGAXXXXXXXXXXXXXXXXXXGXXXXXXXXXXXXXXXXXXX,0,10,0
33957,14,1,13,84,502,0,0,516,366,150,GXXXXXXXXXXXXXXXXXXXGXXXXXXXXXXXXXXXXXXXGXXXXXXXXXXXXXXXXXXXGXXXXXXXXXXXXXXXXXXXGXXXXXXXXXXXXXXXXXXXGXXXXXXXXXXXXXXXXXXXGXXXXXXXXXXXXXXXXXXXGXXXXXXXXXXXXXXXXXXXGXXXXXXXXXXXXXXXXXXXGXXXXXXXXXXXXXXXXXXXGXXXXXXXXXXXXXXXXXXXGAXXXXXXXXXXXXXXXXXXGXXXXXXXXXXXXXXXXXXX,0,10,0
33978,14,1,13,74,512,0,0,525,366,159,GXXXXXXXXXXXXXXXXXXXGXXXXXXXXXXXXXXXXXXXGXXXXXXXXXXXXXXXXXXXGXXXXXXXXXXXXXXXXXXXGXXXXXXXXXXXXXXXXXXXGXXXXXXXXXXXXXXXXXXXGXXXXXXXXXXXXXXXXXXXGXXXXXXXXXXXXXXXXXXXGXXXXXXXXXXXXXXXXXXXGXXXXXXXXXXXXXXXXXXXGXXXXXXXXXXXXXXXXXXXGAXXXXXXXXXXXXXXXXXXGXXXXXXXXXXXXXXXXXXX,0,10,0
33999,14,1,13,77,509,0,0,523,367,156,GXXXXXXXXXXXXXXXXXXXGXXXXXXXXXXXXXXXXXXXGXXXXXXXXXXXXXXXXXXXGXXXXXXXXXXXXXXXXXXXGXXXXXXXXXXXXXXXXXXXGXXXXXXXXXXXXXXXXXXXGXXXXXXXXXXXXXXXXXXXGXXXXXXXXXXXXXXXXXXXGXXXXXXXXXXXXXXXXXXXGXXXXXXXXXXXXXXXXXXXGXXXXXXXXXXXXXXXXXXXGAXXXXXXXXXXXXXXXXXXGXXXXXXXXXXXXXXXXXXX,0,10,0

34020,14,1,13,83,503,0,0,518,367,151,GXXXXXXXXXXXXXXXXXXXGXXXXXXXXXXXXXXXXXXXGXXXXXXXXXXXXXXXXXXXGXXXXXXXXXXXXXXXXXXXGXXXXXXXXXXXXXXXXXXXGXXXXXXXXXXXXXXXXXXXGXXXXXXXXXXXXXXXXXXXGXXXXXXXXXXXXXXXXXXXGXXXXXXXXXXXXXXXXXXXGXXXXXXXXXXXXXXXXXXXGXXXXXXXXXXXXXXXXXXXGAXXXXXXXXXXXXXXXXXXGXXXXXXXXXXXXXXXXXXX,0,10,0
34041,14,1,13,81,505,0,0,519,371,148,GXXXXXXXXXXXXXXXXXXXGXXXXXXXXXXXXXXXXXXXGXXXXXXXXXXXXXXXXXXXGXXXXXXXXXXXXXXXXXXXGXXXXXXXXXXXXXXXXXXXGXXXXXXXXXXXXXXXXXXXGXXXXXXXXXXXXXXXXXXXGXXXXXXXXXXXXXXXXXXXGXXXXXXXXXXXXXXXXXXXGXXXXXXXXXXXXXXXXXXXGXXXXXXXXXXXXXXXXXXXGAXXXXXXXXXXXXXXXXXXGXXXXXXXXXXXXXXXXXXX,0,10,0
34062,14,1,13,80,506,0,0,520,368,152,GXXXXXXXXXXXXXXXXXXXGXXXXXXXXXXXXXXXXXXXGXXXXXXXXXXXXXXXXXXXGXXXXXXXXXXXXXXXXXXXGXXXXXXXXXXXXXXXXXXXGXXXXXXXXXXXXXXXXXXXGXXXXXXXXXXXXXXXXXXXGXXXXXXXXXXXXXXXXXXXGXXXXXXXXXXXXXXXXXXXGXXXXXXXXXXXXXXXXXXXGXXXXXXXXXXXXXXXXXXXGAXXXXXXXXXXXXXXXXXXGXXXXXXXXXXXXXXXXXXX,0,10,0
34083,14,1,13,79,507,0,0,522,367,155,GXXXXXXXXXXXXXXXXXXXGXXXXXXXXXXXXXXXXXXXGXXXXXXXXXXXXXXXXXXXGXXXXXXXXXXXXXXXXXXXGXXXXXXXXXXXXXXXXXXXGXXXXXXXXXXXXXXXXXXXGXXXXXXXXXXXXXXXXXXXGXXXXXXXXXXXXXXXXXXXGXXXXXXXXXXXXXXXXXXXGXXXXXXXXXXXXXXXXXXXGXXXXXXXXXXXXXXXXXXXGAXXXXXXXXXXXXXXXXXXGXXXXXXXXXXXXXXXXXXX,0,10,0
34104,14,1,13,78,508,0,0,523,372,151,GXXXXXXXXXXXXXXXXXXXGXXXXXXXXXXXXXXXXXXXGXXXXXXXXXXXXXXXXXXXGXXXXXXXXXXXXXXXXXXXGXXXXXXXXXXXXXXXXXXXGXXXXXXXXXXXXXXXXXXXGXXXXXXXXXXXXXXXXXXXGXXXXXXXXXXXXXXXXXXXGXXXXXXXXXXXXXXXXXXXGXXXXXXXXXXXXXXXXXXXGXXXXXXXXXXXXXXXXXXXGAXXXXXXXXXXXXXXXXXXGXXXXXXXXXXXXXXXXXXX,0,10,0

34125,14,1,13,80,506,0,0,521,373,148,GXXXXXXXXXXXXXXXXXXXGXXXXXXXXXXXXXXXXXXXGXXXXXXXXXXXXXXXXXXXGXXXXXXXXXXXXXXXXXXXGXXXXXXXXXXXXXXXXXXXGXXXXXXXXXXXXXXXXXXXGXXXXXXXXXXXXXXXXXXXGXXXXXXXXXXXXXXXXXXXGXXXXXXXXXXXXXXXXXXXGXXXXXXXXXXXXXXXXXXXGXXXXXXXXXXXXXXXXXXXGAXXXXXXXXXXXXXXXXXXGXXXXXXXXXXXXXXXXXXX,0,10,0
34146,14,0,14,80,506,0,0,521,374,147,GXXXXXXXXXXXXXXXXXXXGXXXXXXXXXXXXXXXXXXXGXXXXXXXXXXXXXXXXXXXGXXXXXXXXXXXXXXXXXXXGXXXXXXXXXXXXXXXXXXXGXXXXXXXXXXXXXXXXXXXGXXXXXXXXXXXXXXXXXXXGXXXXXXXXXXXXXXXXXXXGXXXXXXXXXXXXXXXXXXXGXXXXXXXXXXXXXXXXXXXGXXXXXXXXXXXXXXXXXXXGOXXXXXXXXXXXXXXXXXXGXXXXXXXXXXXXXXXXXXX,0,10,0
34167,13,0,13,87,500,0,0,514,375,139,GXXXXXXXXXXXXXXXXXXXGXXXXXXXXXXXXXXXXXXXGXXXXXXXXXXXXXXXXXXXGXXXXXXXXXXXXXXXXXXXGXXXXXXXXXXXXXXXXXXXGXXXXXXXXXXXXXXXXXXXGXXXXXXXXXXXXXXXXXXXGXXXXXXXXXXXXXXXXXXXGXXXXXXXXXXXXXXXXXXXGXXXXXXXXXXXXXXXXXXXGXXXXXXXXXXXXXXXXXXXGXXXXXXXXXXXXXXXXXXXGXXXXXXXXXXXXXXXXXXX,0,10,0
34188,13,0,13,91,496,0,0,511,374,137,GXXXXXXXXXXXXXXXXXXXGXXXXXXXXXXXXXXXXXXXGXXXXXXXXXXXXXXXXXXXGXXXXXXXXXXXXXXXXXXXGXXXXXXXXXXXXXXXXXXXGXXXXXXXXXXXXXXXXXXXGXXXXXXXXXXXXXXXXXXXGXXXXXXXXXXXXXXXXXXXGXXXXXXXXXXXXXXXXXXXGXXXXXXXXXXXXXXXXXXXGXXXXXXXXXXXXXXXXXXXGXXXXXXXXXXXXXXXXXXXGXXXXXXXXXXXXXXXXXXX,0,10,0
34209,13,0,13,90,497,0,0,512,372,140,GXXXXXXXXXXXXXXXXXXXGXXXXXXXXXXXXXXXXXXXGXXXXXXXXXXXXXXXXXXXGXXXXXXXXXXXXXXXXXXXGXXXXXXXXXXXXXXXXXXXGXXXXXXXXXXXXXXXXXXXGXXXXXXXXXXXXXXXXXXXGXXXXXXXXXXXXXXXXXXXGXXXXXXXXXXXXXXXXXXXGXXXXXXXXXXXXXXXXXXXGXXXXXXXXXXXXXXXXXXXGXXXXXXXXXXXXXXXXXXXGXXXXXXXXXXXXXXXXXXX,0,10,0

34230,13,0,13,94,493,0,0,507,367,140,GXXXXXXXXXXXXXXXXXXXGXXXXXXXXXXXXXXXXXXXGXXXXXXXXXXXXXXXXXXXGXXXXXXXXXXXXXXXXXXXGXXXXXXXXXXXXXXXXXXXGXXXXXXXXXXXXXXXXXXXGXXXXXXXXXXXXXXXXXXXGXXXXXXXXXXXXXXXXXXXGXXXXXXXXXXXXXXXXXXXGXXXXXXXXXXXXXXXXXXXGXXXXXXXXXXXXXXXXXXXGXXXXXXXXXXXXXXXXXXXGXXXXXXXXXXXXXXXXXXX,0,10,0
34251,13,0,13,90,497,0,0,513,374,139,GXXXXXXXXXXXXXXXXXXXGXXXXXXXXXXXXXXXXXXXGXXXXXXXXXXXXXXXXXXXGXXXXXXXXXXXXXXXXXXXGXXXXXXXXXXXXXXXXXXXGXXXXXXXXXXXXXXXXXXXGXXXXXXXXXXXXXXXXXXXGXXXXXXXXXXXXXXXXXXXGXXXXXXXXXXXXXXXXXXXGXXXXXXXXXXXXXXXXXXXGXXXXXXXXXXXXXXXXXXXGXXXXXXXXXXXXXXXXXXXGXXXXXXXXXXXXXXXXXXX,0,10,0
34272,13,0,13,97,490,0,0,506,371,135,GXXXXXXXXXXXXXXXXXXXGXXXXXXXXXXXXXXXXXXXGXXXXXXXXXXXXXXXXXXXGXXXXXXXXXXXXXXXXXXXGXXXXXXXXXXXXXXXXXXXGXXXXXXXXXXXXXXXXXXXGXXXXXXXXXXXXXXXXXXXGXXXXXXXXXXXXXXXXXXXGXXXXXXXXXXXXXXXXXXXGXXXXXXXXXXXXXXXXXXXGXXXXXXXXXXXXXXXXXXXGXXXXXXXXXXXXXXXXXXXGXXXXXXXXXXXXXXXXXXX,0,10,0
34293,16,3,13,98,486,0,0,502,370,132,GXXXXXXXXXXXXXXXXXXXGAXXXXXXXXXXXXXXXXXXGXXXXXXXXXXXXXXXXXXXGXXXXXXXXXXXXXXXXXXXGXXXXXXXXXXXXXXXXXXXGAXXXXXXXXXXXXXXXXXXGXXXXXXXXXXXXXXXXXXXGXXXXXXXXXXXXXXXXXXXGXXXXXXXXXXXXXXXXXXXGXXXXXXXXXXXXXXXXXXXGXXXXXXXXXXXXXXXXXXXGAXXXXXXXXXXXXXXXXXXGXXXXXXXXXXXXXXXXXXX,0,10,0
34314,16,3,13,95,489,0,0,506,371,135,GXXXXXXXXXXXXXXXXXXXGAXXXXXXXXXXXXXXXXXXGXXXXXXXXXXXXXXXXXXXGXXXXXXXXXXXXXXXXXXXGXXXXXXXXXXXXXXXXXXXGAXXXXXXXXXXXXXXXXXXGXXXXXXXXXXXXXXXXXXXGXXXXXXXXXXXXXXXXXXXGXXXXXXXXXXXXXXXXXXXGXXXXXXXXXXXXXXXXXXXGXXXXXXXXXXXXXXXXXXXGAXXXXXXXXXXXXXXXXXXGXXXXXXXXXXXXXXXXXXX,0,10,0

34335,16,3,13,91,493,0,0,508,368,140,GXXXXXXXXXXXXXXXXXXXGAXXXXXXXXXXXXXXXXXXGXXXXXXXXXXXXXXXXXXXGXXXXXXXXXXXXXXXXXXXGXXXXXXXXXXXXXXXXXXXGAXXXXXXXXXXXXXXXXXXGXXXXXXXXXXXXXXXXXXXGXXXXXXXXXXXXXXXXXXXGXXXXXXXXXXXXXXXXXXXGXXXXXXXXXXXXXXXXXXXGXXXXXXXXXXXXXXXXXXXGAXXXXXXXXXXXXXXXXXXGXXXXXXXXXXXXXXXXXXX,0,10,0
34356,16,2,14,87,497,0,0,511,367,144,GXXXXXXXXXXXXXXXXXXXGAXXXXXXXXXXXXXXXXXXGXXXXXXXXXXXXXXXXXXXGXXXXXXXXXXXXXXXXXXXGXXXXXXXXXXXXXXXXXXXGOXXXXXXXXXXXXXXXXXXGXXXXXXXXXXXXXXXXXXXGXXXXXXXXXXXXXXXXXXXGXXXXXXXXXXXXXXXXXXXGXXXXXXXXXXXXXXXXXXXGXXXXXXXXXXXXXXXXXXXGAXXXXXXXXXXXXXXXXXXGXXXXXXXXXXXXXXXXXXX,0,10,0
34377,17,3,14,86,497,0,0,511,368,143,GXXXXXXXXXXXXXXXXXXXGAXXXXXXXXXXXXXXXXXXGXXXXXXXXXXXXXXXXXXXGXXXXXXXXXXXXXXXXXXXGXXXXXXXXXXXXXXXXXXXGOXXXXXXXXXXXXXXXXXXGXXXXXXXXXXXXXXXXXXXGXXXXXXXXXXXXXXXXXXXGXXXXXXXXXXXXXXXXXXXGAXXXXXXXXXXXXXXXXXXGXXXXXXXXXXXXXXXXXXXGAXXXXXXXXXXXXXXXXXXGXXXXXXXXXXXXXXXXXXX,0,10,0
34398,17,3,14,77,506,0,0,520,371,149,GXXXXXXXXXXXXXXXXXXXGAXXXXXXXXXXXXXXXXXXGXXXXXXXXXXXXXXXXXXXGXXXXXXXXXXXXXXXXXXXGXXXXXXXXXXXXXXXXXXXGOXXXXXXXXXXXXXXXXXXGXXXXXXXXXXXXXXXXXXXGXXXXXXXXXXXXXXXXXXXGXXXXXXXXXXXXXXXXXXXGAXXXXXXXXXXXXXXXXXXGXXXXXXXXXXXXXXXXXXXGAXXXXXXXXXXXXXXXXXXGXXXXXXXXXXXXXXXXXXX,0,10,0
34419,16,3,13,80,504,0,0,518,371,147,GXXXXXXXXXXXXXXXXXXXGAXXXXXXXXXXXXXXXXXXGXXXXXXXXXXXXXXXXXXXGXXXXXXXXXXXXXXXXXXXGXXXXXXXXXXXXXXXXXXXGXXXXXXXXXXXXXXXXXXXGXXXXXXXXXXXXXXXXXXXGXXXXXXXXXXXXXXXXXXXGXXXXXXXXXXXXXXXXXXXGAXXXXXXXXXXXXXXXXXXGXXXXXXXXXXXXXXXXXXXGAXXXXXXXXXXXXXXXXXXGXXXXXXXXXXXXXXXXXXX,0,10,0

34440,16,2,14,77,507,0,0,520,371,149,GXXXXXXXXXXXXXXXXXXXGAXXXXXXXXXXXXXXXXXXGXXXXXXXXXXXXXXXXXXXGXXXXXXXXXXXXXXXXXXXGXXXXXXXXXXXXXXXXXXXGXXXXXXXXXXXXXXXXXXXGXXXXXXXXXXXXXXXXXXXGXXXXXXXXXXXXXXXXXXXGXXXXXXXXXXXXXXXXXXXGOXXXXXXXXXXXXXXXXXXGXXXXXXXXXXXXXXXXXXXGAXXXXXXXXXXXXXXXXXXGXXXXXXXXXXXXXXXXXXX,0,10,0
34461,15,2,13,82,503,0,0,516,369,147,GXXXXXXXXXXXXXXXXXXXGAXXXXXXXXXXXXXXXXXXGXXXXXXXXXXXXXXXXXXXGXXXXXXXXXXXXXXXXXXXGXXXXXXXXXXXXXXXXXXXGXXXXXXXXXXXXXXXXXXXGXXXXXXXXXXXXXXXXXXXGXXXXXXXXXXXXXXXXXXXGXXXXXXXXXXXXXXXXXXXGXXXXXXXXXXXXXXXXXXXGXXXXXXXXXXXXXXXXXXXGAXXXXXXXXXXXXXXXXXXGXXXXXXXXXXXXXXXXXXX,0,10,0
34482,15,1,14,73,512,0,0,525,371,154,GXXXXXXXXXXXXXXXXXXXGAXXXXXXXXXXXXXXXXXXGXXXXXXXXXXXXXXXXXXXGXXXXXXXXXXXXXXXXXXXGXXXXXXXXXXXXXXXXXXXGXXXXXXXXXXXXXXXXXXXGXXXXXXXXXXXXXXXXXXXGXXXXXXXXXXXXXXXXXXXGXXXXXXXXXXXXXXXXXXXGXXXXXXXXXXXXXXXXXXXGXXXXXXXXXXXXXXXXXXXGOXXXXXXXXXXXXXXXXXXGXXXXXXXXXXXXXXXXXXX,0,10,0
34503,13,0,13,69,518,0,0,530,374,156,GXXXXXXXXXXXXXXXXXXXGXXXXXXXXXXXXXXXXXXXGXXXXXXXXXXXXXXXXXXXGXXXXXXXXXXXXXXXXXXXGXXXXXXXXXXXXXXXXXXXGXXXXXXXXXXXXXXXXXXXGXXXXXXXXXXXXXXXXXXXGXXXXXXXXXXXXXXXXXXXGXXXXXXXXXXXXXXXXXXXGXXXXXXXXXXXXXXXXXXXGXXXXXXXXXXXXXXXXXXXGXXXXXXXXXXXXXXXXXXXGXXXXXXXXXXXXXXXXXXX,0,10,0
34524,13,0,13,67,520,0,0,530,376,154,GXXXXXXXXXXXXXXXXXXXGXXXXXXXXXXXXXXXXXXXGXXXXXXXXXXXXXXXXXXXGXXXXXXXXXXXXXXXXXXXGXXXXXXXXXXXXXXXXXXXGXXXXXXXXXXXXXXXXXXXGXXXXXXXXXXXXXXXXXXXGXXXXXXXXXXXXXXXXXXXGXXXXXXXXXXXXXXXXXXXGXXXXXXXXXXXXXXXXXXXGXXXXXXXXXXXXXXXXXXXGXXXXXXXXXXXXXXXXXXXGXXXXXXXXXXXXXXXXXXX,0,10,0

34545,13,0,13,73,514,0,0,527,371,156,GXXXXXXXXXXXXXXXXXXXGXXXXXXXXXXXXXXXXXXXGXXXXXXXXXXXXXXXXXXXGXXXXXXXXXXXXXXXXXXXGXXXXXXXXXXXXXXXXXXXGXXXXXXXXXXXXXXXXXXXGXXXXXXXXXXXXXXXXXXXGXXXXXXXXXXXXXXXXXXXGXXXXXXXXXXXXXXXXXXXGXXXXXXXXXXXXXXXXXXXGXXXXXXXXXXXXXXXXXXXGXXXXXXXXXXXXXXXXXXXGXXXXXXXXXXXXXXXXXXX,0,10,0
34566,13,0,13,70,517,0,0,530,374,156,GXXXXXXXXXXXXXXXXXXXGXXXXXXXXXXXXXXXXXXXGXXXXXXXXXXXXXXXXXXXGXXXXXXXXXXXXXXXXXXXGXXXXXXXXXXXXXXXXXXXGXXXXXXXXXXXXXXXXXXXGXXXXXXXXXXXXXXXXXXXGXXXXXXXXXXXXXXXXXXXGXXXXXXXXXXXXXXXXXXXGXXXXXXXXXXXXXXXXXXXGXXXXXXXXXXXXXXXXXXXGXXXXXXXXXXXXXXXXXXXGXXXXXXXXXXXXXXXXXXX,0,10,0
34587,13,0,13,79,508,0,0,522,369,153,GXXXXXXXXXXXXXXXXXXXGXXXXXXXXXXXXXXXXXXXGXXXXXXXXXXXXXXXXXXXGXXXXXXXXXXXXXXXXXXXGXXXXXXXXXXXXXXXXXXXGXXXXXXXXXXXXXXXXXXXGXXXXXXXXXXXXXXXXXXXGXXXXXXXXXXXXXXXXXXXGXXXXXXXXXXXXXXXXXXXGXXXXXXXXXXXXXXXXXXXGXXXXXXXXXXXXXXXXXXXGXXXXXXXXXXXXXXXXXXXGXXXXXXXXXXXXXXXXXXX,0,10,0
34608,13,0,13,85,502,0,0,516,365,151,GXXXXXXXXXXXXXXXXXXXGXXXXXXXXXXXXXXXXXXXGXXXXXXXXXXXXXXXXXXXGXXXXXXXXXXXXXXXXXXXGXXXXXXXXXXXXXXXXXXXGXXXXXXXXXXXXXXXXXXXGXXXXXXXXXXXXXXXXXXXGXXXXXXXXXXXXXXXXXXXGXXXXXXXXXXXXXXXXXXXGXXXXXXXXXXXXXXXXXXXGXXXXXXXXXXXXXXXXXXXGXXXXXXXXXXXXXXXXXXXGXXXXXXXXXXXXXXXXXXX,0,10,0
34629,13,0,13,85,502,0,0,516,368,148,GXXXXXXXXXXXXXXXXXXXGXXXXXXXXXXXXXXXXXXXGXXXXXXXXXXXXXXXXXXXGXXXXXXXXXXXXXXXXXXXGXXXXXXXXXXXXXXXXXXXGXXXXXXXXXXXXXXXXXXXGXXXXXXXXXXXXXXXXXXXGXXXXXXXXXXXXXXXXXXXGXXXXXXXXXXXXXXXXXXXGXXXXXXXXXXXXXXXXXXXGXXXXXXXXXXXXXXXXXXXGXXXXXXXXXXXXXXXXXXXGXXXXXXXXXXXXXXXXXXX,0,10,0

34650,13,0,13,82,505,0,0,519,371,148,GXXXXXXXXXXXXXXXXXXXGXXXXXXXXXXXXXXXXXXXGXXXXXXXXXXXXXXXXXXXGXXXXXXXXXXXXXXXXXXXGXXXXXXXXXXXXXXXXXXXGXXXXXXXXXXXXXXXXXXXGXXXXXXXXXXXXXXXXXXXGXXXXXXXXXXXXXXXXXXXGXXXXXXXXXXXXXXXXXXXGXXXXXXXXXXXXXXXXXXXGXXXXXXXXXXXXXXXXXXXGXXXXXXXXXXXXXXXXXXXGXXXXXXXXXXXXXXXXXXX,0,10,0
34671,13,0,13,88,499,0,0,513,370,143,GXXXXXXXXXXXXXXXXXXXGXXXXXXXXXXXXXXXXXXXGXXXXXXXXXXXXXXXXXXXGXXXXXXXXXXXXXXXXXXXGXXXXXXXXXXXXXXXXXXXGXXXXXXXXXXXXXXXXXXXGXXXXXXXXXXXXXXXXXXXGXXXXXXXXXXXXXXXXXXXGXXXXXXXXXXXXXXXXXXXGXXXXXXXXXXXXXXXXXXXGXXXXXXXXXXXXXXXXXXXGXXXXXXXXXXXXXXXXXXXGXXXXXXXXXXXXXXXXXXX,0,10,0
34692,13,0,13,88,499,0,0,512,376,136,GXXXXXXXXXXXXXXXXXXXGXXXXXXXXXXXXXXXXXXXGXXXXXXXXXXXXXXXXXXXGXXXXXXXXXXXXXXXXXXXGXXXXXXXXXXXXXXXXXXXGXXXXXXXXXXXXXXXXXXXGXXXXXXXXXXXXXXXXXXXGXXXXXXXXXXXXXXXXXXXGXXXXXXXXXXXXXXXXXXXGXXXXXXXXXXXXXXXXXXXGXXXXXXXXXXXXXXXXXXXGXXXXXXXXXXXXXXXXXXXGXXXXXXXXXXXXXXXXXXX,0,10,0
34713,13,0,13,88,499,0,0,512,372,140,GXXXXXXXXXXXXXXXXXXXGXXXXXXXXXXXXXXXXXXXGXXXXXXXXXXXXXXXXXXXGXXXXXXXXXXXXXXXXXXXGXXXXXXXXXXXXXXXXXXXGXXXXXXXXXXXXXXXXXXXGXXXXXXXXXXXXXXXXXXXGXXXXXXXXXXXXXXXXXXXGXXXXXXXXXXXXXXXXXXXGXXXXXXXXXXXXXXXXXXXGXXXXXXXXXXXXXXXXXXXGXXXXXXXXXXXXXXXXXXXGXXXXXXXXXXXXXXXXXXX,0,10,0
34734,13,0,13,89,498,0,0,511,374,137,GXXXXXXXXXXXXXXXXXXXGXXXXXXXXXXXXXXXXXXXGXXXXXXXXXXXXXXXXXXXGXXXXXXXXXXXXXXXXXXXGXXXXXXXXXXXXXXXXXXXGXXXXXXXXXXXXXXXXXXXGXXXXXXXXXXXXXXXXXXXGXXXXXXXXXXXXXXXXXXXGXXXXXXXXXXXXXXXXXXXGXXXXXXXXXXXXXXXXXXXGXXXXXXXXXXXXXXXXXXXGXXXXXXXXXXXXXXXXXXXGXXXXXXXXXXXXXXXXXXX,0,10,0

34755,13,0,13,93,494,0,0,508,372,136,GXXXXXXXXXXXXXXXXXXXGXXXXXXXXXXXXXXXXXXXGXXXXXXXXXXXXXXXXXXXGXXXXXXXXXXXXXXXXXXXGXXXXXXXXXXXXXXXXXXXGXXXXXXXXXXXXXXXXXXXGXXXXXXXXXXXXXXXXXXXGXXXXXXXXXXXXXXXXXXXGXXXXXXXXXXXXXXXXXXXGXXXXXXXXXXXXXXXXXXXGXXXXXXXXXXXXXXXXXXXGXXXXXXXXXXXXXXXXXXXGXXXXXXXXXXXXXXXXXXX,0,10,0
34776,13,0,13,93,494,0,0,509,370,139,GXXXXXXXXXXXXXXXXXXXGXXXXXXXXXXXXXXXXXXXGXXXXXXXXXXXXXXXXXXXGXXXXXXXXXXXXXXXXXXXGXXXXXXXXXXXXXXXXXXXGXXXXXXXXXXXXXXXXXXXGXXXXXXXXXXXXXXXXXXXGXXXXXXXXXXXXXXXXXXXGXXXXXXXXXXXXXXXXXXXGXXXXXXXXXXXXXXXXXXXGXXXXXXXXXXXXXXXXXXXGXXXXXXXXXXXXXXXXXXXGXXXXXXXXXXXXXXXXXXX,0,10,0
34797,13,0,13,95,492,0,0,507,371,136,GXXXXXXXXXXXXXXXXXXXGXXXXXXXXXXXXXXXXXXXGXXXXXXXXXXXXXXXXXXXGXXXXXXXXXXXXXXXXXXXGXXXXXXXXXXXXXXXXXXXGXXXXXXXXXXXXXXXXXXXGXXXXXXXXXXXXXXXXXXXGXXXXXXXXXXXXXXXXXXXGXXXXXXXXXXXXXXXXXXXGXXXXXXXXXXXXXXXXXXXGXXXXXXXXXXXXXXXXXXXGXXXXXXXXXXXXXXXXXXXGXXXXXXXXXXXXXXXXXXX,0,10,0
34818,13,0,13,90,497,0,0,512,371,141,GXXXXXXXXXXXXXXXXXXXGXXXXXXXXXXXXXXXXXXXGXXXXXXXXXXXXXXXXXXXGXXXXXXXXXXXXXXXXXXXGXXXXXXXXXXXXXXXXXXXGXXXXXXXXXXXXXXXXXXXGXXXXXXXXXXXXXXXXXXXGXXXXXXXXXXXXXXXXXXXGXXXXXXXXXXXXXXXXXXXGXXXXXXXXXXXXXXXXXXXGXXXXXXXXXXXXXXXXXXXGXXXXXXXXXXXXXXXXXXXGXXXXXXXXXXXXXXXXXXX,0,10,0
34839,13,0,13,85,502,0,0,517,371,146,GXXXXXXXXXXXXXXXXXXXGXXXXXXXXXXXXXXXXXXXGXXXXXXXXXXXXXXXXXXXGXXXXXXXXXXXXXXXXXXXGXXXXXXXXXXXXXXXXXXXGXXXXXXXXXXXXXXXXXXXGXXXXXXXXXXXXXXXXXXXGXXXXXXXXXXXXXXXXXXXGXXXXXXXXXXXXXXXXXXXGXXXXXXXXXXXXXXXXXXXGXXXXXXXXXXXXXXXXXXXGXXXXXXXXXXXXXXXXXXXGXXXXXXXXXXXXXXXXXXX,0,10,0

34860,13,0,13,85,502,0,0,515,374,141,GXXXXXXXXXXXXXXXXXXXGXXXXXXXXXXXXXXXXXXXGXXXXXXXXXXXXXXXXXXXGXXXXXXXXXXXXXXXXXXXGXXXXXXXXXXXXXXXXXXXGXXXXXXXXXXXXXXXXXXXGXXXXXXXXXXXXXXXXXXXGXXXXXXXXXXXXXXXXXXXGXXXXXXXXXXXXXXXXXXXGXXXXXXXXXXXXXXXXXXXGXXXXXXXXXXXXXXXXXXXGXXXXXXXXXXXXXXXXXXXGXXXXXXXXXXXXXXXXXXX,0,10,0
34881,13,0,13,84,503,0,0,519,370,149,GXXXXXXXXXXXXXXXXXXXGXXXXXXXXXXXXXXXXXXXGXXXXXXXXXXXXXXXXXXXGXXXXXXXXXXXXXXXXXXXGXXXXXXXXXXXXXXXXXXXGXXXXXXXXXXXXXXXXXXXGXXXXXXXXXXXXXXXXXXXGXXXXXXXXXXXXXXXXXXXGXXXXXXXXXXXXXXXXXXXGXXXXXXXXXXXXXXXXXXXGXXXXXXXXXXXXXXXXXXXGXXXXXXXXXXXXXXXXXXXGXXXXXXXXXXXXXXXXXXX,0,10,0
34902,14,1,13,72,514,0,0,528,375,153,GXXXXXXXXXXXXXXXXXXXGXXXXXXXXXXXXXXXXXXXGXXXXXXXXXXXXXXXXXXXGXXXXXXXXXXXXXXXXXXXGXXXXXXXXXXXXXXXXXXXGXXXXXXXXXXXXXXXXXXXGXXXXXXXXXXXXXXXXXXXGXXXXXXXXXXXXXXXXXXXGAXXXXXXXXXXXXXXXXXXGXXXXXXXXXXXXXXXXXXXGXXXXXXXXXXXXXXXXXXXGXXXXXXXXXXXXXXXXXXXGXXXXXXXXXXXXXXXXXXX,0,10,0
34923,14,1,13,75,511,0,0,525,379,146,GXXXXXXXXXXXXXXXXXXXGXXXXXXXXXXXXXXXXXXXGXXXXXXXXXXXXXXXXXXXGXXXXXXXXXXXXXXXXXXXGXXXXXXXXXXXXXXXXXXXGXXXXXXXXXXXXXXXXXXXGXXXXXXXXXXXXXXXXXXXGXXXXXXXXXXXXXXXXXXXGAXXXXXXXXXXXXXXXXXXGXXXXXXXXXXXXXXXXXXXGXXXXXXXXXXXXXXXXXXXGXXXXXXXXXXXXXXXXXXXGXXXXXXXXXXXXXXXXXXX,0,10,0
34944,14,1,13,80,506,0,0,520,378,142,GXXXXXXXXXXXXXXXXXXXGXXXXXXXXXXXXXXXXXXXGXXXXXXXXXXXXXXXXXXXGXXXXXXXXXXXXXXXXXXXGXXXXXXXXXXXXXXXXXXXGXXXXXXXXXXXXXXXXXXXGXXXXXXXXXXXXXXXXXXXGXXXXXXXXXXXXXXXXXXXGAXXXXXXXXXXXXXXXXXXGXXXXXXXXXXXXXXXXXXXGXXXXXXXXXXXXXXXXXXXGXXXXXXXXXXXXXXXXXXXGXXXXXXXXXXXXXXXXXXX,0,10,0

34965,14,1,13,81,505,0,0,519,374,145,GXXXXXXXXXXXXXXXXXXXGXXXXXXXXXXXXXXXXXXXGXXXXXXXXXXXXXXXXXXXGXXXXXXXXXXXXXXXXXXXGXXXXXXXXXXXXXXXXXXXGXXXXXXXXXXXXXXXXXXXGXXXXXXXXXXXXXXXXXXXGXXXXXXXXXXXXXXXXXXXGAXXXXXXXXXXXXXXXXXXGXXXXXXXXXXXXXXXXXXXGXXXXXXXXXXXXXXXXXXXGXXXXXXXXXXXXXXXXXXXGXXXXXXXXXXXXXXXXXXX,0,10,0
34986,14,1,13,80,506,0,0,521,376,145,GXXXXXXXXXXXXXXXXXXXGXXXXXXXXXXXXXXXXXXXGXXXXXXXXXXXXXXXXXXXGXXXXXXXXXXXXXXXXXXXGXXXXXXXXXXXXXXXXXXXGXXXXXXXXXXXXXXXXXXXGXXXXXXXXXXXXXXXXXXXGXXXXXXXXXXXXXXXXXXXGAXXXXXXXXXXXXXXXXXXGXXXXXXXXXXXXXXXXXXXGXXXXXXXXXXXXXXXXXXXGXXXXXXXXXXXXXXXXXXXGXXXXXXXXXXXXXXXXXXX,0,10,0
35007,14,1,13,81,505,0,0,520,372,148,GXXXXXXXXXXXXXXXXXXXGXXXXXXXXXXXXXXXXXXXGXXXXXXXXXXXXXXXXXXXGXXXXXXXXXXXXXXXXXXXGXXXXXXXXXXXXXXXXXXXGXXXXXXXXXXXXXXXXXXXGXXXXXXXXXXXXXXXXXXXGXXXXXXXXXXXXXXXXXXXGAXXXXXXXXXXXXXXXXXXGXXXXXXXXXXXXXXXXXXXGXXXXXXXXXXXXXXXXXXXGXXXXXXXXXXXXXXXXXXXGXXXXXXXXXXXXXXXXXXX,0,10,0
35028,14,1,13,84,502,0,0,518,373,145,GXXXXXXXXXXXXXXXXXXXGXXXXXXXXXXXXXXXXXXXGXXXXXXXXXXXXXXXXXXXGXXXXXXXXXXXXXXXXXXXGXXXXXXXXXXXXXXXXXXXGXXXXXXXXXXXXXXXXXXXGXXXXXXXXXXXXXXXXXXXGXXXXXXXXXXXXXXXXXXXGAXXXXXXXXXXXXXXXXXXGXXXXXXXXXXXXXXXXXXXGXXXXXXXXXXXXXXXXXXXGXXXXXXXXXXXXXXXXXXXGXXXXXXXXXXXXXXXXXXX,0,10,0
35049,14,1,13,79,507,0,0,523,377,146,GXXXXXXXXXXXXXXXXXXXGXXXXXXXXXXXXXXXXXXXGXXXXXXXXXXXXXXXXXXXGXXXXXXXXXXXXXXXXXXXGXXXXXXXXXXXXXXXXXXXGXXXXXXXXXXXXXXXXXXXGXXXXXXXXXXXXXXXXXXXGXXXXXXXXXXXXXXXXXXXGAXXXXXXXXXXXXXXXXXXGXXXXXXXXXXXXXXXXXXXGXXXXXXXXXXXXXXXXXXXGXXXXXXXXXXXXXXXXXXXGXXXXXXXXXXXXXXXXXXX,0,10,0

35070,14,0,14,79,507,0,0,522,378,144,GXXXXXXXXXXXXXXXXXXXGXXXXXXXXXXXXXXXXXXXGXXXXXXXXXXXXXXXXXXXGXXXXXXXXXXXXXXXXXXXGXXXXXXXXXXXXXXXXXXXGXXXXXXXXXXXXXXXXXXXGXXXXXXXXXXXXXXXXXXXGXXXXXXXXXXXXXXXXXXXGOXXXXXXXXXXXXXXXXXXGXXXXXXXXXXXXXXXXXXXGXXXXXXXXXXXXXXXXXXXGXXXXXXXXXXXXXXXXXXXGXXXXXXXXXXXXXXXXXXX,0,10,0
35091,14,0,14,74,512,0,0,525,377,148,GXXXXXXXXXXXXXXXXXXXGXXXXXXXXXXXXXXXXXXXGXXXXXXXXXXXXXXXXXXXGXXXXXXXXXXXXXXXXXXXGXXXXXXXXXXXXXXXXXXXGXXXXXXXXXXXXXXXXXXXGXXXXXXXXXXXXXXXXXXXGXXXXXXXXXXXXXXXXXXXGOXXXXXXXXXXXXXXXXXXGXXXXXXXXXXXXXXXXXXXGXXXXXXXXXXXXXXXXXXXGXXXXXXXXXXXXXXXXXXXGXXXXXXXXXXXXXXXXXXX,0,10,0
35112,13,0,13,87,500,0,0,513,374,139,GXXXXXXXXXXXXXXXXXXXGXXXXXXXXXXXXXXXXXXXGXXXXXXXXXXXXXXXXXXXGXXXXXXXXXXXXXXXXXXXGXXXXXXXXXXXXXXXXXXXGXXXXXXXXXXXXXXXXXXXGXXXXXXXXXXXXXXXXXXXGXXXXXXXXXXXXXXXXXXXGXXXXXXXXXXXXXXXXXXXGXXXXXXXXXXXXXXXXXXXGXXXXXXXXXXXXXXXXXXXGXXXXXXXXXXXXXXXXXXXGXXXXXXXXXXXXXXXXXXX,0,10,0
35133,13,0,13,86,501,0,0,513,375,138,GXXXXXXXXXXXXXXXXXXXGXXXXXXXXXXXXXXXXXXXGXXXXXXXXXXXXXXXXXXXGXXXXXXXXXXXXXXXXXXXGXXXXXXXXXXXXXXXXXXXGXXXXXXXXXXXXXXXXXXXGXXXXXXXXXXXXXXXXXXXGXXXXXXXXXXXXXXXXXXXGXXXXXXXXXXXXXXXXXXXGXXXXXXXXXXXXXXXXXXXGXXXXXXXXXXXXXXXXXXXGXXXXXXXXXXXXXXXXXXXGXXXXXXXXXXXXXXXXXXX,0,10,0
35154,13,0,13,94,493,0,0,506,369,137,GXXXXXXXXXXXXXXXXXXXGXXXXXXXXXXXXXXXXXXXGXXXXXXXXXXXXXXXXXXXGXXXXXXXXXXXXXXXXXXXGXXXXXXXXXXXXXXXXXXXGXXXXXXXXXXXXXXXXXXXGXXXXXXXXXXXXXXXXXXXGXXXXXXXXXXXXXXXXXXXGXXXXXXXXXXXXXXXXXXXGXXXXXXXXXXXXXXXXXXXGXXXXXXXXXXXXXXXXXXXGXXXXXXXXXXXXXXXXXXXGXXXXXXXXXXXXXXXXXXX,0,10,0

35175,13,0,13,88,499,0,0,512,373,139,GXXXXXXXXXXXXXXXXXXXGXXXXXXXXXXXXXXXXXXXGXXXXXXXXXXXXXXXXXXXGXXXXXXXXXXXXXXXXXXXGXXXXXXXXXXXXXXXXXXXGXXXXXXXXXXXXXXXXXXXGXXXXXXXXXXXXXXXXXXXGXXXXXXXXXXXXXXXXXXXGXXXXXXXXXXXXXXXXXXXGXXXXXXXXXXXXXXXXXXXGXXXXXXXXXXXXXXXXXXXGXXXXXXXXXXXXXXXXXXXGXXXXXXXXXXXXXXXXXXX,0,10,0
35196,13,0,13,85,502,0,0,513,377,136,GXXXXXXXXXXXXXXXXXXXGXXXXXXXXXXXXXXXXXXXGXXXXXXXXXXXXXXXXXXXGXXXXXXXXXXXXXXXXXXXGXXXXXXXXXXXXXXXXXXXGXXXXXXXXXXXXXXXXXXXGXXXXXXXXXXXXXXXXXXXGXXXXXXXXXXXXXXXXXXXGXXXXXXXXXXXXXXXXXXXGXXXXXXXXXXXXXXXXXXXGXXXXXXXXXXXXXXXXXXXGXXXXXXXXXXXXXXXXXXXGXXXXXXXXXXXXXXXXXXX,0,10,0
35217,13,0,13,84,503,0,0,515,377,138,GXXXXXXXXXXXXXXXXXXXGXXXXXXXXXXXXXXXXXXXGXXXXXXXXXXXXXXXXXXXGXXXXXXXXXXXXXXXXXXXGXXXXXXXXXXXXXXXXXXXGXXXXXXXXXXXXXXXXXXXGXXXXXXXXXXXXXXXXXXXGXXXXXXXXXXXXXXXXXXXGXXXXXXXXXXXXXXXXXXXGXXXXXXXXXXXXXXXXXXXGXXXXXXXXXXXXXXXXXXXGXXXXXXXXXXXXXXXXXXXGXXXXXXXXXXXXXXXXXXX,0,10,0
35238,13,0,13,81,506,0,0,518,374,144,GXXXXXXXXXXXXXXXXXXXGXXXXXXXXXXXXXXXXXXXGXXXXXXXXXXXXXXXXXXXGXXXXXXXXXXXXXXXXXXXGXXXXXXXXXXXXXXXXXXXGXXXXXXXXXXXXXXXXXXXGXXXXXXXXXXXXXXXXXXXGXXXXXXXXXXXXXXXXXXXGXXXXXXXXXXXXXXXXXXXGXXXXXXXXXXXXXXXXXXXGXXXXXXXXXXXXXXXXXXXGXXXXXXXXXXXXXXXXXXXGXXXXXXXXXXXXXXXXXXX,0,10,0
35259,13,0,13,81,506,0,0,519,372,147,GXXXXXXXXXXXXXXXXXXXGXXXXXXXXXXXXXXXXXXXGXXXXXXXXXXXXXXXXXXXGXXXXXXXXXXXXXXXXXXXGXXXXXXXXXXXXXXXXXXXGXXXXXXXXXXXXXXXXXXXGXXXXXXXXXXXXXXXXXXXGXXXXXXXXXXXXXXXXXXXGXXXXXXXXXXXXXXXXXXXGXXXXXXXXXXXXXXXXXXXGXXXXXXXXXXXXXXXXXXXGXXXXXXXXXXXXXXXXXXXGXXXXXXXXXXXXXXXXXXX,0,10,0

35280,14,1,13,83,503,0,0,516,373,143,GXXXXXXXXXXXXXXXXXXXGXXXXXXXXXXXXXXXXXXXGXXXXXXXXXXXXXXXXXXXGXXXXXXXXXXXXXXXXXXXGXXXXXXXXXXXXXXXXXXXGXXXXXXXXXXXXXXXXXXXGXXXXXXXXXXXXXXXXXXXGXXXXXXXXXXXXXXXXXXXGXXXXXXXXXXXXXXXXXXXGXXXXXXXXXXXXXXXXXXXGXXXXXXXXXXXXXXXXXXXGAXXXXXXXXXXXXXXXXXXGXXXXXXXXXXXXXXXXXXX,0,10,0
35301,14,1,13,82,504,0,0,517,370,147,GXXXXXXXXXXXXXXXXXXXGXXXXXXXXXXXXXXXXXXXGXXXXXXXXXXXXXXXXXXXGXXXXXXXXXXXXXXXXXXXGXXXXXXXXXXXXXXXXXXXGXXXXXXXXXXXXXXXXXXXGXXXXXXXXXXXXXXXXXXXGXXXXXXXXXXXXXXXXXXXGXXXXXXXXXXXXXXXXXXXGXXXXXXXXXXXXXXXXXXXGXXXXXXXXXXXXXXXXXXXGAXXXXXXXXXXXXXXXXXXGXXXXXXXXXXXXXXXXXXX,0,10,0
35322,14,1,13,79,507,0,0,521,370,151,GXXXXXXXXXXXXXXXXXXXGXXXXXXXXXXXXXXXXXXXGXXXXXXXXXXXXXXXXXXXGXXXXXXXXXXXXXXXXXXXGXXXXXXXXXXXXXXXXXXXGXXXXXXXXXXXXXXXXXXXGXXXXXXXXXXXXXXXXXXXGXXXXXXXXXXXXXXXXXXXGXXXXXXXXXXXXXXXXXXXGXXXXXXXXXXXXXXXXXXXGXXXXXXXXXXXXXXXXXXXGAXXXXXXXXXXXXXXXXXXGXXXXXXXXXXXXXXXXXXX,0,10,0
35343,14,1,13,80,506,0,0,519,373,146,GXXXXXXXXXXXXXXXXXXXGXXXXXXXXXXXXXXXXXXXGXXXXXXXXXXXXXXXXXXXGXXXXXXXXXXXXXXXXXXXGXXXXXXXXXXXXXXXXXXXGXXXXXXXXXXXXXXXXXXXGXXXXXXXXXXXXXXXXXXXGXXXXXXXXXXXXXXXXXXXGXXXXXXXXXXXXXXXXXXXGXXXXXXXXXXXXXXXXXXXGXXXXXXXXXXXXXXXXXXXGAXXXXXXXXXXXXXXXXXXGXXXXXXXXXXXXXXXXXXX,0,10,0
35364,14,1,13,82,504,0,0,517,375,142,GXXXXXXXXXXXXXXXXXXXGXXXXXXXXXXXXXXXXXXXGXXXXXXXXXXXXXXXXXXXGXXXXXXXXXXXXXXXXXXXGXXXXXXXXXXXXXXXXXXXGXXXXXXXXXXXXXXXXXXXGXXXXXXXXXXXXXXXXXXXGXXXXXXXXXXXXXXXXXXXGXXXXXXXXXXXXXXXXXXXGXXXXXXXXXXXXXXXXXXXGXXXXXXXXXXXXXXXXXXXGAXXXXXXXXXXXXXXXXXXGXXXXXXXXXXXXXXXXXXX,0,10,0

35385,14,1,13,86,500,0,0,515,373,142,GXXXXXXXXXXXXXXXXXXXGXXXXXXXXXXXXXXXXXXXGXXXXXXXXXXXXXXXXXXXGXXXXXXXXXXXXXXXXXXXGXXXXXXXXXXXXXXXXXXXGXXXXXXXXXXXXXXXXXXXGXXXXXXXXXXXXXXXXXXXGXXXXXXXXXXXXXXXXXXXGXXXXXXXXXXXXXXXXXXXGXXXXXXXXXXXXXXXXXXXGXXXXXXXXXXXXXXXXXXXGAXXXXXXXXXXXXXXXXXXGXXXXXXXXXXXXXXXXXXX,0,10,0
35406,14,1,13,82,504,0,0,519,376,143,GXXXXXXXXXXXXXXXXXXXGXXXXXXXXXXXXXXXXXXXGXXXXXXXXXXXXXXXXXXXGXXXXXXXXXXXXXXXXXXXGXXXXXXXXXXXXXXXXXXXGXXXXXXXXXXXXXXXXXXXGXXXXXXXXXXXXXXXXXXXGXXXXXXXXXXXXXXXXXXXGXXXXXXXXXXXXXXXXXXXGXXXXXXXXXXXXXXXXXXXGXXXXXXXXXXXXXXXXXXXGAXXXXXXXXXXXXXXXXXXGXXXXXXXXXXXXXXXXXXX,0,10,0
35427,14,1,13,78,508,0,0,523,374,149,GXXXXXXXXXXXXXXXXXXXGXXXXXXXXXXXXXXXXXXXGXXXXXXXXXXXXXXXXXXXGXXXXXXXXXXXXXXXXXXXGXXXXXXXXXXXXXXXXXXXGXXXXXXXXXXXXXXXXXXXGXXXXXXXXXXXXXXXXXXXGXXXXXXXXXXXXXXXXXXXGXXXXXXXXXXXXXXXXXXXGXXXXXXXXXXXXXXXXXXXGXXXXXXXXXXXXXXXXXXXGAXXXXXXXXXXXXXXXXXXGXXXXXXXXXXXXXXXXXXX,0,10,0
35448,14,1,13,71,515,0,0,529,380,149,GXXXXXXXXXXXXXXXXXXXGXXXXXXXXXXXXXXXXXXXGXXXXXXXXXXXXXXXXXXXGXXXXXXXXXXXXXXXXXXXGXXXXXXXXXXXXXXXXXXXGXXXXXXXXXXXXXXXXXXXGXXXXXXXXXXXXXXXXXXXGXXXXXXXXXXXXXXXXXXXGXXXXXXXXXXXXXXXXXXXGXXXXXXXXXXXXXXXXXXXGXXXXXXXXXXXXXXXXXXXGAXXXXXXXXXXXXXXXXXXGXXXXXXXXXXXXXXXXXXX,0,10,0
35469,15,2,13,68,517,0,0,531,381,150,GXXXXXXXXXXXXXXXXXXXGXXXXXXXXXXXXXXXXXXXGXXXXXXXXXXXXXXXXXXXGXXXXXXXXXXXXXXXXXXXGXXXXXXXXXXXXXXXXXXXGXXXXXXXXXXXXXXXXXXXGXXXXXXXXXXXXXXXXXXXGXXXXXXXXXXXXXXXXXXXGXXXXXXXXXXXXXXXXXXXGXXXXXXXXXXXXXXXXXXXGAXXXXXXXXXXXXXXXXXXGAXXXXXXXXXXXXXXXXXXGXXXXXXXXXXXXXXXXXXX,0,10,0

35490,14,1,13,74,512,0,0,526,379,147,GXXXXXXXXXXXXXXXXXXXGXXXXXXXXXXXXXXXXXXXGXXXXXXXXXXXXXXXXXXXGXXXXXXXXXXXXXXXXXXXGXXXXXXXXXXXXXXXXXXXGXXXXXXXXXXXXXXXXXXXGXXXXXXXXXXXXXXXXXXXGXXXXXXXXXXXXXXXXXXXGXXXXXXXXXXXXXXXXXXXGXXXXXXXXXXXXXXXXXXXGAXXXXXXXXXXXXXXXXXXGXXXXXXXXXXXXXXXXXXXGXXXXXXXXXXXXXXXXXXX,0,10,0
35511,14,1,13,73,513,0,0,526,374,152,GXXXXXXXXXXXXXXXXXXXGXXXXXXXXXXXXXXXXXXXGXXXXXXXXXXXXXXXXXXXGXXXXXXXXXXXXXXXXXXXGXXXXXXXXXXXXXXXXXXXGXXXXXXXXXXXXXXXXXXXGXXXXXXXXXXXXXXXXXXXGXXXXXXXXXXXXXXXXXXXGXXXXXXXXXXXXXXXXXXXGXXXXXXXXXXXXXXXXXXXGAXXXXXXXXXXXXXXXXXXGXXXXXXXXXXXXXXXXXXXGXXXXXXXXXXXXXXXXXXX,0,10,0
35532,14,1,13,69,517,0,0,531,375,156,GXXXXXXXXXXXXXXXXXXXGXXXXXXXXXXXXXXXXXXXGXXXXXXXXXXXXXXXXXXXGXXXXXXXXXXXXXXXXXXXGXXXXXXXXXXXXXXXXXXXGXXXXXXXXXXXXXXXXXXXGXXXXXXXXXXXXXXXXXXXGXXXXXXXXXXXXXXXXXXXGXXXXXXXXXXXXXXXXXXXGXXXXXXXXXXXXXXXXXXXGAXXXXXXXXXXXXXXXXXXGXXXXXXXXXXXXXXXXXXXGXXXXXXXXXXXXXXXXXXX,0,10,0
35553,14,1,13,68,518,0,0,533,375,158,GXXXXXXXXXXXXXXXXXXXGXXXXXXXXXXXXXXXXXXXGXXXXXXXXXXXXXXXXXXXGXXXXXXXXXXXXXXXXXXXGXXXXXXXXXXXXXXXXXXXGXXXXXXXXXXXXXXXXXXXGXXXXXXXXXXXXXXXXXXXGXXXXXXXXXXXXXXXXXXXGXXXXXXXXXXXXXXXXXXXGXXXXXXXXXXXXXXXXXXXGAXXXXXXXXXXXXXXXXXXGXXXXXXXXXXXXXXXXXXXGXXXXXXXXXXXXXXXXXXX,0,10,0
35574,14,0,14,73,513,0,0,527,372,155,GXXXXXXXXXXXXXXXXXXXGXXXXXXXXXXXXXXXXXXXGXXXXXXXXXXXXXXXXXXXGXXXXXXXXXXXXXXXXXXXGXXXXXXXXXXXXXXXXXXXGXXXXXXXXXXXXXXXXXXXGXXXXXXXXXXXXXXXXXXXGXXXXXXXXXXXXXXXXXXXGXXXXXXXXXXXXXXXXXXXGXXXXXXXXXXXXXXXXXXXGOXXXXXXXXXXXXXXXXXXGXXXXXXXXXXXXXXXXXXXGXXXXXXXXXXXXXXXXXXX,0,10,0

35595,15,1,14,72,513,0,0,526,373,153,GXXXXXXXXXXXXXXXXXXXGAXXXXXXXXXXXXXXXXXXGXXXXXXXXXXXXXXXXXXXGXXXXXXXXXXXXXXXXXXXGXXXXXXXXXXXXXXXXXXXGXXXXXXXXXXXXXXXXXXXGXXXXXXXXXXXXXXXXXXXGXXXXXXXXXXXXXXXXXXXGXXXXXXXXXXXXXXXXXXXGXXXXXXXXXXXXXXXXXXXGOXXXXXXXXXXXXXXXXXXGXXXXXXXXXXXXXXXXXXXGXXXXXXXXXXXXXXXXXXX,0,10,0
35616,14,1,13,72,514,0,0,528,373,155,GXXXXXXXXXXXXXXXXXXXGAXXXXXXXXXXXXXXXXXXGXXXXXXXXXXXXXXXXXXXGXXXXXXXXXXXXXXXXXXXGXXXXXXXXXXXXXXXXXXXGXXXXXXXXXXXXXXXXXXXGXXXXXXXXXXXXXXXXXXXGXXXXXXXXXXXXXXXXXXXGXXXXXXXXXXXXXXXXXXXGXXXXXXXXXXXXXXXXXXXGXXXXXXXXXXXXXXXXXXXGXXXXXXXXXXXXXXXXXXXGXXXXXXXXXXXXXXXXXXX,0,10,0
35637,14,1,13,76,510,0,0,524,371,153,GXXXXXXXXXXXXXXXXXXXGAXXXXXXXXXXXXXXXXXXGXXXXXXXXXXXXXXXXXXXGXXXXXXXXXXXXXXXXXXXGXXXXXXXXXXXXXXXXXXXGXXXXXXXXXXXXXXXXXXXGXXXXXXXXXXXXXXXXXXXGXXXXXXXXXXXXXXXXXXXGXXXXXXXXXXXXXXXXXXXGXXXXXXXXXXXXXXXXXXXGXXXXXXXXXXXXXXXXXXXGXXXXXXXXXXXXXXXXXXXGXXXXXXXXXXXXXXXXXXX,0,10,0
35658,13,0,13,77,510,0,0,524,376,148,GXXXXXXXXXXXXXXXXXXXGXXXXXXXXXXXXXXXXXXXGXXXXXXXXXXXXXXXXXXXGXXXXXXXXXXXXXXXXXXXGXXXXXXXXXXXXXXXXXXXGXXXXXXXXXXXXXXXXXXXGXXXXXXXXXXXXXXXXXXXGXXXXXXXXXXXXXXXXXXXGXXXXXXXXXXXXXXXXXXXGXXXXXXXXXXXXXXXXXXXGXXXXXXXXXXXXXXXXXXXGXXXXXXXXXXXXXXXXXXXGXXXXXXXXXXXXXXXXXXX,0,10,0
35679,13,0,13,74,513,0,0,526,378,148,GXXXXXXXXXXXXXXXXXXXGXXXXXXXXXXXXXXXXXXXGXXXXXXXXXXXXXXXXXXXGXXXXXXXXXXXXXXXXXXXGXXXXXXXXXXXXXXXXXXXGXXXXXXXXXXXXXXXXXXXGXXXXXXXXXXXXXXXXXXXGXXXXXXXXXXXXXXXXXXXGXXXXXXXXXXXXXXXXXXXGXXXXXXXXXXXXXXXXXXXGXXXXXXXXXXXXXXXXXXXGXXXXXXXXXXXXXXXXXXXGXXXXXXXXXXXXXXXXXXX,0,10,0

35700,13,0,13,73,514,0,0,527,376,151,GXXXXXXXXXXXXXXXXXXXGXXXXXXXXXXXXXXXXXXXGXXXXXXXXXXXXXXXXXXXGXXXXXXXXXXXXXXXXXXXGXXXXXXXXXXXXXXXXXXXGXXXXXXXXXXXXXXXXXXXGXXXXXXXXXXXXXXXXXXXGXXXXXXXXXXXXXXXXXXXGXXXXXXXXXXXXXXXXXXXGXXXXXXXXXXXXXXXXXXXGXXXXXXXXXXXXXXXXXXXGXXXXXXXXXXXXXXXXXXXGXXXXXXXXXXXXXXXXXXX,0,10,0
35721,13,0,13,63,524,0,0,536,378,158,GXXXXXXXXXXXXXXXXXXXGXXXXXXXXXXXXXXXXXXXGXXXXXXXXXXXXXXXXXXXGXXXXXXXXXXXXXXXXXXXGXXXXXXXXXXXXXXXXXXXGXXXXXXXXXXXXXXXXXXXGXXXXXXXXXXXXXXXXXXXGXXXXXXXXXXXXXXXXXXXGXXXXXXXXXXXXXXXXXXXGXXXXXXXXXXXXXXXXXXXGXXXXXXXXXXXXXXXXXXXGXXXXXXXXXXXXXXXXXXXGXXXXXXXXXXXXXXXXXXX,0,10,0
35742,13,0,13,70,517,0,0,531,379,152,GXXXXXXXXXXXXXXXXXXXGXXXXXXXXXXXXXXXXXXXGXXXXXXXXXXXXXXXXXXXGXXXXXXXXXXXXXXXXXXXGXXXXXXXXXXXXXXXXXXXGXXXXXXXXXXXXXXXXXXXGXXXXXXXXXXXXXXXXXXXGXXXXXXXXXXXXXXXXXXXGXXXXXXXXXXXXXXXXXXXGXXXXXXXXXXXXXXXXXXXGXXXXXXXXXXXXXXXXXXXGXXXXXXXXXXXXXXXXXXXGXXXXXXXXXXXXXXXXXXX,0,10,0
35763,13,0,13,70,517,0,0,531,381,150,GXXXXXXXXXXXXXXXXXXXGXXXXXXXXXXXXXXXXXXXGXXXXXXXXXXXXXXXXXXXGXXXXXXXXXXXXXXXXXXXGXXXXXXXXXXXXXXXXXXXGXXXXXXXXXXXXXXXXXXXGXXXXXXXXXXXXXXXXXXXGXXXXXXXXXXXXXXXXXXXGXXXXXXXXXXXXXXXXXXXGXXXXXXXXXXXXXXXXXXXGXXXXXXXXXXXXXXXXXXXGXXXXXXXXXXXXXXXXXXXGXXXXXXXXXXXXXXXXXXX,0,10,0
35784,13,0,13,76,511,0,0,525,381,144,GXXXXXXXXXXXXXXXXXXXGXXXXXXXXXXXXXXXXXXXGXXXXXXXXXXXXXXXXXXXGXXXXXXXXXXXXXXXXXXXGXXXXXXXXXXXXXXXXXXXGXXXXXXXXXXXXXXXXXXXGXXXXXXXXXXXXXXXXXXXGXXXXXXXXXXXXXXXXXXXGXXXXXXXXXXXXXXXXXXXGXXXXXXXXXXXXXXXXXXXGXXXXXXXXXXXXXXXXXXXGXXXXXXXXXXXXXXXXXXXGXXXXXXXXXXXXXXXXXXX,0,10,0

35805,13,0,13,71,516,0,0,529,384,145,GXXXXXXXXXXXXXXXXXXXGXXXXXXXXXXXXXXXXXXXGXXXXXXXXXXXXXXXXXXXGXXXXXXXXXXXXXXXXXXXGXXXXXXXXXXXXXXXXXXXGXXXXXXXXXXXXXXXXXXXGXXXXXXXXXXXXXXXXXXXGXXXXXXXXXXXXXXXXXXXGXXXXXXXXXXXXXXXXXXXGXXXXXXXXXXXXXXXXXXXGXXXXXXXXXXXXXXXXXXXGXXXXXXXXXXXXXXXXXXXGXXXXXXXXXXXXXXXXXXX,0,10,0
35826,13,0,13,72,515,0,0,530,382,148,GXXXXXXXXXXXXXXXXXXXGXXXXXXXXXXXXXXXXXXXGXXXXXXXXXXXXXXXXXXXGXXXXXXXXXXXXXXXXXXXGXXXXXXXXXXXXXXXXXXXGXXXXXXXXXXXXXXXXXXXGXXXXXXXXXXXXXXXXXXXGXXXXXXXXXXXXXXXXXXXGXXXXXXXXXXXXXXXXXXXGXXXXXXXXXXXXXXXXXXXGXXXXXXXXXXXXXXXXXXXGXXXXXXXXXXXXXXXXXXXGXXXXXXXXXXXXXXXXXXX,0,10,0
35847,13,0,13,74,513,0,0,528,379,149,GXXXXXXXXXXXXXXXXXXXGXXXXXXXXXXXXXXXXXXXGXXXXXXXXXXXXXXXXXXXGXXXXXXXXXXXXXXXXXXXGXXXXXXXXXXXXXXXXXXXGXXXXXXXXXXXXXXXXXXXGXXXXXXXXXXXXXXXXXXXGXXXXXXXXXXXXXXXXXXXGXXXXXXXXXXXXXXXXXXXGXXXXXXXXXXXXXXXXXXXGXXXXXXXXXXXXXXXXXXXGXXXXXXXXXXXXXXXXXXXGXXXXXXXXXXXXXXXXXXX,0,10,0
35868,13,0,13,74,513,0,0,529,382,147,GXXXXXXXXXXXXXXXXXXXGXXXXXXXXXXXXXXXXXXXGXXXXXXXXXXXXXXXXXXXGXXXXXXXXXXXXXXXXXXXGXXXXXXXXXXXXXXXXXXXGXXXXXXXXXXXXXXXXXXXGXXXXXXXXXXXXXXXXXXXGXXXXXXXXXXXXXXXXXXXGXXXXXXXXXXXXXXXXXXXGXXXXXXXXXXXXXXXXXXXGXXXXXXXXXXXXXXXXXXXGXXXXXXXXXXXXXXXXXXXGXXXXXXXXXXXXXXXXXXX,0,10,0
35889,13,0,13,73,514,0,0,529,381,148,GXXXXXXXXXXXXXXXXXXXGXXXXXXXXXXXXXXXXXXXGXXXXXXXXXXXXXXXXXXXGXXXXXXXXXXXXXXXXXXXGXXXXXXXXXXXXXXXXXXXGXXXXXXXXXXXXXXXXXXXGXXXXXXXXXXXXXXXXXXXGXXXXXXXXXXXXXXXXXXXGXXXXXXXXXXXXXXXXXXXGXXXXXXXXXXXXXXXXXXXGXXXXXXXXXXXXXXXXXXXGXXXXXXXXXXXXXXXXXXXGXXXXXXXXXXXXXXXXXXX,0,10,0

35910,13,0,13,72,515,0,0,530,384,146,GXXXXXXXXXXXXXXXXXXXGXXXXXXXXXXXXXXXXXXXGXXXXXXXXXXXXXXXXXXXGXXXXXXXXXXXXXXXXXXXGXXXXXXXXXXXXXXXXXXXGXXXXXXXXXXXXXXXXXXXGXXXXXXXXXXXXXXXXXXXGXXXXXXXXXXXXXXXXXXXGXXXXXXXXXXXXXXXXXXXGXXXXXXXXXXXXXXXXXXXGXXXXXXXXXXXXXXXXXXXGXXXXXXXXXXXXXXXXXXXGXXXXXXXXXXXXXXXXXXX,0,10,0
35931,13,0,13,72,515,0,0,530,387,143,GXXXXXXXXXXXXXXXXXXXGXXXXXXXXXXXXXXXXXXXGXXXXXXXXXXXXXXXXXXXGXXXXXXXXXXXXXXXXXXXGXXXXXXXXXXXXXXXXXXXGXXXXXXXXXXXXXXXXXXXGXXXXXXXXXXXXXXXXXXXGXXXXXXXXXXXXXXXXXXXGXXXXXXXXXXXXXXXXXXXGXXXXXXXXXXXXXXXXXXXGXXXXXXXXXXXXXXXXXXXGXXXXXXXXXXXXXXXXXXXGXXXXXXXXXXXXXXXXXXX,0,10,0
35952,13,0,13,79,508,0,0,522,383,139,GXXXXXXXXXXXXXXXXXXXGXXXXXXXXXXXXXXXXXXXGXXXXXXXXXXXXXXXXXXXGXXXXXXXXXXXXXXXXXXXGXXXXXXXXXXXXXXXXXXXGXXXXXXXXXXXXXXXXXXXGXXXXXXXXXXXXXXXXXXXGXXXXXXXXXXXXXXXXXXXGXXXXXXXXXXXXXXXXXXXGXXXXXXXXXXXXXXXXXXXGXXXXXXXXXXXXXXXXXXXGXXXXXXXXXXXXXXXXXXXGXXXXXXXXXXXXXXXXXXX,0,10,0
35973,13,0,13,81,506,0,0,520,387,133,GXXXXXXXXXXXXXXXXXXXGXXXXXXXXXXXXXXXXXXXGXXXXXXXXXXXXXXXXXXXGXXXXXXXXXXXXXXXXXXXGXXXXXXXXXXXXXXXXXXXGXXXXXXXXXXXXXXXXXXXGXXXXXXXXXXXXXXXXXXXGXXXXXXXXXXXXXXXXXXXGXXXXXXXXXXXXXXXXXXXGXXXXXXXXXXXXXXXXXXXGXXXXXXXXXXXXXXXXXXXGXXXXXXXXXXXXXXXXXXXGXXXXXXXXXXXXXXXXXXX,0,10,0
35994,13,0,13,81,506,0,0,520,387,133,GXXXXXXXXXXXXXXXXXXXGXXXXXXXXXXXXXXXXXXXGXXXXXXXXXXXXXXXXXXXGXXXXXXXXXXXXXXXXXXXGXXXXXXXXXXXXXXXXXXXGXXXXXXXXXXXXXXXXXXXGXXXXXXXXXXXXXXXXXXXGXXXXXXXXXXXXXXXXXXXGXXXXXXXXXXXXXXXXXXXGXXXXXXXXXXXXXXXXXXXGXXXXXXXXXXXXXXXXXXXGXXXXXXXXXXXXXXXXXXXGXXXXXXXXXXXXXXXXXXX,0,10,0

36015,13,0,13,87,500,0,0,514,383,131,GXXXXXXXXXXXXXXXXXXXGXXXXXXXXXXXXXXXXXXXGXXXXXXXXXXXXXXXXXXXGXXXXXXXXXXXXXXXXXXXGXXXXXXXXXXXXXXXXXXXGXXXXXXXXXXXXXXXXXXXGXXXXXXXXXXXXXXXXXXXGXXXXXXXXXXXXXXXXXXXGXXXXXXXXXXXXXXXXXXXGXXXXXXXXXXXXXXXXXXXGXXXXXXXXXXXXXXXXXXXGXXXXXXXXXXXXXXXXXXXGXXXXXXXXXXXXXXXXXXX,0,10,0
36036,13,0,13,84,503,0,0,517,385,132,GXXXXXXXXXXXXXXXXXXXGXXXXXXXXXXXXXXXXXXXGXXXXXXXXXXXXXXXXXXXGXXXXXXXXXXXXXXXXXXXGXXXXXXXXXXXXXXXXXXXGXXXXXXXXXXXXXXXXXXXGXXXXXXXXXXXXXXXXXXXGXXXXXXXXXXXXXXXXXXXGXXXXXXXXXXXXXXXXXXXGXXXXXXXXXXXXXXXXXXXGXXXXXXXXXXXXXXXXXXXGXXXXXXXXXXXXXXXXXXXGXXXXXXXXXXXXXXXXXXX,0,10,0
36057,13,0,13,85,502,0,0,517,381,136,GXXXXXXXXXXXXXXXXXXXGXXXXXXXXXXXXXXXXXXXGXXXXXXXXXXXXXXXXXXXGXXXXXXXXXXXXXXXXXXXGXXXXXXXXXXXXXXXXXXXGXXXXXXXXXXXXXXXXXXXGXXXXXXXXXXXXXXXXXXXGXXXXXXXXXXXXXXXXXXXGXXXXXXXXXXXXXXXXXXXGXXXXXXXXXXXXXXXXXXXGXXXXXXXXXXXXXXXXXXXGXXXXXXXXXXXXXXXXXXXGXXXXXXXXXXXXXXXXXXX,0,10,0
36078,13,0,13,81,506,0,0,520,389,131,GXXXXXXXXXXXXXXXXXXXGXXXXXXXXXXXXXXXXXXXGXXXXXXXXXXXXXXXXXXXGXXXXXXXXXXXXXXXXXXXGXXXXXXXXXXXXXXXXXXXGXXXXXXXXXXXXXXXXXXXGXXXXXXXXXXXXXXXXXXXGXXXXXXXXXXXXXXXXXXXGXXXXXXXXXXXXXXXXXXXGXXXXXXXXXXXXXXXXXXXGXXXXXXXXXXXXXXXXXXXGXXXXXXXXXXXXXXXXXXXGXXXXXXXXXXXXXXXXXXX,0,10,0
36099,13,0,13,83,504,0,0,517,383,134,GXXXXXXXXXXXXXXXXXXXGXXXXXXXXXXXXXXXXXXXGXXXXXXXXXXXXXXXXXXXGXXXXXXXXXXXXXXXXXXXGXXXXXXXXXXXXXXXXXXXGXXXXXXXXXXXXXXXXXXXGXXXXXXXXXXXXXXXXXXXGXXXXXXXXXXXXXXXXXXXGXXXXXXXXXXXXXXXXXXXGXXXXXXXXXXXXXXXXXXXGXXXXXXXXXXXXXXXXXXXGXXXXXXXXXXXXXXXXXXXGXXXXXXXXXXXXXXXXXXX,0,10,0

36120,13,0,13,83,504,0,0,517,383,134,GXXXXXXXXXXXXXXXXXXXGXXXXXXXXXXXXXXXXXXXGXXXXXXXXXXXXXXXXXXXGXXXXXXXXXXXXXXXXXXXGXXXXXXXXXXXXXXXXXXXGXXXXXXXXXXXXXXXXXXXGXXXXXXXXXXXXXXXXXXXGXXXXXXXXXXXXXXXXXXXGXXXXXXXXXXXXXXXXXXXGXXXXXXXXXXXXXXXXXXXGXXXXXXXXXXXXXXXXXXXGXXXXXXXXXXXXXXXXXXXGXXXXXXXXXXXXXXXXXXX,0,10,0
36141,13,0,13,85,502,0,0,517,384,133,GXXXXXXXXXXXXXXXXXXXGXXXXXXXXXXXXXXXXXXXGXXXXXXXXXXXXXXXXXXXGXXXXXXXXXXXXXXXXXXXGXXXXXXXXXXXXXXXXXXXGXXXXXXXXXXXXXXXXXXXGXXXXXXXXXXXXXXXXXXXGXXXXXXXXXXXXXXXXXXXGXXXXXXXXXXXXXXXXXXXGXXXXXXXXXXXXXXXXXXXGXXXXXXXXXXXXXXXXXXXGXXXXXXXXXXXXXXXXXXXGXXXXXXXXXXXXXXXXXXX,0,10,0
36162,13,0,13,86,501,0,0,515,388,127,GXXXXXXXXXXXXXXXXXXXGXXXXXXXXXXXXXXXXXXXGXXXXXXXXXXXXXXXXXXXGXXXXXXXXXXXXXXXXXXXGXXXXXXXXXXXXXXXXXXXGXXXXXXXXXXXXXXXXXXXGXXXXXXXXXXXXXXXXXXXGXXXXXXXXXXXXXXXXXXXGXXXXXXXXXXXXXXXXXXXGXXXXXXXXXXXXXXXXXXXGXXXXXXXXXXXXXXXXXXXGXXXXXXXXXXXXXXXXXXXGXXXXXXXXXXXXXXXXXXX,0,10,0
36183,13,0,13,86,501,0,0,516,385,131,GXXXXXXXXXXXXXXXXXXXGXXXXXXXXXXXXXXXXXXXGXXXXXXXXXXXXXXXXXXXGXXXXXXXXXXXXXXXXXXXGXXXXXXXXXXXXXXXXXXXGXXXXXXXXXXXXXXXXXXXGXXXXXXXXXXXXXXXXXXXGXXXXXXXXXXXXXXXXXXXGXXXXXXXXXXXXXXXXXXXGXXXXXXXXXXXXXXXXXXXGXXXXXXXXXXXXXXXXXXXGXXXXXXXXXXXXXXXXXXXGXXXXXXXXXXXXXXXXXXX,0,10,0
36204,13,0,13,86,501,0,0,515,387,128,GXXXXXXXXXXXXXXXXXXXGXXXXXXXXXXXXXXXXXXXGXXXXXXXXXXXXXXXXXXXGXXXXXXXXXXXXXXXXXXXGXXXXXXXXXXXXXXXXXXXGXXXXXXXXXXXXXXXXXXXGXXXXXXXXXXXXXXXXXXXGXXXXXXXXXXXXXXXXXXXGXXXXXXXXXXXXXXXXXXXGXXXXXXXXXXXXXXXXXXXGXXXXXXXXXXXXXXXXXXXGXXXXXXXXXXXXXXXXXXXGXXXXXXXXXXXXXXXXXXX,0,10,0

36225,13,0,13,83,504,0,0,519,384,135,GXXXXXXXXXXXXXXXXXXXGXXXXXXXXXXXXXXXXXXXGXXXXXXXXXXXXXXXXXXXGXXXXXXXXXXXXXXXXXXXGXXXXXXXXXXXXXXXXXXXGXXXXXXXXXXXXXXXXXXXGXXXXXXXXXXXXXXXXXXXGXXXXXXXXXXXXXXXXXXXGXXXXXXXXXXXXXXXXXXXGXXXXXXXXXXXXXXXXXXXGXXXXXXXXXXXXXXXXXXXGXXXXXXXXXXXXXXXXXXXGXXXXXXXXXXXXXXXXXXX,0,10,0
36246,14,1,13,79,507,0,0,522,384,138,GXXXXXXXXXXXXXXXXXXXGXXXXXXXXXXXXXXXXXXXGXXXXXXXXXXXXXXXXXXXGXXXXXXXXXXXXXXXXXXXGXXXXXXXXXXXXXXXXXXXGAXXXXXXXXXXXXXXXXXXGXXXXXXXXXXXXXXXXXXXGXXXXXXXXXXXXXXXXXXXGXXXXXXXXXXXXXXXXXXXGXXXXXXXXXXXXXXXXXXXGXXXXXXXXXXXXXXXXXXXGXXXXXXXXXXXXXXXXXXXGXXXXXXXXXXXXXXXXXXX,0,10,0
36267,14,1,13,77,509,0,0,521,384,137,GXXXXXXXXXXXXXXXXXXXGXXXXXXXXXXXXXXXXXXXGXXXXXXXXXXXXXXXXXXXGXXXXXXXXXXXXXXXXXXXGXXXXXXXXXXXXXXXXXXXGAXXXXXXXXXXXXXXXXXXGXXXXXXXXXXXXXXXXXXXGXXXXXXXXXXXXXXXXXXXGXXXXXXXXXXXXXXXXXXXGXXXXXXXXXXXXXXXXXXXGXXXXXXXXXXXXXXXXXXXGXXXXXXXXXXXXXXXXXXXGXXXXXXXXXXXXXXXXXXX,0,10,0
36288,14,1,13,83,503,0,0,518,381,137,GXXXXXXXXXXXXXXXXXXXGXXXXXXXXXXXXXXXXXXXGXXXXXXXXXXXXXXXXXXXGXXXXXXXXXXXXXXXXXXXGXXXXXXXXXXXXXXXXXXXGAXXXXXXXXXXXXXXXXXXGXXXXXXXXXXXXXXXXXXXGXXXXXXXXXXXXXXXXXXXGXXXXXXXXXXXXXXXXXXXGXXXXXXXXXXXXXXXXXXXGXXXXXXXXXXXXXXXXXXXGXXXXXXXXXXXXXXXXXXXGXXXXXXXXXXXXXXXXXXX,0,10,0
36309,14,1,13,82,504,0,0,518,380,138,GXXXXXXXXXXXXXXXXXXXGXXXXXXXXXXXXXXXXXXXGXXXXXXXXXXXXXXXXXXXGXXXXXXXXXXXXXXXXXXXGXXXXXXXXXXXXXXXXXXXGAXXXXXXXXXXXXXXXXXXGXXXXXXXXXXXXXXXXXXXGXXXXXXXXXXXXXXXXXXXGXXXXXXXXXXXXXXXXXXXGXXXXXXXXXXXXXXXXXXXGXXXXXXXXXXXXXXXXXXXGXXXXXXXXXXXXXXXXXXXGXXXXXXXXXXXXXXXXXXX,0,10,0

36330,14,1,13,79,507,0,0,521,382,139,GXXXXXXXXXXXXXXXXXXXGXXXXXXXXXXXXXXXXXXXGXXXXXXXXXXXXXXXXXXXGXXXXXXXXXXXXXXXXXXXGXXXXXXXXXXXXXXXXXXXGAXXXXXXXXXXXXXXXXXXGXXXXXXXXXXXXXXXXXXXGXXXXXXXXXXXXXXXXXXXGXXXXXXXXXXXXXXXXXXXGXXXXXXXXXXXXXXXXXXXGXXXXXXXXXXXXXXXXXXXGXXXXXXXXXXXXXXXXXXXGXXXXXXXXXXXXXXXXXXX,0,10,0
36351,13,0,13,79,508,0,0,521,380,141,GXXXXXXXXXXXXXXXXXXXGXXXXXXXXXXXXXXXXXXXGXXXXXXXXXXXXXXXXXXXGXXXXXXXXXXXXXXXXXXXGXXXXXXXXXXXXXXXXXXXGXXXXXXXXXXXXXXXXXXXGXXXXXXXXXXXXXXXXXXXGXXXXXXXXXXXXXXXXXXXGXXXXXXXXXXXXXXXXXXXGXXXXXXXXXXXXXXXXXXXGXXXXXXXXXXXXXXXXXXXGXXXXXXXXXXXXXXXXXXXGXXXXXXXXXXXXXXXXXXX,0,10,0
36372,14,1,13,71,515,0,0,528,380,148,GXXXXXXXXXXXXXXXXXXXGXXXXXXXXXXXXXXXXXXXGXXXXXXXXXXXXXXXXXXXGXXXXXXXXXXXXXXXXXXXGXXXXXXXXXXXXXXXXXXXGXXXXXXXXXXXXXXXXXXXGXXXXXXXXXXXXXXXXXXXGXXXXXXXXXXXXXXXXXXXGAXXXXXXXXXXXXXXXXXXGXXXXXXXXXXXXXXXXXXXGXXXXXXXXXXXXXXXXXXXGXXXXXXXXXXXXXXXXXXXGXXXXXXXXXXXXXXXXXXX,0,10,0
36393,14,1,13,64,522,0,0,535,380,155,GXXXXXXXXXXXXXXXXXXXGXXXXXXXXXXXXXXXXXXXGXXXXXXXXXXXXXXXXXXXGXXXXXXXXXXXXXXXXXXXGXXXXXXXXXXXXXXXXXXXGXXXXXXXXXXXXXXXXXXXGXXXXXXXXXXXXXXXXXXXGXXXXXXXXXXXXXXXXXXXGAXXXXXXXXXXXXXXXXXXGXXXXXXXXXXXXXXXXXXXGXXXXXXXXXXXXXXXXXXXGXXXXXXXXXXXXXXXXXXXGXXXXXXXXXXXXXXXXXXX,0,10,0
36414,13,0,13,63,524,0,0,537,382,155,GXXXXXXXXXXXXXXXXXXXGXXXXXXXXXXXXXXXXXXXGXXXXXXXXXXXXXXXXXXXGXXXXXXXXXXXXXXXXXXXGXXXXXXXXXXXXXXXXXXXGXXXXXXXXXXXXXXXXXXXGXXXXXXXXXXXXXXXXXXXGXXXXXXXXXXXXXXXXXXXGXXXXXXXXXXXXXXXXXXXGXXXXXXXXXXXXXXXXXXXGXXXXXXXXXXXXXXXXXXXGXXXXXXXXXXXXXXXXXXXGXXXXXXXXXXXXXXXXXXX,0,10,0

36435,13,0,13,64,523,0,0,536,385,151,GXXXXXXXXXXXXXXXXXXXGXXXXXXXXXXXXXXXXXXXGXXXXXXXXXXXXXXXXXXXGXXXXXXXXXXXXXXXXXXXGXXXXXXXXXXXXXXXXXXXGXXXXXXXXXXXXXXXXXXXGXXXXXXXXXXXXXXXXXXXGXXXXXXXXXXXXXXXXXXXGXXXXXXXXXXXXXXXXXXXGXXXXXXXXXXXXXXXXXXXGXXXXXXXXXXXXXXXXXXXGXXXXXXXXXXXXXXXXXXXGXXXXXXXXXXXXXXXXXXX,0,10,0
36456,13,0,13,67,520,0,0,533,384,149,GXXXXXXXXXXXXXXXXXXXGXXXXXXXXXXXXXXXXXXXGXXXXXXXXXXXXXXXXXXXGXXXXXXXXXXXXXXXXXXXGXXXXXXXXXXXXXXXXXXXGXXXXXXXXXXXXXXXXXXXGXXXXXXXXXXXXXXXXXXXGXXXXXXXXXXXXXXXXXXXGXXXXXXXXXXXXXXXXXXXGXXXXXXXXXXXXXXXXXXXGXXXXXXXXXXXXXXXXXXXGXXXXXXXXXXXXXXXXXXXGXXXXXXXXXXXXXXXXXXX,0,10,0
36477,13,0,13,64,523,0,0,535,383,152,GXXXXXXXXXXXXXXXXXXXGXXXXXXXXXXXXXXXXXXXGXXXXXXXXXXXXXXXXXXXGXXXXXXXXXXXXXXXXXXXGXXXXXXXXXXXXXXXXXXXGXXXXXXXXXXXXXXXXXXXGXXXXXXXXXXXXXXXXXXXGXXXXXXXXXXXXXXXXXXXGXXXXXXXXXXXXXXXXXXXGXXXXXXXXXXXXXXXXXXXGXXXXXXXXXXXXXXXXXXXGXXXXXXXXXXXXXXXXXXXGXXXXXXXXXXXXXXXXXXX,0,10,0
36498,13,0,13,64,523,0,0,537,389,148,GXXXXXXXXXXXXXXXXXXXGXXXXXXXXXXXXXXXXXXXGXXXXXXXXXXXXXXXXXXXGXXXXXXXXXXXXXXXXXXXGXXXXXXXXXXXXXXXXXXXGXXXXXXXXXXXXXXXXXXXGXXXXXXXXXXXXXXXXXXXGXXXXXXXXXXXXXXXXXXXGXXXXXXXXXXXXXXXXXXXGXXXXXXXXXXXXXXXXXXXGXXXXXXXXXXXXXXXXXXXGXXXXXXXXXXXXXXXXXXXGXXXXXXXXXXXXXXXXXXX,0,10,0
36519,13,0,13,68,519,0,0,533,390,143,GXXXXXXXXXXXXXXXXXXXGXXXXXXXXXXXXXXXXXXXGXXXXXXXXXXXXXXXXXXXGXXXXXXXXXXXXXXXXXXXGXXXXXXXXXXXXXXXXXXXGXXXXXXXXXXXXXXXXXXXGXXXXXXXXXXXXXXXXXXXGXXXXXXXXXXXXXXXXXXXGXXXXXXXXXXXXXXXXXXXGXXXXXXXXXXXXXXXXXXXGXXXXXXXXXXXXXXXXXXXGXXXXXXXXXXXXXXXXXXXGXXXXXXXXXXXXXXXXXXX,0,10,0

36540,13,0,13,73,514,0,0,528,389,139,GXXXXXXXXXXXXXXXXXXXGXXXXXXXXXXXXXXXXXXXGXXXXXXXXXXXXXXXXXXXGXXXXXXXXXXXXXXXXXXXGXXXXXXXXXXXXXXXXXXXGXXXXXXXXXXXXXXXXXXXGXXXXXXXXXXXXXXXXXXXGXXXXXXXXXXXXXXXXXXXGXXXXXXXXXXXXXXXXXXXGXXXXXXXXXXXXXXXXXXXGXXXXXXXXXXXXXXXXXXXGXXXXXXXXXXXXXXXXXXXGXXXXXXXXXXXXXXXXXXX,0,10,0
36561,13,0,13,77,510,0,0,524,392,132,GXXXXXXXXXXXXXXXXXXXGXXXXXXXXXXXXXXXXXXXGXXXXXXXXXXXXXXXXXXXGXXXXXXXXXXXXXXXXXXXGXXXXXXXXXXXXXXXXXXXGXXXXXXXXXXXXXXXXXXXGXXXXXXXXXXXXXXXXXXXGXXXXXXXXXXXXXXXXXXXGXXXXXXXXXXXXXXXXXXXGXXXXXXXXXXXXXXXXXXXGXXXXXXXXXXXXXXXXXXXGXXXXXXXXXXXXXXXXXXXGXXXXXXXXXXXXXXXXXXX,0,10,0
36582,13,0,13,78,509,0,0,523,391,132,GXXXXXXXXXXXXXXXXXXXGXXXXXXXXXXXXXXXXXXXGXXXXXXXXXXXXXXXXXXXGXXXXXXXXXXXXXXXXXXXGXXXXXXXXXXXXXXXXXXXGXXXXXXXXXXXXXXXXXXXGXXXXXXXXXXXXXXXXXXXGXXXXXXXXXXXXXXXXXXXGXXXXXXXXXXXXXXXXXXXGXXXXXXXXXXXXXXXXXXXGXXXXXXXXXXXXXXXXXXXGXXXXXXXXXXXXXXXXXXXGXXXXXXXXXXXXXXXXXXX,0,10,0
36603,13,0,13,81,506,0,0,518,383,135,GXXXXXXXXXXXXXXXXXXXGXXXXXXXXXXXXXXXXXXXGXXXXXXXXXXXXXXXXXXXGXXXXXXXXXXXXXXXXXXXGXXXXXXXXXXXXXXXXXXXGXXXXXXXXXXXXXXXXXXXGXXXXXXXXXXXXXXXXXXXGXXXXXXXXXXXXXXXXXXXGXXXXXXXXXXXXXXXXXXXGXXXXXXXXXXXXXXXXXXXGXXXXXXXXXXXXXXXXXXXGXXXXXXXXXXXXXXXXXXXGXXXXXXXXXXXXXXXXXXX,0,10,0
36624,14,1,13,82,504,0,0,517,389,128,GXXXXXXXXXXXXXXXXXXXGXXXXXXXXXXXXXXXXXXXGXXXXXXXXXXXXXXXXXXXGXXXXXXXXXXXXXXXXXXXGXXXXXXXXXXXXXXXXXXXGXXXXXXXXXXXXXXXXXXXGXXXXXXXXXXXXXXXXXXXGXXXXXXXXXXXXXXXXXXXGAXXXXXXXXXXXXXXXXXXGXXXXXXXXXXXXXXXXXXXGXXXXXXXXXXXXXXXXXXXGXXXXXXXXXXXXXXXXXXXGXXXXXXXXXXXXXXXXXXX,0,10,0

36645,14,1,13,89,497,0,0,510,388,122,GXXXXXXXXXXXXXXXXXXXGXXXXXXXXXXXXXXXXXXXGXXXXXXXXXXXXXXXXXXXGXXXXXXXXXXXXXXXXXXXGXXXXXXXXXXXXXXXXXXXGXXXXXXXXXXXXXXXXXXXGXXXXXXXXXXXXXXXXXXXGXXXXXXXXXXXXXXXXXXXGAXXXXXXXXXXXXXXXXXXGXXXXXXXXXXXXXXXXXXXGXXXXXXXXXXXXXXXXXXXGXXXXXXXXXXXXXXXXXXXGXXXXXXXXXXXXXXXXXXX,0,10,0
36666,14,0,14,91,495,0,0,509,385,124,GXXXXXXXXXXXXXXXXXXXGXXXXXXXXXXXXXXXXXXXGXXXXXXXXXXXXXXXXXXXGXXXXXXXXXXXXXXXXXXXGXXXXXXXXXXXXXXXXXXXGXXXXXXXXXXXXXXXXXXXGXXXXXXXXXXXXXXXXXXXGXXXXXXXXXXXXXXXXXXXGOXXXXXXXXXXXXXXXXXXGXXXXXXXXXXXXXXXXXXXGXXXXXXXXXXXXXXXXXXXGXXXXXXXXXXXXXXXXXXXGXXXXXXXXXXXXXXXXXXX,0,10,0
36687,14,0,14,93,493,0,0,507,381,126,GXXXXXXXXXXXXXXXXXXXGXXXXXXXXXXXXXXXXXXXGXXXXXXXXXXXXXXXXXXXGXXXXXXXXXXXXXXXXXXXGXXXXXXXXXXXXXXXXXXXGXXXXXXXXXXXXXXXXXXXGXXXXXXXXXXXXXXXXXXXGXXXXXXXXXXXXXXXXXXXGOXXXXXXXXXXXXXXXXXXGXXXXXXXXXXXXXXXXXXXGXXXXXXXXXXXXXXXXXXXGXXXXXXXXXXXXXXXXXXXGXXXXXXXXXXXXXXXXXXX,0,10,0
36708,13,0,13,95,492,0,0,506,386,120,GXXXXXXXXXXXXXXXXXXXGXXXXXXXXXXXXXXXXXXXGXXXXXXXXXXXXXXXXXXXGXXXXXXXXXXXXXXXXXXXGXXXXXXXXXXXXXXXXXXXGXXXXXXXXXXXXXXXXXXXGXXXXXXXXXXXXXXXXXXXGXXXXXXXXXXXXXXXXXXXGXXXXXXXXXXXXXXXXXXXGXXXXXXXXXXXXXXXXXXXGXXXXXXXXXXXXXXXXXXXGXXXXXXXXXXXXXXXXXXXGXXXXXXXXXXXXXXXXXXX,0,10,0
36729,13,0,13,86,501,0,0,515,389,126,GXXXXXXXXXXXXXXXXXXXGXXXXXXXXXXXXXXXXXXXGXXXXXXXXXXXXXXXXXXXGXXXXXXXXXXXXXXXXXXXGXXXXXXXXXXXXXXXXXXXGXXXXXXXXXXXXXXXXXXXGXXXXXXXXXXXXXXXXXXXGXXXXXXXXXXXXXXXXXXXGXXXXXXXXXXXXXXXXXXXGXXXXXXXXXXXXXXXXXXXGXXXXXXXXXXXXXXXXXXXGXXXXXXXXXXXXXXXXXXXGXXXXXXXXXXXXXXXXXXX,0,10,0

36750,13,0,13,85,502,0,0,515,382,133,GXXXXXXXXXXXXXXXXXXXGXXXXXXXXXXXXXXXXXXXGXXXXXXXXXXXXXXXXXXXGXXXXXXXXXXXXXXXXXXXGXXXXXXXXXXXXXXXXXXXGXXXXXXXXXXXXXXXXXXXGXXXXXXXXXXXXXXXXXXXGXXXXXXXXXXXXXXXXXXXGXXXXXXXXXXXXXXXXXXXGXXXXXXXXXXXXXXXXXXXGXXXXXXXXXXXXXXXXXXXGXXXXXXXXXXXXXXXXXXXGXXXXXXXXXXXXXXXXXXX,0,10,0
36771,13,0,13,80,507,0,0,519,388,131,GXXXXXXXXXXXXXXXXXXXGXXXXXXXXXXXXXXXXXXXGXXXXXXXXXXXXXXXXXXXGXXXXXXXXXXXXXXXXXXXGXXXXXXXXXXXXXXXXXXXGXXXXXXXXXXXXXXXXXXXGXXXXXXXXXXXXXXXXXXXGXXXXXXXXXXXXXXXXXXXGXXXXXXXXXXXXXXXXXXXGXXXXXXXXXXXXXXXXXXXGXXXXXXXXXXXXXXXXXXXGXXXXXXXXXXXXXXXXXXXGXXXXXXXXXXXXXXXXXXX,0,10,0
36792,13,0,13,79,508,0,0,520,387,133,GXXXXXXXXXXXXXXXXXXXGXXXXXXXXXXXXXXXXXXXGXXXXXXXXXXXXXXXXXXXGXXXXXXXXXXXXXXXXXXXGXXXXXXXXXXXXXXXXXXXGXXXXXXXXXXXXXXXXXXXGXXXXXXXXXXXXXXXXXXXGXXXXXXXXXXXXXXXXXXXGXXXXXXXXXXXXXXXXXXXGXXXXXXXXXXXXXXXXXXXGXXXXXXXXXXXXXXXXXXXGXXXXXXXXXXXXXXXXXXXGXXXXXXXXXXXXXXXXXXX,0,10,0
36813,13,0,13,81,506,0,0,520,385,135,GXXXXXXXXXXXXXXXXXXXGXXXXXXXXXXXXXXXXXXXGXXXXXXXXXXXXXXXXXXXGXXXXXXXXXXXXXXXXXXXGXXXXXXXXXXXXXXXXXXXGXXXXXXXXXXXXXXXXXXXGXXXXXXXXXXXXXXXXXXXGXXXXXXXXXXXXXXXXXXXGXXXXXXXXXXXXXXXXXXXGXXXXXXXXXXXXXXXXXXXGXXXXXXXXXXXXXXXXXXXGXXXXXXXXXXXXXXXXXXXGXXXXXXXXXXXXXXXXXXX,0,10,0
36834,13,0,13,82,505,0,0,519,383,136,GXXXXXXXXXXXXXXXXXXXGXXXXXXXXXXXXXXXXXXXGXXXXXXXXXXXXXXXXXXXGXXXXXXXXXXXXXXXXXXXGXXXXXXXXXXXXXXXXXXXGXXXXXXXXXXXXXXXXXXXGXXXXXXXXXXXXXXXXXXXGXXXXXXXXXXXXXXXXXXXGXXXXXXXXXXXXXXXXXXXGXXXXXXXXXXXXXXXXXXXGXXXXXXXXXXXXXXXXXXXGXXXXXXXXXXXXXXXXXXXGXXXXXXXXXXXXXXXXXXX,0,10,0

36855,14,1,13,83,503,0,0,517,383,134,GXXXXXXXXXXXXXXXXXXXGXXXXXXXXXXXXXXXXXXXGAXXXXXXXXXXXXXXXXXXGXXXXXXXXXXXXXXXXXXXGXXXXXXXXXXXXXXXXXXXGXXXXXXXXXXXXXXXXXXXGXXXXXXXXXXXXXXXXXXXGXXXXXXXXXXXXXXXXXXXGXXXXXXXXXXXXXXXXXXXGXXXXXXXXXXXXXXXXXXXGXXXXXXXXXXXXXXXXXXXGXXXXXXXXXXXXXXXXXXXGXXXXXXXXXXXXXXXXXXX,0,10,0
36876,14,1,13,78,508,0,0,522,383,139,GXXXXXXXXXXXXXXXXXXXGXXXXXXXXXXXXXXXXXXXGAXXXXXXXXXXXXXXXXXXGXXXXXXXXXXXXXXXXXXXGXXXXXXXXXXXXXXXXXXXGXXXXXXXXXXXXXXXXXXXGXXXXXXXXXXXXXXXXXXXGXXXXXXXXXXXXXXXXXXXGXXXXXXXXXXXXXXXXXXXGXXXXXXXXXXXXXXXXXXXGXXXXXXXXXXXXXXXXXXXGXXXXXXXXXXXXXXXXXXXGXXXXXXXXXXXXXXXXXXX,0,10,0
36897,14,1,13,71,515,0,0,528,383,145,GXXXXXXXXXXXXXXXXXXXGXXXXXXXXXXXXXXXXXXXGAXXXXXXXXXXXXXXXXXXGXXXXXXXXXXXXXXXXXXXGXXXXXXXXXXXXXXXXXXXGXXXXXXXXXXXXXXXXXXXGXXXXXXXXXXXXXXXXXXXGXXXXXXXXXXXXXXXXXXXGXXXXXXXXXXXXXXXXXXXGXXXXXXXXXXXXXXXXXXXGXXXXXXXXXXXXXXXXXXXGXXXXXXXXXXXXXXXXXXXGXXXXXXXXXXXXXXXXXXX,0,10,0
36918,14,0,14,65,521,0,0,533,387,146,GXXXXXXXXXXXXXXXXXXXGXXXXXXXXXXXXXXXXXXXGOXXXXXXXXXXXXXXXXXXGXXXXXXXXXXXXXXXXXXXGXXXXXXXXXXXXXXXXXXXGXXXXXXXXXXXXXXXXXXXGXXXXXXXXXXXXXXXXXXXGXXXXXXXXXXXXXXXXXXXGXXXXXXXXXXXXXXXXXXXGXXXXXXXXXXXXXXXXXXXGXXXXXXXXXXXXXXXXXXXGXXXXXXXXXXXXXXXXXXXGXXXXXXXXXXXXXXXXXXX,0,10,0
36939,14,0,14,65,521,0,0,534,386,148,GXXXXXXXXXXXXXXXXXXXGXXXXXXXXXXXXXXXXXXXGOXXXXXXXXXXXXXXXXXXGXXXXXXXXXXXXXXXXXXXGXXXXXXXXXXXXXXXXXXXGXXXXXXXXXXXXXXXXXXXGXXXXXXXXXXXXXXXXXXXGXXXXXXXXXXXXXXXXXXXGXXXXXXXXXXXXXXXXXXXGXXXXXXXXXXXXXXXXXXXGXXXXXXXXXXXXXXXXXXXGXXXXXXXXXXXXXXXXXXXGXXXXXXXXXXXXXXXXXXX,0,10,0

36960,13,0,13,64,523,0,0,536,390,146,GXXXXXXXXXXXXXXXXXXXGXXXXXXXXXXXXXXXXXXXGXXXXXXXXXXXXXXXXXXXGXXXXXXXXXXXXXXXXXXXGXXXXXXXXXXXXXXXXXXXGXXXXXXXXXXXXXXXXXXXGXXXXXXXXXXXXXXXXXXXGXXXXXXXXXXXXXXXXXXXGXXXXXXXXXXXXXXXXXXXGXXXXXXXXXXXXXXXXXXXGXXXXXXXXXXXXXXXXXXXGXXXXXXXXXXXXXXXXXXXGXXXXXXXXXXXXXXXXXXX,0,10,0
36981,14,1,13,67,519,0,0,533,385,148,GXXXXXXXXXXXXXXXXXXXGXXXXXXXXXXXXXXXXXXXGXXXXXXXXXXXXXXXXXXXGXXXXXXXXXXXXXXXXXXXGXXXXXXXXXXXXXXXXXXXGXXXXXXXXXXXXXXXXXXXGXXXXXXXXXXXXXXXXXXXGXXXXXXXXXXXXXXXXXXXGXXXXXXXXXXXXXXXXXXXGXXXXXXXXXXXXXXXXXXXGAXXXXXXXXXXXXXXXXXXGXXXXXXXXXXXXXXXXXXXGXXXXXXXXXXXXXXXXXXX,0,10,0
37002,14,1,13,70,516,0,0,529,387,142,GXXXXXXXXXXXXXXXXXXXGXXXXXXXXXXXXXXXXXXXGXXXXXXXXXXXXXXXXXXXGXXXXXXXXXXXXXXXXXXXGXXXXXXXXXXXXXXXXXXXGXXXXXXXXXXXXXXXXXXXGXXXXXXXXXXXXXXXXXXXGXXXXXXXXXXXXXXXXXXXGXXXXXXXXXXXXXXXXXXXGXXXXXXXXXXXXXXXXXXXGAXXXXXXXXXXXXXXXXXXGXXXXXXXXXXXXXXXXXXXGXXXXXXXXXXXXXXXXXXX,0,10,0
37023,14,1,13,74,512,0,0,525,390,135,GXXXXXXXXXXXXXXXXXXXGXXXXXXXXXXXXXXXXXXXGXXXXXXXXXXXXXXXXXXXGXXXXXXXXXXXXXXXXXXXGXXXXXXXXXXXXXXXXXXXGXXXXXXXXXXXXXXXXXXXGXXXXXXXXXXXXXXXXXXXGXXXXXXXXXXXXXXXXXXXGXXXXXXXXXXXXXXXXXXXGXXXXXXXXXXXXXXXXXXXGAXXXXXXXXXXXXXXXXXXGXXXXXXXXXXXXXXXXXXXGXXXXXXXXXXXXXXXXXXX,0,10,0
37044,14,1,13,72,514,0,0,525,391,134,GXXXXXXXXXXXXXXXXXXXGXXXXXXXXXXXXXXXXXXXGXXXXXXXXXXXXXXXXXXXGXXXXXXXXXXXXXXXXXXXGXXXXXXXXXXXXXXXXXXXGXXXXXXXXXXXXXXXXXXXGXXXXXXXXXXXXXXXXXXXGXXXXXXXXXXXXXXXXXXXGXXXXXXXXXXXXXXXXXXXGXXXXXXXXXXXXXXXXXXXGAXXXXXXXXXXXXXXXXXXGXXXXXXXXXXXXXXXXXXXGXXXXXXXXXXXXXXXXXXX,0,10,0

37065,14,1,13,71,515,0,0,527,391,136,GXXXXXXXXXXXXXXXXXXXGXXXXXXXXXXXXXXXXXXXGXXXXXXXXXXXXXXXXXXXGXXXXXXXXXXXXXXXXXXXGXXXXXXXXXXXXXXXXXXXGXXXXXXXXXXXXXXXXXXXGXXXXXXXXXXXXXXXXXXXGXXXXXXXXXXXXXXXXXXXGXXXXXXXXXXXXXXXXXXXGXXXXXXXXXXXXXXXXXXXGAXXXXXXXXXXXXXXXXXXGXXXXXXXXXXXXXXXXXXXGXXXXXXXXXXXXXXXXXXX,0,10,0
37086,14,1,13,70,516,0,0,529,394,135,GXXXXXXXXXXXXXXXXXXXGXXXXXXXXXXXXXXXXXXXGXXXXXXXXXXXXXXXXXXXGXXXXXXXXXXXXXXXXXXXGXXXXXXXXXXXXXXXXXXXGXXXXXXXXXXXXXXXXXXXGXXXXXXXXXXXXXXXXXXXGXXXXXXXXXXXXXXXXXXXGXXXXXXXXXXXXXXXXXXXGXXXXXXXXXXXXXXXXXXXGAXXXXXXXXXXXXXXXXXXGXXXXXXXXXXXXXXXXXXXGXXXXXXXXXXXXXXXXXXX,0,10,0
37107,14,1,13,70,516,0,0,529,396,133,GXXXXXXXXXXXXXXXXXXXGXXXXXXXXXXXXXXXXXXXGXXXXXXXXXXXXXXXXXXXGXXXXXXXXXXXXXXXXXXXGXXXXXXXXXXXXXXXXXXXGXXXXXXXXXXXXXXXXXXXGXXXXXXXXXXXXXXXXXXXGXXXXXXXXXXXXXXXXXXXGXXXXXXXXXXXXXXXXXXXGXXXXXXXXXXXXXXXXXXXGAXXXXXXXXXXXXXXXXXXGXXXXXXXXXXXXXXXXXXXGXXXXXXXXXXXXXXXXXXX,0,10,0
37128,14,1,13,77,509,0,0,522,389,133,GXXXXXXXXXXXXXXXXXXXGXXXXXXXXXXXXXXXXXXXGXXXXXXXXXXXXXXXXXXXGXXXXXXXXXXXXXXXXXXXGXXXXXXXXXXXXXXXXXXXGXXXXXXXXXXXXXXXXXXXGXXXXXXXXXXXXXXXXXXXGXXXXXXXXXXXXXXXXXXXGXXXXXXXXXXXXXXXXXXXGXXXXXXXXXXXXXXXXXXXGAXXXXXXXXXXXXXXXXXXGXXXXXXXXXXXXXXXXXXXGXXXXXXXXXXXXXXXXXXX,0,10,0
37149,14,1,13,72,514,0,0,526,388,138,GXXXXXXXXXXXXXXXXXXXGXXXXXXXXXXXXXXXXXXXGXXXXXXXXXXXXXXXXXXXGXXXXXXXXXXXXXXXXXXXGXXXXXXXXXXXXXXXXXXXGXXXXXXXXXXXXXXXXXXXGXXXXXXXXXXXXXXXXXXXGXXXXXXXXXXXXXXXXXXXGXXXXXXXXXXXXXXXXXXXGXXXXXXXXXXXXXXXXXXXGAXXXXXXXXXXXXXXXXXXGXXXXXXXXXXXXXXXXXXXGXXXXXXXXXXXXXXXXXXX,0,10,0

37170,14,1,13,74,512,0,0,525,386,139,GXXXXXXXXXXXXXXXXXXXGXXXXXXXXXXXXXXXXXXXGXXXXXXXXXXXXXXXXXXXGXXXXXXXXXXXXXXXXXXXGXXXXXXXXXXXXXXXXXXXGXXXXXXXXXXXXXXXXXXXGXXXXXXXXXXXXXXXXXXXGXXXXXXXXXXXXXXXXXXXGXXXXXXXXXXXXXXXXXXXGXXXXXXXXXXXXXXXXXXXGAXXXXXXXXXXXXXXXXXXGXXXXXXXXXXXXXXXXXXXGXXXXXXXXXXXXXXXXXXX,0,10,0
37191,14,1,13,66,520,0,0,532,394,138,GXXXXXXXXXXXXXXXXXXXGXXXXXXXXXXXXXXXXXXXGXXXXXXXXXXXXXXXXXXXGXXXXXXXXXXXXXXXXXXXGXXXXXXXXXXXXXXXXXXXGXXXXXXXXXXXXXXXXXXXGXXXXXXXXXXXXXXXXXXXGXXXXXXXXXXXXXXXXXXXGXXXXXXXXXXXXXXXXXXXGXXXXXXXXXXXXXXXXXXXGAXXXXXXXXXXXXXXXXXXGXXXXXXXXXXXXXXXXXXXGXXXXXXXXXXXXXXXXXXX,0,10,0
37212,14,1,13,66,520,0,0,533,393,140,GXXXXXXXXXXXXXXXXXXXGXXXXXXXXXXXXXXXXXXXGXXXXXXXXXXXXXXXXXXXGXXXXXXXXXXXXXXXXXXXGXXXXXXXXXXXXXXXXXXXGXXXXXXXXXXXXXXXXXXXGXXXXXXXXXXXXXXXXXXXGXXXXXXXXXXXXXXXXXXXGXXXXXXXXXXXXXXXXXXXGXXXXXXXXXXXXXXXXXXXGAXXXXXXXXXXXXXXXXXXGXXXXXXXXXXXXXXXXXXXGXXXXXXXXXXXXXXXXXXX,0,10,0
37233,14,1,13,72,514,0,0,526,389,137,GXXXXXXXXXXXXXXXXXXXGXXXXXXXXXXXXXXXXXXXGXXXXXXXXXXXXXXXXXXXGXXXXXXXXXXXXXXXXXXXGXXXXXXXXXXXXXXXXXXXGXXXXXXXXXXXXXXXXXXXGXXXXXXXXXXXXXXXXXXXGXXXXXXXXXXXXXXXXXXXGXXXXXXXXXXXXXXXXXXXGXXXXXXXXXXXXXXXXXXXGAXXXXXXXXXXXXXXXXXXGXXXXXXXXXXXXXXXXXXXGXXXXXXXXXXXXXXXXXXX,0,10,0
37254,14,1,13,64,522,0,0,536,392,144,GXXXXXXXXXXXXXXXXXXXGXXXXXXXXXXXXXXXXXXXGXXXXXXXXXXXXXXXXXXXGXXXXXXXXXXXXXXXXXXXGXXXXXXXXXXXXXXXXXXXGXXXXXXXXXXXXXXXXXXXGXXXXXXXXXXXXXXXXXXXGXXXXXXXXXXXXXXXXXXXGXXXXXXXXXXXXXXXXXXXGXXXXXXXXXXXXXXXXXXXGAXXXXXXXXXXXXXXXXXXGXXXXXXXXXXXXXXXXXXXGXXXXXXXXXXXXXXXXXXX,0,10,0

37275,14,1,13,76,510,0,0,524,392,132,GXXXXXXXXXXXXXXXXXXXGXXXXXXXXXXXXXXXXXXXGXXXXXXXXXXXXXXXXXXXGXXXXXXXXXXXXXXXXXXXGXXXXXXXXXXXXXXXXXXXGXXXXXXXXXXXXXXXXXXXGXXXXXXXXXXXXXXXXXXXGXXXXXXXXXXXXXXXXXXXGXXXXXXXXXXXXXXXXXXXGXXXXXXXXXXXXXXXXXXXGAXXXXXXXXXXXXXXXXXXGXXXXXXXXXXXXXXXXXXXGXXXXXXXXXXXXXXXXXXX,0,10,0
37296,13,0,13,77,510,0,0,524,392,132,GXXXXXXXXXXXXXXXXXXXGXXXXXXXXXXXXXXXXXXXGXXXXXXXXXXXXXXXXXXXGXXXXXXXXXXXXXXXXXXXGXXXXXXXXXXXXXXXXXXXGXXXXXXXXXXXXXXXXXXXGXXXXXXXXXXXXXXXXXXXGXXXXXXXXXXXXXXXXXXXGXXXXXXXXXXXXXXXXXXXGXXXXXXXXXXXXXXXXXXXGXXXXXXXXXXXXXXXXXXXGXXXXXXXXXXXXXXXXXXXGXXXXXXXXXXXXXXXXXXX,0,10,0
37317,13,0,13,75,512,0,0,526,398,128,GXXXXXXXXXXXXXXXXXXXGXXXXXXXXXXXXXXXXXXXGXXXXXXXXXXXXXXXXXXXGXXXXXXXXXXXXXXXXXXXGXXXXXXXXXXXXXXXXXXXGXXXXXXXXXXXXXXXXXXXGXXXXXXXXXXXXXXXXXXXGXXXXXXXXXXXXXXXXXXXGXXXXXXXXXXXXXXXXXXXGXXXXXXXXXXXXXXXXXXXGXXXXXXXXXXXXXXXXXXXGXXXXXXXXXXXXXXXXXXXGXXXXXXXXXXXXXXXXXXX,0,10,0
37338,13,0,13,78,509,0,0,522,396,126,GXXXXXXXXXXXXXXXXXXXGXXXXXXXXXXXXXXXXXXXGXXXXXXXXXXXXXXXXXXXGXXXXXXXXXXXXXXXXXXXGXXXXXXXXXXXXXXXXXXXGXXXXXXXXXXXXXXXXXXXGXXXXXXXXXXXXXXXXXXXGXXXXXXXXXXXXXXXXXXXGXXXXXXXXXXXXXXXXXXXGXXXXXXXXXXXXXXXXXXXGXXXXXXXXXXXXXXXXXXXGXXXXXXXXXXXXXXXXXXXGXXXXXXXXXXXXXXXXXXX,0,10,0
37359,13,0,13,80,507,0,0,521,390,131,GXXXXXXXXXXXXXXXXXXXGXXXXXXXXXXXXXXXXXXXGXXXXXXXXXXXXXXXXXXXGXXXXXXXXXXXXXXXXXXXGXXXXXXXXXXXXXXXXXXXGXXXXXXXXXXXXXXXXXXXGXXXXXXXXXXXXXXXXXXXGXXXXXXXXXXXXXXXXXXXGXXXXXXXXXXXXXXXXXXXGXXXXXXXXXXXXXXXXXXXGXXXXXXXXXXXXXXXXXXXGXXXXXXXXXXXXXXXXXXXGXXXXXXXXXXXXXXXXXXX,0,10,0

37380,13,0,13,81,506,0,0,520,388,132,GXXXXXXXXXXXXXXXXXXXGXXXXXXXXXXXXXXXXXXXGXXXXXXXXXXXXXXXXXXXGXXXXXXXXXXXXXXXXXXXGXXXXXXXXXXXXXXXXXXXGXXXXXXXXXXXXXXXXXXXGXXXXXXXXXXXXXXXXXXXGXXXXXXXXXXXXXXXXXXXGXXXXXXXXXXXXXXXXXXXGXXXXXXXXXXXXXXXXXXXGXXXXXXXXXXXXXXXXXXXGXXXXXXXXXXXXXXXXXXXGXXXXXXXXXXXXXXXXXXX,0,10,0
37401,13,0,13,75,512,0,0,525,389,136,GXXXXXXXXXXXXXXXXXXXGXXXXXXXXXXXXXXXXXXXGXXXXXXXXXXXXXXXXXXXGXXXXXXXXXXXXXXXXXXXGXXXXXXXXXXXXXXXXXXXGXXXXXXXXXXXXXXXXXXXGXXXXXXXXXXXXXXXXXXXGXXXXXXXXXXXXXXXXXXXGXXXXXXXXXXXXXXXXXXXGXXXXXXXXXXXXXXXXXXXGXXXXXXXXXXXXXXXXXXXGXXXXXXXXXXXXXXXXXXXGXXXXXXXXXXXXXXXXXXX,0,10,0
37422,13,0,13,73,514,0,0,527,388,139,GXXXXXXXXXXXXXXXXXXXGXXXXXXXXXXXXXXXXXXXGXXXXXXXXXXXXXXXXXXXGXXXXXXXXXXXXXXXXXXXGXXXXXXXXXXXXXXXXXXXGXXXXXXXXXXXXXXXXXXXGXXXXXXXXXXXXXXXXXXXGXXXXXXXXXXXXXXXXXXXGXXXXXXXXXXXXXXXXXXXGXXXXXXXXXXXXXXXXXXXGXXXXXXXXXXXXXXXXXXXGXXXXXXXXXXXXXXXXXXXGXXXXXXXXXXXXXXXXXXX,0,10,0
37443,14,1,13,70,516,0,0,530,387,143,GXXXXXXXXXXXXXXXXXXXGXXXXXXXXXXXXXXXXXXXGXXXXXXXXXXXXXXXXXXXGXXXXXXXXXXXXXXXXXXXGXXXXXXXXXXXXXXXXXXXGAXXXXXXXXXXXXXXXXXXGXXXXXXXXXXXXXXXXXXXGXXXXXXXXXXXXXXXXXXXGXXXXXXXXXXXXXXXXXXXGXXXXXXXXXXXXXXXXXXXGXXXXXXXXXXXXXXXXXXXGXXXXXXXXXXXXXXXXXXXGXXXXXXXXXXXXXXXXXXX,0,10,0
37464,14,1,13,62,524,0,0,538,390,148,GXXXXXXXXXXXXXXXXXXXGXXXXXXXXXXXXXXXXXXXGXXXXXXXXXXXXXXXXXXXGXXXXXXXXXXXXXXXXXXXGXXXXXXXXXXXXXXXXXXXGAXXXXXXXXXXXXXXXXXXGXXXXXXXXXXXXXXXXXXXGXXXXXXXXXXXXXXXXXXXGXXXXXXXXXXXXXXXXXXXGXXXXXXXXXXXXXXXXXXXGXXXXXXXXXXXXXXXXXXXGXXXXXXXXXXXXXXXXXXXGXXXXXXXXXXXXXXXXXXX,0,10,0

37485,14,1,13,60,526,0,0,539,393,146,GXXXXXXXXXXXXXXXXXXXGXXXXXXXXXXXXXXXXXXXGXXXXXXXXXXXXXXXXXXXGXXXXXXXXXXXXXXXXXXXGXXXXXXXXXXXXXXXXXXXGAXXXXXXXXXXXXXXXXXXGXXXXXXXXXXXXXXXXXXXGXXXXXXXXXXXXXXXXXXXGXXXXXXXXXXXXXXXXXXXGXXXXXXXXXXXXXXXXXXXGXXXXXXXXXXXXXXXXXXXGXXXXXXXXXXXXXXXXXXXGXXXXXXXXXXXXXXXXXXX,0,10,0
37506,14,1,13,67,519,0,0,532,390,142,GXXXXXXXXXXXXXXXXXXXGXXXXXXXXXXXXXXXXXXXGXXXXXXXXXXXXXXXXXXXGXXXXXXXXXXXXXXXXXXXGXXXXXXXXXXXXXXXXXXXGAXXXXXXXXXXXXXXXXXXGXXXXXXXXXXXXXXXXXXXGXXXXXXXXXXXXXXXXXXXGXXXXXXXXXXXXXXXXXXXGXXXXXXXXXXXXXXXXXXXGXXXXXXXXXXXXXXXXXXXGXXXXXXXXXXXXXXXXXXXGXXXXXXXXXXXXXXXXXXX,0,10,0
37527,14,1,13,68,518,0,0,530,389,141,GXXXXXXXXXXXXXXXXXXXGXXXXXXXXXXXXXXXXXXXGXXXXXXXXXXXXXXXXXXXGXXXXXXXXXXXXXXXXXXXGXXXXXXXXXXXXXXXXXXXGAXXXXXXXXXXXXXXXXXXGXXXXXXXXXXXXXXXXXXXGXXXXXXXXXXXXXXXXXXXGXXXXXXXXXXXXXXXXXXXGXXXXXXXXXXXXXXXXXXXGXXXXXXXXXXXXXXXXXXXGXXXXXXXXXXXXXXXXXXXGXXXXXXXXXXXXXXXXXXX,0,10,0
37548,14,1,13,74,512,0,0,525,389,136,GXXXXXXXXXXXXXXXXXXXGXXXXXXXXXXXXXXXXXXXGXXXXXXXXXXXXXXXXXXXGXXXXXXXXXXXXXXXXXXXGXXXXXXXXXXXXXXXXXXXGAXXXXXXXXXXXXXXXXXXGXXXXXXXXXXXXXXXXXXXGXXXXXXXXXXXXXXXXXXXGXXXXXXXXXXXXXXXXXXXGXXXXXXXXXXXXXXXXXXXGXXXXXXXXXXXXXXXXXXXGXXXXXXXXXXXXXXXXXXXGXXXXXXXXXXXXXXXXXXX,0,10,0
37569,14,1,13,73,513,0,0,525,396,129,GXXXXXXXXXXXXXXXXXXXGXXXXXXXXXXXXXXXXXXXGXXXXXXXXXXXXXXXXXXXGXXXXXXXXXXXXXXXXXXXGXXXXXXXXXXXXXXXXXXXGAXXXXXXXXXXXXXXXXXXGXXXXXXXXXXXXXXXXXXXGXXXXXXXXXXXXXXXXXXXGXXXXXXXXXXXXXXXXXXXGXXXXXXXXXXXXXXXXXXXGXXXXXXXXXXXXXXXXXXXGXXXXXXXXXXXXXXXXXXXGXXXXXXXXXXXXXXXXXXX,0,10,0

37590,14,1,13,77,509,0,0,521,395,126,GXXXXXXXXXXXXXXXXXXXGXXXXXXXXXXXXXXXXXXXGXXXXXXXXXXXXXXXXXXXGXXXXXXXXXXXXXXXXXXXGXXXXXXXXXXXXXXXXXXXGAXXXXXXXXXXXXXXXXXXGXXXXXXXXXXXXXXXXXXXGXXXXXXXXXXXXXXXXXXXGXXXXXXXXXXXXXXXXXXXGXXXXXXXXXXXXXXXXXXXGXXXXXXXXXXXXXXXXXXXGXXXXXXXXXXXXXXXXXXXGXXXXXXXXXXXXXXXXXXX,0,10,0
37611,14,1,13,80,506,0,0,519,391,128,GXXXXXXXXXXXXXXXXXXXGXXXXXXXXXXXXXXXXXXXGXXXXXXXXXXXXXXXXXXXGXXXXXXXXXXXXXXXXXXXGXXXXXXXXXXXXXXXXXXXGAXXXXXXXXXXXXXXXXXXGXXXXXXXXXXXXXXXXXXXGXXXXXXXXXXXXXXXXXXXGXXXXXXXXXXXXXXXXXXXGXXXXXXXXXXXXXXXXXXXGXXXXXXXXXXXXXXXXXXXGXXXXXXXXXXXXXXXXXXXGXXXXXXXXXXXXXXXXXXX,0,10,0
37632,14,0,14,81,505,0,0,518,392,126,GXXXXXXXXXXXXXXXXXXXGXXXXXXXXXXXXXXXXXXXGXXXXXXXXXXXXXXXXXXXGXXXXXXXXXXXXXXXXXXXGXXXXXXXXXXXXXXXXXXXGOXXXXXXXXXXXXXXXXXXGXXXXXXXXXXXXXXXXXXXGXXXXXXXXXXXXXXXXXXXGXXXXXXXXXXXXXXXXXXXGXXXXXXXXXXXXXXXXXXXGXXXXXXXXXXXXXXXXXXXGXXXXXXXXXXXXXXXXXXXGXXXXXXXXXXXXXXXXXXX,0,10,0
37653,13,0,13,83,504,0,0,516,397,119,GXXXXXXXXXXXXXXXXXXXGXXXXXXXXXXXXXXXXXXXGXXXXXXXXXXXXXXXXXXXGXXXXXXXXXXXXXXXXXXXGXXXXXXXXXXXXXXXXXXXGXXXXXXXXXXXXXXXXXXXGXXXXXXXXXXXXXXXXXXXGXXXXXXXXXXXXXXXXXXXGXXXXXXXXXXXXXXXXXXXGXXXXXXXXXXXXXXXXXXXGXXXXXXXXXXXXXXXXXXXGXXXXXXXXXXXXXXXXXXXGXXXXXXXXXXXXXXXXXXX,0,10,0
37674,13,0,13,84,503,0,0,515,396,119,GXXXXXXXXXXXXXXXXXXXGXXXXXXXXXXXXXXXXXXXGXXXXXXXXXXXXXXXXXXXGXXXXXXXXXXXXXXXXXXXGXXXXXXXXXXXXXXXXXXXGXXXXXXXXXXXXXXXXXXXGXXXXXXXXXXXXXXXXXXXGXXXXXXXXXXXXXXXXXXXGXXXXXXXXXXXXXXXXXXXGXXXXXXXXXXXXXXXXXXXGXXXXXXXXXXXXXXXXXXXGXXXXXXXXXXXXXXXXXXXGXXXXXXXXXXXXXXXXXXX,0,10,0

37695,13,0,13,82,505,0,0,519,397,122,GXXXXXXXXXXXXXXXXXXXGXXXXXXXXXXXXXXXXXXXGXXXXXXXXXXXXXXXXXXXGXXXXXXXXXXXXXXXXXXXGXXXXXXXXXXXXXXXXXXXGXXXXXXXXXXXXXXXXXXXGXXXXXXXXXXXXXXXXXXXGXXXXXXXXXXXXXXXXXXXGXXXXXXXXXXXXXXXXXXXGXXXXXXXXXXXXXXXXXXXGXXXXXXXXXXXXXXXXXXXGXXXXXXXXXXXXXXXXXXXGXXXXXXXXXXXXXXXXXXX,0,10,0
37716,13,0,13,86,501,0,0,515,397,118,GXXXXXXXXXXXXXXXXXXXGXXXXXXXXXXXXXXXXXXXGXXXXXXXXXXXXXXXXXXXGXXXXXXXXXXXXXXXXXXXGXXXXXXXXXXXXXXXXXXXGXXXXXXXXXXXXXXXXXXXGXXXXXXXXXXXXXXXXXXXGXXXXXXXXXXXXXXXXXXXGXXXXXXXXXXXXXXXXXXXGXXXXXXXXXXXXXXXXXXXGXXXXXXXXXXXXXXXXXXXGXXXXXXXXXXXXXXXXXXXGXXXXXXXXXXXXXXXXXXX,0,10,0
37737,13,0,13,90,497,0,0,510,391,119,GXXXXXXXXXXXXXXXXXXXGXXXXXXXXXXXXXXXXXXXGXXXXXXXXXXXXXXXXXXXGXXXXXXXXXXXXXXXXXXXGXXXXXXXXXXXXXXXXXXXGXXXXXXXXXXXXXXXXXXXGXXXXXXXXXXXXXXXXXXXGXXXXXXXXXXXXXXXXXXXGXXXXXXXXXXXXXXXXXXXGXXXXXXXXXXXXXXXXXXXGXXXXXXXXXXXXXXXXXXXGXXXXXXXXXXXXXXXXXXXGXXXXXXXXXXXXXXXXXXX,0,10,0
37758,13,0,13,94,493,0,0,507,393,114,GXXXXXXXXXXXXXXXXXXXGXXXXXXXXXXXXXXXXXXXGXXXXXXXXXXXXXXXXXXXGXXXXXXXXXXXXXXXXXXXGXXXXXXXXXXXXXXXXXXXGXXXXXXXXXXXXXXXXXXXGXXXXXXXXXXXXXXXXXXXGXXXXXXXXXXXXXXXXXXXGXXXXXXXXXXXXXXXXXXXGXXXXXXXXXXXXXXXXXXXGXXXXXXXXXXXXXXXXXXXGXXXXXXXXXXXXXXXXXXXGXXXXXXXXXXXXXXXXXXX,0,10,0
37779,13,0,13,91,496,0,0,509,393,116,GXXXXXXXXXXXXXXXXXXXGXXXXXXXXXXXXXXXXXXXGXXXXXXXXXXXXXXXXXXXGXXXXXXXXXXXXXXXXXXXGXXXXXXXXXXXXXXXXXXXGXXXXXXXXXXXXXXXXXXXGXXXXXXXXXXXXXXXXXXXGXXXXXXXXXXXXXXXXXXXGXXXXXXXXXXXXXXXXXXXGXXXXXXXXXXXXXXXXXXXGXXXXXXXXXXXXXXXXXXXGXXXXXXXXXXXXXXXXXXXGXXXXXXXXXXXXXXXXXXX,0,10,0

37800,13,0,13,93,494,0,0,507,391,116,GXXXXXXXXXXXXXXXXXXXGXXXXXXXXXXXXXXXXXXXGXXXXXXXXXXXXXXXXXXXGXXXXXXXXXXXXXXXXXXXGXXXXXXXXXXXXXXXXXXXGXXXXXXXXXXXXXXXXXXXGXXXXXXXXXXXXXXXXXXXGXXXXXXXXXXXXXXXXXXXGXXXXXXXXXXXXXXXXXXXGXXXXXXXXXXXXXXXXXXXGXXXXXXXXXXXXXXXXXXXGXXXXXXXXXXXXXXXXXXXGXXXXXXXXXXXXXXXXXXX,0,10,0
37821,13,0,13,84,503,0,0,517,395,122,GXXXXXXXXXXXXXXXXXXXGXXXXXXXXXXXXXXXXXXXGXXXXXXXXXXXXXXXXXXXGXXXXXXXXXXXXXXXXXXXGXXXXXXXXXXXXXXXXXXXGXXXXXXXXXXXXXXXXXXXGXXXXXXXXXXXXXXXXXXXGXXXXXXXXXXXXXXXXXXXGXXXXXXXXXXXXXXXXXXXGXXXXXXXXXXXXXXXXXXXGXXXXXXXXXXXXXXXXXXXGXXXXXXXXXXXXXXXXXXXGXXXXXXXXXXXXXXXXXXX,0,10,0
37842,14,1,13,78,508,0,0,520,400,120,GXXXXXXXXXXXXXXXXXXXGXXXXXXXXXXXXXXXXXXXGXXXXXXXXXXXXXXXXXXXGXXXXXXXXXXXXXXXXXXXGXXXXXXXXXXXXXXXXXXXGXXXXXXXXXXXXXXXXXXXGXXXXXXXXXXXXXXXXXXXGXXXXXXXXXXXXXXXXXXXGXXXXXXXXXXXXXXXXXXXGXXXXXXXXXXXXXXXXXXXGXXXXXXXXXXXXXXXXXXXGXXXXXXXXXXXXXXXXXXXGAXXXXXXXXXXXXXXXXXX,0,10,0
37863,14,1,13,83,503,0,0,516,391,125,GXXXXXXXXXXXXXXXXXXXGXXXXXXXXXXXXXXXXXXXGXXXXXXXXXXXXXXXXXXXGXXXXXXXXXXXXXXXXXXXGXXXXXXXXXXXXXXXXXXXGXXXXXXXXXXXXXXXXXXXGXXXXXXXXXXXXXXXXXXXGXXXXXXXXXXXXXXXXXXXGXXXXXXXXXXXXXXXXXXXGXXXXXXXXXXXXXXXXXXXGXXXXXXXXXXXXXXXXXXXGXXXXXXXXXXXXXXXXXXXGAXXXXXXXXXXXXXXXXXX,0,10,0
37884,14,1,13,75,511,0,0,523,390,133,GXXXXXXXXXXXXXXXXXXXGXXXXXXXXXXXXXXXXXXXGXXXXXXXXXXXXXXXXXXXGXXXXXXXXXXXXXXXXXXXGXXXXXXXXXXXXXXXXXXXGXXXXXXXXXXXXXXXXXXXGXXXXXXXXXXXXXXXXXXXGXXXXXXXXXXXXXXXXXXXGXXXXXXXXXXXXXXXXXXXGXXXXXXXXXXXXXXXXXXXGXXXXXXXXXXXXXXXXXXXGXXXXXXXXXXXXXXXXXXXGAXXXXXXXXXXXXXXXXXX,0,10,0

37905,15,2,13,70,515,0,0,528,394,134,GXXXXXXXXXXXXXXXXXXXGXXXXXXXXXXXXXXXXXXXGXXXXXXXXXXXXXXXXXXXGAXXXXXXXXXXXXXXXXXXGXXXXXXXXXXXXXXXXXXXGXXXXXXXXXXXXXXXXXXXGXXXXXXXXXXXXXXXXXXXGXXXXXXXXXXXXXXXXXXXGXXXXXXXXXXXXXXXXXXXGXXXXXXXXXXXXXXXXXXXGXXXXXXXXXXXXXXXXXXXGXXXXXXXXXXXXXXXXXXXGAXXXXXXXXXXXXXXXXXX,0,10,0
37926,15,2,13,71,514,0,0,527,395,132,GXXXXXXXXXXXXXXXXXXXGXXXXXXXXXXXXXXXXXXXGXXXXXXXXXXXXXXXXXXXGAXXXXXXXXXXXXXXXXXXGXXXXXXXXXXXXXXXXXXXGXXXXXXXXXXXXXXXXXXXGXXXXXXXXXXXXXXXXXXXGXXXXXXXXXXXXXXXXXXXGXXXXXXXXXXXXXXXXXXXGXXXXXXXXXXXXXXXXXXXGXXXXXXXXXXXXXXXXXXXGXXXXXXXXXXXXXXXXXXXGAXXXXXXXXXXXXXXXXXX,0,10,0
37947,15,2,13,74,511,0,0,524,393,131,GXXXXXXXXXXXXXXXXXXXGXXXXXXXXXXXXXXXXXXXGXXXXXXXXXXXXXXXXXXXGAXXXXXXXXXXXXXXXXXXGXXXXXXXXXXXXXXXXXXXGXXXXXXXXXXXXXXXXXXXGXXXXXXXXXXXXXXXXXXXGXXXXXXXXXXXXXXXXXXXGXXXXXXXXXXXXXXXXXXXGXXXXXXXXXXXXXXXXXXXGXXXXXXXXXXXXXXXXXXXGXXXXXXXXXXXXXXXXXXXGAXXXXXXXXXXXXXXXXXX,0,10,0
37968,15,2,13,78,507,0,0,521,389,132,GXXXXXXXXXXXXXXXXXXXGXXXXXXXXXXXXXXXXXXXGXXXXXXXXXXXXXXXXXXXGAXXXXXXXXXXXXXXXXXXGXXXXXXXXXXXXXXXXXXXGXXXXXXXXXXXXXXXXXXXGXXXXXXXXXXXXXXXXXXXGXXXXXXXXXXXXXXXXXXXGXXXXXXXXXXXXXXXXXXXGXXXXXXXXXXXXXXXXXXXGXXXXXXXXXXXXXXXXXXXGXXXXXXXXXXXXXXXXXXXGAXXXXXXXXXXXXXXXXXX,0,10,0
37989,15,1,14,73,512,0,0,526,392,134,GXXXXXXXXXXXXXXXXXXXGXXXXXXXXXXXXXXXXXXXGXXXXXXXXXXXXXXXXXXXGOXXXXXXXXXXXXXXXXXXGXXXXXXXXXXXXXXXXXXXGXXXXXXXXXXXXXXXXXXXGXXXXXXXXXXXXXXXXXXXGXXXXXXXXXXXXXXXXXXXGXXXXXXXXXXXXXXXXXXXGXXXXXXXXXXXXXXXXXXXGXXXXXXXXXXXXXXXXXXXGXXXXXXXXXXXXXXXXXXXGAXXXXXXXXXXXXXXXXXX,0,10,0

38010,14,1,13,76,510,0,0,524,391,133,GXXXXXXXXXXXXXXXXXXXGXXXXXXXXXXXXXXXXXXXGXXXXXXXXXXXXXXXXXXXGXXXXXXXXXXXXXXXXXXXGXXXXXXXXXXXXXXXXXXXGXXXXXXXXXXXXXXXXXXXGXXXXXXXXXXXXXXXXXXXGXXXXXXXXXXXXXXXXXXXGXXXXXXXXXXXXXXXXXXXGXXXXXXXXXXXXXXXXXXXGXXXXXXXXXXXXXXXXXXXGXXXXXXXXXXXXXXXXXXXGAXXXXXXXXXXXXXXXXXX,0,10,0
38031,14,1,13,71,515,0,0,528,389,139,GXXXXXXXXXXXXXXXXXXXGXXXXXXXXXXXXXXXXXXXGXXXXXXXXXXXXXXXXXXXGXXXXXXXXXXXXXXXXXXXGXXXXXXXXXXXXXXXXXXXGXXXXXXXXXXXXXXXXXXXGXXXXXXXXXXXXXXXXXXXGXXXXXXXXXXXXXXXXXXXGXXXXXXXXXXXXXXXXXXXGXXXXXXXXXXXXXXXXXXXGXXXXXXXXXXXXXXXXXXXGXXXXXXXXXXXXXXXXXXXGAXXXXXXXXXXXXXXXXXX,0,10,0
38052,14,1,13,62,524,0,0,539,394,145,GXXXXXXXXXXXXXXXXXXXGXXXXXXXXXXXXXXXXXXXGXXXXXXXXXXXXXXXXXXXGXXXXXXXXXXXXXXXXXXXGXXXXXXXXXXXXXXXXXXXGXXXXXXXXXXXXXXXXXXXGXXXXXXXXXXXXXXXXXXXGXXXXXXXXXXXXXXXXXXXGXXXXXXXXXXXXXXXXXXXGXXXXXXXXXXXXXXXXXXXGXXXXXXXXXXXXXXXXXXXGXXXXXXXXXXXXXXXXXXXGAXXXXXXXXXXXXXXXXXX,0,10,0
38073,14,1,13,61,525,0,0,540,394,146,GXXXXXXXXXXXXXXXXXXXGXXXXXXXXXXXXXXXXXXXGXXXXXXXXXXXXXXXXXXXGXXXXXXXXXXXXXXXXXXXGXXXXXXXXXXXXXXXXXXXGXXXXXXXXXXXXXXXXXXXGXXXXXXXXXXXXXXXXXXXGXXXXXXXXXXXXXXXXXXXGXXXXXXXXXXXXXXXXXXXGXXXXXXXXXXXXXXXXXXXGXXXXXXXXXXXXXXXXXXXGXXXXXXXXXXXXXXXXXXXGAXXXXXXXXXXXXXXXXXX,0,10,0
38094,14,1,13,62,524,0,0,538,397,141,GXXXXXXXXXXXXXXXXXXXGXXXXXXXXXXXXXXXXXXXGXXXXXXXXXXXXXXXXXXXGXXXXXXXXXXXXXXXXXXXGXXXXXXXXXXXXXXXXXXXGXXXXXXXXXXXXXXXXXXXGXXXXXXXXXXXXXXXXXXXGXXXXXXXXXXXXXXXXXXXGXXXXXXXXXXXXXXXXXXXGXXXXXXXXXXXXXXXXXXXGXXXXXXXXXXXXXXXXXXXGXXXXXXXXXXXXXXXXXXXGAXXXXXXXXXXXXXXXXXX,0,10,0

38115,14,1,13,70,516,0,0,530,391,139,GXXXXXXXXXXXXXXXXXXXGXXXXXXXXXXXXXXXXXXXGXXXXXXXXXXXXXXXXXXXGXXXXXXXXXXXXXXXXXXXGXXXXXXXXXXXXXXXXXXXGXXXXXXXXXXXXXXXXXXXGXXXXXXXXXXXXXXXXXXXGXXXXXXXXXXXXXXXXXXXGXXXXXXXXXXXXXXXXXXXGXXXXXXXXXXXXXXXXXXXGXXXXXXXXXXXXXXXXXXXGXXXXXXXXXXXXXXXXXXXGAXXXXXXXXXXXXXXXXXX,0,10,0
38136,14,1,13,72,514,0,0,527,395,132,GXXXXXXXXXXXXXXXXXXXGXXXXXXXXXXXXXXXXXXXGXXXXXXXXXXXXXXXXXXXGXXXXXXXXXXXXXXXXXXXGXXXXXXXXXXXXXXXXXXXGXXXXXXXXXXXXXXXXXXXGXXXXXXXXXXXXXXXXXXXGXXXXXXXXXXXXXXXXXXXGXXXXXXXXXXXXXXXXXXXGXXXXXXXXXXXXXXXXXXXGXXXXXXXXXXXXXXXXXXXGXXXXXXXXXXXXXXXXXXXGAXXXXXXXXXXXXXXXXXX,0,10,0
38157,14,1,13,71,515,0,0,529,398,131,GXXXXXXXXXXXXXXXXXXXGXXXXXXXXXXXXXXXXXXXGXXXXXXXXXXXXXXXXXXXGXXXXXXXXXXXXXXXXXXXGXXXXXXXXXXXXXXXXXXXGXXXXXXXXXXXXXXXXXXXGXXXXXXXXXXXXXXXXXXXGXXXXXXXXXXXXXXXXXXXGXXXXXXXXXXXXXXXXXXXGXXXXXXXXXXXXXXXXXXXGXXXXXXXXXXXXXXXXXXXGXXXXXXXXXXXXXXXXXXXGAXXXXXXXXXXXXXXXXXX,0,10,0
38178,14,1,13,67,519,0,0,532,400,132,GXXXXXXXXXXXXXXXXXXXGXXXXXXXXXXXXXXXXXXXGXXXXXXXXXXXXXXXXXXXGXXXXXXXXXXXXXXXXXXXGXXXXXXXXXXXXXXXXXXXGXXXXXXXXXXXXXXXXXXXGXXXXXXXXXXXXXXXXXXXGXXXXXXXXXXXXXXXXXXXGXXXXXXXXXXXXXXXXXXXGXXXXXXXXXXXXXXXXXXXGXXXXXXXXXXXXXXXXXXXGXXXXXXXXXXXXXXXXXXXGAXXXXXXXXXXXXXXXXXX,0,10,0
38199,14,1,13,74,512,0,0,523,393,130,GXXXXXXXXXXXXXXXXXXXGXXXXXXXXXXXXXXXXXXXGXXXXXXXXXXXXXXXXXXXGXXXXXXXXXXXXXXXXXXXGXXXXXXXXXXXXXXXXXXXGXXXXXXXXXXXXXXXXXXXGXXXXXXXXXXXXXXXXXXXGXXXXXXXXXXXXXXXXXXXGXXXXXXXXXXXXXXXXXXXGXXXXXXXXXXXXXXXXXXXGXXXXXXXXXXXXXXXXXXXGXXXXXXXXXXXXXXXXXXXGAXXXXXXXXXXXXXXXXXX,0,10,0

38220,14,0,14,72,514,0,0,527,395,132,GXXXXXXXXXXXXXXXXXXXGXXXXXXXXXXXXXXXXXXXGXXXXXXXXXXXXXXXXXXXGXXXXXXXXXXXXXXXXXXXGXXXXXXXXXXXXXXXXXXXGXXXXXXXXXXXXXXXXXXXGXXXXXXXXXXXXXXXXXXXGXXXXXXXXXXXXXXXXXXXGXXXXXXXXXXXXXXXXXXXGXXXXXXXXXXXXXXXXXXXGXXXXXXXXXXXXXXXXXXXGXXXXXXXXXXXXXXXXXXXGOXXXXXXXXXXXXXXXXXX,0,10,0
38241,14,0,14,67,519,0,0,532,402,130,GXXXXXXXXXXXXXXXXXXXGXXXXXXXXXXXXXXXXXXXGXXXXXXXXXXXXXXXXXXXGXXXXXXXXXXXXXXXXXXXGXXXXXXXXXXXXXXXXXXXGXXXXXXXXXXXXXXXXXXXGXXXXXXXXXXXXXXXXXXXGXXXXXXXXXXXXXXXXXXXGXXXXXXXXXXXXXXXXXXXGXXXXXXXXXXXXXXXXXXXGXXXXXXXXXXXXXXXXXXXGXXXXXXXXXXXXXXXXXXXGOXXXXXXXXXXXXXXXXXX,0,10,0
38262,13,0,13,72,515,0,0,528,398,130,GXXXXXXXXXXXXXXXXXXXGXXXXXXXXXXXXXXXXXXXGXXXXXXXXXXXXXXXXXXXGXXXXXXXXXXXXXXXXXXXGXXXXXXXXXXXXXXXXXXXGXXXXXXXXXXXXXXXXXXXGXXXXXXXXXXXXXXXXXXXGXXXXXXXXXXXXXXXXXXXGXXXXXXXXXXXXXXXXXXXGXXXXXXXXXXXXXXXXXXXGXXXXXXXXXXXXXXXXXXXGXXXXXXXXXXXXXXXXXXXGXXXXXXXXXXXXXXXXXXX,0,10,0
38283,13,0,13,76,511,0,0,524,395,129,GXXXXXXXXXXXXXXXXXXXGXXXXXXXXXXXXXXXXXXXGXXXXXXXXXXXXXXXXXXXGXXXXXXXXXXXXXXXXXXXGXXXXXXXXXXXXXXXXXXXGXXXXXXXXXXXXXXXXXXXGXXXXXXXXXXXXXXXXXXXGXXXXXXXXXXXXXXXXXXXGXXXXXXXXXXXXXXXXXXXGXXXXXXXXXXXXXXXXXXXGXXXXXXXXXXXXXXXXXXXGXXXXXXXXXXXXXXXXXXXGXXXXXXXXXXXXXXXXXXX,0,10,0
38304,13,0,13,78,509,0,0,521,398,123,GXXXXXXXXXXXXXXXXXXXGXXXXXXXXXXXXXXXXXXXGXXXXXXXXXXXXXXXXXXXGXXXXXXXXXXXXXXXXXXXGXXXXXXXXXXXXXXXXXXXGXXXXXXXXXXXXXXXXXXXGXXXXXXXXXXXXXXXXXXXGXXXXXXXXXXXXXXXXXXXGXXXXXXXXXXXXXXXXXXXGXXXXXXXXXXXXXXXXXXXGXXXXXXXXXXXXXXXXXXXGXXXXXXXXXXXXXXXXXXXGXXXXXXXXXXXXXXXXXXX,0,10,0

38325,13,0,13,76,511,0,0,523,400,123,GXXXXXXXXXXXXXXXXXXXGXXXXXXXXXXXXXXXXXXXGXXXXXXXXXXXXXXXXXXXGXXXXXXXXXXXXXXXXXXXGXXXXXXXXXXXXXXXXXXXGXXXXXXXXXXXXXXXXXXXGXXXXXXXXXXXXXXXXXXXGXXXXXXXXXXXXXXXXXXXGXXXXXXXXXXXXXXXXXXXGXXXXXXXXXXXXXXXXXXXGXXXXXXXXXXXXXXXXXXXGXXXXXXXXXXXXXXXXXXXGXXXXXXXXXXXXXXXXXXX,0,10,0
38346,13,0,13,71,516,0,0,529,399,130,GXXXXXXXXXXXXXXXXXXXGXXXXXXXXXXXXXXXXXXXGXXXXXXXXXXXXXXXXXXXGXXXXXXXXXXXXXXXXXXXGXXXXXXXXXXXXXXXXXXXGXXXXXXXXXXXXXXXXXXXGXXXXXXXXXXXXXXXXXXXGXXXXXXXXXXXXXXXXXXXGXXXXXXXXXXXXXXXXXXXGXXXXXXXXXXXXXXXXXXXGXXXXXXXXXXXXXXXXXXXGXXXXXXXXXXXXXXXXXXXGXXXXXXXXXXXXXXXXXXX,0,10,0
38367,14,1,13,74,512,0,0,524,398,126,GXXXXXXXXXXXXXXXXXXXGXXXXXXXXXXXXXXXXXXXGXXXXXXXXXXXXXXXXXXXGXXXXXXXXXXXXXXXXXXXGXXXXXXXXXXXXXXXXXXXGXXXXXXXXXXXXXXXXXXXGAXXXXXXXXXXXXXXXXXXGXXXXXXXXXXXXXXXXXXXGXXXXXXXXXXXXXXXXXXXGXXXXXXXXXXXXXXXXXXXGXXXXXXXXXXXXXXXXXXXGXXXXXXXXXXXXXXXXXXXGXXXXXXXXXXXXXXXXXXX,0,10,0
38388,14,1,13,77,509,0,0,522,398,124,GXXXXXXXXXXXXXXXXXXXGXXXXXXXXXXXXXXXXXXXGXXXXXXXXXXXXXXXXXXXGXXXXXXXXXXXXXXXXXXXGXXXXXXXXXXXXXXXXXXXGXXXXXXXXXXXXXXXXXXXGAXXXXXXXXXXXXXXXXXXGXXXXXXXXXXXXXXXXXXXGXXXXXXXXXXXXXXXXXXXGXXXXXXXXXXXXXXXXXXXGXXXXXXXXXXXXXXXXXXXGXXXXXXXXXXXXXXXXXXXGXXXXXXXXXXXXXXXXXXX,0,10,0
38409,14,1,13,79,507,0,0,521,403,118,GXXXXXXXXXXXXXXXXXXXGXXXXXXXXXXXXXXXXXXXGXXXXXXXXXXXXXXXXXXXGXXXXXXXXXXXXXXXXXXXGXXXXXXXXXXXXXXXXXXXGXXXXXXXXXXXXXXXXXXXGAXXXXXXXXXXXXXXXXXXGXXXXXXXXXXXXXXXXXXXGXXXXXXXXXXXXXXXXXXXGXXXXXXXXXXXXXXXXXXXGXXXXXXXXXXXXXXXXXXXGXXXXXXXXXXXXXXXXXXXGXXXXXXXXXXXXXXXXXXX,0,10,0

38430,14,1,13,85,501,0,0,515,398,117,GXXXXXXXXXXXXXXXXXXXGXXXXXXXXXXXXXXXXXXXGXXXXXXXXXXXXXXXXXXXGXXXXXXXXXXXXXXXXXXXGXXXXXXXXXXXXXXXXXXXGXXXXXXXXXXXXXXXXXXXGAXXXXXXXXXXXXXXXXXXGXXXXXXXXXXXXXXXXXXXGXXXXXXXXXXXXXXXXXXXGXXXXXXXXXXXXXXXXXXXGXXXXXXXXXXXXXXXXXXXGXXXXXXXXXXXXXXXXXXXGXXXXXXXXXXXXXXXXXXX,0,10,0
38451,14,1,13,78,508,0,0,522,403,119,GXXXXXXXXXXXXXXXXXXXGXXXXXXXXXXXXXXXXXXXGXXXXXXXXXXXXXXXXXXXGXXXXXXXXXXXXXXXXXXXGXXXXXXXXXXXXXXXXXXXGXXXXXXXXXXXXXXXXXXXGAXXXXXXXXXXXXXXXXXXGXXXXXXXXXXXXXXXXXXXGXXXXXXXXXXXXXXXXXXXGXXXXXXXXXXXXXXXXXXXGXXXXXXXXXXXXXXXXXXXGXXXXXXXXXXXXXXXXXXXGXXXXXXXXXXXXXXXXXXX,0,10,0
38472,14,1,13,82,504,0,0,516,399,117,GXXXXXXXXXXXXXXXXXXXGXXXXXXXXXXXXXXXXXXXGXXXXXXXXXXXXXXXXXXXGXXXXXXXXXXXXXXXXXXXGXXXXXXXXXXXXXXXXXXXGXXXXXXXXXXXXXXXXXXXGAXXXXXXXXXXXXXXXXXXGXXXXXXXXXXXXXXXXXXXGXXXXXXXXXXXXXXXXXXXGXXXXXXXXXXXXXXXXXXXGXXXXXXXXXXXXXXXXXXXGXXXXXXXXXXXXXXXXXXXGXXXXXXXXXXXXXXXXXXX,0,10,0
38493,14,1,13,88,498,0,0,512,395,117,GXXXXXXXXXXXXXXXXXXXGXXXXXXXXXXXXXXXXXXXGXXXXXXXXXXXXXXXXXXXGXXXXXXXXXXXXXXXXXXXGXXXXXXXXXXXXXXXXXXXGXXXXXXXXXXXXXXXXXXXGAXXXXXXXXXXXXXXXXXXGXXXXXXXXXXXXXXXXXXXGXXXXXXXXXXXXXXXXXXXGXXXXXXXXXXXXXXXXXXXGXXXXXXXXXXXXXXXXXXXGXXXXXXXXXXXXXXXXXXXGXXXXXXXXXXXXXXXXXXX,0,10,0
38514,14,1,13,84,502,0,0,516,395,121,GXXXXXXXXXXXXXXXXXXXGXXXXXXXXXXXXXXXXXXXGXXXXXXXXXXXXXXXXXXXGXXXXXXXXXXXXXXXXXXXGXXXXXXXXXXXXXXXXXXXGXXXXXXXXXXXXXXXXXXXGAXXXXXXXXXXXXXXXXXXGXXXXXXXXXXXXXXXXXXXGXXXXXXXXXXXXXXXXXXXGXXXXXXXXXXXXXXXXXXXGXXXXXXXXXXXXXXXXXXXGXXXXXXXXXXXXXXXXXXXGXXXXXXXXXXXXXXXXXXX,0,10,0

38535,14,1,13,81,505,0,0,519,393,126,GXXXXXXXXXXXXXXXXXXXGXXXXXXXXXXXXXXXXXXXGXXXXXXXXXXXXXXXXXXXGXXXXXXXXXXXXXXXXXXXGXXXXXXXXXXXXXXXXXXXGXXXXXXXXXXXXXXXXXXXGAXXXXXXXXXXXXXXXXXXGXXXXXXXXXXXXXXXXXXXGXXXXXXXXXXXXXXXXXXXGXXXXXXXXXXXXXXXXXXXGXXXXXXXXXXXXXXXXXXXGXXXXXXXXXXXXXXXXXXXGXXXXXXXXXXXXXXXXXXX,0,10,0
38556,14,1,13,81,505,0,0,518,392,126,GXXXXXXXXXXXXXXXXXXXGXXXXXXXXXXXXXXXXXXXGXXXXXXXXXXXXXXXXXXXGXXXXXXXXXXXXXXXXXXXGXXXXXXXXXXXXXXXXXXXGXXXXXXXXXXXXXXXXXXXGAXXXXXXXXXXXXXXXXXXGXXXXXXXXXXXXXXXXXXXGXXXXXXXXXXXXXXXXXXXGXXXXXXXXXXXXXXXXXXXGXXXXXXXXXXXXXXXXXXXGXXXXXXXXXXXXXXXXXXXGXXXXXXXXXXXXXXXXXXX,0,10,0
38577,14,1,13,77,509,0,0,522,397,125,GXXXXXXXXXXXXXXXXXXXGXXXXXXXXXXXXXXXXXXXGXXXXXXXXXXXXXXXXXXXGXXXXXXXXXXXXXXXXXXXGXXXXXXXXXXXXXXXXXXXGXXXXXXXXXXXXXXXXXXXGAXXXXXXXXXXXXXXXXXXGXXXXXXXXXXXXXXXXXXXGXXXXXXXXXXXXXXXXXXXGXXXXXXXXXXXXXXXXXXXGXXXXXXXXXXXXXXXXXXXGXXXXXXXXXXXXXXXXXXXGXXXXXXXXXXXXXXXXXXX,0,10,0
38598,14,1,13,72,514,0,0,528,398,130,GXXXXXXXXXXXXXXXXXXXGXXXXXXXXXXXXXXXXXXXGXXXXXXXXXXXXXXXXXXXGXXXXXXXXXXXXXXXXXXXGXXXXXXXXXXXXXXXXXXXGXXXXXXXXXXXXXXXXXXXGAXXXXXXXXXXXXXXXXXXGXXXXXXXXXXXXXXXXXXXGXXXXXXXXXXXXXXXXXXXGXXXXXXXXXXXXXXXXXXXGXXXXXXXXXXXXXXXXXXXGXXXXXXXXXXXXXXXXXXXGXXXXXXXXXXXXXXXXXXX,0,10,0
38619,14,1,13,73,513,0,0,527,392,135,GXXXXXXXXXXXXXXXXXXXGXXXXXXXXXXXXXXXXXXXGXXXXXXXXXXXXXXXXXXXGXXXXXXXXXXXXXXXXXXXGXXXXXXXXXXXXXXXXXXXGXXXXXXXXXXXXXXXXXXXGAXXXXXXXXXXXXXXXXXXGXXXXXXXXXXXXXXXXXXXGXXXXXXXXXXXXXXXXXXXGXXXXXXXXXXXXXXXXXXXGXXXXXXXXXXXXXXXXXXXGXXXXXXXXXXXXXXXXXXXGXXXXXXXXXXXXXXXXXXX,0,10,0

38640,14,1,13,62,524,0,0,537,392,145,GXXXXXXXXXXXXXXXXXXXGXXXXXXXXXXXXXXXXXXXGXXXXXXXXXXXXXXXXXXXGXXXXXXXXXXXXXXXXXXXGXXXXXXXXXXXXXXXXXXXGXXXXXXXXXXXXXXXXXXXGAXXXXXXXXXXXXXXXXXXGXXXXXXXXXXXXXXXXXXXGXXXXXXXXXXXXXXXXXXXGXXXXXXXXXXXXXXXXXXXGXXXXXXXXXXXXXXXXXXXGXXXXXXXXXXXXXXXXXXXGXXXXXXXXXXXXXXXXXXX,0,10,0
38661,14,0,14,66,520,0,0,534,399,135,GXXXXXXXXXXXXXXXXXXXGXXXXXXXXXXXXXXXXXXXGXXXXXXXXXXXXXXXXXXXGXXXXXXXXXXXXXXXXXXXGXXXXXXXXXXXXXXXXXXXGXXXXXXXXXXXXXXXXXXXGOXXXXXXXXXXXXXXXXXXGXXXXXXXXXXXXXXXXXXXGXXXXXXXXXXXXXXXXXXXGXXXXXXXXXXXXXXXXXXXGXXXXXXXXXXXXXXXXXXXGXXXXXXXXXXXXXXXXXXXGXXXXXXXXXXXXXXXXXXX,0,10,0
38682,14,0,14,67,519,0,0,533,395,138,GXXXXXXXXXXXXXXXXXXXGXXXXXXXXXXXXXXXXXXXGXXXXXXXXXXXXXXXXXXXGXXXXXXXXXXXXXXXXXXXGXXXXXXXXXXXXXXXXXXXGXXXXXXXXXXXXXXXXXXXGOXXXXXXXXXXXXXXXXXXGXXXXXXXXXXXXXXXXXXXGXXXXXXXXXXXXXXXXXXXGXXXXXXXXXXXXXXXXXXXGXXXXXXXXXXXXXXXXXXXGXXXXXXXXXXXXXXXXXXXGXXXXXXXXXXXXXXXXXXX,0,10,0
38703,13,0,13,61,526,0,0,540,402,138,GXXXXXXXXXXXXXXXXXXXGXXXXXXXXXXXXXXXXXXXGXXXXXXXXXXXXXXXXXXXGXXXXXXXXXXXXXXXXXXXGXXXXXXXXXXXXXXXXXXXGXXXXXXXXXXXXXXXXXXXGXXXXXXXXXXXXXXXXXXXGXXXXXXXXXXXXXXXXXXXGXXXXXXXXXXXXXXXXXXXGXXXXXXXXXXXXXXXXXXXGXXXXXXXXXXXXXXXXXXXGXXXXXXXXXXXXXXXXXXXGXXXXXXXXXXXXXXXXXXX,0,10,0
38724,13,0,13,64,523,0,0,538,399,139,GXXXXXXXXXXXXXXXXXXXGXXXXXXXXXXXXXXXXXXXGXXXXXXXXXXXXXXXXXXXGXXXXXXXXXXXXXXXXXXXGXXXXXXXXXXXXXXXXXXXGXXXXXXXXXXXXXXXXXXXGXXXXXXXXXXXXXXXXXXXGXXXXXXXXXXXXXXXXXXXGXXXXXXXXXXXXXXXXXXXGXXXXXXXXXXXXXXXXXXXGXXXXXXXXXXXXXXXXXXXGXXXXXXXXXXXXXXXXXXXGXXXXXXXXXXXXXXXXXXX,0,10,0

38745,13,0,13,65,522,0,0,537,401,136,GXXXXXXXXXXXXXXXXXXXGXXXXXXXXXXXXXXXXXXXGXXXXXXXXXXXXXXXXXXXGXXXXXXXXXXXXXXXXXXXGXXXXXXXXXXXXXXXXXXXGXXXXXXXXXXXXXXXXXXXGXXXXXXXXXXXXXXXXXXXGXXXXXXXXXXXXXXXXXXXGXXXXXXXXXXXXXXXXXXXGXXXXXXXXXXXXXXXXXXXGXXXXXXXXXXXXXXXXXXXGXXXXXXXXXXXXXXXXXXXGXXXXXXXXXXXXXXXXXXX,0,10,0
38766,13,0,13,73,514,0,0,530,401,129,GXXXXXXXXXXXXXXXXXXXGXXXXXXXXXXXXXXXXXXXGXXXXXXXXXXXXXXXXXXXGXXXXXXXXXXXXXXXXXXXGXXXXXXXXXXXXXXXXXXXGXXXXXXXXXXXXXXXXXXXGXXXXXXXXXXXXXXXXXXXGXXXXXXXXXXXXXXXXXXXGXXXXXXXXXXXXXXXXXXXGXXXXXXXXXXXXXXXXXXXGXXXXXXXXXXXXXXXXXXXGXXXXXXXXXXXXXXXXXXXGXXXXXXXXXXXXXXXXXXX,0,10,0
38787,13,0,13,69,518,0,0,533,400,133,GXXXXXXXXXXXXXXXXXXXGXXXXXXXXXXXXXXXXXXXGXXXXXXXXXXXXXXXXXXXGXXXXXXXXXXXXXXXXXXXGXXXXXXXXXXXXXXXXXXXGXXXXXXXXXXXXXXXXXXXGXXXXXXXXXXXXXXXXXXXGXXXXXXXXXXXXXXXXXXXGXXXXXXXXXXXXXXXXXXXGXXXXXXXXXXXXXXXXXXXGXXXXXXXXXXXXXXXXXXXGXXXXXXXXXXXXXXXXXXXGXXXXXXXXXXXXXXXXXXX,0,10,0
38808,14,1,13,61,525,0,0,538,405,133,GXXXXXXXXXXXXXXXXXXXGXXXXXXXXXXXXXXXXXXXGXXXXXXXXXXXXXXXXXXXGXXXXXXXXXXXXXXXXXXXGXXXXXXXXXXXXXXXXXXXGXXXXXXXXXXXXXXXXXXXGAXXXXXXXXXXXXXXXXXXGXXXXXXXXXXXXXXXXXXXGXXXXXXXXXXXXXXXXXXXGXXXXXXXXXXXXXXXXXXXGXXXXXXXXXXXXXXXXXXXGXXXXXXXXXXXXXXXXXXXGXXXXXXXXXXXXXXXXXXX,0,10,0
38829,14,1,13,64,522,0,0,536,402,134,GXXXXXXXXXXXXXXXXXXXGXXXXXXXXXXXXXXXXXXXGXXXXXXXXXXXXXXXXXXXGXXXXXXXXXXXXXXXXXXXGXXXXXXXXXXXXXXXXXXXGXXXXXXXXXXXXXXXXXXXGAXXXXXXXXXXXXXXXXXXGXXXXXXXXXXXXXXXXXXXGXXXXXXXXXXXXXXXXXXXGXXXXXXXXXXXXXXXXXXXGXXXXXXXXXXXXXXXXXXXGXXXXXXXXXXXXXXXXXXXGXXXXXXXXXXXXXXXXXXX,0,10,0

38850,14,1,13,64,522,0,0,536,398,138,GXXXXXXXXXXXXXXXXXXXGXXXXXXXXXXXXXXXXXXXGXXXXXXXXXXXXXXXXXXXGXXXXXXXXXXXXXXXXXXXGXXXXXXXXXXXXXXXXXXXGXXXXXXXXXXXXXXXXXXXGAXXXXXXXXXXXXXXXXXXGXXXXXXXXXXXXXXXXXXXGXXXXXXXXXXXXXXXXXXXGXXXXXXXXXXXXXXXXXXXGXXXXXXXXXXXXXXXXXXXGXXXXXXXXXXXXXXXXXXXGXXXXXXXXXXXXXXXXXXX,0,10,0
38871,14,1,13,68,518,0,0,532,399,133,GXXXXXXXXXXXXXXXXXXXGXXXXXXXXXXXXXXXXXXXGXXXXXXXXXXXXXXXXXXXGXXXXXXXXXXXXXXXXXXXGXXXXXXXXXXXXXXXXXXXGXXXXXXXXXXXXXXXXXXXGAXXXXXXXXXXXXXXXXXXGXXXXXXXXXXXXXXXXXXXGXXXXXXXXXXXXXXXXXXXGXXXXXXXXXXXXXXXXXXXGXXXXXXXXXXXXXXXXXXXGXXXXXXXXXXXXXXXXXXXGXXXXXXXXXXXXXXXXXXX,0,10,0
38892,14,1,13,67,519,0,0,531,403,128,GXXXXXXXXXXXXXXXXXXXGXXXXXXXXXXXXXXXXXXXGXXXXXXXXXXXXXXXXXXXGXXXXXXXXXXXXXXXXXXXGXXXXXXXXXXXXXXXXXXXGXXXXXXXXXXXXXXXXXXXGAXXXXXXXXXXXXXXXXXXGXXXXXXXXXXXXXXXXXXXGXXXXXXXXXXXXXXXXXXXGXXXXXXXXXXXXXXXXXXXGXXXXXXXXXXXXXXXXXXXGXXXXXXXXXXXXXXXXXXXGXXXXXXXXXXXXXXXXXXX,0,10,0
38913,14,1,13,66,520,0,0,532,407,125,GXXXXXXXXXXXXXXXXXXXGXXXXXXXXXXXXXXXXXXXGXXXXXXXXXXXXXXXXXXXGXXXXXXXXXXXXXXXXXXXGXXXXXXXXXXXXXXXXXXXGXXXXXXXXXXXXXXXXXXXGAXXXXXXXXXXXXXXXXXXGXXXXXXXXXXXXXXXXXXXGXXXXXXXXXXXXXXXXXXXGXXXXXXXXXXXXXXXXXXXGXXXXXXXXXXXXXXXXXXXGXXXXXXXXXXXXXXXXXXXGXXXXXXXXXXXXXXXXXXX,0,10,0
38934,14,1,13,71,515,0,0,528,407,121,GXXXXXXXXXXXXXXXXXXXGXXXXXXXXXXXXXXXXXXXGXXXXXXXXXXXXXXXXXXXGXXXXXXXXXXXXXXXXXXXGXXXXXXXXXXXXXXXXXXXGXXXXXXXXXXXXXXXXXXXGAXXXXXXXXXXXXXXXXXXGXXXXXXXXXXXXXXXXXXXGXXXXXXXXXXXXXXXXXXXGXXXXXXXXXXXXXXXXXXXGXXXXXXXXXXXXXXXXXXXGXXXXXXXXXXXXXXXXXXXGXXXXXXXXXXXXXXXXXXX,0,10,0

38955,14,1,13,73,513,0,0,525,408,117,GXXXXXXXXXXXXXXXXXXXGXXXXXXXXXXXXXXXXXXXGXXXXXXXXXXXXXXXXXXXGXXXXXXXXXXXXXXXXXXXGXXXXXXXXXXXXXXXXXXXGXXXXXXXXXXXXXXXXXXXGAXXXXXXXXXXXXXXXXXXGXXXXXXXXXXXXXXXXXXXGXXXXXXXXXXXXXXXXXXXGXXXXXXXXXXXXXXXXXXXGXXXXXXXXXXXXXXXXXXXGXXXXXXXXXXXXXXXXXXXGXXXXXXXXXXXXXXXXXXX,0,10,0
38976,13,0,13,78,509,0,0,522,408,114,GXXXXXXXXXXXXXXXXXXXGXXXXXXXXXXXXXXXXXXXGXXXXXXXXXXXXXXXXXXXGXXXXXXXXXXXXXXXXXXXGXXXXXXXXXXXXXXXXXXXGXXXXXXXXXXXXXXXXXXXGXXXXXXXXXXXXXXXXXXXGXXXXXXXXXXXXXXXXXXXGXXXXXXXXXXXXXXXXXXXGXXXXXXXXXXXXXXXXXXXGXXXXXXXXXXXXXXXXXXXGXXXXXXXXXXXXXXXXXXXGXXXXXXXXXXXXXXXXXXX,0,10,0
38997,13,0,13,80,507,0,0,520,406,114,GXXXXXXXXXXXXXXXXXXXGXXXXXXXXXXXXXXXXXXXGXXXXXXXXXXXXXXXXXXXGXXXXXXXXXXXXXXXXXXXGXXXXXXXXXXXXXXXXXXXGXXXXXXXXXXXXXXXXXXXGXXXXXXXXXXXXXXXXXXXGXXXXXXXXXXXXXXXXXXXGXXXXXXXXXXXXXXXXXXXGXXXXXXXXXXXXXXXXXXXGXXXXXXXXXXXXXXXXXXXGXXXXXXXXXXXXXXXXXXXGXXXXXXXXXXXXXXXXXXX,0,10,0
39018,13,0,13,84,503,0,0,516,403,113,GXXXXXXXXXXXXXXXXXXXGXXXXXXXXXXXXXXXXXXXGXXXXXXXXXXXXXXXXXXXGXXXXXXXXXXXXXXXXXXXGXXXXXXXXXXXXXXXXXXXGXXXXXXXXXXXXXXXXXXXGXXXXXXXXXXXXXXXXXXXGXXXXXXXXXXXXXXXXXXXGXXXXXXXXXXXXXXXXXXXGXXXXXXXXXXXXXXXXXXXGXXXXXXXXXXXXXXXXXXXGXXXXXXXXXXXXXXXXXXXGXXXXXXXXXXXXXXXXXXX,0,10,0
39039,13,0,13,83,504,0,0,517,399,118,GXXXXXXXXXXXXXXXXXXXGXXXXXXXXXXXXXXXXXXXGXXXXXXXXXXXXXXXXXXXGXXXXXXXXXXXXXXXXXXXGXXXXXXXXXXXXXXXXXXXGXXXXXXXXXXXXXXXXXXXGXXXXXXXXXXXXXXXXXXXGXXXXXXXXXXXXXXXXXXXGXXXXXXXXXXXXXXXXXXXGXXXXXXXXXXXXXXXXXXXGXXXXXXXXXXXXXXXXXXXGXXXXXXXXXXXXXXXXXXXGXXXXXXXXXXXXXXXXXXX,0,10,0

39060,13,0,13,77,510,0,0,524,404,120,GXXXXXXXXXXXXXXXXXXXGXXXXXXXXXXXXXXXXXXXGXXXXXXXXXXXXXXXXXXXGXXXXXXXXXXXXXXXXXXXGXXXXXXXXXXXXXXXXXXXGXXXXXXXXXXXXXXXXXXXGXXXXXXXXXXXXXXXXXXXGXXXXXXXXXXXXXXXXXXXGXXXXXXXXXXXXXXXXXXXGXXXXXXXXXXXXXXXXXXXGXXXXXXXXXXXXXXXXXXXGXXXXXXXXXXXXXXXXXXXGXXXXXXXXXXXXXXXXXXX,0,10,0
39081,13,0,13,74,513,0,0,524,411,113,GXXXXXXXXXXXXXXXXXXXGXXXXXXXXXXXXXXXXXXXGXXXXXXXXXXXXXXXXXXXGXXXXXXXXXXXXXXXXXXXGXXXXXXXXXXXXXXXXXXXGXXXXXXXXXXXXXXXXXXXGXXXXXXXXXXXXXXXXXXXGXXXXXXXXXXXXXXXXXXXGXXXXXXXXXXXXXXXXXXXGXXXXXXXXXXXXXXXXXXXGXXXXXXXXXXXXXXXXXXXGXXXXXXXXXXXXXXXXXXXGXXXXXXXXXXXXXXXXXXX,0,10,0
39102,13,0,13,77,510,0,0,523,403,120,GXXXXXXXXXXXXXXXXXXXGXXXXXXXXXXXXXXXXXXXGXXXXXXXXXXXXXXXXXXXGXXXXXXXXXXXXXXXXXXXGXXXXXXXXXXXXXXXXXXXGXXXXXXXXXXXXXXXXXXXGXXXXXXXXXXXXXXXXXXXGXXXXXXXXXXXXXXXXXXXGXXXXXXXXXXXXXXXXXXXGXXXXXXXXXXXXXXXXXXXGXXXXXXXXXXXXXXXXXXXGXXXXXXXXXXXXXXXXXXXGXXXXXXXXXXXXXXXXXXX,0,10,0
39123,13,0,13,76,511,0,0,523,400,123,GXXXXXXXXXXXXXXXXXXXGXXXXXXXXXXXXXXXXXXXGXXXXXXXXXXXXXXXXXXXGXXXXXXXXXXXXXXXXXXXGXXXXXXXXXXXXXXXXXXXGXXXXXXXXXXXXXXXXXXXGXXXXXXXXXXXXXXXXXXXGXXXXXXXXXXXXXXXXXXXGXXXXXXXXXXXXXXXXXXXGXXXXXXXXXXXXXXXXXXXGXXXXXXXXXXXXXXXXXXXGXXXXXXXXXXXXXXXXXXXGXXXXXXXXXXXXXXXXXXX,0,10,0
39144,13,0,13,69,518,0,0,530,402,128,GXXXXXXXXXXXXXXXXXXXGXXXXXXXXXXXXXXXXXXXGXXXXXXXXXXXXXXXXXXXGXXXXXXXXXXXXXXXXXXXGXXXXXXXXXXXXXXXXXXXGXXXXXXXXXXXXXXXXXXXGXXXXXXXXXXXXXXXXXXXGXXXXXXXXXXXXXXXXXXXGXXXXXXXXXXXXXXXXXXXGXXXXXXXXXXXXXXXXXXXGXXXXXXXXXXXXXXXXXXXGXXXXXXXXXXXXXXXXXXXGXXXXXXXXXXXXXXXXXXX,0,10,0

39165,13,0,13,69,518,0,0,531,403,128,GXXXXXXXXXXXXXXXXXXXGXXXXXXXXXXXXXXXXXXXGXXXXXXXXXXXXXXXXXXXGXXXXXXXXXXXXXXXXXXXGXXXXXXXXXXXXXXXXXXXGXXXXXXXXXXXXXXXXXXXGXXXXXXXXXXXXXXXXXXXGXXXXXXXXXXXXXXXXXXXGXXXXXXXXXXXXXXXXXXXGXXXXXXXXXXXXXXXXXXXGXXXXXXXXXXXXXXXXXXXGXXXXXXXXXXXXXXXXXXXGXXXXXXXXXXXXXXXXXXX,0,10,0
39186,13,0,13,65,522,0,0,535,402,133,GXXXXXXXXXXXXXXXXXXXGXXXXXXXXXXXXXXXXXXXGXXXXXXXXXXXXXXXXXXXGXXXXXXXXXXXXXXXXXXXGXXXXXXXXXXXXXXXXXXXGXXXXXXXXXXXXXXXXXXXGXXXXXXXXXXXXXXXXXXXGXXXXXXXXXXXXXXXXXXXGXXXXXXXXXXXXXXXXXXXGXXXXXXXXXXXXXXXXXXXGXXXXXXXXXXXXXXXXXXXGXXXXXXXXXXXXXXXXXXXGXXXXXXXXXXXXXXXXXXX,0,10,0
39207,13,0,13,61,526,0,0,539,403,136,GXXXXXXXXXXXXXXXXXXXGXXXXXXXXXXXXXXXXXXXGXXXXXXXXXXXXXXXXXXXGXXXXXXXXXXXXXXXXXXXGXXXXXXXXXXXXXXXXXXXGXXXXXXXXXXXXXXXXXXXGXXXXXXXXXXXXXXXXXXXGXXXXXXXXXXXXXXXXXXXGXXXXXXXXXXXXXXXXXXXGXXXXXXXXXXXXXXXXXXXGXXXXXXXXXXXXXXXXXXXGXXXXXXXXXXXXXXXXXXXGXXXXXXXXXXXXXXXXXXX,0,10,0
39228,13,0,13,60,527,0,0,539,406,133,GXXXXXXXXXXXXXXXXXXXGXXXXXXXXXXXXXXXXXXXGXXXXXXXXXXXXXXXXXXXGXXXXXXXXXXXXXXXXXXXGXXXXXXXXXXXXXXXXXXXGXXXXXXXXXXXXXXXXXXXGXXXXXXXXXXXXXXXXXXXGXXXXXXXXXXXXXXXXXXXGXXXXXXXXXXXXXXXXXXXGXXXXXXXXXXXXXXXXXXXGXXXXXXXXXXXXXXXXXXXGXXXXXXXXXXXXXXXXXXXGXXXXXXXXXXXXXXXXXXX,0,10,0
39249,14,1,13,57,529,0,0,542,410,132,GXXXXXXXXXXXXXXXXXXXGXXXXXXXXXXXXXXXXXXXGAXXXXXXXXXXXXXXXXXXGXXXXXXXXXXXXXXXXXXXGXXXXXXXXXXXXXXXXXXXGXXXXXXXXXXXXXXXXXXXGXXXXXXXXXXXXXXXXXXXGXXXXXXXXXXXXXXXXXXXGXXXXXXXXXXXXXXXXXXXGXXXXXXXXXXXXXXXXXXXGXXXXXXXXXXXXXXXXXXXGXXXXXXXXXXXXXXXXXXXGXXXXXXXXXXXXXXXXXXX,0,10,0

39270,14,1,13,58,528,0,0,540,409,131,GXXXXXXXXXXXXXXXXXXXGXXXXXXXXXXXXXXXXXXXGAXXXXXXXXXXXXXXXXXXGXXXXXXXXXXXXXXXXXXXGXXXXXXXXXXXXXXXXXXXGXXXXXXXXXXXXXXXXXXXGXXXXXXXXXXXXXXXXXXXGXXXXXXXXXXXXXXXXXXXGXXXXXXXXXXXXXXXXXXXGXXXXXXXXXXXXXXXXXXXGXXXXXXXXXXXXXXXXXXXGXXXXXXXXXXXXXXXXXXXGXXXXXXXXXXXXXXXXXXX,0,10,0
39291,14,1,13,60,526,0,0,539,408,131,GXXXXXXXXXXXXXXXXXXXGXXXXXXXXXXXXXXXXXXXGAXXXXXXXXXXXXXXXXXXGXXXXXXXXXXXXXXXXXXXGXXXXXXXXXXXXXXXXXXXGXXXXXXXXXXXXXXXXXXXGXXXXXXXXXXXXXXXXXXXGXXXXXXXXXXXXXXXXXXXGXXXXXXXXXXXXXXXXXXXGXXXXXXXXXXXXXXXXXXXGXXXXXXXXXXXXXXXXXXXGXXXXXXXXXXXXXXXXXXXGXXXXXXXXXXXXXXXXXXX,0,10,0
39312,14,1,13,61,525,0,0,538,411,127,GXXXXXXXXXXXXXXXXXXXGXXXXXXXXXXXXXXXXXXXGAXXXXXXXXXXXXXXXXXXGXXXXXXXXXXXXXXXXXXXGXXXXXXXXXXXXXXXXXXXGXXXXXXXXXXXXXXXXXXXGXXXXXXXXXXXXXXXXXXXGXXXXXXXXXXXXXXXXXXXGXXXXXXXXXXXXXXXXXXXGXXXXXXXXXXXXXXXXXXXGXXXXXXXXXXXXXXXXXXXGXXXXXXXXXXXXXXXXXXXGXXXXXXXXXXXXXXXXXXX,0,10,0
39333,14,0,14,63,523,0,0,536,404,132,GXXXXXXXXXXXXXXXXXXXGXXXXXXXXXXXXXXXXXXXGOXXXXXXXXXXXXXXXXXXGXXXXXXXXXXXXXXXXXXXGXXXXXXXXXXXXXXXXXXXGXXXXXXXXXXXXXXXXXXXGXXXXXXXXXXXXXXXXXXXGXXXXXXXXXXXXXXXXXXXGXXXXXXXXXXXXXXXXXXXGXXXXXXXXXXXXXXXXXXXGXXXXXXXXXXXXXXXXXXXGXXXXXXXXXXXXXXXXXXXGXXXXXXXXXXXXXXXXXXX,0,10,0
39354,13,0,13,67,520,0,0,532,404,128,GXXXXXXXXXXXXXXXXXXXGXXXXXXXXXXXXXXXXXXXGXXXXXXXXXXXXXXXXXXXGXXXXXXXXXXXXXXXXXXXGXXXXXXXXXXXXXXXXXXXGXXXXXXXXXXXXXXXXXXXGXXXXXXXXXXXXXXXXXXXGXXXXXXXXXXXXXXXXXXXGXXXXXXXXXXXXXXXXXXXGXXXXXXXXXXXXXXXXXXXGXXXXXXXXXXXXXXXXXXXGXXXXXXXXXXXXXXXXXXXGXXXXXXXXXXXXXXXXXXX,0,10,0

39375,13,0,13,71,516,0,0,529,404,125,GXXXXXXXXXXXXXXXXXXXGXXXXXXXXXXXXXXXXXXXGXXXXXXXXXXXXXXXXXXXGXXXXXXXXXXXXXXXXXXXGXXXXXXXXXXXXXXXXXXXGXXXXXXXXXXXXXXXXXXXGXXXXXXXXXXXXXXXXXXXGXXXXXXXXXXXXXXXXXXXGXXXXXXXXXXXXXXXXXXXGXXXXXXXXXXXXXXXXXXXGXXXXXXXXXXXXXXXXXXXGXXXXXXXXXXXXXXXXXXXGXXXXXXXXXXXXXXXXXXX,0,10,0
39396,13,0,13,69,518,0,0,531,407,124,GXXXXXXXXXXXXXXXXXXXGXXXXXXXXXXXXXXXXXXXGXXXXXXXXXXXXXXXXXXXGXXXXXXXXXXXXXXXXXXXGXXXXXXXXXXXXXXXXXXXGXXXXXXXXXXXXXXXXXXXGXXXXXXXXXXXXXXXXXXXGXXXXXXXXXXXXXXXXXXXGXXXXXXXXXXXXXXXXXXXGXXXXXXXXXXXXXXXXXXXGXXXXXXXXXXXXXXXXXXXGXXXXXXXXXXXXXXXXXXXGXXXXXXXXXXXXXXXXXXX,0,10,0
39417,13,0,13,65,522,0,0,535,408,127,GXXXXXXXXXXXXXXXXXXXGXXXXXXXXXXXXXXXXXXXGXXXXXXXXXXXXXXXXXXXGXXXXXXXXXXXXXXXXXXXGXXXXXXXXXXXXXXXXXXXGXXXXXXXXXXXXXXXXXXXGXXXXXXXXXXXXXXXXXXXGXXXXXXXXXXXXXXXXXXXGXXXXXXXXXXXXXXXXXXXGXXXXXXXXXXXXXXXXXXXGXXXXXXXXXXXXXXXXXXXGXXXXXXXXXXXXXXXXXXXGXXXXXXXXXXXXXXXXXXX,0,10,0
39438,13,0,13,68,519,0,0,532,406,126,GXXXXXXXXXXXXXXXXXXXGXXXXXXXXXXXXXXXXXXXGXXXXXXXXXXXXXXXXXXXGXXXXXXXXXXXXXXXXXXXGXXXXXXXXXXXXXXXXXXXGXXXXXXXXXXXXXXXXXXXGXXXXXXXXXXXXXXXXXXXGXXXXXXXXXXXXXXXXXXXGXXXXXXXXXXXXXXXXXXXGXXXXXXXXXXXXXXXXXXXGXXXXXXXXXXXXXXXXXXXGXXXXXXXXXXXXXXXXXXXGXXXXXXXXXXXXXXXXXXX,0,10,0
39459,13,0,13,71,516,0,0,528,405,123,GXXXXXXXXXXXXXXXXXXXGXXXXXXXXXXXXXXXXXXXGXXXXXXXXXXXXXXXXXXXGXXXXXXXXXXXXXXXXXXXGXXXXXXXXXXXXXXXXXXXGXXXXXXXXXXXXXXXXXXXGXXXXXXXXXXXXXXXXXXXGXXXXXXXXXXXXXXXXXXXGXXXXXXXXXXXXXXXXXXXGXXXXXXXXXXXXXXXXXXXGXXXXXXXXXXXXXXXXXXXGXXXXXXXXXXXXXXXXXXXGXXXXXXXXXXXXXXXXXXX,0,10,0

39480,13,0,13,70,517,0,0,529,411,118,GXXXXXXXXXXXXXXXXXXXGXXXXXXXXXXXXXXXXXXXGXXXXXXXXXXXXXXXXXXXGXXXXXXXXXXXXXXXXXXXGXXXXXXXXXXXXXXXXXXXGXXXXXXXXXXXXXXXXXXXGXXXXXXXXXXXXXXXXXXXGXXXXXXXXXXXXXXXXXXXGXXXXXXXXXXXXXXXXXXXGXXXXXXXXXXXXXXXXXXXGXXXXXXXXXXXXXXXXXXXGXXXXXXXXXXXXXXXXXXXGXXXXXXXXXXXXXXXXXXX,0,10,0
39501,13,0,13,71,516,0,0,529,405,124,GXXXXXXXXXXXXXXXXXXXGXXXXXXXXXXXXXXXXXXXGXXXXXXXXXXXXXXXXXXXGXXXXXXXXXXXXXXXXXXXGXXXXXXXXXXXXXXXXXXXGXXXXXXXXXXXXXXXXXXXGXXXXXXXXXXXXXXXXXXXGXXXXXXXXXXXXXXXXXXXGXXXXXXXXXXXXXXXXXXXGXXXXXXXXXXXXXXXXXXXGXXXXXXXXXXXXXXXXXXXGXXXXXXXXXXXXXXXXXXXGXXXXXXXXXXXXXXXXXXX,0,10,0
39522,13,0,13,72,515,0,0,528,402,126,GXXXXXXXXXXXXXXXXXXXGXXXXXXXXXXXXXXXXXXXGXXXXXXXXXXXXXXXXXXXGXXXXXXXXXXXXXXXXXXXGXXXXXXXXXXXXXXXXXXXGXXXXXXXXXXXXXXXXXXXGXXXXXXXXXXXXXXXXXXXGXXXXXXXXXXXXXXXXXXXGXXXXXXXXXXXXXXXXXXXGXXXXXXXXXXXXXXXXXXXGXXXXXXXXXXXXXXXXXXXGXXXXXXXXXXXXXXXXXXXGXXXXXXXXXXXXXXXXXXX,0,10,0
39543,13,0,13,67,520,0,0,534,406,128,GXXXXXXXXXXXXXXXXXXXGXXXXXXXXXXXXXXXXXXXGXXXXXXXXXXXXXXXXXXXGXXXXXXXXXXXXXXXXXXXGXXXXXXXXXXXXXXXXXXXGXXXXXXXXXXXXXXXXXXXGXXXXXXXXXXXXXXXXXXXGXXXXXXXXXXXXXXXXXXXGXXXXXXXXXXXXXXXXXXXGXXXXXXXXXXXXXXXXXXXGXXXXXXXXXXXXXXXXXXXGXXXXXXXXXXXXXXXXXXXGXXXXXXXXXXXXXXXXXXX,0,10,0
39564,13,0,13,68,519,0,0,533,407,126,GXXXXXXXXXXXXXXXXXXXGXXXXXXXXXXXXXXXXXXXGXXXXXXXXXXXXXXXXXXXGXXXXXXXXXXXXXXXXXXXGXXXXXXXXXXXXXXXXXXXGXXXXXXXXXXXXXXXXXXXGXXXXXXXXXXXXXXXXXXXGXXXXXXXXXXXXXXXXXXXGXXXXXXXXXXXXXXXXXXXGXXXXXXXXXXXXXXXXXXXGXXXXXXXXXXXXXXXXXXXGXXXXXXXXXXXXXXXXXXXGXXXXXXXXXXXXXXXXXXX,0,10,0

39585,13,0,13,67,520,0,0,534,410,124,GXXXXXXXXXXXXXXXXXXXGXXXXXXXXXXXXXXXXXXXGXXXXXXXXXXXXXXXXXXXGXXXXXXXXXXXXXXXXXXXGXXXXXXXXXXXXXXXXXXXGXXXXXXXXXXXXXXXXXXXGXXXXXXXXXXXXXXXXXXXGXXXXXXXXXXXXXXXXXXXGXXXXXXXXXXXXXXXXXXXGXXXXXXXXXXXXXXXXXXXGXXXXXXXXXXXXXXXXXXXGXXXXXXXXXXXXXXXXXXXGXXXXXXXXXXXXXXXXXXX,0,10,0
39606,13,0,13,68,519,0,0,532,411,121,GXXXXXXXXXXXXXXXXXXXGXXXXXXXXXXXXXXXXXXXGXXXXXXXXXXXXXXXXXXXGXXXXXXXXXXXXXXXXXXXGXXXXXXXXXXXXXXXXXXXGXXXXXXXXXXXXXXXXXXXGXXXXXXXXXXXXXXXXXXXGXXXXXXXXXXXXXXXXXXXGXXXXXXXXXXXXXXXXXXXGXXXXXXXXXXXXXXXXXXXGXXXXXXXXXXXXXXXXXXXGXXXXXXXXXXXXXXXXXXXGXXXXXXXXXXXXXXXXXXX,0,10,0
39627,13,0,13,70,517,0,0,531,409,122,GXXXXXXXXXXXXXXXXXXXGXXXXXXXXXXXXXXXXXXXGXXXXXXXXXXXXXXXXXXXGXXXXXXXXXXXXXXXXXXXGXXXXXXXXXXXXXXXXXXXGXXXXXXXXXXXXXXXXXXXGXXXXXXXXXXXXXXXXXXXGXXXXXXXXXXXXXXXXXXXGXXXXXXXXXXXXXXXXXXXGXXXXXXXXXXXXXXXXXXXGXXXXXXXXXXXXXXXXXXXGXXXXXXXXXXXXXXXXXXXGXXXXXXXXXXXXXXXXXXX,0,10,0
39648,13,0,13,74,513,0,0,526,405,121,GXXXXXXXXXXXXXXXXXXXGXXXXXXXXXXXXXXXXXXXGXXXXXXXXXXXXXXXXXXXGXXXXXXXXXXXXXXXXXXXGXXXXXXXXXXXXXXXXXXXGXXXXXXXXXXXXXXXXXXXGXXXXXXXXXXXXXXXXXXXGXXXXXXXXXXXXXXXXXXXGXXXXXXXXXXXXXXXXXXXGXXXXXXXXXXXXXXXXXXXGXXXXXXXXXXXXXXXXXXXGXXXXXXXXXXXXXXXXXXXGXXXXXXXXXXXXXXXXXXX,0,10,0
39669,13,0,13,70,517,0,0,531,408,123,GXXXXXXXXXXXXXXXXXXXGXXXXXXXXXXXXXXXXXXXGXXXXXXXXXXXXXXXXXXXGXXXXXXXXXXXXXXXXXXXGXXXXXXXXXXXXXXXXXXXGXXXXXXXXXXXXXXXXXXXGXXXXXXXXXXXXXXXXXXXGXXXXXXXXXXXXXXXXXXXGXXXXXXXXXXXXXXXXXXXGXXXXXXXXXXXXXXXXXXXGXXXXXXXXXXXXXXXXXXXGXXXXXXXXXXXXXXXXXXXGXXXXXXXXXXXXXXXXXXX,0,10,0

39690,13,0,13,69,518,0,0,533,408,125,GXXXXXXXXXXXXXXXXXXXGXXXXXXXXXXXXXXXXXXXGXXXXXXXXXXXXXXXXXXXGXXXXXXXXXXXXXXXXXXXGXXXXXXXXXXXXXXXXXXXGXXXXXXXXXXXXXXXXXXXGXXXXXXXXXXXXXXXXXXXGXXXXXXXXXXXXXXXXXXXGXXXXXXXXXXXXXXXXXXXGXXXXXXXXXXXXXXXXXXXGXXXXXXXXXXXXXXXXXXXGXXXXXXXXXXXXXXXXXXXGXXXXXXXXXXXXXXXXXXX,0,10,0
39711,13,0,13,73,514,0,0,529,410,119,GXXXXXXXXXXXXXXXXXXXGXXXXXXXXXXXXXXXXXXXGXXXXXXXXXXXXXXXXXXXGXXXXXXXXXXXXXXXXXXXGXXXXXXXXXXXXXXXXXXXGXXXXXXXXXXXXXXXXXXXGXXXXXXXXXXXXXXXXXXXGXXXXXXXXXXXXXXXXXXXGXXXXXXXXXXXXXXXXXXXGXXXXXXXXXXXXXXXXXXXGXXXXXXXXXXXXXXXXXXXGXXXXXXXXXXXXXXXXXXXGXXXXXXXXXXXXXXXXXXX,0,10,0
39732,13,0,13,75,512,0,0,528,409,119,GXXXXXXXXXXXXXXXXXXXGXXXXXXXXXXXXXXXXXXXGXXXXXXXXXXXXXXXXXXXGXXXXXXXXXXXXXXXXXXXGXXXXXXXXXXXXXXXXXXXGXXXXXXXXXXXXXXXXXXXGXXXXXXXXXXXXXXXXXXXGXXXXXXXXXXXXXXXXXXXGXXXXXXXXXXXXXXXXXXXGXXXXXXXXXXXXXXXXXXXGXXXXXXXXXXXXXXXXXXXGXXXXXXXXXXXXXXXXXXXGXXXXXXXXXXXXXXXXXXX,0,10,0
39753,13,0,13,73,514,0,0,530,408,122,GXXXXXXXXXXXXXXXXXXXGXXXXXXXXXXXXXXXXXXXGXXXXXXXXXXXXXXXXXXXGXXXXXXXXXXXXXXXXXXXGXXXXXXXXXXXXXXXXXXXGXXXXXXXXXXXXXXXXXXXGXXXXXXXXXXXXXXXXXXXGXXXXXXXXXXXXXXXXXXXGXXXXXXXXXXXXXXXXXXXGXXXXXXXXXXXXXXXXXXXGXXXXXXXXXXXXXXXXXXXGXXXXXXXXXXXXXXXXXXXGXXXXXXXXXXXXXXXXXXX,0,10,0
39774,13,0,13,80,507,0,0,523,410,113,GXXXXXXXXXXXXXXXXXXXGXXXXXXXXXXXXXXXXXXXGXXXXXXXXXXXXXXXXXXXGXXXXXXXXXXXXXXXXXXXGXXXXXXXXXXXXXXXXXXXGXXXXXXXXXXXXXXXXXXXGXXXXXXXXXXXXXXXXXXXGXXXXXXXXXXXXXXXXXXXGXXXXXXXXXXXXXXXXXXXGXXXXXXXXXXXXXXXXXXXGXXXXXXXXXXXXXXXXXXXGXXXXXXXXXXXXXXXXXXXGXXXXXXXXXXXXXXXXXXX,0,10,0

39795,13,0,13,80,507,0,0,523,407,116,GXXXXXXXXXXXXXXXXXXXGXXXXXXXXXXXXXXXXXXXGXXXXXXXXXXXXXXXXXXXGXXXXXXXXXXXXXXXXXXXGXXXXXXXXXXXXXXXXXXXGXXXXXXXXXXXXXXXXXXXGXXXXXXXXXXXXXXXXXXXGXXXXXXXXXXXXXXXXXXXGXXXXXXXXXXXXXXXXXXXGXXXXXXXXXXXXXXXXXXXGXXXXXXXXXXXXXXXXXXXGXXXXXXXXXXXXXXXXXXXGXXXXXXXXXXXXXXXXXXX,0,10,0
39816,13,0,13,78,509,0,0,524,408,116,GXXXXXXXXXXXXXXXXXXXGXXXXXXXXXXXXXXXXXXXGXXXXXXXXXXXXXXXXXXXGXXXXXXXXXXXXXXXXXXXGXXXXXXXXXXXXXXXXXXXGXXXXXXXXXXXXXXXXXXXGXXXXXXXXXXXXXXXXXXXGXXXXXXXXXXXXXXXXXXXGXXXXXXXXXXXXXXXXXXXGXXXXXXXXXXXXXXXXXXXGXXXXXXXXXXXXXXXXXXXGXXXXXXXXXXXXXXXXXXXGXXXXXXXXXXXXXXXXXXX,0,10,0
39837,13,0,13,78,509,0,0,524,408,116,GXXXXXXXXXXXXXXXXXXXGXXXXXXXXXXXXXXXXXXXGXXXXXXXXXXXXXXXXXXXGXXXXXXXXXXXXXXXXXXXGXXXXXXXXXXXXXXXXXXXGXXXXXXXXXXXXXXXXXXXGXXXXXXXXXXXXXXXXXXXGXXXXXXXXXXXXXXXXXXXGXXXXXXXXXXXXXXXXXXXGXXXXXXXXXXXXXXXXXXXGXXXXXXXXXXXXXXXXXXXGXXXXXXXXXXXXXXXXXXXGXXXXXXXXXXXXXXXXXXX,0,10,0
39858,13,0,13,76,511,0,0,526,408,118,GXXXXXXXXXXXXXXXXXXXGXXXXXXXXXXXXXXXXXXXGXXXXXXXXXXXXXXXXXXXGXXXXXXXXXXXXXXXXXXXGXXXXXXXXXXXXXXXXXXXGXXXXXXXXXXXXXXXXXXXGXXXXXXXXXXXXXXXXXXXGXXXXXXXXXXXXXXXXXXXGXXXXXXXXXXXXXXXXXXXGXXXXXXXXXXXXXXXXXXXGXXXXXXXXXXXXXXXXXXXGXXXXXXXXXXXXXXXXXXXGXXXXXXXXXXXXXXXXXXX,0,10,0
39879,13,0,13,70,517,0,0,532,408,124,GXXXXXXXXXXXXXXXXXXXGXXXXXXXXXXXXXXXXXXXGXXXXXXXXXXXXXXXXXXXGXXXXXXXXXXXXXXXXXXXGXXXXXXXXXXXXXXXXXXXGXXXXXXXXXXXXXXXXXXXGXXXXXXXXXXXXXXXXXXXGXXXXXXXXXXXXXXXXXXXGXXXXXXXXXXXXXXXXXXXGXXXXXXXXXXXXXXXXXXXGXXXXXXXXXXXXXXXXXXXGXXXXXXXXXXXXXXXXXXXGXXXXXXXXXXXXXXXXXXX,0,10,0

39900,13,0,13,63,524,0,0,537,408,129,GXXXXXXXXXXXXXXXXXXXGXXXXXXXXXXXXXXXXXXXGXXXXXXXXXXXXXXXXXXXGXXXXXXXXXXXXXXXXXXXGXXXXXXXXXXXXXXXXXXXGXXXXXXXXXXXXXXXXXXXGXXXXXXXXXXXXXXXXXXXGXXXXXXXXXXXXXXXXXXXGXXXXXXXXXXXXXXXXXXXGXXXXXXXXXXXXXXXXXXXGXXXXXXXXXXXXXXXXXXXGXXXXXXXXXXXXXXXXXXXGXXXXXXXXXXXXXXXXXXX,0,10,0
39921,13,0,13,55,532,0,0,547,410,137,GXXXXXXXXXXXXXXXXXXXGXXXXXXXXXXXXXXXXXXXGXXXXXXXXXXXXXXXXXXXGXXXXXXXXXXXXXXXXXXXGXXXXXXXXXXXXXXXXXXXGXXXXXXXXXXXXXXXXXXXGXXXXXXXXXXXXXXXXXXXGXXXXXXXXXXXXXXXXXXXGXXXXXXXXXXXXXXXXXXXGXXXXXXXXXXXXXXXXXXXGXXXXXXXXXXXXXXXXXXXGXXXXXXXXXXXXXXXXXXXGXXXXXXXXXXXXXXXXXXX,0,10,0
39942,13,0,13,55,532,0,0,545,409,136,GXXXXXXXXXXXXXXXXXXXGXXXXXXXXXXXXXXXXXXXGXXXXXXXXXXXXXXXXXXXGXXXXXXXXXXXXXXXXXXXGXXXXXXXXXXXXXXXXXXXGXXXXXXXXXXXXXXXXXXXGXXXXXXXXXXXXXXXXXXXGXXXXXXXXXXXXXXXXXXXGXXXXXXXXXXXXXXXXXXXGXXXXXXXXXXXXXXXXXXXGXXXXXXXXXXXXXXXXXXXGXXXXXXXXXXXXXXXXXXXGXXXXXXXXXXXXXXXXXXX,0,10,0
39963,13,0,13,55,532,0,0,546,414,132,GXXXXXXXXXXXXXXXXXXXGXXXXXXXXXXXXXXXXXXXGXXXXXXXXXXXXXXXXXXXGXXXXXXXXXXXXXXXXXXXGXXXXXXXXXXXXXXXXXXXGXXXXXXXXXXXXXXXXXXXGXXXXXXXXXXXXXXXXXXXGXXXXXXXXXXXXXXXXXXXGXXXXXXXXXXXXXXXXXXXGXXXXXXXXXXXXXXXXXXXGXXXXXXXXXXXXXXXXXXXGXXXXXXXXXXXXXXXXXXXGXXXXXXXXXXXXXXXXXXX,0,10,0
39984,13,0,13,59,528,0,0,541,409,132,GXXXXXXXXXXXXXXXXXXXGXXXXXXXXXXXXXXXXXXXGXXXXXXXXXXXXXXXXXXXGXXXXXXXXXXXXXXXXXXXGXXXXXXXXXXXXXXXXXXXGXXXXXXXXXXXXXXXXXXXGXXXXXXXXXXXXXXXXXXXGXXXXXXXXXXXXXXXXXXXGXXXXXXXXXXXXXXXXXXXGXXXXXXXXXXXXXXXXXXXGXXXXXXXXXXXXXXXXXXXGXXXXXXXXXXXXXXXXXXXGXXXXXXXXXXXXXXXXXXX,0,10,0

40005,13,0,13,59,528,0,0,541,412,129,GXXXXXXXXXXXXXXXXXXXGXXXXXXXXXXXXXXXXXXXGXXXXXXXXXXXXXXXXXXXGXXXXXXXXXXXXXXXXXXXGXXXXXXXXXXXXXXXXXXXGXXXXXXXXXXXXXXXXXXXGXXXXXXXXXXXXXXXXXXXGXXXXXXXXXXXXXXXXXXXGXXXXXXXXXXXXXXXXXXXGXXXXXXXXXXXXXXXXXXXGXXXXXXXXXXXXXXXXXXXGXXXXXXXXXXXXXXXXXXXGXXXXXXXXXXXXXXXXXXX,0,10,0
40026,13,0,13,66,521,0,0,533,407,126,GXXXXXXXXXXXXXXXXXXXGXXXXXXXXXXXXXXXXXXXGXXXXXXXXXXXXXXXXXXXGXXXXXXXXXXXXXXXXXXXGXXXXXXXXXXXXXXXXXXXGXXXXXXXXXXXXXXXXXXXGXXXXXXXXXXXXXXXXXXXGXXXXXXXXXXXXXXXXXXXGXXXXXXXXXXXXXXXXXXXGXXXXXXXXXXXXXXXXXXXGXXXXXXXXXXXXXXXXXXXGXXXXXXXXXXXXXXXXXXXGXXXXXXXXXXXXXXXXXXX,0,10,0
40047,13,0,13,70,517,0,0,531,406,125,GXXXXXXXXXXXXXXXXXXXGXXXXXXXXXXXXXXXXXXXGXXXXXXXXXXXXXXXXXXXGXXXXXXXXXXXXXXXXXXXGXXXXXXXXXXXXXXXXXXXGXXXXXXXXXXXXXXXXXXXGXXXXXXXXXXXXXXXXXXXGXXXXXXXXXXXXXXXXXXXGXXXXXXXXXXXXXXXXXXXGXXXXXXXXXXXXXXXXXXXGXXXXXXXXXXXXXXXXXXXGXXXXXXXXXXXXXXXXXXXGXXXXXXXXXXXXXXXXXXX,0,10,0
40068,14,1,13,68,518,0,0,532,409,123,GXXXXXXXXXXXXXXXXXXXGXXXXXXXXXXXXXXXXXXXGXXXXXXXXXXXXXXXXXXXGXXXXXXXXXXXXXXXXXXXGXXXXXXXXXXXXXXXXXXXGXXXXXXXXXXXXXXXXXXXGXXXXXXXXXXXXXXXXXXXGXXXXXXXXXXXXXXXXXXXGXXXXXXXXXXXXXXXXXXXGAXXXXXXXXXXXXXXXXXXGXXXXXXXXXXXXXXXXXXXGXXXXXXXXXXXXXXXXXXXGXXXXXXXXXXXXXXXXXXX,0,10,0
40089,15,2,13,66,519,0,0,532,407,125,GAXXXXXXXXXXXXXXXXXXGXXXXXXXXXXXXXXXXXXXGXXXXXXXXXXXXXXXXXXXGXXXXXXXXXXXXXXXXXXXGXXXXXXXXXXXXXXXXXXXGXXXXXXXXXXXXXXXXXXXGXXXXXXXXXXXXXXXXXXXGXXXXXXXXXXXXXXXXXXXGXXXXXXXXXXXXXXXXXXXGAXXXXXXXXXXXXXXXXXXGXXXXXXXXXXXXXXXXXXXGXXXXXXXXXXXXXXXXXXXGXXXXXXXXXXXXXXXXXXX,0,10,0

40110,14,1,13,69,517,0,0,531,405,126,GAXXXXXXXXXXXXXXXXXXGXXXXXXXXXXXXXXXXXXXGXXXXXXXXXXXXXXXXXXXGXXXXXXXXXXXXXXXXXXXGXXXXXXXXXXXXXXXXXXXGXXXXXXXXXXXXXXXXXXXGXXXXXXXXXXXXXXXXXXXGXXXXXXXXXXXXXXXXXXXGXXXXXXXXXXXXXXXXXXXGXXXXXXXXXXXXXXXXXXXGXXXXXXXXXXXXXXXXXXXGXXXXXXXXXXXXXXXXXXXGXXXXXXXXXXXXXXXXXXX,0,10,0
40131,14,0,14,69,517,0,0,531,409,122,GOXXXXXXXXXXXXXXXXXXGXXXXXXXXXXXXXXXXXXXGXXXXXXXXXXXXXXXXXXXGXXXXXXXXXXXXXXXXXXXGXXXXXXXXXXXXXXXXXXXGXXXXXXXXXXXXXXXXXXXGXXXXXXXXXXXXXXXXXXXGXXXXXXXXXXXXXXXXXXXGXXXXXXXXXXXXXXXXXXXGXXXXXXXXXXXXXXXXXXXGXXXXXXXXXXXXXXXXXXXGXXXXXXXXXXXXXXXXXXXGXXXXXXXXXXXXXXXXXXX,0,10,0
40152,13,0,13,65,522,0,0,536,409,127,GXXXXXXXXXXXXXXXXXXXGXXXXXXXXXXXXXXXXXXXGXXXXXXXXXXXXXXXXXXXGXXXXXXXXXXXXXXXXXXXGXXXXXXXXXXXXXXXXXXXGXXXXXXXXXXXXXXXXXXXGXXXXXXXXXXXXXXXXXXXGXXXXXXXXXXXXXXXXXXXGXXXXXXXXXXXXXXXXXXXGXXXXXXXXXXXXXXXXXXXGXXXXXXXXXXXXXXXXXXXGXXXXXXXXXXXXXXXXXXXGXXXXXXXXXXXXXXXXXXX,0,10,0
40173,13,0,13,66,521,0,0,535,407,128,GXXXXXXXXXXXXXXXXXXXGXXXXXXXXXXXXXXXXXXXGXXXXXXXXXXXXXXXXXXXGXXXXXXXXXXXXXXXXXXXGXXXXXXXXXXXXXXXXXXXGXXXXXXXXXXXXXXXXXXXGXXXXXXXXXXXXXXXXXXXGXXXXXXXXXXXXXXXXXXXGXXXXXXXXXXXXXXXXXXXGXXXXXXXXXXXXXXXXXXXGXXXXXXXXXXXXXXXXXXXGXXXXXXXXXXXXXXXXXXXGXXXXXXXXXXXXXXXXXXX,0,10,0
40194,13,0,13,73,514,0,0,529,406,123,GXXXXXXXXXXXXXXXXXXXGXXXXXXXXXXXXXXXXXXXGXXXXXXXXXXXXXXXXXXXGXXXXXXXXXXXXXXXXXXXGXXXXXXXXXXXXXXXXXXXGXXXXXXXXXXXXXXXXXXXGXXXXXXXXXXXXXXXXXXXGXXXXXXXXXXXXXXXXXXXGXXXXXXXXXXXXXXXXXXXGXXXXXXXXXXXXXXXXXXXGXXXXXXXXXXXXXXXXXXXGXXXXXXXXXXXXXXXXXXXGXXXXXXXXXXXXXXXXXXX,0,10,0

40215,13,0,13,70,517,0,0,530,408,122,GXXXXXXXXXXXXXXXXXXXGXXXXXXXXXXXXXXXXXXXGXXXXXXXXXXXXXXXXXXXGXXXXXXXXXXXXXXXXXXXGXXXXXXXXXXXXXXXXXXXGXXXXXXXXXXXXXXXXXXXGXXXXXXXXXXXXXXXXXXXGXXXXXXXXXXXXXXXXXXXGXXXXXXXXXXXXXXXXXXXGXXXXXXXXXXXXXXXXXXXGXXXXXXXXXXXXXXXXXXXGXXXXXXXXXXXXXXXXXXXGXXXXXXXXXXXXXXXXXXX,0,10,0
40236,13,0,13,74,513,0,0,527,409,118,GXXXXXXXXXXXXXXXXXXXGXXXXXXXXXXXXXXXXXXXGXXXXXXXXXXXXXXXXXXXGXXXXXXXXXXXXXXXXXXXGXXXXXXXXXXXXXXXXXXXGXXXXXXXXXXXXXXXXXXXGXXXXXXXXXXXXXXXXXXXGXXXXXXXXXXXXXXXXXXXGXXXXXXXXXXXXXXXXXXXGXXXXXXXXXXXXXXXXXXXGXXXXXXXXXXXXXXXXXXXGXXXXXXXXXXXXXXXXXXXGXXXXXXXXXXXXXXXXXXX,0,10,0
40257,13,0,13,74,513,0,0,526,410,116,GXXXXXXXXXXXXXXXXXXXGXXXXXXXXXXXXXXXXXXXGXXXXXXXXXXXXXXXXXXXGXXXXXXXXXXXXXXXXXXXGXXXXXXXXXXXXXXXXXXXGXXXXXXXXXXXXXXXXXXXGXXXXXXXXXXXXXXXXXXXGXXXXXXXXXXXXXXXXXXXGXXXXXXXXXXXXXXXXXXXGXXXXXXXXXXXXXXXXXXXGXXXXXXXXXXXXXXXXXXXGXXXXXXXXXXXXXXXXXXXGXXXXXXXXXXXXXXXXXXX,0,10,0
40278,13,0,13,72,515,0,0,529,413,116,GXXXXXXXXXXXXXXXXXXXGXXXXXXXXXXXXXXXXXXXGXXXXXXXXXXXXXXXXXXXGXXXXXXXXXXXXXXXXXXXGXXXXXXXXXXXXXXXXXXXGXXXXXXXXXXXXXXXXXXXGXXXXXXXXXXXXXXXXXXXGXXXXXXXXXXXXXXXXXXXGXXXXXXXXXXXXXXXXXXXGXXXXXXXXXXXXXXXXXXXGXXXXXXXXXXXXXXXXXXXGXXXXXXXXXXXXXXXXXXXGXXXXXXXXXXXXXXXXXXX,0,10,0
40299,13,0,13,72,515,0,0,529,412,117,GXXXXXXXXXXXXXXXXXXXGXXXXXXXXXXXXXXXXXXXGXXXXXXXXXXXXXXXXXXXGXXXXXXXXXXXXXXXXXXXGXXXXXXXXXXXXXXXXXXXGXXXXXXXXXXXXXXXXXXXGXXXXXXXXXXXXXXXXXXXGXXXXXXXXXXXXXXXXXXXGXXXXXXXXXXXXXXXXXXXGXXXXXXXXXXXXXXXXXXXGXXXXXXXXXXXXXXXXXXXGXXXXXXXXXXXXXXXXXXXGXXXXXXXXXXXXXXXXXXX,0,10,0

40320,13,0,13,71,516,0,0,529,418,111,GXXXXXXXXXXXXXXXXXXXGXXXXXXXXXXXXXXXXXXXGXXXXXXXXXXXXXXXXXXXGXXXXXXXXXXXXXXXXXXXGXXXXXXXXXXXXXXXXXXXGXXXXXXXXXXXXXXXXXXXGXXXXXXXXXXXXXXXXXXXGXXXXXXXXXXXXXXXXXXXGXXXXXXXXXXXXXXXXXXXGXXXXXXXXXXXXXXXXXXXGXXXXXXXXXXXXXXXXXXXGXXXXXXXXXXXXXXXXXXXGXXXXXXXXXXXXXXXXXXX,0,10,0
40341,13,0,13,71,516,0,0,529,417,112,GXXXXXXXXXXXXXXXXXXXGXXXXXXXXXXXXXXXXXXXGXXXXXXXXXXXXXXXXXXXGXXXXXXXXXXXXXXXXXXXGXXXXXXXXXXXXXXXXXXXGXXXXXXXXXXXXXXXXXXXGXXXXXXXXXXXXXXXXXXXGXXXXXXXXXXXXXXXXXXXGXXXXXXXXXXXXXXXXXXXGXXXXXXXXXXXXXXXXXXXGXXXXXXXXXXXXXXXXXXXGXXXXXXXXXXXXXXXXXXXGXXXXXXXXXXXXXXXXXXX,0,10,0
40362,13,0,13,70,517,0,0,530,412,118,GXXXXXXXXXXXXXXXXXXXGXXXXXXXXXXXXXXXXXXXGXXXXXXXXXXXXXXXXXXXGXXXXXXXXXXXXXXXXXXXGXXXXXXXXXXXXXXXXXXXGXXXXXXXXXXXXXXXXXXXGXXXXXXXXXXXXXXXXXXXGXXXXXXXXXXXXXXXXXXXGXXXXXXXXXXXXXXXXXXXGXXXXXXXXXXXXXXXXXXXGXXXXXXXXXXXXXXXXXXXGXXXXXXXXXXXXXXXXXXXGXXXXXXXXXXXXXXXXXXX,0,10,0
40383,13,0,13,70,517,0,0,530,414,116,GXXXXXXXXXXXXXXXXXXXGXXXXXXXXXXXXXXXXXXXGXXXXXXXXXXXXXXXXXXXGXXXXXXXXXXXXXXXXXXXGXXXXXXXXXXXXXXXXXXXGXXXXXXXXXXXXXXXXXXXGXXXXXXXXXXXXXXXXXXXGXXXXXXXXXXXXXXXXXXXGXXXXXXXXXXXXXXXXXXXGXXXXXXXXXXXXXXXXXXXGXXXXXXXXXXXXXXXXXXXGXXXXXXXXXXXXXXXXXXXGXXXXXXXXXXXXXXXXXXX,0,10,0
40404,13,0,13,67,520,0,0,533,412,121,GXXXXXXXXXXXXXXXXXXXGXXXXXXXXXXXXXXXXXXXGXXXXXXXXXXXXXXXXXXXGXXXXXXXXXXXXXXXXXXXGXXXXXXXXXXXXXXXXXXXGXXXXXXXXXXXXXXXXXXXGXXXXXXXXXXXXXXXXXXXGXXXXXXXXXXXXXXXXXXXGXXXXXXXXXXXXXXXXXXXGXXXXXXXXXXXXXXXXXXXGXXXXXXXXXXXXXXXXXXXGXXXXXXXXXXXXXXXXXXXGXXXXXXXXXXXXXXXXXXX,0,10,0

40425,13,0,13,65,522,0,0,535,410,125,GXXXXXXXXXXXXXXXXXXXGXXXXXXXXXXXXXXXXXXXGXXXXXXXXXXXXXXXXXXXGXXXXXXXXXXXXXXXXXXXGXXXXXXXXXXXXXXXXXXXGXXXXXXXXXXXXXXXXXXXGXXXXXXXXXXXXXXXXXXXGXXXXXXXXXXXXXXXXXXXGXXXXXXXXXXXXXXXXXXXGXXXXXXXXXXXXXXXXXXXGXXXXXXXXXXXXXXXXXXXGXXXXXXXXXXXXXXXXXXXGXXXXXXXXXXXXXXXXXXX,0,10,0
40446,13,0,13,67,520,0,0,534,410,124,GXXXXXXXXXXXXXXXXXXXGXXXXXXXXXXXXXXXXXXXGXXXXXXXXXXXXXXXXXXXGXXXXXXXXXXXXXXXXXXXGXXXXXXXXXXXXXXXXXXXGXXXXXXXXXXXXXXXXXXXGXXXXXXXXXXXXXXXXXXXGXXXXXXXXXXXXXXXXXXXGXXXXXXXXXXXXXXXXXXXGXXXXXXXXXXXXXXXXXXXGXXXXXXXXXXXXXXXXXXXGXXXXXXXXXXXXXXXXXXXGXXXXXXXXXXXXXXXXXXX,0,10,0
40467,13,0,13,66,521,0,0,535,409,126,GXXXXXXXXXXXXXXXXXXXGXXXXXXXXXXXXXXXXXXXGXXXXXXXXXXXXXXXXXXXGXXXXXXXXXXXXXXXXXXXGXXXXXXXXXXXXXXXXXXXGXXXXXXXXXXXXXXXXXXXGXXXXXXXXXXXXXXXXXXXGXXXXXXXXXXXXXXXXXXXGXXXXXXXXXXXXXXXXXXXGXXXXXXXXXXXXXXXXXXXGXXXXXXXXXXXXXXXXXXXGXXXXXXXXXXXXXXXXXXXGXXXXXXXXXXXXXXXXXXX,0,10,0
40488,13,0,13,63,524,0,0,537,411,126,GXXXXXXXXXXXXXXXXXXXGXXXXXXXXXXXXXXXXXXXGXXXXXXXXXXXXXXXXXXXGXXXXXXXXXXXXXXXXXXXGXXXXXXXXXXXXXXXXXXXGXXXXXXXXXXXXXXXXXXXGXXXXXXXXXXXXXXXXXXXGXXXXXXXXXXXXXXXXXXXGXXXXXXXXXXXXXXXXXXXGXXXXXXXXXXXXXXXXXXXGXXXXXXXXXXXXXXXXXXXGXXXXXXXXXXXXXXXXXXXGXXXXXXXXXXXXXXXXXXX,0,10,0
40509,13,0,13,62,525,0,0,539,415,124,GXXXXXXXXXXXXXXXXXXXGXXXXXXXXXXXXXXXXXXXGXXXXXXXXXXXXXXXXXXXGXXXXXXXXXXXXXXXXXXXGXXXXXXXXXXXXXXXXXXXGXXXXXXXXXXXXXXXXXXXGXXXXXXXXXXXXXXXXXXXGXXXXXXXXXXXXXXXXXXXGXXXXXXXXXXXXXXXXXXXGXXXXXXXXXXXXXXXXXXXGXXXXXXXXXXXXXXXXXXXGXXXXXXXXXXXXXXXXXXXGXXXXXXXXXXXXXXXXXXX,0,10,0

40530,13,0,13,66,521,0,0,535,409,126,GXXXXXXXXXXXXXXXXXXXGXXXXXXXXXXXXXXXXXXXGXXXXXXXXXXXXXXXXXXXGXXXXXXXXXXXXXXXXXXXGXXXXXXXXXXXXXXXXXXXGXXXXXXXXXXXXXXXXXXXGXXXXXXXXXXXXXXXXXXXGXXXXXXXXXXXXXXXXXXXGXXXXXXXXXXXXXXXXXXXGXXXXXXXXXXXXXXXXXXXGXXXXXXXXXXXXXXXXXXXGXXXXXXXXXXXXXXXXXXXGXXXXXXXXXXXXXXXXXXX,0,10,0
40551,13,0,13,63,524,0,0,538,412,126,GXXXXXXXXXXXXXXXXXXXGXXXXXXXXXXXXXXXXXXXGXXXXXXXXXXXXXXXXXXXGXXXXXXXXXXXXXXXXXXXGXXXXXXXXXXXXXXXXXXXGXXXXXXXXXXXXXXXXXXXGXXXXXXXXXXXXXXXXXXXGXXXXXXXXXXXXXXXXXXXGXXXXXXXXXXXXXXXXXXXGXXXXXXXXXXXXXXXXXXXGXXXXXXXXXXXXXXXXXXXGXXXXXXXXXXXXXXXXXXXGXXXXXXXXXXXXXXXXXXX,0,10,0
40572,13,0,13,61,526,0,0,539,411,128,GXXXXXXXXXXXXXXXXXXXGXXXXXXXXXXXXXXXXXXXGXXXXXXXXXXXXXXXXXXXGXXXXXXXXXXXXXXXXXXXGXXXXXXXXXXXXXXXXXXXGXXXXXXXXXXXXXXXXXXXGXXXXXXXXXXXXXXXXXXXGXXXXXXXXXXXXXXXXXXXGXXXXXXXXXXXXXXXXXXXGXXXXXXXXXXXXXXXXXXXGXXXXXXXXXXXXXXXXXXXGXXXXXXXXXXXXXXXXXXXGXXXXXXXXXXXXXXXXXXX,0,10,0
40593,13,0,13,61,526,0,0,538,412,126,GXXXXXXXXXXXXXXXXXXXGXXXXXXXXXXXXXXXXXXXGXXXXXXXXXXXXXXXXXXXGXXXXXXXXXXXXXXXXXXXGXXXXXXXXXXXXXXXXXXXGXXXXXXXXXXXXXXXXXXXGXXXXXXXXXXXXXXXXXXXGXXXXXXXXXXXXXXXXXXXGXXXXXXXXXXXXXXXXXXXGXXXXXXXXXXXXXXXXXXXGXXXXXXXXXXXXXXXXXXXGXXXXXXXXXXXXXXXXXXXGXXXXXXXXXXXXXXXXXXX,0,10,0
40614,13,0,13,63,524,0,0,537,415,122,GXXXXXXXXXXXXXXXXXXXGXXXXXXXXXXXXXXXXXXXGXXXXXXXXXXXXXXXXXXXGXXXXXXXXXXXXXXXXXXXGXXXXXXXXXXXXXXXXXXXGXXXXXXXXXXXXXXXXXXXGXXXXXXXXXXXXXXXXXXXGXXXXXXXXXXXXXXXXXXXGXXXXXXXXXXXXXXXXXXXGXXXXXXXXXXXXXXXXXXXGXXXXXXXXXXXXXXXXXXXGXXXXXXXXXXXXXXXXXXXGXXXXXXXXXXXXXXXXXXX,0,10,0

40635,13,0,13,65,522,0,0,535,414,121,GXXXXXXXXXXXXXXXXXXXGXXXXXXXXXXXXXXXXXXXGXXXXXXXXXXXXXXXXXXXGXXXXXXXXXXXXXXXXXXXGXXXXXXXXXXXXXXXXXXXGXXXXXXXXXXXXXXXXXXXGXXXXXXXXXXXXXXXXXXXGXXXXXXXXXXXXXXXXXXXGXXXXXXXXXXXXXXXXXXXGXXXXXXXXXXXXXXXXXXXGXXXXXXXXXXXXXXXXXXXGXXXXXXXXXXXXXXXXXXXGXXXXXXXXXXXXXXXXXXX,0,10,0
40656,13,0,13,64,523,0,0,535,416,119,GXXXXXXXXXXXXXXXXXXXGXXXXXXXXXXXXXXXXXXXGXXXXXXXXXXXXXXXXXXXGXXXXXXXXXXXXXXXXXXXGXXXXXXXXXXXXXXXXXXXGXXXXXXXXXXXXXXXXXXXGXXXXXXXXXXXXXXXXXXXGXXXXXXXXXXXXXXXXXXXGXXXXXXXXXXXXXXXXXXXGXXXXXXXXXXXXXXXXXXXGXXXXXXXXXXXXXXXXXXXGXXXXXXXXXXXXXXXXXXXGXXXXXXXXXXXXXXXXXXX,0,10,0
40677,13,0,13,65,522,0,0,535,411,124,GXXXXXXXXXXXXXXXXXXXGXXXXXXXXXXXXXXXXXXXGXXXXXXXXXXXXXXXXXXXGXXXXXXXXXXXXXXXXXXXGXXXXXXXXXXXXXXXXXXXGXXXXXXXXXXXXXXXXXXXGXXXXXXXXXXXXXXXXXXXGXXXXXXXXXXXXXXXXXXXGXXXXXXXXXXXXXXXXXXXGXXXXXXXXXXXXXXXXXXXGXXXXXXXXXXXXXXXXXXXGXXXXXXXXXXXXXXXXXXXGXXXXXXXXXXXXXXXXXXX,0,10,0
40698,13,0,13,66,521,0,0,535,413,122,GXXXXXXXXXXXXXXXXXXXGXXXXXXXXXXXXXXXXXXXGXXXXXXXXXXXXXXXXXXXGXXXXXXXXXXXXXXXXXXXGXXXXXXXXXXXXXXXXXXXGXXXXXXXXXXXXXXXXXXXGXXXXXXXXXXXXXXXXXXXGXXXXXXXXXXXXXXXXXXXGXXXXXXXXXXXXXXXXXXXGXXXXXXXXXXXXXXXXXXXGXXXXXXXXXXXXXXXXXXXGXXXXXXXXXXXXXXXXXXXGXXXXXXXXXXXXXXXXXXX,0,10,0
40719,13,0,13,65,522,0,0,536,414,122,GXXXXXXXXXXXXXXXXXXXGXXXXXXXXXXXXXXXXXXXGXXXXXXXXXXXXXXXXXXXGXXXXXXXXXXXXXXXXXXXGXXXXXXXXXXXXXXXXXXXGXXXXXXXXXXXXXXXXXXXGXXXXXXXXXXXXXXXXXXXGXXXXXXXXXXXXXXXXXXXGXXXXXXXXXXXXXXXXXXXGXXXXXXXXXXXXXXXXXXXGXXXXXXXXXXXXXXXXXXXGXXXXXXXXXXXXXXXXXXXGXXXXXXXXXXXXXXXXXXX,0,10,0

40740,13,0,13,70,517,0,0,532,413,119,GXXXXXXXXXXXXXXXXXXXGXXXXXXXXXXXXXXXXXXXGXXXXXXXXXXXXXXXXXXXGXXXXXXXXXXXXXXXXXXXGXXXXXXXXXXXXXXXXXXXGXXXXXXXXXXXXXXXXXXXGXXXXXXXXXXXXXXXXXXXGXXXXXXXXXXXXXXXXXXXGXXXXXXXXXXXXXXXXXXXGXXXXXXXXXXXXXXXXXXXGXXXXXXXXXXXXXXXXXXXGXXXXXXXXXXXXXXXXXXXGXXXXXXXXXXXXXXXXXXX,0,10,0
40761,13,0,13,70,517,0,0,532,416,116,GXXXXXXXXXXXXXXXXXXXGXXXXXXXXXXXXXXXXXXXGXXXXXXXXXXXXXXXXXXXGXXXXXXXXXXXXXXXXXXXGXXXXXXXXXXXXXXXXXXXGXXXXXXXXXXXXXXXXXXXGXXXXXXXXXXXXXXXXXXXGXXXXXXXXXXXXXXXXXXXGXXXXXXXXXXXXXXXXXXXGXXXXXXXXXXXXXXXXXXXGXXXXXXXXXXXXXXXXXXXGXXXXXXXXXXXXXXXXXXXGXXXXXXXXXXXXXXXXXXX,0,10,0
40782,13,0,13,64,523,0,0,537,413,124,GXXXXXXXXXXXXXXXXXXXGXXXXXXXXXXXXXXXXXXXGXXXXXXXXXXXXXXXXXXXGXXXXXXXXXXXXXXXXXXXGXXXXXXXXXXXXXXXXXXXGXXXXXXXXXXXXXXXXXXXGXXXXXXXXXXXXXXXXXXXGXXXXXXXXXXXXXXXXXXXGXXXXXXXXXXXXXXXXXXXGXXXXXXXXXXXXXXXXXXXGXXXXXXXXXXXXXXXXXXXGXXXXXXXXXXXXXXXXXXXGXXXXXXXXXXXXXXXXXXX,0,10,0
40803,13,0,13,66,521,0,0,534,413,121,GXXXXXXXXXXXXXXXXXXXGXXXXXXXXXXXXXXXXXXXGXXXXXXXXXXXXXXXXXXXGXXXXXXXXXXXXXXXXXXXGXXXXXXXXXXXXXXXXXXXGXXXXXXXXXXXXXXXXXXXGXXXXXXXXXXXXXXXXXXXGXXXXXXXXXXXXXXXXXXXGXXXXXXXXXXXXXXXXXXXGXXXXXXXXXXXXXXXXXXXGXXXXXXXXXXXXXXXXXXXGXXXXXXXXXXXXXXXXXXXGXXXXXXXXXXXXXXXXXXX,0,10,0
40824,13,0,13,63,524,0,0,537,412,125,GXXXXXXXXXXXXXXXXXXXGXXXXXXXXXXXXXXXXXXXGXXXXXXXXXXXXXXXXXXXGXXXXXXXXXXXXXXXXXXXGXXXXXXXXXXXXXXXXXXXGXXXXXXXXXXXXXXXXXXXGXXXXXXXXXXXXXXXXXXXGXXXXXXXXXXXXXXXXXXXGXXXXXXXXXXXXXXXXXXXGXXXXXXXXXXXXXXXXXXXGXXXXXXXXXXXXXXXXXXXGXXXXXXXXXXXXXXXXXXXGXXXXXXXXXXXXXXXXXXX,0,10,0

40845,13,0,13,62,525,0,0,538,415,123,GXXXXXXXXXXXXXXXXXXXGXXXXXXXXXXXXXXXXXXXGXXXXXXXXXXXXXXXXXXXGXXXXXXXXXXXXXXXXXXXGXXXXXXXXXXXXXXXXXXXGXXXXXXXXXXXXXXXXXXXGXXXXXXXXXXXXXXXXXXXGXXXXXXXXXXXXXXXXXXXGXXXXXXXXXXXXXXXXXXXGXXXXXXXXXXXXXXXXXXXGXXXXXXXXXXXXXXXXXXXGXXXXXXXXXXXXXXXXXXXGXXXXXXXXXXXXXXXXXXX,0,10,0
40866,13,0,13,69,518,0,0,532,412,120,GXXXXXXXXXXXXXXXXXXXGXXXXXXXXXXXXXXXXXXXGXXXXXXXXXXXXXXXXXXXGXXXXXXXXXXXXXXXXXXXGXXXXXXXXXXXXXXXXXXXGXXXXXXXXXXXXXXXXXXXGXXXXXXXXXXXXXXXXXXXGXXXXXXXXXXXXXXXXXXXGXXXXXXXXXXXXXXXXXXXGXXXXXXXXXXXXXXXXXXXGXXXXXXXXXXXXXXXXXXXGXXXXXXXXXXXXXXXXXXXGXXXXXXXXXXXXXXXXXXX,0,10,0
40887,14,1,13,66,520,0,0,533,410,123,GXXXXXXXXXXXXXXXXXXXGXXXXXXXXXXXXXXXXXXXGXXXXXXXXXXXXXXXXXXXGXXXXXXXXXXXXXXXXXXXGXXXXXXXXXXXXXXXXXXXGXXXXXXXXXXXXXXXXXXXGXXXXXXXXXXXXXXXXXXXGXXXXXXXXXXXXXXXXXXXGXXXXXXXXXXXXXXXXXXXGXXXXXXXXXXXXXXXXXXXGXXXXXXXXXXXXXXXXXXXGAXXXXXXXXXXXXXXXXXXGXXXXXXXXXXXXXXXXXXX,0,10,0
40908,14,1,13,67,519,0,0,533,414,119,GXXXXXXXXXXXXXXXXXXXGXXXXXXXXXXXXXXXXXXXGXXXXXXXXXXXXXXXXXXXGXXXXXXXXXXXXXXXXXXXGXXXXXXXXXXXXXXXXXXXGXXXXXXXXXXXXXXXXXXXGXXXXXXXXXXXXXXXXXXXGXXXXXXXXXXXXXXXXXXXGXXXXXXXXXXXXXXXXXXXGXXXXXXXXXXXXXXXXXXXGXXXXXXXXXXXXXXXXXXXGAXXXXXXXXXXXXXXXXXXGXXXXXXXXXXXXXXXXXXX,0,10,0
40929,13,0,13,71,516,0,0,530,409,121,GXXXXXXXXXXXXXXXXXXXGXXXXXXXXXXXXXXXXXXXGXXXXXXXXXXXXXXXXXXXGXXXXXXXXXXXXXXXXXXXGXXXXXXXXXXXXXXXXXXXGXXXXXXXXXXXXXXXXXXXGXXXXXXXXXXXXXXXXXXXGXXXXXXXXXXXXXXXXXXXGXXXXXXXXXXXXXXXXXXXGXXXXXXXXXXXXXXXXXXXGXXXXXXXXXXXXXXXXXXXGXXXXXXXXXXXXXXXXXXXGXXXXXXXXXXXXXXXXXXX,0,10,0

40950,13,0,13,75,512,0,0,525,413,112,GXXXXXXXXXXXXXXXXXXXGXXXXXXXXXXXXXXXXXXXGXXXXXXXXXXXXXXXXXXXGXXXXXXXXXXXXXXXXXXXGXXXXXXXXXXXXXXXXXXXGXXXXXXXXXXXXXXXXXXXGXXXXXXXXXXXXXXXXXXXGXXXXXXXXXXXXXXXXXXXGXXXXXXXXXXXXXXXXXXXGXXXXXXXXXXXXXXXXXXXGXXXXXXXXXXXXXXXXXXXGXXXXXXXXXXXXXXXXXXXGXXXXXXXXXXXXXXXXXXX,0,10,0
40971,13,0,13,70,517,0,0,530,411,119,GXXXXXXXXXXXXXXXXXXXGXXXXXXXXXXXXXXXXXXXGXXXXXXXXXXXXXXXXXXXGXXXXXXXXXXXXXXXXXXXGXXXXXXXXXXXXXXXXXXXGXXXXXXXXXXXXXXXXXXXGXXXXXXXXXXXXXXXXXXXGXXXXXXXXXXXXXXXXXXXGXXXXXXXXXXXXXXXXXXXGXXXXXXXXXXXXXXXXXXXGXXXXXXXXXXXXXXXXXXXGXXXXXXXXXXXXXXXXXXXGXXXXXXXXXXXXXXXXXXX,0,10,0
40992,13,0,13,72,515,0,0,528,416,112,GXXXXXXXXXXXXXXXXXXXGXXXXXXXXXXXXXXXXXXXGXXXXXXXXXXXXXXXXXXXGXXXXXXXXXXXXXXXXXXXGXXXXXXXXXXXXXXXXXXXGXXXXXXXXXXXXXXXXXXXGXXXXXXXXXXXXXXXXXXXGXXXXXXXXXXXXXXXXXXXGXXXXXXXXXXXXXXXXXXXGXXXXXXXXXXXXXXXXXXXGXXXXXXXXXXXXXXXXXXXGXXXXXXXXXXXXXXXXXXXGXXXXXXXXXXXXXXXXXXX,0,10,0
41013,13,0,13,73,514,0,0,527,415,112,GXXXXXXXXXXXXXXXXXXXGXXXXXXXXXXXXXXXXXXXGXXXXXXXXXXXXXXXXXXXGXXXXXXXXXXXXXXXXXXXGXXXXXXXXXXXXXXXXXXXGXXXXXXXXXXXXXXXXXXXGXXXXXXXXXXXXXXXXXXXGXXXXXXXXXXXXXXXXXXXGXXXXXXXXXXXXXXXXXXXGXXXXXXXXXXXXXXXXXXXGXXXXXXXXXXXXXXXXXXXGXXXXXXXXXXXXXXXXXXXGXXXXXXXXXXXXXXXXXXX,0,10,0
41034,13,0,13,69,518,0,0,530,414,116,GXXXXXXXXXXXXXXXXXXXGXXXXXXXXXXXXXXXXXXXGXXXXXXXXXXXXXXXXXXXGXXXXXXXXXXXXXXXXXXXGXXXXXXXXXXXXXXXXXXXGXXXXXXXXXXXXXXXXXXXGXXXXXXXXXXXXXXXXXXXGXXXXXXXXXXXXXXXXXXXGXXXXXXXXXXXXXXXXXXXGXXXXXXXXXXXXXXXXXXXGXXXXXXXXXXXXXXXXXXXGXXXXXXXXXXXXXXXXXXXGXXXXXXXXXXXXXXXXXXX,0,10,0

41055,13,0,13,69,518,0,0,532,417,115,GXXXXXXXXXXXXXXXXXXXGXXXXXXXXXXXXXXXXXXXGXXXXXXXXXXXXXXXXXXXGXXXXXXXXXXXXXXXXXXXGXXXXXXXXXXXXXXXXXXXGXXXXXXXXXXXXXXXXXXXGXXXXXXXXXXXXXXXXXXXGXXXXXXXXXXXXXXXXXXXGXXXXXXXXXXXXXXXXXXXGXXXXXXXXXXXXXXXXXXXGXXXXXXXXXXXXXXXXXXXGXXXXXXXXXXXXXXXXXXXGXXXXXXXXXXXXXXXXXXX,0,10,0
41076,13,0,13,66,521,0,0,535,417,118,GXXXXXXXXXXXXXXXXXXXGXXXXXXXXXXXXXXXXXXXGXXXXXXXXXXXXXXXXXXXGXXXXXXXXXXXXXXXXXXXGXXXXXXXXXXXXXXXXXXXGXXXXXXXXXXXXXXXXXXXGXXXXXXXXXXXXXXXXXXXGXXXXXXXXXXXXXXXXXXXGXXXXXXXXXXXXXXXXXXXGXXXXXXXXXXXXXXXXXXXGXXXXXXXXXXXXXXXXXXXGXXXXXXXXXXXXXXXXXXXGXXXXXXXXXXXXXXXXXXX,0,10,0
41097,13,0,13,63,524,0,0,538,413,125,GXXXXXXXXXXXXXXXXXXXGXXXXXXXXXXXXXXXXXXXGXXXXXXXXXXXXXXXXXXXGXXXXXXXXXXXXXXXXXXXGXXXXXXXXXXXXXXXXXXXGXXXXXXXXXXXXXXXXXXXGXXXXXXXXXXXXXXXXXXXGXXXXXXXXXXXXXXXXXXXGXXXXXXXXXXXXXXXXXXXGXXXXXXXXXXXXXXXXXXXGXXXXXXXXXXXXXXXXXXXGXXXXXXXXXXXXXXXXXXXGXXXXXXXXXXXXXXXXXXX,0,10,0
41118,13,0,13,65,522,0,0,535,415,120,GXXXXXXXXXXXXXXXXXXXGXXXXXXXXXXXXXXXXXXXGXXXXXXXXXXXXXXXXXXXGXXXXXXXXXXXXXXXXXXXGXXXXXXXXXXXXXXXXXXXGXXXXXXXXXXXXXXXXXXXGXXXXXXXXXXXXXXXXXXXGXXXXXXXXXXXXXXXXXXXGXXXXXXXXXXXXXXXXXXXGXXXXXXXXXXXXXXXXXXXGXXXXXXXXXXXXXXXXXXXGXXXXXXXXXXXXXXXXXXXGXXXXXXXXXXXXXXXXXXX,0,10,0
41139,13,0,13,61,526,0,0,539,417,122,GXXXXXXXXXXXXXXXXXXXGXXXXXXXXXXXXXXXXXXXGXXXXXXXXXXXXXXXXXXXGXXXXXXXXXXXXXXXXXXXGXXXXXXXXXXXXXXXXXXXGXXXXXXXXXXXXXXXXXXXGXXXXXXXXXXXXXXXXXXXGXXXXXXXXXXXXXXXXXXXGXXXXXXXXXXXXXXXXXXXGXXXXXXXXXXXXXXXXXXXGXXXXXXXXXXXXXXXXXXXGXXXXXXXXXXXXXXXXXXXGXXXXXXXXXXXXXXXXXXX,0,10,0

41160,13,0,13,63,524,0,0,537,413,124,GXXXXXXXXXXXXXXXXXXXGXXXXXXXXXXXXXXXXXXXGXXXXXXXXXXXXXXXXXXXGXXXXXXXXXXXXXXXXXXXGXXXXXXXXXXXXXXXXXXXGXXXXXXXXXXXXXXXXXXXGXXXXXXXXXXXXXXXXXXXGXXXXXXXXXXXXXXXXXXXGXXXXXXXXXXXXXXXXXXXGXXXXXXXXXXXXXXXXXXXGXXXXXXXXXXXXXXXXXXXGXXXXXXXXXXXXXXXXXXXGXXXXXXXXXXXXXXXXXXX,0,10,0
41181,13,0,13,64,523,0,0,536,415,121,GXXXXXXXXXXXXXXXXXXXGXXXXXXXXXXXXXXXXXXXGXXXXXXXXXXXXXXXXXXXGXXXXXXXXXXXXXXXXXXXGXXXXXXXXXXXXXXXXXXXGXXXXXXXXXXXXXXXXXXXGXXXXXXXXXXXXXXXXXXXGXXXXXXXXXXXXXXXXXXXGXXXXXXXXXXXXXXXXXXXGXXXXXXXXXXXXXXXXXXXGXXXXXXXXXXXXXXXXXXXGXXXXXXXXXXXXXXXXXXXGXXXXXXXXXXXXXXXXXXX,0,10,0
41202,13,0,13,62,525,0,0,537,413,124,GXXXXXXXXXXXXXXXXXXXGXXXXXXXXXXXXXXXXXXXGXXXXXXXXXXXXXXXXXXXGXXXXXXXXXXXXXXXXXXXGXXXXXXXXXXXXXXXXXXXGXXXXXXXXXXXXXXXXXXXGXXXXXXXXXXXXXXXXXXXGXXXXXXXXXXXXXXXXXXXGXXXXXXXXXXXXXXXXXXXGXXXXXXXXXXXXXXXXXXXGXXXXXXXXXXXXXXXXXXXGXXXXXXXXXXXXXXXXXXXGXXXXXXXXXXXXXXXXXXX,0,10,0
41223,13,0,13,61,526,0,0,539,415,124,GXXXXXXXXXXXXXXXXXXXGXXXXXXXXXXXXXXXXXXXGXXXXXXXXXXXXXXXXXXXGXXXXXXXXXXXXXXXXXXXGXXXXXXXXXXXXXXXXXXXGXXXXXXXXXXXXXXXXXXXGXXXXXXXXXXXXXXXXXXXGXXXXXXXXXXXXXXXXXXXGXXXXXXXXXXXXXXXXXXXGXXXXXXXXXXXXXXXXXXXGXXXXXXXXXXXXXXXXXXXGXXXXXXXXXXXXXXXXXXXGXXXXXXXXXXXXXXXXXXX,0,10,0
41244,13,0,13,59,528,0,0,541,415,126,GXXXXXXXXXXXXXXXXXXXGXXXXXXXXXXXXXXXXXXXGXXXXXXXXXXXXXXXXXXXGXXXXXXXXXXXXXXXXXXXGXXXXXXXXXXXXXXXXXXXGXXXXXXXXXXXXXXXXXXXGXXXXXXXXXXXXXXXXXXXGXXXXXXXXXXXXXXXXXXXGXXXXXXXXXXXXXXXXXXXGXXXXXXXXXXXXXXXXXXXGXXXXXXXXXXXXXXXXXXXGXXXXXXXXXXXXXXXXXXXGXXXXXXXXXXXXXXXXXXX,0,10,0

41265,13,0,13,56,531,0,0,544,410,134,GXXXXXXXXXXXXXXXXXXXGXXXXXXXXXXXXXXXXXXXGXXXXXXXXXXXXXXXXXXXGXXXXXXXXXXXXXXXXXXXGXXXXXXXXXXXXXXXXXXXGXXXXXXXXXXXXXXXXXXXGXXXXXXXXXXXXXXXXXXXGXXXXXXXXXXXXXXXXXXXGXXXXXXXXXXXXXXXXXXXGXXXXXXXXXXXXXXXXXXXGXXXXXXXXXXXXXXXXXXXGXXXXXXXXXXXXXXXXXXXGXXXXXXXXXXXXXXXXXXX,0,10,0
41286,13,0,13,56,531,0,0,542,413,129,GXXXXXXXXXXXXXXXXXXXGXXXXXXXXXXXXXXXXXXXGXXXXXXXXXXXXXXXXXXXGXXXXXXXXXXXXXXXXXXXGXXXXXXXXXXXXXXXXXXXGXXXXXXXXXXXXXXXXXXXGXXXXXXXXXXXXXXXXXXXGXXXXXXXXXXXXXXXXXXXGXXXXXXXXXXXXXXXXXXXGXXXXXXXXXXXXXXXXXXXGXXXXXXXXXXXXXXXXXXXGXXXXXXXXXXXXXXXXXXXGXXXXXXXXXXXXXXXXXXX,0,10,0
41307,13,0,13,53,534,0,0,547,413,134,GXXXXXXXXXXXXXXXXXXXGXXXXXXXXXXXXXXXXXXXGXXXXXXXXXXXXXXXXXXXGXXXXXXXXXXXXXXXXXXXGXXXXXXXXXXXXXXXXXXXGXXXXXXXXXXXXXXXXXXXGXXXXXXXXXXXXXXXXXXXGXXXXXXXXXXXXXXXXXXXGXXXXXXXXXXXXXXXXXXXGXXXXXXXXXXXXXXXXXXXGXXXXXXXXXXXXXXXXXXXGXXXXXXXXXXXXXXXXXXXGXXXXXXXXXXXXXXXXXXX,0,10,0
41328,13,0,13,57,530,0,0,543,415,128,GXXXXXXXXXXXXXXXXXXXGXXXXXXXXXXXXXXXXXXXGXXXXXXXXXXXXXXXXXXXGXXXXXXXXXXXXXXXXXXXGXXXXXXXXXXXXXXXXXXXGXXXXXXXXXXXXXXXXXXXGXXXXXXXXXXXXXXXXXXXGXXXXXXXXXXXXXXXXXXXGXXXXXXXXXXXXXXXXXXXGXXXXXXXXXXXXXXXXXXXGXXXXXXXXXXXXXXXXXXXGXXXXXXXXXXXXXXXXXXXGXXXXXXXXXXXXXXXXXXX,0,10,0
41349,13,0,13,68,519,0,0,531,413,118,GXXXXXXXXXXXXXXXXXXXGXXXXXXXXXXXXXXXXXXXGXXXXXXXXXXXXXXXXXXXGXXXXXXXXXXXXXXXXXXXGXXXXXXXXXXXXXXXXXXXGXXXXXXXXXXXXXXXXXXXGXXXXXXXXXXXXXXXXXXXGXXXXXXXXXXXXXXXXXXXGXXXXXXXXXXXXXXXXXXXGXXXXXXXXXXXXXXXXXXXGXXXXXXXXXXXXXXXXXXXGXXXXXXXXXXXXXXXXXXXGXXXXXXXXXXXXXXXXXXX,0,10,0

41370,13,0,13,66,521,0,0,533,415,118,GXXXXXXXXXXXXXXXXXXXGXXXXXXXXXXXXXXXXXXXGXXXXXXXXXXXXXXXXXXXGXXXXXXXXXXXXXXXXXXXGXXXXXXXXXXXXXXXXXXXGXXXXXXXXXXXXXXXXXXXGXXXXXXXXXXXXXXXXXXXGXXXXXXXXXXXXXXXXXXXGXXXXXXXXXXXXXXXXXXXGXXXXXXXXXXXXXXXXXXXGXXXXXXXXXXXXXXXXXXXGXXXXXXXXXXXXXXXXXXXGXXXXXXXXXXXXXXXXXXX,0,10,0
41391,13,0,13,64,523,0,0,537,419,118,GXXXXXXXXXXXXXXXXXXXGXXXXXXXXXXXXXXXXXXXGXXXXXXXXXXXXXXXXXXXGXXXXXXXXXXXXXXXXXXXGXXXXXXXXXXXXXXXXXXXGXXXXXXXXXXXXXXXXXXXGXXXXXXXXXXXXXXXXXXXGXXXXXXXXXXXXXXXXXXXGXXXXXXXXXXXXXXXXXXXGXXXXXXXXXXXXXXXXXXXGXXXXXXXXXXXXXXXXXXXGXXXXXXXXXXXXXXXXXXXGXXXXXXXXXXXXXXXXXXX,0,10,0
41412,13,0,13,65,522,0,0,536,418,118,GXXXXXXXXXXXXXXXXXXXGXXXXXXXXXXXXXXXXXXXGXXXXXXXXXXXXXXXXXXXGXXXXXXXXXXXXXXXXXXXGXXXXXXXXXXXXXXXXXXXGXXXXXXXXXXXXXXXXXXXGXXXXXXXXXXXXXXXXXXXGXXXXXXXXXXXXXXXXXXXGXXXXXXXXXXXXXXXXXXXGXXXXXXXXXXXXXXXXXXXGXXXXXXXXXXXXXXXXXXXGXXXXXXXXXXXXXXXXXXXGXXXXXXXXXXXXXXXXXXX,0,10,0
41433,13,0,13,70,517,0,0,531,416,115,GXXXXXXXXXXXXXXXXXXXGXXXXXXXXXXXXXXXXXXXGXXXXXXXXXXXXXXXXXXXGXXXXXXXXXXXXXXXXXXXGXXXXXXXXXXXXXXXXXXXGXXXXXXXXXXXXXXXXXXXGXXXXXXXXXXXXXXXXXXXGXXXXXXXXXXXXXXXXXXXGXXXXXXXXXXXXXXXXXXXGXXXXXXXXXXXXXXXXXXXGXXXXXXXXXXXXXXXXXXXGXXXXXXXXXXXXXXXXXXXGXXXXXXXXXXXXXXXXXXX,0,10,0
41454,13,0,13,70,517,0,0,531,417,114,GXXXXXXXXXXXXXXXXXXXGXXXXXXXXXXXXXXXXXXXGXXXXXXXXXXXXXXXXXXXGXXXXXXXXXXXXXXXXXXXGXXXXXXXXXXXXXXXXXXXGXXXXXXXXXXXXXXXXXXXGXXXXXXXXXXXXXXXXXXXGXXXXXXXXXXXXXXXXXXXGXXXXXXXXXXXXXXXXXXXGXXXXXXXXXXXXXXXXXXXGXXXXXXXXXXXXXXXXXXXGXXXXXXXXXXXXXXXXXXXGXXXXXXXXXXXXXXXXXXX,0,10,0

41475,13,0,13,72,515,0,0,529,418,111,GXXXXXXXXXXXXXXXXXXXGXXXXXXXXXXXXXXXXXXXGXXXXXXXXXXXXXXXXXXXGXXXXXXXXXXXXXXXXXXXGXXXXXXXXXXXXXXXXXXXGXXXXXXXXXXXXXXXXXXXGXXXXXXXXXXXXXXXXXXXGXXXXXXXXXXXXXXXXXXXGXXXXXXXXXXXXXXXXXXXGXXXXXXXXXXXXXXXXXXXGXXXXXXXXXXXXXXXXXXXGXXXXXXXXXXXXXXXXXXXGXXXXXXXXXXXXXXXXXXX,0,10,0
41496,13,0,13,75,512,0,0,526,416,110,GXXXXXXXXXXXXXXXXXXXGXXXXXXXXXXXXXXXXXXXGXXXXXXXXXXXXXXXXXXXGXXXXXXXXXXXXXXXXXXXGXXXXXXXXXXXXXXXXXXXGXXXXXXXXXXXXXXXXXXXGXXXXXXXXXXXXXXXXXXXGXXXXXXXXXXXXXXXXXXXGXXXXXXXXXXXXXXXXXXXGXXXXXXXXXXXXXXXXXXXGXXXXXXXXXXXXXXXXXXXGXXXXXXXXXXXXXXXXXXXGXXXXXXXXXXXXXXXXXXX,0,10,0
41517,13,0,13,75,512,0,0,525,418,107,GXXXXXXXXXXXXXXXXXXXGXXXXXXXXXXXXXXXXXXXGXXXXXXXXXXXXXXXXXXXGXXXXXXXXXXXXXXXXXXXGXXXXXXXXXXXXXXXXXXXGXXXXXXXXXXXXXXXXXXXGXXXXXXXXXXXXXXXXXXXGXXXXXXXXXXXXXXXXXXXGXXXXXXXXXXXXXXXXXXXGXXXXXXXXXXXXXXXXXXXGXXXXXXXXXXXXXXXXXXXGXXXXXXXXXXXXXXXXXXXGXXXXXXXXXXXXXXXXXXX,0,10,0
41538,13,0,13,76,511,0,0,524,415,109,GXXXXXXXXXXXXXXXXXXXGXXXXXXXXXXXXXXXXXXXGXXXXXXXXXXXXXXXXXXXGXXXXXXXXXXXXXXXXXXXGXXXXXXXXXXXXXXXXXXXGXXXXXXXXXXXXXXXXXXXGXXXXXXXXXXXXXXXXXXXGXXXXXXXXXXXXXXXXXXXGXXXXXXXXXXXXXXXXXXXGXXXXXXXXXXXXXXXXXXXGXXXXXXXXXXXXXXXXXXXGXXXXXXXXXXXXXXXXXXXGXXXXXXXXXXXXXXXXXXX,0,10,0
41559,13,0,13,76,511,0,0,521,417,104,GXXXXXXXXXXXXXXXXXXXGXXXXXXXXXXXXXXXXXXXGXXXXXXXXXXXXXXXXXXXGXXXXXXXXXXXXXXXXXXXGXXXXXXXXXXXXXXXXXXXGXXXXXXXXXXXXXXXXXXXGXXXXXXXXXXXXXXXXXXXGXXXXXXXXXXXXXXXXXXXGXXXXXXXXXXXXXXXXXXXGXXXXXXXXXXXXXXXXXXXGXXXXXXXXXXXXXXXXXXXGXXXXXXXXXXXXXXXXXXXGXXXXXXXXXXXXXXXXXXX,0,10,0

41580,13,0,13,81,506,0,0,519,415,104,GXXXXXXXXXXXXXXXXXXXGXXXXXXXXXXXXXXXXXXXGXXXXXXXXXXXXXXXXXXXGXXXXXXXXXXXXXXXXXXXGXXXXXXXXXXXXXXXXXXXGXXXXXXXXXXXXXXXXXXXGXXXXXXXXXXXXXXXXXXXGXXXXXXXXXXXXXXXXXXXGXXXXXXXXXXXXXXXXXXXGXXXXXXXXXXXXXXXXXXXGXXXXXXXXXXXXXXXXXXXGXXXXXXXXXXXXXXXXXXXGXXXXXXXXXXXXXXXXXXX,0,10,0
41601,13,0,13,83,504,0,0,516,410,106,GXXXXXXXXXXXXXXXXXXXGXXXXXXXXXXXXXXXXXXXGXXXXXXXXXXXXXXXXXXXGXXXXXXXXXXXXXXXXXXXGXXXXXXXXXXXXXXXXXXXGXXXXXXXXXXXXXXXXXXXGXXXXXXXXXXXXXXXXXXXGXXXXXXXXXXXXXXXXXXXGXXXXXXXXXXXXXXXXXXXGXXXXXXXXXXXXXXXXXXXGXXXXXXXXXXXXXXXXXXXGXXXXXXXXXXXXXXXXXXXGXXXXXXXXXXXXXXXXXXX,0,10,0
41622,13,0,13,81,506,0,0,519,411,108,GXXXXXXXXXXXXXXXXXXXGXXXXXXXXXXXXXXXXXXXGXXXXXXXXXXXXXXXXXXXGXXXXXXXXXXXXXXXXXXXGXXXXXXXXXXXXXXXXXXXGXXXXXXXXXXXXXXXXXXXGXXXXXXXXXXXXXXXXXXXGXXXXXXXXXXXXXXXXXXXGXXXXXXXXXXXXXXXXXXXGXXXXXXXXXXXXXXXXXXXGXXXXXXXXXXXXXXXXXXXGXXXXXXXXXXXXXXXXXXXGXXXXXXXXXXXXXXXXXXX,0,10,0
41643,13,0,13,75,512,0,0,526,411,115,GXXXXXXXXXXXXXXXXXXXGXXXXXXXXXXXXXXXXXXXGXXXXXXXXXXXXXXXXXXXGXXXXXXXXXXXXXXXXXXXGXXXXXXXXXXXXXXXXXXXGXXXXXXXXXXXXXXXXXXXGXXXXXXXXXXXXXXXXXXXGXXXXXXXXXXXXXXXXXXXGXXXXXXXXXXXXXXXXXXXGXXXXXXXXXXXXXXXXXXXGXXXXXXXXXXXXXXXXXXXGXXXXXXXXXXXXXXXXXXXGXXXXXXXXXXXXXXXXXXX,0,10,0
41664,14,1,13,68,518,0,0,532,411,121,GXXXXXXXXXXXXXXXXXXXGXXXXXXXXXXXXXXXXXXXGAXXXXXXXXXXXXXXXXXXGXXXXXXXXXXXXXXXXXXXGXXXXXXXXXXXXXXXXXXXGXXXXXXXXXXXXXXXXXXXGXXXXXXXXXXXXXXXXXXXGXXXXXXXXXXXXXXXXXXXGXXXXXXXXXXXXXXXXXXXGXXXXXXXXXXXXXXXXXXXGXXXXXXXXXXXXXXXXXXXGXXXXXXXXXXXXXXXXXXXGXXXXXXXXXXXXXXXXXXX,0,10,0

41685,14,1,13,67,519,0,0,532,412,120,GXXXXXXXXXXXXXXXXXXXGXXXXXXXXXXXXXXXXXXXGAXXXXXXXXXXXXXXXXXXGXXXXXXXXXXXXXXXXXXXGXXXXXXXXXXXXXXXXXXXGXXXXXXXXXXXXXXXXXXXGXXXXXXXXXXXXXXXXXXXGXXXXXXXXXXXXXXXXXXXGXXXXXXXXXXXXXXXXXXXGXXXXXXXXXXXXXXXXXXXGXXXXXXXXXXXXXXXXXXXGXXXXXXXXXXXXXXXXXXXGXXXXXXXXXXXXXXXXXXX,0,10,0
41706,15,2,13,64,521,0,0,535,414,121,GXXXXXXXXXXXXXXXXXXXGXXXXXXXXXXXXXXXXXXXGAXXXXXXXXXXXXXXXXXXGXXXXXXXXXXXXXXXXXXXGXXXXXXXXXXXXXXXXXXXGXXXXXXXXXXXXXXXXXXXGXXXXXXXXXXXXXXXXXXXGXXXXXXXXXXXXXXXXXXXGXXXXXXXXXXXXXXXXXXXGXXXXXXXXXXXXXXXXXXXGXXXXXXXXXXXXXXXXXXXGAXXXXXXXXXXXXXXXXXXGXXXXXXXXXXXXXXXXXXX,0,10,0
41727,15,1,14,60,525,0,0,536,417,119,GXXXXXXXXXXXXXXXXXXXGXXXXXXXXXXXXXXXXXXXGOXXXXXXXXXXXXXXXXXXGXXXXXXXXXXXXXXXXXXXGXXXXXXXXXXXXXXXXXXXGXXXXXXXXXXXXXXXXXXXGXXXXXXXXXXXXXXXXXXXGXXXXXXXXXXXXXXXXXXXGXXXXXXXXXXXXXXXXXXXGXXXXXXXXXXXXXXXXXXXGXXXXXXXXXXXXXXXXXXXGAXXXXXXXXXXXXXXXXXXGXXXXXXXXXXXXXXXXXXX,0,10,0
41748,16,2,14,53,531,0,0,545,419,126,GXXXXXXXXXXXXXXXXXXXGAXXXXXXXXXXXXXXXXXXGOXXXXXXXXXXXXXXXXXXGXXXXXXXXXXXXXXXXXXXGXXXXXXXXXXXXXXXXXXXGXXXXXXXXXXXXXXXXXXXGXXXXXXXXXXXXXXXXXXXGXXXXXXXXXXXXXXXXXXXGXXXXXXXXXXXXXXXXXXXGXXXXXXXXXXXXXXXXXXXGXXXXXXXXXXXXXXXXXXXGAXXXXXXXXXXXXXXXXXXGXXXXXXXXXXXXXXXXXXX,0,10,0
41769,15,2,13,52,533,0,0,547,417,130,GXXXXXXXXXXXXXXXXXXXGAXXXXXXXXXXXXXXXXXXGXXXXXXXXXXXXXXXXXXXGXXXXXXXXXXXXXXXXXXXGXXXXXXXXXXXXXXXXXXXGXXXXXXXXXXXXXXXXXXXGXXXXXXXXXXXXXXXXXXXGXXXXXXXXXXXXXXXXXXXGXXXXXXXXXXXXXXXXXXXGXXXXXXXXXXXXXXXXXXXGXXXXXXXXXXXXXXXXXXXGAXXXXXXXXXXXXXXXXXXGXXXXXXXXXXXXXXXXXXX,0,10,0

41790,15,1,14,53,532,0,0,546,416,130,GXXXXXXXXXXXXXXXXXXXGAXXXXXXXXXXXXXXXXXXGXXXXXXXXXXXXXXXXXXXGXXXXXXXXXXXXXXXXXXXGXXXXXXXXXXXXXXXXXXXGXXXXXXXXXXXXXXXXXXXGXXXXXXXXXXXXXXXXXXXGXXXXXXXXXXXXXXXXXXXGXXXXXXXXXXXXXXXXXXXGXXXXXXXXXXXXXXXXXXXGXXXXXXXXXXXXXXXXXXXGOXXXXXXXXXXXXXXXXXXGXXXXXXXXXXXXXXXXXXX,0,10,0
41811,14,1,13,63,523,0,0,537,409,128,GXXXXXXXXXXXXXXXXXXXGAXXXXXXXXXXXXXXXXXXGXXXXXXXXXXXXXXXXXXXGXXXXXXXXXXXXXXXXXXXGXXXXXXXXXXXXXXXXXXXGXXXXXXXXXXXXXXXXXXXGXXXXXXXXXXXXXXXXXXXGXXXXXXXXXXXXXXXXXXXGXXXXXXXXXXXXXXXXXXXGXXXXXXXXXXXXXXXXXXXGXXXXXXXXXXXXXXXXXXXGXXXXXXXXXXXXXXXXXXXGXXXXXXXXXXXXXXXXXXX,0,10,0
41832,14,1,13,56,530,0,0,544,414,130,GXXXXXXXXXXXXXXXXXXXGXXXXXXXXXXXXXXXXXXXGXXXXXXXXXXXXXXXXXXXGXXXXXXXXXXXXXXXXXXXGXXXXXXXXXXXXXXXXXXXGXXXXXXXXXXXXXXXXXXXGXXXXXXXXXXXXXXXXXXXGXXXXXXXXXXXXXXXXXXXGXXXXXXXXXXXXXXXXXXXGXXXXXXXXXXXXXXXXXXXGXXXXXXXXXXXXXXXXXXXGXXXXXXXXXXXXXXXXXXXGAXXXXXXXXXXXXXXXXXX,0,10,0
41853,14,1,13,58,528,0,0,542,412,130,GXXXXXXXXXXXXXXXXXXXGXXXXXXXXXXXXXXXXXXXGXXXXXXXXXXXXXXXXXXXGXXXXXXXXXXXXXXXXXXXGXXXXXXXXXXXXXXXXXXXGXXXXXXXXXXXXXXXXXXXGXXXXXXXXXXXXXXXXXXXGXXXXXXXXXXXXXXXXXXXGXXXXXXXXXXXXXXXXXXXGXXXXXXXXXXXXXXXXXXXGXXXXXXXXXXXXXXXXXXXGXXXXXXXXXXXXXXXXXXXGAXXXXXXXXXXXXXXXXXX,0,10,0
41874,14,1,13,55,531,0,0,545,418,127,GXXXXXXXXXXXXXXXXXXXGXXXXXXXXXXXXXXXXXXXGXXXXXXXXXXXXXXXXXXXGXXXXXXXXXXXXXXXXXXXGXXXXXXXXXXXXXXXXXXXGXXXXXXXXXXXXXXXXXXXGXXXXXXXXXXXXXXXXXXXGXXXXXXXXXXXXXXXXXXXGXXXXXXXXXXXXXXXXXXXGXXXXXXXXXXXXXXXXXXXGXXXXXXXXXXXXXXXXXXXGXXXXXXXXXXXXXXXXXXXGAXXXXXXXXXXXXXXXXXX,0,10,0

41895,14,0,14,62,524,0,0,538,415,123,GXXXXXXXXXXXXXXXXXXXGXXXXXXXXXXXXXXXXXXXGXXXXXXXXXXXXXXXXXXXGXXXXXXXXXXXXXXXXXXXGXXXXXXXXXXXXXXXXXXXGXXXXXXXXXXXXXXXXXXXGXXXXXXXXXXXXXXXXXXXGXXXXXXXXXXXXXXXXXXXGXXXXXXXXXXXXXXXXXXXGXXXXXXXXXXXXXXXXXXXGXXXXXXXXXXXXXXXXXXXGXXXXXXXXXXXXXXXXXXXGOXXXXXXXXXXXXXXXXXX,0,10,0
41916,13,0,13,63,524,0,0,537,414,123,GXXXXXXXXXXXXXXXXXXXGXXXXXXXXXXXXXXXXXXXGXXXXXXXXXXXXXXXXXXXGXXXXXXXXXXXXXXXXXXXGXXXXXXXXXXXXXXXXXXXGXXXXXXXXXXXXXXXXXXXGXXXXXXXXXXXXXXXXXXXGXXXXXXXXXXXXXXXXXXXGXXXXXXXXXXXXXXXXXXXGXXXXXXXXXXXXXXXXXXXGXXXXXXXXXXXXXXXXXXXGXXXXXXXXXXXXXXXXXXXGXXXXXXXXXXXXXXXXXXX,0,10,0
41937,13,0,13,61,526,0,0,539,414,125,GXXXXXXXXXXXXXXXXXXXGXXXXXXXXXXXXXXXXXXXGXXXXXXXXXXXXXXXXXXXGXXXXXXXXXXXXXXXXXXXGXXXXXXXXXXXXXXXXXXXGXXXXXXXXXXXXXXXXXXXGXXXXXXXXXXXXXXXXXXXGXXXXXXXXXXXXXXXXXXXGXXXXXXXXXXXXXXXXXXXGXXXXXXXXXXXXXXXXXXXGXXXXXXXXXXXXXXXXXXXGXXXXXXXXXXXXXXXXXXXGXXXXXXXXXXXXXXXXXXX,0,10,0
41958,13,0,13,61,526,0,0,539,412,127,GXXXXXXXXXXXXXXXXXXXGXXXXXXXXXXXXXXXXXXXGXXXXXXXXXXXXXXXXXXXGXXXXXXXXXXXXXXXXXXXGXXXXXXXXXXXXXXXXXXXGXXXXXXXXXXXXXXXXXXXGXXXXXXXXXXXXXXXXXXXGXXXXXXXXXXXXXXXXXXXGXXXXXXXXXXXXXXXXXXXGXXXXXXXXXXXXXXXXXXXGXXXXXXXXXXXXXXXXXXXGXXXXXXXXXXXXXXXXXXXGXXXXXXXXXXXXXXXXXXX,0,10,0
41979,13,0,13,61,526,0,0,540,414,126,GXXXXXXXXXXXXXXXXXXXGXXXXXXXXXXXXXXXXXXXGXXXXXXXXXXXXXXXXXXXGXXXXXXXXXXXXXXXXXXXGXXXXXXXXXXXXXXXXXXXGXXXXXXXXXXXXXXXXXXXGXXXXXXXXXXXXXXXXXXXGXXXXXXXXXXXXXXXXXXXGXXXXXXXXXXXXXXXXXXXGXXXXXXXXXXXXXXXXXXXGXXXXXXXXXXXXXXXXXXXGXXXXXXXXXXXXXXXXXXXGXXXXXXXXXXXXXXXXXXX,0,10,0

42000,13,0,13,66,521,0,0,535,410,125,GXXXXXXXXXXXXXXXXXXXGXXXXXXXXXXXXXXXXXXXGXXXXXXXXXXXXXXXXXXXGXXXXXXXXXXXXXXXXXXXGXXXXXXXXXXXXXXXXXXXGXXXXXXXXXXXXXXXXXXXGXXXXXXXXXXXXXXXXXXXGXXXXXXXXXXXXXXXXXXXGXXXXXXXXXXXXXXXXXXXGXXXXXXXXXXXXXXXXXXXGXXXXXXXXXXXXXXXXXXXGXXXXXXXXXXXXXXXXXXXGXXXXXXXXXXXXXXXXXXX,0,10,0
42021,13,0,13,61,526,0,0,540,413,127,GXXXXXXXXXXXXXXXXXXXGXXXXXXXXXXXXXXXXXXXGXXXXXXXXXXXXXXXXXXXGXXXXXXXXXXXXXXXXXXXGXXXXXXXXXXXXXXXXXXXGXXXXXXXXXXXXXXXXXXXGXXXXXXXXXXXXXXXXXXXGXXXXXXXXXXXXXXXXXXXGXXXXXXXXXXXXXXXXXXXGXXXXXXXXXXXXXXXXXXXGXXXXXXXXXXXXXXXXXXXGXXXXXXXXXXXXXXXXXXXGXXXXXXXXXXXXXXXXXXX,0,10,0
42042,14,1,13,59,527,0,0,540,412,128,GXXXXXXXXXXXXXXXXXXXGXXXXXXXXXXXXXXXXXXXGXXXXXXXXXXXXXXXXXXXGXXXXXXXXXXXXXXXXXXXGXXXXXXXXXXXXXXXXXXXGXXXXXXXXXXXXXXXXXXXGAXXXXXXXXXXXXXXXXXXGXXXXXXXXXXXXXXXXXXXGXXXXXXXXXXXXXXXXXXXGXXXXXXXXXXXXXXXXXXXGXXXXXXXXXXXXXXXXXXXGXXXXXXXXXXXXXXXXXXXGXXXXXXXXXXXXXXXXXXX,0,10,0
42063,14,1,13,55,531,0,0,545,412,133,GXXXXXXXXXXXXXXXXXXXGXXXXXXXXXXXXXXXXXXXGXXXXXXXXXXXXXXXXXXXGXXXXXXXXXXXXXXXXXXXGXXXXXXXXXXXXXXXXXXXGXXXXXXXXXXXXXXXXXXXGAXXXXXXXXXXXXXXXXXXGXXXXXXXXXXXXXXXXXXXGXXXXXXXXXXXXXXXXXXXGXXXXXXXXXXXXXXXXXXXGXXXXXXXXXXXXXXXXXXXGXXXXXXXXXXXXXXXXXXXGXXXXXXXXXXXXXXXXXXX,0,10,0
42084,14,1,13,57,529,0,0,543,411,132,GXXXXXXXXXXXXXXXXXXXGXXXXXXXXXXXXXXXXXXXGXXXXXXXXXXXXXXXXXXXGXXXXXXXXXXXXXXXXXXXGXXXXXXXXXXXXXXXXXXXGXXXXXXXXXXXXXXXXXXXGAXXXXXXXXXXXXXXXXXXGXXXXXXXXXXXXXXXXXXXGXXXXXXXXXXXXXXXXXXXGXXXXXXXXXXXXXXXXXXXGXXXXXXXXXXXXXXXXXXXGXXXXXXXXXXXXXXXXXXXGXXXXXXXXXXXXXXXXXXX,0,10,0

42105,14,0,14,52,534,0,0,547,413,134,GXXXXXXXXXXXXXXXXXXXGXXXXXXXXXXXXXXXXXXXGXXXXXXXXXXXXXXXXXXXGXXXXXXXXXXXXXXXXXXXGXXXXXXXXXXXXXXXXXXXGXXXXXXXXXXXXXXXXXXXGOXXXXXXXXXXXXXXXXXXGXXXXXXXXXXXXXXXXXXXGXXXXXXXXXXXXXXXXXXXGXXXXXXXXXXXXXXXXXXXGXXXXXXXXXXXXXXXXXXXGXXXXXXXXXXXXXXXXXXXGXXXXXXXXXXXXXXXXXXX,0,10,0
42126,13,0,13,54,533,0,0,544,416,128,GXXXXXXXXXXXXXXXXXXXGXXXXXXXXXXXXXXXXXXXGXXXXXXXXXXXXXXXXXXXGXXXXXXXXXXXXXXXXXXXGXXXXXXXXXXXXXXXXXXXGXXXXXXXXXXXXXXXXXXXGXXXXXXXXXXXXXXXXXXXGXXXXXXXXXXXXXXXXXXXGXXXXXXXXXXXXXXXXXXXGXXXXXXXXXXXXXXXXXXXGXXXXXXXXXXXXXXXXXXXGXXXXXXXXXXXXXXXXXXXGXXXXXXXXXXXXXXXXXXX,0,10,0
42147,13,0,13,56,531,0,0,543,418,125,GXXXXXXXXXXXXXXXXXXXGXXXXXXXXXXXXXXXXXXXGXXXXXXXXXXXXXXXXXXXGXXXXXXXXXXXXXXXXXXXGXXXXXXXXXXXXXXXXXXXGXXXXXXXXXXXXXXXXXXXGXXXXXXXXXXXXXXXXXXXGXXXXXXXXXXXXXXXXXXXGXXXXXXXXXXXXXXXXXXXGXXXXXXXXXXXXXXXXXXXGXXXXXXXXXXXXXXXXXXXGXXXXXXXXXXXXXXXXXXXGXXXXXXXXXXXXXXXXXXX,0,10,0
42168,13,0,13,56,531,0,0,544,417,127,GXXXXXXXXXXXXXXXXXXXGXXXXXXXXXXXXXXXXXXXGXXXXXXXXXXXXXXXXXXXGXXXXXXXXXXXXXXXXXXXGXXXXXXXXXXXXXXXXXXXGXXXXXXXXXXXXXXXXXXXGXXXXXXXXXXXXXXXXXXXGXXXXXXXXXXXXXXXXXXXGXXXXXXXXXXXXXXXXXXXGXXXXXXXXXXXXXXXXXXXGXXXXXXXXXXXXXXXXXXXGXXXXXXXXXXXXXXXXXXXGXXXXXXXXXXXXXXXXXXX,0,10,0
42189,13,0,13,55,532,0,0,545,423,122,GXXXXXXXXXXXXXXXXXXXGXXXXXXXXXXXXXXXXXXXGXXXXXXXXXXXXXXXXXXXGXXXXXXXXXXXXXXXXXXXGXXXXXXXXXXXXXXXXXXXGXXXXXXXXXXXXXXXXXXXGXXXXXXXXXXXXXXXXXXXGXXXXXXXXXXXXXXXXXXXGXXXXXXXXXXXXXXXXXXXGXXXXXXXXXXXXXXXXXXXGXXXXXXXXXXXXXXXXXXXGXXXXXXXXXXXXXXXXXXXGXXXXXXXXXXXXXXXXXXX,0,10,0

42210,13,0,13,64,523,0,0,536,420,116,GXXXXXXXXXXXXXXXXXXXGXXXXXXXXXXXXXXXXXXXGXXXXXXXXXXXXXXXXXXXGXXXXXXXXXXXXXXXXXXXGXXXXXXXXXXXXXXXXXXXGXXXXXXXXXXXXXXXXXXXGXXXXXXXXXXXXXXXXXXXGXXXXXXXXXXXXXXXXXXXGXXXXXXXXXXXXXXXXXXXGXXXXXXXXXXXXXXXXXXXGXXXXXXXXXXXXXXXXXXXGXXXXXXXXXXXXXXXXXXXGXXXXXXXXXXXXXXXXXXX,0,10,0
42231,13,0,13,68,519,0,0,532,417,115,GXXXXXXXXXXXXXXXXXXXGXXXXXXXXXXXXXXXXXXXGXXXXXXXXXXXXXXXXXXXGXXXXXXXXXXXXXXXXXXXGXXXXXXXXXXXXXXXXXXXGXXXXXXXXXXXXXXXXXXXGXXXXXXXXXXXXXXXXXXXGXXXXXXXXXXXXXXXXXXXGXXXXXXXXXXXXXXXXXXXGXXXXXXXXXXXXXXXXXXXGXXXXXXXXXXXXXXXXXXXGXXXXXXXXXXXXXXXXXXXGXXXXXXXXXXXXXXXXXXX,0,10,0
42252,13,0,13,66,521,0,0,534,420,114,GXXXXXXXXXXXXXXXXXXXGXXXXXXXXXXXXXXXXXXXGXXXXXXXXXXXXXXXXXXXGXXXXXXXXXXXXXXXXXXXGXXXXXXXXXXXXXXXXXXXGXXXXXXXXXXXXXXXXXXXGXXXXXXXXXXXXXXXXXXXGXXXXXXXXXXXXXXXXXXXGXXXXXXXXXXXXXXXXXXXGXXXXXXXXXXXXXXXXXXXGXXXXXXXXXXXXXXXXXXXGXXXXXXXXXXXXXXXXXXXGXXXXXXXXXXXXXXXXXXX,0,10,0
42273,13,0,13,63,524,0,0,537,419,118,GXXXXXXXXXXXXXXXXXXXGXXXXXXXXXXXXXXXXXXXGXXXXXXXXXXXXXXXXXXXGXXXXXXXXXXXXXXXXXXXGXXXXXXXXXXXXXXXXXXXGXXXXXXXXXXXXXXXXXXXGXXXXXXXXXXXXXXXXXXXGXXXXXXXXXXXXXXXXXXXGXXXXXXXXXXXXXXXXXXXGXXXXXXXXXXXXXXXXXXXGXXXXXXXXXXXXXXXXXXXGXXXXXXXXXXXXXXXXXXXGXXXXXXXXXXXXXXXXXXX,0,10,0
42294,13,0,13,63,524,0,0,536,416,120,GXXXXXXXXXXXXXXXXXXXGXXXXXXXXXXXXXXXXXXXGXXXXXXXXXXXXXXXXXXXGXXXXXXXXXXXXXXXXXXXGXXXXXXXXXXXXXXXXXXXGXXXXXXXXXXXXXXXXXXXGXXXXXXXXXXXXXXXXXXXGXXXXXXXXXXXXXXXXXXXGXXXXXXXXXXXXXXXXXXXGXXXXXXXXXXXXXXXXXXXGXXXXXXXXXXXXXXXXXXXGXXXXXXXXXXXXXXXXXXXGXXXXXXXXXXXXXXXXXXX,0,10,0

42315,13,0,13,63,524,0,0,537,422,115,GXXXXXXXXXXXXXXXXXXXGXXXXXXXXXXXXXXXXXXXGXXXXXXXXXXXXXXXXXXXGXXXXXXXXXXXXXXXXXXXGXXXXXXXXXXXXXXXXXXXGXXXXXXXXXXXXXXXXXXXGXXXXXXXXXXXXXXXXXXXGXXXXXXXXXXXXXXXXXXXGXXXXXXXXXXXXXXXXXXXGXXXXXXXXXXXXXXXXXXXGXXXXXXXXXXXXXXXXXXXGXXXXXXXXXXXXXXXXXXXGXXXXXXXXXXXXXXXXXXX,0,10,0
42336,13,0,13,65,522,0,0,535,419,116,GXXXXXXXXXXXXXXXXXXXGXXXXXXXXXXXXXXXXXXXGXXXXXXXXXXXXXXXXXXXGXXXXXXXXXXXXXXXXXXXGXXXXXXXXXXXXXXXXXXXGXXXXXXXXXXXXXXXXXXXGXXXXXXXXXXXXXXXXXXXGXXXXXXXXXXXXXXXXXXXGXXXXXXXXXXXXXXXXXXXGXXXXXXXXXXXXXXXXXXXGXXXXXXXXXXXXXXXXXXXGXXXXXXXXXXXXXXXXXXXGXXXXXXXXXXXXXXXXXXX,0,10,0
42357,13,0,13,67,520,0,0,534,416,118,GXXXXXXXXXXXXXXXXXXXGXXXXXXXXXXXXXXXXXXXGXXXXXXXXXXXXXXXXXXXGXXXXXXXXXXXXXXXXXXXGXXXXXXXXXXXXXXXXXXXGXXXXXXXXXXXXXXXXXXXGXXXXXXXXXXXXXXXXXXXGXXXXXXXXXXXXXXXXXXXGXXXXXXXXXXXXXXXXXXXGXXXXXXXXXXXXXXXXXXXGXXXXXXXXXXXXXXXXXXXGXXXXXXXXXXXXXXXXXXXGXXXXXXXXXXXXXXXXXXX,0,10,0
42378,13,0,13,67,520,0,0,534,417,117,GXXXXXXXXXXXXXXXXXXXGXXXXXXXXXXXXXXXXXXXGXXXXXXXXXXXXXXXXXXXGXXXXXXXXXXXXXXXXXXXGXXXXXXXXXXXXXXXXXXXGXXXXXXXXXXXXXXXXXXXGXXXXXXXXXXXXXXXXXXXGXXXXXXXXXXXXXXXXXXXGXXXXXXXXXXXXXXXXXXXGXXXXXXXXXXXXXXXXXXXGXXXXXXXXXXXXXXXXXXXGXXXXXXXXXXXXXXXXXXXGXXXXXXXXXXXXXXXXXXX,0,10,0
42399,13,0,13,65,522,0,0,536,419,117,GXXXXXXXXXXXXXXXXXXXGXXXXXXXXXXXXXXXXXXXGXXXXXXXXXXXXXXXXXXXGXXXXXXXXXXXXXXXXXXXGXXXXXXXXXXXXXXXXXXXGXXXXXXXXXXXXXXXXXXXGXXXXXXXXXXXXXXXXXXXGXXXXXXXXXXXXXXXXXXXGXXXXXXXXXXXXXXXXXXXGXXXXXXXXXXXXXXXXXXXGXXXXXXXXXXXXXXXXXXXGXXXXXXXXXXXXXXXXXXXGXXXXXXXXXXXXXXXXXXX,0,10,0

42420,13,0,13,67,520,0,0,534,421,113,GXXXXXXXXXXXXXXXXXXXGXXXXXXXXXXXXXXXXXXXGXXXXXXXXXXXXXXXXXXXGXXXXXXXXXXXXXXXXXXXGXXXXXXXXXXXXXXXXXXXGXXXXXXXXXXXXXXXXXXXGXXXXXXXXXXXXXXXXXXXGXXXXXXXXXXXXXXXXXXXGXXXXXXXXXXXXXXXXXXXGXXXXXXXXXXXXXXXXXXXGXXXXXXXXXXXXXXXXXXXGXXXXXXXXXXXXXXXXXXXGXXXXXXXXXXXXXXXXXXX,0,10,0
42441,14,1,13,67,519,0,0,533,418,115,GXXXXXXXXXXXXXXXXXXXGXXXXXXXXXXXXXXXXXXXGXXXXXXXXXXXXXXXXXXXGXXXXXXXXXXXXXXXXXXXGXXXXXXXXXXXXXXXXXXXGAXXXXXXXXXXXXXXXXXXGXXXXXXXXXXXXXXXXXXXGXXXXXXXXXXXXXXXXXXXGXXXXXXXXXXXXXXXXXXXGXXXXXXXXXXXXXXXXXXXGXXXXXXXXXXXXXXXXXXXGXXXXXXXXXXXXXXXXXXXGXXXXXXXXXXXXXXXXXXX,0,10,0
42462,14,1,13,67,519,0,0,533,417,116,GXXXXXXXXXXXXXXXXXXXGXXXXXXXXXXXXXXXXXXXGXXXXXXXXXXXXXXXXXXXGXXXXXXXXXXXXXXXXXXXGXXXXXXXXXXXXXXXXXXXGAXXXXXXXXXXXXXXXXXXGXXXXXXXXXXXXXXXXXXXGXXXXXXXXXXXXXXXXXXXGXXXXXXXXXXXXXXXXXXXGXXXXXXXXXXXXXXXXXXXGXXXXXXXXXXXXXXXXXXXGXXXXXXXXXXXXXXXXXXXGXXXXXXXXXXXXXXXXXXX,0,10,0
42483,14,1,13,63,523,0,0,537,418,119,GXXXXXXXXXXXXXXXXXXXGXXXXXXXXXXXXXXXXXXXGXXXXXXXXXXXXXXXXXXXGXXXXXXXXXXXXXXXXXXXGXXXXXXXXXXXXXXXXXXXGAXXXXXXXXXXXXXXXXXXGXXXXXXXXXXXXXXXXXXXGXXXXXXXXXXXXXXXXXXXGXXXXXXXXXXXXXXXXXXXGXXXXXXXXXXXXXXXXXXXGXXXXXXXXXXXXXXXXXXXGXXXXXXXXXXXXXXXXXXXGXXXXXXXXXXXXXXXXXXX,0,10,0
42504,13,0,13,61,526,0,0,540,423,117,GXXXXXXXXXXXXXXXXXXXGXXXXXXXXXXXXXXXXXXXGXXXXXXXXXXXXXXXXXXXGXXXXXXXXXXXXXXXXXXXGXXXXXXXXXXXXXXXXXXXGXXXXXXXXXXXXXXXXXXXGXXXXXXXXXXXXXXXXXXXGXXXXXXXXXXXXXXXXXXXGXXXXXXXXXXXXXXXXXXXGXXXXXXXXXXXXXXXXXXXGXXXXXXXXXXXXXXXXXXXGXXXXXXXXXXXXXXXXXXXGXXXXXXXXXXXXXXXXXXX,0,10,0

42525,13,0,13,66,521,0,0,535,421,114,GXXXXXXXXXXXXXXXXXXXGXXXXXXXXXXXXXXXXXXXGXXXXXXXXXXXXXXXXXXXGXXXXXXXXXXXXXXXXXXXGXXXXXXXXXXXXXXXXXXXGXXXXXXXXXXXXXXXXXXXGXXXXXXXXXXXXXXXXXXXGXXXXXXXXXXXXXXXXXXXGXXXXXXXXXXXXXXXXXXXGXXXXXXXXXXXXXXXXXXXGXXXXXXXXXXXXXXXXXXXGXXXXXXXXXXXXXXXXXXXGXXXXXXXXXXXXXXXXXXX,0,10,0
42546,13,0,13,69,518,0,0,533,419,114,GXXXXXXXXXXXXXXXXXXXGXXXXXXXXXXXXXXXXXXXGXXXXXXXXXXXXXXXXXXXGXXXXXXXXXXXXXXXXXXXGXXXXXXXXXXXXXXXXXXXGXXXXXXXXXXXXXXXXXXXGXXXXXXXXXXXXXXXXXXXGXXXXXXXXXXXXXXXXXXXGXXXXXXXXXXXXXXXXXXXGXXXXXXXXXXXXXXXXXXXGXXXXXXXXXXXXXXXXXXXGXXXXXXXXXXXXXXXXXXXGXXXXXXXXXXXXXXXXXXX,0,10,0
42567,13,0,13,65,522,0,0,536,419,117,GXXXXXXXXXXXXXXXXXXXGXXXXXXXXXXXXXXXXXXXGXXXXXXXXXXXXXXXXXXXGXXXXXXXXXXXXXXXXXXXGXXXXXXXXXXXXXXXXXXXGXXXXXXXXXXXXXXXXXXXGXXXXXXXXXXXXXXXXXXXGXXXXXXXXXXXXXXXXXXXGXXXXXXXXXXXXXXXXXXXGXXXXXXXXXXXXXXXXXXXGXXXXXXXXXXXXXXXXXXXGXXXXXXXXXXXXXXXXXXXGXXXXXXXXXXXXXXXXXXX,0,10,0
42588,13,0,13,69,518,0,0,532,421,111,GXXXXXXXXXXXXXXXXXXXGXXXXXXXXXXXXXXXXXXXGXXXXXXXXXXXXXXXXXXXGXXXXXXXXXXXXXXXXXXXGXXXXXXXXXXXXXXXXXXXGXXXXXXXXXXXXXXXXXXXGXXXXXXXXXXXXXXXXXXXGXXXXXXXXXXXXXXXXXXXGXXXXXXXXXXXXXXXXXXXGXXXXXXXXXXXXXXXXXXXGXXXXXXXXXXXXXXXXXXXGXXXXXXXXXXXXXXXXXXXGXXXXXXXXXXXXXXXXXXX,0,10,0
42609,13,0,13,65,522,0,0,535,417,118,GXXXXXXXXXXXXXXXXXXXGXXXXXXXXXXXXXXXXXXXGXXXXXXXXXXXXXXXXXXXGXXXXXXXXXXXXXXXXXXXGXXXXXXXXXXXXXXXXXXXGXXXXXXXXXXXXXXXXXXXGXXXXXXXXXXXXXXXXXXXGXXXXXXXXXXXXXXXXXXXGXXXXXXXXXXXXXXXXXXXGXXXXXXXXXXXXXXXXXXXGXXXXXXXXXXXXXXXXXXXGXXXXXXXXXXXXXXXXXXXGXXXXXXXXXXXXXXXXXXX,0,10,0

42630,13,0,13,65,522,0,0,536,418,118,GXXXXXXXXXXXXXXXXXXXGXXXXXXXXXXXXXXXXXXXGXXXXXXXXXXXXXXXXXXXGXXXXXXXXXXXXXXXXXXXGXXXXXXXXXXXXXXXXXXXGXXXXXXXXXXXXXXXXXXXGXXXXXXXXXXXXXXXXXXXGXXXXXXXXXXXXXXXXXXXGXXXXXXXXXXXXXXXXXXXGXXXXXXXXXXXXXXXXXXXGXXXXXXXXXXXXXXXXXXXGXXXXXXXXXXXXXXXXXXXGXXXXXXXXXXXXXXXXXXX,0,10,0
42651,13,0,13,61,526,0,0,540,421,119,GXXXXXXXXXXXXXXXXXXXGXXXXXXXXXXXXXXXXXXXGXXXXXXXXXXXXXXXXXXXGXXXXXXXXXXXXXXXXXXXGXXXXXXXXXXXXXXXXXXXGXXXXXXXXXXXXXXXXXXXGXXXXXXXXXXXXXXXXXXXGXXXXXXXXXXXXXXXXXXXGXXXXXXXXXXXXXXXXXXXGXXXXXXXXXXXXXXXXXXXGXXXXXXXXXXXXXXXXXXXGXXXXXXXXXXXXXXXXXXXGXXXXXXXXXXXXXXXXXXX,0,10,0
42672,13,0,13,65,522,0,0,537,419,118,GXXXXXXXXXXXXXXXXXXXGXXXXXXXXXXXXXXXXXXXGXXXXXXXXXXXXXXXXXXXGXXXXXXXXXXXXXXXXXXXGXXXXXXXXXXXXXXXXXXXGXXXXXXXXXXXXXXXXXXXGXXXXXXXXXXXXXXXXXXXGXXXXXXXXXXXXXXXXXXXGXXXXXXXXXXXXXXXXXXXGXXXXXXXXXXXXXXXXXXXGXXXXXXXXXXXXXXXXXXXGXXXXXXXXXXXXXXXXXXXGXXXXXXXXXXXXXXXXXXX,0,10,0
42693,13,0,13,59,528,0,0,543,416,127,GXXXXXXXXXXXXXXXXXXXGXXXXXXXXXXXXXXXXXXXGXXXXXXXXXXXXXXXXXXXGXXXXXXXXXXXXXXXXXXXGXXXXXXXXXXXXXXXXXXXGXXXXXXXXXXXXXXXXXXXGXXXXXXXXXXXXXXXXXXXGXXXXXXXXXXXXXXXXXXXGXXXXXXXXXXXXXXXXXXXGXXXXXXXXXXXXXXXXXXXGXXXXXXXXXXXXXXXXXXXGXXXXXXXXXXXXXXXXXXXGXXXXXXXXXXXXXXXXXXX,0,10,0
42714,13,0,13,56,531,0,0,547,414,133,GXXXXXXXXXXXXXXXXXXXGXXXXXXXXXXXXXXXXXXXGXXXXXXXXXXXXXXXXXXXGXXXXXXXXXXXXXXXXXXXGXXXXXXXXXXXXXXXXXXXGXXXXXXXXXXXXXXXXXXXGXXXXXXXXXXXXXXXXXXXGXXXXXXXXXXXXXXXXXXXGXXXXXXXXXXXXXXXXXXXGXXXXXXXXXXXXXXXXXXXGXXXXXXXXXXXXXXXXXXXGXXXXXXXXXXXXXXXXXXXGXXXXXXXXXXXXXXXXXXX,0,10,0

42735,13,0,13,51,536,0,0,550,415,135,GXXXXXXXXXXXXXXXXXXXGXXXXXXXXXXXXXXXXXXXGXXXXXXXXXXXXXXXXXXXGXXXXXXXXXXXXXXXXXXXGXXXXXXXXXXXXXXXXXXXGXXXXXXXXXXXXXXXXXXXGXXXXXXXXXXXXXXXXXXXGXXXXXXXXXXXXXXXXXXXGXXXXXXXXXXXXXXXXXXXGXXXXXXXXXXXXXXXXXXXGXXXXXXXXXXXXXXXXXXXGXXXXXXXXXXXXXXXXXXXGXXXXXXXXXXXXXXXXXXX,0,10,0
42756,13,0,13,51,536,0,0,551,419,132,GXXXXXXXXXXXXXXXXXXXGXXXXXXXXXXXXXXXXXXXGXXXXXXXXXXXXXXXXXXXGXXXXXXXXXXXXXXXXXXXGXXXXXXXXXXXXXXXXXXXGXXXXXXXXXXXXXXXXXXXGXXXXXXXXXXXXXXXXXXXGXXXXXXXXXXXXXXXXXXXGXXXXXXXXXXXXXXXXXXXGXXXXXXXXXXXXXXXXXXXGXXXXXXXXXXXXXXXXXXXGXXXXXXXXXXXXXXXXXXXGXXXXXXXXXXXXXXXXXXX,0,10,0
42777,13,0,13,51,536,0,0,551,420,131,GXXXXXXXXXXXXXXXXXXXGXXXXXXXXXXXXXXXXXXXGXXXXXXXXXXXXXXXXXXXGXXXXXXXXXXXXXXXXXXXGXXXXXXXXXXXXXXXXXXXGXXXXXXXXXXXXXXXXXXXGXXXXXXXXXXXXXXXXXXXGXXXXXXXXXXXXXXXXXXXGXXXXXXXXXXXXXXXXXXXGXXXXXXXXXXXXXXXXXXXGXXXXXXXXXXXXXXXXXXXGXXXXXXXXXXXXXXXXXXXGXXXXXXXXXXXXXXXXXXX,0,10,0
42798,13,0,13,53,534,0,0,549,421,128,GXXXXXXXXXXXXXXXXXXXGXXXXXXXXXXXXXXXXXXXGXXXXXXXXXXXXXXXXXXXGXXXXXXXXXXXXXXXXXXXGXXXXXXXXXXXXXXXXXXXGXXXXXXXXXXXXXXXXXXXGXXXXXXXXXXXXXXXXXXXGXXXXXXXXXXXXXXXXXXXGXXXXXXXXXXXXXXXXXXXGXXXXXXXXXXXXXXXXXXXGXXXXXXXXXXXXXXXXXXXGXXXXXXXXXXXXXXXXXXXGXXXXXXXXXXXXXXXXXXX,0,10,0
42819,13,0,13,51,536,0,0,551,424,127,GXXXXXXXXXXXXXXXXXXXGXXXXXXXXXXXXXXXXXXXGXXXXXXXXXXXXXXXXXXXGXXXXXXXXXXXXXXXXXXXGXXXXXXXXXXXXXXXXXXXGXXXXXXXXXXXXXXXXXXXGXXXXXXXXXXXXXXXXXXXGXXXXXXXXXXXXXXXXXXXGXXXXXXXXXXXXXXXXXXXGXXXXXXXXXXXXXXXXXXXGXXXXXXXXXXXXXXXXXXXGXXXXXXXXXXXXXXXXXXXGXXXXXXXXXXXXXXXXXXX,0,10,0

42840,13,0,13,58,529,0,0,544,423,121,GXXXXXXXXXXXXXXXXXXXGXXXXXXXXXXXXXXXXXXXGXXXXXXXXXXXXXXXXXXXGXXXXXXXXXXXXXXXXXXXGXXXXXXXXXXXXXXXXXXXGXXXXXXXXXXXXXXXXXXXGXXXXXXXXXXXXXXXXXXXGXXXXXXXXXXXXXXXXXXXGXXXXXXXXXXXXXXXXXXXGXXXXXXXXXXXXXXXXXXXGXXXXXXXXXXXXXXXXXXXGXXXXXXXXXXXXXXXXXXXGXXXXXXXXXXXXXXXXXXX,0,10,0
42861,13,0,13,63,524,0,0,538,421,117,GXXXXXXXXXXXXXXXXXXXGXXXXXXXXXXXXXXXXXXXGXXXXXXXXXXXXXXXXXXXGXXXXXXXXXXXXXXXXXXXGXXXXXXXXXXXXXXXXXXXGXXXXXXXXXXXXXXXXXXXGXXXXXXXXXXXXXXXXXXXGXXXXXXXXXXXXXXXXXXXGXXXXXXXXXXXXXXXXXXXGXXXXXXXXXXXXXXXXXXXGXXXXXXXXXXXXXXXXXXXGXXXXXXXXXXXXXXXXXXXGXXXXXXXXXXXXXXXXXXX,0,10,0
42882,13,0,13,67,520,0,0,534,422,112,GXXXXXXXXXXXXXXXXXXXGXXXXXXXXXXXXXXXXXXXGXXXXXXXXXXXXXXXXXXXGXXXXXXXXXXXXXXXXXXXGXXXXXXXXXXXXXXXXXXXGXXXXXXXXXXXXXXXXXXXGXXXXXXXXXXXXXXXXXXXGXXXXXXXXXXXXXXXXXXXGXXXXXXXXXXXXXXXXXXXGXXXXXXXXXXXXXXXXXXXGXXXXXXXXXXXXXXXXXXXGXXXXXXXXXXXXXXXXXXXGXXXXXXXXXXXXXXXXXXX,0,10,0
42903,13,0,13,70,517,0,0,530,420,110,GXXXXXXXXXXXXXXXXXXXGXXXXXXXXXXXXXXXXXXXGXXXXXXXXXXXXXXXXXXXGXXXXXXXXXXXXXXXXXXXGXXXXXXXXXXXXXXXXXXXGXXXXXXXXXXXXXXXXXXXGXXXXXXXXXXXXXXXXXXXGXXXXXXXXXXXXXXXXXXXGXXXXXXXXXXXXXXXXXXXGXXXXXXXXXXXXXXXXXXXGXXXXXXXXXXXXXXXXXXXGXXXXXXXXXXXXXXXXXXXGXXXXXXXXXXXXXXXXXXX,0,10,0
42924,13,0,13,72,515,0,0,530,419,111,GXXXXXXXXXXXXXXXXXXXGXXXXXXXXXXXXXXXXXXXGXXXXXXXXXXXXXXXXXXXGXXXXXXXXXXXXXXXXXXXGXXXXXXXXXXXXXXXXXXXGXXXXXXXXXXXXXXXXXXXGXXXXXXXXXXXXXXXXXXXGXXXXXXXXXXXXXXXXXXXGXXXXXXXXXXXXXXXXXXXGXXXXXXXXXXXXXXXXXXXGXXXXXXXXXXXXXXXXXXXGXXXXXXXXXXXXXXXXXXXGXXXXXXXXXXXXXXXXXXX,0,10,0

42945,13,0,13,72,515,0,0,529,421,108,GXXXXXXXXXXXXXXXXXXXGXXXXXXXXXXXXXXXXXXXGXXXXXXXXXXXXXXXXXXXGXXXXXXXXXXXXXXXXXXXGXXXXXXXXXXXXXXXXXXXGXXXXXXXXXXXXXXXXXXXGXXXXXXXXXXXXXXXXXXXGXXXXXXXXXXXXXXXXXXXGXXXXXXXXXXXXXXXXXXXGXXXXXXXXXXXXXXXXXXXGXXXXXXXXXXXXXXXXXXXGXXXXXXXXXXXXXXXXXXXGXXXXXXXXXXXXXXXXXXX,0,10,0
42966,13,0,13,78,509,0,0,523,422,101,GXXXXXXXXXXXXXXXXXXXGXXXXXXXXXXXXXXXXXXXGXXXXXXXXXXXXXXXXXXXGXXXXXXXXXXXXXXXXXXXGXXXXXXXXXXXXXXXXXXXGXXXXXXXXXXXXXXXXXXXGXXXXXXXXXXXXXXXXXXXGXXXXXXXXXXXXXXXXXXXGXXXXXXXXXXXXXXXXXXXGXXXXXXXXXXXXXXXXXXXGXXXXXXXXXXXXXXXXXXXGXXXXXXXXXXXXXXXXXXXGXXXXXXXXXXXXXXXXXXX,0,10,0
42987,13,0,13,79,508,0,0,523,419,104,GXXXXXXXXXXXXXXXXXXXGXXXXXXXXXXXXXXXXXXXGXXXXXXXXXXXXXXXXXXXGXXXXXXXXXXXXXXXXXXXGXXXXXXXXXXXXXXXXXXXGXXXXXXXXXXXXXXXXXXXGXXXXXXXXXXXXXXXXXXXGXXXXXXXXXXXXXXXXXXXGXXXXXXXXXXXXXXXXXXXGXXXXXXXXXXXXXXXXXXXGXXXXXXXXXXXXXXXXXXXGXXXXXXXXXXXXXXXXXXXGXXXXXXXXXXXXXXXXXXX,0,10,0
43008,13,0,13,78,509,0,0,524,423,101,GXXXXXXXXXXXXXXXXXXXGXXXXXXXXXXXXXXXXXXXGXXXXXXXXXXXXXXXXXXXGXXXXXXXXXXXXXXXXXXXGXXXXXXXXXXXXXXXXXXXGXXXXXXXXXXXXXXXXXXXGXXXXXXXXXXXXXXXXXXXGXXXXXXXXXXXXXXXXXXXGXXXXXXXXXXXXXXXXXXXGXXXXXXXXXXXXXXXXXXXGXXXXXXXXXXXXXXXXXXXGXXXXXXXXXXXXXXXXXXXGXXXXXXXXXXXXXXXXXXX,0,10,0
43029,13,0,13,76,511,0,0,526,424,102,GXXXXXXXXXXXXXXXXXXXGXXXXXXXXXXXXXXXXXXXGXXXXXXXXXXXXXXXXXXXGXXXXXXXXXXXXXXXXXXXGXXXXXXXXXXXXXXXXXXXGXXXXXXXXXXXXXXXXXXXGXXXXXXXXXXXXXXXXXXXGXXXXXXXXXXXXXXXXXXXGXXXXXXXXXXXXXXXXXXXGXXXXXXXXXXXXXXXXXXXGXXXXXXXXXXXXXXXXXXXGXXXXXXXXXXXXXXXXXXXGXXXXXXXXXXXXXXXXXXX,0,10,0

43050,14,1,13,78,508,0,0,523,421,102,GXXXXXXXXXXXXXXXXXXXGXXXXXXXXXXXXXXXXXXXGXXXXXXXXXXXXXXXXXXXGXXXXXXXXXXXXXXXXXXXGXXXXXXXXXXXXXXXXXXXGXXXXXXXXXXXXXXXXXXXGXXXXXXXXXXXXXXXXXXXGAXXXXXXXXXXXXXXXXXXGXXXXXXXXXXXXXXXXXXXGXXXXXXXXXXXXXXXXXXXGXXXXXXXXXXXXXXXXXXXGXXXXXXXXXXXXXXXXXXXGXXXXXXXXXXXXXXXXXXX,0,10,0
43071,14,1,13,76,510,0,0,526,419,107,GXXXXXXXXXXXXXXXXXXXGXXXXXXXXXXXXXXXXXXXGXXXXXXXXXXXXXXXXXXXGXXXXXXXXXXXXXXXXXXXGXXXXXXXXXXXXXXXXXXXGXXXXXXXXXXXXXXXXXXXGXXXXXXXXXXXXXXXXXXXGAXXXXXXXXXXXXXXXXXXGXXXXXXXXXXXXXXXXXXXGXXXXXXXXXXXXXXXXXXXGXXXXXXXXXXXXXXXXXXXGXXXXXXXXXXXXXXXXXXXGXXXXXXXXXXXXXXXXXXX,0,10,0
43092,15,2,13,72,513,0,0,528,415,113,GXXXXXXXXXXXXXXXXXXXGXXXXXXXXXXXXXXXXXXXGAXXXXXXXXXXXXXXXXXXGXXXXXXXXXXXXXXXXXXXGXXXXXXXXXXXXXXXXXXXGXXXXXXXXXXXXXXXXXXXGXXXXXXXXXXXXXXXXXXXGAXXXXXXXXXXXXXXXXXXGXXXXXXXXXXXXXXXXXXXGXXXXXXXXXXXXXXXXXXXGXXXXXXXXXXXXXXXXXXXGXXXXXXXXXXXXXXXXXXXGXXXXXXXXXXXXXXXXXXX,0,10,0
43113,15,2,13,69,516,0,0,532,416,116,GXXXXXXXXXXXXXXXXXXXGXXXXXXXXXXXXXXXXXXXGAXXXXXXXXXXXXXXXXXXGXXXXXXXXXXXXXXXXXXXGXXXXXXXXXXXXXXXXXXXGXXXXXXXXXXXXXXXXXXXGXXXXXXXXXXXXXXXXXXXGAXXXXXXXXXXXXXXXXXXGXXXXXXXXXXXXXXXXXXXGXXXXXXXXXXXXXXXXXXXGXXXXXXXXXXXXXXXXXXXGXXXXXXXXXXXXXXXXXXXGXXXXXXXXXXXXXXXXXXX,0,10,0
43134,15,2,13,62,523,0,0,540,423,117,GXXXXXXXXXXXXXXXXXXXGXXXXXXXXXXXXXXXXXXXGAXXXXXXXXXXXXXXXXXXGXXXXXXXXXXXXXXXXXXXGXXXXXXXXXXXXXXXXXXXGXXXXXXXXXXXXXXXXXXXGXXXXXXXXXXXXXXXXXXXGAXXXXXXXXXXXXXXXXXXGXXXXXXXXXXXXXXXXXXXGXXXXXXXXXXXXXXXXXXXGXXXXXXXXXXXXXXXXXXXGXXXXXXXXXXXXXXXXXXXGXXXXXXXXXXXXXXXXXXX,0,10,0

43155,14,1,13,65,521,0,0,537,423,114,GXXXXXXXXXXXXXXXXXXXGXXXXXXXXXXXXXXXXXXXGAXXXXXXXXXXXXXXXXXXGXXXXXXXXXXXXXXXXXXXGXXXXXXXXXXXXXXXXXXXGXXXXXXXXXXXXXXXXXXXGXXXXXXXXXXXXXXXXXXXGXXXXXXXXXXXXXXXXXXXGXXXXXXXXXXXXXXXXXXXGXXXXXXXXXXXXXXXXXXXGXXXXXXXXXXXXXXXXXXXGXXXXXXXXXXXXXXXXXXXGXXXXXXXXXXXXXXXXXXX,0,10,0
43176,14,1,13,61,525,0,0,542,421,121,GXXXXXXXXXXXXXXXXXXXGXXXXXXXXXXXXXXXXXXXGAXXXXXXXXXXXXXXXXXXGXXXXXXXXXXXXXXXXXXXGXXXXXXXXXXXXXXXXXXXGXXXXXXXXXXXXXXXXXXXGXXXXXXXXXXXXXXXXXXXGXXXXXXXXXXXXXXXXXXXGXXXXXXXXXXXXXXXXXXXGXXXXXXXXXXXXXXXXXXXGXXXXXXXXXXXXXXXXXXXGXXXXXXXXXXXXXXXXXXXGXXXXXXXXXXXXXXXXXXX,0,10,0
43197,14,1,13,59,527,0,0,544,420,124,GXXXXXXXXXXXXXXXXXXXGXXXXXXXXXXXXXXXXXXXGAXXXXXXXXXXXXXXXXXXGXXXXXXXXXXXXXXXXXXXGXXXXXXXXXXXXXXXXXXXGXXXXXXXXXXXXXXXXXXXGXXXXXXXXXXXXXXXXXXXGXXXXXXXXXXXXXXXXXXXGXXXXXXXXXXXXXXXXXXXGXXXXXXXXXXXXXXXXXXXGXXXXXXXXXXXXXXXXXXXGXXXXXXXXXXXXXXXXXXXGXXXXXXXXXXXXXXXXXXX,0,10,0
43218,14,1,13,60,526,0,0,542,419,123,GXXXXXXXXXXXXXXXXXXXGXXXXXXXXXXXXXXXXXXXGAXXXXXXXXXXXXXXXXXXGXXXXXXXXXXXXXXXXXXXGXXXXXXXXXXXXXXXXXXXGXXXXXXXXXXXXXXXXXXXGXXXXXXXXXXXXXXXXXXXGXXXXXXXXXXXXXXXXXXXGXXXXXXXXXXXXXXXXXXXGXXXXXXXXXXXXXXXXXXXGXXXXXXXXXXXXXXXXXXXGXXXXXXXXXXXXXXXXXXXGXXXXXXXXXXXXXXXXXXX,0,10,0
43239,14,1,13,57,529,0,0,545,421,124,GXXXXXXXXXXXXXXXXXXXGXXXXXXXXXXXXXXXXXXXGAXXXXXXXXXXXXXXXXXXGXXXXXXXXXXXXXXXXXXXGXXXXXXXXXXXXXXXXXXXGXXXXXXXXXXXXXXXXXXXGXXXXXXXXXXXXXXXXXXXGXXXXXXXXXXXXXXXXXXXGXXXXXXXXXXXXXXXXXXXGXXXXXXXXXXXXXXXXXXXGXXXXXXXXXXXXXXXXXXXGXXXXXXXXXXXXXXXXXXXGXXXXXXXXXXXXXXXXXXX,0,10,0

43260,14,1,13,58,528,0,0,544,417,127,GXXXXXXXXXXXXXXXXXXXGXXXXXXXXXXXXXXXXXXXGAXXXXXXXXXXXXXXXXXXGXXXXXXXXXXXXXXXXXXXGXXXXXXXXXXXXXXXXXXXGXXXXXXXXXXXXXXXXXXXGXXXXXXXXXXXXXXXXXXXGXXXXXXXXXXXXXXXXXXXGXXXXXXXXXXXXXXXXXXXGXXXXXXXXXXXXXXXXXXXGXXXXXXXXXXXXXXXXXXXGXXXXXXXXXXXXXXXXXXXGXXXXXXXXXXXXXXXXXXX,0,10,0
43281,14,1,13,54,532,0,0,547,421,126,GXXXXXXXXXXXXXXXXXXXGXXXXXXXXXXXXXXXXXXXGAXXXXXXXXXXXXXXXXXXGXXXXXXXXXXXXXXXXXXXGXXXXXXXXXXXXXXXXXXXGXXXXXXXXXXXXXXXXXXXGXXXXXXXXXXXXXXXXXXXGXXXXXXXXXXXXXXXXXXXGXXXXXXXXXXXXXXXXXXXGXXXXXXXXXXXXXXXXXXXGXXXXXXXXXXXXXXXXXXXGXXXXXXXXXXXXXXXXXXXGXXXXXXXXXXXXXXXXXXX,0,10,0
43302,14,1,13,57,529,0,0,544,424,120,GXXXXXXXXXXXXXXXXXXXGXXXXXXXXXXXXXXXXXXXGAXXXXXXXXXXXXXXXXXXGXXXXXXXXXXXXXXXXXXXGXXXXXXXXXXXXXXXXXXXGXXXXXXXXXXXXXXXXXXXGXXXXXXXXXXXXXXXXXXXGXXXXXXXXXXXXXXXXXXXGXXXXXXXXXXXXXXXXXXXGXXXXXXXXXXXXXXXXXXXGXXXXXXXXXXXXXXXXXXXGXXXXXXXXXXXXXXXXXXXGXXXXXXXXXXXXXXXXXXX,0,10,0
43323,14,0,14,57,529,0,0,542,420,122,GXXXXXXXXXXXXXXXXXXXGXXXXXXXXXXXXXXXXXXXGOXXXXXXXXXXXXXXXXXXGXXXXXXXXXXXXXXXXXXXGXXXXXXXXXXXXXXXXXXXGXXXXXXXXXXXXXXXXXXXGXXXXXXXXXXXXXXXXXXXGXXXXXXXXXXXXXXXXXXXGXXXXXXXXXXXXXXXXXXXGXXXXXXXXXXXXXXXXXXXGXXXXXXXXXXXXXXXXXXXGXXXXXXXXXXXXXXXXXXXGXXXXXXXXXXXXXXXXXXX,0,10,0
43344,14,0,14,62,524,0,0,538,416,122,GXXXXXXXXXXXXXXXXXXXGXXXXXXXXXXXXXXXXXXXGOXXXXXXXXXXXXXXXXXXGXXXXXXXXXXXXXXXXXXXGXXXXXXXXXXXXXXXXXXXGXXXXXXXXXXXXXXXXXXXGXXXXXXXXXXXXXXXXXXXGXXXXXXXXXXXXXXXXXXXGXXXXXXXXXXXXXXXXXXXGXXXXXXXXXXXXXXXXXXXGXXXXXXXXXXXXXXXXXXXGXXXXXXXXXXXXXXXXXXXGXXXXXXXXXXXXXXXXXXX,0,10,0

43365,13,0,13,61,526,0,0,540,420,120,GXXXXXXXXXXXXXXXXXXXGXXXXXXXXXXXXXXXXXXXGXXXXXXXXXXXXXXXXXXXGXXXXXXXXXXXXXXXXXXXGXXXXXXXXXXXXXXXXXXXGXXXXXXXXXXXXXXXXXXXGXXXXXXXXXXXXXXXXXXXGXXXXXXXXXXXXXXXXXXXGXXXXXXXXXXXXXXXXXXXGXXXXXXXXXXXXXXXXXXXGXXXXXXXXXXXXXXXXXXXGXXXXXXXXXXXXXXXXXXXGXXXXXXXXXXXXXXXXXXX,0,10,0
43386,13,0,13,60,527,0,0,540,422,118,GXXXXXXXXXXXXXXXXXXXGXXXXXXXXXXXXXXXXXXXGXXXXXXXXXXXXXXXXXXXGXXXXXXXXXXXXXXXXXXXGXXXXXXXXXXXXXXXXXXXGXXXXXXXXXXXXXXXXXXXGXXXXXXXXXXXXXXXXXXXGXXXXXXXXXXXXXXXXXXXGXXXXXXXXXXXXXXXXXXXGXXXXXXXXXXXXXXXXXXXGXXXXXXXXXXXXXXXXXXXGXXXXXXXXXXXXXXXXXXXGXXXXXXXXXXXXXXXXXXX,0,10,0
43407,13,0,13,60,527,0,0,541,419,122,GXXXXXXXXXXXXXXXXXXXGXXXXXXXXXXXXXXXXXXXGXXXXXXXXXXXXXXXXXXXGXXXXXXXXXXXXXXXXXXXGXXXXXXXXXXXXXXXXXXXGXXXXXXXXXXXXXXXXXXXGXXXXXXXXXXXXXXXXXXXGXXXXXXXXXXXXXXXXXXXGXXXXXXXXXXXXXXXXXXXGXXXXXXXXXXXXXXXXXXXGXXXXXXXXXXXXXXXXXXXGXXXXXXXXXXXXXXXXXXXGXXXXXXXXXXXXXXXXXXX,0,10,0
43428,13,0,13,57,530,0,0,542,424,118,GXXXXXXXXXXXXXXXXXXXGXXXXXXXXXXXXXXXXXXXGXXXXXXXXXXXXXXXXXXXGXXXXXXXXXXXXXXXXXXXGXXXXXXXXXXXXXXXXXXXGXXXXXXXXXXXXXXXXXXXGXXXXXXXXXXXXXXXXXXXGXXXXXXXXXXXXXXXXXXXGXXXXXXXXXXXXXXXXXXXGXXXXXXXXXXXXXXXXXXXGXXXXXXXXXXXXXXXXXXXGXXXXXXXXXXXXXXXXXXXGXXXXXXXXXXXXXXXXXXX,0,10,0
43449,13,0,13,57,530,0,0,544,426,118,GXXXXXXXXXXXXXXXXXXXGXXXXXXXXXXXXXXXXXXXGXXXXXXXXXXXXXXXXXXXGXXXXXXXXXXXXXXXXXXXGXXXXXXXXXXXXXXXXXXXGXXXXXXXXXXXXXXXXXXXGXXXXXXXXXXXXXXXXXXXGXXXXXXXXXXXXXXXXXXXGXXXXXXXXXXXXXXXXXXXGXXXXXXXXXXXXXXXXXXXGXXXXXXXXXXXXXXXXXXXGXXXXXXXXXXXXXXXXXXXGXXXXXXXXXXXXXXXXXXX,0,10,0

43470,13,0,13,59,528,0,0,541,426,115,GXXXXXXXXXXXXXXXXXXXGXXXXXXXXXXXXXXXXXXXGXXXXXXXXXXXXXXXXXXXGXXXXXXXXXXXXXXXXXXXGXXXXXXXXXXXXXXXXXXXGXXXXXXXXXXXXXXXXXXXGXXXXXXXXXXXXXXXXXXXGXXXXXXXXXXXXXXXXXXXGXXXXXXXXXXXXXXXXXXXGXXXXXXXXXXXXXXXXXXXGXXXXXXXXXXXXXXXXXXXGXXXXXXXXXXXXXXXXXXXGXXXXXXXXXXXXXXXXXXX,0,10,0
43491,13,0,13,61,526,0,0,540,426,114,GXXXXXXXXXXXXXXXXXXXGXXXXXXXXXXXXXXXXXXXGXXXXXXXXXXXXXXXXXXXGXXXXXXXXXXXXXXXXXXXGXXXXXXXXXXXXXXXXXXXGXXXXXXXXXXXXXXXXXXXGXXXXXXXXXXXXXXXXXXXGXXXXXXXXXXXXXXXXXXXGXXXXXXXXXXXXXXXXXXXGXXXXXXXXXXXXXXXXXXXGXXXXXXXXXXXXXXXXXXXGXXXXXXXXXXXXXXXXXXXGXXXXXXXXXXXXXXXXXXX,0,10,0
43512,14,1,13,54,532,0,0,546,430,116,GXXXXXXXXXXXXXXXXXXXGXXXXXXXXXXXXXXXXXXXGXXXXXXXXXXXXXXXXXXXGXXXXXXXXXXXXXXXXXXXGXXXXXXXXXXXXXXXXXXXGAXXXXXXXXXXXXXXXXXXGXXXXXXXXXXXXXXXXXXXGXXXXXXXXXXXXXXXXXXXGXXXXXXXXXXXXXXXXXXXGXXXXXXXXXXXXXXXXXXXGXXXXXXXXXXXXXXXXXXXGXXXXXXXXXXXXXXXXXXXGXXXXXXXXXXXXXXXXXXX,0,10,0
43533,14,1,13,59,527,0,0,542,426,116,GXXXXXXXXXXXXXXXXXXXGXXXXXXXXXXXXXXXXXXXGXXXXXXXXXXXXXXXXXXXGXXXXXXXXXXXXXXXXXXXGXXXXXXXXXXXXXXXXXXXGAXXXXXXXXXXXXXXXXXXGXXXXXXXXXXXXXXXXXXXGXXXXXXXXXXXXXXXXXXXGXXXXXXXXXXXXXXXXXXXGXXXXXXXXXXXXXXXXXXXGXXXXXXXXXXXXXXXXXXXGXXXXXXXXXXXXXXXXXXXGXXXXXXXXXXXXXXXXXXX,0,10,0
43554,14,0,14,61,525,0,0,540,422,118,GXXXXXXXXXXXXXXXXXXXGXXXXXXXXXXXXXXXXXXXGXXXXXXXXXXXXXXXXXXXGXXXXXXXXXXXXXXXXXXXGXXXXXXXXXXXXXXXXXXXGOXXXXXXXXXXXXXXXXXXGXXXXXXXXXXXXXXXXXXXGXXXXXXXXXXXXXXXXXXXGXXXXXXXXXXXXXXXXXXXGXXXXXXXXXXXXXXXXXXXGXXXXXXXXXXXXXXXXXXXGXXXXXXXXXXXXXXXXXXXGXXXXXXXXXXXXXXXXXXX,0,10,0

43575,14,0,14,58,528,0,0,542,424,118,GXXXXXXXXXXXXXXXXXXXGXXXXXXXXXXXXXXXXXXXGXXXXXXXXXXXXXXXXXXXGXXXXXXXXXXXXXXXXXXXGXXXXXXXXXXXXXXXXXXXGOXXXXXXXXXXXXXXXXXXGXXXXXXXXXXXXXXXXXXXGXXXXXXXXXXXXXXXXXXXGXXXXXXXXXXXXXXXXXXXGXXXXXXXXXXXXXXXXXXXGXXXXXXXXXXXXXXXXXXXGXXXXXXXXXXXXXXXXXXXGXXXXXXXXXXXXXXXXXXX,0,10,0
43596,14,0,14,64,522,0,0,538,426,112,GXXXXXXXXXXXXXXXXXXXGXXXXXXXXXXXXXXXXXXXGXXXXXXXXXXXXXXXXXXXGXXXXXXXXXXXXXXXXXXXGXXXXXXXXXXXXXXXXXXXGOXXXXXXXXXXXXXXXXXXGXXXXXXXXXXXXXXXXXXXGXXXXXXXXXXXXXXXXXXXGXXXXXXXXXXXXXXXXXXXGXXXXXXXXXXXXXXXXXXXGXXXXXXXXXXXXXXXXXXXGXXXXXXXXXXXXXXXXXXXGXXXXXXXXXXXXXXXXXXX,0,10,0
43617,14,1,13,62,524,0,0,539,423,116,GXXXXXXXXXXXXXXXXXXXGXXXXXXXXXXXXXXXXXXXGXXXXXXXXXXXXXXXXXXXGXXXXXXXXXXXXXXXXXXXGXXXXXXXXXXXXXXXXXXXGXXXXXXXXXXXXXXXXXXXGXXXXXXXXXXXXXXXXXXXGAXXXXXXXXXXXXXXXXXXGXXXXXXXXXXXXXXXXXXXGXXXXXXXXXXXXXXXXXXXGXXXXXXXXXXXXXXXXXXXGXXXXXXXXXXXXXXXXXXXGXXXXXXXXXXXXXXXXXXX,0,10,0
43638,14,1,13,57,529,0,0,544,426,118,GXXXXXXXXXXXXXXXXXXXGXXXXXXXXXXXXXXXXXXXGXXXXXXXXXXXXXXXXXXXGXXXXXXXXXXXXXXXXXXXGXXXXXXXXXXXXXXXXXXXGXXXXXXXXXXXXXXXXXXXGXXXXXXXXXXXXXXXXXXXGAXXXXXXXXXXXXXXXXXXGXXXXXXXXXXXXXXXXXXXGXXXXXXXXXXXXXXXXXXXGXXXXXXXXXXXXXXXXXXXGXXXXXXXXXXXXXXXXXXXGXXXXXXXXXXXXXXXXXXX,0,10,0
43659,14,1,13,59,527,0,0,542,426,116,GXXXXXXXXXXXXXXXXXXXGXXXXXXXXXXXXXXXXXXXGXXXXXXXXXXXXXXXXXXXGXXXXXXXXXXXXXXXXXXXGXXXXXXXXXXXXXXXXXXXGXXXXXXXXXXXXXXXXXXXGXXXXXXXXXXXXXXXXXXXGAXXXXXXXXXXXXXXXXXXGXXXXXXXXXXXXXXXXXXXGXXXXXXXXXXXXXXXXXXXGXXXXXXXXXXXXXXXXXXXGXXXXXXXXXXXXXXXXXXXGXXXXXXXXXXXXXXXXXXX,0,10,0

43680,14,1,13,59,527,0,0,543,421,122,GXXXXXXXXXXXXXXXXXXXGXXXXXXXXXXXXXXXXXXXGXXXXXXXXXXXXXXXXXXXGXXXXXXXXXXXXXXXXXXXGXXXXXXXXXXXXXXXXXXXGXXXXXXXXXXXXXXXXXXXGXXXXXXXXXXXXXXXXXXXGAXXXXXXXXXXXXXXXXXXGXXXXXXXXXXXXXXXXXXXGXXXXXXXXXXXXXXXXXXXGXXXXXXXXXXXXXXXXXXXGXXXXXXXXXXXXXXXXXXXGXXXXXXXXXXXXXXXXXXX,0,10,0
43701,14,1,13,59,527,0,0,543,422,121,GXXXXXXXXXXXXXXXXXXXGXXXXXXXXXXXXXXXXXXXGXXXXXXXXXXXXXXXXXXXGXXXXXXXXXXXXXXXXXXXGXXXXXXXXXXXXXXXXXXXGXXXXXXXXXXXXXXXXXXXGXXXXXXXXXXXXXXXXXXXGAXXXXXXXXXXXXXXXXXXGXXXXXXXXXXXXXXXXXXXGXXXXXXXXXXXXXXXXXXXGXXXXXXXXXXXXXXXXXXXGXXXXXXXXXXXXXXXXXXXGXXXXXXXXXXXXXXXXXXX,0,10,0
43722,14,1,13,62,524,0,0,540,423,117,GXXXXXXXXXXXXXXXXXXXGXXXXXXXXXXXXXXXXXXXGXXXXXXXXXXXXXXXXXXXGXXXXXXXXXXXXXXXXXXXGXXXXXXXXXXXXXXXXXXXGXXXXXXXXXXXXXXXXXXXGXXXXXXXXXXXXXXXXXXXGAXXXXXXXXXXXXXXXXXXGXXXXXXXXXXXXXXXXXXXGXXXXXXXXXXXXXXXXXXXGXXXXXXXXXXXXXXXXXXXGXXXXXXXXXXXXXXXXXXXGXXXXXXXXXXXXXXXXXXX,0,10,0
43743,14,1,13,61,525,0,0,540,427,113,GXXXXXXXXXXXXXXXXXXXGXXXXXXXXXXXXXXXXXXXGXXXXXXXXXXXXXXXXXXXGXXXXXXXXXXXXXXXXXXXGXXXXXXXXXXXXXXXXXXXGXXXXXXXXXXXXXXXXXXXGXXXXXXXXXXXXXXXXXXXGAXXXXXXXXXXXXXXXXXXGXXXXXXXXXXXXXXXXXXXGXXXXXXXXXXXXXXXXXXXGXXXXXXXXXXXXXXXXXXXGXXXXXXXXXXXXXXXXXXXGXXXXXXXXXXXXXXXXXXX,0,10,0
43764,14,1,13,63,523,0,0,538,427,111,GXXXXXXXXXXXXXXXXXXXGXXXXXXXXXXXXXXXXXXXGXXXXXXXXXXXXXXXXXXXGXXXXXXXXXXXXXXXXXXXGXXXXXXXXXXXXXXXXXXXGXXXXXXXXXXXXXXXXXXXGXXXXXXXXXXXXXXXXXXXGAXXXXXXXXXXXXXXXXXXGXXXXXXXXXXXXXXXXXXXGXXXXXXXXXXXXXXXXXXXGXXXXXXXXXXXXXXXXXXXGXXXXXXXXXXXXXXXXXXXGXXXXXXXXXXXXXXXXXXX,0,10,0

43785,15,2,13,58,527,0,0,542,427,115,GXXXXXXXXXXXXXXXXXXXGXXXXXXXXXXXXXXXXXXXGXXXXXXXXXXXXXXXXXXXGXXXXXXXXXXXXXXXXXXXGXXXXXXXXXXXXXXXXXXXGXXXXXXXXXXXXXXXXXXXGXXXXXXXXXXXXXXXXXXXGAXXXXXXXXXXXXXXXXXXGAXXXXXXXXXXXXXXXXXXGXXXXXXXXXXXXXXXXXXXGXXXXXXXXXXXXXXXXXXXGXXXXXXXXXXXXXXXXXXXGXXXXXXXXXXXXXXXXXXX,0,10,0
43806,15,2,13,60,525,0,0,541,425,116,GXXXXXXXXXXXXXXXXXXXGXXXXXXXXXXXXXXXXXXXGXXXXXXXXXXXXXXXXXXXGXXXXXXXXXXXXXXXXXXXGXXXXXXXXXXXXXXXXXXXGXXXXXXXXXXXXXXXXXXXGXXXXXXXXXXXXXXXXXXXGAXXXXXXXXXXXXXXXXXXGAXXXXXXXXXXXXXXXXXXGXXXXXXXXXXXXXXXXXXXGXXXXXXXXXXXXXXXXXXXGXXXXXXXXXXXXXXXXXXXGXXXXXXXXXXXXXXXXXXX,0,10,0
43827,15,2,13,56,529,0,0,544,431,113,GXXXXXXXXXXXXXXXXXXXGXXXXXXXXXXXXXXXXXXXGXXXXXXXXXXXXXXXXXXXGXXXXXXXXXXXXXXXXXXXGXXXXXXXXXXXXXXXXXXXGXXXXXXXXXXXXXXXXXXXGXXXXXXXXXXXXXXXXXXXGAXXXXXXXXXXXXXXXXXXGAXXXXXXXXXXXXXXXXXXGXXXXXXXXXXXXXXXXXXXGXXXXXXXXXXXXXXXXXXXGXXXXXXXXXXXXXXXXXXXGXXXXXXXXXXXXXXXXXXX,0,10,0
43848,15,2,13,59,526,0,0,543,435,108,GXXXXXXXXXXXXXXXXXXXGXXXXXXXXXXXXXXXXXXXGXXXXXXXXXXXXXXXXXXXGAXXXXXXXXXXXXXXXXXXGXXXXXXXXXXXXXXXXXXXGXXXXXXXXXXXXXXXXXXXGXXXXXXXXXXXXXXXXXXXGXXXXXXXXXXXXXXXXXXXGAXXXXXXXXXXXXXXXXXXGXXXXXXXXXXXXXXXXXXXGXXXXXXXXXXXXXXXXXXXGXXXXXXXXXXXXXXXXXXXGXXXXXXXXXXXXXXXXXXX,0,10,0
43869,16,2,14,58,526,0,0,542,427,115,GXXXXXXXXXXXXXXXXXXXGXXXXXXXXXXXXXXXXXXXGXXXXXXXXXXXXXXXXXXXGAXXXXXXXXXXXXXXXXXXGXXXXXXXXXXXXXXXXXXXGXXXXXXXXXXXXXXXXXXXGAXXXXXXXXXXXXXXXXXXGXXXXXXXXXXXXXXXXXXXGOXXXXXXXXXXXXXXXXXXGXXXXXXXXXXXXXXXXXXXGXXXXXXXXXXXXXXXXXXXGXXXXXXXXXXXXXXXXXXXGXXXXXXXXXXXXXXXXXXX,0,10,0

43890,16,2,14,56,528,0,0,545,426,119,GXXXXXXXXXXXXXXXXXXXGXXXXXXXXXXXXXXXXXXXGXXXXXXXXXXXXXXXXXXXGAXXXXXXXXXXXXXXXXXXGXXXXXXXXXXXXXXXXXXXGXXXXXXXXXXXXXXXXXXXGAXXXXXXXXXXXXXXXXXXGXXXXXXXXXXXXXXXXXXXGOXXXXXXXXXXXXXXXXXXGXXXXXXXXXXXXXXXXXXXGXXXXXXXXXXXXXXXXXXXGXXXXXXXXXXXXXXXXXXXGXXXXXXXXXXXXXXXXXXX,0,10,0
43911,14,1,13,57,529,0,0,546,427,119,GXXXXXXXXXXXXXXXXXXXGXXXXXXXXXXXXXXXXXXXGXXXXXXXXXXXXXXXXXXXGAXXXXXXXXXXXXXXXXXXGXXXXXXXXXXXXXXXXXXXGXXXXXXXXXXXXXXXXXXXGXXXXXXXXXXXXXXXXXXXGXXXXXXXXXXXXXXXXXXXGXXXXXXXXXXXXXXXXXXXGXXXXXXXXXXXXXXXXXXXGXXXXXXXXXXXXXXXXXXXGXXXXXXXXXXXXXXXXXXXGXXXXXXXXXXXXXXXXXXX,0,10,0
43932,14,1,13,58,528,0,0,545,430,115,GXXXXXXXXXXXXXXXXXXXGXXXXXXXXXXXXXXXXXXXGXXXXXXXXXXXXXXXXXXXGAXXXXXXXXXXXXXXXXXXGXXXXXXXXXXXXXXXXXXXGXXXXXXXXXXXXXXXXXXXGXXXXXXXXXXXXXXXXXXXGXXXXXXXXXXXXXXXXXXXGXXXXXXXXXXXXXXXXXXXGXXXXXXXXXXXXXXXXXXXGXXXXXXXXXXXXXXXXXXXGXXXXXXXXXXXXXXXXXXXGXXXXXXXXXXXXXXXXXXX,0,10,0
43953,14,1,13,62,524,0,0,541,425,116,GXXXXXXXXXXXXXXXXXXXGXXXXXXXXXXXXXXXXXXXGXXXXXXXXXXXXXXXXXXXGAXXXXXXXXXXXXXXXXXXGXXXXXXXXXXXXXXXXXXXGXXXXXXXXXXXXXXXXXXXGXXXXXXXXXXXXXXXXXXXGXXXXXXXXXXXXXXXXXXXGXXXXXXXXXXXXXXXXXXXGXXXXXXXXXXXXXXXXXXXGXXXXXXXXXXXXXXXXXXXGXXXXXXXXXXXXXXXXXXXGXXXXXXXXXXXXXXXXXXX,0,10,0
43974,14,0,14,64,522,0,0,539,425,114,GXXXXXXXXXXXXXXXXXXXGXXXXXXXXXXXXXXXXXXXGXXXXXXXXXXXXXXXXXXXGOXXXXXXXXXXXXXXXXXXGXXXXXXXXXXXXXXXXXXXGXXXXXXXXXXXXXXXXXXXGXXXXXXXXXXXXXXXXXXXGXXXXXXXXXXXXXXXXXXXGXXXXXXXXXXXXXXXXXXXGXXXXXXXXXXXXXXXXXXXGXXXXXXXXXXXXXXXXXXXGXXXXXXXXXXXXXXXXXXXGXXXXXXXXXXXXXXXXXXX,0,10,0

43995,14,0,14,65,521,0,0,538,429,109,GXXXXXXXXXXXXXXXXXXXGXXXXXXXXXXXXXXXXXXXGXXXXXXXXXXXXXXXXXXXGOXXXXXXXXXXXXXXXXXXGXXXXXXXXXXXXXXXXXXXGXXXXXXXXXXXXXXXXXXXGXXXXXXXXXXXXXXXXXXXGXXXXXXXXXXXXXXXXXXXGXXXXXXXXXXXXXXXXXXXGXXXXXXXXXXXXXXXXXXXGXXXXXXXXXXXXXXXXXXXGXXXXXXXXXXXXXXXXXXXGXXXXXXXXXXXXXXXXXXX,0,10,0
44016,13,0,13,65,522,0,0,537,426,111,GXXXXXXXXXXXXXXXXXXXGXXXXXXXXXXXXXXXXXXXGXXXXXXXXXXXXXXXXXXXGXXXXXXXXXXXXXXXXXXXGXXXXXXXXXXXXXXXXXXXGXXXXXXXXXXXXXXXXXXXGXXXXXXXXXXXXXXXXXXXGXXXXXXXXXXXXXXXXXXXGXXXXXXXXXXXXXXXXXXXGXXXXXXXXXXXXXXXXXXXGXXXXXXXXXXXXXXXXXXXGXXXXXXXXXXXXXXXXXXXGXXXXXXXXXXXXXXXXXXX,0,10,0
44037,13,0,13,70,517,0,0,532,426,106,GXXXXXXXXXXXXXXXXXXXGXXXXXXXXXXXXXXXXXXXGXXXXXXXXXXXXXXXXXXXGXXXXXXXXXXXXXXXXXXXGXXXXXXXXXXXXXXXXXXXGXXXXXXXXXXXXXXXXXXXGXXXXXXXXXXXXXXXXXXXGXXXXXXXXXXXXXXXXXXXGXXXXXXXXXXXXXXXXXXXGXXXXXXXXXXXXXXXXXXXGXXXXXXXXXXXXXXXXXXXGXXXXXXXXXXXXXXXXXXXGXXXXXXXXXXXXXXXXXXX,0,10,0
44058,13,0,13,70,517,0,0,532,424,108,GXXXXXXXXXXXXXXXXXXXGXXXXXXXXXXXXXXXXXXXGXXXXXXXXXXXXXXXXXXXGXXXXXXXXXXXXXXXXXXXGXXXXXXXXXXXXXXXXXXXGXXXXXXXXXXXXXXXXXXXGXXXXXXXXXXXXXXXXXXXGXXXXXXXXXXXXXXXXXXXGXXXXXXXXXXXXXXXXXXXGXXXXXXXXXXXXXXXXXXXGXXXXXXXXXXXXXXXXXXXGXXXXXXXXXXXXXXXXXXXGXXXXXXXXXXXXXXXXXXX,0,10,0
44079,13,0,13,67,520,0,0,535,427,108,GXXXXXXXXXXXXXXXXXXXGXXXXXXXXXXXXXXXXXXXGXXXXXXXXXXXXXXXXXXXGXXXXXXXXXXXXXXXXXXXGXXXXXXXXXXXXXXXXXXXGXXXXXXXXXXXXXXXXXXXGXXXXXXXXXXXXXXXXXXXGXXXXXXXXXXXXXXXXXXXGXXXXXXXXXXXXXXXXXXXGXXXXXXXXXXXXXXXXXXXGXXXXXXXXXXXXXXXXXXXGXXXXXXXXXXXXXXXXXXXGXXXXXXXXXXXXXXXXXXX,0,10,0

44100,13,0,13,64,523,0,0,538,425,113,GXXXXXXXXXXXXXXXXXXXGXXXXXXXXXXXXXXXXXXXGXXXXXXXXXXXXXXXXXXXGXXXXXXXXXXXXXXXXXXXGXXXXXXXXXXXXXXXXXXXGXXXXXXXXXXXXXXXXXXXGXXXXXXXXXXXXXXXXXXXGXXXXXXXXXXXXXXXXXXXGXXXXXXXXXXXXXXXXXXXGXXXXXXXXXXXXXXXXXXXGXXXXXXXXXXXXXXXXXXXGXXXXXXXXXXXXXXXXXXXGXXXXXXXXXXXXXXXXXXX,0,10,0
44121,13,0,13,67,520,0,0,535,424,111,GXXXXXXXXXXXXXXXXXXXGXXXXXXXXXXXXXXXXXXXGXXXXXXXXXXXXXXXXXXXGXXXXXXXXXXXXXXXXXXXGXXXXXXXXXXXXXXXXXXXGXXXXXXXXXXXXXXXXXXXGXXXXXXXXXXXXXXXXXXXGXXXXXXXXXXXXXXXXXXXGXXXXXXXXXXXXXXXXXXXGXXXXXXXXXXXXXXXXXXXGXXXXXXXXXXXXXXXXXXXGXXXXXXXXXXXXXXXXXXXGXXXXXXXXXXXXXXXXXXX,0,10,0
44142,13,0,13,66,521,0,0,536,424,112,GXXXXXXXXXXXXXXXXXXXGXXXXXXXXXXXXXXXXXXXGXXXXXXXXXXXXXXXXXXXGXXXXXXXXXXXXXXXXXXXGXXXXXXXXXXXXXXXXXXXGXXXXXXXXXXXXXXXXXXXGXXXXXXXXXXXXXXXXXXXGXXXXXXXXXXXXXXXXXXXGXXXXXXXXXXXXXXXXXXXGXXXXXXXXXXXXXXXXXXXGXXXXXXXXXXXXXXXXXXXGXXXXXXXXXXXXXXXXXXXGXXXXXXXXXXXXXXXXXXX,0,10,0
44163,13,0,13,67,520,0,0,535,427,108,GXXXXXXXXXXXXXXXXXXXGXXXXXXXXXXXXXXXXXXXGXXXXXXXXXXXXXXXXXXXGXXXXXXXXXXXXXXXXXXXGXXXXXXXXXXXXXXXXXXXGXXXXXXXXXXXXXXXXXXXGXXXXXXXXXXXXXXXXXXXGXXXXXXXXXXXXXXXXXXXGXXXXXXXXXXXXXXXXXXXGXXXXXXXXXXXXXXXXXXXGXXXXXXXXXXXXXXXXXXXGXXXXXXXXXXXXXXXXXXXGXXXXXXXXXXXXXXXXXXX,0,10,0
44184,13,0,13,66,521,0,0,536,429,107,GXXXXXXXXXXXXXXXXXXXGXXXXXXXXXXXXXXXXXXXGXXXXXXXXXXXXXXXXXXXGXXXXXXXXXXXXXXXXXXXGXXXXXXXXXXXXXXXXXXXGXXXXXXXXXXXXXXXXXXXGXXXXXXXXXXXXXXXXXXXGXXXXXXXXXXXXXXXXXXXGXXXXXXXXXXXXXXXXXXXGXXXXXXXXXXXXXXXXXXXGXXXXXXXXXXXXXXXXXXXGXXXXXXXXXXXXXXXXXXXGXXXXXXXXXXXXXXXXXXX,0,10,0

44205,13,0,13,67,520,0,0,532,427,105,GXXXXXXXXXXXXXXXXXXXGXXXXXXXXXXXXXXXXXXXGXXXXXXXXXXXXXXXXXXXGXXXXXXXXXXXXXXXXXXXGXXXXXXXXXXXXXXXXXXXGXXXXXXXXXXXXXXXXXXXGXXXXXXXXXXXXXXXXXXXGXXXXXXXXXXXXXXXXXXXGXXXXXXXXXXXXXXXXXXXGXXXXXXXXXXXXXXXXXXXGXXXXXXXXXXXXXXXXXXXGXXXXXXXXXXXXXXXXXXXGXXXXXXXXXXXXXXXXXXX,0,10,0
44226,13,0,13,60,527,0,0,539,431,108,GXXXXXXXXXXXXXXXXXXXGXXXXXXXXXXXXXXXXXXXGXXXXXXXXXXXXXXXXXXXGXXXXXXXXXXXXXXXXXXXGXXXXXXXXXXXXXXXXXXXGXXXXXXXXXXXXXXXXXXXGXXXXXXXXXXXXXXXXXXXGXXXXXXXXXXXXXXXXXXXGXXXXXXXXXXXXXXXXXXXGXXXXXXXXXXXXXXXXXXXGXXXXXXXXXXXXXXXXXXXGXXXXXXXXXXXXXXXXXXXGXXXXXXXXXXXXXXXXXXX,0,10,0
44247,13,0,13,63,524,0,0,537,428,109,GXXXXXXXXXXXXXXXXXXXGXXXXXXXXXXXXXXXXXXXGXXXXXXXXXXXXXXXXXXXGXXXXXXXXXXXXXXXXXXXGXXXXXXXXXXXXXXXXXXXGXXXXXXXXXXXXXXXXXXXGXXXXXXXXXXXXXXXXXXXGXXXXXXXXXXXXXXXXXXXGXXXXXXXXXXXXXXXXXXXGXXXXXXXXXXXXXXXXXXXGXXXXXXXXXXXXXXXXXXXGXXXXXXXXXXXXXXXXXXXGXXXXXXXXXXXXXXXXXXX,0,10,0
44268,13,0,13,59,528,0,0,541,424,117,GXXXXXXXXXXXXXXXXXXXGXXXXXXXXXXXXXXXXXXXGXXXXXXXXXXXXXXXXXXXGXXXXXXXXXXXXXXXXXXXGXXXXXXXXXXXXXXXXXXXGXXXXXXXXXXXXXXXXXXXGXXXXXXXXXXXXXXXXXXXGXXXXXXXXXXXXXXXXXXXGXXXXXXXXXXXXXXXXXXXGXXXXXXXXXXXXXXXXXXXGXXXXXXXXXXXXXXXXXXXGXXXXXXXXXXXXXXXXXXXGXXXXXXXXXXXXXXXXXXX,0,10,0
44289,13,0,13,59,528,0,0,541,423,118,GXXXXXXXXXXXXXXXXXXXGXXXXXXXXXXXXXXXXXXXGXXXXXXXXXXXXXXXXXXXGXXXXXXXXXXXXXXXXXXXGXXXXXXXXXXXXXXXXXXXGXXXXXXXXXXXXXXXXXXXGXXXXXXXXXXXXXXXXXXXGXXXXXXXXXXXXXXXXXXXGXXXXXXXXXXXXXXXXXXXGXXXXXXXXXXXXXXXXXXXGXXXXXXXXXXXXXXXXXXXGXXXXXXXXXXXXXXXXXXXGXXXXXXXXXXXXXXXXXXX,0,10,0

44310,14,1,13,56,530,0,0,543,427,116,GXXXXXXXXXXXXXXXXXXXGXXXXXXXXXXXXXXXXXXXGXXXXXXXXXXXXXXXXXXXGXXXXXXXXXXXXXXXXXXXGXXXXXXXXXXXXXXXXXXXGXXXXXXXXXXXXXXXXXXXGXXXXXXXXXXXXXXXXXXXGXXXXXXXXXXXXXXXXXXXGXXXXXXXXXXXXXXXXXXXGAXXXXXXXXXXXXXXXXXXGXXXXXXXXXXXXXXXXXXXGXXXXXXXXXXXXXXXXXXXGXXXXXXXXXXXXXXXXXXX,0,10,0
44331,14,1,13,55,531,0,0,544,429,115,GXXXXXXXXXXXXXXXXXXXGXXXXXXXXXXXXXXXXXXXGXXXXXXXXXXXXXXXXXXXGXXXXXXXXXXXXXXXXXXXGXXXXXXXXXXXXXXXXXXXGXXXXXXXXXXXXXXXXXXXGXXXXXXXXXXXXXXXXXXXGXXXXXXXXXXXXXXXXXXXGXXXXXXXXXXXXXXXXXXXGAXXXXXXXXXXXXXXXXXXGXXXXXXXXXXXXXXXXXXXGXXXXXXXXXXXXXXXXXXXGXXXXXXXXXXXXXXXXXXX,0,10,0
44352,13,0,13,55,532,0,0,545,432,113,GXXXXXXXXXXXXXXXXXXXGXXXXXXXXXXXXXXXXXXXGXXXXXXXXXXXXXXXXXXXGXXXXXXXXXXXXXXXXXXXGXXXXXXXXXXXXXXXXXXXGXXXXXXXXXXXXXXXXXXXGXXXXXXXXXXXXXXXXXXXGXXXXXXXXXXXXXXXXXXXGXXXXXXXXXXXXXXXXXXXGXXXXXXXXXXXXXXXXXXXGXXXXXXXXXXXXXXXXXXXGXXXXXXXXXXXXXXXXXXXGXXXXXXXXXXXXXXXXXXX,0,10,0
44373,13,0,13,60,527,0,0,540,429,111,GXXXXXXXXXXXXXXXXXXXGXXXXXXXXXXXXXXXXXXXGXXXXXXXXXXXXXXXXXXXGXXXXXXXXXXXXXXXXXXXGXXXXXXXXXXXXXXXXXXXGXXXXXXXXXXXXXXXXXXXGXXXXXXXXXXXXXXXXXXXGXXXXXXXXXXXXXXXXXXXGXXXXXXXXXXXXXXXXXXXGXXXXXXXXXXXXXXXXXXXGXXXXXXXXXXXXXXXXXXXGXXXXXXXXXXXXXXXXXXXGXXXXXXXXXXXXXXXXXXX,0,10,0
44394,14,1,13,57,529,0,0,542,427,115,GXXXXXXXXXXXXXXXXXXXGXXXXXXXXXXXXXXXXXXXGXXXXXXXXXXXXXXXXXXXGXXXXXXXXXXXXXXXXXXXGXXXXXXXXXXXXXXXXXXXGXXXXXXXXXXXXXXXXXXXGAXXXXXXXXXXXXXXXXXXGXXXXXXXXXXXXXXXXXXXGXXXXXXXXXXXXXXXXXXXGXXXXXXXXXXXXXXXXXXXGXXXXXXXXXXXXXXXXXXXGXXXXXXXXXXXXXXXXXXXGXXXXXXXXXXXXXXXXXXX,0,10,0

44415,13,0,13,53,534,0,0,547,436,111,GXXXXXXXXXXXXXXXXXXXGXXXXXXXXXXXXXXXXXXXGXXXXXXXXXXXXXXXXXXXGXXXXXXXXXXXXXXXXXXXGXXXXXXXXXXXXXXXXXXXGXXXXXXXXXXXXXXXXXXXGXXXXXXXXXXXXXXXXXXXGXXXXXXXXXXXXXXXXXXXGXXXXXXXXXXXXXXXXXXXGXXXXXXXXXXXXXXXXXXXGXXXXXXXXXXXXXXXXXXXGXXXXXXXXXXXXXXXXXXXGXXXXXXXXXXXXXXXXXXX,0,10,0
44436,13,0,13,55,532,0,0,545,436,109,GXXXXXXXXXXXXXXXXXXXGXXXXXXXXXXXXXXXXXXXGXXXXXXXXXXXXXXXXXXXGXXXXXXXXXXXXXXXXXXXGXXXXXXXXXXXXXXXXXXXGXXXXXXXXXXXXXXXXXXXGXXXXXXXXXXXXXXXXXXXGXXXXXXXXXXXXXXXXXXXGXXXXXXXXXXXXXXXXXXXGXXXXXXXXXXXXXXXXXXXGXXXXXXXXXXXXXXXXXXXGXXXXXXXXXXXXXXXXXXXGXXXXXXXXXXXXXXXXXXX,0,10,0
44457,13,0,13,57,530,0,0,543,431,112,GXXXXXXXXXXXXXXXXXXXGXXXXXXXXXXXXXXXXXXXGXXXXXXXXXXXXXXXXXXXGXXXXXXXXXXXXXXXXXXXGXXXXXXXXXXXXXXXXXXXGXXXXXXXXXXXXXXXXXXXGXXXXXXXXXXXXXXXXXXXGXXXXXXXXXXXXXXXXXXXGXXXXXXXXXXXXXXXXXXXGXXXXXXXXXXXXXXXXXXXGXXXXXXXXXXXXXXXXXXXGXXXXXXXXXXXXXXXXXXXGXXXXXXXXXXXXXXXXXXX,0,10,0
44478,13,0,13,58,529,0,0,542,432,110,GXXXXXXXXXXXXXXXXXXXGXXXXXXXXXXXXXXXXXXXGXXXXXXXXXXXXXXXXXXXGXXXXXXXXXXXXXXXXXXXGXXXXXXXXXXXXXXXXXXXGXXXXXXXXXXXXXXXXXXXGXXXXXXXXXXXXXXXXXXXGXXXXXXXXXXXXXXXXXXXGXXXXXXXXXXXXXXXXXXXGXXXXXXXXXXXXXXXXXXXGXXXXXXXXXXXXXXXXXXXGXXXXXXXXXXXXXXXXXXXGXXXXXXXXXXXXXXXXXXX,0,10,0
44499,13,0,13,60,527,0,0,540,435,105,GXXXXXXXXXXXXXXXXXXXGXXXXXXXXXXXXXXXXXXXGXXXXXXXXXXXXXXXXXXXGXXXXXXXXXXXXXXXXXXXGXXXXXXXXXXXXXXXXXXXGXXXXXXXXXXXXXXXXXXXGXXXXXXXXXXXXXXXXXXXGXXXXXXXXXXXXXXXXXXXGXXXXXXXXXXXXXXXXXXXGXXXXXXXXXXXXXXXXXXXGXXXXXXXXXXXXXXXXXXXGXXXXXXXXXXXXXXXXXXXGXXXXXXXXXXXXXXXXXXX,0,10,0

44520,13,0,13,63,524,0,0,537,429,108,GXXXXXXXXXXXXXXXXXXXGXXXXXXXXXXXXXXXXXXXGXXXXXXXXXXXXXXXXXXXGXXXXXXXXXXXXXXXXXXXGXXXXXXXXXXXXXXXXXXXGXXXXXXXXXXXXXXXXXXXGXXXXXXXXXXXXXXXXXXXGXXXXXXXXXXXXXXXXXXXGXXXXXXXXXXXXXXXXXXXGXXXXXXXXXXXXXXXXXXXGXXXXXXXXXXXXXXXXXXXGXXXXXXXXXXXXXXXXXXXGXXXXXXXXXXXXXXXXXXX,0,10,0
44541,13,0,13,63,524,0,0,537,433,104,GXXXXXXXXXXXXXXXXXXXGXXXXXXXXXXXXXXXXXXXGXXXXXXXXXXXXXXXXXXXGXXXXXXXXXXXXXXXXXXXGXXXXXXXXXXXXXXXXXXXGXXXXXXXXXXXXXXXXXXXGXXXXXXXXXXXXXXXXXXXGXXXXXXXXXXXXXXXXXXXGXXXXXXXXXXXXXXXXXXXGXXXXXXXXXXXXXXXXXXXGXXXXXXXXXXXXXXXXXXXGXXXXXXXXXXXXXXXXXXXGXXXXXXXXXXXXXXXXXXX,0,10,0
44562,13,0,13,66,521,0,0,534,434,100,GXXXXXXXXXXXXXXXXXXXGXXXXXXXXXXXXXXXXXXXGXXXXXXXXXXXXXXXXXXXGXXXXXXXXXXXXXXXXXXXGXXXXXXXXXXXXXXXXXXXGXXXXXXXXXXXXXXXXXXXGXXXXXXXXXXXXXXXXXXXGXXXXXXXXXXXXXXXXXXXGXXXXXXXXXXXXXXXXXXXGXXXXXXXXXXXXXXXXXXXGXXXXXXXXXXXXXXXXXXXGXXXXXXXXXXXXXXXXXXXGXXXXXXXXXXXXXXXXXXX,0,10,0
44583,13,0,13,67,520,0,0,533,431,102,GXXXXXXXXXXXXXXXXXXXGXXXXXXXXXXXXXXXXXXXGXXXXXXXXXXXXXXXXXXXGXXXXXXXXXXXXXXXXXXXGXXXXXXXXXXXXXXXXXXXGXXXXXXXXXXXXXXXXXXXGXXXXXXXXXXXXXXXXXXXGXXXXXXXXXXXXXXXXXXXGXXXXXXXXXXXXXXXXXXXGXXXXXXXXXXXXXXXXXXXGXXXXXXXXXXXXXXXXXXXGXXXXXXXXXXXXXXXXXXXGXXXXXXXXXXXXXXXXXXX,0,10,0
44604,13,0,13,65,522,0,0,534,431,103,GXXXXXXXXXXXXXXXXXXXGXXXXXXXXXXXXXXXXXXXGXXXXXXXXXXXXXXXXXXXGXXXXXXXXXXXXXXXXXXXGXXXXXXXXXXXXXXXXXXXGXXXXXXXXXXXXXXXXXXXGXXXXXXXXXXXXXXXXXXXGXXXXXXXXXXXXXXXXXXXGXXXXXXXXXXXXXXXXXXXGXXXXXXXXXXXXXXXXXXXGXXXXXXXXXXXXXXXXXXXGXXXXXXXXXXXXXXXXXXXGXXXXXXXXXXXXXXXXXXX,0,10,0

44625,13,0,13,61,526,0,0,538,432,106,GXXXXXXXXXXXXXXXXXXXGXXXXXXXXXXXXXXXXXXXGXXXXXXXXXXXXXXXXXXXGXXXXXXXXXXXXXXXXXXXGXXXXXXXXXXXXXXXXXXXGXXXXXXXXXXXXXXXXXXXGXXXXXXXXXXXXXXXXXXXGXXXXXXXXXXXXXXXXXXXGXXXXXXXXXXXXXXXXXXXGXXXXXXXXXXXXXXXXXXXGXXXXXXXXXXXXXXXXXXXGXXXXXXXXXXXXXXXXXXXGXXXXXXXXXXXXXXXXXXX,0,10,0
44646,13,0,13,58,529,0,0,541,431,110,GXXXXXXXXXXXXXXXXXXXGXXXXXXXXXXXXXXXXXXXGXXXXXXXXXXXXXXXXXXXGXXXXXXXXXXXXXXXXXXXGXXXXXXXXXXXXXXXXXXXGXXXXXXXXXXXXXXXXXXXGXXXXXXXXXXXXXXXXXXXGXXXXXXXXXXXXXXXXXXXGXXXXXXXXXXXXXXXXXXXGXXXXXXXXXXXXXXXXXXXGXXXXXXXXXXXXXXXXXXXGXXXXXXXXXXXXXXXXXXXGXXXXXXXXXXXXXXXXXXX,0,10,0
44667,13,0,13,62,525,0,0,537,428,109,GXXXXXXXXXXXXXXXXXXXGXXXXXXXXXXXXXXXXXXXGXXXXXXXXXXXXXXXXXXXGXXXXXXXXXXXXXXXXXXXGXXXXXXXXXXXXXXXXXXXGXXXXXXXXXXXXXXXXXXXGXXXXXXXXXXXXXXXXXXXGXXXXXXXXXXXXXXXXXXXGXXXXXXXXXXXXXXXXXXXGXXXXXXXXXXXXXXXXXXXGXXXXXXXXXXXXXXXXXXXGXXXXXXXXXXXXXXXXXXXGXXXXXXXXXXXXXXXXXXX,0,10,0
44688,13,0,13,57,530,0,0,542,428,114,GXXXXXXXXXXXXXXXXXXXGXXXXXXXXXXXXXXXXXXXGXXXXXXXXXXXXXXXXXXXGXXXXXXXXXXXXXXXXXXXGXXXXXXXXXXXXXXXXXXXGXXXXXXXXXXXXXXXXXXXGXXXXXXXXXXXXXXXXXXXGXXXXXXXXXXXXXXXXXXXGXXXXXXXXXXXXXXXXXXXGXXXXXXXXXXXXXXXXXXXGXXXXXXXXXXXXXXXXXXXGXXXXXXXXXXXXXXXXXXXGXXXXXXXXXXXXXXXXXXX,0,10,0
44709,13,0,13,58,529,0,0,542,432,110,GXXXXXXXXXXXXXXXXXXXGXXXXXXXXXXXXXXXXXXXGXXXXXXXXXXXXXXXXXXXGXXXXXXXXXXXXXXXXXXXGXXXXXXXXXXXXXXXXXXXGXXXXXXXXXXXXXXXXXXXGXXXXXXXXXXXXXXXXXXXGXXXXXXXXXXXXXXXXXXXGXXXXXXXXXXXXXXXXXXXGXXXXXXXXXXXXXXXXXXXGXXXXXXXXXXXXXXXXXXXGXXXXXXXXXXXXXXXXXXXGXXXXXXXXXXXXXXXXXXX,0,10,0

44730,14,1,13,64,522,0,0,535,435,100,GXXXXXXXXXXXXXXXXXXXGXXXXXXXXXXXXXXXXXXXGXXXXXXXXXXXXXXXXXXXGAXXXXXXXXXXXXXXXXXXGXXXXXXXXXXXXXXXXXXXGXXXXXXXXXXXXXXXXXXXGXXXXXXXXXXXXXXXXXXXGXXXXXXXXXXXXXXXXXXXGXXXXXXXXXXXXXXXXXXXGXXXXXXXXXXXXXXXXXXXGXXXXXXXXXXXXXXXXXXXGXXXXXXXXXXXXXXXXXXXGXXXXXXXXXXXXXXXXXXX,0,10,0
44751,13,0,13,67,520,0,0,532,431,101,GXXXXXXXXXXXXXXXXXXXGXXXXXXXXXXXXXXXXXXXGXXXXXXXXXXXXXXXXXXXGXXXXXXXXXXXXXXXXXXXGXXXXXXXXXXXXXXXXXXXGXXXXXXXXXXXXXXXXXXXGXXXXXXXXXXXXXXXXXXXGXXXXXXXXXXXXXXXXXXXGXXXXXXXXXXXXXXXXXXXGXXXXXXXXXXXXXXXXXXXGXXXXXXXXXXXXXXXXXXXGXXXXXXXXXXXXXXXXXXXGXXXXXXXXXXXXXXXXXXX,0,10,0
44772,13,0,13,66,521,0,0,534,433,101,GXXXXXXXXXXXXXXXXXXXGXXXXXXXXXXXXXXXXXXXGXXXXXXXXXXXXXXXXXXXGXXXXXXXXXXXXXXXXXXXGXXXXXXXXXXXXXXXXXXXGXXXXXXXXXXXXXXXXXXXGXXXXXXXXXXXXXXXXXXXGXXXXXXXXXXXXXXXXXXXGXXXXXXXXXXXXXXXXXXXGXXXXXXXXXXXXXXXXXXXGXXXXXXXXXXXXXXXXXXXGXXXXXXXXXXXXXXXXXXXGXXXXXXXXXXXXXXXXXXX,0,10,0
44793,13,0,13,64,523,0,0,535,429,106,GXXXXXXXXXXXXXXXXXXXGXXXXXXXXXXXXXXXXXXXGXXXXXXXXXXXXXXXXXXXGXXXXXXXXXXXXXXXXXXXGXXXXXXXXXXXXXXXXXXXGXXXXXXXXXXXXXXXXXXXGXXXXXXXXXXXXXXXXXXXGXXXXXXXXXXXXXXXXXXXGXXXXXXXXXXXXXXXXXXXGXXXXXXXXXXXXXXXXXXXGXXXXXXXXXXXXXXXXXXXGXXXXXXXXXXXXXXXXXXXGXXXXXXXXXXXXXXXXXXX,0,10,0
44814,13,0,13,61,526,0,0,538,431,107,GXXXXXXXXXXXXXXXXXXXGXXXXXXXXXXXXXXXXXXXGXXXXXXXXXXXXXXXXXXXGXXXXXXXXXXXXXXXXXXXGXXXXXXXXXXXXXXXXXXXGXXXXXXXXXXXXXXXXXXXGXXXXXXXXXXXXXXXXXXXGXXXXXXXXXXXXXXXXXXXGXXXXXXXXXXXXXXXXXXXGXXXXXXXXXXXXXXXXXXXGXXXXXXXXXXXXXXXXXXXGXXXXXXXXXXXXXXXXXXXGXXXXXXXXXXXXXXXXXXX,0,10,0

44835,13,0,13,53,534,0,0,546,432,114,GXXXXXXXXXXXXXXXXXXXGXXXXXXXXXXXXXXXXXXXGXXXXXXXXXXXXXXXXXXXGXXXXXXXXXXXXXXXXXXXGXXXXXXXXXXXXXXXXXXXGXXXXXXXXXXXXXXXXXXXGXXXXXXXXXXXXXXXXXXXGXXXXXXXXXXXXXXXXXXXGXXXXXXXXXXXXXXXXXXXGXXXXXXXXXXXXXXXXXXXGXXXXXXXXXXXXXXXXXXXGXXXXXXXXXXXXXXXXXXXGXXXXXXXXXXXXXXXXXXX,0,10,0
44856,13,0,13,47,540,0,0,553,439,114,GXXXXXXXXXXXXXXXXXXXGXXXXXXXXXXXXXXXXXXXGXXXXXXXXXXXXXXXXXXXGXXXXXXXXXXXXXXXXXXXGXXXXXXXXXXXXXXXXXXXGXXXXXXXXXXXXXXXXXXXGXXXXXXXXXXXXXXXXXXXGXXXXXXXXXXXXXXXXXXXGXXXXXXXXXXXXXXXXXXXGXXXXXXXXXXXXXXXXXXXGXXXXXXXXXXXXXXXXXXXGXXXXXXXXXXXXXXXXXXXGXXXXXXXXXXXXXXXXXXX,0,10,0
44877,13,0,13,52,535,0,0,548,432,116,GXXXXXXXXXXXXXXXXXXXGXXXXXXXXXXXXXXXXXXXGXXXXXXXXXXXXXXXXXXXGXXXXXXXXXXXXXXXXXXXGXXXXXXXXXXXXXXXXXXXGXXXXXXXXXXXXXXXXXXXGXXXXXXXXXXXXXXXXXXXGXXXXXXXXXXXXXXXXXXXGXXXXXXXXXXXXXXXXXXXGXXXXXXXXXXXXXXXXXXXGXXXXXXXXXXXXXXXXXXXGXXXXXXXXXXXXXXXXXXXGXXXXXXXXXXXXXXXXXXX,0,10,0
44898,13,0,13,53,534,0,0,548,430,118,GXXXXXXXXXXXXXXXXXXXGXXXXXXXXXXXXXXXXXXXGXXXXXXXXXXXXXXXXXXXGXXXXXXXXXXXXXXXXXXXGXXXXXXXXXXXXXXXXXXXGXXXXXXXXXXXXXXXXXXXGXXXXXXXXXXXXXXXXXXXGXXXXXXXXXXXXXXXXXXXGXXXXXXXXXXXXXXXXXXXGXXXXXXXXXXXXXXXXXXXGXXXXXXXXXXXXXXXXXXXGXXXXXXXXXXXXXXXXXXXGXXXXXXXXXXXXXXXXXXX,0,10,0
44919,13,0,13,52,535,0,0,550,433,117,GXXXXXXXXXXXXXXXXXXXGXXXXXXXXXXXXXXXXXXXGXXXXXXXXXXXXXXXXXXXGXXXXXXXXXXXXXXXXXXXGXXXXXXXXXXXXXXXXXXXGXXXXXXXXXXXXXXXXXXXGXXXXXXXXXXXXXXXXXXXGXXXXXXXXXXXXXXXXXXXGXXXXXXXXXXXXXXXXXXXGXXXXXXXXXXXXXXXXXXXGXXXXXXXXXXXXXXXXXXXGXXXXXXXXXXXXXXXXXXXGXXXXXXXXXXXXXXXXXXX,0,10,0

44940,13,0,13,54,533,0,0,547,437,110,GXXXXXXXXXXXXXXXXXXXGXXXXXXXXXXXXXXXXXXXGXXXXXXXXXXXXXXXXXXXGXXXXXXXXXXXXXXXXXXXGXXXXXXXXXXXXXXXXXXXGXXXXXXXXXXXXXXXXXXXGXXXXXXXXXXXXXXXXXXXGXXXXXXXXXXXXXXXXXXXGXXXXXXXXXXXXXXXXXXXGXXXXXXXXXXXXXXXXXXXGXXXXXXXXXXXXXXXXXXXGXXXXXXXXXXXXXXXXXXXGXXXXXXXXXXXXXXXXXXX,0,10,0
44961,13,0,13,58,529,0,0,543,434,109,GXXXXXXXXXXXXXXXXXXXGXXXXXXXXXXXXXXXXXXXGXXXXXXXXXXXXXXXXXXXGXXXXXXXXXXXXXXXXXXXGXXXXXXXXXXXXXXXXXXXGXXXXXXXXXXXXXXXXXXXGXXXXXXXXXXXXXXXXXXXGXXXXXXXXXXXXXXXXXXXGXXXXXXXXXXXXXXXXXXXGXXXXXXXXXXXXXXXXXXXGXXXXXXXXXXXXXXXXXXXGXXXXXXXXXXXXXXXXXXXGXXXXXXXXXXXXXXXXXXX,0,10,0
44982,13,0,13,55,532,0,0,546,431,115,GXXXXXXXXXXXXXXXXXXXGXXXXXXXXXXXXXXXXXXXGXXXXXXXXXXXXXXXXXXXGXXXXXXXXXXXXXXXXXXXGXXXXXXXXXXXXXXXXXXXGXXXXXXXXXXXXXXXXXXXGXXXXXXXXXXXXXXXXXXXGXXXXXXXXXXXXXXXXXXXGXXXXXXXXXXXXXXXXXXXGXXXXXXXXXXXXXXXXXXXGXXXXXXXXXXXXXXXXXXXGXXXXXXXXXXXXXXXXXXXGXXXXXXXXXXXXXXXXXXX,0,10,0
45003,13,0,13,58,529,0,0,542,431,111,GXXXXXXXXXXXXXXXXXXXGXXXXXXXXXXXXXXXXXXXGXXXXXXXXXXXXXXXXXXXGXXXXXXXXXXXXXXXXXXXGXXXXXXXXXXXXXXXXXXXGXXXXXXXXXXXXXXXXXXXGXXXXXXXXXXXXXXXXXXXGXXXXXXXXXXXXXXXXXXXGXXXXXXXXXXXXXXXXXXXGXXXXXXXXXXXXXXXXXXXGXXXXXXXXXXXXXXXXXXXGXXXXXXXXXXXXXXXXXXXGXXXXXXXXXXXXXXXXXXX,0,10,0
45024,13,0,13,60,527,0,0,541,430,111,GXXXXXXXXXXXXXXXXXXXGXXXXXXXXXXXXXXXXXXXGXXXXXXXXXXXXXXXXXXXGXXXXXXXXXXXXXXXXXXXGXXXXXXXXXXXXXXXXXXXGXXXXXXXXXXXXXXXXXXXGXXXXXXXXXXXXXXXXXXXGXXXXXXXXXXXXXXXXXXXGXXXXXXXXXXXXXXXXXXXGXXXXXXXXXXXXXXXXXXXGXXXXXXXXXXXXXXXXXXXGXXXXXXXXXXXXXXXXXXXGXXXXXXXXXXXXXXXXXXX,0,10,0

45045,13,0,13,58,529,0,0,543,431,112,GXXXXXXXXXXXXXXXXXXXGXXXXXXXXXXXXXXXXXXXGXXXXXXXXXXXXXXXXXXXGXXXXXXXXXXXXXXXXXXXGXXXXXXXXXXXXXXXXXXXGXXXXXXXXXXXXXXXXXXXGXXXXXXXXXXXXXXXXXXXGXXXXXXXXXXXXXXXXXXXGXXXXXXXXXXXXXXXXXXXGXXXXXXXXXXXXXXXXXXXGXXXXXXXXXXXXXXXXXXXGXXXXXXXXXXXXXXXXXXXGXXXXXXXXXXXXXXXXXXX,0,10,0
45066,13,0,13,55,532,0,0,547,434,113,GXXXXXXXXXXXXXXXXXXXGXXXXXXXXXXXXXXXXXXXGXXXXXXXXXXXXXXXXXXXGXXXXXXXXXXXXXXXXXXXGXXXXXXXXXXXXXXXXXXXGXXXXXXXXXXXXXXXXXXXGXXXXXXXXXXXXXXXXXXXGXXXXXXXXXXXXXXXXXXXGXXXXXXXXXXXXXXXXXXXGXXXXXXXXXXXXXXXXXXXGXXXXXXXXXXXXXXXXXXXGXXXXXXXXXXXXXXXXXXXGXXXXXXXXXXXXXXXXXXX,0,10,0
45087,13,0,13,59,528,0,0,542,433,109,GXXXXXXXXXXXXXXXXXXXGXXXXXXXXXXXXXXXXXXXGXXXXXXXXXXXXXXXXXXXGXXXXXXXXXXXXXXXXXXXGXXXXXXXXXXXXXXXXXXXGXXXXXXXXXXXXXXXXXXXGXXXXXXXXXXXXXXXXXXXGXXXXXXXXXXXXXXXXXXXGXXXXXXXXXXXXXXXXXXXGXXXXXXXXXXXXXXXXXXXGXXXXXXXXXXXXXXXXXXXGXXXXXXXXXXXXXXXXXXXGXXXXXXXXXXXXXXXXXXX,0,10,0
45108,13,0,13,56,531,0,0,544,435,109,GXXXXXXXXXXXXXXXXXXXGXXXXXXXXXXXXXXXXXXXGXXXXXXXXXXXXXXXXXXXGXXXXXXXXXXXXXXXXXXXGXXXXXXXXXXXXXXXXXXXGXXXXXXXXXXXXXXXXXXXGXXXXXXXXXXXXXXXXXXXGXXXXXXXXXXXXXXXXXXXGXXXXXXXXXXXXXXXXXXXGXXXXXXXXXXXXXXXXXXXGXXXXXXXXXXXXXXXXXXXGXXXXXXXXXXXXXXXXXXXGXXXXXXXXXXXXXXXXXXX,0,10,0
45129,13,0,13,57,530,0,0,544,435,109,GXXXXXXXXXXXXXXXXXXXGXXXXXXXXXXXXXXXXXXXGXXXXXXXXXXXXXXXXXXXGXXXXXXXXXXXXXXXXXXXGXXXXXXXXXXXXXXXXXXXGXXXXXXXXXXXXXXXXXXXGXXXXXXXXXXXXXXXXXXXGXXXXXXXXXXXXXXXXXXXGXXXXXXXXXXXXXXXXXXXGXXXXXXXXXXXXXXXXXXXGXXXXXXXXXXXXXXXXXXXGXXXXXXXXXXXXXXXXXXXGXXXXXXXXXXXXXXXXXXX,0,10,0

45150,13,0,13,57,530,0,0,545,434,111,GXXXXXXXXXXXXXXXXXXXGXXXXXXXXXXXXXXXXXXXGXXXXXXXXXXXXXXXXXXXGXXXXXXXXXXXXXXXXXXXGXXXXXXXXXXXXXXXXXXXGXXXXXXXXXXXXXXXXXXXGXXXXXXXXXXXXXXXXXXXGXXXXXXXXXXXXXXXXXXXGXXXXXXXXXXXXXXXXXXXGXXXXXXXXXXXXXXXXXXXGXXXXXXXXXXXXXXXXXXXGXXXXXXXXXXXXXXXXXXXGXXXXXXXXXXXXXXXXXXX,0,10,0
45171,13,0,13,58,529,0,0,544,434,110,GXXXXXXXXXXXXXXXXXXXGXXXXXXXXXXXXXXXXXXXGXXXXXXXXXXXXXXXXXXXGXXXXXXXXXXXXXXXXXXXGXXXXXXXXXXXXXXXXXXXGXXXXXXXXXXXXXXXXXXXGXXXXXXXXXXXXXXXXXXXGXXXXXXXXXXXXXXXXXXXGXXXXXXXXXXXXXXXXXXXGXXXXXXXXXXXXXXXXXXXGXXXXXXXXXXXXXXXXXXXGXXXXXXXXXXXXXXXXXXXGXXXXXXXXXXXXXXXXXXX,0,10,0
45192,13,0,13,56,531,0,0,546,438,108,GXXXXXXXXXXXXXXXXXXXGXXXXXXXXXXXXXXXXXXXGXXXXXXXXXXXXXXXXXXXGXXXXXXXXXXXXXXXXXXXGXXXXXXXXXXXXXXXXXXXGXXXXXXXXXXXXXXXXXXXGXXXXXXXXXXXXXXXXXXXGXXXXXXXXXXXXXXXXXXXGXXXXXXXXXXXXXXXXXXXGXXXXXXXXXXXXXXXXXXXGXXXXXXXXXXXXXXXXXXXGXXXXXXXXXXXXXXXXXXXGXXXXXXXXXXXXXXXXXXX,0,10,0
45213,13,0,13,62,525,0,0,540,438,102,GXXXXXXXXXXXXXXXXXXXGXXXXXXXXXXXXXXXXXXXGXXXXXXXXXXXXXXXXXXXGXXXXXXXXXXXXXXXXXXXGXXXXXXXXXXXXXXXXXXXGXXXXXXXXXXXXXXXXXXXGXXXXXXXXXXXXXXXXXXXGXXXXXXXXXXXXXXXXXXXGXXXXXXXXXXXXXXXXXXXGXXXXXXXXXXXXXXXXXXXGXXXXXXXXXXXXXXXXXXXGXXXXXXXXXXXXXXXXXXXGXXXXXXXXXXXXXXXXXXX,0,10,0
45234,13,0,13,64,523,0,0,538,440,98,GXXXXXXXXXXXXXXXXXXXGXXXXXXXXXXXXXXXXXXXGXXXXXXXXXXXXXXXXXXXGXXXXXXXXXXXXXXXXXXXGXXXXXXXXXXXXXXXXXXXGXXXXXXXXXXXXXXXXXXXGXXXXXXXXXXXXXXXXXXXGXXXXXXXXXXXXXXXXXXXGXXXXXXXXXXXXXXXXXXXGXXXXXXXXXXXXXXXXXXXGXXXXXXXXXXXXXXXXXXXGXXXXXXXXXXXXXXXXXXXGXXXXXXXXXXXXXXXXXXX,0,10,0

45255,13,0,13,67,520,0,0,535,441,94,GXXXXXXXXXXXXXXXXXXXGXXXXXXXXXXXXXXXXXXXGXXXXXXXXXXXXXXXXXXXGXXXXXXXXXXXXXXXXXXXGXXXXXXXXXXXXXXXXXXXGXXXXXXXXXXXXXXXXXXXGXXXXXXXXXXXXXXXXXXXGXXXXXXXXXXXXXXXXXXXGXXXXXXXXXXXXXXXXXXXGXXXXXXXXXXXXXXXXXXXGXXXXXXXXXXXXXXXXXXXGXXXXXXXXXXXXXXXXXXXGXXXXXXXXXXXXXXXXXXX,0,10,0
45276,13,0,13,59,528,0,0,543,442,101,GXXXXXXXXXXXXXXXXXXXGXXXXXXXXXXXXXXXXXXXGXXXXXXXXXXXXXXXXXXXGXXXXXXXXXXXXXXXXXXXGXXXXXXXXXXXXXXXXXXXGXXXXXXXXXXXXXXXXXXXGXXXXXXXXXXXXXXXXXXXGXXXXXXXXXXXXXXXXXXXGXXXXXXXXXXXXXXXXXXXGXXXXXXXXXXXXXXXXXXXGXXXXXXXXXXXXXXXXXXXGXXXXXXXXXXXXXXXXXXXGXXXXXXXXXXXXXXXXXXX,0,10,0
45297,13,0,13,65,522,0,0,537,441,96,GXXXXXXXXXXXXXXXXXXXGXXXXXXXXXXXXXXXXXXXGXXXXXXXXXXXXXXXXXXXGXXXXXXXXXXXXXXXXXXXGXXXXXXXXXXXXXXXXXXXGXXXXXXXXXXXXXXXXXXXGXXXXXXXXXXXXXXXXXXXGXXXXXXXXXXXXXXXXXXXGXXXXXXXXXXXXXXXXXXXGXXXXXXXXXXXXXXXXXXXGXXXXXXXXXXXXXXXXXXXGXXXXXXXXXXXXXXXXXXXGXXXXXXXXXXXXXXXXXXX,0,10,0
45318,13,0,13,65,522,0,0,537,439,98,GXXXXXXXXXXXXXXXXXXXGXXXXXXXXXXXXXXXXXXXGXXXXXXXXXXXXXXXXXXXGXXXXXXXXXXXXXXXXXXXGXXXXXXXXXXXXXXXXXXXGXXXXXXXXXXXXXXXXXXXGXXXXXXXXXXXXXXXXXXXGXXXXXXXXXXXXXXXXXXXGXXXXXXXXXXXXXXXXXXXGXXXXXXXXXXXXXXXXXXXGXXXXXXXXXXXXXXXXXXXGXXXXXXXXXXXXXXXXXXXGXXXXXXXXXXXXXXXXXXX,0,10,0
45339,13,0,13,59,528,0,0,543,436,107,GXXXXXXXXXXXXXXXXXXXGXXXXXXXXXXXXXXXXXXXGXXXXXXXXXXXXXXXXXXXGXXXXXXXXXXXXXXXXXXXGXXXXXXXXXXXXXXXXXXXGXXXXXXXXXXXXXXXXXXXGXXXXXXXXXXXXXXXXXXXGXXXXXXXXXXXXXXXXXXXGXXXXXXXXXXXXXXXXXXXGXXXXXXXXXXXXXXXXXXXGXXXXXXXXXXXXXXXXXXXGXXXXXXXXXXXXXXXXXXXGXXXXXXXXXXXXXXXXXXX,0,10,0

45360,13,0,13,53,534,0,0,548,437,111,GXXXXXXXXXXXXXXXXXXXGXXXXXXXXXXXXXXXXXXXGXXXXXXXXXXXXXXXXXXXGXXXXXXXXXXXXXXXXXXXGXXXXXXXXXXXXXXXXXXXGXXXXXXXXXXXXXXXXXXXGXXXXXXXXXXXXXXXXXXXGXXXXXXXXXXXXXXXXXXXGXXXXXXXXXXXXXXXXXXXGXXXXXXXXXXXXXXXXXXXGXXXXXXXXXXXXXXXXXXXGXXXXXXXXXXXXXXXXXXXGXXXXXXXXXXXXXXXXXXX,0,10,0
45381,13,0,13,53,534,0,0,549,439,110,GXXXXXXXXXXXXXXXXXXXGXXXXXXXXXXXXXXXXXXXGXXXXXXXXXXXXXXXXXXXGXXXXXXXXXXXXXXXXXXXGXXXXXXXXXXXXXXXXXXXGXXXXXXXXXXXXXXXXXXXGXXXXXXXXXXXXXXXXXXXGXXXXXXXXXXXXXXXXXXXGXXXXXXXXXXXXXXXXXXXGXXXXXXXXXXXXXXXXXXXGXXXXXXXXXXXXXXXXXXXGXXXXXXXXXXXXXXXXXXXGXXXXXXXXXXXXXXXXXXX,0,10,0
45402,13,0,13,51,536,0,0,550,437,113,GXXXXXXXXXXXXXXXXXXXGXXXXXXXXXXXXXXXXXXXGXXXXXXXXXXXXXXXXXXXGXXXXXXXXXXXXXXXXXXXGXXXXXXXXXXXXXXXXXXXGXXXXXXXXXXXXXXXXXXXGXXXXXXXXXXXXXXXXXXXGXXXXXXXXXXXXXXXXXXXGXXXXXXXXXXXXXXXXXXXGXXXXXXXXXXXXXXXXXXXGXXXXXXXXXXXXXXXXXXXGXXXXXXXXXXXXXXXXXXXGXXXXXXXXXXXXXXXXXXX,0,10,0
45423,13,0,13,51,536,0,0,550,440,110,GXXXXXXXXXXXXXXXXXXXGXXXXXXXXXXXXXXXXXXXGXXXXXXXXXXXXXXXXXXXGXXXXXXXXXXXXXXXXXXXGXXXXXXXXXXXXXXXXXXXGXXXXXXXXXXXXXXXXXXXGXXXXXXXXXXXXXXXXXXXGXXXXXXXXXXXXXXXXXXXGXXXXXXXXXXXXXXXXXXXGXXXXXXXXXXXXXXXXXXXGXXXXXXXXXXXXXXXXXXXGXXXXXXXXXXXXXXXXXXXGXXXXXXXXXXXXXXXXXXX,0,10,0
45444,13,0,13,53,534,0,0,549,440,109,GXXXXXXXXXXXXXXXXXXXGXXXXXXXXXXXXXXXXXXXGXXXXXXXXXXXXXXXXXXXGXXXXXXXXXXXXXXXXXXXGXXXXXXXXXXXXXXXXXXXGXXXXXXXXXXXXXXXXXXXGXXXXXXXXXXXXXXXXXXXGXXXXXXXXXXXXXXXXXXXGXXXXXXXXXXXXXXXXXXXGXXXXXXXXXXXXXXXXXXXGXXXXXXXXXXXXXXXXXXXGXXXXXXXXXXXXXXXXXXXGXXXXXXXXXXXXXXXXXXX,0,10,0

45465,13,0,13,53,534,0,0,549,438,111,GXXXXXXXXXXXXXXXXXXXGXXXXXXXXXXXXXXXXXXXGXXXXXXXXXXXXXXXXXXXGXXXXXXXXXXXXXXXXXXXGXXXXXXXXXXXXXXXXXXXGXXXXXXXXXXXXXXXXXXXGXXXXXXXXXXXXXXXXXXXGXXXXXXXXXXXXXXXXXXXGXXXXXXXXXXXXXXXXXXXGXXXXXXXXXXXXXXXXXXXGXXXXXXXXXXXXXXXXXXXGXXXXXXXXXXXXXXXXXXXGXXXXXXXXXXXXXXXXXXX,0,10,0
45486,13,0,13,41,546,0,0,561,438,123,GXXXXXXXXXXXXXXXXXXXGXXXXXXXXXXXXXXXXXXXGXXXXXXXXXXXXXXXXXXXGXXXXXXXXXXXXXXXXXXXGXXXXXXXXXXXXXXXXXXXGXXXXXXXXXXXXXXXXXXXGXXXXXXXXXXXXXXXXXXXGXXXXXXXXXXXXXXXXXXXGXXXXXXXXXXXXXXXXXXXGXXXXXXXXXXXXXXXXXXXGXXXXXXXXXXXXXXXXXXXGXXXXXXXXXXXXXXXXXXXGXXXXXXXXXXXXXXXXXXX,0,10,0
45507,13,0,13,43,544,0,0,559,440,119,GXXXXXXXXXXXXXXXXXXXGXXXXXXXXXXXXXXXXXXXGXXXXXXXXXXXXXXXXXXXGXXXXXXXXXXXXXXXXXXXGXXXXXXXXXXXXXXXXXXXGXXXXXXXXXXXXXXXXXXXGXXXXXXXXXXXXXXXXXXXGXXXXXXXXXXXXXXXXXXXGXXXXXXXXXXXXXXXXXXXGXXXXXXXXXXXXXXXXXXXGXXXXXXXXXXXXXXXXXXXGXXXXXXXXXXXXXXXXXXXGXXXXXXXXXXXXXXXXXXX,0,10,0
45528,13,0,13,43,544,0,0,559,438,121,GXXXXXXXXXXXXXXXXXXXGXXXXXXXXXXXXXXXXXXXGXXXXXXXXXXXXXXXXXXXGXXXXXXXXXXXXXXXXXXXGXXXXXXXXXXXXXXXXXXXGXXXXXXXXXXXXXXXXXXXGXXXXXXXXXXXXXXXXXXXGXXXXXXXXXXXXXXXXXXXGXXXXXXXXXXXXXXXXXXXGXXXXXXXXXXXXXXXXXXXGXXXXXXXXXXXXXXXXXXXGXXXXXXXXXXXXXXXXXXXGXXXXXXXXXXXXXXXXXXX,0,10,0
45549,13,0,13,39,548,0,0,563,440,123,GXXXXXXXXXXXXXXXXXXXGXXXXXXXXXXXXXXXXXXXGXXXXXXXXXXXXXXXXXXXGXXXXXXXXXXXXXXXXXXXGXXXXXXXXXXXXXXXXXXXGXXXXXXXXXXXXXXXXXXXGXXXXXXXXXXXXXXXXXXXGXXXXXXXXXXXXXXXXXXXGXXXXXXXXXXXXXXXXXXXGXXXXXXXXXXXXXXXXXXXGXXXXXXXXXXXXXXXXXXXGXXXXXXXXXXXXXXXXXXXGXXXXXXXXXXXXXXXXXXX,0,10,0

45570,13,0,13,45,542,0,0,557,436,121,GXXXXXXXXXXXXXXXXXXXGXXXXXXXXXXXXXXXXXXXGXXXXXXXXXXXXXXXXXXXGXXXXXXXXXXXXXXXXXXXGXXXXXXXXXXXXXXXXXXXGXXXXXXXXXXXXXXXXXXXGXXXXXXXXXXXXXXXXXXXGXXXXXXXXXXXXXXXXXXXGXXXXXXXXXXXXXXXXXXXGXXXXXXXXXXXXXXXXXXXGXXXXXXXXXXXXXXXXXXXGXXXXXXXXXXXXXXXXXXXGXXXXXXXXXXXXXXXXXXX,0,10,0
45591,14,1,13,49,537,0,0,552,433,119,GXXXXXXXXXXXXXXXXXXXGXXXXXXXXXXXXXXXXXXXGXXXXXXXXXXXXXXXXXXXGAXXXXXXXXXXXXXXXXXXGXXXXXXXXXXXXXXXXXXXGXXXXXXXXXXXXXXXXXXXGXXXXXXXXXXXXXXXXXXXGXXXXXXXXXXXXXXXXXXXGXXXXXXXXXXXXXXXXXXXGXXXXXXXXXXXXXXXXXXXGXXXXXXXXXXXXXXXXXXXGXXXXXXXXXXXXXXXXXXXGXXXXXXXXXXXXXXXXXXX,0,10,0
45612,14,1,13,46,540,0,0,555,436,119,GXXXXXXXXXXXXXXXXXXXGXXXXXXXXXXXXXXXXXXXGXXXXXXXXXXXXXXXXXXXGAXXXXXXXXXXXXXXXXXXGXXXXXXXXXXXXXXXXXXXGXXXXXXXXXXXXXXXXXXXGXXXXXXXXXXXXXXXXXXXGXXXXXXXXXXXXXXXXXXXGXXXXXXXXXXXXXXXXXXXGXXXXXXXXXXXXXXXXXXXGXXXXXXXXXXXXXXXXXXXGXXXXXXXXXXXXXXXXXXXGXXXXXXXXXXXXXXXXXXX,0,10,0
45633,14,1,13,49,537,0,0,552,435,117,GXXXXXXXXXXXXXXXXXXXGXXXXXXXXXXXXXXXXXXXGXXXXXXXXXXXXXXXXXXXGAXXXXXXXXXXXXXXXXXXGXXXXXXXXXXXXXXXXXXXGXXXXXXXXXXXXXXXXXXXGXXXXXXXXXXXXXXXXXXXGXXXXXXXXXXXXXXXXXXXGXXXXXXXXXXXXXXXXXXXGXXXXXXXXXXXXXXXXXXXGXXXXXXXXXXXXXXXXXXXGXXXXXXXXXXXXXXXXXXXGXXXXXXXXXXXXXXXXXXX,0,10,0
45654,14,1,13,51,535,0,0,550,439,111,GXXXXXXXXXXXXXXXXXXXGXXXXXXXXXXXXXXXXXXXGXXXXXXXXXXXXXXXXXXXGAXXXXXXXXXXXXXXXXXXGXXXXXXXXXXXXXXXXXXXGXXXXXXXXXXXXXXXXXXXGXXXXXXXXXXXXXXXXXXXGXXXXXXXXXXXXXXXXXXXGXXXXXXXXXXXXXXXXXXXGXXXXXXXXXXXXXXXXXXXGXXXXXXXXXXXXXXXXXXXGXXXXXXXXXXXXXXXXXXXGXXXXXXXXXXXXXXXXXXX,0,10,0

45675,13,0,13,55,532,0,0,547,438,109,GXXXXXXXXXXXXXXXXXXXGXXXXXXXXXXXXXXXXXXXGXXXXXXXXXXXXXXXXXXXGXXXXXXXXXXXXXXXXXXXGXXXXXXXXXXXXXXXXXXXGXXXXXXXXXXXXXXXXXXXGXXXXXXXXXXXXXXXXXXXGXXXXXXXXXXXXXXXXXXXGXXXXXXXXXXXXXXXXXXXGXXXXXXXXXXXXXXXXXXXGXXXXXXXXXXXXXXXXXXXGXXXXXXXXXXXXXXXXXXXGXXXXXXXXXXXXXXXXXXX,0,10,0
45696,13,0,13,53,534,0,0,548,434,114,GXXXXXXXXXXXXXXXXXXXGXXXXXXXXXXXXXXXXXXXGXXXXXXXXXXXXXXXXXXXGXXXXXXXXXXXXXXXXXXXGXXXXXXXXXXXXXXXXXXXGXXXXXXXXXXXXXXXXXXXGXXXXXXXXXXXXXXXXXXXGXXXXXXXXXXXXXXXXXXXGXXXXXXXXXXXXXXXXXXXGXXXXXXXXXXXXXXXXXXXGXXXXXXXXXXXXXXXXXXXGXXXXXXXXXXXXXXXXXXXGXXXXXXXXXXXXXXXXXXX,0,10,0
45717,13,0,13,54,533,0,0,547,434,113,GXXXXXXXXXXXXXXXXXXXGXXXXXXXXXXXXXXXXXXXGXXXXXXXXXXXXXXXXXXXGXXXXXXXXXXXXXXXXXXXGXXXXXXXXXXXXXXXXXXXGXXXXXXXXXXXXXXXXXXXGXXXXXXXXXXXXXXXXXXXGXXXXXXXXXXXXXXXXXXXGXXXXXXXXXXXXXXXXXXXGXXXXXXXXXXXXXXXXXXXGXXXXXXXXXXXXXXXXXXXGXXXXXXXXXXXXXXXXXXXGXXXXXXXXXXXXXXXXXXX,0,10,0
45738,14,1,13,58,528,0,0,542,433,109,GXXXXXXXXXXXXXXXXXXXGXXXXXXXXXXXXXXXXXXXGXXXXXXXXXXXXXXXXXXXGXXXXXXXXXXXXXXXXXXXGAXXXXXXXXXXXXXXXXXXGXXXXXXXXXXXXXXXXXXXGXXXXXXXXXXXXXXXXXXXGXXXXXXXXXXXXXXXXXXXGXXXXXXXXXXXXXXXXXXXGXXXXXXXXXXXXXXXXXXXGXXXXXXXXXXXXXXXXXXXGXXXXXXXXXXXXXXXXXXXGXXXXXXXXXXXXXXXXXXX,0,10,0
45759,14,1,13,58,528,0,0,542,437,105,GXXXXXXXXXXXXXXXXXXXGXXXXXXXXXXXXXXXXXXXGXXXXXXXXXXXXXXXXXXXGXXXXXXXXXXXXXXXXXXXGAXXXXXXXXXXXXXXXXXXGXXXXXXXXXXXXXXXXXXXGXXXXXXXXXXXXXXXXXXXGXXXXXXXXXXXXXXXXXXXGXXXXXXXXXXXXXXXXXXXGXXXXXXXXXXXXXXXXXXXGXXXXXXXXXXXXXXXXXXXGXXXXXXXXXXXXXXXXXXXGXXXXXXXXXXXXXXXXXXX,0,10,0

45780,14,1,13,61,525,0,0,538,436,102,GXXXXXXXXXXXXXXXXXXXGXXXXXXXXXXXXXXXXXXXGXXXXXXXXXXXXXXXXXXXGXXXXXXXXXXXXXXXXXXXGAXXXXXXXXXXXXXXXXXXGXXXXXXXXXXXXXXXXXXXGXXXXXXXXXXXXXXXXXXXGXXXXXXXXXXXXXXXXXXXGXXXXXXXXXXXXXXXXXXXGXXXXXXXXXXXXXXXXXXXGXXXXXXXXXXXXXXXXXXXGXXXXXXXXXXXXXXXXXXXGXXXXXXXXXXXXXXXXXXX,0,10,0
45801,14,1,13,57,529,0,0,542,439,103,GXXXXXXXXXXXXXXXXXXXGXXXXXXXXXXXXXXXXXXXGXXXXXXXXXXXXXXXXXXXGXXXXXXXXXXXXXXXXXXXGAXXXXXXXXXXXXXXXXXXGXXXXXXXXXXXXXXXXXXXGXXXXXXXXXXXXXXXXXXXGXXXXXXXXXXXXXXXXXXXGXXXXXXXXXXXXXXXXXXXGXXXXXXXXXXXXXXXXXXXGXXXXXXXXXXXXXXXXXXXGXXXXXXXXXXXXXXXXXXXGXXXXXXXXXXXXXXXXXXX,0,10,0
45822,14,1,13,56,530,0,0,543,444,99,GXXXXXXXXXXXXXXXXXXXGXXXXXXXXXXXXXXXXXXXGXXXXXXXXXXXXXXXXXXXGXXXXXXXXXXXXXXXXXXXGAXXXXXXXXXXXXXXXXXXGXXXXXXXXXXXXXXXXXXXGXXXXXXXXXXXXXXXXXXXGXXXXXXXXXXXXXXXXXXXGXXXXXXXXXXXXXXXXXXXGXXXXXXXXXXXXXXXXXXXGXXXXXXXXXXXXXXXXXXXGXXXXXXXXXXXXXXXXXXXGXXXXXXXXXXXXXXXXXXX,0,10,0
45843,14,1,13,65,521,0,0,535,438,97,GXXXXXXXXXXXXXXXXXXXGXXXXXXXXXXXXXXXXXXXGXXXXXXXXXXXXXXXXXXXGXXXXXXXXXXXXXXXXXXXGAXXXXXXXXXXXXXXXXXXGXXXXXXXXXXXXXXXXXXXGXXXXXXXXXXXXXXXXXXXGXXXXXXXXXXXXXXXXXXXGXXXXXXXXXXXXXXXXXXXGXXXXXXXXXXXXXXXXXXXGXXXXXXXXXXXXXXXXXXXGXXXXXXXXXXXXXXXXXXXGXXXXXXXXXXXXXXXXXXX,0,10,0
45864,14,1,13,64,522,0,0,536,437,99,GXXXXXXXXXXXXXXXXXXXGXXXXXXXXXXXXXXXXXXXGXXXXXXXXXXXXXXXXXXXGXXXXXXXXXXXXXXXXXXXGAXXXXXXXXXXXXXXXXXXGXXXXXXXXXXXXXXXXXXXGXXXXXXXXXXXXXXXXXXXGXXXXXXXXXXXXXXXXXXXGXXXXXXXXXXXXXXXXXXXGXXXXXXXXXXXXXXXXXXXGXXXXXXXXXXXXXXXXXXXGXXXXXXXXXXXXXXXXXXXGXXXXXXXXXXXXXXXXXXX,0,10,0

45885,14,1,13,61,525,0,0,539,438,101,GXXXXXXXXXXXXXXXXXXXGXXXXXXXXXXXXXXXXXXXGXXXXXXXXXXXXXXXXXXXGXXXXXXXXXXXXXXXXXXXGAXXXXXXXXXXXXXXXXXXGXXXXXXXXXXXXXXXXXXXGXXXXXXXXXXXXXXXXXXXGXXXXXXXXXXXXXXXXXXXGXXXXXXXXXXXXXXXXXXXGXXXXXXXXXXXXXXXXXXXGXXXXXXXXXXXXXXXXXXXGXXXXXXXXXXXXXXXXXXXGXXXXXXXXXXXXXXXXXXX,0,10,0
45906,14,1,13,65,521,0,0,535,439,96,GXXXXXXXXXXXXXXXXXXXGXXXXXXXXXXXXXXXXXXXGXXXXXXXXXXXXXXXXXXXGXXXXXXXXXXXXXXXXXXXGAXXXXXXXXXXXXXXXXXXGXXXXXXXXXXXXXXXXXXXGXXXXXXXXXXXXXXXXXXXGXXXXXXXXXXXXXXXXXXXGXXXXXXXXXXXXXXXXXXXGXXXXXXXXXXXXXXXXXXXGXXXXXXXXXXXXXXXXXXXGXXXXXXXXXXXXXXXXXXXGXXXXXXXXXXXXXXXXXXX,0,10,0
45927,14,1,13,63,523,0,0,537,436,101,GXXXXXXXXXXXXXXXXXXXGXXXXXXXXXXXXXXXXXXXGXXXXXXXXXXXXXXXXXXXGXXXXXXXXXXXXXXXXXXXGAXXXXXXXXXXXXXXXXXXGXXXXXXXXXXXXXXXXXXXGXXXXXXXXXXXXXXXXXXXGXXXXXXXXXXXXXXXXXXXGXXXXXXXXXXXXXXXXXXXGXXXXXXXXXXXXXXXXXXXGXXXXXXXXXXXXXXXXXXXGXXXXXXXXXXXXXXXXXXXGXXXXXXXXXXXXXXXXXXX,0,10,0
45948,14,1,13,68,518,0,0,531,435,96,GXXXXXXXXXXXXXXXXXXXGXXXXXXXXXXXXXXXXXXXGXXXXXXXXXXXXXXXXXXXGXXXXXXXXXXXXXXXXXXXGAXXXXXXXXXXXXXXXXXXGXXXXXXXXXXXXXXXXXXXGXXXXXXXXXXXXXXXXXXXGXXXXXXXXXXXXXXXXXXXGXXXXXXXXXXXXXXXXXXXGXXXXXXXXXXXXXXXXXXXGXXXXXXXXXXXXXXXXXXXGXXXXXXXXXXXXXXXXXXXGXXXXXXXXXXXXXXXXXXX,0,10,0
45969,15,1,14,66,519,0,0,531,433,98,GXXXXXXXXXXXXXXXXXXXGXXXXXXXXXXXXXXXXXXXGXXXXXXXXXXXXXXXXXXXGXXXXXXXXXXXXXXXXXXXGOXXXXXXXXXXXXXXXXXXGXXXXXXXXXXXXXXXXXXXGAXXXXXXXXXXXXXXXXXXGXXXXXXXXXXXXXXXXXXXGXXXXXXXXXXXXXXXXXXXGXXXXXXXXXXXXXXXXXXXGXXXXXXXXXXXXXXXXXXXGXXXXXXXXXXXXXXXXXXXGXXXXXXXXXXXXXXXXXXX,0,10,0

45990,15,1,14,62,523,0,0,536,435,101,GXXXXXXXXXXXXXXXXXXXGXXXXXXXXXXXXXXXXXXXGXXXXXXXXXXXXXXXXXXXGXXXXXXXXXXXXXXXXXXXGOXXXXXXXXXXXXXXXXXXGXXXXXXXXXXXXXXXXXXXGAXXXXXXXXXXXXXXXXXXGXXXXXXXXXXXXXXXXXXXGXXXXXXXXXXXXXXXXXXXGXXXXXXXXXXXXXXXXXXXGXXXXXXXXXXXXXXXXXXXGXXXXXXXXXXXXXXXXXXXGXXXXXXXXXXXXXXXXXXX,0,10,0
46011,14,1,13,60,526,0,0,539,437,102,GXXXXXXXXXXXXXXXXXXXGXXXXXXXXXXXXXXXXXXXGXXXXXXXXXXXXXXXXXXXGXXXXXXXXXXXXXXXXXXXGXXXXXXXXXXXXXXXXXXXGXXXXXXXXXXXXXXXXXXXGAXXXXXXXXXXXXXXXXXXGXXXXXXXXXXXXXXXXXXXGXXXXXXXXXXXXXXXXXXXGXXXXXXXXXXXXXXXXXXXGXXXXXXXXXXXXXXXXXXXGXXXXXXXXXXXXXXXXXXXGXXXXXXXXXXXXXXXXXXX,0,10,0
46032,14,1,13,54,532,0,0,544,435,109,GXXXXXXXXXXXXXXXXXXXGXXXXXXXXXXXXXXXXXXXGXXXXXXXXXXXXXXXXXXXGXXXXXXXXXXXXXXXXXXXGXXXXXXXXXXXXXXXXXXXGXXXXXXXXXXXXXXXXXXXGAXXXXXXXXXXXXXXXXXXGXXXXXXXXXXXXXXXXXXXGXXXXXXXXXXXXXXXXXXXGXXXXXXXXXXXXXXXXXXXGXXXXXXXXXXXXXXXXXXXGXXXXXXXXXXXXXXXXXXXGXXXXXXXXXXXXXXXXXXX,0,10,0
46053,14,1,13,55,531,0,0,543,436,107,GXXXXXXXXXXXXXXXXXXXGXXXXXXXXXXXXXXXXXXXGXXXXXXXXXXXXXXXXXXXGXXXXXXXXXXXXXXXXXXXGXXXXXXXXXXXXXXXXXXXGXXXXXXXXXXXXXXXXXXXGAXXXXXXXXXXXXXXXXXXGXXXXXXXXXXXXXXXXXXXGXXXXXXXXXXXXXXXXXXXGXXXXXXXXXXXXXXXXXXXGXXXXXXXXXXXXXXXXXXXGXXXXXXXXXXXXXXXXXXXGXXXXXXXXXXXXXXXXXXX,0,10,0
46074,14,1,13,51,535,0,0,548,439,109,GXXXXXXXXXXXXXXXXXXXGXXXXXXXXXXXXXXXXXXXGXXXXXXXXXXXXXXXXXXXGXXXXXXXXXXXXXXXXXXXGXXXXXXXXXXXXXXXXXXXGXXXXXXXXXXXXXXXXXXXGAXXXXXXXXXXXXXXXXXXGXXXXXXXXXXXXXXXXXXXGXXXXXXXXXXXXXXXXXXXGXXXXXXXXXXXXXXXXXXXGXXXXXXXXXXXXXXXXXXXGXXXXXXXXXXXXXXXXXXXGXXXXXXXXXXXXXXXXXXX,0,10,0

46095,14,1,13,56,530,0,0,543,438,105,GXXXXXXXXXXXXXXXXXXXGXXXXXXXXXXXXXXXXXXXGXXXXXXXXXXXXXXXXXXXGXXXXXXXXXXXXXXXXXXXGXXXXXXXXXXXXXXXXXXXGXXXXXXXXXXXXXXXXXXXGAXXXXXXXXXXXXXXXXXXGXXXXXXXXXXXXXXXXXXXGXXXXXXXXXXXXXXXXXXXGXXXXXXXXXXXXXXXXXXXGXXXXXXXXXXXXXXXXXXXGXXXXXXXXXXXXXXXXXXXGXXXXXXXXXXXXXXXXXXX,0,10,0
46116,14,1,13,55,531,0,0,543,435,108,GXXXXXXXXXXXXXXXXXXXGXXXXXXXXXXXXXXXXXXXGXXXXXXXXXXXXXXXXXXXGXXXXXXXXXXXXXXXXXXXGXXXXXXXXXXXXXXXXXXXGXXXXXXXXXXXXXXXXXXXGAXXXXXXXXXXXXXXXXXXGXXXXXXXXXXXXXXXXXXXGXXXXXXXXXXXXXXXXXXXGXXXXXXXXXXXXXXXXXXXGXXXXXXXXXXXXXXXXXXXGXXXXXXXXXXXXXXXXXXXGXXXXXXXXXXXXXXXXXXX,0,10,0
46137,13,0,13,55,532,0,0,545,434,111,GXXXXXXXXXXXXXXXXXXXGXXXXXXXXXXXXXXXXXXXGXXXXXXXXXXXXXXXXXXXGXXXXXXXXXXXXXXXXXXXGXXXXXXXXXXXXXXXXXXXGXXXXXXXXXXXXXXXXXXXGXXXXXXXXXXXXXXXXXXXGXXXXXXXXXXXXXXXXXXXGXXXXXXXXXXXXXXXXXXXGXXXXXXXXXXXXXXXXXXXGXXXXXXXXXXXXXXXXXXXGXXXXXXXXXXXXXXXXXXXGXXXXXXXXXXXXXXXXXXX,0,10,0
46158,13,0,13,49,538,0,0,550,437,113,GXXXXXXXXXXXXXXXXXXXGXXXXXXXXXXXXXXXXXXXGXXXXXXXXXXXXXXXXXXXGXXXXXXXXXXXXXXXXXXXGXXXXXXXXXXXXXXXXXXXGXXXXXXXXXXXXXXXXXXXGXXXXXXXXXXXXXXXXXXXGXXXXXXXXXXXXXXXXXXXGXXXXXXXXXXXXXXXXXXXGXXXXXXXXXXXXXXXXXXXGXXXXXXXXXXXXXXXXXXXGXXXXXXXXXXXXXXXXXXXGXXXXXXXXXXXXXXXXXXX,0,10,0
46179,13,0,13,49,538,0,0,551,433,118,GXXXXXXXXXXXXXXXXXXXGXXXXXXXXXXXXXXXXXXXGXXXXXXXXXXXXXXXXXXXGXXXXXXXXXXXXXXXXXXXGXXXXXXXXXXXXXXXXXXXGXXXXXXXXXXXXXXXXXXXGXXXXXXXXXXXXXXXXXXXGXXXXXXXXXXXXXXXXXXXGXXXXXXXXXXXXXXXXXXXGXXXXXXXXXXXXXXXXXXXGXXXXXXXXXXXXXXXXXXXGXXXXXXXXXXXXXXXXXXXGXXXXXXXXXXXXXXXXXXX,0,10,0

46200,13,0,13,42,545,0,0,559,436,123,GXXXXXXXXXXXXXXXXXXXGXXXXXXXXXXXXXXXXXXXGXXXXXXXXXXXXXXXXXXXGXXXXXXXXXXXXXXXXXXXGXXXXXXXXXXXXXXXXXXXGXXXXXXXXXXXXXXXXXXXGXXXXXXXXXXXXXXXXXXXGXXXXXXXXXXXXXXXXXXXGXXXXXXXXXXXXXXXXXXXGXXXXXXXXXXXXXXXXXXXGXXXXXXXXXXXXXXXXXXXGXXXXXXXXXXXXXXXXXXXGXXXXXXXXXXXXXXXXXXX,0,10,0
46221,13,0,13,45,542,0,0,555,434,121,GXXXXXXXXXXXXXXXXXXXGXXXXXXXXXXXXXXXXXXXGXXXXXXXXXXXXXXXXXXXGXXXXXXXXXXXXXXXXXXXGXXXXXXXXXXXXXXXXXXXGXXXXXXXXXXXXXXXXXXXGXXXXXXXXXXXXXXXXXXXGXXXXXXXXXXXXXXXXXXXGXXXXXXXXXXXXXXXXXXXGXXXXXXXXXXXXXXXXXXXGXXXXXXXXXXXXXXXXXXXGXXXXXXXXXXXXXXXXXXXGXXXXXXXXXXXXXXXXXXX,0,10,0
46242,13,0,13,42,545,0,0,559,436,123,GXXXXXXXXXXXXXXXXXXXGXXXXXXXXXXXXXXXXXXXGXXXXXXXXXXXXXXXXXXXGXXXXXXXXXXXXXXXXXXXGXXXXXXXXXXXXXXXXXXXGXXXXXXXXXXXXXXXXXXXGXXXXXXXXXXXXXXXXXXXGXXXXXXXXXXXXXXXXXXXGXXXXXXXXXXXXXXXXXXXGXXXXXXXXXXXXXXXXXXXGXXXXXXXXXXXXXXXXXXXGXXXXXXXXXXXXXXXXXXXGXXXXXXXXXXXXXXXXXXX,0,10,0
46263,13,0,13,46,541,0,0,554,441,113,GXXXXXXXXXXXXXXXXXXXGXXXXXXXXXXXXXXXXXXXGXXXXXXXXXXXXXXXXXXXGXXXXXXXXXXXXXXXXXXXGXXXXXXXXXXXXXXXXXXXGXXXXXXXXXXXXXXXXXXXGXXXXXXXXXXXXXXXXXXXGXXXXXXXXXXXXXXXXXXXGXXXXXXXXXXXXXXXXXXXGXXXXXXXXXXXXXXXXXXXGXXXXXXXXXXXXXXXXXXXGXXXXXXXXXXXXXXXXXXXGXXXXXXXXXXXXXXXXXXX,0,10,0
46284,13,0,13,53,534,0,0,548,435,113,GXXXXXXXXXXXXXXXXXXXGXXXXXXXXXXXXXXXXXXXGXXXXXXXXXXXXXXXXXXXGXXXXXXXXXXXXXXXXXXXGXXXXXXXXXXXXXXXXXXXGXXXXXXXXXXXXXXXXXXXGXXXXXXXXXXXXXXXXXXXGXXXXXXXXXXXXXXXXXXXGXXXXXXXXXXXXXXXXXXXGXXXXXXXXXXXXXXXXXXXGXXXXXXXXXXXXXXXXXXXGXXXXXXXXXXXXXXXXXXXGXXXXXXXXXXXXXXXXXXX,0,10,0

46305,13,0,13,52,535,0,0,550,439,111,GXXXXXXXXXXXXXXXXXXXGXXXXXXXXXXXXXXXXXXXGXXXXXXXXXXXXXXXXXXXGXXXXXXXXXXXXXXXXXXXGXXXXXXXXXXXXXXXXXXXGXXXXXXXXXXXXXXXXXXXGXXXXXXXXXXXXXXXXXXXGXXXXXXXXXXXXXXXXXXXGXXXXXXXXXXXXXXXXXXXGXXXXXXXXXXXXXXXXXXXGXXXXXXXXXXXXXXXXXXXGXXXXXXXXXXXXXXXXXXXGXXXXXXXXXXXXXXXXXXX,0,10,0
46326,13,0,13,56,531,0,0,546,443,103,GXXXXXXXXXXXXXXXXXXXGXXXXXXXXXXXXXXXXXXXGXXXXXXXXXXXXXXXXXXXGXXXXXXXXXXXXXXXXXXXGXXXXXXXXXXXXXXXXXXXGXXXXXXXXXXXXXXXXXXXGXXXXXXXXXXXXXXXXXXXGXXXXXXXXXXXXXXXXXXXGXXXXXXXXXXXXXXXXXXXGXXXXXXXXXXXXXXXXXXXGXXXXXXXXXXXXXXXXXXXGXXXXXXXXXXXXXXXXXXXGXXXXXXXXXXXXXXXXXXX,0,10,0
46347,13,0,13,56,531,0,0,545,444,101,GXXXXXXXXXXXXXXXXXXXGXXXXXXXXXXXXXXXXXXXGXXXXXXXXXXXXXXXXXXXGXXXXXXXXXXXXXXXXXXXGXXXXXXXXXXXXXXXXXXXGXXXXXXXXXXXXXXXXXXXGXXXXXXXXXXXXXXXXXXXGXXXXXXXXXXXXXXXXXXXGXXXXXXXXXXXXXXXXXXXGXXXXXXXXXXXXXXXXXXXGXXXXXXXXXXXXXXXXXXXGXXXXXXXXXXXXXXXXXXXGXXXXXXXXXXXXXXXXXXX,0,10,0
46368,13,0,13,56,531,0,0,547,444,103,GXXXXXXXXXXXXXXXXXXXGXXXXXXXXXXXXXXXXXXXGXXXXXXXXXXXXXXXXXXXGXXXXXXXXXXXXXXXXXXXGXXXXXXXXXXXXXXXXXXXGXXXXXXXXXXXXXXXXXXXGXXXXXXXXXXXXXXXXXXXGXXXXXXXXXXXXXXXXXXXGXXXXXXXXXXXXXXXXXXXGXXXXXXXXXXXXXXXXXXXGXXXXXXXXXXXXXXXXXXXGXXXXXXXXXXXXXXXXXXXGXXXXXXXXXXXXXXXXXXX,0,10,0
46389,13,0,13,63,524,0,0,540,444,96,GXXXXXXXXXXXXXXXXXXXGXXXXXXXXXXXXXXXXXXXGXXXXXXXXXXXXXXXXXXXGXXXXXXXXXXXXXXXXXXXGXXXXXXXXXXXXXXXXXXXGXXXXXXXXXXXXXXXXXXXGXXXXXXXXXXXXXXXXXXXGXXXXXXXXXXXXXXXXXXXGXXXXXXXXXXXXXXXXXXXGXXXXXXXXXXXXXXXXXXXGXXXXXXXXXXXXXXXXXXXGXXXXXXXXXXXXXXXXXXXGXXXXXXXXXXXXXXXXXXX,0,10,0

46410,13,0,13,66,521,0,0,536,441,95,GXXXXXXXXXXXXXXXXXXXGXXXXXXXXXXXXXXXXXXXGXXXXXXXXXXXXXXXXXXXGXXXXXXXXXXXXXXXXXXXGXXXXXXXXXXXXXXXXXXXGXXXXXXXXXXXXXXXXXXXGXXXXXXXXXXXXXXXXXXXGXXXXXXXXXXXXXXXXXXXGXXXXXXXXXXXXXXXXXXXGXXXXXXXXXXXXXXXXXXXGXXXXXXXXXXXXXXXXXXXGXXXXXXXXXXXXXXXXXXXGXXXXXXXXXXXXXXXXXXX,0,10,0
46431,13,0,13,63,524,0,0,539,441,98,GXXXXXXXXXXXXXXXXXXXGXXXXXXXXXXXXXXXXXXXGXXXXXXXXXXXXXXXXXXXGXXXXXXXXXXXXXXXXXXXGXXXXXXXXXXXXXXXXXXXGXXXXXXXXXXXXXXXXXXXGXXXXXXXXXXXXXXXXXXXGXXXXXXXXXXXXXXXXXXXGXXXXXXXXXXXXXXXXXXXGXXXXXXXXXXXXXXXXXXXGXXXXXXXXXXXXXXXXXXXGXXXXXXXXXXXXXXXXXXXGXXXXXXXXXXXXXXXXXXX,0,10,0
46452,13,0,13,64,523,0,0,537,439,98,GXXXXXXXXXXXXXXXXXXXGXXXXXXXXXXXXXXXXXXXGXXXXXXXXXXXXXXXXXXXGXXXXXXXXXXXXXXXXXXXGXXXXXXXXXXXXXXXXXXXGXXXXXXXXXXXXXXXXXXXGXXXXXXXXXXXXXXXXXXXGXXXXXXXXXXXXXXXXXXXGXXXXXXXXXXXXXXXXXXXGXXXXXXXXXXXXXXXXXXXGXXXXXXXXXXXXXXXXXXXGXXXXXXXXXXXXXXXXXXXGXXXXXXXXXXXXXXXXXXX,0,10,0
46473,13,0,13,64,523,0,0,538,439,99,GXXXXXXXXXXXXXXXXXXXGXXXXXXXXXXXXXXXXXXXGXXXXXXXXXXXXXXXXXXXGXXXXXXXXXXXXXXXXXXXGXXXXXXXXXXXXXXXXXXXGXXXXXXXXXXXXXXXXXXXGXXXXXXXXXXXXXXXXXXXGXXXXXXXXXXXXXXXXXXXGXXXXXXXXXXXXXXXXXXXGXXXXXXXXXXXXXXXXXXXGXXXXXXXXXXXXXXXXXXXGXXXXXXXXXXXXXXXXXXXGXXXXXXXXXXXXXXXXXXX,0,10,0
46494,13,0,13,64,523,0,0,536,436,100,GXXXXXXXXXXXXXXXXXXXGXXXXXXXXXXXXXXXXXXXGXXXXXXXXXXXXXXXXXXXGXXXXXXXXXXXXXXXXXXXGXXXXXXXXXXXXXXXXXXXGXXXXXXXXXXXXXXXXXXXGXXXXXXXXXXXXXXXXXXXGXXXXXXXXXXXXXXXXXXXGXXXXXXXXXXXXXXXXXXXGXXXXXXXXXXXXXXXXXXXGXXXXXXXXXXXXXXXXXXXGXXXXXXXXXXXXXXXXXXXGXXXXXXXXXXXXXXXXXXX,0,10,0

46515,13,0,13,58,529,0,0,542,438,104,GXXXXXXXXXXXXXXXXXXXGXXXXXXXXXXXXXXXXXXXGXXXXXXXXXXXXXXXXXXXGXXXXXXXXXXXXXXXXXXXGXXXXXXXXXXXXXXXXXXXGXXXXXXXXXXXXXXXXXXXGXXXXXXXXXXXXXXXXXXXGXXXXXXXXXXXXXXXXXXXGXXXXXXXXXXXXXXXXXXXGXXXXXXXXXXXXXXXXXXXGXXXXXXXXXXXXXXXXXXXGXXXXXXXXXXXXXXXXXXXGXXXXXXXXXXXXXXXXXXX,0,10,0
46536,13,0,13,61,526,0,0,539,439,100,GXXXXXXXXXXXXXXXXXXXGXXXXXXXXXXXXXXXXXXXGXXXXXXXXXXXXXXXXXXXGXXXXXXXXXXXXXXXXXXXGXXXXXXXXXXXXXXXXXXXGXXXXXXXXXXXXXXXXXXXGXXXXXXXXXXXXXXXXXXXGXXXXXXXXXXXXXXXXXXXGXXXXXXXXXXXXXXXXXXXGXXXXXXXXXXXXXXXXXXXGXXXXXXXXXXXXXXXXXXXGXXXXXXXXXXXXXXXXXXXGXXXXXXXXXXXXXXXXXXX,0,10,0
46557,14,1,13,63,523,0,0,536,434,102,GXXXXXXXXXXXXXXXXXXXGXXXXXXXXXXXXXXXXXXXGXXXXXXXXXXXXXXXXXXXGXXXXXXXXXXXXXXXXXXXGXXXXXXXXXXXXXXXXXXXGAXXXXXXXXXXXXXXXXXXGXXXXXXXXXXXXXXXXXXXGXXXXXXXXXXXXXXXXXXXGXXXXXXXXXXXXXXXXXXXGXXXXXXXXXXXXXXXXXXXGXXXXXXXXXXXXXXXXXXXGXXXXXXXXXXXXXXXXXXXGXXXXXXXXXXXXXXXXXXX,0,10,0
46578,14,1,13,60,526,0,0,540,440,100,GXXXXXXXXXXXXXXXXXXXGXXXXXXXXXXXXXXXXXXXGXXXXXXXXXXXXXXXXXXXGXXXXXXXXXXXXXXXXXXXGXXXXXXXXXXXXXXXXXXXGAXXXXXXXXXXXXXXXXXXGXXXXXXXXXXXXXXXXXXXGXXXXXXXXXXXXXXXXXXXGXXXXXXXXXXXXXXXXXXXGXXXXXXXXXXXXXXXXXXXGXXXXXXXXXXXXXXXXXXXGXXXXXXXXXXXXXXXXXXXGXXXXXXXXXXXXXXXXXXX,0,10,0
46599,13,0,13,60,527,0,0,540,439,101,GXXXXXXXXXXXXXXXXXXXGXXXXXXXXXXXXXXXXXXXGXXXXXXXXXXXXXXXXXXXGXXXXXXXXXXXXXXXXXXXGXXXXXXXXXXXXXXXXXXXGXXXXXXXXXXXXXXXXXXXGXXXXXXXXXXXXXXXXXXXGXXXXXXXXXXXXXXXXXXXGXXXXXXXXXXXXXXXXXXXGXXXXXXXXXXXXXXXXXXXGXXXXXXXXXXXXXXXXXXXGXXXXXXXXXXXXXXXXXXXGXXXXXXXXXXXXXXXXXXX,0,10,0

46620,13,0,13,59,528,0,0,541,440,101,GXXXXXXXXXXXXXXXXXXXGXXXXXXXXXXXXXXXXXXXGXXXXXXXXXXXXXXXXXXXGXXXXXXXXXXXXXXXXXXXGXXXXXXXXXXXXXXXXXXXGXXXXXXXXXXXXXXXXXXXGXXXXXXXXXXXXXXXXXXXGXXXXXXXXXXXXXXXXXXXGXXXXXXXXXXXXXXXXXXXGXXXXXXXXXXXXXXXXXXXGXXXXXXXXXXXXXXXXXXXGXXXXXXXXXXXXXXXXXXXGXXXXXXXXXXXXXXXXXXX,0,10,0
46641,13,0,13,54,533,0,0,546,444,102,GXXXXXXXXXXXXXXXXXXXGXXXXXXXXXXXXXXXXXXXGXXXXXXXXXXXXXXXXXXXGXXXXXXXXXXXXXXXXXXXGXXXXXXXXXXXXXXXXXXXGXXXXXXXXXXXXXXXXXXXGXXXXXXXXXXXXXXXXXXXGXXXXXXXXXXXXXXXXXXXGXXXXXXXXXXXXXXXXXXXGXXXXXXXXXXXXXXXXXXXGXXXXXXXXXXXXXXXXXXXGXXXXXXXXXXXXXXXXXXXGXXXXXXXXXXXXXXXXXXX,0,10,0
46662,13,0,13,58,529,0,0,542,442,100,GXXXXXXXXXXXXXXXXXXXGXXXXXXXXXXXXXXXXXXXGXXXXXXXXXXXXXXXXXXXGXXXXXXXXXXXXXXXXXXXGXXXXXXXXXXXXXXXXXXXGXXXXXXXXXXXXXXXXXXXGXXXXXXXXXXXXXXXXXXXGXXXXXXXXXXXXXXXXXXXGXXXXXXXXXXXXXXXXXXXGXXXXXXXXXXXXXXXXXXXGXXXXXXXXXXXXXXXXXXXGXXXXXXXXXXXXXXXXXXXGXXXXXXXXXXXXXXXXXXX,0,10,0
46683,13,0,13,57,530,0,0,543,440,103,GXXXXXXXXXXXXXXXXXXXGXXXXXXXXXXXXXXXXXXXGXXXXXXXXXXXXXXXXXXXGXXXXXXXXXXXXXXXXXXXGXXXXXXXXXXXXXXXXXXXGXXXXXXXXXXXXXXXXXXXGXXXXXXXXXXXXXXXXXXXGXXXXXXXXXXXXXXXXXXXGXXXXXXXXXXXXXXXXXXXGXXXXXXXXXXXXXXXXXXXGXXXXXXXXXXXXXXXXXXXGXXXXXXXXXXXXXXXXXXXGXXXXXXXXXXXXXXXXXXX,0,10,0
46704,13,0,13,57,530,0,0,543,441,102,GXXXXXXXXXXXXXXXXXXXGXXXXXXXXXXXXXXXXXXXGXXXXXXXXXXXXXXXXXXXGXXXXXXXXXXXXXXXXXXXGXXXXXXXXXXXXXXXXXXXGXXXXXXXXXXXXXXXXXXXGXXXXXXXXXXXXXXXXXXXGXXXXXXXXXXXXXXXXXXXGXXXXXXXXXXXXXXXXXXXGXXXXXXXXXXXXXXXXXXXGXXXXXXXXXXXXXXXXXXXGXXXXXXXXXXXXXXXXXXXGXXXXXXXXXXXXXXXXXXX,0,10,0

46725,13,0,13,57,530,0,0,542,440,102,GXXXXXXXXXXXXXXXXXXXGXXXXXXXXXXXXXXXXXXXGXXXXXXXXXXXXXXXXXXXGXXXXXXXXXXXXXXXXXXXGXXXXXXXXXXXXXXXXXXXGXXXXXXXXXXXXXXXXXXXGXXXXXXXXXXXXXXXXXXXGXXXXXXXXXXXXXXXXXXXGXXXXXXXXXXXXXXXXXXXGXXXXXXXXXXXXXXXXXXXGXXXXXXXXXXXXXXXXXXXGXXXXXXXXXXXXXXXXXXXGXXXXXXXXXXXXXXXXXXX,0,10,0
46746,13,0,13,59,528,0,0,540,439,101,GXXXXXXXXXXXXXXXXXXXGXXXXXXXXXXXXXXXXXXXGXXXXXXXXXXXXXXXXXXXGXXXXXXXXXXXXXXXXXXXGXXXXXXXXXXXXXXXXXXXGXXXXXXXXXXXXXXXXXXXGXXXXXXXXXXXXXXXXXXXGXXXXXXXXXXXXXXXXXXXGXXXXXXXXXXXXXXXXXXXGXXXXXXXXXXXXXXXXXXXGXXXXXXXXXXXXXXXXXXXGXXXXXXXXXXXXXXXXXXXGXXXXXXXXXXXXXXXXXXX,0,10,0
46767,13,0,13,60,527,0,0,540,438,102,GXXXXXXXXXXXXXXXXXXXGXXXXXXXXXXXXXXXXXXXGXXXXXXXXXXXXXXXXXXXGXXXXXXXXXXXXXXXXXXXGXXXXXXXXXXXXXXXXXXXGXXXXXXXXXXXXXXXXXXXGXXXXXXXXXXXXXXXXXXXGXXXXXXXXXXXXXXXXXXXGXXXXXXXXXXXXXXXXXXXGXXXXXXXXXXXXXXXXXXXGXXXXXXXXXXXXXXXXXXXGXXXXXXXXXXXXXXXXXXXGXXXXXXXXXXXXXXXXXXX,0,10,0
46788,13,0,13,58,529,0,0,542,438,104,GXXXXXXXXXXXXXXXXXXXGXXXXXXXXXXXXXXXXXXXGXXXXXXXXXXXXXXXXXXXGXXXXXXXXXXXXXXXXXXXGXXXXXXXXXXXXXXXXXXXGXXXXXXXXXXXXXXXXXXXGXXXXXXXXXXXXXXXXXXXGXXXXXXXXXXXXXXXXXXXGXXXXXXXXXXXXXXXXXXXGXXXXXXXXXXXXXXXXXXXGXXXXXXXXXXXXXXXXXXXGXXXXXXXXXXXXXXXXXXXGXXXXXXXXXXXXXXXXXXX,0,10,0
46809,13,0,13,55,532,0,0,543,436,107,GXXXXXXXXXXXXXXXXXXXGXXXXXXXXXXXXXXXXXXXGXXXXXXXXXXXXXXXXXXXGXXXXXXXXXXXXXXXXXXXGXXXXXXXXXXXXXXXXXXXGXXXXXXXXXXXXXXXXXXXGXXXXXXXXXXXXXXXXXXXGXXXXXXXXXXXXXXXXXXXGXXXXXXXXXXXXXXXXXXXGXXXXXXXXXXXXXXXXXXXGXXXXXXXXXXXXXXXXXXXGXXXXXXXXXXXXXXXXXXXGXXXXXXXXXXXXXXXXXXX,0,10,0

46830,13,0,13,55,532,0,0,545,443,102,GXXXXXXXXXXXXXXXXXXXGXXXXXXXXXXXXXXXXXXXGXXXXXXXXXXXXXXXXXXXGXXXXXXXXXXXXXXXXXXXGXXXXXXXXXXXXXXXXXXXGXXXXXXXXXXXXXXXXXXXGXXXXXXXXXXXXXXXXXXXGXXXXXXXXXXXXXXXXXXXGXXXXXXXXXXXXXXXXXXXGXXXXXXXXXXXXXXXXXXXGXXXXXXXXXXXXXXXXXXXGXXXXXXXXXXXXXXXXXXXGXXXXXXXXXXXXXXXXXXX,0,10,0
46851,13,0,13,59,528,0,0,541,438,103,GXXXXXXXXXXXXXXXXXXXGXXXXXXXXXXXXXXXXXXXGXXXXXXXXXXXXXXXXXXXGXXXXXXXXXXXXXXXXXXXGXXXXXXXXXXXXXXXXXXXGXXXXXXXXXXXXXXXXXXXGXXXXXXXXXXXXXXXXXXXGXXXXXXXXXXXXXXXXXXXGXXXXXXXXXXXXXXXXXXXGXXXXXXXXXXXXXXXXXXXGXXXXXXXXXXXXXXXXXXXGXXXXXXXXXXXXXXXXXXXGXXXXXXXXXXXXXXXXXXX,0,10,0
46872,13,0,13,57,530,0,0,542,437,105,GXXXXXXXXXXXXXXXXXXXGXXXXXXXXXXXXXXXXXXXGXXXXXXXXXXXXXXXXXXXGXXXXXXXXXXXXXXXXXXXGXXXXXXXXXXXXXXXXXXXGXXXXXXXXXXXXXXXXXXXGXXXXXXXXXXXXXXXXXXXGXXXXXXXXXXXXXXXXXXXGXXXXXXXXXXXXXXXXXXXGXXXXXXXXXXXXXXXXXXXGXXXXXXXXXXXXXXXXXXXGXXXXXXXXXXXXXXXXXXXGXXXXXXXXXXXXXXXXXXX,0,10,0
46893,13,0,13,60,527,0,0,540,439,101,GXXXXXXXXXXXXXXXXXXXGXXXXXXXXXXXXXXXXXXXGXXXXXXXXXXXXXXXXXXXGXXXXXXXXXXXXXXXXXXXGXXXXXXXXXXXXXXXXXXXGXXXXXXXXXXXXXXXXXXXGXXXXXXXXXXXXXXXXXXXGXXXXXXXXXXXXXXXXXXXGXXXXXXXXXXXXXXXXXXXGXXXXXXXXXXXXXXXXXXXGXXXXXXXXXXXXXXXXXXXGXXXXXXXXXXXXXXXXXXXGXXXXXXXXXXXXXXXXXXX,0,10,0
46914,13,0,13,59,528,0,0,540,439,101,GXXXXXXXXXXXXXXXXXXXGXXXXXXXXXXXXXXXXXXXGXXXXXXXXXXXXXXXXXXXGXXXXXXXXXXXXXXXXXXXGXXXXXXXXXXXXXXXXXXXGXXXXXXXXXXXXXXXXXXXGXXXXXXXXXXXXXXXXXXXGXXXXXXXXXXXXXXXXXXXGXXXXXXXXXXXXXXXXXXXGXXXXXXXXXXXXXXXXXXXGXXXXXXXXXXXXXXXXXXXGXXXXXXXXXXXXXXXXXXXGXXXXXXXXXXXXXXXXXXX,0,10,0

46935,13,0,13,52,535,0,0,547,441,106,GXXXXXXXXXXXXXXXXXXXGXXXXXXXXXXXXXXXXXXXGXXXXXXXXXXXXXXXXXXXGXXXXXXXXXXXXXXXXXXXGXXXXXXXXXXXXXXXXXXXGXXXXXXXXXXXXXXXXXXXGXXXXXXXXXXXXXXXXXXXGXXXXXXXXXXXXXXXXXXXGXXXXXXXXXXXXXXXXXXXGXXXXXXXXXXXXXXXXXXXGXXXXXXXXXXXXXXXXXXXGXXXXXXXXXXXXXXXXXXXGXXXXXXXXXXXXXXXXXXX,0,10,0
46956,13,0,13,53,534,0,0,547,439,108,GXXXXXXXXXXXXXXXXXXXGXXXXXXXXXXXXXXXXXXXGXXXXXXXXXXXXXXXXXXXGXXXXXXXXXXXXXXXXXXXGXXXXXXXXXXXXXXXXXXXGXXXXXXXXXXXXXXXXXXXGXXXXXXXXXXXXXXXXXXXGXXXXXXXXXXXXXXXXXXXGXXXXXXXXXXXXXXXXXXXGXXXXXXXXXXXXXXXXXXXGXXXXXXXXXXXXXXXXXXXGXXXXXXXXXXXXXXXXXXXGXXXXXXXXXXXXXXXXXXX,0,10,0
46977,13,0,13,54,533,0,0,546,439,107,GXXXXXXXXXXXXXXXXXXXGXXXXXXXXXXXXXXXXXXXGXXXXXXXXXXXXXXXXXXXGXXXXXXXXXXXXXXXXXXXGXXXXXXXXXXXXXXXXXXXGXXXXXXXXXXXXXXXXXXXGXXXXXXXXXXXXXXXXXXXGXXXXXXXXXXXXXXXXXXXGXXXXXXXXXXXXXXXXXXXGXXXXXXXXXXXXXXXXXXXGXXXXXXXXXXXXXXXXXXXGXXXXXXXXXXXXXXXXXXXGXXXXXXXXXXXXXXXXXXX,0,10,0
46998,13,0,13,51,536,0,0,549,442,107,GXXXXXXXXXXXXXXXXXXXGXXXXXXXXXXXXXXXXXXXGXXXXXXXXXXXXXXXXXXXGXXXXXXXXXXXXXXXXXXXGXXXXXXXXXXXXXXXXXXXGXXXXXXXXXXXXXXXXXXXGXXXXXXXXXXXXXXXXXXXGXXXXXXXXXXXXXXXXXXXGXXXXXXXXXXXXXXXXXXXGXXXXXXXXXXXXXXXXXXXGXXXXXXXXXXXXXXXXXXXGXXXXXXXXXXXXXXXXXXXGXXXXXXXXXXXXXXXXXXX,0,10,0
47019,13,0,13,53,534,0,0,547,440,107,GXXXXXXXXXXXXXXXXXXXGXXXXXXXXXXXXXXXXXXXGXXXXXXXXXXXXXXXXXXXGXXXXXXXXXXXXXXXXXXXGXXXXXXXXXXXXXXXXXXXGXXXXXXXXXXXXXXXXXXXGXXXXXXXXXXXXXXXXXXXGXXXXXXXXXXXXXXXXXXXGXXXXXXXXXXXXXXXXXXXGXXXXXXXXXXXXXXXXXXXGXXXXXXXXXXXXXXXXXXXGXXXXXXXXXXXXXXXXXXXGXXXXXXXXXXXXXXXXXXX,0,10,0

47040,13,0,13,56,531,0,0,544,441,103,GXXXXXXXXXXXXXXXXXXXGXXXXXXXXXXXXXXXXXXXGXXXXXXXXXXXXXXXXXXXGXXXXXXXXXXXXXXXXXXXGXXXXXXXXXXXXXXXXXXXGXXXXXXXXXXXXXXXXXXXGXXXXXXXXXXXXXXXXXXXGXXXXXXXXXXXXXXXXXXXGXXXXXXXXXXXXXXXXXXXGXXXXXXXXXXXXXXXXXXXGXXXXXXXXXXXXXXXXXXXGXXXXXXXXXXXXXXXXXXXGXXXXXXXXXXXXXXXXXXX,0,10,0
47061,13,0,13,59,528,0,0,540,439,101,GXXXXXXXXXXXXXXXXXXXGXXXXXXXXXXXXXXXXXXXGXXXXXXXXXXXXXXXXXXXGXXXXXXXXXXXXXXXXXXXGXXXXXXXXXXXXXXXXXXXGXXXXXXXXXXXXXXXXXXXGXXXXXXXXXXXXXXXXXXXGXXXXXXXXXXXXXXXXXXXGXXXXXXXXXXXXXXXXXXXGXXXXXXXXXXXXXXXXXXXGXXXXXXXXXXXXXXXXXXXGXXXXXXXXXXXXXXXXXXXGXXXXXXXXXXXXXXXXXXX,0,10,0
47082,14,1,13,55,531,0,0,543,443,100,GXXXXXXXXXXXXXXXXXXXGXXXXXXXXXXXXXXXXXXXGXXXXXXXXXXXXXXXXXXXGXXXXXXXXXXXXXXXXXXXGXXXXXXXXXXXXXXXXXXXGXXXXXXXXXXXXXXXXXXXGXXXXXXXXXXXXXXXXXXXGXXXXXXXXXXXXXXXXXXXGXXXXXXXXXXXXXXXXXXXGXXXXXXXXXXXXXXXXXXXGXXXXXXXXXXXXXXXXXXXGXXXXXXXXXXXXXXXXXXXGAXXXXXXXXXXXXXXXXXX,0,10,0
47103,14,0,14,53,533,0,0,547,442,105,GXXXXXXXXXXXXXXXXXXXGXXXXXXXXXXXXXXXXXXXGXXXXXXXXXXXXXXXXXXXGXXXXXXXXXXXXXXXXXXXGXXXXXXXXXXXXXXXXXXXGXXXXXXXXXXXXXXXXXXXGXXXXXXXXXXXXXXXXXXXGXXXXXXXXXXXXXXXXXXXGXXXXXXXXXXXXXXXXXXXGXXXXXXXXXXXXXXXXXXXGXXXXXXXXXXXXXXXXXXXGXXXXXXXXXXXXXXXXXXXGOXXXXXXXXXXXXXXXXXX,0,10,0
47124,14,0,14,55,531,0,0,545,441,104,GXXXXXXXXXXXXXXXXXXXGXXXXXXXXXXXXXXXXXXXGXXXXXXXXXXXXXXXXXXXGXXXXXXXXXXXXXXXXXXXGXXXXXXXXXXXXXXXXXXXGXXXXXXXXXXXXXXXXXXXGXXXXXXXXXXXXXXXXXXXGXXXXXXXXXXXXXXXXXXXGXXXXXXXXXXXXXXXXXXXGXXXXXXXXXXXXXXXXXXXGXXXXXXXXXXXXXXXXXXXGXXXXXXXXXXXXXXXXXXXGOXXXXXXXXXXXXXXXXXX,0,10,0

47145,14,0,14,54,532,0,0,546,445,101,GXXXXXXXXXXXXXXXXXXXGXXXXXXXXXXXXXXXXXXXGXXXXXXXXXXXXXXXXXXXGXXXXXXXXXXXXXXXXXXXGXXXXXXXXXXXXXXXXXXXGXXXXXXXXXXXXXXXXXXXGXXXXXXXXXXXXXXXXXXXGXXXXXXXXXXXXXXXXXXXGXXXXXXXXXXXXXXXXXXXGXXXXXXXXXXXXXXXXXXXGXXXXXXXXXXXXXXXXXXXGXXXXXXXXXXXXXXXXXXXGOXXXXXXXXXXXXXXXXXX,0,10,0
47166,13,0,13,54,533,0,0,547,445,102,GXXXXXXXXXXXXXXXXXXXGXXXXXXXXXXXXXXXXXXXGXXXXXXXXXXXXXXXXXXXGXXXXXXXXXXXXXXXXXXXGXXXXXXXXXXXXXXXXXXXGXXXXXXXXXXXXXXXXXXXGXXXXXXXXXXXXXXXXXXXGXXXXXXXXXXXXXXXXXXXGXXXXXXXXXXXXXXXXXXXGXXXXXXXXXXXXXXXXXXXGXXXXXXXXXXXXXXXXXXXGXXXXXXXXXXXXXXXXXXXGXXXXXXXXXXXXXXXXXXX,0,10,0
47187,13,0,13,58,529,0,0,543,443,100,GXXXXXXXXXXXXXXXXXXXGXXXXXXXXXXXXXXXXXXXGXXXXXXXXXXXXXXXXXXXGXXXXXXXXXXXXXXXXXXXGXXXXXXXXXXXXXXXXXXXGXXXXXXXXXXXXXXXXXXXGXXXXXXXXXXXXXXXXXXXGXXXXXXXXXXXXXXXXXXXGXXXXXXXXXXXXXXXXXXXGXXXXXXXXXXXXXXXXXXXGXXXXXXXXXXXXXXXXXXXGXXXXXXXXXXXXXXXXXXXGXXXXXXXXXXXXXXXXXXX,0,10,0
47208,13,0,13,57,530,0,0,543,442,101,GXXXXXXXXXXXXXXXXXXXGXXXXXXXXXXXXXXXXXXXGXXXXXXXXXXXXXXXXXXXGXXXXXXXXXXXXXXXXXXXGXXXXXXXXXXXXXXXXXXXGXXXXXXXXXXXXXXXXXXXGXXXXXXXXXXXXXXXXXXXGXXXXXXXXXXXXXXXXXXXGXXXXXXXXXXXXXXXXXXXGXXXXXXXXXXXXXXXXXXXGXXXXXXXXXXXXXXXXXXXGXXXXXXXXXXXXXXXXXXXGXXXXXXXXXXXXXXXXXXX,0,10,0
47229,13,0,13,55,532,0,0,545,442,103,GXXXXXXXXXXXXXXXXXXXGXXXXXXXXXXXXXXXXXXXGXXXXXXXXXXXXXXXXXXXGXXXXXXXXXXXXXXXXXXXGXXXXXXXXXXXXXXXXXXXGXXXXXXXXXXXXXXXXXXXGXXXXXXXXXXXXXXXXXXXGXXXXXXXXXXXXXXXXXXXGXXXXXXXXXXXXXXXXXXXGXXXXXXXXXXXXXXXXXXXGXXXXXXXXXXXXXXXXXXXGXXXXXXXXXXXXXXXXXXXGXXXXXXXXXXXXXXXXXXX,0,10,0

47250,13,0,13,59,528,0,0,542,442,100,GXXXXXXXXXXXXXXXXXXXGXXXXXXXXXXXXXXXXXXXGXXXXXXXXXXXXXXXXXXXGXXXXXXXXXXXXXXXXXXXGXXXXXXXXXXXXXXXXXXXGXXXXXXXXXXXXXXXXXXXGXXXXXXXXXXXXXXXXXXXGXXXXXXXXXXXXXXXXXXXGXXXXXXXXXXXXXXXXXXXGXXXXXXXXXXXXXXXXXXXGXXXXXXXXXXXXXXXXXXXGXXXXXXXXXXXXXXXXXXXGXXXXXXXXXXXXXXXXXXX,0,10,0
47271,13,0,13,60,527,0,0,541,442,99,GXXXXXXXXXXXXXXXXXXXGXXXXXXXXXXXXXXXXXXXGXXXXXXXXXXXXXXXXXXXGXXXXXXXXXXXXXXXXXXXGXXXXXXXXXXXXXXXXXXXGXXXXXXXXXXXXXXXXXXXGXXXXXXXXXXXXXXXXXXXGXXXXXXXXXXXXXXXXXXXGXXXXXXXXXXXXXXXXXXXGXXXXXXXXXXXXXXXXXXXGXXXXXXXXXXXXXXXXXXXGXXXXXXXXXXXXXXXXXXXGXXXXXXXXXXXXXXXXXXX,0,10,0
47292,13,0,13,54,533,0,0,547,440,107,GXXXXXXXXXXXXXXXXXXXGXXXXXXXXXXXXXXXXXXXGXXXXXXXXXXXXXXXXXXXGXXXXXXXXXXXXXXXXXXXGXXXXXXXXXXXXXXXXXXXGXXXXXXXXXXXXXXXXXXXGXXXXXXXXXXXXXXXXXXXGXXXXXXXXXXXXXXXXXXXGXXXXXXXXXXXXXXXXXXXGXXXXXXXXXXXXXXXXXXXGXXXXXXXXXXXXXXXXXXXGXXXXXXXXXXXXXXXXXXXGXXXXXXXXXXXXXXXXXXX,0,10,0
47313,13,0,13,50,537,0,0,551,440,111,GXXXXXXXXXXXXXXXXXXXGXXXXXXXXXXXXXXXXXXXGXXXXXXXXXXXXXXXXXXXGXXXXXXXXXXXXXXXXXXXGXXXXXXXXXXXXXXXXXXXGXXXXXXXXXXXXXXXXXXXGXXXXXXXXXXXXXXXXXXXGXXXXXXXXXXXXXXXXXXXGXXXXXXXXXXXXXXXXXXXGXXXXXXXXXXXXXXXXXXXGXXXXXXXXXXXXXXXXXXXGXXXXXXXXXXXXXXXXXXXGXXXXXXXXXXXXXXXXXXX,0,10,0
47334,13,0,13,51,536,0,0,550,440,110,GXXXXXXXXXXXXXXXXXXXGXXXXXXXXXXXXXXXXXXXGXXXXXXXXXXXXXXXXXXXGXXXXXXXXXXXXXXXXXXXGXXXXXXXXXXXXXXXXXXXGXXXXXXXXXXXXXXXXXXXGXXXXXXXXXXXXXXXXXXXGXXXXXXXXXXXXXXXXXXXGXXXXXXXXXXXXXXXXXXXGXXXXXXXXXXXXXXXXXXXGXXXXXXXXXXXXXXXXXXXGXXXXXXXXXXXXXXXXXXXGXXXXXXXXXXXXXXXXXXX,0,10,0

47355,13,0,13,53,534,0,0,548,442,106,GXXXXXXXXXXXXXXXXXXXGXXXXXXXXXXXXXXXXXXXGXXXXXXXXXXXXXXXXXXXGXXXXXXXXXXXXXXXXXXXGXXXXXXXXXXXXXXXXXXXGXXXXXXXXXXXXXXXXXXXGXXXXXXXXXXXXXXXXXXXGXXXXXXXXXXXXXXXXXXXGXXXXXXXXXXXXXXXXXXXGXXXXXXXXXXXXXXXXXXXGXXXXXXXXXXXXXXXXXXXGXXXXXXXXXXXXXXXXXXXGXXXXXXXXXXXXXXXXXXX,0,10,0
47376,13,0,13,54,533,0,0,547,445,102,GXXXXXXXXXXXXXXXXXXXGXXXXXXXXXXXXXXXXXXXGXXXXXXXXXXXXXXXXXXXGXXXXXXXXXXXXXXXXXXXGXXXXXXXXXXXXXXXXXXXGXXXXXXXXXXXXXXXXXXXGXXXXXXXXXXXXXXXXXXXGXXXXXXXXXXXXXXXXXXXGXXXXXXXXXXXXXXXXXXXGXXXXXXXXXXXXXXXXXXXGXXXXXXXXXXXXXXXXXXXGXXXXXXXXXXXXXXXXXXXGXXXXXXXXXXXXXXXXXXX,0,10,0
47397,13,0,13,54,533,0,0,546,446,100,GXXXXXXXXXXXXXXXXXXXGXXXXXXXXXXXXXXXXXXXGXXXXXXXXXXXXXXXXXXXGXXXXXXXXXXXXXXXXXXXGXXXXXXXXXXXXXXXXXXXGXXXXXXXXXXXXXXXXXXXGXXXXXXXXXXXXXXXXXXXGXXXXXXXXXXXXXXXXXXXGXXXXXXXXXXXXXXXXXXXGXXXXXXXXXXXXXXXXXXXGXXXXXXXXXXXXXXXXXXXGXXXXXXXXXXXXXXXXXXXGXXXXXXXXXXXXXXXXXXX,0,10,0
47418,13,0,13,60,527,0,0,540,443,97,GXXXXXXXXXXXXXXXXXXXGXXXXXXXXXXXXXXXXXXXGXXXXXXXXXXXXXXXXXXXGXXXXXXXXXXXXXXXXXXXGXXXXXXXXXXXXXXXXXXXGXXXXXXXXXXXXXXXXXXXGXXXXXXXXXXXXXXXXXXXGXXXXXXXXXXXXXXXXXXXGXXXXXXXXXXXXXXXXXXXGXXXXXXXXXXXXXXXXXXXGXXXXXXXXXXXXXXXXXXXGXXXXXXXXXXXXXXXXXXXGXXXXXXXXXXXXXXXXXXX,0,10,0
47439,13,0,13,61,526,0,0,539,446,93,GXXXXXXXXXXXXXXXXXXXGXXXXXXXXXXXXXXXXXXXGXXXXXXXXXXXXXXXXXXXGXXXXXXXXXXXXXXXXXXXGXXXXXXXXXXXXXXXXXXXGXXXXXXXXXXXXXXXXXXXGXXXXXXXXXXXXXXXXXXXGXXXXXXXXXXXXXXXXXXXGXXXXXXXXXXXXXXXXXXXGXXXXXXXXXXXXXXXXXXXGXXXXXXXXXXXXXXXXXXXGXXXXXXXXXXXXXXXXXXXGXXXXXXXXXXXXXXXXXXX,0,10,0

47460,13,0,13,57,530,0,0,542,441,101,GXXXXXXXXXXXXXXXXXXXGXXXXXXXXXXXXXXXXXXXGXXXXXXXXXXXXXXXXXXXGXXXXXXXXXXXXXXXXXXXGXXXXXXXXXXXXXXXXXXXGXXXXXXXXXXXXXXXXXXXGXXXXXXXXXXXXXXXXXXXGXXXXXXXXXXXXXXXXXXXGXXXXXXXXXXXXXXXXXXXGXXXXXXXXXXXXXXXXXXXGXXXXXXXXXXXXXXXXXXXGXXXXXXXXXXXXXXXXXXXGXXXXXXXXXXXXXXXXXXX,0,10,0
47481,13,0,13,53,534,0,0,547,439,108,GXXXXXXXXXXXXXXXXXXXGXXXXXXXXXXXXXXXXXXXGXXXXXXXXXXXXXXXXXXXGXXXXXXXXXXXXXXXXXXXGXXXXXXXXXXXXXXXXXXXGXXXXXXXXXXXXXXXXXXXGXXXXXXXXXXXXXXXXXXXGXXXXXXXXXXXXXXXXXXXGXXXXXXXXXXXXXXXXXXXGXXXXXXXXXXXXXXXXXXXGXXXXXXXXXXXXXXXXXXXGXXXXXXXXXXXXXXXXXXXGXXXXXXXXXXXXXXXXXXX,0,10,0
47502,13,0,13,51,536,0,0,551,441,110,GXXXXXXXXXXXXXXXXXXXGXXXXXXXXXXXXXXXXXXXGXXXXXXXXXXXXXXXXXXXGXXXXXXXXXXXXXXXXXXXGXXXXXXXXXXXXXXXXXXXGXXXXXXXXXXXXXXXXXXXGXXXXXXXXXXXXXXXXXXXGXXXXXXXXXXXXXXXXXXXGXXXXXXXXXXXXXXXXXXXGXXXXXXXXXXXXXXXXXXXGXXXXXXXXXXXXXXXXXXXGXXXXXXXXXXXXXXXXXXXGXXXXXXXXXXXXXXXXXXX,0,10,0
47523,13,0,13,49,538,0,0,552,442,110,GXXXXXXXXXXXXXXXXXXXGXXXXXXXXXXXXXXXXXXXGXXXXXXXXXXXXXXXXXXXGXXXXXXXXXXXXXXXXXXXGXXXXXXXXXXXXXXXXXXXGXXXXXXXXXXXXXXXXXXXGXXXXXXXXXXXXXXXXXXXGXXXXXXXXXXXXXXXXXXXGXXXXXXXXXXXXXXXXXXXGXXXXXXXXXXXXXXXXXXXGXXXXXXXXXXXXXXXXXXXGXXXXXXXXXXXXXXXXXXXGXXXXXXXXXXXXXXXXXXX,0,10,0
47544,14,1,13,50,536,0,0,549,444,105,GXXXXXXXXXXXXXXXXXXXGXXXXXXXXXXXXXXXXXXXGXXXXXXXXXXXXXXXXXXXGXXXXXXXXXXXXXXXXXXXGXXXXXXXXXXXXXXXXXXXGXXXXXXXXXXXXXXXXXXXGAXXXXXXXXXXXXXXXXXXGXXXXXXXXXXXXXXXXXXXGXXXXXXXXXXXXXXXXXXXGXXXXXXXXXXXXXXXXXXXGXXXXXXXXXXXXXXXXXXXGXXXXXXXXXXXXXXXXXXXGXXXXXXXXXXXXXXXXXXX,0,10,0

47565,14,1,13,48,538,0,0,552,447,105,GXXXXXXXXXXXXXXXXXXXGXXXXXXXXXXXXXXXXXXXGXXXXXXXXXXXXXXXXXXXGXXXXXXXXXXXXXXXXXXXGXXXXXXXXXXXXXXXXXXXGXXXXXXXXXXXXXXXXXXXGAXXXXXXXXXXXXXXXXXXGXXXXXXXXXXXXXXXXXXXGXXXXXXXXXXXXXXXXXXXGXXXXXXXXXXXXXXXXXXXGXXXXXXXXXXXXXXXXXXXGXXXXXXXXXXXXXXXXXXXGXXXXXXXXXXXXXXXXXXX,0,10,0
47586,14,1,13,48,538,0,0,551,448,103,GXXXXXXXXXXXXXXXXXXXGXXXXXXXXXXXXXXXXXXXGXXXXXXXXXXXXXXXXXXXGXXXXXXXXXXXXXXXXXXXGXXXXXXXXXXXXXXXXXXXGXXXXXXXXXXXXXXXXXXXGAXXXXXXXXXXXXXXXXXXGXXXXXXXXXXXXXXXXXXXGXXXXXXXXXXXXXXXXXXXGXXXXXXXXXXXXXXXXXXXGXXXXXXXXXXXXXXXXXXXGXXXXXXXXXXXXXXXXXXXGXXXXXXXXXXXXXXXXXXX,0,10,0
47607,14,1,13,47,539,0,0,552,451,101,GXXXXXXXXXXXXXXXXXXXGXXXXXXXXXXXXXXXXXXXGXXXXXXXXXXXXXXXXXXXGXXXXXXXXXXXXXXXXXXXGXXXXXXXXXXXXXXXXXXXGXXXXXXXXXXXXXXXXXXXGAXXXXXXXXXXXXXXXXXXGXXXXXXXXXXXXXXXXXXXGXXXXXXXXXXXXXXXXXXXGXXXXXXXXXXXXXXXXXXXGXXXXXXXXXXXXXXXXXXXGXXXXXXXXXXXXXXXXXXXGXXXXXXXXXXXXXXXXXXX,0,10,0
47628,14,1,13,53,533,0,0,546,449,97,GXXXXXXXXXXXXXXXXXXXGXXXXXXXXXXXXXXXXXXXGXXXXXXXXXXXXXXXXXXXGXXXXXXXXXXXXXXXXXXXGXXXXXXXXXXXXXXXXXXXGXXXXXXXXXXXXXXXXXXXGAXXXXXXXXXXXXXXXXXXGXXXXXXXXXXXXXXXXXXXGXXXXXXXXXXXXXXXXXXXGXXXXXXXXXXXXXXXXXXXGXXXXXXXXXXXXXXXXXXXGXXXXXXXXXXXXXXXXXXXGXXXXXXXXXXXXXXXXXXX,0,10,0
47649,14,1,13,56,530,0,0,542,448,94,GXXXXXXXXXXXXXXXXXXXGXXXXXXXXXXXXXXXXXXXGXXXXXXXXXXXXXXXXXXXGXXXXXXXXXXXXXXXXXXXGXXXXXXXXXXXXXXXXXXXGXXXXXXXXXXXXXXXXXXXGAXXXXXXXXXXXXXXXXXXGXXXXXXXXXXXXXXXXXXXGXXXXXXXXXXXXXXXXXXXGXXXXXXXXXXXXXXXXXXXGXXXXXXXXXXXXXXXXXXXGXXXXXXXXXXXXXXXXXXXGXXXXXXXXXXXXXXXXXXX,0,10,0

47670,14,0,14,58,528,0,0,541,447,94,GXXXXXXXXXXXXXXXXXXXGXXXXXXXXXXXXXXXXXXXGXXXXXXXXXXXXXXXXXXXGXXXXXXXXXXXXXXXXXXXGXXXXXXXXXXXXXXXXXXXGXXXXXXXXXXXXXXXXXXXGOXXXXXXXXXXXXXXXXXXGXXXXXXXXXXXXXXXXXXXGXXXXXXXXXXXXXXXXXXXGXXXXXXXXXXXXXXXXXXXGXXXXXXXXXXXXXXXXXXXGXXXXXXXXXXXXXXXXXXXGXXXXXXXXXXXXXXXXXXX,0,10,0
47691,14,0,14,56,530,0,0,542,446,96,GXXXXXXXXXXXXXXXXXXXGXXXXXXXXXXXXXXXXXXXGXXXXXXXXXXXXXXXXXXXGXXXXXXXXXXXXXXXXXXXGXXXXXXXXXXXXXXXXXXXGXXXXXXXXXXXXXXXXXXXGOXXXXXXXXXXXXXXXXXXGXXXXXXXXXXXXXXXXXXXGXXXXXXXXXXXXXXXXXXXGXXXXXXXXXXXXXXXXXXXGXXXXXXXXXXXXXXXXXXXGXXXXXXXXXXXXXXXXXXXGXXXXXXXXXXXXXXXXXXX,0,10,0
47712,13,0,13,52,535,0,0,548,451,97,GXXXXXXXXXXXXXXXXXXXGXXXXXXXXXXXXXXXXXXXGXXXXXXXXXXXXXXXXXXXGXXXXXXXXXXXXXXXXXXXGXXXXXXXXXXXXXXXXXXXGXXXXXXXXXXXXXXXXXXXGXXXXXXXXXXXXXXXXXXXGXXXXXXXXXXXXXXXXXXXGXXXXXXXXXXXXXXXXXXXGXXXXXXXXXXXXXXXXXXXGXXXXXXXXXXXXXXXXXXXGXXXXXXXXXXXXXXXXXXXGXXXXXXXXXXXXXXXXXXX,0,10,0
47733,13,0,13,55,532,0,0,545,446,99,GXXXXXXXXXXXXXXXXXXXGXXXXXXXXXXXXXXXXXXXGXXXXXXXXXXXXXXXXXXXGXXXXXXXXXXXXXXXXXXXGXXXXXXXXXXXXXXXXXXXGXXXXXXXXXXXXXXXXXXXGXXXXXXXXXXXXXXXXXXXGXXXXXXXXXXXXXXXXXXXGXXXXXXXXXXXXXXXXXXXGXXXXXXXXXXXXXXXXXXXGXXXXXXXXXXXXXXXXXXXGXXXXXXXXXXXXXXXXXXXGXXXXXXXXXXXXXXXXXXX,0,10,0
47754,13,0,13,58,529,0,0,542,443,99,GXXXXXXXXXXXXXXXXXXXGXXXXXXXXXXXXXXXXXXXGXXXXXXXXXXXXXXXXXXXGXXXXXXXXXXXXXXXXXXXGXXXXXXXXXXXXXXXXXXXGXXXXXXXXXXXXXXXXXXXGXXXXXXXXXXXXXXXXXXXGXXXXXXXXXXXXXXXXXXXGXXXXXXXXXXXXXXXXXXXGXXXXXXXXXXXXXXXXXXXGXXXXXXXXXXXXXXXXXXXGXXXXXXXXXXXXXXXXXXXGXXXXXXXXXXXXXXXXXXX,0,10,0

47775,13,0,13,60,527,0,0,540,441,99,GXXXXXXXXXXXXXXXXXXXGXXXXXXXXXXXXXXXXXXXGXXXXXXXXXXXXXXXXXXXGXXXXXXXXXXXXXXXXXXXGXXXXXXXXXXXXXXXXXXXGXXXXXXXXXXXXXXXXXXXGXXXXXXXXXXXXXXXXXXXGXXXXXXXXXXXXXXXXXXXGXXXXXXXXXXXXXXXXXXXGXXXXXXXXXXXXXXXXXXXGXXXXXXXXXXXXXXXXXXXGXXXXXXXXXXXXXXXXXXXGXXXXXXXXXXXXXXXXXXX,0,10,0
47796,13,0,13,61,526,0,0,539,447,92,GXXXXXXXXXXXXXXXXXXXGXXXXXXXXXXXXXXXXXXXGXXXXXXXXXXXXXXXXXXXGXXXXXXXXXXXXXXXXXXXGXXXXXXXXXXXXXXXXXXXGXXXXXXXXXXXXXXXXXXXGXXXXXXXXXXXXXXXXXXXGXXXXXXXXXXXXXXXXXXXGXXXXXXXXXXXXXXXXXXXGXXXXXXXXXXXXXXXXXXXGXXXXXXXXXXXXXXXXXXXGXXXXXXXXXXXXXXXXXXXGXXXXXXXXXXXXXXXXXXX,0,10,0
47817,14,1,13,65,521,0,0,534,443,91,GXXXXXXXXXXXXXXXXXXXGXXXXXXXXXXXXXXXXXXXGXXXXXXXXXXXXXXXXXXXGXXXXXXXXXXXXXXXXXXXGXXXXXXXXXXXXXXXXXXXGXXXXXXXXXXXXXXXXXXXGXXXXXXXXXXXXXXXXXXXGXXXXXXXXXXXXXXXXXXXGAXXXXXXXXXXXXXXXXXXGXXXXXXXXXXXXXXXXXXXGXXXXXXXXXXXXXXXXXXXGXXXXXXXXXXXXXXXXXXXGXXXXXXXXXXXXXXXXXXX,0,10,0
47838,14,1,13,64,522,0,0,534,446,88,GXXXXXXXXXXXXXXXXXXXGXXXXXXXXXXXXXXXXXXXGXXXXXXXXXXXXXXXXXXXGXXXXXXXXXXXXXXXXXXXGXXXXXXXXXXXXXXXXXXXGXXXXXXXXXXXXXXXXXXXGXXXXXXXXXXXXXXXXXXXGXXXXXXXXXXXXXXXXXXXGAXXXXXXXXXXXXXXXXXXGXXXXXXXXXXXXXXXXXXXGXXXXXXXXXXXXXXXXXXXGXXXXXXXXXXXXXXXXXXXGXXXXXXXXXXXXXXXXXXX,0,10,0
47859,14,1,13,55,531,0,0,543,449,94,GXXXXXXXXXXXXXXXXXXXGXXXXXXXXXXXXXXXXXXXGXXXXXXXXXXXXXXXXXXXGXXXXXXXXXXXXXXXXXXXGXXXXXXXXXXXXXXXXXXXGXXXXXXXXXXXXXXXXXXXGXXXXXXXXXXXXXXXXXXXGXXXXXXXXXXXXXXXXXXXGAXXXXXXXXXXXXXXXXXXGXXXXXXXXXXXXXXXXXXXGXXXXXXXXXXXXXXXXXXXGXXXXXXXXXXXXXXXXXXXGXXXXXXXXXXXXXXXXXXX,0,10,0

47880,14,1,13,59,527,0,0,539,445,94,GXXXXXXXXXXXXXXXXXXXGXXXXXXXXXXXXXXXXXXXGXXXXXXXXXXXXXXXXXXXGXXXXXXXXXXXXXXXXXXXGXXXXXXXXXXXXXXXXXXXGXXXXXXXXXXXXXXXXXXXGXXXXXXXXXXXXXXXXXXXGXXXXXXXXXXXXXXXXXXXGAXXXXXXXXXXXXXXXXXXGXXXXXXXXXXXXXXXXXXXGXXXXXXXXXXXXXXXXXXXGXXXXXXXXXXXXXXXXXXXGXXXXXXXXXXXXXXXXXXX,0,10,0
47901,13,0,13,57,530,0,0,542,444,98,GXXXXXXXXXXXXXXXXXXXGXXXXXXXXXXXXXXXXXXXGXXXXXXXXXXXXXXXXXXXGXXXXXXXXXXXXXXXXXXXGXXXXXXXXXXXXXXXXXXXGXXXXXXXXXXXXXXXXXXXGXXXXXXXXXXXXXXXXXXXGXXXXXXXXXXXXXXXXXXXGXXXXXXXXXXXXXXXXXXXGXXXXXXXXXXXXXXXXXXXGXXXXXXXXXXXXXXXXXXXGXXXXXXXXXXXXXXXXXXXGXXXXXXXXXXXXXXXXXXX,0,10,0
47922,13,0,13,55,532,0,0,545,446,99,GXXXXXXXXXXXXXXXXXXXGXXXXXXXXXXXXXXXXXXXGXXXXXXXXXXXXXXXXXXXGXXXXXXXXXXXXXXXXXXXGXXXXXXXXXXXXXXXXXXXGXXXXXXXXXXXXXXXXXXXGXXXXXXXXXXXXXXXXXXXGXXXXXXXXXXXXXXXXXXXGXXXXXXXXXXXXXXXXXXXGXXXXXXXXXXXXXXXXXXXGXXXXXXXXXXXXXXXXXXXGXXXXXXXXXXXXXXXXXXXGXXXXXXXXXXXXXXXXXXX,0,10,0
47943,13,0,13,54,533,0,0,545,442,103,GXXXXXXXXXXXXXXXXXXXGXXXXXXXXXXXXXXXXXXXGXXXXXXXXXXXXXXXXXXXGXXXXXXXXXXXXXXXXXXXGXXXXXXXXXXXXXXXXXXXGXXXXXXXXXXXXXXXXXXXGXXXXXXXXXXXXXXXXXXXGXXXXXXXXXXXXXXXXXXXGXXXXXXXXXXXXXXXXXXXGXXXXXXXXXXXXXXXXXXXGXXXXXXXXXXXXXXXXXXXGXXXXXXXXXXXXXXXXXXXGXXXXXXXXXXXXXXXXXXX,0,10,0
47964,14,1,13,55,531,0,0,544,443,101,GXXXXXXXXXXXXXXXXXXXGXXXXXXXXXXXXXXXXXXXGXXXXXXXXXXXXXXXXXXXGXXXXXXXXXXXXXXXXXXXGXXXXXXXXXXXXXXXXXXXGAXXXXXXXXXXXXXXXXXXGXXXXXXXXXXXXXXXXXXXGXXXXXXXXXXXXXXXXXXXGXXXXXXXXXXXXXXXXXXXGXXXXXXXXXXXXXXXXXXXGXXXXXXXXXXXXXXXXXXXGXXXXXXXXXXXXXXXXXXXGXXXXXXXXXXXXXXXXXXX,0,10,0

47985,14,1,13,59,527,0,0,539,442,97,GXXXXXXXXXXXXXXXXXXXGXXXXXXXXXXXXXXXXXXXGXXXXXXXXXXXXXXXXXXXGXXXXXXXXXXXXXXXXXXXGXXXXXXXXXXXXXXXXXXXGAXXXXXXXXXXXXXXXXXXGXXXXXXXXXXXXXXXXXXXGXXXXXXXXXXXXXXXXXXXGXXXXXXXXXXXXXXXXXXXGXXXXXXXXXXXXXXXXXXXGXXXXXXXXXXXXXXXXXXXGXXXXXXXXXXXXXXXXXXXGXXXXXXXXXXXXXXXXXXX,0,10,0
48006,13,0,13,50,537,0,0,548,444,104,GXXXXXXXXXXXXXXXXXXXGXXXXXXXXXXXXXXXXXXXGXXXXXXXXXXXXXXXXXXXGXXXXXXXXXXXXXXXXXXXGXXXXXXXXXXXXXXXXXXXGXXXXXXXXXXXXXXXXXXXGXXXXXXXXXXXXXXXXXXXGXXXXXXXXXXXXXXXXXXXGXXXXXXXXXXXXXXXXXXXGXXXXXXXXXXXXXXXXXXXGXXXXXXXXXXXXXXXXXXXGXXXXXXXXXXXXXXXXXXXGXXXXXXXXXXXXXXXXXXX,0,10,0
48027,13,0,13,51,536,0,0,550,445,105,GXXXXXXXXXXXXXXXXXXXGXXXXXXXXXXXXXXXXXXXGXXXXXXXXXXXXXXXXXXXGXXXXXXXXXXXXXXXXXXXGXXXXXXXXXXXXXXXXXXXGXXXXXXXXXXXXXXXXXXXGXXXXXXXXXXXXXXXXXXXGXXXXXXXXXXXXXXXXXXXGXXXXXXXXXXXXXXXXXXXGXXXXXXXXXXXXXXXXXXXGXXXXXXXXXXXXXXXXXXXGXXXXXXXXXXXXXXXXXXXGXXXXXXXXXXXXXXXXXXX,0,10,0
48048,13,0,13,49,538,0,0,552,449,103,GXXXXXXXXXXXXXXXXXXXGXXXXXXXXXXXXXXXXXXXGXXXXXXXXXXXXXXXXXXXGXXXXXXXXXXXXXXXXXXXGXXXXXXXXXXXXXXXXXXXGXXXXXXXXXXXXXXXXXXXGXXXXXXXXXXXXXXXXXXXGXXXXXXXXXXXXXXXXXXXGXXXXXXXXXXXXXXXXXXXGXXXXXXXXXXXXXXXXXXXGXXXXXXXXXXXXXXXXXXXGXXXXXXXXXXXXXXXXXXXGXXXXXXXXXXXXXXXXXXX,0,10,0
48069,13,0,13,54,533,0,0,546,444,102,GXXXXXXXXXXXXXXXXXXXGXXXXXXXXXXXXXXXXXXXGXXXXXXXXXXXXXXXXXXXGXXXXXXXXXXXXXXXXXXXGXXXXXXXXXXXXXXXXXXXGXXXXXXXXXXXXXXXXXXXGXXXXXXXXXXXXXXXXXXXGXXXXXXXXXXXXXXXXXXXGXXXXXXXXXXXXXXXXXXXGXXXXXXXXXXXXXXXXXXXGXXXXXXXXXXXXXXXXXXXGXXXXXXXXXXXXXXXXXXXGXXXXXXXXXXXXXXXXXXX,0,10,0

48090,13,0,13,49,538,0,0,551,445,106,GXXXXXXXXXXXXXXXXXXXGXXXXXXXXXXXXXXXXXXXGXXXXXXXXXXXXXXXXXXXGXXXXXXXXXXXXXXXXXXXGXXXXXXXXXXXXXXXXXXXGXXXXXXXXXXXXXXXXXXXGXXXXXXXXXXXXXXXXXXXGXXXXXXXXXXXXXXXXXXXGXXXXXXXXXXXXXXXXXXXGXXXXXXXXXXXXXXXXXXXGXXXXXXXXXXXXXXXXXXXGXXXXXXXXXXXXXXXXXXXGXXXXXXXXXXXXXXXXXXX,0,10,0
48111,13,0,13,45,542,0,0,555,446,109,GXXXXXXXXXXXXXXXXXXXGXXXXXXXXXXXXXXXXXXXGXXXXXXXXXXXXXXXXXXXGXXXXXXXXXXXXXXXXXXXGXXXXXXXXXXXXXXXXXXXGXXXXXXXXXXXXXXXXXXXGXXXXXXXXXXXXXXXXXXXGXXXXXXXXXXXXXXXXXXXGXXXXXXXXXXXXXXXXXXXGXXXXXXXXXXXXXXXXXXXGXXXXXXXXXXXXXXXXXXXGXXXXXXXXXXXXXXXXXXXGXXXXXXXXXXXXXXXXXXX,0,10,0
48132,13,0,13,47,540,0,0,553,452,101,GXXXXXXXXXXXXXXXXXXXGXXXXXXXXXXXXXXXXXXXGXXXXXXXXXXXXXXXXXXXGXXXXXXXXXXXXXXXXXXXGXXXXXXXXXXXXXXXXXXXGXXXXXXXXXXXXXXXXXXXGXXXXXXXXXXXXXXXXXXXGXXXXXXXXXXXXXXXXXXXGXXXXXXXXXXXXXXXXXXXGXXXXXXXXXXXXXXXXXXXGXXXXXXXXXXXXXXXXXXXGXXXXXXXXXXXXXXXXXXXGXXXXXXXXXXXXXXXXXXX,0,10,0
48153,15,2,13,48,537,0,0,549,451,98,GXXXXXXXXXXXXXXXXXXXGXXXXXXXXXXXXXXXXXXXGXXXXXXXXXXXXXXXXXXXGAAXXXXXXXXXXXXXXXXXGXXXXXXXXXXXXXXXXXXXGXXXXXXXXXXXXXXXXXXXGXXXXXXXXXXXXXXXXXXXGXXXXXXXXXXXXXXXXXXXGXXXXXXXXXXXXXXXXXXXGXXXXXXXXXXXXXXXXXXXGXXXXXXXXXXXXXXXXXXXGXXXXXXXXXXXXXXXXXXXGXXXXXXXXXXXXXXXXXXX,0,10,0
48174,15,1,14,46,539,0,0,552,449,103,GXXXXXXXXXXXXXXXXXXXGXXXXXXXXXXXXXXXXXXXGXXXXXXXXXXXXXXXXXXXGOAXXXXXXXXXXXXXXXXXGXXXXXXXXXXXXXXXXXXXGXXXXXXXXXXXXXXXXXXXGXXXXXXXXXXXXXXXXXXXGXXXXXXXXXXXXXXXXXXXGXXXXXXXXXXXXXXXXXXXGXXXXXXXXXXXXXXXXXXXGXXXXXXXXXXXXXXXXXXXGXXXXXXXXXXXXXXXXXXXGXXXXXXXXXXXXXXXXXXX,0,10,0

48195,15,1,14,49,536,0,0,549,453,96,GXXXXXXXXXXXXXXXXXXXGXXXXXXXXXXXXXXXXXXXGXXXXXXXXXXXXXXXXXXXGOAXXXXXXXXXXXXXXXXXGXXXXXXXXXXXXXXXXXXXGXXXXXXXXXXXXXXXXXXXGXXXXXXXXXXXXXXXXXXXGXXXXXXXXXXXXXXXXXXXGXXXXXXXXXXXXXXXXXXXGXXXXXXXXXXXXXXXXXXXGXXXXXXXXXXXXXXXXXXXGXXXXXXXXXXXXXXXXXXXGXXXXXXXXXXXXXXXXXXX,0,10,0
48216,14,1,13,47,539,0,0,552,452,100,GXXXXXXXXXXXXXXXXXXXGXXXXXXXXXXXXXXXXXXXGXXXXXXXXXXXXXXXXXXXGXAXXXXXXXXXXXXXXXXXGXXXXXXXXXXXXXXXXXXXGXXXXXXXXXXXXXXXXXXXGXXXXXXXXXXXXXXXXXXXGXXXXXXXXXXXXXXXXXXXGXXXXXXXXXXXXXXXXXXXGXXXXXXXXXXXXXXXXXXXGXXXXXXXXXXXXXXXXXXXGXXXXXXXXXXXXXXXXXXXGXXXXXXXXXXXXXXXXXXX,0,10,0
48237,13,0,13,49,538,0,0,551,451,100,GXXXXXXXXXXXXXXXXXXXGXXXXXXXXXXXXXXXXXXXGXXXXXXXXXXXXXXXXXXXGXXXXXXXXXXXXXXXXXXXGXXXXXXXXXXXXXXXXXXXGXXXXXXXXXXXXXXXXXXXGXXXXXXXXXXXXXXXXXXXGXXXXXXXXXXXXXXXXXXXGXXXXXXXXXXXXXXXXXXXGXXXXXXXXXXXXXXXXXXXGXXXXXXXXXXXXXXXXXXXGXXXXXXXXXXXXXXXXXXXGXXXXXXXXXXXXXXXXXXX,0,10,0
48258,13,0,13,51,536,0,0,549,449,100,GXXXXXXXXXXXXXXXXXXXGXXXXXXXXXXXXXXXXXXXGXXXXXXXXXXXXXXXXXXXGXXXXXXXXXXXXXXXXXXXGXXXXXXXXXXXXXXXXXXXGXXXXXXXXXXXXXXXXXXXGXXXXXXXXXXXXXXXXXXXGXXXXXXXXXXXXXXXXXXXGXXXXXXXXXXXXXXXXXXXGXXXXXXXXXXXXXXXXXXXGXXXXXXXXXXXXXXXXXXXGXXXXXXXXXXXXXXXXXXXGXXXXXXXXXXXXXXXXXXX,0,10,0
48279,14,1,13,53,533,0,0,546,449,97,GXXXXXXXXXXXXXXXXXXXGXXXXXXXXXXXXXXXXXXXGXXXXXXXXXXXXXXXXXXXGAXXXXXXXXXXXXXXXXXXGXXXXXXXXXXXXXXXXXXXGXXXXXXXXXXXXXXXXXXXGXXXXXXXXXXXXXXXXXXXGXXXXXXXXXXXXXXXXXXXGXXXXXXXXXXXXXXXXXXXGXXXXXXXXXXXXXXXXXXXGXXXXXXXXXXXXXXXXXXXGXXXXXXXXXXXXXXXXXXXGXXXXXXXXXXXXXXXXXXX,0,10,0

48300,14,1,13,55,531,0,0,544,446,98,GXXXXXXXXXXXXXXXXXXXGXXXXXXXXXXXXXXXXXXXGXXXXXXXXXXXXXXXXXXXGAXXXXXXXXXXXXXXXXXXGXXXXXXXXXXXXXXXXXXXGXXXXXXXXXXXXXXXXXXXGXXXXXXXXXXXXXXXXXXXGXXXXXXXXXXXXXXXXXXXGXXXXXXXXXXXXXXXXXXXGXXXXXXXXXXXXXXXXXXXGXXXXXXXXXXXXXXXXXXXGXXXXXXXXXXXXXXXXXXXGXXXXXXXXXXXXXXXXXXX,0,10,0
48321,14,1,13,54,532,0,0,545,447,98,GXXXXXXXXXXXXXXXXXXXGXXXXXXXXXXXXXXXXXXXGXXXXXXXXXXXXXXXXXXXGAXXXXXXXXXXXXXXXXXXGXXXXXXXXXXXXXXXXXXXGXXXXXXXXXXXXXXXXXXXGXXXXXXXXXXXXXXXXXXXGXXXXXXXXXXXXXXXXXXXGXXXXXXXXXXXXXXXXXXXGXXXXXXXXXXXXXXXXXXXGXXXXXXXXXXXXXXXXXXXGXXXXXXXXXXXXXXXXXXXGXXXXXXXXXXXXXXXXXXX,0,10,0
48342,14,1,13,55,531,0,0,545,453,92,GXXXXXXXXXXXXXXXXXXXGXXXXXXXXXXXXXXXXXXXGXXXXXXXXXXXXXXXXXXXGAXXXXXXXXXXXXXXXXXXGXXXXXXXXXXXXXXXXXXXGXXXXXXXXXXXXXXXXXXXGXXXXXXXXXXXXXXXXXXXGXXXXXXXXXXXXXXXXXXXGXXXXXXXXXXXXXXXXXXXGXXXXXXXXXXXXXXXXXXXGXXXXXXXXXXXXXXXXXXXGXXXXXXXXXXXXXXXXXXXGXXXXXXXXXXXXXXXXXXX,0,10,0
48363,14,1,13,59,527,0,0,541,448,93,GXXXXXXXXXXXXXXXXXXXGXXXXXXXXXXXXXXXXXXXGXXXXXXXXXXXXXXXXXXXGAXXXXXXXXXXXXXXXXXXGXXXXXXXXXXXXXXXXXXXGXXXXXXXXXXXXXXXXXXXGXXXXXXXXXXXXXXXXXXXGXXXXXXXXXXXXXXXXXXXGXXXXXXXXXXXXXXXXXXXGXXXXXXXXXXXXXXXXXXXGXXXXXXXXXXXXXXXXXXXGXXXXXXXXXXXXXXXXXXXGXXXXXXXXXXXXXXXXXXX,0,10,0
48384,14,1,13,62,524,0,0,537,446,91,GXXXXXXXXXXXXXXXXXXXGXXXXXXXXXXXXXXXXXXXGXXXXXXXXXXXXXXXXXXXGAXXXXXXXXXXXXXXXXXXGXXXXXXXXXXXXXXXXXXXGXXXXXXXXXXXXXXXXXXXGXXXXXXXXXXXXXXXXXXXGXXXXXXXXXXXXXXXXXXXGXXXXXXXXXXXXXXXXXXXGXXXXXXXXXXXXXXXXXXXGXXXXXXXXXXXXXXXXXXXGXXXXXXXXXXXXXXXXXXXGXXXXXXXXXXXXXXXXXXX,0,10,0

48405,14,1,13,57,529,0,0,542,449,93,GXXXXXXXXXXXXXXXXXXXGXXXXXXXXXXXXXXXXXXXGXXXXXXXXXXXXXXXXXXXGAXXXXXXXXXXXXXXXXXXGXXXXXXXXXXXXXXXXXXXGXXXXXXXXXXXXXXXXXXXGXXXXXXXXXXXXXXXXXXXGXXXXXXXXXXXXXXXXXXXGXXXXXXXXXXXXXXXXXXXGXXXXXXXXXXXXXXXXXXXGXXXXXXXXXXXXXXXXXXXGXXXXXXXXXXXXXXXXXXXGXXXXXXXXXXXXXXXXXXX,0,10,0
48426,14,1,13,56,530,0,0,543,449,94,GXXXXXXXXXXXXXXXXXXXGXXXXXXXXXXXXXXXXXXXGXXXXXXXXXXXXXXXXXXXGAXXXXXXXXXXXXXXXXXXGXXXXXXXXXXXXXXXXXXXGXXXXXXXXXXXXXXXXXXXGXXXXXXXXXXXXXXXXXXXGXXXXXXXXXXXXXXXXXXXGXXXXXXXXXXXXXXXXXXXGXXXXXXXXXXXXXXXXXXXGXXXXXXXXXXXXXXXXXXXGXXXXXXXXXXXXXXXXXXXGXXXXXXXXXXXXXXXXXXX,0,10,0
48447,14,1,13,62,524,0,0,538,444,94,GXXXXXXXXXXXXXXXXXXXGXXXXXXXXXXXXXXXXXXXGXXXXXXXXXXXXXXXXXXXGAXXXXXXXXXXXXXXXXXXGXXXXXXXXXXXXXXXXXXXGXXXXXXXXXXXXXXXXXXXGXXXXXXXXXXXXXXXXXXXGXXXXXXXXXXXXXXXXXXXGXXXXXXXXXXXXXXXXXXXGXXXXXXXXXXXXXXXXXXXGXXXXXXXXXXXXXXXXXXXGXXXXXXXXXXXXXXXXXXXGXXXXXXXXXXXXXXXXXXX,0,10,0
48468,14,1,13,59,527,0,0,541,451,90,GXXXXXXXXXXXXXXXXXXXGXXXXXXXXXXXXXXXXXXXGXXXXXXXXXXXXXXXXXXXGAXXXXXXXXXXXXXXXXXXGXXXXXXXXXXXXXXXXXXXGXXXXXXXXXXXXXXXXXXXGXXXXXXXXXXXXXXXXXXXGXXXXXXXXXXXXXXXXXXXGXXXXXXXXXXXXXXXXXXXGXXXXXXXXXXXXXXXXXXXGXXXXXXXXXXXXXXXXXXXGXXXXXXXXXXXXXXXXXXXGXXXXXXXXXXXXXXXXXXX,0,10,0
48489,14,1,13,54,532,0,0,546,451,95,GXXXXXXXXXXXXXXXXXXXGXXXXXXXXXXXXXXXXXXXGXXXXXXXXXXXXXXXXXXXGAXXXXXXXXXXXXXXXXXXGXXXXXXXXXXXXXXXXXXXGXXXXXXXXXXXXXXXXXXXGXXXXXXXXXXXXXXXXXXXGXXXXXXXXXXXXXXXXXXXGXXXXXXXXXXXXXXXXXXXGXXXXXXXXXXXXXXXXXXXGXXXXXXXXXXXXXXXXXXXGXXXXXXXXXXXXXXXXXXXGXXXXXXXXXXXXXXXXXXX,0,10,0

48510,14,1,13,53,533,0,0,547,454,93,GXXXXXXXXXXXXXXXXXXXGXXXXXXXXXXXXXXXXXXXGXXXXXXXXXXXXXXXXXXXGAXXXXXXXXXXXXXXXXXXGXXXXXXXXXXXXXXXXXXXGXXXXXXXXXXXXXXXXXXXGXXXXXXXXXXXXXXXXXXXGXXXXXXXXXXXXXXXXXXXGXXXXXXXXXXXXXXXXXXXGXXXXXXXXXXXXXXXXXXXGXXXXXXXXXXXXXXXXXXXGXXXXXXXXXXXXXXXXXXXGXXXXXXXXXXXXXXXXXXX,0,10,0
48531,14,1,13,56,530,0,0,543,449,94,GXXXXXXXXXXXXXXXXXXXGXXXXXXXXXXXXXXXXXXXGXXXXXXXXXXXXXXXXXXXGAXXXXXXXXXXXXXXXXXXGXXXXXXXXXXXXXXXXXXXGXXXXXXXXXXXXXXXXXXXGXXXXXXXXXXXXXXXXXXXGXXXXXXXXXXXXXXXXXXXGXXXXXXXXXXXXXXXXXXXGXXXXXXXXXXXXXXXXXXXGXXXXXXXXXXXXXXXXXXXGXXXXXXXXXXXXXXXXXXXGXXXXXXXXXXXXXXXXXXX,0,10,0
48552,14,1,13,56,530,0,0,544,448,96,GXXXXXXXXXXXXXXXXXXXGXXXXXXXXXXXXXXXXXXXGXXXXXXXXXXXXXXXXXXXGAXXXXXXXXXXXXXXXXXXGXXXXXXXXXXXXXXXXXXXGXXXXXXXXXXXXXXXXXXXGXXXXXXXXXXXXXXXXXXXGXXXXXXXXXXXXXXXXXXXGXXXXXXXXXXXXXXXXXXXGXXXXXXXXXXXXXXXXXXXGXXXXXXXXXXXXXXXXXXXGXXXXXXXXXXXXXXXXXXXGXXXXXXXXXXXXXXXXXXX,0,10,0
48573,14,1,13,54,532,0,0,544,449,95,GXXXXXXXXXXXXXXXXXXXGXXXXXXXXXXXXXXXXXXXGXXXXXXXXXXXXXXXXXXXGAXXXXXXXXXXXXXXXXXXGXXXXXXXXXXXXXXXXXXXGXXXXXXXXXXXXXXXXXXXGXXXXXXXXXXXXXXXXXXXGXXXXXXXXXXXXXXXXXXXGXXXXXXXXXXXXXXXXXXXGXXXXXXXXXXXXXXXXXXXGXXXXXXXXXXXXXXXXXXXGXXXXXXXXXXXXXXXXXXXGXXXXXXXXXXXXXXXXXXX,0,10,0
48594,14,1,13,57,529,0,0,543,450,93,GXXXXXXXXXXXXXXXXXXXGXXXXXXXXXXXXXXXXXXXGXXXXXXXXXXXXXXXXXXXGAXXXXXXXXXXXXXXXXXXGXXXXXXXXXXXXXXXXXXXGXXXXXXXXXXXXXXXXXXXGXXXXXXXXXXXXXXXXXXXGXXXXXXXXXXXXXXXXXXXGXXXXXXXXXXXXXXXXXXXGXXXXXXXXXXXXXXXXXXXGXXXXXXXXXXXXXXXXXXXGXXXXXXXXXXXXXXXXXXXGXXXXXXXXXXXXXXXXXXX,0,10,0

48615,14,1,13,60,526,0,0,539,447,92,GXXXXXXXXXXXXXXXXXXXGXXXXXXXXXXXXXXXXXXXGXXXXXXXXXXXXXXXXXXXGAXXXXXXXXXXXXXXXXXXGXXXXXXXXXXXXXXXXXXXGXXXXXXXXXXXXXXXXXXXGXXXXXXXXXXXXXXXXXXXGXXXXXXXXXXXXXXXXXXXGXXXXXXXXXXXXXXXXXXXGXXXXXXXXXXXXXXXXXXXGXXXXXXXXXXXXXXXXXXXGXXXXXXXXXXXXXXXXXXXGXXXXXXXXXXXXXXXXXXX,0,10,0
48636,14,1,13,58,528,0,0,542,446,96,GXXXXXXXXXXXXXXXXXXXGXXXXXXXXXXXXXXXXXXXGXXXXXXXXXXXXXXXXXXXGXXXXXXXXXXXXXXXXXXXGAXXXXXXXXXXXXXXXXXXGXXXXXXXXXXXXXXXXXXXGXXXXXXXXXXXXXXXXXXXGXXXXXXXXXXXXXXXXXXXGXXXXXXXXXXXXXXXXXXXGXXXXXXXXXXXXXXXXXXXGXXXXXXXXXXXXXXXXXXXGXXXXXXXXXXXXXXXXXXXGXXXXXXXXXXXXXXXXXXX,0,10,0
48657,14,1,13,57,529,0,0,544,447,97,GXXXXXXXXXXXXXXXXXXXGXXXXXXXXXXXXXXXXXXXGXXXXXXXXXXXXXXXXXXXGXXXXXXXXXXXXXXXXXXXGAXXXXXXXXXXXXXXXXXXGXXXXXXXXXXXXXXXXXXXGXXXXXXXXXXXXXXXXXXXGXXXXXXXXXXXXXXXXXXXGXXXXXXXXXXXXXXXXXXXGXXXXXXXXXXXXXXXXXXXGXXXXXXXXXXXXXXXXXXXGXXXXXXXXXXXXXXXXXXXGXXXXXXXXXXXXXXXXXXX,0,10,0
48678,14,1,13,58,528,0,0,543,447,96,GXXXXXXXXXXXXXXXXXXXGXXXXXXXXXXXXXXXXXXXGXXXXXXXXXXXXXXXXXXXGXXXXXXXXXXXXXXXXXXXGAXXXXXXXXXXXXXXXXXXGXXXXXXXXXXXXXXXXXXXGXXXXXXXXXXXXXXXXXXXGXXXXXXXXXXXXXXXXXXXGXXXXXXXXXXXXXXXXXXXGXXXXXXXXXXXXXXXXXXXGXXXXXXXXXXXXXXXXXXXGXXXXXXXXXXXXXXXXXXXGXXXXXXXXXXXXXXXXXXX,0,10,0
48699,14,1,13,52,534,0,0,548,446,102,GXXXXXXXXXXXXXXXXXXXGXXXXXXXXXXXXXXXXXXXGXXXXXXXXXXXXXXXXXXXGXXXXXXXXXXXXXXXXXXXGAXXXXXXXXXXXXXXXXXXGXXXXXXXXXXXXXXXXXXXGXXXXXXXXXXXXXXXXXXXGXXXXXXXXXXXXXXXXXXXGXXXXXXXXXXXXXXXXXXXGXXXXXXXXXXXXXXXXXXXGXXXXXXXXXXXXXXXXXXXGXXXXXXXXXXXXXXXXXXXGXXXXXXXXXXXXXXXXXXX,0,10,0

48720,14,1,13,49,537,0,0,552,449,103,GXXXXXXXXXXXXXXXXXXXGXXXXXXXXXXXXXXXXXXXGXXXXXXXXXXXXXXXXXXXGXXXXXXXXXXXXXXXXXXXGAXXXXXXXXXXXXXXXXXXGXXXXXXXXXXXXXXXXXXXGXXXXXXXXXXXXXXXXXXXGXXXXXXXXXXXXXXXXXXXGXXXXXXXXXXXXXXXXXXXGXXXXXXXXXXXXXXXXXXXGXXXXXXXXXXXXXXXXXXXGXXXXXXXXXXXXXXXXXXXGXXXXXXXXXXXXXXXXXXX,0,10,0
48741,14,1,13,49,537,0,0,552,450,102,GXXXXXXXXXXXXXXXXXXXGXXXXXXXXXXXXXXXXXXXGXXXXXXXXXXXXXXXXXXXGXXXXXXXXXXXXXXXXXXXGAXXXXXXXXXXXXXXXXXXGXXXXXXXXXXXXXXXXXXXGXXXXXXXXXXXXXXXXXXXGXXXXXXXXXXXXXXXXXXXGXXXXXXXXXXXXXXXXXXXGXXXXXXXXXXXXXXXXXXXGXXXXXXXXXXXXXXXXXXXGXXXXXXXXXXXXXXXXXXXGXXXXXXXXXXXXXXXXXXX,0,10,0
48762,14,1,13,50,536,0,0,551,449,102,GXXXXXXXXXXXXXXXXXXXGXXXXXXXXXXXXXXXXXXXGXXXXXXXXXXXXXXXXXXXGXXXXXXXXXXXXXXXXXXXGAXXXXXXXXXXXXXXXXXXGXXXXXXXXXXXXXXXXXXXGXXXXXXXXXXXXXXXXXXXGXXXXXXXXXXXXXXXXXXXGXXXXXXXXXXXXXXXXXXXGXXXXXXXXXXXXXXXXXXXGXXXXXXXXXXXXXXXXXXXGXXXXXXXXXXXXXXXXXXXGXXXXXXXXXXXXXXXXXXX,0,10,0
48783,14,1,13,48,538,0,0,553,450,103,GXXXXXXXXXXXXXXXXXXXGXXXXXXXXXXXXXXXXXXXGXXXXXXXXXXXXXXXXXXXGXXXXXXXXXXXXXXXXXXXGAXXXXXXXXXXXXXXXXXXGXXXXXXXXXXXXXXXXXXXGXXXXXXXXXXXXXXXXXXXGXXXXXXXXXXXXXXXXXXXGXXXXXXXXXXXXXXXXXXXGXXXXXXXXXXXXXXXXXXXGXXXXXXXXXXXXXXXXXXXGXXXXXXXXXXXXXXXXXXXGXXXXXXXXXXXXXXXXXXX,0,10,0
48804,14,1,13,51,535,0,0,550,449,101,GXXXXXXXXXXXXXXXXXXXGXXXXXXXXXXXXXXXXXXXGXXXXXXXXXXXXXXXXXXXGXXXXXXXXXXXXXXXXXXXGAXXXXXXXXXXXXXXXXXXGXXXXXXXXXXXXXXXXXXXGXXXXXXXXXXXXXXXXXXXGXXXXXXXXXXXXXXXXXXXGXXXXXXXXXXXXXXXXXXXGXXXXXXXXXXXXXXXXXXXGXXXXXXXXXXXXXXXXXXXGXXXXXXXXXXXXXXXXXXXGXXXXXXXXXXXXXXXXXXX,0,10,0

48825,14,1,13,51,535,0,0,551,446,105,GXXXXXXXXXXXXXXXXXXXGXXXXXXXXXXXXXXXXXXXGXXXXXXXXXXXXXXXXXXXGXXXXXXXXXXXXXXXXXXXGAXXXXXXXXXXXXXXXXXXGXXXXXXXXXXXXXXXXXXXGXXXXXXXXXXXXXXXXXXXGXXXXXXXXXXXXXXXXXXXGXXXXXXXXXXXXXXXXXXXGXXXXXXXXXXXXXXXXXXXGXXXXXXXXXXXXXXXXXXXGXXXXXXXXXXXXXXXXXXXGXXXXXXXXXXXXXXXXXXX,0,10,0
48846,14,1,13,43,543,0,0,558,451,107,GXXXXXXXXXXXXXXXXXXXGXXXXXXXXXXXXXXXXXXXGXXXXXXXXXXXXXXXXXXXGXXXXXXXXXXXXXXXXXXXGAXXXXXXXXXXXXXXXXXXGXXXXXXXXXXXXXXXXXXXGXXXXXXXXXXXXXXXXXXXGXXXXXXXXXXXXXXXXXXXGXXXXXXXXXXXXXXXXXXXGXXXXXXXXXXXXXXXXXXXGXXXXXXXXXXXXXXXXXXXGXXXXXXXXXXXXXXXXXXXGXXXXXXXXXXXXXXXXXXX,0,10,0
48867,14,1,13,42,544,0,0,558,455,103,GXXXXXXXXXXXXXXXXXXXGXXXXXXXXXXXXXXXXXXXGXXXXXXXXXXXXXXXXXXXGXXXXXXXXXXXXXXXXXXXGAXXXXXXXXXXXXXXXXXXGXXXXXXXXXXXXXXXXXXXGXXXXXXXXXXXXXXXXXXXGXXXXXXXXXXXXXXXXXXXGXXXXXXXXXXXXXXXXXXXGXXXXXXXXXXXXXXXXXXXGXXXXXXXXXXXXXXXXXXXGXXXXXXXXXXXXXXXXXXXGXXXXXXXXXXXXXXXXXXX,0,10,0
48888,14,1,13,42,544,0,0,559,462,97,GXXXXXXXXXXXXXXXXXXXGXXXXXXXXXXXXXXXXXXXGXXXXXXXXXXXXXXXXXXXGXXXXXXXXXXXXXXXXXXXGAXXXXXXXXXXXXXXXXXXGXXXXXXXXXXXXXXXXXXXGXXXXXXXXXXXXXXXXXXXGXXXXXXXXXXXXXXXXXXXGXXXXXXXXXXXXXXXXXXXGXXXXXXXXXXXXXXXXXXXGXXXXXXXXXXXXXXXXXXXGXXXXXXXXXXXXXXXXXXXGXXXXXXXXXXXXXXXXXXX,0,10,0
48909,14,1,13,50,536,0,0,550,457,93,GXXXXXXXXXXXXXXXXXXXGXXXXXXXXXXXXXXXXXXXGXXXXXXXXXXXXXXXXXXXGXXXXXXXXXXXXXXXXXXXGAXXXXXXXXXXXXXXXXXXGXXXXXXXXXXXXXXXXXXXGXXXXXXXXXXXXXXXXXXXGXXXXXXXXXXXXXXXXXXXGXXXXXXXXXXXXXXXXXXXGXXXXXXXXXXXXXXXXXXXGXXXXXXXXXXXXXXXXXXXGXXXXXXXXXXXXXXXXXXXGXXXXXXXXXXXXXXXXXXX,0,10,0

48930,14,1,13,49,537,0,0,549,457,92,GXXXXXXXXXXXXXXXXXXXGXXXXXXXXXXXXXXXXXXXGXXXXXXXXXXXXXXXXXXXGXXXXXXXXXXXXXXXXXXXGAXXXXXXXXXXXXXXXXXXGXXXXXXXXXXXXXXXXXXXGXXXXXXXXXXXXXXXXXXXGXXXXXXXXXXXXXXXXXXXGXXXXXXXXXXXXXXXXXXXGXXXXXXXXXXXXXXXXXXXGXXXXXXXXXXXXXXXXXXXGXXXXXXXXXXXXXXXXXXXGXXXXXXXXXXXXXXXXXXX,0,10,0
48951,14,1,13,54,532,0,0,545,452,93,GXXXXXXXXXXXXXXXXXXXGXXXXXXXXXXXXXXXXXXXGXXXXXXXXXXXXXXXXXXXGXXXXXXXXXXXXXXXXXXXGAXXXXXXXXXXXXXXXXXXGXXXXXXXXXXXXXXXXXXXGXXXXXXXXXXXXXXXXXXXGXXXXXXXXXXXXXXXXXXXGXXXXXXXXXXXXXXXXXXXGXXXXXXXXXXXXXXXXXXXGXXXXXXXXXXXXXXXXXXXGXXXXXXXXXXXXXXXXXXXGXXXXXXXXXXXXXXXXXXX,0,10,0
48972,14,1,13,53,533,0,0,547,449,98,GXXXXXXXXXXXXXXXXXXXGXXXXXXXXXXXXXXXXXXXGXXXXXXXXXXXXXXXXXXXGXXXXXXXXXXXXXXXXXXXGAXXXXXXXXXXXXXXXXXXGXXXXXXXXXXXXXXXXXXXGXXXXXXXXXXXXXXXXXXXGXXXXXXXXXXXXXXXXXXXGXXXXXXXXXXXXXXXXXXXGXXXXXXXXXXXXXXXXXXXGXXXXXXXXXXXXXXXXXXXGXXXXXXXXXXXXXXXXXXXGXXXXXXXXXXXXXXXXXXX,0,10,0
48993,14,1,13,54,532,0,0,545,450,95,GXXXXXXXXXXXXXXXXXXXGXXXXXXXXXXXXXXXXXXXGXXXXXXXXXXXXXXXXXXXGXXXXXXXXXXXXXXXXXXXGAXXXXXXXXXXXXXXXXXXGXXXXXXXXXXXXXXXXXXXGXXXXXXXXXXXXXXXXXXXGXXXXXXXXXXXXXXXXXXXGXXXXXXXXXXXXXXXXXXXGXXXXXXXXXXXXXXXXXXXGXXXXXXXXXXXXXXXXXXXGXXXXXXXXXXXXXXXXXXXGXXXXXXXXXXXXXXXXXXX,0,10,0
49014,13,0,13,51,536,0,0,548,451,97,GXXXXXXXXXXXXXXXXXXXGXXXXXXXXXXXXXXXXXXXGXXXXXXXXXXXXXXXXXXXGXXXXXXXXXXXXXXXXXXXGXXXXXXXXXXXXXXXXXXXGXXXXXXXXXXXXXXXXXXXGXXXXXXXXXXXXXXXXXXXGXXXXXXXXXXXXXXXXXXXGXXXXXXXXXXXXXXXXXXXGXXXXXXXXXXXXXXXXXXXGXXXXXXXXXXXXXXXXXXXGXXXXXXXXXXXXXXXXXXXGXXXXXXXXXXXXXXXXXXX,0,10,0

49035,13,0,13,49,538,0,0,551,449,102,GXXXXXXXXXXXXXXXXXXXGXXXXXXXXXXXXXXXXXXXGXXXXXXXXXXXXXXXXXXXGXXXXXXXXXXXXXXXXXXXGXXXXXXXXXXXXXXXXXXXGXXXXXXXXXXXXXXXXXXXGXXXXXXXXXXXXXXXXXXXGXXXXXXXXXXXXXXXXXXXGXXXXXXXXXXXXXXXXXXXGXXXXXXXXXXXXXXXXXXXGXXXXXXXXXXXXXXXXXXXGXXXXXXXXXXXXXXXXXXXGXXXXXXXXXXXXXXXXXXX,0,10,0
49056,13,0,13,48,539,0,0,552,457,95,GXXXXXXXXXXXXXXXXXXXGXXXXXXXXXXXXXXXXXXXGXXXXXXXXXXXXXXXXXXXGXXXXXXXXXXXXXXXXXXXGXXXXXXXXXXXXXXXXXXXGXXXXXXXXXXXXXXXXXXXGXXXXXXXXXXXXXXXXXXXGXXXXXXXXXXXXXXXXXXXGXXXXXXXXXXXXXXXXXXXGXXXXXXXXXXXXXXXXXXXGXXXXXXXXXXXXXXXXXXXGXXXXXXXXXXXXXXXXXXXGXXXXXXXXXXXXXXXXXXX,0,10,0
49077,13,0,13,49,538,0,0,551,451,100,GXXXXXXXXXXXXXXXXXXXGXXXXXXXXXXXXXXXXXXXGXXXXXXXXXXXXXXXXXXXGXXXXXXXXXXXXXXXXXXXGXXXXXXXXXXXXXXXXXXXGXXXXXXXXXXXXXXXXXXXGXXXXXXXXXXXXXXXXXXXGXXXXXXXXXXXXXXXXXXXGXXXXXXXXXXXXXXXXXXXGXXXXXXXXXXXXXXXXXXXGXXXXXXXXXXXXXXXXXXXGXXXXXXXXXXXXXXXXXXXGXXXXXXXXXXXXXXXXXXX,0,10,0
49098,13,0,13,46,541,0,0,554,452,102,GXXXXXXXXXXXXXXXXXXXGXXXXXXXXXXXXXXXXXXXGXXXXXXXXXXXXXXXXXXXGXXXXXXXXXXXXXXXXXXXGXXXXXXXXXXXXXXXXXXXGXXXXXXXXXXXXXXXXXXXGXXXXXXXXXXXXXXXXXXXGXXXXXXXXXXXXXXXXXXXGXXXXXXXXXXXXXXXXXXXGXXXXXXXXXXXXXXXXXXXGXXXXXXXXXXXXXXXXXXXGXXXXXXXXXXXXXXXXXXXGXXXXXXXXXXXXXXXXXXX,0,10,0
49119,13,0,13,46,541,0,0,554,452,102,GXXXXXXXXXXXXXXXXXXXGXXXXXXXXXXXXXXXXXXXGXXXXXXXXXXXXXXXXXXXGXXXXXXXXXXXXXXXXXXXGXXXXXXXXXXXXXXXXXXXGXXXXXXXXXXXXXXXXXXXGXXXXXXXXXXXXXXXXXXXGXXXXXXXXXXXXXXXXXXXGXXXXXXXXXXXXXXXXXXXGXXXXXXXXXXXXXXXXXXXGXXXXXXXXXXXXXXXXXXXGXXXXXXXXXXXXXXXXXXXGXXXXXXXXXXXXXXXXXXX,0,10,0

49140,13,0,13,45,542,0,0,555,453,102,GXXXXXXXXXXXXXXXXXXXGXXXXXXXXXXXXXXXXXXXGXXXXXXXXXXXXXXXXXXXGXXXXXXXXXXXXXXXXXXXGXXXXXXXXXXXXXXXXXXXGXXXXXXXXXXXXXXXXXXXGXXXXXXXXXXXXXXXXXXXGXXXXXXXXXXXXXXXXXXXGXXXXXXXXXXXXXXXXXXXGXXXXXXXXXXXXXXXXXXXGXXXXXXXXXXXXXXXXXXXGXXXXXXXXXXXXXXXXXXXGXXXXXXXXXXXXXXXXXXX,0,10,0
49161,13,0,13,47,540,0,0,552,454,98,GXXXXXXXXXXXXXXXXXXXGXXXXXXXXXXXXXXXXXXXGXXXXXXXXXXXXXXXXXXXGXXXXXXXXXXXXXXXXXXXGXXXXXXXXXXXXXXXXXXXGXXXXXXXXXXXXXXXXXXXGXXXXXXXXXXXXXXXXXXXGXXXXXXXXXXXXXXXXXXXGXXXXXXXXXXXXXXXXXXXGXXXXXXXXXXXXXXXXXXXGXXXXXXXXXXXXXXXXXXXGXXXXXXXXXXXXXXXXXXXGXXXXXXXXXXXXXXXXXXX,0,10,0
49182,13,0,13,50,537,0,0,550,452,98,GXXXXXXXXXXXXXXXXXXXGXXXXXXXXXXXXXXXXXXXGXXXXXXXXXXXXXXXXXXXGXXXXXXXXXXXXXXXXXXXGXXXXXXXXXXXXXXXXXXXGXXXXXXXXXXXXXXXXXXXGXXXXXXXXXXXXXXXXXXXGXXXXXXXXXXXXXXXXXXXGXXXXXXXXXXXXXXXXXXXGXXXXXXXXXXXXXXXXXXXGXXXXXXXXXXXXXXXXXXXGXXXXXXXXXXXXXXXXXXXGXXXXXXXXXXXXXXXXXXX,0,10,0
49203,13,0,13,47,540,0,0,553,449,104,GXXXXXXXXXXXXXXXXXXXGXXXXXXXXXXXXXXXXXXXGXXXXXXXXXXXXXXXXXXXGXXXXXXXXXXXXXXXXXXXGXXXXXXXXXXXXXXXXXXXGXXXXXXXXXXXXXXXXXXXGXXXXXXXXXXXXXXXXXXXGXXXXXXXXXXXXXXXXXXXGXXXXXXXXXXXXXXXXXXXGXXXXXXXXXXXXXXXXXXXGXXXXXXXXXXXXXXXXXXXGXXXXXXXXXXXXXXXXXXXGXXXXXXXXXXXXXXXXXXX,0,10,0
49224,13,0,13,47,540,0,0,553,449,104,GXXXXXXXXXXXXXXXXXXXGXXXXXXXXXXXXXXXXXXXGXXXXXXXXXXXXXXXXXXXGXXXXXXXXXXXXXXXXXXXGXXXXXXXXXXXXXXXXXXXGXXXXXXXXXXXXXXXXXXXGXXXXXXXXXXXXXXXXXXXGXXXXXXXXXXXXXXXXXXXGXXXXXXXXXXXXXXXXXXXGXXXXXXXXXXXXXXXXXXXGXXXXXXXXXXXXXXXXXXXGXXXXXXXXXXXXXXXXXXXGXXXXXXXXXXXXXXXXXXX,0,10,0

49245,13,0,13,47,540,0,0,553,451,102,GXXXXXXXXXXXXXXXXXXXGXXXXXXXXXXXXXXXXXXXGXXXXXXXXXXXXXXXXXXXGXXXXXXXXXXXXXXXXXXXGXXXXXXXXXXXXXXXXXXXGXXXXXXXXXXXXXXXXXXXGXXXXXXXXXXXXXXXXXXXGXXXXXXXXXXXXXXXXXXXGXXXXXXXXXXXXXXXXXXXGXXXXXXXXXXXXXXXXXXXGXXXXXXXXXXXXXXXXXXXGXXXXXXXXXXXXXXXXXXXGXXXXXXXXXXXXXXXXXXX,0,10,0
49266,13,0,13,47,540,0,0,552,451,101,GXXXXXXXXXXXXXXXXXXXGXXXXXXXXXXXXXXXXXXXGXXXXXXXXXXXXXXXXXXXGXXXXXXXXXXXXXXXXXXXGXXXXXXXXXXXXXXXXXXXGXXXXXXXXXXXXXXXXXXXGXXXXXXXXXXXXXXXXXXXGXXXXXXXXXXXXXXXXXXXGXXXXXXXXXXXXXXXXXXXGXXXXXXXXXXXXXXXXXXXGXXXXXXXXXXXXXXXXXXXGXXXXXXXXXXXXXXXXXXXGXXXXXXXXXXXXXXXXXXX,0,10,0
49287,13,0,13,49,538,0,0,551,453,98,GXXXXXXXXXXXXXXXXXXXGXXXXXXXXXXXXXXXXXXXGXXXXXXXXXXXXXXXXXXXGXXXXXXXXXXXXXXXXXXXGXXXXXXXXXXXXXXXXXXXGXXXXXXXXXXXXXXXXXXXGXXXXXXXXXXXXXXXXXXXGXXXXXXXXXXXXXXXXXXXGXXXXXXXXXXXXXXXXXXXGXXXXXXXXXXXXXXXXXXXGXXXXXXXXXXXXXXXXXXXGXXXXXXXXXXXXXXXXXXXGXXXXXXXXXXXXXXXXXXX,0,10,0
49308,13,0,13,48,539,0,0,553,453,100,GXXXXXXXXXXXXXXXXXXXGXXXXXXXXXXXXXXXXXXXGXXXXXXXXXXXXXXXXXXXGXXXXXXXXXXXXXXXXXXXGXXXXXXXXXXXXXXXXXXXGXXXXXXXXXXXXXXXXXXXGXXXXXXXXXXXXXXXXXXXGXXXXXXXXXXXXXXXXXXXGXXXXXXXXXXXXXXXXXXXGXXXXXXXXXXXXXXXXXXXGXXXXXXXXXXXXXXXXXXXGXXXXXXXXXXXXXXXXXXXGXXXXXXXXXXXXXXXXXXX,0,10,0
49329,13,0,13,39,548,0,0,562,453,109,GXXXXXXXXXXXXXXXXXXXGXXXXXXXXXXXXXXXXXXXGXXXXXXXXXXXXXXXXXXXGXXXXXXXXXXXXXXXXXXXGXXXXXXXXXXXXXXXXXXXGXXXXXXXXXXXXXXXXXXXGXXXXXXXXXXXXXXXXXXXGXXXXXXXXXXXXXXXXXXXGXXXXXXXXXXXXXXXXXXXGXXXXXXXXXXXXXXXXXXXGXXXXXXXXXXXXXXXXXXXGXXXXXXXXXXXXXXXXXXXGXXXXXXXXXXXXXXXXXXX,0,10,0

49350,13,0,13,43,544,0,0,557,452,105,GXXXXXXXXXXXXXXXXXXXGXXXXXXXXXXXXXXXXXXXGXXXXXXXXXXXXXXXXXXXGXXXXXXXXXXXXXXXXXXXGXXXXXXXXXXXXXXXXXXXGXXXXXXXXXXXXXXXXXXXGXXXXXXXXXXXXXXXXXXXGXXXXXXXXXXXXXXXXXXXGXXXXXXXXXXXXXXXXXXXGXXXXXXXXXXXXXXXXXXXGXXXXXXXXXXXXXXXXXXXGXXXXXXXXXXXXXXXXXXXGXXXXXXXXXXXXXXXXXXX,0,10,0
49371,13,0,13,47,540,0,0,553,451,102,GXXXXXXXXXXXXXXXXXXXGXXXXXXXXXXXXXXXXXXXGXXXXXXXXXXXXXXXXXXXGXXXXXXXXXXXXXXXXXXXGXXXXXXXXXXXXXXXXXXXGXXXXXXXXXXXXXXXXXXXGXXXXXXXXXXXXXXXXXXXGXXXXXXXXXXXXXXXXXXXGXXXXXXXXXXXXXXXXXXXGXXXXXXXXXXXXXXXXXXXGXXXXXXXXXXXXXXXXXXXGXXXXXXXXXXXXXXXXXXXGXXXXXXXXXXXXXXXXXXX,0,10,0
49392,13,0,13,48,539,0,0,552,451,101,GXXXXXXXXXXXXXXXXXXXGXXXXXXXXXXXXXXXXXXXGXXXXXXXXXXXXXXXXXXXGXXXXXXXXXXXXXXXXXXXGXXXXXXXXXXXXXXXXXXXGXXXXXXXXXXXXXXXXXXXGXXXXXXXXXXXXXXXXXXXGXXXXXXXXXXXXXXXXXXXGXXXXXXXXXXXXXXXXXXXGXXXXXXXXXXXXXXXXXXXGXXXXXXXXXXXXXXXXXXXGXXXXXXXXXXXXXXXXXXXGXXXXXXXXXXXXXXXXXXX,0,10,0
49413,13,0,13,49,538,0,0,550,451,99,GXXXXXXXXXXXXXXXXXXXGXXXXXXXXXXXXXXXXXXXGXXXXXXXXXXXXXXXXXXXGXXXXXXXXXXXXXXXXXXXGXXXXXXXXXXXXXXXXXXXGXXXXXXXXXXXXXXXXXXXGXXXXXXXXXXXXXXXXXXXGXXXXXXXXXXXXXXXXXXXGXXXXXXXXXXXXXXXXXXXGXXXXXXXXXXXXXXXXXXXGXXXXXXXXXXXXXXXXXXXGXXXXXXXXXXXXXXXXXXXGXXXXXXXXXXXXXXXXXXX,0,10,0
49434,13,0,13,48,539,0,0,549,452,97,GXXXXXXXXXXXXXXXXXXXGXXXXXXXXXXXXXXXXXXXGXXXXXXXXXXXXXXXXXXXGXXXXXXXXXXXXXXXXXXXGXXXXXXXXXXXXXXXXXXXGXXXXXXXXXXXXXXXXXXXGXXXXXXXXXXXXXXXXXXXGXXXXXXXXXXXXXXXXXXXGXXXXXXXXXXXXXXXXXXXGXXXXXXXXXXXXXXXXXXXGXXXXXXXXXXXXXXXXXXXGXXXXXXXXXXXXXXXXXXXGXXXXXXXXXXXXXXXXXXX,0,10,0

49455,13,0,13,47,540,0,0,553,456,97,GXXXXXXXXXXXXXXXXXXXGXXXXXXXXXXXXXXXXXXXGXXXXXXXXXXXXXXXXXXXGXXXXXXXXXXXXXXXXXXXGXXXXXXXXXXXXXXXXXXXGXXXXXXXXXXXXXXXXXXXGXXXXXXXXXXXXXXXXXXXGXXXXXXXXXXXXXXXXXXXGXXXXXXXXXXXXXXXXXXXGXXXXXXXXXXXXXXXXXXXGXXXXXXXXXXXXXXXXXXXGXXXXXXXXXXXXXXXXXXXGXXXXXXXXXXXXXXXXXXX,0,10,0
49476,13,0,13,52,535,0,0,548,452,96,GXXXXXXXXXXXXXXXXXXXGXXXXXXXXXXXXXXXXXXXGXXXXXXXXXXXXXXXXXXXGXXXXXXXXXXXXXXXXXXXGXXXXXXXXXXXXXXXXXXXGXXXXXXXXXXXXXXXXXXXGXXXXXXXXXXXXXXXXXXXGXXXXXXXXXXXXXXXXXXXGXXXXXXXXXXXXXXXXXXXGXXXXXXXXXXXXXXXXXXXGXXXXXXXXXXXXXXXXXXXGXXXXXXXXXXXXXXXXXXXGXXXXXXXXXXXXXXXXXXX,0,10,0
49497,13,0,13,54,533,0,0,546,453,93,GXXXXXXXXXXXXXXXXXXXGXXXXXXXXXXXXXXXXXXXGXXXXXXXXXXXXXXXXXXXGXXXXXXXXXXXXXXXXXXXGXXXXXXXXXXXXXXXXXXXGXXXXXXXXXXXXXXXXXXXGXXXXXXXXXXXXXXXXXXXGXXXXXXXXXXXXXXXXXXXGXXXXXXXXXXXXXXXXXXXGXXXXXXXXXXXXXXXXXXXGXXXXXXXXXXXXXXXXXXXGXXXXXXXXXXXXXXXXXXXGXXXXXXXXXXXXXXXXXXX,0,10,0
49518,13,0,13,55,532,0,0,544,453,91,GXXXXXXXXXXXXXXXXXXXGXXXXXXXXXXXXXXXXXXXGXXXXXXXXXXXXXXXXXXXGXXXXXXXXXXXXXXXXXXXGXXXXXXXXXXXXXXXXXXXGXXXXXXXXXXXXXXXXXXXGXXXXXXXXXXXXXXXXXXXGXXXXXXXXXXXXXXXXXXXGXXXXXXXXXXXXXXXXXXXGXXXXXXXXXXXXXXXXXXXGXXXXXXXXXXXXXXXXXXXGXXXXXXXXXXXXXXXXXXXGXXXXXXXXXXXXXXXXXXX,0,10,0
49539,13,0,13,54,533,0,0,546,453,93,GXXXXXXXXXXXXXXXXXXXGXXXXXXXXXXXXXXXXXXXGXXXXXXXXXXXXXXXXXXXGXXXXXXXXXXXXXXXXXXXGXXXXXXXXXXXXXXXXXXXGXXXXXXXXXXXXXXXXXXXGXXXXXXXXXXXXXXXXXXXGXXXXXXXXXXXXXXXXXXXGXXXXXXXXXXXXXXXXXXXGXXXXXXXXXXXXXXXXXXXGXXXXXXXXXXXXXXXXXXXGXXXXXXXXXXXXXXXXXXXGXXXXXXXXXXXXXXXXXXX,0,10,0

49560,13,0,13,56,531,0,0,546,452,94,GXXXXXXXXXXXXXXXXXXXGXXXXXXXXXXXXXXXXXXXGXXXXXXXXXXXXXXXXXXXGXXXXXXXXXXXXXXXXXXXGXXXXXXXXXXXXXXXXXXXGXXXXXXXXXXXXXXXXXXXGXXXXXXXXXXXXXXXXXXXGXXXXXXXXXXXXXXXXXXXGXXXXXXXXXXXXXXXXXXXGXXXXXXXXXXXXXXXXXXXGXXXXXXXXXXXXXXXXXXXGXXXXXXXXXXXXXXXXXXXGXXXXXXXXXXXXXXXXXXX,0,10,0
49581,13,0,13,56,531,0,0,546,455,91,GXXXXXXXXXXXXXXXXXXXGXXXXXXXXXXXXXXXXXXXGXXXXXXXXXXXXXXXXXXXGXXXXXXXXXXXXXXXXXXXGXXXXXXXXXXXXXXXXXXXGXXXXXXXXXXXXXXXXXXXGXXXXXXXXXXXXXXXXXXXGXXXXXXXXXXXXXXXXXXXGXXXXXXXXXXXXXXXXXXXGXXXXXXXXXXXXXXXXXXXGXXXXXXXXXXXXXXXXXXXGXXXXXXXXXXXXXXXXXXXGXXXXXXXXXXXXXXXXXXX,0,10,0
49602,13,0,13,59,528,0,0,542,454,88,GXXXXXXXXXXXXXXXXXXXGXXXXXXXXXXXXXXXXXXXGXXXXXXXXXXXXXXXXXXXGXXXXXXXXXXXXXXXXXXXGXXXXXXXXXXXXXXXXXXXGXXXXXXXXXXXXXXXXXXXGXXXXXXXXXXXXXXXXXXXGXXXXXXXXXXXXXXXXXXXGXXXXXXXXXXXXXXXXXXXGXXXXXXXXXXXXXXXXXXXGXXXXXXXXXXXXXXXXXXXGXXXXXXXXXXXXXXXXXXXGXXXXXXXXXXXXXXXXXXX,0,10,0
49623,13,0,13,56,531,0,0,544,457,87,GXXXXXXXXXXXXXXXXXXXGXXXXXXXXXXXXXXXXXXXGXXXXXXXXXXXXXXXXXXXGXXXXXXXXXXXXXXXXXXXGXXXXXXXXXXXXXXXXXXXGXXXXXXXXXXXXXXXXXXXGXXXXXXXXXXXXXXXXXXXGXXXXXXXXXXXXXXXXXXXGXXXXXXXXXXXXXXXXXXXGXXXXXXXXXXXXXXXXXXXGXXXXXXXXXXXXXXXXXXXGXXXXXXXXXXXXXXXXXXXGXXXXXXXXXXXXXXXXXXX,0,10,0
49644,14,1,13,58,528,0,0,542,454,88,GXXXXXXXXXXXXXXXXXXXGXXXXXXXXXXXXXXXXXXXGXXXXXXXXXXXXXXXXXXXGAXXXXXXXXXXXXXXXXXXGXXXXXXXXXXXXXXXXXXXGXXXXXXXXXXXXXXXXXXXGXXXXXXXXXXXXXXXXXXXGXXXXXXXXXXXXXXXXXXXGXXXXXXXXXXXXXXXXXXXGXXXXXXXXXXXXXXXXXXXGXXXXXXXXXXXXXXXXXXXGXXXXXXXXXXXXXXXXXXXGXXXXXXXXXXXXXXXXXXX,0,10,0

49665,14,0,14,54,532,0,0,547,453,94,GXXXXXXXXXXXXXXXXXXXGXXXXXXXXXXXXXXXXXXXGXXXXXXXXXXXXXXXXXXXGOXXXXXXXXXXXXXXXXXXGXXXXXXXXXXXXXXXXXXXGXXXXXXXXXXXXXXXXXXXGXXXXXXXXXXXXXXXXXXXGXXXXXXXXXXXXXXXXXXXGXXXXXXXXXXXXXXXXXXXGXXXXXXXXXXXXXXXXXXXGXXXXXXXXXXXXXXXXXXXGXXXXXXXXXXXXXXXXXXXGXXXXXXXXXXXXXXXXXXX,0,10,0
49686,14,0,14,55,531,0,0,546,451,95,GXXXXXXXXXXXXXXXXXXXGXXXXXXXXXXXXXXXXXXXGXXXXXXXXXXXXXXXXXXXGOXXXXXXXXXXXXXXXXXXGXXXXXXXXXXXXXXXXXXXGXXXXXXXXXXXXXXXXXXXGXXXXXXXXXXXXXXXXXXXGXXXXXXXXXXXXXXXXXXXGXXXXXXXXXXXXXXXXXXXGXXXXXXXXXXXXXXXXXXXGXXXXXXXXXXXXXXXXXXXGXXXXXXXXXXXXXXXXXXXGXXXXXXXXXXXXXXXXXXX,0,10,0
49707,13,0,13,49,538,0,0,551,454,97,GXXXXXXXXXXXXXXXXXXXGXXXXXXXXXXXXXXXXXXXGXXXXXXXXXXXXXXXXXXXGXXXXXXXXXXXXXXXXXXXGXXXXXXXXXXXXXXXXXXXGXXXXXXXXXXXXXXXXXXXGXXXXXXXXXXXXXXXXXXXGXXXXXXXXXXXXXXXXXXXGXXXXXXXXXXXXXXXXXXXGXXXXXXXXXXXXXXXXXXXGXXXXXXXXXXXXXXXXXXXGXXXXXXXXXXXXXXXXXXXGXXXXXXXXXXXXXXXXXXX,0,10,0
49728,13,0,13,53,534,0,0,548,453,95,GXXXXXXXXXXXXXXXXXXXGXXXXXXXXXXXXXXXXXXXGXXXXXXXXXXXXXXXXXXXGXXXXXXXXXXXXXXXXXXXGXXXXXXXXXXXXXXXXXXXGXXXXXXXXXXXXXXXXXXXGXXXXXXXXXXXXXXXXXXXGXXXXXXXXXXXXXXXXXXXGXXXXXXXXXXXXXXXXXXXGXXXXXXXXXXXXXXXXXXXGXXXXXXXXXXXXXXXXXXXGXXXXXXXXXXXXXXXXXXXGXXXXXXXXXXXXXXXXXXX,0,10,0
49749,13,0,13,54,533,0,0,547,451,96,GXXXXXXXXXXXXXXXXXXXGXXXXXXXXXXXXXXXXXXXGXXXXXXXXXXXXXXXXXXXGXXXXXXXXXXXXXXXXXXXGXXXXXXXXXXXXXXXXXXXGXXXXXXXXXXXXXXXXXXXGXXXXXXXXXXXXXXXXXXXGXXXXXXXXXXXXXXXXXXXGXXXXXXXXXXXXXXXXXXXGXXXXXXXXXXXXXXXXXXXGXXXXXXXXXXXXXXXXXXXGXXXXXXXXXXXXXXXXXXXGXXXXXXXXXXXXXXXXXXX,0,10,0

49770,13,0,13,52,535,0,0,549,451,98,GXXXXXXXXXXXXXXXXXXXGXXXXXXXXXXXXXXXXXXXGXXXXXXXXXXXXXXXXXXXGXXXXXXXXXXXXXXXXXXXGXXXXXXXXXXXXXXXXXXXGXXXXXXXXXXXXXXXXXXXGXXXXXXXXXXXXXXXXXXXGXXXXXXXXXXXXXXXXXXXGXXXXXXXXXXXXXXXXXXXGXXXXXXXXXXXXXXXXXXXGXXXXXXXXXXXXXXXXXXXGXXXXXXXXXXXXXXXXXXXGXXXXXXXXXXXXXXXXXXX,0,10,0
49791,13,0,13,52,535,0,0,548,455,93,GXXXXXXXXXXXXXXXXXXXGXXXXXXXXXXXXXXXXXXXGXXXXXXXXXXXXXXXXXXXGXXXXXXXXXXXXXXXXXXXGXXXXXXXXXXXXXXXXXXXGXXXXXXXXXXXXXXXXXXXGXXXXXXXXXXXXXXXXXXXGXXXXXXXXXXXXXXXXXXXGXXXXXXXXXXXXXXXXXXXGXXXXXXXXXXXXXXXXXXXGXXXXXXXXXXXXXXXXXXXGXXXXXXXXXXXXXXXXXXXGXXXXXXXXXXXXXXXXXXX,0,10,0
49812,13,0,13,54,533,0,0,546,450,96,GXXXXXXXXXXXXXXXXXXXGXXXXXXXXXXXXXXXXXXXGXXXXXXXXXXXXXXXXXXXGXXXXXXXXXXXXXXXXXXXGXXXXXXXXXXXXXXXXXXXGXXXXXXXXXXXXXXXXXXXGXXXXXXXXXXXXXXXXXXXGXXXXXXXXXXXXXXXXXXXGXXXXXXXXXXXXXXXXXXXGXXXXXXXXXXXXXXXXXXXGXXXXXXXXXXXXXXXXXXXGXXXXXXXXXXXXXXXXXXXGXXXXXXXXXXXXXXXXXXX,0,10,0
49833,13,0,13,55,532,0,0,544,450,94,GXXXXXXXXXXXXXXXXXXXGXXXXXXXXXXXXXXXXXXXGXXXXXXXXXXXXXXXXXXXGXXXXXXXXXXXXXXXXXXXGXXXXXXXXXXXXXXXXXXXGXXXXXXXXXXXXXXXXXXXGXXXXXXXXXXXXXXXXXXXGXXXXXXXXXXXXXXXXXXXGXXXXXXXXXXXXXXXXXXXGXXXXXXXXXXXXXXXXXXXGXXXXXXXXXXXXXXXXXXXGXXXXXXXXXXXXXXXXXXXGXXXXXXXXXXXXXXXXXXX,0,10,0
49854,13,0,13,53,534,0,0,547,452,95,GXXXXXXXXXXXXXXXXXXXGXXXXXXXXXXXXXXXXXXXGXXXXXXXXXXXXXXXXXXXGXXXXXXXXXXXXXXXXXXXGXXXXXXXXXXXXXXXXXXXGXXXXXXXXXXXXXXXXXXXGXXXXXXXXXXXXXXXXXXXGXXXXXXXXXXXXXXXXXXXGXXXXXXXXXXXXXXXXXXXGXXXXXXXXXXXXXXXXXXXGXXXXXXXXXXXXXXXXXXXGXXXXXXXXXXXXXXXXXXXGXXXXXXXXXXXXXXXXXXX,0,10,0

49875,13,0,13,51,536,0,0,548,454,94,GXXXXXXXXXXXXXXXXXXXGXXXXXXXXXXXXXXXXXXXGXXXXXXXXXXXXXXXXXXXGXXXXXXXXXXXXXXXXXXXGXXXXXXXXXXXXXXXXXXXGXXXXXXXXXXXXXXXXXXXGXXXXXXXXXXXXXXXXXXXGXXXXXXXXXXXXXXXXXXXGXXXXXXXXXXXXXXXXXXXGXXXXXXXXXXXXXXXXXXXGXXXXXXXXXXXXXXXXXXXGXXXXXXXXXXXXXXXXXXXGXXXXXXXXXXXXXXXXXXX,0,10,0
49896,13,0,13,47,540,0,0,553,456,97,GXXXXXXXXXXXXXXXXXXXGXXXXXXXXXXXXXXXXXXXGXXXXXXXXXXXXXXXXXXXGXXXXXXXXXXXXXXXXXXXGXXXXXXXXXXXXXXXXXXXGXXXXXXXXXXXXXXXXXXXGXXXXXXXXXXXXXXXXXXXGXXXXXXXXXXXXXXXXXXXGXXXXXXXXXXXXXXXXXXXGXXXXXXXXXXXXXXXXXXXGXXXXXXXXXXXXXXXXXXXGXXXXXXXXXXXXXXXXXXXGXXXXXXXXXXXXXXXXXXX,0,10,0
49917,13,0,13,49,538,0,0,551,453,98,GXXXXXXXXXXXXXXXXXXXGXXXXXXXXXXXXXXXXXXXGXXXXXXXXXXXXXXXXXXXGXXXXXXXXXXXXXXXXXXXGXXXXXXXXXXXXXXXXXXXGXXXXXXXXXXXXXXXXXXXGXXXXXXXXXXXXXXXXXXXGXXXXXXXXXXXXXXXXXXXGXXXXXXXXXXXXXXXXXXXGXXXXXXXXXXXXXXXXXXXGXXXXXXXXXXXXXXXXXXXGXXXXXXXXXXXXXXXXXXXGXXXXXXXXXXXXXXXXXXX,0,10,0
49938,13,0,13,47,540,0,0,553,455,98,GXXXXXXXXXXXXXXXXXXXGXXXXXXXXXXXXXXXXXXXGXXXXXXXXXXXXXXXXXXXGXXXXXXXXXXXXXXXXXXXGXXXXXXXXXXXXXXXXXXXGXXXXXXXXXXXXXXXXXXXGXXXXXXXXXXXXXXXXXXXGXXXXXXXXXXXXXXXXXXXGXXXXXXXXXXXXXXXXXXXGXXXXXXXXXXXXXXXXXXXGXXXXXXXXXXXXXXXXXXXGXXXXXXXXXXXXXXXXXXXGXXXXXXXXXXXXXXXXXXX,0,10,0
49959,13,0,13,50,537,0,0,550,456,94,GXXXXXXXXXXXXXXXXXXXGXXXXXXXXXXXXXXXXXXXGXXXXXXXXXXXXXXXXXXXGXXXXXXXXXXXXXXXXXXXGXXXXXXXXXXXXXXXXXXXGXXXXXXXXXXXXXXXXXXXGXXXXXXXXXXXXXXXXXXXGXXXXXXXXXXXXXXXXXXXGXXXXXXXXXXXXXXXXXXXGXXXXXXXXXXXXXXXXXXXGXXXXXXXXXXXXXXXXXXXGXXXXXXXXXXXXXXXXXXXGXXXXXXXXXXXXXXXXXXX,0,10,0

