iterCounter, dimersInMT, activeDimersInMT, inactiveDimersInMT, activeDimersFree,inactiveDimersFree, longestProtoFilament, lengthOfMT, totalGTPs, activeGTPs,inactiveGTPs, mtRepresentation, DeHydro Katanins, Hydro Katanins, Bonded Katanins

21,0,0,0,0,0,0,0,0,0,0,XXXXXXXXXXXXXXXXXXXXXXXXXXXXXXXXXXXXXXXXXXXXXXXXXXXXXXXXXXXXXXXXXXXXXXXXXXXXXXXXXXXXXXXXXXXXXXXXXXXXXXXXXXXXXXXXXXXXXXXXXXXXXXXXXXXXXXXXXXXXXXXXXXXXXXXXXXXXXXXXXXXXXXXXXXXXXXXXXXXXXXXXXXXXXXXXXXXXXXXXXXXXXXXXXXXXXXXXXXXXXXXXXXXXXXXXXXXXXXXXXXXXXXXXXXXXXXXXXXXX,0,0,0
42,0,0,0,0,0,0,0,0,0,0,XXXXXXXXXXXXXXXXXXXXXXXXXXXXXXXXXXXXXXXXXXXXXXXXXXXXXXXXXXXXXXXXXXXXXXXXXXXXXXXXXXXXXXXXXXXXXXXXXXXXXXXXXXXXXXXXXXXXXXXXXXXXXXXXXXXXXXXXXXXXXXXXXXXXXXXXXXXXXXXXXXXXXXXXXXXXXXXXXXXXXXXXXXXXXXXXXXXXXXXXXXXXXXXXXXXXXXXXXXXXXXXXXXXXXXXXXXXXXXXXXXXXXXXXXXXXXXXXXXXX,0,0,0
63,0,0,0,0,0,0,0,0,0,0,XXXXXXXXXXXXXXXXXXXXXXXXXXXXXXXXXXXXXXXXXXXXXXXXXXXXXXXXXXXXXXXXXXXXXXXXXXXXXXXXXXXXXXXXXXXXXXXXXXXXXXXXXXXXXXXXXXXXXXXXXXXXXXXXXXXXXXXXXXXXXXXXXXXXXXXXXXXXXXXXXXXXXXXXXXXXXXXXXXXXXXXXXXXXXXXXXXXXXXXXXXXXXXXXXXXXXXXXXXXXXXXXXXXXXXXXXXXXXXXXXXXXXXXXXXXXXXXXXXXX,0,0,0
84,0,0,0,0,0,0,0,0,0,0,XXXXXXXXXXXXXXXXXXXXXXXXXXXXXXXXXXXXXXXXXXXXXXXXXXXXXXXXXXXXXXXXXXXXXXXXXXXXXXXXXXXXXXXXXXXXXXXXXXXXXXXXXXXXXXXXXXXXXXXXXXXXXXXXXXXXXXXXXXXXXXXXXXXXXXXXXXXXXXXXXXXXXXXXXXXXXXXXXXXXXXXXXXXXXXXXXXXXXXXXXXXXXXXXXXXXXXXXXXXXXXXXXXXXXXXXXXXXXXXXXXXXXXXXXXXXXXXXXXXX,0,0,0

105,2,2,0,298,0,0,0,300,300,0,XXXXXXXXXXXXXXXXXXXXGXXXXXXXXXXXXXXXXXXXXXXXXXXXXXXXXXXXXXXXXXXXXXXXXXXXXXXXXXXXXXXXXXXXXXXXXXXXXXXXXXXXXXXXXXXXXXXXXXXXXXXXXXXXXXXXXXXXXXXXXXXXXXXXXXXXXXXXXXXXXXXXXXXXXXXXXXXXXXXXXXXXXXXXXXXXXXXXXXXXGXXXXXXXXXXXXXXXXXXXXXXXXXXXXXXXXXXXXXXXXXXXXXXXXXXXXXXXXXXX,0,300,0
126,3,3,0,297,0,0,0,300,300,0,XXXXXXXXXXXXXXXXXXXXGXXXXXXXXXXXXXXXXXXXXXXXXXXXXXXXXXXXXXXXXXXXXXXXXXXXXXXXXXXXXXXXXXXXXXXXXXXXXXXXXXXXXXXXXXXXXXXXXXXXXXXXXXXXXXXXXXXXXXXXXXXXXXXXXXXXXXXXXXXXXXXXXXXXXXXXXXXXXXXXXXXXXXXXXXXXXXXXXXXXGXXXXXXXXXXXXXXXXXXXXXXXXXXXXXXXXXXXXXXXGXXXXXXXXXXXXXXXXXXX,0,300,0
147,5,5,0,295,0,0,0,300,300,0,XXXXXXXXXXXXXXXXXXXXGXXXXXXXXXXXXXXXXXXXXXXXXXXXXXXXXXXXXXXXXXXXXXXXXXXXXXXXXXXXXXXXXXXXXXXXXXXXXXXXXXXXXXXXXXXXXXXXXXXXXXXXXXXXXXXXXXXXXXXXXXXXXXXXXXXXXXXXXXXXGXXXXXXXXXXXXXXXXXXXGXXXXXXXXXXXXXXXXXXXGXXXXXXXXXXXXXXXXXXXXXXXXXXXXXXXXXXXXXXXGXXXXXXXXXXXXXXXXXXX,0,300,0
168,5,5,0,295,0,0,0,300,300,0,XXXXXXXXXXXXXXXXXXXXGXXXXXXXXXXXXXXXXXXXXXXXXXXXXXXXXXXXXXXXXXXXXXXXXXXXXXXXXXXXXXXXXXXXXXXXXXXXXXXXXXXXXXXXXXXXXXXXXXXXXXXXXXXXXXXXXXXXXXXXXXXXXXXXXXXXXXXXXXXXGXXXXXXXXXXXXXXXXXXXGXXXXXXXXXXXXXXXXXXXGXXXXXXXXXXXXXXXXXXXXXXXXXXXXXXXXXXXXXXXGXXXXXXXXXXXXXXXXXXX,0,300,0
189,6,6,0,294,0,0,0,300,300,0,XXXXXXXXXXXXXXXXXXXXGXXXXXXXXXXXXXXXXXXXXXXXXXXXXXXXXXXXXXXXXXXXXXXXXXXXXXXXXXXXGXXXXXXXXXXXXXXXXXXXXXXXXXXXXXXXXXXXXXXXXXXXXXXXXXXXXXXXXXXXXXXXXXXXXXXXXXXXXXXXGXXXXXXXXXXXXXXXXXXXGXXXXXXXXXXXXXXXXXXXGXXXXXXXXXXXXXXXXXXXXXXXXXXXXXXXXXXXXXXXGXXXXXXXXXXXXXXXXXXX,0,300,0

210,7,7,0,293,0,0,0,300,300,0,XXXXXXXXXXXXXXXXXXXXGXXXXXXXXXXXXXXXXXXXGXXXXXXXXXXXXXXXXXXXXXXXXXXXXXXXXXXXXXXXGXXXXXXXXXXXXXXXXXXXXXXXXXXXXXXXXXXXXXXXXXXXXXXXXXXXXXXXXXXXXXXXXXXXXXXXXXXXXXXXGXXXXXXXXXXXXXXXXXXXGXXXXXXXXXXXXXXXXXXXGXXXXXXXXXXXXXXXXXXXXXXXXXXXXXXXXXXXXXXXGXXXXXXXXXXXXXXXXXXX,0,300,0
231,8,8,0,292,0,0,0,300,300,0,XXXXXXXXXXXXXXXXXXXXGXXXXXXXXXXXXXXXXXXXGXXXXXXXXXXXXXXXXXXXXXXXXXXXXXXXXXXXXXXXGXXXXXXXXXXXXXXXXXXXXXXXXXXXXXXXXXXXXXXXGXXXXXXXXXXXXXXXXXXXXXXXXXXXXXXXXXXXXXXXGXXXXXXXXXXXXXXXXXXXGXXXXXXXXXXXXXXXXXXXGXXXXXXXXXXXXXXXXXXXXXXXXXXXXXXXXXXXXXXXGXXXXXXXXXXXXXXXXXXX,0,300,0
252,10,10,0,290,0,0,0,300,300,0,XXXXXXXXXXXXXXXXXXXXGXXXXXXXXXXXXXXXXXXXGXXXXXXXXXXXXXXXXXXXXXXXXXXXXXXXXXXXXXXXGXXXXXXXXXXXXXXXXXXXXXXXXXXXXXXXXXXXXXXXGXXXXXXXXXXXXXXXXXXXXXXXXXXXXXXXXXXXXXXXGXXXXXXXXXXXXXXXXXXXGAXXXXXXXXXXXXXXXXXXGXXXXXXXXXXXXXXXXXXXGXXXXXXXXXXXXXXXXXXXGXXXXXXXXXXXXXXXXXXX,0,300,0
273,10,10,0,290,0,0,0,300,300,0,XXXXXXXXXXXXXXXXXXXXGXXXXXXXXXXXXXXXXXXXGXXXXXXXXXXXXXXXXXXXXXXXXXXXXXXXXXXXXXXXGXXXXXXXXXXXXXXXXXXXXXXXXXXXXXXXXXXXXXXXGXXXXXXXXXXXXXXXXXXXXXXXXXXXXXXXXXXXXXXXGXXXXXXXXXXXXXXXXXXXGAXXXXXXXXXXXXXXXXXXGXXXXXXXXXXXXXXXXXXXGXXXXXXXXXXXXXXXXXXXGXXXXXXXXXXXXXXXXXXX,0,300,0
294,10,10,0,290,0,0,0,300,300,0,XXXXXXXXXXXXXXXXXXXXGXXXXXXXXXXXXXXXXXXXGXXXXXXXXXXXXXXXXXXXXXXXXXXXXXXXXXXXXXXXGXXXXXXXXXXXXXXXXXXXXXXXXXXXXXXXXXXXXXXXGXXXXXXXXXXXXXXXXXXXXXXXXXXXXXXXXXXXXXXXGXXXXXXXXXXXXXXXXXXXGAXXXXXXXXXXXXXXXXXXGXXXXXXXXXXXXXXXXXXXGXXXXXXXXXXXXXXXXXXXGXXXXXXXXXXXXXXXXXXX,0,300,0

315,10,8,2,279,11,0,0,300,300,0,XXXXXXXXXXXXXXXXXXXXGXXXXXXXXXXXXXXXXXXXGXXXXXXXXXXXXXXXXXXXXXXXXXXXXXXXXXXXXXXXGXXXXXXXXXXXXXXXXXXXXXXXXXXXXXXXXXXXXXXXGXXXXXXXXXXXXXXXXXXXXXXXXXXXXXXXXXXXXXXXGXXXXXXXXXXXXXXXXXXXGAXXXXXXXXXXXXXXXXXXGXXXXXXXXXXXXXXXXXXXGXXXXXXXXXXXXXXXXXXXGXXXXXXXXXXXXXXXXXXX,0,300,0
336,11,9,2,264,25,0,0,289,289,0,XXXXXXXXXXXXXXXXXXXXGXXXXXXXXXXXXXXXXXXXGXXXXXXXXXXXXXXXXXXXXXXXXXXXXXXXXXXXXXXXGXXXXXXXXXXXXXXXXXXXXXXXXXXXXXXXXXXXXXXXGXXXXXXXXXXXXXXXXXXXXXXXXXXXXXXXXXXXXXXXGXXXXXXXXXXXXXXXXXXXGAXXXXXXXXXXXXXXXXXXGAXXXXXXXXXXXXXXXXXXGXXXXXXXXXXXXXXXXXXXGXXXXXXXXXXXXXXXXXXX,0,300,0
357,10,8,2,248,42,0,0,274,274,0,XXXXXXXXXXXXXXXXXXXXGXXXXXXXXXXXXXXXXXXXGXXXXXXXXXXXXXXXXXXXXXXXXXXXXXXXXXXXXXXXGXXXXXXXXXXXXXXXXXXXXXXXXXXXXXXXXXXXXXXXGXXXXXXXXXXXXXXXXXXXXXXXXXXXXXXXXXXXXXXXGXXXXXXXXXXXXXXXXXXXGAXXXXXXXXXXXXXXXXXXGXXXXXXXXXXXXXXXXXXXGXXXXXXXXXXXXXXXXXXXGXXXXXXXXXXXXXXXXXXX,0,300,0
378,10,7,3,248,42,0,0,255,255,0,XXXXXXXXXXXXXXXXXXXXGXXXXXXXXXXXXXXXXXXXGXXXXXXXXXXXXXXXXXXXXXXXXXXXXXXXXXXXXXXXGXXXXXXXXXXXXXXXXXXXXXXXXXXXXXXXXXXXXXXXGXXXXXXXXXXXXXXXXXXXXXXXXXXXXXXXXXXXXXXXGXXXXXXXXXXXXXXXXXXXGAXXXXXXXXXXXXXXXXXXGXXXXXXXXXXXXXXXXXXXGXXXXXXXXXXXXXXXXXXXGXXXXXXXXXXXXXXXXXXX,0,300,0
399,11,7,4,245,44,0,0,240,240,0,XXXXXXXXXXXXXXXXXXXXGXXXXXXXXXXXXXXXXXXXGXXXXXXXXXXXXXXXXXXXXXXXXXXXXXXXXXXXXXXXGXXXXXXXXXXXXXXXXXXXXXXXXXXXXXXXXXXXXXXXGXXXXXXXXXXXXXXXXXXXGXXXXXXXXXXXXXXXXXXXGXXXXXXXXXXXXXXXXXXXGOXXXXXXXXXXXXXXXXXXGXXXXXXXXXXXXXXXXXXXGXXXXXXXXXXXXXXXXXXXGXXXXXXXXXXXXXXXXXXX,0,300,0

420,11,8,3,238,51,0,0,226,226,0,XXXXXXXXXXXXXXXXXXXXGXXXXXXXXXXXXXXXXXXXGXXXXXXXXXXXXXXXXXXXXXXXXXXXXXXXXXXXXXXXGXXXXXXXXXXXXXXXXXXXXXXXXXXXXXXXXXXXXXXXGXXXXXXXXXXXXXXXXXXXGXXXXXXXXXXXXXXXXXXXGXXXXXXXXXXXXXXXXXXXGAXXXXXXXXXXXXXXXXXXGXXXXXXXXXXXXXXXXXXXGXXXXXXXXXXXXXXXXXXXGXXXXXXXXXXXXXXXXXXX,0,300,0
441,12,9,3,237,51,0,0,208,208,0,GXXXXXXXXXXXXXXXXXXXGXXXXXXXXXXXXXXXXXXXGXXXXXXXXXXXXXXXXXXXXXXXXXXXXXXXXXXXXXXXGXXXXXXXXXXXXXXXXXXXXXXXXXXXXXXXXXXXXXXXGXXXXXXXXXXXXXXXXXXXGXXXXXXXXXXXXXXXXXXXGXXXXXXXXXXXXXXXXXXXGAXXXXXXXXXXXXXXXXXXGXXXXXXXXXXXXXXXXXXXGXXXXXXXXXXXXXXXXXXXGXXXXXXXXXXXXXXXXXXX,0,300,0
462,13,10,3,237,50,0,0,189,189,0,GXXXXXXXXXXXXXXXXXXXGAXXXXXXXXXXXXXXXXXXGXXXXXXXXXXXXXXXXXXXXXXXXXXXXXXXXXXXXXXXGXXXXXXXXXXXXXXXXXXXXXXXXXXXXXXXXXXXXXXXGXXXXXXXXXXXXXXXXXXXGXXXXXXXXXXXXXXXXXXXGXXXXXXXXXXXXXXXXXXXGAXXXXXXXXXXXXXXXXXXGXXXXXXXXXXXXXXXXXXXGXXXXXXXXXXXXXXXXXXXGXXXXXXXXXXXXXXXXXXX,0,300,0
483,14,10,4,235,51,0,0,176,176,0,GXXXXXXXXXXXXXXXXXXXGAXXXXXXXXXXXXXXXXXXGXXXXXXXXXXXXXXXXXXXXXXXXXXXXXXXXXXXXXXXGXXXXXXXXXXXXXXXXXXXGXXXXXXXXXXXXXXXXXXXGXXXXXXXXXXXXXXXXXXXGXXXXXXXXXXXXXXXXXXXGXXXXXXXXXXXXXXXXXXXGAXXXXXXXXXXXXXXXXXXGXXXXXXXXXXXXXXXXXXXGXXXXXXXXXXXXXXXXXXXGXXXXXXXXXXXXXXXXXXX,0,300,0
504,14,10,4,227,59,0,0,162,162,0,GXXXXXXXXXXXXXXXXXXXGAXXXXXXXXXXXXXXXXXXGXXXXXXXXXXXXXXXXXXXXXXXXXXXXXXXXXXXXXXXGXXXXXXXXXXXXXXXXXXXGXXXXXXXXXXXXXXXXXXXGXXXXXXXXXXXXXXXXXXXGXXXXXXXXXXXXXXXXXXXGXXXXXXXXXXXXXXXXXXXGAXXXXXXXXXXXXXXXXXXGXXXXXXXXXXXXXXXXXXXGXXXXXXXXXXXXXXXXXXXGXXXXXXXXXXXXXXXXXXX,0,300,0

525,14,9,5,226,60,0,0,145,145,0,GXXXXXXXXXXXXXXXXXXXGAXXXXXXXXXXXXXXXXXXGXXXXXXXXXXXXXXXXXXXXXXXXXXXXXXXXXXXXXXXGXXXXXXXXXXXXXXXXXXXGXXXXXXXXXXXXXXXXXXXGXXXXXXXXXXXXXXXXXXXGXXXXXXXXXXXXXXXXXXXGXXXXXXXXXXXXXXXXXXXGAXXXXXXXXXXXXXXXXXXGXXXXXXXXXXXXXXXXXXXGXXXXXXXXXXXXXXXXXXXGXXXXXXXXXXXXXXXXXXX,0,300,0
546,14,7,7,223,63,0,0,127,127,0,GXXXXXXXXXXXXXXXXXXXGAXXXXXXXXXXXXXXXXXXGXXXXXXXXXXXXXXXXXXXXXXXXXXXXXXXXXXXXXXXGXXXXXXXXXXXXXXXXXXXGXXXXXXXXXXXXXXXXXXXGXXXXXXXXXXXXXXXXXXXGXXXXXXXXXXXXXXXXXXXGXXXXXXXXXXXXXXXXXXXGAXXXXXXXXXXXXXXXXXXGXXXXXXXXXXXXXXXXXXXGXXXXXXXXXXXXXXXXXXXGXXXXXXXXXXXXXXXXXXX,0,300,0
567,16,4,12,217,67,0,0,115,112,3,GXXXXXXXXXXXXXXXXXXXGAOXXXXXXXXXXXXXXXXXGXXXXXXXXXXXXXXXXXXXXXXXXXXXXXXXXXXXXXXXGXXXXXXXXXXXXXXXXXXXGXXXXXXXXXXXXXXXXXXXGXXXXXXXXXXXXXXXXXXXGXXXXXXXXXXXXXXXXXXXGAXXXXXXXXXXXXXXXXXXGAXXXXXXXXXXXXXXXXXXGXXXXXXXXXXXXXXXXXXXGXXXXXXXXXXXXXXXXXXXGXXXXXXXXXXXXXXXXXXX,0,300,0
588,16,2,14,201,83,0,0,106,98,8,GXXXXXXXXXXXXXXXXXXXGOOXXXXXXXXXXXXXXXXXGXXXXXXXXXXXXXXXXXXXXXXXXXXXXXXXXXXXXXXXGXXXXXXXXXXXXXXXXXXXGXXXXXXXXXXXXXXXXXXXGXXXXXXXXXXXXXXXXXXXGXXXXXXXXXXXXXXXXXXXGAXXXXXXXXXXXXXXXXXXGAXXXXXXXXXXXXXXXXXXGXXXXXXXXXXXXXXXXXXXGXXXXXXXXXXXXXXXXXXXGXXXXXXXXXXXXXXXXXXX,0,300,0
609,14,2,12,197,89,0,0,101,85,16,GXXXXXXXXXXXXXXXXXXXGXXXXXXXXXXXXXXXXXXXGXXXXXXXXXXXXXXXXXXXXXXXXXXXXXXXXXXXXXXXGXXXXXXXXXXXXXXXXXXXGXXXXXXXXXXXXXXXXXXXGXXXXXXXXXXXXXXXXXXXGXXXXXXXXXXXXXXXXXXXGAXXXXXXXXXXXXXXXXXXGAXXXXXXXXXXXXXXXXXXGXXXXXXXXXXXXXXXXXXXGXXXXXXXXXXXXXXXXXXXGXXXXXXXXXXXXXXXXXXX,0,300,0

630,14,2,12,194,92,0,0,103,71,32,GXXXXXXXXXXXXXXXXXXXGXXXXXXXXXXXXXXXXXXXGXXXXXXXXXXXXXXXXXXXXXXXXXXXXXXXXXXXXXXXGXXXXXXXXXXXXXXXXXXXGXXXXXXXXXXXXXXXXXXXGXXXXXXXXXXXXXXXXXXXGXXXXXXXXXXXXXXXXXXXGAXXXXXXXXXXXXXXXXXXGAXXXXXXXXXXXXXXXXXXGXXXXXXXXXXXXXXXXXXXGXXXXXXXXXXXXXXXXXXXGXXXXXXXXXXXXXXXXXXX,0,300,0
651,14,2,12,200,86,0,0,98,59,39,GXXXXXXXXXXXXXXXXXXXGXXXXXXXXXXXXXXXXXXXGXXXXXXXXXXXXXXXXXXXXXXXXXXXXXXXXXXXXXXXGXXXXXXXXXXXXXXXXXXXGXXXXXXXXXXXXXXXXXXXGXXXXXXXXXXXXXXXXXXXGXXXXXXXXXXXXXXXXXXXGAXXXXXXXXXXXXXXXXXXGAXXXXXXXXXXXXXXXXXXGXXXXXXXXXXXXXXXXXXXGXXXXXXXXXXXXXXXXXXXGXXXXXXXXXXXXXXXXXXX,0,300,0
672,14,2,12,202,84,0,0,96,50,46,GXXXXXXXXXXXXXXXXXXXGXXXXXXXXXXXXXXXXXXXGXXXXXXXXXXXXXXXXXXXXXXXXXXXXXXXXXXXXXXXGXXXXXXXXXXXXXXXXXXXGXXXXXXXXXXXXXXXXXXXGXXXXXXXXXXXXXXXXXXXGXXXXXXXXXXXXXXXXXXXGAXXXXXXXXXXXXXXXXXXGAXXXXXXXXXXXXXXXXXXGXXXXXXXXXXXXXXXXXXXGXXXXXXXXXXXXXXXXXXXGXXXXXXXXXXXXXXXXXXX,0,300,0
693,14,2,12,206,80,0,0,92,42,50,GXXXXXXXXXXXXXXXXXXXGXXXXXXXXXXXXXXXXXXXGXXXXXXXXXXXXXXXXXXXXXXXXXXXXXXXXXXXXXXXGXXXXXXXXXXXXXXXXXXXGXXXXXXXXXXXXXXXXXXXGXXXXXXXXXXXXXXXXXXXGXXXXXXXXXXXXXXXXXXXGAXXXXXXXXXXXXXXXXXXGAXXXXXXXXXXXXXXXXXXGXXXXXXXXXXXXXXXXXXXGXXXXXXXXXXXXXXXXXXXGXXXXXXXXXXXXXXXXXXX,0,300,0
714,14,2,12,198,88,0,0,100,38,62,GXXXXXXXXXXXXXXXXXXXGXXXXXXXXXXXXXXXXXXXGXXXXXXXXXXXXXXXXXXXXXXXXXXXXXXXXXXXXXXXGXXXXXXXXXXXXXXXXXXXGXXXXXXXXXXXXXXXXXXXGXXXXXXXXXXXXXXXXXXXGXXXXXXXXXXXXXXXXXXXGAXXXXXXXXXXXXXXXXXXGAXXXXXXXXXXXXXXXXXXGXXXXXXXXXXXXXXXXXXXGXXXXXXXXXXXXXXXXXXXGXXXXXXXXXXXXXXXXXXX,0,300,0

735,15,3,12,185,100,0,0,112,37,75,GXXXXXXXXXXXXXXXXXXXGXXXXXXXXXXXXXXXXXXXGXXXXXXXXXXXXXXXXXXXGXXXXXXXXXXXXXXXXXXXGXXXXXXXXXXXXXXXXXXXGXXXXXXXXXXXXXXXXXXXGXXXXXXXXXXXXXXXXXXXGXXXXXXXXXXXXXXXXXXXGAXXXXXXXXXXXXXXXXXXGAXXXXXXXXXXXXXXXXXXGXXXXXXXXXXXXXXXXXXXGXXXXXXXXXXXXXXXXXXXGXXXXXXXXXXXXXXXXXXX,0,300,0
756,15,3,12,178,107,0,0,118,32,86,GXXXXXXXXXXXXXXXXXXXGXXXXXXXXXXXXXXXXXXXGXXXXXXXXXXXXXXXXXXXGXXXXXXXXXXXXXXXXXXXGXXXXXXXXXXXXXXXXXXXGXXXXXXXXXXXXXXXXXXXGXXXXXXXXXXXXXXXXXXXGXXXXXXXXXXXXXXXXXXXGAXXXXXXXXXXXXXXXXXXGAXXXXXXXXXXXXXXXXXXGXXXXXXXXXXXXXXXXXXXGXXXXXXXXXXXXXXXXXXXGXXXXXXXXXXXXXXXXXXX,0,300,0
777,15,3,12,164,121,0,0,131,29,102,GXXXXXXXXXXXXXXXXXXXGXXXXXXXXXXXXXXXXXXXGXXXXXXXXXXXXXXXXXXXGXXXXXXXXXXXXXXXXXXXGXXXXXXXXXXXXXXXXXXXGXXXXXXXXXXXXXXXXXXXGXXXXXXXXXXXXXXXXXXXGXXXXXXXXXXXXXXXXXXXGAXXXXXXXXXXXXXXXXXXGAXXXXXXXXXXXXXXXXXXGXXXXXXXXXXXXXXXXXXXGXXXXXXXXXXXXXXXXXXXGXXXXXXXXXXXXXXXXXXX,0,300,0
798,16,4,12,150,134,0,0,144,19,125,GXXXXXXXXXXXXXXXXXXXGXXXXXXXXXXXXXXXXXXXGXXXXXXXXXXXXXXXXXXXGXXXXXXXXXXXXXXXXXXXGXXXXXXXXXXXXXXXXXXXGXXXXXXXXXXXXXXXXXXXGXXXXXXXXXXXXXXXXXXXGXXXXXXXXXXXXXXXXXXXGAXXXXXXXXXXXXXXXXXXGAXXXXXXXXXXXXXXXXXXGXXXXXXXXXXXXXXXXXXXGAXXXXXXXXXXXXXXXXXXGXXXXXXXXXXXXXXXXXXX,0,300,0
819,17,5,12,138,145,0,0,155,14,141,GXXXXXXXXXXXXXXXXXXXGXXXXXXXXXXXXXXXXXXXGXXXXXXXXXXXXXXXXXXXGXXXXXXXXXXXXXXXXXXXGXXXXXXXXXXXXXXXXXXXGXXXXXXXXXXXXXXXXXXXGXXXXXXXXXXXXXXXXXXXGXXXXXXXXXXXXXXXXXXXGAXXXXXXXXXXXXXXXXXXGAXXXXXXXXXXXXXXXXXXGXXXXXXXXXXXXXXXXXXXGAAXXXXXXXXXXXXXXXXXGXXXXXXXXXXXXXXXXXXX,0,300,0

840,17,3,14,123,160,0,0,171,12,159,GXXXXXXXXXXXXXXXXXXXGXXXXXXXXXXXXXXXXXXXGXXXXXXXXXXXXXXXXXXXGXXXXXXXXXXXXXXXXXXXGXXXXXXXXXXXXXXXXXXXGXXXXXXXXXXXXXXXXXXXGXXXXXXXXXXXXXXXXXXXGXXXXXXXXXXXXXXXXXXXGAXXXXXXXXXXXXXXXXXXGAXXXXXXXXXXXXXXXXXXGXXXXXXXXXXXXXXXXXXXGOAXXXXXXXXXXXXXXXXXGXXXXXXXXXXXXXXXXXXX,0,300,0
861,15,2,13,113,172,0,0,183,12,171,GXXXXXXXXXXXXXXXXXXXGXXXXXXXXXXXXXXXXXXXGXXXXXXXXXXXXXXXXXXXGXXXXXXXXXXXXXXXXXXXGXXXXXXXXXXXXXXXXXXXGXXXXXXXXXXXXXXXXXXXGXXXXXXXXXXXXXXXXXXXGXXXXXXXXXXXXXXXXXXXGXXXXXXXXXXXXXXXXXXXGAXXXXXXXXXXXXXXXXXXGXXXXXXXXXXXXXXXXXXXGXAXXXXXXXXXXXXXXXXXGXXXXXXXXXXXXXXXXXXX,0,300,0
882,14,1,13,102,184,0,0,196,14,182,GXXXXXXXXXXXXXXXXXXXGXXXXXXXXXXXXXXXXXXXGXXXXXXXXXXXXXXXXXXXGXXXXXXXXXXXXXXXXXXXGXXXXXXXXXXXXXXXXXXXGXXXXXXXXXXXXXXXXXXXGXXXXXXXXXXXXXXXXXXXGXXXXXXXXXXXXXXXXXXXGXXXXXXXXXXXXXXXXXXXGAXXXXXXXXXXXXXXXXXXGXXXXXXXXXXXXXXXXXXXGXXXXXXXXXXXXXXXXXXXGXXXXXXXXXXXXXXXXXXX,0,300,0
903,13,0,13,86,201,0,0,212,16,196,GXXXXXXXXXXXXXXXXXXXGXXXXXXXXXXXXXXXXXXXGXXXXXXXXXXXXXXXXXXXGXXXXXXXXXXXXXXXXXXXGXXXXXXXXXXXXXXXXXXXGXXXXXXXXXXXXXXXXXXXGXXXXXXXXXXXXXXXXXXXGXXXXXXXXXXXXXXXXXXXGXXXXXXXXXXXXXXXXXXXGXXXXXXXXXXXXXXXXXXXGXXXXXXXXXXXXXXXXXXXGXXXXXXXXXXXXXXXXXXXGXXXXXXXXXXXXXXXXXXX,0,300,0
924,13,0,13,73,214,0,0,226,19,207,GXXXXXXXXXXXXXXXXXXXGXXXXXXXXXXXXXXXXXXXGXXXXXXXXXXXXXXXXXXXGXXXXXXXXXXXXXXXXXXXGXXXXXXXXXXXXXXXXXXXGXXXXXXXXXXXXXXXXXXXGXXXXXXXXXXXXXXXXXXXGXXXXXXXXXXXXXXXXXXXGXXXXXXXXXXXXXXXXXXXGXXXXXXXXXXXXXXXXXXXGXXXXXXXXXXXXXXXXXXXGXXXXXXXXXXXXXXXXXXXGXXXXXXXXXXXXXXXXXXX,0,300,0

945,14,1,13,58,228,0,0,239,17,222,GXXXXXXXXXXXXXXXXXXXGXXXXXXXXXXXXXXXXXXXGXXXXXXXXXXXXXXXXXXXGXXXXXXXXXXXXXXXXXXXGXXXXXXXXXXXXXXXXXXXGXXXXXXXXXXXXXXXXXXXGXXXXXXXXXXXXXXXXXXXGXXXXXXXXXXXXXXXXXXXGXXXXXXXXXXXXXXXXXXXGAXXXXXXXXXXXXXXXXXXGXXXXXXXXXXXXXXXXXXXGXXXXXXXXXXXXXXXXXXXGXXXXXXXXXXXXXXXXXXX,0,300,0
966,14,1,13,54,232,0,0,243,15,228,GXXXXXXXXXXXXXXXXXXXGXXXXXXXXXXXXXXXXXXXGXXXXXXXXXXXXXXXXXXXGXXXXXXXXXXXXXXXXXXXGXXXXXXXXXXXXXXXXXXXGXXXXXXXXXXXXXXXXXXXGXXXXXXXXXXXXXXXXXXXGXXXXXXXXXXXXXXXXXXXGXXXXXXXXXXXXXXXXXXXGAXXXXXXXXXXXXXXXXXXGXXXXXXXXXXXXXXXXXXXGXXXXXXXXXXXXXXXXXXXGXXXXXXXXXXXXXXXXXXX,0,300,0
987,14,1,13,56,230,0,0,242,16,226,GXXXXXXXXXXXXXXXXXXXGXXXXXXXXXXXXXXXXXXXGXXXXXXXXXXXXXXXXXXXGXXXXXXXXXXXXXXXXXXXGXXXXXXXXXXXXXXXXXXXGXXXXXXXXXXXXXXXXXXXGXXXXXXXXXXXXXXXXXXXGXXXXXXXXXXXXXXXXXXXGXXXXXXXXXXXXXXXXXXXGAXXXXXXXXXXXXXXXXXXGXXXXXXXXXXXXXXXXXXXGXXXXXXXXXXXXXXXXXXXGXXXXXXXXXXXXXXXXXXX,0,300,0
1008,14,1,13,53,233,0,0,245,18,227,GXXXXXXXXXXXXXXXXXXXGXXXXXXXXXXXXXXXXXXXGXXXXXXXXXXXXXXXXXXXGXXXXXXXXXXXXXXXXXXXGXXXXXXXXXXXXXXXXXXXGXXXXXXXXXXXXXXXXXXXGXXXXXXXXXXXXXXXXXXXGXXXXXXXXXXXXXXXXXXXGXXXXXXXXXXXXXXXXXXXGAXXXXXXXXXXXXXXXXXXGXXXXXXXXXXXXXXXXXXXGXXXXXXXXXXXXXXXXXXXGXXXXXXXXXXXXXXXXXXX,0,300,0
1029,14,1,13,55,231,0,0,243,18,225,GXXXXXXXXXXXXXXXXXXXGXXXXXXXXXXXXXXXXXXXGXXXXXXXXXXXXXXXXXXXGXXXXXXXXXXXXXXXXXXXGXXXXXXXXXXXXXXXXXXXGXXXXXXXXXXXXXXXXXXXGXXXXXXXXXXXXXXXXXXXGXXXXXXXXXXXXXXXXXXXGXXXXXXXXXXXXXXXXXXXGAXXXXXXXXXXXXXXXXXXGXXXXXXXXXXXXXXXXXXXGXXXXXXXXXXXXXXXXXXXGXXXXXXXXXXXXXXXXXXX,0,300,0

1050,14,1,13,61,225,0,0,237,20,217,GXXXXXXXXXXXXXXXXXXXGXXXXXXXXXXXXXXXXXXXGXXXXXXXXXXXXXXXXXXXGXXXXXXXXXXXXXXXXXXXGXXXXXXXXXXXXXXXXXXXGXXXXXXXXXXXXXXXXXXXGXXXXXXXXXXXXXXXXXXXGXXXXXXXXXXXXXXXXXXXGXXXXXXXXXXXXXXXXXXXGAXXXXXXXXXXXXXXXXXXGXXXXXXXXXXXXXXXXXXXGXXXXXXXXXXXXXXXXXXXGXXXXXXXXXXXXXXXXXXX,0,300,0
1071,14,1,13,59,227,0,0,242,26,216,GXXXXXXXXXXXXXXXXXXXGXXXXXXXXXXXXXXXXXXXGXXXXXXXXXXXXXXXXXXXGXXXXXXXXXXXXXXXXXXXGXXXXXXXXXXXXXXXXXXXGXXXXXXXXXXXXXXXXXXXGXXXXXXXXXXXXXXXXXXXGXXXXXXXXXXXXXXXXXXXGXXXXXXXXXXXXXXXXXXXGAXXXXXXXXXXXXXXXXXXGXXXXXXXXXXXXXXXXXXXGXXXXXXXXXXXXXXXXXXXGXXXXXXXXXXXXXXXXXXX,0,300,0
1092,14,0,14,62,224,0,0,239,33,206,GXXXXXXXXXXXXXXXXXXXGXXXXXXXXXXXXXXXXXXXGXXXXXXXXXXXXXXXXXXXGXXXXXXXXXXXXXXXXXXXGXXXXXXXXXXXXXXXXXXXGXXXXXXXXXXXXXXXXXXXGXXXXXXXXXXXXXXXXXXXGXXXXXXXXXXXXXXXXXXXGXXXXXXXXXXXXXXXXXXXGOXXXXXXXXXXXXXXXXXXGXXXXXXXXXXXXXXXXXXXGXXXXXXXXXXXXXXXXXXXGXXXXXXXXXXXXXXXXXXX,0,300,0
1113,13,0,13,67,220,0,0,235,34,201,GXXXXXXXXXXXXXXXXXXXGXXXXXXXXXXXXXXXXXXXGXXXXXXXXXXXXXXXXXXXGXXXXXXXXXXXXXXXXXXXGXXXXXXXXXXXXXXXXXXXGXXXXXXXXXXXXXXXXXXXGXXXXXXXXXXXXXXXXXXXGXXXXXXXXXXXXXXXXXXXGXXXXXXXXXXXXXXXXXXXGXXXXXXXXXXXXXXXXXXXGXXXXXXXXXXXXXXXXXXXGXXXXXXXXXXXXXXXXXXXGXXXXXXXXXXXXXXXXXXX,0,300,0
1134,13,0,13,68,219,0,0,233,32,201,GXXXXXXXXXXXXXXXXXXXGXXXXXXXXXXXXXXXXXXXGXXXXXXXXXXXXXXXXXXXGXXXXXXXXXXXXXXXXXXXGXXXXXXXXXXXXXXXXXXXGXXXXXXXXXXXXXXXXXXXGXXXXXXXXXXXXXXXXXXXGXXXXXXXXXXXXXXXXXXXGXXXXXXXXXXXXXXXXXXXGXXXXXXXXXXXXXXXXXXXGXXXXXXXXXXXXXXXXXXXGXXXXXXXXXXXXXXXXXXXGXXXXXXXXXXXXXXXXXXX,0,300,0

1155,13,0,13,70,217,0,0,229,33,196,GXXXXXXXXXXXXXXXXXXXGXXXXXXXXXXXXXXXXXXXGXXXXXXXXXXXXXXXXXXXGXXXXXXXXXXXXXXXXXXXGXXXXXXXXXXXXXXXXXXXGXXXXXXXXXXXXXXXXXXXGXXXXXXXXXXXXXXXXXXXGXXXXXXXXXXXXXXXXXXXGXXXXXXXXXXXXXXXXXXXGXXXXXXXXXXXXXXXXXXXGXXXXXXXXXXXXXXXXXXXGXXXXXXXXXXXXXXXXXXXGXXXXXXXXXXXXXXXXXXX,0,300,0
1176,13,0,13,69,218,0,0,231,38,193,GXXXXXXXXXXXXXXXXXXXGXXXXXXXXXXXXXXXXXXXGXXXXXXXXXXXXXXXXXXXGXXXXXXXXXXXXXXXXXXXGXXXXXXXXXXXXXXXXXXXGXXXXXXXXXXXXXXXXXXXGXXXXXXXXXXXXXXXXXXXGXXXXXXXXXXXXXXXXXXXGXXXXXXXXXXXXXXXXXXXGXXXXXXXXXXXXXXXXXXXGXXXXXXXXXXXXXXXXXXXGXXXXXXXXXXXXXXXXXXXGXXXXXXXXXXXXXXXXXXX,0,300,0
1197,13,0,13,79,208,0,0,222,45,177,GXXXXXXXXXXXXXXXXXXXGXXXXXXXXXXXXXXXXXXXGXXXXXXXXXXXXXXXXXXXGXXXXXXXXXXXXXXXXXXXGXXXXXXXXXXXXXXXXXXXGXXXXXXXXXXXXXXXXXXXGXXXXXXXXXXXXXXXXXXXGXXXXXXXXXXXXXXXXXXXGXXXXXXXXXXXXXXXXXXXGXXXXXXXXXXXXXXXXXXXGXXXXXXXXXXXXXXXXXXXGXXXXXXXXXXXXXXXXXXXGXXXXXXXXXXXXXXXXXXX,0,300,0
1218,13,0,13,87,200,0,0,213,44,169,GXXXXXXXXXXXXXXXXXXXGXXXXXXXXXXXXXXXXXXXGXXXXXXXXXXXXXXXXXXXGXXXXXXXXXXXXXXXXXXXGXXXXXXXXXXXXXXXXXXXGXXXXXXXXXXXXXXXXXXXGXXXXXXXXXXXXXXXXXXXGXXXXXXXXXXXXXXXXXXXGXXXXXXXXXXXXXXXXXXXGXXXXXXXXXXXXXXXXXXXGXXXXXXXXXXXXXXXXXXXGXXXXXXXXXXXXXXXXXXXGXXXXXXXXXXXXXXXXXXX,0,300,0
1239,13,0,13,95,192,0,0,203,47,156,GXXXXXXXXXXXXXXXXXXXGXXXXXXXXXXXXXXXXXXXGXXXXXXXXXXXXXXXXXXXGXXXXXXXXXXXXXXXXXXXGXXXXXXXXXXXXXXXXXXXGXXXXXXXXXXXXXXXXXXXGXXXXXXXXXXXXXXXXXXXGXXXXXXXXXXXXXXXXXXXGXXXXXXXXXXXXXXXXXXXGXXXXXXXXXXXXXXXXXXXGXXXXXXXXXXXXXXXXXXXGXXXXXXXXXXXXXXXXXXXGXXXXXXXXXXXXXXXXXXX,0,300,0

1260,13,0,13,97,190,0,0,201,47,154,GXXXXXXXXXXXXXXXXXXXGXXXXXXXXXXXXXXXXXXXGXXXXXXXXXXXXXXXXXXXGXXXXXXXXXXXXXXXXXXXGXXXXXXXXXXXXXXXXXXXGXXXXXXXXXXXXXXXXXXXGXXXXXXXXXXXXXXXXXXXGXXXXXXXXXXXXXXXXXXXGXXXXXXXXXXXXXXXXXXXGXXXXXXXXXXXXXXXXXXXGXXXXXXXXXXXXXXXXXXXGXXXXXXXXXXXXXXXXXXXGXXXXXXXXXXXXXXXXXXX,0,300,0
1281,13,0,13,100,187,0,0,199,50,149,GXXXXXXXXXXXXXXXXXXXGXXXXXXXXXXXXXXXXXXXGXXXXXXXXXXXXXXXXXXXGXXXXXXXXXXXXXXXXXXXGXXXXXXXXXXXXXXXXXXXGXXXXXXXXXXXXXXXXXXXGXXXXXXXXXXXXXXXXXXXGXXXXXXXXXXXXXXXXXXXGXXXXXXXXXXXXXXXXXXXGXXXXXXXXXXXXXXXXXXXGXXXXXXXXXXXXXXXXXXXGXXXXXXXXXXXXXXXXXXXGXXXXXXXXXXXXXXXXXXX,0,300,0
1302,13,0,13,106,181,0,0,193,45,148,GXXXXXXXXXXXXXXXXXXXGXXXXXXXXXXXXXXXXXXXGXXXXXXXXXXXXXXXXXXXGXXXXXXXXXXXXXXXXXXXGXXXXXXXXXXXXXXXXXXXGXXXXXXXXXXXXXXXXXXXGXXXXXXXXXXXXXXXXXXXGXXXXXXXXXXXXXXXXXXXGXXXXXXXXXXXXXXXXXXXGXXXXXXXXXXXXXXXXXXXGXXXXXXXXXXXXXXXXXXXGXXXXXXXXXXXXXXXXXXXGXXXXXXXXXXXXXXXXXXX,0,300,0
1323,13,0,13,108,179,0,0,191,43,148,GXXXXXXXXXXXXXXXXXXXGXXXXXXXXXXXXXXXXXXXGXXXXXXXXXXXXXXXXXXXGXXXXXXXXXXXXXXXXXXXGXXXXXXXXXXXXXXXXXXXGXXXXXXXXXXXXXXXXXXXGXXXXXXXXXXXXXXXXXXXGXXXXXXXXXXXXXXXXXXXGXXXXXXXXXXXXXXXXXXXGXXXXXXXXXXXXXXXXXXXGXXXXXXXXXXXXXXXXXXXGXXXXXXXXXXXXXXXXXXXGXXXXXXXXXXXXXXXXXXX,0,300,0
1344,13,0,13,110,177,0,0,188,40,148,GXXXXXXXXXXXXXXXXXXXGXXXXXXXXXXXXXXXXXXXGXXXXXXXXXXXXXXXXXXXGXXXXXXXXXXXXXXXXXXXGXXXXXXXXXXXXXXXXXXXGXXXXXXXXXXXXXXXXXXXGXXXXXXXXXXXXXXXXXXXGXXXXXXXXXXXXXXXXXXXGXXXXXXXXXXXXXXXXXXXGXXXXXXXXXXXXXXXXXXXGXXXXXXXXXXXXXXXXXXXGXXXXXXXXXXXXXXXXXXXGXXXXXXXXXXXXXXXXXXX,0,300,0

1365,13,0,13,109,178,0,0,188,45,143,GXXXXXXXXXXXXXXXXXXXGXXXXXXXXXXXXXXXXXXXGXXXXXXXXXXXXXXXXXXXGXXXXXXXXXXXXXXXXXXXGXXXXXXXXXXXXXXXXXXXGXXXXXXXXXXXXXXXXXXXGXXXXXXXXXXXXXXXXXXXGXXXXXXXXXXXXXXXXXXXGXXXXXXXXXXXXXXXXXXXGXXXXXXXXXXXXXXXXXXXGXXXXXXXXXXXXXXXXXXXGXXXXXXXXXXXXXXXXXXXGXXXXXXXXXXXXXXXXXXX,0,300,0
1386,13,0,13,110,177,0,0,189,51,138,GXXXXXXXXXXXXXXXXXXXGXXXXXXXXXXXXXXXXXXXGXXXXXXXXXXXXXXXXXXXGXXXXXXXXXXXXXXXXXXXGXXXXXXXXXXXXXXXXXXXGXXXXXXXXXXXXXXXXXXXGXXXXXXXXXXXXXXXXXXXGXXXXXXXXXXXXXXXXXXXGXXXXXXXXXXXXXXXXXXXGXXXXXXXXXXXXXXXXXXXGXXXXXXXXXXXXXXXXXXXGXXXXXXXXXXXXXXXXXXXGXXXXXXXXXXXXXXXXXXX,0,300,0
1407,13,0,13,107,180,0,0,191,53,138,GXXXXXXXXXXXXXXXXXXXGXXXXXXXXXXXXXXXXXXXGXXXXXXXXXXXXXXXXXXXGXXXXXXXXXXXXXXXXXXXGXXXXXXXXXXXXXXXXXXXGXXXXXXXXXXXXXXXXXXXGXXXXXXXXXXXXXXXXXXXGXXXXXXXXXXXXXXXXXXXGXXXXXXXXXXXXXXXXXXXGXXXXXXXXXXXXXXXXXXXGXXXXXXXXXXXXXXXXXXXGXXXXXXXXXXXXXXXXXXXGXXXXXXXXXXXXXXXXXXX,0,300,0
1428,13,0,13,118,169,0,0,178,40,138,GXXXXXXXXXXXXXXXXXXXGXXXXXXXXXXXXXXXXXXXGXXXXXXXXXXXXXXXXXXXGXXXXXXXXXXXXXXXXXXXGXXXXXXXXXXXXXXXXXXXGXXXXXXXXXXXXXXXXXXXGXXXXXXXXXXXXXXXXXXXGXXXXXXXXXXXXXXXXXXXGXXXXXXXXXXXXXXXXXXXGXXXXXXXXXXXXXXXXXXXGXXXXXXXXXXXXXXXXXXXGXXXXXXXXXXXXXXXXXXXGXXXXXXXXXXXXXXXXXXX,0,300,0
1449,13,0,13,120,167,0,0,179,38,141,GXXXXXXXXXXXXXXXXXXXGXXXXXXXXXXXXXXXXXXXGXXXXXXXXXXXXXXXXXXXGXXXXXXXXXXXXXXXXXXXGXXXXXXXXXXXXXXXXXXXGXXXXXXXXXXXXXXXXXXXGXXXXXXXXXXXXXXXXXXXGXXXXXXXXXXXXXXXXXXXGXXXXXXXXXXXXXXXXXXXGXXXXXXXXXXXXXXXXXXXGXXXXXXXXXXXXXXXXXXXGXXXXXXXXXXXXXXXXXXXGXXXXXXXXXXXXXXXXXXX,0,300,0

1470,13,0,13,121,166,0,0,177,36,141,GXXXXXXXXXXXXXXXXXXXGXXXXXXXXXXXXXXXXXXXGXXXXXXXXXXXXXXXXXXXGXXXXXXXXXXXXXXXXXXXGXXXXXXXXXXXXXXXXXXXGXXXXXXXXXXXXXXXXXXXGXXXXXXXXXXXXXXXXXXXGXXXXXXXXXXXXXXXXXXXGXXXXXXXXXXXXXXXXXXXGXXXXXXXXXXXXXXXXXXXGXXXXXXXXXXXXXXXXXXXGXXXXXXXXXXXXXXXXXXXGXXXXXXXXXXXXXXXXXXX,0,300,0
1491,14,1,13,114,172,0,0,184,31,153,GAXXXXXXXXXXXXXXXXXXGXXXXXXXXXXXXXXXXXXXGXXXXXXXXXXXXXXXXXXXGXXXXXXXXXXXXXXXXXXXGXXXXXXXXXXXXXXXXXXXGXXXXXXXXXXXXXXXXXXXGXXXXXXXXXXXXXXXXXXXGXXXXXXXXXXXXXXXXXXXGXXXXXXXXXXXXXXXXXXXGXXXXXXXXXXXXXXXXXXXGXXXXXXXXXXXXXXXXXXXGXXXXXXXXXXXXXXXXXXXGXXXXXXXXXXXXXXXXXXX,0,300,0
1512,14,1,13,112,174,0,0,186,27,159,GAXXXXXXXXXXXXXXXXXXGXXXXXXXXXXXXXXXXXXXGXXXXXXXXXXXXXXXXXXXGXXXXXXXXXXXXXXXXXXXGXXXXXXXXXXXXXXXXXXXGXXXXXXXXXXXXXXXXXXXGXXXXXXXXXXXXXXXXXXXGXXXXXXXXXXXXXXXXXXXGXXXXXXXXXXXXXXXXXXXGXXXXXXXXXXXXXXXXXXXGXXXXXXXXXXXXXXXXXXXGXXXXXXXXXXXXXXXXXXXGXXXXXXXXXXXXXXXXXXX,0,300,0
1533,14,1,13,111,175,0,0,187,29,158,GAXXXXXXXXXXXXXXXXXXGXXXXXXXXXXXXXXXXXXXGXXXXXXXXXXXXXXXXXXXGXXXXXXXXXXXXXXXXXXXGXXXXXXXXXXXXXXXXXXXGXXXXXXXXXXXXXXXXXXXGXXXXXXXXXXXXXXXXXXXGXXXXXXXXXXXXXXXXXXXGXXXXXXXXXXXXXXXXXXXGXXXXXXXXXXXXXXXXXXXGXXXXXXXXXXXXXXXXXXXGXXXXXXXXXXXXXXXXXXXGXXXXXXXXXXXXXXXXXXX,0,300,0
1554,14,1,13,106,180,0,0,191,31,160,GAXXXXXXXXXXXXXXXXXXGXXXXXXXXXXXXXXXXXXXGXXXXXXXXXXXXXXXXXXXGXXXXXXXXXXXXXXXXXXXGXXXXXXXXXXXXXXXXXXXGXXXXXXXXXXXXXXXXXXXGXXXXXXXXXXXXXXXXXXXGXXXXXXXXXXXXXXXXXXXGXXXXXXXXXXXXXXXXXXXGXXXXXXXXXXXXXXXXXXXGXXXXXXXXXXXXXXXXXXXGXXXXXXXXXXXXXXXXXXXGXXXXXXXXXXXXXXXXXXX,0,300,0

1575,14,1,13,99,187,0,0,198,32,166,GAXXXXXXXXXXXXXXXXXXGXXXXXXXXXXXXXXXXXXXGXXXXXXXXXXXXXXXXXXXGXXXXXXXXXXXXXXXXXXXGXXXXXXXXXXXXXXXXXXXGXXXXXXXXXXXXXXXXXXXGXXXXXXXXXXXXXXXXXXXGXXXXXXXXXXXXXXXXXXXGXXXXXXXXXXXXXXXXXXXGXXXXXXXXXXXXXXXXXXXGXXXXXXXXXXXXXXXXXXXGXXXXXXXXXXXXXXXXXXXGXXXXXXXXXXXXXXXXXXX,0,300,0
1596,14,1,13,89,197,0,0,209,39,170,GAXXXXXXXXXXXXXXXXXXGXXXXXXXXXXXXXXXXXXXGXXXXXXXXXXXXXXXXXXXGXXXXXXXXXXXXXXXXXXXGXXXXXXXXXXXXXXXXXXXGXXXXXXXXXXXXXXXXXXXGXXXXXXXXXXXXXXXXXXXGXXXXXXXXXXXXXXXXXXXGXXXXXXXXXXXXXXXXXXXGXXXXXXXXXXXXXXXXXXXGXXXXXXXXXXXXXXXXXXXGXXXXXXXXXXXXXXXXXXXGXXXXXXXXXXXXXXXXXXX,0,300,0
1617,14,1,13,86,200,0,0,212,39,173,GAXXXXXXXXXXXXXXXXXXGXXXXXXXXXXXXXXXXXXXGXXXXXXXXXXXXXXXXXXXGXXXXXXXXXXXXXXXXXXXGXXXXXXXXXXXXXXXXXXXGXXXXXXXXXXXXXXXXXXXGXXXXXXXXXXXXXXXXXXXGXXXXXXXXXXXXXXXXXXXGXXXXXXXXXXXXXXXXXXXGXXXXXXXXXXXXXXXXXXXGXXXXXXXXXXXXXXXXXXXGXXXXXXXXXXXXXXXXXXXGXXXXXXXXXXXXXXXXXXX,0,300,0
1638,14,1,13,95,191,0,0,203,34,169,GAXXXXXXXXXXXXXXXXXXGXXXXXXXXXXXXXXXXXXXGXXXXXXXXXXXXXXXXXXXGXXXXXXXXXXXXXXXXXXXGXXXXXXXXXXXXXXXXXXXGXXXXXXXXXXXXXXXXXXXGXXXXXXXXXXXXXXXXXXXGXXXXXXXXXXXXXXXXXXXGXXXXXXXXXXXXXXXXXXXGXXXXXXXXXXXXXXXXXXXGXXXXXXXXXXXXXXXXXXXGXXXXXXXXXXXXXXXXXXXGXXXXXXXXXXXXXXXXXXX,0,300,0
1659,14,1,13,94,192,0,0,203,36,167,GAXXXXXXXXXXXXXXXXXXGXXXXXXXXXXXXXXXXXXXGXXXXXXXXXXXXXXXXXXXGXXXXXXXXXXXXXXXXXXXGXXXXXXXXXXXXXXXXXXXGXXXXXXXXXXXXXXXXXXXGXXXXXXXXXXXXXXXXXXXGXXXXXXXXXXXXXXXXXXXGXXXXXXXXXXXXXXXXXXXGXXXXXXXXXXXXXXXXXXXGXXXXXXXXXXXXXXXXXXXGXXXXXXXXXXXXXXXXXXXGXXXXXXXXXXXXXXXXXXX,0,300,0

1680,14,1,13,93,193,0,0,204,35,169,GAXXXXXXXXXXXXXXXXXXGXXXXXXXXXXXXXXXXXXXGXXXXXXXXXXXXXXXXXXXGXXXXXXXXXXXXXXXXXXXGXXXXXXXXXXXXXXXXXXXGXXXXXXXXXXXXXXXXXXXGXXXXXXXXXXXXXXXXXXXGXXXXXXXXXXXXXXXXXXXGXXXXXXXXXXXXXXXXXXXGXXXXXXXXXXXXXXXXXXXGXXXXXXXXXXXXXXXXXXXGXXXXXXXXXXXXXXXXXXXGXXXXXXXXXXXXXXXXXXX,0,300,0
1701,14,1,13,91,195,0,0,205,36,169,GAXXXXXXXXXXXXXXXXXXGXXXXXXXXXXXXXXXXXXXGXXXXXXXXXXXXXXXXXXXGXXXXXXXXXXXXXXXXXXXGXXXXXXXXXXXXXXXXXXXGXXXXXXXXXXXXXXXXXXXGXXXXXXXXXXXXXXXXXXXGXXXXXXXXXXXXXXXXXXXGXXXXXXXXXXXXXXXXXXXGXXXXXXXXXXXXXXXXXXXGXXXXXXXXXXXXXXXXXXXGXXXXXXXXXXXXXXXXXXXGXXXXXXXXXXXXXXXXXXX,0,300,0
1722,14,1,13,90,196,0,0,208,32,176,GAXXXXXXXXXXXXXXXXXXGXXXXXXXXXXXXXXXXXXXGXXXXXXXXXXXXXXXXXXXGXXXXXXXXXXXXXXXXXXXGXXXXXXXXXXXXXXXXXXXGXXXXXXXXXXXXXXXXXXXGXXXXXXXXXXXXXXXXXXXGXXXXXXXXXXXXXXXXXXXGXXXXXXXXXXXXXXXXXXXGXXXXXXXXXXXXXXXXXXXGXXXXXXXXXXXXXXXXXXXGXXXXXXXXXXXXXXXXXXXGXXXXXXXXXXXXXXXXXXX,0,300,0
1743,14,1,13,86,200,0,0,211,37,174,GAXXXXXXXXXXXXXXXXXXGXXXXXXXXXXXXXXXXXXXGXXXXXXXXXXXXXXXXXXXGXXXXXXXXXXXXXXXXXXXGXXXXXXXXXXXXXXXXXXXGXXXXXXXXXXXXXXXXXXXGXXXXXXXXXXXXXXXXXXXGXXXXXXXXXXXXXXXXXXXGXXXXXXXXXXXXXXXXXXXGXXXXXXXXXXXXXXXXXXXGXXXXXXXXXXXXXXXXXXXGXXXXXXXXXXXXXXXXXXXGXXXXXXXXXXXXXXXXXXX,0,300,0
1764,14,1,13,92,194,0,0,206,34,172,GAXXXXXXXXXXXXXXXXXXGXXXXXXXXXXXXXXXXXXXGXXXXXXXXXXXXXXXXXXXGXXXXXXXXXXXXXXXXXXXGXXXXXXXXXXXXXXXXXXXGXXXXXXXXXXXXXXXXXXXGXXXXXXXXXXXXXXXXXXXGXXXXXXXXXXXXXXXXXXXGXXXXXXXXXXXXXXXXXXXGXXXXXXXXXXXXXXXXXXXGXXXXXXXXXXXXXXXXXXXGXXXXXXXXXXXXXXXXXXXGXXXXXXXXXXXXXXXXXXX,0,300,0

1785,14,1,13,87,199,0,0,211,40,171,GAXXXXXXXXXXXXXXXXXXGXXXXXXXXXXXXXXXXXXXGXXXXXXXXXXXXXXXXXXXGXXXXXXXXXXXXXXXXXXXGXXXXXXXXXXXXXXXXXXXGXXXXXXXXXXXXXXXXXXXGXXXXXXXXXXXXXXXXXXXGXXXXXXXXXXXXXXXXXXXGXXXXXXXXXXXXXXXXXXXGXXXXXXXXXXXXXXXXXXXGXXXXXXXXXXXXXXXXXXXGXXXXXXXXXXXXXXXXXXXGXXXXXXXXXXXXXXXXXXX,0,300,0
1806,14,1,13,87,199,0,0,210,37,173,GAXXXXXXXXXXXXXXXXXXGXXXXXXXXXXXXXXXXXXXGXXXXXXXXXXXXXXXXXXXGXXXXXXXXXXXXXXXXXXXGXXXXXXXXXXXXXXXXXXXGXXXXXXXXXXXXXXXXXXXGXXXXXXXXXXXXXXXXXXXGXXXXXXXXXXXXXXXXXXXGXXXXXXXXXXXXXXXXXXXGXXXXXXXXXXXXXXXXXXXGXXXXXXXXXXXXXXXXXXXGXXXXXXXXXXXXXXXXXXXGXXXXXXXXXXXXXXXXXXX,0,300,0
1827,14,1,13,91,195,0,0,207,34,173,GAXXXXXXXXXXXXXXXXXXGXXXXXXXXXXXXXXXXXXXGXXXXXXXXXXXXXXXXXXXGXXXXXXXXXXXXXXXXXXXGXXXXXXXXXXXXXXXXXXXGXXXXXXXXXXXXXXXXXXXGXXXXXXXXXXXXXXXXXXXGXXXXXXXXXXXXXXXXXXXGXXXXXXXXXXXXXXXXXXXGXXXXXXXXXXXXXXXXXXXGXXXXXXXXXXXXXXXXXXXGXXXXXXXXXXXXXXXXXXXGXXXXXXXXXXXXXXXXXXX,0,300,0
1848,15,2,13,92,193,0,0,204,34,170,GAXXXXXXXXXXXXXXXXXXGXXXXXXXXXXXXXXXXXXXGXXXXXXXXXXXXXXXXXXXGXXXXXXXXXXXXXXXXXXXGXXXXXXXXXXXXXXXXXXXGXXXXXXXXXXXXXXXXXXXGAXXXXXXXXXXXXXXXXXXGXXXXXXXXXXXXXXXXXXXGXXXXXXXXXXXXXXXXXXXGXXXXXXXXXXXXXXXXXXXGXXXXXXXXXXXXXXXXXXXGXXXXXXXXXXXXXXXXXXXGXXXXXXXXXXXXXXXXXXX,0,300,0
1869,15,1,14,100,185,0,0,197,28,169,GOXXXXXXXXXXXXXXXXXXGXXXXXXXXXXXXXXXXXXXGXXXXXXXXXXXXXXXXXXXGXXXXXXXXXXXXXXXXXXXGXXXXXXXXXXXXXXXXXXXGXXXXXXXXXXXXXXXXXXXGAXXXXXXXXXXXXXXXXXXGXXXXXXXXXXXXXXXXXXXGXXXXXXXXXXXXXXXXXXXGXXXXXXXXXXXXXXXXXXXGXXXXXXXXXXXXXXXXXXXGXXXXXXXXXXXXXXXXXXXGXXXXXXXXXXXXXXXXXXX,0,300,0

1890,15,1,14,93,192,0,0,204,36,168,GOXXXXXXXXXXXXXXXXXXGXXXXXXXXXXXXXXXXXXXGXXXXXXXXXXXXXXXXXXXGXXXXXXXXXXXXXXXXXXXGXXXXXXXXXXXXXXXXXXXGXXXXXXXXXXXXXXXXXXXGAXXXXXXXXXXXXXXXXXXGXXXXXXXXXXXXXXXXXXXGXXXXXXXXXXXXXXXXXXXGXXXXXXXXXXXXXXXXXXXGXXXXXXXXXXXXXXXXXXXGXXXXXXXXXXXXXXXXXXXGXXXXXXXXXXXXXXXXXXX,0,300,0
1911,14,1,13,91,195,0,0,207,39,168,GXXXXXXXXXXXXXXXXXXXGXXXXXXXXXXXXXXXXXXXGXXXXXXXXXXXXXXXXXXXGXXXXXXXXXXXXXXXXXXXGXXXXXXXXXXXXXXXXXXXGXXXXXXXXXXXXXXXXXXXGAXXXXXXXXXXXXXXXXXXGXXXXXXXXXXXXXXXXXXXGXXXXXXXXXXXXXXXXXXXGXXXXXXXXXXXXXXXXXXXGXXXXXXXXXXXXXXXXXXXGXXXXXXXXXXXXXXXXXXXGXXXXXXXXXXXXXXXXXXX,0,300,0
1932,14,1,13,93,193,0,0,205,49,156,GXXXXXXXXXXXXXXXXXXXGXXXXXXXXXXXXXXXXXXXGXXXXXXXXXXXXXXXXXXXGXXXXXXXXXXXXXXXXXXXGXXXXXXXXXXXXXXXXXXXGXXXXXXXXXXXXXXXXXXXGAXXXXXXXXXXXXXXXXXXGXXXXXXXXXXXXXXXXXXXGXXXXXXXXXXXXXXXXXXXGXXXXXXXXXXXXXXXXXXXGXXXXXXXXXXXXXXXXXXXGXXXXXXXXXXXXXXXXXXXGXXXXXXXXXXXXXXXXXXX,0,300,0
1953,14,1,13,98,188,0,0,201,38,163,GXXXXXXXXXXXXXXXXXXXGXXXXXXXXXXXXXXXXXXXGXXXXXXXXXXXXXXXXXXXGXXXXXXXXXXXXXXXXXXXGXXXXXXXXXXXXXXXXXXXGXXXXXXXXXXXXXXXXXXXGAXXXXXXXXXXXXXXXXXXGXXXXXXXXXXXXXXXXXXXGXXXXXXXXXXXXXXXXXXXGXXXXXXXXXXXXXXXXXXXGXXXXXXXXXXXXXXXXXXXGXXXXXXXXXXXXXXXXXXXGXXXXXXXXXXXXXXXXXXX,0,300,0
1974,14,1,13,95,191,0,0,204,41,163,GXXXXXXXXXXXXXXXXXXXGXXXXXXXXXXXXXXXXXXXGXXXXXXXXXXXXXXXXXXXGXXXXXXXXXXXXXXXXXXXGXXXXXXXXXXXXXXXXXXXGXXXXXXXXXXXXXXXXXXXGAXXXXXXXXXXXXXXXXXXGXXXXXXXXXXXXXXXXXXXGXXXXXXXXXXXXXXXXXXXGXXXXXXXXXXXXXXXXXXXGXXXXXXXXXXXXXXXXXXXGXXXXXXXXXXXXXXXXXXXGXXXXXXXXXXXXXXXXXXX,0,300,0

1995,14,1,13,97,189,0,0,202,44,158,GXXXXXXXXXXXXXXXXXXXGXXXXXXXXXXXXXXXXXXXGXXXXXXXXXXXXXXXXXXXGXXXXXXXXXXXXXXXXXXXGXXXXXXXXXXXXXXXXXXXGXXXXXXXXXXXXXXXXXXXGAXXXXXXXXXXXXXXXXXXGXXXXXXXXXXXXXXXXXXXGXXXXXXXXXXXXXXXXXXXGXXXXXXXXXXXXXXXXXXXGXXXXXXXXXXXXXXXXXXXGXXXXXXXXXXXXXXXXXXXGXXXXXXXXXXXXXXXXXXX,0,300,0
2016,14,1,13,102,184,0,0,197,42,155,GXXXXXXXXXXXXXXXXXXXGXXXXXXXXXXXXXXXXXXXGXXXXXXXXXXXXXXXXXXXGXXXXXXXXXXXXXXXXXXXGXXXXXXXXXXXXXXXXXXXGXXXXXXXXXXXXXXXXXXXGAXXXXXXXXXXXXXXXXXXGXXXXXXXXXXXXXXXXXXXGXXXXXXXXXXXXXXXXXXXGXXXXXXXXXXXXXXXXXXXGXXXXXXXXXXXXXXXXXXXGXXXXXXXXXXXXXXXXXXXGXXXXXXXXXXXXXXXXXXX,0,300,0
2037,14,0,14,100,186,0,0,199,42,157,GXXXXXXXXXXXXXXXXXXXGXXXXXXXXXXXXXXXXXXXGXXXXXXXXXXXXXXXXXXXGXXXXXXXXXXXXXXXXXXXGXXXXXXXXXXXXXXXXXXXGXXXXXXXXXXXXXXXXXXXGOXXXXXXXXXXXXXXXXXXGXXXXXXXXXXXXXXXXXXXGXXXXXXXXXXXXXXXXXXXGXXXXXXXXXXXXXXXXXXXGXXXXXXXXXXXXXXXXXXXGXXXXXXXXXXXXXXXXXXXGXXXXXXXXXXXXXXXXXXX,0,300,0
2058,13,0,13,95,192,0,0,204,42,162,GXXXXXXXXXXXXXXXXXXXGXXXXXXXXXXXXXXXXXXXGXXXXXXXXXXXXXXXXXXXGXXXXXXXXXXXXXXXXXXXGXXXXXXXXXXXXXXXXXXXGXXXXXXXXXXXXXXXXXXXGXXXXXXXXXXXXXXXXXXXGXXXXXXXXXXXXXXXXXXXGXXXXXXXXXXXXXXXXXXXGXXXXXXXXXXXXXXXXXXXGXXXXXXXXXXXXXXXXXXXGXXXXXXXXXXXXXXXXXXXGXXXXXXXXXXXXXXXXXXX,0,300,0
2079,13,0,13,93,194,0,0,205,40,165,GXXXXXXXXXXXXXXXXXXXGXXXXXXXXXXXXXXXXXXXGXXXXXXXXXXXXXXXXXXXGXXXXXXXXXXXXXXXXXXXGXXXXXXXXXXXXXXXXXXXGXXXXXXXXXXXXXXXXXXXGXXXXXXXXXXXXXXXXXXXGXXXXXXXXXXXXXXXXXXXGXXXXXXXXXXXXXXXXXXXGXXXXXXXXXXXXXXXXXXXGXXXXXXXXXXXXXXXXXXXGXXXXXXXXXXXXXXXXXXXGXXXXXXXXXXXXXXXXXXX,0,300,0

2100,13,0,13,88,199,0,0,211,43,168,GXXXXXXXXXXXXXXXXXXXGXXXXXXXXXXXXXXXXXXXGXXXXXXXXXXXXXXXXXXXGXXXXXXXXXXXXXXXXXXXGXXXXXXXXXXXXXXXXXXXGXXXXXXXXXXXXXXXXXXXGXXXXXXXXXXXXXXXXXXXGXXXXXXXXXXXXXXXXXXXGXXXXXXXXXXXXXXXXXXXGXXXXXXXXXXXXXXXXXXXGXXXXXXXXXXXXXXXXXXXGXXXXXXXXXXXXXXXXXXXGXXXXXXXXXXXXXXXXXXX,0,300,0
2121,13,0,13,91,196,0,0,209,44,165,GXXXXXXXXXXXXXXXXXXXGXXXXXXXXXXXXXXXXXXXGXXXXXXXXXXXXXXXXXXXGXXXXXXXXXXXXXXXXXXXGXXXXXXXXXXXXXXXXXXXGXXXXXXXXXXXXXXXXXXXGXXXXXXXXXXXXXXXXXXXGXXXXXXXXXXXXXXXXXXXGXXXXXXXXXXXXXXXXXXXGXXXXXXXXXXXXXXXXXXXGXXXXXXXXXXXXXXXXXXXGXXXXXXXXXXXXXXXXXXXGXXXXXXXXXXXXXXXXXXX,0,300,0
2142,13,0,13,88,199,0,0,211,47,164,GXXXXXXXXXXXXXXXXXXXGXXXXXXXXXXXXXXXXXXXGXXXXXXXXXXXXXXXXXXXGXXXXXXXXXXXXXXXXXXXGXXXXXXXXXXXXXXXXXXXGXXXXXXXXXXXXXXXXXXXGXXXXXXXXXXXXXXXXXXXGXXXXXXXXXXXXXXXXXXXGXXXXXXXXXXXXXXXXXXXGXXXXXXXXXXXXXXXXXXXGXXXXXXXXXXXXXXXXXXXGXXXXXXXXXXXXXXXXXXXGXXXXXXXXXXXXXXXXXXX,0,300,0
2163,13,0,13,85,202,0,0,213,44,169,GXXXXXXXXXXXXXXXXXXXGXXXXXXXXXXXXXXXXXXXGXXXXXXXXXXXXXXXXXXXGXXXXXXXXXXXXXXXXXXXGXXXXXXXXXXXXXXXXXXXGXXXXXXXXXXXXXXXXXXXGXXXXXXXXXXXXXXXXXXXGXXXXXXXXXXXXXXXXXXXGXXXXXXXXXXXXXXXXXXXGXXXXXXXXXXXXXXXXXXXGXXXXXXXXXXXXXXXXXXXGXXXXXXXXXXXXXXXXXXXGXXXXXXXXXXXXXXXXXXX,0,300,0
2184,13,0,13,87,200,0,0,212,49,163,GXXXXXXXXXXXXXXXXXXXGXXXXXXXXXXXXXXXXXXXGXXXXXXXXXXXXXXXXXXXGXXXXXXXXXXXXXXXXXXXGXXXXXXXXXXXXXXXXXXXGXXXXXXXXXXXXXXXXXXXGXXXXXXXXXXXXXXXXXXXGXXXXXXXXXXXXXXXXXXXGXXXXXXXXXXXXXXXXXXXGXXXXXXXXXXXXXXXXXXXGXXXXXXXXXXXXXXXXXXXGXXXXXXXXXXXXXXXXXXXGXXXXXXXXXXXXXXXXXXX,0,300,0

2205,13,0,13,91,196,0,0,206,47,159,GXXXXXXXXXXXXXXXXXXXGXXXXXXXXXXXXXXXXXXXGXXXXXXXXXXXXXXXXXXXGXXXXXXXXXXXXXXXXXXXGXXXXXXXXXXXXXXXXXXXGXXXXXXXXXXXXXXXXXXXGXXXXXXXXXXXXXXXXXXXGXXXXXXXXXXXXXXXXXXXGXXXXXXXXXXXXXXXXXXXGXXXXXXXXXXXXXXXXXXXGXXXXXXXXXXXXXXXXXXXGXXXXXXXXXXXXXXXXXXXGXXXXXXXXXXXXXXXXXXX,0,300,0
2226,14,1,13,104,182,0,0,194,45,149,GXXXXXXXXXXXXXXXXXXXGXXXXXXXXXXXXXXXXXXXGXXXXXXXXXXXXXXXXXXXGXXXXXXXXXXXXXXXXXXXGXXXXXXXXXXXXXXXXXXXGXXXXXXXXXXXXXXXXXXXGAXXXXXXXXXXXXXXXXXXGXXXXXXXXXXXXXXXXXXXGXXXXXXXXXXXXXXXXXXXGXXXXXXXXXXXXXXXXXXXGXXXXXXXXXXXXXXXXXXXGXXXXXXXXXXXXXXXXXXXGXXXXXXXXXXXXXXXXXXX,0,300,0
2247,14,1,13,106,180,0,0,192,42,150,GXXXXXXXXXXXXXXXXXXXGXXXXXXXXXXXXXXXXXXXGXXXXXXXXXXXXXXXXXXXGXXXXXXXXXXXXXXXXXXXGXXXXXXXXXXXXXXXXXXXGXXXXXXXXXXXXXXXXXXXGAXXXXXXXXXXXXXXXXXXGXXXXXXXXXXXXXXXXXXXGXXXXXXXXXXXXXXXXXXXGXXXXXXXXXXXXXXXXXXXGXXXXXXXXXXXXXXXXXXXGXXXXXXXXXXXXXXXXXXXGXXXXXXXXXXXXXXXXXXX,0,300,0
2268,14,1,13,112,174,0,0,185,45,140,GXXXXXXXXXXXXXXXXXXXGXXXXXXXXXXXXXXXXXXXGXXXXXXXXXXXXXXXXXXXGXXXXXXXXXXXXXXXXXXXGXXXXXXXXXXXXXXXXXXXGXXXXXXXXXXXXXXXXXXXGAXXXXXXXXXXXXXXXXXXGXXXXXXXXXXXXXXXXXXXGXXXXXXXXXXXXXXXXXXXGXXXXXXXXXXXXXXXXXXXGXXXXXXXXXXXXXXXXXXXGXXXXXXXXXXXXXXXXXXXGXXXXXXXXXXXXXXXXXXX,0,300,0
2289,14,1,13,117,169,0,0,180,41,139,GXXXXXXXXXXXXXXXXXXXGXXXXXXXXXXXXXXXXXXXGXXXXXXXXXXXXXXXXXXXGXXXXXXXXXXXXXXXXXXXGXXXXXXXXXXXXXXXXXXXGXXXXXXXXXXXXXXXXXXXGAXXXXXXXXXXXXXXXXXXGXXXXXXXXXXXXXXXXXXXGXXXXXXXXXXXXXXXXXXXGXXXXXXXXXXXXXXXXXXXGXXXXXXXXXXXXXXXXXXXGXXXXXXXXXXXXXXXXXXXGXXXXXXXXXXXXXXXXXXX,0,300,0

2310,14,1,13,109,177,0,0,190,38,152,GXXXXXXXXXXXXXXXXXXXGXXXXXXXXXXXXXXXXXXXGXXXXXXXXXXXXXXXXXXXGXXXXXXXXXXXXXXXXXXXGXXXXXXXXXXXXXXXXXXXGXXXXXXXXXXXXXXXXXXXGAXXXXXXXXXXXXXXXXXXGXXXXXXXXXXXXXXXXXXXGXXXXXXXXXXXXXXXXXXXGXXXXXXXXXXXXXXXXXXXGXXXXXXXXXXXXXXXXXXXGXXXXXXXXXXXXXXXXXXXGXXXXXXXXXXXXXXXXXXX,0,300,0
2331,14,1,13,106,180,0,0,191,40,151,GXXXXXXXXXXXXXXXXXXXGXXXXXXXXXXXXXXXXXXXGXXXXXXXXXXXXXXXXXXXGXXXXXXXXXXXXXXXXXXXGXXXXXXXXXXXXXXXXXXXGXXXXXXXXXXXXXXXXXXXGAXXXXXXXXXXXXXXXXXXGXXXXXXXXXXXXXXXXXXXGXXXXXXXXXXXXXXXXXXXGXXXXXXXXXXXXXXXXXXXGXXXXXXXXXXXXXXXXXXXGXXXXXXXXXXXXXXXXXXXGXXXXXXXXXXXXXXXXXXX,0,300,0
2352,14,1,13,105,181,0,0,192,41,151,GXXXXXXXXXXXXXXXXXXXGXXXXXXXXXXXXXXXXXXXGXXXXXXXXXXXXXXXXXXXGXXXXXXXXXXXXXXXXXXXGXXXXXXXXXXXXXXXXXXXGXXXXXXXXXXXXXXXXXXXGAXXXXXXXXXXXXXXXXXXGXXXXXXXXXXXXXXXXXXXGXXXXXXXXXXXXXXXXXXXGXXXXXXXXXXXXXXXXXXXGXXXXXXXXXXXXXXXXXXXGXXXXXXXXXXXXXXXXXXXGXXXXXXXXXXXXXXXXXXX,0,300,0
2373,14,1,13,104,182,0,0,193,40,153,GXXXXXXXXXXXXXXXXXXXGXXXXXXXXXXXXXXXXXXXGXXXXXXXXXXXXXXXXXXXGXXXXXXXXXXXXXXXXXXXGXXXXXXXXXXXXXXXXXXXGXXXXXXXXXXXXXXXXXXXGAXXXXXXXXXXXXXXXXXXGXXXXXXXXXXXXXXXXXXXGXXXXXXXXXXXXXXXXXXXGXXXXXXXXXXXXXXXXXXXGXXXXXXXXXXXXXXXXXXXGXXXXXXXXXXXXXXXXXXXGXXXXXXXXXXXXXXXXXXX,0,300,0
2394,14,1,13,103,183,0,0,195,42,153,GXXXXXXXXXXXXXXXXXXXGXXXXXXXXXXXXXXXXXXXGXXXXXXXXXXXXXXXXXXXGXXXXXXXXXXXXXXXXXXXGXXXXXXXXXXXXXXXXXXXGXXXXXXXXXXXXXXXXXXXGAXXXXXXXXXXXXXXXXXXGXXXXXXXXXXXXXXXXXXXGXXXXXXXXXXXXXXXXXXXGXXXXXXXXXXXXXXXXXXXGXXXXXXXXXXXXXXXXXXXGXXXXXXXXXXXXXXXXXXXGXXXXXXXXXXXXXXXXXXX,0,300,0

2415,13,0,13,101,186,0,0,198,44,154,GXXXXXXXXXXXXXXXXXXXGXXXXXXXXXXXXXXXXXXXGXXXXXXXXXXXXXXXXXXXGXXXXXXXXXXXXXXXXXXXGXXXXXXXXXXXXXXXXXXXGXXXXXXXXXXXXXXXXXXXGXXXXXXXXXXXXXXXXXXXGXXXXXXXXXXXXXXXXXXXGXXXXXXXXXXXXXXXXXXXGXXXXXXXXXXXXXXXXXXXGXXXXXXXXXXXXXXXXXXXGXXXXXXXXXXXXXXXXXXXGXXXXXXXXXXXXXXXXXXX,0,300,0
2436,13,0,13,99,188,0,0,200,40,160,GXXXXXXXXXXXXXXXXXXXGXXXXXXXXXXXXXXXXXXXGXXXXXXXXXXXXXXXXXXXGXXXXXXXXXXXXXXXXXXXGXXXXXXXXXXXXXXXXXXXGXXXXXXXXXXXXXXXXXXXGXXXXXXXXXXXXXXXXXXXGXXXXXXXXXXXXXXXXXXXGXXXXXXXXXXXXXXXXXXXGXXXXXXXXXXXXXXXXXXXGXXXXXXXXXXXXXXXXXXXGXXXXXXXXXXXXXXXXXXXGXXXXXXXXXXXXXXXXXXX,0,300,0
2457,14,1,13,100,186,0,0,198,47,151,GXXXXXXXXXXXXXXXXXXXGXXXXXXXXXXXXXXXXXXXGXXXXXXXXXXXXXXXXXXXGXXXXXXXXXXXXXXXXXXXGAXXXXXXXXXXXXXXXXXXGXXXXXXXXXXXXXXXXXXXGXXXXXXXXXXXXXXXXXXXGXXXXXXXXXXXXXXXXXXXGXXXXXXXXXXXXXXXXXXXGXXXXXXXXXXXXXXXXXXXGXXXXXXXXXXXXXXXXXXXGXXXXXXXXXXXXXXXXXXXGXXXXXXXXXXXXXXXXXXX,0,300,0
2478,14,0,14,102,184,0,0,196,50,146,GXXXXXXXXXXXXXXXXXXXGXXXXXXXXXXXXXXXXXXXGXXXXXXXXXXXXXXXXXXXGXXXXXXXXXXXXXXXXXXXGOXXXXXXXXXXXXXXXXXXGXXXXXXXXXXXXXXXXXXXGXXXXXXXXXXXXXXXXXXXGXXXXXXXXXXXXXXXXXXXGXXXXXXXXXXXXXXXXXXXGXXXXXXXXXXXXXXXXXXXGXXXXXXXXXXXXXXXXXXXGXXXXXXXXXXXXXXXXXXXGXXXXXXXXXXXXXXXXXXX,0,300,0
2499,14,0,14,106,180,0,0,191,41,150,GXXXXXXXXXXXXXXXXXXXGXXXXXXXXXXXXXXXXXXXGXXXXXXXXXXXXXXXXXXXGXXXXXXXXXXXXXXXXXXXGOXXXXXXXXXXXXXXXXXXGXXXXXXXXXXXXXXXXXXXGXXXXXXXXXXXXXXXXXXXGXXXXXXXXXXXXXXXXXXXGXXXXXXXXXXXXXXXXXXXGXXXXXXXXXXXXXXXXXXXGXXXXXXXXXXXXXXXXXXXGXXXXXXXXXXXXXXXXXXXGXXXXXXXXXXXXXXXXXXX,0,300,0

2520,13,0,13,105,182,0,0,194,37,157,GXXXXXXXXXXXXXXXXXXXGXXXXXXXXXXXXXXXXXXXGXXXXXXXXXXXXXXXXXXXGXXXXXXXXXXXXXXXXXXXGXXXXXXXXXXXXXXXXXXXGXXXXXXXXXXXXXXXXXXXGXXXXXXXXXXXXXXXXXXXGXXXXXXXXXXXXXXXXXXXGXXXXXXXXXXXXXXXXXXXGXXXXXXXXXXXXXXXXXXXGXXXXXXXXXXXXXXXXXXXGXXXXXXXXXXXXXXXXXXXGXXXXXXXXXXXXXXXXXXX,0,300,0
2541,13,0,13,93,194,0,0,205,40,165,GXXXXXXXXXXXXXXXXXXXGXXXXXXXXXXXXXXXXXXXGXXXXXXXXXXXXXXXXXXXGXXXXXXXXXXXXXXXXXXXGXXXXXXXXXXXXXXXXXXXGXXXXXXXXXXXXXXXXXXXGXXXXXXXXXXXXXXXXXXXGXXXXXXXXXXXXXXXXXXXGXXXXXXXXXXXXXXXXXXXGXXXXXXXXXXXXXXXXXXXGXXXXXXXXXXXXXXXXXXXGXXXXXXXXXXXXXXXXXXXGXXXXXXXXXXXXXXXXXXX,0,300,0
2562,13,0,13,92,195,0,0,207,39,168,GXXXXXXXXXXXXXXXXXXXGXXXXXXXXXXXXXXXXXXXGXXXXXXXXXXXXXXXXXXXGXXXXXXXXXXXXXXXXXXXGXXXXXXXXXXXXXXXXXXXGXXXXXXXXXXXXXXXXXXXGXXXXXXXXXXXXXXXXXXXGXXXXXXXXXXXXXXXXXXXGXXXXXXXXXXXXXXXXXXXGXXXXXXXXXXXXXXXXXXXGXXXXXXXXXXXXXXXXXXXGXXXXXXXXXXXXXXXXXXXGXXXXXXXXXXXXXXXXXXX,0,300,0
2583,13,0,13,93,194,0,0,203,35,168,GXXXXXXXXXXXXXXXXXXXGXXXXXXXXXXXXXXXXXXXGXXXXXXXXXXXXXXXXXXXGXXXXXXXXXXXXXXXXXXXGXXXXXXXXXXXXXXXXXXXGXXXXXXXXXXXXXXXXXXXGXXXXXXXXXXXXXXXXXXXGXXXXXXXXXXXXXXXXXXXGXXXXXXXXXXXXXXXXXXXGXXXXXXXXXXXXXXXXXXXGXXXXXXXXXXXXXXXXXXXGXXXXXXXXXXXXXXXXXXXGXXXXXXXXXXXXXXXXXXX,0,300,0
2604,13,0,13,93,194,0,0,206,38,168,GXXXXXXXXXXXXXXXXXXXGXXXXXXXXXXXXXXXXXXXGXXXXXXXXXXXXXXXXXXXGXXXXXXXXXXXXXXXXXXXGXXXXXXXXXXXXXXXXXXXGXXXXXXXXXXXXXXXXXXXGXXXXXXXXXXXXXXXXXXXGXXXXXXXXXXXXXXXXXXXGXXXXXXXXXXXXXXXXXXXGXXXXXXXXXXXXXXXXXXXGXXXXXXXXXXXXXXXXXXXGXXXXXXXXXXXXXXXXXXXGXXXXXXXXXXXXXXXXXXX,0,300,0

2625,13,0,13,89,198,0,0,209,45,164,GXXXXXXXXXXXXXXXXXXXGXXXXXXXXXXXXXXXXXXXGXXXXXXXXXXXXXXXXXXXGXXXXXXXXXXXXXXXXXXXGXXXXXXXXXXXXXXXXXXXGXXXXXXXXXXXXXXXXXXXGXXXXXXXXXXXXXXXXXXXGXXXXXXXXXXXXXXXXXXXGXXXXXXXXXXXXXXXXXXXGXXXXXXXXXXXXXXXXXXXGXXXXXXXXXXXXXXXXXXXGXXXXXXXXXXXXXXXXXXXGXXXXXXXXXXXXXXXXXXX,0,300,0
2646,13,0,13,94,193,0,0,204,37,167,GXXXXXXXXXXXXXXXXXXXGXXXXXXXXXXXXXXXXXXXGXXXXXXXXXXXXXXXXXXXGXXXXXXXXXXXXXXXXXXXGXXXXXXXXXXXXXXXXXXXGXXXXXXXXXXXXXXXXXXXGXXXXXXXXXXXXXXXXXXXGXXXXXXXXXXXXXXXXXXXGXXXXXXXXXXXXXXXXXXXGXXXXXXXXXXXXXXXXXXXGXXXXXXXXXXXXXXXXXXXGXXXXXXXXXXXXXXXXXXXGXXXXXXXXXXXXXXXXXXX,0,300,0
2667,13,0,13,93,194,0,0,203,43,160,GXXXXXXXXXXXXXXXXXXXGXXXXXXXXXXXXXXXXXXXGXXXXXXXXXXXXXXXXXXXGXXXXXXXXXXXXXXXXXXXGXXXXXXXXXXXXXXXXXXXGXXXXXXXXXXXXXXXXXXXGXXXXXXXXXXXXXXXXXXXGXXXXXXXXXXXXXXXXXXXGXXXXXXXXXXXXXXXXXXXGXXXXXXXXXXXXXXXXXXXGXXXXXXXXXXXXXXXXXXXGXXXXXXXXXXXXXXXXXXXGXXXXXXXXXXXXXXXXXXX,0,300,0
2688,13,0,13,91,196,0,0,207,45,162,GXXXXXXXXXXXXXXXXXXXGXXXXXXXXXXXXXXXXXXXGXXXXXXXXXXXXXXXXXXXGXXXXXXXXXXXXXXXXXXXGXXXXXXXXXXXXXXXXXXXGXXXXXXXXXXXXXXXXXXXGXXXXXXXXXXXXXXXXXXXGXXXXXXXXXXXXXXXXXXXGXXXXXXXXXXXXXXXXXXXGXXXXXXXXXXXXXXXXXXXGXXXXXXXXXXXXXXXXXXXGXXXXXXXXXXXXXXXXXXXGXXXXXXXXXXXXXXXXXXX,0,300,0
2709,13,0,13,95,192,0,0,204,46,158,GXXXXXXXXXXXXXXXXXXXGXXXXXXXXXXXXXXXXXXXGXXXXXXXXXXXXXXXXXXXGXXXXXXXXXXXXXXXXXXXGXXXXXXXXXXXXXXXXXXXGXXXXXXXXXXXXXXXXXXXGXXXXXXXXXXXXXXXXXXXGXXXXXXXXXXXXXXXXXXXGXXXXXXXXXXXXXXXXXXXGXXXXXXXXXXXXXXXXXXXGXXXXXXXXXXXXXXXXXXXGXXXXXXXXXXXXXXXXXXXGXXXXXXXXXXXXXXXXXXX,0,300,0

2730,13,0,13,97,190,0,0,202,37,165,GXXXXXXXXXXXXXXXXXXXGXXXXXXXXXXXXXXXXXXXGXXXXXXXXXXXXXXXXXXXGXXXXXXXXXXXXXXXXXXXGXXXXXXXXXXXXXXXXXXXGXXXXXXXXXXXXXXXXXXXGXXXXXXXXXXXXXXXXXXXGXXXXXXXXXXXXXXXXXXXGXXXXXXXXXXXXXXXXXXXGXXXXXXXXXXXXXXXXXXXGXXXXXXXXXXXXXXXXXXXGXXXXXXXXXXXXXXXXXXXGXXXXXXXXXXXXXXXXXXX,0,300,0
2751,13,0,13,92,195,0,0,207,43,164,GXXXXXXXXXXXXXXXXXXXGXXXXXXXXXXXXXXXXXXXGXXXXXXXXXXXXXXXXXXXGXXXXXXXXXXXXXXXXXXXGXXXXXXXXXXXXXXXXXXXGXXXXXXXXXXXXXXXXXXXGXXXXXXXXXXXXXXXXXXXGXXXXXXXXXXXXXXXXXXXGXXXXXXXXXXXXXXXXXXXGXXXXXXXXXXXXXXXXXXXGXXXXXXXXXXXXXXXXXXXGXXXXXXXXXXXXXXXXXXXGXXXXXXXXXXXXXXXXXXX,0,300,0
2772,13,0,13,95,192,0,0,204,35,169,GXXXXXXXXXXXXXXXXXXXGXXXXXXXXXXXXXXXXXXXGXXXXXXXXXXXXXXXXXXXGXXXXXXXXXXXXXXXXXXXGXXXXXXXXXXXXXXXXXXXGXXXXXXXXXXXXXXXXXXXGXXXXXXXXXXXXXXXXXXXGXXXXXXXXXXXXXXXXXXXGXXXXXXXXXXXXXXXXXXXGXXXXXXXXXXXXXXXXXXXGXXXXXXXXXXXXXXXXXXXGXXXXXXXXXXXXXXXXXXXGXXXXXXXXXXXXXXXXXXX,0,300,0
2793,13,0,13,100,187,0,0,199,31,168,GXXXXXXXXXXXXXXXXXXXGXXXXXXXXXXXXXXXXXXXGXXXXXXXXXXXXXXXXXXXGXXXXXXXXXXXXXXXXXXXGXXXXXXXXXXXXXXXXXXXGXXXXXXXXXXXXXXXXXXXGXXXXXXXXXXXXXXXXXXXGXXXXXXXXXXXXXXXXXXXGXXXXXXXXXXXXXXXXXXXGXXXXXXXXXXXXXXXXXXXGXXXXXXXXXXXXXXXXXXXGXXXXXXXXXXXXXXXXXXXGXXXXXXXXXXXXXXXXXXX,0,300,0
2814,13,0,13,98,189,0,0,200,42,158,GXXXXXXXXXXXXXXXXXXXGXXXXXXXXXXXXXXXXXXXGXXXXXXXXXXXXXXXXXXXGXXXXXXXXXXXXXXXXXXXGXXXXXXXXXXXXXXXXXXXGXXXXXXXXXXXXXXXXXXXGXXXXXXXXXXXXXXXXXXXGXXXXXXXXXXXXXXXXXXXGXXXXXXXXXXXXXXXXXXXGXXXXXXXXXXXXXXXXXXXGXXXXXXXXXXXXXXXXXXXGXXXXXXXXXXXXXXXXXXXGXXXXXXXXXXXXXXXXXXX,0,300,0

2835,13,0,13,92,195,0,0,206,41,165,GXXXXXXXXXXXXXXXXXXXGXXXXXXXXXXXXXXXXXXXGXXXXXXXXXXXXXXXXXXXGXXXXXXXXXXXXXXXXXXXGXXXXXXXXXXXXXXXXXXXGXXXXXXXXXXXXXXXXXXXGXXXXXXXXXXXXXXXXXXXGXXXXXXXXXXXXXXXXXXXGXXXXXXXXXXXXXXXXXXXGXXXXXXXXXXXXXXXXXXXGXXXXXXXXXXXXXXXXXXXGXXXXXXXXXXXXXXXXXXXGXXXXXXXXXXXXXXXXXXX,0,300,0
2856,14,1,13,87,199,0,0,210,46,164,GXXXXXXXXXXXXXXXXXXXGXXXXXXXXXXXXXXXXXXXGXXXXXXXXXXXXXXXXXXXGXXXXXXXXXXXXXXXXXXXGAXXXXXXXXXXXXXXXXXXGXXXXXXXXXXXXXXXXXXXGXXXXXXXXXXXXXXXXXXXGXXXXXXXXXXXXXXXXXXXGXXXXXXXXXXXXXXXXXXXGXXXXXXXXXXXXXXXXXXXGXXXXXXXXXXXXXXXXXXXGXXXXXXXXXXXXXXXXXXXGXXXXXXXXXXXXXXXXXXX,0,300,0
2877,14,1,13,92,194,0,0,205,41,164,GXXXXXXXXXXXXXXXXXXXGXXXXXXXXXXXXXXXXXXXGXXXXXXXXXXXXXXXXXXXGXXXXXXXXXXXXXXXXXXXGAXXXXXXXXXXXXXXXXXXGXXXXXXXXXXXXXXXXXXXGXXXXXXXXXXXXXXXXXXXGXXXXXXXXXXXXXXXXXXXGXXXXXXXXXXXXXXXXXXXGXXXXXXXXXXXXXXXXXXXGXXXXXXXXXXXXXXXXXXXGXXXXXXXXXXXXXXXXXXXGXXXXXXXXXXXXXXXXXXX,0,300,0
2898,14,1,13,93,193,0,0,203,44,159,GXXXXXXXXXXXXXXXXXXXGXXXXXXXXXXXXXXXXXXXGXXXXXXXXXXXXXXXXXXXGXXXXXXXXXXXXXXXXXXXGAXXXXXXXXXXXXXXXXXXGXXXXXXXXXXXXXXXXXXXGXXXXXXXXXXXXXXXXXXXGXXXXXXXXXXXXXXXXXXXGXXXXXXXXXXXXXXXXXXXGXXXXXXXXXXXXXXXXXXXGXXXXXXXXXXXXXXXXXXXGXXXXXXXXXXXXXXXXXXXGXXXXXXXXXXXXXXXXXXX,0,300,0
2919,14,1,13,91,195,0,0,206,49,157,GXXXXXXXXXXXXXXXXXXXGXXXXXXXXXXXXXXXXXXXGXXXXXXXXXXXXXXXXXXXGXXXXXXXXXXXXXXXXXXXGAXXXXXXXXXXXXXXXXXXGXXXXXXXXXXXXXXXXXXXGXXXXXXXXXXXXXXXXXXXGXXXXXXXXXXXXXXXXXXXGXXXXXXXXXXXXXXXXXXXGXXXXXXXXXXXXXXXXXXXGXXXXXXXXXXXXXXXXXXXGXXXXXXXXXXXXXXXXXXXGXXXXXXXXXXXXXXXXXXX,0,300,0

2940,14,1,13,93,193,0,0,205,45,160,GXXXXXXXXXXXXXXXXXXXGXXXXXXXXXXXXXXXXXXXGXXXXXXXXXXXXXXXXXXXGXXXXXXXXXXXXXXXXXXXGAXXXXXXXXXXXXXXXXXXGXXXXXXXXXXXXXXXXXXXGXXXXXXXXXXXXXXXXXXXGXXXXXXXXXXXXXXXXXXXGXXXXXXXXXXXXXXXXXXXGXXXXXXXXXXXXXXXXXXXGXXXXXXXXXXXXXXXXXXXGXXXXXXXXXXXXXXXXXXXGXXXXXXXXXXXXXXXXXXX,0,300,0
2961,14,1,13,95,191,0,0,203,44,159,GXXXXXXXXXXXXXXXXXXXGXXXXXXXXXXXXXXXXXXXGXXXXXXXXXXXXXXXXXXXGXXXXXXXXXXXXXXXXXXXGAXXXXXXXXXXXXXXXXXXGXXXXXXXXXXXXXXXXXXXGXXXXXXXXXXXXXXXXXXXGXXXXXXXXXXXXXXXXXXXGXXXXXXXXXXXXXXXXXXXGXXXXXXXXXXXXXXXXXXXGXXXXXXXXXXXXXXXXXXXGXXXXXXXXXXXXXXXXXXXGXXXXXXXXXXXXXXXXXXX,0,300,0
2982,14,0,14,98,188,0,0,198,43,155,GXXXXXXXXXXXXXXXXXXXGXXXXXXXXXXXXXXXXXXXGXXXXXXXXXXXXXXXXXXXGXXXXXXXXXXXXXXXXXXXGOXXXXXXXXXXXXXXXXXXGXXXXXXXXXXXXXXXXXXXGXXXXXXXXXXXXXXXXXXXGXXXXXXXXXXXXXXXXXXXGXXXXXXXXXXXXXXXXXXXGXXXXXXXXXXXXXXXXXXXGXXXXXXXXXXXXXXXXXXXGXXXXXXXXXXXXXXXXXXXGXXXXXXXXXXXXXXXXXXX,0,300,0
3003,14,1,13,95,191,0,0,203,45,158,GXXXXXXXXXXXXXXXXXXXGXXXXXXXXXXXXXXXXXXXGXXXXXXXXXXXXXXXXXXXGXXXXXXXXXXXXXXXXXXXGXXXXXXXXXXXXXXXXXXXGXXXXXXXXXXXXXXXXXXXGXXXXXXXXXXXXXXXXXXXGXXXXXXXXXXXXXXXXXXXGXXXXXXXXXXXXXXXXXXXGAXXXXXXXXXXXXXXXXXXGXXXXXXXXXXXXXXXXXXXGXXXXXXXXXXXXXXXXXXXGXXXXXXXXXXXXXXXXXXX,0,300,0
3024,14,1,13,95,191,0,0,203,44,159,GXXXXXXXXXXXXXXXXXXXGXXXXXXXXXXXXXXXXXXXGXXXXXXXXXXXXXXXXXXXGXXXXXXXXXXXXXXXXXXXGXXXXXXXXXXXXXXXXXXXGXXXXXXXXXXXXXXXXXXXGXXXXXXXXXXXXXXXXXXXGXXXXXXXXXXXXXXXXXXXGXXXXXXXXXXXXXXXXXXXGAXXXXXXXXXXXXXXXXXXGXXXXXXXXXXXXXXXXXXXGXXXXXXXXXXXXXXXXXXXGXXXXXXXXXXXXXXXXXXX,0,300,0

3045,14,1,13,87,199,0,0,211,49,162,GXXXXXXXXXXXXXXXXXXXGXXXXXXXXXXXXXXXXXXXGXXXXXXXXXXXXXXXXXXXGXXXXXXXXXXXXXXXXXXXGXXXXXXXXXXXXXXXXXXXGXXXXXXXXXXXXXXXXXXXGXXXXXXXXXXXXXXXXXXXGXXXXXXXXXXXXXXXXXXXGXXXXXXXXXXXXXXXXXXXGAXXXXXXXXXXXXXXXXXXGXXXXXXXXXXXXXXXXXXXGXXXXXXXXXXXXXXXXXXXGXXXXXXXXXXXXXXXXXXX,0,300,0
3066,14,1,13,96,190,0,0,202,42,160,GXXXXXXXXXXXXXXXXXXXGXXXXXXXXXXXXXXXXXXXGXXXXXXXXXXXXXXXXXXXGXXXXXXXXXXXXXXXXXXXGXXXXXXXXXXXXXXXXXXXGXXXXXXXXXXXXXXXXXXXGXXXXXXXXXXXXXXXXXXXGXXXXXXXXXXXXXXXXXXXGXXXXXXXXXXXXXXXXXXXGAXXXXXXXXXXXXXXXXXXGXXXXXXXXXXXXXXXXXXXGXXXXXXXXXXXXXXXXXXXGXXXXXXXXXXXXXXXXXXX,0,300,0
3087,14,1,13,98,188,0,0,200,41,159,GXXXXXXXXXXXXXXXXXXXGXXXXXXXXXXXXXXXXXXXGXXXXXXXXXXXXXXXXXXXGXXXXXXXXXXXXXXXXXXXGXXXXXXXXXXXXXXXXXXXGXXXXXXXXXXXXXXXXXXXGXXXXXXXXXXXXXXXXXXXGXXXXXXXXXXXXXXXXXXXGXXXXXXXXXXXXXXXXXXXGAXXXXXXXXXXXXXXXXXXGXXXXXXXXXXXXXXXXXXXGXXXXXXXXXXXXXXXXXXXGXXXXXXXXXXXXXXXXXXX,0,300,0
3108,14,1,13,101,185,0,0,198,44,154,GXXXXXXXXXXXXXXXXXXXGXXXXXXXXXXXXXXXXXXXGXXXXXXXXXXXXXXXXXXXGXXXXXXXXXXXXXXXXXXXGXXXXXXXXXXXXXXXXXXXGXXXXXXXXXXXXXXXXXXXGXXXXXXXXXXXXXXXXXXXGXXXXXXXXXXXXXXXXXXXGXXXXXXXXXXXXXXXXXXXGAXXXXXXXXXXXXXXXXXXGXXXXXXXXXXXXXXXXXXXGXXXXXXXXXXXXXXXXXXXGXXXXXXXXXXXXXXXXXXX,0,300,0
3129,14,1,13,104,182,0,0,194,44,150,GXXXXXXXXXXXXXXXXXXXGXXXXXXXXXXXXXXXXXXXGXXXXXXXXXXXXXXXXXXXGXXXXXXXXXXXXXXXXXXXGXXXXXXXXXXXXXXXXXXXGXXXXXXXXXXXXXXXXXXXGXXXXXXXXXXXXXXXXXXXGXXXXXXXXXXXXXXXXXXXGXXXXXXXXXXXXXXXXXXXGAXXXXXXXXXXXXXXXXXXGXXXXXXXXXXXXXXXXXXXGXXXXXXXXXXXXXXXXXXXGXXXXXXXXXXXXXXXXXXX,0,300,0

3150,14,1,13,97,189,0,0,202,44,158,GXXXXXXXXXXXXXXXXXXXGXXXXXXXXXXXXXXXXXXXGXXXXXXXXXXXXXXXXXXXGXXXXXXXXXXXXXXXXXXXGXXXXXXXXXXXXXXXXXXXGXXXXXXXXXXXXXXXXXXXGXXXXXXXXXXXXXXXXXXXGXXXXXXXXXXXXXXXXXXXGXXXXXXXXXXXXXXXXXXXGAXXXXXXXXXXXXXXXXXXGXXXXXXXXXXXXXXXXXXXGXXXXXXXXXXXXXXXXXXXGXXXXXXXXXXXXXXXXXXX,0,300,0
3171,14,1,13,94,192,0,0,204,40,164,GXXXXXXXXXXXXXXXXXXXGXXXXXXXXXXXXXXXXXXXGXXXXXXXXXXXXXXXXXXXGXXXXXXXXXXXXXXXXXXXGXXXXXXXXXXXXXXXXXXXGXXXXXXXXXXXXXXXXXXXGXXXXXXXXXXXXXXXXXXXGXXXXXXXXXXXXXXXXXXXGXXXXXXXXXXXXXXXXXXXGAXXXXXXXXXXXXXXXXXXGXXXXXXXXXXXXXXXXXXXGXXXXXXXXXXXXXXXXXXXGXXXXXXXXXXXXXXXXXXX,0,300,0
3192,14,1,13,90,196,0,0,209,42,167,GXXXXXXXXXXXXXXXXXXXGXXXXXXXXXXXXXXXXXXXGXXXXXXXXXXXXXXXXXXXGXXXXXXXXXXXXXXXXXXXGXXXXXXXXXXXXXXXXXXXGXXXXXXXXXXXXXXXXXXXGXXXXXXXXXXXXXXXXXXXGXXXXXXXXXXXXXXXXXXXGXXXXXXXXXXXXXXXXXXXGAXXXXXXXXXXXXXXXXXXGXXXXXXXXXXXXXXXXXXXGXXXXXXXXXXXXXXXXXXXGXXXXXXXXXXXXXXXXXXX,0,300,0
3213,14,1,13,93,193,0,0,206,45,161,GXXXXXXXXXXXXXXXXXXXGXXXXXXXXXXXXXXXXXXXGXXXXXXXXXXXXXXXXXXXGXXXXXXXXXXXXXXXXXXXGXXXXXXXXXXXXXXXXXXXGXXXXXXXXXXXXXXXXXXXGXXXXXXXXXXXXXXXXXXXGXXXXXXXXXXXXXXXXXXXGXXXXXXXXXXXXXXXXXXXGAXXXXXXXXXXXXXXXXXXGXXXXXXXXXXXXXXXXXXXGXXXXXXXXXXXXXXXXXXXGXXXXXXXXXXXXXXXXXXX,0,300,0
3234,14,1,13,94,192,0,0,204,46,158,GXXXXXXXXXXXXXXXXXXXGXXXXXXXXXXXXXXXXXXXGXXXXXXXXXXXXXXXXXXXGXXXXXXXXXXXXXXXXXXXGXXXXXXXXXXXXXXXXXXXGXXXXXXXXXXXXXXXXXXXGXXXXXXXXXXXXXXXXXXXGXXXXXXXXXXXXXXXXXXXGXXXXXXXXXXXXXXXXXXXGAXXXXXXXXXXXXXXXXXXGXXXXXXXXXXXXXXXXXXXGXXXXXXXXXXXXXXXXXXXGXXXXXXXXXXXXXXXXXXX,0,300,0

3255,14,1,13,95,191,0,0,203,51,152,GXXXXXXXXXXXXXXXXXXXGXXXXXXXXXXXXXXXXXXXGXXXXXXXXXXXXXXXXXXXGXXXXXXXXXXXXXXXXXXXGXXXXXXXXXXXXXXXXXXXGXXXXXXXXXXXXXXXXXXXGXXXXXXXXXXXXXXXXXXXGXXXXXXXXXXXXXXXXXXXGXXXXXXXXXXXXXXXXXXXGAXXXXXXXXXXXXXXXXXXGXXXXXXXXXXXXXXXXXXXGXXXXXXXXXXXXXXXXXXXGXXXXXXXXXXXXXXXXXXX,0,300,0
3276,14,1,13,110,176,0,0,188,37,151,GXXXXXXXXXXXXXXXXXXXGXXXXXXXXXXXXXXXXXXXGXXXXXXXXXXXXXXXXXXXGXXXXXXXXXXXXXXXXXXXGXXXXXXXXXXXXXXXXXXXGXXXXXXXXXXXXXXXXXXXGXXXXXXXXXXXXXXXXXXXGXXXXXXXXXXXXXXXXXXXGXXXXXXXXXXXXXXXXXXXGAXXXXXXXXXXXXXXXXXXGXXXXXXXXXXXXXXXXXXXGXXXXXXXXXXXXXXXXXXXGXXXXXXXXXXXXXXXXXXX,0,300,0
3297,14,1,13,102,184,0,0,196,43,153,GXXXXXXXXXXXXXXXXXXXGXXXXXXXXXXXXXXXXXXXGXXXXXXXXXXXXXXXXXXXGXXXXXXXXXXXXXXXXXXXGXXXXXXXXXXXXXXXXXXXGXXXXXXXXXXXXXXXXXXXGXXXXXXXXXXXXXXXXXXXGXXXXXXXXXXXXXXXXXXXGXXXXXXXXXXXXXXXXXXXGAXXXXXXXXXXXXXXXXXXGXXXXXXXXXXXXXXXXXXXGXXXXXXXXXXXXXXXXXXXGXXXXXXXXXXXXXXXXXXX,0,300,0
3318,14,0,14,99,187,0,0,199,42,157,GXXXXXXXXXXXXXXXXXXXGXXXXXXXXXXXXXXXXXXXGXXXXXXXXXXXXXXXXXXXGXXXXXXXXXXXXXXXXXXXGXXXXXXXXXXXXXXXXXXXGXXXXXXXXXXXXXXXXXXXGXXXXXXXXXXXXXXXXXXXGXXXXXXXXXXXXXXXXXXXGXXXXXXXXXXXXXXXXXXXGOXXXXXXXXXXXXXXXXXXGXXXXXXXXXXXXXXXXXXXGXXXXXXXXXXXXXXXXXXXGXXXXXXXXXXXXXXXXXXX,0,300,0
3339,15,1,14,94,191,0,0,203,46,157,GXXXXXXXXXXXXXXXXXXXGXXXXXXXXXXXXXXXXXXXGXXXXXXXXXXXXXXXXXXXGXXXXXXXXXXXXXXXXXXXGXXXXXXXXXXXXXXXXXXXGXXXXXXXXXXXXXXXXXXXGXXXXXXXXXXXXXXXXXXXGXXXXXXXXXXXXXXXXXXXGXXXXXXXXXXXXXXXXXXXGOAXXXXXXXXXXXXXXXXXGXXXXXXXXXXXXXXXXXXXGXXXXXXXXXXXXXXXXXXXGXXXXXXXXXXXXXXXXXXX,0,300,0

3360,14,1,13,90,196,0,0,208,50,158,GXXXXXXXXXXXXXXXXXXXGXXXXXXXXXXXXXXXXXXXGXXXXXXXXXXXXXXXXXXXGXXXXXXXXXXXXXXXXXXXGXXXXXXXXXXXXXXXXXXXGXXXXXXXXXXXXXXXXXXXGXXXXXXXXXXXXXXXXXXXGXXXXXXXXXXXXXXXXXXXGXXXXXXXXXXXXXXXXXXXGXAXXXXXXXXXXXXXXXXXGXXXXXXXXXXXXXXXXXXXGXXXXXXXXXXXXXXXXXXXGXXXXXXXXXXXXXXXXXXX,0,300,0
3381,13,0,13,89,198,0,0,209,52,157,GXXXXXXXXXXXXXXXXXXXGXXXXXXXXXXXXXXXXXXXGXXXXXXXXXXXXXXXXXXXGXXXXXXXXXXXXXXXXXXXGXXXXXXXXXXXXXXXXXXXGXXXXXXXXXXXXXXXXXXXGXXXXXXXXXXXXXXXXXXXGXXXXXXXXXXXXXXXXXXXGXXXXXXXXXXXXXXXXXXXGXXXXXXXXXXXXXXXXXXXGXXXXXXXXXXXXXXXXXXXGXXXXXXXXXXXXXXXXXXXGXXXXXXXXXXXXXXXXXXX,0,300,0
3402,13,0,13,85,202,0,0,212,53,159,GXXXXXXXXXXXXXXXXXXXGXXXXXXXXXXXXXXXXXXXGXXXXXXXXXXXXXXXXXXXGXXXXXXXXXXXXXXXXXXXGXXXXXXXXXXXXXXXXXXXGXXXXXXXXXXXXXXXXXXXGXXXXXXXXXXXXXXXXXXXGXXXXXXXXXXXXXXXXXXXGXXXXXXXXXXXXXXXXXXXGXXXXXXXXXXXXXXXXXXXGXXXXXXXXXXXXXXXXXXXGXXXXXXXXXXXXXXXXXXXGXXXXXXXXXXXXXXXXXXX,0,300,0
3423,13,0,13,89,198,0,0,209,49,160,GXXXXXXXXXXXXXXXXXXXGXXXXXXXXXXXXXXXXXXXGXXXXXXXXXXXXXXXXXXXGXXXXXXXXXXXXXXXXXXXGXXXXXXXXXXXXXXXXXXXGXXXXXXXXXXXXXXXXXXXGXXXXXXXXXXXXXXXXXXXGXXXXXXXXXXXXXXXXXXXGXXXXXXXXXXXXXXXXXXXGXXXXXXXXXXXXXXXXXXXGXXXXXXXXXXXXXXXXXXXGXXXXXXXXXXXXXXXXXXXGXXXXXXXXXXXXXXXXXXX,0,300,0
3444,13,0,13,82,205,0,0,216,47,169,GXXXXXXXXXXXXXXXXXXXGXXXXXXXXXXXXXXXXXXXGXXXXXXXXXXXXXXXXXXXGXXXXXXXXXXXXXXXXXXXGXXXXXXXXXXXXXXXXXXXGXXXXXXXXXXXXXXXXXXXGXXXXXXXXXXXXXXXXXXXGXXXXXXXXXXXXXXXXXXXGXXXXXXXXXXXXXXXXXXXGXXXXXXXXXXXXXXXXXXXGXXXXXXXXXXXXXXXXXXXGXXXXXXXXXXXXXXXXXXXGXXXXXXXXXXXXXXXXXXX,0,300,0

3465,13,0,13,76,211,0,0,223,46,177,GXXXXXXXXXXXXXXXXXXXGXXXXXXXXXXXXXXXXXXXGXXXXXXXXXXXXXXXXXXXGXXXXXXXXXXXXXXXXXXXGXXXXXXXXXXXXXXXXXXXGXXXXXXXXXXXXXXXXXXXGXXXXXXXXXXXXXXXXXXXGXXXXXXXXXXXXXXXXXXXGXXXXXXXXXXXXXXXXXXXGXXXXXXXXXXXXXXXXXXXGXXXXXXXXXXXXXXXXXXXGXXXXXXXXXXXXXXXXXXXGXXXXXXXXXXXXXXXXXXX,0,300,0
3486,13,0,13,83,204,0,0,216,48,168,GXXXXXXXXXXXXXXXXXXXGXXXXXXXXXXXXXXXXXXXGXXXXXXXXXXXXXXXXXXXGXXXXXXXXXXXXXXXXXXXGXXXXXXXXXXXXXXXXXXXGXXXXXXXXXXXXXXXXXXXGXXXXXXXXXXXXXXXXXXXGXXXXXXXXXXXXXXXXXXXGXXXXXXXXXXXXXXXXXXXGXXXXXXXXXXXXXXXXXXXGXXXXXXXXXXXXXXXXXXXGXXXXXXXXXXXXXXXXXXXGXXXXXXXXXXXXXXXXXXX,0,300,0
3507,13,0,13,82,205,0,0,215,54,161,GXXXXXXXXXXXXXXXXXXXGXXXXXXXXXXXXXXXXXXXGXXXXXXXXXXXXXXXXXXXGXXXXXXXXXXXXXXXXXXXGXXXXXXXXXXXXXXXXXXXGXXXXXXXXXXXXXXXXXXXGXXXXXXXXXXXXXXXXXXXGXXXXXXXXXXXXXXXXXXXGXXXXXXXXXXXXXXXXXXXGXXXXXXXXXXXXXXXXXXXGXXXXXXXXXXXXXXXXXXXGXXXXXXXXXXXXXXXXXXXGXXXXXXXXXXXXXXXXXXX,0,300,0
3528,13,0,13,89,198,0,0,209,50,159,GXXXXXXXXXXXXXXXXXXXGXXXXXXXXXXXXXXXXXXXGXXXXXXXXXXXXXXXXXXXGXXXXXXXXXXXXXXXXXXXGXXXXXXXXXXXXXXXXXXXGXXXXXXXXXXXXXXXXXXXGXXXXXXXXXXXXXXXXXXXGXXXXXXXXXXXXXXXXXXXGXXXXXXXXXXXXXXXXXXXGXXXXXXXXXXXXXXXXXXXGXXXXXXXXXXXXXXXXXXXGXXXXXXXXXXXXXXXXXXXGXXXXXXXXXXXXXXXXXXX,0,300,0
3549,13,0,13,90,197,0,0,209,49,160,GXXXXXXXXXXXXXXXXXXXGXXXXXXXXXXXXXXXXXXXGXXXXXXXXXXXXXXXXXXXGXXXXXXXXXXXXXXXXXXXGXXXXXXXXXXXXXXXXXXXGXXXXXXXXXXXXXXXXXXXGXXXXXXXXXXXXXXXXXXXGXXXXXXXXXXXXXXXXXXXGXXXXXXXXXXXXXXXXXXXGXXXXXXXXXXXXXXXXXXXGXXXXXXXXXXXXXXXXXXXGXXXXXXXXXXXXXXXXXXXGXXXXXXXXXXXXXXXXXXX,0,300,0

3570,13,0,13,91,196,0,0,208,52,156,GXXXXXXXXXXXXXXXXXXXGXXXXXXXXXXXXXXXXXXXGXXXXXXXXXXXXXXXXXXXGXXXXXXXXXXXXXXXXXXXGXXXXXXXXXXXXXXXXXXXGXXXXXXXXXXXXXXXXXXXGXXXXXXXXXXXXXXXXXXXGXXXXXXXXXXXXXXXXXXXGXXXXXXXXXXXXXXXXXXXGXXXXXXXXXXXXXXXXXXXGXXXXXXXXXXXXXXXXXXXGXXXXXXXXXXXXXXXXXXXGXXXXXXXXXXXXXXXXXXX,0,300,0
3591,13,0,13,96,191,0,0,203,48,155,GXXXXXXXXXXXXXXXXXXXGXXXXXXXXXXXXXXXXXXXGXXXXXXXXXXXXXXXXXXXGXXXXXXXXXXXXXXXXXXXGXXXXXXXXXXXXXXXXXXXGXXXXXXXXXXXXXXXXXXXGXXXXXXXXXXXXXXXXXXXGXXXXXXXXXXXXXXXXXXXGXXXXXXXXXXXXXXXXXXXGXXXXXXXXXXXXXXXXXXXGXXXXXXXXXXXXXXXXXXXGXXXXXXXXXXXXXXXXXXXGXXXXXXXXXXXXXXXXXXX,0,300,0
3612,14,1,13,95,191,0,0,202,50,152,GXXXXXXXXXXXXXXXXXXXGXXXXXXXXXXXXXXXXXXXGXXXXXXXXXXXXXXXXXXXGXXXXXXXXXXXXXXXXXXXGXXXXXXXXXXXXXXXXXXXGAXXXXXXXXXXXXXXXXXXGXXXXXXXXXXXXXXXXXXXGXXXXXXXXXXXXXXXXXXXGXXXXXXXXXXXXXXXXXXXGXXXXXXXXXXXXXXXXXXXGXXXXXXXXXXXXXXXXXXXGXXXXXXXXXXXXXXXXXXXGXXXXXXXXXXXXXXXXXXX,0,300,0
3633,14,1,13,91,195,0,0,207,51,156,GXXXXXXXXXXXXXXXXXXXGXXXXXXXXXXXXXXXXXXXGXXXXXXXXXXXXXXXXXXXGXXXXXXXXXXXXXXXXXXXGXXXXXXXXXXXXXXXXXXXGAXXXXXXXXXXXXXXXXXXGXXXXXXXXXXXXXXXXXXXGXXXXXXXXXXXXXXXXXXXGXXXXXXXXXXXXXXXXXXXGXXXXXXXXXXXXXXXXXXXGXXXXXXXXXXXXXXXXXXXGXXXXXXXXXXXXXXXXXXXGXXXXXXXXXXXXXXXXXXX,0,300,0
3654,13,0,13,91,196,0,0,208,56,152,GXXXXXXXXXXXXXXXXXXXGXXXXXXXXXXXXXXXXXXXGXXXXXXXXXXXXXXXXXXXGXXXXXXXXXXXXXXXXXXXGXXXXXXXXXXXXXXXXXXXGXXXXXXXXXXXXXXXXXXXGXXXXXXXXXXXXXXXXXXXGXXXXXXXXXXXXXXXXXXXGXXXXXXXXXXXXXXXXXXXGXXXXXXXXXXXXXXXXXXXGXXXXXXXXXXXXXXXXXXXGXXXXXXXXXXXXXXXXXXXGXXXXXXXXXXXXXXXXXXX,0,300,0

3675,13,0,13,88,199,0,0,209,53,156,GXXXXXXXXXXXXXXXXXXXGXXXXXXXXXXXXXXXXXXXGXXXXXXXXXXXXXXXXXXXGXXXXXXXXXXXXXXXXXXXGXXXXXXXXXXXXXXXXXXXGXXXXXXXXXXXXXXXXXXXGXXXXXXXXXXXXXXXXXXXGXXXXXXXXXXXXXXXXXXXGXXXXXXXXXXXXXXXXXXXGXXXXXXXXXXXXXXXXXXXGXXXXXXXXXXXXXXXXXXXGXXXXXXXXXXXXXXXXXXXGXXXXXXXXXXXXXXXXXXX,0,300,0
3696,13,0,13,92,195,0,0,206,49,157,GXXXXXXXXXXXXXXXXXXXGXXXXXXXXXXXXXXXXXXXGXXXXXXXXXXXXXXXXXXXGXXXXXXXXXXXXXXXXXXXGXXXXXXXXXXXXXXXXXXXGXXXXXXXXXXXXXXXXXXXGXXXXXXXXXXXXXXXXXXXGXXXXXXXXXXXXXXXXXXXGXXXXXXXXXXXXXXXXXXXGXXXXXXXXXXXXXXXXXXXGXXXXXXXXXXXXXXXXXXXGXXXXXXXXXXXXXXXXXXXGXXXXXXXXXXXXXXXXXXX,0,300,0
3717,13,0,13,95,192,0,0,204,55,149,GXXXXXXXXXXXXXXXXXXXGXXXXXXXXXXXXXXXXXXXGXXXXXXXXXXXXXXXXXXXGXXXXXXXXXXXXXXXXXXXGXXXXXXXXXXXXXXXXXXXGXXXXXXXXXXXXXXXXXXXGXXXXXXXXXXXXXXXXXXXGXXXXXXXXXXXXXXXXXXXGXXXXXXXXXXXXXXXXXXXGXXXXXXXXXXXXXXXXXXXGXXXXXXXXXXXXXXXXXXXGXXXXXXXXXXXXXXXXXXXGXXXXXXXXXXXXXXXXXXX,0,300,0
3738,13,0,13,87,200,0,0,212,62,150,GXXXXXXXXXXXXXXXXXXXGXXXXXXXXXXXXXXXXXXXGXXXXXXXXXXXXXXXXXXXGXXXXXXXXXXXXXXXXXXXGXXXXXXXXXXXXXXXXXXXGXXXXXXXXXXXXXXXXXXXGXXXXXXXXXXXXXXXXXXXGXXXXXXXXXXXXXXXXXXXGXXXXXXXXXXXXXXXXXXXGXXXXXXXXXXXXXXXXXXXGXXXXXXXXXXXXXXXXXXXGXXXXXXXXXXXXXXXXXXXGXXXXXXXXXXXXXXXXXXX,0,300,0
3759,13,0,13,84,203,0,0,215,63,152,GXXXXXXXXXXXXXXXXXXXGXXXXXXXXXXXXXXXXXXXGXXXXXXXXXXXXXXXXXXXGXXXXXXXXXXXXXXXXXXXGXXXXXXXXXXXXXXXXXXXGXXXXXXXXXXXXXXXXXXXGXXXXXXXXXXXXXXXXXXXGXXXXXXXXXXXXXXXXXXXGXXXXXXXXXXXXXXXXXXXGXXXXXXXXXXXXXXXXXXXGXXXXXXXXXXXXXXXXXXXGXXXXXXXXXXXXXXXXXXXGXXXXXXXXXXXXXXXXXXX,0,300,0

3780,13,0,13,83,204,0,0,215,61,154,GXXXXXXXXXXXXXXXXXXXGXXXXXXXXXXXXXXXXXXXGXXXXXXXXXXXXXXXXXXXGXXXXXXXXXXXXXXXXXXXGXXXXXXXXXXXXXXXXXXXGXXXXXXXXXXXXXXXXXXXGXXXXXXXXXXXXXXXXXXXGXXXXXXXXXXXXXXXXXXXGXXXXXXXXXXXXXXXXXXXGXXXXXXXXXXXXXXXXXXXGXXXXXXXXXXXXXXXXXXXGXXXXXXXXXXXXXXXXXXXGXXXXXXXXXXXXXXXXXXX,0,300,0
3801,13,0,13,93,194,0,0,206,51,155,GXXXXXXXXXXXXXXXXXXXGXXXXXXXXXXXXXXXXXXXGXXXXXXXXXXXXXXXXXXXGXXXXXXXXXXXXXXXXXXXGXXXXXXXXXXXXXXXXXXXGXXXXXXXXXXXXXXXXXXXGXXXXXXXXXXXXXXXXXXXGXXXXXXXXXXXXXXXXXXXGXXXXXXXXXXXXXXXXXXXGXXXXXXXXXXXXXXXXXXXGXXXXXXXXXXXXXXXXXXXGXXXXXXXXXXXXXXXXXXXGXXXXXXXXXXXXXXXXXXX,0,300,0
3822,13,0,13,84,203,0,0,214,55,159,GXXXXXXXXXXXXXXXXXXXGXXXXXXXXXXXXXXXXXXXGXXXXXXXXXXXXXXXXXXXGXXXXXXXXXXXXXXXXXXXGXXXXXXXXXXXXXXXXXXXGXXXXXXXXXXXXXXXXXXXGXXXXXXXXXXXXXXXXXXXGXXXXXXXXXXXXXXXXXXXGXXXXXXXXXXXXXXXXXXXGXXXXXXXXXXXXXXXXXXXGXXXXXXXXXXXXXXXXXXXGXXXXXXXXXXXXXXXXXXXGXXXXXXXXXXXXXXXXXXX,0,300,0
3843,13,0,13,94,193,0,0,205,58,147,GXXXXXXXXXXXXXXXXXXXGXXXXXXXXXXXXXXXXXXXGXXXXXXXXXXXXXXXXXXXGXXXXXXXXXXXXXXXXXXXGXXXXXXXXXXXXXXXXXXXGXXXXXXXXXXXXXXXXXXXGXXXXXXXXXXXXXXXXXXXGXXXXXXXXXXXXXXXXXXXGXXXXXXXXXXXXXXXXXXXGXXXXXXXXXXXXXXXXXXXGXXXXXXXXXXXXXXXXXXXGXXXXXXXXXXXXXXXXXXXGXXXXXXXXXXXXXXXXXXX,0,300,0
3864,13,0,13,98,189,0,0,200,53,147,GXXXXXXXXXXXXXXXXXXXGXXXXXXXXXXXXXXXXXXXGXXXXXXXXXXXXXXXXXXXGXXXXXXXXXXXXXXXXXXXGXXXXXXXXXXXXXXXXXXXGXXXXXXXXXXXXXXXXXXXGXXXXXXXXXXXXXXXXXXXGXXXXXXXXXXXXXXXXXXXGXXXXXXXXXXXXXXXXXXXGXXXXXXXXXXXXXXXXXXXGXXXXXXXXXXXXXXXXXXXGXXXXXXXXXXXXXXXXXXXGXXXXXXXXXXXXXXXXXXX,0,300,0

3885,13,0,13,97,190,0,0,202,49,153,GXXXXXXXXXXXXXXXXXXXGXXXXXXXXXXXXXXXXXXXGXXXXXXXXXXXXXXXXXXXGXXXXXXXXXXXXXXXXXXXGXXXXXXXXXXXXXXXXXXXGXXXXXXXXXXXXXXXXXXXGXXXXXXXXXXXXXXXXXXXGXXXXXXXXXXXXXXXXXXXGXXXXXXXXXXXXXXXXXXXGXXXXXXXXXXXXXXXXXXXGXXXXXXXXXXXXXXXXXXXGXXXXXXXXXXXXXXXXXXXGXXXXXXXXXXXXXXXXXXX,0,300,0
3906,14,1,13,96,190,0,0,202,55,147,GAXXXXXXXXXXXXXXXXXXGXXXXXXXXXXXXXXXXXXXGXXXXXXXXXXXXXXXXXXXGXXXXXXXXXXXXXXXXXXXGXXXXXXXXXXXXXXXXXXXGXXXXXXXXXXXXXXXXXXXGXXXXXXXXXXXXXXXXXXXGXXXXXXXXXXXXXXXXXXXGXXXXXXXXXXXXXXXXXXXGXXXXXXXXXXXXXXXXXXXGXXXXXXXXXXXXXXXXXXXGXXXXXXXXXXXXXXXXXXXGXXXXXXXXXXXXXXXXXXX,0,300,0
3927,14,0,14,89,197,0,0,209,58,151,GOXXXXXXXXXXXXXXXXXXGXXXXXXXXXXXXXXXXXXXGXXXXXXXXXXXXXXXXXXXGXXXXXXXXXXXXXXXXXXXGXXXXXXXXXXXXXXXXXXXGXXXXXXXXXXXXXXXXXXXGXXXXXXXXXXXXXXXXXXXGXXXXXXXXXXXXXXXXXXXGXXXXXXXXXXXXXXXXXXXGXXXXXXXXXXXXXXXXXXXGXXXXXXXXXXXXXXXXXXXGXXXXXXXXXXXXXXXXXXXGXXXXXXXXXXXXXXXXXXX,0,300,0
3948,14,0,14,88,198,0,0,211,56,155,GOXXXXXXXXXXXXXXXXXXGXXXXXXXXXXXXXXXXXXXGXXXXXXXXXXXXXXXXXXXGXXXXXXXXXXXXXXXXXXXGXXXXXXXXXXXXXXXXXXXGXXXXXXXXXXXXXXXXXXXGXXXXXXXXXXXXXXXXXXXGXXXXXXXXXXXXXXXXXXXGXXXXXXXXXXXXXXXXXXXGXXXXXXXXXXXXXXXXXXXGXXXXXXXXXXXXXXXXXXXGXXXXXXXXXXXXXXXXXXXGXXXXXXXXXXXXXXXXXXX,0,300,0
3969,13,0,13,91,196,0,0,209,50,159,GXXXXXXXXXXXXXXXXXXXGXXXXXXXXXXXXXXXXXXXGXXXXXXXXXXXXXXXXXXXGXXXXXXXXXXXXXXXXXXXGXXXXXXXXXXXXXXXXXXXGXXXXXXXXXXXXXXXXXXXGXXXXXXXXXXXXXXXXXXXGXXXXXXXXXXXXXXXXXXXGXXXXXXXXXXXXXXXXXXXGXXXXXXXXXXXXXXXXXXXGXXXXXXXXXXXXXXXXXXXGXXXXXXXXXXXXXXXXXXXGXXXXXXXXXXXXXXXXXXX,0,300,0

3990,13,0,13,91,196,0,0,210,50,160,GXXXXXXXXXXXXXXXXXXXGXXXXXXXXXXXXXXXXXXXGXXXXXXXXXXXXXXXXXXXGXXXXXXXXXXXXXXXXXXXGXXXXXXXXXXXXXXXXXXXGXXXXXXXXXXXXXXXXXXXGXXXXXXXXXXXXXXXXXXXGXXXXXXXXXXXXXXXXXXXGXXXXXXXXXXXXXXXXXXXGXXXXXXXXXXXXXXXXXXXGXXXXXXXXXXXXXXXXXXXGXXXXXXXXXXXXXXXXXXXGXXXXXXXXXXXXXXXXXXX,0,300,0
4011,13,0,13,83,204,0,0,217,51,166,GXXXXXXXXXXXXXXXXXXXGXXXXXXXXXXXXXXXXXXXGXXXXXXXXXXXXXXXXXXXGXXXXXXXXXXXXXXXXXXXGXXXXXXXXXXXXXXXXXXXGXXXXXXXXXXXXXXXXXXXGXXXXXXXXXXXXXXXXXXXGXXXXXXXXXXXXXXXXXXXGXXXXXXXXXXXXXXXXXXXGXXXXXXXXXXXXXXXXXXXGXXXXXXXXXXXXXXXXXXXGXXXXXXXXXXXXXXXXXXXGXXXXXXXXXXXXXXXXXXX,0,300,0
4032,13,0,13,82,205,0,0,219,50,169,GXXXXXXXXXXXXXXXXXXXGXXXXXXXXXXXXXXXXXXXGXXXXXXXXXXXXXXXXXXXGXXXXXXXXXXXXXXXXXXXGXXXXXXXXXXXXXXXXXXXGXXXXXXXXXXXXXXXXXXXGXXXXXXXXXXXXXXXXXXXGXXXXXXXXXXXXXXXXXXXGXXXXXXXXXXXXXXXXXXXGXXXXXXXXXXXXXXXXXXXGXXXXXXXXXXXXXXXXXXXGXXXXXXXXXXXXXXXXXXXGXXXXXXXXXXXXXXXXXXX,0,300,0
4053,13,0,13,78,209,0,0,222,51,171,GXXXXXXXXXXXXXXXXXXXGXXXXXXXXXXXXXXXXXXXGXXXXXXXXXXXXXXXXXXXGXXXXXXXXXXXXXXXXXXXGXXXXXXXXXXXXXXXXXXXGXXXXXXXXXXXXXXXXXXXGXXXXXXXXXXXXXXXXXXXGXXXXXXXXXXXXXXXXXXXGXXXXXXXXXXXXXXXXXXXGXXXXXXXXXXXXXXXXXXXGXXXXXXXXXXXXXXXXXXXGXXXXXXXXXXXXXXXXXXXGXXXXXXXXXXXXXXXXXXX,0,300,0
4074,13,0,13,86,201,0,0,214,45,169,GXXXXXXXXXXXXXXXXXXXGXXXXXXXXXXXXXXXXXXXGXXXXXXXXXXXXXXXXXXXGXXXXXXXXXXXXXXXXXXXGXXXXXXXXXXXXXXXXXXXGXXXXXXXXXXXXXXXXXXXGXXXXXXXXXXXXXXXXXXXGXXXXXXXXXXXXXXXXXXXGXXXXXXXXXXXXXXXXXXXGXXXXXXXXXXXXXXXXXXXGXXXXXXXXXXXXXXXXXXXGXXXXXXXXXXXXXXXXXXXGXXXXXXXXXXXXXXXXXXX,0,300,0

4095,13,0,13,84,203,0,0,214,54,160,GXXXXXXXXXXXXXXXXXXXGXXXXXXXXXXXXXXXXXXXGXXXXXXXXXXXXXXXXXXXGXXXXXXXXXXXXXXXXXXXGXXXXXXXXXXXXXXXXXXXGXXXXXXXXXXXXXXXXXXXGXXXXXXXXXXXXXXXXXXXGXXXXXXXXXXXXXXXXXXXGXXXXXXXXXXXXXXXXXXXGXXXXXXXXXXXXXXXXXXXGXXXXXXXXXXXXXXXXXXXGXXXXXXXXXXXXXXXXXXXGXXXXXXXXXXXXXXXXXXX,0,300,0
4116,13,0,13,83,204,0,0,217,63,154,GXXXXXXXXXXXXXXXXXXXGXXXXXXXXXXXXXXXXXXXGXXXXXXXXXXXXXXXXXXXGXXXXXXXXXXXXXXXXXXXGXXXXXXXXXXXXXXXXXXXGXXXXXXXXXXXXXXXXXXXGXXXXXXXXXXXXXXXXXXXGXXXXXXXXXXXXXXXXXXXGXXXXXXXXXXXXXXXXXXXGXXXXXXXXXXXXXXXXXXXGXXXXXXXXXXXXXXXXXXXGXXXXXXXXXXXXXXXXXXXGXXXXXXXXXXXXXXXXXXX,0,300,0
4137,13,0,13,83,204,0,0,217,62,155,GXXXXXXXXXXXXXXXXXXXGXXXXXXXXXXXXXXXXXXXGXXXXXXXXXXXXXXXXXXXGXXXXXXXXXXXXXXXXXXXGXXXXXXXXXXXXXXXXXXXGXXXXXXXXXXXXXXXXXXXGXXXXXXXXXXXXXXXXXXXGXXXXXXXXXXXXXXXXXXXGXXXXXXXXXXXXXXXXXXXGXXXXXXXXXXXXXXXXXXXGXXXXXXXXXXXXXXXXXXXGXXXXXXXXXXXXXXXXXXXGXXXXXXXXXXXXXXXXXXX,0,300,0
4158,13,0,13,84,203,0,0,216,63,153,GXXXXXXXXXXXXXXXXXXXGXXXXXXXXXXXXXXXXXXXGXXXXXXXXXXXXXXXXXXXGXXXXXXXXXXXXXXXXXXXGXXXXXXXXXXXXXXXXXXXGXXXXXXXXXXXXXXXXXXXGXXXXXXXXXXXXXXXXXXXGXXXXXXXXXXXXXXXXXXXGXXXXXXXXXXXXXXXXXXXGXXXXXXXXXXXXXXXXXXXGXXXXXXXXXXXXXXXXXXXGXXXXXXXXXXXXXXXXXXXGXXXXXXXXXXXXXXXXXXX,0,300,0
4179,13,0,13,91,196,0,0,209,59,150,GXXXXXXXXXXXXXXXXXXXGXXXXXXXXXXXXXXXXXXXGXXXXXXXXXXXXXXXXXXXGXXXXXXXXXXXXXXXXXXXGXXXXXXXXXXXXXXXXXXXGXXXXXXXXXXXXXXXXXXXGXXXXXXXXXXXXXXXXXXXGXXXXXXXXXXXXXXXXXXXGXXXXXXXXXXXXXXXXXXXGXXXXXXXXXXXXXXXXXXXGXXXXXXXXXXXXXXXXXXXGXXXXXXXXXXXXXXXXXXXGXXXXXXXXXXXXXXXXXXX,0,300,0

4200,13,0,13,96,191,0,0,204,56,148,GXXXXXXXXXXXXXXXXXXXGXXXXXXXXXXXXXXXXXXXGXXXXXXXXXXXXXXXXXXXGXXXXXXXXXXXXXXXXXXXGXXXXXXXXXXXXXXXXXXXGXXXXXXXXXXXXXXXXXXXGXXXXXXXXXXXXXXXXXXXGXXXXXXXXXXXXXXXXXXXGXXXXXXXXXXXXXXXXXXXGXXXXXXXXXXXXXXXXXXXGXXXXXXXXXXXXXXXXXXXGXXXXXXXXXXXXXXXXXXXGXXXXXXXXXXXXXXXXXXX,0,300,0
4221,13,0,13,97,190,0,0,203,55,148,GXXXXXXXXXXXXXXXXXXXGXXXXXXXXXXXXXXXXXXXGXXXXXXXXXXXXXXXXXXXGXXXXXXXXXXXXXXXXXXXGXXXXXXXXXXXXXXXXXXXGXXXXXXXXXXXXXXXXXXXGXXXXXXXXXXXXXXXXXXXGXXXXXXXXXXXXXXXXXXXGXXXXXXXXXXXXXXXXXXXGXXXXXXXXXXXXXXXXXXXGXXXXXXXXXXXXXXXXXXXGXXXXXXXXXXXXXXXXXXXGXXXXXXXXXXXXXXXXXXX,0,300,0
4242,13,0,13,98,189,0,0,202,57,145,GXXXXXXXXXXXXXXXXXXXGXXXXXXXXXXXXXXXXXXXGXXXXXXXXXXXXXXXXXXXGXXXXXXXXXXXXXXXXXXXGXXXXXXXXXXXXXXXXXXXGXXXXXXXXXXXXXXXXXXXGXXXXXXXXXXXXXXXXXXXGXXXXXXXXXXXXXXXXXXXGXXXXXXXXXXXXXXXXXXXGXXXXXXXXXXXXXXXXXXXGXXXXXXXXXXXXXXXXXXXGXXXXXXXXXXXXXXXXXXXGXXXXXXXXXXXXXXXXXXX,0,300,0
4263,13,0,13,93,194,0,0,206,56,150,GXXXXXXXXXXXXXXXXXXXGXXXXXXXXXXXXXXXXXXXGXXXXXXXXXXXXXXXXXXXGXXXXXXXXXXXXXXXXXXXGXXXXXXXXXXXXXXXXXXXGXXXXXXXXXXXXXXXXXXXGXXXXXXXXXXXXXXXXXXXGXXXXXXXXXXXXXXXXXXXGXXXXXXXXXXXXXXXXXXXGXXXXXXXXXXXXXXXXXXXGXXXXXXXXXXXXXXXXXXXGXXXXXXXXXXXXXXXXXXXGXXXXXXXXXXXXXXXXXXX,0,300,0
4284,13,0,13,97,190,0,0,202,61,141,GXXXXXXXXXXXXXXXXXXXGXXXXXXXXXXXXXXXXXXXGXXXXXXXXXXXXXXXXXXXGXXXXXXXXXXXXXXXXXXXGXXXXXXXXXXXXXXXXXXXGXXXXXXXXXXXXXXXXXXXGXXXXXXXXXXXXXXXXXXXGXXXXXXXXXXXXXXXXXXXGXXXXXXXXXXXXXXXXXXXGXXXXXXXXXXXXXXXXXXXGXXXXXXXXXXXXXXXXXXXGXXXXXXXXXXXXXXXXXXXGXXXXXXXXXXXXXXXXXXX,0,300,0

4305,13,0,13,102,185,0,0,198,53,145,GXXXXXXXXXXXXXXXXXXXGXXXXXXXXXXXXXXXXXXXGXXXXXXXXXXXXXXXXXXXGXXXXXXXXXXXXXXXXXXXGXXXXXXXXXXXXXXXXXXXGXXXXXXXXXXXXXXXXXXXGXXXXXXXXXXXXXXXXXXXGXXXXXXXXXXXXXXXXXXXGXXXXXXXXXXXXXXXXXXXGXXXXXXXXXXXXXXXXXXXGXXXXXXXXXXXXXXXXXXXGXXXXXXXXXXXXXXXXXXXGXXXXXXXXXXXXXXXXXXX,0,300,0
4326,13,0,13,102,185,0,0,198,50,148,GXXXXXXXXXXXXXXXXXXXGXXXXXXXXXXXXXXXXXXXGXXXXXXXXXXXXXXXXXXXGXXXXXXXXXXXXXXXXXXXGXXXXXXXXXXXXXXXXXXXGXXXXXXXXXXXXXXXXXXXGXXXXXXXXXXXXXXXXXXXGXXXXXXXXXXXXXXXXXXXGXXXXXXXXXXXXXXXXXXXGXXXXXXXXXXXXXXXXXXXGXXXXXXXXXXXXXXXXXXXGXXXXXXXXXXXXXXXXXXXGXXXXXXXXXXXXXXXXXXX,0,300,0
4347,13,0,13,98,189,0,0,201,52,149,GXXXXXXXXXXXXXXXXXXXGXXXXXXXXXXXXXXXXXXXGXXXXXXXXXXXXXXXXXXXGXXXXXXXXXXXXXXXXXXXGXXXXXXXXXXXXXXXXXXXGXXXXXXXXXXXXXXXXXXXGXXXXXXXXXXXXXXXXXXXGXXXXXXXXXXXXXXXXXXXGXXXXXXXXXXXXXXXXXXXGXXXXXXXXXXXXXXXXXXXGXXXXXXXXXXXXXXXXXXXGXXXXXXXXXXXXXXXXXXXGXXXXXXXXXXXXXXXXXXX,0,300,0
4368,13,0,13,94,193,0,0,205,54,151,GXXXXXXXXXXXXXXXXXXXGXXXXXXXXXXXXXXXXXXXGXXXXXXXXXXXXXXXXXXXGXXXXXXXXXXXXXXXXXXXGXXXXXXXXXXXXXXXXXXXGXXXXXXXXXXXXXXXXXXXGXXXXXXXXXXXXXXXXXXXGXXXXXXXXXXXXXXXXXXXGXXXXXXXXXXXXXXXXXXXGXXXXXXXXXXXXXXXXXXXGXXXXXXXXXXXXXXXXXXXGXXXXXXXXXXXXXXXXXXXGXXXXXXXXXXXXXXXXXXX,0,300,0
4389,13,0,13,91,196,0,0,208,53,155,GXXXXXXXXXXXXXXXXXXXGXXXXXXXXXXXXXXXXXXXGXXXXXXXXXXXXXXXXXXXGXXXXXXXXXXXXXXXXXXXGXXXXXXXXXXXXXXXXXXXGXXXXXXXXXXXXXXXXXXXGXXXXXXXXXXXXXXXXXXXGXXXXXXXXXXXXXXXXXXXGXXXXXXXXXXXXXXXXXXXGXXXXXXXXXXXXXXXXXXXGXXXXXXXXXXXXXXXXXXXGXXXXXXXXXXXXXXXXXXXGXXXXXXXXXXXXXXXXXXX,0,300,0

4410,13,0,13,98,189,0,0,201,46,155,GXXXXXXXXXXXXXXXXXXXGXXXXXXXXXXXXXXXXXXXGXXXXXXXXXXXXXXXXXXXGXXXXXXXXXXXXXXXXXXXGXXXXXXXXXXXXXXXXXXXGXXXXXXXXXXXXXXXXXXXGXXXXXXXXXXXXXXXXXXXGXXXXXXXXXXXXXXXXXXXGXXXXXXXXXXXXXXXXXXXGXXXXXXXXXXXXXXXXXXXGXXXXXXXXXXXXXXXXXXXGXXXXXXXXXXXXXXXXXXXGXXXXXXXXXXXXXXXXXXX,0,300,0
4431,13,0,13,97,190,0,0,202,50,152,GXXXXXXXXXXXXXXXXXXXGXXXXXXXXXXXXXXXXXXXGXXXXXXXXXXXXXXXXXXXGXXXXXXXXXXXXXXXXXXXGXXXXXXXXXXXXXXXXXXXGXXXXXXXXXXXXXXXXXXXGXXXXXXXXXXXXXXXXXXXGXXXXXXXXXXXXXXXXXXXGXXXXXXXXXXXXXXXXXXXGXXXXXXXXXXXXXXXXXXXGXXXXXXXXXXXXXXXXXXXGXXXXXXXXXXXXXXXXXXXGXXXXXXXXXXXXXXXXXXX,0,300,0
4452,13,0,13,94,193,0,0,204,48,156,GXXXXXXXXXXXXXXXXXXXGXXXXXXXXXXXXXXXXXXXGXXXXXXXXXXXXXXXXXXXGXXXXXXXXXXXXXXXXXXXGXXXXXXXXXXXXXXXXXXXGXXXXXXXXXXXXXXXXXXXGXXXXXXXXXXXXXXXXXXXGXXXXXXXXXXXXXXXXXXXGXXXXXXXXXXXXXXXXXXXGXXXXXXXXXXXXXXXXXXXGXXXXXXXXXXXXXXXXXXXGXXXXXXXXXXXXXXXXXXXGXXXXXXXXXXXXXXXXXXX,0,300,0
4473,14,1,13,88,198,0,0,211,49,162,GXXXXXXXXXXXXXXXXXXXGXXXXXXXXXXXXXXXXXXXGXXXXXXXXXXXXXXXXXXXGXXXXXXXXXXXXXXXXXXXGXXXXXXXXXXXXXXXXXXXGXXXXXXXXXXXXXXXXXXXGXXXXXXXXXXXXXXXXXXXGXXXXXXXXXXXXXXXXXXXGXXXXXXXXXXXXXXXXXXXGXXXXXXXXXXXXXXXXXXXGXXXXXXXXXXXXXXXXXXXGXXXXXXXXXXXXXXXXXXXGAXXXXXXXXXXXXXXXXXX,0,300,0
4494,14,1,13,85,201,0,0,213,50,163,GXXXXXXXXXXXXXXXXXXXGXXXXXXXXXXXXXXXXXXXGXXXXXXXXXXXXXXXXXXXGXXXXXXXXXXXXXXXXXXXGXXXXXXXXXXXXXXXXXXXGXXXXXXXXXXXXXXXXXXXGXXXXXXXXXXXXXXXXXXXGXXXXXXXXXXXXXXXXXXXGXXXXXXXXXXXXXXXXXXXGXXXXXXXXXXXXXXXXXXXGXXXXXXXXXXXXXXXXXXXGXXXXXXXXXXXXXXXXXXXGAXXXXXXXXXXXXXXXXXX,0,300,0

4515,14,1,13,88,198,0,0,210,47,163,GXXXXXXXXXXXXXXXXXXXGXXXXXXXXXXXXXXXXXXXGXXXXXXXXXXXXXXXXXXXGXXXXXXXXXXXXXXXXXXXGXXXXXXXXXXXXXXXXXXXGXXXXXXXXXXXXXXXXXXXGXXXXXXXXXXXXXXXXXXXGXXXXXXXXXXXXXXXXXXXGXXXXXXXXXXXXXXXXXXXGXXXXXXXXXXXXXXXXXXXGXXXXXXXXXXXXXXXXXXXGXXXXXXXXXXXXXXXXXXXGAXXXXXXXXXXXXXXXXXX,0,300,0
4536,14,1,13,86,200,0,0,212,47,165,GXXXXXXXXXXXXXXXXXXXGXXXXXXXXXXXXXXXXXXXGXXXXXXXXXXXXXXXXXXXGXXXXXXXXXXXXXXXXXXXGXXXXXXXXXXXXXXXXXXXGXXXXXXXXXXXXXXXXXXXGXXXXXXXXXXXXXXXXXXXGXXXXXXXXXXXXXXXXXXXGXXXXXXXXXXXXXXXXXXXGXXXXXXXXXXXXXXXXXXXGXXXXXXXXXXXXXXXXXXXGXXXXXXXXXXXXXXXXXXXGAXXXXXXXXXXXXXXXXXX,0,300,0
4557,14,1,13,82,204,0,0,216,53,163,GXXXXXXXXXXXXXXXXXXXGXXXXXXXXXXXXXXXXXXXGXXXXXXXXXXXXXXXXXXXGXXXXXXXXXXXXXXXXXXXGXXXXXXXXXXXXXXXXXXXGXXXXXXXXXXXXXXXXXXXGXXXXXXXXXXXXXXXXXXXGXXXXXXXXXXXXXXXXXXXGXXXXXXXXXXXXXXXXXXXGXXXXXXXXXXXXXXXXXXXGXXXXXXXXXXXXXXXXXXXGXXXXXXXXXXXXXXXXXXXGAXXXXXXXXXXXXXXXXXX,0,300,0
4578,14,1,13,84,202,0,0,214,48,166,GXXXXXXXXXXXXXXXXXXXGXXXXXXXXXXXXXXXXXXXGXXXXXXXXXXXXXXXXXXXGXXXXXXXXXXXXXXXXXXXGXXXXXXXXXXXXXXXXXXXGXXXXXXXXXXXXXXXXXXXGXXXXXXXXXXXXXXXXXXXGXXXXXXXXXXXXXXXXXXXGXXXXXXXXXXXXXXXXXXXGXXXXXXXXXXXXXXXXXXXGXXXXXXXXXXXXXXXXXXXGXXXXXXXXXXXXXXXXXXXGAXXXXXXXXXXXXXXXXXX,0,300,0
4599,15,2,13,80,205,0,0,217,56,161,GXXXXXXXXXXXXXXXXXXXGXXXXXXXXXXXXXXXXXXXGXXXXXXXXXXXXXXXXXXXGXXXXXXXXXXXXXXXXXXXGAXXXXXXXXXXXXXXXXXXGXXXXXXXXXXXXXXXXXXXGXXXXXXXXXXXXXXXXXXXGXXXXXXXXXXXXXXXXXXXGXXXXXXXXXXXXXXXXXXXGXXXXXXXXXXXXXXXXXXXGXXXXXXXXXXXXXXXXXXXGXXXXXXXXXXXXXXXXXXXGAXXXXXXXXXXXXXXXXXX,0,300,0

4620,15,2,13,87,198,0,0,210,54,156,GXXXXXXXXXXXXXXXXXXXGXXXXXXXXXXXXXXXXXXXGXXXXXXXXXXXXXXXXXXXGXXXXXXXXXXXXXXXXXXXGAXXXXXXXXXXXXXXXXXXGXXXXXXXXXXXXXXXXXXXGXXXXXXXXXXXXXXXXXXXGXXXXXXXXXXXXXXXXXXXGXXXXXXXXXXXXXXXXXXXGXXXXXXXXXXXXXXXXXXXGXXXXXXXXXXXXXXXXXXXGXXXXXXXXXXXXXXXXXXXGAXXXXXXXXXXXXXXXXXX,0,300,0
4641,15,2,13,87,198,0,0,210,50,160,GXXXXXXXXXXXXXXXXXXXGXXXXXXXXXXXXXXXXXXXGXXXXXXXXXXXXXXXXXXXGXXXXXXXXXXXXXXXXXXXGAXXXXXXXXXXXXXXXXXXGXXXXXXXXXXXXXXXXXXXGXXXXXXXXXXXXXXXXXXXGXXXXXXXXXXXXXXXXXXXGXXXXXXXXXXXXXXXXXXXGXXXXXXXXXXXXXXXXXXXGXXXXXXXXXXXXXXXXXXXGXXXXXXXXXXXXXXXXXXXGAXXXXXXXXXXXXXXXXXX,0,300,0
4662,15,2,13,90,195,0,0,207,48,159,GXXXXXXXXXXXXXXXXXXXGXXXXXXXXXXXXXXXXXXXGXXXXXXXXXXXXXXXXXXXGXXXXXXXXXXXXXXXXXXXGAXXXXXXXXXXXXXXXXXXGXXXXXXXXXXXXXXXXXXXGXXXXXXXXXXXXXXXXXXXGXXXXXXXXXXXXXXXXXXXGXXXXXXXXXXXXXXXXXXXGXXXXXXXXXXXXXXXXXXXGXXXXXXXXXXXXXXXXXXXGXXXXXXXXXXXXXXXXXXXGAXXXXXXXXXXXXXXXXXX,0,300,0
4683,15,2,13,86,199,0,0,212,41,171,GXXXXXXXXXXXXXXXXXXXGXXXXXXXXXXXXXXXXXXXGXXXXXXXXXXXXXXXXXXXGXXXXXXXXXXXXXXXXXXXGAXXXXXXXXXXXXXXXXXXGXXXXXXXXXXXXXXXXXXXGXXXXXXXXXXXXXXXXXXXGXXXXXXXXXXXXXXXXXXXGXXXXXXXXXXXXXXXXXXXGXXXXXXXXXXXXXXXXXXXGXXXXXXXXXXXXXXXXXXXGXXXXXXXXXXXXXXXXXXXGAXXXXXXXXXXXXXXXXXX,0,300,0
4704,15,2,13,81,204,0,0,217,48,169,GXXXXXXXXXXXXXXXXXXXGXXXXXXXXXXXXXXXXXXXGXXXXXXXXXXXXXXXXXXXGXXXXXXXXXXXXXXXXXXXGAXXXXXXXXXXXXXXXXXXGXXXXXXXXXXXXXXXXXXXGXXXXXXXXXXXXXXXXXXXGXXXXXXXXXXXXXXXXXXXGXXXXXXXXXXXXXXXXXXXGXXXXXXXXXXXXXXXXXXXGXXXXXXXXXXXXXXXXXXXGXXXXXXXXXXXXXXXXXXXGAXXXXXXXXXXXXXXXXXX,0,300,0

4725,16,3,13,81,203,0,0,216,52,164,GXXXXXXXXXXXXXXXXXXXGXXXXXXXXXXXXXXXXXXXGXXXXXXXXXXXXXXXXXXXGXXXXXXXXXXXXXXXXXXXGAAXXXXXXXXXXXXXXXXXGXXXXXXXXXXXXXXXXXXXGXXXXXXXXXXXXXXXXXXXGXXXXXXXXXXXXXXXXXXXGXXXXXXXXXXXXXXXXXXXGXXXXXXXXXXXXXXXXXXXGXXXXXXXXXXXXXXXXXXXGXXXXXXXXXXXXXXXXXXXGAXXXXXXXXXXXXXXXXXX,0,300,0
4746,16,3,13,88,196,0,0,209,52,157,GXXXXXXXXXXXXXXXXXXXGXXXXXXXXXXXXXXXXXXXGXXXXXXXXXXXXXXXXXXXGXXXXXXXXXXXXXXXXXXXGAAXXXXXXXXXXXXXXXXXGXXXXXXXXXXXXXXXXXXXGXXXXXXXXXXXXXXXXXXXGXXXXXXXXXXXXXXXXXXXGXXXXXXXXXXXXXXXXXXXGXXXXXXXXXXXXXXXXXXXGXXXXXXXXXXXXXXXXXXXGXXXXXXXXXXXXXXXXXXXGAXXXXXXXXXXXXXXXXXX,0,300,0
4767,16,2,14,87,197,0,0,210,53,157,GXXXXXXXXXXXXXXXXXXXGXXXXXXXXXXXXXXXXXXXGXXXXXXXXXXXXXXXXXXXGXXXXXXXXXXXXXXXXXXXGAAXXXXXXXXXXXXXXXXXGXXXXXXXXXXXXXXXXXXXGXXXXXXXXXXXXXXXXXXXGXXXXXXXXXXXXXXXXXXXGXXXXXXXXXXXXXXXXXXXGXXXXXXXXXXXXXXXXXXXGXXXXXXXXXXXXXXXXXXXGXXXXXXXXXXXXXXXXXXXGOXXXXXXXXXXXXXXXXXX,0,300,0
4788,16,2,14,85,199,0,0,211,59,152,GXXXXXXXXXXXXXXXXXXXGXXXXXXXXXXXXXXXXXXXGXXXXXXXXXXXXXXXXXXXGXXXXXXXXXXXXXXXXXXXGAAXXXXXXXXXXXXXXXXXGXXXXXXXXXXXXXXXXXXXGXXXXXXXXXXXXXXXXXXXGXXXXXXXXXXXXXXXXXXXGXXXXXXXXXXXXXXXXXXXGXXXXXXXXXXXXXXXXXXXGXXXXXXXXXXXXXXXXXXXGXXXXXXXXXXXXXXXXXXXGOXXXXXXXXXXXXXXXXXX,0,300,0
4809,14,1,13,87,199,0,0,211,67,144,GXXXXXXXXXXXXXXXXXXXGXXXXXXXXXXXXXXXXXXXGXXXXXXXXXXXXXXXXXXXGXXXXXXXXXXXXXXXXXXXGAXXXXXXXXXXXXXXXXXXGXXXXXXXXXXXXXXXXXXXGXXXXXXXXXXXXXXXXXXXGXXXXXXXXXXXXXXXXXXXGXXXXXXXXXXXXXXXXXXXGXXXXXXXXXXXXXXXXXXXGXXXXXXXXXXXXXXXXXXXGXXXXXXXXXXXXXXXXXXXGXXXXXXXXXXXXXXXXXXX,0,300,0

4830,14,1,13,91,195,0,0,207,68,139,GXXXXXXXXXXXXXXXXXXXGXXXXXXXXXXXXXXXXXXXGXXXXXXXXXXXXXXXXXXXGXXXXXXXXXXXXXXXXXXXGAXXXXXXXXXXXXXXXXXXGXXXXXXXXXXXXXXXXXXXGXXXXXXXXXXXXXXXXXXXGXXXXXXXXXXXXXXXXXXXGXXXXXXXXXXXXXXXXXXXGXXXXXXXXXXXXXXXXXXXGXXXXXXXXXXXXXXXXXXXGXXXXXXXXXXXXXXXXXXXGXXXXXXXXXXXXXXXXXXX,0,300,0
4851,14,1,13,93,193,0,0,204,62,142,GXXXXXXXXXXXXXXXXXXXGAXXXXXXXXXXXXXXXXXXGXXXXXXXXXXXXXXXXXXXGXXXXXXXXXXXXXXXXXXXGXXXXXXXXXXXXXXXXXXXGXXXXXXXXXXXXXXXXXXXGXXXXXXXXXXXXXXXXXXXGXXXXXXXXXXXXXXXXXXXGXXXXXXXXXXXXXXXXXXXGXXXXXXXXXXXXXXXXXXXGXXXXXXXXXXXXXXXXXXXGXXXXXXXXXXXXXXXXXXXGXXXXXXXXXXXXXXXXXXX,0,300,0
4872,14,1,13,96,190,0,0,202,64,138,GXXXXXXXXXXXXXXXXXXXGAXXXXXXXXXXXXXXXXXXGXXXXXXXXXXXXXXXXXXXGXXXXXXXXXXXXXXXXXXXGXXXXXXXXXXXXXXXXXXXGXXXXXXXXXXXXXXXXXXXGXXXXXXXXXXXXXXXXXXXGXXXXXXXXXXXXXXXXXXXGXXXXXXXXXXXXXXXXXXXGXXXXXXXXXXXXXXXXXXXGXXXXXXXXXXXXXXXXXXXGXXXXXXXXXXXXXXXXXXXGXXXXXXXXXXXXXXXXXXX,0,300,0
4893,14,1,13,100,186,0,0,198,59,139,GXXXXXXXXXXXXXXXXXXXGAXXXXXXXXXXXXXXXXXXGXXXXXXXXXXXXXXXXXXXGXXXXXXXXXXXXXXXXXXXGXXXXXXXXXXXXXXXXXXXGXXXXXXXXXXXXXXXXXXXGXXXXXXXXXXXXXXXXXXXGXXXXXXXXXXXXXXXXXXXGXXXXXXXXXXXXXXXXXXXGXXXXXXXXXXXXXXXXXXXGXXXXXXXXXXXXXXXXXXXGXXXXXXXXXXXXXXXXXXXGXXXXXXXXXXXXXXXXXXX,0,300,0
4914,14,1,13,98,188,0,0,200,63,137,GXXXXXXXXXXXXXXXXXXXGAXXXXXXXXXXXXXXXXXXGXXXXXXXXXXXXXXXXXXXGXXXXXXXXXXXXXXXXXXXGXXXXXXXXXXXXXXXXXXXGXXXXXXXXXXXXXXXXXXXGXXXXXXXXXXXXXXXXXXXGXXXXXXXXXXXXXXXXXXXGXXXXXXXXXXXXXXXXXXXGXXXXXXXXXXXXXXXXXXXGXXXXXXXXXXXXXXXXXXXGXXXXXXXXXXXXXXXXXXXGXXXXXXXXXXXXXXXXXXX,0,300,0

4935,14,1,13,93,193,0,0,205,62,143,GXXXXXXXXXXXXXXXXXXXGAXXXXXXXXXXXXXXXXXXGXXXXXXXXXXXXXXXXXXXGXXXXXXXXXXXXXXXXXXXGXXXXXXXXXXXXXXXXXXXGXXXXXXXXXXXXXXXXXXXGXXXXXXXXXXXXXXXXXXXGXXXXXXXXXXXXXXXXXXXGXXXXXXXXXXXXXXXXXXXGXXXXXXXXXXXXXXXXXXXGXXXXXXXXXXXXXXXXXXXGXXXXXXXXXXXXXXXXXXXGXXXXXXXXXXXXXXXXXXX,0,300,0
4956,14,1,13,96,190,0,0,203,65,138,GXXXXXXXXXXXXXXXXXXXGAXXXXXXXXXXXXXXXXXXGXXXXXXXXXXXXXXXXXXXGXXXXXXXXXXXXXXXXXXXGXXXXXXXXXXXXXXXXXXXGXXXXXXXXXXXXXXXXXXXGXXXXXXXXXXXXXXXXXXXGXXXXXXXXXXXXXXXXXXXGXXXXXXXXXXXXXXXXXXXGXXXXXXXXXXXXXXXXXXXGXXXXXXXXXXXXXXXXXXXGXXXXXXXXXXXXXXXXXXXGXXXXXXXXXXXXXXXXXXX,0,300,0
4977,15,2,13,97,188,0,0,200,56,144,GXXXXXXXXXXXXXXXXXXXGAXXXXXXXXXXXXXXXXXXGXXXXXXXXXXXXXXXXXXXGXXXXXXXXXXXXXXXXXXXGAXXXXXXXXXXXXXXXXXXGXXXXXXXXXXXXXXXXXXXGXXXXXXXXXXXXXXXXXXXGXXXXXXXXXXXXXXXXXXXGXXXXXXXXXXXXXXXXXXXGXXXXXXXXXXXXXXXXXXXGXXXXXXXXXXXXXXXXXXXGXXXXXXXXXXXXXXXXXXXGXXXXXXXXXXXXXXXXXXX,0,300,0
4998,15,2,13,98,187,0,0,200,54,146,GXXXXXXXXXXXXXXXXXXXGAXXXXXXXXXXXXXXXXXXGXXXXXXXXXXXXXXXXXXXGXXXXXXXXXXXXXXXXXXXGAXXXXXXXXXXXXXXXXXXGXXXXXXXXXXXXXXXXXXXGXXXXXXXXXXXXXXXXXXXGXXXXXXXXXXXXXXXXXXXGXXXXXXXXXXXXXXXXXXXGXXXXXXXXXXXXXXXXXXXGXXXXXXXXXXXXXXXXXXXGXXXXXXXXXXXXXXXXXXXGXXXXXXXXXXXXXXXXXXX,0,300,0
5019,15,2,13,94,191,0,0,204,57,147,GXXXXXXXXXXXXXXXXXXXGAXXXXXXXXXXXXXXXXXXGXXXXXXXXXXXXXXXXXXXGXXXXXXXXXXXXXXXXXXXGAXXXXXXXXXXXXXXXXXXGXXXXXXXXXXXXXXXXXXXGXXXXXXXXXXXXXXXXXXXGXXXXXXXXXXXXXXXXXXXGXXXXXXXXXXXXXXXXXXXGXXXXXXXXXXXXXXXXXXXGXXXXXXXXXXXXXXXXXXXGXXXXXXXXXXXXXXXXXXXGXXXXXXXXXXXXXXXXXXX,0,300,0

5040,15,2,13,90,195,0,0,207,61,146,GXXXXXXXXXXXXXXXXXXXGAXXXXXXXXXXXXXXXXXXGXXXXXXXXXXXXXXXXXXXGXXXXXXXXXXXXXXXXXXXGAXXXXXXXXXXXXXXXXXXGXXXXXXXXXXXXXXXXXXXGXXXXXXXXXXXXXXXXXXXGXXXXXXXXXXXXXXXXXXXGXXXXXXXXXXXXXXXXXXXGXXXXXXXXXXXXXXXXXXXGXXXXXXXXXXXXXXXXXXXGXXXXXXXXXXXXXXXXXXXGXXXXXXXXXXXXXXXXXXX,0,300,0
5061,16,3,13,95,189,0,0,201,59,142,GXXXXXXXXXXXXXXXXXXXGAAXXXXXXXXXXXXXXXXXGXXXXXXXXXXXXXXXXXXXGXXXXXXXXXXXXXXXXXXXGAXXXXXXXXXXXXXXXXXXGXXXXXXXXXXXXXXXXXXXGXXXXXXXXXXXXXXXXXXXGXXXXXXXXXXXXXXXXXXXGXXXXXXXXXXXXXXXXXXXGXXXXXXXXXXXXXXXXXXXGXXXXXXXXXXXXXXXXXXXGXXXXXXXXXXXXXXXXXXXGXXXXXXXXXXXXXXXXXXX,0,300,0
5082,16,2,14,91,193,0,0,205,65,140,GXXXXXXXXXXXXXXXXXXXGOAXXXXXXXXXXXXXXXXXGXXXXXXXXXXXXXXXXXXXGXXXXXXXXXXXXXXXXXXXGAXXXXXXXXXXXXXXXXXXGXXXXXXXXXXXXXXXXXXXGXXXXXXXXXXXXXXXXXXXGXXXXXXXXXXXXXXXXXXXGXXXXXXXXXXXXXXXXXXXGXXXXXXXXXXXXXXXXXXXGXXXXXXXXXXXXXXXXXXXGXXXXXXXXXXXXXXXXXXXGXXXXXXXXXXXXXXXXXXX,0,300,0
5103,15,2,13,94,191,0,0,202,54,148,GXXXXXXXXXXXXXXXXXXXGXAXXXXXXXXXXXXXXXXXGXXXXXXXXXXXXXXXXXXXGXXXXXXXXXXXXXXXXXXXGAXXXXXXXXXXXXXXXXXXGXXXXXXXXXXXXXXXXXXXGXXXXXXXXXXXXXXXXXXXGXXXXXXXXXXXXXXXXXXXGXXXXXXXXXXXXXXXXXXXGXXXXXXXXXXXXXXXXXXXGXXXXXXXXXXXXXXXXXXXGXXXXXXXXXXXXXXXXXXXGXXXXXXXXXXXXXXXXXXX,0,300,0
5124,15,1,14,96,189,0,0,201,51,150,GXXXXXXXXXXXXXXXXXXXGXAXXXXXXXXXXXXXXXXXGXXXXXXXXXXXXXXXXXXXGXXXXXXXXXXXXXXXXXXXGOXXXXXXXXXXXXXXXXXXGXXXXXXXXXXXXXXXXXXXGXXXXXXXXXXXXXXXXXXXGXXXXXXXXXXXXXXXXXXXGXXXXXXXXXXXXXXXXXXXGXXXXXXXXXXXXXXXXXXXGXXXXXXXXXXXXXXXXXXXGXXXXXXXXXXXXXXXXXXXGXXXXXXXXXXXXXXXXXXX,0,300,0

5145,14,0,14,85,201,0,0,213,60,153,GXXXXXXXXXXXXXXXXXXXGXXXXXXXXXXXXXXXXXXXGXXXXXXXXXXXXXXXXXXXGXXXXXXXXXXXXXXXXXXXGOXXXXXXXXXXXXXXXXXXGXXXXXXXXXXXXXXXXXXXGXXXXXXXXXXXXXXXXXXXGXXXXXXXXXXXXXXXXXXXGXXXXXXXXXXXXXXXXXXXGXXXXXXXXXXXXXXXXXXXGXXXXXXXXXXXXXXXXXXXGXXXXXXXXXXXXXXXXXXXGXXXXXXXXXXXXXXXXXXX,0,300,0
5166,13,0,13,85,202,0,0,213,56,157,GXXXXXXXXXXXXXXXXXXXGXXXXXXXXXXXXXXXXXXXGXXXXXXXXXXXXXXXXXXXGXXXXXXXXXXXXXXXXXXXGXXXXXXXXXXXXXXXXXXXGXXXXXXXXXXXXXXXXXXXGXXXXXXXXXXXXXXXXXXXGXXXXXXXXXXXXXXXXXXXGXXXXXXXXXXXXXXXXXXXGXXXXXXXXXXXXXXXXXXXGXXXXXXXXXXXXXXXXXXXGXXXXXXXXXXXXXXXXXXXGXXXXXXXXXXXXXXXXXXX,0,300,0
5187,13,0,13,87,200,0,0,212,50,162,GXXXXXXXXXXXXXXXXXXXGXXXXXXXXXXXXXXXXXXXGXXXXXXXXXXXXXXXXXXXGXXXXXXXXXXXXXXXXXXXGXXXXXXXXXXXXXXXXXXXGXXXXXXXXXXXXXXXXXXXGXXXXXXXXXXXXXXXXXXXGXXXXXXXXXXXXXXXXXXXGXXXXXXXXXXXXXXXXXXXGXXXXXXXXXXXXXXXXXXXGXXXXXXXXXXXXXXXXXXXGXXXXXXXXXXXXXXXXXXXGXXXXXXXXXXXXXXXXXXX,0,300,0
5208,13,0,13,83,204,0,0,216,53,163,GXXXXXXXXXXXXXXXXXXXGXXXXXXXXXXXXXXXXXXXGXXXXXXXXXXXXXXXXXXXGXXXXXXXXXXXXXXXXXXXGXXXXXXXXXXXXXXXXXXXGXXXXXXXXXXXXXXXXXXXGXXXXXXXXXXXXXXXXXXXGXXXXXXXXXXXXXXXXXXXGXXXXXXXXXXXXXXXXXXXGXXXXXXXXXXXXXXXXXXXGXXXXXXXXXXXXXXXXXXXGXXXXXXXXXXXXXXXXXXXGXXXXXXXXXXXXXXXXXXX,0,300,0
5229,13,0,13,84,203,0,0,215,50,165,GXXXXXXXXXXXXXXXXXXXGXXXXXXXXXXXXXXXXXXXGXXXXXXXXXXXXXXXXXXXGXXXXXXXXXXXXXXXXXXXGXXXXXXXXXXXXXXXXXXXGXXXXXXXXXXXXXXXXXXXGXXXXXXXXXXXXXXXXXXXGXXXXXXXXXXXXXXXXXXXGXXXXXXXXXXXXXXXXXXXGXXXXXXXXXXXXXXXXXXXGXXXXXXXXXXXXXXXXXXXGXXXXXXXXXXXXXXXXXXXGXXXXXXXXXXXXXXXXXXX,0,300,0

5250,13,0,13,88,199,0,0,210,48,162,GXXXXXXXXXXXXXXXXXXXGXXXXXXXXXXXXXXXXXXXGXXXXXXXXXXXXXXXXXXXGXXXXXXXXXXXXXXXXXXXGXXXXXXXXXXXXXXXXXXXGXXXXXXXXXXXXXXXXXXXGXXXXXXXXXXXXXXXXXXXGXXXXXXXXXXXXXXXXXXXGXXXXXXXXXXXXXXXXXXXGXXXXXXXXXXXXXXXXXXXGXXXXXXXXXXXXXXXXXXXGXXXXXXXXXXXXXXXXXXXGXXXXXXXXXXXXXXXXXXX,0,300,0
5271,13,0,13,84,203,0,0,213,53,160,GXXXXXXXXXXXXXXXXXXXGXXXXXXXXXXXXXXXXXXXGXXXXXXXXXXXXXXXXXXXGXXXXXXXXXXXXXXXXXXXGXXXXXXXXXXXXXXXXXXXGXXXXXXXXXXXXXXXXXXXGXXXXXXXXXXXXXXXXXXXGXXXXXXXXXXXXXXXXXXXGXXXXXXXXXXXXXXXXXXXGXXXXXXXXXXXXXXXXXXXGXXXXXXXXXXXXXXXXXXXGXXXXXXXXXXXXXXXXXXXGXXXXXXXXXXXXXXXXXXX,0,300,0
5292,13,0,13,90,197,0,0,209,52,157,GXXXXXXXXXXXXXXXXXXXGXXXXXXXXXXXXXXXXXXXGXXXXXXXXXXXXXXXXXXXGXXXXXXXXXXXXXXXXXXXGXXXXXXXXXXXXXXXXXXXGXXXXXXXXXXXXXXXXXXXGXXXXXXXXXXXXXXXXXXXGXXXXXXXXXXXXXXXXXXXGXXXXXXXXXXXXXXXXXXXGXXXXXXXXXXXXXXXXXXXGXXXXXXXXXXXXXXXXXXXGXXXXXXXXXXXXXXXXXXXGXXXXXXXXXXXXXXXXXXX,0,300,0
5313,13,0,13,90,197,0,0,208,53,155,GXXXXXXXXXXXXXXXXXXXGXXXXXXXXXXXXXXXXXXXGXXXXXXXXXXXXXXXXXXXGXXXXXXXXXXXXXXXXXXXGXXXXXXXXXXXXXXXXXXXGXXXXXXXXXXXXXXXXXXXGXXXXXXXXXXXXXXXXXXXGXXXXXXXXXXXXXXXXXXXGXXXXXXXXXXXXXXXXXXXGXXXXXXXXXXXXXXXXXXXGXXXXXXXXXXXXXXXXXXXGXXXXXXXXXXXXXXXXXXXGXXXXXXXXXXXXXXXXXXX,0,300,0
5334,13,0,13,92,195,0,0,206,61,145,GXXXXXXXXXXXXXXXXXXXGXXXXXXXXXXXXXXXXXXXGXXXXXXXXXXXXXXXXXXXGXXXXXXXXXXXXXXXXXXXGXXXXXXXXXXXXXXXXXXXGXXXXXXXXXXXXXXXXXXXGXXXXXXXXXXXXXXXXXXXGXXXXXXXXXXXXXXXXXXXGXXXXXXXXXXXXXXXXXXXGXXXXXXXXXXXXXXXXXXXGXXXXXXXXXXXXXXXXXXXGXXXXXXXXXXXXXXXXXXXGXXXXXXXXXXXXXXXXXXX,0,300,0

5355,13,0,13,98,189,0,0,200,58,142,GXXXXXXXXXXXXXXXXXXXGXXXXXXXXXXXXXXXXXXXGXXXXXXXXXXXXXXXXXXXGXXXXXXXXXXXXXXXXXXXGXXXXXXXXXXXXXXXXXXXGXXXXXXXXXXXXXXXXXXXGXXXXXXXXXXXXXXXXXXXGXXXXXXXXXXXXXXXXXXXGXXXXXXXXXXXXXXXXXXXGXXXXXXXXXXXXXXXXXXXGXXXXXXXXXXXXXXXXXXXGXXXXXXXXXXXXXXXXXXXGXXXXXXXXXXXXXXXXXXX,0,300,0
5376,13,0,13,91,196,0,0,208,56,152,GXXXXXXXXXXXXXXXXXXXGXXXXXXXXXXXXXXXXXXXGXXXXXXXXXXXXXXXXXXXGXXXXXXXXXXXXXXXXXXXGXXXXXXXXXXXXXXXXXXXGXXXXXXXXXXXXXXXXXXXGXXXXXXXXXXXXXXXXXXXGXXXXXXXXXXXXXXXXXXXGXXXXXXXXXXXXXXXXXXXGXXXXXXXXXXXXXXXXXXXGXXXXXXXXXXXXXXXXXXXGXXXXXXXXXXXXXXXXXXXGXXXXXXXXXXXXXXXXXXX,0,300,0
5397,13,0,13,90,197,0,0,210,61,149,GXXXXXXXXXXXXXXXXXXXGXXXXXXXXXXXXXXXXXXXGXXXXXXXXXXXXXXXXXXXGXXXXXXXXXXXXXXXXXXXGXXXXXXXXXXXXXXXXXXXGXXXXXXXXXXXXXXXXXXXGXXXXXXXXXXXXXXXXXXXGXXXXXXXXXXXXXXXXXXXGXXXXXXXXXXXXXXXXXXXGXXXXXXXXXXXXXXXXXXXGXXXXXXXXXXXXXXXXXXXGXXXXXXXXXXXXXXXXXXXGXXXXXXXXXXXXXXXXXXX,0,300,0
5418,13,0,13,93,194,0,0,207,60,147,GXXXXXXXXXXXXXXXXXXXGXXXXXXXXXXXXXXXXXXXGXXXXXXXXXXXXXXXXXXXGXXXXXXXXXXXXXXXXXXXGXXXXXXXXXXXXXXXXXXXGXXXXXXXXXXXXXXXXXXXGXXXXXXXXXXXXXXXXXXXGXXXXXXXXXXXXXXXXXXXGXXXXXXXXXXXXXXXXXXXGXXXXXXXXXXXXXXXXXXXGXXXXXXXXXXXXXXXXXXXGXXXXXXXXXXXXXXXXXXXGXXXXXXXXXXXXXXXXXXX,0,300,0
5439,13,0,13,88,199,0,0,212,60,152,GXXXXXXXXXXXXXXXXXXXGXXXXXXXXXXXXXXXXXXXGXXXXXXXXXXXXXXXXXXXGXXXXXXXXXXXXXXXXXXXGXXXXXXXXXXXXXXXXXXXGXXXXXXXXXXXXXXXXXXXGXXXXXXXXXXXXXXXXXXXGXXXXXXXXXXXXXXXXXXXGXXXXXXXXXXXXXXXXXXXGXXXXXXXXXXXXXXXXXXXGXXXXXXXXXXXXXXXXXXXGXXXXXXXXXXXXXXXXXXXGXXXXXXXXXXXXXXXXXXX,0,300,0

5460,13,0,13,89,198,0,0,211,65,146,GXXXXXXXXXXXXXXXXXXXGXXXXXXXXXXXXXXXXXXXGXXXXXXXXXXXXXXXXXXXGXXXXXXXXXXXXXXXXXXXGXXXXXXXXXXXXXXXXXXXGXXXXXXXXXXXXXXXXXXXGXXXXXXXXXXXXXXXXXXXGXXXXXXXXXXXXXXXXXXXGXXXXXXXXXXXXXXXXXXXGXXXXXXXXXXXXXXXXXXXGXXXXXXXXXXXXXXXXXXXGXXXXXXXXXXXXXXXXXXXGXXXXXXXXXXXXXXXXXXX,0,300,0
5481,13,0,13,96,191,0,0,204,63,141,GXXXXXXXXXXXXXXXXXXXGXXXXXXXXXXXXXXXXXXXGXXXXXXXXXXXXXXXXXXXGXXXXXXXXXXXXXXXXXXXGXXXXXXXXXXXXXXXXXXXGXXXXXXXXXXXXXXXXXXXGXXXXXXXXXXXXXXXXXXXGXXXXXXXXXXXXXXXXXXXGXXXXXXXXXXXXXXXXXXXGXXXXXXXXXXXXXXXXXXXGXXXXXXXXXXXXXXXXXXXGXXXXXXXXXXXXXXXXXXXGXXXXXXXXXXXXXXXXXXX,0,300,0
5502,13,0,13,98,189,0,0,201,62,139,GXXXXXXXXXXXXXXXXXXXGXXXXXXXXXXXXXXXXXXXGXXXXXXXXXXXXXXXXXXXGXXXXXXXXXXXXXXXXXXXGXXXXXXXXXXXXXXXXXXXGXXXXXXXXXXXXXXXXXXXGXXXXXXXXXXXXXXXXXXXGXXXXXXXXXXXXXXXXXXXGXXXXXXXXXXXXXXXXXXXGXXXXXXXXXXXXXXXXXXXGXXXXXXXXXXXXXXXXXXXGXXXXXXXXXXXXXXXXXXXGXXXXXXXXXXXXXXXXXXX,0,300,0
5523,13,0,13,93,194,0,0,206,64,142,GXXXXXXXXXXXXXXXXXXXGXXXXXXXXXXXXXXXXXXXGXXXXXXXXXXXXXXXXXXXGXXXXXXXXXXXXXXXXXXXGXXXXXXXXXXXXXXXXXXXGXXXXXXXXXXXXXXXXXXXGXXXXXXXXXXXXXXXXXXXGXXXXXXXXXXXXXXXXXXXGXXXXXXXXXXXXXXXXXXXGXXXXXXXXXXXXXXXXXXXGXXXXXXXXXXXXXXXXXXXGXXXXXXXXXXXXXXXXXXXGXXXXXXXXXXXXXXXXXXX,0,300,0
5544,13,0,13,93,194,0,0,206,64,142,GXXXXXXXXXXXXXXXXXXXGXXXXXXXXXXXXXXXXXXXGXXXXXXXXXXXXXXXXXXXGXXXXXXXXXXXXXXXXXXXGXXXXXXXXXXXXXXXXXXXGXXXXXXXXXXXXXXXXXXXGXXXXXXXXXXXXXXXXXXXGXXXXXXXXXXXXXXXXXXXGXXXXXXXXXXXXXXXXXXXGXXXXXXXXXXXXXXXXXXXGXXXXXXXXXXXXXXXXXXXGXXXXXXXXXXXXXXXXXXXGXXXXXXXXXXXXXXXXXXX,0,300,0

5565,13,0,13,91,196,0,0,208,66,142,GXXXXXXXXXXXXXXXXXXXGXXXXXXXXXXXXXXXXXXXGXXXXXXXXXXXXXXXXXXXGXXXXXXXXXXXXXXXXXXXGXXXXXXXXXXXXXXXXXXXGXXXXXXXXXXXXXXXXXXXGXXXXXXXXXXXXXXXXXXXGXXXXXXXXXXXXXXXXXXXGXXXXXXXXXXXXXXXXXXXGXXXXXXXXXXXXXXXXXXXGXXXXXXXXXXXXXXXXXXXGXXXXXXXXXXXXXXXXXXXGXXXXXXXXXXXXXXXXXXX,0,300,0
5586,13,0,13,96,191,0,0,205,58,147,GXXXXXXXXXXXXXXXXXXXGXXXXXXXXXXXXXXXXXXXGXXXXXXXXXXXXXXXXXXXGXXXXXXXXXXXXXXXXXXXGXXXXXXXXXXXXXXXXXXXGXXXXXXXXXXXXXXXXXXXGXXXXXXXXXXXXXXXXXXXGXXXXXXXXXXXXXXXXXXXGXXXXXXXXXXXXXXXXXXXGXXXXXXXXXXXXXXXXXXXGXXXXXXXXXXXXXXXXXXXGXXXXXXXXXXXXXXXXXXXGXXXXXXXXXXXXXXXXXXX,0,300,0
5607,13,0,13,94,193,0,0,206,60,146,GXXXXXXXXXXXXXXXXXXXGXXXXXXXXXXXXXXXXXXXGXXXXXXXXXXXXXXXXXXXGXXXXXXXXXXXXXXXXXXXGXXXXXXXXXXXXXXXXXXXGXXXXXXXXXXXXXXXXXXXGXXXXXXXXXXXXXXXXXXXGXXXXXXXXXXXXXXXXXXXGXXXXXXXXXXXXXXXXXXXGXXXXXXXXXXXXXXXXXXXGXXXXXXXXXXXXXXXXXXXGXXXXXXXXXXXXXXXXXXXGXXXXXXXXXXXXXXXXXXX,0,300,0
5628,13,0,13,94,193,0,0,206,56,150,GXXXXXXXXXXXXXXXXXXXGXXXXXXXXXXXXXXXXXXXGXXXXXXXXXXXXXXXXXXXGXXXXXXXXXXXXXXXXXXXGXXXXXXXXXXXXXXXXXXXGXXXXXXXXXXXXXXXXXXXGXXXXXXXXXXXXXXXXXXXGXXXXXXXXXXXXXXXXXXXGXXXXXXXXXXXXXXXXXXXGXXXXXXXXXXXXXXXXXXXGXXXXXXXXXXXXXXXXXXXGXXXXXXXXXXXXXXXXXXXGXXXXXXXXXXXXXXXXXXX,0,300,0
5649,13,0,13,89,198,0,0,211,60,151,GXXXXXXXXXXXXXXXXXXXGXXXXXXXXXXXXXXXXXXXGXXXXXXXXXXXXXXXXXXXGXXXXXXXXXXXXXXXXXXXGXXXXXXXXXXXXXXXXXXXGXXXXXXXXXXXXXXXXXXXGXXXXXXXXXXXXXXXXXXXGXXXXXXXXXXXXXXXXXXXGXXXXXXXXXXXXXXXXXXXGXXXXXXXXXXXXXXXXXXXGXXXXXXXXXXXXXXXXXXXGXXXXXXXXXXXXXXXXXXXGXXXXXXXXXXXXXXXXXXX,0,300,0

5670,13,0,13,103,184,0,0,197,51,146,GXXXXXXXXXXXXXXXXXXXGXXXXXXXXXXXXXXXXXXXGXXXXXXXXXXXXXXXXXXXGXXXXXXXXXXXXXXXXXXXGXXXXXXXXXXXXXXXXXXXGXXXXXXXXXXXXXXXXXXXGXXXXXXXXXXXXXXXXXXXGXXXXXXXXXXXXXXXXXXXGXXXXXXXXXXXXXXXXXXXGXXXXXXXXXXXXXXXXXXXGXXXXXXXXXXXXXXXXXXXGXXXXXXXXXXXXXXXXXXXGXXXXXXXXXXXXXXXXXXX,0,300,0
5691,13,0,13,97,190,0,0,203,57,146,GXXXXXXXXXXXXXXXXXXXGXXXXXXXXXXXXXXXXXXXGXXXXXXXXXXXXXXXXXXXGXXXXXXXXXXXXXXXXXXXGXXXXXXXXXXXXXXXXXXXGXXXXXXXXXXXXXXXXXXXGXXXXXXXXXXXXXXXXXXXGXXXXXXXXXXXXXXXXXXXGXXXXXXXXXXXXXXXXXXXGXXXXXXXXXXXXXXXXXXXGXXXXXXXXXXXXXXXXXXXGXXXXXXXXXXXXXXXXXXXGXXXXXXXXXXXXXXXXXXX,0,300,0
5712,13,0,13,105,182,0,0,195,54,141,GXXXXXXXXXXXXXXXXXXXGXXXXXXXXXXXXXXXXXXXGXXXXXXXXXXXXXXXXXXXGXXXXXXXXXXXXXXXXXXXGXXXXXXXXXXXXXXXXXXXGXXXXXXXXXXXXXXXXXXXGXXXXXXXXXXXXXXXXXXXGXXXXXXXXXXXXXXXXXXXGXXXXXXXXXXXXXXXXXXXGXXXXXXXXXXXXXXXXXXXGXXXXXXXXXXXXXXXXXXXGXXXXXXXXXXXXXXXXXXXGXXXXXXXXXXXXXXXXXXX,0,300,0
5733,14,1,13,104,182,0,0,196,56,140,GXXXXXXXXXXXXXXXXXXXGXXXXXXXXXXXXXXXXXXXGXXXXXXXXXXXXXXXXXXXGXXXXXXXXXXXXXXXXXXXGXXXXXXXXXXXXXXXXXXXGXXXXXXXXXXXXXXXXXXXGXXXXXXXXXXXXXXXXXXXGXXXXXXXXXXXXXXXXXXXGXXXXXXXXXXXXXXXXXXXGXXXXXXXXXXXXXXXXXXXGXXXXXXXXXXXXXXXXXXXGXXXXXXXXXXXXXXXXXXXGAXXXXXXXXXXXXXXXXXX,0,300,0
5754,14,1,13,107,179,0,0,194,51,143,GXXXXXXXXXXXXXXXXXXXGXXXXXXXXXXXXXXXXXXXGXXXXXXXXXXXXXXXXXXXGXXXXXXXXXXXXXXXXXXXGXXXXXXXXXXXXXXXXXXXGXXXXXXXXXXXXXXXXXXXGXXXXXXXXXXXXXXXXXXXGXXXXXXXXXXXXXXXXXXXGXXXXXXXXXXXXXXXXXXXGXXXXXXXXXXXXXXXXXXXGXXXXXXXXXXXXXXXXXXXGXXXXXXXXXXXXXXXXXXXGAXXXXXXXXXXXXXXXXXX,0,300,0

5775,14,1,13,100,186,0,0,201,55,146,GXXXXXXXXXXXXXXXXXXXGXXXXXXXXXXXXXXXXXXXGXXXXXXXXXXXXXXXXXXXGXXXXXXXXXXXXXXXXXXXGXXXXXXXXXXXXXXXXXXXGXXXXXXXXXXXXXXXXXXXGXXXXXXXXXXXXXXXXXXXGXXXXXXXXXXXXXXXXXXXGXXXXXXXXXXXXXXXXXXXGXXXXXXXXXXXXXXXXXXXGXXXXXXXXXXXXXXXXXXXGXXXXXXXXXXXXXXXXXXXGAXXXXXXXXXXXXXXXXXX,0,300,0
5796,14,1,13,97,189,0,0,203,59,144,GXXXXXXXXXXXXXXXXXXXGXXXXXXXXXXXXXXXXXXXGXXXXXXXXXXXXXXXXXXXGXXXXXXXXXXXXXXXXXXXGXXXXXXXXXXXXXXXXXXXGXXXXXXXXXXXXXXXXXXXGXXXXXXXXXXXXXXXXXXXGXXXXXXXXXXXXXXXXXXXGXXXXXXXXXXXXXXXXXXXGXXXXXXXXXXXXXXXXXXXGXXXXXXXXXXXXXXXXXXXGXXXXXXXXXXXXXXXXXXXGAXXXXXXXXXXXXXXXXXX,0,300,0
5817,14,1,13,89,197,0,0,208,64,144,GXXXXXXXXXXXXXXXXXXXGXXXXXXXXXXXXXXXXXXXGXXXXXXXXXXXXXXXXXXXGXXXXXXXXXXXXXXXXXXXGXXXXXXXXXXXXXXXXXXXGXXXXXXXXXXXXXXXXXXXGXXXXXXXXXXXXXXXXXXXGXXXXXXXXXXXXXXXXXXXGXXXXXXXXXXXXXXXXXXXGXXXXXXXXXXXXXXXXXXXGXXXXXXXXXXXXXXXXXXXGXXXXXXXXXXXXXXXXXXXGAXXXXXXXXXXXXXXXXXX,0,300,0
5838,14,1,13,89,197,0,0,210,59,151,GXXXXXXXXXXXXXXXXXXXGXXXXXXXXXXXXXXXXXXXGXXXXXXXXXXXXXXXXXXXGXXXXXXXXXXXXXXXXXXXGXXXXXXXXXXXXXXXXXXXGXXXXXXXXXXXXXXXXXXXGXXXXXXXXXXXXXXXXXXXGXXXXXXXXXXXXXXXXXXXGXXXXXXXXXXXXXXXXXXXGXXXXXXXXXXXXXXXXXXXGXXXXXXXXXXXXXXXXXXXGXXXXXXXXXXXXXXXXXXXGAXXXXXXXXXXXXXXXXXX,0,300,0
5859,14,1,13,83,203,0,0,215,58,157,GXXXXXXXXXXXXXXXXXXXGXXXXXXXXXXXXXXXXXXXGXXXXXXXXXXXXXXXXXXXGXXXXXXXXXXXXXXXXXXXGXXXXXXXXXXXXXXXXXXXGXXXXXXXXXXXXXXXXXXXGXXXXXXXXXXXXXXXXXXXGXXXXXXXXXXXXXXXXXXXGXXXXXXXXXXXXXXXXXXXGXXXXXXXXXXXXXXXXXXXGXXXXXXXXXXXXXXXXXXXGXXXXXXXXXXXXXXXXXXXGAXXXXXXXXXXXXXXXXXX,0,300,0

5880,14,1,13,84,202,0,0,215,56,159,GXXXXXXXXXXXXXXXXXXXGXXXXXXXXXXXXXXXXXXXGXXXXXXXXXXXXXXXXXXXGXXXXXXXXXXXXXXXXXXXGXXXXXXXXXXXXXXXXXXXGXXXXXXXXXXXXXXXXXXXGXXXXXXXXXXXXXXXXXXXGXXXXXXXXXXXXXXXXXXXGXXXXXXXXXXXXXXXXXXXGXXXXXXXXXXXXXXXXXXXGXXXXXXXXXXXXXXXXXXXGXXXXXXXXXXXXXXXXXXXGAXXXXXXXXXXXXXXXXXX,0,300,0
5901,14,1,13,76,210,0,0,222,62,160,GXXXXXXXXXXXXXXXXXXXGXXXXXXXXXXXXXXXXXXXGXXXXXXXXXXXXXXXXXXXGXXXXXXXXXXXXXXXXXXXGXXXXXXXXXXXXXXXXXXXGXXXXXXXXXXXXXXXXXXXGXXXXXXXXXXXXXXXXXXXGXXXXXXXXXXXXXXXXXXXGXXXXXXXXXXXXXXXXXXXGXXXXXXXXXXXXXXXXXXXGXXXXXXXXXXXXXXXXXXXGXXXXXXXXXXXXXXXXXXXGAXXXXXXXXXXXXXXXXXX,0,300,0
5922,14,1,13,75,211,0,0,225,60,165,GXXXXXXXXXXXXXXXXXXXGXXXXXXXXXXXXXXXXXXXGXXXXXXXXXXXXXXXXXXXGXXXXXXXXXXXXXXXXXXXGXXXXXXXXXXXXXXXXXXXGXXXXXXXXXXXXXXXXXXXGXXXXXXXXXXXXXXXXXXXGXXXXXXXXXXXXXXXXXXXGXXXXXXXXXXXXXXXXXXXGXXXXXXXXXXXXXXXXXXXGXXXXXXXXXXXXXXXXXXXGXXXXXXXXXXXXXXXXXXXGAXXXXXXXXXXXXXXXXXX,0,300,0
5943,14,1,13,80,206,0,0,220,65,155,GXXXXXXXXXXXXXXXXXXXGXXXXXXXXXXXXXXXXXXXGXXXXXXXXXXXXXXXXXXXGXXXXXXXXXXXXXXXXXXXGXXXXXXXXXXXXXXXXXXXGXXXXXXXXXXXXXXXXXXXGXXXXXXXXXXXXXXXXXXXGXXXXXXXXXXXXXXXXXXXGXXXXXXXXXXXXXXXXXXXGXXXXXXXXXXXXXXXXXXXGXXXXXXXXXXXXXXXXXXXGXXXXXXXXXXXXXXXXXXXGAXXXXXXXXXXXXXXXXXX,0,300,0
5964,14,1,13,80,206,0,0,220,68,152,GXXXXXXXXXXXXXXXXXXXGXXXXXXXXXXXXXXXXXXXGXXXXXXXXXXXXXXXXXXXGXXXXXXXXXXXXXXXXXXXGXXXXXXXXXXXXXXXXXXXGXXXXXXXXXXXXXXXXXXXGXXXXXXXXXXXXXXXXXXXGXXXXXXXXXXXXXXXXXXXGXXXXXXXXXXXXXXXXXXXGXXXXXXXXXXXXXXXXXXXGXXXXXXXXXXXXXXXXXXXGXXXXXXXXXXXXXXXXXXXGAXXXXXXXXXXXXXXXXXX,0,300,0

5985,14,0,14,78,208,0,0,221,68,153,GXXXXXXXXXXXXXXXXXXXGXXXXXXXXXXXXXXXXXXXGXXXXXXXXXXXXXXXXXXXGXXXXXXXXXXXXXXXXXXXGXXXXXXXXXXXXXXXXXXXGXXXXXXXXXXXXXXXXXXXGXXXXXXXXXXXXXXXXXXXGXXXXXXXXXXXXXXXXXXXGXXXXXXXXXXXXXXXXXXXGXXXXXXXXXXXXXXXXXXXGXXXXXXXXXXXXXXXXXXXGXXXXXXXXXXXXXXXXXXXGOXXXXXXXXXXXXXXXXXX,0,300,0
6006,13,0,13,77,210,0,0,222,68,154,GXXXXXXXXXXXXXXXXXXXGXXXXXXXXXXXXXXXXXXXGXXXXXXXXXXXXXXXXXXXGXXXXXXXXXXXXXXXXXXXGXXXXXXXXXXXXXXXXXXXGXXXXXXXXXXXXXXXXXXXGXXXXXXXXXXXXXXXXXXXGXXXXXXXXXXXXXXXXXXXGXXXXXXXXXXXXXXXXXXXGXXXXXXXXXXXXXXXXXXXGXXXXXXXXXXXXXXXXXXXGXXXXXXXXXXXXXXXXXXXGXXXXXXXXXXXXXXXXXXX,0,300,0
6027,13,0,13,80,207,0,0,219,66,153,GXXXXXXXXXXXXXXXXXXXGXXXXXXXXXXXXXXXXXXXGXXXXXXXXXXXXXXXXXXXGXXXXXXXXXXXXXXXXXXXGXXXXXXXXXXXXXXXXXXXGXXXXXXXXXXXXXXXXXXXGXXXXXXXXXXXXXXXXXXXGXXXXXXXXXXXXXXXXXXXGXXXXXXXXXXXXXXXXXXXGXXXXXXXXXXXXXXXXXXXGXXXXXXXXXXXXXXXXXXXGXXXXXXXXXXXXXXXXXXXGXXXXXXXXXXXXXXXXXXX,0,300,0
6048,13,0,13,83,204,0,0,217,66,151,GXXXXXXXXXXXXXXXXXXXGXXXXXXXXXXXXXXXXXXXGXXXXXXXXXXXXXXXXXXXGXXXXXXXXXXXXXXXXXXXGXXXXXXXXXXXXXXXXXXXGXXXXXXXXXXXXXXXXXXXGXXXXXXXXXXXXXXXXXXXGXXXXXXXXXXXXXXXXXXXGXXXXXXXXXXXXXXXXXXXGXXXXXXXXXXXXXXXXXXXGXXXXXXXXXXXXXXXXXXXGXXXXXXXXXXXXXXXXXXXGXXXXXXXXXXXXXXXXXXX,0,300,0
6069,13,0,13,90,197,0,0,210,66,144,GXXXXXXXXXXXXXXXXXXXGXXXXXXXXXXXXXXXXXXXGXXXXXXXXXXXXXXXXXXXGXXXXXXXXXXXXXXXXXXXGXXXXXXXXXXXXXXXXXXXGXXXXXXXXXXXXXXXXXXXGXXXXXXXXXXXXXXXXXXXGXXXXXXXXXXXXXXXXXXXGXXXXXXXXXXXXXXXXXXXGXXXXXXXXXXXXXXXXXXXGXXXXXXXXXXXXXXXXXXXGXXXXXXXXXXXXXXXXXXXGXXXXXXXXXXXXXXXXXXX,0,300,0

6090,13,0,13,92,195,0,0,207,63,144,GXXXXXXXXXXXXXXXXXXXGXXXXXXXXXXXXXXXXXXXGXXXXXXXXXXXXXXXXXXXGXXXXXXXXXXXXXXXXXXXGXXXXXXXXXXXXXXXXXXXGXXXXXXXXXXXXXXXXXXXGXXXXXXXXXXXXXXXXXXXGXXXXXXXXXXXXXXXXXXXGXXXXXXXXXXXXXXXXXXXGXXXXXXXXXXXXXXXXXXXGXXXXXXXXXXXXXXXXXXXGXXXXXXXXXXXXXXXXXXXGXXXXXXXXXXXXXXXXXXX,0,300,0
6111,13,0,13,88,199,0,0,210,64,146,GXXXXXXXXXXXXXXXXXXXGXXXXXXXXXXXXXXXXXXXGXXXXXXXXXXXXXXXXXXXGXXXXXXXXXXXXXXXXXXXGXXXXXXXXXXXXXXXXXXXGXXXXXXXXXXXXXXXXXXXGXXXXXXXXXXXXXXXXXXXGXXXXXXXXXXXXXXXXXXXGXXXXXXXXXXXXXXXXXXXGXXXXXXXXXXXXXXXXXXXGXXXXXXXXXXXXXXXXXXXGXXXXXXXXXXXXXXXXXXXGXXXXXXXXXXXXXXXXXXX,0,300,0
6132,13,0,13,86,201,0,0,213,70,143,GXXXXXXXXXXXXXXXXXXXGXXXXXXXXXXXXXXXXXXXGXXXXXXXXXXXXXXXXXXXGXXXXXXXXXXXXXXXXXXXGXXXXXXXXXXXXXXXXXXXGXXXXXXXXXXXXXXXXXXXGXXXXXXXXXXXXXXXXXXXGXXXXXXXXXXXXXXXXXXXGXXXXXXXXXXXXXXXXXXXGXXXXXXXXXXXXXXXXXXXGXXXXXXXXXXXXXXXXXXXGXXXXXXXXXXXXXXXXXXXGXXXXXXXXXXXXXXXXXXX,0,300,0
6153,13,0,13,90,197,0,0,209,66,143,GXXXXXXXXXXXXXXXXXXXGXXXXXXXXXXXXXXXXXXXGXXXXXXXXXXXXXXXXXXXGXXXXXXXXXXXXXXXXXXXGXXXXXXXXXXXXXXXXXXXGXXXXXXXXXXXXXXXXXXXGXXXXXXXXXXXXXXXXXXXGXXXXXXXXXXXXXXXXXXXGXXXXXXXXXXXXXXXXXXXGXXXXXXXXXXXXXXXXXXXGXXXXXXXXXXXXXXXXXXXGXXXXXXXXXXXXXXXXXXXGXXXXXXXXXXXXXXXXXXX,0,300,0
6174,13,0,13,85,202,0,0,214,67,147,GXXXXXXXXXXXXXXXXXXXGXXXXXXXXXXXXXXXXXXXGXXXXXXXXXXXXXXXXXXXGXXXXXXXXXXXXXXXXXXXGXXXXXXXXXXXXXXXXXXXGXXXXXXXXXXXXXXXXXXXGXXXXXXXXXXXXXXXXXXXGXXXXXXXXXXXXXXXXXXXGXXXXXXXXXXXXXXXXXXXGXXXXXXXXXXXXXXXXXXXGXXXXXXXXXXXXXXXXXXXGXXXXXXXXXXXXXXXXXXXGXXXXXXXXXXXXXXXXXXX,0,300,0

6195,13,0,13,86,201,0,0,212,73,139,GXXXXXXXXXXXXXXXXXXXGXXXXXXXXXXXXXXXXXXXGXXXXXXXXXXXXXXXXXXXGXXXXXXXXXXXXXXXXXXXGXXXXXXXXXXXXXXXXXXXGXXXXXXXXXXXXXXXXXXXGXXXXXXXXXXXXXXXXXXXGXXXXXXXXXXXXXXXXXXXGXXXXXXXXXXXXXXXXXXXGXXXXXXXXXXXXXXXXXXXGXXXXXXXXXXXXXXXXXXXGXXXXXXXXXXXXXXXXXXXGXXXXXXXXXXXXXXXXXXX,0,300,0
6216,13,0,13,88,199,0,0,210,69,141,GXXXXXXXXXXXXXXXXXXXGXXXXXXXXXXXXXXXXXXXGXXXXXXXXXXXXXXXXXXXGXXXXXXXXXXXXXXXXXXXGXXXXXXXXXXXXXXXXXXXGXXXXXXXXXXXXXXXXXXXGXXXXXXXXXXXXXXXXXXXGXXXXXXXXXXXXXXXXXXXGXXXXXXXXXXXXXXXXXXXGXXXXXXXXXXXXXXXXXXXGXXXXXXXXXXXXXXXXXXXGXXXXXXXXXXXXXXXXXXXGXXXXXXXXXXXXXXXXXXX,0,300,0
6237,13,0,13,92,195,0,0,207,66,141,GXXXXXXXXXXXXXXXXXXXGXXXXXXXXXXXXXXXXXXXGXXXXXXXXXXXXXXXXXXXGXXXXXXXXXXXXXXXXXXXGXXXXXXXXXXXXXXXXXXXGXXXXXXXXXXXXXXXXXXXGXXXXXXXXXXXXXXXXXXXGXXXXXXXXXXXXXXXXXXXGXXXXXXXXXXXXXXXXXXXGXXXXXXXXXXXXXXXXXXXGXXXXXXXXXXXXXXXXXXXGXXXXXXXXXXXXXXXXXXXGXXXXXXXXXXXXXXXXXXX,0,300,0
6258,13,0,13,88,199,0,0,211,71,140,GXXXXXXXXXXXXXXXXXXXGXXXXXXXXXXXXXXXXXXXGXXXXXXXXXXXXXXXXXXXGXXXXXXXXXXXXXXXXXXXGXXXXXXXXXXXXXXXXXXXGXXXXXXXXXXXXXXXXXXXGXXXXXXXXXXXXXXXXXXXGXXXXXXXXXXXXXXXXXXXGXXXXXXXXXXXXXXXXXXXGXXXXXXXXXXXXXXXXXXXGXXXXXXXXXXXXXXXXXXXGXXXXXXXXXXXXXXXXXXXGXXXXXXXXXXXXXXXXXXX,0,300,0
6279,13,0,13,90,197,0,0,209,65,144,GXXXXXXXXXXXXXXXXXXXGXXXXXXXXXXXXXXXXXXXGXXXXXXXXXXXXXXXXXXXGXXXXXXXXXXXXXXXXXXXGXXXXXXXXXXXXXXXXXXXGXXXXXXXXXXXXXXXXXXXGXXXXXXXXXXXXXXXXXXXGXXXXXXXXXXXXXXXXXXXGXXXXXXXXXXXXXXXXXXXGXXXXXXXXXXXXXXXXXXXGXXXXXXXXXXXXXXXXXXXGXXXXXXXXXXXXXXXXXXXGXXXXXXXXXXXXXXXXXXX,0,300,0

6300,13,0,13,90,197,0,0,209,65,144,GXXXXXXXXXXXXXXXXXXXGXXXXXXXXXXXXXXXXXXXGXXXXXXXXXXXXXXXXXXXGXXXXXXXXXXXXXXXXXXXGXXXXXXXXXXXXXXXXXXXGXXXXXXXXXXXXXXXXXXXGXXXXXXXXXXXXXXXXXXXGXXXXXXXXXXXXXXXXXXXGXXXXXXXXXXXXXXXXXXXGXXXXXXXXXXXXXXXXXXXGXXXXXXXXXXXXXXXXXXXGXXXXXXXXXXXXXXXXXXXGXXXXXXXXXXXXXXXXXXX,0,300,0
6321,13,0,13,83,204,0,0,214,67,147,GXXXXXXXXXXXXXXXXXXXGXXXXXXXXXXXXXXXXXXXGXXXXXXXXXXXXXXXXXXXGXXXXXXXXXXXXXXXXXXXGXXXXXXXXXXXXXXXXXXXGXXXXXXXXXXXXXXXXXXXGXXXXXXXXXXXXXXXXXXXGXXXXXXXXXXXXXXXXXXXGXXXXXXXXXXXXXXXXXXXGXXXXXXXXXXXXXXXXXXXGXXXXXXXXXXXXXXXXXXXGXXXXXXXXXXXXXXXXXXXGXXXXXXXXXXXXXXXXXXX,0,300,0
6342,13,0,13,84,203,0,0,215,69,146,GXXXXXXXXXXXXXXXXXXXGXXXXXXXXXXXXXXXXXXXGXXXXXXXXXXXXXXXXXXXGXXXXXXXXXXXXXXXXXXXGXXXXXXXXXXXXXXXXXXXGXXXXXXXXXXXXXXXXXXXGXXXXXXXXXXXXXXXXXXXGXXXXXXXXXXXXXXXXXXXGXXXXXXXXXXXXXXXXXXXGXXXXXXXXXXXXXXXXXXXGXXXXXXXXXXXXXXXXXXXGXXXXXXXXXXXXXXXXXXXGXXXXXXXXXXXXXXXXXXX,0,300,0
6363,13,0,13,84,203,0,0,215,69,146,GXXXXXXXXXXXXXXXXXXXGXXXXXXXXXXXXXXXXXXXGXXXXXXXXXXXXXXXXXXXGXXXXXXXXXXXXXXXXXXXGXXXXXXXXXXXXXXXXXXXGXXXXXXXXXXXXXXXXXXXGXXXXXXXXXXXXXXXXXXXGXXXXXXXXXXXXXXXXXXXGXXXXXXXXXXXXXXXXXXXGXXXXXXXXXXXXXXXXXXXGXXXXXXXXXXXXXXXXXXXGXXXXXXXXXXXXXXXXXXXGXXXXXXXXXXXXXXXXXXX,0,300,0
6384,13,0,13,89,198,0,0,211,69,142,GXXXXXXXXXXXXXXXXXXXGXXXXXXXXXXXXXXXXXXXGXXXXXXXXXXXXXXXXXXXGXXXXXXXXXXXXXXXXXXXGXXXXXXXXXXXXXXXXXXXGXXXXXXXXXXXXXXXXXXXGXXXXXXXXXXXXXXXXXXXGXXXXXXXXXXXXXXXXXXXGXXXXXXXXXXXXXXXXXXXGXXXXXXXXXXXXXXXXXXXGXXXXXXXXXXXXXXXXXXXGXXXXXXXXXXXXXXXXXXXGXXXXXXXXXXXXXXXXXXX,0,300,0

6405,13,0,13,85,202,0,0,215,69,146,GXXXXXXXXXXXXXXXXXXXGXXXXXXXXXXXXXXXXXXXGXXXXXXXXXXXXXXXXXXXGXXXXXXXXXXXXXXXXXXXGXXXXXXXXXXXXXXXXXXXGXXXXXXXXXXXXXXXXXXXGXXXXXXXXXXXXXXXXXXXGXXXXXXXXXXXXXXXXXXXGXXXXXXXXXXXXXXXXXXXGXXXXXXXXXXXXXXXXXXXGXXXXXXXXXXXXXXXXXXXGXXXXXXXXXXXXXXXXXXXGXXXXXXXXXXXXXXXXXXX,0,300,0
6426,13,0,13,88,199,0,0,212,66,146,GXXXXXXXXXXXXXXXXXXXGXXXXXXXXXXXXXXXXXXXGXXXXXXXXXXXXXXXXXXXGXXXXXXXXXXXXXXXXXXXGXXXXXXXXXXXXXXXXXXXGXXXXXXXXXXXXXXXXXXXGXXXXXXXXXXXXXXXXXXXGXXXXXXXXXXXXXXXXXXXGXXXXXXXXXXXXXXXXXXXGXXXXXXXXXXXXXXXXXXXGXXXXXXXXXXXXXXXXXXXGXXXXXXXXXXXXXXXXXXXGXXXXXXXXXXXXXXXXXXX,0,300,0
6447,13,0,13,91,196,0,0,209,69,140,GXXXXXXXXXXXXXXXXXXXGXXXXXXXXXXXXXXXXXXXGXXXXXXXXXXXXXXXXXXXGXXXXXXXXXXXXXXXXXXXGXXXXXXXXXXXXXXXXXXXGXXXXXXXXXXXXXXXXXXXGXXXXXXXXXXXXXXXXXXXGXXXXXXXXXXXXXXXXXXXGXXXXXXXXXXXXXXXXXXXGXXXXXXXXXXXXXXXXXXXGXXXXXXXXXXXXXXXXXXXGXXXXXXXXXXXXXXXXXXXGXXXXXXXXXXXXXXXXXXX,0,300,0
6468,13,0,13,99,188,0,0,201,68,133,GXXXXXXXXXXXXXXXXXXXGXXXXXXXXXXXXXXXXXXXGXXXXXXXXXXXXXXXXXXXGXXXXXXXXXXXXXXXXXXXGXXXXXXXXXXXXXXXXXXXGXXXXXXXXXXXXXXXXXXXGXXXXXXXXXXXXXXXXXXXGXXXXXXXXXXXXXXXXXXXGXXXXXXXXXXXXXXXXXXXGXXXXXXXXXXXXXXXXXXXGXXXXXXXXXXXXXXXXXXXGXXXXXXXXXXXXXXXXXXXGXXXXXXXXXXXXXXXXXXX,0,300,0
6489,13,0,13,99,188,0,0,200,65,135,GXXXXXXXXXXXXXXXXXXXGXXXXXXXXXXXXXXXXXXXGXXXXXXXXXXXXXXXXXXXGXXXXXXXXXXXXXXXXXXXGXXXXXXXXXXXXXXXXXXXGXXXXXXXXXXXXXXXXXXXGXXXXXXXXXXXXXXXXXXXGXXXXXXXXXXXXXXXXXXXGXXXXXXXXXXXXXXXXXXXGXXXXXXXXXXXXXXXXXXXGXXXXXXXXXXXXXXXXXXXGXXXXXXXXXXXXXXXXXXXGXXXXXXXXXXXXXXXXXXX,0,300,0

6510,13,0,13,98,189,0,0,203,66,137,GXXXXXXXXXXXXXXXXXXXGXXXXXXXXXXXXXXXXXXXGXXXXXXXXXXXXXXXXXXXGXXXXXXXXXXXXXXXXXXXGXXXXXXXXXXXXXXXXXXXGXXXXXXXXXXXXXXXXXXXGXXXXXXXXXXXXXXXXXXXGXXXXXXXXXXXXXXXXXXXGXXXXXXXXXXXXXXXXXXXGXXXXXXXXXXXXXXXXXXXGXXXXXXXXXXXXXXXXXXXGXXXXXXXXXXXXXXXXXXXGXXXXXXXXXXXXXXXXXXX,0,300,0
6531,13,0,13,95,192,0,0,205,67,138,GXXXXXXXXXXXXXXXXXXXGXXXXXXXXXXXXXXXXXXXGXXXXXXXXXXXXXXXXXXXGXXXXXXXXXXXXXXXXXXXGXXXXXXXXXXXXXXXXXXXGXXXXXXXXXXXXXXXXXXXGXXXXXXXXXXXXXXXXXXXGXXXXXXXXXXXXXXXXXXXGXXXXXXXXXXXXXXXXXXXGXXXXXXXXXXXXXXXXXXXGXXXXXXXXXXXXXXXXXXXGXXXXXXXXXXXXXXXXXXXGXXXXXXXXXXXXXXXXXXX,0,300,0
6552,13,0,13,96,191,0,0,203,63,140,GXXXXXXXXXXXXXXXXXXXGXXXXXXXXXXXXXXXXXXXGXXXXXXXXXXXXXXXXXXXGXXXXXXXXXXXXXXXXXXXGXXXXXXXXXXXXXXXXXXXGXXXXXXXXXXXXXXXXXXXGXXXXXXXXXXXXXXXXXXXGXXXXXXXXXXXXXXXXXXXGXXXXXXXXXXXXXXXXXXXGXXXXXXXXXXXXXXXXXXXGXXXXXXXXXXXXXXXXXXXGXXXXXXXXXXXXXXXXXXXGXXXXXXXXXXXXXXXXXXX,0,300,0
6573,13,0,13,87,200,0,0,211,67,144,GXXXXXXXXXXXXXXXXXXXGXXXXXXXXXXXXXXXXXXXGXXXXXXXXXXXXXXXXXXXGXXXXXXXXXXXXXXXXXXXGXXXXXXXXXXXXXXXXXXXGXXXXXXXXXXXXXXXXXXXGXXXXXXXXXXXXXXXXXXXGXXXXXXXXXXXXXXXXXXXGXXXXXXXXXXXXXXXXXXXGXXXXXXXXXXXXXXXXXXXGXXXXXXXXXXXXXXXXXXXGXXXXXXXXXXXXXXXXXXXGXXXXXXXXXXXXXXXXXXX,0,300,0
6594,13,0,13,82,205,0,0,217,64,153,GXXXXXXXXXXXXXXXXXXXGXXXXXXXXXXXXXXXXXXXGXXXXXXXXXXXXXXXXXXXGXXXXXXXXXXXXXXXXXXXGXXXXXXXXXXXXXXXXXXXGXXXXXXXXXXXXXXXXXXXGXXXXXXXXXXXXXXXXXXXGXXXXXXXXXXXXXXXXXXXGXXXXXXXXXXXXXXXXXXXGXXXXXXXXXXXXXXXXXXXGXXXXXXXXXXXXXXXXXXXGXXXXXXXXXXXXXXXXXXXGXXXXXXXXXXXXXXXXXXX,0,300,0

6615,13,0,13,83,204,0,0,216,67,149,GXXXXXXXXXXXXXXXXXXXGXXXXXXXXXXXXXXXXXXXGXXXXXXXXXXXXXXXXXXXGXXXXXXXXXXXXXXXXXXXGXXXXXXXXXXXXXXXXXXXGXXXXXXXXXXXXXXXXXXXGXXXXXXXXXXXXXXXXXXXGXXXXXXXXXXXXXXXXXXXGXXXXXXXXXXXXXXXXXXXGXXXXXXXXXXXXXXXXXXXGXXXXXXXXXXXXXXXXXXXGXXXXXXXXXXXXXXXXXXXGXXXXXXXXXXXXXXXXXXX,0,300,0
6636,13,0,13,86,201,0,0,212,64,148,GXXXXXXXXXXXXXXXXXXXGXXXXXXXXXXXXXXXXXXXGXXXXXXXXXXXXXXXXXXXGXXXXXXXXXXXXXXXXXXXGXXXXXXXXXXXXXXXXXXXGXXXXXXXXXXXXXXXXXXXGXXXXXXXXXXXXXXXXXXXGXXXXXXXXXXXXXXXXXXXGXXXXXXXXXXXXXXXXXXXGXXXXXXXXXXXXXXXXXXXGXXXXXXXXXXXXXXXXXXXGXXXXXXXXXXXXXXXXXXXGXXXXXXXXXXXXXXXXXXX,0,300,0
6657,13,0,13,84,203,0,0,215,63,152,GXXXXXXXXXXXXXXXXXXXGXXXXXXXXXXXXXXXXXXXGXXXXXXXXXXXXXXXXXXXGXXXXXXXXXXXXXXXXXXXGXXXXXXXXXXXXXXXXXXXGXXXXXXXXXXXXXXXXXXXGXXXXXXXXXXXXXXXXXXXGXXXXXXXXXXXXXXXXXXXGXXXXXXXXXXXXXXXXXXXGXXXXXXXXXXXXXXXXXXXGXXXXXXXXXXXXXXXXXXXGXXXXXXXXXXXXXXXXXXXGXXXXXXXXXXXXXXXXXXX,0,300,0
6678,13,0,13,83,204,0,0,216,69,147,GXXXXXXXXXXXXXXXXXXXGXXXXXXXXXXXXXXXXXXXGXXXXXXXXXXXXXXXXXXXGXXXXXXXXXXXXXXXXXXXGXXXXXXXXXXXXXXXXXXXGXXXXXXXXXXXXXXXXXXXGXXXXXXXXXXXXXXXXXXXGXXXXXXXXXXXXXXXXXXXGXXXXXXXXXXXXXXXXXXXGXXXXXXXXXXXXXXXXXXXGXXXXXXXXXXXXXXXXXXXGXXXXXXXXXXXXXXXXXXXGXXXXXXXXXXXXXXXXXXX,0,300,0
6699,13,0,13,86,201,0,0,212,71,141,GXXXXXXXXXXXXXXXXXXXGXXXXXXXXXXXXXXXXXXXGXXXXXXXXXXXXXXXXXXXGXXXXXXXXXXXXXXXXXXXGXXXXXXXXXXXXXXXXXXXGXXXXXXXXXXXXXXXXXXXGXXXXXXXXXXXXXXXXXXXGXXXXXXXXXXXXXXXXXXXGXXXXXXXXXXXXXXXXXXXGXXXXXXXXXXXXXXXXXXXGXXXXXXXXXXXXXXXXXXXGXXXXXXXXXXXXXXXXXXXGXXXXXXXXXXXXXXXXXXX,0,300,0

6720,13,0,13,90,197,0,0,209,65,144,GXXXXXXXXXXXXXXXXXXXGXXXXXXXXXXXXXXXXXXXGXXXXXXXXXXXXXXXXXXXGXXXXXXXXXXXXXXXXXXXGXXXXXXXXXXXXXXXXXXXGXXXXXXXXXXXXXXXXXXXGXXXXXXXXXXXXXXXXXXXGXXXXXXXXXXXXXXXXXXXGXXXXXXXXXXXXXXXXXXXGXXXXXXXXXXXXXXXXXXXGXXXXXXXXXXXXXXXXXXXGXXXXXXXXXXXXXXXXXXXGXXXXXXXXXXXXXXXXXXX,0,300,0
6741,13,0,13,90,197,0,0,209,63,146,GXXXXXXXXXXXXXXXXXXXGXXXXXXXXXXXXXXXXXXXGXXXXXXXXXXXXXXXXXXXGXXXXXXXXXXXXXXXXXXXGXXXXXXXXXXXXXXXXXXXGXXXXXXXXXXXXXXXXXXXGXXXXXXXXXXXXXXXXXXXGXXXXXXXXXXXXXXXXXXXGXXXXXXXXXXXXXXXXXXXGXXXXXXXXXXXXXXXXXXXGXXXXXXXXXXXXXXXXXXXGXXXXXXXXXXXXXXXXXXXGXXXXXXXXXXXXXXXXXXX,0,300,0
6762,13,0,13,91,196,0,0,208,66,142,GXXXXXXXXXXXXXXXXXXXGXXXXXXXXXXXXXXXXXXXGXXXXXXXXXXXXXXXXXXXGXXXXXXXXXXXXXXXXXXXGXXXXXXXXXXXXXXXXXXXGXXXXXXXXXXXXXXXXXXXGXXXXXXXXXXXXXXXXXXXGXXXXXXXXXXXXXXXXXXXGXXXXXXXXXXXXXXXXXXXGXXXXXXXXXXXXXXXXXXXGXXXXXXXXXXXXXXXXXXXGXXXXXXXXXXXXXXXXXXXGXXXXXXXXXXXXXXXXXXX,0,300,0
6783,13,0,13,92,195,0,0,207,67,140,GXXXXXXXXXXXXXXXXXXXGXXXXXXXXXXXXXXXXXXXGXXXXXXXXXXXXXXXXXXXGXXXXXXXXXXXXXXXXXXXGXXXXXXXXXXXXXXXXXXXGXXXXXXXXXXXXXXXXXXXGXXXXXXXXXXXXXXXXXXXGXXXXXXXXXXXXXXXXXXXGXXXXXXXXXXXXXXXXXXXGXXXXXXXXXXXXXXXXXXXGXXXXXXXXXXXXXXXXXXXGXXXXXXXXXXXXXXXXXXXGXXXXXXXXXXXXXXXXXXX,0,300,0
6804,13,0,13,91,196,0,0,207,71,136,GXXXXXXXXXXXXXXXXXXXGXXXXXXXXXXXXXXXXXXXGXXXXXXXXXXXXXXXXXXXGXXXXXXXXXXXXXXXXXXXGXXXXXXXXXXXXXXXXXXXGXXXXXXXXXXXXXXXXXXXGXXXXXXXXXXXXXXXXXXXGXXXXXXXXXXXXXXXXXXXGXXXXXXXXXXXXXXXXXXXGXXXXXXXXXXXXXXXXXXXGXXXXXXXXXXXXXXXXXXXGXXXXXXXXXXXXXXXXXXXGXXXXXXXXXXXXXXXXXXX,0,300,0

6825,13,0,13,90,197,0,0,209,66,143,GXXXXXXXXXXXXXXXXXXXGXXXXXXXXXXXXXXXXXXXGXXXXXXXXXXXXXXXXXXXGXXXXXXXXXXXXXXXXXXXGXXXXXXXXXXXXXXXXXXXGXXXXXXXXXXXXXXXXXXXGXXXXXXXXXXXXXXXXXXXGXXXXXXXXXXXXXXXXXXXGXXXXXXXXXXXXXXXXXXXGXXXXXXXXXXXXXXXXXXXGXXXXXXXXXXXXXXXXXXXGXXXXXXXXXXXXXXXXXXXGXXXXXXXXXXXXXXXXXXX,0,300,0
6846,14,1,13,87,199,0,0,210,67,143,GXXXXXXXXXXXXXXXXXXXGXXXXXXXXXXXXXXXXXXXGXXXXXXXXXXXXXXXXXXXGXXXXXXXXXXXXXXXXXXXGXXXXXXXXXXXXXXXXXXXGXXXXXXXXXXXXXXXXXXXGAXXXXXXXXXXXXXXXXXXGXXXXXXXXXXXXXXXXXXXGXXXXXXXXXXXXXXXXXXXGXXXXXXXXXXXXXXXXXXXGXXXXXXXXXXXXXXXXXXXGXXXXXXXXXXXXXXXXXXXGXXXXXXXXXXXXXXXXXXX,0,300,0
6867,16,3,13,83,201,0,0,212,67,145,GXXXXXXXXXXXXXXXXXXXGAXXXXXXXXXXXXXXXXXXGXXXXXXXXXXXXXXXXXXXGXXXXXXXXXXXXXXXXXXXGXXXXXXXXXXXXXXXXXXXGXXXXXXXXXXXXXXXXXXXGAXXXXXXXXXXXXXXXXXXGAXXXXXXXXXXXXXXXXXXGXXXXXXXXXXXXXXXXXXXGXXXXXXXXXXXXXXXXXXXGXXXXXXXXXXXXXXXXXXXGXXXXXXXXXXXXXXXXXXXGXXXXXXXXXXXXXXXXXXX,0,300,0
6888,16,3,13,85,199,0,0,211,67,144,GXXXXXXXXXXXXXXXXXXXGAXXXXXXXXXXXXXXXXXXGXXXXXXXXXXXXXXXXXXXGXXXXXXXXXXXXXXXXXXXGXXXXXXXXXXXXXXXXXXXGXXXXXXXXXXXXXXXXXXXGAXXXXXXXXXXXXXXXXXXGAXXXXXXXXXXXXXXXXXXGXXXXXXXXXXXXXXXXXXXGXXXXXXXXXXXXXXXXXXXGXXXXXXXXXXXXXXXXXXXGXXXXXXXXXXXXXXXXXXXGXXXXXXXXXXXXXXXXXXX,0,300,0
6909,15,2,13,87,198,0,0,209,71,138,GXXXXXXXXXXXXXXXXXXXGAXXXXXXXXXXXXXXXXXXGXXXXXXXXXXXXXXXXXXXGXXXXXXXXXXXXXXXXXXXGXXXXXXXXXXXXXXXXXXXGXXXXXXXXXXXXXXXXXXXGAXXXXXXXXXXXXXXXXXXGXXXXXXXXXXXXXXXXXXXGXXXXXXXXXXXXXXXXXXXGXXXXXXXXXXXXXXXXXXXGXXXXXXXXXXXXXXXXXXXGXXXXXXXXXXXXXXXXXXXGXXXXXXXXXXXXXXXXXXX,0,300,0

6930,15,1,14,84,201,0,0,214,77,137,GXXXXXXXXXXXXXXXXXXXGAXXXXXXXXXXXXXXXXXXGXXXXXXXXXXXXXXXXXXXGXXXXXXXXXXXXXXXXXXXGXXXXXXXXXXXXXXXXXXXGXXXXXXXXXXXXXXXXXXXGOXXXXXXXXXXXXXXXXXXGXXXXXXXXXXXXXXXXXXXGXXXXXXXXXXXXXXXXXXXGXXXXXXXXXXXXXXXXXXXGXXXXXXXXXXXXXXXXXXXGXXXXXXXXXXXXXXXXXXXGXXXXXXXXXXXXXXXXXXX,0,300,0
6951,14,1,13,84,202,0,0,213,72,141,GXXXXXXXXXXXXXXXXXXXGAXXXXXXXXXXXXXXXXXXGXXXXXXXXXXXXXXXXXXXGXXXXXXXXXXXXXXXXXXXGXXXXXXXXXXXXXXXXXXXGXXXXXXXXXXXXXXXXXXXGXXXXXXXXXXXXXXXXXXXGXXXXXXXXXXXXXXXXXXXGXXXXXXXXXXXXXXXXXXXGXXXXXXXXXXXXXXXXXXXGXXXXXXXXXXXXXXXXXXXGXXXXXXXXXXXXXXXXXXXGXXXXXXXXXXXXXXXXXXX,0,300,0
6972,14,1,13,80,206,0,0,220,78,142,GXXXXXXXXXXXXXXXXXXXGAXXXXXXXXXXXXXXXXXXGXXXXXXXXXXXXXXXXXXXGXXXXXXXXXXXXXXXXXXXGXXXXXXXXXXXXXXXXXXXGXXXXXXXXXXXXXXXXXXXGXXXXXXXXXXXXXXXXXXXGXXXXXXXXXXXXXXXXXXXGXXXXXXXXXXXXXXXXXXXGXXXXXXXXXXXXXXXXXXXGXXXXXXXXXXXXXXXXXXXGXXXXXXXXXXXXXXXXXXXGXXXXXXXXXXXXXXXXXXX,0,300,0
6993,14,1,13,76,210,0,0,223,76,147,GXXXXXXXXXXXXXXXXXXXGAXXXXXXXXXXXXXXXXXXGXXXXXXXXXXXXXXXXXXXGXXXXXXXXXXXXXXXXXXXGXXXXXXXXXXXXXXXXXXXGXXXXXXXXXXXXXXXXXXXGXXXXXXXXXXXXXXXXXXXGXXXXXXXXXXXXXXXXXXXGXXXXXXXXXXXXXXXXXXXGXXXXXXXXXXXXXXXXXXXGXXXXXXXXXXXXXXXXXXXGXXXXXXXXXXXXXXXXXXXGXXXXXXXXXXXXXXXXXXX,0,300,0
7014,14,1,13,81,205,0,0,219,70,149,GXXXXXXXXXXXXXXXXXXXGAXXXXXXXXXXXXXXXXXXGXXXXXXXXXXXXXXXXXXXGXXXXXXXXXXXXXXXXXXXGXXXXXXXXXXXXXXXXXXXGXXXXXXXXXXXXXXXXXXXGXXXXXXXXXXXXXXXXXXXGXXXXXXXXXXXXXXXXXXXGXXXXXXXXXXXXXXXXXXXGXXXXXXXXXXXXXXXXXXXGXXXXXXXXXXXXXXXXXXXGXXXXXXXXXXXXXXXXXXXGXXXXXXXXXXXXXXXXXXX,0,300,0

7035,14,0,14,85,201,0,0,214,62,152,GXXXXXXXXXXXXXXXXXXXGOXXXXXXXXXXXXXXXXXXGXXXXXXXXXXXXXXXXXXXGXXXXXXXXXXXXXXXXXXXGXXXXXXXXXXXXXXXXXXXGXXXXXXXXXXXXXXXXXXXGXXXXXXXXXXXXXXXXXXXGXXXXXXXXXXXXXXXXXXXGXXXXXXXXXXXXXXXXXXXGXXXXXXXXXXXXXXXXXXXGXXXXXXXXXXXXXXXXXXXGXXXXXXXXXXXXXXXXXXXGXXXXXXXXXXXXXXXXXXX,0,300,0
7056,13,0,13,84,203,0,0,215,63,152,GXXXXXXXXXXXXXXXXXXXGXXXXXXXXXXXXXXXXXXXGXXXXXXXXXXXXXXXXXXXGXXXXXXXXXXXXXXXXXXXGXXXXXXXXXXXXXXXXXXXGXXXXXXXXXXXXXXXXXXXGXXXXXXXXXXXXXXXXXXXGXXXXXXXXXXXXXXXXXXXGXXXXXXXXXXXXXXXXXXXGXXXXXXXXXXXXXXXXXXXGXXXXXXXXXXXXXXXXXXXGXXXXXXXXXXXXXXXXXXXGXXXXXXXXXXXXXXXXXXX,0,300,0
7077,13,0,13,82,205,0,0,216,65,151,GXXXXXXXXXXXXXXXXXXXGXXXXXXXXXXXXXXXXXXXGXXXXXXXXXXXXXXXXXXXGXXXXXXXXXXXXXXXXXXXGXXXXXXXXXXXXXXXXXXXGXXXXXXXXXXXXXXXXXXXGXXXXXXXXXXXXXXXXXXXGXXXXXXXXXXXXXXXXXXXGXXXXXXXXXXXXXXXXXXXGXXXXXXXXXXXXXXXXXXXGXXXXXXXXXXXXXXXXXXXGXXXXXXXXXXXXXXXXXXXGXXXXXXXXXXXXXXXXXXX,0,300,0
7098,13,0,13,80,207,0,0,219,68,151,GXXXXXXXXXXXXXXXXXXXGXXXXXXXXXXXXXXXXXXXGXXXXXXXXXXXXXXXXXXXGXXXXXXXXXXXXXXXXXXXGXXXXXXXXXXXXXXXXXXXGXXXXXXXXXXXXXXXXXXXGXXXXXXXXXXXXXXXXXXXGXXXXXXXXXXXXXXXXXXXGXXXXXXXXXXXXXXXXXXXGXXXXXXXXXXXXXXXXXXXGXXXXXXXXXXXXXXXXXXXGXXXXXXXXXXXXXXXXXXXGXXXXXXXXXXXXXXXXXXX,0,300,0
7119,13,0,13,83,204,0,0,215,63,152,GXXXXXXXXXXXXXXXXXXXGXXXXXXXXXXXXXXXXXXXGXXXXXXXXXXXXXXXXXXXGXXXXXXXXXXXXXXXXXXXGXXXXXXXXXXXXXXXXXXXGXXXXXXXXXXXXXXXXXXXGXXXXXXXXXXXXXXXXXXXGXXXXXXXXXXXXXXXXXXXGXXXXXXXXXXXXXXXXXXXGXXXXXXXXXXXXXXXXXXXGXXXXXXXXXXXXXXXXXXXGXXXXXXXXXXXXXXXXXXXGXXXXXXXXXXXXXXXXXXX,0,300,0

7140,13,0,13,85,202,0,0,214,66,148,GXXXXXXXXXXXXXXXXXXXGXXXXXXXXXXXXXXXXXXXGXXXXXXXXXXXXXXXXXXXGXXXXXXXXXXXXXXXXXXXGXXXXXXXXXXXXXXXXXXXGXXXXXXXXXXXXXXXXXXXGXXXXXXXXXXXXXXXXXXXGXXXXXXXXXXXXXXXXXXXGXXXXXXXXXXXXXXXXXXXGXXXXXXXXXXXXXXXXXXXGXXXXXXXXXXXXXXXXXXXGXXXXXXXXXXXXXXXXXXXGXXXXXXXXXXXXXXXXXXX,0,300,0
7161,13,0,13,84,203,0,0,215,66,149,GXXXXXXXXXXXXXXXXXXXGXXXXXXXXXXXXXXXXXXXGXXXXXXXXXXXXXXXXXXXGXXXXXXXXXXXXXXXXXXXGXXXXXXXXXXXXXXXXXXXGXXXXXXXXXXXXXXXXXXXGXXXXXXXXXXXXXXXXXXXGXXXXXXXXXXXXXXXXXXXGXXXXXXXXXXXXXXXXXXXGXXXXXXXXXXXXXXXXXXXGXXXXXXXXXXXXXXXXXXXGXXXXXXXXXXXXXXXXXXXGXXXXXXXXXXXXXXXXXXX,0,300,0
7182,13,0,13,86,201,0,0,213,64,149,GXXXXXXXXXXXXXXXXXXXGXXXXXXXXXXXXXXXXXXXGXXXXXXXXXXXXXXXXXXXGXXXXXXXXXXXXXXXXXXXGXXXXXXXXXXXXXXXXXXXGXXXXXXXXXXXXXXXXXXXGXXXXXXXXXXXXXXXXXXXGXXXXXXXXXXXXXXXXXXXGXXXXXXXXXXXXXXXXXXXGXXXXXXXXXXXXXXXXXXXGXXXXXXXXXXXXXXXXXXXGXXXXXXXXXXXXXXXXXXXGXXXXXXXXXXXXXXXXXXX,0,300,0
7203,13,0,13,87,200,0,0,211,63,148,GXXXXXXXXXXXXXXXXXXXGXXXXXXXXXXXXXXXXXXXGXXXXXXXXXXXXXXXXXXXGXXXXXXXXXXXXXXXXXXXGXXXXXXXXXXXXXXXXXXXGXXXXXXXXXXXXXXXXXXXGXXXXXXXXXXXXXXXXXXXGXXXXXXXXXXXXXXXXXXXGXXXXXXXXXXXXXXXXXXXGXXXXXXXXXXXXXXXXXXXGXXXXXXXXXXXXXXXXXXXGXXXXXXXXXXXXXXXXXXXGXXXXXXXXXXXXXXXXXXX,0,300,0
7224,13,0,13,87,200,0,0,212,64,148,GXXXXXXXXXXXXXXXXXXXGXXXXXXXXXXXXXXXXXXXGXXXXXXXXXXXXXXXXXXXGXXXXXXXXXXXXXXXXXXXGXXXXXXXXXXXXXXXXXXXGXXXXXXXXXXXXXXXXXXXGXXXXXXXXXXXXXXXXXXXGXXXXXXXXXXXXXXXXXXXGXXXXXXXXXXXXXXXXXXXGXXXXXXXXXXXXXXXXXXXGXXXXXXXXXXXXXXXXXXXGXXXXXXXXXXXXXXXXXXXGXXXXXXXXXXXXXXXXXXX,0,300,0

7245,13,0,13,89,198,0,0,210,74,136,GXXXXXXXXXXXXXXXXXXXGXXXXXXXXXXXXXXXXXXXGXXXXXXXXXXXXXXXXXXXGXXXXXXXXXXXXXXXXXXXGXXXXXXXXXXXXXXXXXXXGXXXXXXXXXXXXXXXXXXXGXXXXXXXXXXXXXXXXXXXGXXXXXXXXXXXXXXXXXXXGXXXXXXXXXXXXXXXXXXXGXXXXXXXXXXXXXXXXXXXGXXXXXXXXXXXXXXXXXXXGXXXXXXXXXXXXXXXXXXXGXXXXXXXXXXXXXXXXXXX,0,300,0
7266,13,0,13,88,199,0,0,211,76,135,GXXXXXXXXXXXXXXXXXXXGXXXXXXXXXXXXXXXXXXXGXXXXXXXXXXXXXXXXXXXGXXXXXXXXXXXXXXXXXXXGXXXXXXXXXXXXXXXXXXXGXXXXXXXXXXXXXXXXXXXGXXXXXXXXXXXXXXXXXXXGXXXXXXXXXXXXXXXXXXXGXXXXXXXXXXXXXXXXXXXGXXXXXXXXXXXXXXXXXXXGXXXXXXXXXXXXXXXXXXXGXXXXXXXXXXXXXXXXXXXGXXXXXXXXXXXXXXXXXXX,0,300,0
7287,13,0,13,92,195,0,0,207,73,134,GXXXXXXXXXXXXXXXXXXXGXXXXXXXXXXXXXXXXXXXGXXXXXXXXXXXXXXXXXXXGXXXXXXXXXXXXXXXXXXXGXXXXXXXXXXXXXXXXXXXGXXXXXXXXXXXXXXXXXXXGXXXXXXXXXXXXXXXXXXXGXXXXXXXXXXXXXXXXXXXGXXXXXXXXXXXXXXXXXXXGXXXXXXXXXXXXXXXXXXXGXXXXXXXXXXXXXXXXXXXGXXXXXXXXXXXXXXXXXXXGXXXXXXXXXXXXXXXXXXX,0,300,0
7308,13,0,13,87,200,0,0,212,72,140,GXXXXXXXXXXXXXXXXXXXGXXXXXXXXXXXXXXXXXXXGXXXXXXXXXXXXXXXXXXXGXXXXXXXXXXXXXXXXXXXGXXXXXXXXXXXXXXXXXXXGXXXXXXXXXXXXXXXXXXXGXXXXXXXXXXXXXXXXXXXGXXXXXXXXXXXXXXXXXXXGXXXXXXXXXXXXXXXXXXXGXXXXXXXXXXXXXXXXXXXGXXXXXXXXXXXXXXXXXXXGXXXXXXXXXXXXXXXXXXXGXXXXXXXXXXXXXXXXXXX,0,300,0
7329,13,0,13,87,200,0,0,213,69,144,GXXXXXXXXXXXXXXXXXXXGXXXXXXXXXXXXXXXXXXXGXXXXXXXXXXXXXXXXXXXGXXXXXXXXXXXXXXXXXXXGXXXXXXXXXXXXXXXXXXXGXXXXXXXXXXXXXXXXXXXGXXXXXXXXXXXXXXXXXXXGXXXXXXXXXXXXXXXXXXXGXXXXXXXXXXXXXXXXXXXGXXXXXXXXXXXXXXXXXXXGXXXXXXXXXXXXXXXXXXXGXXXXXXXXXXXXXXXXXXXGXXXXXXXXXXXXXXXXXXX,0,300,0

7350,13,0,13,90,197,0,0,208,67,141,GXXXXXXXXXXXXXXXXXXXGXXXXXXXXXXXXXXXXXXXGXXXXXXXXXXXXXXXXXXXGXXXXXXXXXXXXXXXXXXXGXXXXXXXXXXXXXXXXXXXGXXXXXXXXXXXXXXXXXXXGXXXXXXXXXXXXXXXXXXXGXXXXXXXXXXXXXXXXXXXGXXXXXXXXXXXXXXXXXXXGXXXXXXXXXXXXXXXXXXXGXXXXXXXXXXXXXXXXXXXGXXXXXXXXXXXXXXXXXXXGXXXXXXXXXXXXXXXXXXX,0,300,0
7371,13,0,13,91,196,0,0,208,67,141,GXXXXXXXXXXXXXXXXXXXGXXXXXXXXXXXXXXXXXXXGXXXXXXXXXXXXXXXXXXXGXXXXXXXXXXXXXXXXXXXGXXXXXXXXXXXXXXXXXXXGXXXXXXXXXXXXXXXXXXXGXXXXXXXXXXXXXXXXXXXGXXXXXXXXXXXXXXXXXXXGXXXXXXXXXXXXXXXXXXXGXXXXXXXXXXXXXXXXXXXGXXXXXXXXXXXXXXXXXXXGXXXXXXXXXXXXXXXXXXXGXXXXXXXXXXXXXXXXXXX,0,300,0
7392,13,0,13,87,200,0,0,212,72,140,GXXXXXXXXXXXXXXXXXXXGXXXXXXXXXXXXXXXXXXXGXXXXXXXXXXXXXXXXXXXGXXXXXXXXXXXXXXXXXXXGXXXXXXXXXXXXXXXXXXXGXXXXXXXXXXXXXXXXXXXGXXXXXXXXXXXXXXXXXXXGXXXXXXXXXXXXXXXXXXXGXXXXXXXXXXXXXXXXXXXGXXXXXXXXXXXXXXXXXXXGXXXXXXXXXXXXXXXXXXXGXXXXXXXXXXXXXXXXXXXGXXXXXXXXXXXXXXXXXXX,0,300,0
7413,13,0,13,83,204,0,0,215,75,140,GXXXXXXXXXXXXXXXXXXXGXXXXXXXXXXXXXXXXXXXGXXXXXXXXXXXXXXXXXXXGXXXXXXXXXXXXXXXXXXXGXXXXXXXXXXXXXXXXXXXGXXXXXXXXXXXXXXXXXXXGXXXXXXXXXXXXXXXXXXXGXXXXXXXXXXXXXXXXXXXGXXXXXXXXXXXXXXXXXXXGXXXXXXXXXXXXXXXXXXXGXXXXXXXXXXXXXXXXXXXGXXXXXXXXXXXXXXXXXXXGXXXXXXXXXXXXXXXXXXX,0,300,0
7434,13,0,13,86,201,0,0,213,76,137,GXXXXXXXXXXXXXXXXXXXGXXXXXXXXXXXXXXXXXXXGXXXXXXXXXXXXXXXXXXXGXXXXXXXXXXXXXXXXXXXGXXXXXXXXXXXXXXXXXXXGXXXXXXXXXXXXXXXXXXXGXXXXXXXXXXXXXXXXXXXGXXXXXXXXXXXXXXXXXXXGXXXXXXXXXXXXXXXXXXXGXXXXXXXXXXXXXXXXXXXGXXXXXXXXXXXXXXXXXXXGXXXXXXXXXXXXXXXXXXXGXXXXXXXXXXXXXXXXXXX,0,300,0

7455,13,0,13,87,200,0,0,212,76,136,GXXXXXXXXXXXXXXXXXXXGXXXXXXXXXXXXXXXXXXXGXXXXXXXXXXXXXXXXXXXGXXXXXXXXXXXXXXXXXXXGXXXXXXXXXXXXXXXXXXXGXXXXXXXXXXXXXXXXXXXGXXXXXXXXXXXXXXXXXXXGXXXXXXXXXXXXXXXXXXXGXXXXXXXXXXXXXXXXXXXGXXXXXXXXXXXXXXXXXXXGXXXXXXXXXXXXXXXXXXXGXXXXXXXXXXXXXXXXXXXGXXXXXXXXXXXXXXXXXXX,0,300,0
7476,13,0,13,86,201,0,0,212,74,138,GXXXXXXXXXXXXXXXXXXXGXXXXXXXXXXXXXXXXXXXGXXXXXXXXXXXXXXXXXXXGXXXXXXXXXXXXXXXXXXXGXXXXXXXXXXXXXXXXXXXGXXXXXXXXXXXXXXXXXXXGXXXXXXXXXXXXXXXXXXXGXXXXXXXXXXXXXXXXXXXGXXXXXXXXXXXXXXXXXXXGXXXXXXXXXXXXXXXXXXXGXXXXXXXXXXXXXXXXXXXGXXXXXXXXXXXXXXXXXXXGXXXXXXXXXXXXXXXXXXX,0,300,0
7497,13,0,13,86,201,0,0,211,69,142,GXXXXXXXXXXXXXXXXXXXGXXXXXXXXXXXXXXXXXXXGXXXXXXXXXXXXXXXXXXXGXXXXXXXXXXXXXXXXXXXGXXXXXXXXXXXXXXXXXXXGXXXXXXXXXXXXXXXXXXXGXXXXXXXXXXXXXXXXXXXGXXXXXXXXXXXXXXXXXXXGXXXXXXXXXXXXXXXXXXXGXXXXXXXXXXXXXXXXXXXGXXXXXXXXXXXXXXXXXXXGXXXXXXXXXXXXXXXXXXXGXXXXXXXXXXXXXXXXXXX,0,300,0
7518,13,0,13,85,202,0,0,214,70,144,GXXXXXXXXXXXXXXXXXXXGXXXXXXXXXXXXXXXXXXXGXXXXXXXXXXXXXXXXXXXGXXXXXXXXXXXXXXXXXXXGXXXXXXXXXXXXXXXXXXXGXXXXXXXXXXXXXXXXXXXGXXXXXXXXXXXXXXXXXXXGXXXXXXXXXXXXXXXXXXXGXXXXXXXXXXXXXXXXXXXGXXXXXXXXXXXXXXXXXXXGXXXXXXXXXXXXXXXXXXXGXXXXXXXXXXXXXXXXXXXGXXXXXXXXXXXXXXXXXXX,0,300,0
7539,13,0,13,90,197,0,0,209,70,139,GXXXXXXXXXXXXXXXXXXXGXXXXXXXXXXXXXXXXXXXGXXXXXXXXXXXXXXXXXXXGXXXXXXXXXXXXXXXXXXXGXXXXXXXXXXXXXXXXXXXGXXXXXXXXXXXXXXXXXXXGXXXXXXXXXXXXXXXXXXXGXXXXXXXXXXXXXXXXXXXGXXXXXXXXXXXXXXXXXXXGXXXXXXXXXXXXXXXXXXXGXXXXXXXXXXXXXXXXXXXGXXXXXXXXXXXXXXXXXXXGXXXXXXXXXXXXXXXXXXX,0,300,0

7560,13,0,13,92,195,0,0,207,68,139,GXXXXXXXXXXXXXXXXXXXGXXXXXXXXXXXXXXXXXXXGXXXXXXXXXXXXXXXXXXXGXXXXXXXXXXXXXXXXXXXGXXXXXXXXXXXXXXXXXXXGXXXXXXXXXXXXXXXXXXXGXXXXXXXXXXXXXXXXXXXGXXXXXXXXXXXXXXXXXXXGXXXXXXXXXXXXXXXXXXXGXXXXXXXXXXXXXXXXXXXGXXXXXXXXXXXXXXXXXXXGXXXXXXXXXXXXXXXXXXXGXXXXXXXXXXXXXXXXXXX,0,300,0
7581,13,0,13,87,200,0,0,212,71,141,GXXXXXXXXXXXXXXXXXXXGXXXXXXXXXXXXXXXXXXXGXXXXXXXXXXXXXXXXXXXGXXXXXXXXXXXXXXXXXXXGXXXXXXXXXXXXXXXXXXXGXXXXXXXXXXXXXXXXXXXGXXXXXXXXXXXXXXXXXXXGXXXXXXXXXXXXXXXXXXXGXXXXXXXXXXXXXXXXXXXGXXXXXXXXXXXXXXXXXXXGXXXXXXXXXXXXXXXXXXXGXXXXXXXXXXXXXXXXXXXGXXXXXXXXXXXXXXXXXXX,0,300,0
7602,13,0,13,91,196,0,0,208,71,137,GXXXXXXXXXXXXXXXXXXXGXXXXXXXXXXXXXXXXXXXGXXXXXXXXXXXXXXXXXXXGXXXXXXXXXXXXXXXXXXXGXXXXXXXXXXXXXXXXXXXGXXXXXXXXXXXXXXXXXXXGXXXXXXXXXXXXXXXXXXXGXXXXXXXXXXXXXXXXXXXGXXXXXXXXXXXXXXXXXXXGXXXXXXXXXXXXXXXXXXXGXXXXXXXXXXXXXXXXXXXGXXXXXXXXXXXXXXXXXXXGXXXXXXXXXXXXXXXXXXX,0,300,0
7623,13,0,13,93,194,0,0,206,75,131,GXXXXXXXXXXXXXXXXXXXGXXXXXXXXXXXXXXXXXXXGXXXXXXXXXXXXXXXXXXXGXXXXXXXXXXXXXXXXXXXGXXXXXXXXXXXXXXXXXXXGXXXXXXXXXXXXXXXXXXXGXXXXXXXXXXXXXXXXXXXGXXXXXXXXXXXXXXXXXXXGXXXXXXXXXXXXXXXXXXXGXXXXXXXXXXXXXXXXXXXGXXXXXXXXXXXXXXXXXXXGXXXXXXXXXXXXXXXXXXXGXXXXXXXXXXXXXXXXXXX,0,300,0
7644,14,1,13,90,196,0,0,208,75,133,GXXXXXXXXXXXXXXXXXXXGXXXXXXXXXXXXXXXXXXXGXXXXXXXXXXXXXXXXXXXGXXXXXXXXXXXXXXXXXXXGXXXXXXXXXXXXXXXXXXXGXXXXXXXXXXXXXXXXXXXGXXXXXXXXXXXXXXXXXXXGXXXXXXXXXXXXXXXXXXXGXXXXXXXXXXXXXXXXXXXGAXXXXXXXXXXXXXXXXXXGXXXXXXXXXXXXXXXXXXXGXXXXXXXXXXXXXXXXXXXGXXXXXXXXXXXXXXXXXXX,0,300,0

7665,14,0,14,85,201,0,0,213,70,143,GXXXXXXXXXXXXXXXXXXXGXXXXXXXXXXXXXXXXXXXGXXXXXXXXXXXXXXXXXXXGXXXXXXXXXXXXXXXXXXXGXXXXXXXXXXXXXXXXXXXGXXXXXXXXXXXXXXXXXXXGXXXXXXXXXXXXXXXXXXXGXXXXXXXXXXXXXXXXXXXGXXXXXXXXXXXXXXXXXXXGOXXXXXXXXXXXXXXXXXXGXXXXXXXXXXXXXXXXXXXGXXXXXXXXXXXXXXXXXXXGXXXXXXXXXXXXXXXXXXX,0,300,0
7686,14,0,14,85,201,0,0,213,69,144,GXXXXXXXXXXXXXXXXXXXGXXXXXXXXXXXXXXXXXXXGXXXXXXXXXXXXXXXXXXXGXXXXXXXXXXXXXXXXXXXGXXXXXXXXXXXXXXXXXXXGXXXXXXXXXXXXXXXXXXXGXXXXXXXXXXXXXXXXXXXGXXXXXXXXXXXXXXXXXXXGXXXXXXXXXXXXXXXXXXXGOXXXXXXXXXXXXXXXXXXGXXXXXXXXXXXXXXXXXXXGXXXXXXXXXXXXXXXXXXXGXXXXXXXXXXXXXXXXXXX,0,300,0
7707,13,0,13,87,200,0,0,212,67,145,GXXXXXXXXXXXXXXXXXXXGXXXXXXXXXXXXXXXXXXXGXXXXXXXXXXXXXXXXXXXGXXXXXXXXXXXXXXXXXXXGXXXXXXXXXXXXXXXXXXXGXXXXXXXXXXXXXXXXXXXGXXXXXXXXXXXXXXXXXXXGXXXXXXXXXXXXXXXXXXXGXXXXXXXXXXXXXXXXXXXGXXXXXXXXXXXXXXXXXXXGXXXXXXXXXXXXXXXXXXXGXXXXXXXXXXXXXXXXXXXGXXXXXXXXXXXXXXXXXXX,0,300,0
7728,13,0,13,82,205,0,0,217,74,143,GXXXXXXXXXXXXXXXXXXXGXXXXXXXXXXXXXXXXXXXGXXXXXXXXXXXXXXXXXXXGXXXXXXXXXXXXXXXXXXXGXXXXXXXXXXXXXXXXXXXGXXXXXXXXXXXXXXXXXXXGXXXXXXXXXXXXXXXXXXXGXXXXXXXXXXXXXXXXXXXGXXXXXXXXXXXXXXXXXXXGXXXXXXXXXXXXXXXXXXXGXXXXXXXXXXXXXXXXXXXGXXXXXXXXXXXXXXXXXXXGXXXXXXXXXXXXXXXXXXX,0,300,0
7749,13,0,13,79,208,0,0,218,73,145,GXXXXXXXXXXXXXXXXXXXGXXXXXXXXXXXXXXXXXXXGXXXXXXXXXXXXXXXXXXXGXXXXXXXXXXXXXXXXXXXGXXXXXXXXXXXXXXXXXXXGXXXXXXXXXXXXXXXXXXXGXXXXXXXXXXXXXXXXXXXGXXXXXXXXXXXXXXXXXXXGXXXXXXXXXXXXXXXXXXXGXXXXXXXXXXXXXXXXXXXGXXXXXXXXXXXXXXXXXXXGXXXXXXXXXXXXXXXXXXXGXXXXXXXXXXXXXXXXXXX,0,300,0

7770,13,0,13,78,209,0,0,221,72,149,GXXXXXXXXXXXXXXXXXXXGXXXXXXXXXXXXXXXXXXXGXXXXXXXXXXXXXXXXXXXGXXXXXXXXXXXXXXXXXXXGXXXXXXXXXXXXXXXXXXXGXXXXXXXXXXXXXXXXXXXGXXXXXXXXXXXXXXXXXXXGXXXXXXXXXXXXXXXXXXXGXXXXXXXXXXXXXXXXXXXGXXXXXXXXXXXXXXXXXXXGXXXXXXXXXXXXXXXXXXXGXXXXXXXXXXXXXXXXXXXGXXXXXXXXXXXXXXXXXXX,0,300,0
7791,14,1,13,80,206,0,0,218,69,149,GXXXXXXXXXXXXXXXXXXXGXXXXXXXXXXXXXXXXXXXGXXXXXXXXXXXXXXXXXXXGXXXXXXXXXXXXXXXXXXXGXXXXXXXXXXXXXXXXXXXGXXXXXXXXXXXXXXXXXXXGXXXXXXXXXXXXXXXXXXXGXXXXXXXXXXXXXXXXXXXGXXXXXXXXXXXXXXXXXXXGXXXXXXXXXXXXXXXXXXXGXXXXXXXXXXXXXXXXXXXGAXXXXXXXXXXXXXXXXXXGXXXXXXXXXXXXXXXXXXX,0,300,0
7812,14,1,13,83,203,0,0,216,70,146,GXXXXXXXXXXXXXXXXXXXGXXXXXXXXXXXXXXXXXXXGXXXXXXXXXXXXXXXXXXXGXXXXXXXXXXXXXXXXXXXGXXXXXXXXXXXXXXXXXXXGXXXXXXXXXXXXXXXXXXXGXXXXXXXXXXXXXXXXXXXGXXXXXXXXXXXXXXXXXXXGXXXXXXXXXXXXXXXXXXXGXXXXXXXXXXXXXXXXXXXGXXXXXXXXXXXXXXXXXXXGAXXXXXXXXXXXXXXXXXXGXXXXXXXXXXXXXXXXXXX,0,300,0
7833,14,1,13,86,200,0,0,212,74,138,GXXXXXXXXXXXXXXXXXXXGXXXXXXXXXXXXXXXXXXXGXXXXXXXXXXXXXXXXXXXGXXXXXXXXXXXXXXXXXXXGXXXXXXXXXXXXXXXXXXXGXXXXXXXXXXXXXXXXXXXGXXXXXXXXXXXXXXXXXXXGXXXXXXXXXXXXXXXXXXXGXXXXXXXXXXXXXXXXXXXGXXXXXXXXXXXXXXXXXXXGXXXXXXXXXXXXXXXXXXXGAXXXXXXXXXXXXXXXXXXGXXXXXXXXXXXXXXXXXXX,0,300,0
7854,14,1,13,92,194,0,0,205,69,136,GXXXXXXXXXXXXXXXXXXXGXXXXXXXXXXXXXXXXXXXGXXXXXXXXXXXXXXXXXXXGXXXXXXXXXXXXXXXXXXXGXXXXXXXXXXXXXXXXXXXGXXXXXXXXXXXXXXXXXXXGXXXXXXXXXXXXXXXXXXXGXXXXXXXXXXXXXXXXXXXGXXXXXXXXXXXXXXXXXXXGXXXXXXXXXXXXXXXXXXXGXXXXXXXXXXXXXXXXXXXGAXXXXXXXXXXXXXXXXXXGXXXXXXXXXXXXXXXXXXX,0,300,0

7875,14,1,13,90,196,0,0,207,72,135,GXXXXXXXXXXXXXXXXXXXGXXXXXXXXXXXXXXXXXXXGXXXXXXXXXXXXXXXXXXXGXXXXXXXXXXXXXXXXXXXGXXXXXXXXXXXXXXXXXXXGXXXXXXXXXXXXXXXXXXXGXXXXXXXXXXXXXXXXXXXGXXXXXXXXXXXXXXXXXXXGXXXXXXXXXXXXXXXXXXXGXXXXXXXXXXXXXXXXXXXGXXXXXXXXXXXXXXXXXXXGAXXXXXXXXXXXXXXXXXXGXXXXXXXXXXXXXXXXXXX,0,300,0
7896,14,1,13,93,193,0,0,204,64,140,GXXXXXXXXXXXXXXXXXXXGXXXXXXXXXXXXXXXXXXXGXXXXXXXXXXXXXXXXXXXGXXXXXXXXXXXXXXXXXXXGXXXXXXXXXXXXXXXXXXXGXXXXXXXXXXXXXXXXXXXGXXXXXXXXXXXXXXXXXXXGXXXXXXXXXXXXXXXXXXXGXXXXXXXXXXXXXXXXXXXGXXXXXXXXXXXXXXXXXXXGXXXXXXXXXXXXXXXXXXXGAXXXXXXXXXXXXXXXXXXGXXXXXXXXXXXXXXXXXXX,0,300,0
7917,15,1,14,88,197,0,0,209,62,147,GXXXXXXXXXXXXXXXXXXXGXXXXXXXXXXXXXXXXXXXGXXXXXXXXXXXXXXXXXXXGXXXXXXXXXXXXXXXXXXXGXXXXXXXXXXXXXXXXXXXGXXXXXXXXXXXXXXXXXXXGXXXXXXXXXXXXXXXXXXXGXXXXXXXXXXXXXXXXXXXGXXXXXXXXXXXXXXXXXXXGXXXXXXXXXXXXXXXXXXXGXXXXXXXXXXXXXXXXXXXGOXXXXXXXXXXXXXXXXXXGAXXXXXXXXXXXXXXXXXX,0,300,0
7938,15,1,14,83,202,0,0,214,69,145,GXXXXXXXXXXXXXXXXXXXGXXXXXXXXXXXXXXXXXXXGXXXXXXXXXXXXXXXXXXXGXXXXXXXXXXXXXXXXXXXGXXXXXXXXXXXXXXXXXXXGXXXXXXXXXXXXXXXXXXXGXXXXXXXXXXXXXXXXXXXGXXXXXXXXXXXXXXXXXXXGXXXXXXXXXXXXXXXXXXXGXXXXXXXXXXXXXXXXXXXGXXXXXXXXXXXXXXXXXXXGOXXXXXXXXXXXXXXXXXXGAXXXXXXXXXXXXXXXXXX,0,300,0
7959,14,1,13,80,206,0,0,218,68,150,GXXXXXXXXXXXXXXXXXXXGXXXXXXXXXXXXXXXXXXXGXXXXXXXXXXXXXXXXXXXGXXXXXXXXXXXXXXXXXXXGXXXXXXXXXXXXXXXXXXXGXXXXXXXXXXXXXXXXXXXGXXXXXXXXXXXXXXXXXXXGXXXXXXXXXXXXXXXXXXXGXXXXXXXXXXXXXXXXXXXGXXXXXXXXXXXXXXXXXXXGXXXXXXXXXXXXXXXXXXXGXXXXXXXXXXXXXXXXXXXGAXXXXXXXXXXXXXXXXXX,0,300,0

7980,14,1,13,83,203,0,0,216,69,147,GXXXXXXXXXXXXXXXXXXXGXXXXXXXXXXXXXXXXXXXGXXXXXXXXXXXXXXXXXXXGXXXXXXXXXXXXXXXXXXXGXXXXXXXXXXXXXXXXXXXGXXXXXXXXXXXXXXXXXXXGXXXXXXXXXXXXXXXXXXXGXXXXXXXXXXXXXXXXXXXGXXXXXXXXXXXXXXXXXXXGXXXXXXXXXXXXXXXXXXXGXXXXXXXXXXXXXXXXXXXGXXXXXXXXXXXXXXXXXXXGAXXXXXXXXXXXXXXXXXX,0,300,0
8001,13,0,13,81,206,0,0,218,73,145,GXXXXXXXXXXXXXXXXXXXGXXXXXXXXXXXXXXXXXXXGXXXXXXXXXXXXXXXXXXXGXXXXXXXXXXXXXXXXXXXGXXXXXXXXXXXXXXXXXXXGXXXXXXXXXXXXXXXXXXXGXXXXXXXXXXXXXXXXXXXGXXXXXXXXXXXXXXXXXXXGXXXXXXXXXXXXXXXXXXXGXXXXXXXXXXXXXXXXXXXGXXXXXXXXXXXXXXXXXXXGXXXXXXXXXXXXXXXXXXXGXXXXXXXXXXXXXXXXXXX,0,300,0
8022,13,0,13,81,206,0,0,219,72,147,GXXXXXXXXXXXXXXXXXXXGXXXXXXXXXXXXXXXXXXXGXXXXXXXXXXXXXXXXXXXGXXXXXXXXXXXXXXXXXXXGXXXXXXXXXXXXXXXXXXXGXXXXXXXXXXXXXXXXXXXGXXXXXXXXXXXXXXXXXXXGXXXXXXXXXXXXXXXXXXXGXXXXXXXXXXXXXXXXXXXGXXXXXXXXXXXXXXXXXXXGXXXXXXXXXXXXXXXXXXXGXXXXXXXXXXXXXXXXXXXGXXXXXXXXXXXXXXXXXXX,0,300,0
8043,13,0,13,84,203,0,0,216,66,150,GXXXXXXXXXXXXXXXXXXXGXXXXXXXXXXXXXXXXXXXGXXXXXXXXXXXXXXXXXXXGXXXXXXXXXXXXXXXXXXXGXXXXXXXXXXXXXXXXXXXGXXXXXXXXXXXXXXXXXXXGXXXXXXXXXXXXXXXXXXXGXXXXXXXXXXXXXXXXXXXGXXXXXXXXXXXXXXXXXXXGXXXXXXXXXXXXXXXXXXXGXXXXXXXXXXXXXXXXXXXGXXXXXXXXXXXXXXXXXXXGXXXXXXXXXXXXXXXXXXX,0,300,0
8064,13,0,13,81,206,0,0,219,73,146,GXXXXXXXXXXXXXXXXXXXGXXXXXXXXXXXXXXXXXXXGXXXXXXXXXXXXXXXXXXXGXXXXXXXXXXXXXXXXXXXGXXXXXXXXXXXXXXXXXXXGXXXXXXXXXXXXXXXXXXXGXXXXXXXXXXXXXXXXXXXGXXXXXXXXXXXXXXXXXXXGXXXXXXXXXXXXXXXXXXXGXXXXXXXXXXXXXXXXXXXGXXXXXXXXXXXXXXXXXXXGXXXXXXXXXXXXXXXXXXXGXXXXXXXXXXXXXXXXXXX,0,300,0

8085,13,0,13,79,208,0,0,222,70,152,GXXXXXXXXXXXXXXXXXXXGXXXXXXXXXXXXXXXXXXXGXXXXXXXXXXXXXXXXXXXGXXXXXXXXXXXXXXXXXXXGXXXXXXXXXXXXXXXXXXXGXXXXXXXXXXXXXXXXXXXGXXXXXXXXXXXXXXXXXXXGXXXXXXXXXXXXXXXXXXXGXXXXXXXXXXXXXXXXXXXGXXXXXXXXXXXXXXXXXXXGXXXXXXXXXXXXXXXXXXXGXXXXXXXXXXXXXXXXXXXGXXXXXXXXXXXXXXXXXXX,0,300,0
8106,13,0,13,83,204,0,0,219,72,147,GXXXXXXXXXXXXXXXXXXXGXXXXXXXXXXXXXXXXXXXGXXXXXXXXXXXXXXXXXXXGXXXXXXXXXXXXXXXXXXXGXXXXXXXXXXXXXXXXXXXGXXXXXXXXXXXXXXXXXXXGXXXXXXXXXXXXXXXXXXXGXXXXXXXXXXXXXXXXXXXGXXXXXXXXXXXXXXXXXXXGXXXXXXXXXXXXXXXXXXXGXXXXXXXXXXXXXXXXXXXGXXXXXXXXXXXXXXXXXXXGXXXXXXXXXXXXXXXXXXX,0,300,0
8127,13,0,13,78,209,0,0,224,72,152,GXXXXXXXXXXXXXXXXXXXGXXXXXXXXXXXXXXXXXXXGXXXXXXXXXXXXXXXXXXXGXXXXXXXXXXXXXXXXXXXGXXXXXXXXXXXXXXXXXXXGXXXXXXXXXXXXXXXXXXXGXXXXXXXXXXXXXXXXXXXGXXXXXXXXXXXXXXXXXXXGXXXXXXXXXXXXXXXXXXXGXXXXXXXXXXXXXXXXXXXGXXXXXXXXXXXXXXXXXXXGXXXXXXXXXXXXXXXXXXXGXXXXXXXXXXXXXXXXXXX,0,300,0
8148,13,0,13,76,211,0,0,226,74,152,GXXXXXXXXXXXXXXXXXXXGXXXXXXXXXXXXXXXXXXXGXXXXXXXXXXXXXXXXXXXGXXXXXXXXXXXXXXXXXXXGXXXXXXXXXXXXXXXXXXXGXXXXXXXXXXXXXXXXXXXGXXXXXXXXXXXXXXXXXXXGXXXXXXXXXXXXXXXXXXXGXXXXXXXXXXXXXXXXXXXGXXXXXXXXXXXXXXXXXXXGXXXXXXXXXXXXXXXXXXXGXXXXXXXXXXXXXXXXXXXGXXXXXXXXXXXXXXXXXXX,0,300,0
8169,13,0,13,77,210,0,0,225,80,145,GXXXXXXXXXXXXXXXXXXXGXXXXXXXXXXXXXXXXXXXGXXXXXXXXXXXXXXXXXXXGXXXXXXXXXXXXXXXXXXXGXXXXXXXXXXXXXXXXXXXGXXXXXXXXXXXXXXXXXXXGXXXXXXXXXXXXXXXXXXXGXXXXXXXXXXXXXXXXXXXGXXXXXXXXXXXXXXXXXXXGXXXXXXXXXXXXXXXXXXXGXXXXXXXXXXXXXXXXXXXGXXXXXXXXXXXXXXXXXXXGXXXXXXXXXXXXXXXXXXX,0,300,0

8190,13,0,13,81,206,0,0,220,77,143,GXXXXXXXXXXXXXXXXXXXGXXXXXXXXXXXXXXXXXXXGXXXXXXXXXXXXXXXXXXXGXXXXXXXXXXXXXXXXXXXGXXXXXXXXXXXXXXXXXXXGXXXXXXXXXXXXXXXXXXXGXXXXXXXXXXXXXXXXXXXGXXXXXXXXXXXXXXXXXXXGXXXXXXXXXXXXXXXXXXXGXXXXXXXXXXXXXXXXXXXGXXXXXXXXXXXXXXXXXXXGXXXXXXXXXXXXXXXXXXXGXXXXXXXXXXXXXXXXXXX,0,300,0
8211,13,0,13,86,201,0,0,216,72,144,GXXXXXXXXXXXXXXXXXXXGXXXXXXXXXXXXXXXXXXXGXXXXXXXXXXXXXXXXXXXGXXXXXXXXXXXXXXXXXXXGXXXXXXXXXXXXXXXXXXXGXXXXXXXXXXXXXXXXXXXGXXXXXXXXXXXXXXXXXXXGXXXXXXXXXXXXXXXXXXXGXXXXXXXXXXXXXXXXXXXGXXXXXXXXXXXXXXXXXXXGXXXXXXXXXXXXXXXXXXXGXXXXXXXXXXXXXXXXXXXGXXXXXXXXXXXXXXXXXXX,0,300,0
8232,13,0,13,86,201,0,0,216,77,139,GXXXXXXXXXXXXXXXXXXXGXXXXXXXXXXXXXXXXXXXGXXXXXXXXXXXXXXXXXXXGXXXXXXXXXXXXXXXXXXXGXXXXXXXXXXXXXXXXXXXGXXXXXXXXXXXXXXXXXXXGXXXXXXXXXXXXXXXXXXXGXXXXXXXXXXXXXXXXXXXGXXXXXXXXXXXXXXXXXXXGXXXXXXXXXXXXXXXXXXXGXXXXXXXXXXXXXXXXXXXGXXXXXXXXXXXXXXXXXXXGXXXXXXXXXXXXXXXXXXX,0,300,0
8253,13,0,13,92,195,0,0,209,72,137,GXXXXXXXXXXXXXXXXXXXGXXXXXXXXXXXXXXXXXXXGXXXXXXXXXXXXXXXXXXXGXXXXXXXXXXXXXXXXXXXGXXXXXXXXXXXXXXXXXXXGXXXXXXXXXXXXXXXXXXXGXXXXXXXXXXXXXXXXXXXGXXXXXXXXXXXXXXXXXXXGXXXXXXXXXXXXXXXXXXXGXXXXXXXXXXXXXXXXXXXGXXXXXXXXXXXXXXXXXXXGXXXXXXXXXXXXXXXXXXXGXXXXXXXXXXXXXXXXXXX,0,300,0
8274,13,0,13,94,193,0,0,207,71,136,GXXXXXXXXXXXXXXXXXXXGXXXXXXXXXXXXXXXXXXXGXXXXXXXXXXXXXXXXXXXGXXXXXXXXXXXXXXXXXXXGXXXXXXXXXXXXXXXXXXXGXXXXXXXXXXXXXXXXXXXGXXXXXXXXXXXXXXXXXXXGXXXXXXXXXXXXXXXXXXXGXXXXXXXXXXXXXXXXXXXGXXXXXXXXXXXXXXXXXXXGXXXXXXXXXXXXXXXXXXXGXXXXXXXXXXXXXXXXXXXGXXXXXXXXXXXXXXXXXXX,0,300,0

8295,13,0,13,92,195,0,0,207,70,137,GXXXXXXXXXXXXXXXXXXXGXXXXXXXXXXXXXXXXXXXGXXXXXXXXXXXXXXXXXXXGXXXXXXXXXXXXXXXXXXXGXXXXXXXXXXXXXXXXXXXGXXXXXXXXXXXXXXXXXXXGXXXXXXXXXXXXXXXXXXXGXXXXXXXXXXXXXXXXXXXGXXXXXXXXXXXXXXXXXXXGXXXXXXXXXXXXXXXXXXXGXXXXXXXXXXXXXXXXXXXGXXXXXXXXXXXXXXXXXXXGXXXXXXXXXXXXXXXXXXX,0,300,0
8316,13,0,13,89,198,0,0,210,68,142,GXXXXXXXXXXXXXXXXXXXGXXXXXXXXXXXXXXXXXXXGXXXXXXXXXXXXXXXXXXXGXXXXXXXXXXXXXXXXXXXGXXXXXXXXXXXXXXXXXXXGXXXXXXXXXXXXXXXXXXXGXXXXXXXXXXXXXXXXXXXGXXXXXXXXXXXXXXXXXXXGXXXXXXXXXXXXXXXXXXXGXXXXXXXXXXXXXXXXXXXGXXXXXXXXXXXXXXXXXXXGXXXXXXXXXXXXXXXXXXXGXXXXXXXXXXXXXXXXXXX,0,300,0
8337,13,0,13,83,204,0,0,217,69,148,GXXXXXXXXXXXXXXXXXXXGXXXXXXXXXXXXXXXXXXXGXXXXXXXXXXXXXXXXXXXGXXXXXXXXXXXXXXXXXXXGXXXXXXXXXXXXXXXXXXXGXXXXXXXXXXXXXXXXXXXGXXXXXXXXXXXXXXXXXXXGXXXXXXXXXXXXXXXXXXXGXXXXXXXXXXXXXXXXXXXGXXXXXXXXXXXXXXXXXXXGXXXXXXXXXXXXXXXXXXXGXXXXXXXXXXXXXXXXXXXGXXXXXXXXXXXXXXXXXXX,0,300,0
8358,13,0,13,81,206,0,0,219,74,145,GXXXXXXXXXXXXXXXXXXXGXXXXXXXXXXXXXXXXXXXGXXXXXXXXXXXXXXXXXXXGXXXXXXXXXXXXXXXXXXXGXXXXXXXXXXXXXXXXXXXGXXXXXXXXXXXXXXXXXXXGXXXXXXXXXXXXXXXXXXXGXXXXXXXXXXXXXXXXXXXGXXXXXXXXXXXXXXXXXXXGXXXXXXXXXXXXXXXXXXXGXXXXXXXXXXXXXXXXXXXGXXXXXXXXXXXXXXXXXXXGXXXXXXXXXXXXXXXXXXX,0,300,0
8379,13,0,13,83,204,0,0,217,75,142,GXXXXXXXXXXXXXXXXXXXGXXXXXXXXXXXXXXXXXXXGXXXXXXXXXXXXXXXXXXXGXXXXXXXXXXXXXXXXXXXGXXXXXXXXXXXXXXXXXXXGXXXXXXXXXXXXXXXXXXXGXXXXXXXXXXXXXXXXXXXGXXXXXXXXXXXXXXXXXXXGXXXXXXXXXXXXXXXXXXXGXXXXXXXXXXXXXXXXXXXGXXXXXXXXXXXXXXXXXXXGXXXXXXXXXXXXXXXXXXXGXXXXXXXXXXXXXXXXXXX,0,300,0

8400,13,0,13,75,212,0,0,225,83,142,GXXXXXXXXXXXXXXXXXXXGXXXXXXXXXXXXXXXXXXXGXXXXXXXXXXXXXXXXXXXGXXXXXXXXXXXXXXXXXXXGXXXXXXXXXXXXXXXXXXXGXXXXXXXXXXXXXXXXXXXGXXXXXXXXXXXXXXXXXXXGXXXXXXXXXXXXXXXXXXXGXXXXXXXXXXXXXXXXXXXGXXXXXXXXXXXXXXXXXXXGXXXXXXXXXXXXXXXXXXXGXXXXXXXXXXXXXXXXXXXGXXXXXXXXXXXXXXXXXXX,0,300,0
8421,13,0,13,81,206,0,0,219,82,137,GXXXXXXXXXXXXXXXXXXXGXXXXXXXXXXXXXXXXXXXGXXXXXXXXXXXXXXXXXXXGXXXXXXXXXXXXXXXXXXXGXXXXXXXXXXXXXXXXXXXGXXXXXXXXXXXXXXXXXXXGXXXXXXXXXXXXXXXXXXXGXXXXXXXXXXXXXXXXXXXGXXXXXXXXXXXXXXXXXXXGXXXXXXXXXXXXXXXXXXXGXXXXXXXXXXXXXXXXXXXGXXXXXXXXXXXXXXXXXXXGXXXXXXXXXXXXXXXXXXX,0,300,0
8442,13,0,13,81,206,0,0,219,80,139,GXXXXXXXXXXXXXXXXXXXGXXXXXXXXXXXXXXXXXXXGXXXXXXXXXXXXXXXXXXXGXXXXXXXXXXXXXXXXXXXGXXXXXXXXXXXXXXXXXXXGXXXXXXXXXXXXXXXXXXXGXXXXXXXXXXXXXXXXXXXGXXXXXXXXXXXXXXXXXXXGXXXXXXXXXXXXXXXXXXXGXXXXXXXXXXXXXXXXXXXGXXXXXXXXXXXXXXXXXXXGXXXXXXXXXXXXXXXXXXXGXXXXXXXXXXXXXXXXXXX,0,300,0
8463,13,0,13,85,202,0,0,215,77,138,GXXXXXXXXXXXXXXXXXXXGXXXXXXXXXXXXXXXXXXXGXXXXXXXXXXXXXXXXXXXGXXXXXXXXXXXXXXXXXXXGXXXXXXXXXXXXXXXXXXXGXXXXXXXXXXXXXXXXXXXGXXXXXXXXXXXXXXXXXXXGXXXXXXXXXXXXXXXXXXXGXXXXXXXXXXXXXXXXXXXGXXXXXXXXXXXXXXXXXXXGXXXXXXXXXXXXXXXXXXXGXXXXXXXXXXXXXXXXXXXGXXXXXXXXXXXXXXXXXXX,0,300,0
8484,13,0,13,92,195,0,0,208,73,135,GXXXXXXXXXXXXXXXXXXXGXXXXXXXXXXXXXXXXXXXGXXXXXXXXXXXXXXXXXXXGXXXXXXXXXXXXXXXXXXXGXXXXXXXXXXXXXXXXXXXGXXXXXXXXXXXXXXXXXXXGXXXXXXXXXXXXXXXXXXXGXXXXXXXXXXXXXXXXXXXGXXXXXXXXXXXXXXXXXXXGXXXXXXXXXXXXXXXXXXXGXXXXXXXXXXXXXXXXXXXGXXXXXXXXXXXXXXXXXXXGXXXXXXXXXXXXXXXXXXX,0,300,0

8505,13,0,13,89,198,0,0,211,78,133,GXXXXXXXXXXXXXXXXXXXGXXXXXXXXXXXXXXXXXXXGXXXXXXXXXXXXXXXXXXXGXXXXXXXXXXXXXXXXXXXGXXXXXXXXXXXXXXXXXXXGXXXXXXXXXXXXXXXXXXXGXXXXXXXXXXXXXXXXXXXGXXXXXXXXXXXXXXXXXXXGXXXXXXXXXXXXXXXXXXXGXXXXXXXXXXXXXXXXXXXGXXXXXXXXXXXXXXXXXXXGXXXXXXXXXXXXXXXXXXXGXXXXXXXXXXXXXXXXXXX,0,300,0
8526,13,0,13,89,198,0,0,212,81,131,GXXXXXXXXXXXXXXXXXXXGXXXXXXXXXXXXXXXXXXXGXXXXXXXXXXXXXXXXXXXGXXXXXXXXXXXXXXXXXXXGXXXXXXXXXXXXXXXXXXXGXXXXXXXXXXXXXXXXXXXGXXXXXXXXXXXXXXXXXXXGXXXXXXXXXXXXXXXXXXXGXXXXXXXXXXXXXXXXXXXGXXXXXXXXXXXXXXXXXXXGXXXXXXXXXXXXXXXXXXXGXXXXXXXXXXXXXXXXXXXGXXXXXXXXXXXXXXXXXXX,0,300,0
8547,13,0,13,88,199,0,0,212,81,131,GXXXXXXXXXXXXXXXXXXXGXXXXXXXXXXXXXXXXXXXGXXXXXXXXXXXXXXXXXXXGXXXXXXXXXXXXXXXXXXXGXXXXXXXXXXXXXXXXXXXGXXXXXXXXXXXXXXXXXXXGXXXXXXXXXXXXXXXXXXXGXXXXXXXXXXXXXXXXXXXGXXXXXXXXXXXXXXXXXXXGXXXXXXXXXXXXXXXXXXXGXXXXXXXXXXXXXXXXXXXGXXXXXXXXXXXXXXXXXXXGXXXXXXXXXXXXXXXXXXX,0,300,0
8568,13,0,13,86,201,0,0,214,82,132,GXXXXXXXXXXXXXXXXXXXGXXXXXXXXXXXXXXXXXXXGXXXXXXXXXXXXXXXXXXXGXXXXXXXXXXXXXXXXXXXGXXXXXXXXXXXXXXXXXXXGXXXXXXXXXXXXXXXXXXXGXXXXXXXXXXXXXXXXXXXGXXXXXXXXXXXXXXXXXXXGXXXXXXXXXXXXXXXXXXXGXXXXXXXXXXXXXXXXXXXGXXXXXXXXXXXXXXXXXXXGXXXXXXXXXXXXXXXXXXXGXXXXXXXXXXXXXXXXXXX,0,300,0
8589,13,0,13,87,200,0,0,211,78,133,GXXXXXXXXXXXXXXXXXXXGXXXXXXXXXXXXXXXXXXXGXXXXXXXXXXXXXXXXXXXGXXXXXXXXXXXXXXXXXXXGXXXXXXXXXXXXXXXXXXXGXXXXXXXXXXXXXXXXXXXGXXXXXXXXXXXXXXXXXXXGXXXXXXXXXXXXXXXXXXXGXXXXXXXXXXXXXXXXXXXGXXXXXXXXXXXXXXXXXXXGXXXXXXXXXXXXXXXXXXXGXXXXXXXXXXXXXXXXXXXGXXXXXXXXXXXXXXXXXXX,0,300,0

8610,13,0,13,89,198,0,0,210,77,133,GXXXXXXXXXXXXXXXXXXXGXXXXXXXXXXXXXXXXXXXGXXXXXXXXXXXXXXXXXXXGXXXXXXXXXXXXXXXXXXXGXXXXXXXXXXXXXXXXXXXGXXXXXXXXXXXXXXXXXXXGXXXXXXXXXXXXXXXXXXXGXXXXXXXXXXXXXXXXXXXGXXXXXXXXXXXXXXXXXXXGXXXXXXXXXXXXXXXXXXXGXXXXXXXXXXXXXXXXXXXGXXXXXXXXXXXXXXXXXXXGXXXXXXXXXXXXXXXXXXX,0,300,0
8631,13,0,13,87,200,0,0,211,72,139,GXXXXXXXXXXXXXXXXXXXGXXXXXXXXXXXXXXXXXXXGXXXXXXXXXXXXXXXXXXXGXXXXXXXXXXXXXXXXXXXGXXXXXXXXXXXXXXXXXXXGXXXXXXXXXXXXXXXXXXXGXXXXXXXXXXXXXXXXXXXGXXXXXXXXXXXXXXXXXXXGXXXXXXXXXXXXXXXXXXXGXXXXXXXXXXXXXXXXXXXGXXXXXXXXXXXXXXXXXXXGXXXXXXXXXXXXXXXXXXXGXXXXXXXXXXXXXXXXXXX,0,300,0
8652,13,0,13,84,203,0,0,214,76,138,GXXXXXXXXXXXXXXXXXXXGXXXXXXXXXXXXXXXXXXXGXXXXXXXXXXXXXXXXXXXGXXXXXXXXXXXXXXXXXXXGXXXXXXXXXXXXXXXXXXXGXXXXXXXXXXXXXXXXXXXGXXXXXXXXXXXXXXXXXXXGXXXXXXXXXXXXXXXXXXXGXXXXXXXXXXXXXXXXXXXGXXXXXXXXXXXXXXXXXXXGXXXXXXXXXXXXXXXXXXXGXXXXXXXXXXXXXXXXXXXGXXXXXXXXXXXXXXXXXXX,0,300,0
8673,14,1,13,83,203,0,0,216,68,148,GXXXXXXXXXXXXXXXXXXXGXXXXXXXXXXXXXXXXXXXGXXXXXXXXXXXXXXXXXXXGXXXXXXXXXXXXXXXXXXXGAXXXXXXXXXXXXXXXXXXGXXXXXXXXXXXXXXXXXXXGXXXXXXXXXXXXXXXXXXXGXXXXXXXXXXXXXXXXXXXGXXXXXXXXXXXXXXXXXXXGXXXXXXXXXXXXXXXXXXXGXXXXXXXXXXXXXXXXXXXGXXXXXXXXXXXXXXXXXXXGXXXXXXXXXXXXXXXXXXX,0,300,0
8694,14,1,13,85,201,0,0,214,70,144,GXXXXXXXXXXXXXXXXXXXGXXXXXXXXXXXXXXXXXXXGXXXXXXXXXXXXXXXXXXXGXXXXXXXXXXXXXXXXXXXGAXXXXXXXXXXXXXXXXXXGXXXXXXXXXXXXXXXXXXXGXXXXXXXXXXXXXXXXXXXGXXXXXXXXXXXXXXXXXXXGXXXXXXXXXXXXXXXXXXXGXXXXXXXXXXXXXXXXXXXGXXXXXXXXXXXXXXXXXXXGXXXXXXXXXXXXXXXXXXXGXXXXXXXXXXXXXXXXXXX,0,300,0

8715,14,1,13,87,199,0,0,213,71,142,GXXXXXXXXXXXXXXXXXXXGXXXXXXXXXXXXXXXXXXXGXXXXXXXXXXXXXXXXXXXGXXXXXXXXXXXXXXXXXXXGAXXXXXXXXXXXXXXXXXXGXXXXXXXXXXXXXXXXXXXGXXXXXXXXXXXXXXXXXXXGXXXXXXXXXXXXXXXXXXXGXXXXXXXXXXXXXXXXXXXGXXXXXXXXXXXXXXXXXXXGXXXXXXXXXXXXXXXXXXXGXXXXXXXXXXXXXXXXXXXGXXXXXXXXXXXXXXXXXXX,0,300,0
8736,14,1,13,88,198,0,0,211,72,139,GXXXXXXXXXXXXXXXXXXXGXXXXXXXXXXXXXXXXXXXGXXXXXXXXXXXXXXXXXXXGXXXXXXXXXXXXXXXXXXXGAXXXXXXXXXXXXXXXXXXGXXXXXXXXXXXXXXXXXXXGXXXXXXXXXXXXXXXXXXXGXXXXXXXXXXXXXXXXXXXGXXXXXXXXXXXXXXXXXXXGXXXXXXXXXXXXXXXXXXXGXXXXXXXXXXXXXXXXXXXGXXXXXXXXXXXXXXXXXXXGXXXXXXXXXXXXXXXXXXX,0,300,0
8757,14,1,13,89,197,0,0,210,68,142,GXXXXXXXXXXXXXXXXXXXGXXXXXXXXXXXXXXXXXXXGXXXXXXXXXXXXXXXXXXXGXXXXXXXXXXXXXXXXXXXGAXXXXXXXXXXXXXXXXXXGXXXXXXXXXXXXXXXXXXXGXXXXXXXXXXXXXXXXXXXGXXXXXXXXXXXXXXXXXXXGXXXXXXXXXXXXXXXXXXXGXXXXXXXXXXXXXXXXXXXGXXXXXXXXXXXXXXXXXXXGXXXXXXXXXXXXXXXXXXXGXXXXXXXXXXXXXXXXXXX,0,300,0
8778,14,1,13,89,197,0,0,210,71,139,GXXXXXXXXXXXXXXXXXXXGXXXXXXXXXXXXXXXXXXXGXXXXXXXXXXXXXXXXXXXGXXXXXXXXXXXXXXXXXXXGAXXXXXXXXXXXXXXXXXXGXXXXXXXXXXXXXXXXXXXGXXXXXXXXXXXXXXXXXXXGXXXXXXXXXXXXXXXXXXXGXXXXXXXXXXXXXXXXXXXGXXXXXXXXXXXXXXXXXXXGXXXXXXXXXXXXXXXXXXXGXXXXXXXXXXXXXXXXXXXGXXXXXXXXXXXXXXXXXXX,0,300,0
8799,14,0,14,84,202,0,0,214,69,145,GXXXXXXXXXXXXXXXXXXXGXXXXXXXXXXXXXXXXXXXGXXXXXXXXXXXXXXXXXXXGXXXXXXXXXXXXXXXXXXXGOXXXXXXXXXXXXXXXXXXGXXXXXXXXXXXXXXXXXXXGXXXXXXXXXXXXXXXXXXXGXXXXXXXXXXXXXXXXXXXGXXXXXXXXXXXXXXXXXXXGXXXXXXXXXXXXXXXXXXXGXXXXXXXXXXXXXXXXXXXGXXXXXXXXXXXXXXXXXXXGXXXXXXXXXXXXXXXXXXX,0,300,0

8820,13,0,13,83,204,0,0,217,70,147,GXXXXXXXXXXXXXXXXXXXGXXXXXXXXXXXXXXXXXXXGXXXXXXXXXXXXXXXXXXXGXXXXXXXXXXXXXXXXXXXGXXXXXXXXXXXXXXXXXXXGXXXXXXXXXXXXXXXXXXXGXXXXXXXXXXXXXXXXXXXGXXXXXXXXXXXXXXXXXXXGXXXXXXXXXXXXXXXXXXXGXXXXXXXXXXXXXXXXXXXGXXXXXXXXXXXXXXXXXXXGXXXXXXXXXXXXXXXXXXXGXXXXXXXXXXXXXXXXXXX,0,300,0
8841,13,0,13,81,206,0,0,219,75,144,GXXXXXXXXXXXXXXXXXXXGXXXXXXXXXXXXXXXXXXXGXXXXXXXXXXXXXXXXXXXGXXXXXXXXXXXXXXXXXXXGXXXXXXXXXXXXXXXXXXXGXXXXXXXXXXXXXXXXXXXGXXXXXXXXXXXXXXXXXXXGXXXXXXXXXXXXXXXXXXXGXXXXXXXXXXXXXXXXXXXGXXXXXXXXXXXXXXXXXXXGXXXXXXXXXXXXXXXXXXXGXXXXXXXXXXXXXXXXXXXGXXXXXXXXXXXXXXXXXXX,0,300,0
8862,13,0,13,71,216,0,0,228,77,151,GXXXXXXXXXXXXXXXXXXXGXXXXXXXXXXXXXXXXXXXGXXXXXXXXXXXXXXXXXXXGXXXXXXXXXXXXXXXXXXXGXXXXXXXXXXXXXXXXXXXGXXXXXXXXXXXXXXXXXXXGXXXXXXXXXXXXXXXXXXXGXXXXXXXXXXXXXXXXXXXGXXXXXXXXXXXXXXXXXXXGXXXXXXXXXXXXXXXXXXXGXXXXXXXXXXXXXXXXXXXGXXXXXXXXXXXXXXXXXXXGXXXXXXXXXXXXXXXXXXX,0,300,0
8883,13,0,13,73,214,0,0,227,74,153,GXXXXXXXXXXXXXXXXXXXGXXXXXXXXXXXXXXXXXXXGXXXXXXXXXXXXXXXXXXXGXXXXXXXXXXXXXXXXXXXGXXXXXXXXXXXXXXXXXXXGXXXXXXXXXXXXXXXXXXXGXXXXXXXXXXXXXXXXXXXGXXXXXXXXXXXXXXXXXXXGXXXXXXXXXXXXXXXXXXXGXXXXXXXXXXXXXXXXXXXGXXXXXXXXXXXXXXXXXXXGXXXXXXXXXXXXXXXXXXXGXXXXXXXXXXXXXXXXXXX,0,300,0
8904,13,0,13,77,210,0,0,223,76,147,GXXXXXXXXXXXXXXXXXXXGXXXXXXXXXXXXXXXXXXXGXXXXXXXXXXXXXXXXXXXGXXXXXXXXXXXXXXXXXXXGXXXXXXXXXXXXXXXXXXXGXXXXXXXXXXXXXXXXXXXGXXXXXXXXXXXXXXXXXXXGXXXXXXXXXXXXXXXXXXXGXXXXXXXXXXXXXXXXXXXGXXXXXXXXXXXXXXXXXXXGXXXXXXXXXXXXXXXXXXXGXXXXXXXXXXXXXXXXXXXGXXXXXXXXXXXXXXXXXXX,0,300,0

8925,13,0,13,76,211,0,0,224,76,148,GXXXXXXXXXXXXXXXXXXXGXXXXXXXXXXXXXXXXXXXGXXXXXXXXXXXXXXXXXXXGXXXXXXXXXXXXXXXXXXXGXXXXXXXXXXXXXXXXXXXGXXXXXXXXXXXXXXXXXXXGXXXXXXXXXXXXXXXXXXXGXXXXXXXXXXXXXXXXXXXGXXXXXXXXXXXXXXXXXXXGXXXXXXXXXXXXXXXXXXXGXXXXXXXXXXXXXXXXXXXGXXXXXXXXXXXXXXXXXXXGXXXXXXXXXXXXXXXXXXX,0,300,0
8946,13,0,13,76,211,0,0,224,78,146,GXXXXXXXXXXXXXXXXXXXGXXXXXXXXXXXXXXXXXXXGXXXXXXXXXXXXXXXXXXXGXXXXXXXXXXXXXXXXXXXGXXXXXXXXXXXXXXXXXXXGXXXXXXXXXXXXXXXXXXXGXXXXXXXXXXXXXXXXXXXGXXXXXXXXXXXXXXXXXXXGXXXXXXXXXXXXXXXXXXXGXXXXXXXXXXXXXXXXXXXGXXXXXXXXXXXXXXXXXXXGXXXXXXXXXXXXXXXXXXXGXXXXXXXXXXXXXXXXXXX,0,300,0
8967,13,0,13,78,209,0,0,222,78,144,GXXXXXXXXXXXXXXXXXXXGXXXXXXXXXXXXXXXXXXXGXXXXXXXXXXXXXXXXXXXGXXXXXXXXXXXXXXXXXXXGXXXXXXXXXXXXXXXXXXXGXXXXXXXXXXXXXXXXXXXGXXXXXXXXXXXXXXXXXXXGXXXXXXXXXXXXXXXXXXXGXXXXXXXXXXXXXXXXXXXGXXXXXXXXXXXXXXXXXXXGXXXXXXXXXXXXXXXXXXXGXXXXXXXXXXXXXXXXXXXGXXXXXXXXXXXXXXXXXXX,0,300,0
8988,13,0,13,78,209,0,0,222,79,143,GXXXXXXXXXXXXXXXXXXXGXXXXXXXXXXXXXXXXXXXGXXXXXXXXXXXXXXXXXXXGXXXXXXXXXXXXXXXXXXXGXXXXXXXXXXXXXXXXXXXGXXXXXXXXXXXXXXXXXXXGXXXXXXXXXXXXXXXXXXXGXXXXXXXXXXXXXXXXXXXGXXXXXXXXXXXXXXXXXXXGXXXXXXXXXXXXXXXXXXXGXXXXXXXXXXXXXXXXXXXGXXXXXXXXXXXXXXXXXXXGXXXXXXXXXXXXXXXXXXX,0,300,0
9009,13,0,13,82,205,0,0,218,80,138,GXXXXXXXXXXXXXXXXXXXGXXXXXXXXXXXXXXXXXXXGXXXXXXXXXXXXXXXXXXXGXXXXXXXXXXXXXXXXXXXGXXXXXXXXXXXXXXXXXXXGXXXXXXXXXXXXXXXXXXXGXXXXXXXXXXXXXXXXXXXGXXXXXXXXXXXXXXXXXXXGXXXXXXXXXXXXXXXXXXXGXXXXXXXXXXXXXXXXXXXGXXXXXXXXXXXXXXXXXXXGXXXXXXXXXXXXXXXXXXXGXXXXXXXXXXXXXXXXXXX,0,300,0

9030,13,0,13,81,206,0,0,218,84,134,GXXXXXXXXXXXXXXXXXXXGXXXXXXXXXXXXXXXXXXXGXXXXXXXXXXXXXXXXXXXGXXXXXXXXXXXXXXXXXXXGXXXXXXXXXXXXXXXXXXXGXXXXXXXXXXXXXXXXXXXGXXXXXXXXXXXXXXXXXXXGXXXXXXXXXXXXXXXXXXXGXXXXXXXXXXXXXXXXXXXGXXXXXXXXXXXXXXXXXXXGXXXXXXXXXXXXXXXXXXXGXXXXXXXXXXXXXXXXXXXGXXXXXXXXXXXXXXXXXXX,0,300,0
9051,13,0,13,82,205,0,0,218,86,132,GXXXXXXXXXXXXXXXXXXXGXXXXXXXXXXXXXXXXXXXGXXXXXXXXXXXXXXXXXXXGXXXXXXXXXXXXXXXXXXXGXXXXXXXXXXXXXXXXXXXGXXXXXXXXXXXXXXXXXXXGXXXXXXXXXXXXXXXXXXXGXXXXXXXXXXXXXXXXXXXGXXXXXXXXXXXXXXXXXXXGXXXXXXXXXXXXXXXXXXXGXXXXXXXXXXXXXXXXXXXGXXXXXXXXXXXXXXXXXXXGXXXXXXXXXXXXXXXXXXX,0,300,0
9072,14,1,13,87,199,0,0,211,89,122,GXXXXXXXXXXXXXXXXXXXGXXXXXXXXXXXXXXXXXXXGXXXXXXXXXXXXXXXXXXXGXXXXXXXXXXXXXXXXXXXGXXXXXXXXXXXXXXXXXXXGXXXXXXXXXXXXXXXXXXXGAXXXXXXXXXXXXXXXXXXGXXXXXXXXXXXXXXXXXXXGXXXXXXXXXXXXXXXXXXXGXXXXXXXXXXXXXXXXXXXGXXXXXXXXXXXXXXXXXXXGXXXXXXXXXXXXXXXXXXXGXXXXXXXXXXXXXXXXXXX,0,300,0
9093,14,1,13,94,192,0,0,205,85,120,GXXXXXXXXXXXXXXXXXXXGXXXXXXXXXXXXXXXXXXXGXXXXXXXXXXXXXXXXXXXGXXXXXXXXXXXXXXXXXXXGXXXXXXXXXXXXXXXXXXXGXXXXXXXXXXXXXXXXXXXGAXXXXXXXXXXXXXXXXXXGXXXXXXXXXXXXXXXXXXXGXXXXXXXXXXXXXXXXXXXGXXXXXXXXXXXXXXXXXXXGXXXXXXXXXXXXXXXXXXXGXXXXXXXXXXXXXXXXXXXGXXXXXXXXXXXXXXXXXXX,0,300,0
9114,13,0,13,93,194,0,0,206,84,122,GXXXXXXXXXXXXXXXXXXXGXXXXXXXXXXXXXXXXXXXGXXXXXXXXXXXXXXXXXXXGXXXXXXXXXXXXXXXXXXXGXXXXXXXXXXXXXXXXXXXGXXXXXXXXXXXXXXXXXXXGXXXXXXXXXXXXXXXXXXXGXXXXXXXXXXXXXXXXXXXGXXXXXXXXXXXXXXXXXXXGXXXXXXXXXXXXXXXXXXXGXXXXXXXXXXXXXXXXXXXGXXXXXXXXXXXXXXXXXXXGXXXXXXXXXXXXXXXXXXX,0,300,0

9135,13,0,13,94,193,0,0,205,81,124,GXXXXXXXXXXXXXXXXXXXGXXXXXXXXXXXXXXXXXXXGXXXXXXXXXXXXXXXXXXXGXXXXXXXXXXXXXXXXXXXGXXXXXXXXXXXXXXXXXXXGXXXXXXXXXXXXXXXXXXXGXXXXXXXXXXXXXXXXXXXGXXXXXXXXXXXXXXXXXXXGXXXXXXXXXXXXXXXXXXXGXXXXXXXXXXXXXXXXXXXGXXXXXXXXXXXXXXXXXXXGXXXXXXXXXXXXXXXXXXXGXXXXXXXXXXXXXXXXXXX,0,300,0
9156,13,0,13,90,197,0,0,209,83,126,GXXXXXXXXXXXXXXXXXXXGXXXXXXXXXXXXXXXXXXXGXXXXXXXXXXXXXXXXXXXGXXXXXXXXXXXXXXXXXXXGXXXXXXXXXXXXXXXXXXXGXXXXXXXXXXXXXXXXXXXGXXXXXXXXXXXXXXXXXXXGXXXXXXXXXXXXXXXXXXXGXXXXXXXXXXXXXXXXXXXGXXXXXXXXXXXXXXXXXXXGXXXXXXXXXXXXXXXXXXXGXXXXXXXXXXXXXXXXXXXGXXXXXXXXXXXXXXXXXXX,0,300,0
9177,13,0,13,90,197,0,0,209,80,129,GXXXXXXXXXXXXXXXXXXXGXXXXXXXXXXXXXXXXXXXGXXXXXXXXXXXXXXXXXXXGXXXXXXXXXXXXXXXXXXXGXXXXXXXXXXXXXXXXXXXGXXXXXXXXXXXXXXXXXXXGXXXXXXXXXXXXXXXXXXXGXXXXXXXXXXXXXXXXXXXGXXXXXXXXXXXXXXXXXXXGXXXXXXXXXXXXXXXXXXXGXXXXXXXXXXXXXXXXXXXGXXXXXXXXXXXXXXXXXXXGXXXXXXXXXXXXXXXXXXX,0,300,0
9198,13,0,13,94,193,0,0,205,79,126,GXXXXXXXXXXXXXXXXXXXGXXXXXXXXXXXXXXXXXXXGXXXXXXXXXXXXXXXXXXXGXXXXXXXXXXXXXXXXXXXGXXXXXXXXXXXXXXXXXXXGXXXXXXXXXXXXXXXXXXXGXXXXXXXXXXXXXXXXXXXGXXXXXXXXXXXXXXXXXXXGXXXXXXXXXXXXXXXXXXXGXXXXXXXXXXXXXXXXXXXGXXXXXXXXXXXXXXXXXXXGXXXXXXXXXXXXXXXXXXXGXXXXXXXXXXXXXXXXXXX,0,300,0
9219,13,0,13,87,200,0,0,211,80,131,GXXXXXXXXXXXXXXXXXXXGXXXXXXXXXXXXXXXXXXXGXXXXXXXXXXXXXXXXXXXGXXXXXXXXXXXXXXXXXXXGXXXXXXXXXXXXXXXXXXXGXXXXXXXXXXXXXXXXXXXGXXXXXXXXXXXXXXXXXXXGXXXXXXXXXXXXXXXXXXXGXXXXXXXXXXXXXXXXXXXGXXXXXXXXXXXXXXXXXXXGXXXXXXXXXXXXXXXXXXXGXXXXXXXXXXXXXXXXXXXGXXXXXXXXXXXXXXXXXXX,0,300,0

9240,13,0,13,82,205,0,0,217,78,139,GXXXXXXXXXXXXXXXXXXXGXXXXXXXXXXXXXXXXXXXGXXXXXXXXXXXXXXXXXXXGXXXXXXXXXXXXXXXXXXXGXXXXXXXXXXXXXXXXXXXGXXXXXXXXXXXXXXXXXXXGXXXXXXXXXXXXXXXXXXXGXXXXXXXXXXXXXXXXXXXGXXXXXXXXXXXXXXXXXXXGXXXXXXXXXXXXXXXXXXXGXXXXXXXXXXXXXXXXXXXGXXXXXXXXXXXXXXXXXXXGXXXXXXXXXXXXXXXXXXX,0,300,0
9261,13,0,13,84,203,0,0,215,74,141,GXXXXXXXXXXXXXXXXXXXGXXXXXXXXXXXXXXXXXXXGXXXXXXXXXXXXXXXXXXXGXXXXXXXXXXXXXXXXXXXGXXXXXXXXXXXXXXXXXXXGXXXXXXXXXXXXXXXXXXXGXXXXXXXXXXXXXXXXXXXGXXXXXXXXXXXXXXXXXXXGXXXXXXXXXXXXXXXXXXXGXXXXXXXXXXXXXXXXXXXGXXXXXXXXXXXXXXXXXXXGXXXXXXXXXXXXXXXXXXXGXXXXXXXXXXXXXXXXXXX,0,300,0
9282,13,0,13,81,206,0,0,217,74,143,GXXXXXXXXXXXXXXXXXXXGXXXXXXXXXXXXXXXXXXXGXXXXXXXXXXXXXXXXXXXGXXXXXXXXXXXXXXXXXXXGXXXXXXXXXXXXXXXXXXXGXXXXXXXXXXXXXXXXXXXGXXXXXXXXXXXXXXXXXXXGXXXXXXXXXXXXXXXXXXXGXXXXXXXXXXXXXXXXXXXGXXXXXXXXXXXXXXXXXXXGXXXXXXXXXXXXXXXXXXXGXXXXXXXXXXXXXXXXXXXGXXXXXXXXXXXXXXXXXXX,0,300,0
9303,13,0,13,88,199,0,0,211,73,138,GXXXXXXXXXXXXXXXXXXXGXXXXXXXXXXXXXXXXXXXGXXXXXXXXXXXXXXXXXXXGXXXXXXXXXXXXXXXXXXXGXXXXXXXXXXXXXXXXXXXGXXXXXXXXXXXXXXXXXXXGXXXXXXXXXXXXXXXXXXXGXXXXXXXXXXXXXXXXXXXGXXXXXXXXXXXXXXXXXXXGXXXXXXXXXXXXXXXXXXXGXXXXXXXXXXXXXXXXXXXGXXXXXXXXXXXXXXXXXXXGXXXXXXXXXXXXXXXXXXX,0,300,0
9324,13,0,13,78,209,0,0,220,74,146,GXXXXXXXXXXXXXXXXXXXGXXXXXXXXXXXXXXXXXXXGXXXXXXXXXXXXXXXXXXXGXXXXXXXXXXXXXXXXXXXGXXXXXXXXXXXXXXXXXXXGXXXXXXXXXXXXXXXXXXXGXXXXXXXXXXXXXXXXXXXGXXXXXXXXXXXXXXXXXXXGXXXXXXXXXXXXXXXXXXXGXXXXXXXXXXXXXXXXXXXGXXXXXXXXXXXXXXXXXXXGXXXXXXXXXXXXXXXXXXXGXXXXXXXXXXXXXXXXXXX,0,300,0

9345,13,0,13,76,211,0,0,222,81,141,GXXXXXXXXXXXXXXXXXXXGXXXXXXXXXXXXXXXXXXXGXXXXXXXXXXXXXXXXXXXGXXXXXXXXXXXXXXXXXXXGXXXXXXXXXXXXXXXXXXXGXXXXXXXXXXXXXXXXXXXGXXXXXXXXXXXXXXXXXXXGXXXXXXXXXXXXXXXXXXXGXXXXXXXXXXXXXXXXXXXGXXXXXXXXXXXXXXXXXXXGXXXXXXXXXXXXXXXXXXXGXXXXXXXXXXXXXXXXXXXGXXXXXXXXXXXXXXXXXXX,0,300,0
9366,13,0,13,79,208,0,0,220,76,144,GXXXXXXXXXXXXXXXXXXXGXXXXXXXXXXXXXXXXXXXGXXXXXXXXXXXXXXXXXXXGXXXXXXXXXXXXXXXXXXXGXXXXXXXXXXXXXXXXXXXGXXXXXXXXXXXXXXXXXXXGXXXXXXXXXXXXXXXXXXXGXXXXXXXXXXXXXXXXXXXGXXXXXXXXXXXXXXXXXXXGXXXXXXXXXXXXXXXXXXXGXXXXXXXXXXXXXXXXXXXGXXXXXXXXXXXXXXXXXXXGXXXXXXXXXXXXXXXXXXX,0,300,0
9387,13,0,13,77,210,0,0,221,72,149,GXXXXXXXXXXXXXXXXXXXGXXXXXXXXXXXXXXXXXXXGXXXXXXXXXXXXXXXXXXXGXXXXXXXXXXXXXXXXXXXGXXXXXXXXXXXXXXXXXXXGXXXXXXXXXXXXXXXXXXXGXXXXXXXXXXXXXXXXXXXGXXXXXXXXXXXXXXXXXXXGXXXXXXXXXXXXXXXXXXXGXXXXXXXXXXXXXXXXXXXGXXXXXXXXXXXXXXXXXXXGXXXXXXXXXXXXXXXXXXXGXXXXXXXXXXXXXXXXXXX,0,300,0
9408,13,0,13,75,212,0,0,224,73,151,GXXXXXXXXXXXXXXXXXXXGXXXXXXXXXXXXXXXXXXXGXXXXXXXXXXXXXXXXXXXGXXXXXXXXXXXXXXXXXXXGXXXXXXXXXXXXXXXXXXXGXXXXXXXXXXXXXXXXXXXGXXXXXXXXXXXXXXXXXXXGXXXXXXXXXXXXXXXXXXXGXXXXXXXXXXXXXXXXXXXGXXXXXXXXXXXXXXXXXXXGXXXXXXXXXXXXXXXXXXXGXXXXXXXXXXXXXXXXXXXGXXXXXXXXXXXXXXXXXXX,0,300,0
9429,13,0,13,69,218,0,0,230,78,152,GXXXXXXXXXXXXXXXXXXXGXXXXXXXXXXXXXXXXXXXGXXXXXXXXXXXXXXXXXXXGXXXXXXXXXXXXXXXXXXXGXXXXXXXXXXXXXXXXXXXGXXXXXXXXXXXXXXXXXXXGXXXXXXXXXXXXXXXXXXXGXXXXXXXXXXXXXXXXXXXGXXXXXXXXXXXXXXXXXXXGXXXXXXXXXXXXXXXXXXXGXXXXXXXXXXXXXXXXXXXGXXXXXXXXXXXXXXXXXXXGXXXXXXXXXXXXXXXXXXX,0,300,0

9450,13,0,13,64,223,0,0,236,81,155,GXXXXXXXXXXXXXXXXXXXGXXXXXXXXXXXXXXXXXXXGXXXXXXXXXXXXXXXXXXXGXXXXXXXXXXXXXXXXXXXGXXXXXXXXXXXXXXXXXXXGXXXXXXXXXXXXXXXXXXXGXXXXXXXXXXXXXXXXXXXGXXXXXXXXXXXXXXXXXXXGXXXXXXXXXXXXXXXXXXXGXXXXXXXXXXXXXXXXXXXGXXXXXXXXXXXXXXXXXXXGXXXXXXXXXXXXXXXXXXXGXXXXXXXXXXXXXXXXXXX,0,300,0
9471,14,1,13,60,226,0,0,239,83,156,GXXXXXXXXXXXXXXXXXXXGXXXXXXXXXXXXXXXXXXXGXXXXXXXXXXXXXXXXXXXGXXXXXXXXXXXXXXXXXXXGXXXXXXXXXXXXXXXXXXXGXXXXXXXXXXXXXXXXXXXGXXXXXXXXXXXXXXXXXXXGAXXXXXXXXXXXXXXXXXXGXXXXXXXXXXXXXXXXXXXGXXXXXXXXXXXXXXXXXXXGXXXXXXXXXXXXXXXXXXXGXXXXXXXXXXXXXXXXXXXGXXXXXXXXXXXXXXXXXXX,0,300,0
9492,14,0,14,65,221,0,0,234,90,144,GXXXXXXXXXXXXXXXXXXXGXXXXXXXXXXXXXXXXXXXGXXXXXXXXXXXXXXXXXXXGXXXXXXXXXXXXXXXXXXXGXXXXXXXXXXXXXXXXXXXGXXXXXXXXXXXXXXXXXXXGXXXXXXXXXXXXXXXXXXXGOXXXXXXXXXXXXXXXXXXGXXXXXXXXXXXXXXXXXXXGXXXXXXXXXXXXXXXXXXXGXXXXXXXXXXXXXXXXXXXGXXXXXXXXXXXXXXXXXXXGXXXXXXXXXXXXXXXXXXX,0,300,0
9513,13,0,13,67,220,0,0,231,88,143,GXXXXXXXXXXXXXXXXXXXGXXXXXXXXXXXXXXXXXXXGXXXXXXXXXXXXXXXXXXXGXXXXXXXXXXXXXXXXXXXGXXXXXXXXXXXXXXXXXXXGXXXXXXXXXXXXXXXXXXXGXXXXXXXXXXXXXXXXXXXGXXXXXXXXXXXXXXXXXXXGXXXXXXXXXXXXXXXXXXXGXXXXXXXXXXXXXXXXXXXGXXXXXXXXXXXXXXXXXXXGXXXXXXXXXXXXXXXXXXXGXXXXXXXXXXXXXXXXXXX,0,300,0
9534,13,0,13,76,211,0,0,225,87,138,GXXXXXXXXXXXXXXXXXXXGXXXXXXXXXXXXXXXXXXXGXXXXXXXXXXXXXXXXXXXGXXXXXXXXXXXXXXXXXXXGXXXXXXXXXXXXXXXXXXXGXXXXXXXXXXXXXXXXXXXGXXXXXXXXXXXXXXXXXXXGXXXXXXXXXXXXXXXXXXXGXXXXXXXXXXXXXXXXXXXGXXXXXXXXXXXXXXXXXXXGXXXXXXXXXXXXXXXXXXXGXXXXXXXXXXXXXXXXXXXGXXXXXXXXXXXXXXXXXXX,0,300,0

9555,13,0,13,84,203,0,0,217,76,141,GXXXXXXXXXXXXXXXXXXXGXXXXXXXXXXXXXXXXXXXGXXXXXXXXXXXXXXXXXXXGXXXXXXXXXXXXXXXXXXXGXXXXXXXXXXXXXXXXXXXGXXXXXXXXXXXXXXXXXXXGXXXXXXXXXXXXXXXXXXXGXXXXXXXXXXXXXXXXXXXGXXXXXXXXXXXXXXXXXXXGXXXXXXXXXXXXXXXXXXXGXXXXXXXXXXXXXXXXXXXGXXXXXXXXXXXXXXXXXXXGXXXXXXXXXXXXXXXXXXX,0,300,0
9576,13,0,13,77,210,0,0,224,85,139,GXXXXXXXXXXXXXXXXXXXGXXXXXXXXXXXXXXXXXXXGXXXXXXXXXXXXXXXXXXXGXXXXXXXXXXXXXXXXXXXGXXXXXXXXXXXXXXXXXXXGXXXXXXXXXXXXXXXXXXXGXXXXXXXXXXXXXXXXXXXGXXXXXXXXXXXXXXXXXXXGXXXXXXXXXXXXXXXXXXXGXXXXXXXXXXXXXXXXXXXGXXXXXXXXXXXXXXXXXXXGXXXXXXXXXXXXXXXXXXXGXXXXXXXXXXXXXXXXXXX,0,300,0
9597,13,0,13,78,209,0,0,222,84,138,GXXXXXXXXXXXXXXXXXXXGXXXXXXXXXXXXXXXXXXXGXXXXXXXXXXXXXXXXXXXGXXXXXXXXXXXXXXXXXXXGXXXXXXXXXXXXXXXXXXXGXXXXXXXXXXXXXXXXXXXGXXXXXXXXXXXXXXXXXXXGXXXXXXXXXXXXXXXXXXXGXXXXXXXXXXXXXXXXXXXGXXXXXXXXXXXXXXXXXXXGXXXXXXXXXXXXXXXXXXXGXXXXXXXXXXXXXXXXXXXGXXXXXXXXXXXXXXXXXXX,0,300,0
9618,13,0,13,80,207,0,0,220,84,136,GXXXXXXXXXXXXXXXXXXXGXXXXXXXXXXXXXXXXXXXGXXXXXXXXXXXXXXXXXXXGXXXXXXXXXXXXXXXXXXXGXXXXXXXXXXXXXXXXXXXGXXXXXXXXXXXXXXXXXXXGXXXXXXXXXXXXXXXXXXXGXXXXXXXXXXXXXXXXXXXGXXXXXXXXXXXXXXXXXXXGXXXXXXXXXXXXXXXXXXXGXXXXXXXXXXXXXXXXXXXGXXXXXXXXXXXXXXXXXXXGXXXXXXXXXXXXXXXXXXX,0,300,0
9639,14,1,13,83,203,0,0,216,85,131,GXXXXXXXXXXXXXXXXXXXGXXXXXXXXXXXXXXXXXXXGXXXXXXXXXXXXXXXXXXXGAXXXXXXXXXXXXXXXXXXGXXXXXXXXXXXXXXXXXXXGXXXXXXXXXXXXXXXXXXXGXXXXXXXXXXXXXXXXXXXGXXXXXXXXXXXXXXXXXXXGXXXXXXXXXXXXXXXXXXXGXXXXXXXXXXXXXXXXXXXGXXXXXXXXXXXXXXXXXXXGXXXXXXXXXXXXXXXXXXXGXXXXXXXXXXXXXXXXXXX,0,300,0

9660,14,1,13,87,199,0,0,211,81,130,GXXXXXXXXXXXXXXXXXXXGXXXXXXXXXXXXXXXXXXXGXXXXXXXXXXXXXXXXXXXGAXXXXXXXXXXXXXXXXXXGXXXXXXXXXXXXXXXXXXXGXXXXXXXXXXXXXXXXXXXGXXXXXXXXXXXXXXXXXXXGXXXXXXXXXXXXXXXXXXXGXXXXXXXXXXXXXXXXXXXGXXXXXXXXXXXXXXXXXXXGXXXXXXXXXXXXXXXXXXXGXXXXXXXXXXXXXXXXXXXGXXXXXXXXXXXXXXXXXXX,0,300,0
9681,15,2,13,86,199,0,0,212,78,134,GXXXXXXXXXXXXXXXXXXXGAXXXXXXXXXXXXXXXXXXGXXXXXXXXXXXXXXXXXXXGAXXXXXXXXXXXXXXXXXXGXXXXXXXXXXXXXXXXXXXGXXXXXXXXXXXXXXXXXXXGXXXXXXXXXXXXXXXXXXXGXXXXXXXXXXXXXXXXXXXGXXXXXXXXXXXXXXXXXXXGXXXXXXXXXXXXXXXXXXXGXXXXXXXXXXXXXXXXXXXGXXXXXXXXXXXXXXXXXXXGXXXXXXXXXXXXXXXXXXX,0,300,0
9702,15,2,13,82,203,0,0,215,88,127,GXXXXXXXXXXXXXXXXXXXGAXXXXXXXXXXXXXXXXXXGXXXXXXXXXXXXXXXXXXXGAXXXXXXXXXXXXXXXXXXGXXXXXXXXXXXXXXXXXXXGXXXXXXXXXXXXXXXXXXXGXXXXXXXXXXXXXXXXXXXGXXXXXXXXXXXXXXXXXXXGXXXXXXXXXXXXXXXXXXXGXXXXXXXXXXXXXXXXXXXGXXXXXXXXXXXXXXXXXXXGXXXXXXXXXXXXXXXXXXXGXXXXXXXXXXXXXXXXXXX,0,300,0
9723,15,2,13,83,202,0,0,214,87,127,GXXXXXXXXXXXXXXXXXXXGAXXXXXXXXXXXXXXXXXXGXXXXXXXXXXXXXXXXXXXGAXXXXXXXXXXXXXXXXXXGXXXXXXXXXXXXXXXXXXXGXXXXXXXXXXXXXXXXXXXGXXXXXXXXXXXXXXXXXXXGXXXXXXXXXXXXXXXXXXXGXXXXXXXXXXXXXXXXXXXGXXXXXXXXXXXXXXXXXXXGXXXXXXXXXXXXXXXXXXXGXXXXXXXXXXXXXXXXXXXGXXXXXXXXXXXXXXXXXXX,0,300,0
9744,15,1,14,84,201,0,0,211,84,127,GXXXXXXXXXXXXXXXXXXXGAXXXXXXXXXXXXXXXXXXGXXXXXXXXXXXXXXXXXXXGOXXXXXXXXXXXXXXXXXXGXXXXXXXXXXXXXXXXXXXGXXXXXXXXXXXXXXXXXXXGXXXXXXXXXXXXXXXXXXXGXXXXXXXXXXXXXXXXXXXGXXXXXXXXXXXXXXXXXXXGXXXXXXXXXXXXXXXXXXXGXXXXXXXXXXXXXXXXXXXGXXXXXXXXXXXXXXXXXXXGXXXXXXXXXXXXXXXXXXX,0,300,0

9765,14,0,14,76,210,0,0,222,87,135,GXXXXXXXXXXXXXXXXXXXGOXXXXXXXXXXXXXXXXXXGXXXXXXXXXXXXXXXXXXXGXXXXXXXXXXXXXXXXXXXGXXXXXXXXXXXXXXXXXXXGXXXXXXXXXXXXXXXXXXXGXXXXXXXXXXXXXXXXXXXGXXXXXXXXXXXXXXXXXXXGXXXXXXXXXXXXXXXXXXXGXXXXXXXXXXXXXXXXXXXGXXXXXXXXXXXXXXXXXXXGXXXXXXXXXXXXXXXXXXXGXXXXXXXXXXXXXXXXXXX,0,300,0
9786,15,1,14,74,211,0,0,224,85,139,GAXXXXXXXXXXXXXXXXXXGOXXXXXXXXXXXXXXXXXXGXXXXXXXXXXXXXXXXXXXGXXXXXXXXXXXXXXXXXXXGXXXXXXXXXXXXXXXXXXXGXXXXXXXXXXXXXXXXXXXGXXXXXXXXXXXXXXXXXXXGXXXXXXXXXXXXXXXXXXXGXXXXXXXXXXXXXXXXXXXGXXXXXXXXXXXXXXXXXXXGXXXXXXXXXXXXXXXXXXXGXXXXXXXXXXXXXXXXXXXGXXXXXXXXXXXXXXXXXXX,0,300,0
9807,14,1,13,74,212,0,0,224,81,143,GAXXXXXXXXXXXXXXXXXXGXXXXXXXXXXXXXXXXXXXGXXXXXXXXXXXXXXXXXXXGXXXXXXXXXXXXXXXXXXXGXXXXXXXXXXXXXXXXXXXGXXXXXXXXXXXXXXXXXXXGXXXXXXXXXXXXXXXXXXXGXXXXXXXXXXXXXXXXXXXGXXXXXXXXXXXXXXXXXXXGXXXXXXXXXXXXXXXXXXXGXXXXXXXXXXXXXXXXXXXGXXXXXXXXXXXXXXXXXXXGXXXXXXXXXXXXXXXXXXX,0,300,0
9828,14,0,14,75,211,0,0,223,82,141,GOXXXXXXXXXXXXXXXXXXGXXXXXXXXXXXXXXXXXXXGXXXXXXXXXXXXXXXXXXXGXXXXXXXXXXXXXXXXXXXGXXXXXXXXXXXXXXXXXXXGXXXXXXXXXXXXXXXXXXXGXXXXXXXXXXXXXXXXXXXGXXXXXXXXXXXXXXXXXXXGXXXXXXXXXXXXXXXXXXXGXXXXXXXXXXXXXXXXXXXGXXXXXXXXXXXXXXXXXXXGXXXXXXXXXXXXXXXXXXXGXXXXXXXXXXXXXXXXXXX,0,300,0
9849,14,0,14,67,219,0,0,231,83,148,GOXXXXXXXXXXXXXXXXXXGXXXXXXXXXXXXXXXXXXXGXXXXXXXXXXXXXXXXXXXGXXXXXXXXXXXXXXXXXXXGXXXXXXXXXXXXXXXXXXXGXXXXXXXXXXXXXXXXXXXGXXXXXXXXXXXXXXXXXXXGXXXXXXXXXXXXXXXXXXXGXXXXXXXXXXXXXXXXXXXGXXXXXXXXXXXXXXXXXXXGXXXXXXXXXXXXXXXXXXXGXXXXXXXXXXXXXXXXXXXGXXXXXXXXXXXXXXXXXXX,0,300,0

9870,13,0,13,75,212,0,0,226,81,145,GXXXXXXXXXXXXXXXXXXXGXXXXXXXXXXXXXXXXXXXGXXXXXXXXXXXXXXXXXXXGXXXXXXXXXXXXXXXXXXXGXXXXXXXXXXXXXXXXXXXGXXXXXXXXXXXXXXXXXXXGXXXXXXXXXXXXXXXXXXXGXXXXXXXXXXXXXXXXXXXGXXXXXXXXXXXXXXXXXXXGXXXXXXXXXXXXXXXXXXXGXXXXXXXXXXXXXXXXXXXGXXXXXXXXXXXXXXXXXXXGXXXXXXXXXXXXXXXXXXX,0,300,0
9891,13,0,13,73,214,0,0,228,80,148,GXXXXXXXXXXXXXXXXXXXGXXXXXXXXXXXXXXXXXXXGXXXXXXXXXXXXXXXXXXXGXXXXXXXXXXXXXXXXXXXGXXXXXXXXXXXXXXXXXXXGXXXXXXXXXXXXXXXXXXXGXXXXXXXXXXXXXXXXXXXGXXXXXXXXXXXXXXXXXXXGXXXXXXXXXXXXXXXXXXXGXXXXXXXXXXXXXXXXXXXGXXXXXXXXXXXXXXXXXXXGXXXXXXXXXXXXXXXXXXXGXXXXXXXXXXXXXXXXXXX,0,300,0
9912,13,0,13,70,217,0,0,230,79,151,GXXXXXXXXXXXXXXXXXXXGXXXXXXXXXXXXXXXXXXXGXXXXXXXXXXXXXXXXXXXGXXXXXXXXXXXXXXXXXXXGXXXXXXXXXXXXXXXXXXXGXXXXXXXXXXXXXXXXXXXGXXXXXXXXXXXXXXXXXXXGXXXXXXXXXXXXXXXXXXXGXXXXXXXXXXXXXXXXXXXGXXXXXXXXXXXXXXXXXXXGXXXXXXXXXXXXXXXXXXXGXXXXXXXXXXXXXXXXXXXGXXXXXXXXXXXXXXXXXXX,0,300,0
9933,13,0,13,67,220,0,0,232,80,152,GXXXXXXXXXXXXXXXXXXXGXXXXXXXXXXXXXXXXXXXGXXXXXXXXXXXXXXXXXXXGXXXXXXXXXXXXXXXXXXXGXXXXXXXXXXXXXXXXXXXGXXXXXXXXXXXXXXXXXXXGXXXXXXXXXXXXXXXXXXXGXXXXXXXXXXXXXXXXXXXGXXXXXXXXXXXXXXXXXXXGXXXXXXXXXXXXXXXXXXXGXXXXXXXXXXXXXXXXXXXGXXXXXXXXXXXXXXXXXXXGXXXXXXXXXXXXXXXXXXX,0,300,0
9954,13,0,13,73,214,0,0,228,79,149,GXXXXXXXXXXXXXXXXXXXGXXXXXXXXXXXXXXXXXXXGXXXXXXXXXXXXXXXXXXXGXXXXXXXXXXXXXXXXXXXGXXXXXXXXXXXXXXXXXXXGXXXXXXXXXXXXXXXXXXXGXXXXXXXXXXXXXXXXXXXGXXXXXXXXXXXXXXXXXXXGXXXXXXXXXXXXXXXXXXXGXXXXXXXXXXXXXXXXXXXGXXXXXXXXXXXXXXXXXXXGXXXXXXXXXXXXXXXXXXXGXXXXXXXXXXXXXXXXXXX,0,300,0

9975,13,0,13,69,218,0,0,232,80,152,GXXXXXXXXXXXXXXXXXXXGXXXXXXXXXXXXXXXXXXXGXXXXXXXXXXXXXXXXXXXGXXXXXXXXXXXXXXXXXXXGXXXXXXXXXXXXXXXXXXXGXXXXXXXXXXXXXXXXXXXGXXXXXXXXXXXXXXXXXXXGXXXXXXXXXXXXXXXXXXXGXXXXXXXXXXXXXXXXXXXGXXXXXXXXXXXXXXXXXXXGXXXXXXXXXXXXXXXXXXXGXXXXXXXXXXXXXXXXXXXGXXXXXXXXXXXXXXXXXXX,0,300,0
9996,13,0,13,73,214,0,0,226,79,147,GXXXXXXXXXXXXXXXXXXXGXXXXXXXXXXXXXXXXXXXGXXXXXXXXXXXXXXXXXXXGXXXXXXXXXXXXXXXXXXXGXXXXXXXXXXXXXXXXXXXGXXXXXXXXXXXXXXXXXXXGXXXXXXXXXXXXXXXXXXXGXXXXXXXXXXXXXXXXXXXGXXXXXXXXXXXXXXXXXXXGXXXXXXXXXXXXXXXXXXXGXXXXXXXXXXXXXXXXXXXGXXXXXXXXXXXXXXXXXXXGXXXXXXXXXXXXXXXXXXX,0,300,0
10017,13,0,13,71,216,0,0,228,84,144,GXXXXXXXXXXXXXXXXXXXGXXXXXXXXXXXXXXXXXXXGXXXXXXXXXXXXXXXXXXXGXXXXXXXXXXXXXXXXXXXGXXXXXXXXXXXXXXXXXXXGXXXXXXXXXXXXXXXXXXXGXXXXXXXXXXXXXXXXXXXGXXXXXXXXXXXXXXXXXXXGXXXXXXXXXXXXXXXXXXXGXXXXXXXXXXXXXXXXXXXGXXXXXXXXXXXXXXXXXXXGXXXXXXXXXXXXXXXXXXXGXXXXXXXXXXXXXXXXXXX,0,300,0
10038,13,0,13,71,216,0,0,226,81,145,GXXXXXXXXXXXXXXXXXXXGXXXXXXXXXXXXXXXXXXXGXXXXXXXXXXXXXXXXXXXGXXXXXXXXXXXXXXXXXXXGXXXXXXXXXXXXXXXXXXXGXXXXXXXXXXXXXXXXXXXGXXXXXXXXXXXXXXXXXXXGXXXXXXXXXXXXXXXXXXXGXXXXXXXXXXXXXXXXXXXGXXXXXXXXXXXXXXXXXXXGXXXXXXXXXXXXXXXXXXXGXXXXXXXXXXXXXXXXXXXGXXXXXXXXXXXXXXXXXXX,0,300,0
10059,13,0,13,73,214,0,0,225,84,141,GXXXXXXXXXXXXXXXXXXXGXXXXXXXXXXXXXXXXXXXGXXXXXXXXXXXXXXXXXXXGXXXXXXXXXXXXXXXXXXXGXXXXXXXXXXXXXXXXXXXGXXXXXXXXXXXXXXXXXXXGXXXXXXXXXXXXXXXXXXXGXXXXXXXXXXXXXXXXXXXGXXXXXXXXXXXXXXXXXXXGXXXXXXXXXXXXXXXXXXXGXXXXXXXXXXXXXXXXXXXGXXXXXXXXXXXXXXXXXXXGXXXXXXXXXXXXXXXXXXX,0,300,0

10080,13,0,13,70,217,0,0,228,84,144,GXXXXXXXXXXXXXXXXXXXGXXXXXXXXXXXXXXXXXXXGXXXXXXXXXXXXXXXXXXXGXXXXXXXXXXXXXXXXXXXGXXXXXXXXXXXXXXXXXXXGXXXXXXXXXXXXXXXXXXXGXXXXXXXXXXXXXXXXXXXGXXXXXXXXXXXXXXXXXXXGXXXXXXXXXXXXXXXXXXXGXXXXXXXXXXXXXXXXXXXGXXXXXXXXXXXXXXXXXXXGXXXXXXXXXXXXXXXXXXXGXXXXXXXXXXXXXXXXXXX,0,300,0
10101,13,0,13,71,216,0,0,227,82,145,GXXXXXXXXXXXXXXXXXXXGXXXXXXXXXXXXXXXXXXXGXXXXXXXXXXXXXXXXXXXGXXXXXXXXXXXXXXXXXXXGXXXXXXXXXXXXXXXXXXXGXXXXXXXXXXXXXXXXXXXGXXXXXXXXXXXXXXXXXXXGXXXXXXXXXXXXXXXXXXXGXXXXXXXXXXXXXXXXXXXGXXXXXXXXXXXXXXXXXXXGXXXXXXXXXXXXXXXXXXXGXXXXXXXXXXXXXXXXXXXGXXXXXXXXXXXXXXXXXXX,0,300,0
10122,13,0,13,64,223,0,0,234,91,143,GXXXXXXXXXXXXXXXXXXXGXXXXXXXXXXXXXXXXXXXGXXXXXXXXXXXXXXXXXXXGXXXXXXXXXXXXXXXXXXXGXXXXXXXXXXXXXXXXXXXGXXXXXXXXXXXXXXXXXXXGXXXXXXXXXXXXXXXXXXXGXXXXXXXXXXXXXXXXXXXGXXXXXXXXXXXXXXXXXXXGXXXXXXXXXXXXXXXXXXXGXXXXXXXXXXXXXXXXXXXGXXXXXXXXXXXXXXXXXXXGXXXXXXXXXXXXXXXXXXX,0,300,0
10143,13,0,13,69,218,0,0,230,93,137,GXXXXXXXXXXXXXXXXXXXGXXXXXXXXXXXXXXXXXXXGXXXXXXXXXXXXXXXXXXXGXXXXXXXXXXXXXXXXXXXGXXXXXXXXXXXXXXXXXXXGXXXXXXXXXXXXXXXXXXXGXXXXXXXXXXXXXXXXXXXGXXXXXXXXXXXXXXXXXXXGXXXXXXXXXXXXXXXXXXXGXXXXXXXXXXXXXXXXXXXGXXXXXXXXXXXXXXXXXXXGXXXXXXXXXXXXXXXXXXXGXXXXXXXXXXXXXXXXXXX,0,300,0
10164,13,0,13,74,213,0,0,223,88,135,GXXXXXXXXXXXXXXXXXXXGXXXXXXXXXXXXXXXXXXXGXXXXXXXXXXXXXXXXXXXGXXXXXXXXXXXXXXXXXXXGXXXXXXXXXXXXXXXXXXXGXXXXXXXXXXXXXXXXXXXGXXXXXXXXXXXXXXXXXXXGXXXXXXXXXXXXXXXXXXXGXXXXXXXXXXXXXXXXXXXGXXXXXXXXXXXXXXXXXXXGXXXXXXXXXXXXXXXXXXXGXXXXXXXXXXXXXXXXXXXGXXXXXXXXXXXXXXXXXXX,0,300,0

10185,13,0,13,81,206,0,0,218,90,128,GXXXXXXXXXXXXXXXXXXXGXXXXXXXXXXXXXXXXXXXGXXXXXXXXXXXXXXXXXXXGXXXXXXXXXXXXXXXXXXXGXXXXXXXXXXXXXXXXXXXGXXXXXXXXXXXXXXXXXXXGXXXXXXXXXXXXXXXXXXXGXXXXXXXXXXXXXXXXXXXGXXXXXXXXXXXXXXXXXXXGXXXXXXXXXXXXXXXXXXXGXXXXXXXXXXXXXXXXXXXGXXXXXXXXXXXXXXXXXXXGXXXXXXXXXXXXXXXXXXX,0,300,0
10206,13,0,13,84,203,0,0,215,91,124,GXXXXXXXXXXXXXXXXXXXGXXXXXXXXXXXXXXXXXXXGXXXXXXXXXXXXXXXXXXXGXXXXXXXXXXXXXXXXXXXGXXXXXXXXXXXXXXXXXXXGXXXXXXXXXXXXXXXXXXXGXXXXXXXXXXXXXXXXXXXGXXXXXXXXXXXXXXXXXXXGXXXXXXXXXXXXXXXXXXXGXXXXXXXXXXXXXXXXXXXGXXXXXXXXXXXXXXXXXXXGXXXXXXXXXXXXXXXXXXXGXXXXXXXXXXXXXXXXXXX,0,300,0
10227,13,0,13,88,199,0,0,210,89,121,GXXXXXXXXXXXXXXXXXXXGXXXXXXXXXXXXXXXXXXXGXXXXXXXXXXXXXXXXXXXGXXXXXXXXXXXXXXXXXXXGXXXXXXXXXXXXXXXXXXXGXXXXXXXXXXXXXXXXXXXGXXXXXXXXXXXXXXXXXXXGXXXXXXXXXXXXXXXXXXXGXXXXXXXXXXXXXXXXXXXGXXXXXXXXXXXXXXXXXXXGXXXXXXXXXXXXXXXXXXXGXXXXXXXXXXXXXXXXXXXGXXXXXXXXXXXXXXXXXXX,0,300,0
10248,13,0,13,85,202,0,0,214,89,125,GXXXXXXXXXXXXXXXXXXXGXXXXXXXXXXXXXXXXXXXGXXXXXXXXXXXXXXXXXXXGXXXXXXXXXXXXXXXXXXXGXXXXXXXXXXXXXXXXXXXGXXXXXXXXXXXXXXXXXXXGXXXXXXXXXXXXXXXXXXXGXXXXXXXXXXXXXXXXXXXGXXXXXXXXXXXXXXXXXXXGXXXXXXXXXXXXXXXXXXXGXXXXXXXXXXXXXXXXXXXGXXXXXXXXXXXXXXXXXXXGXXXXXXXXXXXXXXXXXXX,0,300,0
10269,13,0,13,90,197,0,0,209,94,115,GXXXXXXXXXXXXXXXXXXXGXXXXXXXXXXXXXXXXXXXGXXXXXXXXXXXXXXXXXXXGXXXXXXXXXXXXXXXXXXXGXXXXXXXXXXXXXXXXXXXGXXXXXXXXXXXXXXXXXXXGXXXXXXXXXXXXXXXXXXXGXXXXXXXXXXXXXXXXXXXGXXXXXXXXXXXXXXXXXXXGXXXXXXXXXXXXXXXXXXXGXXXXXXXXXXXXXXXXXXXGXXXXXXXXXXXXXXXXXXXGXXXXXXXXXXXXXXXXXXX,0,300,0

10290,13,0,13,86,201,0,0,213,97,116,GXXXXXXXXXXXXXXXXXXXGXXXXXXXXXXXXXXXXXXXGXXXXXXXXXXXXXXXXXXXGXXXXXXXXXXXXXXXXXXXGXXXXXXXXXXXXXXXXXXXGXXXXXXXXXXXXXXXXXXXGXXXXXXXXXXXXXXXXXXXGXXXXXXXXXXXXXXXXXXXGXXXXXXXXXXXXXXXXXXXGXXXXXXXXXXXXXXXXXXXGXXXXXXXXXXXXXXXXXXXGXXXXXXXXXXXXXXXXXXXGXXXXXXXXXXXXXXXXXXX,0,300,0
10311,13,0,13,90,197,0,0,210,87,123,GXXXXXXXXXXXXXXXXXXXGXXXXXXXXXXXXXXXXXXXGXXXXXXXXXXXXXXXXXXXGXXXXXXXXXXXXXXXXXXXGXXXXXXXXXXXXXXXXXXXGXXXXXXXXXXXXXXXXXXXGXXXXXXXXXXXXXXXXXXXGXXXXXXXXXXXXXXXXXXXGXXXXXXXXXXXXXXXXXXXGXXXXXXXXXXXXXXXXXXXGXXXXXXXXXXXXXXXXXXXGXXXXXXXXXXXXXXXXXXXGXXXXXXXXXXXXXXXXXXX,0,300,0
10332,13,0,13,91,196,0,0,209,88,121,GXXXXXXXXXXXXXXXXXXXGXXXXXXXXXXXXXXXXXXXGXXXXXXXXXXXXXXXXXXXGXXXXXXXXXXXXXXXXXXXGXXXXXXXXXXXXXXXXXXXGXXXXXXXXXXXXXXXXXXXGXXXXXXXXXXXXXXXXXXXGXXXXXXXXXXXXXXXXXXXGXXXXXXXXXXXXXXXXXXXGXXXXXXXXXXXXXXXXXXXGXXXXXXXXXXXXXXXXXXXGXXXXXXXXXXXXXXXXXXXGXXXXXXXXXXXXXXXXXXX,0,300,0
10353,13,0,13,85,202,0,0,213,93,120,GXXXXXXXXXXXXXXXXXXXGXXXXXXXXXXXXXXXXXXXGXXXXXXXXXXXXXXXXXXXGXXXXXXXXXXXXXXXXXXXGXXXXXXXXXXXXXXXXXXXGXXXXXXXXXXXXXXXXXXXGXXXXXXXXXXXXXXXXXXXGXXXXXXXXXXXXXXXXXXXGXXXXXXXXXXXXXXXXXXXGXXXXXXXXXXXXXXXXXXXGXXXXXXXXXXXXXXXXXXXGXXXXXXXXXXXXXXXXXXXGXXXXXXXXXXXXXXXXXXX,0,300,0
10374,13,0,13,85,202,0,0,214,90,124,GXXXXXXXXXXXXXXXXXXXGXXXXXXXXXXXXXXXXXXXGXXXXXXXXXXXXXXXXXXXGXXXXXXXXXXXXXXXXXXXGXXXXXXXXXXXXXXXXXXXGXXXXXXXXXXXXXXXXXXXGXXXXXXXXXXXXXXXXXXXGXXXXXXXXXXXXXXXXXXXGXXXXXXXXXXXXXXXXXXXGXXXXXXXXXXXXXXXXXXXGXXXXXXXXXXXXXXXXXXXGXXXXXXXXXXXXXXXXXXXGXXXXXXXXXXXXXXXXXXX,0,300,0

10395,13,0,13,86,201,0,0,212,86,126,GXXXXXXXXXXXXXXXXXXXGXXXXXXXXXXXXXXXXXXXGXXXXXXXXXXXXXXXXXXXGXXXXXXXXXXXXXXXXXXXGXXXXXXXXXXXXXXXXXXXGXXXXXXXXXXXXXXXXXXXGXXXXXXXXXXXXXXXXXXXGXXXXXXXXXXXXXXXXXXXGXXXXXXXXXXXXXXXXXXXGXXXXXXXXXXXXXXXXXXXGXXXXXXXXXXXXXXXXXXXGXXXXXXXXXXXXXXXXXXXGXXXXXXXXXXXXXXXXXXX,0,300,0
10416,13,0,13,83,204,0,0,215,83,132,GXXXXXXXXXXXXXXXXXXXGXXXXXXXXXXXXXXXXXXXGXXXXXXXXXXXXXXXXXXXGXXXXXXXXXXXXXXXXXXXGXXXXXXXXXXXXXXXXXXXGXXXXXXXXXXXXXXXXXXXGXXXXXXXXXXXXXXXXXXXGXXXXXXXXXXXXXXXXXXXGXXXXXXXXXXXXXXXXXXXGXXXXXXXXXXXXXXXXXXXGXXXXXXXXXXXXXXXXXXXGXXXXXXXXXXXXXXXXXXXGXXXXXXXXXXXXXXXXXXX,0,300,0
10437,13,0,13,84,203,0,0,215,81,134,GXXXXXXXXXXXXXXXXXXXGXXXXXXXXXXXXXXXXXXXGXXXXXXXXXXXXXXXXXXXGXXXXXXXXXXXXXXXXXXXGXXXXXXXXXXXXXXXXXXXGXXXXXXXXXXXXXXXXXXXGXXXXXXXXXXXXXXXXXXXGXXXXXXXXXXXXXXXXXXXGXXXXXXXXXXXXXXXXXXXGXXXXXXXXXXXXXXXXXXXGXXXXXXXXXXXXXXXXXXXGXXXXXXXXXXXXXXXXXXXGXXXXXXXXXXXXXXXXXXX,0,300,0
10458,13,0,13,84,203,0,0,215,82,133,GXXXXXXXXXXXXXXXXXXXGXXXXXXXXXXXXXXXXXXXGXXXXXXXXXXXXXXXXXXXGXXXXXXXXXXXXXXXXXXXGXXXXXXXXXXXXXXXXXXXGXXXXXXXXXXXXXXXXXXXGXXXXXXXXXXXXXXXXXXXGXXXXXXXXXXXXXXXXXXXGXXXXXXXXXXXXXXXXXXXGXXXXXXXXXXXXXXXXXXXGXXXXXXXXXXXXXXXXXXXGXXXXXXXXXXXXXXXXXXXGXXXXXXXXXXXXXXXXXXX,0,300,0
10479,13,0,13,74,213,0,0,225,80,145,GXXXXXXXXXXXXXXXXXXXGXXXXXXXXXXXXXXXXXXXGXXXXXXXXXXXXXXXXXXXGXXXXXXXXXXXXXXXXXXXGXXXXXXXXXXXXXXXXXXXGXXXXXXXXXXXXXXXXXXXGXXXXXXXXXXXXXXXXXXXGXXXXXXXXXXXXXXXXXXXGXXXXXXXXXXXXXXXXXXXGXXXXXXXXXXXXXXXXXXXGXXXXXXXXXXXXXXXXXXXGXXXXXXXXXXXXXXXXXXXGXXXXXXXXXXXXXXXXXXX,0,300,0

10500,13,0,13,76,211,0,0,223,82,141,GXXXXXXXXXXXXXXXXXXXGXXXXXXXXXXXXXXXXXXXGXXXXXXXXXXXXXXXXXXXGXXXXXXXXXXXXXXXXXXXGXXXXXXXXXXXXXXXXXXXGXXXXXXXXXXXXXXXXXXXGXXXXXXXXXXXXXXXXXXXGXXXXXXXXXXXXXXXXXXXGXXXXXXXXXXXXXXXXXXXGXXXXXXXXXXXXXXXXXXXGXXXXXXXXXXXXXXXXXXXGXXXXXXXXXXXXXXXXXXXGXXXXXXXXXXXXXXXXXXX,0,300,0
10521,13,0,13,72,215,0,0,227,80,147,GXXXXXXXXXXXXXXXXXXXGXXXXXXXXXXXXXXXXXXXGXXXXXXXXXXXXXXXXXXXGXXXXXXXXXXXXXXXXXXXGXXXXXXXXXXXXXXXXXXXGXXXXXXXXXXXXXXXXXXXGXXXXXXXXXXXXXXXXXXXGXXXXXXXXXXXXXXXXXXXGXXXXXXXXXXXXXXXXXXXGXXXXXXXXXXXXXXXXXXXGXXXXXXXXXXXXXXXXXXXGXXXXXXXXXXXXXXXXXXXGXXXXXXXXXXXXXXXXXXX,0,300,0
10542,13,0,13,71,216,0,0,228,85,143,GXXXXXXXXXXXXXXXXXXXGXXXXXXXXXXXXXXXXXXXGXXXXXXXXXXXXXXXXXXXGXXXXXXXXXXXXXXXXXXXGXXXXXXXXXXXXXXXXXXXGXXXXXXXXXXXXXXXXXXXGXXXXXXXXXXXXXXXXXXXGXXXXXXXXXXXXXXXXXXXGXXXXXXXXXXXXXXXXXXXGXXXXXXXXXXXXXXXXXXXGXXXXXXXXXXXXXXXXXXXGXXXXXXXXXXXXXXXXXXXGXXXXXXXXXXXXXXXXXXX,0,300,0
10563,13,0,13,70,217,0,0,229,85,144,GXXXXXXXXXXXXXXXXXXXGXXXXXXXXXXXXXXXXXXXGXXXXXXXXXXXXXXXXXXXGXXXXXXXXXXXXXXXXXXXGXXXXXXXXXXXXXXXXXXXGXXXXXXXXXXXXXXXXXXXGXXXXXXXXXXXXXXXXXXXGXXXXXXXXXXXXXXXXXXXGXXXXXXXXXXXXXXXXXXXGXXXXXXXXXXXXXXXXXXXGXXXXXXXXXXXXXXXXXXXGXXXXXXXXXXXXXXXXXXXGXXXXXXXXXXXXXXXXXXX,0,300,0
10584,13,0,13,69,218,0,0,229,86,143,GXXXXXXXXXXXXXXXXXXXGXXXXXXXXXXXXXXXXXXXGXXXXXXXXXXXXXXXXXXXGXXXXXXXXXXXXXXXXXXXGXXXXXXXXXXXXXXXXXXXGXXXXXXXXXXXXXXXXXXXGXXXXXXXXXXXXXXXXXXXGXXXXXXXXXXXXXXXXXXXGXXXXXXXXXXXXXXXXXXXGXXXXXXXXXXXXXXXXXXXGXXXXXXXXXXXXXXXXXXXGXXXXXXXXXXXXXXXXXXXGXXXXXXXXXXXXXXXXXXX,0,300,0

10605,13,0,13,76,211,0,0,223,84,139,GXXXXXXXXXXXXXXXXXXXGXXXXXXXXXXXXXXXXXXXGXXXXXXXXXXXXXXXXXXXGXXXXXXXXXXXXXXXXXXXGXXXXXXXXXXXXXXXXXXXGXXXXXXXXXXXXXXXXXXXGXXXXXXXXXXXXXXXXXXXGXXXXXXXXXXXXXXXXXXXGXXXXXXXXXXXXXXXXXXXGXXXXXXXXXXXXXXXXXXXGXXXXXXXXXXXXXXXXXXXGXXXXXXXXXXXXXXXXXXXGXXXXXXXXXXXXXXXXXXX,0,300,0
10626,13,0,13,75,212,0,0,224,84,140,GXXXXXXXXXXXXXXXXXXXGXXXXXXXXXXXXXXXXXXXGXXXXXXXXXXXXXXXXXXXGXXXXXXXXXXXXXXXXXXXGXXXXXXXXXXXXXXXXXXXGXXXXXXXXXXXXXXXXXXXGXXXXXXXXXXXXXXXXXXXGXXXXXXXXXXXXXXXXXXXGXXXXXXXXXXXXXXXXXXXGXXXXXXXXXXXXXXXXXXXGXXXXXXXXXXXXXXXXXXXGXXXXXXXXXXXXXXXXXXXGXXXXXXXXXXXXXXXXXXX,0,300,0
10647,13,0,13,78,209,0,0,222,85,137,GXXXXXXXXXXXXXXXXXXXGXXXXXXXXXXXXXXXXXXXGXXXXXXXXXXXXXXXXXXXGXXXXXXXXXXXXXXXXXXXGXXXXXXXXXXXXXXXXXXXGXXXXXXXXXXXXXXXXXXXGXXXXXXXXXXXXXXXXXXXGXXXXXXXXXXXXXXXXXXXGXXXXXXXXXXXXXXXXXXXGXXXXXXXXXXXXXXXXXXXGXXXXXXXXXXXXXXXXXXXGXXXXXXXXXXXXXXXXXXXGXXXXXXXXXXXXXXXXXXX,0,300,0
10668,13,0,13,81,206,0,0,219,86,133,GXXXXXXXXXXXXXXXXXXXGXXXXXXXXXXXXXXXXXXXGXXXXXXXXXXXXXXXXXXXGXXXXXXXXXXXXXXXXXXXGXXXXXXXXXXXXXXXXXXXGXXXXXXXXXXXXXXXXXXXGXXXXXXXXXXXXXXXXXXXGXXXXXXXXXXXXXXXXXXXGXXXXXXXXXXXXXXXXXXXGXXXXXXXXXXXXXXXXXXXGXXXXXXXXXXXXXXXXXXXGXXXXXXXXXXXXXXXXXXXGXXXXXXXXXXXXXXXXXXX,0,300,0
10689,13,0,13,82,205,0,0,218,92,126,GXXXXXXXXXXXXXXXXXXXGXXXXXXXXXXXXXXXXXXXGXXXXXXXXXXXXXXXXXXXGXXXXXXXXXXXXXXXXXXXGXXXXXXXXXXXXXXXXXXXGXXXXXXXXXXXXXXXXXXXGXXXXXXXXXXXXXXXXXXXGXXXXXXXXXXXXXXXXXXXGXXXXXXXXXXXXXXXXXXXGXXXXXXXXXXXXXXXXXXXGXXXXXXXXXXXXXXXXXXXGXXXXXXXXXXXXXXXXXXXGXXXXXXXXXXXXXXXXXXX,0,300,0

10710,13,0,13,85,202,0,0,215,92,123,GXXXXXXXXXXXXXXXXXXXGXXXXXXXXXXXXXXXXXXXGXXXXXXXXXXXXXXXXXXXGXXXXXXXXXXXXXXXXXXXGXXXXXXXXXXXXXXXXXXXGXXXXXXXXXXXXXXXXXXXGXXXXXXXXXXXXXXXXXXXGXXXXXXXXXXXXXXXXXXXGXXXXXXXXXXXXXXXXXXXGXXXXXXXXXXXXXXXXXXXGXXXXXXXXXXXXXXXXXXXGXXXXXXXXXXXXXXXXXXXGXXXXXXXXXXXXXXXXXXX,0,300,0
10731,13,0,13,84,203,0,0,216,92,124,GXXXXXXXXXXXXXXXXXXXGXXXXXXXXXXXXXXXXXXXGXXXXXXXXXXXXXXXXXXXGXXXXXXXXXXXXXXXXXXXGXXXXXXXXXXXXXXXXXXXGXXXXXXXXXXXXXXXXXXXGXXXXXXXXXXXXXXXXXXXGXXXXXXXXXXXXXXXXXXXGXXXXXXXXXXXXXXXXXXXGXXXXXXXXXXXXXXXXXXXGXXXXXXXXXXXXXXXXXXXGXXXXXXXXXXXXXXXXXXXGXXXXXXXXXXXXXXXXXXX,0,300,0
10752,13,0,13,80,207,0,0,220,96,124,GXXXXXXXXXXXXXXXXXXXGXXXXXXXXXXXXXXXXXXXGXXXXXXXXXXXXXXXXXXXGXXXXXXXXXXXXXXXXXXXGXXXXXXXXXXXXXXXXXXXGXXXXXXXXXXXXXXXXXXXGXXXXXXXXXXXXXXXXXXXGXXXXXXXXXXXXXXXXXXXGXXXXXXXXXXXXXXXXXXXGXXXXXXXXXXXXXXXXXXXGXXXXXXXXXXXXXXXXXXXGXXXXXXXXXXXXXXXXXXXGXXXXXXXXXXXXXXXXXXX,0,300,0
10773,13,0,13,85,202,0,0,216,87,129,GXXXXXXXXXXXXXXXXXXXGXXXXXXXXXXXXXXXXXXXGXXXXXXXXXXXXXXXXXXXGXXXXXXXXXXXXXXXXXXXGXXXXXXXXXXXXXXXXXXXGXXXXXXXXXXXXXXXXXXXGXXXXXXXXXXXXXXXXXXXGXXXXXXXXXXXXXXXXXXXGXXXXXXXXXXXXXXXXXXXGXXXXXXXXXXXXXXXXXXXGXXXXXXXXXXXXXXXXXXXGXXXXXXXXXXXXXXXXXXXGXXXXXXXXXXXXXXXXXXX,0,300,0
10794,13,0,13,90,197,0,0,211,88,123,GXXXXXXXXXXXXXXXXXXXGXXXXXXXXXXXXXXXXXXXGXXXXXXXXXXXXXXXXXXXGXXXXXXXXXXXXXXXXXXXGXXXXXXXXXXXXXXXXXXXGXXXXXXXXXXXXXXXXXXXGXXXXXXXXXXXXXXXXXXXGXXXXXXXXXXXXXXXXXXXGXXXXXXXXXXXXXXXXXXXGXXXXXXXXXXXXXXXXXXXGXXXXXXXXXXXXXXXXXXXGXXXXXXXXXXXXXXXXXXXGXXXXXXXXXXXXXXXXXXX,0,300,0

10815,13,0,13,81,206,0,0,217,97,120,GXXXXXXXXXXXXXXXXXXXGXXXXXXXXXXXXXXXXXXXGXXXXXXXXXXXXXXXXXXXGXXXXXXXXXXXXXXXXXXXGXXXXXXXXXXXXXXXXXXXGXXXXXXXXXXXXXXXXXXXGXXXXXXXXXXXXXXXXXXXGXXXXXXXXXXXXXXXXXXXGXXXXXXXXXXXXXXXXXXXGXXXXXXXXXXXXXXXXXXXGXXXXXXXXXXXXXXXXXXXGXXXXXXXXXXXXXXXXXXXGXXXXXXXXXXXXXXXXXXX,0,300,0
10836,13,0,13,87,200,0,0,214,91,123,GXXXXXXXXXXXXXXXXXXXGXXXXXXXXXXXXXXXXXXXGXXXXXXXXXXXXXXXXXXXGXXXXXXXXXXXXXXXXXXXGXXXXXXXXXXXXXXXXXXXGXXXXXXXXXXXXXXXXXXXGXXXXXXXXXXXXXXXXXXXGXXXXXXXXXXXXXXXXXXXGXXXXXXXXXXXXXXXXXXXGXXXXXXXXXXXXXXXXXXXGXXXXXXXXXXXXXXXXXXXGXXXXXXXXXXXXXXXXXXXGXXXXXXXXXXXXXXXXXXX,0,300,0
10857,13,0,13,84,203,0,0,217,92,125,GXXXXXXXXXXXXXXXXXXXGXXXXXXXXXXXXXXXXXXXGXXXXXXXXXXXXXXXXXXXGXXXXXXXXXXXXXXXXXXXGXXXXXXXXXXXXXXXXXXXGXXXXXXXXXXXXXXXXXXXGXXXXXXXXXXXXXXXXXXXGXXXXXXXXXXXXXXXXXXXGXXXXXXXXXXXXXXXXXXXGXXXXXXXXXXXXXXXXXXXGXXXXXXXXXXXXXXXXXXXGXXXXXXXXXXXXXXXXXXXGXXXXXXXXXXXXXXXXXXX,0,300,0
10878,14,1,13,78,208,0,0,222,91,131,GXXXXXXXXXXXXXXXXXXXGXXXXXXXXXXXXXXXXXXXGXXXXXXXXXXXXXXXXXXXGXXXXXXXXXXXXXXXXXXXGXXXXXXXXXXXXXXXXXXXGXXXXXXXXXXXXXXXXXXXGXXXXXXXXXXXXXXXXXXXGXXXXXXXXXXXXXXXXXXXGXXXXXXXXXXXXXXXXXXXGAXXXXXXXXXXXXXXXXXXGXXXXXXXXXXXXXXXXXXXGXXXXXXXXXXXXXXXXXXXGXXXXXXXXXXXXXXXXXXX,0,300,0
10899,14,1,13,82,204,0,0,217,89,128,GXXXXXXXXXXXXXXXXXXXGXXXXXXXXXXXXXXXXXXXGXXXXXXXXXXXXXXXXXXXGXXXXXXXXXXXXXXXXXXXGXXXXXXXXXXXXXXXXXXXGXXXXXXXXXXXXXXXXXXXGXXXXXXXXXXXXXXXXXXXGXXXXXXXXXXXXXXXXXXXGXXXXXXXXXXXXXXXXXXXGAXXXXXXXXXXXXXXXXXXGXXXXXXXXXXXXXXXXXXXGXXXXXXXXXXXXXXXXXXXGXXXXXXXXXXXXXXXXXXX,0,300,0

10920,14,1,13,83,203,0,0,215,89,126,GXXXXXXXXXXXXXXXXXXXGXXXXXXXXXXXXXXXXXXXGXXXXXXXXXXXXXXXXXXXGXXXXXXXXXXXXXXXXXXXGXXXXXXXXXXXXXXXXXXXGXXXXXXXXXXXXXXXXXXXGXXXXXXXXXXXXXXXXXXXGXXXXXXXXXXXXXXXXXXXGXXXXXXXXXXXXXXXXXXXGAXXXXXXXXXXXXXXXXXXGXXXXXXXXXXXXXXXXXXXGXXXXXXXXXXXXXXXXXXXGXXXXXXXXXXXXXXXXXXX,0,300,0
10941,14,1,13,81,205,0,0,217,83,134,GXXXXXXXXXXXXXXXXXXXGXXXXXXXXXXXXXXXXXXXGXXXXXXXXXXXXXXXXXXXGXXXXXXXXXXXXXXXXXXXGXXXXXXXXXXXXXXXXXXXGXXXXXXXXXXXXXXXXXXXGXXXXXXXXXXXXXXXXXXXGXXXXXXXXXXXXXXXXXXXGXXXXXXXXXXXXXXXXXXXGAXXXXXXXXXXXXXXXXXXGXXXXXXXXXXXXXXXXXXXGXXXXXXXXXXXXXXXXXXXGXXXXXXXXXXXXXXXXXXX,0,300,0
10962,14,1,13,79,207,0,0,220,83,137,GXXXXXXXXXXXXXXXXXXXGXXXXXXXXXXXXXXXXXXXGXXXXXXXXXXXXXXXXXXXGXXXXXXXXXXXXXXXXXXXGXXXXXXXXXXXXXXXXXXXGXXXXXXXXXXXXXXXXXXXGXXXXXXXXXXXXXXXXXXXGXXXXXXXXXXXXXXXXXXXGXXXXXXXXXXXXXXXXXXXGAXXXXXXXXXXXXXXXXXXGXXXXXXXXXXXXXXXXXXXGXXXXXXXXXXXXXXXXXXXGXXXXXXXXXXXXXXXXXXX,0,300,0
10983,14,1,13,76,210,0,0,223,77,146,GXXXXXXXXXXXXXXXXXXXGXXXXXXXXXXXXXXXXXXXGXXXXXXXXXXXXXXXXXXXGXXXXXXXXXXXXXXXXXXXGXXXXXXXXXXXXXXXXXXXGXXXXXXXXXXXXXXXXXXXGXXXXXXXXXXXXXXXXXXXGXXXXXXXXXXXXXXXXXXXGXXXXXXXXXXXXXXXXXXXGAXXXXXXXXXXXXXXXXXXGXXXXXXXXXXXXXXXXXXXGXXXXXXXXXXXXXXXXXXXGXXXXXXXXXXXXXXXXXXX,0,300,0
11004,14,1,13,74,212,0,0,226,75,151,GXXXXXXXXXXXXXXXXXXXGXXXXXXXXXXXXXXXXXXXGXXXXXXXXXXXXXXXXXXXGXXXXXXXXXXXXXXXXXXXGXXXXXXXXXXXXXXXXXXXGXXXXXXXXXXXXXXXXXXXGXXXXXXXXXXXXXXXXXXXGXXXXXXXXXXXXXXXXXXXGXXXXXXXXXXXXXXXXXXXGAXXXXXXXXXXXXXXXXXXGXXXXXXXXXXXXXXXXXXXGXXXXXXXXXXXXXXXXXXXGXXXXXXXXXXXXXXXXXXX,0,300,0

11025,15,2,13,68,217,0,0,230,82,148,GXXXXXXXXXXXXXXXXXXXGXXXXXXXXXXXXXXXXXXXGXXXXXXXXXXXXXXXXXXXGXXXXXXXXXXXXXXXXXXXGXXXXXXXXXXXXXXXXXXXGAXXXXXXXXXXXXXXXXXXGXXXXXXXXXXXXXXXXXXXGXXXXXXXXXXXXXXXXXXXGXXXXXXXXXXXXXXXXXXXGAXXXXXXXXXXXXXXXXXXGXXXXXXXXXXXXXXXXXXXGXXXXXXXXXXXXXXXXXXXGXXXXXXXXXXXXXXXXXXX,0,300,0
11046,15,1,14,68,217,0,0,229,83,146,GXXXXXXXXXXXXXXXXXXXGXXXXXXXXXXXXXXXXXXXGXXXXXXXXXXXXXXXXXXXGXXXXXXXXXXXXXXXXXXXGXXXXXXXXXXXXXXXXXXXGAXXXXXXXXXXXXXXXXXXGXXXXXXXXXXXXXXXXXXXGXXXXXXXXXXXXXXXXXXXGXXXXXXXXXXXXXXXXXXXGOXXXXXXXXXXXXXXXXXXGXXXXXXXXXXXXXXXXXXXGXXXXXXXXXXXXXXXXXXXGXXXXXXXXXXXXXXXXXXX,0,300,0
11067,14,0,14,73,213,0,0,226,82,144,GXXXXXXXXXXXXXXXXXXXGXXXXXXXXXXXXXXXXXXXGXXXXXXXXXXXXXXXXXXXGXXXXXXXXXXXXXXXXXXXGXXXXXXXXXXXXXXXXXXXGOXXXXXXXXXXXXXXXXXXGXXXXXXXXXXXXXXXXXXXGXXXXXXXXXXXXXXXXXXXGXXXXXXXXXXXXXXXXXXXGXXXXXXXXXXXXXXXXXXXGXXXXXXXXXXXXXXXXXXXGXXXXXXXXXXXXXXXXXXXGXXXXXXXXXXXXXXXXXXX,0,300,0
11088,14,0,14,71,215,0,0,228,83,145,GXXXXXXXXXXXXXXXXXXXGXXXXXXXXXXXXXXXXXXXGXXXXXXXXXXXXXXXXXXXGXXXXXXXXXXXXXXXXXXXGXXXXXXXXXXXXXXXXXXXGOXXXXXXXXXXXXXXXXXXGXXXXXXXXXXXXXXXXXXXGXXXXXXXXXXXXXXXXXXXGXXXXXXXXXXXXXXXXXXXGXXXXXXXXXXXXXXXXXXXGXXXXXXXXXXXXXXXXXXXGXXXXXXXXXXXXXXXXXXXGXXXXXXXXXXXXXXXXXXX,0,300,0
11109,13,0,13,78,209,0,0,222,78,144,GXXXXXXXXXXXXXXXXXXXGXXXXXXXXXXXXXXXXXXXGXXXXXXXXXXXXXXXXXXXGXXXXXXXXXXXXXXXXXXXGXXXXXXXXXXXXXXXXXXXGXXXXXXXXXXXXXXXXXXXGXXXXXXXXXXXXXXXXXXXGXXXXXXXXXXXXXXXXXXXGXXXXXXXXXXXXXXXXXXXGXXXXXXXXXXXXXXXXXXXGXXXXXXXXXXXXXXXXXXXGXXXXXXXXXXXXXXXXXXXGXXXXXXXXXXXXXXXXXXX,0,300,0

11130,13,0,13,76,211,0,0,222,89,133,GXXXXXXXXXXXXXXXXXXXGXXXXXXXXXXXXXXXXXXXGXXXXXXXXXXXXXXXXXXXGXXXXXXXXXXXXXXXXXXXGXXXXXXXXXXXXXXXXXXXGXXXXXXXXXXXXXXXXXXXGXXXXXXXXXXXXXXXXXXXGXXXXXXXXXXXXXXXXXXXGXXXXXXXXXXXXXXXXXXXGXXXXXXXXXXXXXXXXXXXGXXXXXXXXXXXXXXXXXXXGXXXXXXXXXXXXXXXXXXXGXXXXXXXXXXXXXXXXXXX,0,300,0
11151,13,0,13,72,215,0,0,227,93,134,GXXXXXXXXXXXXXXXXXXXGXXXXXXXXXXXXXXXXXXXGXXXXXXXXXXXXXXXXXXXGXXXXXXXXXXXXXXXXXXXGXXXXXXXXXXXXXXXXXXXGXXXXXXXXXXXXXXXXXXXGXXXXXXXXXXXXXXXXXXXGXXXXXXXXXXXXXXXXXXXGXXXXXXXXXXXXXXXXXXXGXXXXXXXXXXXXXXXXXXXGXXXXXXXXXXXXXXXXXXXGXXXXXXXXXXXXXXXXXXXGXXXXXXXXXXXXXXXXXXX,0,300,0
11172,13,0,13,70,217,0,0,229,89,140,GXXXXXXXXXXXXXXXXXXXGXXXXXXXXXXXXXXXXXXXGXXXXXXXXXXXXXXXXXXXGXXXXXXXXXXXXXXXXXXXGXXXXXXXXXXXXXXXXXXXGXXXXXXXXXXXXXXXXXXXGXXXXXXXXXXXXXXXXXXXGXXXXXXXXXXXXXXXXXXXGXXXXXXXXXXXXXXXXXXXGXXXXXXXXXXXXXXXXXXXGXXXXXXXXXXXXXXXXXXXGXXXXXXXXXXXXXXXXXXXGXXXXXXXXXXXXXXXXXXX,0,300,0
11193,13,0,13,77,210,0,0,222,81,141,GXXXXXXXXXXXXXXXXXXXGXXXXXXXXXXXXXXXXXXXGXXXXXXXXXXXXXXXXXXXGXXXXXXXXXXXXXXXXXXXGXXXXXXXXXXXXXXXXXXXGXXXXXXXXXXXXXXXXXXXGXXXXXXXXXXXXXXXXXXXGXXXXXXXXXXXXXXXXXXXGXXXXXXXXXXXXXXXXXXXGXXXXXXXXXXXXXXXXXXXGXXXXXXXXXXXXXXXXXXXGXXXXXXXXXXXXXXXXXXXGXXXXXXXXXXXXXXXXXXX,0,300,0
11214,13,0,13,75,212,0,0,224,83,141,GXXXXXXXXXXXXXXXXXXXGXXXXXXXXXXXXXXXXXXXGXXXXXXXXXXXXXXXXXXXGXXXXXXXXXXXXXXXXXXXGXXXXXXXXXXXXXXXXXXXGXXXXXXXXXXXXXXXXXXXGXXXXXXXXXXXXXXXXXXXGXXXXXXXXXXXXXXXXXXXGXXXXXXXXXXXXXXXXXXXGXXXXXXXXXXXXXXXXXXXGXXXXXXXXXXXXXXXXXXXGXXXXXXXXXXXXXXXXXXXGXXXXXXXXXXXXXXXXXXX,0,300,0

11235,13,0,13,77,210,0,0,222,83,139,GXXXXXXXXXXXXXXXXXXXGXXXXXXXXXXXXXXXXXXXGXXXXXXXXXXXXXXXXXXXGXXXXXXXXXXXXXXXXXXXGXXXXXXXXXXXXXXXXXXXGXXXXXXXXXXXXXXXXXXXGXXXXXXXXXXXXXXXXXXXGXXXXXXXXXXXXXXXXXXXGXXXXXXXXXXXXXXXXXXXGXXXXXXXXXXXXXXXXXXXGXXXXXXXXXXXXXXXXXXXGXXXXXXXXXXXXXXXXXXXGXXXXXXXXXXXXXXXXXXX,0,300,0
11256,13,0,13,78,209,0,0,221,88,133,GXXXXXXXXXXXXXXXXXXXGXXXXXXXXXXXXXXXXXXXGXXXXXXXXXXXXXXXXXXXGXXXXXXXXXXXXXXXXXXXGXXXXXXXXXXXXXXXXXXXGXXXXXXXXXXXXXXXXXXXGXXXXXXXXXXXXXXXXXXXGXXXXXXXXXXXXXXXXXXXGXXXXXXXXXXXXXXXXXXXGXXXXXXXXXXXXXXXXXXXGXXXXXXXXXXXXXXXXXXXGXXXXXXXXXXXXXXXXXXXGXXXXXXXXXXXXXXXXXXX,0,300,0
11277,13,0,13,86,201,0,0,213,87,126,GXXXXXXXXXXXXXXXXXXXGXXXXXXXXXXXXXXXXXXXGXXXXXXXXXXXXXXXXXXXGXXXXXXXXXXXXXXXXXXXGXXXXXXXXXXXXXXXXXXXGXXXXXXXXXXXXXXXXXXXGXXXXXXXXXXXXXXXXXXXGXXXXXXXXXXXXXXXXXXXGXXXXXXXXXXXXXXXXXXXGXXXXXXXXXXXXXXXXXXXGXXXXXXXXXXXXXXXXXXXGXXXXXXXXXXXXXXXXXXXGXXXXXXXXXXXXXXXXXXX,0,300,0
11298,13,0,13,87,200,0,0,211,85,126,GXXXXXXXXXXXXXXXXXXXGXXXXXXXXXXXXXXXXXXXGXXXXXXXXXXXXXXXXXXXGXXXXXXXXXXXXXXXXXXXGXXXXXXXXXXXXXXXXXXXGXXXXXXXXXXXXXXXXXXXGXXXXXXXXXXXXXXXXXXXGXXXXXXXXXXXXXXXXXXXGXXXXXXXXXXXXXXXXXXXGXXXXXXXXXXXXXXXXXXXGXXXXXXXXXXXXXXXXXXXGXXXXXXXXXXXXXXXXXXXGXXXXXXXXXXXXXXXXXXX,0,300,0
11319,13,0,13,83,204,0,0,216,85,131,GXXXXXXXXXXXXXXXXXXXGXXXXXXXXXXXXXXXXXXXGXXXXXXXXXXXXXXXXXXXGXXXXXXXXXXXXXXXXXXXGXXXXXXXXXXXXXXXXXXXGXXXXXXXXXXXXXXXXXXXGXXXXXXXXXXXXXXXXXXXGXXXXXXXXXXXXXXXXXXXGXXXXXXXXXXXXXXXXXXXGXXXXXXXXXXXXXXXXXXXGXXXXXXXXXXXXXXXXXXXGXXXXXXXXXXXXXXXXXXXGXXXXXXXXXXXXXXXXXXX,0,300,0

11340,13,0,13,78,209,0,0,221,87,134,GXXXXXXXXXXXXXXXXXXXGXXXXXXXXXXXXXXXXXXXGXXXXXXXXXXXXXXXXXXXGXXXXXXXXXXXXXXXXXXXGXXXXXXXXXXXXXXXXXXXGXXXXXXXXXXXXXXXXXXXGXXXXXXXXXXXXXXXXXXXGXXXXXXXXXXXXXXXXXXXGXXXXXXXXXXXXXXXXXXXGXXXXXXXXXXXXXXXXXXXGXXXXXXXXXXXXXXXXXXXGXXXXXXXXXXXXXXXXXXXGXXXXXXXXXXXXXXXXXXX,0,300,0
11361,13,0,13,74,213,0,0,225,87,138,GXXXXXXXXXXXXXXXXXXXGXXXXXXXXXXXXXXXXXXXGXXXXXXXXXXXXXXXXXXXGXXXXXXXXXXXXXXXXXXXGXXXXXXXXXXXXXXXXXXXGXXXXXXXXXXXXXXXXXXXGXXXXXXXXXXXXXXXXXXXGXXXXXXXXXXXXXXXXXXXGXXXXXXXXXXXXXXXXXXXGXXXXXXXXXXXXXXXXXXXGXXXXXXXXXXXXXXXXXXXGXXXXXXXXXXXXXXXXXXXGXXXXXXXXXXXXXXXXXXX,0,300,0
11382,13,0,13,69,218,0,0,230,91,139,GXXXXXXXXXXXXXXXXXXXGXXXXXXXXXXXXXXXXXXXGXXXXXXXXXXXXXXXXXXXGXXXXXXXXXXXXXXXXXXXGXXXXXXXXXXXXXXXXXXXGXXXXXXXXXXXXXXXXXXXGXXXXXXXXXXXXXXXXXXXGXXXXXXXXXXXXXXXXXXXGXXXXXXXXXXXXXXXXXXXGXXXXXXXXXXXXXXXXXXXGXXXXXXXXXXXXXXXXXXXGXXXXXXXXXXXXXXXXXXXGXXXXXXXXXXXXXXXXXXX,0,300,0
11403,13,0,13,72,215,0,0,227,91,136,GXXXXXXXXXXXXXXXXXXXGXXXXXXXXXXXXXXXXXXXGXXXXXXXXXXXXXXXXXXXGXXXXXXXXXXXXXXXXXXXGXXXXXXXXXXXXXXXXXXXGXXXXXXXXXXXXXXXXXXXGXXXXXXXXXXXXXXXXXXXGXXXXXXXXXXXXXXXXXXXGXXXXXXXXXXXXXXXXXXXGXXXXXXXXXXXXXXXXXXXGXXXXXXXXXXXXXXXXXXXGXXXXXXXXXXXXXXXXXXXGXXXXXXXXXXXXXXXXXXX,0,300,0
11424,13,0,13,75,212,0,0,224,89,135,GXXXXXXXXXXXXXXXXXXXGXXXXXXXXXXXXXXXXXXXGXXXXXXXXXXXXXXXXXXXGXXXXXXXXXXXXXXXXXXXGXXXXXXXXXXXXXXXXXXXGXXXXXXXXXXXXXXXXXXXGXXXXXXXXXXXXXXXXXXXGXXXXXXXXXXXXXXXXXXXGXXXXXXXXXXXXXXXXXXXGXXXXXXXXXXXXXXXXXXXGXXXXXXXXXXXXXXXXXXXGXXXXXXXXXXXXXXXXXXXGXXXXXXXXXXXXXXXXXXX,0,300,0

11445,13,0,13,73,214,0,0,225,92,133,GXXXXXXXXXXXXXXXXXXXGXXXXXXXXXXXXXXXXXXXGXXXXXXXXXXXXXXXXXXXGXXXXXXXXXXXXXXXXXXXGXXXXXXXXXXXXXXXXXXXGXXXXXXXXXXXXXXXXXXXGXXXXXXXXXXXXXXXXXXXGXXXXXXXXXXXXXXXXXXXGXXXXXXXXXXXXXXXXXXXGXXXXXXXXXXXXXXXXXXXGXXXXXXXXXXXXXXXXXXXGXXXXXXXXXXXXXXXXXXXGXXXXXXXXXXXXXXXXXXX,0,300,0
11466,13,0,13,71,216,0,0,228,93,135,GXXXXXXXXXXXXXXXXXXXGXXXXXXXXXXXXXXXXXXXGXXXXXXXXXXXXXXXXXXXGXXXXXXXXXXXXXXXXXXXGXXXXXXXXXXXXXXXXXXXGXXXXXXXXXXXXXXXXXXXGXXXXXXXXXXXXXXXXXXXGXXXXXXXXXXXXXXXXXXXGXXXXXXXXXXXXXXXXXXXGXXXXXXXXXXXXXXXXXXXGXXXXXXXXXXXXXXXXXXXGXXXXXXXXXXXXXXXXXXXGXXXXXXXXXXXXXXXXXXX,0,300,0
11487,13,0,13,72,215,0,0,226,89,137,GXXXXXXXXXXXXXXXXXXXGXXXXXXXXXXXXXXXXXXXGXXXXXXXXXXXXXXXXXXXGXXXXXXXXXXXXXXXXXXXGXXXXXXXXXXXXXXXXXXXGXXXXXXXXXXXXXXXXXXXGXXXXXXXXXXXXXXXXXXXGXXXXXXXXXXXXXXXXXXXGXXXXXXXXXXXXXXXXXXXGXXXXXXXXXXXXXXXXXXXGXXXXXXXXXXXXXXXXXXXGXXXXXXXXXXXXXXXXXXXGXXXXXXXXXXXXXXXXXXX,0,300,0
11508,13,0,13,71,216,0,0,228,90,138,GXXXXXXXXXXXXXXXXXXXGXXXXXXXXXXXXXXXXXXXGXXXXXXXXXXXXXXXXXXXGXXXXXXXXXXXXXXXXXXXGXXXXXXXXXXXXXXXXXXXGXXXXXXXXXXXXXXXXXXXGXXXXXXXXXXXXXXXXXXXGXXXXXXXXXXXXXXXXXXXGXXXXXXXXXXXXXXXXXXXGXXXXXXXXXXXXXXXXXXXGXXXXXXXXXXXXXXXXXXXGXXXXXXXXXXXXXXXXXXXGXXXXXXXXXXXXXXXXXXX,0,300,0
11529,13,0,13,73,214,0,0,226,84,142,GXXXXXXXXXXXXXXXXXXXGXXXXXXXXXXXXXXXXXXXGXXXXXXXXXXXXXXXXXXXGXXXXXXXXXXXXXXXXXXXGXXXXXXXXXXXXXXXXXXXGXXXXXXXXXXXXXXXXXXXGXXXXXXXXXXXXXXXXXXXGXXXXXXXXXXXXXXXXXXXGXXXXXXXXXXXXXXXXXXXGXXXXXXXXXXXXXXXXXXXGXXXXXXXXXXXXXXXXXXXGXXXXXXXXXXXXXXXXXXXGXXXXXXXXXXXXXXXXXXX,0,300,0

11550,13,0,13,79,208,0,0,220,88,132,GXXXXXXXXXXXXXXXXXXXGXXXXXXXXXXXXXXXXXXXGXXXXXXXXXXXXXXXXXXXGXXXXXXXXXXXXXXXXXXXGXXXXXXXXXXXXXXXXXXXGXXXXXXXXXXXXXXXXXXXGXXXXXXXXXXXXXXXXXXXGXXXXXXXXXXXXXXXXXXXGXXXXXXXXXXXXXXXXXXXGXXXXXXXXXXXXXXXXXXXGXXXXXXXXXXXXXXXXXXXGXXXXXXXXXXXXXXXXXXXGXXXXXXXXXXXXXXXXXXX,0,300,0
11571,13,0,13,78,209,0,0,221,91,130,GXXXXXXXXXXXXXXXXXXXGXXXXXXXXXXXXXXXXXXXGXXXXXXXXXXXXXXXXXXXGXXXXXXXXXXXXXXXXXXXGXXXXXXXXXXXXXXXXXXXGXXXXXXXXXXXXXXXXXXXGXXXXXXXXXXXXXXXXXXXGXXXXXXXXXXXXXXXXXXXGXXXXXXXXXXXXXXXXXXXGXXXXXXXXXXXXXXXXXXXGXXXXXXXXXXXXXXXXXXXGXXXXXXXXXXXXXXXXXXXGXXXXXXXXXXXXXXXXXXX,0,300,0
11592,13,0,13,80,207,0,0,219,86,133,GXXXXXXXXXXXXXXXXXXXGXXXXXXXXXXXXXXXXXXXGXXXXXXXXXXXXXXXXXXXGXXXXXXXXXXXXXXXXXXXGXXXXXXXXXXXXXXXXXXXGXXXXXXXXXXXXXXXXXXXGXXXXXXXXXXXXXXXXXXXGXXXXXXXXXXXXXXXXXXXGXXXXXXXXXXXXXXXXXXXGXXXXXXXXXXXXXXXXXXXGXXXXXXXXXXXXXXXXXXXGXXXXXXXXXXXXXXXXXXXGXXXXXXXXXXXXXXXXXXX,0,300,0
11613,13,0,13,76,211,0,0,223,90,133,GXXXXXXXXXXXXXXXXXXXGXXXXXXXXXXXXXXXXXXXGXXXXXXXXXXXXXXXXXXXGXXXXXXXXXXXXXXXXXXXGXXXXXXXXXXXXXXXXXXXGXXXXXXXXXXXXXXXXXXXGXXXXXXXXXXXXXXXXXXXGXXXXXXXXXXXXXXXXXXXGXXXXXXXXXXXXXXXXXXXGXXXXXXXXXXXXXXXXXXXGXXXXXXXXXXXXXXXXXXXGXXXXXXXXXXXXXXXXXXXGXXXXXXXXXXXXXXXXXXX,0,300,0
11634,14,1,13,74,212,0,0,224,90,134,GXXXXXXXXXXXXXXXXXXXGXXXXXXXXXXXXXXXXXXXGAXXXXXXXXXXXXXXXXXXGXXXXXXXXXXXXXXXXXXXGXXXXXXXXXXXXXXXXXXXGXXXXXXXXXXXXXXXXXXXGXXXXXXXXXXXXXXXXXXXGXXXXXXXXXXXXXXXXXXXGXXXXXXXXXXXXXXXXXXXGXXXXXXXXXXXXXXXXXXXGXXXXXXXXXXXXXXXXXXXGXXXXXXXXXXXXXXXXXXXGXXXXXXXXXXXXXXXXXXX,0,300,0

11655,14,1,13,75,211,0,0,222,90,132,GXXXXXXXXXXXXXXXXXXXGXXXXXXXXXXXXXXXXXXXGAXXXXXXXXXXXXXXXXXXGXXXXXXXXXXXXXXXXXXXGXXXXXXXXXXXXXXXXXXXGXXXXXXXXXXXXXXXXXXXGXXXXXXXXXXXXXXXXXXXGXXXXXXXXXXXXXXXXXXXGXXXXXXXXXXXXXXXXXXXGXXXXXXXXXXXXXXXXXXXGXXXXXXXXXXXXXXXXXXXGXXXXXXXXXXXXXXXXXXXGXXXXXXXXXXXXXXXXXXX,0,300,0
11676,14,1,13,75,211,0,0,223,94,129,GXXXXXXXXXXXXXXXXXXXGXXXXXXXXXXXXXXXXXXXGAXXXXXXXXXXXXXXXXXXGXXXXXXXXXXXXXXXXXXXGXXXXXXXXXXXXXXXXXXXGXXXXXXXXXXXXXXXXXXXGXXXXXXXXXXXXXXXXXXXGXXXXXXXXXXXXXXXXXXXGXXXXXXXXXXXXXXXXXXXGXXXXXXXXXXXXXXXXXXXGXXXXXXXXXXXXXXXXXXXGXXXXXXXXXXXXXXXXXXXGXXXXXXXXXXXXXXXXXXX,0,300,0
11697,14,1,13,80,206,0,0,218,97,121,GXXXXXXXXXXXXXXXXXXXGXXXXXXXXXXXXXXXXXXXGAXXXXXXXXXXXXXXXXXXGXXXXXXXXXXXXXXXXXXXGXXXXXXXXXXXXXXXXXXXGXXXXXXXXXXXXXXXXXXXGXXXXXXXXXXXXXXXXXXXGXXXXXXXXXXXXXXXXXXXGXXXXXXXXXXXXXXXXXXXGXXXXXXXXXXXXXXXXXXXGXXXXXXXXXXXXXXXXXXXGXXXXXXXXXXXXXXXXXXXGXXXXXXXXXXXXXXXXXXX,0,300,0
11718,14,1,13,83,203,0,0,215,97,118,GXXXXXXXXXXXXXXXXXXXGXXXXXXXXXXXXXXXXXXXGAXXXXXXXXXXXXXXXXXXGXXXXXXXXXXXXXXXXXXXGXXXXXXXXXXXXXXXXXXXGXXXXXXXXXXXXXXXXXXXGXXXXXXXXXXXXXXXXXXXGXXXXXXXXXXXXXXXXXXXGXXXXXXXXXXXXXXXXXXXGXXXXXXXXXXXXXXXXXXXGXXXXXXXXXXXXXXXXXXXGXXXXXXXXXXXXXXXXXXXGXXXXXXXXXXXXXXXXXXX,0,300,0
11739,14,1,13,81,205,0,0,216,93,123,GXXXXXXXXXXXXXXXXXXXGXXXXXXXXXXXXXXXXXXXGAXXXXXXXXXXXXXXXXXXGXXXXXXXXXXXXXXXXXXXGXXXXXXXXXXXXXXXXXXXGXXXXXXXXXXXXXXXXXXXGXXXXXXXXXXXXXXXXXXXGXXXXXXXXXXXXXXXXXXXGXXXXXXXXXXXXXXXXXXXGXXXXXXXXXXXXXXXXXXXGXXXXXXXXXXXXXXXXXXXGXXXXXXXXXXXXXXXXXXXGXXXXXXXXXXXXXXXXXXX,0,300,0

11760,14,1,13,78,208,0,0,220,93,127,GXXXXXXXXXXXXXXXXXXXGXXXXXXXXXXXXXXXXXXXGAXXXXXXXXXXXXXXXXXXGXXXXXXXXXXXXXXXXXXXGXXXXXXXXXXXXXXXXXXXGXXXXXXXXXXXXXXXXXXXGXXXXXXXXXXXXXXXXXXXGXXXXXXXXXXXXXXXXXXXGXXXXXXXXXXXXXXXXXXXGXXXXXXXXXXXXXXXXXXXGXXXXXXXXXXXXXXXXXXXGXXXXXXXXXXXXXXXXXXXGXXXXXXXXXXXXXXXXXXX,0,300,0
11781,14,1,13,79,207,0,0,217,95,122,GXXXXXXXXXXXXXXXXXXXGXXXXXXXXXXXXXXXXXXXGAXXXXXXXXXXXXXXXXXXGXXXXXXXXXXXXXXXXXXXGXXXXXXXXXXXXXXXXXXXGXXXXXXXXXXXXXXXXXXXGXXXXXXXXXXXXXXXXXXXGXXXXXXXXXXXXXXXXXXXGXXXXXXXXXXXXXXXXXXXGXXXXXXXXXXXXXXXXXXXGXXXXXXXXXXXXXXXXXXXGXXXXXXXXXXXXXXXXXXXGXXXXXXXXXXXXXXXXXXX,0,300,0
11802,14,1,13,79,207,0,0,219,94,125,GXXXXXXXXXXXXXXXXXXXGXXXXXXXXXXXXXXXXXXXGAXXXXXXXXXXXXXXXXXXGXXXXXXXXXXXXXXXXXXXGXXXXXXXXXXXXXXXXXXXGXXXXXXXXXXXXXXXXXXXGXXXXXXXXXXXXXXXXXXXGXXXXXXXXXXXXXXXXXXXGXXXXXXXXXXXXXXXXXXXGXXXXXXXXXXXXXXXXXXXGXXXXXXXXXXXXXXXXXXXGXXXXXXXXXXXXXXXXXXXGXXXXXXXXXXXXXXXXXXX,0,300,0
11823,14,1,13,81,205,0,0,215,92,123,GXXXXXXXXXXXXXXXXXXXGXXXXXXXXXXXXXXXXXXXGAXXXXXXXXXXXXXXXXXXGXXXXXXXXXXXXXXXXXXXGXXXXXXXXXXXXXXXXXXXGXXXXXXXXXXXXXXXXXXXGXXXXXXXXXXXXXXXXXXXGXXXXXXXXXXXXXXXXXXXGXXXXXXXXXXXXXXXXXXXGXXXXXXXXXXXXXXXXXXXGXXXXXXXXXXXXXXXXXXXGXXXXXXXXXXXXXXXXXXXGXXXXXXXXXXXXXXXXXXX,0,300,0
11844,14,1,13,79,207,0,0,218,89,129,GXXXXXXXXXXXXXXXXXXXGXXXXXXXXXXXXXXXXXXXGAXXXXXXXXXXXXXXXXXXGXXXXXXXXXXXXXXXXXXXGXXXXXXXXXXXXXXXXXXXGXXXXXXXXXXXXXXXXXXXGXXXXXXXXXXXXXXXXXXXGXXXXXXXXXXXXXXXXXXXGXXXXXXXXXXXXXXXXXXXGXXXXXXXXXXXXXXXXXXXGXXXXXXXXXXXXXXXXXXXGXXXXXXXXXXXXXXXXXXXGXXXXXXXXXXXXXXXXXXX,0,300,0

11865,14,1,13,77,209,0,0,221,94,127,GXXXXXXXXXXXXXXXXXXXGXXXXXXXXXXXXXXXXXXXGAXXXXXXXXXXXXXXXXXXGXXXXXXXXXXXXXXXXXXXGXXXXXXXXXXXXXXXXXXXGXXXXXXXXXXXXXXXXXXXGXXXXXXXXXXXXXXXXXXXGXXXXXXXXXXXXXXXXXXXGXXXXXXXXXXXXXXXXXXXGXXXXXXXXXXXXXXXXXXXGXXXXXXXXXXXXXXXXXXXGXXXXXXXXXXXXXXXXXXXGXXXXXXXXXXXXXXXXXXX,0,300,0
11886,14,1,13,81,205,0,0,217,91,126,GXXXXXXXXXXXXXXXXXXXGXXXXXXXXXXXXXXXXXXXGAXXXXXXXXXXXXXXXXXXGXXXXXXXXXXXXXXXXXXXGXXXXXXXXXXXXXXXXXXXGXXXXXXXXXXXXXXXXXXXGXXXXXXXXXXXXXXXXXXXGXXXXXXXXXXXXXXXXXXXGXXXXXXXXXXXXXXXXXXXGXXXXXXXXXXXXXXXXXXXGXXXXXXXXXXXXXXXXXXXGXXXXXXXXXXXXXXXXXXXGXXXXXXXXXXXXXXXXXXX,0,300,0
11907,14,1,13,80,206,0,0,218,97,121,GXXXXXXXXXXXXXXXXXXXGXXXXXXXXXXXXXXXXXXXGAXXXXXXXXXXXXXXXXXXGXXXXXXXXXXXXXXXXXXXGXXXXXXXXXXXXXXXXXXXGXXXXXXXXXXXXXXXXXXXGXXXXXXXXXXXXXXXXXXXGXXXXXXXXXXXXXXXXXXXGXXXXXXXXXXXXXXXXXXXGXXXXXXXXXXXXXXXXXXXGXXXXXXXXXXXXXXXXXXXGXXXXXXXXXXXXXXXXXXXGXXXXXXXXXXXXXXXXXXX,0,300,0
11928,14,1,13,77,209,0,0,220,98,122,GXXXXXXXXXXXXXXXXXXXGXXXXXXXXXXXXXXXXXXXGAXXXXXXXXXXXXXXXXXXGXXXXXXXXXXXXXXXXXXXGXXXXXXXXXXXXXXXXXXXGXXXXXXXXXXXXXXXXXXXGXXXXXXXXXXXXXXXXXXXGXXXXXXXXXXXXXXXXXXXGXXXXXXXXXXXXXXXXXXXGXXXXXXXXXXXXXXXXXXXGXXXXXXXXXXXXXXXXXXXGXXXXXXXXXXXXXXXXXXXGXXXXXXXXXXXXXXXXXXX,0,300,0
11949,14,1,13,86,200,0,0,212,97,115,GXXXXXXXXXXXXXXXXXXXGXXXXXXXXXXXXXXXXXXXGAXXXXXXXXXXXXXXXXXXGXXXXXXXXXXXXXXXXXXXGXXXXXXXXXXXXXXXXXXXGXXXXXXXXXXXXXXXXXXXGXXXXXXXXXXXXXXXXXXXGXXXXXXXXXXXXXXXXXXXGXXXXXXXXXXXXXXXXXXXGXXXXXXXXXXXXXXXXXXXGXXXXXXXXXXXXXXXXXXXGXXXXXXXXXXXXXXXXXXXGXXXXXXXXXXXXXXXXXXX,0,300,0

11970,14,1,13,86,200,0,0,212,101,111,GXXXXXXXXXXXXXXXXXXXGXXXXXXXXXXXXXXXXXXXGAXXXXXXXXXXXXXXXXXXGXXXXXXXXXXXXXXXXXXXGXXXXXXXXXXXXXXXXXXXGXXXXXXXXXXXXXXXXXXXGXXXXXXXXXXXXXXXXXXXGXXXXXXXXXXXXXXXXXXXGXXXXXXXXXXXXXXXXXXXGXXXXXXXXXXXXXXXXXXXGXXXXXXXXXXXXXXXXXXXGXXXXXXXXXXXXXXXXXXXGXXXXXXXXXXXXXXXXXXX,0,300,0
11991,15,2,13,86,199,0,0,211,96,115,GXXXXXXXXXXXXXXXXXXXGXXXXXXXXXXXXXXXXXXXGAXXXXXXXXXXXXXXXXXXGXXXXXXXXXXXXXXXXXXXGXXXXXXXXXXXXXXXXXXXGXXXXXXXXXXXXXXXXXXXGXXXXXXXXXXXXXXXXXXXGXXXXXXXXXXXXXXXXXXXGXXXXXXXXXXXXXXXXXXXGXXXXXXXXXXXXXXXXXXXGXXXXXXXXXXXXXXXXXXXGAXXXXXXXXXXXXXXXXXXGXXXXXXXXXXXXXXXXXXX,0,300,0
12012,15,2,13,87,198,0,0,210,95,115,GXXXXXXXXXXXXXXXXXXXGXXXXXXXXXXXXXXXXXXXGAXXXXXXXXXXXXXXXXXXGXXXXXXXXXXXXXXXXXXXGXXXXXXXXXXXXXXXXXXXGXXXXXXXXXXXXXXXXXXXGXXXXXXXXXXXXXXXXXXXGXXXXXXXXXXXXXXXXXXXGXXXXXXXXXXXXXXXXXXXGXXXXXXXXXXXXXXXXXXXGXXXXXXXXXXXXXXXXXXXGAXXXXXXXXXXXXXXXXXXGXXXXXXXXXXXXXXXXXXX,0,300,0
12033,15,2,13,85,200,0,0,212,97,115,GXXXXXXXXXXXXXXXXXXXGXXXXXXXXXXXXXXXXXXXGAXXXXXXXXXXXXXXXXXXGXXXXXXXXXXXXXXXXXXXGXXXXXXXXXXXXXXXXXXXGXXXXXXXXXXXXXXXXXXXGXXXXXXXXXXXXXXXXXXXGXXXXXXXXXXXXXXXXXXXGXXXXXXXXXXXXXXXXXXXGXXXXXXXXXXXXXXXXXXXGXXXXXXXXXXXXXXXXXXXGAXXXXXXXXXXXXXXXXXXGXXXXXXXXXXXXXXXXXXX,0,300,0
12054,15,2,13,80,205,0,0,217,92,125,GXXXXXXXXXXXXXXXXXXXGXXXXXXXXXXXXXXXXXXXGAXXXXXXXXXXXXXXXXXXGXXXXXXXXXXXXXXXXXXXGXXXXXXXXXXXXXXXXXXXGXXXXXXXXXXXXXXXXXXXGXXXXXXXXXXXXXXXXXXXGXXXXXXXXXXXXXXXXXXXGXXXXXXXXXXXXXXXXXXXGXXXXXXXXXXXXXXXXXXXGXXXXXXXXXXXXXXXXXXXGAXXXXXXXXXXXXXXXXXXGXXXXXXXXXXXXXXXXXXX,0,300,0

12075,15,2,13,73,212,0,0,223,95,128,GXXXXXXXXXXXXXXXXXXXGXXXXXXXXXXXXXXXXXXXGAXXXXXXXXXXXXXXXXXXGXXXXXXXXXXXXXXXXXXXGXXXXXXXXXXXXXXXXXXXGXXXXXXXXXXXXXXXXXXXGXXXXXXXXXXXXXXXXXXXGXXXXXXXXXXXXXXXXXXXGXXXXXXXXXXXXXXXXXXXGXXXXXXXXXXXXXXXXXXXGXXXXXXXXXXXXXXXXXXXGAXXXXXXXXXXXXXXXXXXGXXXXXXXXXXXXXXXXXXX,0,300,0
12096,15,1,14,68,217,0,0,228,95,133,GXXXXXXXXXXXXXXXXXXXGXXXXXXXXXXXXXXXXXXXGAXXXXXXXXXXXXXXXXXXGXXXXXXXXXXXXXXXXXXXGXXXXXXXXXXXXXXXXXXXGXXXXXXXXXXXXXXXXXXXGXXXXXXXXXXXXXXXXXXXGXXXXXXXXXXXXXXXXXXXGXXXXXXXXXXXXXXXXXXXGXXXXXXXXXXXXXXXXXXXGXXXXXXXXXXXXXXXXXXXGOXXXXXXXXXXXXXXXXXXGXXXXXXXXXXXXXXXXXXX,0,300,0
12117,14,1,13,73,213,0,0,224,91,133,GXXXXXXXXXXXXXXXXXXXGXXXXXXXXXXXXXXXXXXXGAXXXXXXXXXXXXXXXXXXGXXXXXXXXXXXXXXXXXXXGXXXXXXXXXXXXXXXXXXXGXXXXXXXXXXXXXXXXXXXGXXXXXXXXXXXXXXXXXXXGXXXXXXXXXXXXXXXXXXXGXXXXXXXXXXXXXXXXXXXGXXXXXXXXXXXXXXXXXXXGXXXXXXXXXXXXXXXXXXXGXXXXXXXXXXXXXXXXXXXGXXXXXXXXXXXXXXXXXXX,0,300,0
12138,14,1,13,74,212,0,0,224,91,133,GXXXXXXXXXXXXXXXXXXXGXXXXXXXXXXXXXXXXXXXGAXXXXXXXXXXXXXXXXXXGXXXXXXXXXXXXXXXXXXXGXXXXXXXXXXXXXXXXXXXGXXXXXXXXXXXXXXXXXXXGXXXXXXXXXXXXXXXXXXXGXXXXXXXXXXXXXXXXXXXGXXXXXXXXXXXXXXXXXXXGXXXXXXXXXXXXXXXXXXXGXXXXXXXXXXXXXXXXXXXGXXXXXXXXXXXXXXXXXXXGXXXXXXXXXXXXXXXXXXX,0,300,0
12159,14,1,13,70,216,0,0,228,91,137,GXXXXXXXXXXXXXXXXXXXGXXXXXXXXXXXXXXXXXXXGAXXXXXXXXXXXXXXXXXXGXXXXXXXXXXXXXXXXXXXGXXXXXXXXXXXXXXXXXXXGXXXXXXXXXXXXXXXXXXXGXXXXXXXXXXXXXXXXXXXGXXXXXXXXXXXXXXXXXXXGXXXXXXXXXXXXXXXXXXXGXXXXXXXXXXXXXXXXXXXGXXXXXXXXXXXXXXXXXXXGXXXXXXXXXXXXXXXXXXXGXXXXXXXXXXXXXXXXXXX,0,300,0

12180,14,1,13,72,214,0,0,226,91,135,GXXXXXXXXXXXXXXXXXXXGXXXXXXXXXXXXXXXXXXXGAXXXXXXXXXXXXXXXXXXGXXXXXXXXXXXXXXXXXXXGXXXXXXXXXXXXXXXXXXXGXXXXXXXXXXXXXXXXXXXGXXXXXXXXXXXXXXXXXXXGXXXXXXXXXXXXXXXXXXXGXXXXXXXXXXXXXXXXXXXGXXXXXXXXXXXXXXXXXXXGXXXXXXXXXXXXXXXXXXXGXXXXXXXXXXXXXXXXXXXGXXXXXXXXXXXXXXXXXXX,0,300,0
12201,14,1,13,71,215,0,0,226,88,138,GXXXXXXXXXXXXXXXXXXXGXXXXXXXXXXXXXXXXXXXGAXXXXXXXXXXXXXXXXXXGXXXXXXXXXXXXXXXXXXXGXXXXXXXXXXXXXXXXXXXGXXXXXXXXXXXXXXXXXXXGXXXXXXXXXXXXXXXXXXXGXXXXXXXXXXXXXXXXXXXGXXXXXXXXXXXXXXXXXXXGXXXXXXXXXXXXXXXXXXXGXXXXXXXXXXXXXXXXXXXGXXXXXXXXXXXXXXXXXXXGXXXXXXXXXXXXXXXXXXX,0,300,0
12222,13,0,13,71,216,0,0,228,91,137,GXXXXXXXXXXXXXXXXXXXGXXXXXXXXXXXXXXXXXXXGXXXXXXXXXXXXXXXXXXXGXXXXXXXXXXXXXXXXXXXGXXXXXXXXXXXXXXXXXXXGXXXXXXXXXXXXXXXXXXXGXXXXXXXXXXXXXXXXXXXGXXXXXXXXXXXXXXXXXXXGXXXXXXXXXXXXXXXXXXXGXXXXXXXXXXXXXXXXXXXGXXXXXXXXXXXXXXXXXXXGXXXXXXXXXXXXXXXXXXXGXXXXXXXXXXXXXXXXXXX,0,300,0
12243,13,0,13,71,216,0,0,228,90,138,GXXXXXXXXXXXXXXXXXXXGXXXXXXXXXXXXXXXXXXXGXXXXXXXXXXXXXXXXXXXGXXXXXXXXXXXXXXXXXXXGXXXXXXXXXXXXXXXXXXXGXXXXXXXXXXXXXXXXXXXGXXXXXXXXXXXXXXXXXXXGXXXXXXXXXXXXXXXXXXXGXXXXXXXXXXXXXXXXXXXGXXXXXXXXXXXXXXXXXXXGXXXXXXXXXXXXXXXXXXXGXXXXXXXXXXXXXXXXXXXGXXXXXXXXXXXXXXXXXXX,0,300,0
12264,14,1,13,73,213,0,0,225,93,132,GXXXXXXXXXXXXXXXXXXXGXXXXXXXXXXXXXXXXXXXGXXXXXXXXXXXXXXXXXXXGXXXXXXXXXXXXXXXXXXXGXXXXXXXXXXXXXXXXXXXGXXXXXXXXXXXXXXXXXXXGXXXXXXXXXXXXXXXXXXXGXXXXXXXXXXXXXXXXXXXGXXXXXXXXXXXXXXXXXXXGXXXXXXXXXXXXXXXXXXXGXXXXXXXXXXXXXXXXXXXGXXXXXXXXXXXXXXXXXXXGAXXXXXXXXXXXXXXXXXX,0,300,0

12285,14,1,13,77,209,0,0,220,93,127,GXXXXXXXXXXXXXXXXXXXGXXXXXXXXXXXXXXXXXXXGXXXXXXXXXXXXXXXXXXXGXXXXXXXXXXXXXXXXXXXGXXXXXXXXXXXXXXXXXXXGXXXXXXXXXXXXXXXXXXXGXXXXXXXXXXXXXXXXXXXGXXXXXXXXXXXXXXXXXXXGXXXXXXXXXXXXXXXXXXXGXXXXXXXXXXXXXXXXXXXGXXXXXXXXXXXXXXXXXXXGXXXXXXXXXXXXXXXXXXXGAXXXXXXXXXXXXXXXXXX,0,300,0
12306,14,1,13,76,210,0,0,221,97,124,GXXXXXXXXXXXXXXXXXXXGXXXXXXXXXXXXXXXXXXXGXXXXXXXXXXXXXXXXXXXGXXXXXXXXXXXXXXXXXXXGXXXXXXXXXXXXXXXXXXXGXXXXXXXXXXXXXXXXXXXGXXXXXXXXXXXXXXXXXXXGXXXXXXXXXXXXXXXXXXXGXXXXXXXXXXXXXXXXXXXGXXXXXXXXXXXXXXXXXXXGXXXXXXXXXXXXXXXXXXXGXXXXXXXXXXXXXXXXXXXGAXXXXXXXXXXXXXXXXXX,0,300,0
12327,14,1,13,77,209,0,0,221,98,123,GXXXXXXXXXXXXXXXXXXXGXXXXXXXXXXXXXXXXXXXGXXXXXXXXXXXXXXXXXXXGXXXXXXXXXXXXXXXXXXXGXXXXXXXXXXXXXXXXXXXGXXXXXXXXXXXXXXXXXXXGXXXXXXXXXXXXXXXXXXXGXXXXXXXXXXXXXXXXXXXGXXXXXXXXXXXXXXXXXXXGXXXXXXXXXXXXXXXXXXXGXXXXXXXXXXXXXXXXXXXGXXXXXXXXXXXXXXXXXXXGAXXXXXXXXXXXXXXXXXX,0,300,0
12348,15,2,13,70,215,0,0,227,96,131,GXXXXXXXXXXXXXXXXXXXGXXXXXXXXXXXXXXXXXXXGAXXXXXXXXXXXXXXXXXXGXXXXXXXXXXXXXXXXXXXGXXXXXXXXXXXXXXXXXXXGXXXXXXXXXXXXXXXXXXXGXXXXXXXXXXXXXXXXXXXGXXXXXXXXXXXXXXXXXXXGXXXXXXXXXXXXXXXXXXXGXXXXXXXXXXXXXXXXXXXGXXXXXXXXXXXXXXXXXXXGXXXXXXXXXXXXXXXXXXXGAXXXXXXXXXXXXXXXXXX,0,300,0
12369,15,2,13,73,212,0,0,224,94,130,GXXXXXXXXXXXXXXXXXXXGXXXXXXXXXXXXXXXXXXXGAXXXXXXXXXXXXXXXXXXGXXXXXXXXXXXXXXXXXXXGXXXXXXXXXXXXXXXXXXXGXXXXXXXXXXXXXXXXXXXGXXXXXXXXXXXXXXXXXXXGXXXXXXXXXXXXXXXXXXXGXXXXXXXXXXXXXXXXXXXGXXXXXXXXXXXXXXXXXXXGXXXXXXXXXXXXXXXXXXXGXXXXXXXXXXXXXXXXXXXGAXXXXXXXXXXXXXXXXXX,0,300,0

12390,15,2,13,74,211,0,0,223,93,130,GXXXXXXXXXXXXXXXXXXXGXXXXXXXXXXXXXXXXXXXGAXXXXXXXXXXXXXXXXXXGXXXXXXXXXXXXXXXXXXXGXXXXXXXXXXXXXXXXXXXGXXXXXXXXXXXXXXXXXXXGXXXXXXXXXXXXXXXXXXXGXXXXXXXXXXXXXXXXXXXGXXXXXXXXXXXXXXXXXXXGXXXXXXXXXXXXXXXXXXXGXXXXXXXXXXXXXXXXXXXGXXXXXXXXXXXXXXXXXXXGAXXXXXXXXXXXXXXXXXX,0,300,0
12411,15,2,13,71,214,0,0,226,97,129,GXXXXXXXXXXXXXXXXXXXGXXXXXXXXXXXXXXXXXXXGAXXXXXXXXXXXXXXXXXXGXXXXXXXXXXXXXXXXXXXGXXXXXXXXXXXXXXXXXXXGXXXXXXXXXXXXXXXXXXXGXXXXXXXXXXXXXXXXXXXGXXXXXXXXXXXXXXXXXXXGXXXXXXXXXXXXXXXXXXXGXXXXXXXXXXXXXXXXXXXGXXXXXXXXXXXXXXXXXXXGXXXXXXXXXXXXXXXXXXXGAXXXXXXXXXXXXXXXXXX,0,300,0
12432,15,1,14,73,212,0,0,224,100,124,GXXXXXXXXXXXXXXXXXXXGXXXXXXXXXXXXXXXXXXXGAXXXXXXXXXXXXXXXXXXGXXXXXXXXXXXXXXXXXXXGXXXXXXXXXXXXXXXXXXXGXXXXXXXXXXXXXXXXXXXGXXXXXXXXXXXXXXXXXXXGXXXXXXXXXXXXXXXXXXXGXXXXXXXXXXXXXXXXXXXGXXXXXXXXXXXXXXXXXXXGXXXXXXXXXXXXXXXXXXXGXXXXXXXXXXXXXXXXXXXGOXXXXXXXXXXXXXXXXXX,0,300,0
12453,14,1,13,79,207,0,0,219,96,123,GXXXXXXXXXXXXXXXXXXXGXXXXXXXXXXXXXXXXXXXGAXXXXXXXXXXXXXXXXXXGXXXXXXXXXXXXXXXXXXXGXXXXXXXXXXXXXXXXXXXGXXXXXXXXXXXXXXXXXXXGXXXXXXXXXXXXXXXXXXXGXXXXXXXXXXXXXXXXXXXGXXXXXXXXXXXXXXXXXXXGXXXXXXXXXXXXXXXXXXXGXXXXXXXXXXXXXXXXXXXGXXXXXXXXXXXXXXXXXXXGXXXXXXXXXXXXXXXXXXX,0,300,0
12474,14,1,13,77,209,0,0,221,98,123,GXXXXXXXXXXXXXXXXXXXGXXXXXXXXXXXXXXXXXXXGAXXXXXXXXXXXXXXXXXXGXXXXXXXXXXXXXXXXXXXGXXXXXXXXXXXXXXXXXXXGXXXXXXXXXXXXXXXXXXXGXXXXXXXXXXXXXXXXXXXGXXXXXXXXXXXXXXXXXXXGXXXXXXXXXXXXXXXXXXXGXXXXXXXXXXXXXXXXXXXGXXXXXXXXXXXXXXXXXXXGXXXXXXXXXXXXXXXXXXXGXXXXXXXXXXXXXXXXXXX,0,300,0

12495,14,1,13,73,213,0,0,225,103,122,GXXXXXXXXXXXXXXXXXXXGXXXXXXXXXXXXXXXXXXXGAXXXXXXXXXXXXXXXXXXGXXXXXXXXXXXXXXXXXXXGXXXXXXXXXXXXXXXXXXXGXXXXXXXXXXXXXXXXXXXGXXXXXXXXXXXXXXXXXXXGXXXXXXXXXXXXXXXXXXXGXXXXXXXXXXXXXXXXXXXGXXXXXXXXXXXXXXXXXXXGXXXXXXXXXXXXXXXXXXXGXXXXXXXXXXXXXXXXXXXGXXXXXXXXXXXXXXXXXXX,0,300,0
12516,14,0,14,77,209,0,0,221,104,117,GXXXXXXXXXXXXXXXXXXXGXXXXXXXXXXXXXXXXXXXGOXXXXXXXXXXXXXXXXXXGXXXXXXXXXXXXXXXXXXXGXXXXXXXXXXXXXXXXXXXGXXXXXXXXXXXXXXXXXXXGXXXXXXXXXXXXXXXXXXXGXXXXXXXXXXXXXXXXXXXGXXXXXXXXXXXXXXXXXXXGXXXXXXXXXXXXXXXXXXXGXXXXXXXXXXXXXXXXXXXGXXXXXXXXXXXXXXXXXXXGXXXXXXXXXXXXXXXXXXX,0,300,0
12537,14,0,14,79,207,0,0,220,100,120,GXXXXXXXXXXXXXXXXXXXGXXXXXXXXXXXXXXXXXXXGOXXXXXXXXXXXXXXXXXXGXXXXXXXXXXXXXXXXXXXGXXXXXXXXXXXXXXXXXXXGXXXXXXXXXXXXXXXXXXXGXXXXXXXXXXXXXXXXXXXGXXXXXXXXXXXXXXXXXXXGXXXXXXXXXXXXXXXXXXXGXXXXXXXXXXXXXXXXXXXGXXXXXXXXXXXXXXXXXXXGXXXXXXXXXXXXXXXXXXXGXXXXXXXXXXXXXXXXXXX,0,300,0
12558,13,0,13,86,201,0,0,213,96,117,GXXXXXXXXXXXXXXXXXXXGXXXXXXXXXXXXXXXXXXXGXXXXXXXXXXXXXXXXXXXGXXXXXXXXXXXXXXXXXXXGXXXXXXXXXXXXXXXXXXXGXXXXXXXXXXXXXXXXXXXGXXXXXXXXXXXXXXXXXXXGXXXXXXXXXXXXXXXXXXXGXXXXXXXXXXXXXXXXXXXGXXXXXXXXXXXXXXXXXXXGXXXXXXXXXXXXXXXXXXXGXXXXXXXXXXXXXXXXXXXGXXXXXXXXXXXXXXXXXXX,0,300,0
12579,13,0,13,87,200,0,0,213,96,117,GXXXXXXXXXXXXXXXXXXXGXXXXXXXXXXXXXXXXXXXGXXXXXXXXXXXXXXXXXXXGXXXXXXXXXXXXXXXXXXXGXXXXXXXXXXXXXXXXXXXGXXXXXXXXXXXXXXXXXXXGXXXXXXXXXXXXXXXXXXXGXXXXXXXXXXXXXXXXXXXGXXXXXXXXXXXXXXXXXXXGXXXXXXXXXXXXXXXXXXXGXXXXXXXXXXXXXXXXXXXGXXXXXXXXXXXXXXXXXXXGXXXXXXXXXXXXXXXXXXX,0,300,0

12600,13,0,13,88,199,0,0,211,96,115,GXXXXXXXXXXXXXXXXXXXGXXXXXXXXXXXXXXXXXXXGXXXXXXXXXXXXXXXXXXXGXXXXXXXXXXXXXXXXXXXGXXXXXXXXXXXXXXXXXXXGXXXXXXXXXXXXXXXXXXXGXXXXXXXXXXXXXXXXXXXGXXXXXXXXXXXXXXXXXXXGXXXXXXXXXXXXXXXXXXXGXXXXXXXXXXXXXXXXXXXGXXXXXXXXXXXXXXXXXXXGXXXXXXXXXXXXXXXXXXXGXXXXXXXXXXXXXXXXXXX,0,300,0
12621,13,0,13,88,199,0,0,210,95,115,GXXXXXXXXXXXXXXXXXXXGXXXXXXXXXXXXXXXXXXXGXXXXXXXXXXXXXXXXXXXGXXXXXXXXXXXXXXXXXXXGXXXXXXXXXXXXXXXXXXXGXXXXXXXXXXXXXXXXXXXGXXXXXXXXXXXXXXXXXXXGXXXXXXXXXXXXXXXXXXXGXXXXXXXXXXXXXXXXXXXGXXXXXXXXXXXXXXXXXXXGXXXXXXXXXXXXXXXXXXXGXXXXXXXXXXXXXXXXXXXGXXXXXXXXXXXXXXXXXXX,0,300,0
12642,13,0,13,86,201,0,0,212,99,113,GXXXXXXXXXXXXXXXXXXXGXXXXXXXXXXXXXXXXXXXGXXXXXXXXXXXXXXXXXXXGXXXXXXXXXXXXXXXXXXXGXXXXXXXXXXXXXXXXXXXGXXXXXXXXXXXXXXXXXXXGXXXXXXXXXXXXXXXXXXXGXXXXXXXXXXXXXXXXXXXGXXXXXXXXXXXXXXXXXXXGXXXXXXXXXXXXXXXXXXXGXXXXXXXXXXXXXXXXXXXGXXXXXXXXXXXXXXXXXXXGXXXXXXXXXXXXXXXXXXX,0,300,0
12663,13,0,13,84,203,0,0,215,98,117,GXXXXXXXXXXXXXXXXXXXGXXXXXXXXXXXXXXXXXXXGXXXXXXXXXXXXXXXXXXXGXXXXXXXXXXXXXXXXXXXGXXXXXXXXXXXXXXXXXXXGXXXXXXXXXXXXXXXXXXXGXXXXXXXXXXXXXXXXXXXGXXXXXXXXXXXXXXXXXXXGXXXXXXXXXXXXXXXXXXXGXXXXXXXXXXXXXXXXXXXGXXXXXXXXXXXXXXXXXXXGXXXXXXXXXXXXXXXXXXXGXXXXXXXXXXXXXXXXXXX,0,300,0
12684,13,0,13,82,205,0,0,216,94,122,GXXXXXXXXXXXXXXXXXXXGXXXXXXXXXXXXXXXXXXXGXXXXXXXXXXXXXXXXXXXGXXXXXXXXXXXXXXXXXXXGXXXXXXXXXXXXXXXXXXXGXXXXXXXXXXXXXXXXXXXGXXXXXXXXXXXXXXXXXXXGXXXXXXXXXXXXXXXXXXXGXXXXXXXXXXXXXXXXXXXGXXXXXXXXXXXXXXXXXXXGXXXXXXXXXXXXXXXXXXXGXXXXXXXXXXXXXXXXXXXGXXXXXXXXXXXXXXXXXXX,0,300,0

12705,13,0,13,83,204,0,0,216,91,125,GXXXXXXXXXXXXXXXXXXXGXXXXXXXXXXXXXXXXXXXGXXXXXXXXXXXXXXXXXXXGXXXXXXXXXXXXXXXXXXXGXXXXXXXXXXXXXXXXXXXGXXXXXXXXXXXXXXXXXXXGXXXXXXXXXXXXXXXXXXXGXXXXXXXXXXXXXXXXXXXGXXXXXXXXXXXXXXXXXXXGXXXXXXXXXXXXXXXXXXXGXXXXXXXXXXXXXXXXXXXGXXXXXXXXXXXXXXXXXXXGXXXXXXXXXXXXXXXXXXX,0,300,0
12726,13,0,13,76,211,0,0,221,92,129,GXXXXXXXXXXXXXXXXXXXGXXXXXXXXXXXXXXXXXXXGXXXXXXXXXXXXXXXXXXXGXXXXXXXXXXXXXXXXXXXGXXXXXXXXXXXXXXXXXXXGXXXXXXXXXXXXXXXXXXXGXXXXXXXXXXXXXXXXXXXGXXXXXXXXXXXXXXXXXXXGXXXXXXXXXXXXXXXXXXXGXXXXXXXXXXXXXXXXXXXGXXXXXXXXXXXXXXXXXXXGXXXXXXXXXXXXXXXXXXXGXXXXXXXXXXXXXXXXXXX,0,300,0
12747,13,0,13,77,210,0,0,223,90,133,GXXXXXXXXXXXXXXXXXXXGXXXXXXXXXXXXXXXXXXXGXXXXXXXXXXXXXXXXXXXGXXXXXXXXXXXXXXXXXXXGXXXXXXXXXXXXXXXXXXXGXXXXXXXXXXXXXXXXXXXGXXXXXXXXXXXXXXXXXXXGXXXXXXXXXXXXXXXXXXXGXXXXXXXXXXXXXXXXXXXGXXXXXXXXXXXXXXXXXXXGXXXXXXXXXXXXXXXXXXXGXXXXXXXXXXXXXXXXXXXGXXXXXXXXXXXXXXXXXXX,0,300,0
12768,13,0,13,74,213,0,0,225,94,131,GXXXXXXXXXXXXXXXXXXXGXXXXXXXXXXXXXXXXXXXGXXXXXXXXXXXXXXXXXXXGXXXXXXXXXXXXXXXXXXXGXXXXXXXXXXXXXXXXXXXGXXXXXXXXXXXXXXXXXXXGXXXXXXXXXXXXXXXXXXXGXXXXXXXXXXXXXXXXXXXGXXXXXXXXXXXXXXXXXXXGXXXXXXXXXXXXXXXXXXXGXXXXXXXXXXXXXXXXXXXGXXXXXXXXXXXXXXXXXXXGXXXXXXXXXXXXXXXXXXX,0,300,0
12789,13,0,13,77,210,0,0,223,95,128,GXXXXXXXXXXXXXXXXXXXGXXXXXXXXXXXXXXXXXXXGXXXXXXXXXXXXXXXXXXXGXXXXXXXXXXXXXXXXXXXGXXXXXXXXXXXXXXXXXXXGXXXXXXXXXXXXXXXXXXXGXXXXXXXXXXXXXXXXXXXGXXXXXXXXXXXXXXXXXXXGXXXXXXXXXXXXXXXXXXXGXXXXXXXXXXXXXXXXXXXGXXXXXXXXXXXXXXXXXXXGXXXXXXXXXXXXXXXXXXXGXXXXXXXXXXXXXXXXXXX,0,300,0

12810,13,0,13,78,209,0,0,222,93,129,GXXXXXXXXXXXXXXXXXXXGXXXXXXXXXXXXXXXXXXXGXXXXXXXXXXXXXXXXXXXGXXXXXXXXXXXXXXXXXXXGXXXXXXXXXXXXXXXXXXXGXXXXXXXXXXXXXXXXXXXGXXXXXXXXXXXXXXXXXXXGXXXXXXXXXXXXXXXXXXXGXXXXXXXXXXXXXXXXXXXGXXXXXXXXXXXXXXXXXXXGXXXXXXXXXXXXXXXXXXXGXXXXXXXXXXXXXXXXXXXGXXXXXXXXXXXXXXXXXXX,0,300,0
12831,13,0,13,82,205,0,0,218,98,120,GXXXXXXXXXXXXXXXXXXXGXXXXXXXXXXXXXXXXXXXGXXXXXXXXXXXXXXXXXXXGXXXXXXXXXXXXXXXXXXXGXXXXXXXXXXXXXXXXXXXGXXXXXXXXXXXXXXXXXXXGXXXXXXXXXXXXXXXXXXXGXXXXXXXXXXXXXXXXXXXGXXXXXXXXXXXXXXXXXXXGXXXXXXXXXXXXXXXXXXXGXXXXXXXXXXXXXXXXXXXGXXXXXXXXXXXXXXXXXXXGXXXXXXXXXXXXXXXXXXX,0,300,0
12852,13,0,13,85,202,0,0,215,94,121,GXXXXXXXXXXXXXXXXXXXGXXXXXXXXXXXXXXXXXXXGXXXXXXXXXXXXXXXXXXXGXXXXXXXXXXXXXXXXXXXGXXXXXXXXXXXXXXXXXXXGXXXXXXXXXXXXXXXXXXXGXXXXXXXXXXXXXXXXXXXGXXXXXXXXXXXXXXXXXXXGXXXXXXXXXXXXXXXXXXXGXXXXXXXXXXXXXXXXXXXGXXXXXXXXXXXXXXXXXXXGXXXXXXXXXXXXXXXXXXXGXXXXXXXXXXXXXXXXXXX,0,300,0
12873,14,1,13,84,202,0,0,215,94,121,GXXXXXXXXXXXXXXXXXXXGXXXXXXXXXXXXXXXXXXXGXXXXXXXXXXXXXXXXXXXGXXXXXXXXXXXXXXXXXXXGXXXXXXXXXXXXXXXXXXXGXXXXXXXXXXXXXXXXXXXGAXXXXXXXXXXXXXXXXXXGXXXXXXXXXXXXXXXXXXXGXXXXXXXXXXXXXXXXXXXGXXXXXXXXXXXXXXXXXXXGXXXXXXXXXXXXXXXXXXXGXXXXXXXXXXXXXXXXXXXGXXXXXXXXXXXXXXXXXXX,0,300,0
12894,14,1,13,80,206,0,0,218,94,124,GXXXXXXXXXXXXXXXXXXXGXXXXXXXXXXXXXXXXXXXGXXXXXXXXXXXXXXXXXXXGXXXXXXXXXXXXXXXXXXXGXXXXXXXXXXXXXXXXXXXGXXXXXXXXXXXXXXXXXXXGAXXXXXXXXXXXXXXXXXXGXXXXXXXXXXXXXXXXXXXGXXXXXXXXXXXXXXXXXXXGXXXXXXXXXXXXXXXXXXXGXXXXXXXXXXXXXXXXXXXGXXXXXXXXXXXXXXXXXXXGXXXXXXXXXXXXXXXXXXX,0,300,0

12915,14,1,13,80,206,0,0,219,93,126,GXXXXXXXXXXXXXXXXXXXGXXXXXXXXXXXXXXXXXXXGXXXXXXXXXXXXXXXXXXXGXXXXXXXXXXXXXXXXXXXGXXXXXXXXXXXXXXXXXXXGXXXXXXXXXXXXXXXXXXXGAXXXXXXXXXXXXXXXXXXGXXXXXXXXXXXXXXXXXXXGXXXXXXXXXXXXXXXXXXXGXXXXXXXXXXXXXXXXXXXGXXXXXXXXXXXXXXXXXXXGXXXXXXXXXXXXXXXXXXXGXXXXXXXXXXXXXXXXXXX,0,300,0
12936,14,1,13,77,209,0,0,222,98,124,GXXXXXXXXXXXXXXXXXXXGXXXXXXXXXXXXXXXXXXXGXXXXXXXXXXXXXXXXXXXGXXXXXXXXXXXXXXXXXXXGXXXXXXXXXXXXXXXXXXXGXXXXXXXXXXXXXXXXXXXGAXXXXXXXXXXXXXXXXXXGXXXXXXXXXXXXXXXXXXXGXXXXXXXXXXXXXXXXXXXGXXXXXXXXXXXXXXXXXXXGXXXXXXXXXXXXXXXXXXXGXXXXXXXXXXXXXXXXXXXGXXXXXXXXXXXXXXXXXXX,0,300,0
12957,14,1,13,78,208,0,0,222,99,123,GXXXXXXXXXXXXXXXXXXXGXXXXXXXXXXXXXXXXXXXGXXXXXXXXXXXXXXXXXXXGXXXXXXXXXXXXXXXXXXXGXXXXXXXXXXXXXXXXXXXGXXXXXXXXXXXXXXXXXXXGAXXXXXXXXXXXXXXXXXXGXXXXXXXXXXXXXXXXXXXGXXXXXXXXXXXXXXXXXXXGXXXXXXXXXXXXXXXXXXXGXXXXXXXXXXXXXXXXXXXGXXXXXXXXXXXXXXXXXXXGXXXXXXXXXXXXXXXXXXX,0,300,0
12978,14,0,14,80,206,0,0,221,92,129,GXXXXXXXXXXXXXXXXXXXGXXXXXXXXXXXXXXXXXXXGXXXXXXXXXXXXXXXXXXXGXXXXXXXXXXXXXXXXXXXGXXXXXXXXXXXXXXXXXXXGXXXXXXXXXXXXXXXXXXXGOXXXXXXXXXXXXXXXXXXGXXXXXXXXXXXXXXXXXXXGXXXXXXXXXXXXXXXXXXXGXXXXXXXXXXXXXXXXXXXGXXXXXXXXXXXXXXXXXXXGXXXXXXXXXXXXXXXXXXXGXXXXXXXXXXXXXXXXXXX,0,300,0
12999,14,0,14,82,204,0,0,219,92,127,GXXXXXXXXXXXXXXXXXXXGXXXXXXXXXXXXXXXXXXXGXXXXXXXXXXXXXXXXXXXGXXXXXXXXXXXXXXXXXXXGXXXXXXXXXXXXXXXXXXXGXXXXXXXXXXXXXXXXXXXGOXXXXXXXXXXXXXXXXXXGXXXXXXXXXXXXXXXXXXXGXXXXXXXXXXXXXXXXXXXGXXXXXXXXXXXXXXXXXXXGXXXXXXXXXXXXXXXXXXXGXXXXXXXXXXXXXXXXXXXGXXXXXXXXXXXXXXXXXXX,0,300,0

13020,14,1,13,81,205,0,0,219,93,126,GAXXXXXXXXXXXXXXXXXXGXXXXXXXXXXXXXXXXXXXGXXXXXXXXXXXXXXXXXXXGXXXXXXXXXXXXXXXXXXXGXXXXXXXXXXXXXXXXXXXGXXXXXXXXXXXXXXXXXXXGXXXXXXXXXXXXXXXXXXXGXXXXXXXXXXXXXXXXXXXGXXXXXXXXXXXXXXXXXXXGXXXXXXXXXXXXXXXXXXXGXXXXXXXXXXXXXXXXXXXGXXXXXXXXXXXXXXXXXXXGXXXXXXXXXXXXXXXXXXX,0,300,0
13041,14,1,13,76,210,0,0,225,100,125,GAXXXXXXXXXXXXXXXXXXGXXXXXXXXXXXXXXXXXXXGXXXXXXXXXXXXXXXXXXXGXXXXXXXXXXXXXXXXXXXGXXXXXXXXXXXXXXXXXXXGXXXXXXXXXXXXXXXXXXXGXXXXXXXXXXXXXXXXXXXGXXXXXXXXXXXXXXXXXXXGXXXXXXXXXXXXXXXXXXXGXXXXXXXXXXXXXXXXXXXGXXXXXXXXXXXXXXXXXXXGXXXXXXXXXXXXXXXXXXXGXXXXXXXXXXXXXXXXXXX,0,300,0
13062,14,1,13,75,211,0,0,226,94,132,GAXXXXXXXXXXXXXXXXXXGXXXXXXXXXXXXXXXXXXXGXXXXXXXXXXXXXXXXXXXGXXXXXXXXXXXXXXXXXXXGXXXXXXXXXXXXXXXXXXXGXXXXXXXXXXXXXXXXXXXGXXXXXXXXXXXXXXXXXXXGXXXXXXXXXXXXXXXXXXXGXXXXXXXXXXXXXXXXXXXGXXXXXXXXXXXXXXXXXXXGXXXXXXXXXXXXXXXXXXXGXXXXXXXXXXXXXXXXXXXGXXXXXXXXXXXXXXXXXXX,0,300,0
13083,14,1,13,72,214,0,0,229,97,132,GAXXXXXXXXXXXXXXXXXXGXXXXXXXXXXXXXXXXXXXGXXXXXXXXXXXXXXXXXXXGXXXXXXXXXXXXXXXXXXXGXXXXXXXXXXXXXXXXXXXGXXXXXXXXXXXXXXXXXXXGXXXXXXXXXXXXXXXXXXXGXXXXXXXXXXXXXXXXXXXGXXXXXXXXXXXXXXXXXXXGXXXXXXXXXXXXXXXXXXXGXXXXXXXXXXXXXXXXXXXGXXXXXXXXXXXXXXXXXXXGXXXXXXXXXXXXXXXXXXX,0,300,0
13104,14,0,14,70,216,0,0,230,98,132,GOXXXXXXXXXXXXXXXXXXGXXXXXXXXXXXXXXXXXXXGXXXXXXXXXXXXXXXXXXXGXXXXXXXXXXXXXXXXXXXGXXXXXXXXXXXXXXXXXXXGXXXXXXXXXXXXXXXXXXXGXXXXXXXXXXXXXXXXXXXGXXXXXXXXXXXXXXXXXXXGXXXXXXXXXXXXXXXXXXXGXXXXXXXXXXXXXXXXXXXGXXXXXXXXXXXXXXXXXXXGXXXXXXXXXXXXXXXXXXXGXXXXXXXXXXXXXXXXXXX,0,300,0

13125,14,0,14,77,209,0,0,225,97,128,GOXXXXXXXXXXXXXXXXXXGXXXXXXXXXXXXXXXXXXXGXXXXXXXXXXXXXXXXXXXGXXXXXXXXXXXXXXXXXXXGXXXXXXXXXXXXXXXXXXXGXXXXXXXXXXXXXXXXXXXGXXXXXXXXXXXXXXXXXXXGXXXXXXXXXXXXXXXXXXXGXXXXXXXXXXXXXXXXXXXGXXXXXXXXXXXXXXXXXXXGXXXXXXXXXXXXXXXXXXXGXXXXXXXXXXXXXXXXXXXGXXXXXXXXXXXXXXXXXXX,0,300,0
13146,14,0,14,78,208,0,0,224,98,126,GOXXXXXXXXXXXXXXXXXXGXXXXXXXXXXXXXXXXXXXGXXXXXXXXXXXXXXXXXXXGXXXXXXXXXXXXXXXXXXXGXXXXXXXXXXXXXXXXXXXGXXXXXXXXXXXXXXXXXXXGXXXXXXXXXXXXXXXXXXXGXXXXXXXXXXXXXXXXXXXGXXXXXXXXXXXXXXXXXXXGXXXXXXXXXXXXXXXXXXXGXXXXXXXXXXXXXXXXXXXGXXXXXXXXXXXXXXXXXXXGXXXXXXXXXXXXXXXXXXX,0,300,0
13167,13,0,13,80,207,0,0,222,96,126,GXXXXXXXXXXXXXXXXXXXGXXXXXXXXXXXXXXXXXXXGXXXXXXXXXXXXXXXXXXXGXXXXXXXXXXXXXXXXXXXGXXXXXXXXXXXXXXXXXXXGXXXXXXXXXXXXXXXXXXXGXXXXXXXXXXXXXXXXXXXGXXXXXXXXXXXXXXXXXXXGXXXXXXXXXXXXXXXXXXXGXXXXXXXXXXXXXXXXXXXGXXXXXXXXXXXXXXXXXXXGXXXXXXXXXXXXXXXXXXXGXXXXXXXXXXXXXXXXXXX,0,300,0
13188,13,0,13,82,205,0,0,221,95,126,GXXXXXXXXXXXXXXXXXXXGXXXXXXXXXXXXXXXXXXXGXXXXXXXXXXXXXXXXXXXGXXXXXXXXXXXXXXXXXXXGXXXXXXXXXXXXXXXXXXXGXXXXXXXXXXXXXXXXXXXGXXXXXXXXXXXXXXXXXXXGXXXXXXXXXXXXXXXXXXXGXXXXXXXXXXXXXXXXXXXGXXXXXXXXXXXXXXXXXXXGXXXXXXXXXXXXXXXXXXXGXXXXXXXXXXXXXXXXXXXGXXXXXXXXXXXXXXXXXXX,0,300,0
13209,13,0,13,77,210,0,0,226,97,129,GXXXXXXXXXXXXXXXXXXXGXXXXXXXXXXXXXXXXXXXGXXXXXXXXXXXXXXXXXXXGXXXXXXXXXXXXXXXXXXXGXXXXXXXXXXXXXXXXXXXGXXXXXXXXXXXXXXXXXXXGXXXXXXXXXXXXXXXXXXXGXXXXXXXXXXXXXXXXXXXGXXXXXXXXXXXXXXXXXXXGXXXXXXXXXXXXXXXXXXXGXXXXXXXXXXXXXXXXXXXGXXXXXXXXXXXXXXXXXXXGXXXXXXXXXXXXXXXXXXX,0,300,0

13230,13,0,13,76,211,0,0,225,102,123,GXXXXXXXXXXXXXXXXXXXGXXXXXXXXXXXXXXXXXXXGXXXXXXXXXXXXXXXXXXXGXXXXXXXXXXXXXXXXXXXGXXXXXXXXXXXXXXXXXXXGXXXXXXXXXXXXXXXXXXXGXXXXXXXXXXXXXXXXXXXGXXXXXXXXXXXXXXXXXXXGXXXXXXXXXXXXXXXXXXXGXXXXXXXXXXXXXXXXXXXGXXXXXXXXXXXXXXXXXXXGXXXXXXXXXXXXXXXXXXXGXXXXXXXXXXXXXXXXXXX,0,300,0
13251,14,1,13,73,213,0,0,225,103,122,GXXXXXXXXXXXXXXXXXXXGXXXXXXXXXXXXXXXXXXXGXXXXXXXXXXXXXXXXXXXGXXXXXXXXXXXXXXXXXXXGXXXXXXXXXXXXXXXXXXXGXXXXXXXXXXXXXXXXXXXGXXXXXXXXXXXXXXXXXXXGXXXXXXXXXXXXXXXXXXXGXXXXXXXXXXXXXXXXXXXGXXXXXXXXXXXXXXXXXXXGXXXXXXXXXXXXXXXXXXXGXXXXXXXXXXXXXXXXXXXGAXXXXXXXXXXXXXXXXXX,0,300,0
13272,14,1,13,73,213,0,0,226,102,124,GXXXXXXXXXXXXXXXXXXXGXXXXXXXXXXXXXXXXXXXGXXXXXXXXXXXXXXXXXXXGXXXXXXXXXXXXXXXXXXXGXXXXXXXXXXXXXXXXXXXGXXXXXXXXXXXXXXXXXXXGXXXXXXXXXXXXXXXXXXXGXXXXXXXXXXXXXXXXXXXGXXXXXXXXXXXXXXXXXXXGXXXXXXXXXXXXXXXXXXXGXXXXXXXXXXXXXXXXXXXGXXXXXXXXXXXXXXXXXXXGAXXXXXXXXXXXXXXXXXX,0,300,0
13293,14,1,13,74,212,0,0,225,105,120,GXXXXXXXXXXXXXXXXXXXGXXXXXXXXXXXXXXXXXXXGXXXXXXXXXXXXXXXXXXXGXXXXXXXXXXXXXXXXXXXGXXXXXXXXXXXXXXXXXXXGXXXXXXXXXXXXXXXXXXXGXXXXXXXXXXXXXXXXXXXGXXXXXXXXXXXXXXXXXXXGXXXXXXXXXXXXXXXXXXXGXXXXXXXXXXXXXXXXXXXGXXXXXXXXXXXXXXXXXXXGXXXXXXXXXXXXXXXXXXXGAXXXXXXXXXXXXXXXXXX,0,300,0
13314,14,1,13,76,210,0,0,221,105,116,GXXXXXXXXXXXXXXXXXXXGXXXXXXXXXXXXXXXXXXXGXXXXXXXXXXXXXXXXXXXGXXXXXXXXXXXXXXXXXXXGXXXXXXXXXXXXXXXXXXXGXXXXXXXXXXXXXXXXXXXGXXXXXXXXXXXXXXXXXXXGXXXXXXXXXXXXXXXXXXXGXXXXXXXXXXXXXXXXXXXGXXXXXXXXXXXXXXXXXXXGXXXXXXXXXXXXXXXXXXXGXXXXXXXXXXXXXXXXXXXGAXXXXXXXXXXXXXXXXXX,0,300,0

13335,14,1,13,75,211,0,0,222,105,117,GXXXXXXXXXXXXXXXXXXXGXXXXXXXXXXXXXXXXXXXGXXXXXXXXXXXXXXXXXXXGXXXXXXXXXXXXXXXXXXXGXXXXXXXXXXXXXXXXXXXGXXXXXXXXXXXXXXXXXXXGXXXXXXXXXXXXXXXXXXXGXXXXXXXXXXXXXXXXXXXGXXXXXXXXXXXXXXXXXXXGXXXXXXXXXXXXXXXXXXXGXXXXXXXXXXXXXXXXXXXGXXXXXXXXXXXXXXXXXXXGAXXXXXXXXXXXXXXXXXX,0,300,0
13356,14,1,13,72,214,0,0,225,106,119,GXXXXXXXXXXXXXXXXXXXGXXXXXXXXXXXXXXXXXXXGXXXXXXXXXXXXXXXXXXXGXXXXXXXXXXXXXXXXXXXGXXXXXXXXXXXXXXXXXXXGXXXXXXXXXXXXXXXXXXXGXXXXXXXXXXXXXXXXXXXGXXXXXXXXXXXXXXXXXXXGXXXXXXXXXXXXXXXXXXXGXXXXXXXXXXXXXXXXXXXGXXXXXXXXXXXXXXXXXXXGXXXXXXXXXXXXXXXXXXXGAXXXXXXXXXXXXXXXXXX,0,300,0
13377,14,1,13,79,207,0,0,219,105,114,GXXXXXXXXXXXXXXXXXXXGXXXXXXXXXXXXXXXXXXXGXXXXXXXXXXXXXXXXXXXGXXXXXXXXXXXXXXXXXXXGXXXXXXXXXXXXXXXXXXXGXXXXXXXXXXXXXXXXXXXGXXXXXXXXXXXXXXXXXXXGXXXXXXXXXXXXXXXXXXXGXXXXXXXXXXXXXXXXXXXGXXXXXXXXXXXXXXXXXXXGXXXXXXXXXXXXXXXXXXXGXXXXXXXXXXXXXXXXXXXGAXXXXXXXXXXXXXXXXXX,0,300,0
13398,15,2,13,83,202,0,0,214,100,114,GXXXXXXXXXXXXXXXXXXXGXXXXXXXXXXXXXXXXXXXGAXXXXXXXXXXXXXXXXXXGXXXXXXXXXXXXXXXXXXXGXXXXXXXXXXXXXXXXXXXGXXXXXXXXXXXXXXXXXXXGXXXXXXXXXXXXXXXXXXXGXXXXXXXXXXXXXXXXXXXGXXXXXXXXXXXXXXXXXXXGXXXXXXXXXXXXXXXXXXXGXXXXXXXXXXXXXXXXXXXGXXXXXXXXXXXXXXXXXXXGAXXXXXXXXXXXXXXXXXX,0,300,0
13419,15,2,13,83,202,0,0,214,99,115,GXXXXXXXXXXXXXXXXXXXGXXXXXXXXXXXXXXXXXXXGAXXXXXXXXXXXXXXXXXXGXXXXXXXXXXXXXXXXXXXGXXXXXXXXXXXXXXXXXXXGXXXXXXXXXXXXXXXXXXXGXXXXXXXXXXXXXXXXXXXGXXXXXXXXXXXXXXXXXXXGXXXXXXXXXXXXXXXXXXXGXXXXXXXXXXXXXXXXXXXGXXXXXXXXXXXXXXXXXXXGXXXXXXXXXXXXXXXXXXXGAXXXXXXXXXXXXXXXXXX,0,300,0

13440,15,1,14,75,210,0,0,221,99,122,GXXXXXXXXXXXXXXXXXXXGXXXXXXXXXXXXXXXXXXXGAXXXXXXXXXXXXXXXXXXGXXXXXXXXXXXXXXXXXXXGXXXXXXXXXXXXXXXXXXXGXXXXXXXXXXXXXXXXXXXGXXXXXXXXXXXXXXXXXXXGXXXXXXXXXXXXXXXXXXXGXXXXXXXXXXXXXXXXXXXGXXXXXXXXXXXXXXXXXXXGXXXXXXXXXXXXXXXXXXXGXXXXXXXXXXXXXXXXXXXGOXXXXXXXXXXXXXXXXXX,0,300,0
13461,14,1,13,71,215,0,0,227,105,122,GXXXXXXXXXXXXXXXXXXXGXXXXXXXXXXXXXXXXXXXGAXXXXXXXXXXXXXXXXXXGXXXXXXXXXXXXXXXXXXXGXXXXXXXXXXXXXXXXXXXGXXXXXXXXXXXXXXXXXXXGXXXXXXXXXXXXXXXXXXXGXXXXXXXXXXXXXXXXXXXGXXXXXXXXXXXXXXXXXXXGXXXXXXXXXXXXXXXXXXXGXXXXXXXXXXXXXXXXXXXGXXXXXXXXXXXXXXXXXXXGXXXXXXXXXXXXXXXXXXX,0,300,0
13482,14,1,13,72,214,0,0,226,103,123,GXXXXXXXXXXXXXXXXXXXGXXXXXXXXXXXXXXXXXXXGAXXXXXXXXXXXXXXXXXXGXXXXXXXXXXXXXXXXXXXGXXXXXXXXXXXXXXXXXXXGXXXXXXXXXXXXXXXXXXXGXXXXXXXXXXXXXXXXXXXGXXXXXXXXXXXXXXXXXXXGXXXXXXXXXXXXXXXXXXXGXXXXXXXXXXXXXXXXXXXGXXXXXXXXXXXXXXXXXXXGXXXXXXXXXXXXXXXXXXXGXXXXXXXXXXXXXXXXXXX,0,300,0
13503,14,1,13,70,216,0,0,228,107,121,GXXXXXXXXXXXXXXXXXXXGXXXXXXXXXXXXXXXXXXXGAXXXXXXXXXXXXXXXXXXGXXXXXXXXXXXXXXXXXXXGXXXXXXXXXXXXXXXXXXXGXXXXXXXXXXXXXXXXXXXGXXXXXXXXXXXXXXXXXXXGXXXXXXXXXXXXXXXXXXXGXXXXXXXXXXXXXXXXXXXGXXXXXXXXXXXXXXXXXXXGXXXXXXXXXXXXXXXXXXXGXXXXXXXXXXXXXXXXXXXGXXXXXXXXXXXXXXXXXXX,0,300,0
13524,14,1,13,70,216,0,0,228,103,125,GXXXXXXXXXXXXXXXXXXXGXXXXXXXXXXXXXXXXXXXGAXXXXXXXXXXXXXXXXXXGXXXXXXXXXXXXXXXXXXXGXXXXXXXXXXXXXXXXXXXGXXXXXXXXXXXXXXXXXXXGXXXXXXXXXXXXXXXXXXXGXXXXXXXXXXXXXXXXXXXGXXXXXXXXXXXXXXXXXXXGXXXXXXXXXXXXXXXXXXXGXXXXXXXXXXXXXXXXXXXGXXXXXXXXXXXXXXXXXXXGXXXXXXXXXXXXXXXXXXX,0,300,0

13545,15,2,13,69,216,0,0,226,105,121,GXXXXXXXXXXXXXXXXXXXGXXXXXXXXXXXXXXXXXXXGAAXXXXXXXXXXXXXXXXXGXXXXXXXXXXXXXXXXXXXGXXXXXXXXXXXXXXXXXXXGXXXXXXXXXXXXXXXXXXXGXXXXXXXXXXXXXXXXXXXGXXXXXXXXXXXXXXXXXXXGXXXXXXXXXXXXXXXXXXXGXXXXXXXXXXXXXXXXXXXGXXXXXXXXXXXXXXXXXXXGXXXXXXXXXXXXXXXXXXXGXXXXXXXXXXXXXXXXXXX,0,300,0
13566,15,2,13,75,210,0,0,222,100,122,GXXXXXXXXXXXXXXXXXXXGXXXXXXXXXXXXXXXXXXXGAAXXXXXXXXXXXXXXXXXGXXXXXXXXXXXXXXXXXXXGXXXXXXXXXXXXXXXXXXXGXXXXXXXXXXXXXXXXXXXGXXXXXXXXXXXXXXXXXXXGXXXXXXXXXXXXXXXXXXXGXXXXXXXXXXXXXXXXXXXGXXXXXXXXXXXXXXXXXXXGXXXXXXXXXXXXXXXXXXXGXXXXXXXXXXXXXXXXXXXGXXXXXXXXXXXXXXXXXXX,0,300,0
13587,15,1,14,75,210,0,0,222,100,122,GXXXXXXXXXXXXXXXXXXXGXXXXXXXXXXXXXXXXXXXGAOXXXXXXXXXXXXXXXXXGXXXXXXXXXXXXXXXXXXXGXXXXXXXXXXXXXXXXXXXGXXXXXXXXXXXXXXXXXXXGXXXXXXXXXXXXXXXXXXXGXXXXXXXXXXXXXXXXXXXGXXXXXXXXXXXXXXXXXXXGXXXXXXXXXXXXXXXXXXXGXXXXXXXXXXXXXXXXXXXGXXXXXXXXXXXXXXXXXXXGXXXXXXXXXXXXXXXXXXX,0,300,0
13608,14,1,13,84,202,0,0,215,102,113,GXXXXXXXXXXXXXXXXXXXGXXXXXXXXXXXXXXXXXXXGAXXXXXXXXXXXXXXXXXXGXXXXXXXXXXXXXXXXXXXGXXXXXXXXXXXXXXXXXXXGXXXXXXXXXXXXXXXXXXXGXXXXXXXXXXXXXXXXXXXGXXXXXXXXXXXXXXXXXXXGXXXXXXXXXXXXXXXXXXXGXXXXXXXXXXXXXXXXXXXGXXXXXXXXXXXXXXXXXXXGXXXXXXXXXXXXXXXXXXXGXXXXXXXXXXXXXXXXXXX,0,300,0
13629,14,1,13,83,203,0,0,215,104,111,GXXXXXXXXXXXXXXXXXXXGXXXXXXXXXXXXXXXXXXXGAXXXXXXXXXXXXXXXXXXGXXXXXXXXXXXXXXXXXXXGXXXXXXXXXXXXXXXXXXXGXXXXXXXXXXXXXXXXXXXGXXXXXXXXXXXXXXXXXXXGXXXXXXXXXXXXXXXXXXXGXXXXXXXXXXXXXXXXXXXGXXXXXXXXXXXXXXXXXXXGXXXXXXXXXXXXXXXXXXXGXXXXXXXXXXXXXXXXXXXGXXXXXXXXXXXXXXXXXXX,0,300,0

13650,14,1,13,82,204,0,0,216,107,109,GXXXXXXXXXXXXXXXXXXXGXXXXXXXXXXXXXXXXXXXGAXXXXXXXXXXXXXXXXXXGXXXXXXXXXXXXXXXXXXXGXXXXXXXXXXXXXXXXXXXGXXXXXXXXXXXXXXXXXXXGXXXXXXXXXXXXXXXXXXXGXXXXXXXXXXXXXXXXXXXGXXXXXXXXXXXXXXXXXXXGXXXXXXXXXXXXXXXXXXXGXXXXXXXXXXXXXXXXXXXGXXXXXXXXXXXXXXXXXXXGXXXXXXXXXXXXXXXXXXX,0,300,0
13671,14,1,13,83,203,0,0,216,104,112,GXXXXXXXXXXXXXXXXXXXGXXXXXXXXXXXXXXXXXXXGAXXXXXXXXXXXXXXXXXXGXXXXXXXXXXXXXXXXXXXGXXXXXXXXXXXXXXXXXXXGXXXXXXXXXXXXXXXXXXXGXXXXXXXXXXXXXXXXXXXGXXXXXXXXXXXXXXXXXXXGXXXXXXXXXXXXXXXXXXXGXXXXXXXXXXXXXXXXXXXGXXXXXXXXXXXXXXXXXXXGXXXXXXXXXXXXXXXXXXXGXXXXXXXXXXXXXXXXXXX,0,300,0
13692,14,1,13,86,200,0,0,213,106,107,GXXXXXXXXXXXXXXXXXXXGXXXXXXXXXXXXXXXXXXXGAXXXXXXXXXXXXXXXXXXGXXXXXXXXXXXXXXXXXXXGXXXXXXXXXXXXXXXXXXXGXXXXXXXXXXXXXXXXXXXGXXXXXXXXXXXXXXXXXXXGXXXXXXXXXXXXXXXXXXXGXXXXXXXXXXXXXXXXXXXGXXXXXXXXXXXXXXXXXXXGXXXXXXXXXXXXXXXXXXXGXXXXXXXXXXXXXXXXXXXGXXXXXXXXXXXXXXXXXXX,0,300,0
13713,14,1,13,89,197,0,0,210,100,110,GXXXXXXXXXXXXXXXXXXXGXXXXXXXXXXXXXXXXXXXGAXXXXXXXXXXXXXXXXXXGXXXXXXXXXXXXXXXXXXXGXXXXXXXXXXXXXXXXXXXGXXXXXXXXXXXXXXXXXXXGXXXXXXXXXXXXXXXXXXXGXXXXXXXXXXXXXXXXXXXGXXXXXXXXXXXXXXXXXXXGXXXXXXXXXXXXXXXXXXXGXXXXXXXXXXXXXXXXXXXGXXXXXXXXXXXXXXXXXXXGXXXXXXXXXXXXXXXXXXX,0,300,0
13734,13,0,13,84,203,0,0,216,101,115,GXXXXXXXXXXXXXXXXXXXGXXXXXXXXXXXXXXXXXXXGXXXXXXXXXXXXXXXXXXXGXXXXXXXXXXXXXXXXXXXGXXXXXXXXXXXXXXXXXXXGXXXXXXXXXXXXXXXXXXXGXXXXXXXXXXXXXXXXXXXGXXXXXXXXXXXXXXXXXXXGXXXXXXXXXXXXXXXXXXXGXXXXXXXXXXXXXXXXXXXGXXXXXXXXXXXXXXXXXXXGXXXXXXXXXXXXXXXXXXXGXXXXXXXXXXXXXXXXXXX,0,300,0

13755,13,0,13,83,204,0,0,215,100,115,GXXXXXXXXXXXXXXXXXXXGXXXXXXXXXXXXXXXXXXXGXXXXXXXXXXXXXXXXXXXGXXXXXXXXXXXXXXXXXXXGXXXXXXXXXXXXXXXXXXXGXXXXXXXXXXXXXXXXXXXGXXXXXXXXXXXXXXXXXXXGXXXXXXXXXXXXXXXXXXXGXXXXXXXXXXXXXXXXXXXGXXXXXXXXXXXXXXXXXXXGXXXXXXXXXXXXXXXXXXXGXXXXXXXXXXXXXXXXXXXGXXXXXXXXXXXXXXXXXXX,0,300,0
13776,13,0,13,77,210,0,0,223,100,123,GXXXXXXXXXXXXXXXXXXXGXXXXXXXXXXXXXXXXXXXGXXXXXXXXXXXXXXXXXXXGXXXXXXXXXXXXXXXXXXXGXXXXXXXXXXXXXXXXXXXGXXXXXXXXXXXXXXXXXXXGXXXXXXXXXXXXXXXXXXXGXXXXXXXXXXXXXXXXXXXGXXXXXXXXXXXXXXXXXXXGXXXXXXXXXXXXXXXXXXXGXXXXXXXXXXXXXXXXXXXGXXXXXXXXXXXXXXXXXXXGXXXXXXXXXXXXXXXXXXX,0,300,0
13797,13,0,13,70,217,0,0,230,99,131,GXXXXXXXXXXXXXXXXXXXGXXXXXXXXXXXXXXXXXXXGXXXXXXXXXXXXXXXXXXXGXXXXXXXXXXXXXXXXXXXGXXXXXXXXXXXXXXXXXXXGXXXXXXXXXXXXXXXXXXXGXXXXXXXXXXXXXXXXXXXGXXXXXXXXXXXXXXXXXXXGXXXXXXXXXXXXXXXXXXXGXXXXXXXXXXXXXXXXXXXGXXXXXXXXXXXXXXXXXXXGXXXXXXXXXXXXXXXXXXXGXXXXXXXXXXXXXXXXXXX,0,300,0
13818,13,0,13,64,223,0,0,237,105,132,GXXXXXXXXXXXXXXXXXXXGXXXXXXXXXXXXXXXXXXXGXXXXXXXXXXXXXXXXXXXGXXXXXXXXXXXXXXXXXXXGXXXXXXXXXXXXXXXXXXXGXXXXXXXXXXXXXXXXXXXGXXXXXXXXXXXXXXXXXXXGXXXXXXXXXXXXXXXXXXXGXXXXXXXXXXXXXXXXXXXGXXXXXXXXXXXXXXXXXXXGXXXXXXXXXXXXXXXXXXXGXXXXXXXXXXXXXXXXXXXGXXXXXXXXXXXXXXXXXXX,0,300,0
13839,13,0,13,69,218,0,0,231,103,128,GXXXXXXXXXXXXXXXXXXXGXXXXXXXXXXXXXXXXXXXGXXXXXXXXXXXXXXXXXXXGXXXXXXXXXXXXXXXXXXXGXXXXXXXXXXXXXXXXXXXGXXXXXXXXXXXXXXXXXXXGXXXXXXXXXXXXXXXXXXXGXXXXXXXXXXXXXXXXXXXGXXXXXXXXXXXXXXXXXXXGXXXXXXXXXXXXXXXXXXXGXXXXXXXXXXXXXXXXXXXGXXXXXXXXXXXXXXXXXXXGXXXXXXXXXXXXXXXXXXX,0,300,0

13860,13,0,13,70,217,0,0,231,102,129,GXXXXXXXXXXXXXXXXXXXGXXXXXXXXXXXXXXXXXXXGXXXXXXXXXXXXXXXXXXXGXXXXXXXXXXXXXXXXXXXGXXXXXXXXXXXXXXXXXXXGXXXXXXXXXXXXXXXXXXXGXXXXXXXXXXXXXXXXXXXGXXXXXXXXXXXXXXXXXXXGXXXXXXXXXXXXXXXXXXXGXXXXXXXXXXXXXXXXXXXGXXXXXXXXXXXXXXXXXXXGXXXXXXXXXXXXXXXXXXXGXXXXXXXXXXXXXXXXXXX,0,300,0
13881,13,0,13,65,222,0,0,237,107,130,GXXXXXXXXXXXXXXXXXXXGXXXXXXXXXXXXXXXXXXXGXXXXXXXXXXXXXXXXXXXGXXXXXXXXXXXXXXXXXXXGXXXXXXXXXXXXXXXXXXXGXXXXXXXXXXXXXXXXXXXGXXXXXXXXXXXXXXXXXXXGXXXXXXXXXXXXXXXXXXXGXXXXXXXXXXXXXXXXXXXGXXXXXXXXXXXXXXXXXXXGXXXXXXXXXXXXXXXXXXXGXXXXXXXXXXXXXXXXXXXGXXXXXXXXXXXXXXXXXXX,0,300,0
13902,13,0,13,74,213,0,0,228,99,129,GXXXXXXXXXXXXXXXXXXXGXXXXXXXXXXXXXXXXXXXGXXXXXXXXXXXXXXXXXXXGXXXXXXXXXXXXXXXXXXXGXXXXXXXXXXXXXXXXXXXGXXXXXXXXXXXXXXXXXXXGXXXXXXXXXXXXXXXXXXXGXXXXXXXXXXXXXXXXXXXGXXXXXXXXXXXXXXXXXXXGXXXXXXXXXXXXXXXXXXXGXXXXXXXXXXXXXXXXXXXGXXXXXXXXXXXXXXXXXXXGXXXXXXXXXXXXXXXXXXX,0,300,0
13923,13,0,13,73,214,0,0,229,102,127,GXXXXXXXXXXXXXXXXXXXGXXXXXXXXXXXXXXXXXXXGXXXXXXXXXXXXXXXXXXXGXXXXXXXXXXXXXXXXXXXGXXXXXXXXXXXXXXXXXXXGXXXXXXXXXXXXXXXXXXXGXXXXXXXXXXXXXXXXXXXGXXXXXXXXXXXXXXXXXXXGXXXXXXXXXXXXXXXXXXXGXXXXXXXXXXXXXXXXXXXGXXXXXXXXXXXXXXXXXXXGXXXXXXXXXXXXXXXXXXXGXXXXXXXXXXXXXXXXXXX,0,300,0
13944,13,0,13,68,219,0,0,234,107,127,GXXXXXXXXXXXXXXXXXXXGXXXXXXXXXXXXXXXXXXXGXXXXXXXXXXXXXXXXXXXGXXXXXXXXXXXXXXXXXXXGXXXXXXXXXXXXXXXXXXXGXXXXXXXXXXXXXXXXXXXGXXXXXXXXXXXXXXXXXXXGXXXXXXXXXXXXXXXXXXXGXXXXXXXXXXXXXXXXXXXGXXXXXXXXXXXXXXXXXXXGXXXXXXXXXXXXXXXXXXXGXXXXXXXXXXXXXXXXXXXGXXXXXXXXXXXXXXXXXXX,0,300,0

13965,13,0,13,73,214,0,0,230,102,128,GXXXXXXXXXXXXXXXXXXXGXXXXXXXXXXXXXXXXXXXGXXXXXXXXXXXXXXXXXXXGXXXXXXXXXXXXXXXXXXXGXXXXXXXXXXXXXXXXXXXGXXXXXXXXXXXXXXXXXXXGXXXXXXXXXXXXXXXXXXXGXXXXXXXXXXXXXXXXXXXGXXXXXXXXXXXXXXXXXXXGXXXXXXXXXXXXXXXXXXXGXXXXXXXXXXXXXXXXXXXGXXXXXXXXXXXXXXXXXXXGXXXXXXXXXXXXXXXXXXX,0,300,0
13986,13,0,13,74,213,0,0,229,108,121,GXXXXXXXXXXXXXXXXXXXGXXXXXXXXXXXXXXXXXXXGXXXXXXXXXXXXXXXXXXXGXXXXXXXXXXXXXXXXXXXGXXXXXXXXXXXXXXXXXXXGXXXXXXXXXXXXXXXXXXXGXXXXXXXXXXXXXXXXXXXGXXXXXXXXXXXXXXXXXXXGXXXXXXXXXXXXXXXXXXXGXXXXXXXXXXXXXXXXXXXGXXXXXXXXXXXXXXXXXXXGXXXXXXXXXXXXXXXXXXXGXXXXXXXXXXXXXXXXXXX,0,300,0
14007,13,0,13,74,213,0,0,228,107,121,GXXXXXXXXXXXXXXXXXXXGXXXXXXXXXXXXXXXXXXXGXXXXXXXXXXXXXXXXXXXGXXXXXXXXXXXXXXXXXXXGXXXXXXXXXXXXXXXXXXXGXXXXXXXXXXXXXXXXXXXGXXXXXXXXXXXXXXXXXXXGXXXXXXXXXXXXXXXXXXXGXXXXXXXXXXXXXXXXXXXGXXXXXXXXXXXXXXXXXXXGXXXXXXXXXXXXXXXXXXXGXXXXXXXXXXXXXXXXXXXGXXXXXXXXXXXXXXXXXXX,0,300,0
14028,13,0,13,70,217,0,0,233,105,128,GXXXXXXXXXXXXXXXXXXXGXXXXXXXXXXXXXXXXXXXGXXXXXXXXXXXXXXXXXXXGXXXXXXXXXXXXXXXXXXXGXXXXXXXXXXXXXXXXXXXGXXXXXXXXXXXXXXXXXXXGXXXXXXXXXXXXXXXXXXXGXXXXXXXXXXXXXXXXXXXGXXXXXXXXXXXXXXXXXXXGXXXXXXXXXXXXXXXXXXXGXXXXXXXXXXXXXXXXXXXGXXXXXXXXXXXXXXXXXXXGXXXXXXXXXXXXXXXXXXX,0,300,0
14049,13,0,13,73,214,0,0,231,102,129,GXXXXXXXXXXXXXXXXXXXGXXXXXXXXXXXXXXXXXXXGXXXXXXXXXXXXXXXXXXXGXXXXXXXXXXXXXXXXXXXGXXXXXXXXXXXXXXXXXXXGXXXXXXXXXXXXXXXXXXXGXXXXXXXXXXXXXXXXXXXGXXXXXXXXXXXXXXXXXXXGXXXXXXXXXXXXXXXXXXXGXXXXXXXXXXXXXXXXXXXGXXXXXXXXXXXXXXXXXXXGXXXXXXXXXXXXXXXXXXXGXXXXXXXXXXXXXXXXXXX,0,300,0

14070,13,0,13,78,209,0,0,225,100,125,GXXXXXXXXXXXXXXXXXXXGXXXXXXXXXXXXXXXXXXXGXXXXXXXXXXXXXXXXXXXGXXXXXXXXXXXXXXXXXXXGXXXXXXXXXXXXXXXXXXXGXXXXXXXXXXXXXXXXXXXGXXXXXXXXXXXXXXXXXXXGXXXXXXXXXXXXXXXXXXXGXXXXXXXXXXXXXXXXXXXGXXXXXXXXXXXXXXXXXXXGXXXXXXXXXXXXXXXXXXXGXXXXXXXXXXXXXXXXXXXGXXXXXXXXXXXXXXXXXXX,0,300,0
14091,14,1,13,76,210,0,0,225,100,125,GXXXXXXXXXXXXXXXXXXXGXXXXXXXXXXXXXXXXXXXGXXXXXXXXXXXXXXXXXXXGXXXXXXXXXXXXXXXXXXXGXXXXXXXXXXXXXXXXXXXGAXXXXXXXXXXXXXXXXXXGXXXXXXXXXXXXXXXXXXXGXXXXXXXXXXXXXXXXXXXGXXXXXXXXXXXXXXXXXXXGXXXXXXXXXXXXXXXXXXXGXXXXXXXXXXXXXXXXXXXGXXXXXXXXXXXXXXXXXXXGXXXXXXXXXXXXXXXXXXX,0,300,0
14112,14,1,13,78,208,0,0,224,97,127,GXXXXXXXXXXXXXXXXXXXGXXXXXXXXXXXXXXXXXXXGXXXXXXXXXXXXXXXXXXXGXXXXXXXXXXXXXXXXXXXGXXXXXXXXXXXXXXXXXXXGAXXXXXXXXXXXXXXXXXXGXXXXXXXXXXXXXXXXXXXGXXXXXXXXXXXXXXXXXXXGXXXXXXXXXXXXXXXXXXXGXXXXXXXXXXXXXXXXXXXGXXXXXXXXXXXXXXXXXXXGXXXXXXXXXXXXXXXXXXXGXXXXXXXXXXXXXXXXXXX,0,300,0
14133,13,0,13,76,211,0,0,228,98,130,GXXXXXXXXXXXXXXXXXXXGXXXXXXXXXXXXXXXXXXXGXXXXXXXXXXXXXXXXXXXGXXXXXXXXXXXXXXXXXXXGXXXXXXXXXXXXXXXXXXXGXXXXXXXXXXXXXXXXXXXGXXXXXXXXXXXXXXXXXXXGXXXXXXXXXXXXXXXXXXXGXXXXXXXXXXXXXXXXXXXGXXXXXXXXXXXXXXXXXXXGXXXXXXXXXXXXXXXXXXXGXXXXXXXXXXXXXXXXXXXGXXXXXXXXXXXXXXXXXXX,0,300,0
14154,13,0,13,69,218,0,0,235,103,132,GXXXXXXXXXXXXXXXXXXXGXXXXXXXXXXXXXXXXXXXGXXXXXXXXXXXXXXXXXXXGXXXXXXXXXXXXXXXXXXXGXXXXXXXXXXXXXXXXXXXGXXXXXXXXXXXXXXXXXXXGXXXXXXXXXXXXXXXXXXXGXXXXXXXXXXXXXXXXXXXGXXXXXXXXXXXXXXXXXXXGXXXXXXXXXXXXXXXXXXXGXXXXXXXXXXXXXXXXXXXGXXXXXXXXXXXXXXXXXXXGXXXXXXXXXXXXXXXXXXX,0,300,0

14175,13,0,13,70,217,0,0,233,105,128,GXXXXXXXXXXXXXXXXXXXGXXXXXXXXXXXXXXXXXXXGXXXXXXXXXXXXXXXXXXXGXXXXXXXXXXXXXXXXXXXGXXXXXXXXXXXXXXXXXXXGXXXXXXXXXXXXXXXXXXXGXXXXXXXXXXXXXXXXXXXGXXXXXXXXXXXXXXXXXXXGXXXXXXXXXXXXXXXXXXXGXXXXXXXXXXXXXXXXXXXGXXXXXXXXXXXXXXXXXXXGXXXXXXXXXXXXXXXXXXXGXXXXXXXXXXXXXXXXXXX,0,300,0
14196,13,0,13,69,218,0,0,234,106,128,GXXXXXXXXXXXXXXXXXXXGXXXXXXXXXXXXXXXXXXXGXXXXXXXXXXXXXXXXXXXGXXXXXXXXXXXXXXXXXXXGXXXXXXXXXXXXXXXXXXXGXXXXXXXXXXXXXXXXXXXGXXXXXXXXXXXXXXXXXXXGXXXXXXXXXXXXXXXXXXXGXXXXXXXXXXXXXXXXXXXGXXXXXXXXXXXXXXXXXXXGXXXXXXXXXXXXXXXXXXXGXXXXXXXXXXXXXXXXXXXGXXXXXXXXXXXXXXXXXXX,0,300,0
14217,13,0,13,71,216,0,0,231,104,127,GXXXXXXXXXXXXXXXXXXXGXXXXXXXXXXXXXXXXXXXGXXXXXXXXXXXXXXXXXXXGXXXXXXXXXXXXXXXXXXXGXXXXXXXXXXXXXXXXXXXGXXXXXXXXXXXXXXXXXXXGXXXXXXXXXXXXXXXXXXXGXXXXXXXXXXXXXXXXXXXGXXXXXXXXXXXXXXXXXXXGXXXXXXXXXXXXXXXXXXXGXXXXXXXXXXXXXXXXXXXGXXXXXXXXXXXXXXXXXXXGXXXXXXXXXXXXXXXXXXX,0,300,0
14238,13,0,13,72,215,0,0,230,106,124,GXXXXXXXXXXXXXXXXXXXGXXXXXXXXXXXXXXXXXXXGXXXXXXXXXXXXXXXXXXXGXXXXXXXXXXXXXXXXXXXGXXXXXXXXXXXXXXXXXXXGXXXXXXXXXXXXXXXXXXXGXXXXXXXXXXXXXXXXXXXGXXXXXXXXXXXXXXXXXXXGXXXXXXXXXXXXXXXXXXXGXXXXXXXXXXXXXXXXXXXGXXXXXXXXXXXXXXXXXXXGXXXXXXXXXXXXXXXXXXXGXXXXXXXXXXXXXXXXXXX,0,300,0
14259,13,0,13,77,210,0,0,224,104,120,GXXXXXXXXXXXXXXXXXXXGXXXXXXXXXXXXXXXXXXXGXXXXXXXXXXXXXXXXXXXGXXXXXXXXXXXXXXXXXXXGXXXXXXXXXXXXXXXXXXXGXXXXXXXXXXXXXXXXXXXGXXXXXXXXXXXXXXXXXXXGXXXXXXXXXXXXXXXXXXXGXXXXXXXXXXXXXXXXXXXGXXXXXXXXXXXXXXXXXXXGXXXXXXXXXXXXXXXXXXXGXXXXXXXXXXXXXXXXXXXGXXXXXXXXXXXXXXXXXXX,0,300,0

14280,13,0,13,72,215,0,0,229,111,118,GXXXXXXXXXXXXXXXXXXXGXXXXXXXXXXXXXXXXXXXGXXXXXXXXXXXXXXXXXXXGXXXXXXXXXXXXXXXXXXXGXXXXXXXXXXXXXXXXXXXGXXXXXXXXXXXXXXXXXXXGXXXXXXXXXXXXXXXXXXXGXXXXXXXXXXXXXXXXXXXGXXXXXXXXXXXXXXXXXXXGXXXXXXXXXXXXXXXXXXXGXXXXXXXXXXXXXXXXXXXGXXXXXXXXXXXXXXXXXXXGXXXXXXXXXXXXXXXXXXX,0,300,0
14301,13,0,13,73,214,0,0,227,111,116,GXXXXXXXXXXXXXXXXXXXGXXXXXXXXXXXXXXXXXXXGXXXXXXXXXXXXXXXXXXXGXXXXXXXXXXXXXXXXXXXGXXXXXXXXXXXXXXXXXXXGXXXXXXXXXXXXXXXXXXXGXXXXXXXXXXXXXXXXXXXGXXXXXXXXXXXXXXXXXXXGXXXXXXXXXXXXXXXXXXXGXXXXXXXXXXXXXXXXXXXGXXXXXXXXXXXXXXXXXXXGXXXXXXXXXXXXXXXXXXXGXXXXXXXXXXXXXXXXXXX,0,300,0
14322,13,0,13,71,216,0,0,229,112,117,GXXXXXXXXXXXXXXXXXXXGXXXXXXXXXXXXXXXXXXXGXXXXXXXXXXXXXXXXXXXGXXXXXXXXXXXXXXXXXXXGXXXXXXXXXXXXXXXXXXXGXXXXXXXXXXXXXXXXXXXGXXXXXXXXXXXXXXXXXXXGXXXXXXXXXXXXXXXXXXXGXXXXXXXXXXXXXXXXXXXGXXXXXXXXXXXXXXXXXXXGXXXXXXXXXXXXXXXXXXXGXXXXXXXXXXXXXXXXXXXGXXXXXXXXXXXXXXXXXXX,0,300,0
14343,13,0,13,72,215,0,0,229,113,116,GXXXXXXXXXXXXXXXXXXXGXXXXXXXXXXXXXXXXXXXGXXXXXXXXXXXXXXXXXXXGXXXXXXXXXXXXXXXXXXXGXXXXXXXXXXXXXXXXXXXGXXXXXXXXXXXXXXXXXXXGXXXXXXXXXXXXXXXXXXXGXXXXXXXXXXXXXXXXXXXGXXXXXXXXXXXXXXXXXXXGXXXXXXXXXXXXXXXXXXXGXXXXXXXXXXXXXXXXXXXGXXXXXXXXXXXXXXXXXXXGXXXXXXXXXXXXXXXXXXX,0,300,0
14364,13,0,13,72,215,0,0,227,109,118,GXXXXXXXXXXXXXXXXXXXGXXXXXXXXXXXXXXXXXXXGXXXXXXXXXXXXXXXXXXXGXXXXXXXXXXXXXXXXXXXGXXXXXXXXXXXXXXXXXXXGXXXXXXXXXXXXXXXXXXXGXXXXXXXXXXXXXXXXXXXGXXXXXXXXXXXXXXXXXXXGXXXXXXXXXXXXXXXXXXXGXXXXXXXXXXXXXXXXXXXGXXXXXXXXXXXXXXXXXXXGXXXXXXXXXXXXXXXXXXXGXXXXXXXXXXXXXXXXXXX,0,300,0

14385,13,0,13,71,216,0,0,229,104,125,GXXXXXXXXXXXXXXXXXXXGXXXXXXXXXXXXXXXXXXXGXXXXXXXXXXXXXXXXXXXGXXXXXXXXXXXXXXXXXXXGXXXXXXXXXXXXXXXXXXXGXXXXXXXXXXXXXXXXXXXGXXXXXXXXXXXXXXXXXXXGXXXXXXXXXXXXXXXXXXXGXXXXXXXXXXXXXXXXXXXGXXXXXXXXXXXXXXXXXXXGXXXXXXXXXXXXXXXXXXXGXXXXXXXXXXXXXXXXXXXGXXXXXXXXXXXXXXXXXXX,0,300,0
14406,13,0,13,73,214,0,0,227,102,125,GXXXXXXXXXXXXXXXXXXXGXXXXXXXXXXXXXXXXXXXGXXXXXXXXXXXXXXXXXXXGXXXXXXXXXXXXXXXXXXXGXXXXXXXXXXXXXXXXXXXGXXXXXXXXXXXXXXXXXXXGXXXXXXXXXXXXXXXXXXXGXXXXXXXXXXXXXXXXXXXGXXXXXXXXXXXXXXXXXXXGXXXXXXXXXXXXXXXXXXXGXXXXXXXXXXXXXXXXXXXGXXXXXXXXXXXXXXXXXXXGXXXXXXXXXXXXXXXXXXX,0,300,0
14427,13,0,13,72,215,0,0,227,103,124,GXXXXXXXXXXXXXXXXXXXGXXXXXXXXXXXXXXXXXXXGXXXXXXXXXXXXXXXXXXXGXXXXXXXXXXXXXXXXXXXGXXXXXXXXXXXXXXXXXXXGXXXXXXXXXXXXXXXXXXXGXXXXXXXXXXXXXXXXXXXGXXXXXXXXXXXXXXXXXXXGXXXXXXXXXXXXXXXXXXXGXXXXXXXXXXXXXXXXXXXGXXXXXXXXXXXXXXXXXXXGXXXXXXXXXXXXXXXXXXXGXXXXXXXXXXXXXXXXXXX,0,300,0
14448,13,0,13,69,218,0,0,229,106,123,GXXXXXXXXXXXXXXXXXXXGXXXXXXXXXXXXXXXXXXXGXXXXXXXXXXXXXXXXXXXGXXXXXXXXXXXXXXXXXXXGXXXXXXXXXXXXXXXXXXXGXXXXXXXXXXXXXXXXXXXGXXXXXXXXXXXXXXXXXXXGXXXXXXXXXXXXXXXXXXXGXXXXXXXXXXXXXXXXXXXGXXXXXXXXXXXXXXXXXXXGXXXXXXXXXXXXXXXXXXXGXXXXXXXXXXXXXXXXXXXGXXXXXXXXXXXXXXXXXXX,0,300,0
14469,13,0,13,71,216,0,0,227,106,121,GXXXXXXXXXXXXXXXXXXXGXXXXXXXXXXXXXXXXXXXGXXXXXXXXXXXXXXXXXXXGXXXXXXXXXXXXXXXXXXXGXXXXXXXXXXXXXXXXXXXGXXXXXXXXXXXXXXXXXXXGXXXXXXXXXXXXXXXXXXXGXXXXXXXXXXXXXXXXXXXGXXXXXXXXXXXXXXXXXXXGXXXXXXXXXXXXXXXXXXXGXXXXXXXXXXXXXXXXXXXGXXXXXXXXXXXXXXXXXXXGXXXXXXXXXXXXXXXXXXX,0,300,0

14490,13,0,13,72,215,0,0,227,107,120,GXXXXXXXXXXXXXXXXXXXGXXXXXXXXXXXXXXXXXXXGXXXXXXXXXXXXXXXXXXXGXXXXXXXXXXXXXXXXXXXGXXXXXXXXXXXXXXXXXXXGXXXXXXXXXXXXXXXXXXXGXXXXXXXXXXXXXXXXXXXGXXXXXXXXXXXXXXXXXXXGXXXXXXXXXXXXXXXXXXXGXXXXXXXXXXXXXXXXXXXGXXXXXXXXXXXXXXXXXXXGXXXXXXXXXXXXXXXXXXXGXXXXXXXXXXXXXXXXXXX,0,300,0
14511,13,0,13,72,215,0,0,226,104,122,GXXXXXXXXXXXXXXXXXXXGXXXXXXXXXXXXXXXXXXXGXXXXXXXXXXXXXXXXXXXGXXXXXXXXXXXXXXXXXXXGXXXXXXXXXXXXXXXXXXXGXXXXXXXXXXXXXXXXXXXGXXXXXXXXXXXXXXXXXXXGXXXXXXXXXXXXXXXXXXXGXXXXXXXXXXXXXXXXXXXGXXXXXXXXXXXXXXXXXXXGXXXXXXXXXXXXXXXXXXXGXXXXXXXXXXXXXXXXXXXGXXXXXXXXXXXXXXXXXXX,0,300,0
14532,13,0,13,70,217,0,0,228,102,126,GXXXXXXXXXXXXXXXXXXXGXXXXXXXXXXXXXXXXXXXGXXXXXXXXXXXXXXXXXXXGXXXXXXXXXXXXXXXXXXXGXXXXXXXXXXXXXXXXXXXGXXXXXXXXXXXXXXXXXXXGXXXXXXXXXXXXXXXXXXXGXXXXXXXXXXXXXXXXXXXGXXXXXXXXXXXXXXXXXXXGXXXXXXXXXXXXXXXXXXXGXXXXXXXXXXXXXXXXXXXGXXXXXXXXXXXXXXXXXXXGXXXXXXXXXXXXXXXXXXX,0,300,0
14553,14,1,13,65,221,0,0,233,105,128,GXXXXXXXXXXXXXXXXXXXGAXXXXXXXXXXXXXXXXXXGXXXXXXXXXXXXXXXXXXXGXXXXXXXXXXXXXXXXXXXGXXXXXXXXXXXXXXXXXXXGXXXXXXXXXXXXXXXXXXXGXXXXXXXXXXXXXXXXXXXGXXXXXXXXXXXXXXXXXXXGXXXXXXXXXXXXXXXXXXXGXXXXXXXXXXXXXXXXXXXGXXXXXXXXXXXXXXXXXXXGXXXXXXXXXXXXXXXXXXXGXXXXXXXXXXXXXXXXXXX,0,300,0
14574,14,1,13,62,224,0,0,235,110,125,GXXXXXXXXXXXXXXXXXXXGAXXXXXXXXXXXXXXXXXXGXXXXXXXXXXXXXXXXXXXGXXXXXXXXXXXXXXXXXXXGXXXXXXXXXXXXXXXXXXXGXXXXXXXXXXXXXXXXXXXGXXXXXXXXXXXXXXXXXXXGXXXXXXXXXXXXXXXXXXXGXXXXXXXXXXXXXXXXXXXGXXXXXXXXXXXXXXXXXXXGXXXXXXXXXXXXXXXXXXXGXXXXXXXXXXXXXXXXXXXGXXXXXXXXXXXXXXXXXXX,0,300,0

14595,14,1,13,65,221,0,0,232,111,121,GXXXXXXXXXXXXXXXXXXXGAXXXXXXXXXXXXXXXXXXGXXXXXXXXXXXXXXXXXXXGXXXXXXXXXXXXXXXXXXXGXXXXXXXXXXXXXXXXXXXGXXXXXXXXXXXXXXXXXXXGXXXXXXXXXXXXXXXXXXXGXXXXXXXXXXXXXXXXXXXGXXXXXXXXXXXXXXXXXXXGXXXXXXXXXXXXXXXXXXXGXXXXXXXXXXXXXXXXXXXGXXXXXXXXXXXXXXXXXXXGXXXXXXXXXXXXXXXXXXX,0,300,0
14616,13,0,13,66,221,0,0,232,111,121,GXXXXXXXXXXXXXXXXXXXGXXXXXXXXXXXXXXXXXXXGXXXXXXXXXXXXXXXXXXXGXXXXXXXXXXXXXXXXXXXGXXXXXXXXXXXXXXXXXXXGXXXXXXXXXXXXXXXXXXXGXXXXXXXXXXXXXXXXXXXGXXXXXXXXXXXXXXXXXXXGXXXXXXXXXXXXXXXXXXXGXXXXXXXXXXXXXXXXXXXGXXXXXXXXXXXXXXXXXXXGXXXXXXXXXXXXXXXXXXXGXXXXXXXXXXXXXXXXXXX,0,300,0
14637,13,0,13,67,220,0,0,231,113,118,GXXXXXXXXXXXXXXXXXXXGXXXXXXXXXXXXXXXXXXXGXXXXXXXXXXXXXXXXXXXGXXXXXXXXXXXXXXXXXXXGXXXXXXXXXXXXXXXXXXXGXXXXXXXXXXXXXXXXXXXGXXXXXXXXXXXXXXXXXXXGXXXXXXXXXXXXXXXXXXXGXXXXXXXXXXXXXXXXXXXGXXXXXXXXXXXXXXXXXXXGXXXXXXXXXXXXXXXXXXXGXXXXXXXXXXXXXXXXXXXGXXXXXXXXXXXXXXXXXXX,0,300,0
14658,13,0,13,77,210,0,0,221,106,115,GXXXXXXXXXXXXXXXXXXXGXXXXXXXXXXXXXXXXXXXGXXXXXXXXXXXXXXXXXXXGXXXXXXXXXXXXXXXXXXXGXXXXXXXXXXXXXXXXXXXGXXXXXXXXXXXXXXXXXXXGXXXXXXXXXXXXXXXXXXXGXXXXXXXXXXXXXXXXXXXGXXXXXXXXXXXXXXXXXXXGXXXXXXXXXXXXXXXXXXXGXXXXXXXXXXXXXXXXXXXGXXXXXXXXXXXXXXXXXXXGXXXXXXXXXXXXXXXXXXX,0,300,0
14679,13,0,13,78,209,0,0,221,109,112,GXXXXXXXXXXXXXXXXXXXGXXXXXXXXXXXXXXXXXXXGXXXXXXXXXXXXXXXXXXXGXXXXXXXXXXXXXXXXXXXGXXXXXXXXXXXXXXXXXXXGXXXXXXXXXXXXXXXXXXXGXXXXXXXXXXXXXXXXXXXGXXXXXXXXXXXXXXXXXXXGXXXXXXXXXXXXXXXXXXXGXXXXXXXXXXXXXXXXXXXGXXXXXXXXXXXXXXXXXXXGXXXXXXXXXXXXXXXXXXXGXXXXXXXXXXXXXXXXXXX,0,300,0

14700,13,0,13,77,210,0,0,222,111,111,GXXXXXXXXXXXXXXXXXXXGXXXXXXXXXXXXXXXXXXXGXXXXXXXXXXXXXXXXXXXGXXXXXXXXXXXXXXXXXXXGXXXXXXXXXXXXXXXXXXXGXXXXXXXXXXXXXXXXXXXGXXXXXXXXXXXXXXXXXXXGXXXXXXXXXXXXXXXXXXXGXXXXXXXXXXXXXXXXXXXGXXXXXXXXXXXXXXXXXXXGXXXXXXXXXXXXXXXXXXXGXXXXXXXXXXXXXXXXXXXGXXXXXXXXXXXXXXXXXXX,0,300,0
14721,13,0,13,79,208,0,0,220,107,113,GXXXXXXXXXXXXXXXXXXXGXXXXXXXXXXXXXXXXXXXGXXXXXXXXXXXXXXXXXXXGXXXXXXXXXXXXXXXXXXXGXXXXXXXXXXXXXXXXXXXGXXXXXXXXXXXXXXXXXXXGXXXXXXXXXXXXXXXXXXXGXXXXXXXXXXXXXXXXXXXGXXXXXXXXXXXXXXXXXXXGXXXXXXXXXXXXXXXXXXXGXXXXXXXXXXXXXXXXXXXGXXXXXXXXXXXXXXXXXXXGXXXXXXXXXXXXXXXXXXX,0,300,0
14742,13,0,13,82,205,0,0,217,106,111,GXXXXXXXXXXXXXXXXXXXGXXXXXXXXXXXXXXXXXXXGXXXXXXXXXXXXXXXXXXXGXXXXXXXXXXXXXXXXXXXGXXXXXXXXXXXXXXXXXXXGXXXXXXXXXXXXXXXXXXXGXXXXXXXXXXXXXXXXXXXGXXXXXXXXXXXXXXXXXXXGXXXXXXXXXXXXXXXXXXXGXXXXXXXXXXXXXXXXXXXGXXXXXXXXXXXXXXXXXXXGXXXXXXXXXXXXXXXXXXXGXXXXXXXXXXXXXXXXXXX,0,300,0
14763,13,0,13,83,204,0,0,215,105,110,GXXXXXXXXXXXXXXXXXXXGXXXXXXXXXXXXXXXXXXXGXXXXXXXXXXXXXXXXXXXGXXXXXXXXXXXXXXXXXXXGXXXXXXXXXXXXXXXXXXXGXXXXXXXXXXXXXXXXXXXGXXXXXXXXXXXXXXXXXXXGXXXXXXXXXXXXXXXXXXXGXXXXXXXXXXXXXXXXXXXGXXXXXXXXXXXXXXXXXXXGXXXXXXXXXXXXXXXXXXXGXXXXXXXXXXXXXXXXXXXGXXXXXXXXXXXXXXXXXXX,0,300,0
14784,13,0,13,80,207,0,0,219,102,117,GXXXXXXXXXXXXXXXXXXXGXXXXXXXXXXXXXXXXXXXGXXXXXXXXXXXXXXXXXXXGXXXXXXXXXXXXXXXXXXXGXXXXXXXXXXXXXXXXXXXGXXXXXXXXXXXXXXXXXXXGXXXXXXXXXXXXXXXXXXXGXXXXXXXXXXXXXXXXXXXGXXXXXXXXXXXXXXXXXXXGXXXXXXXXXXXXXXXXXXXGXXXXXXXXXXXXXXXXXXXGXXXXXXXXXXXXXXXXXXXGXXXXXXXXXXXXXXXXXXX,0,300,0

14805,13,0,13,78,209,0,0,221,107,114,GXXXXXXXXXXXXXXXXXXXGXXXXXXXXXXXXXXXXXXXGXXXXXXXXXXXXXXXXXXXGXXXXXXXXXXXXXXXXXXXGXXXXXXXXXXXXXXXXXXXGXXXXXXXXXXXXXXXXXXXGXXXXXXXXXXXXXXXXXXXGXXXXXXXXXXXXXXXXXXXGXXXXXXXXXXXXXXXXXXXGXXXXXXXXXXXXXXXXXXXGXXXXXXXXXXXXXXXXXXXGXXXXXXXXXXXXXXXXXXXGXXXXXXXXXXXXXXXXXXX,0,300,0
14826,13,0,13,80,207,0,0,220,110,110,GXXXXXXXXXXXXXXXXXXXGXXXXXXXXXXXXXXXXXXXGXXXXXXXXXXXXXXXXXXXGXXXXXXXXXXXXXXXXXXXGXXXXXXXXXXXXXXXXXXXGXXXXXXXXXXXXXXXXXXXGXXXXXXXXXXXXXXXXXXXGXXXXXXXXXXXXXXXXXXXGXXXXXXXXXXXXXXXXXXXGXXXXXXXXXXXXXXXXXXXGXXXXXXXXXXXXXXXXXXXGXXXXXXXXXXXXXXXXXXXGXXXXXXXXXXXXXXXXXXX,0,300,0
14847,13,0,13,79,208,0,0,221,105,116,GXXXXXXXXXXXXXXXXXXXGXXXXXXXXXXXXXXXXXXXGXXXXXXXXXXXXXXXXXXXGXXXXXXXXXXXXXXXXXXXGXXXXXXXXXXXXXXXXXXXGXXXXXXXXXXXXXXXXXXXGXXXXXXXXXXXXXXXXXXXGXXXXXXXXXXXXXXXXXXXGXXXXXXXXXXXXXXXXXXXGXXXXXXXXXXXXXXXXXXXGXXXXXXXXXXXXXXXXXXXGXXXXXXXXXXXXXXXXXXXGXXXXXXXXXXXXXXXXXXX,0,300,0
14868,13,0,13,75,212,0,0,225,109,116,GXXXXXXXXXXXXXXXXXXXGXXXXXXXXXXXXXXXXXXXGXXXXXXXXXXXXXXXXXXXGXXXXXXXXXXXXXXXXXXXGXXXXXXXXXXXXXXXXXXXGXXXXXXXXXXXXXXXXXXXGXXXXXXXXXXXXXXXXXXXGXXXXXXXXXXXXXXXXXXXGXXXXXXXXXXXXXXXXXXXGXXXXXXXXXXXXXXXXXXXGXXXXXXXXXXXXXXXXXXXGXXXXXXXXXXXXXXXXXXXGXXXXXXXXXXXXXXXXXXX,0,300,0
14889,13,0,13,74,213,0,0,226,104,122,GXXXXXXXXXXXXXXXXXXXGXXXXXXXXXXXXXXXXXXXGXXXXXXXXXXXXXXXXXXXGXXXXXXXXXXXXXXXXXXXGXXXXXXXXXXXXXXXXXXXGXXXXXXXXXXXXXXXXXXXGXXXXXXXXXXXXXXXXXXXGXXXXXXXXXXXXXXXXXXXGXXXXXXXXXXXXXXXXXXXGXXXXXXXXXXXXXXXXXXXGXXXXXXXXXXXXXXXXXXXGXXXXXXXXXXXXXXXXXXXGXXXXXXXXXXXXXXXXXXX,0,300,0

14910,13,0,13,78,209,0,0,221,105,116,GXXXXXXXXXXXXXXXXXXXGXXXXXXXXXXXXXXXXXXXGXXXXXXXXXXXXXXXXXXXGXXXXXXXXXXXXXXXXXXXGXXXXXXXXXXXXXXXXXXXGXXXXXXXXXXXXXXXXXXXGXXXXXXXXXXXXXXXXXXXGXXXXXXXXXXXXXXXXXXXGXXXXXXXXXXXXXXXXXXXGXXXXXXXXXXXXXXXXXXXGXXXXXXXXXXXXXXXXXXXGXXXXXXXXXXXXXXXXXXXGXXXXXXXXXXXXXXXXXXX,0,300,0
14931,13,0,13,75,212,0,0,224,103,121,GXXXXXXXXXXXXXXXXXXXGXXXXXXXXXXXXXXXXXXXGXXXXXXXXXXXXXXXXXXXGXXXXXXXXXXXXXXXXXXXGXXXXXXXXXXXXXXXXXXXGXXXXXXXXXXXXXXXXXXXGXXXXXXXXXXXXXXXXXXXGXXXXXXXXXXXXXXXXXXXGXXXXXXXXXXXXXXXXXXXGXXXXXXXXXXXXXXXXXXXGXXXXXXXXXXXXXXXXXXXGXXXXXXXXXXXXXXXXXXXGXXXXXXXXXXXXXXXXXXX,0,300,0
14952,13,0,13,70,217,0,0,230,108,122,GXXXXXXXXXXXXXXXXXXXGXXXXXXXXXXXXXXXXXXXGXXXXXXXXXXXXXXXXXXXGXXXXXXXXXXXXXXXXXXXGXXXXXXXXXXXXXXXXXXXGXXXXXXXXXXXXXXXXXXXGXXXXXXXXXXXXXXXXXXXGXXXXXXXXXXXXXXXXXXXGXXXXXXXXXXXXXXXXXXXGXXXXXXXXXXXXXXXXXXXGXXXXXXXXXXXXXXXXXXXGXXXXXXXXXXXXXXXXXXXGXXXXXXXXXXXXXXXXXXX,0,300,0
14973,13,0,13,69,218,0,0,231,106,125,GXXXXXXXXXXXXXXXXXXXGXXXXXXXXXXXXXXXXXXXGXXXXXXXXXXXXXXXXXXXGXXXXXXXXXXXXXXXXXXXGXXXXXXXXXXXXXXXXXXXGXXXXXXXXXXXXXXXXXXXGXXXXXXXXXXXXXXXXXXXGXXXXXXXXXXXXXXXXXXXGXXXXXXXXXXXXXXXXXXXGXXXXXXXXXXXXXXXXXXXGXXXXXXXXXXXXXXXXXXXGXXXXXXXXXXXXXXXXXXXGXXXXXXXXXXXXXXXXXXX,0,300,0
14994,13,0,13,66,221,0,0,235,104,131,GXXXXXXXXXXXXXXXXXXXGXXXXXXXXXXXXXXXXXXXGXXXXXXXXXXXXXXXXXXXGXXXXXXXXXXXXXXXXXXXGXXXXXXXXXXXXXXXXXXXGXXXXXXXXXXXXXXXXXXXGXXXXXXXXXXXXXXXXXXXGXXXXXXXXXXXXXXXXXXXGXXXXXXXXXXXXXXXXXXXGXXXXXXXXXXXXXXXXXXXGXXXXXXXXXXXXXXXXXXXGXXXXXXXXXXXXXXXXXXXGXXXXXXXXXXXXXXXXXXX,0,300,0

15015,13,0,13,66,221,0,0,235,108,127,GXXXXXXXXXXXXXXXXXXXGXXXXXXXXXXXXXXXXXXXGXXXXXXXXXXXXXXXXXXXGXXXXXXXXXXXXXXXXXXXGXXXXXXXXXXXXXXXXXXXGXXXXXXXXXXXXXXXXXXXGXXXXXXXXXXXXXXXXXXXGXXXXXXXXXXXXXXXXXXXGXXXXXXXXXXXXXXXXXXXGXXXXXXXXXXXXXXXXXXXGXXXXXXXXXXXXXXXXXXXGXXXXXXXXXXXXXXXXXXXGXXXXXXXXXXXXXXXXXXX,0,300,0
15036,14,1,13,64,222,0,0,236,108,128,GXXXXXXXXXXXXXXXXXXXGXXXXXXXXXXXXXXXXXXXGXXXXXXXXXXXXXXXXXXXGXXXXXXXXXXXXXXXXXXXGXXXXXXXXXXXXXXXXXXXGAXXXXXXXXXXXXXXXXXXGXXXXXXXXXXXXXXXXXXXGXXXXXXXXXXXXXXXXXXXGXXXXXXXXXXXXXXXXXXXGXXXXXXXXXXXXXXXXXXXGXXXXXXXXXXXXXXXXXXXGXXXXXXXXXXXXXXXXXXXGXXXXXXXXXXXXXXXXXXX,0,300,0
15057,14,1,13,66,220,0,0,234,108,126,GXXXXXXXXXXXXXXXXXXXGXXXXXXXXXXXXXXXXXXXGXXXXXXXXXXXXXXXXXXXGXXXXXXXXXXXXXXXXXXXGXXXXXXXXXXXXXXXXXXXGAXXXXXXXXXXXXXXXXXXGXXXXXXXXXXXXXXXXXXXGXXXXXXXXXXXXXXXXXXXGXXXXXXXXXXXXXXXXXXXGXXXXXXXXXXXXXXXXXXXGXXXXXXXXXXXXXXXXXXXGXXXXXXXXXXXXXXXXXXXGXXXXXXXXXXXXXXXXXXX,0,300,0
15078,14,1,13,66,220,0,0,234,109,125,GXXXXXXXXXXXXXXXXXXXGXXXXXXXXXXXXXXXXXXXGXXXXXXXXXXXXXXXXXXXGXXXXXXXXXXXXXXXXXXXGXXXXXXXXXXXXXXXXXXXGAXXXXXXXXXXXXXXXXXXGXXXXXXXXXXXXXXXXXXXGXXXXXXXXXXXXXXXXXXXGXXXXXXXXXXXXXXXXXXXGXXXXXXXXXXXXXXXXXXXGXXXXXXXXXXXXXXXXXXXGXXXXXXXXXXXXXXXXXXXGXXXXXXXXXXXXXXXXXXX,0,300,0
15099,14,1,13,63,223,0,0,236,109,127,GXXXXXXXXXXXXXXXXXXXGXXXXXXXXXXXXXXXXXXXGXXXXXXXXXXXXXXXXXXXGXXXXXXXXXXXXXXXXXXXGXXXXXXXXXXXXXXXXXXXGAXXXXXXXXXXXXXXXXXXGXXXXXXXXXXXXXXXXXXXGXXXXXXXXXXXXXXXXXXXGXXXXXXXXXXXXXXXXXXXGXXXXXXXXXXXXXXXXXXXGXXXXXXXXXXXXXXXXXXXGXXXXXXXXXXXXXXXXXXXGXXXXXXXXXXXXXXXXXXX,0,300,0

15120,14,1,13,64,222,0,0,233,108,125,GXXXXXXXXXXXXXXXXXXXGXXXXXXXXXXXXXXXXXXXGXXXXXXXXXXXXXXXXXXXGXXXXXXXXXXXXXXXXXXXGXXXXXXXXXXXXXXXXXXXGAXXXXXXXXXXXXXXXXXXGXXXXXXXXXXXXXXXXXXXGXXXXXXXXXXXXXXXXXXXGXXXXXXXXXXXXXXXXXXXGXXXXXXXXXXXXXXXXXXXGXXXXXXXXXXXXXXXXXXXGXXXXXXXXXXXXXXXXXXXGXXXXXXXXXXXXXXXXXXX,0,300,0
15141,14,1,13,64,222,0,0,235,111,124,GXXXXXXXXXXXXXXXXXXXGXXXXXXXXXXXXXXXXXXXGXXXXXXXXXXXXXXXXXXXGXXXXXXXXXXXXXXXXXXXGXXXXXXXXXXXXXXXXXXXGAXXXXXXXXXXXXXXXXXXGXXXXXXXXXXXXXXXXXXXGXXXXXXXXXXXXXXXXXXXGXXXXXXXXXXXXXXXXXXXGXXXXXXXXXXXXXXXXXXXGXXXXXXXXXXXXXXXXXXXGXXXXXXXXXXXXXXXXXXXGXXXXXXXXXXXXXXXXXXX,0,300,0
15162,13,0,13,68,219,0,0,231,109,122,GXXXXXXXXXXXXXXXXXXXGXXXXXXXXXXXXXXXXXXXGXXXXXXXXXXXXXXXXXXXGXXXXXXXXXXXXXXXXXXXGXXXXXXXXXXXXXXXXXXXGXXXXXXXXXXXXXXXXXXXGXXXXXXXXXXXXXXXXXXXGXXXXXXXXXXXXXXXXXXXGXXXXXXXXXXXXXXXXXXXGXXXXXXXXXXXXXXXXXXXGXXXXXXXXXXXXXXXXXXXGXXXXXXXXXXXXXXXXXXXGXXXXXXXXXXXXXXXXXXX,0,300,0
15183,13,0,13,71,216,0,0,229,107,122,GXXXXXXXXXXXXXXXXXXXGXXXXXXXXXXXXXXXXXXXGXXXXXXXXXXXXXXXXXXXGXXXXXXXXXXXXXXXXXXXGXXXXXXXXXXXXXXXXXXXGXXXXXXXXXXXXXXXXXXXGXXXXXXXXXXXXXXXXXXXGXXXXXXXXXXXXXXXXXXXGXXXXXXXXXXXXXXXXXXXGXXXXXXXXXXXXXXXXXXXGXXXXXXXXXXXXXXXXXXXGXXXXXXXXXXXXXXXXXXXGXXXXXXXXXXXXXXXXXXX,0,300,0
15204,13,0,13,69,218,0,0,231,105,126,GXXXXXXXXXXXXXXXXXXXGXXXXXXXXXXXXXXXXXXXGXXXXXXXXXXXXXXXXXXXGXXXXXXXXXXXXXXXXXXXGXXXXXXXXXXXXXXXXXXXGXXXXXXXXXXXXXXXXXXXGXXXXXXXXXXXXXXXXXXXGXXXXXXXXXXXXXXXXXXXGXXXXXXXXXXXXXXXXXXXGXXXXXXXXXXXXXXXXXXXGXXXXXXXXXXXXXXXXXXXGXXXXXXXXXXXXXXXXXXXGXXXXXXXXXXXXXXXXXXX,0,300,0

15225,13,0,13,65,222,0,0,235,105,130,GXXXXXXXXXXXXXXXXXXXGXXXXXXXXXXXXXXXXXXXGXXXXXXXXXXXXXXXXXXXGXXXXXXXXXXXXXXXXXXXGXXXXXXXXXXXXXXXXXXXGXXXXXXXXXXXXXXXXXXXGXXXXXXXXXXXXXXXXXXXGXXXXXXXXXXXXXXXXXXXGXXXXXXXXXXXXXXXXXXXGXXXXXXXXXXXXXXXXXXXGXXXXXXXXXXXXXXXXXXXGXXXXXXXXXXXXXXXXXXXGXXXXXXXXXXXXXXXXXXX,0,300,0
15246,13,0,13,59,228,0,0,238,106,132,GXXXXXXXXXXXXXXXXXXXGXXXXXXXXXXXXXXXXXXXGXXXXXXXXXXXXXXXXXXXGXXXXXXXXXXXXXXXXXXXGXXXXXXXXXXXXXXXXXXXGXXXXXXXXXXXXXXXXXXXGXXXXXXXXXXXXXXXXXXXGXXXXXXXXXXXXXXXXXXXGXXXXXXXXXXXXXXXXXXXGXXXXXXXXXXXXXXXXXXXGXXXXXXXXXXXXXXXXXXXGXXXXXXXXXXXXXXXXXXXGXXXXXXXXXXXXXXXXXXX,0,300,0
15267,13,0,13,59,228,0,0,240,106,134,GXXXXXXXXXXXXXXXXXXXGXXXXXXXXXXXXXXXXXXXGXXXXXXXXXXXXXXXXXXXGXXXXXXXXXXXXXXXXXXXGXXXXXXXXXXXXXXXXXXXGXXXXXXXXXXXXXXXXXXXGXXXXXXXXXXXXXXXXXXXGXXXXXXXXXXXXXXXXXXXGXXXXXXXXXXXXXXXXXXXGXXXXXXXXXXXXXXXXXXXGXXXXXXXXXXXXXXXXXXXGXXXXXXXXXXXXXXXXXXXGXXXXXXXXXXXXXXXXXXX,0,300,0
15288,13,0,13,60,227,0,0,239,107,132,GXXXXXXXXXXXXXXXXXXXGXXXXXXXXXXXXXXXXXXXGXXXXXXXXXXXXXXXXXXXGXXXXXXXXXXXXXXXXXXXGXXXXXXXXXXXXXXXXXXXGXXXXXXXXXXXXXXXXXXXGXXXXXXXXXXXXXXXXXXXGXXXXXXXXXXXXXXXXXXXGXXXXXXXXXXXXXXXXXXXGXXXXXXXXXXXXXXXXXXXGXXXXXXXXXXXXXXXXXXXGXXXXXXXXXXXXXXXXXXXGXXXXXXXXXXXXXXXXXXX,0,300,0
15309,13,0,13,59,228,0,0,239,106,133,GXXXXXXXXXXXXXXXXXXXGXXXXXXXXXXXXXXXXXXXGXXXXXXXXXXXXXXXXXXXGXXXXXXXXXXXXXXXXXXXGXXXXXXXXXXXXXXXXXXXGXXXXXXXXXXXXXXXXXXXGXXXXXXXXXXXXXXXXXXXGXXXXXXXXXXXXXXXXXXXGXXXXXXXXXXXXXXXXXXXGXXXXXXXXXXXXXXXXXXXGXXXXXXXXXXXXXXXXXXXGXXXXXXXXXXXXXXXXXXXGXXXXXXXXXXXXXXXXXXX,0,300,0

15330,13,0,13,59,228,0,0,240,112,128,GXXXXXXXXXXXXXXXXXXXGXXXXXXXXXXXXXXXXXXXGXXXXXXXXXXXXXXXXXXXGXXXXXXXXXXXXXXXXXXXGXXXXXXXXXXXXXXXXXXXGXXXXXXXXXXXXXXXXXXXGXXXXXXXXXXXXXXXXXXXGXXXXXXXXXXXXXXXXXXXGXXXXXXXXXXXXXXXXXXXGXXXXXXXXXXXXXXXXXXXGXXXXXXXXXXXXXXXXXXXGXXXXXXXXXXXXXXXXXXXGXXXXXXXXXXXXXXXXXXX,0,300,0
15351,13,0,13,61,226,0,0,237,111,126,GXXXXXXXXXXXXXXXXXXXGXXXXXXXXXXXXXXXXXXXGXXXXXXXXXXXXXXXXXXXGXXXXXXXXXXXXXXXXXXXGXXXXXXXXXXXXXXXXXXXGXXXXXXXXXXXXXXXXXXXGXXXXXXXXXXXXXXXXXXXGXXXXXXXXXXXXXXXXXXXGXXXXXXXXXXXXXXXXXXXGXXXXXXXXXXXXXXXXXXXGXXXXXXXXXXXXXXXXXXXGXXXXXXXXXXXXXXXXXXXGXXXXXXXXXXXXXXXXXXX,0,300,0
15372,13,0,13,61,226,0,0,237,114,123,GXXXXXXXXXXXXXXXXXXXGXXXXXXXXXXXXXXXXXXXGXXXXXXXXXXXXXXXXXXXGXXXXXXXXXXXXXXXXXXXGXXXXXXXXXXXXXXXXXXXGXXXXXXXXXXXXXXXXXXXGXXXXXXXXXXXXXXXXXXXGXXXXXXXXXXXXXXXXXXXGXXXXXXXXXXXXXXXXXXXGXXXXXXXXXXXXXXXXXXXGXXXXXXXXXXXXXXXXXXXGXXXXXXXXXXXXXXXXXXXGXXXXXXXXXXXXXXXXXXX,0,300,0
15393,13,0,13,59,228,0,0,239,116,123,GXXXXXXXXXXXXXXXXXXXGXXXXXXXXXXXXXXXXXXXGXXXXXXXXXXXXXXXXXXXGXXXXXXXXXXXXXXXXXXXGXXXXXXXXXXXXXXXXXXXGXXXXXXXXXXXXXXXXXXXGXXXXXXXXXXXXXXXXXXXGXXXXXXXXXXXXXXXXXXXGXXXXXXXXXXXXXXXXXXXGXXXXXXXXXXXXXXXXXXXGXXXXXXXXXXXXXXXXXXXGXXXXXXXXXXXXXXXXXXXGXXXXXXXXXXXXXXXXXXX,0,300,0
15414,13,0,13,63,224,0,0,235,112,123,GXXXXXXXXXXXXXXXXXXXGXXXXXXXXXXXXXXXXXXXGXXXXXXXXXXXXXXXXXXXGXXXXXXXXXXXXXXXXXXXGXXXXXXXXXXXXXXXXXXXGXXXXXXXXXXXXXXXXXXXGXXXXXXXXXXXXXXXXXXXGXXXXXXXXXXXXXXXXXXXGXXXXXXXXXXXXXXXXXXXGXXXXXXXXXXXXXXXXXXXGXXXXXXXXXXXXXXXXXXXGXXXXXXXXXXXXXXXXXXXGXXXXXXXXXXXXXXXXXXX,0,300,0

15435,13,0,13,66,221,0,0,233,109,124,GXXXXXXXXXXXXXXXXXXXGXXXXXXXXXXXXXXXXXXXGXXXXXXXXXXXXXXXXXXXGXXXXXXXXXXXXXXXXXXXGXXXXXXXXXXXXXXXXXXXGXXXXXXXXXXXXXXXXXXXGXXXXXXXXXXXXXXXXXXXGXXXXXXXXXXXXXXXXXXXGXXXXXXXXXXXXXXXXXXXGXXXXXXXXXXXXXXXXXXXGXXXXXXXXXXXXXXXXXXXGXXXXXXXXXXXXXXXXXXXGXXXXXXXXXXXXXXXXXXX,0,300,0
15456,14,1,13,64,222,0,0,233,112,121,GXXXXXXXXXXXXXXXXXXXGXXXXXXXXXXXXXXXXXXXGAXXXXXXXXXXXXXXXXXXGXXXXXXXXXXXXXXXXXXXGXXXXXXXXXXXXXXXXXXXGXXXXXXXXXXXXXXXXXXXGXXXXXXXXXXXXXXXXXXXGXXXXXXXXXXXXXXXXXXXGXXXXXXXXXXXXXXXXXXXGXXXXXXXXXXXXXXXXXXXGXXXXXXXXXXXXXXXXXXXGXXXXXXXXXXXXXXXXXXXGXXXXXXXXXXXXXXXXXXX,0,300,0
15477,14,1,13,65,221,0,0,232,116,116,GXXXXXXXXXXXXXXXXXXXGXXXXXXXXXXXXXXXXXXXGAXXXXXXXXXXXXXXXXXXGXXXXXXXXXXXXXXXXXXXGXXXXXXXXXXXXXXXXXXXGXXXXXXXXXXXXXXXXXXXGXXXXXXXXXXXXXXXXXXXGXXXXXXXXXXXXXXXXXXXGXXXXXXXXXXXXXXXXXXXGXXXXXXXXXXXXXXXXXXXGXXXXXXXXXXXXXXXXXXXGXXXXXXXXXXXXXXXXXXXGXXXXXXXXXXXXXXXXXXX,0,300,0
15498,15,2,13,67,218,0,0,230,110,120,GXXXXXXXXXXXXXXXXXXXGXXXXXXXXXXXXXXXXXXXGAXXXXXXXXXXXXXXXXXXGXXXXXXXXXXXXXXXXXXXGXXXXXXXXXXXXXXXXXXXGXXXXXXXXXXXXXXXXXXXGXXXXXXXXXXXXXXXXXXXGXXXXXXXXXXXXXXXXXXXGXXXXXXXXXXXXXXXXXXXGAXXXXXXXXXXXXXXXXXXGXXXXXXXXXXXXXXXXXXXGXXXXXXXXXXXXXXXXXXXGXXXXXXXXXXXXXXXXXXX,0,300,0
15519,15,1,14,65,220,0,0,232,112,120,GXXXXXXXXXXXXXXXXXXXGXXXXXXXXXXXXXXXXXXXGAXXXXXXXXXXXXXXXXXXGXXXXXXXXXXXXXXXXXXXGXXXXXXXXXXXXXXXXXXXGXXXXXXXXXXXXXXXXXXXGXXXXXXXXXXXXXXXXXXXGXXXXXXXXXXXXXXXXXXXGXXXXXXXXXXXXXXXXXXXGOXXXXXXXXXXXXXXXXXXGXXXXXXXXXXXXXXXXXXXGXXXXXXXXXXXXXXXXXXXGXXXXXXXXXXXXXXXXXXX,0,300,0

15540,15,1,14,67,218,0,0,230,112,118,GXXXXXXXXXXXXXXXXXXXGXXXXXXXXXXXXXXXXXXXGAXXXXXXXXXXXXXXXXXXGXXXXXXXXXXXXXXXXXXXGXXXXXXXXXXXXXXXXXXXGXXXXXXXXXXXXXXXXXXXGXXXXXXXXXXXXXXXXXXXGXXXXXXXXXXXXXXXXXXXGXXXXXXXXXXXXXXXXXXXGOXXXXXXXXXXXXXXXXXXGXXXXXXXXXXXXXXXXXXXGXXXXXXXXXXXXXXXXXXXGXXXXXXXXXXXXXXXXXXX,0,300,0
15561,14,1,13,67,219,0,0,232,116,116,GXXXXXXXXXXXXXXXXXXXGXXXXXXXXXXXXXXXXXXXGAXXXXXXXXXXXXXXXXXXGXXXXXXXXXXXXXXXXXXXGXXXXXXXXXXXXXXXXXXXGXXXXXXXXXXXXXXXXXXXGXXXXXXXXXXXXXXXXXXXGXXXXXXXXXXXXXXXXXXXGXXXXXXXXXXXXXXXXXXXGXXXXXXXXXXXXXXXXXXXGXXXXXXXXXXXXXXXXXXXGXXXXXXXXXXXXXXXXXXXGXXXXXXXXXXXXXXXXXXX,0,300,0
15582,14,1,13,64,222,0,0,235,118,117,GXXXXXXXXXXXXXXXXXXXGXXXXXXXXXXXXXXXXXXXGAXXXXXXXXXXXXXXXXXXGXXXXXXXXXXXXXXXXXXXGXXXXXXXXXXXXXXXXXXXGXXXXXXXXXXXXXXXXXXXGXXXXXXXXXXXXXXXXXXXGXXXXXXXXXXXXXXXXXXXGXXXXXXXXXXXXXXXXXXXGXXXXXXXXXXXXXXXXXXXGXXXXXXXXXXXXXXXXXXXGXXXXXXXXXXXXXXXXXXXGXXXXXXXXXXXXXXXXXXX,0,300,0
15603,14,1,13,65,221,0,0,233,119,114,GXXXXXXXXXXXXXXXXXXXGXXXXXXXXXXXXXXXXXXXGAXXXXXXXXXXXXXXXXXXGXXXXXXXXXXXXXXXXXXXGXXXXXXXXXXXXXXXXXXXGXXXXXXXXXXXXXXXXXXXGXXXXXXXXXXXXXXXXXXXGXXXXXXXXXXXXXXXXXXXGXXXXXXXXXXXXXXXXXXXGXXXXXXXXXXXXXXXXXXXGXXXXXXXXXXXXXXXXXXXGXXXXXXXXXXXXXXXXXXXGXXXXXXXXXXXXXXXXXXX,0,300,0
15624,14,0,14,66,220,0,0,233,118,115,GXXXXXXXXXXXXXXXXXXXGXXXXXXXXXXXXXXXXXXXGOXXXXXXXXXXXXXXXXXXGXXXXXXXXXXXXXXXXXXXGXXXXXXXXXXXXXXXXXXXGXXXXXXXXXXXXXXXXXXXGXXXXXXXXXXXXXXXXXXXGXXXXXXXXXXXXXXXXXXXGXXXXXXXXXXXXXXXXXXXGXXXXXXXXXXXXXXXXXXXGXXXXXXXXXXXXXXXXXXXGXXXXXXXXXXXXXXXXXXXGXXXXXXXXXXXXXXXXXXX,0,300,0

15645,14,0,14,70,216,0,0,228,116,112,GXXXXXXXXXXXXXXXXXXXGXXXXXXXXXXXXXXXXXXXGOXXXXXXXXXXXXXXXXXXGXXXXXXXXXXXXXXXXXXXGXXXXXXXXXXXXXXXXXXXGXXXXXXXXXXXXXXXXXXXGXXXXXXXXXXXXXXXXXXXGXXXXXXXXXXXXXXXXXXXGXXXXXXXXXXXXXXXXXXXGXXXXXXXXXXXXXXXXXXXGXXXXXXXXXXXXXXXXXXXGXXXXXXXXXXXXXXXXXXXGXXXXXXXXXXXXXXXXXXX,0,300,0
15666,13,0,13,65,222,0,0,233,119,114,GXXXXXXXXXXXXXXXXXXXGXXXXXXXXXXXXXXXXXXXGXXXXXXXXXXXXXXXXXXXGXXXXXXXXXXXXXXXXXXXGXXXXXXXXXXXXXXXXXXXGXXXXXXXXXXXXXXXXXXXGXXXXXXXXXXXXXXXXXXXGXXXXXXXXXXXXXXXXXXXGXXXXXXXXXXXXXXXXXXXGXXXXXXXXXXXXXXXXXXXGXXXXXXXXXXXXXXXXXXXGXXXXXXXXXXXXXXXXXXXGXXXXXXXXXXXXXXXXXXX,0,300,0
15687,14,1,13,64,222,0,0,234,115,119,GXXXXXXXXXXXXXXXXXXXGXXXXXXXXXXXXXXXXXXXGAXXXXXXXXXXXXXXXXXXGXXXXXXXXXXXXXXXXXXXGXXXXXXXXXXXXXXXXXXXGXXXXXXXXXXXXXXXXXXXGXXXXXXXXXXXXXXXXXXXGXXXXXXXXXXXXXXXXXXXGXXXXXXXXXXXXXXXXXXXGXXXXXXXXXXXXXXXXXXXGXXXXXXXXXXXXXXXXXXXGXXXXXXXXXXXXXXXXXXXGXXXXXXXXXXXXXXXXXXX,0,300,0
15708,14,1,13,64,222,0,0,234,111,123,GXXXXXXXXXXXXXXXXXXXGXXXXXXXXXXXXXXXXXXXGAXXXXXXXXXXXXXXXXXXGXXXXXXXXXXXXXXXXXXXGXXXXXXXXXXXXXXXXXXXGXXXXXXXXXXXXXXXXXXXGXXXXXXXXXXXXXXXXXXXGXXXXXXXXXXXXXXXXXXXGXXXXXXXXXXXXXXXXXXXGXXXXXXXXXXXXXXXXXXXGXXXXXXXXXXXXXXXXXXXGXXXXXXXXXXXXXXXXXXXGXXXXXXXXXXXXXXXXXXX,0,300,0
15729,14,1,13,62,224,0,0,236,114,122,GXXXXXXXXXXXXXXXXXXXGXXXXXXXXXXXXXXXXXXXGAXXXXXXXXXXXXXXXXXXGXXXXXXXXXXXXXXXXXXXGXXXXXXXXXXXXXXXXXXXGXXXXXXXXXXXXXXXXXXXGXXXXXXXXXXXXXXXXXXXGXXXXXXXXXXXXXXXXXXXGXXXXXXXXXXXXXXXXXXXGXXXXXXXXXXXXXXXXXXXGXXXXXXXXXXXXXXXXXXXGXXXXXXXXXXXXXXXXXXXGXXXXXXXXXXXXXXXXXXX,0,300,0

15750,14,1,13,63,223,0,0,234,113,121,GXXXXXXXXXXXXXXXXXXXGXXXXXXXXXXXXXXXXXXXGAXXXXXXXXXXXXXXXXXXGXXXXXXXXXXXXXXXXXXXGXXXXXXXXXXXXXXXXXXXGXXXXXXXXXXXXXXXXXXXGXXXXXXXXXXXXXXXXXXXGXXXXXXXXXXXXXXXXXXXGXXXXXXXXXXXXXXXXXXXGXXXXXXXXXXXXXXXXXXXGXXXXXXXXXXXXXXXXXXXGXXXXXXXXXXXXXXXXXXXGXXXXXXXXXXXXXXXXXXX,0,300,0
15771,14,1,13,64,222,0,0,235,111,124,GXXXXXXXXXXXXXXXXXXXGXXXXXXXXXXXXXXXXXXXGAXXXXXXXXXXXXXXXXXXGXXXXXXXXXXXXXXXXXXXGXXXXXXXXXXXXXXXXXXXGXXXXXXXXXXXXXXXXXXXGXXXXXXXXXXXXXXXXXXXGXXXXXXXXXXXXXXXXXXXGXXXXXXXXXXXXXXXXXXXGXXXXXXXXXXXXXXXXXXXGXXXXXXXXXXXXXXXXXXXGXXXXXXXXXXXXXXXXXXXGXXXXXXXXXXXXXXXXXXX,0,300,0
15792,14,1,13,62,224,0,0,237,113,124,GXXXXXXXXXXXXXXXXXXXGXXXXXXXXXXXXXXXXXXXGAXXXXXXXXXXXXXXXXXXGXXXXXXXXXXXXXXXXXXXGXXXXXXXXXXXXXXXXXXXGXXXXXXXXXXXXXXXXXXXGXXXXXXXXXXXXXXXXXXXGXXXXXXXXXXXXXXXXXXXGXXXXXXXXXXXXXXXXXXXGXXXXXXXXXXXXXXXXXXXGXXXXXXXXXXXXXXXXXXXGXXXXXXXXXXXXXXXXXXXGXXXXXXXXXXXXXXXXXXX,0,300,0
15813,14,0,14,65,221,0,0,234,114,120,GXXXXXXXXXXXXXXXXXXXGXXXXXXXXXXXXXXXXXXXGOXXXXXXXXXXXXXXXXXXGXXXXXXXXXXXXXXXXXXXGXXXXXXXXXXXXXXXXXXXGXXXXXXXXXXXXXXXXXXXGXXXXXXXXXXXXXXXXXXXGXXXXXXXXXXXXXXXXXXXGXXXXXXXXXXXXXXXXXXXGXXXXXXXXXXXXXXXXXXXGXXXXXXXXXXXXXXXXXXXGXXXXXXXXXXXXXXXXXXXGXXXXXXXXXXXXXXXXXXX,0,300,0
15834,14,0,14,62,224,0,0,237,118,119,GXXXXXXXXXXXXXXXXXXXGXXXXXXXXXXXXXXXXXXXGOXXXXXXXXXXXXXXXXXXGXXXXXXXXXXXXXXXXXXXGXXXXXXXXXXXXXXXXXXXGXXXXXXXXXXXXXXXXXXXGXXXXXXXXXXXXXXXXXXXGXXXXXXXXXXXXXXXXXXXGXXXXXXXXXXXXXXXXXXXGXXXXXXXXXXXXXXXXXXXGXXXXXXXXXXXXXXXXXXXGXXXXXXXXXXXXXXXXXXXGXXXXXXXXXXXXXXXXXXX,0,300,0

15855,13,0,13,65,222,0,0,235,128,107,GXXXXXXXXXXXXXXXXXXXGXXXXXXXXXXXXXXXXXXXGXXXXXXXXXXXXXXXXXXXGXXXXXXXXXXXXXXXXXXXGXXXXXXXXXXXXXXXXXXXGXXXXXXXXXXXXXXXXXXXGXXXXXXXXXXXXXXXXXXXGXXXXXXXXXXXXXXXXXXXGXXXXXXXXXXXXXXXXXXXGXXXXXXXXXXXXXXXXXXXGXXXXXXXXXXXXXXXXXXXGXXXXXXXXXXXXXXXXXXXGXXXXXXXXXXXXXXXXXXX,0,300,0
15876,13,0,13,69,218,0,0,231,127,104,GXXXXXXXXXXXXXXXXXXXGXXXXXXXXXXXXXXXXXXXGXXXXXXXXXXXXXXXXXXXGXXXXXXXXXXXXXXXXXXXGXXXXXXXXXXXXXXXXXXXGXXXXXXXXXXXXXXXXXXXGXXXXXXXXXXXXXXXXXXXGXXXXXXXXXXXXXXXXXXXGXXXXXXXXXXXXXXXXXXXGXXXXXXXXXXXXXXXXXXXGXXXXXXXXXXXXXXXXXXXGXXXXXXXXXXXXXXXXXXXGXXXXXXXXXXXXXXXXXXX,0,300,0
15897,13,0,13,73,214,0,0,227,124,103,GXXXXXXXXXXXXXXXXXXXGXXXXXXXXXXXXXXXXXXXGXXXXXXXXXXXXXXXXXXXGXXXXXXXXXXXXXXXXXXXGXXXXXXXXXXXXXXXXXXXGXXXXXXXXXXXXXXXXXXXGXXXXXXXXXXXXXXXXXXXGXXXXXXXXXXXXXXXXXXXGXXXXXXXXXXXXXXXXXXXGXXXXXXXXXXXXXXXXXXXGXXXXXXXXXXXXXXXXXXXGXXXXXXXXXXXXXXXXXXXGXXXXXXXXXXXXXXXXXXX,0,300,0
15918,13,0,13,72,215,0,0,227,117,110,GXXXXXXXXXXXXXXXXXXXGXXXXXXXXXXXXXXXXXXXGXXXXXXXXXXXXXXXXXXXGXXXXXXXXXXXXXXXXXXXGXXXXXXXXXXXXXXXXXXXGXXXXXXXXXXXXXXXXXXXGXXXXXXXXXXXXXXXXXXXGXXXXXXXXXXXXXXXXXXXGXXXXXXXXXXXXXXXXXXXGXXXXXXXXXXXXXXXXXXXGXXXXXXXXXXXXXXXXXXXGXXXXXXXXXXXXXXXXXXXGXXXXXXXXXXXXXXXXXXX,0,300,0
15939,14,1,13,71,215,0,0,227,117,110,GXXXXXXXXXXXXXXXXXXXGXXXXXXXXXXXXXXXXXXXGXXXXXXXXXXXXXXXXXXXGXXXXXXXXXXXXXXXXXXXGXXXXXXXXXXXXXXXXXXXGXXXXXXXXXXXXXXXXXXXGXXXXXXXXXXXXXXXXXXXGAXXXXXXXXXXXXXXXXXXGXXXXXXXXXXXXXXXXXXXGXXXXXXXXXXXXXXXXXXXGXXXXXXXXXXXXXXXXXXXGXXXXXXXXXXXXXXXXXXXGXXXXXXXXXXXXXXXXXXX,0,300,0

15960,13,0,13,69,218,0,0,231,120,111,GXXXXXXXXXXXXXXXXXXXGXXXXXXXXXXXXXXXXXXXGXXXXXXXXXXXXXXXXXXXGXXXXXXXXXXXXXXXXXXXGXXXXXXXXXXXXXXXXXXXGXXXXXXXXXXXXXXXXXXXGXXXXXXXXXXXXXXXXXXXGXXXXXXXXXXXXXXXXXXXGXXXXXXXXXXXXXXXXXXXGXXXXXXXXXXXXXXXXXXXGXXXXXXXXXXXXXXXXXXXGXXXXXXXXXXXXXXXXXXXGXXXXXXXXXXXXXXXXXXX,0,300,0
15981,13,0,13,69,218,0,0,231,123,108,GXXXXXXXXXXXXXXXXXXXGXXXXXXXXXXXXXXXXXXXGXXXXXXXXXXXXXXXXXXXGXXXXXXXXXXXXXXXXXXXGXXXXXXXXXXXXXXXXXXXGXXXXXXXXXXXXXXXXXXXGXXXXXXXXXXXXXXXXXXXGXXXXXXXXXXXXXXXXXXXGXXXXXXXXXXXXXXXXXXXGXXXXXXXXXXXXXXXXXXXGXXXXXXXXXXXXXXXXXXXGXXXXXXXXXXXXXXXXXXXGXXXXXXXXXXXXXXXXXXX,0,300,0
16002,13,0,13,70,217,0,0,229,118,111,GXXXXXXXXXXXXXXXXXXXGXXXXXXXXXXXXXXXXXXXGXXXXXXXXXXXXXXXXXXXGXXXXXXXXXXXXXXXXXXXGXXXXXXXXXXXXXXXXXXXGXXXXXXXXXXXXXXXXXXXGXXXXXXXXXXXXXXXXXXXGXXXXXXXXXXXXXXXXXXXGXXXXXXXXXXXXXXXXXXXGXXXXXXXXXXXXXXXXXXXGXXXXXXXXXXXXXXXXXXXGXXXXXXXXXXXXXXXXXXXGXXXXXXXXXXXXXXXXXXX,0,300,0
16023,13,0,13,67,220,0,0,233,116,117,GXXXXXXXXXXXXXXXXXXXGXXXXXXXXXXXXXXXXXXXGXXXXXXXXXXXXXXXXXXXGXXXXXXXXXXXXXXXXXXXGXXXXXXXXXXXXXXXXXXXGXXXXXXXXXXXXXXXXXXXGXXXXXXXXXXXXXXXXXXXGXXXXXXXXXXXXXXXXXXXGXXXXXXXXXXXXXXXXXXXGXXXXXXXXXXXXXXXXXXXGXXXXXXXXXXXXXXXXXXXGXXXXXXXXXXXXXXXXXXXGXXXXXXXXXXXXXXXXXXX,0,300,0
16044,13,0,13,66,221,0,0,234,112,122,GXXXXXXXXXXXXXXXXXXXGXXXXXXXXXXXXXXXXXXXGXXXXXXXXXXXXXXXXXXXGXXXXXXXXXXXXXXXXXXXGXXXXXXXXXXXXXXXXXXXGXXXXXXXXXXXXXXXXXXXGXXXXXXXXXXXXXXXXXXXGXXXXXXXXXXXXXXXXXXXGXXXXXXXXXXXXXXXXXXXGXXXXXXXXXXXXXXXXXXXGXXXXXXXXXXXXXXXXXXXGXXXXXXXXXXXXXXXXXXXGXXXXXXXXXXXXXXXXXXX,0,300,0

16065,13,0,13,63,224,0,0,237,113,124,GXXXXXXXXXXXXXXXXXXXGXXXXXXXXXXXXXXXXXXXGXXXXXXXXXXXXXXXXXXXGXXXXXXXXXXXXXXXXXXXGXXXXXXXXXXXXXXXXXXXGXXXXXXXXXXXXXXXXXXXGXXXXXXXXXXXXXXXXXXXGXXXXXXXXXXXXXXXXXXXGXXXXXXXXXXXXXXXXXXXGXXXXXXXXXXXXXXXXXXXGXXXXXXXXXXXXXXXXXXXGXXXXXXXXXXXXXXXXXXXGXXXXXXXXXXXXXXXXXXX,0,300,0
16086,13,0,13,66,221,0,0,234,111,123,GXXXXXXXXXXXXXXXXXXXGXXXXXXXXXXXXXXXXXXXGXXXXXXXXXXXXXXXXXXXGXXXXXXXXXXXXXXXXXXXGXXXXXXXXXXXXXXXXXXXGXXXXXXXXXXXXXXXXXXXGXXXXXXXXXXXXXXXXXXXGXXXXXXXXXXXXXXXXXXXGXXXXXXXXXXXXXXXXXXXGXXXXXXXXXXXXXXXXXXXGXXXXXXXXXXXXXXXXXXXGXXXXXXXXXXXXXXXXXXXGXXXXXXXXXXXXXXXXXXX,0,300,0
16107,13,0,13,65,222,0,0,235,117,118,GXXXXXXXXXXXXXXXXXXXGXXXXXXXXXXXXXXXXXXXGXXXXXXXXXXXXXXXXXXXGXXXXXXXXXXXXXXXXXXXGXXXXXXXXXXXXXXXXXXXGXXXXXXXXXXXXXXXXXXXGXXXXXXXXXXXXXXXXXXXGXXXXXXXXXXXXXXXXXXXGXXXXXXXXXXXXXXXXXXXGXXXXXXXXXXXXXXXXXXXGXXXXXXXXXXXXXXXXXXXGXXXXXXXXXXXXXXXXXXXGXXXXXXXXXXXXXXXXXXX,0,300,0
16128,13,0,13,60,227,0,0,240,122,118,GXXXXXXXXXXXXXXXXXXXGXXXXXXXXXXXXXXXXXXXGXXXXXXXXXXXXXXXXXXXGXXXXXXXXXXXXXXXXXXXGXXXXXXXXXXXXXXXXXXXGXXXXXXXXXXXXXXXXXXXGXXXXXXXXXXXXXXXXXXXGXXXXXXXXXXXXXXXXXXXGXXXXXXXXXXXXXXXXXXXGXXXXXXXXXXXXXXXXXXXGXXXXXXXXXXXXXXXXXXXGXXXXXXXXXXXXXXXXXXXGXXXXXXXXXXXXXXXXXXX,0,300,0
16149,13,0,13,65,222,0,0,235,116,119,GXXXXXXXXXXXXXXXXXXXGXXXXXXXXXXXXXXXXXXXGXXXXXXXXXXXXXXXXXXXGXXXXXXXXXXXXXXXXXXXGXXXXXXXXXXXXXXXXXXXGXXXXXXXXXXXXXXXXXXXGXXXXXXXXXXXXXXXXXXXGXXXXXXXXXXXXXXXXXXXGXXXXXXXXXXXXXXXXXXXGXXXXXXXXXXXXXXXXXXXGXXXXXXXXXXXXXXXXXXXGXXXXXXXXXXXXXXXXXXXGXXXXXXXXXXXXXXXXXXX,0,300,0

16170,14,1,13,68,218,0,0,231,115,116,GXXXXXXXXXXXXXXXXXXXGXXXXXXXXXXXXXXXXXXXGXXXXXXXXXXXXXXXXXXXGAXXXXXXXXXXXXXXXXXXGXXXXXXXXXXXXXXXXXXXGXXXXXXXXXXXXXXXXXXXGXXXXXXXXXXXXXXXXXXXGXXXXXXXXXXXXXXXXXXXGXXXXXXXXXXXXXXXXXXXGXXXXXXXXXXXXXXXXXXXGXXXXXXXXXXXXXXXXXXXGXXXXXXXXXXXXXXXXXXXGXXXXXXXXXXXXXXXXXXX,0,300,0
16191,14,1,13,70,216,0,0,229,115,114,GXXXXXXXXXXXXXXXXXXXGXXXXXXXXXXXXXXXXXXXGXXXXXXXXXXXXXXXXXXXGAXXXXXXXXXXXXXXXXXXGXXXXXXXXXXXXXXXXXXXGXXXXXXXXXXXXXXXXXXXGXXXXXXXXXXXXXXXXXXXGXXXXXXXXXXXXXXXXXXXGXXXXXXXXXXXXXXXXXXXGXXXXXXXXXXXXXXXXXXXGXXXXXXXXXXXXXXXXXXXGXXXXXXXXXXXXXXXXXXXGXXXXXXXXXXXXXXXXXXX,0,300,0
16212,15,2,13,73,212,0,0,226,114,112,GXXXXXXXXXXXXXXXXXXXGXXXXXXXXXXXXXXXXXXXGXXXXXXXXXXXXXXXXXXXGAXXXXXXXXXXXXXXXXXXGXXXXXXXXXXXXXXXXXXXGXXXXXXXXXXXXXXXXXXXGXXXXXXXXXXXXXXXXXXXGXXXXXXXXXXXXXXXXXXXGXXXXXXXXXXXXXXXXXXXGXXXXXXXXXXXXXXXXXXXGXXXXXXXXXXXXXXXXXXXGAXXXXXXXXXXXXXXXXXXGXXXXXXXXXXXXXXXXXXX,0,300,0
16233,16,3,13,68,216,0,0,230,115,115,GXXXXXXXXXXXXXXXXXXXGXXXXXXXXXXXXXXXXXXXGXXXXXXXXXXXXXXXXXXXGAXXXXXXXXXXXXXXXXXXGXXXXXXXXXXXXXXXXXXXGXXXXXXXXXXXXXXXXXXXGXXXXXXXXXXXXXXXXXXXGAXXXXXXXXXXXXXXXXXXGXXXXXXXXXXXXXXXXXXXGXXXXXXXXXXXXXXXXXXXGXXXXXXXXXXXXXXXXXXXGAXXXXXXXXXXXXXXXXXXGXXXXXXXXXXXXXXXXXXX,0,300,0
16254,15,2,13,63,222,0,0,233,117,116,GXXXXXXXXXXXXXXXXXXXGXXXXXXXXXXXXXXXXXXXGXXXXXXXXXXXXXXXXXXXGAXXXXXXXXXXXXXXXXXXGXXXXXXXXXXXXXXXXXXXGXXXXXXXXXXXXXXXXXXXGXXXXXXXXXXXXXXXXXXXGAXXXXXXXXXXXXXXXXXXGXXXXXXXXXXXXXXXXXXXGXXXXXXXXXXXXXXXXXXXGXXXXXXXXXXXXXXXXXXXGXXXXXXXXXXXXXXXXXXXGXXXXXXXXXXXXXXXXXXX,0,300,0

16275,15,1,14,62,223,0,0,235,120,115,GXXXXXXXXXXXXXXXXXXXGXXXXXXXXXXXXXXXXXXXGXXXXXXXXXXXXXXXXXXXGAXXXXXXXXXXXXXXXXXXGXXXXXXXXXXXXXXXXXXXGXXXXXXXXXXXXXXXXXXXGXXXXXXXXXXXXXXXXXXXGOXXXXXXXXXXXXXXXXXXGXXXXXXXXXXXXXXXXXXXGXXXXXXXXXXXXXXXXXXXGXXXXXXXXXXXXXXXXXXXGXXXXXXXXXXXXXXXXXXXGXXXXXXXXXXXXXXXXXXX,0,300,0
16296,15,1,14,62,223,0,0,234,122,112,GXXXXXXXXXXXXXXXXXXXGXXXXXXXXXXXXXXXXXXXGXXXXXXXXXXXXXXXXXXXGAXXXXXXXXXXXXXXXXXXGXXXXXXXXXXXXXXXXXXXGXXXXXXXXXXXXXXXXXXXGXXXXXXXXXXXXXXXXXXXGOXXXXXXXXXXXXXXXXXXGXXXXXXXXXXXXXXXXXXXGXXXXXXXXXXXXXXXXXXXGXXXXXXXXXXXXXXXXXXXGXXXXXXXXXXXXXXXXXXXGXXXXXXXXXXXXXXXXXXX,0,300,0
16317,15,2,13,64,221,0,0,233,119,114,GAXXXXXXXXXXXXXXXXXXGXXXXXXXXXXXXXXXXXXXGXXXXXXXXXXXXXXXXXXXGAXXXXXXXXXXXXXXXXXXGXXXXXXXXXXXXXXXXXXXGXXXXXXXXXXXXXXXXXXXGXXXXXXXXXXXXXXXXXXXGXXXXXXXXXXXXXXXXXXXGXXXXXXXXXXXXXXXXXXXGXXXXXXXXXXXXXXXXXXXGXXXXXXXXXXXXXXXXXXXGXXXXXXXXXXXXXXXXXXXGXXXXXXXXXXXXXXXXXXX,0,300,0
16338,15,1,14,63,222,0,0,233,122,111,GAXXXXXXXXXXXXXXXXXXGXXXXXXXXXXXXXXXXXXXGXXXXXXXXXXXXXXXXXXXGOXXXXXXXXXXXXXXXXXXGXXXXXXXXXXXXXXXXXXXGXXXXXXXXXXXXXXXXXXXGXXXXXXXXXXXXXXXXXXXGXXXXXXXXXXXXXXXXXXXGXXXXXXXXXXXXXXXXXXXGXXXXXXXXXXXXXXXXXXXGXXXXXXXXXXXXXXXXXXXGXXXXXXXXXXXXXXXXXXXGXXXXXXXXXXXXXXXXXXX,0,300,0
16359,14,1,13,62,224,0,0,236,119,117,GAXXXXXXXXXXXXXXXXXXGXXXXXXXXXXXXXXXXXXXGXXXXXXXXXXXXXXXXXXXGXXXXXXXXXXXXXXXXXXXGXXXXXXXXXXXXXXXXXXXGXXXXXXXXXXXXXXXXXXXGXXXXXXXXXXXXXXXXXXXGXXXXXXXXXXXXXXXXXXXGXXXXXXXXXXXXXXXXXXXGXXXXXXXXXXXXXXXXXXXGXXXXXXXXXXXXXXXXXXXGXXXXXXXXXXXXXXXXXXXGXXXXXXXXXXXXXXXXXXX,0,300,0

16380,14,1,13,62,224,0,0,236,118,118,GAXXXXXXXXXXXXXXXXXXGXXXXXXXXXXXXXXXXXXXGXXXXXXXXXXXXXXXXXXXGXXXXXXXXXXXXXXXXXXXGXXXXXXXXXXXXXXXXXXXGXXXXXXXXXXXXXXXXXXXGXXXXXXXXXXXXXXXXXXXGXXXXXXXXXXXXXXXXXXXGXXXXXXXXXXXXXXXXXXXGXXXXXXXXXXXXXXXXXXXGXXXXXXXXXXXXXXXXXXXGXXXXXXXXXXXXXXXXXXXGXXXXXXXXXXXXXXXXXXX,0,300,0
16401,14,1,13,64,222,0,0,234,119,115,GAXXXXXXXXXXXXXXXXXXGXXXXXXXXXXXXXXXXXXXGXXXXXXXXXXXXXXXXXXXGXXXXXXXXXXXXXXXXXXXGXXXXXXXXXXXXXXXXXXXGXXXXXXXXXXXXXXXXXXXGXXXXXXXXXXXXXXXXXXXGXXXXXXXXXXXXXXXXXXXGXXXXXXXXXXXXXXXXXXXGXXXXXXXXXXXXXXXXXXXGXXXXXXXXXXXXXXXXXXXGXXXXXXXXXXXXXXXXXXXGXXXXXXXXXXXXXXXXXXX,0,300,0
16422,14,0,14,62,224,0,0,236,118,118,GOXXXXXXXXXXXXXXXXXXGXXXXXXXXXXXXXXXXXXXGXXXXXXXXXXXXXXXXXXXGXXXXXXXXXXXXXXXXXXXGXXXXXXXXXXXXXXXXXXXGXXXXXXXXXXXXXXXXXXXGXXXXXXXXXXXXXXXXXXXGXXXXXXXXXXXXXXXXXXXGXXXXXXXXXXXXXXXXXXXGXXXXXXXXXXXXXXXXXXXGXXXXXXXXXXXXXXXXXXXGXXXXXXXXXXXXXXXXXXXGXXXXXXXXXXXXXXXXXXX,0,300,0
16443,14,0,14,59,227,0,0,239,123,116,GOXXXXXXXXXXXXXXXXXXGXXXXXXXXXXXXXXXXXXXGXXXXXXXXXXXXXXXXXXXGXXXXXXXXXXXXXXXXXXXGXXXXXXXXXXXXXXXXXXXGXXXXXXXXXXXXXXXXXXXGXXXXXXXXXXXXXXXXXXXGXXXXXXXXXXXXXXXXXXXGXXXXXXXXXXXXXXXXXXXGXXXXXXXXXXXXXXXXXXXGXXXXXXXXXXXXXXXXXXXGXXXXXXXXXXXXXXXXXXXGXXXXXXXXXXXXXXXXXXX,0,300,0
16464,13,0,13,64,223,0,0,234,119,115,GXXXXXXXXXXXXXXXXXXXGXXXXXXXXXXXXXXXXXXXGXXXXXXXXXXXXXXXXXXXGXXXXXXXXXXXXXXXXXXXGXXXXXXXXXXXXXXXXXXXGXXXXXXXXXXXXXXXXXXXGXXXXXXXXXXXXXXXXXXXGXXXXXXXXXXXXXXXXXXXGXXXXXXXXXXXXXXXXXXXGXXXXXXXXXXXXXXXXXXXGXXXXXXXXXXXXXXXXXXXGXXXXXXXXXXXXXXXXXXXGXXXXXXXXXXXXXXXXXXX,0,300,0

16485,13,0,13,65,222,0,0,233,119,114,GXXXXXXXXXXXXXXXXXXXGXXXXXXXXXXXXXXXXXXXGXXXXXXXXXXXXXXXXXXXGXXXXXXXXXXXXXXXXXXXGXXXXXXXXXXXXXXXXXXXGXXXXXXXXXXXXXXXXXXXGXXXXXXXXXXXXXXXXXXXGXXXXXXXXXXXXXXXXXXXGXXXXXXXXXXXXXXXXXXXGXXXXXXXXXXXXXXXXXXXGXXXXXXXXXXXXXXXXXXXGXXXXXXXXXXXXXXXXXXXGXXXXXXXXXXXXXXXXXXX,0,300,0
16506,14,1,13,68,218,0,0,230,115,115,GXXXXXXXXXXXXXXXXXXXGXXXXXXXXXXXXXXXXXXXGXXXXXXXXXXXXXXXXXXXGXXXXXXXXXXXXXXXXXXXGAXXXXXXXXXXXXXXXXXXGXXXXXXXXXXXXXXXXXXXGXXXXXXXXXXXXXXXXXXXGXXXXXXXXXXXXXXXXXXXGXXXXXXXXXXXXXXXXXXXGXXXXXXXXXXXXXXXXXXXGXXXXXXXXXXXXXXXXXXXGXXXXXXXXXXXXXXXXXXXGXXXXXXXXXXXXXXXXXXX,0,300,0
16527,14,1,13,65,221,0,0,231,116,115,GXXXXXXXXXXXXXXXXXXXGXXXXXXXXXXXXXXXXXXXGXXXXXXXXXXXXXXXXXXXGXXXXXXXXXXXXXXXXXXXGAXXXXXXXXXXXXXXXXXXGXXXXXXXXXXXXXXXXXXXGXXXXXXXXXXXXXXXXXXXGXXXXXXXXXXXXXXXXXXXGXXXXXXXXXXXXXXXXXXXGXXXXXXXXXXXXXXXXXXXGXXXXXXXXXXXXXXXXXXXGXXXXXXXXXXXXXXXXXXXGXXXXXXXXXXXXXXXXXXX,0,300,0
16548,14,1,13,68,218,0,0,230,113,117,GXXXXXXXXXXXXXXXXXXXGXXXXXXXXXXXXXXXXXXXGXXXXXXXXXXXXXXXXXXXGXXXXXXXXXXXXXXXXXXXGAXXXXXXXXXXXXXXXXXXGXXXXXXXXXXXXXXXXXXXGXXXXXXXXXXXXXXXXXXXGXXXXXXXXXXXXXXXXXXXGXXXXXXXXXXXXXXXXXXXGXXXXXXXXXXXXXXXXXXXGXXXXXXXXXXXXXXXXXXXGXXXXXXXXXXXXXXXXXXXGXXXXXXXXXXXXXXXXXXX,0,300,0
16569,14,1,13,64,222,0,0,234,113,121,GXXXXXXXXXXXXXXXXXXXGXXXXXXXXXXXXXXXXXXXGXXXXXXXXXXXXXXXXXXXGXXXXXXXXXXXXXXXXXXXGAXXXXXXXXXXXXXXXXXXGXXXXXXXXXXXXXXXXXXXGXXXXXXXXXXXXXXXXXXXGXXXXXXXXXXXXXXXXXXXGXXXXXXXXXXXXXXXXXXXGXXXXXXXXXXXXXXXXXXXGXXXXXXXXXXXXXXXXXXXGXXXXXXXXXXXXXXXXXXXGXXXXXXXXXXXXXXXXXXX,0,300,0

16590,14,1,13,63,223,0,0,235,114,121,GXXXXXXXXXXXXXXXXXXXGXXXXXXXXXXXXXXXXXXXGXXXXXXXXXXXXXXXXXXXGXXXXXXXXXXXXXXXXXXXGAXXXXXXXXXXXXXXXXXXGXXXXXXXXXXXXXXXXXXXGXXXXXXXXXXXXXXXXXXXGXXXXXXXXXXXXXXXXXXXGXXXXXXXXXXXXXXXXXXXGXXXXXXXXXXXXXXXXXXXGXXXXXXXXXXXXXXXXXXXGXXXXXXXXXXXXXXXXXXXGXXXXXXXXXXXXXXXXXXX,0,300,0
16611,14,1,13,61,225,0,0,237,114,123,GXXXXXXXXXXXXXXXXXXXGXXXXXXXXXXXXXXXXXXXGXXXXXXXXXXXXXXXXXXXGXXXXXXXXXXXXXXXXXXXGAXXXXXXXXXXXXXXXXXXGXXXXXXXXXXXXXXXXXXXGXXXXXXXXXXXXXXXXXXXGXXXXXXXXXXXXXXXXXXXGXXXXXXXXXXXXXXXXXXXGXXXXXXXXXXXXXXXXXXXGXXXXXXXXXXXXXXXXXXXGXXXXXXXXXXXXXXXXXXXGXXXXXXXXXXXXXXXXXXX,0,300,0
16632,14,1,13,57,229,0,0,241,113,128,GXXXXXXXXXXXXXXXXXXXGXXXXXXXXXXXXXXXXXXXGXXXXXXXXXXXXXXXXXXXGXXXXXXXXXXXXXXXXXXXGAXXXXXXXXXXXXXXXXXXGXXXXXXXXXXXXXXXXXXXGXXXXXXXXXXXXXXXXXXXGXXXXXXXXXXXXXXXXXXXGXXXXXXXXXXXXXXXXXXXGXXXXXXXXXXXXXXXXXXXGXXXXXXXXXXXXXXXXXXXGXXXXXXXXXXXXXXXXXXXGXXXXXXXXXXXXXXXXXXX,0,300,0
16653,13,0,13,60,227,0,0,239,117,122,GXXXXXXXXXXXXXXXXXXXGXXXXXXXXXXXXXXXXXXXGXXXXXXXXXXXXXXXXXXXGXXXXXXXXXXXXXXXXXXXGXXXXXXXXXXXXXXXXXXXGXXXXXXXXXXXXXXXXXXXGXXXXXXXXXXXXXXXXXXXGXXXXXXXXXXXXXXXXXXXGXXXXXXXXXXXXXXXXXXXGXXXXXXXXXXXXXXXXXXXGXXXXXXXXXXXXXXXXXXXGXXXXXXXXXXXXXXXXXXXGXXXXXXXXXXXXXXXXXXX,0,300,0
16674,13,0,13,58,229,0,0,241,121,120,GXXXXXXXXXXXXXXXXXXXGXXXXXXXXXXXXXXXXXXXGXXXXXXXXXXXXXXXXXXXGXXXXXXXXXXXXXXXXXXXGXXXXXXXXXXXXXXXXXXXGXXXXXXXXXXXXXXXXXXXGXXXXXXXXXXXXXXXXXXXGXXXXXXXXXXXXXXXXXXXGXXXXXXXXXXXXXXXXXXXGXXXXXXXXXXXXXXXXXXXGXXXXXXXXXXXXXXXXXXXGXXXXXXXXXXXXXXXXXXXGXXXXXXXXXXXXXXXXXXX,0,300,0

16695,13,0,13,64,223,0,0,235,123,112,GXXXXXXXXXXXXXXXXXXXGXXXXXXXXXXXXXXXXXXXGXXXXXXXXXXXXXXXXXXXGXXXXXXXXXXXXXXXXXXXGXXXXXXXXXXXXXXXXXXXGXXXXXXXXXXXXXXXXXXXGXXXXXXXXXXXXXXXXXXXGXXXXXXXXXXXXXXXXXXXGXXXXXXXXXXXXXXXXXXXGXXXXXXXXXXXXXXXXXXXGXXXXXXXXXXXXXXXXXXXGXXXXXXXXXXXXXXXXXXXGXXXXXXXXXXXXXXXXXXX,0,300,0
16716,13,0,13,61,226,0,0,238,120,118,GXXXXXXXXXXXXXXXXXXXGXXXXXXXXXXXXXXXXXXXGXXXXXXXXXXXXXXXXXXXGXXXXXXXXXXXXXXXXXXXGXXXXXXXXXXXXXXXXXXXGXXXXXXXXXXXXXXXXXXXGXXXXXXXXXXXXXXXXXXXGXXXXXXXXXXXXXXXXXXXGXXXXXXXXXXXXXXXXXXXGXXXXXXXXXXXXXXXXXXXGXXXXXXXXXXXXXXXXXXXGXXXXXXXXXXXXXXXXXXXGXXXXXXXXXXXXXXXXXXX,0,300,0
16737,13,0,13,61,226,0,0,238,121,117,GXXXXXXXXXXXXXXXXXXXGXXXXXXXXXXXXXXXXXXXGXXXXXXXXXXXXXXXXXXXGXXXXXXXXXXXXXXXXXXXGXXXXXXXXXXXXXXXXXXXGXXXXXXXXXXXXXXXXXXXGXXXXXXXXXXXXXXXXXXXGXXXXXXXXXXXXXXXXXXXGXXXXXXXXXXXXXXXXXXXGXXXXXXXXXXXXXXXXXXXGXXXXXXXXXXXXXXXXXXXGXXXXXXXXXXXXXXXXXXXGXXXXXXXXXXXXXXXXXXX,0,300,0
16758,13,0,13,59,228,0,0,239,126,113,GXXXXXXXXXXXXXXXXXXXGXXXXXXXXXXXXXXXXXXXGXXXXXXXXXXXXXXXXXXXGXXXXXXXXXXXXXXXXXXXGXXXXXXXXXXXXXXXXXXXGXXXXXXXXXXXXXXXXXXXGXXXXXXXXXXXXXXXXXXXGXXXXXXXXXXXXXXXXXXXGXXXXXXXXXXXXXXXXXXXGXXXXXXXXXXXXXXXXXXXGXXXXXXXXXXXXXXXXXXXGXXXXXXXXXXXXXXXXXXXGXXXXXXXXXXXXXXXXXXX,0,300,0
16779,13,0,13,57,230,0,0,242,128,114,GXXXXXXXXXXXXXXXXXXXGXXXXXXXXXXXXXXXXXXXGXXXXXXXXXXXXXXXXXXXGXXXXXXXXXXXXXXXXXXXGXXXXXXXXXXXXXXXXXXXGXXXXXXXXXXXXXXXXXXXGXXXXXXXXXXXXXXXXXXXGXXXXXXXXXXXXXXXXXXXGXXXXXXXXXXXXXXXXXXXGXXXXXXXXXXXXXXXXXXXGXXXXXXXXXXXXXXXXXXXGXXXXXXXXXXXXXXXXXXXGXXXXXXXXXXXXXXXXXXX,0,300,0

16800,13,0,13,65,222,0,0,234,123,111,GXXXXXXXXXXXXXXXXXXXGXXXXXXXXXXXXXXXXXXXGXXXXXXXXXXXXXXXXXXXGXXXXXXXXXXXXXXXXXXXGXXXXXXXXXXXXXXXXXXXGXXXXXXXXXXXXXXXXXXXGXXXXXXXXXXXXXXXXXXXGXXXXXXXXXXXXXXXXXXXGXXXXXXXXXXXXXXXXXXXGXXXXXXXXXXXXXXXXXXXGXXXXXXXXXXXXXXXXXXXGXXXXXXXXXXXXXXXXXXXGXXXXXXXXXXXXXXXXXXX,0,300,0
16821,13,0,13,64,223,0,0,235,128,107,GXXXXXXXXXXXXXXXXXXXGXXXXXXXXXXXXXXXXXXXGXXXXXXXXXXXXXXXXXXXGXXXXXXXXXXXXXXXXXXXGXXXXXXXXXXXXXXXXXXXGXXXXXXXXXXXXXXXXXXXGXXXXXXXXXXXXXXXXXXXGXXXXXXXXXXXXXXXXXXXGXXXXXXXXXXXXXXXXXXXGXXXXXXXXXXXXXXXXXXXGXXXXXXXXXXXXXXXXXXXGXXXXXXXXXXXXXXXXXXXGXXXXXXXXXXXXXXXXXXX,0,300,0
16842,13,0,13,69,218,0,0,228,125,103,GXXXXXXXXXXXXXXXXXXXGXXXXXXXXXXXXXXXXXXXGXXXXXXXXXXXXXXXXXXXGXXXXXXXXXXXXXXXXXXXGXXXXXXXXXXXXXXXXXXXGXXXXXXXXXXXXXXXXXXXGXXXXXXXXXXXXXXXXXXXGXXXXXXXXXXXXXXXXXXXGXXXXXXXXXXXXXXXXXXXGXXXXXXXXXXXXXXXXXXXGXXXXXXXXXXXXXXXXXXXGXXXXXXXXXXXXXXXXXXXGXXXXXXXXXXXXXXXXXXX,0,300,0
16863,13,0,13,73,214,0,0,226,122,104,GXXXXXXXXXXXXXXXXXXXGXXXXXXXXXXXXXXXXXXXGXXXXXXXXXXXXXXXXXXXGXXXXXXXXXXXXXXXXXXXGXXXXXXXXXXXXXXXXXXXGXXXXXXXXXXXXXXXXXXXGXXXXXXXXXXXXXXXXXXXGXXXXXXXXXXXXXXXXXXXGXXXXXXXXXXXXXXXXXXXGXXXXXXXXXXXXXXXXXXXGXXXXXXXXXXXXXXXXXXXGXXXXXXXXXXXXXXXXXXXGXXXXXXXXXXXXXXXXXXX,0,300,0
16884,13,0,13,65,222,0,0,234,128,106,GXXXXXXXXXXXXXXXXXXXGXXXXXXXXXXXXXXXXXXXGXXXXXXXXXXXXXXXXXXXGXXXXXXXXXXXXXXXXXXXGXXXXXXXXXXXXXXXXXXXGXXXXXXXXXXXXXXXXXXXGXXXXXXXXXXXXXXXXXXXGXXXXXXXXXXXXXXXXXXXGXXXXXXXXXXXXXXXXXXXGXXXXXXXXXXXXXXXXXXXGXXXXXXXXXXXXXXXXXXXGXXXXXXXXXXXXXXXXXXXGXXXXXXXXXXXXXXXXXXX,0,300,0

16905,13,0,13,72,215,0,0,227,123,104,GXXXXXXXXXXXXXXXXXXXGXXXXXXXXXXXXXXXXXXXGXXXXXXXXXXXXXXXXXXXGXXXXXXXXXXXXXXXXXXXGXXXXXXXXXXXXXXXXXXXGXXXXXXXXXXXXXXXXXXXGXXXXXXXXXXXXXXXXXXXGXXXXXXXXXXXXXXXXXXXGXXXXXXXXXXXXXXXXXXXGXXXXXXXXXXXXXXXXXXXGXXXXXXXXXXXXXXXXXXXGXXXXXXXXXXXXXXXXXXXGXXXXXXXXXXXXXXXXXXX,0,300,0
16926,13,0,13,66,221,0,0,233,125,108,GXXXXXXXXXXXXXXXXXXXGXXXXXXXXXXXXXXXXXXXGXXXXXXXXXXXXXXXXXXXGXXXXXXXXXXXXXXXXXXXGXXXXXXXXXXXXXXXXXXXGXXXXXXXXXXXXXXXXXXXGXXXXXXXXXXXXXXXXXXXGXXXXXXXXXXXXXXXXXXXGXXXXXXXXXXXXXXXXXXXGXXXXXXXXXXXXXXXXXXXGXXXXXXXXXXXXXXXXXXXGXXXXXXXXXXXXXXXXXXXGXXXXXXXXXXXXXXXXXXX,0,300,0
16947,13,0,13,66,221,0,0,233,127,106,GXXXXXXXXXXXXXXXXXXXGXXXXXXXXXXXXXXXXXXXGXXXXXXXXXXXXXXXXXXXGXXXXXXXXXXXXXXXXXXXGXXXXXXXXXXXXXXXXXXXGXXXXXXXXXXXXXXXXXXXGXXXXXXXXXXXXXXXXXXXGXXXXXXXXXXXXXXXXXXXGXXXXXXXXXXXXXXXXXXXGXXXXXXXXXXXXXXXXXXXGXXXXXXXXXXXXXXXXXXXGXXXXXXXXXXXXXXXXXXXGXXXXXXXXXXXXXXXXXXX,0,300,0
16968,13,0,13,69,218,0,0,228,126,102,GXXXXXXXXXXXXXXXXXXXGXXXXXXXXXXXXXXXXXXXGXXXXXXXXXXXXXXXXXXXGXXXXXXXXXXXXXXXXXXXGXXXXXXXXXXXXXXXXXXXGXXXXXXXXXXXXXXXXXXXGXXXXXXXXXXXXXXXXXXXGXXXXXXXXXXXXXXXXXXXGXXXXXXXXXXXXXXXXXXXGXXXXXXXXXXXXXXXXXXXGXXXXXXXXXXXXXXXXXXXGXXXXXXXXXXXXXXXXXXXGXXXXXXXXXXXXXXXXXXX,0,300,0
16989,13,0,13,67,220,0,0,232,128,104,GXXXXXXXXXXXXXXXXXXXGXXXXXXXXXXXXXXXXXXXGXXXXXXXXXXXXXXXXXXXGXXXXXXXXXXXXXXXXXXXGXXXXXXXXXXXXXXXXXXXGXXXXXXXXXXXXXXXXXXXGXXXXXXXXXXXXXXXXXXXGXXXXXXXXXXXXXXXXXXXGXXXXXXXXXXXXXXXXXXXGXXXXXXXXXXXXXXXXXXXGXXXXXXXXXXXXXXXXXXXGXXXXXXXXXXXXXXXXXXXGXXXXXXXXXXXXXXXXXXX,0,300,0

17010,14,1,13,64,222,0,0,233,130,103,GXXXXXXXXXXXXXXXXXXXGXXXXXXXXXXXXXXXXXXXGXXXXXXXXXXXXXXXXXXXGXXXXXXXXXXXXXXXXXXXGXXXXXXXXXXXXXXXXXXXGXXXXXXXXXXXXXXXXXXXGXXXXXXXXXXXXXXXXXXXGXXXXXXXXXXXXXXXXXXXGXXXXXXXXXXXXXXXXXXXGAXXXXXXXXXXXXXXXXXXGXXXXXXXXXXXXXXXXXXXGXXXXXXXXXXXXXXXXXXXGXXXXXXXXXXXXXXXXXXX,0,300,0
17031,14,0,14,67,219,0,0,231,122,109,GXXXXXXXXXXXXXXXXXXXGXXXXXXXXXXXXXXXXXXXGXXXXXXXXXXXXXXXXXXXGXXXXXXXXXXXXXXXXXXXGXXXXXXXXXXXXXXXXXXXGXXXXXXXXXXXXXXXXXXXGXXXXXXXXXXXXXXXXXXXGXXXXXXXXXXXXXXXXXXXGXXXXXXXXXXXXXXXXXXXGOXXXXXXXXXXXXXXXXXXGXXXXXXXXXXXXXXXXXXXGXXXXXXXXXXXXXXXXXXXGXXXXXXXXXXXXXXXXXXX,0,300,0
17052,13,0,13,70,217,0,0,229,124,105,GXXXXXXXXXXXXXXXXXXXGXXXXXXXXXXXXXXXXXXXGXXXXXXXXXXXXXXXXXXXGXXXXXXXXXXXXXXXXXXXGXXXXXXXXXXXXXXXXXXXGXXXXXXXXXXXXXXXXXXXGXXXXXXXXXXXXXXXXXXXGXXXXXXXXXXXXXXXXXXXGXXXXXXXXXXXXXXXXXXXGXXXXXXXXXXXXXXXXXXXGXXXXXXXXXXXXXXXXXXXGXXXXXXXXXXXXXXXXXXXGXXXXXXXXXXXXXXXXXXX,0,300,0
17073,13,0,13,74,213,0,0,225,122,103,GXXXXXXXXXXXXXXXXXXXGXXXXXXXXXXXXXXXXXXXGXXXXXXXXXXXXXXXXXXXGXXXXXXXXXXXXXXXXXXXGXXXXXXXXXXXXXXXXXXXGXXXXXXXXXXXXXXXXXXXGXXXXXXXXXXXXXXXXXXXGXXXXXXXXXXXXXXXXXXXGXXXXXXXXXXXXXXXXXXXGXXXXXXXXXXXXXXXXXXXGXXXXXXXXXXXXXXXXXXXGXXXXXXXXXXXXXXXXXXXGXXXXXXXXXXXXXXXXXXX,0,300,0
17094,13,0,13,77,210,0,0,222,121,101,GXXXXXXXXXXXXXXXXXXXGXXXXXXXXXXXXXXXXXXXGXXXXXXXXXXXXXXXXXXXGXXXXXXXXXXXXXXXXXXXGXXXXXXXXXXXXXXXXXXXGXXXXXXXXXXXXXXXXXXXGXXXXXXXXXXXXXXXXXXXGXXXXXXXXXXXXXXXXXXXGXXXXXXXXXXXXXXXXXXXGXXXXXXXXXXXXXXXXXXXGXXXXXXXXXXXXXXXXXXXGXXXXXXXXXXXXXXXXXXXGXXXXXXXXXXXXXXXXXXX,0,300,0

17115,13,0,13,81,206,0,0,217,123,94,GXXXXXXXXXXXXXXXXXXXGXXXXXXXXXXXXXXXXXXXGXXXXXXXXXXXXXXXXXXXGXXXXXXXXXXXXXXXXXXXGXXXXXXXXXXXXXXXXXXXGXXXXXXXXXXXXXXXXXXXGXXXXXXXXXXXXXXXXXXXGXXXXXXXXXXXXXXXXXXXGXXXXXXXXXXXXXXXXXXXGXXXXXXXXXXXXXXXXXXXGXXXXXXXXXXXXXXXXXXXGXXXXXXXXXXXXXXXXXXXGXXXXXXXXXXXXXXXXXXX,0,300,0
17136,13,0,13,79,208,0,0,219,121,98,GXXXXXXXXXXXXXXXXXXXGXXXXXXXXXXXXXXXXXXXGXXXXXXXXXXXXXXXXXXXGXXXXXXXXXXXXXXXXXXXGXXXXXXXXXXXXXXXXXXXGXXXXXXXXXXXXXXXXXXXGXXXXXXXXXXXXXXXXXXXGXXXXXXXXXXXXXXXXXXXGXXXXXXXXXXXXXXXXXXXGXXXXXXXXXXXXXXXXXXXGXXXXXXXXXXXXXXXXXXXGXXXXXXXXXXXXXXXXXXXGXXXXXXXXXXXXXXXXXXX,0,300,0
17157,13,0,13,72,215,0,0,227,122,105,GXXXXXXXXXXXXXXXXXXXGXXXXXXXXXXXXXXXXXXXGXXXXXXXXXXXXXXXXXXXGXXXXXXXXXXXXXXXXXXXGXXXXXXXXXXXXXXXXXXXGXXXXXXXXXXXXXXXXXXXGXXXXXXXXXXXXXXXXXXXGXXXXXXXXXXXXXXXXXXXGXXXXXXXXXXXXXXXXXXXGXXXXXXXXXXXXXXXXXXXGXXXXXXXXXXXXXXXXXXXGXXXXXXXXXXXXXXXXXXXGXXXXXXXXXXXXXXXXXXX,0,300,0
17178,13,0,13,68,219,0,0,231,122,109,GXXXXXXXXXXXXXXXXXXXGXXXXXXXXXXXXXXXXXXXGXXXXXXXXXXXXXXXXXXXGXXXXXXXXXXXXXXXXXXXGXXXXXXXXXXXXXXXXXXXGXXXXXXXXXXXXXXXXXXXGXXXXXXXXXXXXXXXXXXXGXXXXXXXXXXXXXXXXXXXGXXXXXXXXXXXXXXXXXXXGXXXXXXXXXXXXXXXXXXXGXXXXXXXXXXXXXXXXXXXGXXXXXXXXXXXXXXXXXXXGXXXXXXXXXXXXXXXXXXX,0,300,0
17199,13,0,13,67,220,0,0,233,124,109,GXXXXXXXXXXXXXXXXXXXGXXXXXXXXXXXXXXXXXXXGXXXXXXXXXXXXXXXXXXXGXXXXXXXXXXXXXXXXXXXGXXXXXXXXXXXXXXXXXXXGXXXXXXXXXXXXXXXXXXXGXXXXXXXXXXXXXXXXXXXGXXXXXXXXXXXXXXXXXXXGXXXXXXXXXXXXXXXXXXXGXXXXXXXXXXXXXXXXXXXGXXXXXXXXXXXXXXXXXXXGXXXXXXXXXXXXXXXXXXXGXXXXXXXXXXXXXXXXXXX,0,300,0

17220,13,0,13,65,222,0,0,234,122,112,GXXXXXXXXXXXXXXXXXXXGXXXXXXXXXXXXXXXXXXXGXXXXXXXXXXXXXXXXXXXGXXXXXXXXXXXXXXXXXXXGXXXXXXXXXXXXXXXXXXXGXXXXXXXXXXXXXXXXXXXGXXXXXXXXXXXXXXXXXXXGXXXXXXXXXXXXXXXXXXXGXXXXXXXXXXXXXXXXXXXGXXXXXXXXXXXXXXXXXXXGXXXXXXXXXXXXXXXXXXXGXXXXXXXXXXXXXXXXXXXGXXXXXXXXXXXXXXXXXXX,0,300,0
17241,13,0,13,69,218,0,0,232,119,113,GXXXXXXXXXXXXXXXXXXXGXXXXXXXXXXXXXXXXXXXGXXXXXXXXXXXXXXXXXXXGXXXXXXXXXXXXXXXXXXXGXXXXXXXXXXXXXXXXXXXGXXXXXXXXXXXXXXXXXXXGXXXXXXXXXXXXXXXXXXXGXXXXXXXXXXXXXXXXXXXGXXXXXXXXXXXXXXXXXXXGXXXXXXXXXXXXXXXXXXXGXXXXXXXXXXXXXXXXXXXGXXXXXXXXXXXXXXXXXXXGXXXXXXXXXXXXXXXXXXX,0,300,0
17262,13,0,13,62,225,0,0,239,119,120,GXXXXXXXXXXXXXXXXXXXGXXXXXXXXXXXXXXXXXXXGXXXXXXXXXXXXXXXXXXXGXXXXXXXXXXXXXXXXXXXGXXXXXXXXXXXXXXXXXXXGXXXXXXXXXXXXXXXXXXXGXXXXXXXXXXXXXXXXXXXGXXXXXXXXXXXXXXXXXXXGXXXXXXXXXXXXXXXXXXXGXXXXXXXXXXXXXXXXXXXGXXXXXXXXXXXXXXXXXXXGXXXXXXXXXXXXXXXXXXXGXXXXXXXXXXXXXXXXXXX,0,300,0
17283,13,0,13,66,221,0,0,235,116,119,GXXXXXXXXXXXXXXXXXXXGXXXXXXXXXXXXXXXXXXXGXXXXXXXXXXXXXXXXXXXGXXXXXXXXXXXXXXXXXXXGXXXXXXXXXXXXXXXXXXXGXXXXXXXXXXXXXXXXXXXGXXXXXXXXXXXXXXXXXXXGXXXXXXXXXXXXXXXXXXXGXXXXXXXXXXXXXXXXXXXGXXXXXXXXXXXXXXXXXXXGXXXXXXXXXXXXXXXXXXXGXXXXXXXXXXXXXXXXXXXGXXXXXXXXXXXXXXXXXXX,0,300,0
17304,13,0,13,62,225,0,0,239,121,118,GXXXXXXXXXXXXXXXXXXXGXXXXXXXXXXXXXXXXXXXGXXXXXXXXXXXXXXXXXXXGXXXXXXXXXXXXXXXXXXXGXXXXXXXXXXXXXXXXXXXGXXXXXXXXXXXXXXXXXXXGXXXXXXXXXXXXXXXXXXXGXXXXXXXXXXXXXXXXXXXGXXXXXXXXXXXXXXXXXXXGXXXXXXXXXXXXXXXXXXXGXXXXXXXXXXXXXXXXXXXGXXXXXXXXXXXXXXXXXXXGXXXXXXXXXXXXXXXXXXX,0,300,0

17325,13,0,13,61,226,0,0,239,119,120,GXXXXXXXXXXXXXXXXXXXGXXXXXXXXXXXXXXXXXXXGXXXXXXXXXXXXXXXXXXXGXXXXXXXXXXXXXXXXXXXGXXXXXXXXXXXXXXXXXXXGXXXXXXXXXXXXXXXXXXXGXXXXXXXXXXXXXXXXXXXGXXXXXXXXXXXXXXXXXXXGXXXXXXXXXXXXXXXXXXXGXXXXXXXXXXXXXXXXXXXGXXXXXXXXXXXXXXXXXXXGXXXXXXXXXXXXXXXXXXXGXXXXXXXXXXXXXXXXXXX,0,300,0
17346,13,0,13,66,221,0,0,234,119,115,GXXXXXXXXXXXXXXXXXXXGXXXXXXXXXXXXXXXXXXXGXXXXXXXXXXXXXXXXXXXGXXXXXXXXXXXXXXXXXXXGXXXXXXXXXXXXXXXXXXXGXXXXXXXXXXXXXXXXXXXGXXXXXXXXXXXXXXXXXXXGXXXXXXXXXXXXXXXXXXXGXXXXXXXXXXXXXXXXXXXGXXXXXXXXXXXXXXXXXXXGXXXXXXXXXXXXXXXXXXXGXXXXXXXXXXXXXXXXXXXGXXXXXXXXXXXXXXXXXXX,0,300,0
17367,13,0,13,69,218,0,0,231,118,113,GXXXXXXXXXXXXXXXXXXXGXXXXXXXXXXXXXXXXXXXGXXXXXXXXXXXXXXXXXXXGXXXXXXXXXXXXXXXXXXXGXXXXXXXXXXXXXXXXXXXGXXXXXXXXXXXXXXXXXXXGXXXXXXXXXXXXXXXXXXXGXXXXXXXXXXXXXXXXXXXGXXXXXXXXXXXXXXXXXXXGXXXXXXXXXXXXXXXXXXXGXXXXXXXXXXXXXXXXXXXGXXXXXXXXXXXXXXXXXXXGXXXXXXXXXXXXXXXXXXX,0,300,0
17388,13,0,13,68,219,0,0,232,124,108,GXXXXXXXXXXXXXXXXXXXGXXXXXXXXXXXXXXXXXXXGXXXXXXXXXXXXXXXXXXXGXXXXXXXXXXXXXXXXXXXGXXXXXXXXXXXXXXXXXXXGXXXXXXXXXXXXXXXXXXXGXXXXXXXXXXXXXXXXXXXGXXXXXXXXXXXXXXXXXXXGXXXXXXXXXXXXXXXXXXXGXXXXXXXXXXXXXXXXXXXGXXXXXXXXXXXXXXXXXXXGXXXXXXXXXXXXXXXXXXXGXXXXXXXXXXXXXXXXXXX,0,300,0
17409,13,0,13,61,226,0,0,239,124,115,GXXXXXXXXXXXXXXXXXXXGXXXXXXXXXXXXXXXXXXXGXXXXXXXXXXXXXXXXXXXGXXXXXXXXXXXXXXXXXXXGXXXXXXXXXXXXXXXXXXXGXXXXXXXXXXXXXXXXXXXGXXXXXXXXXXXXXXXXXXXGXXXXXXXXXXXXXXXXXXXGXXXXXXXXXXXXXXXXXXXGXXXXXXXXXXXXXXXXXXXGXXXXXXXXXXXXXXXXXXXGXXXXXXXXXXXXXXXXXXXGXXXXXXXXXXXXXXXXXXX,0,300,0

17430,13,0,13,63,224,0,0,237,130,107,GXXXXXXXXXXXXXXXXXXXGXXXXXXXXXXXXXXXXXXXGXXXXXXXXXXXXXXXXXXXGXXXXXXXXXXXXXXXXXXXGXXXXXXXXXXXXXXXXXXXGXXXXXXXXXXXXXXXXXXXGXXXXXXXXXXXXXXXXXXXGXXXXXXXXXXXXXXXXXXXGXXXXXXXXXXXXXXXXXXXGXXXXXXXXXXXXXXXXXXXGXXXXXXXXXXXXXXXXXXXGXXXXXXXXXXXXXXXXXXXGXXXXXXXXXXXXXXXXXXX,0,300,0
17451,13,0,13,67,220,0,0,233,125,108,GXXXXXXXXXXXXXXXXXXXGXXXXXXXXXXXXXXXXXXXGXXXXXXXXXXXXXXXXXXXGXXXXXXXXXXXXXXXXXXXGXXXXXXXXXXXXXXXXXXXGXXXXXXXXXXXXXXXXXXXGXXXXXXXXXXXXXXXXXXXGXXXXXXXXXXXXXXXXXXXGXXXXXXXXXXXXXXXXXXXGXXXXXXXXXXXXXXXXXXXGXXXXXXXXXXXXXXXXXXXGXXXXXXXXXXXXXXXXXXXGXXXXXXXXXXXXXXXXXXX,0,300,0
17472,13,0,13,63,224,0,0,237,126,111,GXXXXXXXXXXXXXXXXXXXGXXXXXXXXXXXXXXXXXXXGXXXXXXXXXXXXXXXXXXXGXXXXXXXXXXXXXXXXXXXGXXXXXXXXXXXXXXXXXXXGXXXXXXXXXXXXXXXXXXXGXXXXXXXXXXXXXXXXXXXGXXXXXXXXXXXXXXXXXXXGXXXXXXXXXXXXXXXXXXXGXXXXXXXXXXXXXXXXXXXGXXXXXXXXXXXXXXXXXXXGXXXXXXXXXXXXXXXXXXXGXXXXXXXXXXXXXXXXXXX,0,300,0
17493,13,0,13,65,222,0,0,235,124,111,GXXXXXXXXXXXXXXXXXXXGXXXXXXXXXXXXXXXXXXXGXXXXXXXXXXXXXXXXXXXGXXXXXXXXXXXXXXXXXXXGXXXXXXXXXXXXXXXXXXXGXXXXXXXXXXXXXXXXXXXGXXXXXXXXXXXXXXXXXXXGXXXXXXXXXXXXXXXXXXXGXXXXXXXXXXXXXXXXXXXGXXXXXXXXXXXXXXXXXXXGXXXXXXXXXXXXXXXXXXXGXXXXXXXXXXXXXXXXXXXGXXXXXXXXXXXXXXXXXXX,0,300,0
17514,13,0,13,71,216,0,0,229,118,111,GXXXXXXXXXXXXXXXXXXXGXXXXXXXXXXXXXXXXXXXGXXXXXXXXXXXXXXXXXXXGXXXXXXXXXXXXXXXXXXXGXXXXXXXXXXXXXXXXXXXGXXXXXXXXXXXXXXXXXXXGXXXXXXXXXXXXXXXXXXXGXXXXXXXXXXXXXXXXXXXGXXXXXXXXXXXXXXXXXXXGXXXXXXXXXXXXXXXXXXXGXXXXXXXXXXXXXXXXXXXGXXXXXXXXXXXXXXXXXXXGXXXXXXXXXXXXXXXXXXX,0,300,0

17535,13,0,13,69,218,0,0,230,118,112,GXXXXXXXXXXXXXXXXXXXGXXXXXXXXXXXXXXXXXXXGXXXXXXXXXXXXXXXXXXXGXXXXXXXXXXXXXXXXXXXGXXXXXXXXXXXXXXXXXXXGXXXXXXXXXXXXXXXXXXXGXXXXXXXXXXXXXXXXXXXGXXXXXXXXXXXXXXXXXXXGXXXXXXXXXXXXXXXXXXXGXXXXXXXXXXXXXXXXXXXGXXXXXXXXXXXXXXXXXXXGXXXXXXXXXXXXXXXXXXXGXXXXXXXXXXXXXXXXXXX,0,300,0
17556,13,0,13,65,222,0,0,233,121,112,GXXXXXXXXXXXXXXXXXXXGXXXXXXXXXXXXXXXXXXXGXXXXXXXXXXXXXXXXXXXGXXXXXXXXXXXXXXXXXXXGXXXXXXXXXXXXXXXXXXXGXXXXXXXXXXXXXXXXXXXGXXXXXXXXXXXXXXXXXXXGXXXXXXXXXXXXXXXXXXXGXXXXXXXXXXXXXXXXXXXGXXXXXXXXXXXXXXXXXXXGXXXXXXXXXXXXXXXXXXXGXXXXXXXXXXXXXXXXXXXGXXXXXXXXXXXXXXXXXXX,0,300,0
17577,13,0,13,67,220,0,0,232,117,115,GXXXXXXXXXXXXXXXXXXXGXXXXXXXXXXXXXXXXXXXGXXXXXXXXXXXXXXXXXXXGXXXXXXXXXXXXXXXXXXXGXXXXXXXXXXXXXXXXXXXGXXXXXXXXXXXXXXXXXXXGXXXXXXXXXXXXXXXXXXXGXXXXXXXXXXXXXXXXXXXGXXXXXXXXXXXXXXXXXXXGXXXXXXXXXXXXXXXXXXXGXXXXXXXXXXXXXXXXXXXGXXXXXXXXXXXXXXXXXXXGXXXXXXXXXXXXXXXXXXX,0,300,0
17598,13,0,13,62,225,0,0,236,124,112,GXXXXXXXXXXXXXXXXXXXGXXXXXXXXXXXXXXXXXXXGXXXXXXXXXXXXXXXXXXXGXXXXXXXXXXXXXXXXXXXGXXXXXXXXXXXXXXXXXXXGXXXXXXXXXXXXXXXXXXXGXXXXXXXXXXXXXXXXXXXGXXXXXXXXXXXXXXXXXXXGXXXXXXXXXXXXXXXXXXXGXXXXXXXXXXXXXXXXXXXGXXXXXXXXXXXXXXXXXXXGXXXXXXXXXXXXXXXXXXXGXXXXXXXXXXXXXXXXXXX,0,300,0
17619,13,0,13,68,219,0,0,231,120,111,GXXXXXXXXXXXXXXXXXXXGXXXXXXXXXXXXXXXXXXXGXXXXXXXXXXXXXXXXXXXGXXXXXXXXXXXXXXXXXXXGXXXXXXXXXXXXXXXXXXXGXXXXXXXXXXXXXXXXXXXGXXXXXXXXXXXXXXXXXXXGXXXXXXXXXXXXXXXXXXXGXXXXXXXXXXXXXXXXXXXGXXXXXXXXXXXXXXXXXXXGXXXXXXXXXXXXXXXXXXXGXXXXXXXXXXXXXXXXXXXGXXXXXXXXXXXXXXXXXXX,0,300,0

17640,13,0,13,63,224,0,0,235,123,112,GXXXXXXXXXXXXXXXXXXXGXXXXXXXXXXXXXXXXXXXGXXXXXXXXXXXXXXXXXXXGXXXXXXXXXXXXXXXXXXXGXXXXXXXXXXXXXXXXXXXGXXXXXXXXXXXXXXXXXXXGXXXXXXXXXXXXXXXXXXXGXXXXXXXXXXXXXXXXXXXGXXXXXXXXXXXXXXXXXXXGXXXXXXXXXXXXXXXXXXXGXXXXXXXXXXXXXXXXXXXGXXXXXXXXXXXXXXXXXXXGXXXXXXXXXXXXXXXXXXX,0,300,0
17661,13,0,13,64,223,0,0,234,122,112,GXXXXXXXXXXXXXXXXXXXGXXXXXXXXXXXXXXXXXXXGXXXXXXXXXXXXXXXXXXXGXXXXXXXXXXXXXXXXXXXGXXXXXXXXXXXXXXXXXXXGXXXXXXXXXXXXXXXXXXXGXXXXXXXXXXXXXXXXXXXGXXXXXXXXXXXXXXXXXXXGXXXXXXXXXXXXXXXXXXXGXXXXXXXXXXXXXXXXXXXGXXXXXXXXXXXXXXXXXXXGXXXXXXXXXXXXXXXXXXXGXXXXXXXXXXXXXXXXXXX,0,300,0
17682,13,0,13,58,229,0,0,240,125,115,GXXXXXXXXXXXXXXXXXXXGXXXXXXXXXXXXXXXXXXXGXXXXXXXXXXXXXXXXXXXGXXXXXXXXXXXXXXXXXXXGXXXXXXXXXXXXXXXXXXXGXXXXXXXXXXXXXXXXXXXGXXXXXXXXXXXXXXXXXXXGXXXXXXXXXXXXXXXXXXXGXXXXXXXXXXXXXXXXXXXGXXXXXXXXXXXXXXXXXXXGXXXXXXXXXXXXXXXXXXXGXXXXXXXXXXXXXXXXXXXGXXXXXXXXXXXXXXXXXXX,0,300,0
17703,14,1,13,59,227,0,0,238,127,111,GXXXXXXXXXXXXXXXXXXXGXXXXXXXXXXXXXXXXXXXGXXXXXXXXXXXXXXXXXXXGXXXXXXXXXXXXXXXXXXXGAXXXXXXXXXXXXXXXXXXGXXXXXXXXXXXXXXXXXXXGXXXXXXXXXXXXXXXXXXXGXXXXXXXXXXXXXXXXXXXGXXXXXXXXXXXXXXXXXXXGXXXXXXXXXXXXXXXXXXXGXXXXXXXXXXXXXXXXXXXGXXXXXXXXXXXXXXXXXXXGXXXXXXXXXXXXXXXXXXX,0,300,0
17724,14,1,13,69,217,0,0,229,119,110,GXXXXXXXXXXXXXXXXXXXGXXXXXXXXXXXXXXXXXXXGXXXXXXXXXXXXXXXXXXXGXXXXXXXXXXXXXXXXXXXGAXXXXXXXXXXXXXXXXXXGXXXXXXXXXXXXXXXXXXXGXXXXXXXXXXXXXXXXXXXGXXXXXXXXXXXXXXXXXXXGXXXXXXXXXXXXXXXXXXXGXXXXXXXXXXXXXXXXXXXGXXXXXXXXXXXXXXXXXXXGXXXXXXXXXXXXXXXXXXXGXXXXXXXXXXXXXXXXXXX,0,300,0

17745,14,1,13,65,221,0,0,233,121,112,GXXXXXXXXXXXXXXXXXXXGXXXXXXXXXXXXXXXXXXXGXXXXXXXXXXXXXXXXXXXGXXXXXXXXXXXXXXXXXXXGAXXXXXXXXXXXXXXXXXXGXXXXXXXXXXXXXXXXXXXGXXXXXXXXXXXXXXXXXXXGXXXXXXXXXXXXXXXXXXXGXXXXXXXXXXXXXXXXXXXGXXXXXXXXXXXXXXXXXXXGXXXXXXXXXXXXXXXXXXXGXXXXXXXXXXXXXXXXXXXGXXXXXXXXXXXXXXXXXXX,0,300,0
17766,14,1,13,66,220,0,0,232,124,108,GXXXXXXXXXXXXXXXXXXXGXXXXXXXXXXXXXXXXXXXGXXXXXXXXXXXXXXXXXXXGXXXXXXXXXXXXXXXXXXXGAXXXXXXXXXXXXXXXXXXGXXXXXXXXXXXXXXXXXXXGXXXXXXXXXXXXXXXXXXXGXXXXXXXXXXXXXXXXXXXGXXXXXXXXXXXXXXXXXXXGXXXXXXXXXXXXXXXXXXXGXXXXXXXXXXXXXXXXXXXGXXXXXXXXXXXXXXXXXXXGXXXXXXXXXXXXXXXXXXX,0,300,0
17787,14,1,13,71,215,0,0,227,123,104,GXXXXXXXXXXXXXXXXXXXGXXXXXXXXXXXXXXXXXXXGXXXXXXXXXXXXXXXXXXXGXXXXXXXXXXXXXXXXXXXGAXXXXXXXXXXXXXXXXXXGXXXXXXXXXXXXXXXXXXXGXXXXXXXXXXXXXXXXXXXGXXXXXXXXXXXXXXXXXXXGXXXXXXXXXXXXXXXXXXXGXXXXXXXXXXXXXXXXXXXGXXXXXXXXXXXXXXXXXXXGXXXXXXXXXXXXXXXXXXXGXXXXXXXXXXXXXXXXXXX,0,300,0
17808,14,1,13,71,215,0,0,227,126,101,GXXXXXXXXXXXXXXXXXXXGXXXXXXXXXXXXXXXXXXXGXXXXXXXXXXXXXXXXXXXGXXXXXXXXXXXXXXXXXXXGAXXXXXXXXXXXXXXXXXXGXXXXXXXXXXXXXXXXXXXGXXXXXXXXXXXXXXXXXXXGXXXXXXXXXXXXXXXXXXXGXXXXXXXXXXXXXXXXXXXGXXXXXXXXXXXXXXXXXXXGXXXXXXXXXXXXXXXXXXXGXXXXXXXXXXXXXXXXXXXGXXXXXXXXXXXXXXXXXXX,0,300,0
17829,14,1,13,74,212,0,0,224,125,99,GXXXXXXXXXXXXXXXXXXXGXXXXXXXXXXXXXXXXXXXGXXXXXXXXXXXXXXXXXXXGXXXXXXXXXXXXXXXXXXXGAXXXXXXXXXXXXXXXXXXGXXXXXXXXXXXXXXXXXXXGXXXXXXXXXXXXXXXXXXXGXXXXXXXXXXXXXXXXXXXGXXXXXXXXXXXXXXXXXXXGXXXXXXXXXXXXXXXXXXXGXXXXXXXXXXXXXXXXXXXGXXXXXXXXXXXXXXXXXXXGXXXXXXXXXXXXXXXXXXX,0,300,0

17850,14,1,13,72,214,0,0,226,123,103,GXXXXXXXXXXXXXXXXXXXGXXXXXXXXXXXXXXXXXXXGXXXXXXXXXXXXXXXXXXXGXXXXXXXXXXXXXXXXXXXGAXXXXXXXXXXXXXXXXXXGXXXXXXXXXXXXXXXXXXXGXXXXXXXXXXXXXXXXXXXGXXXXXXXXXXXXXXXXXXXGXXXXXXXXXXXXXXXXXXXGXXXXXXXXXXXXXXXXXXXGXXXXXXXXXXXXXXXXXXXGXXXXXXXXXXXXXXXXXXXGXXXXXXXXXXXXXXXXXXX,0,300,0
17871,14,1,13,73,213,0,0,224,120,104,GXXXXXXXXXXXXXXXXXXXGXXXXXXXXXXXXXXXXXXXGXXXXXXXXXXXXXXXXXXXGXXXXXXXXXXXXXXXXXXXGAXXXXXXXXXXXXXXXXXXGXXXXXXXXXXXXXXXXXXXGXXXXXXXXXXXXXXXXXXXGXXXXXXXXXXXXXXXXXXXGXXXXXXXXXXXXXXXXXXXGXXXXXXXXXXXXXXXXXXXGXXXXXXXXXXXXXXXXXXXGXXXXXXXXXXXXXXXXXXXGXXXXXXXXXXXXXXXXXXX,0,300,0
17892,14,1,13,69,217,0,0,229,120,109,GXXXXXXXXXXXXXXXXXXXGXXXXXXXXXXXXXXXXXXXGXXXXXXXXXXXXXXXXXXXGXXXXXXXXXXXXXXXXXXXGAXXXXXXXXXXXXXXXXXXGXXXXXXXXXXXXXXXXXXXGXXXXXXXXXXXXXXXXXXXGXXXXXXXXXXXXXXXXXXXGXXXXXXXXXXXXXXXXXXXGXXXXXXXXXXXXXXXXXXXGXXXXXXXXXXXXXXXXXXXGXXXXXXXXXXXXXXXXXXXGXXXXXXXXXXXXXXXXXXX,0,300,0
17913,13,0,13,68,219,0,0,228,123,105,GXXXXXXXXXXXXXXXXXXXGXXXXXXXXXXXXXXXXXXXGXXXXXXXXXXXXXXXXXXXGXXXXXXXXXXXXXXXXXXXGXXXXXXXXXXXXXXXXXXXGXXXXXXXXXXXXXXXXXXXGXXXXXXXXXXXXXXXXXXXGXXXXXXXXXXXXXXXXXXXGXXXXXXXXXXXXXXXXXXXGXXXXXXXXXXXXXXXXXXXGXXXXXXXXXXXXXXXXXXXGXXXXXXXXXXXXXXXXXXXGXXXXXXXXXXXXXXXXXXX,0,300,0
17934,13,0,13,63,224,0,0,236,128,108,GXXXXXXXXXXXXXXXXXXXGXXXXXXXXXXXXXXXXXXXGXXXXXXXXXXXXXXXXXXXGXXXXXXXXXXXXXXXXXXXGXXXXXXXXXXXXXXXXXXXGXXXXXXXXXXXXXXXXXXXGXXXXXXXXXXXXXXXXXXXGXXXXXXXXXXXXXXXXXXXGXXXXXXXXXXXXXXXXXXXGXXXXXXXXXXXXXXXXXXXGXXXXXXXXXXXXXXXXXXXGXXXXXXXXXXXXXXXXXXXGXXXXXXXXXXXXXXXXXXX,0,300,0

17955,13,0,13,61,226,0,0,238,128,110,GXXXXXXXXXXXXXXXXXXXGXXXXXXXXXXXXXXXXXXXGXXXXXXXXXXXXXXXXXXXGXXXXXXXXXXXXXXXXXXXGXXXXXXXXXXXXXXXXXXXGXXXXXXXXXXXXXXXXXXXGXXXXXXXXXXXXXXXXXXXGXXXXXXXXXXXXXXXXXXXGXXXXXXXXXXXXXXXXXXXGXXXXXXXXXXXXXXXXXXXGXXXXXXXXXXXXXXXXXXXGXXXXXXXXXXXXXXXXXXXGXXXXXXXXXXXXXXXXXXX,0,300,0
17976,13,0,13,60,227,0,0,239,127,112,GXXXXXXXXXXXXXXXXXXXGXXXXXXXXXXXXXXXXXXXGXXXXXXXXXXXXXXXXXXXGXXXXXXXXXXXXXXXXXXXGXXXXXXXXXXXXXXXXXXXGXXXXXXXXXXXXXXXXXXXGXXXXXXXXXXXXXXXXXXXGXXXXXXXXXXXXXXXXXXXGXXXXXXXXXXXXXXXXXXXGXXXXXXXXXXXXXXXXXXXGXXXXXXXXXXXXXXXXXXXGXXXXXXXXXXXXXXXXXXXGXXXXXXXXXXXXXXXXXXX,0,300,0
17997,13,0,13,60,227,0,0,239,128,111,GXXXXXXXXXXXXXXXXXXXGXXXXXXXXXXXXXXXXXXXGXXXXXXXXXXXXXXXXXXXGXXXXXXXXXXXXXXXXXXXGXXXXXXXXXXXXXXXXXXXGXXXXXXXXXXXXXXXXXXXGXXXXXXXXXXXXXXXXXXXGXXXXXXXXXXXXXXXXXXXGXXXXXXXXXXXXXXXXXXXGXXXXXXXXXXXXXXXXXXXGXXXXXXXXXXXXXXXXXXXGXXXXXXXXXXXXXXXXXXXGXXXXXXXXXXXXXXXXXXX,0,300,0
18018,13,0,13,68,219,0,0,230,126,104,GXXXXXXXXXXXXXXXXXXXGXXXXXXXXXXXXXXXXXXXGXXXXXXXXXXXXXXXXXXXGXXXXXXXXXXXXXXXXXXXGXXXXXXXXXXXXXXXXXXXGXXXXXXXXXXXXXXXXXXXGXXXXXXXXXXXXXXXXXXXGXXXXXXXXXXXXXXXXXXXGXXXXXXXXXXXXXXXXXXXGXXXXXXXXXXXXXXXXXXXGXXXXXXXXXXXXXXXXXXXGXXXXXXXXXXXXXXXXXXXGXXXXXXXXXXXXXXXXXXX,0,300,0
18039,13,0,13,71,216,0,0,227,122,105,GXXXXXXXXXXXXXXXXXXXGXXXXXXXXXXXXXXXXXXXGXXXXXXXXXXXXXXXXXXXGXXXXXXXXXXXXXXXXXXXGXXXXXXXXXXXXXXXXXXXGXXXXXXXXXXXXXXXXXXXGXXXXXXXXXXXXXXXXXXXGXXXXXXXXXXXXXXXXXXXGXXXXXXXXXXXXXXXXXXXGXXXXXXXXXXXXXXXXXXXGXXXXXXXXXXXXXXXXXXXGXXXXXXXXXXXXXXXXXXXGXXXXXXXXXXXXXXXXXXX,0,300,0

18060,13,0,13,70,217,0,0,228,117,111,GXXXXXXXXXXXXXXXXXXXGXXXXXXXXXXXXXXXXXXXGXXXXXXXXXXXXXXXXXXXGXXXXXXXXXXXXXXXXXXXGXXXXXXXXXXXXXXXXXXXGXXXXXXXXXXXXXXXXXXXGXXXXXXXXXXXXXXXXXXXGXXXXXXXXXXXXXXXXXXXGXXXXXXXXXXXXXXXXXXXGXXXXXXXXXXXXXXXXXXXGXXXXXXXXXXXXXXXXXXXGXXXXXXXXXXXXXXXXXXXGXXXXXXXXXXXXXXXXXXX,0,300,0
18081,13,0,13,69,218,0,0,228,116,112,GXXXXXXXXXXXXXXXXXXXGXXXXXXXXXXXXXXXXXXXGXXXXXXXXXXXXXXXXXXXGXXXXXXXXXXXXXXXXXXXGXXXXXXXXXXXXXXXXXXXGXXXXXXXXXXXXXXXXXXXGXXXXXXXXXXXXXXXXXXXGXXXXXXXXXXXXXXXXXXXGXXXXXXXXXXXXXXXXXXXGXXXXXXXXXXXXXXXXXXXGXXXXXXXXXXXXXXXXXXXGXXXXXXXXXXXXXXXXXXXGXXXXXXXXXXXXXXXXXXX,0,300,0
18102,14,1,13,70,216,0,0,228,117,111,GXXXXXXXXXXXXXXXXXXXGXXXXXXXXXXXXXXXXXXXGXXXXXXXXXXXXXXXXXXXGXXXXXXXXXXXXXXXXXXXGXXXXXXXXXXXXXXXXXXXGXXXXXXXXXXXXXXXXXXXGXXXXXXXXXXXXXXXXXXXGXXXXXXXXXXXXXXXXXXXGXXXXXXXXXXXXXXXXXXXGXXXXXXXXXXXXXXXXXXXGXXXXXXXXXXXXXXXXXXXGXXXXXXXXXXXXXXXXXXXGAXXXXXXXXXXXXXXXXXX,0,300,0
18123,14,1,13,67,219,0,0,230,121,109,GXXXXXXXXXXXXXXXXXXXGXXXXXXXXXXXXXXXXXXXGXXXXXXXXXXXXXXXXXXXGXXXXXXXXXXXXXXXXXXXGXXXXXXXXXXXXXXXXXXXGXXXXXXXXXXXXXXXXXXXGXXXXXXXXXXXXXXXXXXXGXXXXXXXXXXXXXXXXXXXGXXXXXXXXXXXXXXXXXXXGXXXXXXXXXXXXXXXXXXXGXXXXXXXXXXXXXXXXXXXGXXXXXXXXXXXXXXXXXXXGAXXXXXXXXXXXXXXXXXX,0,300,0
18144,14,1,13,61,225,0,0,237,124,113,GXXXXXXXXXXXXXXXXXXXGXXXXXXXXXXXXXXXXXXXGXXXXXXXXXXXXXXXXXXXGXXXXXXXXXXXXXXXXXXXGXXXXXXXXXXXXXXXXXXXGXXXXXXXXXXXXXXXXXXXGXXXXXXXXXXXXXXXXXXXGXXXXXXXXXXXXXXXXXXXGXXXXXXXXXXXXXXXXXXXGXXXXXXXXXXXXXXXXXXXGXXXXXXXXXXXXXXXXXXXGXXXXXXXXXXXXXXXXXXXGAXXXXXXXXXXXXXXXXXX,0,300,0

18165,14,1,13,64,222,0,0,234,120,114,GXXXXXXXXXXXXXXXXXXXGXXXXXXXXXXXXXXXXXXXGXXXXXXXXXXXXXXXXXXXGXXXXXXXXXXXXXXXXXXXGXXXXXXXXXXXXXXXXXXXGXXXXXXXXXXXXXXXXXXXGXXXXXXXXXXXXXXXXXXXGXXXXXXXXXXXXXXXXXXXGXXXXXXXXXXXXXXXXXXXGXXXXXXXXXXXXXXXXXXXGXXXXXXXXXXXXXXXXXXXGXXXXXXXXXXXXXXXXXXXGAXXXXXXXXXXXXXXXXXX,0,300,0
18186,14,1,13,66,220,0,0,232,122,110,GXXXXXXXXXXXXXXXXXXXGXXXXXXXXXXXXXXXXXXXGXXXXXXXXXXXXXXXXXXXGXXXXXXXXXXXXXXXXXXXGXXXXXXXXXXXXXXXXXXXGXXXXXXXXXXXXXXXXXXXGXXXXXXXXXXXXXXXXXXXGXXXXXXXXXXXXXXXXXXXGXXXXXXXXXXXXXXXXXXXGXXXXXXXXXXXXXXXXXXXGXXXXXXXXXXXXXXXXXXXGXXXXXXXXXXXXXXXXXXXGAXXXXXXXXXXXXXXXXXX,0,300,0
18207,14,1,13,63,223,0,0,235,118,117,GXXXXXXXXXXXXXXXXXXXGXXXXXXXXXXXXXXXXXXXGXXXXXXXXXXXXXXXXXXXGXXXXXXXXXXXXXXXXXXXGXXXXXXXXXXXXXXXXXXXGXXXXXXXXXXXXXXXXXXXGXXXXXXXXXXXXXXXXXXXGXXXXXXXXXXXXXXXXXXXGXXXXXXXXXXXXXXXXXXXGXXXXXXXXXXXXXXXXXXXGXXXXXXXXXXXXXXXXXXXGXXXXXXXXXXXXXXXXXXXGAXXXXXXXXXXXXXXXXXX,0,300,0
18228,14,1,13,58,228,0,0,239,119,120,GXXXXXXXXXXXXXXXXXXXGXXXXXXXXXXXXXXXXXXXGXXXXXXXXXXXXXXXXXXXGXXXXXXXXXXXXXXXXXXXGXXXXXXXXXXXXXXXXXXXGXXXXXXXXXXXXXXXXXXXGXXXXXXXXXXXXXXXXXXXGXXXXXXXXXXXXXXXXXXXGXXXXXXXXXXXXXXXXXXXGXXXXXXXXXXXXXXXXXXXGXXXXXXXXXXXXXXXXXXXGXXXXXXXXXXXXXXXXXXXGAXXXXXXXXXXXXXXXXXX,0,300,0
18249,14,1,13,58,228,0,0,240,119,121,GXXXXXXXXXXXXXXXXXXXGXXXXXXXXXXXXXXXXXXXGXXXXXXXXXXXXXXXXXXXGXXXXXXXXXXXXXXXXXXXGXXXXXXXXXXXXXXXXXXXGXXXXXXXXXXXXXXXXXXXGXXXXXXXXXXXXXXXXXXXGXXXXXXXXXXXXXXXXXXXGXXXXXXXXXXXXXXXXXXXGXXXXXXXXXXXXXXXXXXXGXXXXXXXXXXXXXXXXXXXGXXXXXXXXXXXXXXXXXXXGAXXXXXXXXXXXXXXXXXX,0,300,0

18270,14,1,13,59,227,0,0,239,117,122,GXXXXXXXXXXXXXXXXXXXGXXXXXXXXXXXXXXXXXXXGXXXXXXXXXXXXXXXXXXXGXXXXXXXXXXXXXXXXXXXGXXXXXXXXXXXXXXXXXXXGXXXXXXXXXXXXXXXXXXXGXXXXXXXXXXXXXXXXXXXGXXXXXXXXXXXXXXXXXXXGXXXXXXXXXXXXXXXXXXXGXXXXXXXXXXXXXXXXXXXGXXXXXXXXXXXXXXXXXXXGXXXXXXXXXXXXXXXXXXXGAXXXXXXXXXXXXXXXXXX,0,300,0
18291,14,1,13,58,228,0,0,240,121,119,GXXXXXXXXXXXXXXXXXXXGXXXXXXXXXXXXXXXXXXXGXXXXXXXXXXXXXXXXXXXGXXXXXXXXXXXXXXXXXXXGXXXXXXXXXXXXXXXXXXXGXXXXXXXXXXXXXXXXXXXGXXXXXXXXXXXXXXXXXXXGXXXXXXXXXXXXXXXXXXXGXXXXXXXXXXXXXXXXXXXGXXXXXXXXXXXXXXXXXXXGXXXXXXXXXXXXXXXXXXXGXXXXXXXXXXXXXXXXXXXGAXXXXXXXXXXXXXXXXXX,0,300,0
18312,13,0,13,59,228,0,0,240,129,111,GXXXXXXXXXXXXXXXXXXXGXXXXXXXXXXXXXXXXXXXGXXXXXXXXXXXXXXXXXXXGXXXXXXXXXXXXXXXXXXXGXXXXXXXXXXXXXXXXXXXGXXXXXXXXXXXXXXXXXXXGXXXXXXXXXXXXXXXXXXXGXXXXXXXXXXXXXXXXXXXGXXXXXXXXXXXXXXXXXXXGXXXXXXXXXXXXXXXXXXXGXXXXXXXXXXXXXXXXXXXGXXXXXXXXXXXXXXXXXXXGXXXXXXXXXXXXXXXXXXX,0,300,0
18333,13,0,13,58,229,0,0,241,130,111,GXXXXXXXXXXXXXXXXXXXGXXXXXXXXXXXXXXXXXXXGXXXXXXXXXXXXXXXXXXXGXXXXXXXXXXXXXXXXXXXGXXXXXXXXXXXXXXXXXXXGXXXXXXXXXXXXXXXXXXXGXXXXXXXXXXXXXXXXXXXGXXXXXXXXXXXXXXXXXXXGXXXXXXXXXXXXXXXXXXXGXXXXXXXXXXXXXXXXXXXGXXXXXXXXXXXXXXXXXXXGXXXXXXXXXXXXXXXXXXXGXXXXXXXXXXXXXXXXXXX,0,300,0
18354,13,0,13,66,221,0,0,233,128,105,GXXXXXXXXXXXXXXXXXXXGXXXXXXXXXXXXXXXXXXXGXXXXXXXXXXXXXXXXXXXGXXXXXXXXXXXXXXXXXXXGXXXXXXXXXXXXXXXXXXXGXXXXXXXXXXXXXXXXXXXGXXXXXXXXXXXXXXXXXXXGXXXXXXXXXXXXXXXXXXXGXXXXXXXXXXXXXXXXXXXGXXXXXXXXXXXXXXXXXXXGXXXXXXXXXXXXXXXXXXXGXXXXXXXXXXXXXXXXXXXGXXXXXXXXXXXXXXXXXXX,0,300,0

18375,13,0,13,62,225,0,0,236,132,104,GXXXXXXXXXXXXXXXXXXXGXXXXXXXXXXXXXXXXXXXGXXXXXXXXXXXXXXXXXXXGXXXXXXXXXXXXXXXXXXXGXXXXXXXXXXXXXXXXXXXGXXXXXXXXXXXXXXXXXXXGXXXXXXXXXXXXXXXXXXXGXXXXXXXXXXXXXXXXXXXGXXXXXXXXXXXXXXXXXXXGXXXXXXXXXXXXXXXXXXXGXXXXXXXXXXXXXXXXXXXGXXXXXXXXXXXXXXXXXXXGXXXXXXXXXXXXXXXXXXX,0,300,0
18396,13,0,13,65,222,0,0,233,127,106,GXXXXXXXXXXXXXXXXXXXGXXXXXXXXXXXXXXXXXXXGXXXXXXXXXXXXXXXXXXXGXXXXXXXXXXXXXXXXXXXGXXXXXXXXXXXXXXXXXXXGXXXXXXXXXXXXXXXXXXXGXXXXXXXXXXXXXXXXXXXGXXXXXXXXXXXXXXXXXXXGXXXXXXXXXXXXXXXXXXXGXXXXXXXXXXXXXXXXXXXGXXXXXXXXXXXXXXXXXXXGXXXXXXXXXXXXXXXXXXXGXXXXXXXXXXXXXXXXXXX,0,300,0
18417,14,1,13,67,219,0,0,230,125,105,GXXXXXXXXXXXXXXXXXXXGXXXXXXXXXXXXXXXXXXXGXXXXXXXXXXXXXXXXXXXGXXXXXXXXXXXXXXXXXXXGXXXXXXXXXXXXXXXXXXXGXXXXXXXXXXXXXXXXXXXGXXXXXXXXXXXXXXXXXXXGXXXXXXXXXXXXXXXXXXXGXXXXXXXXXXXXXXXXXXXGAXXXXXXXXXXXXXXXXXXGXXXXXXXXXXXXXXXXXXXGXXXXXXXXXXXXXXXXXXXGXXXXXXXXXXXXXXXXXXX,0,300,0
18438,14,1,13,63,223,0,0,235,122,113,GXXXXXXXXXXXXXXXXXXXGXXXXXXXXXXXXXXXXXXXGXXXXXXXXXXXXXXXXXXXGXXXXXXXXXXXXXXXXXXXGXXXXXXXXXXXXXXXXXXXGXXXXXXXXXXXXXXXXXXXGXXXXXXXXXXXXXXXXXXXGXXXXXXXXXXXXXXXXXXXGXXXXXXXXXXXXXXXXXXXGAXXXXXXXXXXXXXXXXXXGXXXXXXXXXXXXXXXXXXXGXXXXXXXXXXXXXXXXXXXGXXXXXXXXXXXXXXXXXXX,0,300,0
18459,14,1,13,65,221,0,0,233,121,112,GXXXXXXXXXXXXXXXXXXXGXXXXXXXXXXXXXXXXXXXGXXXXXXXXXXXXXXXXXXXGXXXXXXXXXXXXXXXXXXXGXXXXXXXXXXXXXXXXXXXGXXXXXXXXXXXXXXXXXXXGXXXXXXXXXXXXXXXXXXXGXXXXXXXXXXXXXXXXXXXGXXXXXXXXXXXXXXXXXXXGAXXXXXXXXXXXXXXXXXXGXXXXXXXXXXXXXXXXXXXGXXXXXXXXXXXXXXXXXXXGXXXXXXXXXXXXXXXXXXX,0,300,0

18480,14,1,13,59,227,0,0,239,122,117,GXXXXXXXXXXXXXXXXXXXGXXXXXXXXXXXXXXXXXXXGXXXXXXXXXXXXXXXXXXXGXXXXXXXXXXXXXXXXXXXGXXXXXXXXXXXXXXXXXXXGXXXXXXXXXXXXXXXXXXXGXXXXXXXXXXXXXXXXXXXGXXXXXXXXXXXXXXXXXXXGXXXXXXXXXXXXXXXXXXXGAXXXXXXXXXXXXXXXXXXGXXXXXXXXXXXXXXXXXXXGXXXXXXXXXXXXXXXXXXXGXXXXXXXXXXXXXXXXXXX,0,300,0
18501,14,1,13,56,230,0,0,242,124,118,GXXXXXXXXXXXXXXXXXXXGXXXXXXXXXXXXXXXXXXXGXXXXXXXXXXXXXXXXXXXGXXXXXXXXXXXXXXXXXXXGXXXXXXXXXXXXXXXXXXXGXXXXXXXXXXXXXXXXXXXGXXXXXXXXXXXXXXXXXXXGXXXXXXXXXXXXXXXXXXXGXXXXXXXXXXXXXXXXXXXGAXXXXXXXXXXXXXXXXXXGXXXXXXXXXXXXXXXXXXXGXXXXXXXXXXXXXXXXXXXGXXXXXXXXXXXXXXXXXXX,0,300,0
18522,14,1,13,57,229,0,0,242,124,118,GXXXXXXXXXXXXXXXXXXXGXXXXXXXXXXXXXXXXXXXGXXXXXXXXXXXXXXXXXXXGXXXXXXXXXXXXXXXXXXXGXXXXXXXXXXXXXXXXXXXGXXXXXXXXXXXXXXXXXXXGXXXXXXXXXXXXXXXXXXXGXXXXXXXXXXXXXXXXXXXGXXXXXXXXXXXXXXXXXXXGAXXXXXXXXXXXXXXXXXXGXXXXXXXXXXXXXXXXXXXGXXXXXXXXXXXXXXXXXXXGXXXXXXXXXXXXXXXXXXX,0,300,0
18543,14,0,14,57,229,0,0,242,126,116,GXXXXXXXXXXXXXXXXXXXGXXXXXXXXXXXXXXXXXXXGXXXXXXXXXXXXXXXXXXXGXXXXXXXXXXXXXXXXXXXGXXXXXXXXXXXXXXXXXXXGXXXXXXXXXXXXXXXXXXXGXXXXXXXXXXXXXXXXXXXGXXXXXXXXXXXXXXXXXXXGXXXXXXXXXXXXXXXXXXXGOXXXXXXXXXXXXXXXXXXGXXXXXXXXXXXXXXXXXXXGXXXXXXXXXXXXXXXXXXXGXXXXXXXXXXXXXXXXXXX,0,300,0
18564,13,0,13,60,227,0,0,239,123,116,GXXXXXXXXXXXXXXXXXXXGXXXXXXXXXXXXXXXXXXXGXXXXXXXXXXXXXXXXXXXGXXXXXXXXXXXXXXXXXXXGXXXXXXXXXXXXXXXXXXXGXXXXXXXXXXXXXXXXXXXGXXXXXXXXXXXXXXXXXXXGXXXXXXXXXXXXXXXXXXXGXXXXXXXXXXXXXXXXXXXGXXXXXXXXXXXXXXXXXXXGXXXXXXXXXXXXXXXXXXXGXXXXXXXXXXXXXXXXXXXGXXXXXXXXXXXXXXXXXXX,0,300,0

18585,13,0,13,64,223,0,0,235,121,114,GXXXXXXXXXXXXXXXXXXXGXXXXXXXXXXXXXXXXXXXGXXXXXXXXXXXXXXXXXXXGXXXXXXXXXXXXXXXXXXXGXXXXXXXXXXXXXXXXXXXGXXXXXXXXXXXXXXXXXXXGXXXXXXXXXXXXXXXXXXXGXXXXXXXXXXXXXXXXXXXGXXXXXXXXXXXXXXXXXXXGXXXXXXXXXXXXXXXXXXXGXXXXXXXXXXXXXXXXXXXGXXXXXXXXXXXXXXXXXXXGXXXXXXXXXXXXXXXXXXX,0,300,0
18606,13,0,13,57,230,0,0,244,124,120,GXXXXXXXXXXXXXXXXXXXGXXXXXXXXXXXXXXXXXXXGXXXXXXXXXXXXXXXXXXXGXXXXXXXXXXXXXXXXXXXGXXXXXXXXXXXXXXXXXXXGXXXXXXXXXXXXXXXXXXXGXXXXXXXXXXXXXXXXXXXGXXXXXXXXXXXXXXXXXXXGXXXXXXXXXXXXXXXXXXXGXXXXXXXXXXXXXXXXXXXGXXXXXXXXXXXXXXXXXXXGXXXXXXXXXXXXXXXXXXXGXXXXXXXXXXXXXXXXXXX,0,300,0
18627,13,0,13,61,226,0,0,239,124,115,GXXXXXXXXXXXXXXXXXXXGXXXXXXXXXXXXXXXXXXXGXXXXXXXXXXXXXXXXXXXGXXXXXXXXXXXXXXXXXXXGXXXXXXXXXXXXXXXXXXXGXXXXXXXXXXXXXXXXXXXGXXXXXXXXXXXXXXXXXXXGXXXXXXXXXXXXXXXXXXXGXXXXXXXXXXXXXXXXXXXGXXXXXXXXXXXXXXXXXXXGXXXXXXXXXXXXXXXXXXXGXXXXXXXXXXXXXXXXXXXGXXXXXXXXXXXXXXXXXXX,0,300,0
18648,13,0,13,61,226,0,0,239,124,115,GXXXXXXXXXXXXXXXXXXXGXXXXXXXXXXXXXXXXXXXGXXXXXXXXXXXXXXXXXXXGXXXXXXXXXXXXXXXXXXXGXXXXXXXXXXXXXXXXXXXGXXXXXXXXXXXXXXXXXXXGXXXXXXXXXXXXXXXXXXXGXXXXXXXXXXXXXXXXXXXGXXXXXXXXXXXXXXXXXXXGXXXXXXXXXXXXXXXXXXXGXXXXXXXXXXXXXXXXXXXGXXXXXXXXXXXXXXXXXXXGXXXXXXXXXXXXXXXXXXX,0,300,0
18669,13,0,13,61,226,0,0,238,122,116,GXXXXXXXXXXXXXXXXXXXGXXXXXXXXXXXXXXXXXXXGXXXXXXXXXXXXXXXXXXXGXXXXXXXXXXXXXXXXXXXGXXXXXXXXXXXXXXXXXXXGXXXXXXXXXXXXXXXXXXXGXXXXXXXXXXXXXXXXXXXGXXXXXXXXXXXXXXXXXXXGXXXXXXXXXXXXXXXXXXXGXXXXXXXXXXXXXXXXXXXGXXXXXXXXXXXXXXXXXXXGXXXXXXXXXXXXXXXXXXXGXXXXXXXXXXXXXXXXXXX,0,300,0

18690,14,1,13,57,229,0,0,240,129,111,GXXXXXXXXXXXXXXXXXXXGXXXXXXXXXXXXXXXXXXXGXXXXXXXXXXXXXXXXXXXGXXXXXXXXXXXXXXXXXXXGXXXXXXXXXXXXXXXXXXXGAXXXXXXXXXXXXXXXXXXGXXXXXXXXXXXXXXXXXXXGXXXXXXXXXXXXXXXXXXXGXXXXXXXXXXXXXXXXXXXGXXXXXXXXXXXXXXXXXXXGXXXXXXXXXXXXXXXXXXXGXXXXXXXXXXXXXXXXXXXGXXXXXXXXXXXXXXXXXXX,0,300,0
18711,14,1,13,58,228,0,0,239,126,113,GXXXXXXXXXXXXXXXXXXXGXXXXXXXXXXXXXXXXXXXGXXXXXXXXXXXXXXXXXXXGXXXXXXXXXXXXXXXXXXXGXXXXXXXXXXXXXXXXXXXGAXXXXXXXXXXXXXXXXXXGXXXXXXXXXXXXXXXXXXXGXXXXXXXXXXXXXXXXXXXGXXXXXXXXXXXXXXXXXXXGXXXXXXXXXXXXXXXXXXXGXXXXXXXXXXXXXXXXXXXGXXXXXXXXXXXXXXXXXXXGXXXXXXXXXXXXXXXXXXX,0,300,0
18732,14,1,13,67,219,0,0,231,123,108,GXXXXXXXXXXXXXXXXXXXGXXXXXXXXXXXXXXXXXXXGXXXXXXXXXXXXXXXXXXXGXXXXXXXXXXXXXXXXXXXGXXXXXXXXXXXXXXXXXXXGAXXXXXXXXXXXXXXXXXXGXXXXXXXXXXXXXXXXXXXGXXXXXXXXXXXXXXXXXXXGXXXXXXXXXXXXXXXXXXXGXXXXXXXXXXXXXXXXXXXGXXXXXXXXXXXXXXXXXXXGXXXXXXXXXXXXXXXXXXXGXXXXXXXXXXXXXXXXXXX,0,300,0
18753,15,2,13,66,219,0,0,230,128,102,GXXXXXXXXXXXXXXXXXXXGAXXXXXXXXXXXXXXXXXXGXXXXXXXXXXXXXXXXXXXGXXXXXXXXXXXXXXXXXXXGXXXXXXXXXXXXXXXXXXXGAXXXXXXXXXXXXXXXXXXGXXXXXXXXXXXXXXXXXXXGXXXXXXXXXXXXXXXXXXXGXXXXXXXXXXXXXXXXXXXGXXXXXXXXXXXXXXXXXXXGXXXXXXXXXXXXXXXXXXXGXXXXXXXXXXXXXXXXXXXGXXXXXXXXXXXXXXXXXXX,0,300,0
18774,15,2,13,69,216,0,0,228,130,98,GXXXXXXXXXXXXXXXXXXXGAXXXXXXXXXXXXXXXXXXGXXXXXXXXXXXXXXXXXXXGXXXXXXXXXXXXXXXXXXXGXXXXXXXXXXXXXXXXXXXGAXXXXXXXXXXXXXXXXXXGXXXXXXXXXXXXXXXXXXXGXXXXXXXXXXXXXXXXXXXGXXXXXXXXXXXXXXXXXXXGXXXXXXXXXXXXXXXXXXXGXXXXXXXXXXXXXXXXXXXGXXXXXXXXXXXXXXXXXXXGXXXXXXXXXXXXXXXXXXX,0,300,0

18795,15,2,13,72,213,0,0,225,126,99,GXXXXXXXXXXXXXXXXXXXGAXXXXXXXXXXXXXXXXXXGXXXXXXXXXXXXXXXXXXXGXXXXXXXXXXXXXXXXXXXGXXXXXXXXXXXXXXXXXXXGAXXXXXXXXXXXXXXXXXXGXXXXXXXXXXXXXXXXXXXGXXXXXXXXXXXXXXXXXXXGXXXXXXXXXXXXXXXXXXXGXXXXXXXXXXXXXXXXXXXGXXXXXXXXXXXXXXXXXXXGXXXXXXXXXXXXXXXXXXXGXXXXXXXXXXXXXXXXXXX,0,300,0
18816,15,2,13,69,216,0,0,228,128,100,GXXXXXXXXXXXXXXXXXXXGAXXXXXXXXXXXXXXXXXXGXXXXXXXXXXXXXXXXXXXGXXXXXXXXXXXXXXXXXXXGXXXXXXXXXXXXXXXXXXXGAXXXXXXXXXXXXXXXXXXGXXXXXXXXXXXXXXXXXXXGXXXXXXXXXXXXXXXXXXXGXXXXXXXXXXXXXXXXXXXGXXXXXXXXXXXXXXXXXXXGXXXXXXXXXXXXXXXXXXXGXXXXXXXXXXXXXXXXXXXGXXXXXXXXXXXXXXXXXXX,0,300,0
18837,15,1,14,73,212,0,0,223,125,98,GXXXXXXXXXXXXXXXXXXXGOXXXXXXXXXXXXXXXXXXGXXXXXXXXXXXXXXXXXXXGXXXXXXXXXXXXXXXXXXXGXXXXXXXXXXXXXXXXXXXGAXXXXXXXXXXXXXXXXXXGXXXXXXXXXXXXXXXXXXXGXXXXXXXXXXXXXXXXXXXGXXXXXXXXXXXXXXXXXXXGXXXXXXXXXXXXXXXXXXXGXXXXXXXXXXXXXXXXXXXGXXXXXXXXXXXXXXXXXXXGXXXXXXXXXXXXXXXXXXX,0,300,0
18858,14,1,13,70,216,0,0,227,128,99,GXXXXXXXXXXXXXXXXXXXGXXXXXXXXXXXXXXXXXXXGXXXXXXXXXXXXXXXXXXXGXXXXXXXXXXXXXXXXXXXGXXXXXXXXXXXXXXXXXXXGAXXXXXXXXXXXXXXXXXXGXXXXXXXXXXXXXXXXXXXGXXXXXXXXXXXXXXXXXXXGXXXXXXXXXXXXXXXXXXXGXXXXXXXXXXXXXXXXXXXGXXXXXXXXXXXXXXXXXXXGXXXXXXXXXXXXXXXXXXXGXXXXXXXXXXXXXXXXXXX,0,300,0
18879,14,1,13,68,218,0,0,229,124,105,GXXXXXXXXXXXXXXXXXXXGXXXXXXXXXXXXXXXXXXXGXXXXXXXXXXXXXXXXXXXGXXXXXXXXXXXXXXXXXXXGXXXXXXXXXXXXXXXXXXXGAXXXXXXXXXXXXXXXXXXGXXXXXXXXXXXXXXXXXXXGXXXXXXXXXXXXXXXXXXXGXXXXXXXXXXXXXXXXXXXGXXXXXXXXXXXXXXXXXXXGXXXXXXXXXXXXXXXXXXXGXXXXXXXXXXXXXXXXXXXGXXXXXXXXXXXXXXXXXXX,0,300,0

18900,14,1,13,69,217,0,0,228,126,102,GXXXXXXXXXXXXXXXXXXXGXXXXXXXXXXXXXXXXXXXGXXXXXXXXXXXXXXXXXXXGXXXXXXXXXXXXXXXXXXXGXXXXXXXXXXXXXXXXXXXGAXXXXXXXXXXXXXXXXXXGXXXXXXXXXXXXXXXXXXXGXXXXXXXXXXXXXXXXXXXGXXXXXXXXXXXXXXXXXXXGXXXXXXXXXXXXXXXXXXXGXXXXXXXXXXXXXXXXXXXGXXXXXXXXXXXXXXXXXXXGXXXXXXXXXXXXXXXXXXX,0,300,0
18921,15,2,13,63,222,0,0,234,132,102,GXXXXXXXXXXXXXXXXXXXGAXXXXXXXXXXXXXXXXXXGXXXXXXXXXXXXXXXXXXXGXXXXXXXXXXXXXXXXXXXGXXXXXXXXXXXXXXXXXXXGAXXXXXXXXXXXXXXXXXXGXXXXXXXXXXXXXXXXXXXGXXXXXXXXXXXXXXXXXXXGXXXXXXXXXXXXXXXXXXXGXXXXXXXXXXXXXXXXXXXGXXXXXXXXXXXXXXXXXXXGXXXXXXXXXXXXXXXXXXXGXXXXXXXXXXXXXXXXXXX,0,300,0
18942,15,2,13,61,224,0,0,235,128,107,GXXXXXXXXXXXXXXXXXXXGAXXXXXXXXXXXXXXXXXXGXXXXXXXXXXXXXXXXXXXGXXXXXXXXXXXXXXXXXXXGXXXXXXXXXXXXXXXXXXXGAXXXXXXXXXXXXXXXXXXGXXXXXXXXXXXXXXXXXXXGXXXXXXXXXXXXXXXXXXXGXXXXXXXXXXXXXXXXXXXGXXXXXXXXXXXXXXXXXXXGXXXXXXXXXXXXXXXXXXXGXXXXXXXXXXXXXXXXXXXGXXXXXXXXXXXXXXXXXXX,0,300,0
18963,15,2,13,59,226,0,0,237,131,106,GXXXXXXXXXXXXXXXXXXXGAXXXXXXXXXXXXXXXXXXGXXXXXXXXXXXXXXXXXXXGXXXXXXXXXXXXXXXXXXXGXXXXXXXXXXXXXXXXXXXGAXXXXXXXXXXXXXXXXXXGXXXXXXXXXXXXXXXXXXXGXXXXXXXXXXXXXXXXXXXGXXXXXXXXXXXXXXXXXXXGXXXXXXXXXXXXXXXXXXXGXXXXXXXXXXXXXXXXXXXGXXXXXXXXXXXXXXXXXXXGXXXXXXXXXXXXXXXXXXX,0,300,0
18984,15,2,13,62,223,0,0,235,125,110,GXXXXXXXXXXXXXXXXXXXGAXXXXXXXXXXXXXXXXXXGXXXXXXXXXXXXXXXXXXXGXXXXXXXXXXXXXXXXXXXGXXXXXXXXXXXXXXXXXXXGAXXXXXXXXXXXXXXXXXXGXXXXXXXXXXXXXXXXXXXGXXXXXXXXXXXXXXXXXXXGXXXXXXXXXXXXXXXXXXXGXXXXXXXXXXXXXXXXXXXGXXXXXXXXXXXXXXXXXXXGXXXXXXXXXXXXXXXXXXXGXXXXXXXXXXXXXXXXXXX,0,300,0

19005,15,2,13,65,220,0,0,232,124,108,GXXXXXXXXXXXXXXXXXXXGAXXXXXXXXXXXXXXXXXXGXXXXXXXXXXXXXXXXXXXGXXXXXXXXXXXXXXXXXXXGXXXXXXXXXXXXXXXXXXXGAXXXXXXXXXXXXXXXXXXGXXXXXXXXXXXXXXXXXXXGXXXXXXXXXXXXXXXXXXXGXXXXXXXXXXXXXXXXXXXGXXXXXXXXXXXXXXXXXXXGXXXXXXXXXXXXXXXXXXXGXXXXXXXXXXXXXXXXXXXGXXXXXXXXXXXXXXXXXXX,0,300,0
19026,15,2,13,60,225,0,0,236,126,110,GXXXXXXXXXXXXXXXXXXXGAXXXXXXXXXXXXXXXXXXGXXXXXXXXXXXXXXXXXXXGXXXXXXXXXXXXXXXXXXXGXXXXXXXXXXXXXXXXXXXGAXXXXXXXXXXXXXXXXXXGXXXXXXXXXXXXXXXXXXXGXXXXXXXXXXXXXXXXXXXGXXXXXXXXXXXXXXXXXXXGXXXXXXXXXXXXXXXXXXXGXXXXXXXXXXXXXXXXXXXGXXXXXXXXXXXXXXXXXXXGXXXXXXXXXXXXXXXXXXX,0,300,0
19047,15,2,13,57,228,0,0,240,130,110,GXXXXXXXXXXXXXXXXXXXGAXXXXXXXXXXXXXXXXXXGXXXXXXXXXXXXXXXXXXXGXXXXXXXXXXXXXXXXXXXGXXXXXXXXXXXXXXXXXXXGAXXXXXXXXXXXXXXXXXXGXXXXXXXXXXXXXXXXXXXGXXXXXXXXXXXXXXXXXXXGXXXXXXXXXXXXXXXXXXXGXXXXXXXXXXXXXXXXXXXGXXXXXXXXXXXXXXXXXXXGXXXXXXXXXXXXXXXXXXXGXXXXXXXXXXXXXXXXXXX,0,300,0
19068,14,1,13,57,229,0,0,241,133,108,GXXXXXXXXXXXXXXXXXXXGAXXXXXXXXXXXXXXXXXXGXXXXXXXXXXXXXXXXXXXGXXXXXXXXXXXXXXXXXXXGXXXXXXXXXXXXXXXXXXXGXXXXXXXXXXXXXXXXXXXGXXXXXXXXXXXXXXXXXXXGXXXXXXXXXXXXXXXXXXXGXXXXXXXXXXXXXXXXXXXGXXXXXXXXXXXXXXXXXXXGXXXXXXXXXXXXXXXXXXXGXXXXXXXXXXXXXXXXXXXGXXXXXXXXXXXXXXXXXXX,0,300,0
19089,14,1,13,57,229,0,0,241,130,111,GXXXXXXXXXXXXXXXXXXXGAXXXXXXXXXXXXXXXXXXGXXXXXXXXXXXXXXXXXXXGXXXXXXXXXXXXXXXXXXXGXXXXXXXXXXXXXXXXXXXGXXXXXXXXXXXXXXXXXXXGXXXXXXXXXXXXXXXXXXXGXXXXXXXXXXXXXXXXXXXGXXXXXXXXXXXXXXXXXXXGXXXXXXXXXXXXXXXXXXXGXXXXXXXXXXXXXXXXXXXGXXXXXXXXXXXXXXXXXXXGXXXXXXXXXXXXXXXXXXX,0,300,0

19110,14,1,13,60,226,0,0,237,126,111,GXXXXXXXXXXXXXXXXXXXGAXXXXXXXXXXXXXXXXXXGXXXXXXXXXXXXXXXXXXXGXXXXXXXXXXXXXXXXXXXGXXXXXXXXXXXXXXXXXXXGXXXXXXXXXXXXXXXXXXXGXXXXXXXXXXXXXXXXXXXGXXXXXXXXXXXXXXXXXXXGXXXXXXXXXXXXXXXXXXXGXXXXXXXXXXXXXXXXXXXGXXXXXXXXXXXXXXXXXXXGXXXXXXXXXXXXXXXXXXXGXXXXXXXXXXXXXXXXXXX,0,300,0
19131,14,1,13,60,226,0,0,237,126,111,GXXXXXXXXXXXXXXXXXXXGAXXXXXXXXXXXXXXXXXXGXXXXXXXXXXXXXXXXXXXGXXXXXXXXXXXXXXXXXXXGXXXXXXXXXXXXXXXXXXXGXXXXXXXXXXXXXXXXXXXGXXXXXXXXXXXXXXXXXXXGXXXXXXXXXXXXXXXXXXXGXXXXXXXXXXXXXXXXXXXGXXXXXXXXXXXXXXXXXXXGXXXXXXXXXXXXXXXXXXXGXXXXXXXXXXXXXXXXXXXGXXXXXXXXXXXXXXXXXXX,0,300,0
19152,14,1,13,61,225,0,0,237,129,108,GXXXXXXXXXXXXXXXXXXXGXXXXXXXXXXXXXXXXXXXGXXXXXXXXXXXXXXXXXXXGXXXXXXXXXXXXXXXXXXXGXXXXXXXXXXXXXXXXXXXGXXXXXXXXXXXXXXXXXXXGAXXXXXXXXXXXXXXXXXXGXXXXXXXXXXXXXXXXXXXGXXXXXXXXXXXXXXXXXXXGXXXXXXXXXXXXXXXXXXXGXXXXXXXXXXXXXXXXXXXGXXXXXXXXXXXXXXXXXXXGXXXXXXXXXXXXXXXXXXX,0,300,0
19173,14,1,13,55,231,0,0,242,129,113,GXXXXXXXXXXXXXXXXXXXGXXXXXXXXXXXXXXXXXXXGXXXXXXXXXXXXXXXXXXXGXXXXXXXXXXXXXXXXXXXGXXXXXXXXXXXXXXXXXXXGXXXXXXXXXXXXXXXXXXXGAXXXXXXXXXXXXXXXXXXGXXXXXXXXXXXXXXXXXXXGXXXXXXXXXXXXXXXXXXXGXXXXXXXXXXXXXXXXXXXGXXXXXXXXXXXXXXXXXXXGXXXXXXXXXXXXXXXXXXXGXXXXXXXXXXXXXXXXXXX,0,300,0
19194,14,1,13,58,228,0,0,240,127,113,GXXXXXXXXXXXXXXXXXXXGXXXXXXXXXXXXXXXXXXXGXXXXXXXXXXXXXXXXXXXGXXXXXXXXXXXXXXXXXXXGXXXXXXXXXXXXXXXXXXXGXXXXXXXXXXXXXXXXXXXGAXXXXXXXXXXXXXXXXXXGXXXXXXXXXXXXXXXXXXXGXXXXXXXXXXXXXXXXXXXGXXXXXXXXXXXXXXXXXXXGXXXXXXXXXXXXXXXXXXXGXXXXXXXXXXXXXXXXXXXGXXXXXXXXXXXXXXXXXXX,0,300,0

19215,13,0,13,60,227,0,0,239,126,113,GXXXXXXXXXXXXXXXXXXXGXXXXXXXXXXXXXXXXXXXGXXXXXXXXXXXXXXXXXXXGXXXXXXXXXXXXXXXXXXXGXXXXXXXXXXXXXXXXXXXGXXXXXXXXXXXXXXXXXXXGXXXXXXXXXXXXXXXXXXXGXXXXXXXXXXXXXXXXXXXGXXXXXXXXXXXXXXXXXXXGXXXXXXXXXXXXXXXXXXXGXXXXXXXXXXXXXXXXXXXGXXXXXXXXXXXXXXXXXXXGXXXXXXXXXXXXXXXXXXX,0,300,0
19236,13,0,13,57,230,0,0,242,135,107,GXXXXXXXXXXXXXXXXXXXGXXXXXXXXXXXXXXXXXXXGXXXXXXXXXXXXXXXXXXXGXXXXXXXXXXXXXXXXXXXGXXXXXXXXXXXXXXXXXXXGXXXXXXXXXXXXXXXXXXXGXXXXXXXXXXXXXXXXXXXGXXXXXXXXXXXXXXXXXXXGXXXXXXXXXXXXXXXXXXXGXXXXXXXXXXXXXXXXXXXGXXXXXXXXXXXXXXXXXXXGXXXXXXXXXXXXXXXXXXXGXXXXXXXXXXXXXXXXXXX,0,300,0
19257,13,0,13,55,232,0,0,244,137,107,GXXXXXXXXXXXXXXXXXXXGXXXXXXXXXXXXXXXXXXXGXXXXXXXXXXXXXXXXXXXGXXXXXXXXXXXXXXXXXXXGXXXXXXXXXXXXXXXXXXXGXXXXXXXXXXXXXXXXXXXGXXXXXXXXXXXXXXXXXXXGXXXXXXXXXXXXXXXXXXXGXXXXXXXXXXXXXXXXXXXGXXXXXXXXXXXXXXXXXXXGXXXXXXXXXXXXXXXXXXXGXXXXXXXXXXXXXXXXXXXGXXXXXXXXXXXXXXXXXXX,0,300,0
19278,13,0,13,61,226,0,0,238,129,109,GXXXXXXXXXXXXXXXXXXXGXXXXXXXXXXXXXXXXXXXGXXXXXXXXXXXXXXXXXXXGXXXXXXXXXXXXXXXXXXXGXXXXXXXXXXXXXXXXXXXGXXXXXXXXXXXXXXXXXXXGXXXXXXXXXXXXXXXXXXXGXXXXXXXXXXXXXXXXXXXGXXXXXXXXXXXXXXXXXXXGXXXXXXXXXXXXXXXXXXXGXXXXXXXXXXXXXXXXXXXGXXXXXXXXXXXXXXXXXXXGXXXXXXXXXXXXXXXXXXX,0,300,0
19299,13,0,13,64,223,0,0,234,124,110,GXXXXXXXXXXXXXXXXXXXGXXXXXXXXXXXXXXXXXXXGXXXXXXXXXXXXXXXXXXXGXXXXXXXXXXXXXXXXXXXGXXXXXXXXXXXXXXXXXXXGXXXXXXXXXXXXXXXXXXXGXXXXXXXXXXXXXXXXXXXGXXXXXXXXXXXXXXXXXXXGXXXXXXXXXXXXXXXXXXXGXXXXXXXXXXXXXXXXXXXGXXXXXXXXXXXXXXXXXXXGXXXXXXXXXXXXXXXXXXXGXXXXXXXXXXXXXXXXXXX,0,300,0

19320,13,0,13,58,229,0,0,241,128,113,GXXXXXXXXXXXXXXXXXXXGXXXXXXXXXXXXXXXXXXXGXXXXXXXXXXXXXXXXXXXGXXXXXXXXXXXXXXXXXXXGXXXXXXXXXXXXXXXXXXXGXXXXXXXXXXXXXXXXXXXGXXXXXXXXXXXXXXXXXXXGXXXXXXXXXXXXXXXXXXXGXXXXXXXXXXXXXXXXXXXGXXXXXXXXXXXXXXXXXXXGXXXXXXXXXXXXXXXXXXXGXXXXXXXXXXXXXXXXXXXGXXXXXXXXXXXXXXXXXXX,0,300,0
19341,13,0,13,59,228,0,0,240,128,112,GXXXXXXXXXXXXXXXXXXXGXXXXXXXXXXXXXXXXXXXGXXXXXXXXXXXXXXXXXXXGXXXXXXXXXXXXXXXXXXXGXXXXXXXXXXXXXXXXXXXGXXXXXXXXXXXXXXXXXXXGXXXXXXXXXXXXXXXXXXXGXXXXXXXXXXXXXXXXXXXGXXXXXXXXXXXXXXXXXXXGXXXXXXXXXXXXXXXXXXXGXXXXXXXXXXXXXXXXXXXGXXXXXXXXXXXXXXXXXXXGXXXXXXXXXXXXXXXXXXX,0,300,0
19362,13,0,13,60,227,0,0,238,132,106,GXXXXXXXXXXXXXXXXXXXGXXXXXXXXXXXXXXXXXXXGXXXXXXXXXXXXXXXXXXXGXXXXXXXXXXXXXXXXXXXGXXXXXXXXXXXXXXXXXXXGXXXXXXXXXXXXXXXXXXXGXXXXXXXXXXXXXXXXXXXGXXXXXXXXXXXXXXXXXXXGXXXXXXXXXXXXXXXXXXXGXXXXXXXXXXXXXXXXXXXGXXXXXXXXXXXXXXXXXXXGXXXXXXXXXXXXXXXXXXXGXXXXXXXXXXXXXXXXXXX,0,300,0
19383,13,0,13,54,233,0,0,245,131,114,GXXXXXXXXXXXXXXXXXXXGXXXXXXXXXXXXXXXXXXXGXXXXXXXXXXXXXXXXXXXGXXXXXXXXXXXXXXXXXXXGXXXXXXXXXXXXXXXXXXXGXXXXXXXXXXXXXXXXXXXGXXXXXXXXXXXXXXXXXXXGXXXXXXXXXXXXXXXXXXXGXXXXXXXXXXXXXXXXXXXGXXXXXXXXXXXXXXXXXXXGXXXXXXXXXXXXXXXXXXXGXXXXXXXXXXXXXXXXXXXGXXXXXXXXXXXXXXXXXXX,0,300,0
19404,13,0,13,53,234,0,0,245,130,115,GXXXXXXXXXXXXXXXXXXXGXXXXXXXXXXXXXXXXXXXGXXXXXXXXXXXXXXXXXXXGXXXXXXXXXXXXXXXXXXXGXXXXXXXXXXXXXXXXXXXGXXXXXXXXXXXXXXXXXXXGXXXXXXXXXXXXXXXXXXXGXXXXXXXXXXXXXXXXXXXGXXXXXXXXXXXXXXXXXXXGXXXXXXXXXXXXXXXXXXXGXXXXXXXXXXXXXXXXXXXGXXXXXXXXXXXXXXXXXXXGXXXXXXXXXXXXXXXXXXX,0,300,0

19425,13,0,13,55,232,0,0,244,131,113,GXXXXXXXXXXXXXXXXXXXGXXXXXXXXXXXXXXXXXXXGXXXXXXXXXXXXXXXXXXXGXXXXXXXXXXXXXXXXXXXGXXXXXXXXXXXXXXXXXXXGXXXXXXXXXXXXXXXXXXXGXXXXXXXXXXXXXXXXXXXGXXXXXXXXXXXXXXXXXXXGXXXXXXXXXXXXXXXXXXXGXXXXXXXXXXXXXXXXXXXGXXXXXXXXXXXXXXXXXXXGXXXXXXXXXXXXXXXXXXXGXXXXXXXXXXXXXXXXXXX,0,300,0
19446,13,0,13,58,229,0,0,242,130,112,GXXXXXXXXXXXXXXXXXXXGXXXXXXXXXXXXXXXXXXXGXXXXXXXXXXXXXXXXXXXGXXXXXXXXXXXXXXXXXXXGXXXXXXXXXXXXXXXXXXXGXXXXXXXXXXXXXXXXXXXGXXXXXXXXXXXXXXXXXXXGXXXXXXXXXXXXXXXXXXXGXXXXXXXXXXXXXXXXXXXGXXXXXXXXXXXXXXXXXXXGXXXXXXXXXXXXXXXXXXXGXXXXXXXXXXXXXXXXXXXGXXXXXXXXXXXXXXXXXXX,0,300,0
19467,13,0,13,64,223,0,0,236,128,108,GXXXXXXXXXXXXXXXXXXXGXXXXXXXXXXXXXXXXXXXGXXXXXXXXXXXXXXXXXXXGXXXXXXXXXXXXXXXXXXXGXXXXXXXXXXXXXXXXXXXGXXXXXXXXXXXXXXXXXXXGXXXXXXXXXXXXXXXXXXXGXXXXXXXXXXXXXXXXXXXGXXXXXXXXXXXXXXXXXXXGXXXXXXXXXXXXXXXXXXXGXXXXXXXXXXXXXXXXXXXGXXXXXXXXXXXXXXXXXXXGXXXXXXXXXXXXXXXXXXX,0,300,0
19488,13,0,13,60,227,0,0,240,127,113,GXXXXXXXXXXXXXXXXXXXGXXXXXXXXXXXXXXXXXXXGXXXXXXXXXXXXXXXXXXXGXXXXXXXXXXXXXXXXXXXGXXXXXXXXXXXXXXXXXXXGXXXXXXXXXXXXXXXXXXXGXXXXXXXXXXXXXXXXXXXGXXXXXXXXXXXXXXXXXXXGXXXXXXXXXXXXXXXXXXXGXXXXXXXXXXXXXXXXXXXGXXXXXXXXXXXXXXXXXXXGXXXXXXXXXXXXXXXXXXXGXXXXXXXXXXXXXXXXXXX,0,300,0
19509,13,0,13,67,220,0,0,233,127,106,GXXXXXXXXXXXXXXXXXXXGXXXXXXXXXXXXXXXXXXXGXXXXXXXXXXXXXXXXXXXGXXXXXXXXXXXXXXXXXXXGXXXXXXXXXXXXXXXXXXXGXXXXXXXXXXXXXXXXXXXGXXXXXXXXXXXXXXXXXXXGXXXXXXXXXXXXXXXXXXXGXXXXXXXXXXXXXXXXXXXGXXXXXXXXXXXXXXXXXXXGXXXXXXXXXXXXXXXXXXXGXXXXXXXXXXXXXXXXXXXGXXXXXXXXXXXXXXXXXXX,0,300,0

19530,13,0,13,68,219,0,0,230,124,106,GXXXXXXXXXXXXXXXXXXXGXXXXXXXXXXXXXXXXXXXGXXXXXXXXXXXXXXXXXXXGXXXXXXXXXXXXXXXXXXXGXXXXXXXXXXXXXXXXXXXGXXXXXXXXXXXXXXXXXXXGXXXXXXXXXXXXXXXXXXXGXXXXXXXXXXXXXXXXXXXGXXXXXXXXXXXXXXXXXXXGXXXXXXXXXXXXXXXXXXXGXXXXXXXXXXXXXXXXXXXGXXXXXXXXXXXXXXXXXXXGXXXXXXXXXXXXXXXXXXX,0,300,0
19551,13,0,13,66,221,0,0,234,124,110,GXXXXXXXXXXXXXXXXXXXGXXXXXXXXXXXXXXXXXXXGXXXXXXXXXXXXXXXXXXXGXXXXXXXXXXXXXXXXXXXGXXXXXXXXXXXXXXXXXXXGXXXXXXXXXXXXXXXXXXXGXXXXXXXXXXXXXXXXXXXGXXXXXXXXXXXXXXXXXXXGXXXXXXXXXXXXXXXXXXXGXXXXXXXXXXXXXXXXXXXGXXXXXXXXXXXXXXXXXXXGXXXXXXXXXXXXXXXXXXXGXXXXXXXXXXXXXXXXXXX,0,300,0
19572,13,0,13,63,224,0,0,238,131,107,GXXXXXXXXXXXXXXXXXXXGXXXXXXXXXXXXXXXXXXXGXXXXXXXXXXXXXXXXXXXGXXXXXXXXXXXXXXXXXXXGXXXXXXXXXXXXXXXXXXXGXXXXXXXXXXXXXXXXXXXGXXXXXXXXXXXXXXXXXXXGXXXXXXXXXXXXXXXXXXXGXXXXXXXXXXXXXXXXXXXGXXXXXXXXXXXXXXXXXXXGXXXXXXXXXXXXXXXXXXXGXXXXXXXXXXXXXXXXXXXGXXXXXXXXXXXXXXXXXXX,0,300,0
19593,13,0,13,65,222,0,0,234,127,107,GXXXXXXXXXXXXXXXXXXXGXXXXXXXXXXXXXXXXXXXGXXXXXXXXXXXXXXXXXXXGXXXXXXXXXXXXXXXXXXXGXXXXXXXXXXXXXXXXXXXGXXXXXXXXXXXXXXXXXXXGXXXXXXXXXXXXXXXXXXXGXXXXXXXXXXXXXXXXXXXGXXXXXXXXXXXXXXXXXXXGXXXXXXXXXXXXXXXXXXXGXXXXXXXXXXXXXXXXXXXGXXXXXXXXXXXXXXXXXXXGXXXXXXXXXXXXXXXXXXX,0,300,0
19614,14,1,13,67,219,0,0,232,130,102,GXXXXXXXXXXXXXXXXXXXGXXXXXXXXXXXXXXXXXXXGXXXXXXXXXXXXXXXXXXXGXXXXXXXXXXXXXXXXXXXGXXXXXXXXXXXXXXXXXXXGAXXXXXXXXXXXXXXXXXXGXXXXXXXXXXXXXXXXXXXGXXXXXXXXXXXXXXXXXXXGXXXXXXXXXXXXXXXXXXXGXXXXXXXXXXXXXXXXXXXGXXXXXXXXXXXXXXXXXXXGXXXXXXXXXXXXXXXXXXXGXXXXXXXXXXXXXXXXXXX,0,300,0

19635,15,2,13,68,217,0,0,229,129,100,GXXXXXXXXXXXXXXXXXXXGXXXXXXXXXXXXXXXXXXXGXXXXXXXXXXXXXXXXXXXGXXXXXXXXXXXXXXXXXXXGXXXXXXXXXXXXXXXXXXXGAXXXXXXXXXXXXXXXXXXGXXXXXXXXXXXXXXXXXXXGXXXXXXXXXXXXXXXXXXXGXXXXXXXXXXXXXXXXXXXGXXXXXXXXXXXXXXXXXXXGXXXXXXXXXXXXXXXXXXXGXXXXXXXXXXXXXXXXXXXGAXXXXXXXXXXXXXXXXXX,0,300,0
19656,15,2,13,66,219,0,0,231,131,100,GXXXXXXXXXXXXXXXXXXXGXXXXXXXXXXXXXXXXXXXGXXXXXXXXXXXXXXXXXXXGXXXXXXXXXXXXXXXXXXXGXXXXXXXXXXXXXXXXXXXGAXXXXXXXXXXXXXXXXXXGXXXXXXXXXXXXXXXXXXXGXXXXXXXXXXXXXXXXXXXGXXXXXXXXXXXXXXXXXXXGXXXXXXXXXXXXXXXXXXXGXXXXXXXXXXXXXXXXXXXGXXXXXXXXXXXXXXXXXXXGAXXXXXXXXXXXXXXXXXX,0,300,0
19677,15,1,14,65,220,0,0,232,127,105,GXXXXXXXXXXXXXXXXXXXGXXXXXXXXXXXXXXXXXXXGXXXXXXXXXXXXXXXXXXXGXXXXXXXXXXXXXXXXXXXGXXXXXXXXXXXXXXXXXXXGAXXXXXXXXXXXXXXXXXXGXXXXXXXXXXXXXXXXXXXGXXXXXXXXXXXXXXXXXXXGXXXXXXXXXXXXXXXXXXXGXXXXXXXXXXXXXXXXXXXGXXXXXXXXXXXXXXXXXXXGXXXXXXXXXXXXXXXXXXXGOXXXXXXXXXXXXXXXXXX,0,300,0
19698,15,1,14,65,220,0,0,232,124,108,GXXXXXXXXXXXXXXXXXXXGXXXXXXXXXXXXXXXXXXXGXXXXXXXXXXXXXXXXXXXGXXXXXXXXXXXXXXXXXXXGXXXXXXXXXXXXXXXXXXXGAXXXXXXXXXXXXXXXXXXGXXXXXXXXXXXXXXXXXXXGXXXXXXXXXXXXXXXXXXXGXXXXXXXXXXXXXXXXXXXGXXXXXXXXXXXXXXXXXXXGXXXXXXXXXXXXXXXXXXXGXXXXXXXXXXXXXXXXXXXGOXXXXXXXXXXXXXXXXXX,0,300,0
19719,13,0,13,57,230,0,0,242,129,113,GXXXXXXXXXXXXXXXXXXXGXXXXXXXXXXXXXXXXXXXGXXXXXXXXXXXXXXXXXXXGXXXXXXXXXXXXXXXXXXXGXXXXXXXXXXXXXXXXXXXGXXXXXXXXXXXXXXXXXXXGXXXXXXXXXXXXXXXXXXXGXXXXXXXXXXXXXXXXXXXGXXXXXXXXXXXXXXXXXXXGXXXXXXXXXXXXXXXXXXXGXXXXXXXXXXXXXXXXXXXGXXXXXXXXXXXXXXXXXXXGXXXXXXXXXXXXXXXXXXX,0,300,0

19740,13,0,13,52,235,0,0,247,136,111,GXXXXXXXXXXXXXXXXXXXGXXXXXXXXXXXXXXXXXXXGXXXXXXXXXXXXXXXXXXXGXXXXXXXXXXXXXXXXXXXGXXXXXXXXXXXXXXXXXXXGXXXXXXXXXXXXXXXXXXXGXXXXXXXXXXXXXXXXXXXGXXXXXXXXXXXXXXXXXXXGXXXXXXXXXXXXXXXXXXXGXXXXXXXXXXXXXXXXXXXGXXXXXXXXXXXXXXXXXXXGXXXXXXXXXXXXXXXXXXXGXXXXXXXXXXXXXXXXXXX,0,300,0
19761,14,1,13,56,230,0,0,242,127,115,GXXXXXXXXXXXXXXXXXXXGAXXXXXXXXXXXXXXXXXXGXXXXXXXXXXXXXXXXXXXGXXXXXXXXXXXXXXXXXXXGXXXXXXXXXXXXXXXXXXXGXXXXXXXXXXXXXXXXXXXGXXXXXXXXXXXXXXXXXXXGXXXXXXXXXXXXXXXXXXXGXXXXXXXXXXXXXXXXXXXGXXXXXXXXXXXXXXXXXXXGXXXXXXXXXXXXXXXXXXXGXXXXXXXXXXXXXXXXXXXGXXXXXXXXXXXXXXXXXXX,0,300,0
19782,14,1,13,55,231,0,0,244,130,114,GXXXXXXXXXXXXXXXXXXXGAXXXXXXXXXXXXXXXXXXGXXXXXXXXXXXXXXXXXXXGXXXXXXXXXXXXXXXXXXXGXXXXXXXXXXXXXXXXXXXGXXXXXXXXXXXXXXXXXXXGXXXXXXXXXXXXXXXXXXXGXXXXXXXXXXXXXXXXXXXGXXXXXXXXXXXXXXXXXXXGXXXXXXXXXXXXXXXXXXXGXXXXXXXXXXXXXXXXXXXGXXXXXXXXXXXXXXXXXXXGXXXXXXXXXXXXXXXXXXX,0,300,0
19803,14,1,13,53,233,0,0,246,133,113,GXXXXXXXXXXXXXXXXXXXGAXXXXXXXXXXXXXXXXXXGXXXXXXXXXXXXXXXXXXXGXXXXXXXXXXXXXXXXXXXGXXXXXXXXXXXXXXXXXXXGXXXXXXXXXXXXXXXXXXXGXXXXXXXXXXXXXXXXXXXGXXXXXXXXXXXXXXXXXXXGXXXXXXXXXXXXXXXXXXXGXXXXXXXXXXXXXXXXXXXGXXXXXXXXXXXXXXXXXXXGXXXXXXXXXXXXXXXXXXXGXXXXXXXXXXXXXXXXXXX,0,300,0
19824,14,1,13,58,228,0,0,240,127,113,GXXXXXXXXXXXXXXXXXXXGAXXXXXXXXXXXXXXXXXXGXXXXXXXXXXXXXXXXXXXGXXXXXXXXXXXXXXXXXXXGXXXXXXXXXXXXXXXXXXXGXXXXXXXXXXXXXXXXXXXGXXXXXXXXXXXXXXXXXXXGXXXXXXXXXXXXXXXXXXXGXXXXXXXXXXXXXXXXXXXGXXXXXXXXXXXXXXXXXXXGXXXXXXXXXXXXXXXXXXXGXXXXXXXXXXXXXXXXXXXGXXXXXXXXXXXXXXXXXXX,0,300,0

19845,14,1,13,54,232,0,0,246,130,116,GXXXXXXXXXXXXXXXXXXXGAXXXXXXXXXXXXXXXXXXGXXXXXXXXXXXXXXXXXXXGXXXXXXXXXXXXXXXXXXXGXXXXXXXXXXXXXXXXXXXGXXXXXXXXXXXXXXXXXXXGXXXXXXXXXXXXXXXXXXXGXXXXXXXXXXXXXXXXXXXGXXXXXXXXXXXXXXXXXXXGXXXXXXXXXXXXXXXXXXXGXXXXXXXXXXXXXXXXXXXGXXXXXXXXXXXXXXXXXXXGXXXXXXXXXXXXXXXXXXX,0,300,0
19866,14,1,13,54,232,0,0,245,128,117,GXXXXXXXXXXXXXXXXXXXGAXXXXXXXXXXXXXXXXXXGXXXXXXXXXXXXXXXXXXXGXXXXXXXXXXXXXXXXXXXGXXXXXXXXXXXXXXXXXXXGXXXXXXXXXXXXXXXXXXXGXXXXXXXXXXXXXXXXXXXGXXXXXXXXXXXXXXXXXXXGXXXXXXXXXXXXXXXXXXXGXXXXXXXXXXXXXXXXXXXGXXXXXXXXXXXXXXXXXXXGXXXXXXXXXXXXXXXXXXXGXXXXXXXXXXXXXXXXXXX,0,300,0
19887,14,1,13,57,229,0,0,241,125,116,GXXXXXXXXXXXXXXXXXXXGAXXXXXXXXXXXXXXXXXXGXXXXXXXXXXXXXXXXXXXGXXXXXXXXXXXXXXXXXXXGXXXXXXXXXXXXXXXXXXXGXXXXXXXXXXXXXXXXXXXGXXXXXXXXXXXXXXXXXXXGXXXXXXXXXXXXXXXXXXXGXXXXXXXXXXXXXXXXXXXGXXXXXXXXXXXXXXXXXXXGXXXXXXXXXXXXXXXXXXXGXXXXXXXXXXXXXXXXXXXGXXXXXXXXXXXXXXXXXXX,0,300,0
19908,14,1,13,58,228,0,0,241,127,114,GXXXXXXXXXXXXXXXXXXXGAXXXXXXXXXXXXXXXXXXGXXXXXXXXXXXXXXXXXXXGXXXXXXXXXXXXXXXXXXXGXXXXXXXXXXXXXXXXXXXGXXXXXXXXXXXXXXXXXXXGXXXXXXXXXXXXXXXXXXXGXXXXXXXXXXXXXXXXXXXGXXXXXXXXXXXXXXXXXXXGXXXXXXXXXXXXXXXXXXXGXXXXXXXXXXXXXXXXXXXGXXXXXXXXXXXXXXXXXXXGXXXXXXXXXXXXXXXXXXX,0,300,0
19929,14,1,13,59,227,0,0,240,127,113,GXXXXXXXXXXXXXXXXXXXGAXXXXXXXXXXXXXXXXXXGXXXXXXXXXXXXXXXXXXXGXXXXXXXXXXXXXXXXXXXGXXXXXXXXXXXXXXXXXXXGXXXXXXXXXXXXXXXXXXXGXXXXXXXXXXXXXXXXXXXGXXXXXXXXXXXXXXXXXXXGXXXXXXXXXXXXXXXXXXXGXXXXXXXXXXXXXXXXXXXGXXXXXXXXXXXXXXXXXXXGXXXXXXXXXXXXXXXXXXXGXXXXXXXXXXXXXXXXXXX,0,300,0

19950,14,1,13,55,231,0,0,243,126,117,GXXXXXXXXXXXXXXXXXXXGAXXXXXXXXXXXXXXXXXXGXXXXXXXXXXXXXXXXXXXGXXXXXXXXXXXXXXXXXXXGXXXXXXXXXXXXXXXXXXXGXXXXXXXXXXXXXXXXXXXGXXXXXXXXXXXXXXXXXXXGXXXXXXXXXXXXXXXXXXXGXXXXXXXXXXXXXXXXXXXGXXXXXXXXXXXXXXXXXXXGXXXXXXXXXXXXXXXXXXXGXXXXXXXXXXXXXXXXXXXGXXXXXXXXXXXXXXXXXXX,0,300,0
19971,15,2,13,50,235,0,0,247,126,121,GXXXXXXXXXXXXXXXXXXXGAXXXXXXXXXXXXXXXXXXGXXXXXXXXXXXXXXXXXXXGXXXXXXXXXXXXXXXXXXXGAXXXXXXXXXXXXXXXXXXGXXXXXXXXXXXXXXXXXXXGXXXXXXXXXXXXXXXXXXXGXXXXXXXXXXXXXXXXXXXGXXXXXXXXXXXXXXXXXXXGXXXXXXXXXXXXXXXXXXXGXXXXXXXXXXXXXXXXXXXGXXXXXXXXXXXXXXXXXXXGXXXXXXXXXXXXXXXXXXX,0,300,0
19992,15,2,13,48,237,0,0,249,128,121,GXXXXXXXXXXXXXXXXXXXGAXXXXXXXXXXXXXXXXXXGXXXXXXXXXXXXXXXXXXXGXXXXXXXXXXXXXXXXXXXGAXXXXXXXXXXXXXXXXXXGXXXXXXXXXXXXXXXXXXXGXXXXXXXXXXXXXXXXXXXGXXXXXXXXXXXXXXXXXXXGXXXXXXXXXXXXXXXXXXXGXXXXXXXXXXXXXXXXXXXGXXXXXXXXXXXXXXXXXXXGXXXXXXXXXXXXXXXXXXXGXXXXXXXXXXXXXXXXXXX,0,300,0
20013,14,1,13,52,234,0,0,246,134,112,GXXXXXXXXXXXXXXXXXXXGXXXXXXXXXXXXXXXXXXXGXXXXXXXXXXXXXXXXXXXGXXXXXXXXXXXXXXXXXXXGAXXXXXXXXXXXXXXXXXXGXXXXXXXXXXXXXXXXXXXGXXXXXXXXXXXXXXXXXXXGXXXXXXXXXXXXXXXXXXXGXXXXXXXXXXXXXXXXXXXGXXXXXXXXXXXXXXXXXXXGXXXXXXXXXXXXXXXXXXXGXXXXXXXXXXXXXXXXXXXGXXXXXXXXXXXXXXXXXXX,0,300,0
20034,14,1,13,59,227,0,0,240,134,106,GXXXXXXXXXXXXXXXXXXXGXXXXXXXXXXXXXXXXXXXGXXXXXXXXXXXXXXXXXXXGXXXXXXXXXXXXXXXXXXXGAXXXXXXXXXXXXXXXXXXGXXXXXXXXXXXXXXXXXXXGXXXXXXXXXXXXXXXXXXXGXXXXXXXXXXXXXXXXXXXGXXXXXXXXXXXXXXXXXXXGXXXXXXXXXXXXXXXXXXXGXXXXXXXXXXXXXXXXXXXGXXXXXXXXXXXXXXXXXXXGXXXXXXXXXXXXXXXXXXX,0,300,0

20055,14,1,13,55,231,0,0,244,134,110,GXXXXXXXXXXXXXXXXXXXGXXXXXXXXXXXXXXXXXXXGXXXXXXXXXXXXXXXXXXXGXXXXXXXXXXXXXXXXXXXGAXXXXXXXXXXXXXXXXXXGXXXXXXXXXXXXXXXXXXXGXXXXXXXXXXXXXXXXXXXGXXXXXXXXXXXXXXXXXXXGXXXXXXXXXXXXXXXXXXXGXXXXXXXXXXXXXXXXXXXGXXXXXXXXXXXXXXXXXXXGXXXXXXXXXXXXXXXXXXXGXXXXXXXXXXXXXXXXXXX,0,300,0
20076,14,1,13,62,224,0,0,239,132,107,GXXXXXXXXXXXXXXXXXXXGXXXXXXXXXXXXXXXXXXXGXXXXXXXXXXXXXXXXXXXGXXXXXXXXXXXXXXXXXXXGAXXXXXXXXXXXXXXXXXXGXXXXXXXXXXXXXXXXXXXGXXXXXXXXXXXXXXXXXXXGXXXXXXXXXXXXXXXXXXXGXXXXXXXXXXXXXXXXXXXGXXXXXXXXXXXXXXXXXXXGXXXXXXXXXXXXXXXXXXXGXXXXXXXXXXXXXXXXXXXGXXXXXXXXXXXXXXXXXXX,0,300,0
20097,14,1,13,69,217,0,0,232,132,100,GXXXXXXXXXXXXXXXXXXXGXXXXXXXXXXXXXXXXXXXGXXXXXXXXXXXXXXXXXXXGXXXXXXXXXXXXXXXXXXXGAXXXXXXXXXXXXXXXXXXGXXXXXXXXXXXXXXXXXXXGXXXXXXXXXXXXXXXXXXXGXXXXXXXXXXXXXXXXXXXGXXXXXXXXXXXXXXXXXXXGXXXXXXXXXXXXXXXXXXXGXXXXXXXXXXXXXXXXXXXGXXXXXXXXXXXXXXXXXXXGXXXXXXXXXXXXXXXXXXX,0,300,0
20118,14,1,13,72,214,0,0,231,128,103,GXXXXXXXXXXXXXXXXXXXGXXXXXXXXXXXXXXXXXXXGXXXXXXXXXXXXXXXXXXXGXXXXXXXXXXXXXXXXXXXGAXXXXXXXXXXXXXXXXXXGXXXXXXXXXXXXXXXXXXXGXXXXXXXXXXXXXXXXXXXGXXXXXXXXXXXXXXXXXXXGXXXXXXXXXXXXXXXXXXXGXXXXXXXXXXXXXXXXXXXGXXXXXXXXXXXXXXXXXXXGXXXXXXXXXXXXXXXXXXXGXXXXXXXXXXXXXXXXXXX,0,300,0
20139,14,1,13,72,214,0,0,231,128,103,GXXXXXXXXXXXXXXXXXXXGXXXXXXXXXXXXXXXXXXXGXXXXXXXXXXXXXXXXXXXGXXXXXXXXXXXXXXXXXXXGAXXXXXXXXXXXXXXXXXXGXXXXXXXXXXXXXXXXXXXGXXXXXXXXXXXXXXXXXXXGXXXXXXXXXXXXXXXXXXXGXXXXXXXXXXXXXXXXXXXGXXXXXXXXXXXXXXXXXXXGXXXXXXXXXXXXXXXXXXXGXXXXXXXXXXXXXXXXXXXGXXXXXXXXXXXXXXXXXXX,0,300,0

20160,15,2,13,69,216,0,0,233,134,99,GXXXXXXXXXXXXXXXXXXXGXXXXXXXXXXXXXXXXXXXGXXXXXXXXXXXXXXXXXXXGXXXXXXXXXXXXXXXXXXXGAXXXXXXXXXXXXXXXXXXGAXXXXXXXXXXXXXXXXXXGXXXXXXXXXXXXXXXXXXXGXXXXXXXXXXXXXXXXXXXGXXXXXXXXXXXXXXXXXXXGXXXXXXXXXXXXXXXXXXXGXXXXXXXXXXXXXXXXXXXGXXXXXXXXXXXXXXXXXXXGXXXXXXXXXXXXXXXXXXX,0,300,0
20181,13,0,13,67,220,0,0,237,138,99,GXXXXXXXXXXXXXXXXXXXGXXXXXXXXXXXXXXXXXXXGXXXXXXXXXXXXXXXXXXXGXXXXXXXXXXXXXXXXXXXGXXXXXXXXXXXXXXXXXXXGXXXXXXXXXXXXXXXXXXXGXXXXXXXXXXXXXXXXXXXGXXXXXXXXXXXXXXXXXXXGXXXXXXXXXXXXXXXXXXXGXXXXXXXXXXXXXXXXXXXGXXXXXXXXXXXXXXXXXXXGXXXXXXXXXXXXXXXXXXXGXXXXXXXXXXXXXXXXXXX,0,300,0
20202,13,0,13,68,219,0,0,234,134,100,GXXXXXXXXXXXXXXXXXXXGXXXXXXXXXXXXXXXXXXXGXXXXXXXXXXXXXXXXXXXGXXXXXXXXXXXXXXXXXXXGXXXXXXXXXXXXXXXXXXXGXXXXXXXXXXXXXXXXXXXGXXXXXXXXXXXXXXXXXXXGXXXXXXXXXXXXXXXXXXXGXXXXXXXXXXXXXXXXXXXGXXXXXXXXXXXXXXXXXXXGXXXXXXXXXXXXXXXXXXXGXXXXXXXXXXXXXXXXXXXGXXXXXXXXXXXXXXXXXXX,0,300,0
20223,13,0,13,65,222,0,0,237,137,100,GXXXXXXXXXXXXXXXXXXXGXXXXXXXXXXXXXXXXXXXGXXXXXXXXXXXXXXXXXXXGXXXXXXXXXXXXXXXXXXXGXXXXXXXXXXXXXXXXXXXGXXXXXXXXXXXXXXXXXXXGXXXXXXXXXXXXXXXXXXXGXXXXXXXXXXXXXXXXXXXGXXXXXXXXXXXXXXXXXXXGXXXXXXXXXXXXXXXXXXXGXXXXXXXXXXXXXXXXXXXGXXXXXXXXXXXXXXXXXXXGXXXXXXXXXXXXXXXXXXX,0,300,0
20244,13,0,13,62,225,0,0,239,135,104,GXXXXXXXXXXXXXXXXXXXGXXXXXXXXXXXXXXXXXXXGXXXXXXXXXXXXXXXXXXXGXXXXXXXXXXXXXXXXXXXGXXXXXXXXXXXXXXXXXXXGXXXXXXXXXXXXXXXXXXXGXXXXXXXXXXXXXXXXXXXGXXXXXXXXXXXXXXXXXXXGXXXXXXXXXXXXXXXXXXXGXXXXXXXXXXXXXXXXXXXGXXXXXXXXXXXXXXXXXXXGXXXXXXXXXXXXXXXXXXXGXXXXXXXXXXXXXXXXXXX,0,300,0

20265,13,0,13,65,222,0,0,236,135,101,GXXXXXXXXXXXXXXXXXXXGXXXXXXXXXXXXXXXXXXXGXXXXXXXXXXXXXXXXXXXGXXXXXXXXXXXXXXXXXXXGXXXXXXXXXXXXXXXXXXXGXXXXXXXXXXXXXXXXXXXGXXXXXXXXXXXXXXXXXXXGXXXXXXXXXXXXXXXXXXXGXXXXXXXXXXXXXXXXXXXGXXXXXXXXXXXXXXXXXXXGXXXXXXXXXXXXXXXXXXXGXXXXXXXXXXXXXXXXXXXGXXXXXXXXXXXXXXXXXXX,0,300,0
20286,13,0,13,63,224,0,0,238,133,105,GXXXXXXXXXXXXXXXXXXXGXXXXXXXXXXXXXXXXXXXGXXXXXXXXXXXXXXXXXXXGXXXXXXXXXXXXXXXXXXXGXXXXXXXXXXXXXXXXXXXGXXXXXXXXXXXXXXXXXXXGXXXXXXXXXXXXXXXXXXXGXXXXXXXXXXXXXXXXXXXGXXXXXXXXXXXXXXXXXXXGXXXXXXXXXXXXXXXXXXXGXXXXXXXXXXXXXXXXXXXGXXXXXXXXXXXXXXXXXXXGXXXXXXXXXXXXXXXXXXX,0,300,0
20307,13,0,13,62,225,0,0,237,132,105,GXXXXXXXXXXXXXXXXXXXGXXXXXXXXXXXXXXXXXXXGXXXXXXXXXXXXXXXXXXXGXXXXXXXXXXXXXXXXXXXGXXXXXXXXXXXXXXXXXXXGXXXXXXXXXXXXXXXXXXXGXXXXXXXXXXXXXXXXXXXGXXXXXXXXXXXXXXXXXXXGXXXXXXXXXXXXXXXXXXXGXXXXXXXXXXXXXXXXXXXGXXXXXXXXXXXXXXXXXXXGXXXXXXXXXXXXXXXXXXXGXXXXXXXXXXXXXXXXXXX,0,300,0
20328,13,0,13,59,228,0,0,241,131,110,GXXXXXXXXXXXXXXXXXXXGXXXXXXXXXXXXXXXXXXXGXXXXXXXXXXXXXXXXXXXGXXXXXXXXXXXXXXXXXXXGXXXXXXXXXXXXXXXXXXXGXXXXXXXXXXXXXXXXXXXGXXXXXXXXXXXXXXXXXXXGXXXXXXXXXXXXXXXXXXXGXXXXXXXXXXXXXXXXXXXGXXXXXXXXXXXXXXXXXXXGXXXXXXXXXXXXXXXXXXXGXXXXXXXXXXXXXXXXXXXGXXXXXXXXXXXXXXXXXXX,0,300,0
20349,13,0,13,67,220,0,0,233,127,106,GXXXXXXXXXXXXXXXXXXXGXXXXXXXXXXXXXXXXXXXGXXXXXXXXXXXXXXXXXXXGXXXXXXXXXXXXXXXXXXXGXXXXXXXXXXXXXXXXXXXGXXXXXXXXXXXXXXXXXXXGXXXXXXXXXXXXXXXXXXXGXXXXXXXXXXXXXXXXXXXGXXXXXXXXXXXXXXXXXXXGXXXXXXXXXXXXXXXXXXXGXXXXXXXXXXXXXXXXXXXGXXXXXXXXXXXXXXXXXXXGXXXXXXXXXXXXXXXXXXX,0,300,0

20370,13,0,13,62,225,0,0,238,133,105,GXXXXXXXXXXXXXXXXXXXGXXXXXXXXXXXXXXXXXXXGXXXXXXXXXXXXXXXXXXXGXXXXXXXXXXXXXXXXXXXGXXXXXXXXXXXXXXXXXXXGXXXXXXXXXXXXXXXXXXXGXXXXXXXXXXXXXXXXXXXGXXXXXXXXXXXXXXXXXXXGXXXXXXXXXXXXXXXXXXXGXXXXXXXXXXXXXXXXXXXGXXXXXXXXXXXXXXXXXXXGXXXXXXXXXXXXXXXXXXXGXXXXXXXXXXXXXXXXXXX,0,300,0
20391,13,0,13,66,221,0,0,234,132,102,GXXXXXXXXXXXXXXXXXXXGXXXXXXXXXXXXXXXXXXXGXXXXXXXXXXXXXXXXXXXGXXXXXXXXXXXXXXXXXXXGXXXXXXXXXXXXXXXXXXXGXXXXXXXXXXXXXXXXXXXGXXXXXXXXXXXXXXXXXXXGXXXXXXXXXXXXXXXXXXXGXXXXXXXXXXXXXXXXXXXGXXXXXXXXXXXXXXXXXXXGXXXXXXXXXXXXXXXXXXXGXXXXXXXXXXXXXXXXXXXGXXXXXXXXXXXXXXXXXXX,0,300,0
20412,13,0,13,67,220,0,0,233,133,100,GXXXXXXXXXXXXXXXXXXXGXXXXXXXXXXXXXXXXXXXGXXXXXXXXXXXXXXXXXXXGXXXXXXXXXXXXXXXXXXXGXXXXXXXXXXXXXXXXXXXGXXXXXXXXXXXXXXXXXXXGXXXXXXXXXXXXXXXXXXXGXXXXXXXXXXXXXXXXXXXGXXXXXXXXXXXXXXXXXXXGXXXXXXXXXXXXXXXXXXXGXXXXXXXXXXXXXXXXXXXGXXXXXXXXXXXXXXXXXXXGXXXXXXXXXXXXXXXXXXX,0,300,0
20433,13,0,13,66,221,0,0,232,131,101,GXXXXXXXXXXXXXXXXXXXGXXXXXXXXXXXXXXXXXXXGXXXXXXXXXXXXXXXXXXXGXXXXXXXXXXXXXXXXXXXGXXXXXXXXXXXXXXXXXXXGXXXXXXXXXXXXXXXXXXXGXXXXXXXXXXXXXXXXXXXGXXXXXXXXXXXXXXXXXXXGXXXXXXXXXXXXXXXXXXXGXXXXXXXXXXXXXXXXXXXGXXXXXXXXXXXXXXXXXXXGXXXXXXXXXXXXXXXXXXXGXXXXXXXXXXXXXXXXXXX,0,300,0
20454,13,0,13,68,219,0,0,231,131,100,GXXXXXXXXXXXXXXXXXXXGXXXXXXXXXXXXXXXXXXXGXXXXXXXXXXXXXXXXXXXGXXXXXXXXXXXXXXXXXXXGXXXXXXXXXXXXXXXXXXXGXXXXXXXXXXXXXXXXXXXGXXXXXXXXXXXXXXXXXXXGXXXXXXXXXXXXXXXXXXXGXXXXXXXXXXXXXXXXXXXGXXXXXXXXXXXXXXXXXXXGXXXXXXXXXXXXXXXXXXXGXXXXXXXXXXXXXXXXXXXGXXXXXXXXXXXXXXXXXXX,0,300,0

20475,13,0,13,65,222,0,0,232,129,103,GXXXXXXXXXXXXXXXXXXXGXXXXXXXXXXXXXXXXXXXGXXXXXXXXXXXXXXXXXXXGXXXXXXXXXXXXXXXXXXXGXXXXXXXXXXXXXXXXXXXGXXXXXXXXXXXXXXXXXXXGXXXXXXXXXXXXXXXXXXXGXXXXXXXXXXXXXXXXXXXGXXXXXXXXXXXXXXXXXXXGXXXXXXXXXXXXXXXXXXXGXXXXXXXXXXXXXXXXXXXGXXXXXXXXXXXXXXXXXXXGXXXXXXXXXXXXXXXXXXX,0,300,0
20496,13,0,13,60,227,0,0,238,130,108,GXXXXXXXXXXXXXXXXXXXGXXXXXXXXXXXXXXXXXXXGXXXXXXXXXXXXXXXXXXXGXXXXXXXXXXXXXXXXXXXGXXXXXXXXXXXXXXXXXXXGXXXXXXXXXXXXXXXXXXXGXXXXXXXXXXXXXXXXXXXGXXXXXXXXXXXXXXXXXXXGXXXXXXXXXXXXXXXXXXXGXXXXXXXXXXXXXXXXXXXGXXXXXXXXXXXXXXXXXXXGXXXXXXXXXXXXXXXXXXXGXXXXXXXXXXXXXXXXXXX,0,300,0
20517,13,0,13,60,227,0,0,238,130,108,GXXXXXXXXXXXXXXXXXXXGXXXXXXXXXXXXXXXXXXXGXXXXXXXXXXXXXXXXXXXGXXXXXXXXXXXXXXXXXXXGXXXXXXXXXXXXXXXXXXXGXXXXXXXXXXXXXXXXXXXGXXXXXXXXXXXXXXXXXXXGXXXXXXXXXXXXXXXXXXXGXXXXXXXXXXXXXXXXXXXGXXXXXXXXXXXXXXXXXXXGXXXXXXXXXXXXXXXXXXXGXXXXXXXXXXXXXXXXXXXGXXXXXXXXXXXXXXXXXXX,0,300,0
20538,13,0,13,60,227,0,0,239,133,106,GXXXXXXXXXXXXXXXXXXXGXXXXXXXXXXXXXXXXXXXGXXXXXXXXXXXXXXXXXXXGXXXXXXXXXXXXXXXXXXXGXXXXXXXXXXXXXXXXXXXGXXXXXXXXXXXXXXXXXXXGXXXXXXXXXXXXXXXXXXXGXXXXXXXXXXXXXXXXXXXGXXXXXXXXXXXXXXXXXXXGXXXXXXXXXXXXXXXXXXXGXXXXXXXXXXXXXXXXXXXGXXXXXXXXXXXXXXXXXXXGXXXXXXXXXXXXXXXXXXX,0,300,0
20559,13,0,13,54,233,0,0,245,139,106,GXXXXXXXXXXXXXXXXXXXGXXXXXXXXXXXXXXXXXXXGXXXXXXXXXXXXXXXXXXXGXXXXXXXXXXXXXXXXXXXGXXXXXXXXXXXXXXXXXXXGXXXXXXXXXXXXXXXXXXXGXXXXXXXXXXXXXXXXXXXGXXXXXXXXXXXXXXXXXXXGXXXXXXXXXXXXXXXXXXXGXXXXXXXXXXXXXXXXXXXGXXXXXXXXXXXXXXXXXXXGXXXXXXXXXXXXXXXXXXXGXXXXXXXXXXXXXXXXXXX,0,300,0

20580,13,0,13,62,225,0,0,237,135,102,GXXXXXXXXXXXXXXXXXXXGXXXXXXXXXXXXXXXXXXXGXXXXXXXXXXXXXXXXXXXGXXXXXXXXXXXXXXXXXXXGXXXXXXXXXXXXXXXXXXXGXXXXXXXXXXXXXXXXXXXGXXXXXXXXXXXXXXXXXXXGXXXXXXXXXXXXXXXXXXXGXXXXXXXXXXXXXXXXXXXGXXXXXXXXXXXXXXXXXXXGXXXXXXXXXXXXXXXXXXXGXXXXXXXXXXXXXXXXXXXGXXXXXXXXXXXXXXXXXXX,0,300,0
20601,13,0,13,61,226,0,0,238,136,102,GXXXXXXXXXXXXXXXXXXXGXXXXXXXXXXXXXXXXXXXGXXXXXXXXXXXXXXXXXXXGXXXXXXXXXXXXXXXXXXXGXXXXXXXXXXXXXXXXXXXGXXXXXXXXXXXXXXXXXXXGXXXXXXXXXXXXXXXXXXXGXXXXXXXXXXXXXXXXXXXGXXXXXXXXXXXXXXXXXXXGXXXXXXXXXXXXXXXXXXXGXXXXXXXXXXXXXXXXXXXGXXXXXXXXXXXXXXXXXXXGXXXXXXXXXXXXXXXXXXX,0,300,0
20622,13,0,13,65,222,0,0,234,136,98,GXXXXXXXXXXXXXXXXXXXGXXXXXXXXXXXXXXXXXXXGXXXXXXXXXXXXXXXXXXXGXXXXXXXXXXXXXXXXXXXGXXXXXXXXXXXXXXXXXXXGXXXXXXXXXXXXXXXXXXXGXXXXXXXXXXXXXXXXXXXGXXXXXXXXXXXXXXXXXXXGXXXXXXXXXXXXXXXXXXXGXXXXXXXXXXXXXXXXXXXGXXXXXXXXXXXXXXXXXXXGXXXXXXXXXXXXXXXXXXXGXXXXXXXXXXXXXXXXXXX,0,300,0
20643,13,0,13,67,220,0,0,232,128,104,GXXXXXXXXXXXXXXXXXXXGXXXXXXXXXXXXXXXXXXXGXXXXXXXXXXXXXXXXXXXGXXXXXXXXXXXXXXXXXXXGXXXXXXXXXXXXXXXXXXXGXXXXXXXXXXXXXXXXXXXGXXXXXXXXXXXXXXXXXXXGXXXXXXXXXXXXXXXXXXXGXXXXXXXXXXXXXXXXXXXGXXXXXXXXXXXXXXXXXXXGXXXXXXXXXXXXXXXXXXXGXXXXXXXXXXXXXXXXXXXGXXXXXXXXXXXXXXXXXXX,0,300,0
20664,13,0,13,65,222,0,0,234,132,102,GXXXXXXXXXXXXXXXXXXXGXXXXXXXXXXXXXXXXXXXGXXXXXXXXXXXXXXXXXXXGXXXXXXXXXXXXXXXXXXXGXXXXXXXXXXXXXXXXXXXGXXXXXXXXXXXXXXXXXXXGXXXXXXXXXXXXXXXXXXXGXXXXXXXXXXXXXXXXXXXGXXXXXXXXXXXXXXXXXXXGXXXXXXXXXXXXXXXXXXXGXXXXXXXXXXXXXXXXXXXGXXXXXXXXXXXXXXXXXXXGXXXXXXXXXXXXXXXXXXX,0,300,0

20685,13,0,13,63,224,0,0,236,131,105,GXXXXXXXXXXXXXXXXXXXGXXXXXXXXXXXXXXXXXXXGXXXXXXXXXXXXXXXXXXXGXXXXXXXXXXXXXXXXXXXGXXXXXXXXXXXXXXXXXXXGXXXXXXXXXXXXXXXXXXXGXXXXXXXXXXXXXXXXXXXGXXXXXXXXXXXXXXXXXXXGXXXXXXXXXXXXXXXXXXXGXXXXXXXXXXXXXXXXXXXGXXXXXXXXXXXXXXXXXXXGXXXXXXXXXXXXXXXXXXXGXXXXXXXXXXXXXXXXXXX,0,300,0
20706,13,0,13,60,227,0,0,239,127,112,GXXXXXXXXXXXXXXXXXXXGXXXXXXXXXXXXXXXXXXXGXXXXXXXXXXXXXXXXXXXGXXXXXXXXXXXXXXXXXXXGXXXXXXXXXXXXXXXXXXXGXXXXXXXXXXXXXXXXXXXGXXXXXXXXXXXXXXXXXXXGXXXXXXXXXXXXXXXXXXXGXXXXXXXXXXXXXXXXXXXGXXXXXXXXXXXXXXXXXXXGXXXXXXXXXXXXXXXXXXXGXXXXXXXXXXXXXXXXXXXGXXXXXXXXXXXXXXXXXXX,0,300,0
20727,14,1,13,57,229,0,0,240,130,110,GXXXXXXXXXXXXXXXXXXXGXXXXXXXXXXXXXXXXXXXGXXXXXXXXXXXXXXXXXXXGXXXXXXXXXXXXXXXXXXXGXXXXXXXXXXXXXXXXXXXGXXXXXXXXXXXXXXXXXXXGXXXXXXXXXXXXXXXXXXXGXXXXXXXXXXXXXXXXXXXGXXXXXXXXXXXXXXXXXXXGAXXXXXXXXXXXXXXXXXXGXXXXXXXXXXXXXXXXXXXGXXXXXXXXXXXXXXXXXXXGXXXXXXXXXXXXXXXXXXX,0,300,0
20748,14,1,13,58,228,0,0,240,128,112,GXXXXXXXXXXXXXXXXXXXGXXXXXXXXXXXXXXXXXXXGXXXXXXXXXXXXXXXXXXXGXXXXXXXXXXXXXXXXXXXGXXXXXXXXXXXXXXXXXXXGXXXXXXXXXXXXXXXXXXXGXXXXXXXXXXXXXXXXXXXGXXXXXXXXXXXXXXXXXXXGXXXXXXXXXXXXXXXXXXXGAXXXXXXXXXXXXXXXXXXGXXXXXXXXXXXXXXXXXXXGXXXXXXXXXXXXXXXXXXXGXXXXXXXXXXXXXXXXXXX,0,300,0
20769,15,2,13,56,229,0,0,241,128,113,GXXXXXXXXXXXXXXXXXXXGXXXXXXXXXXXXXXXXXXXGXXXXXXXXXXXXXXXXXXXGXXXXXXXXXXXXXXXXXXXGXXXXXXXXXXXXXXXXXXXGXXXXXXXXXXXXXXXXXXXGXXXXXXXXXXXXXXXXXXXGAXXXXXXXXXXXXXXXXXXGXXXXXXXXXXXXXXXXXXXGAXXXXXXXXXXXXXXXXXXGXXXXXXXXXXXXXXXXXXXGXXXXXXXXXXXXXXXXXXXGXXXXXXXXXXXXXXXXXXX,0,300,0

20790,15,2,13,56,229,0,0,241,127,114,GXXXXXXXXXXXXXXXXXXXGXXXXXXXXXXXXXXXXXXXGXXXXXXXXXXXXXXXXXXXGXXXXXXXXXXXXXXXXXXXGXXXXXXXXXXXXXXXXXXXGXXXXXXXXXXXXXXXXXXXGXXXXXXXXXXXXXXXXXXXGAXXXXXXXXXXXXXXXXXXGXXXXXXXXXXXXXXXXXXXGAXXXXXXXXXXXXXXXXXXGXXXXXXXXXXXXXXXXXXXGXXXXXXXXXXXXXXXXXXXGXXXXXXXXXXXXXXXXXXX,0,300,0
20811,15,2,13,56,229,0,0,241,131,110,GXXXXXXXXXXXXXXXXXXXGXXXXXXXXXXXXXXXXXXXGXXXXXXXXXXXXXXXXXXXGXXXXXXXXXXXXXXXXXXXGXXXXXXXXXXXXXXXXXXXGXXXXXXXXXXXXXXXXXXXGXXXXXXXXXXXXXXXXXXXGAXXXXXXXXXXXXXXXXXXGXXXXXXXXXXXXXXXXXXXGAXXXXXXXXXXXXXXXXXXGXXXXXXXXXXXXXXXXXXXGXXXXXXXXXXXXXXXXXXXGXXXXXXXXXXXXXXXXXXX,0,300,0
20832,15,2,13,63,222,0,0,234,130,104,GXXXXXXXXXXXXXXXXXXXGXXXXXXXXXXXXXXXXXXXGXXXXXXXXXXXXXXXXXXXGXXXXXXXXXXXXXXXXXXXGXXXXXXXXXXXXXXXXXXXGXXXXXXXXXXXXXXXXXXXGXXXXXXXXXXXXXXXXXXXGAXXXXXXXXXXXXXXXXXXGXXXXXXXXXXXXXXXXXXXGAXXXXXXXXXXXXXXXXXXGXXXXXXXXXXXXXXXXXXXGXXXXXXXXXXXXXXXXXXXGXXXXXXXXXXXXXXXXXXX,0,300,0
20853,15,2,13,64,221,0,0,233,132,101,GXXXXXXXXXXXXXXXXXXXGXXXXXXXXXXXXXXXXXXXGXXXXXXXXXXXXXXXXXXXGXXXXXXXXXXXXXXXXXXXGXXXXXXXXXXXXXXXXXXXGXXXXXXXXXXXXXXXXXXXGXXXXXXXXXXXXXXXXXXXGAXXXXXXXXXXXXXXXXXXGXXXXXXXXXXXXXXXXXXXGAXXXXXXXXXXXXXXXXXXGXXXXXXXXXXXXXXXXXXXGXXXXXXXXXXXXXXXXXXXGXXXXXXXXXXXXXXXXXXX,0,300,0
20874,16,3,13,62,222,0,0,234,131,103,GAXXXXXXXXXXXXXXXXXXGXXXXXXXXXXXXXXXXXXXGXXXXXXXXXXXXXXXXXXXGXXXXXXXXXXXXXXXXXXXGXXXXXXXXXXXXXXXXXXXGXXXXXXXXXXXXXXXXXXXGXXXXXXXXXXXXXXXXXXXGAXXXXXXXXXXXXXXXXXXGXXXXXXXXXXXXXXXXXXXGAXXXXXXXXXXXXXXXXXXGXXXXXXXXXXXXXXXXXXXGXXXXXXXXXXXXXXXXXXXGXXXXXXXXXXXXXXXXXXX,0,300,0

20895,16,3,13,63,221,0,0,231,135,96,GAXXXXXXXXXXXXXXXXXXGXXXXXXXXXXXXXXXXXXXGXXXXXXXXXXXXXXXXXXXGXXXXXXXXXXXXXXXXXXXGXXXXXXXXXXXXXXXXXXXGXXXXXXXXXXXXXXXXXXXGXXXXXXXXXXXXXXXXXXXGAXXXXXXXXXXXXXXXXXXGXXXXXXXXXXXXXXXXXXXGAXXXXXXXXXXXXXXXXXXGXXXXXXXXXXXXXXXXXXXGXXXXXXXXXXXXXXXXXXXGXXXXXXXXXXXXXXXXXXX,0,300,0
20916,15,2,13,59,226,0,0,238,142,96,GAXXXXXXXXXXXXXXXXXXGXXXXXXXXXXXXXXXXXXXGXXXXXXXXXXXXXXXXXXXGXXXXXXXXXXXXXXXXXXXGXXXXXXXXXXXXXXXXXXXGXXXXXXXXXXXXXXXXXXXGXXXXXXXXXXXXXXXXXXXGXXXXXXXXXXXXXXXXXXXGXXXXXXXXXXXXXXXXXXXGAXXXXXXXXXXXXXXXXXXGXXXXXXXXXXXXXXXXXXXGXXXXXXXXXXXXXXXXXXXGXXXXXXXXXXXXXXXXXXX,0,300,0
20937,16,3,13,65,219,0,0,232,139,93,GAXXXXXXXXXXXXXXXXXXGXXXXXXXXXXXXXXXXXXXGXXXXXXXXXXXXXXXXXXXGXXXXXXXXXXXXXXXXXXXGAXXXXXXXXXXXXXXXXXXGXXXXXXXXXXXXXXXXXXXGXXXXXXXXXXXXXXXXXXXGXXXXXXXXXXXXXXXXXXXGXXXXXXXXXXXXXXXXXXXGAXXXXXXXXXXXXXXXXXXGXXXXXXXXXXXXXXXXXXXGXXXXXXXXXXXXXXXXXXXGXXXXXXXXXXXXXXXXXXX,0,300,0
20958,16,3,13,65,219,0,0,231,139,92,GAXXXXXXXXXXXXXXXXXXGXXXXXXXXXXXXXXXXXXXGXXXXXXXXXXXXXXXXXXXGXXXXXXXXXXXXXXXXXXXGAXXXXXXXXXXXXXXXXXXGXXXXXXXXXXXXXXXXXXXGXXXXXXXXXXXXXXXXXXXGXXXXXXXXXXXXXXXXXXXGXXXXXXXXXXXXXXXXXXXGAXXXXXXXXXXXXXXXXXXGXXXXXXXXXXXXXXXXXXXGXXXXXXXXXXXXXXXXXXXGXXXXXXXXXXXXXXXXXXX,0,300,0
20979,15,2,13,73,212,0,0,224,133,91,GAXXXXXXXXXXXXXXXXXXGXXXXXXXXXXXXXXXXXXXGXXXXXXXXXXXXXXXXXXXGXXXXXXXXXXXXXXXXXXXGAXXXXXXXXXXXXXXXXXXGXXXXXXXXXXXXXXXXXXXGXXXXXXXXXXXXXXXXXXXGXXXXXXXXXXXXXXXXXXXGXXXXXXXXXXXXXXXXXXXGXXXXXXXXXXXXXXXXXXXGXXXXXXXXXXXXXXXXXXXGXXXXXXXXXXXXXXXXXXXGXXXXXXXXXXXXXXXXXXX,0,300,0

21000,16,2,14,72,212,0,0,224,135,89,GAXXXXXXXXXXXXXXXXXXGXXXXXXXXXXXXXXXXXXXGXXXXXXXXXXXXXXXXXXXGXXXXXXXXXXXXXXXXXXXGOXXXXXXXXXXXXXXXXXXGXXXXXXXXXXXXXXXXXXXGXXXXXXXXXXXXXXXXXXXGXXXXXXXXXXXXXXXXXXXGXXXXXXXXXXXXXXXXXXXGXXXXXXXXXXXXXXXXXXXGAXXXXXXXXXXXXXXXXXXGXXXXXXXXXXXXXXXXXXXGXXXXXXXXXXXXXXXXXXX,0,300,0
21021,15,1,14,76,209,0,0,221,135,86,GOXXXXXXXXXXXXXXXXXXGXXXXXXXXXXXXXXXXXXXGXXXXXXXXXXXXXXXXXXXGXXXXXXXXXXXXXXXXXXXGXXXXXXXXXXXXXXXXXXXGXXXXXXXXXXXXXXXXXXXGXXXXXXXXXXXXXXXXXXXGXXXXXXXXXXXXXXXXXXXGXXXXXXXXXXXXXXXXXXXGXXXXXXXXXXXXXXXXXXXGAXXXXXXXXXXXXXXXXXXGXXXXXXXXXXXXXXXXXXXGXXXXXXXXXXXXXXXXXXX,0,300,0
21042,15,0,15,74,211,0,0,224,133,91,GOXXXXXXXXXXXXXXXXXXGXXXXXXXXXXXXXXXXXXXGXXXXXXXXXXXXXXXXXXXGXXXXXXXXXXXXXXXXXXXGXXXXXXXXXXXXXXXXXXXGXXXXXXXXXXXXXXXXXXXGXXXXXXXXXXXXXXXXXXXGXXXXXXXXXXXXXXXXXXXGXXXXXXXXXXXXXXXXXXXGXXXXXXXXXXXXXXXXXXXGOXXXXXXXXXXXXXXXXXXGXXXXXXXXXXXXXXXXXXXGXXXXXXXXXXXXXXXXXXX,0,300,0
21063,13,0,13,65,222,0,0,234,133,101,GXXXXXXXXXXXXXXXXXXXGXXXXXXXXXXXXXXXXXXXGXXXXXXXXXXXXXXXXXXXGXXXXXXXXXXXXXXXXXXXGXXXXXXXXXXXXXXXXXXXGXXXXXXXXXXXXXXXXXXXGXXXXXXXXXXXXXXXXXXXGXXXXXXXXXXXXXXXXXXXGXXXXXXXXXXXXXXXXXXXGXXXXXXXXXXXXXXXXXXXGXXXXXXXXXXXXXXXXXXXGXXXXXXXXXXXXXXXXXXXGXXXXXXXXXXXXXXXXXXX,0,300,0
21084,13,0,13,62,225,0,0,238,130,108,GXXXXXXXXXXXXXXXXXXXGXXXXXXXXXXXXXXXXXXXGXXXXXXXXXXXXXXXXXXXGXXXXXXXXXXXXXXXXXXXGXXXXXXXXXXXXXXXXXXXGXXXXXXXXXXXXXXXXXXXGXXXXXXXXXXXXXXXXXXXGXXXXXXXXXXXXXXXXXXXGXXXXXXXXXXXXXXXXXXXGXXXXXXXXXXXXXXXXXXXGXXXXXXXXXXXXXXXXXXXGXXXXXXXXXXXXXXXXXXXGXXXXXXXXXXXXXXXXXXX,0,300,0

21105,13,0,13,60,227,0,0,238,132,106,GXXXXXXXXXXXXXXXXXXXGXXXXXXXXXXXXXXXXXXXGXXXXXXXXXXXXXXXXXXXGXXXXXXXXXXXXXXXXXXXGXXXXXXXXXXXXXXXXXXXGXXXXXXXXXXXXXXXXXXXGXXXXXXXXXXXXXXXXXXXGXXXXXXXXXXXXXXXXXXXGXXXXXXXXXXXXXXXXXXXGXXXXXXXXXXXXXXXXXXXGXXXXXXXXXXXXXXXXXXXGXXXXXXXXXXXXXXXXXXXGXXXXXXXXXXXXXXXXXXX,0,300,0
21126,13,0,13,61,226,0,0,238,128,110,GXXXXXXXXXXXXXXXXXXXGXXXXXXXXXXXXXXXXXXXGXXXXXXXXXXXXXXXXXXXGXXXXXXXXXXXXXXXXXXXGXXXXXXXXXXXXXXXXXXXGXXXXXXXXXXXXXXXXXXXGXXXXXXXXXXXXXXXXXXXGXXXXXXXXXXXXXXXXXXXGXXXXXXXXXXXXXXXXXXXGXXXXXXXXXXXXXXXXXXXGXXXXXXXXXXXXXXXXXXXGXXXXXXXXXXXXXXXXXXXGXXXXXXXXXXXXXXXXXXX,0,300,0
21147,13,0,13,60,227,0,0,239,132,107,GXXXXXXXXXXXXXXXXXXXGXXXXXXXXXXXXXXXXXXXGXXXXXXXXXXXXXXXXXXXGXXXXXXXXXXXXXXXXXXXGXXXXXXXXXXXXXXXXXXXGXXXXXXXXXXXXXXXXXXXGXXXXXXXXXXXXXXXXXXXGXXXXXXXXXXXXXXXXXXXGXXXXXXXXXXXXXXXXXXXGXXXXXXXXXXXXXXXXXXXGXXXXXXXXXXXXXXXXXXXGXXXXXXXXXXXXXXXXXXXGXXXXXXXXXXXXXXXXXXX,0,300,0
21168,13,0,13,60,227,0,0,239,130,109,GXXXXXXXXXXXXXXXXXXXGXXXXXXXXXXXXXXXXXXXGXXXXXXXXXXXXXXXXXXXGXXXXXXXXXXXXXXXXXXXGXXXXXXXXXXXXXXXXXXXGXXXXXXXXXXXXXXXXXXXGXXXXXXXXXXXXXXXXXXXGXXXXXXXXXXXXXXXXXXXGXXXXXXXXXXXXXXXXXXXGXXXXXXXXXXXXXXXXXXXGXXXXXXXXXXXXXXXXXXXGXXXXXXXXXXXXXXXXXXXGXXXXXXXXXXXXXXXXXXX,0,300,0
21189,13,0,13,62,225,0,0,237,127,110,GXXXXXXXXXXXXXXXXXXXGXXXXXXXXXXXXXXXXXXXGXXXXXXXXXXXXXXXXXXXGXXXXXXXXXXXXXXXXXXXGXXXXXXXXXXXXXXXXXXXGXXXXXXXXXXXXXXXXXXXGXXXXXXXXXXXXXXXXXXXGXXXXXXXXXXXXXXXXXXXGXXXXXXXXXXXXXXXXXXXGXXXXXXXXXXXXXXXXXXXGXXXXXXXXXXXXXXXXXXXGXXXXXXXXXXXXXXXXXXXGXXXXXXXXXXXXXXXXXXX,0,300,0

21210,13,0,13,58,229,0,0,240,126,114,GXXXXXXXXXXXXXXXXXXXGXXXXXXXXXXXXXXXXXXXGXXXXXXXXXXXXXXXXXXXGXXXXXXXXXXXXXXXXXXXGXXXXXXXXXXXXXXXXXXXGXXXXXXXXXXXXXXXXXXXGXXXXXXXXXXXXXXXXXXXGXXXXXXXXXXXXXXXXXXXGXXXXXXXXXXXXXXXXXXXGXXXXXXXXXXXXXXXXXXXGXXXXXXXXXXXXXXXXXXXGXXXXXXXXXXXXXXXXXXXGXXXXXXXXXXXXXXXXXXX,0,300,0
21231,13,0,13,61,226,0,0,237,125,112,GXXXXXXXXXXXXXXXXXXXGXXXXXXXXXXXXXXXXXXXGXXXXXXXXXXXXXXXXXXXGXXXXXXXXXXXXXXXXXXXGXXXXXXXXXXXXXXXXXXXGXXXXXXXXXXXXXXXXXXXGXXXXXXXXXXXXXXXXXXXGXXXXXXXXXXXXXXXXXXXGXXXXXXXXXXXXXXXXXXXGXXXXXXXXXXXXXXXXXXXGXXXXXXXXXXXXXXXXXXXGXXXXXXXXXXXXXXXXXXXGXXXXXXXXXXXXXXXXXXX,0,300,0
21252,13,0,13,60,227,0,0,240,125,115,GXXXXXXXXXXXXXXXXXXXGXXXXXXXXXXXXXXXXXXXGXXXXXXXXXXXXXXXXXXXGXXXXXXXXXXXXXXXXXXXGXXXXXXXXXXXXXXXXXXXGXXXXXXXXXXXXXXXXXXXGXXXXXXXXXXXXXXXXXXXGXXXXXXXXXXXXXXXXXXXGXXXXXXXXXXXXXXXXXXXGXXXXXXXXXXXXXXXXXXXGXXXXXXXXXXXXXXXXXXXGXXXXXXXXXXXXXXXXXXXGXXXXXXXXXXXXXXXXXXX,0,300,0
21273,13,0,13,58,229,0,0,241,126,115,GXXXXXXXXXXXXXXXXXXXGXXXXXXXXXXXXXXXXXXXGXXXXXXXXXXXXXXXXXXXGXXXXXXXXXXXXXXXXXXXGXXXXXXXXXXXXXXXXXXXGXXXXXXXXXXXXXXXXXXXGXXXXXXXXXXXXXXXXXXXGXXXXXXXXXXXXXXXXXXXGXXXXXXXXXXXXXXXXXXXGXXXXXXXXXXXXXXXXXXXGXXXXXXXXXXXXXXXXXXXGXXXXXXXXXXXXXXXXXXXGXXXXXXXXXXXXXXXXXXX,0,300,0
21294,13,0,13,56,231,0,0,242,130,112,GXXXXXXXXXXXXXXXXXXXGXXXXXXXXXXXXXXXXXXXGXXXXXXXXXXXXXXXXXXXGXXXXXXXXXXXXXXXXXXXGXXXXXXXXXXXXXXXXXXXGXXXXXXXXXXXXXXXXXXXGXXXXXXXXXXXXXXXXXXXGXXXXXXXXXXXXXXXXXXXGXXXXXXXXXXXXXXXXXXXGXXXXXXXXXXXXXXXXXXXGXXXXXXXXXXXXXXXXXXXGXXXXXXXXXXXXXXXXXXXGXXXXXXXXXXXXXXXXXXX,0,300,0

21315,13,0,13,55,232,0,0,243,127,116,GXXXXXXXXXXXXXXXXXXXGXXXXXXXXXXXXXXXXXXXGXXXXXXXXXXXXXXXXXXXGXXXXXXXXXXXXXXXXXXXGXXXXXXXXXXXXXXXXXXXGXXXXXXXXXXXXXXXXXXXGXXXXXXXXXXXXXXXXXXXGXXXXXXXXXXXXXXXXXXXGXXXXXXXXXXXXXXXXXXXGXXXXXXXXXXXXXXXXXXXGXXXXXXXXXXXXXXXXXXXGXXXXXXXXXXXXXXXXXXXGXXXXXXXXXXXXXXXXXXX,0,300,0
21336,13,0,13,56,231,0,0,243,129,114,GXXXXXXXXXXXXXXXXXXXGXXXXXXXXXXXXXXXXXXXGXXXXXXXXXXXXXXXXXXXGXXXXXXXXXXXXXXXXXXXGXXXXXXXXXXXXXXXXXXXGXXXXXXXXXXXXXXXXXXXGXXXXXXXXXXXXXXXXXXXGXXXXXXXXXXXXXXXXXXXGXXXXXXXXXXXXXXXXXXXGXXXXXXXXXXXXXXXXXXXGXXXXXXXXXXXXXXXXXXXGXXXXXXXXXXXXXXXXXXXGXXXXXXXXXXXXXXXXXXX,0,300,0
21357,13,0,13,56,231,0,0,242,134,108,GXXXXXXXXXXXXXXXXXXXGXXXXXXXXXXXXXXXXXXXGXXXXXXXXXXXXXXXXXXXGXXXXXXXXXXXXXXXXXXXGXXXXXXXXXXXXXXXXXXXGXXXXXXXXXXXXXXXXXXXGXXXXXXXXXXXXXXXXXXXGXXXXXXXXXXXXXXXXXXXGXXXXXXXXXXXXXXXXXXXGXXXXXXXXXXXXXXXXXXXGXXXXXXXXXXXXXXXXXXXGXXXXXXXXXXXXXXXXXXXGXXXXXXXXXXXXXXXXXXX,0,300,0
21378,13,0,13,57,230,0,0,241,130,111,GXXXXXXXXXXXXXXXXXXXGXXXXXXXXXXXXXXXXXXXGXXXXXXXXXXXXXXXXXXXGXXXXXXXXXXXXXXXXXXXGXXXXXXXXXXXXXXXXXXXGXXXXXXXXXXXXXXXXXXXGXXXXXXXXXXXXXXXXXXXGXXXXXXXXXXXXXXXXXXXGXXXXXXXXXXXXXXXXXXXGXXXXXXXXXXXXXXXXXXXGXXXXXXXXXXXXXXXXXXXGXXXXXXXXXXXXXXXXXXXGXXXXXXXXXXXXXXXXXXX,0,300,0
21399,13,0,13,56,231,0,0,243,128,115,GXXXXXXXXXXXXXXXXXXXGXXXXXXXXXXXXXXXXXXXGXXXXXXXXXXXXXXXXXXXGXXXXXXXXXXXXXXXXXXXGXXXXXXXXXXXXXXXXXXXGXXXXXXXXXXXXXXXXXXXGXXXXXXXXXXXXXXXXXXXGXXXXXXXXXXXXXXXXXXXGXXXXXXXXXXXXXXXXXXXGXXXXXXXXXXXXXXXXXXXGXXXXXXXXXXXXXXXXXXXGXXXXXXXXXXXXXXXXXXXGXXXXXXXXXXXXXXXXXXX,0,300,0

21420,13,0,13,54,233,0,0,243,133,110,GXXXXXXXXXXXXXXXXXXXGXXXXXXXXXXXXXXXXXXXGXXXXXXXXXXXXXXXXXXXGXXXXXXXXXXXXXXXXXXXGXXXXXXXXXXXXXXXXXXXGXXXXXXXXXXXXXXXXXXXGXXXXXXXXXXXXXXXXXXXGXXXXXXXXXXXXXXXXXXXGXXXXXXXXXXXXXXXXXXXGXXXXXXXXXXXXXXXXXXXGXXXXXXXXXXXXXXXXXXXGXXXXXXXXXXXXXXXXXXXGXXXXXXXXXXXXXXXXXXX,0,300,0
21441,13,0,13,55,232,0,0,244,133,111,GXXXXXXXXXXXXXXXXXXXGXXXXXXXXXXXXXXXXXXXGXXXXXXXXXXXXXXXXXXXGXXXXXXXXXXXXXXXXXXXGXXXXXXXXXXXXXXXXXXXGXXXXXXXXXXXXXXXXXXXGXXXXXXXXXXXXXXXXXXXGXXXXXXXXXXXXXXXXXXXGXXXXXXXXXXXXXXXXXXXGXXXXXXXXXXXXXXXXXXXGXXXXXXXXXXXXXXXXXXXGXXXXXXXXXXXXXXXXXXXGXXXXXXXXXXXXXXXXXXX,0,300,0
21462,13,0,13,53,234,0,0,246,135,111,GXXXXXXXXXXXXXXXXXXXGXXXXXXXXXXXXXXXXXXXGXXXXXXXXXXXXXXXXXXXGXXXXXXXXXXXXXXXXXXXGXXXXXXXXXXXXXXXXXXXGXXXXXXXXXXXXXXXXXXXGXXXXXXXXXXXXXXXXXXXGXXXXXXXXXXXXXXXXXXXGXXXXXXXXXXXXXXXXXXXGXXXXXXXXXXXXXXXXXXXGXXXXXXXXXXXXXXXXXXXGXXXXXXXXXXXXXXXXXXXGXXXXXXXXXXXXXXXXXXX,0,300,0
21483,13,0,13,54,233,0,0,245,140,105,GXXXXXXXXXXXXXXXXXXXGXXXXXXXXXXXXXXXXXXXGXXXXXXXXXXXXXXXXXXXGXXXXXXXXXXXXXXXXXXXGXXXXXXXXXXXXXXXXXXXGXXXXXXXXXXXXXXXXXXXGXXXXXXXXXXXXXXXXXXXGXXXXXXXXXXXXXXXXXXXGXXXXXXXXXXXXXXXXXXXGXXXXXXXXXXXXXXXXXXXGXXXXXXXXXXXXXXXXXXXGXXXXXXXXXXXXXXXXXXXGXXXXXXXXXXXXXXXXXXX,0,300,0
21504,13,0,13,56,231,0,0,243,138,105,GXXXXXXXXXXXXXXXXXXXGXXXXXXXXXXXXXXXXXXXGXXXXXXXXXXXXXXXXXXXGXXXXXXXXXXXXXXXXXXXGXXXXXXXXXXXXXXXXXXXGXXXXXXXXXXXXXXXXXXXGXXXXXXXXXXXXXXXXXXXGXXXXXXXXXXXXXXXXXXXGXXXXXXXXXXXXXXXXXXXGXXXXXXXXXXXXXXXXXXXGXXXXXXXXXXXXXXXXXXXGXXXXXXXXXXXXXXXXXXXGXXXXXXXXXXXXXXXXXXX,0,300,0

21525,13,0,13,60,227,0,0,239,141,98,GXXXXXXXXXXXXXXXXXXXGXXXXXXXXXXXXXXXXXXXGXXXXXXXXXXXXXXXXXXXGXXXXXXXXXXXXXXXXXXXGXXXXXXXXXXXXXXXXXXXGXXXXXXXXXXXXXXXXXXXGXXXXXXXXXXXXXXXXXXXGXXXXXXXXXXXXXXXXXXXGXXXXXXXXXXXXXXXXXXXGXXXXXXXXXXXXXXXXXXXGXXXXXXXXXXXXXXXXXXXGXXXXXXXXXXXXXXXXXXXGXXXXXXXXXXXXXXXXXXX,0,300,0
21546,13,0,13,64,223,0,0,235,140,95,GXXXXXXXXXXXXXXXXXXXGXXXXXXXXXXXXXXXXXXXGXXXXXXXXXXXXXXXXXXXGXXXXXXXXXXXXXXXXXXXGXXXXXXXXXXXXXXXXXXXGXXXXXXXXXXXXXXXXXXXGXXXXXXXXXXXXXXXXXXXGXXXXXXXXXXXXXXXXXXXGXXXXXXXXXXXXXXXXXXXGXXXXXXXXXXXXXXXXXXXGXXXXXXXXXXXXXXXXXXXGXXXXXXXXXXXXXXXXXXXGXXXXXXXXXXXXXXXXXXX,0,300,0
21567,13,0,13,66,221,0,0,233,141,92,GXXXXXXXXXXXXXXXXXXXGXXXXXXXXXXXXXXXXXXXGXXXXXXXXXXXXXXXXXXXGXXXXXXXXXXXXXXXXXXXGXXXXXXXXXXXXXXXXXXXGXXXXXXXXXXXXXXXXXXXGXXXXXXXXXXXXXXXXXXXGXXXXXXXXXXXXXXXXXXXGXXXXXXXXXXXXXXXXXXXGXXXXXXXXXXXXXXXXXXXGXXXXXXXXXXXXXXXXXXXGXXXXXXXXXXXXXXXXXXXGXXXXXXXXXXXXXXXXXXX,0,300,0
21588,13,0,13,69,218,0,0,230,138,92,GXXXXXXXXXXXXXXXXXXXGXXXXXXXXXXXXXXXXXXXGXXXXXXXXXXXXXXXXXXXGXXXXXXXXXXXXXXXXXXXGXXXXXXXXXXXXXXXXXXXGXXXXXXXXXXXXXXXXXXXGXXXXXXXXXXXXXXXXXXXGXXXXXXXXXXXXXXXXXXXGXXXXXXXXXXXXXXXXXXXGXXXXXXXXXXXXXXXXXXXGXXXXXXXXXXXXXXXXXXXGXXXXXXXXXXXXXXXXXXXGXXXXXXXXXXXXXXXXXXX,0,300,0
21609,13,0,13,67,220,0,0,232,135,97,GXXXXXXXXXXXXXXXXXXXGXXXXXXXXXXXXXXXXXXXGXXXXXXXXXXXXXXXXXXXGXXXXXXXXXXXXXXXXXXXGXXXXXXXXXXXXXXXXXXXGXXXXXXXXXXXXXXXXXXXGXXXXXXXXXXXXXXXXXXXGXXXXXXXXXXXXXXXXXXXGXXXXXXXXXXXXXXXXXXXGXXXXXXXXXXXXXXXXXXXGXXXXXXXXXXXXXXXXXXXGXXXXXXXXXXXXXXXXXXXGXXXXXXXXXXXXXXXXXXX,0,300,0

21630,14,1,13,63,223,0,0,235,135,100,GXXXXXXXXXXXXXXXXXXXGXXXXXXXXXXXXXXXXXXXGXXXXXXXXXXXXXXXXXXXGXXXXXXXXXXXXXXXXXXXGXXXXXXXXXXXXXXXXXXXGXXXXXXXXXXXXXXXXXXXGXXXXXXXXXXXXXXXXXXXGXXXXXXXXXXXXXXXXXXXGXXXXXXXXXXXXXXXXXXXGXXXXXXXXXXXXXXXXXXXGXXXXXXXXXXXXXXXXXXXGXXXXXXXXXXXXXXXXXXXGAXXXXXXXXXXXXXXXXXX,0,300,0
21651,14,1,13,64,222,0,0,234,133,101,GXXXXXXXXXXXXXXXXXXXGXXXXXXXXXXXXXXXXXXXGXXXXXXXXXXXXXXXXXXXGXXXXXXXXXXXXXXXXXXXGXXXXXXXXXXXXXXXXXXXGXXXXXXXXXXXXXXXXXXXGXXXXXXXXXXXXXXXXXXXGXXXXXXXXXXXXXXXXXXXGXXXXXXXXXXXXXXXXXXXGXXXXXXXXXXXXXXXXXXXGXXXXXXXXXXXXXXXXXXXGXXXXXXXXXXXXXXXXXXXGAXXXXXXXXXXXXXXXXXX,0,300,0
21672,14,1,13,64,222,0,0,234,129,105,GXXXXXXXXXXXXXXXXXXXGXXXXXXXXXXXXXXXXXXXGXXXXXXXXXXXXXXXXXXXGXXXXXXXXXXXXXXXXXXXGXXXXXXXXXXXXXXXXXXXGXXXXXXXXXXXXXXXXXXXGXXXXXXXXXXXXXXXXXXXGXXXXXXXXXXXXXXXXXXXGXXXXXXXXXXXXXXXXXXXGXXXXXXXXXXXXXXXXXXXGXXXXXXXXXXXXXXXXXXXGXXXXXXXXXXXXXXXXXXXGAXXXXXXXXXXXXXXXXXX,0,300,0
21693,14,1,13,62,224,0,0,236,134,102,GXXXXXXXXXXXXXXXXXXXGXXXXXXXXXXXXXXXXXXXGXXXXXXXXXXXXXXXXXXXGXXXXXXXXXXXXXXXXXXXGXXXXXXXXXXXXXXXXXXXGXXXXXXXXXXXXXXXXXXXGXXXXXXXXXXXXXXXXXXXGXXXXXXXXXXXXXXXXXXXGXXXXXXXXXXXXXXXXXXXGXXXXXXXXXXXXXXXXXXXGXXXXXXXXXXXXXXXXXXXGXXXXXXXXXXXXXXXXXXXGAXXXXXXXXXXXXXXXXXX,0,300,0
21714,14,1,13,59,227,0,0,240,137,103,GXXXXXXXXXXXXXXXXXXXGXXXXXXXXXXXXXXXXXXXGXXXXXXXXXXXXXXXXXXXGXXXXXXXXXXXXXXXXXXXGXXXXXXXXXXXXXXXXXXXGXXXXXXXXXXXXXXXXXXXGXXXXXXXXXXXXXXXXXXXGXXXXXXXXXXXXXXXXXXXGXXXXXXXXXXXXXXXXXXXGXXXXXXXXXXXXXXXXXXXGXXXXXXXXXXXXXXXXXXXGXXXXXXXXXXXXXXXXXXXGAXXXXXXXXXXXXXXXXXX,0,300,0

21735,14,1,13,66,220,0,0,233,133,100,GXXXXXXXXXXXXXXXXXXXGXXXXXXXXXXXXXXXXXXXGXXXXXXXXXXXXXXXXXXXGXXXXXXXXXXXXXXXXXXXGXXXXXXXXXXXXXXXXXXXGXXXXXXXXXXXXXXXXXXXGXXXXXXXXXXXXXXXXXXXGXXXXXXXXXXXXXXXXXXXGXXXXXXXXXXXXXXXXXXXGXXXXXXXXXXXXXXXXXXXGXXXXXXXXXXXXXXXXXXXGXXXXXXXXXXXXXXXXXXXGAXXXXXXXXXXXXXXXXXX,0,300,0
21756,13,0,13,66,221,0,0,234,130,104,GXXXXXXXXXXXXXXXXXXXGXXXXXXXXXXXXXXXXXXXGXXXXXXXXXXXXXXXXXXXGXXXXXXXXXXXXXXXXXXXGXXXXXXXXXXXXXXXXXXXGXXXXXXXXXXXXXXXXXXXGXXXXXXXXXXXXXXXXXXXGXXXXXXXXXXXXXXXXXXXGXXXXXXXXXXXXXXXXXXXGXXXXXXXXXXXXXXXXXXXGXXXXXXXXXXXXXXXXXXXGXXXXXXXXXXXXXXXXXXXGXXXXXXXXXXXXXXXXXXX,0,300,0
21777,13,0,13,58,229,0,0,240,133,107,GXXXXXXXXXXXXXXXXXXXGXXXXXXXXXXXXXXXXXXXGXXXXXXXXXXXXXXXXXXXGXXXXXXXXXXXXXXXXXXXGXXXXXXXXXXXXXXXXXXXGXXXXXXXXXXXXXXXXXXXGXXXXXXXXXXXXXXXXXXXGXXXXXXXXXXXXXXXXXXXGXXXXXXXXXXXXXXXXXXXGXXXXXXXXXXXXXXXXXXXGXXXXXXXXXXXXXXXXXXXGXXXXXXXXXXXXXXXXXXXGXXXXXXXXXXXXXXXXXXX,0,300,0
21798,13,0,13,58,229,0,0,240,130,110,GXXXXXXXXXXXXXXXXXXXGXXXXXXXXXXXXXXXXXXXGXXXXXXXXXXXXXXXXXXXGXXXXXXXXXXXXXXXXXXXGXXXXXXXXXXXXXXXXXXXGXXXXXXXXXXXXXXXXXXXGXXXXXXXXXXXXXXXXXXXGXXXXXXXXXXXXXXXXXXXGXXXXXXXXXXXXXXXXXXXGXXXXXXXXXXXXXXXXXXXGXXXXXXXXXXXXXXXXXXXGXXXXXXXXXXXXXXXXXXXGXXXXXXXXXXXXXXXXXXX,0,300,0
21819,13,0,13,58,229,0,0,241,133,108,GXXXXXXXXXXXXXXXXXXXGXXXXXXXXXXXXXXXXXXXGXXXXXXXXXXXXXXXXXXXGXXXXXXXXXXXXXXXXXXXGXXXXXXXXXXXXXXXXXXXGXXXXXXXXXXXXXXXXXXXGXXXXXXXXXXXXXXXXXXXGXXXXXXXXXXXXXXXXXXXGXXXXXXXXXXXXXXXXXXXGXXXXXXXXXXXXXXXXXXXGXXXXXXXXXXXXXXXXXXXGXXXXXXXXXXXXXXXXXXXGXXXXXXXXXXXXXXXXXXX,0,300,0

21840,13,0,13,57,230,0,0,242,134,108,GXXXXXXXXXXXXXXXXXXXGXXXXXXXXXXXXXXXXXXXGXXXXXXXXXXXXXXXXXXXGXXXXXXXXXXXXXXXXXXXGXXXXXXXXXXXXXXXXXXXGXXXXXXXXXXXXXXXXXXXGXXXXXXXXXXXXXXXXXXXGXXXXXXXXXXXXXXXXXXXGXXXXXXXXXXXXXXXXXXXGXXXXXXXXXXXXXXXXXXXGXXXXXXXXXXXXXXXXXXXGXXXXXXXXXXXXXXXXXXXGXXXXXXXXXXXXXXXXXXX,0,300,0
21861,13,0,13,56,231,0,0,243,137,106,GXXXXXXXXXXXXXXXXXXXGXXXXXXXXXXXXXXXXXXXGXXXXXXXXXXXXXXXXXXXGXXXXXXXXXXXXXXXXXXXGXXXXXXXXXXXXXXXXXXXGXXXXXXXXXXXXXXXXXXXGXXXXXXXXXXXXXXXXXXXGXXXXXXXXXXXXXXXXXXXGXXXXXXXXXXXXXXXXXXXGXXXXXXXXXXXXXXXXXXXGXXXXXXXXXXXXXXXXXXXGXXXXXXXXXXXXXXXXXXXGXXXXXXXXXXXXXXXXXXX,0,300,0
21882,13,0,13,55,232,0,0,244,142,102,GXXXXXXXXXXXXXXXXXXXGXXXXXXXXXXXXXXXXXXXGXXXXXXXXXXXXXXXXXXXGXXXXXXXXXXXXXXXXXXXGXXXXXXXXXXXXXXXXXXXGXXXXXXXXXXXXXXXXXXXGXXXXXXXXXXXXXXXXXXXGXXXXXXXXXXXXXXXXXXXGXXXXXXXXXXXXXXXXXXXGXXXXXXXXXXXXXXXXXXXGXXXXXXXXXXXXXXXXXXXGXXXXXXXXXXXXXXXXXXXGXXXXXXXXXXXXXXXXXXX,0,300,0
21903,13,0,13,63,224,0,0,236,138,98,GXXXXXXXXXXXXXXXXXXXGXXXXXXXXXXXXXXXXXXXGXXXXXXXXXXXXXXXXXXXGXXXXXXXXXXXXXXXXXXXGXXXXXXXXXXXXXXXXXXXGXXXXXXXXXXXXXXXXXXXGXXXXXXXXXXXXXXXXXXXGXXXXXXXXXXXXXXXXXXXGXXXXXXXXXXXXXXXXXXXGXXXXXXXXXXXXXXXXXXXGXXXXXXXXXXXXXXXXXXXGXXXXXXXXXXXXXXXXXXXGXXXXXXXXXXXXXXXXXXX,0,300,0
21924,13,0,13,56,231,0,0,243,138,105,GXXXXXXXXXXXXXXXXXXXGXXXXXXXXXXXXXXXXXXXGXXXXXXXXXXXXXXXXXXXGXXXXXXXXXXXXXXXXXXXGXXXXXXXXXXXXXXXXXXXGXXXXXXXXXXXXXXXXXXXGXXXXXXXXXXXXXXXXXXXGXXXXXXXXXXXXXXXXXXXGXXXXXXXXXXXXXXXXXXXGXXXXXXXXXXXXXXXXXXXGXXXXXXXXXXXXXXXXXXXGXXXXXXXXXXXXXXXXXXXGXXXXXXXXXXXXXXXXXXX,0,300,0

21945,13,0,13,59,228,0,0,240,134,106,GXXXXXXXXXXXXXXXXXXXGXXXXXXXXXXXXXXXXXXXGXXXXXXXXXXXXXXXXXXXGXXXXXXXXXXXXXXXXXXXGXXXXXXXXXXXXXXXXXXXGXXXXXXXXXXXXXXXXXXXGXXXXXXXXXXXXXXXXXXXGXXXXXXXXXXXXXXXXXXXGXXXXXXXXXXXXXXXXXXXGXXXXXXXXXXXXXXXXXXXGXXXXXXXXXXXXXXXXXXXGXXXXXXXXXXXXXXXXXXXGXXXXXXXXXXXXXXXXXXX,0,300,0
21966,13,0,13,59,228,0,0,240,137,103,GXXXXXXXXXXXXXXXXXXXGXXXXXXXXXXXXXXXXXXXGXXXXXXXXXXXXXXXXXXXGXXXXXXXXXXXXXXXXXXXGXXXXXXXXXXXXXXXXXXXGXXXXXXXXXXXXXXXXXXXGXXXXXXXXXXXXXXXXXXXGXXXXXXXXXXXXXXXXXXXGXXXXXXXXXXXXXXXXXXXGXXXXXXXXXXXXXXXXXXXGXXXXXXXXXXXXXXXXXXXGXXXXXXXXXXXXXXXXXXXGXXXXXXXXXXXXXXXXXXX,0,300,0
21987,13,0,13,66,221,0,0,232,137,95,GXXXXXXXXXXXXXXXXXXXGXXXXXXXXXXXXXXXXXXXGXXXXXXXXXXXXXXXXXXXGXXXXXXXXXXXXXXXXXXXGXXXXXXXXXXXXXXXXXXXGXXXXXXXXXXXXXXXXXXXGXXXXXXXXXXXXXXXXXXXGXXXXXXXXXXXXXXXXXXXGXXXXXXXXXXXXXXXXXXXGXXXXXXXXXXXXXXXXXXXGXXXXXXXXXXXXXXXXXXXGXXXXXXXXXXXXXXXXXXXGXXXXXXXXXXXXXXXXXXX,0,300,0
22008,13,0,13,66,221,0,0,232,140,92,GXXXXXXXXXXXXXXXXXXXGXXXXXXXXXXXXXXXXXXXGXXXXXXXXXXXXXXXXXXXGXXXXXXXXXXXXXXXXXXXGXXXXXXXXXXXXXXXXXXXGXXXXXXXXXXXXXXXXXXXGXXXXXXXXXXXXXXXXXXXGXXXXXXXXXXXXXXXXXXXGXXXXXXXXXXXXXXXXXXXGXXXXXXXXXXXXXXXXXXXGXXXXXXXXXXXXXXXXXXXGXXXXXXXXXXXXXXXXXXXGXXXXXXXXXXXXXXXXXXX,0,300,0
22029,13,0,13,67,220,0,0,232,136,96,GXXXXXXXXXXXXXXXXXXXGXXXXXXXXXXXXXXXXXXXGXXXXXXXXXXXXXXXXXXXGXXXXXXXXXXXXXXXXXXXGXXXXXXXXXXXXXXXXXXXGXXXXXXXXXXXXXXXXXXXGXXXXXXXXXXXXXXXXXXXGXXXXXXXXXXXXXXXXXXXGXXXXXXXXXXXXXXXXXXXGXXXXXXXXXXXXXXXXXXXGXXXXXXXXXXXXXXXXXXXGXXXXXXXXXXXXXXXXXXXGXXXXXXXXXXXXXXXXXXX,0,300,0

22050,13,0,13,73,214,0,0,226,133,93,GXXXXXXXXXXXXXXXXXXXGXXXXXXXXXXXXXXXXXXXGXXXXXXXXXXXXXXXXXXXGXXXXXXXXXXXXXXXXXXXGXXXXXXXXXXXXXXXXXXXGXXXXXXXXXXXXXXXXXXXGXXXXXXXXXXXXXXXXXXXGXXXXXXXXXXXXXXXXXXXGXXXXXXXXXXXXXXXXXXXGXXXXXXXXXXXXXXXXXXXGXXXXXXXXXXXXXXXXXXXGXXXXXXXXXXXXXXXXXXXGXXXXXXXXXXXXXXXXXXX,0,300,0
22071,13,0,13,67,220,0,0,232,138,94,GXXXXXXXXXXXXXXXXXXXGXXXXXXXXXXXXXXXXXXXGXXXXXXXXXXXXXXXXXXXGXXXXXXXXXXXXXXXXXXXGXXXXXXXXXXXXXXXXXXXGXXXXXXXXXXXXXXXXXXXGXXXXXXXXXXXXXXXXXXXGXXXXXXXXXXXXXXXXXXXGXXXXXXXXXXXXXXXXXXXGXXXXXXXXXXXXXXXXXXXGXXXXXXXXXXXXXXXXXXXGXXXXXXXXXXXXXXXXXXXGXXXXXXXXXXXXXXXXXXX,0,300,0
22092,13,0,13,63,224,0,0,236,140,96,GXXXXXXXXXXXXXXXXXXXGXXXXXXXXXXXXXXXXXXXGXXXXXXXXXXXXXXXXXXXGXXXXXXXXXXXXXXXXXXXGXXXXXXXXXXXXXXXXXXXGXXXXXXXXXXXXXXXXXXXGXXXXXXXXXXXXXXXXXXXGXXXXXXXXXXXXXXXXXXXGXXXXXXXXXXXXXXXXXXXGXXXXXXXXXXXXXXXXXXXGXXXXXXXXXXXXXXXXXXXGXXXXXXXXXXXXXXXXXXXGXXXXXXXXXXXXXXXXXXX,0,300,0
22113,13,0,13,59,228,0,0,240,137,103,GXXXXXXXXXXXXXXXXXXXGXXXXXXXXXXXXXXXXXXXGXXXXXXXXXXXXXXXXXXXGXXXXXXXXXXXXXXXXXXXGXXXXXXXXXXXXXXXXXXXGXXXXXXXXXXXXXXXXXXXGXXXXXXXXXXXXXXXXXXXGXXXXXXXXXXXXXXXXXXXGXXXXXXXXXXXXXXXXXXXGXXXXXXXXXXXXXXXXXXXGXXXXXXXXXXXXXXXXXXXGXXXXXXXXXXXXXXXXXXXGXXXXXXXXXXXXXXXXXXX,0,300,0
22134,13,0,13,56,231,0,0,241,136,105,GXXXXXXXXXXXXXXXXXXXGXXXXXXXXXXXXXXXXXXXGXXXXXXXXXXXXXXXXXXXGXXXXXXXXXXXXXXXXXXXGXXXXXXXXXXXXXXXXXXXGXXXXXXXXXXXXXXXXXXXGXXXXXXXXXXXXXXXXXXXGXXXXXXXXXXXXXXXXXXXGXXXXXXXXXXXXXXXXXXXGXXXXXXXXXXXXXXXXXXXGXXXXXXXXXXXXXXXXXXXGXXXXXXXXXXXXXXXXXXXGXXXXXXXXXXXXXXXXXXX,0,300,0

22155,13,0,13,57,230,0,0,242,137,105,GXXXXXXXXXXXXXXXXXXXGXXXXXXXXXXXXXXXXXXXGXXXXXXXXXXXXXXXXXXXGXXXXXXXXXXXXXXXXXXXGXXXXXXXXXXXXXXXXXXXGXXXXXXXXXXXXXXXXXXXGXXXXXXXXXXXXXXXXXXXGXXXXXXXXXXXXXXXXXXXGXXXXXXXXXXXXXXXXXXXGXXXXXXXXXXXXXXXXXXXGXXXXXXXXXXXXXXXXXXXGXXXXXXXXXXXXXXXXXXXGXXXXXXXXXXXXXXXXXXX,0,300,0
22176,13,0,13,64,223,0,0,235,136,99,GXXXXXXXXXXXXXXXXXXXGXXXXXXXXXXXXXXXXXXXGXXXXXXXXXXXXXXXXXXXGXXXXXXXXXXXXXXXXXXXGXXXXXXXXXXXXXXXXXXXGXXXXXXXXXXXXXXXXXXXGXXXXXXXXXXXXXXXXXXXGXXXXXXXXXXXXXXXXXXXGXXXXXXXXXXXXXXXXXXXGXXXXXXXXXXXXXXXXXXXGXXXXXXXXXXXXXXXXXXXGXXXXXXXXXXXXXXXXXXXGXXXXXXXXXXXXXXXXXXX,0,300,0
22197,14,1,13,64,222,0,0,235,132,103,GXXXXXXXXXXXXXXXXXXXGXXXXXXXXXXXXXXXXXXXGXXXXXXXXXXXXXXXXXXXGXXXXXXXXXXXXXXXXXXXGXXXXXXXXXXXXXXXXXXXGXXXXXXXXXXXXXXXXXXXGXXXXXXXXXXXXXXXXXXXGAXXXXXXXXXXXXXXXXXXGXXXXXXXXXXXXXXXXXXXGXXXXXXXXXXXXXXXXXXXGXXXXXXXXXXXXXXXXXXXGXXXXXXXXXXXXXXXXXXXGXXXXXXXXXXXXXXXXXXX,0,300,0
22218,14,1,13,64,222,0,0,235,137,98,GXXXXXXXXXXXXXXXXXXXGXXXXXXXXXXXXXXXXXXXGXXXXXXXXXXXXXXXXXXXGXXXXXXXXXXXXXXXXXXXGXXXXXXXXXXXXXXXXXXXGXXXXXXXXXXXXXXXXXXXGXXXXXXXXXXXXXXXXXXXGAXXXXXXXXXXXXXXXXXXGXXXXXXXXXXXXXXXXXXXGXXXXXXXXXXXXXXXXXXXGXXXXXXXXXXXXXXXXXXXGXXXXXXXXXXXXXXXXXXXGXXXXXXXXXXXXXXXXXXX,0,300,0
22239,14,1,13,65,221,0,0,233,140,93,GXXXXXXXXXXXXXXXXXXXGXXXXXXXXXXXXXXXXXXXGXXXXXXXXXXXXXXXXXXXGXXXXXXXXXXXXXXXXXXXGXXXXXXXXXXXXXXXXXXXGXXXXXXXXXXXXXXXXXXXGXXXXXXXXXXXXXXXXXXXGAXXXXXXXXXXXXXXXXXXGXXXXXXXXXXXXXXXXXXXGXXXXXXXXXXXXXXXXXXXGXXXXXXXXXXXXXXXXXXXGXXXXXXXXXXXXXXXXXXXGXXXXXXXXXXXXXXXXXXX,0,300,0

22260,14,1,13,57,229,0,0,242,140,102,GXXXXXXXXXXXXXXXXXXXGXXXXXXXXXXXXXXXXXXXGXXXXXXXXXXXXXXXXXXXGXXXXXXXXXXXXXXXXXXXGXXXXXXXXXXXXXXXXXXXGXXXXXXXXXXXXXXXXXXXGXXXXXXXXXXXXXXXXXXXGAXXXXXXXXXXXXXXXXXXGXXXXXXXXXXXXXXXXXXXGXXXXXXXXXXXXXXXXXXXGXXXXXXXXXXXXXXXXXXXGXXXXXXXXXXXXXXXXXXXGXXXXXXXXXXXXXXXXXXX,0,300,0
22281,14,1,13,61,225,0,0,238,140,98,GXXXXXXXXXXXXXXXXXXXGXXXXXXXXXXXXXXXXXXXGXXXXXXXXXXXXXXXXXXXGXXXXXXXXXXXXXXXXXXXGXXXXXXXXXXXXXXXXXXXGXXXXXXXXXXXXXXXXXXXGXXXXXXXXXXXXXXXXXXXGAXXXXXXXXXXXXXXXXXXGXXXXXXXXXXXXXXXXXXXGXXXXXXXXXXXXXXXXXXXGXXXXXXXXXXXXXXXXXXXGXXXXXXXXXXXXXXXXXXXGXXXXXXXXXXXXXXXXXXX,0,300,0
22302,14,1,13,60,226,0,0,237,138,99,GXXXXXXXXXXXXXXXXXXXGXXXXXXXXXXXXXXXXXXXGXXXXXXXXXXXXXXXXXXXGXXXXXXXXXXXXXXXXXXXGXXXXXXXXXXXXXXXXXXXGXXXXXXXXXXXXXXXXXXXGXXXXXXXXXXXXXXXXXXXGAXXXXXXXXXXXXXXXXXXGXXXXXXXXXXXXXXXXXXXGXXXXXXXXXXXXXXXXXXXGXXXXXXXXXXXXXXXXXXXGXXXXXXXXXXXXXXXXXXXGXXXXXXXXXXXXXXXXXXX,0,300,0
22323,14,1,13,58,228,0,0,241,136,105,GXXXXXXXXXXXXXXXXXXXGXXXXXXXXXXXXXXXXXXXGXXXXXXXXXXXXXXXXXXXGXXXXXXXXXXXXXXXXXXXGXXXXXXXXXXXXXXXXXXXGXXXXXXXXXXXXXXXXXXXGXXXXXXXXXXXXXXXXXXXGAXXXXXXXXXXXXXXXXXXGXXXXXXXXXXXXXXXXXXXGXXXXXXXXXXXXXXXXXXXGXXXXXXXXXXXXXXXXXXXGXXXXXXXXXXXXXXXXXXXGXXXXXXXXXXXXXXXXXXX,0,300,0
22344,14,1,13,55,231,0,0,243,133,110,GXXXXXXXXXXXXXXXXXXXGXXXXXXXXXXXXXXXXXXXGXXXXXXXXXXXXXXXXXXXGXXXXXXXXXXXXXXXXXXXGXXXXXXXXXXXXXXXXXXXGXXXXXXXXXXXXXXXXXXXGXXXXXXXXXXXXXXXXXXXGAXXXXXXXXXXXXXXXXXXGXXXXXXXXXXXXXXXXXXXGXXXXXXXXXXXXXXXXXXXGXXXXXXXXXXXXXXXXXXXGXXXXXXXXXXXXXXXXXXXGXXXXXXXXXXXXXXXXXXX,0,300,0

22365,14,1,13,57,229,0,0,242,132,110,GXXXXXXXXXXXXXXXXXXXGXXXXXXXXXXXXXXXXXXXGXXXXXXXXXXXXXXXXXXXGXXXXXXXXXXXXXXXXXXXGXXXXXXXXXXXXXXXXXXXGXXXXXXXXXXXXXXXXXXXGXXXXXXXXXXXXXXXXXXXGAXXXXXXXXXXXXXXXXXXGXXXXXXXXXXXXXXXXXXXGXXXXXXXXXXXXXXXXXXXGXXXXXXXXXXXXXXXXXXXGXXXXXXXXXXXXXXXXXXXGXXXXXXXXXXXXXXXXXXX,0,300,0
22386,14,1,13,59,227,0,0,240,134,106,GXXXXXXXXXXXXXXXXXXXGXXXXXXXXXXXXXXXXXXXGXXXXXXXXXXXXXXXXXXXGXXXXXXXXXXXXXXXXXXXGXXXXXXXXXXXXXXXXXXXGXXXXXXXXXXXXXXXXXXXGXXXXXXXXXXXXXXXXXXXGAXXXXXXXXXXXXXXXXXXGXXXXXXXXXXXXXXXXXXXGXXXXXXXXXXXXXXXXXXXGXXXXXXXXXXXXXXXXXXXGXXXXXXXXXXXXXXXXXXXGXXXXXXXXXXXXXXXXXXX,0,300,0
22407,14,0,14,59,227,0,0,240,137,103,GXXXXXXXXXXXXXXXXXXXGXXXXXXXXXXXXXXXXXXXGXXXXXXXXXXXXXXXXXXXGXXXXXXXXXXXXXXXXXXXGXXXXXXXXXXXXXXXXXXXGXXXXXXXXXXXXXXXXXXXGXXXXXXXXXXXXXXXXXXXGOXXXXXXXXXXXXXXXXXXGXXXXXXXXXXXXXXXXXXXGXXXXXXXXXXXXXXXXXXXGXXXXXXXXXXXXXXXXXXXGXXXXXXXXXXXXXXXXXXXGXXXXXXXXXXXXXXXXXXX,0,300,0
22428,14,0,14,62,224,0,0,237,142,95,GXXXXXXXXXXXXXXXXXXXGXXXXXXXXXXXXXXXXXXXGXXXXXXXXXXXXXXXXXXXGXXXXXXXXXXXXXXXXXXXGXXXXXXXXXXXXXXXXXXXGXXXXXXXXXXXXXXXXXXXGXXXXXXXXXXXXXXXXXXXGOXXXXXXXXXXXXXXXXXXGXXXXXXXXXXXXXXXXXXXGXXXXXXXXXXXXXXXXXXXGXXXXXXXXXXXXXXXXXXXGXXXXXXXXXXXXXXXXXXXGXXXXXXXXXXXXXXXXXXX,0,300,0
22449,14,0,14,70,216,0,0,229,140,89,GXXXXXXXXXXXXXXXXXXXGXXXXXXXXXXXXXXXXXXXGXXXXXXXXXXXXXXXXXXXGXXXXXXXXXXXXXXXXXXXGXXXXXXXXXXXXXXXXXXXGXXXXXXXXXXXXXXXXXXXGXXXXXXXXXXXXXXXXXXXGOXXXXXXXXXXXXXXXXXXGXXXXXXXXXXXXXXXXXXXGXXXXXXXXXXXXXXXXXXXGXXXXXXXXXXXXXXXXXXXGXXXXXXXXXXXXXXXXXXXGXXXXXXXXXXXXXXXXXXX,0,300,0

22470,13,0,13,74,213,0,0,225,138,87,GXXXXXXXXXXXXXXXXXXXGXXXXXXXXXXXXXXXXXXXGXXXXXXXXXXXXXXXXXXXGXXXXXXXXXXXXXXXXXXXGXXXXXXXXXXXXXXXXXXXGXXXXXXXXXXXXXXXXXXXGXXXXXXXXXXXXXXXXXXXGXXXXXXXXXXXXXXXXXXXGXXXXXXXXXXXXXXXXXXXGXXXXXXXXXXXXXXXXXXXGXXXXXXXXXXXXXXXXXXXGXXXXXXXXXXXXXXXXXXXGXXXXXXXXXXXXXXXXXXX,0,300,0
22491,13,0,13,68,219,0,0,232,140,92,GXXXXXXXXXXXXXXXXXXXGXXXXXXXXXXXXXXXXXXXGXXXXXXXXXXXXXXXXXXXGXXXXXXXXXXXXXXXXXXXGXXXXXXXXXXXXXXXXXXXGXXXXXXXXXXXXXXXXXXXGXXXXXXXXXXXXXXXXXXXGXXXXXXXXXXXXXXXXXXXGXXXXXXXXXXXXXXXXXXXGXXXXXXXXXXXXXXXXXXXGXXXXXXXXXXXXXXXXXXXGXXXXXXXXXXXXXXXXXXXGXXXXXXXXXXXXXXXXXXX,0,300,0
22512,13,0,13,67,220,0,0,233,142,91,GXXXXXXXXXXXXXXXXXXXGXXXXXXXXXXXXXXXXXXXGXXXXXXXXXXXXXXXXXXXGXXXXXXXXXXXXXXXXXXXGXXXXXXXXXXXXXXXXXXXGXXXXXXXXXXXXXXXXXXXGXXXXXXXXXXXXXXXXXXXGXXXXXXXXXXXXXXXXXXXGXXXXXXXXXXXXXXXXXXXGXXXXXXXXXXXXXXXXXXXGXXXXXXXXXXXXXXXXXXXGXXXXXXXXXXXXXXXXXXXGXXXXXXXXXXXXXXXXXXX,0,300,0
22533,13,0,13,63,224,0,0,235,141,94,GXXXXXXXXXXXXXXXXXXXGXXXXXXXXXXXXXXXXXXXGXXXXXXXXXXXXXXXXXXXGXXXXXXXXXXXXXXXXXXXGXXXXXXXXXXXXXXXXXXXGXXXXXXXXXXXXXXXXXXXGXXXXXXXXXXXXXXXXXXXGXXXXXXXXXXXXXXXXXXXGXXXXXXXXXXXXXXXXXXXGXXXXXXXXXXXXXXXXXXXGXXXXXXXXXXXXXXXXXXXGXXXXXXXXXXXXXXXXXXXGXXXXXXXXXXXXXXXXXXX,0,300,0
22554,13,0,13,61,226,0,0,238,137,101,GXXXXXXXXXXXXXXXXXXXGXXXXXXXXXXXXXXXXXXXGXXXXXXXXXXXXXXXXXXXGXXXXXXXXXXXXXXXXXXXGXXXXXXXXXXXXXXXXXXXGXXXXXXXXXXXXXXXXXXXGXXXXXXXXXXXXXXXXXXXGXXXXXXXXXXXXXXXXXXXGXXXXXXXXXXXXXXXXXXXGXXXXXXXXXXXXXXXXXXXGXXXXXXXXXXXXXXXXXXXGXXXXXXXXXXXXXXXXXXXGXXXXXXXXXXXXXXXXXXX,0,300,0

22575,13,0,13,53,234,0,0,246,140,106,GXXXXXXXXXXXXXXXXXXXGXXXXXXXXXXXXXXXXXXXGXXXXXXXXXXXXXXXXXXXGXXXXXXXXXXXXXXXXXXXGXXXXXXXXXXXXXXXXXXXGXXXXXXXXXXXXXXXXXXXGXXXXXXXXXXXXXXXXXXXGXXXXXXXXXXXXXXXXXXXGXXXXXXXXXXXXXXXXXXXGXXXXXXXXXXXXXXXXXXXGXXXXXXXXXXXXXXXXXXXGXXXXXXXXXXXXXXXXXXXGXXXXXXXXXXXXXXXXXXX,0,300,0
22596,13,0,13,53,234,0,0,246,138,108,GXXXXXXXXXXXXXXXXXXXGXXXXXXXXXXXXXXXXXXXGXXXXXXXXXXXXXXXXXXXGXXXXXXXXXXXXXXXXXXXGXXXXXXXXXXXXXXXXXXXGXXXXXXXXXXXXXXXXXXXGXXXXXXXXXXXXXXXXXXXGXXXXXXXXXXXXXXXXXXXGXXXXXXXXXXXXXXXXXXXGXXXXXXXXXXXXXXXXXXXGXXXXXXXXXXXXXXXXXXXGXXXXXXXXXXXXXXXXXXXGXXXXXXXXXXXXXXXXXXX,0,300,0
22617,13,0,13,54,233,0,0,244,142,102,GXXXXXXXXXXXXXXXXXXXGXXXXXXXXXXXXXXXXXXXGXXXXXXXXXXXXXXXXXXXGXXXXXXXXXXXXXXXXXXXGXXXXXXXXXXXXXXXXXXXGXXXXXXXXXXXXXXXXXXXGXXXXXXXXXXXXXXXXXXXGXXXXXXXXXXXXXXXXXXXGXXXXXXXXXXXXXXXXXXXGXXXXXXXXXXXXXXXXXXXGXXXXXXXXXXXXXXXXXXXGXXXXXXXXXXXXXXXXXXXGXXXXXXXXXXXXXXXXXXX,0,300,0
22638,13,0,13,52,235,0,0,247,138,109,GXXXXXXXXXXXXXXXXXXXGXXXXXXXXXXXXXXXXXXXGXXXXXXXXXXXXXXXXXXXGXXXXXXXXXXXXXXXXXXXGXXXXXXXXXXXXXXXXXXXGXXXXXXXXXXXXXXXXXXXGXXXXXXXXXXXXXXXXXXXGXXXXXXXXXXXXXXXXXXXGXXXXXXXXXXXXXXXXXXXGXXXXXXXXXXXXXXXXXXXGXXXXXXXXXXXXXXXXXXXGXXXXXXXXXXXXXXXXXXXGXXXXXXXXXXXXXXXXXXX,0,300,0
22659,13,0,13,51,236,0,0,248,138,110,GXXXXXXXXXXXXXXXXXXXGXXXXXXXXXXXXXXXXXXXGXXXXXXXXXXXXXXXXXXXGXXXXXXXXXXXXXXXXXXXGXXXXXXXXXXXXXXXXXXXGXXXXXXXXXXXXXXXXXXXGXXXXXXXXXXXXXXXXXXXGXXXXXXXXXXXXXXXXXXXGXXXXXXXXXXXXXXXXXXXGXXXXXXXXXXXXXXXXXXXGXXXXXXXXXXXXXXXXXXXGXXXXXXXXXXXXXXXXXXXGXXXXXXXXXXXXXXXXXXX,0,300,0

22680,13,0,13,52,235,0,0,247,136,111,GXXXXXXXXXXXXXXXXXXXGXXXXXXXXXXXXXXXXXXXGXXXXXXXXXXXXXXXXXXXGXXXXXXXXXXXXXXXXXXXGXXXXXXXXXXXXXXXXXXXGXXXXXXXXXXXXXXXXXXXGXXXXXXXXXXXXXXXXXXXGXXXXXXXXXXXXXXXXXXXGXXXXXXXXXXXXXXXXXXXGXXXXXXXXXXXXXXXXXXXGXXXXXXXXXXXXXXXXXXXGXXXXXXXXXXXXXXXXXXXGXXXXXXXXXXXXXXXXXXX,0,300,0
22701,13,0,13,54,233,0,0,244,137,107,GXXXXXXXXXXXXXXXXXXXGXXXXXXXXXXXXXXXXXXXGXXXXXXXXXXXXXXXXXXXGXXXXXXXXXXXXXXXXXXXGXXXXXXXXXXXXXXXXXXXGXXXXXXXXXXXXXXXXXXXGXXXXXXXXXXXXXXXXXXXGXXXXXXXXXXXXXXXXXXXGXXXXXXXXXXXXXXXXXXXGXXXXXXXXXXXXXXXXXXXGXXXXXXXXXXXXXXXXXXXGXXXXXXXXXXXXXXXXXXXGXXXXXXXXXXXXXXXXXXX,0,300,0
22722,13,0,13,55,232,0,0,245,137,108,GXXXXXXXXXXXXXXXXXXXGXXXXXXXXXXXXXXXXXXXGXXXXXXXXXXXXXXXXXXXGXXXXXXXXXXXXXXXXXXXGXXXXXXXXXXXXXXXXXXXGXXXXXXXXXXXXXXXXXXXGXXXXXXXXXXXXXXXXXXXGXXXXXXXXXXXXXXXXXXXGXXXXXXXXXXXXXXXXXXXGXXXXXXXXXXXXXXXXXXXGXXXXXXXXXXXXXXXXXXXGXXXXXXXXXXXXXXXXXXXGXXXXXXXXXXXXXXXXXXX,0,300,0
22743,13,0,13,55,232,0,0,245,140,105,GXXXXXXXXXXXXXXXXXXXGXXXXXXXXXXXXXXXXXXXGXXXXXXXXXXXXXXXXXXXGXXXXXXXXXXXXXXXXXXXGXXXXXXXXXXXXXXXXXXXGXXXXXXXXXXXXXXXXXXXGXXXXXXXXXXXXXXXXXXXGXXXXXXXXXXXXXXXXXXXGXXXXXXXXXXXXXXXXXXXGXXXXXXXXXXXXXXXXXXXGXXXXXXXXXXXXXXXXXXXGXXXXXXXXXXXXXXXXXXXGXXXXXXXXXXXXXXXXXXX,0,300,0
22764,13,0,13,53,234,0,0,246,138,108,GXXXXXXXXXXXXXXXXXXXGXXXXXXXXXXXXXXXXXXXGXXXXXXXXXXXXXXXXXXXGXXXXXXXXXXXXXXXXXXXGXXXXXXXXXXXXXXXXXXXGXXXXXXXXXXXXXXXXXXXGXXXXXXXXXXXXXXXXXXXGXXXXXXXXXXXXXXXXXXXGXXXXXXXXXXXXXXXXXXXGXXXXXXXXXXXXXXXXXXXGXXXXXXXXXXXXXXXXXXXGXXXXXXXXXXXXXXXXXXXGXXXXXXXXXXXXXXXXXXX,0,300,0

22785,13,0,13,52,235,0,0,248,140,108,GXXXXXXXXXXXXXXXXXXXGXXXXXXXXXXXXXXXXXXXGXXXXXXXXXXXXXXXXXXXGXXXXXXXXXXXXXXXXXXXGXXXXXXXXXXXXXXXXXXXGXXXXXXXXXXXXXXXXXXXGXXXXXXXXXXXXXXXXXXXGXXXXXXXXXXXXXXXXXXXGXXXXXXXXXXXXXXXXXXXGXXXXXXXXXXXXXXXXXXXGXXXXXXXXXXXXXXXXXXXGXXXXXXXXXXXXXXXXXXXGXXXXXXXXXXXXXXXXXXX,0,300,0
22806,13,0,13,54,233,0,0,245,139,106,GXXXXXXXXXXXXXXXXXXXGXXXXXXXXXXXXXXXXXXXGXXXXXXXXXXXXXXXXXXXGXXXXXXXXXXXXXXXXXXXGXXXXXXXXXXXXXXXXXXXGXXXXXXXXXXXXXXXXXXXGXXXXXXXXXXXXXXXXXXXGXXXXXXXXXXXXXXXXXXXGXXXXXXXXXXXXXXXXXXXGXXXXXXXXXXXXXXXXXXXGXXXXXXXXXXXXXXXXXXXGXXXXXXXXXXXXXXXXXXXGXXXXXXXXXXXXXXXXXXX,0,300,0
22827,13,0,13,57,230,0,0,242,137,105,GXXXXXXXXXXXXXXXXXXXGXXXXXXXXXXXXXXXXXXXGXXXXXXXXXXXXXXXXXXXGXXXXXXXXXXXXXXXXXXXGXXXXXXXXXXXXXXXXXXXGXXXXXXXXXXXXXXXXXXXGXXXXXXXXXXXXXXXXXXXGXXXXXXXXXXXXXXXXXXXGXXXXXXXXXXXXXXXXXXXGXXXXXXXXXXXXXXXXXXXGXXXXXXXXXXXXXXXXXXXGXXXXXXXXXXXXXXXXXXXGXXXXXXXXXXXXXXXXXXX,0,300,0
22848,13,0,13,57,230,0,0,242,136,106,GXXXXXXXXXXXXXXXXXXXGXXXXXXXXXXXXXXXXXXXGXXXXXXXXXXXXXXXXXXXGXXXXXXXXXXXXXXXXXXXGXXXXXXXXXXXXXXXXXXXGXXXXXXXXXXXXXXXXXXXGXXXXXXXXXXXXXXXXXXXGXXXXXXXXXXXXXXXXXXXGXXXXXXXXXXXXXXXXXXXGXXXXXXXXXXXXXXXXXXXGXXXXXXXXXXXXXXXXXXXGXXXXXXXXXXXXXXXXXXXGXXXXXXXXXXXXXXXXXXX,0,300,0
22869,13,0,13,54,233,0,0,244,140,104,GXXXXXXXXXXXXXXXXXXXGXXXXXXXXXXXXXXXXXXXGXXXXXXXXXXXXXXXXXXXGXXXXXXXXXXXXXXXXXXXGXXXXXXXXXXXXXXXXXXXGXXXXXXXXXXXXXXXXXXXGXXXXXXXXXXXXXXXXXXXGXXXXXXXXXXXXXXXXXXXGXXXXXXXXXXXXXXXXXXXGXXXXXXXXXXXXXXXXXXXGXXXXXXXXXXXXXXXXXXXGXXXXXXXXXXXXXXXXXXXGXXXXXXXXXXXXXXXXXXX,0,300,0

22890,13,0,13,53,234,0,0,246,143,103,GXXXXXXXXXXXXXXXXXXXGXXXXXXXXXXXXXXXXXXXGXXXXXXXXXXXXXXXXXXXGXXXXXXXXXXXXXXXXXXXGXXXXXXXXXXXXXXXXXXXGXXXXXXXXXXXXXXXXXXXGXXXXXXXXXXXXXXXXXXXGXXXXXXXXXXXXXXXXXXXGXXXXXXXXXXXXXXXXXXXGXXXXXXXXXXXXXXXXXXXGXXXXXXXXXXXXXXXXXXXGXXXXXXXXXXXXXXXXXXXGXXXXXXXXXXXXXXXXXXX,0,300,0
22911,13,0,13,53,234,0,0,245,146,99,GXXXXXXXXXXXXXXXXXXXGXXXXXXXXXXXXXXXXXXXGXXXXXXXXXXXXXXXXXXXGXXXXXXXXXXXXXXXXXXXGXXXXXXXXXXXXXXXXXXXGXXXXXXXXXXXXXXXXXXXGXXXXXXXXXXXXXXXXXXXGXXXXXXXXXXXXXXXXXXXGXXXXXXXXXXXXXXXXXXXGXXXXXXXXXXXXXXXXXXXGXXXXXXXXXXXXXXXXXXXGXXXXXXXXXXXXXXXXXXXGXXXXXXXXXXXXXXXXXXX,0,300,0
22932,13,0,13,48,239,0,0,251,145,106,GXXXXXXXXXXXXXXXXXXXGXXXXXXXXXXXXXXXXXXXGXXXXXXXXXXXXXXXXXXXGXXXXXXXXXXXXXXXXXXXGXXXXXXXXXXXXXXXXXXXGXXXXXXXXXXXXXXXXXXXGXXXXXXXXXXXXXXXXXXXGXXXXXXXXXXXXXXXXXXXGXXXXXXXXXXXXXXXXXXXGXXXXXXXXXXXXXXXXXXXGXXXXXXXXXXXXXXXXXXXGXXXXXXXXXXXXXXXXXXXGXXXXXXXXXXXXXXXXXXX,0,300,0
22953,13,0,13,54,233,0,0,243,148,95,GXXXXXXXXXXXXXXXXXXXGXXXXXXXXXXXXXXXXXXXGXXXXXXXXXXXXXXXXXXXGXXXXXXXXXXXXXXXXXXXGXXXXXXXXXXXXXXXXXXXGXXXXXXXXXXXXXXXXXXXGXXXXXXXXXXXXXXXXXXXGXXXXXXXXXXXXXXXXXXXGXXXXXXXXXXXXXXXXXXXGXXXXXXXXXXXXXXXXXXXGXXXXXXXXXXXXXXXXXXXGXXXXXXXXXXXXXXXXXXXGXXXXXXXXXXXXXXXXXXX,0,300,0
22974,13,0,13,60,227,0,0,239,142,97,GXXXXXXXXXXXXXXXXXXXGXXXXXXXXXXXXXXXXXXXGXXXXXXXXXXXXXXXXXXXGXXXXXXXXXXXXXXXXXXXGXXXXXXXXXXXXXXXXXXXGXXXXXXXXXXXXXXXXXXXGXXXXXXXXXXXXXXXXXXXGXXXXXXXXXXXXXXXXXXXGXXXXXXXXXXXXXXXXXXXGXXXXXXXXXXXXXXXXXXXGXXXXXXXXXXXXXXXXXXXGXXXXXXXXXXXXXXXXXXXGXXXXXXXXXXXXXXXXXXX,0,300,0

22995,13,0,13,55,232,0,0,244,142,102,GXXXXXXXXXXXXXXXXXXXGXXXXXXXXXXXXXXXXXXXGXXXXXXXXXXXXXXXXXXXGXXXXXXXXXXXXXXXXXXXGXXXXXXXXXXXXXXXXXXXGXXXXXXXXXXXXXXXXXXXGXXXXXXXXXXXXXXXXXXXGXXXXXXXXXXXXXXXXXXXGXXXXXXXXXXXXXXXXXXXGXXXXXXXXXXXXXXXXXXXGXXXXXXXXXXXXXXXXXXXGXXXXXXXXXXXXXXXXXXXGXXXXXXXXXXXXXXXXXXX,0,300,0
23016,13,0,13,57,230,0,0,242,141,101,GXXXXXXXXXXXXXXXXXXXGXXXXXXXXXXXXXXXXXXXGXXXXXXXXXXXXXXXXXXXGXXXXXXXXXXXXXXXXXXXGXXXXXXXXXXXXXXXXXXXGXXXXXXXXXXXXXXXXXXXGXXXXXXXXXXXXXXXXXXXGXXXXXXXXXXXXXXXXXXXGXXXXXXXXXXXXXXXXXXXGXXXXXXXXXXXXXXXXXXXGXXXXXXXXXXXXXXXXXXXGXXXXXXXXXXXXXXXXXXXGXXXXXXXXXXXXXXXXXXX,0,300,0
23037,13,0,13,58,229,0,0,241,138,103,GXXXXXXXXXXXXXXXXXXXGXXXXXXXXXXXXXXXXXXXGXXXXXXXXXXXXXXXXXXXGXXXXXXXXXXXXXXXXXXXGXXXXXXXXXXXXXXXXXXXGXXXXXXXXXXXXXXXXXXXGXXXXXXXXXXXXXXXXXXXGXXXXXXXXXXXXXXXXXXXGXXXXXXXXXXXXXXXXXXXGXXXXXXXXXXXXXXXXXXXGXXXXXXXXXXXXXXXXXXXGXXXXXXXXXXXXXXXXXXXGXXXXXXXXXXXXXXXXXXX,0,300,0
23058,13,0,13,53,234,0,0,244,143,101,GXXXXXXXXXXXXXXXXXXXGXXXXXXXXXXXXXXXXXXXGXXXXXXXXXXXXXXXXXXXGXXXXXXXXXXXXXXXXXXXGXXXXXXXXXXXXXXXXXXXGXXXXXXXXXXXXXXXXXXXGXXXXXXXXXXXXXXXXXXXGXXXXXXXXXXXXXXXXXXXGXXXXXXXXXXXXXXXXXXXGXXXXXXXXXXXXXXXXXXXGXXXXXXXXXXXXXXXXXXXGXXXXXXXXXXXXXXXXXXXGXXXXXXXXXXXXXXXXXXX,0,300,0
23079,13,0,13,50,237,0,0,249,141,108,GXXXXXXXXXXXXXXXXXXXGXXXXXXXXXXXXXXXXXXXGXXXXXXXXXXXXXXXXXXXGXXXXXXXXXXXXXXXXXXXGXXXXXXXXXXXXXXXXXXXGXXXXXXXXXXXXXXXXXXXGXXXXXXXXXXXXXXXXXXXGXXXXXXXXXXXXXXXXXXXGXXXXXXXXXXXXXXXXXXXGXXXXXXXXXXXXXXXXXXXGXXXXXXXXXXXXXXXXXXXGXXXXXXXXXXXXXXXXXXXGXXXXXXXXXXXXXXXXXXX,0,300,0

23100,13,0,13,46,241,0,0,253,140,113,GXXXXXXXXXXXXXXXXXXXGXXXXXXXXXXXXXXXXXXXGXXXXXXXXXXXXXXXXXXXGXXXXXXXXXXXXXXXXXXXGXXXXXXXXXXXXXXXXXXXGXXXXXXXXXXXXXXXXXXXGXXXXXXXXXXXXXXXXXXXGXXXXXXXXXXXXXXXXXXXGXXXXXXXXXXXXXXXXXXXGXXXXXXXXXXXXXXXXXXXGXXXXXXXXXXXXXXXXXXXGXXXXXXXXXXXXXXXXXXXGXXXXXXXXXXXXXXXXXXX,0,300,0
23121,13,0,13,46,241,0,0,252,144,108,GXXXXXXXXXXXXXXXXXXXGXXXXXXXXXXXXXXXXXXXGXXXXXXXXXXXXXXXXXXXGXXXXXXXXXXXXXXXXXXXGXXXXXXXXXXXXXXXXXXXGXXXXXXXXXXXXXXXXXXXGXXXXXXXXXXXXXXXXXXXGXXXXXXXXXXXXXXXXXXXGXXXXXXXXXXXXXXXXXXXGXXXXXXXXXXXXXXXXXXXGXXXXXXXXXXXXXXXXXXXGXXXXXXXXXXXXXXXXXXXGXXXXXXXXXXXXXXXXXXX,0,300,0
23142,13,0,13,48,239,0,0,251,146,105,GXXXXXXXXXXXXXXXXXXXGXXXXXXXXXXXXXXXXXXXGXXXXXXXXXXXXXXXXXXXGXXXXXXXXXXXXXXXXXXXGXXXXXXXXXXXXXXXXXXXGXXXXXXXXXXXXXXXXXXXGXXXXXXXXXXXXXXXXXXXGXXXXXXXXXXXXXXXXXXXGXXXXXXXXXXXXXXXXXXXGXXXXXXXXXXXXXXXXXXXGXXXXXXXXXXXXXXXXXXXGXXXXXXXXXXXXXXXXXXXGXXXXXXXXXXXXXXXXXXX,0,300,0
23163,13,0,13,51,236,0,0,248,147,101,GXXXXXXXXXXXXXXXXXXXGXXXXXXXXXXXXXXXXXXXGXXXXXXXXXXXXXXXXXXXGXXXXXXXXXXXXXXXXXXXGXXXXXXXXXXXXXXXXXXXGXXXXXXXXXXXXXXXXXXXGXXXXXXXXXXXXXXXXXXXGXXXXXXXXXXXXXXXXXXXGXXXXXXXXXXXXXXXXXXXGXXXXXXXXXXXXXXXXXXXGXXXXXXXXXXXXXXXXXXXGXXXXXXXXXXXXXXXXXXXGXXXXXXXXXXXXXXXXXXX,0,300,0
23184,13,0,13,57,230,0,0,242,144,98,GXXXXXXXXXXXXXXXXXXXGXXXXXXXXXXXXXXXXXXXGXXXXXXXXXXXXXXXXXXXGXXXXXXXXXXXXXXXXXXXGXXXXXXXXXXXXXXXXXXXGXXXXXXXXXXXXXXXXXXXGXXXXXXXXXXXXXXXXXXXGXXXXXXXXXXXXXXXXXXXGXXXXXXXXXXXXXXXXXXXGXXXXXXXXXXXXXXXXXXXGXXXXXXXXXXXXXXXXXXXGXXXXXXXXXXXXXXXXXXXGXXXXXXXXXXXXXXXXXXX,0,300,0

23205,13,0,13,61,226,0,0,238,143,95,GXXXXXXXXXXXXXXXXXXXGXXXXXXXXXXXXXXXXXXXGXXXXXXXXXXXXXXXXXXXGXXXXXXXXXXXXXXXXXXXGXXXXXXXXXXXXXXXXXXXGXXXXXXXXXXXXXXXXXXXGXXXXXXXXXXXXXXXXXXXGXXXXXXXXXXXXXXXXXXXGXXXXXXXXXXXXXXXXXXXGXXXXXXXXXXXXXXXXXXXGXXXXXXXXXXXXXXXXXXXGXXXXXXXXXXXXXXXXXXXGXXXXXXXXXXXXXXXXXXX,0,300,0
23226,13,0,13,63,224,0,0,236,144,92,GXXXXXXXXXXXXXXXXXXXGXXXXXXXXXXXXXXXXXXXGXXXXXXXXXXXXXXXXXXXGXXXXXXXXXXXXXXXXXXXGXXXXXXXXXXXXXXXXXXXGXXXXXXXXXXXXXXXXXXXGXXXXXXXXXXXXXXXXXXXGXXXXXXXXXXXXXXXXXXXGXXXXXXXXXXXXXXXXXXXGXXXXXXXXXXXXXXXXXXXGXXXXXXXXXXXXXXXXXXXGXXXXXXXXXXXXXXXXXXXGXXXXXXXXXXXXXXXXXXX,0,300,0
23247,13,0,13,61,226,0,0,238,143,95,GXXXXXXXXXXXXXXXXXXXGXXXXXXXXXXXXXXXXXXXGXXXXXXXXXXXXXXXXXXXGXXXXXXXXXXXXXXXXXXXGXXXXXXXXXXXXXXXXXXXGXXXXXXXXXXXXXXXXXXXGXXXXXXXXXXXXXXXXXXXGXXXXXXXXXXXXXXXXXXXGXXXXXXXXXXXXXXXXXXXGXXXXXXXXXXXXXXXXXXXGXXXXXXXXXXXXXXXXXXXGXXXXXXXXXXXXXXXXXXXGXXXXXXXXXXXXXXXXXXX,0,300,0
23268,13,0,13,57,230,0,0,242,142,100,GXXXXXXXXXXXXXXXXXXXGXXXXXXXXXXXXXXXXXXXGXXXXXXXXXXXXXXXXXXXGXXXXXXXXXXXXXXXXXXXGXXXXXXXXXXXXXXXXXXXGXXXXXXXXXXXXXXXXXXXGXXXXXXXXXXXXXXXXXXXGXXXXXXXXXXXXXXXXXXXGXXXXXXXXXXXXXXXXXXXGXXXXXXXXXXXXXXXXXXXGXXXXXXXXXXXXXXXXXXXGXXXXXXXXXXXXXXXXXXXGXXXXXXXXXXXXXXXXXXX,0,300,0
23289,13,0,13,60,227,0,0,239,142,97,GXXXXXXXXXXXXXXXXXXXGXXXXXXXXXXXXXXXXXXXGXXXXXXXXXXXXXXXXXXXGXXXXXXXXXXXXXXXXXXXGXXXXXXXXXXXXXXXXXXXGXXXXXXXXXXXXXXXXXXXGXXXXXXXXXXXXXXXXXXXGXXXXXXXXXXXXXXXXXXXGXXXXXXXXXXXXXXXXXXXGXXXXXXXXXXXXXXXXXXXGXXXXXXXXXXXXXXXXXXXGXXXXXXXXXXXXXXXXXXXGXXXXXXXXXXXXXXXXXXX,0,300,0

23310,13,0,13,57,230,0,0,242,144,98,GXXXXXXXXXXXXXXXXXXXGXXXXXXXXXXXXXXXXXXXGXXXXXXXXXXXXXXXXXXXGXXXXXXXXXXXXXXXXXXXGXXXXXXXXXXXXXXXXXXXGXXXXXXXXXXXXXXXXXXXGXXXXXXXXXXXXXXXXXXXGXXXXXXXXXXXXXXXXXXXGXXXXXXXXXXXXXXXXXXXGXXXXXXXXXXXXXXXXXXXGXXXXXXXXXXXXXXXXXXXGXXXXXXXXXXXXXXXXXXXGXXXXXXXXXXXXXXXXXXX,0,300,0
23331,13,0,13,57,230,0,0,242,146,96,GXXXXXXXXXXXXXXXXXXXGXXXXXXXXXXXXXXXXXXXGXXXXXXXXXXXXXXXXXXXGXXXXXXXXXXXXXXXXXXXGXXXXXXXXXXXXXXXXXXXGXXXXXXXXXXXXXXXXXXXGXXXXXXXXXXXXXXXXXXXGXXXXXXXXXXXXXXXXXXXGXXXXXXXXXXXXXXXXXXXGXXXXXXXXXXXXXXXXXXXGXXXXXXXXXXXXXXXXXXXGXXXXXXXXXXXXXXXXXXXGXXXXXXXXXXXXXXXXXXX,0,300,0
23352,13,0,13,57,230,0,0,241,148,93,GXXXXXXXXXXXXXXXXXXXGXXXXXXXXXXXXXXXXXXXGXXXXXXXXXXXXXXXXXXXGXXXXXXXXXXXXXXXXXXXGXXXXXXXXXXXXXXXXXXXGXXXXXXXXXXXXXXXXXXXGXXXXXXXXXXXXXXXXXXXGXXXXXXXXXXXXXXXXXXXGXXXXXXXXXXXXXXXXXXXGXXXXXXXXXXXXXXXXXXXGXXXXXXXXXXXXXXXXXXXGXXXXXXXXXXXXXXXXXXXGXXXXXXXXXXXXXXXXXXX,0,300,0
23373,13,0,13,57,230,0,0,241,153,88,GXXXXXXXXXXXXXXXXXXXGXXXXXXXXXXXXXXXXXXXGXXXXXXXXXXXXXXXXXXXGXXXXXXXXXXXXXXXXXXXGXXXXXXXXXXXXXXXXXXXGXXXXXXXXXXXXXXXXXXXGXXXXXXXXXXXXXXXXXXXGXXXXXXXXXXXXXXXXXXXGXXXXXXXXXXXXXXXXXXXGXXXXXXXXXXXXXXXXXXXGXXXXXXXXXXXXXXXXXXXGXXXXXXXXXXXXXXXXXXXGXXXXXXXXXXXXXXXXXXX,0,300,0
23394,13,0,13,59,228,0,0,240,148,92,GXXXXXXXXXXXXXXXXXXXGXXXXXXXXXXXXXXXXXXXGXXXXXXXXXXXXXXXXXXXGXXXXXXXXXXXXXXXXXXXGXXXXXXXXXXXXXXXXXXXGXXXXXXXXXXXXXXXXXXXGXXXXXXXXXXXXXXXXXXXGXXXXXXXXXXXXXXXXXXXGXXXXXXXXXXXXXXXXXXXGXXXXXXXXXXXXXXXXXXXGXXXXXXXXXXXXXXXXXXXGXXXXXXXXXXXXXXXXXXXGXXXXXXXXXXXXXXXXXXX,0,300,0

23415,13,0,13,61,226,0,0,238,143,95,GXXXXXXXXXXXXXXXXXXXGXXXXXXXXXXXXXXXXXXXGXXXXXXXXXXXXXXXXXXXGXXXXXXXXXXXXXXXXXXXGXXXXXXXXXXXXXXXXXXXGXXXXXXXXXXXXXXXXXXXGXXXXXXXXXXXXXXXXXXXGXXXXXXXXXXXXXXXXXXXGXXXXXXXXXXXXXXXXXXXGXXXXXXXXXXXXXXXXXXXGXXXXXXXXXXXXXXXXXXXGXXXXXXXXXXXXXXXXXXXGXXXXXXXXXXXXXXXXXXX,0,300,0
23436,13,0,13,61,226,0,0,238,143,95,GXXXXXXXXXXXXXXXXXXXGXXXXXXXXXXXXXXXXXXXGXXXXXXXXXXXXXXXXXXXGXXXXXXXXXXXXXXXXXXXGXXXXXXXXXXXXXXXXXXXGXXXXXXXXXXXXXXXXXXXGXXXXXXXXXXXXXXXXXXXGXXXXXXXXXXXXXXXXXXXGXXXXXXXXXXXXXXXXXXXGXXXXXXXXXXXXXXXXXXXGXXXXXXXXXXXXXXXXXXXGXXXXXXXXXXXXXXXXXXXGXXXXXXXXXXXXXXXXXXX,0,300,0
23457,13,0,13,62,225,0,0,237,144,93,GXXXXXXXXXXXXXXXXXXXGXXXXXXXXXXXXXXXXXXXGXXXXXXXXXXXXXXXXXXXGXXXXXXXXXXXXXXXXXXXGXXXXXXXXXXXXXXXXXXXGXXXXXXXXXXXXXXXXXXXGXXXXXXXXXXXXXXXXXXXGXXXXXXXXXXXXXXXXXXXGXXXXXXXXXXXXXXXXXXXGXXXXXXXXXXXXXXXXXXXGXXXXXXXXXXXXXXXXXXXGXXXXXXXXXXXXXXXXXXXGXXXXXXXXXXXXXXXXXXX,0,300,0
23478,13,0,13,60,227,0,0,237,144,93,GXXXXXXXXXXXXXXXXXXXGXXXXXXXXXXXXXXXXXXXGXXXXXXXXXXXXXXXXXXXGXXXXXXXXXXXXXXXXXXXGXXXXXXXXXXXXXXXXXXXGXXXXXXXXXXXXXXXXXXXGXXXXXXXXXXXXXXXXXXXGXXXXXXXXXXXXXXXXXXXGXXXXXXXXXXXXXXXXXXXGXXXXXXXXXXXXXXXXXXXGXXXXXXXXXXXXXXXXXXXGXXXXXXXXXXXXXXXXXXXGXXXXXXXXXXXXXXXXXXX,0,300,0
23499,13,0,13,59,228,0,0,240,144,96,GXXXXXXXXXXXXXXXXXXXGXXXXXXXXXXXXXXXXXXXGXXXXXXXXXXXXXXXXXXXGXXXXXXXXXXXXXXXXXXXGXXXXXXXXXXXXXXXXXXXGXXXXXXXXXXXXXXXXXXXGXXXXXXXXXXXXXXXXXXXGXXXXXXXXXXXXXXXXXXXGXXXXXXXXXXXXXXXXXXXGXXXXXXXXXXXXXXXXXXXGXXXXXXXXXXXXXXXXXXXGXXXXXXXXXXXXXXXXXXXGXXXXXXXXXXXXXXXXXXX,0,300,0

23520,13,0,13,63,224,0,0,236,145,91,GXXXXXXXXXXXXXXXXXXXGXXXXXXXXXXXXXXXXXXXGXXXXXXXXXXXXXXXXXXXGXXXXXXXXXXXXXXXXXXXGXXXXXXXXXXXXXXXXXXXGXXXXXXXXXXXXXXXXXXXGXXXXXXXXXXXXXXXXXXXGXXXXXXXXXXXXXXXXXXXGXXXXXXXXXXXXXXXXXXXGXXXXXXXXXXXXXXXXXXXGXXXXXXXXXXXXXXXXXXXGXXXXXXXXXXXXXXXXXXXGXXXXXXXXXXXXXXXXXXX,0,300,0
23541,13,0,13,65,222,0,0,234,145,89,GXXXXXXXXXXXXXXXXXXXGXXXXXXXXXXXXXXXXXXXGXXXXXXXXXXXXXXXXXXXGXXXXXXXXXXXXXXXXXXXGXXXXXXXXXXXXXXXXXXXGXXXXXXXXXXXXXXXXXXXGXXXXXXXXXXXXXXXXXXXGXXXXXXXXXXXXXXXXXXXGXXXXXXXXXXXXXXXXXXXGXXXXXXXXXXXXXXXXXXXGXXXXXXXXXXXXXXXXXXXGXXXXXXXXXXXXXXXXXXXGXXXXXXXXXXXXXXXXXXX,0,300,0
23562,13,0,13,68,219,0,0,231,143,88,GXXXXXXXXXXXXXXXXXXXGXXXXXXXXXXXXXXXXXXXGXXXXXXXXXXXXXXXXXXXGXXXXXXXXXXXXXXXXXXXGXXXXXXXXXXXXXXXXXXXGXXXXXXXXXXXXXXXXXXXGXXXXXXXXXXXXXXXXXXXGXXXXXXXXXXXXXXXXXXXGXXXXXXXXXXXXXXXXXXXGXXXXXXXXXXXXXXXXXXXGXXXXXXXXXXXXXXXXXXXGXXXXXXXXXXXXXXXXXXXGXXXXXXXXXXXXXXXXXXX,0,300,0
23583,14,1,13,66,220,0,0,232,136,96,GXXXXXXXXXXXXXXXXXXXGXXXXXXXXXXXXXXXXXXXGXXXXXXXXXXXXXXXXXXXGXXXXXXXXXXXXXXXXXXXGXXXXXXXXXXXXXXXXXXXGXXXXXXXXXXXXXXXXXXXGXXXXXXXXXXXXXXXXXXXGXXXXXXXXXXXXXXXXXXXGAXXXXXXXXXXXXXXXXXXGXXXXXXXXXXXXXXXXXXXGXXXXXXXXXXXXXXXXXXXGXXXXXXXXXXXXXXXXXXXGXXXXXXXXXXXXXXXXXXX,0,300,0
23604,14,1,13,60,226,0,0,238,138,100,GXXXXXXXXXXXXXXXXXXXGXXXXXXXXXXXXXXXXXXXGXXXXXXXXXXXXXXXXXXXGXXXXXXXXXXXXXXXXXXXGXXXXXXXXXXXXXXXXXXXGXXXXXXXXXXXXXXXXXXXGXXXXXXXXXXXXXXXXXXXGXXXXXXXXXXXXXXXXXXXGAXXXXXXXXXXXXXXXXXXGXXXXXXXXXXXXXXXXXXXGXXXXXXXXXXXXXXXXXXXGXXXXXXXXXXXXXXXXXXXGXXXXXXXXXXXXXXXXXXX,0,300,0

23625,14,1,13,56,230,0,0,241,135,106,GXXXXXXXXXXXXXXXXXXXGXXXXXXXXXXXXXXXXXXXGXXXXXXXXXXXXXXXXXXXGXXXXXXXXXXXXXXXXXXXGXXXXXXXXXXXXXXXXXXXGXXXXXXXXXXXXXXXXXXXGXXXXXXXXXXXXXXXXXXXGXXXXXXXXXXXXXXXXXXXGAXXXXXXXXXXXXXXXXXXGXXXXXXXXXXXXXXXXXXXGXXXXXXXXXXXXXXXXXXXGXXXXXXXXXXXXXXXXXXXGXXXXXXXXXXXXXXXXXXX,0,300,0
23646,14,1,13,49,237,0,0,249,142,107,GXXXXXXXXXXXXXXXXXXXGXXXXXXXXXXXXXXXXXXXGXXXXXXXXXXXXXXXXXXXGXXXXXXXXXXXXXXXXXXXGXXXXXXXXXXXXXXXXXXXGXXXXXXXXXXXXXXXXXXXGXXXXXXXXXXXXXXXXXXXGXXXXXXXXXXXXXXXXXXXGAXXXXXXXXXXXXXXXXXXGXXXXXXXXXXXXXXXXXXXGXXXXXXXXXXXXXXXXXXXGXXXXXXXXXXXXXXXXXXXGXXXXXXXXXXXXXXXXXXX,0,300,0
23667,15,2,13,43,242,0,0,253,143,110,GXXXXXXXXXXXXXXXXXXXGXXXXXXXXXXXXXXXXXXXGXXXXXXXXXXXXXXXXXXXGXXXXXXXXXXXXXXXXXXXGXXXXXXXXXXXXXXXXXXXGXXXXXXXXXXXXXXXXXXXGXXXXXXXXXXXXXXXXXXXGXXXXXXXXXXXXXXXXXXXGAXXXXXXXXXXXXXXXXXXGXXXXXXXXXXXXXXXXXXXGAXXXXXXXXXXXXXXXXXXGXXXXXXXXXXXXXXXXXXXGXXXXXXXXXXXXXXXXXXX,0,300,0
23688,15,1,14,45,240,0,0,255,145,110,GXXXXXXXXXXXXXXXXXXXGXXXXXXXXXXXXXXXXXXXGXXXXXXXXXXXXXXXXXXXGXXXXXXXXXXXXXXXXXXXGXXXXXXXXXXXXXXXXXXXGXXXXXXXXXXXXXXXXXXXGXXXXXXXXXXXXXXXXXXXGXXXXXXXXXXXXXXXXXXXGAXXXXXXXXXXXXXXXXXXGXXXXXXXXXXXXXXXXXXXGOXXXXXXXXXXXXXXXXXXGXXXXXXXXXXXXXXXXXXXGXXXXXXXXXXXXXXXXXXX,0,300,0
23709,14,0,14,53,233,0,0,247,142,105,GXXXXXXXXXXXXXXXXXXXGXXXXXXXXXXXXXXXXXXXGXXXXXXXXXXXXXXXXXXXGXXXXXXXXXXXXXXXXXXXGXXXXXXXXXXXXXXXXXXXGXXXXXXXXXXXXXXXXXXXGXXXXXXXXXXXXXXXXXXXGXXXXXXXXXXXXXXXXXXXGOXXXXXXXXXXXXXXXXXXGXXXXXXXXXXXXXXXXXXXGXXXXXXXXXXXXXXXXXXXGXXXXXXXXXXXXXXXXXXXGXXXXXXXXXXXXXXXXXXX,0,300,0

23730,14,0,14,54,232,0,0,247,139,108,GXXXXXXXXXXXXXXXXXXXGXXXXXXXXXXXXXXXXXXXGXXXXXXXXXXXXXXXXXXXGXXXXXXXXXXXXXXXXXXXGXXXXXXXXXXXXXXXXXXXGXXXXXXXXXXXXXXXXXXXGXXXXXXXXXXXXXXXXXXXGXXXXXXXXXXXXXXXXXXXGOXXXXXXXXXXXXXXXXXXGXXXXXXXXXXXXXXXXXXXGXXXXXXXXXXXXXXXXXXXGXXXXXXXXXXXXXXXXXXXGXXXXXXXXXXXXXXXXXXX,0,300,0
23751,13,0,13,55,232,0,0,246,135,111,GXXXXXXXXXXXXXXXXXXXGXXXXXXXXXXXXXXXXXXXGXXXXXXXXXXXXXXXXXXXGXXXXXXXXXXXXXXXXXXXGXXXXXXXXXXXXXXXXXXXGXXXXXXXXXXXXXXXXXXXGXXXXXXXXXXXXXXXXXXXGXXXXXXXXXXXXXXXXXXXGXXXXXXXXXXXXXXXXXXXGXXXXXXXXXXXXXXXXXXXGXXXXXXXXXXXXXXXXXXXGXXXXXXXXXXXXXXXXXXXGXXXXXXXXXXXXXXXXXXX,0,300,0
23772,13,0,13,54,233,0,0,248,138,110,GXXXXXXXXXXXXXXXXXXXGXXXXXXXXXXXXXXXXXXXGXXXXXXXXXXXXXXXXXXXGXXXXXXXXXXXXXXXXXXXGXXXXXXXXXXXXXXXXXXXGXXXXXXXXXXXXXXXXXXXGXXXXXXXXXXXXXXXXXXXGXXXXXXXXXXXXXXXXXXXGXXXXXXXXXXXXXXXXXXXGXXXXXXXXXXXXXXXXXXXGXXXXXXXXXXXXXXXXXXXGXXXXXXXXXXXXXXXXXXXGXXXXXXXXXXXXXXXXXXX,0,300,0
23793,14,1,13,52,234,0,0,248,142,106,GXXXXXXXXXXXXXXXXXXXGXXXXXXXXXXXXXXXXXXXGXXXXXXXXXXXXXXXXXXXGXXXXXXXXXXXXXXXXXXXGXXXXXXXXXXXXXXXXXXXGXXXXXXXXXXXXXXXXXXXGXXXXXXXXXXXXXXXXXXXGXXXXXXXXXXXXXXXXXXXGAXXXXXXXXXXXXXXXXXXGXXXXXXXXXXXXXXXXXXXGXXXXXXXXXXXXXXXXXXXGXXXXXXXXXXXXXXXXXXXGXXXXXXXXXXXXXXXXXXX,0,300,0
23814,14,1,13,55,231,0,0,245,141,104,GXXXXXXXXXXXXXXXXXXXGXXXXXXXXXXXXXXXXXXXGXXXXXXXXXXXXXXXXXXXGXXXXXXXXXXXXXXXXXXXGXXXXXXXXXXXXXXXXXXXGXXXXXXXXXXXXXXXXXXXGXXXXXXXXXXXXXXXXXXXGXXXXXXXXXXXXXXXXXXXGAXXXXXXXXXXXXXXXXXXGXXXXXXXXXXXXXXXXXXXGXXXXXXXXXXXXXXXXXXXGXXXXXXXXXXXXXXXXXXXGXXXXXXXXXXXXXXXXXXX,0,300,0

23835,14,1,13,58,228,0,0,243,139,104,GXXXXXXXXXXXXXXXXXXXGXXXXXXXXXXXXXXXXXXXGXXXXXXXXXXXXXXXXXXXGXXXXXXXXXXXXXXXXXXXGXXXXXXXXXXXXXXXXXXXGXXXXXXXXXXXXXXXXXXXGXXXXXXXXXXXXXXXXXXXGXXXXXXXXXXXXXXXXXXXGAXXXXXXXXXXXXXXXXXXGXXXXXXXXXXXXXXXXXXXGXXXXXXXXXXXXXXXXXXXGXXXXXXXXXXXXXXXXXXXGXXXXXXXXXXXXXXXXXXX,0,300,0
23856,14,1,13,54,232,0,0,246,140,106,GXXXXXXXXXXXXXXXXXXXGXXXXXXXXXXXXXXXXXXXGXXXXXXXXXXXXXXXXXXXGXXXXXXXXXXXXXXXXXXXGXXXXXXXXXXXXXXXXXXXGXXXXXXXXXXXXXXXXXXXGXXXXXXXXXXXXXXXXXXXGXXXXXXXXXXXXXXXXXXXGAXXXXXXXXXXXXXXXXXXGXXXXXXXXXXXXXXXXXXXGXXXXXXXXXXXXXXXXXXXGXXXXXXXXXXXXXXXXXXXGXXXXXXXXXXXXXXXXXXX,0,300,0
23877,14,1,13,52,234,0,0,248,142,106,GXXXXXXXXXXXXXXXXXXXGXXXXXXXXXXXXXXXXXXXGXXXXXXXXXXXXXXXXXXXGXXXXXXXXXXXXXXXXXXXGXXXXXXXXXXXXXXXXXXXGXXXXXXXXXXXXXXXXXXXGXXXXXXXXXXXXXXXXXXXGXXXXXXXXXXXXXXXXXXXGAXXXXXXXXXXXXXXXXXXGXXXXXXXXXXXXXXXXXXXGXXXXXXXXXXXXXXXXXXXGXXXXXXXXXXXXXXXXXXXGXXXXXXXXXXXXXXXXXXX,0,300,0
23898,14,1,13,52,234,0,0,247,148,99,GXXXXXXXXXXXXXXXXXXXGXXXXXXXXXXXXXXXXXXXGXXXXXXXXXXXXXXXXXXXGXXXXXXXXXXXXXXXXXXXGXXXXXXXXXXXXXXXXXXXGXXXXXXXXXXXXXXXXXXXGXXXXXXXXXXXXXXXXXXXGXXXXXXXXXXXXXXXXXXXGAXXXXXXXXXXXXXXXXXXGXXXXXXXXXXXXXXXXXXXGXXXXXXXXXXXXXXXXXXXGXXXXXXXXXXXXXXXXXXXGXXXXXXXXXXXXXXXXXXX,0,300,0
23919,14,1,13,53,233,0,0,246,151,95,GXXXXXXXXXXXXXXXXXXXGXXXXXXXXXXXXXXXXXXXGXXXXXXXXXXXXXXXXXXXGXXXXXXXXXXXXXXXXXXXGXXXXXXXXXXXXXXXXXXXGXXXXXXXXXXXXXXXXXXXGXXXXXXXXXXXXXXXXXXXGXXXXXXXXXXXXXXXXXXXGAXXXXXXXXXXXXXXXXXXGXXXXXXXXXXXXXXXXXXXGXXXXXXXXXXXXXXXXXXXGXXXXXXXXXXXXXXXXXXXGXXXXXXXXXXXXXXXXXXX,0,300,0

23940,14,1,13,54,232,0,0,245,154,91,GXXXXXXXXXXXXXXXXXXXGXXXXXXXXXXXXXXXXXXXGXXXXXXXXXXXXXXXXXXXGXXXXXXXXXXXXXXXXXXXGXXXXXXXXXXXXXXXXXXXGXXXXXXXXXXXXXXXXXXXGXXXXXXXXXXXXXXXXXXXGXXXXXXXXXXXXXXXXXXXGAXXXXXXXXXXXXXXXXXXGXXXXXXXXXXXXXXXXXXXGXXXXXXXXXXXXXXXXXXXGXXXXXXXXXXXXXXXXXXXGXXXXXXXXXXXXXXXXXXX,0,300,0
23961,14,1,13,60,226,0,0,239,153,86,GXXXXXXXXXXXXXXXXXXXGXXXXXXXXXXXXXXXXXXXGXXXXXXXXXXXXXXXXXXXGXXXXXXXXXXXXXXXXXXXGXXXXXXXXXXXXXXXXXXXGXXXXXXXXXXXXXXXXXXXGXXXXXXXXXXXXXXXXXXXGXXXXXXXXXXXXXXXXXXXGAXXXXXXXXXXXXXXXXXXGXXXXXXXXXXXXXXXXXXXGXXXXXXXXXXXXXXXXXXXGXXXXXXXXXXXXXXXXXXXGXXXXXXXXXXXXXXXXXXX,0,300,0
23982,14,1,13,67,219,0,0,232,150,82,GXXXXXXXXXXXXXXXXXXXGXXXXXXXXXXXXXXXXXXXGXXXXXXXXXXXXXXXXXXXGXXXXXXXXXXXXXXXXXXXGXXXXXXXXXXXXXXXXXXXGXXXXXXXXXXXXXXXXXXXGXXXXXXXXXXXXXXXXXXXGXXXXXXXXXXXXXXXXXXXGAXXXXXXXXXXXXXXXXXXGXXXXXXXXXXXXXXXXXXXGXXXXXXXXXXXXXXXXXXXGXXXXXXXXXXXXXXXXXXXGXXXXXXXXXXXXXXXXXXX,0,300,0
24003,14,1,13,67,219,0,0,232,151,81,GXXXXXXXXXXXXXXXXXXXGXXXXXXXXXXXXXXXXXXXGXXXXXXXXXXXXXXXXXXXGXXXXXXXXXXXXXXXXXXXGXXXXXXXXXXXXXXXXXXXGXXXXXXXXXXXXXXXXXXXGXXXXXXXXXXXXXXXXXXXGXXXXXXXXXXXXXXXXXXXGAXXXXXXXXXXXXXXXXXXGXXXXXXXXXXXXXXXXXXXGXXXXXXXXXXXXXXXXXXXGXXXXXXXXXXXXXXXXXXXGXXXXXXXXXXXXXXXXXXX,0,300,0
24024,14,1,13,66,220,0,0,232,146,86,GXXXXXXXXXXXXXXXXXXXGXXXXXXXXXXXXXXXXXXXGXXXXXXXXXXXXXXXXXXXGXXXXXXXXXXXXXXXXXXXGXXXXXXXXXXXXXXXXXXXGXXXXXXXXXXXXXXXXXXXGXXXXXXXXXXXXXXXXXXXGXXXXXXXXXXXXXXXXXXXGAXXXXXXXXXXXXXXXXXXGXXXXXXXXXXXXXXXXXXXGXXXXXXXXXXXXXXXXXXXGXXXXXXXXXXXXXXXXXXXGXXXXXXXXXXXXXXXXXXX,0,300,0

24045,14,1,13,64,222,0,0,234,146,88,GXXXXXXXXXXXXXXXXXXXGXXXXXXXXXXXXXXXXXXXGXXXXXXXXXXXXXXXXXXXGXXXXXXXXXXXXXXXXXXXGXXXXXXXXXXXXXXXXXXXGXXXXXXXXXXXXXXXXXXXGXXXXXXXXXXXXXXXXXXXGXXXXXXXXXXXXXXXXXXXGAXXXXXXXXXXXXXXXXXXGXXXXXXXXXXXXXXXXXXXGXXXXXXXXXXXXXXXXXXXGXXXXXXXXXXXXXXXXXXXGXXXXXXXXXXXXXXXXXXX,0,300,0
24066,14,1,13,63,223,0,0,236,148,88,GXXXXXXXXXXXXXXXXXXXGXXXXXXXXXXXXXXXXXXXGXXXXXXXXXXXXXXXXXXXGXXXXXXXXXXXXXXXXXXXGXXXXXXXXXXXXXXXXXXXGXXXXXXXXXXXXXXXXXXXGXXXXXXXXXXXXXXXXXXXGXXXXXXXXXXXXXXXXXXXGAXXXXXXXXXXXXXXXXXXGXXXXXXXXXXXXXXXXXXXGXXXXXXXXXXXXXXXXXXXGXXXXXXXXXXXXXXXXXXXGXXXXXXXXXXXXXXXXXXX,0,300,0
24087,14,1,13,65,221,0,0,235,144,91,GXXXXXXXXXXXXXXXXXXXGXXXXXXXXXXXXXXXXXXXGXXXXXXXXXXXXXXXXXXXGXXXXXXXXXXXXXXXXXXXGXXXXXXXXXXXXXXXXXXXGXXXXXXXXXXXXXXXXXXXGXXXXXXXXXXXXXXXXXXXGXXXXXXXXXXXXXXXXXXXGAXXXXXXXXXXXXXXXXXXGXXXXXXXXXXXXXXXXXXXGXXXXXXXXXXXXXXXXXXXGXXXXXXXXXXXXXXXXXXXGXXXXXXXXXXXXXXXXXXX,0,300,0
24108,14,1,13,64,222,0,0,235,142,93,GXXXXXXXXXXXXXXXXXXXGXXXXXXXXXXXXXXXXXXXGXXXXXXXXXXXXXXXXXXXGXXXXXXXXXXXXXXXXXXXGXXXXXXXXXXXXXXXXXXXGXXXXXXXXXXXXXXXXXXXGXXXXXXXXXXXXXXXXXXXGXXXXXXXXXXXXXXXXXXXGAXXXXXXXXXXXXXXXXXXGXXXXXXXXXXXXXXXXXXXGXXXXXXXXXXXXXXXXXXXGXXXXXXXXXXXXXXXXXXXGXXXXXXXXXXXXXXXXXXX,0,300,0
24129,14,1,13,63,223,0,0,237,141,96,GXXXXXXXXXXXXXXXXXXXGXXXXXXXXXXXXXXXXXXXGXXXXXXXXXXXXXXXXXXXGXXXXXXXXXXXXXXXXXXXGXXXXXXXXXXXXXXXXXXXGXXXXXXXXXXXXXXXXXXXGXXXXXXXXXXXXXXXXXXXGXXXXXXXXXXXXXXXXXXXGAXXXXXXXXXXXXXXXXXXGXXXXXXXXXXXXXXXXXXXGXXXXXXXXXXXXXXXXXXXGXXXXXXXXXXXXXXXXXXXGXXXXXXXXXXXXXXXXXXX,0,300,0

24150,14,1,13,61,225,0,0,238,139,99,GXXXXXXXXXXXXXXXXXXXGXXXXXXXXXXXXXXXXXXXGXXXXXXXXXXXXXXXXXXXGXXXXXXXXXXXXXXXXXXXGXXXXXXXXXXXXXXXXXXXGXXXXXXXXXXXXXXXXXXXGXXXXXXXXXXXXXXXXXXXGXXXXXXXXXXXXXXXXXXXGAXXXXXXXXXXXXXXXXXXGXXXXXXXXXXXXXXXXXXXGXXXXXXXXXXXXXXXXXXXGXXXXXXXXXXXXXXXXXXXGXXXXXXXXXXXXXXXXXXX,0,300,0
24171,14,0,14,58,228,0,0,240,142,98,GXXXXXXXXXXXXXXXXXXXGXXXXXXXXXXXXXXXXXXXGXXXXXXXXXXXXXXXXXXXGXXXXXXXXXXXXXXXXXXXGXXXXXXXXXXXXXXXXXXXGXXXXXXXXXXXXXXXXXXXGXXXXXXXXXXXXXXXXXXXGXXXXXXXXXXXXXXXXXXXGOXXXXXXXXXXXXXXXXXXGXXXXXXXXXXXXXXXXXXXGXXXXXXXXXXXXXXXXXXXGXXXXXXXXXXXXXXXXXXXGXXXXXXXXXXXXXXXXXXX,0,300,0
24192,14,0,14,56,230,0,0,243,145,98,GXXXXXXXXXXXXXXXXXXXGXXXXXXXXXXXXXXXXXXXGXXXXXXXXXXXXXXXXXXXGXXXXXXXXXXXXXXXXXXXGXXXXXXXXXXXXXXXXXXXGXXXXXXXXXXXXXXXXXXXGXXXXXXXXXXXXXXXXXXXGXXXXXXXXXXXXXXXXXXXGOXXXXXXXXXXXXXXXXXXGXXXXXXXXXXXXXXXXXXXGXXXXXXXXXXXXXXXXXXXGXXXXXXXXXXXXXXXXXXXGXXXXXXXXXXXXXXXXXXX,0,300,0
24213,13,0,13,54,233,0,0,246,147,99,GXXXXXXXXXXXXXXXXXXXGXXXXXXXXXXXXXXXXXXXGXXXXXXXXXXXXXXXXXXXGXXXXXXXXXXXXXXXXXXXGXXXXXXXXXXXXXXXXXXXGXXXXXXXXXXXXXXXXXXXGXXXXXXXXXXXXXXXXXXXGXXXXXXXXXXXXXXXXXXXGXXXXXXXXXXXXXXXXXXXGXXXXXXXXXXXXXXXXXXXGXXXXXXXXXXXXXXXXXXXGXXXXXXXXXXXXXXXXXXXGXXXXXXXXXXXXXXXXXXX,0,300,0
24234,13,0,13,54,233,0,0,244,149,95,GXXXXXXXXXXXXXXXXXXXGXXXXXXXXXXXXXXXXXXXGXXXXXXXXXXXXXXXXXXXGXXXXXXXXXXXXXXXXXXXGXXXXXXXXXXXXXXXXXXXGXXXXXXXXXXXXXXXXXXXGXXXXXXXXXXXXXXXXXXXGXXXXXXXXXXXXXXXXXXXGXXXXXXXXXXXXXXXXXXXGXXXXXXXXXXXXXXXXXXXGXXXXXXXXXXXXXXXXXXXGXXXXXXXXXXXXXXXXXXXGXXXXXXXXXXXXXXXXXXX,0,300,0

24255,13,0,13,62,225,0,0,237,142,95,GXXXXXXXXXXXXXXXXXXXGXXXXXXXXXXXXXXXXXXXGXXXXXXXXXXXXXXXXXXXGXXXXXXXXXXXXXXXXXXXGXXXXXXXXXXXXXXXXXXXGXXXXXXXXXXXXXXXXXXXGXXXXXXXXXXXXXXXXXXXGXXXXXXXXXXXXXXXXXXXGXXXXXXXXXXXXXXXXXXXGXXXXXXXXXXXXXXXXXXXGXXXXXXXXXXXXXXXXXXXGXXXXXXXXXXXXXXXXXXXGXXXXXXXXXXXXXXXXXXX,0,300,0
24276,13,0,13,60,227,0,0,238,136,102,GXXXXXXXXXXXXXXXXXXXGXXXXXXXXXXXXXXXXXXXGXXXXXXXXXXXXXXXXXXXGXXXXXXXXXXXXXXXXXXXGXXXXXXXXXXXXXXXXXXXGXXXXXXXXXXXXXXXXXXXGXXXXXXXXXXXXXXXXXXXGXXXXXXXXXXXXXXXXXXXGXXXXXXXXXXXXXXXXXXXGXXXXXXXXXXXXXXXXXXXGXXXXXXXXXXXXXXXXXXXGXXXXXXXXXXXXXXXXXXXGXXXXXXXXXXXXXXXXXXX,0,300,0
24297,13,0,13,55,232,0,0,243,140,103,GXXXXXXXXXXXXXXXXXXXGXXXXXXXXXXXXXXXXXXXGXXXXXXXXXXXXXXXXXXXGXXXXXXXXXXXXXXXXXXXGXXXXXXXXXXXXXXXXXXXGXXXXXXXXXXXXXXXXXXXGXXXXXXXXXXXXXXXXXXXGXXXXXXXXXXXXXXXXXXXGXXXXXXXXXXXXXXXXXXXGXXXXXXXXXXXXXXXXXXXGXXXXXXXXXXXXXXXXXXXGXXXXXXXXXXXXXXXXXXXGXXXXXXXXXXXXXXXXXXX,0,300,0
24318,13,0,13,56,231,0,0,243,142,101,GXXXXXXXXXXXXXXXXXXXGXXXXXXXXXXXXXXXXXXXGXXXXXXXXXXXXXXXXXXXGXXXXXXXXXXXXXXXXXXXGXXXXXXXXXXXXXXXXXXXGXXXXXXXXXXXXXXXXXXXGXXXXXXXXXXXXXXXXXXXGXXXXXXXXXXXXXXXXXXXGXXXXXXXXXXXXXXXXXXXGXXXXXXXXXXXXXXXXXXXGXXXXXXXXXXXXXXXXXXXGXXXXXXXXXXXXXXXXXXXGXXXXXXXXXXXXXXXXXXX,0,300,0
24339,13,0,13,58,229,0,0,241,142,99,GXXXXXXXXXXXXXXXXXXXGXXXXXXXXXXXXXXXXXXXGXXXXXXXXXXXXXXXXXXXGXXXXXXXXXXXXXXXXXXXGXXXXXXXXXXXXXXXXXXXGXXXXXXXXXXXXXXXXXXXGXXXXXXXXXXXXXXXXXXXGXXXXXXXXXXXXXXXXXXXGXXXXXXXXXXXXXXXXXXXGXXXXXXXXXXXXXXXXXXXGXXXXXXXXXXXXXXXXXXXGXXXXXXXXXXXXXXXXXXXGXXXXXXXXXXXXXXXXXXX,0,300,0

24360,13,0,13,56,231,0,0,244,139,105,GXXXXXXXXXXXXXXXXXXXGXXXXXXXXXXXXXXXXXXXGXXXXXXXXXXXXXXXXXXXGXXXXXXXXXXXXXXXXXXXGXXXXXXXXXXXXXXXXXXXGXXXXXXXXXXXXXXXXXXXGXXXXXXXXXXXXXXXXXXXGXXXXXXXXXXXXXXXXXXXGXXXXXXXXXXXXXXXXXXXGXXXXXXXXXXXXXXXXXXXGXXXXXXXXXXXXXXXXXXXGXXXXXXXXXXXXXXXXXXXGXXXXXXXXXXXXXXXXXXX,0,300,0
24381,13,0,13,58,229,0,0,241,137,104,GXXXXXXXXXXXXXXXXXXXGXXXXXXXXXXXXXXXXXXXGXXXXXXXXXXXXXXXXXXXGXXXXXXXXXXXXXXXXXXXGXXXXXXXXXXXXXXXXXXXGXXXXXXXXXXXXXXXXXXXGXXXXXXXXXXXXXXXXXXXGXXXXXXXXXXXXXXXXXXXGXXXXXXXXXXXXXXXXXXXGXXXXXXXXXXXXXXXXXXXGXXXXXXXXXXXXXXXXXXXGXXXXXXXXXXXXXXXXXXXGXXXXXXXXXXXXXXXXXXX,0,300,0
24402,14,1,13,56,230,0,0,243,136,107,GXXXXXXXXXXXXXXXXXXXGXXXXXXXXXXXXXXXXXXXGXXXXXXXXXXXXXXXXXXXGXXXXXXXXXXXXXXXXXXXGXXXXXXXXXXXXXXXXXXXGXXXXXXXXXXXXXXXXXXXGAXXXXXXXXXXXXXXXXXXGXXXXXXXXXXXXXXXXXXXGXXXXXXXXXXXXXXXXXXXGXXXXXXXXXXXXXXXXXXXGXXXXXXXXXXXXXXXXXXXGXXXXXXXXXXXXXXXXXXXGXXXXXXXXXXXXXXXXXXX,0,300,0
24423,14,1,13,53,233,0,0,246,141,105,GXXXXXXXXXXXXXXXXXXXGXXXXXXXXXXXXXXXXXXXGXXXXXXXXXXXXXXXXXXXGXXXXXXXXXXXXXXXXXXXGXXXXXXXXXXXXXXXXXXXGXXXXXXXXXXXXXXXXXXXGAXXXXXXXXXXXXXXXXXXGXXXXXXXXXXXXXXXXXXXGXXXXXXXXXXXXXXXXXXXGXXXXXXXXXXXXXXXXXXXGXXXXXXXXXXXXXXXXXXXGXXXXXXXXXXXXXXXXXXXGXXXXXXXXXXXXXXXXXXX,0,300,0
24444,14,1,13,48,238,0,0,252,144,108,GXXXXXXXXXXXXXXXXXXXGXXXXXXXXXXXXXXXXXXXGXXXXXXXXXXXXXXXXXXXGXXXXXXXXXXXXXXXXXXXGXXXXXXXXXXXXXXXXXXXGXXXXXXXXXXXXXXXXXXXGAXXXXXXXXXXXXXXXXXXGXXXXXXXXXXXXXXXXXXXGXXXXXXXXXXXXXXXXXXXGXXXXXXXXXXXXXXXXXXXGXXXXXXXXXXXXXXXXXXXGXXXXXXXXXXXXXXXXXXXGXXXXXXXXXXXXXXXXXXX,0,300,0

24465,14,1,13,55,231,0,0,245,140,105,GXXXXXXXXXXXXXXXXXXXGXXXXXXXXXXXXXXXXXXXGXXXXXXXXXXXXXXXXXXXGXXXXXXXXXXXXXXXXXXXGXXXXXXXXXXXXXXXXXXXGXXXXXXXXXXXXXXXXXXXGAXXXXXXXXXXXXXXXXXXGXXXXXXXXXXXXXXXXXXXGXXXXXXXXXXXXXXXXXXXGXXXXXXXXXXXXXXXXXXXGXXXXXXXXXXXXXXXXXXXGXXXXXXXXXXXXXXXXXXXGXXXXXXXXXXXXXXXXXXX,0,300,0
24486,14,1,13,52,234,0,0,246,141,105,GXXXXXXXXXXXXXXXXXXXGXXXXXXXXXXXXXXXXXXXGXXXXXXXXXXXXXXXXXXXGXXXXXXXXXXXXXXXXXXXGXXXXXXXXXXXXXXXXXXXGXXXXXXXXXXXXXXXXXXXGAXXXXXXXXXXXXXXXXXXGXXXXXXXXXXXXXXXXXXXGXXXXXXXXXXXXXXXXXXXGXXXXXXXXXXXXXXXXXXXGXXXXXXXXXXXXXXXXXXXGXXXXXXXXXXXXXXXXXXXGXXXXXXXXXXXXXXXXXXX,0,300,0
24507,14,1,13,49,237,0,0,251,143,108,GXXXXXXXXXXXXXXXXXXXGXXXXXXXXXXXXXXXXXXXGXXXXXXXXXXXXXXXXXXXGXXXXXXXXXXXXXXXXXXXGXXXXXXXXXXXXXXXXXXXGXXXXXXXXXXXXXXXXXXXGAXXXXXXXXXXXXXXXXXXGXXXXXXXXXXXXXXXXXXXGXXXXXXXXXXXXXXXXXXXGXXXXXXXXXXXXXXXXXXXGXXXXXXXXXXXXXXXXXXXGXXXXXXXXXXXXXXXXXXXGXXXXXXXXXXXXXXXXXXX,0,300,0
24528,14,0,14,50,236,0,0,248,142,106,GXXXXXXXXXXXXXXXXXXXGXXXXXXXXXXXXXXXXXXXGXXXXXXXXXXXXXXXXXXXGXXXXXXXXXXXXXXXXXXXGXXXXXXXXXXXXXXXXXXXGXXXXXXXXXXXXXXXXXXXGOXXXXXXXXXXXXXXXXXXGXXXXXXXXXXXXXXXXXXXGXXXXXXXXXXXXXXXXXXXGXXXXXXXXXXXXXXXXXXXGXXXXXXXXXXXXXXXXXXXGXXXXXXXXXXXXXXXXXXXGXXXXXXXXXXXXXXXXXXX,0,300,0
24549,14,0,14,51,235,0,0,248,141,107,GXXXXXXXXXXXXXXXXXXXGXXXXXXXXXXXXXXXXXXXGXXXXXXXXXXXXXXXXXXXGXXXXXXXXXXXXXXXXXXXGXXXXXXXXXXXXXXXXXXXGXXXXXXXXXXXXXXXXXXXGOXXXXXXXXXXXXXXXXXXGXXXXXXXXXXXXXXXXXXXGXXXXXXXXXXXXXXXXXXXGXXXXXXXXXXXXXXXXXXXGXXXXXXXXXXXXXXXXXXXGXXXXXXXXXXXXXXXXXXXGXXXXXXXXXXXXXXXXXXX,0,300,0

24570,13,0,13,51,236,0,0,248,144,104,GXXXXXXXXXXXXXXXXXXXGXXXXXXXXXXXXXXXXXXXGXXXXXXXXXXXXXXXXXXXGXXXXXXXXXXXXXXXXXXXGXXXXXXXXXXXXXXXXXXXGXXXXXXXXXXXXXXXXXXXGXXXXXXXXXXXXXXXXXXXGXXXXXXXXXXXXXXXXXXXGXXXXXXXXXXXXXXXXXXXGXXXXXXXXXXXXXXXXXXXGXXXXXXXXXXXXXXXXXXXGXXXXXXXXXXXXXXXXXXXGXXXXXXXXXXXXXXXXXXX,0,300,0
24591,13,0,13,49,238,0,0,250,146,104,GXXXXXXXXXXXXXXXXXXXGXXXXXXXXXXXXXXXXXXXGXXXXXXXXXXXXXXXXXXXGXXXXXXXXXXXXXXXXXXXGXXXXXXXXXXXXXXXXXXXGXXXXXXXXXXXXXXXXXXXGXXXXXXXXXXXXXXXXXXXGXXXXXXXXXXXXXXXXXXXGXXXXXXXXXXXXXXXXXXXGXXXXXXXXXXXXXXXXXXXGXXXXXXXXXXXXXXXXXXXGXXXXXXXXXXXXXXXXXXXGXXXXXXXXXXXXXXXXXXX,0,300,0
24612,13,0,13,54,233,0,0,245,145,100,GXXXXXXXXXXXXXXXXXXXGXXXXXXXXXXXXXXXXXXXGXXXXXXXXXXXXXXXXXXXGXXXXXXXXXXXXXXXXXXXGXXXXXXXXXXXXXXXXXXXGXXXXXXXXXXXXXXXXXXXGXXXXXXXXXXXXXXXXXXXGXXXXXXXXXXXXXXXXXXXGXXXXXXXXXXXXXXXXXXXGXXXXXXXXXXXXXXXXXXXGXXXXXXXXXXXXXXXXXXXGXXXXXXXXXXXXXXXXXXXGXXXXXXXXXXXXXXXXXXX,0,300,0
24633,13,0,13,58,229,0,0,241,146,95,GXXXXXXXXXXXXXXXXXXXGXXXXXXXXXXXXXXXXXXXGXXXXXXXXXXXXXXXXXXXGXXXXXXXXXXXXXXXXXXXGXXXXXXXXXXXXXXXXXXXGXXXXXXXXXXXXXXXXXXXGXXXXXXXXXXXXXXXXXXXGXXXXXXXXXXXXXXXXXXXGXXXXXXXXXXXXXXXXXXXGXXXXXXXXXXXXXXXXXXXGXXXXXXXXXXXXXXXXXXXGXXXXXXXXXXXXXXXXXXXGXXXXXXXXXXXXXXXXXXX,0,300,0
24654,13,0,13,60,227,0,0,240,146,94,GXXXXXXXXXXXXXXXXXXXGXXXXXXXXXXXXXXXXXXXGXXXXXXXXXXXXXXXXXXXGXXXXXXXXXXXXXXXXXXXGXXXXXXXXXXXXXXXXXXXGXXXXXXXXXXXXXXXXXXXGXXXXXXXXXXXXXXXXXXXGXXXXXXXXXXXXXXXXXXXGXXXXXXXXXXXXXXXXXXXGXXXXXXXXXXXXXXXXXXXGXXXXXXXXXXXXXXXXXXXGXXXXXXXXXXXXXXXXXXXGXXXXXXXXXXXXXXXXXXX,0,300,0

24675,13,0,13,61,226,0,0,239,141,98,GXXXXXXXXXXXXXXXXXXXGXXXXXXXXXXXXXXXXXXXGXXXXXXXXXXXXXXXXXXXGXXXXXXXXXXXXXXXXXXXGXXXXXXXXXXXXXXXXXXXGXXXXXXXXXXXXXXXXXXXGXXXXXXXXXXXXXXXXXXXGXXXXXXXXXXXXXXXXXXXGXXXXXXXXXXXXXXXXXXXGXXXXXXXXXXXXXXXXXXXGXXXXXXXXXXXXXXXXXXXGXXXXXXXXXXXXXXXXXXXGXXXXXXXXXXXXXXXXXXX,0,300,0
24696,13,0,13,62,225,0,0,239,143,96,GXXXXXXXXXXXXXXXXXXXGXXXXXXXXXXXXXXXXXXXGXXXXXXXXXXXXXXXXXXXGXXXXXXXXXXXXXXXXXXXGXXXXXXXXXXXXXXXXXXXGXXXXXXXXXXXXXXXXXXXGXXXXXXXXXXXXXXXXXXXGXXXXXXXXXXXXXXXXXXXGXXXXXXXXXXXXXXXXXXXGXXXXXXXXXXXXXXXXXXXGXXXXXXXXXXXXXXXXXXXGXXXXXXXXXXXXXXXXXXXGXXXXXXXXXXXXXXXXXXX,0,300,0
24717,13,0,13,64,223,0,0,237,142,95,GXXXXXXXXXXXXXXXXXXXGXXXXXXXXXXXXXXXXXXXGXXXXXXXXXXXXXXXXXXXGXXXXXXXXXXXXXXXXXXXGXXXXXXXXXXXXXXXXXXXGXXXXXXXXXXXXXXXXXXXGXXXXXXXXXXXXXXXXXXXGXXXXXXXXXXXXXXXXXXXGXXXXXXXXXXXXXXXXXXXGXXXXXXXXXXXXXXXXXXXGXXXXXXXXXXXXXXXXXXXGXXXXXXXXXXXXXXXXXXXGXXXXXXXXXXXXXXXXXXX,0,300,0
24738,13,0,13,65,222,0,0,236,142,94,GXXXXXXXXXXXXXXXXXXXGXXXXXXXXXXXXXXXXXXXGXXXXXXXXXXXXXXXXXXXGXXXXXXXXXXXXXXXXXXXGXXXXXXXXXXXXXXXXXXXGXXXXXXXXXXXXXXXXXXXGXXXXXXXXXXXXXXXXXXXGXXXXXXXXXXXXXXXXXXXGXXXXXXXXXXXXXXXXXXXGXXXXXXXXXXXXXXXXXXXGXXXXXXXXXXXXXXXXXXXGXXXXXXXXXXXXXXXXXXXGXXXXXXXXXXXXXXXXXXX,0,300,0
24759,13,0,13,58,229,0,0,242,146,96,GXXXXXXXXXXXXXXXXXXXGXXXXXXXXXXXXXXXXXXXGXXXXXXXXXXXXXXXXXXXGXXXXXXXXXXXXXXXXXXXGXXXXXXXXXXXXXXXXXXXGXXXXXXXXXXXXXXXXXXXGXXXXXXXXXXXXXXXXXXXGXXXXXXXXXXXXXXXXXXXGXXXXXXXXXXXXXXXXXXXGXXXXXXXXXXXXXXXXXXXGXXXXXXXXXXXXXXXXXXXGXXXXXXXXXXXXXXXXXXXGXXXXXXXXXXXXXXXXXXX,0,300,0

24780,13,0,13,53,234,0,0,247,155,92,GXXXXXXXXXXXXXXXXXXXGXXXXXXXXXXXXXXXXXXXGXXXXXXXXXXXXXXXXXXXGXXXXXXXXXXXXXXXXXXXGXXXXXXXXXXXXXXXXXXXGXXXXXXXXXXXXXXXXXXXGXXXXXXXXXXXXXXXXXXXGXXXXXXXXXXXXXXXXXXXGXXXXXXXXXXXXXXXXXXXGXXXXXXXXXXXXXXXXXXXGXXXXXXXXXXXXXXXXXXXGXXXXXXXXXXXXXXXXXXXGXXXXXXXXXXXXXXXXXXX,0,300,0
24801,13,0,13,56,231,0,0,243,151,92,GXXXXXXXXXXXXXXXXXXXGXXXXXXXXXXXXXXXXXXXGXXXXXXXXXXXXXXXXXXXGXXXXXXXXXXXXXXXXXXXGXXXXXXXXXXXXXXXXXXXGXXXXXXXXXXXXXXXXXXXGXXXXXXXXXXXXXXXXXXXGXXXXXXXXXXXXXXXXXXXGXXXXXXXXXXXXXXXXXXXGXXXXXXXXXXXXXXXXXXXGXXXXXXXXXXXXXXXXXXXGXXXXXXXXXXXXXXXXXXXGXXXXXXXXXXXXXXXXXXX,0,300,0
24822,13,0,13,55,232,0,0,245,150,95,GXXXXXXXXXXXXXXXXXXXGXXXXXXXXXXXXXXXXXXXGXXXXXXXXXXXXXXXXXXXGXXXXXXXXXXXXXXXXXXXGXXXXXXXXXXXXXXXXXXXGXXXXXXXXXXXXXXXXXXXGXXXXXXXXXXXXXXXXXXXGXXXXXXXXXXXXXXXXXXXGXXXXXXXXXXXXXXXXXXXGXXXXXXXXXXXXXXXXXXXGXXXXXXXXXXXXXXXXXXXGXXXXXXXXXXXXXXXXXXXGXXXXXXXXXXXXXXXXXXX,0,300,0
24843,13,0,13,57,230,0,0,243,146,97,GXXXXXXXXXXXXXXXXXXXGXXXXXXXXXXXXXXXXXXXGXXXXXXXXXXXXXXXXXXXGXXXXXXXXXXXXXXXXXXXGXXXXXXXXXXXXXXXXXXXGXXXXXXXXXXXXXXXXXXXGXXXXXXXXXXXXXXXXXXXGXXXXXXXXXXXXXXXXXXXGXXXXXXXXXXXXXXXXXXXGXXXXXXXXXXXXXXXXXXXGXXXXXXXXXXXXXXXXXXXGXXXXXXXXXXXXXXXXXXXGXXXXXXXXXXXXXXXXXXX,0,300,0
24864,13,0,13,53,234,0,0,245,147,98,GXXXXXXXXXXXXXXXXXXXGXXXXXXXXXXXXXXXXXXXGXXXXXXXXXXXXXXXXXXXGXXXXXXXXXXXXXXXXXXXGXXXXXXXXXXXXXXXXXXXGXXXXXXXXXXXXXXXXXXXGXXXXXXXXXXXXXXXXXXXGXXXXXXXXXXXXXXXXXXXGXXXXXXXXXXXXXXXXXXXGXXXXXXXXXXXXXXXXXXXGXXXXXXXXXXXXXXXXXXXGXXXXXXXXXXXXXXXXXXXGXXXXXXXXXXXXXXXXXXX,0,300,0

24885,13,0,13,50,237,0,0,249,146,103,GXXXXXXXXXXXXXXXXXXXGXXXXXXXXXXXXXXXXXXXGXXXXXXXXXXXXXXXXXXXGXXXXXXXXXXXXXXXXXXXGXXXXXXXXXXXXXXXXXXXGXXXXXXXXXXXXXXXXXXXGXXXXXXXXXXXXXXXXXXXGXXXXXXXXXXXXXXXXXXXGXXXXXXXXXXXXXXXXXXXGXXXXXXXXXXXXXXXXXXXGXXXXXXXXXXXXXXXXXXXGXXXXXXXXXXXXXXXXXXXGXXXXXXXXXXXXXXXXXXX,0,300,0
24906,13,0,13,51,236,0,0,247,141,106,GXXXXXXXXXXXXXXXXXXXGXXXXXXXXXXXXXXXXXXXGXXXXXXXXXXXXXXXXXXXGXXXXXXXXXXXXXXXXXXXGXXXXXXXXXXXXXXXXXXXGXXXXXXXXXXXXXXXXXXXGXXXXXXXXXXXXXXXXXXXGXXXXXXXXXXXXXXXXXXXGXXXXXXXXXXXXXXXXXXXGXXXXXXXXXXXXXXXXXXXGXXXXXXXXXXXXXXXXXXXGXXXXXXXXXXXXXXXXXXXGXXXXXXXXXXXXXXXXXXX,0,300,0
24927,13,0,13,48,239,0,0,251,146,105,GXXXXXXXXXXXXXXXXXXXGXXXXXXXXXXXXXXXXXXXGXXXXXXXXXXXXXXXXXXXGXXXXXXXXXXXXXXXXXXXGXXXXXXXXXXXXXXXXXXXGXXXXXXXXXXXXXXXXXXXGXXXXXXXXXXXXXXXXXXXGXXXXXXXXXXXXXXXXXXXGXXXXXXXXXXXXXXXXXXXGXXXXXXXXXXXXXXXXXXXGXXXXXXXXXXXXXXXXXXXGXXXXXXXXXXXXXXXXXXXGXXXXXXXXXXXXXXXXXXX,0,300,0
24948,13,0,13,50,237,0,0,249,149,100,GXXXXXXXXXXXXXXXXXXXGXXXXXXXXXXXXXXXXXXXGXXXXXXXXXXXXXXXXXXXGXXXXXXXXXXXXXXXXXXXGXXXXXXXXXXXXXXXXXXXGXXXXXXXXXXXXXXXXXXXGXXXXXXXXXXXXXXXXXXXGXXXXXXXXXXXXXXXXXXXGXXXXXXXXXXXXXXXXXXXGXXXXXXXXXXXXXXXXXXXGXXXXXXXXXXXXXXXXXXXGXXXXXXXXXXXXXXXXXXXGXXXXXXXXXXXXXXXXXXX,0,300,0
24969,13,0,13,54,233,0,0,245,144,101,GXXXXXXXXXXXXXXXXXXXGXXXXXXXXXXXXXXXXXXXGXXXXXXXXXXXXXXXXXXXGXXXXXXXXXXXXXXXXXXXGXXXXXXXXXXXXXXXXXXXGXXXXXXXXXXXXXXXXXXXGXXXXXXXXXXXXXXXXXXXGXXXXXXXXXXXXXXXXXXXGXXXXXXXXXXXXXXXXXXXGXXXXXXXXXXXXXXXXXXXGXXXXXXXXXXXXXXXXXXXGXXXXXXXXXXXXXXXXXXXGXXXXXXXXXXXXXXXXXXX,0,300,0

24990,13,0,13,56,231,0,0,243,145,98,GXXXXXXXXXXXXXXXXXXXGXXXXXXXXXXXXXXXXXXXGXXXXXXXXXXXXXXXXXXXGXXXXXXXXXXXXXXXXXXXGXXXXXXXXXXXXXXXXXXXGXXXXXXXXXXXXXXXXXXXGXXXXXXXXXXXXXXXXXXXGXXXXXXXXXXXXXXXXXXXGXXXXXXXXXXXXXXXXXXXGXXXXXXXXXXXXXXXXXXXGXXXXXXXXXXXXXXXXXXXGXXXXXXXXXXXXXXXXXXXGXXXXXXXXXXXXXXXXXXX,0,300,0
25011,13,0,13,60,227,0,0,238,144,94,GXXXXXXXXXXXXXXXXXXXGXXXXXXXXXXXXXXXXXXXGXXXXXXXXXXXXXXXXXXXGXXXXXXXXXXXXXXXXXXXGXXXXXXXXXXXXXXXXXXXGXXXXXXXXXXXXXXXXXXXGXXXXXXXXXXXXXXXXXXXGXXXXXXXXXXXXXXXXXXXGXXXXXXXXXXXXXXXXXXXGXXXXXXXXXXXXXXXXXXXGXXXXXXXXXXXXXXXXXXXGXXXXXXXXXXXXXXXXXXXGXXXXXXXXXXXXXXXXXXX,0,300,0
25032,13,0,13,59,228,0,0,240,145,95,GXXXXXXXXXXXXXXXXXXXGXXXXXXXXXXXXXXXXXXXGXXXXXXXXXXXXXXXXXXXGXXXXXXXXXXXXXXXXXXXGXXXXXXXXXXXXXXXXXXXGXXXXXXXXXXXXXXXXXXXGXXXXXXXXXXXXXXXXXXXGXXXXXXXXXXXXXXXXXXXGXXXXXXXXXXXXXXXXXXXGXXXXXXXXXXXXXXXXXXXGXXXXXXXXXXXXXXXXXXXGXXXXXXXXXXXXXXXXXXXGXXXXXXXXXXXXXXXXXXX,0,300,0
25053,13,0,13,59,228,0,0,240,143,97,GXXXXXXXXXXXXXXXXXXXGXXXXXXXXXXXXXXXXXXXGXXXXXXXXXXXXXXXXXXXGXXXXXXXXXXXXXXXXXXXGXXXXXXXXXXXXXXXXXXXGXXXXXXXXXXXXXXXXXXXGXXXXXXXXXXXXXXXXXXXGXXXXXXXXXXXXXXXXXXXGXXXXXXXXXXXXXXXXXXXGXXXXXXXXXXXXXXXXXXXGXXXXXXXXXXXXXXXXXXXGXXXXXXXXXXXXXXXXXXXGXXXXXXXXXXXXXXXXXXX,0,300,0
25074,13,0,13,59,228,0,0,240,147,93,GXXXXXXXXXXXXXXXXXXXGXXXXXXXXXXXXXXXXXXXGXXXXXXXXXXXXXXXXXXXGXXXXXXXXXXXXXXXXXXXGXXXXXXXXXXXXXXXXXXXGXXXXXXXXXXXXXXXXXXXGXXXXXXXXXXXXXXXXXXXGXXXXXXXXXXXXXXXXXXXGXXXXXXXXXXXXXXXXXXXGXXXXXXXXXXXXXXXXXXXGXXXXXXXXXXXXXXXXXXXGXXXXXXXXXXXXXXXXXXXGXXXXXXXXXXXXXXXXXXX,0,300,0

25095,13,0,13,62,225,0,0,237,143,94,GXXXXXXXXXXXXXXXXXXXGXXXXXXXXXXXXXXXXXXXGXXXXXXXXXXXXXXXXXXXGXXXXXXXXXXXXXXXXXXXGXXXXXXXXXXXXXXXXXXXGXXXXXXXXXXXXXXXXXXXGXXXXXXXXXXXXXXXXXXXGXXXXXXXXXXXXXXXXXXXGXXXXXXXXXXXXXXXXXXXGXXXXXXXXXXXXXXXXXXXGXXXXXXXXXXXXXXXXXXXGXXXXXXXXXXXXXXXXXXXGXXXXXXXXXXXXXXXXXXX,0,300,0
25116,13,0,13,61,226,0,0,237,147,90,GXXXXXXXXXXXXXXXXXXXGXXXXXXXXXXXXXXXXXXXGXXXXXXXXXXXXXXXXXXXGXXXXXXXXXXXXXXXXXXXGXXXXXXXXXXXXXXXXXXXGXXXXXXXXXXXXXXXXXXXGXXXXXXXXXXXXXXXXXXXGXXXXXXXXXXXXXXXXXXXGXXXXXXXXXXXXXXXXXXXGXXXXXXXXXXXXXXXXXXXGXXXXXXXXXXXXXXXXXXXGXXXXXXXXXXXXXXXXXXXGXXXXXXXXXXXXXXXXXXX,0,300,0
25137,14,1,13,67,219,0,0,231,149,82,GXXXXXXXXXXXXXXXXXXXGXXXXXXXXXXXXXXXXXXXGXXXXXXXXXXXXXXXXXXXGXXXXXXXXXXXXXXXXXXXGXXXXXXXXXXXXXXXXXXXGXXXXXXXXXXXXXXXXXXXGXXXXXXXXXXXXXXXXXXXGXXXXXXXXXXXXXXXXXXXGXXXXXXXXXXXXXXXXXXXGAXXXXXXXXXXXXXXXXXXGXXXXXXXXXXXXXXXXXXXGXXXXXXXXXXXXXXXXXXXGXXXXXXXXXXXXXXXXXXX,0,300,0
25158,14,1,13,66,220,0,0,231,145,86,GXXXXXXXXXXXXXXXXXXXGXXXXXXXXXXXXXXXXXXXGXXXXXXXXXXXXXXXXXXXGXXXXXXXXXXXXXXXXXXXGXXXXXXXXXXXXXXXXXXXGXXXXXXXXXXXXXXXXXXXGXXXXXXXXXXXXXXXXXXXGXXXXXXXXXXXXXXXXXXXGXXXXXXXXXXXXXXXXXXXGAXXXXXXXXXXXXXXXXXXGXXXXXXXXXXXXXXXXXXXGXXXXXXXXXXXXXXXXXXXGXXXXXXXXXXXXXXXXXXX,0,300,0
25179,14,1,13,64,222,0,0,234,146,88,GXXXXXXXXXXXXXXXXXXXGXXXXXXXXXXXXXXXXXXXGXXXXXXXXXXXXXXXXXXXGXXXXXXXXXXXXXXXXXXXGXXXXXXXXXXXXXXXXXXXGXXXXXXXXXXXXXXXXXXXGXXXXXXXXXXXXXXXXXXXGXXXXXXXXXXXXXXXXXXXGXXXXXXXXXXXXXXXXXXXGAXXXXXXXXXXXXXXXXXXGXXXXXXXXXXXXXXXXXXXGXXXXXXXXXXXXXXXXXXXGXXXXXXXXXXXXXXXXXXX,0,300,0

25200,14,1,13,60,226,0,0,238,142,96,GXXXXXXXXXXXXXXXXXXXGXXXXXXXXXXXXXXXXXXXGXXXXXXXXXXXXXXXXXXXGXXXXXXXXXXXXXXXXXXXGXXXXXXXXXXXXXXXXXXXGXXXXXXXXXXXXXXXXXXXGXXXXXXXXXXXXXXXXXXXGXXXXXXXXXXXXXXXXXXXGXXXXXXXXXXXXXXXXXXXGAXXXXXXXXXXXXXXXXXXGXXXXXXXXXXXXXXXXXXXGXXXXXXXXXXXXXXXXXXXGXXXXXXXXXXXXXXXXXXX,0,300,0
25221,14,1,13,59,227,0,0,240,145,95,GXXXXXXXXXXXXXXXXXXXGXXXXXXXXXXXXXXXXXXXGXXXXXXXXXXXXXXXXXXXGXXXXXXXXXXXXXXXXXXXGXXXXXXXXXXXXXXXXXXXGXXXXXXXXXXXXXXXXXXXGXXXXXXXXXXXXXXXXXXXGXXXXXXXXXXXXXXXXXXXGXXXXXXXXXXXXXXXXXXXGAXXXXXXXXXXXXXXXXXXGXXXXXXXXXXXXXXXXXXXGXXXXXXXXXXXXXXXXXXXGXXXXXXXXXXXXXXXXXXX,0,300,0
25242,14,1,13,59,227,0,0,240,144,96,GXXXXXXXXXXXXXXXXXXXGXXXXXXXXXXXXXXXXXXXGXXXXXXXXXXXXXXXXXXXGXXXXXXXXXXXXXXXXXXXGXXXXXXXXXXXXXXXXXXXGXXXXXXXXXXXXXXXXXXXGXXXXXXXXXXXXXXXXXXXGXXXXXXXXXXXXXXXXXXXGXXXXXXXXXXXXXXXXXXXGAXXXXXXXXXXXXXXXXXXGXXXXXXXXXXXXXXXXXXXGXXXXXXXXXXXXXXXXXXXGXXXXXXXXXXXXXXXXXXX,0,300,0
25263,14,1,13,60,226,0,0,238,149,89,GXXXXXXXXXXXXXXXXXXXGXXXXXXXXXXXXXXXXXXXGXXXXXXXXXXXXXXXXXXXGXXXXXXXXXXXXXXXXXXXGXXXXXXXXXXXXXXXXXXXGXXXXXXXXXXXXXXXXXXXGXXXXXXXXXXXXXXXXXXXGXXXXXXXXXXXXXXXXXXXGXXXXXXXXXXXXXXXXXXXGAXXXXXXXXXXXXXXXXXXGXXXXXXXXXXXXXXXXXXXGXXXXXXXXXXXXXXXXXXXGXXXXXXXXXXXXXXXXXXX,0,300,0
25284,14,1,13,65,221,0,0,234,144,90,GXXXXXXXXXXXXXXXXXXXGXXXXXXXXXXXXXXXXXXXGXXXXXXXXXXXXXXXXXXXGXXXXXXXXXXXXXXXXXXXGXXXXXXXXXXXXXXXXXXXGXXXXXXXXXXXXXXXXXXXGXXXXXXXXXXXXXXXXXXXGXXXXXXXXXXXXXXXXXXXGXXXXXXXXXXXXXXXXXXXGAXXXXXXXXXXXXXXXXXXGXXXXXXXXXXXXXXXXXXXGXXXXXXXXXXXXXXXXXXXGXXXXXXXXXXXXXXXXXXX,0,300,0

25305,14,1,13,58,228,0,0,240,148,92,GXXXXXXXXXXXXXXXXXXXGXXXXXXXXXXXXXXXXXXXGXXXXXXXXXXXXXXXXXXXGXXXXXXXXXXXXXXXXXXXGXXXXXXXXXXXXXXXXXXXGXXXXXXXXXXXXXXXXXXXGXXXXXXXXXXXXXXXXXXXGXXXXXXXXXXXXXXXXXXXGXXXXXXXXXXXXXXXXXXXGAXXXXXXXXXXXXXXXXXXGXXXXXXXXXXXXXXXXXXXGXXXXXXXXXXXXXXXXXXXGXXXXXXXXXXXXXXXXXXX,0,300,0
25326,14,1,13,54,232,0,0,244,146,98,GXXXXXXXXXXXXXXXXXXXGXXXXXXXXXXXXXXXXXXXGXXXXXXXXXXXXXXXXXXXGXXXXXXXXXXXXXXXXXXXGXXXXXXXXXXXXXXXXXXXGXXXXXXXXXXXXXXXXXXXGXXXXXXXXXXXXXXXXXXXGXXXXXXXXXXXXXXXXXXXGXXXXXXXXXXXXXXXXXXXGAXXXXXXXXXXXXXXXXXXGXXXXXXXXXXXXXXXXXXXGXXXXXXXXXXXXXXXXXXXGXXXXXXXXXXXXXXXXXXX,0,300,0
25347,14,0,14,54,232,0,0,244,150,94,GXXXXXXXXXXXXXXXXXXXGXXXXXXXXXXXXXXXXXXXGXXXXXXXXXXXXXXXXXXXGXXXXXXXXXXXXXXXXXXXGXXXXXXXXXXXXXXXXXXXGXXXXXXXXXXXXXXXXXXXGXXXXXXXXXXXXXXXXXXXGXXXXXXXXXXXXXXXXXXXGXXXXXXXXXXXXXXXXXXXGOXXXXXXXXXXXXXXXXXXGXXXXXXXXXXXXXXXXXXXGXXXXXXXXXXXXXXXXXXXGXXXXXXXXXXXXXXXXXXX,0,300,0
25368,13,0,13,54,233,0,0,244,147,97,GXXXXXXXXXXXXXXXXXXXGXXXXXXXXXXXXXXXXXXXGXXXXXXXXXXXXXXXXXXXGXXXXXXXXXXXXXXXXXXXGXXXXXXXXXXXXXXXXXXXGXXXXXXXXXXXXXXXXXXXGXXXXXXXXXXXXXXXXXXXGXXXXXXXXXXXXXXXXXXXGXXXXXXXXXXXXXXXXXXXGXXXXXXXXXXXXXXXXXXXGXXXXXXXXXXXXXXXXXXXGXXXXXXXXXXXXXXXXXXXGXXXXXXXXXXXXXXXXXXX,0,300,0
25389,13,0,13,55,232,0,0,244,144,100,GXXXXXXXXXXXXXXXXXXXGXXXXXXXXXXXXXXXXXXXGXXXXXXXXXXXXXXXXXXXGXXXXXXXXXXXXXXXXXXXGXXXXXXXXXXXXXXXXXXXGXXXXXXXXXXXXXXXXXXXGXXXXXXXXXXXXXXXXXXXGXXXXXXXXXXXXXXXXXXXGXXXXXXXXXXXXXXXXXXXGXXXXXXXXXXXXXXXXXXXGXXXXXXXXXXXXXXXXXXXGXXXXXXXXXXXXXXXXXXXGXXXXXXXXXXXXXXXXXXX,0,300,0

25410,13,0,13,53,234,0,0,246,143,103,GXXXXXXXXXXXXXXXXXXXGXXXXXXXXXXXXXXXXXXXGXXXXXXXXXXXXXXXXXXXGXXXXXXXXXXXXXXXXXXXGXXXXXXXXXXXXXXXXXXXGXXXXXXXXXXXXXXXXXXXGXXXXXXXXXXXXXXXXXXXGXXXXXXXXXXXXXXXXXXXGXXXXXXXXXXXXXXXXXXXGXXXXXXXXXXXXXXXXXXXGXXXXXXXXXXXXXXXXXXXGXXXXXXXXXXXXXXXXXXXGXXXXXXXXXXXXXXXXXXX,0,300,0
25431,13,0,13,48,239,0,0,251,147,104,GXXXXXXXXXXXXXXXXXXXGXXXXXXXXXXXXXXXXXXXGXXXXXXXXXXXXXXXXXXXGXXXXXXXXXXXXXXXXXXXGXXXXXXXXXXXXXXXXXXXGXXXXXXXXXXXXXXXXXXXGXXXXXXXXXXXXXXXXXXXGXXXXXXXXXXXXXXXXXXXGXXXXXXXXXXXXXXXXXXXGXXXXXXXXXXXXXXXXXXXGXXXXXXXXXXXXXXXXXXXGXXXXXXXXXXXXXXXXXXXGXXXXXXXXXXXXXXXXXXX,0,300,0
25452,13,0,13,49,238,0,0,250,148,102,GXXXXXXXXXXXXXXXXXXXGXXXXXXXXXXXXXXXXXXXGXXXXXXXXXXXXXXXXXXXGXXXXXXXXXXXXXXXXXXXGXXXXXXXXXXXXXXXXXXXGXXXXXXXXXXXXXXXXXXXGXXXXXXXXXXXXXXXXXXXGXXXXXXXXXXXXXXXXXXXGXXXXXXXXXXXXXXXXXXXGXXXXXXXXXXXXXXXXXXXGXXXXXXXXXXXXXXXXXXXGXXXXXXXXXXXXXXXXXXXGXXXXXXXXXXXXXXXXXXX,0,300,0
25473,13,0,13,47,240,0,0,252,148,104,GXXXXXXXXXXXXXXXXXXXGXXXXXXXXXXXXXXXXXXXGXXXXXXXXXXXXXXXXXXXGXXXXXXXXXXXXXXXXXXXGXXXXXXXXXXXXXXXXXXXGXXXXXXXXXXXXXXXXXXXGXXXXXXXXXXXXXXXXXXXGXXXXXXXXXXXXXXXXXXXGXXXXXXXXXXXXXXXXXXXGXXXXXXXXXXXXXXXXXXXGXXXXXXXXXXXXXXXXXXXGXXXXXXXXXXXXXXXXXXXGXXXXXXXXXXXXXXXXXXX,0,300,0
25494,13,0,13,51,236,0,0,249,145,104,GXXXXXXXXXXXXXXXXXXXGXXXXXXXXXXXXXXXXXXXGXXXXXXXXXXXXXXXXXXXGXXXXXXXXXXXXXXXXXXXGXXXXXXXXXXXXXXXXXXXGXXXXXXXXXXXXXXXXXXXGXXXXXXXXXXXXXXXXXXXGXXXXXXXXXXXXXXXXXXXGXXXXXXXXXXXXXXXXXXXGXXXXXXXXXXXXXXXXXXXGXXXXXXXXXXXXXXXXXXXGXXXXXXXXXXXXXXXXXXXGXXXXXXXXXXXXXXXXXXX,0,300,0

25515,13,0,13,48,239,0,0,252,147,105,GXXXXXXXXXXXXXXXXXXXGXXXXXXXXXXXXXXXXXXXGXXXXXXXXXXXXXXXXXXXGXXXXXXXXXXXXXXXXXXXGXXXXXXXXXXXXXXXXXXXGXXXXXXXXXXXXXXXXXXXGXXXXXXXXXXXXXXXXXXXGXXXXXXXXXXXXXXXXXXXGXXXXXXXXXXXXXXXXXXXGXXXXXXXXXXXXXXXXXXXGXXXXXXXXXXXXXXXXXXXGXXXXXXXXXXXXXXXXXXXGXXXXXXXXXXXXXXXXXXX,0,300,0
25536,13,0,13,44,243,0,0,255,152,103,GXXXXXXXXXXXXXXXXXXXGXXXXXXXXXXXXXXXXXXXGXXXXXXXXXXXXXXXXXXXGXXXXXXXXXXXXXXXXXXXGXXXXXXXXXXXXXXXXXXXGXXXXXXXXXXXXXXXXXXXGXXXXXXXXXXXXXXXXXXXGXXXXXXXXXXXXXXXXXXXGXXXXXXXXXXXXXXXXXXXGXXXXXXXXXXXXXXXXXXXGXXXXXXXXXXXXXXXXXXXGXXXXXXXXXXXXXXXXXXXGXXXXXXXXXXXXXXXXXXX,0,300,0
25557,13,0,13,49,238,0,0,250,150,100,GXXXXXXXXXXXXXXXXXXXGXXXXXXXXXXXXXXXXXXXGXXXXXXXXXXXXXXXXXXXGXXXXXXXXXXXXXXXXXXXGXXXXXXXXXXXXXXXXXXXGXXXXXXXXXXXXXXXXXXXGXXXXXXXXXXXXXXXXXXXGXXXXXXXXXXXXXXXXXXXGXXXXXXXXXXXXXXXXXXXGXXXXXXXXXXXXXXXXXXXGXXXXXXXXXXXXXXXXXXXGXXXXXXXXXXXXXXXXXXXGXXXXXXXXXXXXXXXXXXX,0,300,0
25578,13,0,13,48,239,0,0,252,148,104,GXXXXXXXXXXXXXXXXXXXGXXXXXXXXXXXXXXXXXXXGXXXXXXXXXXXXXXXXXXXGXXXXXXXXXXXXXXXXXXXGXXXXXXXXXXXXXXXXXXXGXXXXXXXXXXXXXXXXXXXGXXXXXXXXXXXXXXXXXXXGXXXXXXXXXXXXXXXXXXXGXXXXXXXXXXXXXXXXXXXGXXXXXXXXXXXXXXXXXXXGXXXXXXXXXXXXXXXXXXXGXXXXXXXXXXXXXXXXXXXGXXXXXXXXXXXXXXXXXXX,0,300,0
25599,13,0,13,47,240,0,0,253,152,101,GXXXXXXXXXXXXXXXXXXXGXXXXXXXXXXXXXXXXXXXGXXXXXXXXXXXXXXXXXXXGXXXXXXXXXXXXXXXXXXXGXXXXXXXXXXXXXXXXXXXGXXXXXXXXXXXXXXXXXXXGXXXXXXXXXXXXXXXXXXXGXXXXXXXXXXXXXXXXXXXGXXXXXXXXXXXXXXXXXXXGXXXXXXXXXXXXXXXXXXXGXXXXXXXXXXXXXXXXXXXGXXXXXXXXXXXXXXXXXXXGXXXXXXXXXXXXXXXXXXX,0,300,0

25620,13,0,13,53,234,0,0,246,152,94,GXXXXXXXXXXXXXXXXXXXGXXXXXXXXXXXXXXXXXXXGXXXXXXXXXXXXXXXXXXXGXXXXXXXXXXXXXXXXXXXGXXXXXXXXXXXXXXXXXXXGXXXXXXXXXXXXXXXXXXXGXXXXXXXXXXXXXXXXXXXGXXXXXXXXXXXXXXXXXXXGXXXXXXXXXXXXXXXXXXXGXXXXXXXXXXXXXXXXXXXGXXXXXXXXXXXXXXXXXXXGXXXXXXXXXXXXXXXXXXXGXXXXXXXXXXXXXXXXXXX,0,300,0
25641,13,0,13,52,235,0,0,247,151,96,GXXXXXXXXXXXXXXXXXXXGXXXXXXXXXXXXXXXXXXXGXXXXXXXXXXXXXXXXXXXGXXXXXXXXXXXXXXXXXXXGXXXXXXXXXXXXXXXXXXXGXXXXXXXXXXXXXXXXXXXGXXXXXXXXXXXXXXXXXXXGXXXXXXXXXXXXXXXXXXXGXXXXXXXXXXXXXXXXXXXGXXXXXXXXXXXXXXXXXXXGXXXXXXXXXXXXXXXXXXXGXXXXXXXXXXXXXXXXXXXGXXXXXXXXXXXXXXXXXXX,0,300,0
25662,13,0,13,54,233,0,0,244,155,89,GXXXXXXXXXXXXXXXXXXXGXXXXXXXXXXXXXXXXXXXGXXXXXXXXXXXXXXXXXXXGXXXXXXXXXXXXXXXXXXXGXXXXXXXXXXXXXXXXXXXGXXXXXXXXXXXXXXXXXXXGXXXXXXXXXXXXXXXXXXXGXXXXXXXXXXXXXXXXXXXGXXXXXXXXXXXXXXXXXXXGXXXXXXXXXXXXXXXXXXXGXXXXXXXXXXXXXXXXXXXGXXXXXXXXXXXXXXXXXXXGXXXXXXXXXXXXXXXXXXX,0,300,0
25683,13,0,13,57,230,0,0,242,151,91,GXXXXXXXXXXXXXXXXXXXGXXXXXXXXXXXXXXXXXXXGXXXXXXXXXXXXXXXXXXXGXXXXXXXXXXXXXXXXXXXGXXXXXXXXXXXXXXXXXXXGXXXXXXXXXXXXXXXXXXXGXXXXXXXXXXXXXXXXXXXGXXXXXXXXXXXXXXXXXXXGXXXXXXXXXXXXXXXXXXXGXXXXXXXXXXXXXXXXXXXGXXXXXXXXXXXXXXXXXXXGXXXXXXXXXXXXXXXXXXXGXXXXXXXXXXXXXXXXXXX,0,300,0
25704,13,0,13,55,232,0,0,244,159,85,GXXXXXXXXXXXXXXXXXXXGXXXXXXXXXXXXXXXXXXXGXXXXXXXXXXXXXXXXXXXGXXXXXXXXXXXXXXXXXXXGXXXXXXXXXXXXXXXXXXXGXXXXXXXXXXXXXXXXXXXGXXXXXXXXXXXXXXXXXXXGXXXXXXXXXXXXXXXXXXXGXXXXXXXXXXXXXXXXXXXGXXXXXXXXXXXXXXXXXXXGXXXXXXXXXXXXXXXXXXXGXXXXXXXXXXXXXXXXXXXGXXXXXXXXXXXXXXXXXXX,0,300,0

25725,13,0,13,58,229,0,0,241,155,86,GXXXXXXXXXXXXXXXXXXXGXXXXXXXXXXXXXXXXXXXGXXXXXXXXXXXXXXXXXXXGXXXXXXXXXXXXXXXXXXXGXXXXXXXXXXXXXXXXXXXGXXXXXXXXXXXXXXXXXXXGXXXXXXXXXXXXXXXXXXXGXXXXXXXXXXXXXXXXXXXGXXXXXXXXXXXXXXXXXXXGXXXXXXXXXXXXXXXXXXXGXXXXXXXXXXXXXXXXXXXGXXXXXXXXXXXXXXXXXXXGXXXXXXXXXXXXXXXXXXX,0,300,0
25746,13,0,13,64,223,0,0,236,151,85,GXXXXXXXXXXXXXXXXXXXGXXXXXXXXXXXXXXXXXXXGXXXXXXXXXXXXXXXXXXXGXXXXXXXXXXXXXXXXXXXGXXXXXXXXXXXXXXXXXXXGXXXXXXXXXXXXXXXXXXXGXXXXXXXXXXXXXXXXXXXGXXXXXXXXXXXXXXXXXXXGXXXXXXXXXXXXXXXXXXXGXXXXXXXXXXXXXXXXXXXGXXXXXXXXXXXXXXXXXXXGXXXXXXXXXXXXXXXXXXXGXXXXXXXXXXXXXXXXXXX,0,300,0
25767,13,0,13,65,222,0,0,234,147,87,GXXXXXXXXXXXXXXXXXXXGXXXXXXXXXXXXXXXXXXXGXXXXXXXXXXXXXXXXXXXGXXXXXXXXXXXXXXXXXXXGXXXXXXXXXXXXXXXXXXXGXXXXXXXXXXXXXXXXXXXGXXXXXXXXXXXXXXXXXXXGXXXXXXXXXXXXXXXXXXXGXXXXXXXXXXXXXXXXXXXGXXXXXXXXXXXXXXXXXXXGXXXXXXXXXXXXXXXXXXXGXXXXXXXXXXXXXXXXXXXGXXXXXXXXXXXXXXXXXXX,0,300,0
25788,13,0,13,67,220,0,0,233,147,86,GXXXXXXXXXXXXXXXXXXXGXXXXXXXXXXXXXXXXXXXGXXXXXXXXXXXXXXXXXXXGXXXXXXXXXXXXXXXXXXXGXXXXXXXXXXXXXXXXXXXGXXXXXXXXXXXXXXXXXXXGXXXXXXXXXXXXXXXXXXXGXXXXXXXXXXXXXXXXXXXGXXXXXXXXXXXXXXXXXXXGXXXXXXXXXXXXXXXXXXXGXXXXXXXXXXXXXXXXXXXGXXXXXXXXXXXXXXXXXXXGXXXXXXXXXXXXXXXXXXX,0,300,0
25809,13,0,13,62,225,0,0,238,148,90,GXXXXXXXXXXXXXXXXXXXGXXXXXXXXXXXXXXXXXXXGXXXXXXXXXXXXXXXXXXXGXXXXXXXXXXXXXXXXXXXGXXXXXXXXXXXXXXXXXXXGXXXXXXXXXXXXXXXXXXXGXXXXXXXXXXXXXXXXXXXGXXXXXXXXXXXXXXXXXXXGXXXXXXXXXXXXXXXXXXXGXXXXXXXXXXXXXXXXXXXGXXXXXXXXXXXXXXXXXXXGXXXXXXXXXXXXXXXXXXXGXXXXXXXXXXXXXXXXXXX,0,300,0

25830,13,0,13,64,223,0,0,236,145,91,GXXXXXXXXXXXXXXXXXXXGXXXXXXXXXXXXXXXXXXXGXXXXXXXXXXXXXXXXXXXGXXXXXXXXXXXXXXXXXXXGXXXXXXXXXXXXXXXXXXXGXXXXXXXXXXXXXXXXXXXGXXXXXXXXXXXXXXXXXXXGXXXXXXXXXXXXXXXXXXXGXXXXXXXXXXXXXXXXXXXGXXXXXXXXXXXXXXXXXXXGXXXXXXXXXXXXXXXXXXXGXXXXXXXXXXXXXXXXXXXGXXXXXXXXXXXXXXXXXXX,0,300,0
25851,13,0,13,60,227,0,0,239,144,95,GXXXXXXXXXXXXXXXXXXXGXXXXXXXXXXXXXXXXXXXGXXXXXXXXXXXXXXXXXXXGXXXXXXXXXXXXXXXXXXXGXXXXXXXXXXXXXXXXXXXGXXXXXXXXXXXXXXXXXXXGXXXXXXXXXXXXXXXXXXXGXXXXXXXXXXXXXXXXXXXGXXXXXXXXXXXXXXXXXXXGXXXXXXXXXXXXXXXXXXXGXXXXXXXXXXXXXXXXXXXGXXXXXXXXXXXXXXXXXXXGXXXXXXXXXXXXXXXXXXX,0,300,0
25872,13,0,13,59,228,0,0,240,145,95,GXXXXXXXXXXXXXXXXXXXGXXXXXXXXXXXXXXXXXXXGXXXXXXXXXXXXXXXXXXXGXXXXXXXXXXXXXXXXXXXGXXXXXXXXXXXXXXXXXXXGXXXXXXXXXXXXXXXXXXXGXXXXXXXXXXXXXXXXXXXGXXXXXXXXXXXXXXXXXXXGXXXXXXXXXXXXXXXXXXXGXXXXXXXXXXXXXXXXXXXGXXXXXXXXXXXXXXXXXXXGXXXXXXXXXXXXXXXXXXXGXXXXXXXXXXXXXXXXXXX,0,300,0
25893,13,0,13,53,234,0,0,247,149,98,GXXXXXXXXXXXXXXXXXXXGXXXXXXXXXXXXXXXXXXXGXXXXXXXXXXXXXXXXXXXGXXXXXXXXXXXXXXXXXXXGXXXXXXXXXXXXXXXXXXXGXXXXXXXXXXXXXXXXXXXGXXXXXXXXXXXXXXXXXXXGXXXXXXXXXXXXXXXXXXXGXXXXXXXXXXXXXXXXXXXGXXXXXXXXXXXXXXXXXXXGXXXXXXXXXXXXXXXXXXXGXXXXXXXXXXXXXXXXXXXGXXXXXXXXXXXXXXXXXXX,0,300,0
25914,13,0,13,52,235,0,0,247,151,96,GXXXXXXXXXXXXXXXXXXXGXXXXXXXXXXXXXXXXXXXGXXXXXXXXXXXXXXXXXXXGXXXXXXXXXXXXXXXXXXXGXXXXXXXXXXXXXXXXXXXGXXXXXXXXXXXXXXXXXXXGXXXXXXXXXXXXXXXXXXXGXXXXXXXXXXXXXXXXXXXGXXXXXXXXXXXXXXXXXXXGXXXXXXXXXXXXXXXXXXXGXXXXXXXXXXXXXXXXXXXGXXXXXXXXXXXXXXXXXXXGXXXXXXXXXXXXXXXXXXX,0,300,0

25935,13,0,13,55,232,0,0,245,149,96,GXXXXXXXXXXXXXXXXXXXGXXXXXXXXXXXXXXXXXXXGXXXXXXXXXXXXXXXXXXXGXXXXXXXXXXXXXXXXXXXGXXXXXXXXXXXXXXXXXXXGXXXXXXXXXXXXXXXXXXXGXXXXXXXXXXXXXXXXXXXGXXXXXXXXXXXXXXXXXXXGXXXXXXXXXXXXXXXXXXXGXXXXXXXXXXXXXXXXXXXGXXXXXXXXXXXXXXXXXXXGXXXXXXXXXXXXXXXXXXXGXXXXXXXXXXXXXXXXXXX,0,300,0
25956,13,0,13,55,232,0,0,244,151,93,GXXXXXXXXXXXXXXXXXXXGXXXXXXXXXXXXXXXXXXXGXXXXXXXXXXXXXXXXXXXGXXXXXXXXXXXXXXXXXXXGXXXXXXXXXXXXXXXXXXXGXXXXXXXXXXXXXXXXXXXGXXXXXXXXXXXXXXXXXXXGXXXXXXXXXXXXXXXXXXXGXXXXXXXXXXXXXXXXXXXGXXXXXXXXXXXXXXXXXXXGXXXXXXXXXXXXXXXXXXXGXXXXXXXXXXXXXXXXXXXGXXXXXXXXXXXXXXXXXXX,0,300,0
25977,13,0,13,50,237,0,0,249,155,94,GXXXXXXXXXXXXXXXXXXXGXXXXXXXXXXXXXXXXXXXGXXXXXXXXXXXXXXXXXXXGXXXXXXXXXXXXXXXXXXXGXXXXXXXXXXXXXXXXXXXGXXXXXXXXXXXXXXXXXXXGXXXXXXXXXXXXXXXXXXXGXXXXXXXXXXXXXXXXXXXGXXXXXXXXXXXXXXXXXXXGXXXXXXXXXXXXXXXXXXXGXXXXXXXXXXXXXXXXXXXGXXXXXXXXXXXXXXXXXXXGXXXXXXXXXXXXXXXXXXX,0,300,0
25998,13,0,13,53,234,0,0,246,148,98,GXXXXXXXXXXXXXXXXXXXGXXXXXXXXXXXXXXXXXXXGXXXXXXXXXXXXXXXXXXXGXXXXXXXXXXXXXXXXXXXGXXXXXXXXXXXXXXXXXXXGXXXXXXXXXXXXXXXXXXXGXXXXXXXXXXXXXXXXXXXGXXXXXXXXXXXXXXXXXXXGXXXXXXXXXXXXXXXXXXXGXXXXXXXXXXXXXXXXXXXGXXXXXXXXXXXXXXXXXXXGXXXXXXXXXXXXXXXXXXXGXXXXXXXXXXXXXXXXXXX,0,300,0
26019,13,0,13,52,235,0,0,247,149,98,GXXXXXXXXXXXXXXXXXXXGXXXXXXXXXXXXXXXXXXXGXXXXXXXXXXXXXXXXXXXGXXXXXXXXXXXXXXXXXXXGXXXXXXXXXXXXXXXXXXXGXXXXXXXXXXXXXXXXXXXGXXXXXXXXXXXXXXXXXXXGXXXXXXXXXXXXXXXXXXXGXXXXXXXXXXXXXXXXXXXGXXXXXXXXXXXXXXXXXXXGXXXXXXXXXXXXXXXXXXXGXXXXXXXXXXXXXXXXXXXGXXXXXXXXXXXXXXXXXXX,0,300,0

26040,13,0,13,53,234,0,0,247,150,97,GXXXXXXXXXXXXXXXXXXXGXXXXXXXXXXXXXXXXXXXGXXXXXXXXXXXXXXXXXXXGXXXXXXXXXXXXXXXXXXXGXXXXXXXXXXXXXXXXXXXGXXXXXXXXXXXXXXXXXXXGXXXXXXXXXXXXXXXXXXXGXXXXXXXXXXXXXXXXXXXGXXXXXXXXXXXXXXXXXXXGXXXXXXXXXXXXXXXXXXXGXXXXXXXXXXXXXXXXXXXGXXXXXXXXXXXXXXXXXXXGXXXXXXXXXXXXXXXXXXX,0,300,0
26061,13,0,13,54,233,0,0,246,151,95,GXXXXXXXXXXXXXXXXXXXGXXXXXXXXXXXXXXXXXXXGXXXXXXXXXXXXXXXXXXXGXXXXXXXXXXXXXXXXXXXGXXXXXXXXXXXXXXXXXXXGXXXXXXXXXXXXXXXXXXXGXXXXXXXXXXXXXXXXXXXGXXXXXXXXXXXXXXXXXXXGXXXXXXXXXXXXXXXXXXXGXXXXXXXXXXXXXXXXXXXGXXXXXXXXXXXXXXXXXXXGXXXXXXXXXXXXXXXXXXXGXXXXXXXXXXXXXXXXXXX,0,300,0
26082,14,1,13,52,234,0,0,247,150,97,GXXXXXXXXXXXXXXXXXXXGXXXXXXXXXXXXXXXXXXXGXXXXXXXXXXXXXXXXXXXGXXXXXXXXXXXXXXXXXXXGXXXXXXXXXXXXXXXXXXXGXXXXXXXXXXXXXXXXXXXGAXXXXXXXXXXXXXXXXXXGXXXXXXXXXXXXXXXXXXXGXXXXXXXXXXXXXXXXXXXGXXXXXXXXXXXXXXXXXXXGXXXXXXXXXXXXXXXXXXXGXXXXXXXXXXXXXXXXXXXGXXXXXXXXXXXXXXXXXXX,0,300,0
26103,14,1,13,51,235,0,0,248,152,96,GXXXXXXXXXXXXXXXXXXXGXXXXXXXXXXXXXXXXXXXGXXXXXXXXXXXXXXXXXXXGXXXXXXXXXXXXXXXXXXXGXXXXXXXXXXXXXXXXXXXGXXXXXXXXXXXXXXXXXXXGAXXXXXXXXXXXXXXXXXXGXXXXXXXXXXXXXXXXXXXGXXXXXXXXXXXXXXXXXXXGXXXXXXXXXXXXXXXXXXXGXXXXXXXXXXXXXXXXXXXGXXXXXXXXXXXXXXXXXXXGXXXXXXXXXXXXXXXXXXX,0,300,0
26124,14,1,13,51,235,0,0,248,154,94,GXXXXXXXXXXXXXXXXXXXGXXXXXXXXXXXXXXXXXXXGXXXXXXXXXXXXXXXXXXXGXXXXXXXXXXXXXXXXXXXGXXXXXXXXXXXXXXXXXXXGXXXXXXXXXXXXXXXXXXXGAXXXXXXXXXXXXXXXXXXGXXXXXXXXXXXXXXXXXXXGXXXXXXXXXXXXXXXXXXXGXXXXXXXXXXXXXXXXXXXGXXXXXXXXXXXXXXXXXXXGXXXXXXXXXXXXXXXXXXXGXXXXXXXXXXXXXXXXXXX,0,300,0

26145,14,1,13,51,235,0,0,248,155,93,GXXXXXXXXXXXXXXXXXXXGXXXXXXXXXXXXXXXXXXXGXXXXXXXXXXXXXXXXXXXGXXXXXXXXXXXXXXXXXXXGXXXXXXXXXXXXXXXXXXXGXXXXXXXXXXXXXXXXXXXGAXXXXXXXXXXXXXXXXXXGXXXXXXXXXXXXXXXXXXXGXXXXXXXXXXXXXXXXXXXGXXXXXXXXXXXXXXXXXXXGXXXXXXXXXXXXXXXXXXXGXXXXXXXXXXXXXXXXXXXGXXXXXXXXXXXXXXXXXXX,0,300,0
26166,14,1,13,51,235,0,0,248,157,91,GXXXXXXXXXXXXXXXXXXXGXXXXXXXXXXXXXXXXXXXGXXXXXXXXXXXXXXXXXXXGXXXXXXXXXXXXXXXXXXXGXXXXXXXXXXXXXXXXXXXGXXXXXXXXXXXXXXXXXXXGAXXXXXXXXXXXXXXXXXXGXXXXXXXXXXXXXXXXXXXGXXXXXXXXXXXXXXXXXXXGXXXXXXXXXXXXXXXXXXXGXXXXXXXXXXXXXXXXXXXGXXXXXXXXXXXXXXXXXXXGXXXXXXXXXXXXXXXXXXX,0,300,0
26187,14,1,13,55,231,0,0,244,156,88,GXXXXXXXXXXXXXXXXXXXGXXXXXXXXXXXXXXXXXXXGXXXXXXXXXXXXXXXXXXXGXXXXXXXXXXXXXXXXXXXGXXXXXXXXXXXXXXXXXXXGXXXXXXXXXXXXXXXXXXXGAXXXXXXXXXXXXXXXXXXGXXXXXXXXXXXXXXXXXXXGXXXXXXXXXXXXXXXXXXXGXXXXXXXXXXXXXXXXXXXGXXXXXXXXXXXXXXXXXXXGXXXXXXXXXXXXXXXXXXXGXXXXXXXXXXXXXXXXXXX,0,300,0
26208,14,1,13,53,233,0,0,246,155,91,GXXXXXXXXXXXXXXXXXXXGXXXXXXXXXXXXXXXXXXXGXXXXXXXXXXXXXXXXXXXGXXXXXXXXXXXXXXXXXXXGXXXXXXXXXXXXXXXXXXXGXXXXXXXXXXXXXXXXXXXGAXXXXXXXXXXXXXXXXXXGXXXXXXXXXXXXXXXXXXXGXXXXXXXXXXXXXXXXXXXGXXXXXXXXXXXXXXXXXXXGXXXXXXXXXXXXXXXXXXXGXXXXXXXXXXXXXXXXXXXGXXXXXXXXXXXXXXXXXXX,0,300,0
26229,14,1,13,60,226,0,0,239,157,82,GXXXXXXXXXXXXXXXXXXXGXXXXXXXXXXXXXXXXXXXGXXXXXXXXXXXXXXXXXXXGXXXXXXXXXXXXXXXXXXXGXXXXXXXXXXXXXXXXXXXGXXXXXXXXXXXXXXXXXXXGAXXXXXXXXXXXXXXXXXXGXXXXXXXXXXXXXXXXXXXGXXXXXXXXXXXXXXXXXXXGXXXXXXXXXXXXXXXXXXXGXXXXXXXXXXXXXXXXXXXGXXXXXXXXXXXXXXXXXXXGXXXXXXXXXXXXXXXXXXX,0,300,0

26250,14,1,13,56,230,0,0,244,161,83,GXXXXXXXXXXXXXXXXXXXGXXXXXXXXXXXXXXXXXXXGXXXXXXXXXXXXXXXXXXXGXXXXXXXXXXXXXXXXXXXGXXXXXXXXXXXXXXXXXXXGXXXXXXXXXXXXXXXXXXXGAXXXXXXXXXXXXXXXXXXGXXXXXXXXXXXXXXXXXXXGXXXXXXXXXXXXXXXXXXXGXXXXXXXXXXXXXXXXXXXGXXXXXXXXXXXXXXXXXXXGXXXXXXXXXXXXXXXXXXXGXXXXXXXXXXXXXXXXXXX,0,300,0
26271,14,1,13,57,229,0,0,243,156,87,GXXXXXXXXXXXXXXXXXXXGXXXXXXXXXXXXXXXXXXXGXXXXXXXXXXXXXXXXXXXGXXXXXXXXXXXXXXXXXXXGXXXXXXXXXXXXXXXXXXXGXXXXXXXXXXXXXXXXXXXGAXXXXXXXXXXXXXXXXXXGXXXXXXXXXXXXXXXXXXXGXXXXXXXXXXXXXXXXXXXGXXXXXXXXXXXXXXXXXXXGXXXXXXXXXXXXXXXXXXXGXXXXXXXXXXXXXXXXXXXGXXXXXXXXXXXXXXXXXXX,0,300,0
26292,14,1,13,61,225,0,0,238,155,83,GXXXXXXXXXXXXXXXXXXXGXXXXXXXXXXXXXXXXXXXGXXXXXXXXXXXXXXXXXXXGXXXXXXXXXXXXXXXXXXXGXXXXXXXXXXXXXXXXXXXGXXXXXXXXXXXXXXXXXXXGAXXXXXXXXXXXXXXXXXXGXXXXXXXXXXXXXXXXXXXGXXXXXXXXXXXXXXXXXXXGXXXXXXXXXXXXXXXXXXXGXXXXXXXXXXXXXXXXXXXGXXXXXXXXXXXXXXXXXXXGXXXXXXXXXXXXXXXXXXX,0,300,0
26313,14,1,13,56,230,0,0,244,155,89,GXXXXXXXXXXXXXXXXXXXGXXXXXXXXXXXXXXXXXXXGXXXXXXXXXXXXXXXXXXXGXXXXXXXXXXXXXXXXXXXGXXXXXXXXXXXXXXXXXXXGXXXXXXXXXXXXXXXXXXXGAXXXXXXXXXXXXXXXXXXGXXXXXXXXXXXXXXXXXXXGXXXXXXXXXXXXXXXXXXXGXXXXXXXXXXXXXXXXXXXGXXXXXXXXXXXXXXXXXXXGXXXXXXXXXXXXXXXXXXXGXXXXXXXXXXXXXXXXXXX,0,300,0
26334,14,0,14,52,234,0,0,248,154,94,GXXXXXXXXXXXXXXXXXXXGXXXXXXXXXXXXXXXXXXXGXXXXXXXXXXXXXXXXXXXGXXXXXXXXXXXXXXXXXXXGXXXXXXXXXXXXXXXXXXXGXXXXXXXXXXXXXXXXXXXGOXXXXXXXXXXXXXXXXXXGXXXXXXXXXXXXXXXXXXXGXXXXXXXXXXXXXXXXXXXGXXXXXXXXXXXXXXXXXXXGXXXXXXXXXXXXXXXXXXXGXXXXXXXXXXXXXXXXXXXGXXXXXXXXXXXXXXXXXXX,0,300,0

26355,13,0,13,56,231,0,0,242,149,93,GXXXXXXXXXXXXXXXXXXXGXXXXXXXXXXXXXXXXXXXGXXXXXXXXXXXXXXXXXXXGXXXXXXXXXXXXXXXXXXXGXXXXXXXXXXXXXXXXXXXGXXXXXXXXXXXXXXXXXXXGXXXXXXXXXXXXXXXXXXXGXXXXXXXXXXXXXXXXXXXGXXXXXXXXXXXXXXXXXXXGXXXXXXXXXXXXXXXXXXXGXXXXXXXXXXXXXXXXXXXGXXXXXXXXXXXXXXXXXXXGXXXXXXXXXXXXXXXXXXX,0,300,0
26376,13,0,13,43,244,0,0,255,156,99,GXXXXXXXXXXXXXXXXXXXGXXXXXXXXXXXXXXXXXXXGXXXXXXXXXXXXXXXXXXXGXXXXXXXXXXXXXXXXXXXGXXXXXXXXXXXXXXXXXXXGXXXXXXXXXXXXXXXXXXXGXXXXXXXXXXXXXXXXXXXGXXXXXXXXXXXXXXXXXXXGXXXXXXXXXXXXXXXXXXXGXXXXXXXXXXXXXXXXXXXGXXXXXXXXXXXXXXXXXXXGXXXXXXXXXXXXXXXXXXXGXXXXXXXXXXXXXXXXXXX,0,300,0
26397,13,0,13,45,242,0,0,254,156,98,GXXXXXXXXXXXXXXXXXXXGXXXXXXXXXXXXXXXXXXXGXXXXXXXXXXXXXXXXXXXGXXXXXXXXXXXXXXXXXXXGXXXXXXXXXXXXXXXXXXXGXXXXXXXXXXXXXXXXXXXGXXXXXXXXXXXXXXXXXXXGXXXXXXXXXXXXXXXXXXXGXXXXXXXXXXXXXXXXXXXGXXXXXXXXXXXXXXXXXXXGXXXXXXXXXXXXXXXXXXXGXXXXXXXXXXXXXXXXXXXGXXXXXXXXXXXXXXXXXXX,0,300,0
26418,13,0,13,44,243,0,0,255,153,102,GXXXXXXXXXXXXXXXXXXXGXXXXXXXXXXXXXXXXXXXGXXXXXXXXXXXXXXXXXXXGXXXXXXXXXXXXXXXXXXXGXXXXXXXXXXXXXXXXXXXGXXXXXXXXXXXXXXXXXXXGXXXXXXXXXXXXXXXXXXXGXXXXXXXXXXXXXXXXXXXGXXXXXXXXXXXXXXXXXXXGXXXXXXXXXXXXXXXXXXXGXXXXXXXXXXXXXXXXXXXGXXXXXXXXXXXXXXXXXXXGXXXXXXXXXXXXXXXXXXX,0,300,0
26439,13,0,13,51,236,0,0,247,151,96,GXXXXXXXXXXXXXXXXXXXGXXXXXXXXXXXXXXXXXXXGXXXXXXXXXXXXXXXXXXXGXXXXXXXXXXXXXXXXXXXGXXXXXXXXXXXXXXXXXXXGXXXXXXXXXXXXXXXXXXXGXXXXXXXXXXXXXXXXXXXGXXXXXXXXXXXXXXXXXXXGXXXXXXXXXXXXXXXXXXXGXXXXXXXXXXXXXXXXXXXGXXXXXXXXXXXXXXXXXXXGXXXXXXXXXXXXXXXXXXXGXXXXXXXXXXXXXXXXXXX,0,300,0

26460,13,0,13,50,237,0,0,248,149,99,GXXXXXXXXXXXXXXXXXXXGXXXXXXXXXXXXXXXXXXXGXXXXXXXXXXXXXXXXXXXGXXXXXXXXXXXXXXXXXXXGXXXXXXXXXXXXXXXXXXXGXXXXXXXXXXXXXXXXXXXGXXXXXXXXXXXXXXXXXXXGXXXXXXXXXXXXXXXXXXXGXXXXXXXXXXXXXXXXXXXGXXXXXXXXXXXXXXXXXXXGXXXXXXXXXXXXXXXXXXXGXXXXXXXXXXXXXXXXXXXGXXXXXXXXXXXXXXXXXXX,0,300,0
26481,13,0,13,47,240,0,0,251,151,100,GXXXXXXXXXXXXXXXXXXXGXXXXXXXXXXXXXXXXXXXGXXXXXXXXXXXXXXXXXXXGXXXXXXXXXXXXXXXXXXXGXXXXXXXXXXXXXXXXXXXGXXXXXXXXXXXXXXXXXXXGXXXXXXXXXXXXXXXXXXXGXXXXXXXXXXXXXXXXXXXGXXXXXXXXXXXXXXXXXXXGXXXXXXXXXXXXXXXXXXXGXXXXXXXXXXXXXXXXXXXGXXXXXXXXXXXXXXXXXXXGXXXXXXXXXXXXXXXXXXX,0,300,0
26502,13,0,13,43,244,0,0,256,151,105,GXXXXXXXXXXXXXXXXXXXGXXXXXXXXXXXXXXXXXXXGXXXXXXXXXXXXXXXXXXXGXXXXXXXXXXXXXXXXXXXGXXXXXXXXXXXXXXXXXXXGXXXXXXXXXXXXXXXXXXXGXXXXXXXXXXXXXXXXXXXGXXXXXXXXXXXXXXXXXXXGXXXXXXXXXXXXXXXXXXXGXXXXXXXXXXXXXXXXXXXGXXXXXXXXXXXXXXXXXXXGXXXXXXXXXXXXXXXXXXXGXXXXXXXXXXXXXXXXXXX,0,300,0
26523,13,0,13,43,244,0,0,256,155,101,GXXXXXXXXXXXXXXXXXXXGXXXXXXXXXXXXXXXXXXXGXXXXXXXXXXXXXXXXXXXGXXXXXXXXXXXXXXXXXXXGXXXXXXXXXXXXXXXXXXXGXXXXXXXXXXXXXXXXXXXGXXXXXXXXXXXXXXXXXXXGXXXXXXXXXXXXXXXXXXXGXXXXXXXXXXXXXXXXXXXGXXXXXXXXXXXXXXXXXXXGXXXXXXXXXXXXXXXXXXXGXXXXXXXXXXXXXXXXXXXGXXXXXXXXXXXXXXXXXXX,0,300,0
26544,13,0,13,47,240,0,0,252,155,97,GXXXXXXXXXXXXXXXXXXXGXXXXXXXXXXXXXXXXXXXGXXXXXXXXXXXXXXXXXXXGXXXXXXXXXXXXXXXXXXXGXXXXXXXXXXXXXXXXXXXGXXXXXXXXXXXXXXXXXXXGXXXXXXXXXXXXXXXXXXXGXXXXXXXXXXXXXXXXXXXGXXXXXXXXXXXXXXXXXXXGXXXXXXXXXXXXXXXXXXXGXXXXXXXXXXXXXXXXXXXGXXXXXXXXXXXXXXXXXXXGXXXXXXXXXXXXXXXXXXX,0,300,0

26565,13,0,13,47,240,0,0,254,153,101,GXXXXXXXXXXXXXXXXXXXGXXXXXXXXXXXXXXXXXXXGXXXXXXXXXXXXXXXXXXXGXXXXXXXXXXXXXXXXXXXGXXXXXXXXXXXXXXXXXXXGXXXXXXXXXXXXXXXXXXXGXXXXXXXXXXXXXXXXXXXGXXXXXXXXXXXXXXXXXXXGXXXXXXXXXXXXXXXXXXXGXXXXXXXXXXXXXXXXXXXGXXXXXXXXXXXXXXXXXXXGXXXXXXXXXXXXXXXXXXXGXXXXXXXXXXXXXXXXXXX,0,300,0
26586,13,0,13,51,236,0,0,250,158,92,GXXXXXXXXXXXXXXXXXXXGXXXXXXXXXXXXXXXXXXXGXXXXXXXXXXXXXXXXXXXGXXXXXXXXXXXXXXXXXXXGXXXXXXXXXXXXXXXXXXXGXXXXXXXXXXXXXXXXXXXGXXXXXXXXXXXXXXXXXXXGXXXXXXXXXXXXXXXXXXXGXXXXXXXXXXXXXXXXXXXGXXXXXXXXXXXXXXXXXXXGXXXXXXXXXXXXXXXXXXXGXXXXXXXXXXXXXXXXXXXGXXXXXXXXXXXXXXXXXXX,0,300,0
26607,13,0,13,50,237,0,0,251,159,92,GXXXXXXXXXXXXXXXXXXXGXXXXXXXXXXXXXXXXXXXGXXXXXXXXXXXXXXXXXXXGXXXXXXXXXXXXXXXXXXXGXXXXXXXXXXXXXXXXXXXGXXXXXXXXXXXXXXXXXXXGXXXXXXXXXXXXXXXXXXXGXXXXXXXXXXXXXXXXXXXGXXXXXXXXXXXXXXXXXXXGXXXXXXXXXXXXXXXXXXXGXXXXXXXXXXXXXXXXXXXGXXXXXXXXXXXXXXXXXXXGXXXXXXXXXXXXXXXXXXX,0,300,0
26628,13,0,13,58,229,0,0,243,157,86,GXXXXXXXXXXXXXXXXXXXGXXXXXXXXXXXXXXXXXXXGXXXXXXXXXXXXXXXXXXXGXXXXXXXXXXXXXXXXXXXGXXXXXXXXXXXXXXXXXXXGXXXXXXXXXXXXXXXXXXXGXXXXXXXXXXXXXXXXXXXGXXXXXXXXXXXXXXXXXXXGXXXXXXXXXXXXXXXXXXXGXXXXXXXXXXXXXXXXXXXGXXXXXXXXXXXXXXXXXXXGXXXXXXXXXXXXXXXXXXXGXXXXXXXXXXXXXXXXXXX,0,300,0
26649,13,0,13,59,228,0,0,243,159,84,GXXXXXXXXXXXXXXXXXXXGXXXXXXXXXXXXXXXXXXXGXXXXXXXXXXXXXXXXXXXGXXXXXXXXXXXXXXXXXXXGXXXXXXXXXXXXXXXXXXXGXXXXXXXXXXXXXXXXXXXGXXXXXXXXXXXXXXXXXXXGXXXXXXXXXXXXXXXXXXXGXXXXXXXXXXXXXXXXXXXGXXXXXXXXXXXXXXXXXXXGXXXXXXXXXXXXXXXXXXXGXXXXXXXXXXXXXXXXXXXGXXXXXXXXXXXXXXXXXXX,0,300,0

26670,13,0,13,64,223,0,0,238,153,85,GXXXXXXXXXXXXXXXXXXXGXXXXXXXXXXXXXXXXXXXGXXXXXXXXXXXXXXXXXXXGXXXXXXXXXXXXXXXXXXXGXXXXXXXXXXXXXXXXXXXGXXXXXXXXXXXXXXXXXXXGXXXXXXXXXXXXXXXXXXXGXXXXXXXXXXXXXXXXXXXGXXXXXXXXXXXXXXXXXXXGXXXXXXXXXXXXXXXXXXXGXXXXXXXXXXXXXXXXXXXGXXXXXXXXXXXXXXXXXXXGXXXXXXXXXXXXXXXXXXX,0,300,0
26691,13,0,13,58,229,0,0,243,154,89,GXXXXXXXXXXXXXXXXXXXGXXXXXXXXXXXXXXXXXXXGXXXXXXXXXXXXXXXXXXXGXXXXXXXXXXXXXXXXXXXGXXXXXXXXXXXXXXXXXXXGXXXXXXXXXXXXXXXXXXXGXXXXXXXXXXXXXXXXXXXGXXXXXXXXXXXXXXXXXXXGXXXXXXXXXXXXXXXXXXXGXXXXXXXXXXXXXXXXXXXGXXXXXXXXXXXXXXXXXXXGXXXXXXXXXXXXXXXXXXXGXXXXXXXXXXXXXXXXXXX,0,300,0
26712,13,0,13,57,230,0,0,245,153,92,GXXXXXXXXXXXXXXXXXXXGXXXXXXXXXXXXXXXXXXXGXXXXXXXXXXXXXXXXXXXGXXXXXXXXXXXXXXXXXXXGXXXXXXXXXXXXXXXXXXXGXXXXXXXXXXXXXXXXXXXGXXXXXXXXXXXXXXXXXXXGXXXXXXXXXXXXXXXXXXXGXXXXXXXXXXXXXXXXXXXGXXXXXXXXXXXXXXXXXXXGXXXXXXXXXXXXXXXXXXXGXXXXXXXXXXXXXXXXXXXGXXXXXXXXXXXXXXXXXXX,0,300,0
26733,13,0,13,56,231,0,0,247,154,93,GXXXXXXXXXXXXXXXXXXXGXXXXXXXXXXXXXXXXXXXGXXXXXXXXXXXXXXXXXXXGXXXXXXXXXXXXXXXXXXXGXXXXXXXXXXXXXXXXXXXGXXXXXXXXXXXXXXXXXXXGXXXXXXXXXXXXXXXXXXXGXXXXXXXXXXXXXXXXXXXGXXXXXXXXXXXXXXXXXXXGXXXXXXXXXXXXXXXXXXXGXXXXXXXXXXXXXXXXXXXGXXXXXXXXXXXXXXXXXXXGXXXXXXXXXXXXXXXXXXX,0,300,0
26754,13,0,13,62,225,0,0,241,151,90,GXXXXXXXXXXXXXXXXXXXGXXXXXXXXXXXXXXXXXXXGXXXXXXXXXXXXXXXXXXXGXXXXXXXXXXXXXXXXXXXGXXXXXXXXXXXXXXXXXXXGXXXXXXXXXXXXXXXXXXXGXXXXXXXXXXXXXXXXXXXGXXXXXXXXXXXXXXXXXXXGXXXXXXXXXXXXXXXXXXXGXXXXXXXXXXXXXXXXXXXGXXXXXXXXXXXXXXXXXXXGXXXXXXXXXXXXXXXXXXXGXXXXXXXXXXXXXXXXXXX,0,300,0

26775,13,0,13,62,225,0,0,242,155,87,GXXXXXXXXXXXXXXXXXXXGXXXXXXXXXXXXXXXXXXXGXXXXXXXXXXXXXXXXXXXGXXXXXXXXXXXXXXXXXXXGXXXXXXXXXXXXXXXXXXXGXXXXXXXXXXXXXXXXXXXGXXXXXXXXXXXXXXXXXXXGXXXXXXXXXXXXXXXXXXXGXXXXXXXXXXXXXXXXXXXGXXXXXXXXXXXXXXXXXXXGXXXXXXXXXXXXXXXXXXXGXXXXXXXXXXXXXXXXXXXGXXXXXXXXXXXXXXXXXXX,0,300,0
26796,13,0,13,58,229,0,0,243,157,86,GXXXXXXXXXXXXXXXXXXXGXXXXXXXXXXXXXXXXXXXGXXXXXXXXXXXXXXXXXXXGXXXXXXXXXXXXXXXXXXXGXXXXXXXXXXXXXXXXXXXGXXXXXXXXXXXXXXXXXXXGXXXXXXXXXXXXXXXXXXXGXXXXXXXXXXXXXXXXXXXGXXXXXXXXXXXXXXXXXXXGXXXXXXXXXXXXXXXXXXXGXXXXXXXXXXXXXXXXXXXGXXXXXXXXXXXXXXXXXXXGXXXXXXXXXXXXXXXXXXX,0,300,0
26817,13,0,13,53,234,0,0,249,156,93,GXXXXXXXXXXXXXXXXXXXGXXXXXXXXXXXXXXXXXXXGXXXXXXXXXXXXXXXXXXXGXXXXXXXXXXXXXXXXXXXGXXXXXXXXXXXXXXXXXXXGXXXXXXXXXXXXXXXXXXXGXXXXXXXXXXXXXXXXXXXGXXXXXXXXXXXXXXXXXXXGXXXXXXXXXXXXXXXXXXXGXXXXXXXXXXXXXXXXXXXGXXXXXXXXXXXXXXXXXXXGXXXXXXXXXXXXXXXXXXXGXXXXXXXXXXXXXXXXXXX,0,300,0
26838,13,0,13,55,232,0,0,246,155,91,GXXXXXXXXXXXXXXXXXXXGXXXXXXXXXXXXXXXXXXXGXXXXXXXXXXXXXXXXXXXGXXXXXXXXXXXXXXXXXXXGXXXXXXXXXXXXXXXXXXXGXXXXXXXXXXXXXXXXXXXGXXXXXXXXXXXXXXXXXXXGXXXXXXXXXXXXXXXXXXXGXXXXXXXXXXXXXXXXXXXGXXXXXXXXXXXXXXXXXXXGXXXXXXXXXXXXXXXXXXXGXXXXXXXXXXXXXXXXXXXGXXXXXXXXXXXXXXXXXXX,0,300,0
26859,13,0,13,53,234,0,0,247,156,91,GXXXXXXXXXXXXXXXXXXXGXXXXXXXXXXXXXXXXXXXGXXXXXXXXXXXXXXXXXXXGXXXXXXXXXXXXXXXXXXXGXXXXXXXXXXXXXXXXXXXGXXXXXXXXXXXXXXXXXXXGXXXXXXXXXXXXXXXXXXXGXXXXXXXXXXXXXXXXXXXGXXXXXXXXXXXXXXXXXXXGXXXXXXXXXXXXXXXXXXXGXXXXXXXXXXXXXXXXXXXGXXXXXXXXXXXXXXXXXXXGXXXXXXXXXXXXXXXXXXX,0,300,0

26880,13,0,13,56,231,0,0,244,153,91,GXXXXXXXXXXXXXXXXXXXGXXXXXXXXXXXXXXXXXXXGXXXXXXXXXXXXXXXXXXXGXXXXXXXXXXXXXXXXXXXGXXXXXXXXXXXXXXXXXXXGXXXXXXXXXXXXXXXXXXXGXXXXXXXXXXXXXXXXXXXGXXXXXXXXXXXXXXXXXXXGXXXXXXXXXXXXXXXXXXXGXXXXXXXXXXXXXXXXXXXGXXXXXXXXXXXXXXXXXXXGXXXXXXXXXXXXXXXXXXXGXXXXXXXXXXXXXXXXXXX,0,300,0
26901,13,0,13,58,229,0,0,242,155,87,GXXXXXXXXXXXXXXXXXXXGXXXXXXXXXXXXXXXXXXXGXXXXXXXXXXXXXXXXXXXGXXXXXXXXXXXXXXXXXXXGXXXXXXXXXXXXXXXXXXXGXXXXXXXXXXXXXXXXXXXGXXXXXXXXXXXXXXXXXXXGXXXXXXXXXXXXXXXXXXXGXXXXXXXXXXXXXXXXXXXGXXXXXXXXXXXXXXXXXXXGXXXXXXXXXXXXXXXXXXXGXXXXXXXXXXXXXXXXXXXGXXXXXXXXXXXXXXXXXXX,0,300,0
26922,13,0,13,58,229,0,0,241,155,86,GXXXXXXXXXXXXXXXXXXXGXXXXXXXXXXXXXXXXXXXGXXXXXXXXXXXXXXXXXXXGXXXXXXXXXXXXXXXXXXXGXXXXXXXXXXXXXXXXXXXGXXXXXXXXXXXXXXXXXXXGXXXXXXXXXXXXXXXXXXXGXXXXXXXXXXXXXXXXXXXGXXXXXXXXXXXXXXXXXXXGXXXXXXXXXXXXXXXXXXXGXXXXXXXXXXXXXXXXXXXGXXXXXXXXXXXXXXXXXXXGXXXXXXXXXXXXXXXXXXX,0,300,0
26943,13,0,13,54,233,0,0,245,152,93,GXXXXXXXXXXXXXXXXXXXGXXXXXXXXXXXXXXXXXXXGXXXXXXXXXXXXXXXXXXXGXXXXXXXXXXXXXXXXXXXGXXXXXXXXXXXXXXXXXXXGXXXXXXXXXXXXXXXXXXXGXXXXXXXXXXXXXXXXXXXGXXXXXXXXXXXXXXXXXXXGXXXXXXXXXXXXXXXXXXXGXXXXXXXXXXXXXXXXXXXGXXXXXXXXXXXXXXXXXXXGXXXXXXXXXXXXXXXXXXXGXXXXXXXXXXXXXXXXXXX,0,300,0
26964,13,0,13,54,233,0,0,245,152,93,GXXXXXXXXXXXXXXXXXXXGXXXXXXXXXXXXXXXXXXXGXXXXXXXXXXXXXXXXXXXGXXXXXXXXXXXXXXXXXXXGXXXXXXXXXXXXXXXXXXXGXXXXXXXXXXXXXXXXXXXGXXXXXXXXXXXXXXXXXXXGXXXXXXXXXXXXXXXXXXXGXXXXXXXXXXXXXXXXXXXGXXXXXXXXXXXXXXXXXXXGXXXXXXXXXXXXXXXXXXXGXXXXXXXXXXXXXXXXXXXGXXXXXXXXXXXXXXXXXXX,0,300,0

26985,13,0,13,57,230,0,0,242,150,92,GXXXXXXXXXXXXXXXXXXXGXXXXXXXXXXXXXXXXXXXGXXXXXXXXXXXXXXXXXXXGXXXXXXXXXXXXXXXXXXXGXXXXXXXXXXXXXXXXXXXGXXXXXXXXXXXXXXXXXXXGXXXXXXXXXXXXXXXXXXXGXXXXXXXXXXXXXXXXXXXGXXXXXXXXXXXXXXXXXXXGXXXXXXXXXXXXXXXXXXXGXXXXXXXXXXXXXXXXXXXGXXXXXXXXXXXXXXXXXXXGXXXXXXXXXXXXXXXXXXX,0,300,0
27006,13,0,13,59,228,0,0,240,153,87,GXXXXXXXXXXXXXXXXXXXGXXXXXXXXXXXXXXXXXXXGXXXXXXXXXXXXXXXXXXXGXXXXXXXXXXXXXXXXXXXGXXXXXXXXXXXXXXXXXXXGXXXXXXXXXXXXXXXXXXXGXXXXXXXXXXXXXXXXXXXGXXXXXXXXXXXXXXXXXXXGXXXXXXXXXXXXXXXXXXXGXXXXXXXXXXXXXXXXXXXGXXXXXXXXXXXXXXXXXXXGXXXXXXXXXXXXXXXXXXXGXXXXXXXXXXXXXXXXXXX,0,300,0
27027,13,0,13,57,230,0,0,242,156,86,GXXXXXXXXXXXXXXXXXXXGXXXXXXXXXXXXXXXXXXXGXXXXXXXXXXXXXXXXXXXGXXXXXXXXXXXXXXXXXXXGXXXXXXXXXXXXXXXXXXXGXXXXXXXXXXXXXXXXXXXGXXXXXXXXXXXXXXXXXXXGXXXXXXXXXXXXXXXXXXXGXXXXXXXXXXXXXXXXXXXGXXXXXXXXXXXXXXXXXXXGXXXXXXXXXXXXXXXXXXXGXXXXXXXXXXXXXXXXXXXGXXXXXXXXXXXXXXXXXXX,0,300,0
27048,13,0,13,59,228,0,0,239,153,86,GXXXXXXXXXXXXXXXXXXXGXXXXXXXXXXXXXXXXXXXGXXXXXXXXXXXXXXXXXXXGXXXXXXXXXXXXXXXXXXXGXXXXXXXXXXXXXXXXXXXGXXXXXXXXXXXXXXXXXXXGXXXXXXXXXXXXXXXXXXXGXXXXXXXXXXXXXXXXXXXGXXXXXXXXXXXXXXXXXXXGXXXXXXXXXXXXXXXXXXXGXXXXXXXXXXXXXXXXXXXGXXXXXXXXXXXXXXXXXXXGXXXXXXXXXXXXXXXXXXX,0,300,0
27069,13,0,13,55,232,0,0,244,151,93,GXXXXXXXXXXXXXXXXXXXGXXXXXXXXXXXXXXXXXXXGXXXXXXXXXXXXXXXXXXXGXXXXXXXXXXXXXXXXXXXGXXXXXXXXXXXXXXXXXXXGXXXXXXXXXXXXXXXXXXXGXXXXXXXXXXXXXXXXXXXGXXXXXXXXXXXXXXXXXXXGXXXXXXXXXXXXXXXXXXXGXXXXXXXXXXXXXXXXXXXGXXXXXXXXXXXXXXXXXXXGXXXXXXXXXXXXXXXXXXXGXXXXXXXXXXXXXXXXXXX,0,300,0

27090,13,0,13,54,233,0,0,245,154,91,GXXXXXXXXXXXXXXXXXXXGXXXXXXXXXXXXXXXXXXXGXXXXXXXXXXXXXXXXXXXGXXXXXXXXXXXXXXXXXXXGXXXXXXXXXXXXXXXXXXXGXXXXXXXXXXXXXXXXXXXGXXXXXXXXXXXXXXXXXXXGXXXXXXXXXXXXXXXXXXXGXXXXXXXXXXXXXXXXXXXGXXXXXXXXXXXXXXXXXXXGXXXXXXXXXXXXXXXXXXXGXXXXXXXXXXXXXXXXXXXGXXXXXXXXXXXXXXXXXXX,0,300,0
27111,13,0,13,58,229,0,0,241,152,89,GXXXXXXXXXXXXXXXXXXXGXXXXXXXXXXXXXXXXXXXGXXXXXXXXXXXXXXXXXXXGXXXXXXXXXXXXXXXXXXXGXXXXXXXXXXXXXXXXXXXGXXXXXXXXXXXXXXXXXXXGXXXXXXXXXXXXXXXXXXXGXXXXXXXXXXXXXXXXXXXGXXXXXXXXXXXXXXXXXXXGXXXXXXXXXXXXXXXXXXXGXXXXXXXXXXXXXXXXXXXGXXXXXXXXXXXXXXXXXXXGXXXXXXXXXXXXXXXXXXX,0,300,0
27132,13,0,13,64,223,0,0,235,153,82,GXXXXXXXXXXXXXXXXXXXGXXXXXXXXXXXXXXXXXXXGXXXXXXXXXXXXXXXXXXXGXXXXXXXXXXXXXXXXXXXGXXXXXXXXXXXXXXXXXXXGXXXXXXXXXXXXXXXXXXXGXXXXXXXXXXXXXXXXXXXGXXXXXXXXXXXXXXXXXXXGXXXXXXXXXXXXXXXXXXXGXXXXXXXXXXXXXXXXXXXGXXXXXXXXXXXXXXXXXXXGXXXXXXXXXXXXXXXXXXXGXXXXXXXXXXXXXXXXXXX,0,300,0
27153,13,0,13,60,227,0,0,239,156,83,GXXXXXXXXXXXXXXXXXXXGXXXXXXXXXXXXXXXXXXXGXXXXXXXXXXXXXXXXXXXGXXXXXXXXXXXXXXXXXXXGXXXXXXXXXXXXXXXXXXXGXXXXXXXXXXXXXXXXXXXGXXXXXXXXXXXXXXXXXXXGXXXXXXXXXXXXXXXXXXXGXXXXXXXXXXXXXXXXXXXGXXXXXXXXXXXXXXXXXXXGXXXXXXXXXXXXXXXXXXXGXXXXXXXXXXXXXXXXXXXGXXXXXXXXXXXXXXXXXXX,0,300,0
27174,13,0,13,62,225,0,0,236,155,81,GXXXXXXXXXXXXXXXXXXXGXXXXXXXXXXXXXXXXXXXGXXXXXXXXXXXXXXXXXXXGXXXXXXXXXXXXXXXXXXXGXXXXXXXXXXXXXXXXXXXGXXXXXXXXXXXXXXXXXXXGXXXXXXXXXXXXXXXXXXXGXXXXXXXXXXXXXXXXXXXGXXXXXXXXXXXXXXXXXXXGXXXXXXXXXXXXXXXXXXXGXXXXXXXXXXXXXXXXXXXGXXXXXXXXXXXXXXXXXXXGXXXXXXXXXXXXXXXXXXX,0,300,0

27195,13,0,13,60,227,0,0,239,159,80,GXXXXXXXXXXXXXXXXXXXGXXXXXXXXXXXXXXXXXXXGXXXXXXXXXXXXXXXXXXXGXXXXXXXXXXXXXXXXXXXGXXXXXXXXXXXXXXXXXXXGXXXXXXXXXXXXXXXXXXXGXXXXXXXXXXXXXXXXXXXGXXXXXXXXXXXXXXXXXXXGXXXXXXXXXXXXXXXXXXXGXXXXXXXXXXXXXXXXXXXGXXXXXXXXXXXXXXXXXXXGXXXXXXXXXXXXXXXXXXXGXXXXXXXXXXXXXXXXXXX,0,300,0
27216,13,0,13,57,230,0,0,242,161,81,GXXXXXXXXXXXXXXXXXXXGXXXXXXXXXXXXXXXXXXXGXXXXXXXXXXXXXXXXXXXGXXXXXXXXXXXXXXXXXXXGXXXXXXXXXXXXXXXXXXXGXXXXXXXXXXXXXXXXXXXGXXXXXXXXXXXXXXXXXXXGXXXXXXXXXXXXXXXXXXXGXXXXXXXXXXXXXXXXXXXGXXXXXXXXXXXXXXXXXXXGXXXXXXXXXXXXXXXXXXXGXXXXXXXXXXXXXXXXXXXGXXXXXXXXXXXXXXXXXXX,0,300,0
27237,13,0,13,58,229,0,0,241,156,85,GXXXXXXXXXXXXXXXXXXXGXXXXXXXXXXXXXXXXXXXGXXXXXXXXXXXXXXXXXXXGXXXXXXXXXXXXXXXXXXXGXXXXXXXXXXXXXXXXXXXGXXXXXXXXXXXXXXXXXXXGXXXXXXXXXXXXXXXXXXXGXXXXXXXXXXXXXXXXXXXGXXXXXXXXXXXXXXXXXXXGXXXXXXXXXXXXXXXXXXXGXXXXXXXXXXXXXXXXXXXGXXXXXXXXXXXXXXXXXXXGXXXXXXXXXXXXXXXXXXX,0,300,0
27258,13,0,13,54,233,0,0,245,158,87,GXXXXXXXXXXXXXXXXXXXGXXXXXXXXXXXXXXXXXXXGXXXXXXXXXXXXXXXXXXXGXXXXXXXXXXXXXXXXXXXGXXXXXXXXXXXXXXXXXXXGXXXXXXXXXXXXXXXXXXXGXXXXXXXXXXXXXXXXXXXGXXXXXXXXXXXXXXXXXXXGXXXXXXXXXXXXXXXXXXXGXXXXXXXXXXXXXXXXXXXGXXXXXXXXXXXXXXXXXXXGXXXXXXXXXXXXXXXXXXXGXXXXXXXXXXXXXXXXXXX,0,300,0
27279,13,0,13,53,234,0,0,245,156,89,GXXXXXXXXXXXXXXXXXXXGXXXXXXXXXXXXXXXXXXXGXXXXXXXXXXXXXXXXXXXGXXXXXXXXXXXXXXXXXXXGXXXXXXXXXXXXXXXXXXXGXXXXXXXXXXXXXXXXXXXGXXXXXXXXXXXXXXXXXXXGXXXXXXXXXXXXXXXXXXXGXXXXXXXXXXXXXXXXXXXGXXXXXXXXXXXXXXXXXXXGXXXXXXXXXXXXXXXXXXXGXXXXXXXXXXXXXXXXXXXGXXXXXXXXXXXXXXXXXXX,0,300,0

27300,13,0,13,53,234,0,0,246,156,90,GXXXXXXXXXXXXXXXXXXXGXXXXXXXXXXXXXXXXXXXGXXXXXXXXXXXXXXXXXXXGXXXXXXXXXXXXXXXXXXXGXXXXXXXXXXXXXXXXXXXGXXXXXXXXXXXXXXXXXXXGXXXXXXXXXXXXXXXXXXXGXXXXXXXXXXXXXXXXXXXGXXXXXXXXXXXXXXXXXXXGXXXXXXXXXXXXXXXXXXXGXXXXXXXXXXXXXXXXXXXGXXXXXXXXXXXXXXXXXXXGXXXXXXXXXXXXXXXXXXX,0,300,0
27321,13,0,13,51,236,0,0,247,155,92,GXXXXXXXXXXXXXXXXXXXGXXXXXXXXXXXXXXXXXXXGXXXXXXXXXXXXXXXXXXXGXXXXXXXXXXXXXXXXXXXGXXXXXXXXXXXXXXXXXXXGXXXXXXXXXXXXXXXXXXXGXXXXXXXXXXXXXXXXXXXGXXXXXXXXXXXXXXXXXXXGXXXXXXXXXXXXXXXXXXXGXXXXXXXXXXXXXXXXXXXGXXXXXXXXXXXXXXXXXXXGXXXXXXXXXXXXXXXXXXXGXXXXXXXXXXXXXXXXXXX,0,300,0
27342,13,0,13,52,235,0,0,247,154,93,GXXXXXXXXXXXXXXXXXXXGXXXXXXXXXXXXXXXXXXXGXXXXXXXXXXXXXXXXXXXGXXXXXXXXXXXXXXXXXXXGXXXXXXXXXXXXXXXXXXXGXXXXXXXXXXXXXXXXXXXGXXXXXXXXXXXXXXXXXXXGXXXXXXXXXXXXXXXXXXXGXXXXXXXXXXXXXXXXXXXGXXXXXXXXXXXXXXXXXXXGXXXXXXXXXXXXXXXXXXXGXXXXXXXXXXXXXXXXXXXGXXXXXXXXXXXXXXXXXXX,0,300,0
27363,13,0,13,50,237,0,0,248,155,93,GXXXXXXXXXXXXXXXXXXXGXXXXXXXXXXXXXXXXXXXGXXXXXXXXXXXXXXXXXXXGXXXXXXXXXXXXXXXXXXXGXXXXXXXXXXXXXXXXXXXGXXXXXXXXXXXXXXXXXXXGXXXXXXXXXXXXXXXXXXXGXXXXXXXXXXXXXXXXXXXGXXXXXXXXXXXXXXXXXXXGXXXXXXXXXXXXXXXXXXXGXXXXXXXXXXXXXXXXXXXGXXXXXXXXXXXXXXXXXXXGXXXXXXXXXXXXXXXXXXX,0,300,0
27384,13,0,13,49,238,0,0,250,159,91,GXXXXXXXXXXXXXXXXXXXGXXXXXXXXXXXXXXXXXXXGXXXXXXXXXXXXXXXXXXXGXXXXXXXXXXXXXXXXXXXGXXXXXXXXXXXXXXXXXXXGXXXXXXXXXXXXXXXXXXXGXXXXXXXXXXXXXXXXXXXGXXXXXXXXXXXXXXXXXXXGXXXXXXXXXXXXXXXXXXXGXXXXXXXXXXXXXXXXXXXGXXXXXXXXXXXXXXXXXXXGXXXXXXXXXXXXXXXXXXXGXXXXXXXXXXXXXXXXXXX,0,300,0

27405,13,0,13,55,232,0,0,243,153,90,GXXXXXXXXXXXXXXXXXXXGXXXXXXXXXXXXXXXXXXXGXXXXXXXXXXXXXXXXXXXGXXXXXXXXXXXXXXXXXXXGXXXXXXXXXXXXXXXXXXXGXXXXXXXXXXXXXXXXXXXGXXXXXXXXXXXXXXXXXXXGXXXXXXXXXXXXXXXXXXXGXXXXXXXXXXXXXXXXXXXGXXXXXXXXXXXXXXXXXXXGXXXXXXXXXXXXXXXXXXXGXXXXXXXXXXXXXXXXXXXGXXXXXXXXXXXXXXXXXXX,0,300,0
27426,13,0,13,46,241,0,0,253,153,100,GXXXXXXXXXXXXXXXXXXXGXXXXXXXXXXXXXXXXXXXGXXXXXXXXXXXXXXXXXXXGXXXXXXXXXXXXXXXXXXXGXXXXXXXXXXXXXXXXXXXGXXXXXXXXXXXXXXXXXXXGXXXXXXXXXXXXXXXXXXXGXXXXXXXXXXXXXXXXXXXGXXXXXXXXXXXXXXXXXXXGXXXXXXXXXXXXXXXXXXXGXXXXXXXXXXXXXXXXXXXGXXXXXXXXXXXXXXXXXXXGXXXXXXXXXXXXXXXXXXX,0,300,0
27447,13,0,13,48,239,0,0,251,153,98,GXXXXXXXXXXXXXXXXXXXGXXXXXXXXXXXXXXXXXXXGXXXXXXXXXXXXXXXXXXXGXXXXXXXXXXXXXXXXXXXGXXXXXXXXXXXXXXXXXXXGXXXXXXXXXXXXXXXXXXXGXXXXXXXXXXXXXXXXXXXGXXXXXXXXXXXXXXXXXXXGXXXXXXXXXXXXXXXXXXXGXXXXXXXXXXXXXXXXXXXGXXXXXXXXXXXXXXXXXXXGXXXXXXXXXXXXXXXXXXXGXXXXXXXXXXXXXXXXXXX,0,300,0
27468,13,0,13,45,242,0,0,254,156,98,GXXXXXXXXXXXXXXXXXXXGXXXXXXXXXXXXXXXXXXXGXXXXXXXXXXXXXXXXXXXGXXXXXXXXXXXXXXXXXXXGXXXXXXXXXXXXXXXXXXXGXXXXXXXXXXXXXXXXXXXGXXXXXXXXXXXXXXXXXXXGXXXXXXXXXXXXXXXXXXXGXXXXXXXXXXXXXXXXXXXGXXXXXXXXXXXXXXXXXXXGXXXXXXXXXXXXXXXXXXXGXXXXXXXXXXXXXXXXXXXGXXXXXXXXXXXXXXXXXXX,0,300,0
27489,13,0,13,46,241,0,0,253,158,95,GXXXXXXXXXXXXXXXXXXXGXXXXXXXXXXXXXXXXXXXGXXXXXXXXXXXXXXXXXXXGXXXXXXXXXXXXXXXXXXXGXXXXXXXXXXXXXXXXXXXGXXXXXXXXXXXXXXXXXXXGXXXXXXXXXXXXXXXXXXXGXXXXXXXXXXXXXXXXXXXGXXXXXXXXXXXXXXXXXXXGXXXXXXXXXXXXXXXXXXXGXXXXXXXXXXXXXXXXXXXGXXXXXXXXXXXXXXXXXXXGXXXXXXXXXXXXXXXXXXX,0,300,0

27510,13,0,13,40,247,0,0,257,160,97,GXXXXXXXXXXXXXXXXXXXGXXXXXXXXXXXXXXXXXXXGXXXXXXXXXXXXXXXXXXXGXXXXXXXXXXXXXXXXXXXGXXXXXXXXXXXXXXXXXXXGXXXXXXXXXXXXXXXXXXXGXXXXXXXXXXXXXXXXXXXGXXXXXXXXXXXXXXXXXXXGXXXXXXXXXXXXXXXXXXXGXXXXXXXXXXXXXXXXXXXGXXXXXXXXXXXXXXXXXXXGXXXXXXXXXXXXXXXXXXXGXXXXXXXXXXXXXXXXXXX,0,300,0
27531,13,0,13,40,247,0,0,259,157,102,GXXXXXXXXXXXXXXXXXXXGXXXXXXXXXXXXXXXXXXXGXXXXXXXXXXXXXXXXXXXGXXXXXXXXXXXXXXXXXXXGXXXXXXXXXXXXXXXXXXXGXXXXXXXXXXXXXXXXXXXGXXXXXXXXXXXXXXXXXXXGXXXXXXXXXXXXXXXXXXXGXXXXXXXXXXXXXXXXXXXGXXXXXXXXXXXXXXXXXXXGXXXXXXXXXXXXXXXXXXXGXXXXXXXXXXXXXXXXXXXGXXXXXXXXXXXXXXXXXXX,0,300,0
27552,13,0,13,41,246,0,0,259,156,103,GXXXXXXXXXXXXXXXXXXXGXXXXXXXXXXXXXXXXXXXGXXXXXXXXXXXXXXXXXXXGXXXXXXXXXXXXXXXXXXXGXXXXXXXXXXXXXXXXXXXGXXXXXXXXXXXXXXXXXXXGXXXXXXXXXXXXXXXXXXXGXXXXXXXXXXXXXXXXXXXGXXXXXXXXXXXXXXXXXXXGXXXXXXXXXXXXXXXXXXXGXXXXXXXXXXXXXXXXXXXGXXXXXXXXXXXXXXXXXXXGXXXXXXXXXXXXXXXXXXX,0,300,0
27573,13,0,13,45,242,0,0,254,156,98,GXXXXXXXXXXXXXXXXXXXGXXXXXXXXXXXXXXXXXXXGXXXXXXXXXXXXXXXXXXXGXXXXXXXXXXXXXXXXXXXGXXXXXXXXXXXXXXXXXXXGXXXXXXXXXXXXXXXXXXXGXXXXXXXXXXXXXXXXXXXGXXXXXXXXXXXXXXXXXXXGXXXXXXXXXXXXXXXXXXXGXXXXXXXXXXXXXXXXXXXGXXXXXXXXXXXXXXXXXXXGXXXXXXXXXXXXXXXXXXXGXXXXXXXXXXXXXXXXXXX,0,300,0
27594,13,0,13,51,236,0,0,248,151,97,GXXXXXXXXXXXXXXXXXXXGXXXXXXXXXXXXXXXXXXXGXXXXXXXXXXXXXXXXXXXGXXXXXXXXXXXXXXXXXXXGXXXXXXXXXXXXXXXXXXXGXXXXXXXXXXXXXXXXXXXGXXXXXXXXXXXXXXXXXXXGXXXXXXXXXXXXXXXXXXXGXXXXXXXXXXXXXXXXXXXGXXXXXXXXXXXXXXXXXXXGXXXXXXXXXXXXXXXXXXXGXXXXXXXXXXXXXXXXXXXGXXXXXXXXXXXXXXXXXXX,0,300,0

27615,13,0,13,43,244,0,0,256,156,100,GXXXXXXXXXXXXXXXXXXXGXXXXXXXXXXXXXXXXXXXGXXXXXXXXXXXXXXXXXXXGXXXXXXXXXXXXXXXXXXXGXXXXXXXXXXXXXXXXXXXGXXXXXXXXXXXXXXXXXXXGXXXXXXXXXXXXXXXXXXXGXXXXXXXXXXXXXXXXXXXGXXXXXXXXXXXXXXXXXXXGXXXXXXXXXXXXXXXXXXXGXXXXXXXXXXXXXXXXXXXGXXXXXXXXXXXXXXXXXXXGXXXXXXXXXXXXXXXXXXX,0,300,0
27636,13,0,13,42,245,0,0,256,154,102,GXXXXXXXXXXXXXXXXXXXGXXXXXXXXXXXXXXXXXXXGXXXXXXXXXXXXXXXXXXXGXXXXXXXXXXXXXXXXXXXGXXXXXXXXXXXXXXXXXXXGXXXXXXXXXXXXXXXXXXXGXXXXXXXXXXXXXXXXXXXGXXXXXXXXXXXXXXXXXXXGXXXXXXXXXXXXXXXXXXXGXXXXXXXXXXXXXXXXXXXGXXXXXXXXXXXXXXXXXXXGXXXXXXXXXXXXXXXXXXXGXXXXXXXXXXXXXXXXXXX,0,300,0
27657,13,0,13,39,248,0,0,259,158,101,GXXXXXXXXXXXXXXXXXXXGXXXXXXXXXXXXXXXXXXXGXXXXXXXXXXXXXXXXXXXGXXXXXXXXXXXXXXXXXXXGXXXXXXXXXXXXXXXXXXXGXXXXXXXXXXXXXXXXXXXGXXXXXXXXXXXXXXXXXXXGXXXXXXXXXXXXXXXXXXXGXXXXXXXXXXXXXXXXXXXGXXXXXXXXXXXXXXXXXXXGXXXXXXXXXXXXXXXXXXXGXXXXXXXXXXXXXXXXXXXGXXXXXXXXXXXXXXXXXXX,0,300,0
27678,13,0,13,39,248,0,0,260,163,97,GXXXXXXXXXXXXXXXXXXXGXXXXXXXXXXXXXXXXXXXGXXXXXXXXXXXXXXXXXXXGXXXXXXXXXXXXXXXXXXXGXXXXXXXXXXXXXXXXXXXGXXXXXXXXXXXXXXXXXXXGXXXXXXXXXXXXXXXXXXXGXXXXXXXXXXXXXXXXXXXGXXXXXXXXXXXXXXXXXXXGXXXXXXXXXXXXXXXXXXXGXXXXXXXXXXXXXXXXXXXGXXXXXXXXXXXXXXXXXXXGXXXXXXXXXXXXXXXXXXX,0,300,0
27699,13,0,13,44,243,0,0,255,160,95,GXXXXXXXXXXXXXXXXXXXGXXXXXXXXXXXXXXXXXXXGXXXXXXXXXXXXXXXXXXXGXXXXXXXXXXXXXXXXXXXGXXXXXXXXXXXXXXXXXXXGXXXXXXXXXXXXXXXXXXXGXXXXXXXXXXXXXXXXXXXGXXXXXXXXXXXXXXXXXXXGXXXXXXXXXXXXXXXXXXXGXXXXXXXXXXXXXXXXXXXGXXXXXXXXXXXXXXXXXXXGXXXXXXXXXXXXXXXXXXXGXXXXXXXXXXXXXXXXXXX,0,300,0

27720,13,0,13,49,238,0,0,250,157,93,GXXXXXXXXXXXXXXXXXXXGXXXXXXXXXXXXXXXXXXXGXXXXXXXXXXXXXXXXXXXGXXXXXXXXXXXXXXXXXXXGXXXXXXXXXXXXXXXXXXXGXXXXXXXXXXXXXXXXXXXGXXXXXXXXXXXXXXXXXXXGXXXXXXXXXXXXXXXXXXXGXXXXXXXXXXXXXXXXXXXGXXXXXXXXXXXXXXXXXXXGXXXXXXXXXXXXXXXXXXXGXXXXXXXXXXXXXXXXXXXGXXXXXXXXXXXXXXXXXXX,0,300,0
27741,13,0,13,54,233,0,0,245,155,90,GXXXXXXXXXXXXXXXXXXXGXXXXXXXXXXXXXXXXXXXGXXXXXXXXXXXXXXXXXXXGXXXXXXXXXXXXXXXXXXXGXXXXXXXXXXXXXXXXXXXGXXXXXXXXXXXXXXXXXXXGXXXXXXXXXXXXXXXXXXXGXXXXXXXXXXXXXXXXXXXGXXXXXXXXXXXXXXXXXXXGXXXXXXXXXXXXXXXXXXXGXXXXXXXXXXXXXXXXXXXGXXXXXXXXXXXXXXXXXXXGXXXXXXXXXXXXXXXXXXX,0,300,0
27762,13,0,13,53,234,0,0,246,159,87,GXXXXXXXXXXXXXXXXXXXGXXXXXXXXXXXXXXXXXXXGXXXXXXXXXXXXXXXXXXXGXXXXXXXXXXXXXXXXXXXGXXXXXXXXXXXXXXXXXXXGXXXXXXXXXXXXXXXXXXXGXXXXXXXXXXXXXXXXXXXGXXXXXXXXXXXXXXXXXXXGXXXXXXXXXXXXXXXXXXXGXXXXXXXXXXXXXXXXXXXGXXXXXXXXXXXXXXXXXXXGXXXXXXXXXXXXXXXXXXXGXXXXXXXXXXXXXXXXXXX,0,300,0
27783,13,0,13,52,235,0,0,247,157,90,GXXXXXXXXXXXXXXXXXXXGXXXXXXXXXXXXXXXXXXXGXXXXXXXXXXXXXXXXXXXGXXXXXXXXXXXXXXXXXXXGXXXXXXXXXXXXXXXXXXXGXXXXXXXXXXXXXXXXXXXGXXXXXXXXXXXXXXXXXXXGXXXXXXXXXXXXXXXXXXXGXXXXXXXXXXXXXXXXXXXGXXXXXXXXXXXXXXXXXXXGXXXXXXXXXXXXXXXXXXXGXXXXXXXXXXXXXXXXXXXGXXXXXXXXXXXXXXXXXXX,0,300,0
27804,13,0,13,53,234,0,0,246,160,86,GXXXXXXXXXXXXXXXXXXXGXXXXXXXXXXXXXXXXXXXGXXXXXXXXXXXXXXXXXXXGXXXXXXXXXXXXXXXXXXXGXXXXXXXXXXXXXXXXXXXGXXXXXXXXXXXXXXXXXXXGXXXXXXXXXXXXXXXXXXXGXXXXXXXXXXXXXXXXXXXGXXXXXXXXXXXXXXXXXXXGXXXXXXXXXXXXXXXXXXXGXXXXXXXXXXXXXXXXXXXGXXXXXXXXXXXXXXXXXXXGXXXXXXXXXXXXXXXXXXX,0,300,0

27825,13,0,13,48,239,0,0,251,161,90,GXXXXXXXXXXXXXXXXXXXGXXXXXXXXXXXXXXXXXXXGXXXXXXXXXXXXXXXXXXXGXXXXXXXXXXXXXXXXXXXGXXXXXXXXXXXXXXXXXXXGXXXXXXXXXXXXXXXXXXXGXXXXXXXXXXXXXXXXXXXGXXXXXXXXXXXXXXXXXXXGXXXXXXXXXXXXXXXXXXXGXXXXXXXXXXXXXXXXXXXGXXXXXXXXXXXXXXXXXXXGXXXXXXXXXXXXXXXXXXXGXXXXXXXXXXXXXXXXXXX,0,300,0
27846,13,0,13,47,240,0,0,252,162,90,GXXXXXXXXXXXXXXXXXXXGXXXXXXXXXXXXXXXXXXXGXXXXXXXXXXXXXXXXXXXGXXXXXXXXXXXXXXXXXXXGXXXXXXXXXXXXXXXXXXXGXXXXXXXXXXXXXXXXXXXGXXXXXXXXXXXXXXXXXXXGXXXXXXXXXXXXXXXXXXXGXXXXXXXXXXXXXXXXXXXGXXXXXXXXXXXXXXXXXXXGXXXXXXXXXXXXXXXXXXXGXXXXXXXXXXXXXXXXXXXGXXXXXXXXXXXXXXXXXXX,0,300,0
27867,13,0,13,47,240,0,0,252,164,88,GXXXXXXXXXXXXXXXXXXXGXXXXXXXXXXXXXXXXXXXGXXXXXXXXXXXXXXXXXXXGXXXXXXXXXXXXXXXXXXXGXXXXXXXXXXXXXXXXXXXGXXXXXXXXXXXXXXXXXXXGXXXXXXXXXXXXXXXXXXXGXXXXXXXXXXXXXXXXXXXGXXXXXXXXXXXXXXXXXXXGXXXXXXXXXXXXXXXXXXXGXXXXXXXXXXXXXXXXXXXGXXXXXXXXXXXXXXXXXXXGXXXXXXXXXXXXXXXXXXX,0,300,0
27888,13,0,13,50,237,0,0,248,163,85,GXXXXXXXXXXXXXXXXXXXGXXXXXXXXXXXXXXXXXXXGXXXXXXXXXXXXXXXXXXXGXXXXXXXXXXXXXXXXXXXGXXXXXXXXXXXXXXXXXXXGXXXXXXXXXXXXXXXXXXXGXXXXXXXXXXXXXXXXXXXGXXXXXXXXXXXXXXXXXXXGXXXXXXXXXXXXXXXXXXXGXXXXXXXXXXXXXXXXXXXGXXXXXXXXXXXXXXXXXXXGXXXXXXXXXXXXXXXXXXXGXXXXXXXXXXXXXXXXXXX,0,300,0
27909,13,0,13,53,234,0,0,246,159,87,GXXXXXXXXXXXXXXXXXXXGXXXXXXXXXXXXXXXXXXXGXXXXXXXXXXXXXXXXXXXGXXXXXXXXXXXXXXXXXXXGXXXXXXXXXXXXXXXXXXXGXXXXXXXXXXXXXXXXXXXGXXXXXXXXXXXXXXXXXXXGXXXXXXXXXXXXXXXXXXXGXXXXXXXXXXXXXXXXXXXGXXXXXXXXXXXXXXXXXXXGXXXXXXXXXXXXXXXXXXXGXXXXXXXXXXXXXXXXXXXGXXXXXXXXXXXXXXXXXXX,0,300,0

27930,13,0,13,52,235,0,0,247,159,88,GXXXXXXXXXXXXXXXXXXXGXXXXXXXXXXXXXXXXXXXGXXXXXXXXXXXXXXXXXXXGXXXXXXXXXXXXXXXXXXXGXXXXXXXXXXXXXXXXXXXGXXXXXXXXXXXXXXXXXXXGXXXXXXXXXXXXXXXXXXXGXXXXXXXXXXXXXXXXXXXGXXXXXXXXXXXXXXXXXXXGXXXXXXXXXXXXXXXXXXXGXXXXXXXXXXXXXXXXXXXGXXXXXXXXXXXXXXXXXXXGXXXXXXXXXXXXXXXXXXX,0,300,0
27951,13,0,13,56,231,0,0,243,158,85,GXXXXXXXXXXXXXXXXXXXGXXXXXXXXXXXXXXXXXXXGXXXXXXXXXXXXXXXXXXXGXXXXXXXXXXXXXXXXXXXGXXXXXXXXXXXXXXXXXXXGXXXXXXXXXXXXXXXXXXXGXXXXXXXXXXXXXXXXXXXGXXXXXXXXXXXXXXXXXXXGXXXXXXXXXXXXXXXXXXXGXXXXXXXXXXXXXXXXXXXGXXXXXXXXXXXXXXXXXXXGXXXXXXXXXXXXXXXXXXXGXXXXXXXXXXXXXXXXXXX,0,300,0
27972,13,0,13,50,237,0,0,249,158,91,GXXXXXXXXXXXXXXXXXXXGXXXXXXXXXXXXXXXXXXXGXXXXXXXXXXXXXXXXXXXGXXXXXXXXXXXXXXXXXXXGXXXXXXXXXXXXXXXXXXXGXXXXXXXXXXXXXXXXXXXGXXXXXXXXXXXXXXXXXXXGXXXXXXXXXXXXXXXXXXXGXXXXXXXXXXXXXXXXXXXGXXXXXXXXXXXXXXXXXXXGXXXXXXXXXXXXXXXXXXXGXXXXXXXXXXXXXXXXXXXGXXXXXXXXXXXXXXXXXXX,0,300,0
27993,14,1,13,50,236,0,0,248,157,91,GXXXXXXXXXXXXXXXXXXXGXXXXXXXXXXXXXXXXXXXGXXXXXXXXXXXXXXXXXXXGXXXXXXXXXXXXXXXXXXXGXXXXXXXXXXXXXXXXXXXGXXXXXXXXXXXXXXXXXXXGAXXXXXXXXXXXXXXXXXXGXXXXXXXXXXXXXXXXXXXGXXXXXXXXXXXXXXXXXXXGXXXXXXXXXXXXXXXXXXXGXXXXXXXXXXXXXXXXXXXGXXXXXXXXXXXXXXXXXXXGXXXXXXXXXXXXXXXXXXX,0,300,0
28014,14,1,13,49,237,0,0,248,156,92,GXXXXXXXXXXXXXXXXXXXGXXXXXXXXXXXXXXXXXXXGXXXXXXXXXXXXXXXXXXXGXXXXXXXXXXXXXXXXXXXGXXXXXXXXXXXXXXXXXXXGXXXXXXXXXXXXXXXXXXXGAXXXXXXXXXXXXXXXXXXGXXXXXXXXXXXXXXXXXXXGXXXXXXXXXXXXXXXXXXXGXXXXXXXXXXXXXXXXXXXGXXXXXXXXXXXXXXXXXXXGXXXXXXXXXXXXXXXXXXXGXXXXXXXXXXXXXXXXXXX,0,300,0

28035,14,1,13,44,242,0,0,253,157,96,GXXXXXXXXXXXXXXXXXXXGXXXXXXXXXXXXXXXXXXXGXXXXXXXXXXXXXXXXXXXGXXXXXXXXXXXXXXXXXXXGXXXXXXXXXXXXXXXXXXXGXXXXXXXXXXXXXXXXXXXGAXXXXXXXXXXXXXXXXXXGXXXXXXXXXXXXXXXXXXXGXXXXXXXXXXXXXXXXXXXGXXXXXXXXXXXXXXXXXXXGXXXXXXXXXXXXXXXXXXXGXXXXXXXXXXXXXXXXXXXGXXXXXXXXXXXXXXXXXXX,0,300,0
28056,14,1,13,38,248,0,0,260,159,101,GXXXXXXXXXXXXXXXXXXXGXXXXXXXXXXXXXXXXXXXGXXXXXXXXXXXXXXXXXXXGXXXXXXXXXXXXXXXXXXXGXXXXXXXXXXXXXXXXXXXGXXXXXXXXXXXXXXXXXXXGAXXXXXXXXXXXXXXXXXXGXXXXXXXXXXXXXXXXXXXGXXXXXXXXXXXXXXXXXXXGXXXXXXXXXXXXXXXXXXXGXXXXXXXXXXXXXXXXXXXGXXXXXXXXXXXXXXXXXXXGXXXXXXXXXXXXXXXXXXX,0,300,0
28077,14,1,13,38,248,0,0,259,156,103,GXXXXXXXXXXXXXXXXXXXGXXXXXXXXXXXXXXXXXXXGXXXXXXXXXXXXXXXXXXXGXXXXXXXXXXXXXXXXXXXGXXXXXXXXXXXXXXXXXXXGXXXXXXXXXXXXXXXXXXXGAXXXXXXXXXXXXXXXXXXGXXXXXXXXXXXXXXXXXXXGXXXXXXXXXXXXXXXXXXXGXXXXXXXXXXXXXXXXXXXGXXXXXXXXXXXXXXXXXXXGXXXXXXXXXXXXXXXXXXXGXXXXXXXXXXXXXXXXXXX,0,300,0
28098,14,1,13,37,249,0,0,261,165,96,GXXXXXXXXXXXXXXXXXXXGXXXXXXXXXXXXXXXXXXXGXXXXXXXXXXXXXXXXXXXGXXXXXXXXXXXXXXXXXXXGXXXXXXXXXXXXXXXXXXXGXXXXXXXXXXXXXXXXXXXGAXXXXXXXXXXXXXXXXXXGXXXXXXXXXXXXXXXXXXXGXXXXXXXXXXXXXXXXXXXGXXXXXXXXXXXXXXXXXXXGXXXXXXXXXXXXXXXXXXXGXXXXXXXXXXXXXXXXXXXGXXXXXXXXXXXXXXXXXXX,0,300,0
28119,14,1,13,40,246,0,0,258,159,99,GXXXXXXXXXXXXXXXXXXXGXXXXXXXXXXXXXXXXXXXGXXXXXXXXXXXXXXXXXXXGXXXXXXXXXXXXXXXXXXXGXXXXXXXXXXXXXXXXXXXGXXXXXXXXXXXXXXXXXXXGAXXXXXXXXXXXXXXXXXXGXXXXXXXXXXXXXXXXXXXGXXXXXXXXXXXXXXXXXXXGXXXXXXXXXXXXXXXXXXXGXXXXXXXXXXXXXXXXXXXGXXXXXXXXXXXXXXXXXXXGXXXXXXXXXXXXXXXXXXX,0,300,0

28140,14,1,13,41,245,0,0,256,157,99,GXXXXXXXXXXXXXXXXXXXGXXXXXXXXXXXXXXXXXXXGXXXXXXXXXXXXXXXXXXXGXXXXXXXXXXXXXXXXXXXGXXXXXXXXXXXXXXXXXXXGXXXXXXXXXXXXXXXXXXXGAXXXXXXXXXXXXXXXXXXGXXXXXXXXXXXXXXXXXXXGXXXXXXXXXXXXXXXXXXXGXXXXXXXXXXXXXXXXXXXGXXXXXXXXXXXXXXXXXXXGXXXXXXXXXXXXXXXXXXXGXXXXXXXXXXXXXXXXXXX,0,300,0
28161,14,1,13,42,244,0,0,256,160,96,GXXXXXXXXXXXXXXXXXXXGXXXXXXXXXXXXXXXXXXXGXXXXXXXXXXXXXXXXXXXGXXXXXXXXXXXXXXXXXXXGXXXXXXXXXXXXXXXXXXXGXXXXXXXXXXXXXXXXXXXGAXXXXXXXXXXXXXXXXXXGXXXXXXXXXXXXXXXXXXXGXXXXXXXXXXXXXXXXXXXGXXXXXXXXXXXXXXXXXXXGXXXXXXXXXXXXXXXXXXXGXXXXXXXXXXXXXXXXXXXGXXXXXXXXXXXXXXXXXXX,0,300,0
28182,14,1,13,45,241,0,0,253,161,92,GXXXXXXXXXXXXXXXXXXXGXXXXXXXXXXXXXXXXXXXGXXXXXXXXXXXXXXXXXXXGXXXXXXXXXXXXXXXXXXXGXXXXXXXXXXXXXXXXXXXGXXXXXXXXXXXXXXXXXXXGAXXXXXXXXXXXXXXXXXXGXXXXXXXXXXXXXXXXXXXGXXXXXXXXXXXXXXXXXXXGXXXXXXXXXXXXXXXXXXXGXXXXXXXXXXXXXXXXXXXGXXXXXXXXXXXXXXXXXXXGXXXXXXXXXXXXXXXXXXX,0,300,0
28203,14,1,13,46,240,0,0,252,162,90,GXXXXXXXXXXXXXXXXXXXGXXXXXXXXXXXXXXXXXXXGXXXXXXXXXXXXXXXXXXXGXXXXXXXXXXXXXXXXXXXGXXXXXXXXXXXXXXXXXXXGXXXXXXXXXXXXXXXXXXXGAXXXXXXXXXXXXXXXXXXGXXXXXXXXXXXXXXXXXXXGXXXXXXXXXXXXXXXXXXXGXXXXXXXXXXXXXXXXXXXGXXXXXXXXXXXXXXXXXXXGXXXXXXXXXXXXXXXXXXXGXXXXXXXXXXXXXXXXXXX,0,300,0
28224,14,1,13,53,233,0,0,245,162,83,GXXXXXXXXXXXXXXXXXXXGXXXXXXXXXXXXXXXXXXXGXXXXXXXXXXXXXXXXXXXGXXXXXXXXXXXXXXXXXXXGXXXXXXXXXXXXXXXXXXXGXXXXXXXXXXXXXXXXXXXGAXXXXXXXXXXXXXXXXXXGXXXXXXXXXXXXXXXXXXXGXXXXXXXXXXXXXXXXXXXGXXXXXXXXXXXXXXXXXXXGXXXXXXXXXXXXXXXXXXXGXXXXXXXXXXXXXXXXXXXGXXXXXXXXXXXXXXXXXXX,0,300,0

28245,13,0,13,57,230,0,0,241,155,86,GXXXXXXXXXXXXXXXXXXXGXXXXXXXXXXXXXXXXXXXGXXXXXXXXXXXXXXXXXXXGXXXXXXXXXXXXXXXXXXXGXXXXXXXXXXXXXXXXXXXGXXXXXXXXXXXXXXXXXXXGXXXXXXXXXXXXXXXXXXXGXXXXXXXXXXXXXXXXXXXGXXXXXXXXXXXXXXXXXXXGXXXXXXXXXXXXXXXXXXXGXXXXXXXXXXXXXXXXXXXGXXXXXXXXXXXXXXXXXXXGXXXXXXXXXXXXXXXXXXX,0,300,0
28266,13,0,13,53,234,0,0,245,161,84,GXXXXXXXXXXXXXXXXXXXGXXXXXXXXXXXXXXXXXXXGXXXXXXXXXXXXXXXXXXXGXXXXXXXXXXXXXXXXXXXGXXXXXXXXXXXXXXXXXXXGXXXXXXXXXXXXXXXXXXXGXXXXXXXXXXXXXXXXXXXGXXXXXXXXXXXXXXXXXXXGXXXXXXXXXXXXXXXXXXXGXXXXXXXXXXXXXXXXXXXGXXXXXXXXXXXXXXXXXXXGXXXXXXXXXXXXXXXXXXXGXXXXXXXXXXXXXXXXXXX,0,300,0
28287,13,0,13,56,231,0,0,243,158,85,GXXXXXXXXXXXXXXXXXXXGXXXXXXXXXXXXXXXXXXXGXXXXXXXXXXXXXXXXXXXGXXXXXXXXXXXXXXXXXXXGXXXXXXXXXXXXXXXXXXXGXXXXXXXXXXXXXXXXXXXGXXXXXXXXXXXXXXXXXXXGXXXXXXXXXXXXXXXXXXXGXXXXXXXXXXXXXXXXXXXGXXXXXXXXXXXXXXXXXXXGXXXXXXXXXXXXXXXXXXXGXXXXXXXXXXXXXXXXXXXGXXXXXXXXXXXXXXXXXXX,0,300,0
28308,13,0,13,51,236,0,0,248,158,90,GXXXXXXXXXXXXXXXXXXXGXXXXXXXXXXXXXXXXXXXGXXXXXXXXXXXXXXXXXXXGXXXXXXXXXXXXXXXXXXXGXXXXXXXXXXXXXXXXXXXGXXXXXXXXXXXXXXXXXXXGXXXXXXXXXXXXXXXXXXXGXXXXXXXXXXXXXXXXXXXGXXXXXXXXXXXXXXXXXXXGXXXXXXXXXXXXXXXXXXXGXXXXXXXXXXXXXXXXXXXGXXXXXXXXXXXXXXXXXXXGXXXXXXXXXXXXXXXXXXX,0,300,0
28329,13,0,13,52,235,0,0,247,156,91,GXXXXXXXXXXXXXXXXXXXGXXXXXXXXXXXXXXXXXXXGXXXXXXXXXXXXXXXXXXXGXXXXXXXXXXXXXXXXXXXGXXXXXXXXXXXXXXXXXXXGXXXXXXXXXXXXXXXXXXXGXXXXXXXXXXXXXXXXXXXGXXXXXXXXXXXXXXXXXXXGXXXXXXXXXXXXXXXXXXXGXXXXXXXXXXXXXXXXXXXGXXXXXXXXXXXXXXXXXXXGXXXXXXXXXXXXXXXXXXXGXXXXXXXXXXXXXXXXXXX,0,300,0

28350,14,1,13,53,233,0,0,245,156,89,GXXXXXXXXXXXXXXXXXXXGAXXXXXXXXXXXXXXXXXXGXXXXXXXXXXXXXXXXXXXGXXXXXXXXXXXXXXXXXXXGXXXXXXXXXXXXXXXXXXXGXXXXXXXXXXXXXXXXXXXGXXXXXXXXXXXXXXXXXXXGXXXXXXXXXXXXXXXXXXXGXXXXXXXXXXXXXXXXXXXGXXXXXXXXXXXXXXXXXXXGXXXXXXXXXXXXXXXXXXXGXXXXXXXXXXXXXXXXXXXGXXXXXXXXXXXXXXXXXXX,0,300,0
28371,14,1,13,55,231,0,0,243,159,84,GXXXXXXXXXXXXXXXXXXXGAXXXXXXXXXXXXXXXXXXGXXXXXXXXXXXXXXXXXXXGXXXXXXXXXXXXXXXXXXXGXXXXXXXXXXXXXXXXXXXGXXXXXXXXXXXXXXXXXXXGXXXXXXXXXXXXXXXXXXXGXXXXXXXXXXXXXXXXXXXGXXXXXXXXXXXXXXXXXXXGXXXXXXXXXXXXXXXXXXXGXXXXXXXXXXXXXXXXXXXGXXXXXXXXXXXXXXXXXXXGXXXXXXXXXXXXXXXXXXX,0,300,0
28392,14,1,13,54,232,0,0,243,160,83,GXXXXXXXXXXXXXXXXXXXGAXXXXXXXXXXXXXXXXXXGXXXXXXXXXXXXXXXXXXXGXXXXXXXXXXXXXXXXXXXGXXXXXXXXXXXXXXXXXXXGXXXXXXXXXXXXXXXXXXXGXXXXXXXXXXXXXXXXXXXGXXXXXXXXXXXXXXXXXXXGXXXXXXXXXXXXXXXXXXXGXXXXXXXXXXXXXXXXXXXGXXXXXXXXXXXXXXXXXXXGXXXXXXXXXXXXXXXXXXXGXXXXXXXXXXXXXXXXXXX,0,300,0
28413,13,0,13,54,233,0,0,245,162,83,GXXXXXXXXXXXXXXXXXXXGXXXXXXXXXXXXXXXXXXXGXXXXXXXXXXXXXXXXXXXGXXXXXXXXXXXXXXXXXXXGXXXXXXXXXXXXXXXXXXXGXXXXXXXXXXXXXXXXXXXGXXXXXXXXXXXXXXXXXXXGXXXXXXXXXXXXXXXXXXXGXXXXXXXXXXXXXXXXXXXGXXXXXXXXXXXXXXXXXXXGXXXXXXXXXXXXXXXXXXXGXXXXXXXXXXXXXXXXXXXGXXXXXXXXXXXXXXXXXXX,0,300,0
28434,13,0,13,51,236,0,0,247,164,83,GXXXXXXXXXXXXXXXXXXXGXXXXXXXXXXXXXXXXXXXGXXXXXXXXXXXXXXXXXXXGXXXXXXXXXXXXXXXXXXXGXXXXXXXXXXXXXXXXXXXGXXXXXXXXXXXXXXXXXXXGXXXXXXXXXXXXXXXXXXXGXXXXXXXXXXXXXXXXXXXGXXXXXXXXXXXXXXXXXXXGXXXXXXXXXXXXXXXXXXXGXXXXXXXXXXXXXXXXXXXGXXXXXXXXXXXXXXXXXXXGXXXXXXXXXXXXXXXXXXX,0,300,0

28455,13,0,13,53,234,0,0,246,169,77,GXXXXXXXXXXXXXXXXXXXGXXXXXXXXXXXXXXXXXXXGXXXXXXXXXXXXXXXXXXXGXXXXXXXXXXXXXXXXXXXGXXXXXXXXXXXXXXXXXXXGXXXXXXXXXXXXXXXXXXXGXXXXXXXXXXXXXXXXXXXGXXXXXXXXXXXXXXXXXXXGXXXXXXXXXXXXXXXXXXXGXXXXXXXXXXXXXXXXXXXGXXXXXXXXXXXXXXXXXXXGXXXXXXXXXXXXXXXXXXXGXXXXXXXXXXXXXXXXXXX,0,300,0
28476,13,0,13,56,231,0,0,242,166,76,GXXXXXXXXXXXXXXXXXXXGXXXXXXXXXXXXXXXXXXXGXXXXXXXXXXXXXXXXXXXGXXXXXXXXXXXXXXXXXXXGXXXXXXXXXXXXXXXXXXXGXXXXXXXXXXXXXXXXXXXGXXXXXXXXXXXXXXXXXXXGXXXXXXXXXXXXXXXXXXXGXXXXXXXXXXXXXXXXXXXGXXXXXXXXXXXXXXXXXXXGXXXXXXXXXXXXXXXXXXXGXXXXXXXXXXXXXXXXXXXGXXXXXXXXXXXXXXXXXXX,0,300,0
28497,13,0,13,64,223,0,0,235,162,73,GXXXXXXXXXXXXXXXXXXXGXXXXXXXXXXXXXXXXXXXGXXXXXXXXXXXXXXXXXXXGXXXXXXXXXXXXXXXXXXXGXXXXXXXXXXXXXXXXXXXGXXXXXXXXXXXXXXXXXXXGXXXXXXXXXXXXXXXXXXXGXXXXXXXXXXXXXXXXXXXGXXXXXXXXXXXXXXXXXXXGXXXXXXXXXXXXXXXXXXXGXXXXXXXXXXXXXXXXXXXGXXXXXXXXXXXXXXXXXXXGXXXXXXXXXXXXXXXXXXX,0,300,0
28518,13,0,13,64,223,0,0,235,158,77,GXXXXXXXXXXXXXXXXXXXGXXXXXXXXXXXXXXXXXXXGXXXXXXXXXXXXXXXXXXXGXXXXXXXXXXXXXXXXXXXGXXXXXXXXXXXXXXXXXXXGXXXXXXXXXXXXXXXXXXXGXXXXXXXXXXXXXXXXXXXGXXXXXXXXXXXXXXXXXXXGXXXXXXXXXXXXXXXXXXXGXXXXXXXXXXXXXXXXXXXGXXXXXXXXXXXXXXXXXXXGXXXXXXXXXXXXXXXXXXXGXXXXXXXXXXXXXXXXXXX,0,300,0
28539,13,0,13,61,226,0,0,237,160,77,GXXXXXXXXXXXXXXXXXXXGXXXXXXXXXXXXXXXXXXXGXXXXXXXXXXXXXXXXXXXGXXXXXXXXXXXXXXXXXXXGXXXXXXXXXXXXXXXXXXXGXXXXXXXXXXXXXXXXXXXGXXXXXXXXXXXXXXXXXXXGXXXXXXXXXXXXXXXXXXXGXXXXXXXXXXXXXXXXXXXGXXXXXXXXXXXXXXXXXXXGXXXXXXXXXXXXXXXXXXXGXXXXXXXXXXXXXXXXXXXGXXXXXXXXXXXXXXXXXXX,0,300,0

28560,13,0,13,58,229,0,0,241,163,78,GXXXXXXXXXXXXXXXXXXXGXXXXXXXXXXXXXXXXXXXGXXXXXXXXXXXXXXXXXXXGXXXXXXXXXXXXXXXXXXXGXXXXXXXXXXXXXXXXXXXGXXXXXXXXXXXXXXXXXXXGXXXXXXXXXXXXXXXXXXXGXXXXXXXXXXXXXXXXXXXGXXXXXXXXXXXXXXXXXXXGXXXXXXXXXXXXXXXXXXXGXXXXXXXXXXXXXXXXXXXGXXXXXXXXXXXXXXXXXXXGXXXXXXXXXXXXXXXXXXX,0,300,0
28581,13,0,13,52,235,0,0,246,169,77,GXXXXXXXXXXXXXXXXXXXGXXXXXXXXXXXXXXXXXXXGXXXXXXXXXXXXXXXXXXXGXXXXXXXXXXXXXXXXXXXGXXXXXXXXXXXXXXXXXXXGXXXXXXXXXXXXXXXXXXXGXXXXXXXXXXXXXXXXXXXGXXXXXXXXXXXXXXXXXXXGXXXXXXXXXXXXXXXXXXXGXXXXXXXXXXXXXXXXXXXGXXXXXXXXXXXXXXXXXXXGXXXXXXXXXXXXXXXXXXXGXXXXXXXXXXXXXXXXXXX,0,300,0
28602,13,0,13,49,238,0,0,249,165,84,GXXXXXXXXXXXXXXXXXXXGXXXXXXXXXXXXXXXXXXXGXXXXXXXXXXXXXXXXXXXGXXXXXXXXXXXXXXXXXXXGXXXXXXXXXXXXXXXXXXXGXXXXXXXXXXXXXXXXXXXGXXXXXXXXXXXXXXXXXXXGXXXXXXXXXXXXXXXXXXXGXXXXXXXXXXXXXXXXXXXGXXXXXXXXXXXXXXXXXXXGXXXXXXXXXXXXXXXXXXXGXXXXXXXXXXXXXXXXXXXGXXXXXXXXXXXXXXXXXXX,0,300,0
28623,13,0,13,54,233,0,0,246,160,86,GXXXXXXXXXXXXXXXXXXXGXXXXXXXXXXXXXXXXXXXGXXXXXXXXXXXXXXXXXXXGXXXXXXXXXXXXXXXXXXXGXXXXXXXXXXXXXXXXXXXGXXXXXXXXXXXXXXXXXXXGXXXXXXXXXXXXXXXXXXXGXXXXXXXXXXXXXXXXXXXGXXXXXXXXXXXXXXXXXXXGXXXXXXXXXXXXXXXXXXXGXXXXXXXXXXXXXXXXXXXGXXXXXXXXXXXXXXXXXXXGXXXXXXXXXXXXXXXXXXX,0,300,0
28644,13,0,13,54,233,0,0,246,164,82,GXXXXXXXXXXXXXXXXXXXGXXXXXXXXXXXXXXXXXXXGXXXXXXXXXXXXXXXXXXXGXXXXXXXXXXXXXXXXXXXGXXXXXXXXXXXXXXXXXXXGXXXXXXXXXXXXXXXXXXXGXXXXXXXXXXXXXXXXXXXGXXXXXXXXXXXXXXXXXXXGXXXXXXXXXXXXXXXXXXXGXXXXXXXXXXXXXXXXXXXGXXXXXXXXXXXXXXXXXXXGXXXXXXXXXXXXXXXXXXXGXXXXXXXXXXXXXXXXXXX,0,300,0

28665,13,0,13,55,232,0,0,245,161,84,GXXXXXXXXXXXXXXXXXXXGXXXXXXXXXXXXXXXXXXXGXXXXXXXXXXXXXXXXXXXGXXXXXXXXXXXXXXXXXXXGXXXXXXXXXXXXXXXXXXXGXXXXXXXXXXXXXXXXXXXGXXXXXXXXXXXXXXXXXXXGXXXXXXXXXXXXXXXXXXXGXXXXXXXXXXXXXXXXXXXGXXXXXXXXXXXXXXXXXXXGXXXXXXXXXXXXXXXXXXXGXXXXXXXXXXXXXXXXXXXGXXXXXXXXXXXXXXXXXXX,0,300,0
28686,13,0,13,52,235,0,0,248,165,83,GXXXXXXXXXXXXXXXXXXXGXXXXXXXXXXXXXXXXXXXGXXXXXXXXXXXXXXXXXXXGXXXXXXXXXXXXXXXXXXXGXXXXXXXXXXXXXXXXXXXGXXXXXXXXXXXXXXXXXXXGXXXXXXXXXXXXXXXXXXXGXXXXXXXXXXXXXXXXXXXGXXXXXXXXXXXXXXXXXXXGXXXXXXXXXXXXXXXXXXXGXXXXXXXXXXXXXXXXXXXGXXXXXXXXXXXXXXXXXXXGXXXXXXXXXXXXXXXXXXX,0,300,0
28707,13,0,13,53,234,0,0,246,160,86,GXXXXXXXXXXXXXXXXXXXGXXXXXXXXXXXXXXXXXXXGXXXXXXXXXXXXXXXXXXXGXXXXXXXXXXXXXXXXXXXGXXXXXXXXXXXXXXXXXXXGXXXXXXXXXXXXXXXXXXXGXXXXXXXXXXXXXXXXXXXGXXXXXXXXXXXXXXXXXXXGXXXXXXXXXXXXXXXXXXXGXXXXXXXXXXXXXXXXXXXGXXXXXXXXXXXXXXXXXXXGXXXXXXXXXXXXXXXXXXXGXXXXXXXXXXXXXXXXXXX,0,300,0
28728,13,0,13,53,234,0,0,246,161,85,GXXXXXXXXXXXXXXXXXXXGXXXXXXXXXXXXXXXXXXXGXXXXXXXXXXXXXXXXXXXGXXXXXXXXXXXXXXXXXXXGXXXXXXXXXXXXXXXXXXXGXXXXXXXXXXXXXXXXXXXGXXXXXXXXXXXXXXXXXXXGXXXXXXXXXXXXXXXXXXXGXXXXXXXXXXXXXXXXXXXGXXXXXXXXXXXXXXXXXXXGXXXXXXXXXXXXXXXXXXXGXXXXXXXXXXXXXXXXXXXGXXXXXXXXXXXXXXXXXXX,0,300,0
28749,13,0,13,51,236,0,0,245,164,81,GXXXXXXXXXXXXXXXXXXXGXXXXXXXXXXXXXXXXXXXGXXXXXXXXXXXXXXXXXXXGXXXXXXXXXXXXXXXXXXXGXXXXXXXXXXXXXXXXXXXGXXXXXXXXXXXXXXXXXXXGXXXXXXXXXXXXXXXXXXXGXXXXXXXXXXXXXXXXXXXGXXXXXXXXXXXXXXXXXXXGXXXXXXXXXXXXXXXXXXXGXXXXXXXXXXXXXXXXXXXGXXXXXXXXXXXXXXXXXXXGXXXXXXXXXXXXXXXXXXX,0,300,0

28770,13,0,13,48,239,0,0,252,160,92,GXXXXXXXXXXXXXXXXXXXGXXXXXXXXXXXXXXXXXXXGXXXXXXXXXXXXXXXXXXXGXXXXXXXXXXXXXXXXXXXGXXXXXXXXXXXXXXXXXXXGXXXXXXXXXXXXXXXXXXXGXXXXXXXXXXXXXXXXXXXGXXXXXXXXXXXXXXXXXXXGXXXXXXXXXXXXXXXXXXXGXXXXXXXXXXXXXXXXXXXGXXXXXXXXXXXXXXXXXXXGXXXXXXXXXXXXXXXXXXXGXXXXXXXXXXXXXXXXXXX,0,300,0
28791,13,0,13,43,244,0,0,256,164,92,GXXXXXXXXXXXXXXXXXXXGXXXXXXXXXXXXXXXXXXXGXXXXXXXXXXXXXXXXXXXGXXXXXXXXXXXXXXXXXXXGXXXXXXXXXXXXXXXXXXXGXXXXXXXXXXXXXXXXXXXGXXXXXXXXXXXXXXXXXXXGXXXXXXXXXXXXXXXXXXXGXXXXXXXXXXXXXXXXXXXGXXXXXXXXXXXXXXXXXXXGXXXXXXXXXXXXXXXXXXXGXXXXXXXXXXXXXXXXXXXGXXXXXXXXXXXXXXXXXXX,0,300,0
28812,13,0,13,43,244,0,0,257,166,91,GXXXXXXXXXXXXXXXXXXXGXXXXXXXXXXXXXXXXXXXGXXXXXXXXXXXXXXXXXXXGXXXXXXXXXXXXXXXXXXXGXXXXXXXXXXXXXXXXXXXGXXXXXXXXXXXXXXXXXXXGXXXXXXXXXXXXXXXXXXXGXXXXXXXXXXXXXXXXXXXGXXXXXXXXXXXXXXXXXXXGXXXXXXXXXXXXXXXXXXXGXXXXXXXXXXXXXXXXXXXGXXXXXXXXXXXXXXXXXXXGXXXXXXXXXXXXXXXXXXX,0,300,0
28833,14,1,13,45,241,0,0,254,164,90,GXXXXXXXXXXXXXXXXXXXGXXXXXXXXXXXXXXXXXXXGXXXXXXXXXXXXXXXXXXXGXXXXXXXXXXXXXXXXXXXGXXXXXXXXXXXXXXXXXXXGXXXXXXXXXXXXXXXXXXXGXXXXXXXXXXXXXXXXXXXGAXXXXXXXXXXXXXXXXXXGXXXXXXXXXXXXXXXXXXXGXXXXXXXXXXXXXXXXXXXGXXXXXXXXXXXXXXXXXXXGXXXXXXXXXXXXXXXXXXXGXXXXXXXXXXXXXXXXXXX,0,300,0
28854,14,1,13,46,240,0,0,253,161,92,GXXXXXXXXXXXXXXXXXXXGXXXXXXXXXXXXXXXXXXXGXXXXXXXXXXXXXXXXXXXGXXXXXXXXXXXXXXXXXXXGXXXXXXXXXXXXXXXXXXXGXXXXXXXXXXXXXXXXXXXGXXXXXXXXXXXXXXXXXXXGAXXXXXXXXXXXXXXXXXXGXXXXXXXXXXXXXXXXXXXGXXXXXXXXXXXXXXXXXXXGXXXXXXXXXXXXXXXXXXXGXXXXXXXXXXXXXXXXXXXGXXXXXXXXXXXXXXXXXXX,0,300,0

28875,14,1,13,43,243,0,0,256,166,90,GXXXXXXXXXXXXXXXXXXXGXXXXXXXXXXXXXXXXXXXGXXXXXXXXXXXXXXXXXXXGXXXXXXXXXXXXXXXXXXXGXXXXXXXXXXXXXXXXXXXGXXXXXXXXXXXXXXXXXXXGXXXXXXXXXXXXXXXXXXXGAXXXXXXXXXXXXXXXXXXGXXXXXXXXXXXXXXXXXXXGXXXXXXXXXXXXXXXXXXXGXXXXXXXXXXXXXXXXXXXGXXXXXXXXXXXXXXXXXXXGXXXXXXXXXXXXXXXXXXX,0,300,0
28896,14,1,13,44,242,0,0,255,165,90,GXXXXXXXXXXXXXXXXXXXGXXXXXXXXXXXXXXXXXXXGXXXXXXXXXXXXXXXXXXXGXXXXXXXXXXXXXXXXXXXGXXXXXXXXXXXXXXXXXXXGXXXXXXXXXXXXXXXXXXXGXXXXXXXXXXXXXXXXXXXGAXXXXXXXXXXXXXXXXXXGXXXXXXXXXXXXXXXXXXXGXXXXXXXXXXXXXXXXXXXGXXXXXXXXXXXXXXXXXXXGXXXXXXXXXXXXXXXXXXXGXXXXXXXXXXXXXXXXXXX,0,300,0
28917,14,1,13,48,238,0,0,250,160,90,GXXXXXXXXXXXXXXXXXXXGXXXXXXXXXXXXXXXXXXXGXXXXXXXXXXXXXXXXXXXGXXXXXXXXXXXXXXXXXXXGXXXXXXXXXXXXXXXXXXXGXXXXXXXXXXXXXXXXXXXGXXXXXXXXXXXXXXXXXXXGAXXXXXXXXXXXXXXXXXXGXXXXXXXXXXXXXXXXXXXGXXXXXXXXXXXXXXXXXXXGXXXXXXXXXXXXXXXXXXXGXXXXXXXXXXXXXXXXXXXGXXXXXXXXXXXXXXXXXXX,0,300,0
28938,14,1,13,52,234,0,0,246,158,88,GXXXXXXXXXXXXXXXXXXXGXXXXXXXXXXXXXXXXXXXGXXXXXXXXXXXXXXXXXXXGXXXXXXXXXXXXXXXXXXXGXXXXXXXXXXXXXXXXXXXGXXXXXXXXXXXXXXXXXXXGXXXXXXXXXXXXXXXXXXXGAXXXXXXXXXXXXXXXXXXGXXXXXXXXXXXXXXXXXXXGXXXXXXXXXXXXXXXXXXXGXXXXXXXXXXXXXXXXXXXGXXXXXXXXXXXXXXXXXXXGXXXXXXXXXXXXXXXXXXX,0,300,0
28959,14,1,13,57,229,0,0,241,161,80,GXXXXXXXXXXXXXXXXXXXGXXXXXXXXXXXXXXXXXXXGXXXXXXXXXXXXXXXXXXXGXXXXXXXXXXXXXXXXXXXGXXXXXXXXXXXXXXXXXXXGXXXXXXXXXXXXXXXXXXXGXXXXXXXXXXXXXXXXXXXGAXXXXXXXXXXXXXXXXXXGXXXXXXXXXXXXXXXXXXXGXXXXXXXXXXXXXXXXXXXGXXXXXXXXXXXXXXXXXXXGXXXXXXXXXXXXXXXXXXXGXXXXXXXXXXXXXXXXXXX,0,300,0

28980,15,2,13,54,231,0,0,243,159,84,GXXXXXXXXXXXXXXXXXXXGXXXXXXXXXXXXXXXXXXXGXXXXXXXXXXXXXXXXXXXGXXXXXXXXXXXXXXXXXXXGXXXXXXXXXXXXXXXXXXXGXXXXXXXXXXXXXXXXXXXGXXXXXXXXXXXXXXXXXXXGAAXXXXXXXXXXXXXXXXXGXXXXXXXXXXXXXXXXXXXGXXXXXXXXXXXXXXXXXXXGXXXXXXXXXXXXXXXXXXXGXXXXXXXXXXXXXXXXXXXGXXXXXXXXXXXXXXXXXXX,0,300,0
29001,15,2,13,51,234,0,0,246,163,83,GXXXXXXXXXXXXXXXXXXXGXXXXXXXXXXXXXXXXXXXGXXXXXXXXXXXXXXXXXXXGXXXXXXXXXXXXXXXXXXXGXXXXXXXXXXXXXXXXXXXGXXXXXXXXXXXXXXXXXXXGXXXXXXXXXXXXXXXXXXXGAAXXXXXXXXXXXXXXXXXGXXXXXXXXXXXXXXXXXXXGXXXXXXXXXXXXXXXXXXXGXXXXXXXXXXXXXXXXXXXGXXXXXXXXXXXXXXXXXXXGXXXXXXXXXXXXXXXXXXX,0,300,0
29022,15,1,14,56,229,0,0,241,163,78,GXXXXXXXXXXXXXXXXXXXGXXXXXXXXXXXXXXXXXXXGXXXXXXXXXXXXXXXXXXXGXXXXXXXXXXXXXXXXXXXGXXXXXXXXXXXXXXXXXXXGXXXXXXXXXXXXXXXXXXXGXXXXXXXXXXXXXXXXXXXGOAXXXXXXXXXXXXXXXXXGXXXXXXXXXXXXXXXXXXXGXXXXXXXXXXXXXXXXXXXGXXXXXXXXXXXXXXXXXXXGXXXXXXXXXXXXXXXXXXXGXXXXXXXXXXXXXXXXXXX,0,300,0
29043,15,1,14,55,230,0,0,242,164,78,GXXXXXXXXXXXXXXXXXXXGXXXXXXXXXXXXXXXXXXXGXXXXXXXXXXXXXXXXXXXGXXXXXXXXXXXXXXXXXXXGXXXXXXXXXXXXXXXXXXXGXXXXXXXXXXXXXXXXXXXGXXXXXXXXXXXXXXXXXXXGOAXXXXXXXXXXXXXXXXXGXXXXXXXXXXXXXXXXXXXGXXXXXXXXXXXXXXXXXXXGXXXXXXXXXXXXXXXXXXXGXXXXXXXXXXXXXXXXXXXGXXXXXXXXXXXXXXXXXXX,0,300,0
29064,14,1,13,54,232,0,0,244,166,78,GXXXXXXXXXXXXXXXXXXXGXXXXXXXXXXXXXXXXXXXGXXXXXXXXXXXXXXXXXXXGXXXXXXXXXXXXXXXXXXXGXXXXXXXXXXXXXXXXXXXGXXXXXXXXXXXXXXXXXXXGXXXXXXXXXXXXXXXXXXXGXAXXXXXXXXXXXXXXXXXGXXXXXXXXXXXXXXXXXXXGXXXXXXXXXXXXXXXXXXXGXXXXXXXXXXXXXXXXXXXGXXXXXXXXXXXXXXXXXXXGXXXXXXXXXXXXXXXXXXX,0,300,0

29085,13,0,13,56,231,0,0,243,158,85,GXXXXXXXXXXXXXXXXXXXGXXXXXXXXXXXXXXXXXXXGXXXXXXXXXXXXXXXXXXXGXXXXXXXXXXXXXXXXXXXGXXXXXXXXXXXXXXXXXXXGXXXXXXXXXXXXXXXXXXXGXXXXXXXXXXXXXXXXXXXGXXXXXXXXXXXXXXXXXXXGXXXXXXXXXXXXXXXXXXXGXXXXXXXXXXXXXXXXXXXGXXXXXXXXXXXXXXXXXXXGXXXXXXXXXXXXXXXXXXXGXXXXXXXXXXXXXXXXXXX,0,300,0
29106,13,0,13,52,235,0,0,246,163,83,GXXXXXXXXXXXXXXXXXXXGXXXXXXXXXXXXXXXXXXXGXXXXXXXXXXXXXXXXXXXGXXXXXXXXXXXXXXXXXXXGXXXXXXXXXXXXXXXXXXXGXXXXXXXXXXXXXXXXXXXGXXXXXXXXXXXXXXXXXXXGXXXXXXXXXXXXXXXXXXXGXXXXXXXXXXXXXXXXXXXGXXXXXXXXXXXXXXXXXXXGXXXXXXXXXXXXXXXXXXXGXXXXXXXXXXXXXXXXXXXGXXXXXXXXXXXXXXXXXXX,0,300,0
29127,13,0,13,54,233,0,0,244,166,78,GXXXXXXXXXXXXXXXXXXXGXXXXXXXXXXXXXXXXXXXGXXXXXXXXXXXXXXXXXXXGXXXXXXXXXXXXXXXXXXXGXXXXXXXXXXXXXXXXXXXGXXXXXXXXXXXXXXXXXXXGXXXXXXXXXXXXXXXXXXXGXXXXXXXXXXXXXXXXXXXGXXXXXXXXXXXXXXXXXXXGXXXXXXXXXXXXXXXXXXXGXXXXXXXXXXXXXXXXXXXGXXXXXXXXXXXXXXXXXXXGXXXXXXXXXXXXXXXXXXX,0,300,0
29148,13,0,13,54,233,0,0,244,167,77,GXXXXXXXXXXXXXXXXXXXGXXXXXXXXXXXXXXXXXXXGXXXXXXXXXXXXXXXXXXXGXXXXXXXXXXXXXXXXXXXGXXXXXXXXXXXXXXXXXXXGXXXXXXXXXXXXXXXXXXXGXXXXXXXXXXXXXXXXXXXGXXXXXXXXXXXXXXXXXXXGXXXXXXXXXXXXXXXXXXXGXXXXXXXXXXXXXXXXXXXGXXXXXXXXXXXXXXXXXXXGXXXXXXXXXXXXXXXXXXXGXXXXXXXXXXXXXXXXXXX,0,300,0
29169,13,0,13,53,234,0,0,246,165,81,GXXXXXXXXXXXXXXXXXXXGXXXXXXXXXXXXXXXXXXXGXXXXXXXXXXXXXXXXXXXGXXXXXXXXXXXXXXXXXXXGXXXXXXXXXXXXXXXXXXXGXXXXXXXXXXXXXXXXXXXGXXXXXXXXXXXXXXXXXXXGXXXXXXXXXXXXXXXXXXXGXXXXXXXXXXXXXXXXXXXGXXXXXXXXXXXXXXXXXXXGXXXXXXXXXXXXXXXXXXXGXXXXXXXXXXXXXXXXXXXGXXXXXXXXXXXXXXXXXXX,0,300,0

29190,14,1,13,54,232,0,0,244,163,81,GXXXXXXXXXXXXXXXXXXXGXXXXXXXXXXXXXXXXXXXGXXXXXXXXXXXXXXXXXXXGXXXXXXXXXXXXXXXXXXXGXXXXXXXXXXXXXXXXXXXGXXXXXXXXXXXXXXXXXXXGXXXXXXXXXXXXXXXXXXXGXXXXXXXXXXXXXXXXXXXGAXXXXXXXXXXXXXXXXXXGXXXXXXXXXXXXXXXXXXXGXXXXXXXXXXXXXXXXXXXGXXXXXXXXXXXXXXXXXXXGXXXXXXXXXXXXXXXXXXX,0,300,0
29211,14,1,13,52,234,0,0,246,164,82,GXXXXXXXXXXXXXXXXXXXGXXXXXXXXXXXXXXXXXXXGXXXXXXXXXXXXXXXXXXXGXXXXXXXXXXXXXXXXXXXGXXXXXXXXXXXXXXXXXXXGXXXXXXXXXXXXXXXXXXXGXXXXXXXXXXXXXXXXXXXGXXXXXXXXXXXXXXXXXXXGAXXXXXXXXXXXXXXXXXXGXXXXXXXXXXXXXXXXXXXGXXXXXXXXXXXXXXXXXXXGXXXXXXXXXXXXXXXXXXXGXXXXXXXXXXXXXXXXXXX,0,300,0
29232,14,1,13,52,234,0,0,246,160,86,GXXXXXXXXXXXXXXXXXXXGXXXXXXXXXXXXXXXXXXXGXXXXXXXXXXXXXXXXXXXGXXXXXXXXXXXXXXXXXXXGXXXXXXXXXXXXXXXXXXXGXXXXXXXXXXXXXXXXXXXGXXXXXXXXXXXXXXXXXXXGXXXXXXXXXXXXXXXXXXXGAXXXXXXXXXXXXXXXXXXGXXXXXXXXXXXXXXXXXXXGXXXXXXXXXXXXXXXXXXXGXXXXXXXXXXXXXXXXXXXGXXXXXXXXXXXXXXXXXXX,0,300,0
29253,14,1,13,51,235,0,0,247,161,86,GXXXXXXXXXXXXXXXXXXXGXXXXXXXXXXXXXXXXXXXGXXXXXXXXXXXXXXXXXXXGXXXXXXXXXXXXXXXXXXXGXXXXXXXXXXXXXXXXXXXGXXXXXXXXXXXXXXXXXXXGXXXXXXXXXXXXXXXXXXXGXXXXXXXXXXXXXXXXXXXGAXXXXXXXXXXXXXXXXXXGXXXXXXXXXXXXXXXXXXXGXXXXXXXXXXXXXXXXXXXGXXXXXXXXXXXXXXXXXXXGXXXXXXXXXXXXXXXXXXX,0,300,0
29274,14,1,13,45,241,0,0,252,166,86,GXXXXXXXXXXXXXXXXXXXGXXXXXXXXXXXXXXXXXXXGXXXXXXXXXXXXXXXXXXXGXXXXXXXXXXXXXXXXXXXGXXXXXXXXXXXXXXXXXXXGXXXXXXXXXXXXXXXXXXXGXXXXXXXXXXXXXXXXXXXGXXXXXXXXXXXXXXXXXXXGAXXXXXXXXXXXXXXXXXXGXXXXXXXXXXXXXXXXXXXGXXXXXXXXXXXXXXXXXXXGXXXXXXXXXXXXXXXXXXXGXXXXXXXXXXXXXXXXXXX,0,300,0

29295,14,1,13,47,239,0,0,250,165,85,GXXXXXXXXXXXXXXXXXXXGXXXXXXXXXXXXXXXXXXXGXXXXXXXXXXXXXXXXXXXGXXXXXXXXXXXXXXXXXXXGXXXXXXXXXXXXXXXXXXXGXXXXXXXXXXXXXXXXXXXGXXXXXXXXXXXXXXXXXXXGXXXXXXXXXXXXXXXXXXXGAXXXXXXXXXXXXXXXXXXGXXXXXXXXXXXXXXXXXXXGXXXXXXXXXXXXXXXXXXXGXXXXXXXXXXXXXXXXXXXGXXXXXXXXXXXXXXXXXXX,0,300,0
29316,13,0,13,46,241,0,0,252,160,92,GXXXXXXXXXXXXXXXXXXXGXXXXXXXXXXXXXXXXXXXGXXXXXXXXXXXXXXXXXXXGXXXXXXXXXXXXXXXXXXXGXXXXXXXXXXXXXXXXXXXGXXXXXXXXXXXXXXXXXXXGXXXXXXXXXXXXXXXXXXXGXXXXXXXXXXXXXXXXXXXGXXXXXXXXXXXXXXXXXXXGXXXXXXXXXXXXXXXXXXXGXXXXXXXXXXXXXXXXXXXGXXXXXXXXXXXXXXXXXXXGXXXXXXXXXXXXXXXXXXX,0,300,0
29337,13,0,13,46,241,0,0,253,160,93,GXXXXXXXXXXXXXXXXXXXGXXXXXXXXXXXXXXXXXXXGXXXXXXXXXXXXXXXXXXXGXXXXXXXXXXXXXXXXXXXGXXXXXXXXXXXXXXXXXXXGXXXXXXXXXXXXXXXXXXXGXXXXXXXXXXXXXXXXXXXGXXXXXXXXXXXXXXXXXXXGXXXXXXXXXXXXXXXXXXXGXXXXXXXXXXXXXXXXXXXGXXXXXXXXXXXXXXXXXXXGXXXXXXXXXXXXXXXXXXXGXXXXXXXXXXXXXXXXXXX,0,300,0
29358,13,0,13,46,241,0,0,253,160,93,GXXXXXXXXXXXXXXXXXXXGXXXXXXXXXXXXXXXXXXXGXXXXXXXXXXXXXXXXXXXGXXXXXXXXXXXXXXXXXXXGXXXXXXXXXXXXXXXXXXXGXXXXXXXXXXXXXXXXXXXGXXXXXXXXXXXXXXXXXXXGXXXXXXXXXXXXXXXXXXXGXXXXXXXXXXXXXXXXXXXGXXXXXXXXXXXXXXXXXXXGXXXXXXXXXXXXXXXXXXXGXXXXXXXXXXXXXXXXXXXGXXXXXXXXXXXXXXXXXXX,0,300,0
29379,13,0,13,47,240,0,0,252,164,88,GXXXXXXXXXXXXXXXXXXXGXXXXXXXXXXXXXXXXXXXGXXXXXXXXXXXXXXXXXXXGXXXXXXXXXXXXXXXXXXXGXXXXXXXXXXXXXXXXXXXGXXXXXXXXXXXXXXXXXXXGXXXXXXXXXXXXXXXXXXXGXXXXXXXXXXXXXXXXXXXGXXXXXXXXXXXXXXXXXXXGXXXXXXXXXXXXXXXXXXXGXXXXXXXXXXXXXXXXXXXGXXXXXXXXXXXXXXXXXXXGXXXXXXXXXXXXXXXXXXX,0,300,0

29400,13,0,13,50,237,0,0,249,165,84,GXXXXXXXXXXXXXXXXXXXGXXXXXXXXXXXXXXXXXXXGXXXXXXXXXXXXXXXXXXXGXXXXXXXXXXXXXXXXXXXGXXXXXXXXXXXXXXXXXXXGXXXXXXXXXXXXXXXXXXXGXXXXXXXXXXXXXXXXXXXGXXXXXXXXXXXXXXXXXXXGXXXXXXXXXXXXXXXXXXXGXXXXXXXXXXXXXXXXXXXGXXXXXXXXXXXXXXXXXXXGXXXXXXXXXXXXXXXXXXXGXXXXXXXXXXXXXXXXXXX,0,300,0
29421,13,0,13,51,236,0,0,248,167,81,GXXXXXXXXXXXXXXXXXXXGXXXXXXXXXXXXXXXXXXXGXXXXXXXXXXXXXXXXXXXGXXXXXXXXXXXXXXXXXXXGXXXXXXXXXXXXXXXXXXXGXXXXXXXXXXXXXXXXXXXGXXXXXXXXXXXXXXXXXXXGXXXXXXXXXXXXXXXXXXXGXXXXXXXXXXXXXXXXXXXGXXXXXXXXXXXXXXXXXXXGXXXXXXXXXXXXXXXXXXXGXXXXXXXXXXXXXXXXXXXGXXXXXXXXXXXXXXXXXXX,0,300,0
29442,13,0,13,53,234,0,0,246,167,79,GXXXXXXXXXXXXXXXXXXXGXXXXXXXXXXXXXXXXXXXGXXXXXXXXXXXXXXXXXXXGXXXXXXXXXXXXXXXXXXXGXXXXXXXXXXXXXXXXXXXGXXXXXXXXXXXXXXXXXXXGXXXXXXXXXXXXXXXXXXXGXXXXXXXXXXXXXXXXXXXGXXXXXXXXXXXXXXXXXXXGXXXXXXXXXXXXXXXXXXXGXXXXXXXXXXXXXXXXXXXGXXXXXXXXXXXXXXXXXXXGXXXXXXXXXXXXXXXXXXX,0,300,0
29463,13,0,13,57,230,0,0,241,165,76,GXXXXXXXXXXXXXXXXXXXGXXXXXXXXXXXXXXXXXXXGXXXXXXXXXXXXXXXXXXXGXXXXXXXXXXXXXXXXXXXGXXXXXXXXXXXXXXXXXXXGXXXXXXXXXXXXXXXXXXXGXXXXXXXXXXXXXXXXXXXGXXXXXXXXXXXXXXXXXXXGXXXXXXXXXXXXXXXXXXXGXXXXXXXXXXXXXXXXXXXGXXXXXXXXXXXXXXXXXXXGXXXXXXXXXXXXXXXXXXXGXXXXXXXXXXXXXXXXXXX,0,300,0
29484,13,0,13,56,231,0,0,243,165,78,GXXXXXXXXXXXXXXXXXXXGXXXXXXXXXXXXXXXXXXXGXXXXXXXXXXXXXXXXXXXGXXXXXXXXXXXXXXXXXXXGXXXXXXXXXXXXXXXXXXXGXXXXXXXXXXXXXXXXXXXGXXXXXXXXXXXXXXXXXXXGXXXXXXXXXXXXXXXXXXXGXXXXXXXXXXXXXXXXXXXGXXXXXXXXXXXXXXXXXXXGXXXXXXXXXXXXXXXXXXXGXXXXXXXXXXXXXXXXXXXGXXXXXXXXXXXXXXXXXXX,0,300,0

29505,13,0,13,57,230,0,0,242,167,75,GXXXXXXXXXXXXXXXXXXXGXXXXXXXXXXXXXXXXXXXGXXXXXXXXXXXXXXXXXXXGXXXXXXXXXXXXXXXXXXXGXXXXXXXXXXXXXXXXXXXGXXXXXXXXXXXXXXXXXXXGXXXXXXXXXXXXXXXXXXXGXXXXXXXXXXXXXXXXXXXGXXXXXXXXXXXXXXXXXXXGXXXXXXXXXXXXXXXXXXXGXXXXXXXXXXXXXXXXXXXGXXXXXXXXXXXXXXXXXXXGXXXXXXXXXXXXXXXXXXX,0,300,0
29526,13,0,13,56,231,0,0,242,165,77,GXXXXXXXXXXXXXXXXXXXGXXXXXXXXXXXXXXXXXXXGXXXXXXXXXXXXXXXXXXXGXXXXXXXXXXXXXXXXXXXGXXXXXXXXXXXXXXXXXXXGXXXXXXXXXXXXXXXXXXXGXXXXXXXXXXXXXXXXXXXGXXXXXXXXXXXXXXXXXXXGXXXXXXXXXXXXXXXXXXXGXXXXXXXXXXXXXXXXXXXGXXXXXXXXXXXXXXXXXXXGXXXXXXXXXXXXXXXXXXXGXXXXXXXXXXXXXXXXXXX,0,300,0
29547,13,0,13,59,228,0,0,240,167,73,GXXXXXXXXXXXXXXXXXXXGXXXXXXXXXXXXXXXXXXXGXXXXXXXXXXXXXXXXXXXGXXXXXXXXXXXXXXXXXXXGXXXXXXXXXXXXXXXXXXXGXXXXXXXXXXXXXXXXXXXGXXXXXXXXXXXXXXXXXXXGXXXXXXXXXXXXXXXXXXXGXXXXXXXXXXXXXXXXXXXGXXXXXXXXXXXXXXXXXXXGXXXXXXXXXXXXXXXXXXXGXXXXXXXXXXXXXXXXXXXGXXXXXXXXXXXXXXXXXXX,0,300,0
29568,13,0,13,62,225,0,0,236,160,76,GXXXXXXXXXXXXXXXXXXXGXXXXXXXXXXXXXXXXXXXGXXXXXXXXXXXXXXXXXXXGXXXXXXXXXXXXXXXXXXXGXXXXXXXXXXXXXXXXXXXGXXXXXXXXXXXXXXXXXXXGXXXXXXXXXXXXXXXXXXXGXXXXXXXXXXXXXXXXXXXGXXXXXXXXXXXXXXXXXXXGXXXXXXXXXXXXXXXXXXXGXXXXXXXXXXXXXXXXXXXGXXXXXXXXXXXXXXXXXXXGXXXXXXXXXXXXXXXXXXX,0,300,0
29589,13,0,13,64,223,0,0,235,161,74,GXXXXXXXXXXXXXXXXXXXGXXXXXXXXXXXXXXXXXXXGXXXXXXXXXXXXXXXXXXXGXXXXXXXXXXXXXXXXXXXGXXXXXXXXXXXXXXXXXXXGXXXXXXXXXXXXXXXXXXXGXXXXXXXXXXXXXXXXXXXGXXXXXXXXXXXXXXXXXXXGXXXXXXXXXXXXXXXXXXXGXXXXXXXXXXXXXXXXXXXGXXXXXXXXXXXXXXXXXXXGXXXXXXXXXXXXXXXXXXXGXXXXXXXXXXXXXXXXXXX,0,300,0

29610,13,0,13,59,228,0,0,239,164,75,GXXXXXXXXXXXXXXXXXXXGXXXXXXXXXXXXXXXXXXXGXXXXXXXXXXXXXXXXXXXGXXXXXXXXXXXXXXXXXXXGXXXXXXXXXXXXXXXXXXXGXXXXXXXXXXXXXXXXXXXGXXXXXXXXXXXXXXXXXXXGXXXXXXXXXXXXXXXXXXXGXXXXXXXXXXXXXXXXXXXGXXXXXXXXXXXXXXXXXXXGXXXXXXXXXXXXXXXXXXXGXXXXXXXXXXXXXXXXXXXGXXXXXXXXXXXXXXXXXXX,0,300,0
29631,13,0,13,53,234,0,0,246,166,80,GXXXXXXXXXXXXXXXXXXXGXXXXXXXXXXXXXXXXXXXGXXXXXXXXXXXXXXXXXXXGXXXXXXXXXXXXXXXXXXXGXXXXXXXXXXXXXXXXXXXGXXXXXXXXXXXXXXXXXXXGXXXXXXXXXXXXXXXXXXXGXXXXXXXXXXXXXXXXXXXGXXXXXXXXXXXXXXXXXXXGXXXXXXXXXXXXXXXXXXXGXXXXXXXXXXXXXXXXXXXGXXXXXXXXXXXXXXXXXXXGXXXXXXXXXXXXXXXXXXX,0,300,0
29652,13,0,13,52,235,0,0,247,164,83,GXXXXXXXXXXXXXXXXXXXGXXXXXXXXXXXXXXXXXXXGXXXXXXXXXXXXXXXXXXXGXXXXXXXXXXXXXXXXXXXGXXXXXXXXXXXXXXXXXXXGXXXXXXXXXXXXXXXXXXXGXXXXXXXXXXXXXXXXXXXGXXXXXXXXXXXXXXXXXXXGXXXXXXXXXXXXXXXXXXXGXXXXXXXXXXXXXXXXXXXGXXXXXXXXXXXXXXXXXXXGXXXXXXXXXXXXXXXXXXXGXXXXXXXXXXXXXXXXXXX,0,300,0
29673,13,0,13,48,239,0,0,251,162,89,GXXXXXXXXXXXXXXXXXXXGXXXXXXXXXXXXXXXXXXXGXXXXXXXXXXXXXXXXXXXGXXXXXXXXXXXXXXXXXXXGXXXXXXXXXXXXXXXXXXXGXXXXXXXXXXXXXXXXXXXGXXXXXXXXXXXXXXXXXXXGXXXXXXXXXXXXXXXXXXXGXXXXXXXXXXXXXXXXXXXGXXXXXXXXXXXXXXXXXXXGXXXXXXXXXXXXXXXXXXXGXXXXXXXXXXXXXXXXXXXGXXXXXXXXXXXXXXXXXXX,0,300,0
29694,13,0,13,47,240,0,0,252,161,91,GXXXXXXXXXXXXXXXXXXXGXXXXXXXXXXXXXXXXXXXGXXXXXXXXXXXXXXXXXXXGXXXXXXXXXXXXXXXXXXXGXXXXXXXXXXXXXXXXXXXGXXXXXXXXXXXXXXXXXXXGXXXXXXXXXXXXXXXXXXXGXXXXXXXXXXXXXXXXXXXGXXXXXXXXXXXXXXXXXXXGXXXXXXXXXXXXXXXXXXXGXXXXXXXXXXXXXXXXXXXGXXXXXXXXXXXXXXXXXXXGXXXXXXXXXXXXXXXXXXX,0,300,0

29715,14,1,13,42,244,0,0,256,164,92,GXXXXXXXXXXXXXXXXXXXGXXXXXXXXXXXXXXXXXXXGXXXXXXXXXXXXXXXXXXXGAXXXXXXXXXXXXXXXXXXGXXXXXXXXXXXXXXXXXXXGXXXXXXXXXXXXXXXXXXXGXXXXXXXXXXXXXXXXXXXGXXXXXXXXXXXXXXXXXXXGXXXXXXXXXXXXXXXXXXXGXXXXXXXXXXXXXXXXXXXGXXXXXXXXXXXXXXXXXXXGXXXXXXXXXXXXXXXXXXXGXXXXXXXXXXXXXXXXXXX,0,300,0
29736,14,1,13,40,246,0,0,257,166,91,GXXXXXXXXXXXXXXXXXXXGXXXXXXXXXXXXXXXXXXXGXXXXXXXXXXXXXXXXXXXGAXXXXXXXXXXXXXXXXXXGXXXXXXXXXXXXXXXXXXXGXXXXXXXXXXXXXXXXXXXGXXXXXXXXXXXXXXXXXXXGXXXXXXXXXXXXXXXXXXXGXXXXXXXXXXXXXXXXXXXGXXXXXXXXXXXXXXXXXXXGXXXXXXXXXXXXXXXXXXXGXXXXXXXXXXXXXXXXXXXGXXXXXXXXXXXXXXXXXXX,0,300,0
29757,14,1,13,39,247,0,0,259,165,94,GXXXXXXXXXXXXXXXXXXXGXXXXXXXXXXXXXXXXXXXGXXXXXXXXXXXXXXXXXXXGAXXXXXXXXXXXXXXXXXXGXXXXXXXXXXXXXXXXXXXGXXXXXXXXXXXXXXXXXXXGXXXXXXXXXXXXXXXXXXXGXXXXXXXXXXXXXXXXXXXGXXXXXXXXXXXXXXXXXXXGXXXXXXXXXXXXXXXXXXXGXXXXXXXXXXXXXXXXXXXGXXXXXXXXXXXXXXXXXXXGXXXXXXXXXXXXXXXXXXX,0,300,0
29778,14,1,13,42,244,0,0,256,167,89,GXXXXXXXXXXXXXXXXXXXGXXXXXXXXXXXXXXXXXXXGXXXXXXXXXXXXXXXXXXXGAXXXXXXXXXXXXXXXXXXGXXXXXXXXXXXXXXXXXXXGXXXXXXXXXXXXXXXXXXXGXXXXXXXXXXXXXXXXXXXGXXXXXXXXXXXXXXXXXXXGXXXXXXXXXXXXXXXXXXXGXXXXXXXXXXXXXXXXXXXGXXXXXXXXXXXXXXXXXXXGXXXXXXXXXXXXXXXXXXXGXXXXXXXXXXXXXXXXXXX,0,300,0
29799,14,1,13,41,245,0,0,256,164,92,GXXXXXXXXXXXXXXXXXXXGXXXXXXXXXXXXXXXXXXXGXXXXXXXXXXXXXXXXXXXGAXXXXXXXXXXXXXXXXXXGXXXXXXXXXXXXXXXXXXXGXXXXXXXXXXXXXXXXXXXGXXXXXXXXXXXXXXXXXXXGXXXXXXXXXXXXXXXXXXXGXXXXXXXXXXXXXXXXXXXGXXXXXXXXXXXXXXXXXXXGXXXXXXXXXXXXXXXXXXXGXXXXXXXXXXXXXXXXXXXGXXXXXXXXXXXXXXXXXXX,0,300,0

29820,14,1,13,46,240,0,0,252,164,88,GXXXXXXXXXXXXXXXXXXXGXXXXXXXXXXXXXXXXXXXGXXXXXXXXXXXXXXXXXXXGAXXXXXXXXXXXXXXXXXXGXXXXXXXXXXXXXXXXXXXGXXXXXXXXXXXXXXXXXXXGXXXXXXXXXXXXXXXXXXXGXXXXXXXXXXXXXXXXXXXGXXXXXXXXXXXXXXXXXXXGXXXXXXXXXXXXXXXXXXXGXXXXXXXXXXXXXXXXXXXGXXXXXXXXXXXXXXXXXXXGXXXXXXXXXXXXXXXXXXX,0,300,0
29841,14,1,13,44,242,0,0,254,170,84,GXXXXXXXXXXXXXXXXXXXGXXXXXXXXXXXXXXXXXXXGXXXXXXXXXXXXXXXXXXXGAXXXXXXXXXXXXXXXXXXGXXXXXXXXXXXXXXXXXXXGXXXXXXXXXXXXXXXXXXXGXXXXXXXXXXXXXXXXXXXGXXXXXXXXXXXXXXXXXXXGXXXXXXXXXXXXXXXXXXXGXXXXXXXXXXXXXXXXXXXGXXXXXXXXXXXXXXXXXXXGXXXXXXXXXXXXXXXXXXXGXXXXXXXXXXXXXXXXXXX,0,300,0
29862,15,2,13,46,239,0,0,251,170,81,GXXXXXXXXXXXXXXXXXXXGXXXXXXXXXXXXXXXXXXXGXXXXXXXXXXXXXXXXXXXGAXXXXXXXXXXXXXXXXXXGXXXXXXXXXXXXXXXXXXXGAXXXXXXXXXXXXXXXXXXGXXXXXXXXXXXXXXXXXXXGXXXXXXXXXXXXXXXXXXXGXXXXXXXXXXXXXXXXXXXGXXXXXXXXXXXXXXXXXXXGXXXXXXXXXXXXXXXXXXXGXXXXXXXXXXXXXXXXXXXGXXXXXXXXXXXXXXXXXXX,0,300,0
29883,15,2,13,55,230,0,0,242,161,81,GXXXXXXXXXXXXXXXXXXXGXXXXXXXXXXXXXXXXXXXGXXXXXXXXXXXXXXXXXXXGAXXXXXXXXXXXXXXXXXXGXXXXXXXXXXXXXXXXXXXGAXXXXXXXXXXXXXXXXXXGXXXXXXXXXXXXXXXXXXXGXXXXXXXXXXXXXXXXXXXGXXXXXXXXXXXXXXXXXXXGXXXXXXXXXXXXXXXXXXXGXXXXXXXXXXXXXXXXXXXGXXXXXXXXXXXXXXXXXXXGXXXXXXXXXXXXXXXXXXX,0,300,0
29904,15,2,13,55,230,0,0,242,164,78,GXXXXXXXXXXXXXXXXXXXGXXXXXXXXXXXXXXXXXXXGXXXXXXXXXXXXXXXXXXXGAXXXXXXXXXXXXXXXXXXGXXXXXXXXXXXXXXXXXXXGAXXXXXXXXXXXXXXXXXXGXXXXXXXXXXXXXXXXXXXGXXXXXXXXXXXXXXXXXXXGXXXXXXXXXXXXXXXXXXXGXXXXXXXXXXXXXXXXXXXGXXXXXXXXXXXXXXXXXXXGXXXXXXXXXXXXXXXXXXXGXXXXXXXXXXXXXXXXXXX,0,300,0

29925,15,2,13,56,229,0,0,241,163,78,GXXXXXXXXXXXXXXXXXXXGXXXXXXXXXXXXXXXXXXXGXXXXXXXXXXXXXXXXXXXGAXXXXXXXXXXXXXXXXXXGXXXXXXXXXXXXXXXXXXXGAXXXXXXXXXXXXXXXXXXGXXXXXXXXXXXXXXXXXXXGXXXXXXXXXXXXXXXXXXXGXXXXXXXXXXXXXXXXXXXGXXXXXXXXXXXXXXXXXXXGXXXXXXXXXXXXXXXXXXXGXXXXXXXXXXXXXXXXXXXGXXXXXXXXXXXXXXXXXXX,0,300,0
29946,15,2,13,56,229,0,0,241,160,81,GXXXXXXXXXXXXXXXXXXXGXXXXXXXXXXXXXXXXXXXGXXXXXXXXXXXXXXXXXXXGAXXXXXXXXXXXXXXXXXXGXXXXXXXXXXXXXXXXXXXGAXXXXXXXXXXXXXXXXXXGXXXXXXXXXXXXXXXXXXXGXXXXXXXXXXXXXXXXXXXGXXXXXXXXXXXXXXXXXXXGXXXXXXXXXXXXXXXXXXXGXXXXXXXXXXXXXXXXXXXGXXXXXXXXXXXXXXXXXXXGXXXXXXXXXXXXXXXXXXX,0,300,0
29967,15,2,13,52,233,0,0,245,163,82,GXXXXXXXXXXXXXXXXXXXGXXXXXXXXXXXXXXXXXXXGXXXXXXXXXXXXXXXXXXXGAXXXXXXXXXXXXXXXXXXGXXXXXXXXXXXXXXXXXXXGAXXXXXXXXXXXXXXXXXXGXXXXXXXXXXXXXXXXXXXGXXXXXXXXXXXXXXXXXXXGXXXXXXXXXXXXXXXXXXXGXXXXXXXXXXXXXXXXXXXGXXXXXXXXXXXXXXXXXXXGXXXXXXXXXXXXXXXXXXXGXXXXXXXXXXXXXXXXXXX,0,300,0
29988,15,1,14,49,236,0,0,248,161,87,GXXXXXXXXXXXXXXXXXXXGXXXXXXXXXXXXXXXXXXXGXXXXXXXXXXXXXXXXXXXGAXXXXXXXXXXXXXXXXXXGXXXXXXXXXXXXXXXXXXXGOXXXXXXXXXXXXXXXXXXGXXXXXXXXXXXXXXXXXXXGXXXXXXXXXXXXXXXXXXXGXXXXXXXXXXXXXXXXXXXGXXXXXXXXXXXXXXXXXXXGXXXXXXXXXXXXXXXXXXXGXXXXXXXXXXXXXXXXXXXGXXXXXXXXXXXXXXXXXXX,0,300,0
30009,14,1,13,45,241,0,0,253,165,88,GXXXXXXXXXXXXXXXXXXXGXXXXXXXXXXXXXXXXXXXGXXXXXXXXXXXXXXXXXXXGAXXXXXXXXXXXXXXXXXXGXXXXXXXXXXXXXXXXXXXGXXXXXXXXXXXXXXXXXXXGXXXXXXXXXXXXXXXXXXXGXXXXXXXXXXXXXXXXXXXGXXXXXXXXXXXXXXXXXXXGXXXXXXXXXXXXXXXXXXXGXXXXXXXXXXXXXXXXXXXGXXXXXXXXXXXXXXXXXXXGXXXXXXXXXXXXXXXXXXX,0,300,0

30030,14,1,13,47,239,0,0,251,164,87,GXXXXXXXXXXXXXXXXXXXGXXXXXXXXXXXXXXXXXXXGXXXXXXXXXXXXXXXXXXXGAXXXXXXXXXXXXXXXXXXGXXXXXXXXXXXXXXXXXXXGXXXXXXXXXXXXXXXXXXXGXXXXXXXXXXXXXXXXXXXGXXXXXXXXXXXXXXXXXXXGXXXXXXXXXXXXXXXXXXXGXXXXXXXXXXXXXXXXXXXGXXXXXXXXXXXXXXXXXXXGXXXXXXXXXXXXXXXXXXXGXXXXXXXXXXXXXXXXXXX,0,300,0
30051,14,1,13,40,246,0,0,257,166,91,GXXXXXXXXXXXXXXXXXXXGXXXXXXXXXXXXXXXXXXXGXXXXXXXXXXXXXXXXXXXGAXXXXXXXXXXXXXXXXXXGXXXXXXXXXXXXXXXXXXXGXXXXXXXXXXXXXXXXXXXGXXXXXXXXXXXXXXXXXXXGXXXXXXXXXXXXXXXXXXXGXXXXXXXXXXXXXXXXXXXGXXXXXXXXXXXXXXXXXXXGXXXXXXXXXXXXXXXXXXXGXXXXXXXXXXXXXXXXXXXGXXXXXXXXXXXXXXXXXXX,0,300,0
30072,14,0,14,43,243,0,0,255,164,91,GXXXXXXXXXXXXXXXXXXXGXXXXXXXXXXXXXXXXXXXGXXXXXXXXXXXXXXXXXXXGOXXXXXXXXXXXXXXXXXXGXXXXXXXXXXXXXXXXXXXGXXXXXXXXXXXXXXXXXXXGXXXXXXXXXXXXXXXXXXXGXXXXXXXXXXXXXXXXXXXGXXXXXXXXXXXXXXXXXXXGXXXXXXXXXXXXXXXXXXXGXXXXXXXXXXXXXXXXXXXGXXXXXXXXXXXXXXXXXXXGXXXXXXXXXXXXXXXXXXX,0,300,0
30093,14,0,14,44,242,0,0,254,168,86,GXXXXXXXXXXXXXXXXXXXGXXXXXXXXXXXXXXXXXXXGXXXXXXXXXXXXXXXXXXXGOXXXXXXXXXXXXXXXXXXGXXXXXXXXXXXXXXXXXXXGXXXXXXXXXXXXXXXXXXXGXXXXXXXXXXXXXXXXXXXGXXXXXXXXXXXXXXXXXXXGXXXXXXXXXXXXXXXXXXXGXXXXXXXXXXXXXXXXXXXGXXXXXXXXXXXXXXXXXXXGXXXXXXXXXXXXXXXXXXXGXXXXXXXXXXXXXXXXXXX,0,300,0
30114,13,0,13,45,242,0,0,255,174,81,GXXXXXXXXXXXXXXXXXXXGXXXXXXXXXXXXXXXXXXXGXXXXXXXXXXXXXXXXXXXGXXXXXXXXXXXXXXXXXXXGXXXXXXXXXXXXXXXXXXXGXXXXXXXXXXXXXXXXXXXGXXXXXXXXXXXXXXXXXXXGXXXXXXXXXXXXXXXXXXXGXXXXXXXXXXXXXXXXXXXGXXXXXXXXXXXXXXXXXXXGXXXXXXXXXXXXXXXXXXXGXXXXXXXXXXXXXXXXXXXGXXXXXXXXXXXXXXXXXXX,0,300,0

30135,13,0,13,44,243,0,0,254,175,79,GXXXXXXXXXXXXXXXXXXXGXXXXXXXXXXXXXXXXXXXGXXXXXXXXXXXXXXXXXXXGXXXXXXXXXXXXXXXXXXXGXXXXXXXXXXXXXXXXXXXGXXXXXXXXXXXXXXXXXXXGXXXXXXXXXXXXXXXXXXXGXXXXXXXXXXXXXXXXXXXGXXXXXXXXXXXXXXXXXXXGXXXXXXXXXXXXXXXXXXXGXXXXXXXXXXXXXXXXXXXGXXXXXXXXXXXXXXXXXXXGXXXXXXXXXXXXXXXXXXX,0,300,0
30156,13,0,13,49,238,0,0,251,166,85,GXXXXXXXXXXXXXXXXXXXGXXXXXXXXXXXXXXXXXXXGXXXXXXXXXXXXXXXXXXXGXXXXXXXXXXXXXXXXXXXGXXXXXXXXXXXXXXXXXXXGXXXXXXXXXXXXXXXXXXXGXXXXXXXXXXXXXXXXXXXGXXXXXXXXXXXXXXXXXXXGXXXXXXXXXXXXXXXXXXXGXXXXXXXXXXXXXXXXXXXGXXXXXXXXXXXXXXXXXXXGXXXXXXXXXXXXXXXXXXXGXXXXXXXXXXXXXXXXXXX,0,300,0
30177,13,0,13,48,239,0,0,251,166,85,GXXXXXXXXXXXXXXXXXXXGXXXXXXXXXXXXXXXXXXXGXXXXXXXXXXXXXXXXXXXGXXXXXXXXXXXXXXXXXXXGXXXXXXXXXXXXXXXXXXXGXXXXXXXXXXXXXXXXXXXGXXXXXXXXXXXXXXXXXXXGXXXXXXXXXXXXXXXXXXXGXXXXXXXXXXXXXXXXXXXGXXXXXXXXXXXXXXXXXXXGXXXXXXXXXXXXXXXXXXXGXXXXXXXXXXXXXXXXXXXGXXXXXXXXXXXXXXXXXXX,0,300,0
30198,13,0,13,49,238,0,0,251,163,88,GXXXXXXXXXXXXXXXXXXXGXXXXXXXXXXXXXXXXXXXGXXXXXXXXXXXXXXXXXXXGXXXXXXXXXXXXXXXXXXXGXXXXXXXXXXXXXXXXXXXGXXXXXXXXXXXXXXXXXXXGXXXXXXXXXXXXXXXXXXXGXXXXXXXXXXXXXXXXXXXGXXXXXXXXXXXXXXXXXXXGXXXXXXXXXXXXXXXXXXXGXXXXXXXXXXXXXXXXXXXGXXXXXXXXXXXXXXXXXXXGXXXXXXXXXXXXXXXXXXX,0,300,0
30219,13,0,13,51,236,0,0,249,160,89,GXXXXXXXXXXXXXXXXXXXGXXXXXXXXXXXXXXXXXXXGXXXXXXXXXXXXXXXXXXXGXXXXXXXXXXXXXXXXXXXGXXXXXXXXXXXXXXXXXXXGXXXXXXXXXXXXXXXXXXXGXXXXXXXXXXXXXXXXXXXGXXXXXXXXXXXXXXXXXXXGXXXXXXXXXXXXXXXXXXXGXXXXXXXXXXXXXXXXXXXGXXXXXXXXXXXXXXXXXXXGXXXXXXXXXXXXXXXXXXXGXXXXXXXXXXXXXXXXXXX,0,300,0

30240,13,0,13,47,240,0,0,251,159,92,GXXXXXXXXXXXXXXXXXXXGXXXXXXXXXXXXXXXXXXXGXXXXXXXXXXXXXXXXXXXGXXXXXXXXXXXXXXXXXXXGXXXXXXXXXXXXXXXXXXXGXXXXXXXXXXXXXXXXXXXGXXXXXXXXXXXXXXXXXXXGXXXXXXXXXXXXXXXXXXXGXXXXXXXXXXXXXXXXXXXGXXXXXXXXXXXXXXXXXXXGXXXXXXXXXXXXXXXXXXXGXXXXXXXXXXXXXXXXXXXGXXXXXXXXXXXXXXXXXXX,0,300,0
30261,13,0,13,46,241,0,0,253,162,91,GXXXXXXXXXXXXXXXXXXXGXXXXXXXXXXXXXXXXXXXGXXXXXXXXXXXXXXXXXXXGXXXXXXXXXXXXXXXXXXXGXXXXXXXXXXXXXXXXXXXGXXXXXXXXXXXXXXXXXXXGXXXXXXXXXXXXXXXXXXXGXXXXXXXXXXXXXXXXXXXGXXXXXXXXXXXXXXXXXXXGXXXXXXXXXXXXXXXXXXXGXXXXXXXXXXXXXXXXXXXGXXXXXXXXXXXXXXXXXXXGXXXXXXXXXXXXXXXXXXX,0,300,0
30282,13,0,13,45,242,0,0,254,164,90,GXXXXXXXXXXXXXXXXXXXGXXXXXXXXXXXXXXXXXXXGXXXXXXXXXXXXXXXXXXXGXXXXXXXXXXXXXXXXXXXGXXXXXXXXXXXXXXXXXXXGXXXXXXXXXXXXXXXXXXXGXXXXXXXXXXXXXXXXXXXGXXXXXXXXXXXXXXXXXXXGXXXXXXXXXXXXXXXXXXXGXXXXXXXXXXXXXXXXXXXGXXXXXXXXXXXXXXXXXXXGXXXXXXXXXXXXXXXXXXXGXXXXXXXXXXXXXXXXXXX,0,300,0
30303,13,0,13,48,239,0,0,251,167,84,GXXXXXXXXXXXXXXXXXXXGXXXXXXXXXXXXXXXXXXXGXXXXXXXXXXXXXXXXXXXGXXXXXXXXXXXXXXXXXXXGXXXXXXXXXXXXXXXXXXXGXXXXXXXXXXXXXXXXXXXGXXXXXXXXXXXXXXXXXXXGXXXXXXXXXXXXXXXXXXXGXXXXXXXXXXXXXXXXXXXGXXXXXXXXXXXXXXXXXXXGXXXXXXXXXXXXXXXXXXXGXXXXXXXXXXXXXXXXXXXGXXXXXXXXXXXXXXXXXXX,0,300,0
30324,13,0,13,54,233,0,0,245,163,82,GXXXXXXXXXXXXXXXXXXXGXXXXXXXXXXXXXXXXXXXGXXXXXXXXXXXXXXXXXXXGXXXXXXXXXXXXXXXXXXXGXXXXXXXXXXXXXXXXXXXGXXXXXXXXXXXXXXXXXXXGXXXXXXXXXXXXXXXXXXXGXXXXXXXXXXXXXXXXXXXGXXXXXXXXXXXXXXXXXXXGXXXXXXXXXXXXXXXXXXXGXXXXXXXXXXXXXXXXXXXGXXXXXXXXXXXXXXXXXXXGXXXXXXXXXXXXXXXXXXX,0,300,0

30345,13,0,13,56,231,0,0,243,164,79,GXXXXXXXXXXXXXXXXXXXGXXXXXXXXXXXXXXXXXXXGXXXXXXXXXXXXXXXXXXXGXXXXXXXXXXXXXXXXXXXGXXXXXXXXXXXXXXXXXXXGXXXXXXXXXXXXXXXXXXXGXXXXXXXXXXXXXXXXXXXGXXXXXXXXXXXXXXXXXXXGXXXXXXXXXXXXXXXXXXXGXXXXXXXXXXXXXXXXXXXGXXXXXXXXXXXXXXXXXXXGXXXXXXXXXXXXXXXXXXXGXXXXXXXXXXXXXXXXXXX,0,300,0
30366,13,0,13,55,232,0,0,244,167,77,GXXXXXXXXXXXXXXXXXXXGXXXXXXXXXXXXXXXXXXXGXXXXXXXXXXXXXXXXXXXGXXXXXXXXXXXXXXXXXXXGXXXXXXXXXXXXXXXXXXXGXXXXXXXXXXXXXXXXXXXGXXXXXXXXXXXXXXXXXXXGXXXXXXXXXXXXXXXXXXXGXXXXXXXXXXXXXXXXXXXGXXXXXXXXXXXXXXXXXXXGXXXXXXXXXXXXXXXXXXXGXXXXXXXXXXXXXXXXXXXGXXXXXXXXXXXXXXXXXXX,0,300,0
30387,13,0,13,51,236,0,0,248,171,77,GXXXXXXXXXXXXXXXXXXXGXXXXXXXXXXXXXXXXXXXGXXXXXXXXXXXXXXXXXXXGXXXXXXXXXXXXXXXXXXXGXXXXXXXXXXXXXXXXXXXGXXXXXXXXXXXXXXXXXXXGXXXXXXXXXXXXXXXXXXXGXXXXXXXXXXXXXXXXXXXGXXXXXXXXXXXXXXXXXXXGXXXXXXXXXXXXXXXXXXXGXXXXXXXXXXXXXXXXXXXGXXXXXXXXXXXXXXXXXXXGXXXXXXXXXXXXXXXXXXX,0,300,0
30408,13,0,13,49,238,0,0,250,166,84,GXXXXXXXXXXXXXXXXXXXGXXXXXXXXXXXXXXXXXXXGXXXXXXXXXXXXXXXXXXXGXXXXXXXXXXXXXXXXXXXGXXXXXXXXXXXXXXXXXXXGXXXXXXXXXXXXXXXXXXXGXXXXXXXXXXXXXXXXXXXGXXXXXXXXXXXXXXXXXXXGXXXXXXXXXXXXXXXXXXXGXXXXXXXXXXXXXXXXXXXGXXXXXXXXXXXXXXXXXXXGXXXXXXXXXXXXXXXXXXXGXXXXXXXXXXXXXXXXXXX,0,300,0
30429,13,0,13,45,242,0,0,253,165,88,GXXXXXXXXXXXXXXXXXXXGXXXXXXXXXXXXXXXXXXXGXXXXXXXXXXXXXXXXXXXGXXXXXXXXXXXXXXXXXXXGXXXXXXXXXXXXXXXXXXXGXXXXXXXXXXXXXXXXXXXGXXXXXXXXXXXXXXXXXXXGXXXXXXXXXXXXXXXXXXXGXXXXXXXXXXXXXXXXXXXGXXXXXXXXXXXXXXXXXXXGXXXXXXXXXXXXXXXXXXXGXXXXXXXXXXXXXXXXXXXGXXXXXXXXXXXXXXXXXXX,0,300,0

30450,13,0,13,43,244,0,0,256,171,85,GXXXXXXXXXXXXXXXXXXXGXXXXXXXXXXXXXXXXXXXGXXXXXXXXXXXXXXXXXXXGXXXXXXXXXXXXXXXXXXXGXXXXXXXXXXXXXXXXXXXGXXXXXXXXXXXXXXXXXXXGXXXXXXXXXXXXXXXXXXXGXXXXXXXXXXXXXXXXXXXGXXXXXXXXXXXXXXXXXXXGXXXXXXXXXXXXXXXXXXXGXXXXXXXXXXXXXXXXXXXGXXXXXXXXXXXXXXXXXXXGXXXXXXXXXXXXXXXXXXX,0,300,0
30471,13,0,13,46,241,0,0,254,167,87,GXXXXXXXXXXXXXXXXXXXGXXXXXXXXXXXXXXXXXXXGXXXXXXXXXXXXXXXXXXXGXXXXXXXXXXXXXXXXXXXGXXXXXXXXXXXXXXXXXXXGXXXXXXXXXXXXXXXXXXXGXXXXXXXXXXXXXXXXXXXGXXXXXXXXXXXXXXXXXXXGXXXXXXXXXXXXXXXXXXXGXXXXXXXXXXXXXXXXXXXGXXXXXXXXXXXXXXXXXXXGXXXXXXXXXXXXXXXXXXXGXXXXXXXXXXXXXXXXXXX,0,300,0
30492,13,0,13,41,246,0,0,259,168,91,GXXXXXXXXXXXXXXXXXXXGXXXXXXXXXXXXXXXXXXXGXXXXXXXXXXXXXXXXXXXGXXXXXXXXXXXXXXXXXXXGXXXXXXXXXXXXXXXXXXXGXXXXXXXXXXXXXXXXXXXGXXXXXXXXXXXXXXXXXXXGXXXXXXXXXXXXXXXXXXXGXXXXXXXXXXXXXXXXXXXGXXXXXXXXXXXXXXXXXXXGXXXXXXXXXXXXXXXXXXXGXXXXXXXXXXXXXXXXXXXGXXXXXXXXXXXXXXXXXXX,0,300,0
30513,14,1,13,42,244,0,0,257,168,89,GXXXXXXXXXXXXXXXXXXXGXXXXXXXXXXXXXXXXXXXGXXXXXXXXXXXXXXXXXXXGXXXXXXXXXXXXXXXXXXXGXXXXXXXXXXXXXXXXXXXGXXXXXXXXXXXXXXXXXXXGXXXXXXXXXXXXXXXXXXXGAXXXXXXXXXXXXXXXXXXGXXXXXXXXXXXXXXXXXXXGXXXXXXXXXXXXXXXXXXXGXXXXXXXXXXXXXXXXXXXGXXXXXXXXXXXXXXXXXXXGXXXXXXXXXXXXXXXXXXX,0,300,0
30534,14,1,13,45,241,0,0,253,164,89,GXXXXXXXXXXXXXXXXXXXGXXXXXXXXXXXXXXXXXXXGXXXXXXXXXXXXXXXXXXXGXXXXXXXXXXXXXXXXXXXGXXXXXXXXXXXXXXXXXXXGXXXXXXXXXXXXXXXXXXXGXXXXXXXXXXXXXXXXXXXGAXXXXXXXXXXXXXXXXXXGXXXXXXXXXXXXXXXXXXXGXXXXXXXXXXXXXXXXXXXGXXXXXXXXXXXXXXXXXXXGXXXXXXXXXXXXXXXXXXXGXXXXXXXXXXXXXXXXXXX,0,300,0

30555,14,1,13,44,242,0,0,255,166,89,GXXXXXXXXXXXXXXXXXXXGXXXXXXXXXXXXXXXXXXXGXXXXXXXXXXXXXXXXXXXGXXXXXXXXXXXXXXXXXXXGXXXXXXXXXXXXXXXXXXXGXXXXXXXXXXXXXXXXXXXGXXXXXXXXXXXXXXXXXXXGAXXXXXXXXXXXXXXXXXXGXXXXXXXXXXXXXXXXXXXGXXXXXXXXXXXXXXXXXXXGXXXXXXXXXXXXXXXXXXXGXXXXXXXXXXXXXXXXXXXGXXXXXXXXXXXXXXXXXXX,0,300,0
30576,14,1,13,45,241,0,0,254,168,86,GXXXXXXXXXXXXXXXXXXXGXXXXXXXXXXXXXXXXXXXGXXXXXXXXXXXXXXXXXXXGXXXXXXXXXXXXXXXXXXXGXXXXXXXXXXXXXXXXXXXGXXXXXXXXXXXXXXXXXXXGXXXXXXXXXXXXXXXXXXXGAXXXXXXXXXXXXXXXXXXGXXXXXXXXXXXXXXXXXXXGXXXXXXXXXXXXXXXXXXXGXXXXXXXXXXXXXXXXXXXGXXXXXXXXXXXXXXXXXXXGXXXXXXXXXXXXXXXXXXX,0,300,0
30597,14,1,13,49,237,0,0,250,163,87,GXXXXXXXXXXXXXXXXXXXGXXXXXXXXXXXXXXXXXXXGXXXXXXXXXXXXXXXXXXXGXXXXXXXXXXXXXXXXXXXGXXXXXXXXXXXXXXXXXXXGXXXXXXXXXXXXXXXXXXXGXXXXXXXXXXXXXXXXXXXGAXXXXXXXXXXXXXXXXXXGXXXXXXXXXXXXXXXXXXXGXXXXXXXXXXXXXXXXXXXGXXXXXXXXXXXXXXXXXXXGXXXXXXXXXXXXXXXXXXXGXXXXXXXXXXXXXXXXXXX,0,300,0
30618,14,1,13,50,236,0,0,249,165,84,GXXXXXXXXXXXXXXXXXXXGXXXXXXXXXXXXXXXXXXXGXXXXXXXXXXXXXXXXXXXGXXXXXXXXXXXXXXXXXXXGXXXXXXXXXXXXXXXXXXXGXXXXXXXXXXXXXXXXXXXGXXXXXXXXXXXXXXXXXXXGAXXXXXXXXXXXXXXXXXXGXXXXXXXXXXXXXXXXXXXGXXXXXXXXXXXXXXXXXXXGXXXXXXXXXXXXXXXXXXXGXXXXXXXXXXXXXXXXXXXGXXXXXXXXXXXXXXXXXXX,0,300,0
30639,14,1,13,47,239,0,0,252,166,86,GXXXXXXXXXXXXXXXXXXXGXXXXXXXXXXXXXXXXXXXGXXXXXXXXXXXXXXXXXXXGXXXXXXXXXXXXXXXXXXXGXXXXXXXXXXXXXXXXXXXGXXXXXXXXXXXXXXXXXXXGXXXXXXXXXXXXXXXXXXXGAXXXXXXXXXXXXXXXXXXGXXXXXXXXXXXXXXXXXXXGXXXXXXXXXXXXXXXXXXXGXXXXXXXXXXXXXXXXXXXGXXXXXXXXXXXXXXXXXXXGXXXXXXXXXXXXXXXXXXX,0,300,0

30660,14,1,13,44,242,0,0,255,167,88,GXXXXXXXXXXXXXXXXXXXGXXXXXXXXXXXXXXXXXXXGXXXXXXXXXXXXXXXXXXXGXXXXXXXXXXXXXXXXXXXGXXXXXXXXXXXXXXXXXXXGXXXXXXXXXXXXXXXXXXXGXXXXXXXXXXXXXXXXXXXGAXXXXXXXXXXXXXXXXXXGXXXXXXXXXXXXXXXXXXXGXXXXXXXXXXXXXXXXXXXGXXXXXXXXXXXXXXXXXXXGXXXXXXXXXXXXXXXXXXXGXXXXXXXXXXXXXXXXXXX,0,300,0
30681,14,1,13,44,242,0,0,254,166,88,GXXXXXXXXXXXXXXXXXXXGXXXXXXXXXXXXXXXXXXXGXXXXXXXXXXXXXXXXXXXGXXXXXXXXXXXXXXXXXXXGXXXXXXXXXXXXXXXXXXXGXXXXXXXXXXXXXXXXXXXGXXXXXXXXXXXXXXXXXXXGAXXXXXXXXXXXXXXXXXXGXXXXXXXXXXXXXXXXXXXGXXXXXXXXXXXXXXXXXXXGXXXXXXXXXXXXXXXXXXXGXXXXXXXXXXXXXXXXXXXGXXXXXXXXXXXXXXXXXXX,0,300,0
30702,14,1,13,44,242,0,0,255,165,90,GXXXXXXXXXXXXXXXXXXXGXXXXXXXXXXXXXXXXXXXGXXXXXXXXXXXXXXXXXXXGXXXXXXXXXXXXXXXXXXXGXXXXXXXXXXXXXXXXXXXGXXXXXXXXXXXXXXXXXXXGXXXXXXXXXXXXXXXXXXXGAXXXXXXXXXXXXXXXXXXGXXXXXXXXXXXXXXXXXXXGXXXXXXXXXXXXXXXXXXXGXXXXXXXXXXXXXXXXXXXGXXXXXXXXXXXXXXXXXXXGXXXXXXXXXXXXXXXXXXX,0,300,0
30723,13,0,13,41,246,0,0,258,166,92,GXXXXXXXXXXXXXXXXXXXGXXXXXXXXXXXXXXXXXXXGXXXXXXXXXXXXXXXXXXXGXXXXXXXXXXXXXXXXXXXGXXXXXXXXXXXXXXXXXXXGXXXXXXXXXXXXXXXXXXXGXXXXXXXXXXXXXXXXXXXGXXXXXXXXXXXXXXXXXXXGXXXXXXXXXXXXXXXXXXXGXXXXXXXXXXXXXXXXXXXGXXXXXXXXXXXXXXXXXXXGXXXXXXXXXXXXXXXXXXXGXXXXXXXXXXXXXXXXXXX,0,300,0
30744,13,0,13,46,241,0,0,253,167,86,GXXXXXXXXXXXXXXXXXXXGXXXXXXXXXXXXXXXXXXXGXXXXXXXXXXXXXXXXXXXGXXXXXXXXXXXXXXXXXXXGXXXXXXXXXXXXXXXXXXXGXXXXXXXXXXXXXXXXXXXGXXXXXXXXXXXXXXXXXXXGXXXXXXXXXXXXXXXXXXXGXXXXXXXXXXXXXXXXXXXGXXXXXXXXXXXXXXXXXXXGXXXXXXXXXXXXXXXXXXXGXXXXXXXXXXXXXXXXXXXGXXXXXXXXXXXXXXXXXXX,0,300,0

30765,13,0,13,48,239,0,0,251,167,84,GXXXXXXXXXXXXXXXXXXXGXXXXXXXXXXXXXXXXXXXGXXXXXXXXXXXXXXXXXXXGXXXXXXXXXXXXXXXXXXXGXXXXXXXXXXXXXXXXXXXGXXXXXXXXXXXXXXXXXXXGXXXXXXXXXXXXXXXXXXXGXXXXXXXXXXXXXXXXXXXGXXXXXXXXXXXXXXXXXXXGXXXXXXXXXXXXXXXXXXXGXXXXXXXXXXXXXXXXXXXGXXXXXXXXXXXXXXXXXXXGXXXXXXXXXXXXXXXXXXX,0,300,0
30786,13,0,13,46,241,0,0,253,165,88,GXXXXXXXXXXXXXXXXXXXGXXXXXXXXXXXXXXXXXXXGXXXXXXXXXXXXXXXXXXXGXXXXXXXXXXXXXXXXXXXGXXXXXXXXXXXXXXXXXXXGXXXXXXXXXXXXXXXXXXXGXXXXXXXXXXXXXXXXXXXGXXXXXXXXXXXXXXXXXXXGXXXXXXXXXXXXXXXXXXXGXXXXXXXXXXXXXXXXXXXGXXXXXXXXXXXXXXXXXXXGXXXXXXXXXXXXXXXXXXXGXXXXXXXXXXXXXXXXXXX,0,300,0
30807,13,0,13,43,244,0,0,255,168,87,GXXXXXXXXXXXXXXXXXXXGXXXXXXXXXXXXXXXXXXXGXXXXXXXXXXXXXXXXXXXGXXXXXXXXXXXXXXXXXXXGXXXXXXXXXXXXXXXXXXXGXXXXXXXXXXXXXXXXXXXGXXXXXXXXXXXXXXXXXXXGXXXXXXXXXXXXXXXXXXXGXXXXXXXXXXXXXXXXXXXGXXXXXXXXXXXXXXXXXXXGXXXXXXXXXXXXXXXXXXXGXXXXXXXXXXXXXXXXXXXGXXXXXXXXXXXXXXXXXXX,0,300,0
30828,13,0,13,43,244,0,0,256,168,88,GXXXXXXXXXXXXXXXXXXXGXXXXXXXXXXXXXXXXXXXGXXXXXXXXXXXXXXXXXXXGXXXXXXXXXXXXXXXXXXXGXXXXXXXXXXXXXXXXXXXGXXXXXXXXXXXXXXXXXXXGXXXXXXXXXXXXXXXXXXXGXXXXXXXXXXXXXXXXXXXGXXXXXXXXXXXXXXXXXXXGXXXXXXXXXXXXXXXXXXXGXXXXXXXXXXXXXXXXXXXGXXXXXXXXXXXXXXXXXXXGXXXXXXXXXXXXXXXXXXX,0,300,0
30849,13,0,13,45,242,0,0,254,167,87,GXXXXXXXXXXXXXXXXXXXGXXXXXXXXXXXXXXXXXXXGXXXXXXXXXXXXXXXXXXXGXXXXXXXXXXXXXXXXXXXGXXXXXXXXXXXXXXXXXXXGXXXXXXXXXXXXXXXXXXXGXXXXXXXXXXXXXXXXXXXGXXXXXXXXXXXXXXXXXXXGXXXXXXXXXXXXXXXXXXXGXXXXXXXXXXXXXXXXXXXGXXXXXXXXXXXXXXXXXXXGXXXXXXXXXXXXXXXXXXXGXXXXXXXXXXXXXXXXXXX,0,300,0

30870,13,0,13,45,242,0,0,254,168,86,GXXXXXXXXXXXXXXXXXXXGXXXXXXXXXXXXXXXXXXXGXXXXXXXXXXXXXXXXXXXGXXXXXXXXXXXXXXXXXXXGXXXXXXXXXXXXXXXXXXXGXXXXXXXXXXXXXXXXXXXGXXXXXXXXXXXXXXXXXXXGXXXXXXXXXXXXXXXXXXXGXXXXXXXXXXXXXXXXXXXGXXXXXXXXXXXXXXXXXXXGXXXXXXXXXXXXXXXXXXXGXXXXXXXXXXXXXXXXXXXGXXXXXXXXXXXXXXXXXXX,0,300,0
30891,13,0,13,45,242,0,0,254,169,85,GXXXXXXXXXXXXXXXXXXXGXXXXXXXXXXXXXXXXXXXGXXXXXXXXXXXXXXXXXXXGXXXXXXXXXXXXXXXXXXXGXXXXXXXXXXXXXXXXXXXGXXXXXXXXXXXXXXXXXXXGXXXXXXXXXXXXXXXXXXXGXXXXXXXXXXXXXXXXXXXGXXXXXXXXXXXXXXXXXXXGXXXXXXXXXXXXXXXXXXXGXXXXXXXXXXXXXXXXXXXGXXXXXXXXXXXXXXXXXXXGXXXXXXXXXXXXXXXXXXX,0,300,0
30912,13,0,13,46,241,0,0,253,175,78,GXXXXXXXXXXXXXXXXXXXGXXXXXXXXXXXXXXXXXXXGXXXXXXXXXXXXXXXXXXXGXXXXXXXXXXXXXXXXXXXGXXXXXXXXXXXXXXXXXXXGXXXXXXXXXXXXXXXXXXXGXXXXXXXXXXXXXXXXXXXGXXXXXXXXXXXXXXXXXXXGXXXXXXXXXXXXXXXXXXXGXXXXXXXXXXXXXXXXXXXGXXXXXXXXXXXXXXXXXXXGXXXXXXXXXXXXXXXXXXXGXXXXXXXXXXXXXXXXXXX,0,300,0
30933,13,0,13,46,241,0,0,253,174,79,GXXXXXXXXXXXXXXXXXXXGXXXXXXXXXXXXXXXXXXXGXXXXXXXXXXXXXXXXXXXGXXXXXXXXXXXXXXXXXXXGXXXXXXXXXXXXXXXXXXXGXXXXXXXXXXXXXXXXXXXGXXXXXXXXXXXXXXXXXXXGXXXXXXXXXXXXXXXXXXXGXXXXXXXXXXXXXXXXXXXGXXXXXXXXXXXXXXXXXXXGXXXXXXXXXXXXXXXXXXXGXXXXXXXXXXXXXXXXXXXGXXXXXXXXXXXXXXXXXXX,0,300,0
30954,13,0,13,48,239,0,0,251,170,81,GXXXXXXXXXXXXXXXXXXXGXXXXXXXXXXXXXXXXXXXGXXXXXXXXXXXXXXXXXXXGXXXXXXXXXXXXXXXXXXXGXXXXXXXXXXXXXXXXXXXGXXXXXXXXXXXXXXXXXXXGXXXXXXXXXXXXXXXXXXXGXXXXXXXXXXXXXXXXXXXGXXXXXXXXXXXXXXXXXXXGXXXXXXXXXXXXXXXXXXXGXXXXXXXXXXXXXXXXXXXGXXXXXXXXXXXXXXXXXXXGXXXXXXXXXXXXXXXXXXX,0,300,0

30975,13,0,13,53,234,0,0,247,171,76,GXXXXXXXXXXXXXXXXXXXGXXXXXXXXXXXXXXXXXXXGXXXXXXXXXXXXXXXXXXXGXXXXXXXXXXXXXXXXXXXGXXXXXXXXXXXXXXXXXXXGXXXXXXXXXXXXXXXXXXXGXXXXXXXXXXXXXXXXXXXGXXXXXXXXXXXXXXXXXXXGXXXXXXXXXXXXXXXXXXXGXXXXXXXXXXXXXXXXXXXGXXXXXXXXXXXXXXXXXXXGXXXXXXXXXXXXXXXXXXXGXXXXXXXXXXXXXXXXXXX,0,300,0
30996,14,1,13,52,234,0,0,247,167,80,GXXXXXXXXXXXXXXXXXXXGXXXXXXXXXXXXXXXXXXXGXXXXXXXXXXXXXXXXXXXGXXXXXXXXXXXXXXXXXXXGXXXXXXXXXXXXXXXXXXXGXXXXXXXXXXXXXXXXXXXGXXXXXXXXXXXXXXXXXXXGXXXXXXXXXXXXXXXXXXXGXXXXXXXXXXXXXXXXXXXGXXXXXXXXXXXXXXXXXXXGAXXXXXXXXXXXXXXXXXXGXXXXXXXXXXXXXXXXXXXGXXXXXXXXXXXXXXXXXXX,0,300,0
31017,13,0,13,50,237,0,0,250,168,82,GXXXXXXXXXXXXXXXXXXXGXXXXXXXXXXXXXXXXXXXGXXXXXXXXXXXXXXXXXXXGXXXXXXXXXXXXXXXXXXXGXXXXXXXXXXXXXXXXXXXGXXXXXXXXXXXXXXXXXXXGXXXXXXXXXXXXXXXXXXXGXXXXXXXXXXXXXXXXXXXGXXXXXXXXXXXXXXXXXXXGXXXXXXXXXXXXXXXXXXXGXXXXXXXXXXXXXXXXXXXGXXXXXXXXXXXXXXXXXXXGXXXXXXXXXXXXXXXXXXX,0,300,0
31038,13,0,13,46,241,0,0,254,168,86,GXXXXXXXXXXXXXXXXXXXGXXXXXXXXXXXXXXXXXXXGXXXXXXXXXXXXXXXXXXXGXXXXXXXXXXXXXXXXXXXGXXXXXXXXXXXXXXXXXXXGXXXXXXXXXXXXXXXXXXXGXXXXXXXXXXXXXXXXXXXGXXXXXXXXXXXXXXXXXXXGXXXXXXXXXXXXXXXXXXXGXXXXXXXXXXXXXXXXXXXGXXXXXXXXXXXXXXXXXXXGXXXXXXXXXXXXXXXXXXXGXXXXXXXXXXXXXXXXXXX,0,300,0
31059,14,1,13,43,243,0,0,256,170,86,GXXXXXXXXXXXXXXXXXXXGXXXXXXXXXXXXXXXXXXXGXXXXXXXXXXXXXXXXXXXGXXXXXXXXXXXXXXXXXXXGXXXXXXXXXXXXXXXXXXXGXXXXXXXXXXXXXXXXXXXGXXXXXXXXXXXXXXXXXXXGAXXXXXXXXXXXXXXXXXXGXXXXXXXXXXXXXXXXXXXGXXXXXXXXXXXXXXXXXXXGXXXXXXXXXXXXXXXXXXXGXXXXXXXXXXXXXXXXXXXGXXXXXXXXXXXXXXXXXXX,0,300,0

31080,15,2,13,43,242,0,0,255,168,87,GXXXXXXXXXXXXXXXXXXXGXXXXXXXXXXXXXXXXXXXGXXXXXXXXXXXXXXXXXXXGXXXXXXXXXXXXXXXXXXXGXXXXXXXXXXXXXXXXXXXGXXXXXXXXXXXXXXXXXXXGAXXXXXXXXXXXXXXXXXXGAXXXXXXXXXXXXXXXXXXGXXXXXXXXXXXXXXXXXXXGXXXXXXXXXXXXXXXXXXXGXXXXXXXXXXXXXXXXXXXGXXXXXXXXXXXXXXXXXXXGXXXXXXXXXXXXXXXXXXX,0,300,0
31101,15,2,13,44,241,0,0,252,170,82,GXXXXXXXXXXXXXXXXXXXGXXXXXXXXXXXXXXXXXXXGXXXXXXXXXXXXXXXXXXXGXXXXXXXXXXXXXXXXXXXGXXXXXXXXXXXXXXXXXXXGXXXXXXXXXXXXXXXXXXXGAXXXXXXXXXXXXXXXXXXGAXXXXXXXXXXXXXXXXXXGXXXXXXXXXXXXXXXXXXXGXXXXXXXXXXXXXXXXXXXGXXXXXXXXXXXXXXXXXXXGXXXXXXXXXXXXXXXXXXXGXXXXXXXXXXXXXXXXXXX,0,300,0
31122,15,1,14,40,245,0,0,257,171,86,GXXXXXXXXXXXXXXXXXXXGXXXXXXXXXXXXXXXXXXXGXXXXXXXXXXXXXXXXXXXGXXXXXXXXXXXXXXXXXXXGXXXXXXXXXXXXXXXXXXXGXXXXXXXXXXXXXXXXXXXGAXXXXXXXXXXXXXXXXXXGOXXXXXXXXXXXXXXXXXXGXXXXXXXXXXXXXXXXXXXGXXXXXXXXXXXXXXXXXXXGXXXXXXXXXXXXXXXXXXXGXXXXXXXXXXXXXXXXXXXGXXXXXXXXXXXXXXXXXXX,0,300,0
31143,15,1,14,42,243,0,0,255,173,82,GXXXXXXXXXXXXXXXXXXXGXXXXXXXXXXXXXXXXXXXGXXXXXXXXXXXXXXXXXXXGXXXXXXXXXXXXXXXXXXXGXXXXXXXXXXXXXXXXXXXGXXXXXXXXXXXXXXXXXXXGAXXXXXXXXXXXXXXXXXXGOXXXXXXXXXXXXXXXXXXGXXXXXXXXXXXXXXXXXXXGXXXXXXXXXXXXXXXXXXXGXXXXXXXXXXXXXXXXXXXGXXXXXXXXXXXXXXXXXXXGXXXXXXXXXXXXXXXXXXX,0,300,0
31164,14,1,13,40,246,0,0,258,174,84,GXXXXXXXXXXXXXXXXXXXGXXXXXXXXXXXXXXXXXXXGXXXXXXXXXXXXXXXXXXXGXXXXXXXXXXXXXXXXXXXGXXXXXXXXXXXXXXXXXXXGXXXXXXXXXXXXXXXXXXXGAXXXXXXXXXXXXXXXXXXGXXXXXXXXXXXXXXXXXXXGXXXXXXXXXXXXXXXXXXXGXXXXXXXXXXXXXXXXXXXGXXXXXXXXXXXXXXXXXXXGXXXXXXXXXXXXXXXXXXXGXXXXXXXXXXXXXXXXXXX,0,300,0

31185,14,1,13,45,241,0,0,253,170,83,GXXXXXXXXXXXXXXXXXXXGXXXXXXXXXXXXXXXXXXXGXXXXXXXXXXXXXXXXXXXGXXXXXXXXXXXXXXXXXXXGXXXXXXXXXXXXXXXXXXXGXXXXXXXXXXXXXXXXXXXGAXXXXXXXXXXXXXXXXXXGXXXXXXXXXXXXXXXXXXXGXXXXXXXXXXXXXXXXXXXGXXXXXXXXXXXXXXXXXXXGXXXXXXXXXXXXXXXXXXXGXXXXXXXXXXXXXXXXXXXGXXXXXXXXXXXXXXXXXXX,0,300,0
31206,14,1,13,43,243,0,0,255,175,80,GXXXXXXXXXXXXXXXXXXXGXXXXXXXXXXXXXXXXXXXGXXXXXXXXXXXXXXXXXXXGXXXXXXXXXXXXXXXXXXXGXXXXXXXXXXXXXXXXXXXGXXXXXXXXXXXXXXXXXXXGAXXXXXXXXXXXXXXXXXXGXXXXXXXXXXXXXXXXXXXGXXXXXXXXXXXXXXXXXXXGXXXXXXXXXXXXXXXXXXXGXXXXXXXXXXXXXXXXXXXGXXXXXXXXXXXXXXXXXXXGXXXXXXXXXXXXXXXXXXX,0,300,0
31227,14,1,13,45,241,0,0,253,171,82,GXXXXXXXXXXXXXXXXXXXGXXXXXXXXXXXXXXXXXXXGXXXXXXXXXXXXXXXXXXXGXXXXXXXXXXXXXXXXXXXGXXXXXXXXXXXXXXXXXXXGXXXXXXXXXXXXXXXXXXXGAXXXXXXXXXXXXXXXXXXGXXXXXXXXXXXXXXXXXXXGXXXXXXXXXXXXXXXXXXXGXXXXXXXXXXXXXXXXXXXGXXXXXXXXXXXXXXXXXXXGXXXXXXXXXXXXXXXXXXXGXXXXXXXXXXXXXXXXXXX,0,300,0
31248,14,1,13,41,245,0,0,256,173,83,GXXXXXXXXXXXXXXXXXXXGXXXXXXXXXXXXXXXXXXXGXXXXXXXXXXXXXXXXXXXGXXXXXXXXXXXXXXXXXXXGXXXXXXXXXXXXXXXXXXXGXXXXXXXXXXXXXXXXXXXGAXXXXXXXXXXXXXXXXXXGXXXXXXXXXXXXXXXXXXXGXXXXXXXXXXXXXXXXXXXGXXXXXXXXXXXXXXXXXXXGXXXXXXXXXXXXXXXXXXXGXXXXXXXXXXXXXXXXXXXGXXXXXXXXXXXXXXXXXXX,0,300,0
31269,14,1,13,46,240,0,0,252,170,82,GXXXXXXXXXXXXXXXXXXXGXXXXXXXXXXXXXXXXXXXGXXXXXXXXXXXXXXXXXXXGXXXXXXXXXXXXXXXXXXXGXXXXXXXXXXXXXXXXXXXGXXXXXXXXXXXXXXXXXXXGAXXXXXXXXXXXXXXXXXXGXXXXXXXXXXXXXXXXXXXGXXXXXXXXXXXXXXXXXXXGXXXXXXXXXXXXXXXXXXXGXXXXXXXXXXXXXXXXXXXGXXXXXXXXXXXXXXXXXXXGXXXXXXXXXXXXXXXXXXX,0,300,0

31290,14,1,13,50,236,0,0,248,169,79,GXXXXXXXXXXXXXXXXXXXGXXXXXXXXXXXXXXXXXXXGXXXXXXXXXXXXXXXXXXXGXXXXXXXXXXXXXXXXXXXGXXXXXXXXXXXXXXXXXXXGXXXXXXXXXXXXXXXXXXXGAXXXXXXXXXXXXXXXXXXGXXXXXXXXXXXXXXXXXXXGXXXXXXXXXXXXXXXXXXXGXXXXXXXXXXXXXXXXXXXGXXXXXXXXXXXXXXXXXXXGXXXXXXXXXXXXXXXXXXXGXXXXXXXXXXXXXXXXXXX,0,300,0
31311,14,1,13,48,238,0,0,249,166,83,GXXXXXXXXXXXXXXXXXXXGXXXXXXXXXXXXXXXXXXXGXXXXXXXXXXXXXXXXXXXGXXXXXXXXXXXXXXXXXXXGXXXXXXXXXXXXXXXXXXXGXXXXXXXXXXXXXXXXXXXGAXXXXXXXXXXXXXXXXXXGXXXXXXXXXXXXXXXXXXXGXXXXXXXXXXXXXXXXXXXGXXXXXXXXXXXXXXXXXXXGXXXXXXXXXXXXXXXXXXXGXXXXXXXXXXXXXXXXXXXGXXXXXXXXXXXXXXXXXXX,0,300,0
31332,14,1,13,48,238,0,0,249,170,79,GXXXXXXXXXXXXXXXXXXXGXXXXXXXXXXXXXXXXXXXGXXXXXXXXXXXXXXXXXXXGXXXXXXXXXXXXXXXXXXXGXXXXXXXXXXXXXXXXXXXGXXXXXXXXXXXXXXXXXXXGAXXXXXXXXXXXXXXXXXXGXXXXXXXXXXXXXXXXXXXGXXXXXXXXXXXXXXXXXXXGXXXXXXXXXXXXXXXXXXXGXXXXXXXXXXXXXXXXXXXGXXXXXXXXXXXXXXXXXXXGXXXXXXXXXXXXXXXXXXX,0,300,0
31353,14,1,13,47,239,0,0,251,171,80,GXXXXXXXXXXXXXXXXXXXGXXXXXXXXXXXXXXXXXXXGXXXXXXXXXXXXXXXXXXXGXXXXXXXXXXXXXXXXXXXGXXXXXXXXXXXXXXXXXXXGXXXXXXXXXXXXXXXXXXXGAXXXXXXXXXXXXXXXXXXGXXXXXXXXXXXXXXXXXXXGXXXXXXXXXXXXXXXXXXXGXXXXXXXXXXXXXXXXXXXGXXXXXXXXXXXXXXXXXXXGXXXXXXXXXXXXXXXXXXXGXXXXXXXXXXXXXXXXXXX,0,300,0
31374,14,1,13,45,241,0,0,253,170,83,GXXXXXXXXXXXXXXXXXXXGXXXXXXXXXXXXXXXXXXXGXXXXXXXXXXXXXXXXXXXGXXXXXXXXXXXXXXXXXXXGXXXXXXXXXXXXXXXXXXXGXXXXXXXXXXXXXXXXXXXGAXXXXXXXXXXXXXXXXXXGXXXXXXXXXXXXXXXXXXXGXXXXXXXXXXXXXXXXXXXGXXXXXXXXXXXXXXXXXXXGXXXXXXXXXXXXXXXXXXXGXXXXXXXXXXXXXXXXXXXGXXXXXXXXXXXXXXXXXXX,0,300,0

31395,15,1,14,43,242,0,0,253,169,84,GXXXXXXXXXXXXXXXXXXXGXXXXXXXXXXXXXXXXXXXGXXXXXXXXXXXXXXXXXXXGXXXXXXXXXXXXXXXXXXXGXXXXXXXXXXXXXXXXXXXGXXXXXXXXXXXXXXXXXXXGOXXXXXXXXXXXXXXXXXXGXXXXXXXXXXXXXXXXXXXGAXXXXXXXXXXXXXXXXXXGXXXXXXXXXXXXXXXXXXXGXXXXXXXXXXXXXXXXXXXGXXXXXXXXXXXXXXXXXXXGXXXXXXXXXXXXXXXXXXX,0,300,0
31416,14,1,13,47,239,0,0,251,168,83,GXXXXXXXXXXXXXXXXXXXGXXXXXXXXXXXXXXXXXXXGXXXXXXXXXXXXXXXXXXXGXXXXXXXXXXXXXXXXXXXGXXXXXXXXXXXXXXXXXXXGXXXXXXXXXXXXXXXXXXXGXXXXXXXXXXXXXXXXXXXGXXXXXXXXXXXXXXXXXXXGAXXXXXXXXXXXXXXXXXXGXXXXXXXXXXXXXXXXXXXGXXXXXXXXXXXXXXXXXXXGXXXXXXXXXXXXXXXXXXXGXXXXXXXXXXXXXXXXXXX,0,300,0
31437,14,1,13,45,241,0,0,253,172,81,GXXXXXXXXXXXXXXXXXXXGXXXXXXXXXXXXXXXXXXXGXXXXXXXXXXXXXXXXXXXGXXXXXXXXXXXXXXXXXXXGXXXXXXXXXXXXXXXXXXXGXXXXXXXXXXXXXXXXXXXGXXXXXXXXXXXXXXXXXXXGXXXXXXXXXXXXXXXXXXXGAXXXXXXXXXXXXXXXXXXGXXXXXXXXXXXXXXXXXXXGXXXXXXXXXXXXXXXXXXXGXXXXXXXXXXXXXXXXXXXGXXXXXXXXXXXXXXXXXXX,0,300,0
31458,14,1,13,51,235,0,0,247,169,78,GXXXXXXXXXXXXXXXXXXXGXXXXXXXXXXXXXXXXXXXGXXXXXXXXXXXXXXXXXXXGXXXXXXXXXXXXXXXXXXXGXXXXXXXXXXXXXXXXXXXGXXXXXXXXXXXXXXXXXXXGXXXXXXXXXXXXXXXXXXXGXXXXXXXXXXXXXXXXXXXGAXXXXXXXXXXXXXXXXXXGXXXXXXXXXXXXXXXXXXXGXXXXXXXXXXXXXXXXXXXGXXXXXXXXXXXXXXXXXXXGXXXXXXXXXXXXXXXXXXX,0,300,0
31479,13,0,13,52,235,0,0,247,166,81,GXXXXXXXXXXXXXXXXXXXGXXXXXXXXXXXXXXXXXXXGXXXXXXXXXXXXXXXXXXXGXXXXXXXXXXXXXXXXXXXGXXXXXXXXXXXXXXXXXXXGXXXXXXXXXXXXXXXXXXXGXXXXXXXXXXXXXXXXXXXGXXXXXXXXXXXXXXXXXXXGXXXXXXXXXXXXXXXXXXXGXXXXXXXXXXXXXXXXXXXGXXXXXXXXXXXXXXXXXXXGXXXXXXXXXXXXXXXXXXXGXXXXXXXXXXXXXXXXXXX,0,300,0

31500,13,0,13,51,236,0,0,248,167,81,GXXXXXXXXXXXXXXXXXXXGXXXXXXXXXXXXXXXXXXXGXXXXXXXXXXXXXXXXXXXGXXXXXXXXXXXXXXXXXXXGXXXXXXXXXXXXXXXXXXXGXXXXXXXXXXXXXXXXXXXGXXXXXXXXXXXXXXXXXXXGXXXXXXXXXXXXXXXXXXXGXXXXXXXXXXXXXXXXXXXGXXXXXXXXXXXXXXXXXXXGXXXXXXXXXXXXXXXXXXXGXXXXXXXXXXXXXXXXXXXGXXXXXXXXXXXXXXXXXXX,0,300,0
31521,13,0,13,47,240,0,0,252,166,86,GXXXXXXXXXXXXXXXXXXXGXXXXXXXXXXXXXXXXXXXGXXXXXXXXXXXXXXXXXXXGXXXXXXXXXXXXXXXXXXXGXXXXXXXXXXXXXXXXXXXGXXXXXXXXXXXXXXXXXXXGXXXXXXXXXXXXXXXXXXXGXXXXXXXXXXXXXXXXXXXGXXXXXXXXXXXXXXXXXXXGXXXXXXXXXXXXXXXXXXXGXXXXXXXXXXXXXXXXXXXGXXXXXXXXXXXXXXXXXXXGXXXXXXXXXXXXXXXXXXX,0,300,0
31542,13,0,13,48,239,0,0,251,165,86,GXXXXXXXXXXXXXXXXXXXGXXXXXXXXXXXXXXXXXXXGXXXXXXXXXXXXXXXXXXXGXXXXXXXXXXXXXXXXXXXGXXXXXXXXXXXXXXXXXXXGXXXXXXXXXXXXXXXXXXXGXXXXXXXXXXXXXXXXXXXGXXXXXXXXXXXXXXXXXXXGXXXXXXXXXXXXXXXXXXXGXXXXXXXXXXXXXXXXXXXGXXXXXXXXXXXXXXXXXXXGXXXXXXXXXXXXXXXXXXXGXXXXXXXXXXXXXXXXXXX,0,300,0
31563,13,0,13,43,244,0,0,255,169,86,GXXXXXXXXXXXXXXXXXXXGXXXXXXXXXXXXXXXXXXXGXXXXXXXXXXXXXXXXXXXGXXXXXXXXXXXXXXXXXXXGXXXXXXXXXXXXXXXXXXXGXXXXXXXXXXXXXXXXXXXGXXXXXXXXXXXXXXXXXXXGXXXXXXXXXXXXXXXXXXXGXXXXXXXXXXXXXXXXXXXGXXXXXXXXXXXXXXXXXXXGXXXXXXXXXXXXXXXXXXXGXXXXXXXXXXXXXXXXXXXGXXXXXXXXXXXXXXXXXXX,0,300,0
31584,13,0,13,44,243,0,0,254,167,87,GXXXXXXXXXXXXXXXXXXXGXXXXXXXXXXXXXXXXXXXGXXXXXXXXXXXXXXXXXXXGXXXXXXXXXXXXXXXXXXXGXXXXXXXXXXXXXXXXXXXGXXXXXXXXXXXXXXXXXXXGXXXXXXXXXXXXXXXXXXXGXXXXXXXXXXXXXXXXXXXGXXXXXXXXXXXXXXXXXXXGXXXXXXXXXXXXXXXXXXXGXXXXXXXXXXXXXXXXXXXGXXXXXXXXXXXXXXXXXXXGXXXXXXXXXXXXXXXXXXX,0,300,0

31605,13,0,13,38,249,0,0,261,171,90,GXXXXXXXXXXXXXXXXXXXGXXXXXXXXXXXXXXXXXXXGXXXXXXXXXXXXXXXXXXXGXXXXXXXXXXXXXXXXXXXGXXXXXXXXXXXXXXXXXXXGXXXXXXXXXXXXXXXXXXXGXXXXXXXXXXXXXXXXXXXGXXXXXXXXXXXXXXXXXXXGXXXXXXXXXXXXXXXXXXXGXXXXXXXXXXXXXXXXXXXGXXXXXXXXXXXXXXXXXXXGXXXXXXXXXXXXXXXXXXXGXXXXXXXXXXXXXXXXXXX,0,300,0
31626,13,0,13,38,249,0,0,261,173,88,GXXXXXXXXXXXXXXXXXXXGXXXXXXXXXXXXXXXXXXXGXXXXXXXXXXXXXXXXXXXGXXXXXXXXXXXXXXXXXXXGXXXXXXXXXXXXXXXXXXXGXXXXXXXXXXXXXXXXXXXGXXXXXXXXXXXXXXXXXXXGXXXXXXXXXXXXXXXXXXXGXXXXXXXXXXXXXXXXXXXGXXXXXXXXXXXXXXXXXXXGXXXXXXXXXXXXXXXXXXXGXXXXXXXXXXXXXXXXXXXGXXXXXXXXXXXXXXXXXXX,0,300,0
31647,13,0,13,40,247,0,0,259,172,87,GXXXXXXXXXXXXXXXXXXXGXXXXXXXXXXXXXXXXXXXGXXXXXXXXXXXXXXXXXXXGXXXXXXXXXXXXXXXXXXXGXXXXXXXXXXXXXXXXXXXGXXXXXXXXXXXXXXXXXXXGXXXXXXXXXXXXXXXXXXXGXXXXXXXXXXXXXXXXXXXGXXXXXXXXXXXXXXXXXXXGXXXXXXXXXXXXXXXXXXXGXXXXXXXXXXXXXXXXXXXGXXXXXXXXXXXXXXXXXXXGXXXXXXXXXXXXXXXXXXX,0,300,0
31668,13,0,13,38,249,0,0,261,169,92,GXXXXXXXXXXXXXXXXXXXGXXXXXXXXXXXXXXXXXXXGXXXXXXXXXXXXXXXXXXXGXXXXXXXXXXXXXXXXXXXGXXXXXXXXXXXXXXXXXXXGXXXXXXXXXXXXXXXXXXXGXXXXXXXXXXXXXXXXXXXGXXXXXXXXXXXXXXXXXXXGXXXXXXXXXXXXXXXXXXXGXXXXXXXXXXXXXXXXXXXGXXXXXXXXXXXXXXXXXXXGXXXXXXXXXXXXXXXXXXXGXXXXXXXXXXXXXXXXXXX,0,300,0
31689,13,0,13,41,246,0,0,258,167,91,GXXXXXXXXXXXXXXXXXXXGXXXXXXXXXXXXXXXXXXXGXXXXXXXXXXXXXXXXXXXGXXXXXXXXXXXXXXXXXXXGXXXXXXXXXXXXXXXXXXXGXXXXXXXXXXXXXXXXXXXGXXXXXXXXXXXXXXXXXXXGXXXXXXXXXXXXXXXXXXXGXXXXXXXXXXXXXXXXXXXGXXXXXXXXXXXXXXXXXXXGXXXXXXXXXXXXXXXXXXXGXXXXXXXXXXXXXXXXXXXGXXXXXXXXXXXXXXXXXXX,0,300,0

31710,13,0,13,35,252,0,0,263,172,91,GXXXXXXXXXXXXXXXXXXXGXXXXXXXXXXXXXXXXXXXGXXXXXXXXXXXXXXXXXXXGXXXXXXXXXXXXXXXXXXXGXXXXXXXXXXXXXXXXXXXGXXXXXXXXXXXXXXXXXXXGXXXXXXXXXXXXXXXXXXXGXXXXXXXXXXXXXXXXXXXGXXXXXXXXXXXXXXXXXXXGXXXXXXXXXXXXXXXXXXXGXXXXXXXXXXXXXXXXXXXGXXXXXXXXXXXXXXXXXXXGXXXXXXXXXXXXXXXXXXX,0,300,0
31731,13,0,13,39,248,0,0,258,171,87,GXXXXXXXXXXXXXXXXXXXGXXXXXXXXXXXXXXXXXXXGXXXXXXXXXXXXXXXXXXXGXXXXXXXXXXXXXXXXXXXGXXXXXXXXXXXXXXXXXXXGXXXXXXXXXXXXXXXXXXXGXXXXXXXXXXXXXXXXXXXGXXXXXXXXXXXXXXXXXXXGXXXXXXXXXXXXXXXXXXXGXXXXXXXXXXXXXXXXXXXGXXXXXXXXXXXXXXXXXXXGXXXXXXXXXXXXXXXXXXXGXXXXXXXXXXXXXXXXXXX,0,300,0
31752,13,0,13,35,252,0,0,264,171,93,GXXXXXXXXXXXXXXXXXXXGXXXXXXXXXXXXXXXXXXXGXXXXXXXXXXXXXXXXXXXGXXXXXXXXXXXXXXXXXXXGXXXXXXXXXXXXXXXXXXXGXXXXXXXXXXXXXXXXXXXGXXXXXXXXXXXXXXXXXXXGXXXXXXXXXXXXXXXXXXXGXXXXXXXXXXXXXXXXXXXGXXXXXXXXXXXXXXXXXXXGXXXXXXXXXXXXXXXXXXXGXXXXXXXXXXXXXXXXXXXGXXXXXXXXXXXXXXXXXXX,0,300,0
31773,13,0,13,34,253,0,0,265,171,94,GXXXXXXXXXXXXXXXXXXXGXXXXXXXXXXXXXXXXXXXGXXXXXXXXXXXXXXXXXXXGXXXXXXXXXXXXXXXXXXXGXXXXXXXXXXXXXXXXXXXGXXXXXXXXXXXXXXXXXXXGXXXXXXXXXXXXXXXXXXXGXXXXXXXXXXXXXXXXXXXGXXXXXXXXXXXXXXXXXXXGXXXXXXXXXXXXXXXXXXXGXXXXXXXXXXXXXXXXXXXGXXXXXXXXXXXXXXXXXXXGXXXXXXXXXXXXXXXXXXX,0,300,0
31794,13,0,13,32,255,0,0,268,175,93,GXXXXXXXXXXXXXXXXXXXGXXXXXXXXXXXXXXXXXXXGXXXXXXXXXXXXXXXXXXXGXXXXXXXXXXXXXXXXXXXGXXXXXXXXXXXXXXXXXXXGXXXXXXXXXXXXXXXXXXXGXXXXXXXXXXXXXXXXXXXGXXXXXXXXXXXXXXXXXXXGXXXXXXXXXXXXXXXXXXXGXXXXXXXXXXXXXXXXXXXGXXXXXXXXXXXXXXXXXXXGXXXXXXXXXXXXXXXXXXXGXXXXXXXXXXXXXXXXXXX,0,300,0

31815,13,0,13,39,248,0,0,261,174,87,GXXXXXXXXXXXXXXXXXXXGXXXXXXXXXXXXXXXXXXXGXXXXXXXXXXXXXXXXXXXGXXXXXXXXXXXXXXXXXXXGXXXXXXXXXXXXXXXXXXXGXXXXXXXXXXXXXXXXXXXGXXXXXXXXXXXXXXXXXXXGXXXXXXXXXXXXXXXXXXXGXXXXXXXXXXXXXXXXXXXGXXXXXXXXXXXXXXXXXXXGXXXXXXXXXXXXXXXXXXXGXXXXXXXXXXXXXXXXXXXGXXXXXXXXXXXXXXXXXXX,0,300,0
31836,13,0,13,43,244,0,0,257,175,82,GXXXXXXXXXXXXXXXXXXXGXXXXXXXXXXXXXXXXXXXGXXXXXXXXXXXXXXXXXXXGXXXXXXXXXXXXXXXXXXXGXXXXXXXXXXXXXXXXXXXGXXXXXXXXXXXXXXXXXXXGXXXXXXXXXXXXXXXXXXXGXXXXXXXXXXXXXXXXXXXGXXXXXXXXXXXXXXXXXXXGXXXXXXXXXXXXXXXXXXXGXXXXXXXXXXXXXXXXXXXGXXXXXXXXXXXXXXXXXXXGXXXXXXXXXXXXXXXXXXX,0,300,0
31857,13,0,13,50,237,0,0,250,174,76,GXXXXXXXXXXXXXXXXXXXGXXXXXXXXXXXXXXXXXXXGXXXXXXXXXXXXXXXXXXXGXXXXXXXXXXXXXXXXXXXGXXXXXXXXXXXXXXXXXXXGXXXXXXXXXXXXXXXXXXXGXXXXXXXXXXXXXXXXXXXGXXXXXXXXXXXXXXXXXXXGXXXXXXXXXXXXXXXXXXXGXXXXXXXXXXXXXXXXXXXGXXXXXXXXXXXXXXXXXXXGXXXXXXXXXXXXXXXXXXXGXXXXXXXXXXXXXXXXXXX,0,300,0
31878,13,0,13,47,240,0,0,252,174,78,GXXXXXXXXXXXXXXXXXXXGXXXXXXXXXXXXXXXXXXXGXXXXXXXXXXXXXXXXXXXGXXXXXXXXXXXXXXXXXXXGXXXXXXXXXXXXXXXXXXXGXXXXXXXXXXXXXXXXXXXGXXXXXXXXXXXXXXXXXXXGXXXXXXXXXXXXXXXXXXXGXXXXXXXXXXXXXXXXXXXGXXXXXXXXXXXXXXXXXXXGXXXXXXXXXXXXXXXXXXXGXXXXXXXXXXXXXXXXXXXGXXXXXXXXXXXXXXXXXXX,0,300,0
31899,13,0,13,51,236,0,0,249,169,80,GXXXXXXXXXXXXXXXXXXXGXXXXXXXXXXXXXXXXXXXGXXXXXXXXXXXXXXXXXXXGXXXXXXXXXXXXXXXXXXXGXXXXXXXXXXXXXXXXXXXGXXXXXXXXXXXXXXXXXXXGXXXXXXXXXXXXXXXXXXXGXXXXXXXXXXXXXXXXXXXGXXXXXXXXXXXXXXXXXXXGXXXXXXXXXXXXXXXXXXXGXXXXXXXXXXXXXXXXXXXGXXXXXXXXXXXXXXXXXXXGXXXXXXXXXXXXXXXXXXX,0,300,0

31920,13,0,13,52,235,0,0,248,169,79,GXXXXXXXXXXXXXXXXXXXGXXXXXXXXXXXXXXXXXXXGXXXXXXXXXXXXXXXXXXXGXXXXXXXXXXXXXXXXXXXGXXXXXXXXXXXXXXXXXXXGXXXXXXXXXXXXXXXXXXXGXXXXXXXXXXXXXXXXXXXGXXXXXXXXXXXXXXXXXXXGXXXXXXXXXXXXXXXXXXXGXXXXXXXXXXXXXXXXXXXGXXXXXXXXXXXXXXXXXXXGXXXXXXXXXXXXXXXXXXXGXXXXXXXXXXXXXXXXXXX,0,300,0
31941,13,0,13,52,235,0,0,248,169,79,GXXXXXXXXXXXXXXXXXXXGXXXXXXXXXXXXXXXXXXXGXXXXXXXXXXXXXXXXXXXGXXXXXXXXXXXXXXXXXXXGXXXXXXXXXXXXXXXXXXXGXXXXXXXXXXXXXXXXXXXGXXXXXXXXXXXXXXXXXXXGXXXXXXXXXXXXXXXXXXXGXXXXXXXXXXXXXXXXXXXGXXXXXXXXXXXXXXXXXXXGXXXXXXXXXXXXXXXXXXXGXXXXXXXXXXXXXXXXXXXGXXXXXXXXXXXXXXXXXXX,0,300,0
31962,13,0,13,52,235,0,0,247,171,76,GXXXXXXXXXXXXXXXXXXXGXXXXXXXXXXXXXXXXXXXGXXXXXXXXXXXXXXXXXXXGXXXXXXXXXXXXXXXXXXXGXXXXXXXXXXXXXXXXXXXGXXXXXXXXXXXXXXXXXXXGXXXXXXXXXXXXXXXXXXXGXXXXXXXXXXXXXXXXXXXGXXXXXXXXXXXXXXXXXXXGXXXXXXXXXXXXXXXXXXXGXXXXXXXXXXXXXXXXXXXGXXXXXXXXXXXXXXXXXXXGXXXXXXXXXXXXXXXXXXX,0,300,0
31983,13,0,13,55,232,0,0,244,169,75,GXXXXXXXXXXXXXXXXXXXGXXXXXXXXXXXXXXXXXXXGXXXXXXXXXXXXXXXXXXXGXXXXXXXXXXXXXXXXXXXGXXXXXXXXXXXXXXXXXXXGXXXXXXXXXXXXXXXXXXXGXXXXXXXXXXXXXXXXXXXGXXXXXXXXXXXXXXXXXXXGXXXXXXXXXXXXXXXXXXXGXXXXXXXXXXXXXXXXXXXGXXXXXXXXXXXXXXXXXXXGXXXXXXXXXXXXXXXXXXXGXXXXXXXXXXXXXXXXXXX,0,300,0
32004,13,0,13,53,234,0,0,246,174,72,GXXXXXXXXXXXXXXXXXXXGXXXXXXXXXXXXXXXXXXXGXXXXXXXXXXXXXXXXXXXGXXXXXXXXXXXXXXXXXXXGXXXXXXXXXXXXXXXXXXXGXXXXXXXXXXXXXXXXXXXGXXXXXXXXXXXXXXXXXXXGXXXXXXXXXXXXXXXXXXXGXXXXXXXXXXXXXXXXXXXGXXXXXXXXXXXXXXXXXXXGXXXXXXXXXXXXXXXXXXXGXXXXXXXXXXXXXXXXXXXGXXXXXXXXXXXXXXXXXXX,0,300,0

32025,13,0,13,53,234,0,0,246,171,75,GXXXXXXXXXXXXXXXXXXXGXXXXXXXXXXXXXXXXXXXGXXXXXXXXXXXXXXXXXXXGXXXXXXXXXXXXXXXXXXXGXXXXXXXXXXXXXXXXXXXGXXXXXXXXXXXXXXXXXXXGXXXXXXXXXXXXXXXXXXXGXXXXXXXXXXXXXXXXXXXGXXXXXXXXXXXXXXXXXXXGXXXXXXXXXXXXXXXXXXXGXXXXXXXXXXXXXXXXXXXGXXXXXXXXXXXXXXXXXXXGXXXXXXXXXXXXXXXXXXX,0,300,0
32046,13,0,13,49,238,0,0,250,174,76,GXXXXXXXXXXXXXXXXXXXGXXXXXXXXXXXXXXXXXXXGXXXXXXXXXXXXXXXXXXXGXXXXXXXXXXXXXXXXXXXGXXXXXXXXXXXXXXXXXXXGXXXXXXXXXXXXXXXXXXXGXXXXXXXXXXXXXXXXXXXGXXXXXXXXXXXXXXXXXXXGXXXXXXXXXXXXXXXXXXXGXXXXXXXXXXXXXXXXXXXGXXXXXXXXXXXXXXXXXXXGXXXXXXXXXXXXXXXXXXXGXXXXXXXXXXXXXXXXXXX,0,300,0
32067,14,1,13,53,233,0,0,245,177,68,GXXXXXXXXXXXXXXXXXXXGXXXXXXXXXXXXXXXXXXXGXXXXXXXXXXXXXXXXXXXGXXXXXXXXXXXXXXXXXXXGXXXXXXXXXXXXXXXXXXXGXXXXXXXXXXXXXXXXXXXGXXXXXXXXXXXXXXXXXXXGXXXXXXXXXXXXXXXXXXXGXXXXXXXXXXXXXXXXXXXGAXXXXXXXXXXXXXXXXXXGXXXXXXXXXXXXXXXXXXXGXXXXXXXXXXXXXXXXXXXGXXXXXXXXXXXXXXXXXXX,0,300,0
32088,14,1,13,54,232,0,0,243,174,69,GXXXXXXXXXXXXXXXXXXXGXXXXXXXXXXXXXXXXXXXGXXXXXXXXXXXXXXXXXXXGXXXXXXXXXXXXXXXXXXXGXXXXXXXXXXXXXXXXXXXGXXXXXXXXXXXXXXXXXXXGXXXXXXXXXXXXXXXXXXXGXXXXXXXXXXXXXXXXXXXGXXXXXXXXXXXXXXXXXXXGAXXXXXXXXXXXXXXXXXXGXXXXXXXXXXXXXXXXXXXGXXXXXXXXXXXXXXXXXXXGXXXXXXXXXXXXXXXXXXX,0,300,0
32109,14,1,13,55,231,0,0,243,171,72,GXXXXXXXXXXXXXXXXXXXGXXXXXXXXXXXXXXXXXXXGXXXXXXXXXXXXXXXXXXXGXXXXXXXXXXXXXXXXXXXGXXXXXXXXXXXXXXXXXXXGXXXXXXXXXXXXXXXXXXXGXXXXXXXXXXXXXXXXXXXGXXXXXXXXXXXXXXXXXXXGXXXXXXXXXXXXXXXXXXXGAXXXXXXXXXXXXXXXXXXGXXXXXXXXXXXXXXXXXXXGXXXXXXXXXXXXXXXXXXXGXXXXXXXXXXXXXXXXXXX,0,300,0

32130,14,1,13,55,231,0,0,243,173,70,GXXXXXXXXXXXXXXXXXXXGXXXXXXXXXXXXXXXXXXXGXXXXXXXXXXXXXXXXXXXGXXXXXXXXXXXXXXXXXXXGXXXXXXXXXXXXXXXXXXXGXXXXXXXXXXXXXXXXXXXGXXXXXXXXXXXXXXXXXXXGXXXXXXXXXXXXXXXXXXXGXXXXXXXXXXXXXXXXXXXGAXXXXXXXXXXXXXXXXXXGXXXXXXXXXXXXXXXXXXXGXXXXXXXXXXXXXXXXXXXGXXXXXXXXXXXXXXXXXXX,0,300,0
32151,14,1,13,49,237,0,0,249,168,81,GXXXXXXXXXXXXXXXXXXXGXXXXXXXXXXXXXXXXXXXGXXXXXXXXXXXXXXXXXXXGXXXXXXXXXXXXXXXXXXXGXXXXXXXXXXXXXXXXXXXGXXXXXXXXXXXXXXXXXXXGXXXXXXXXXXXXXXXXXXXGXXXXXXXXXXXXXXXXXXXGXXXXXXXXXXXXXXXXXXXGAXXXXXXXXXXXXXXXXXXGXXXXXXXXXXXXXXXXXXXGXXXXXXXXXXXXXXXXXXXGXXXXXXXXXXXXXXXXXXX,0,300,0
32172,14,1,13,51,235,0,0,247,173,74,GXXXXXXXXXXXXXXXXXXXGXXXXXXXXXXXXXXXXXXXGXXXXXXXXXXXXXXXXXXXGXXXXXXXXXXXXXXXXXXXGXXXXXXXXXXXXXXXXXXXGXXXXXXXXXXXXXXXXXXXGXXXXXXXXXXXXXXXXXXXGXXXXXXXXXXXXXXXXXXXGXXXXXXXXXXXXXXXXXXXGAXXXXXXXXXXXXXXXXXXGXXXXXXXXXXXXXXXXXXXGXXXXXXXXXXXXXXXXXXXGXXXXXXXXXXXXXXXXXXX,0,300,0
32193,13,0,13,47,240,0,0,251,174,77,GXXXXXXXXXXXXXXXXXXXGXXXXXXXXXXXXXXXXXXXGXXXXXXXXXXXXXXXXXXXGXXXXXXXXXXXXXXXXXXXGXXXXXXXXXXXXXXXXXXXGXXXXXXXXXXXXXXXXXXXGXXXXXXXXXXXXXXXXXXXGXXXXXXXXXXXXXXXXXXXGXXXXXXXXXXXXXXXXXXXGXXXXXXXXXXXXXXXXXXXGXXXXXXXXXXXXXXXXXXXGXXXXXXXXXXXXXXXXXXXGXXXXXXXXXXXXXXXXXXX,0,300,0
32214,13,0,13,50,237,0,0,249,173,76,GXXXXXXXXXXXXXXXXXXXGXXXXXXXXXXXXXXXXXXXGXXXXXXXXXXXXXXXXXXXGXXXXXXXXXXXXXXXXXXXGXXXXXXXXXXXXXXXXXXXGXXXXXXXXXXXXXXXXXXXGXXXXXXXXXXXXXXXXXXXGXXXXXXXXXXXXXXXXXXXGXXXXXXXXXXXXXXXXXXXGXXXXXXXXXXXXXXXXXXXGXXXXXXXXXXXXXXXXXXXGXXXXXXXXXXXXXXXXXXXGXXXXXXXXXXXXXXXXXXX,0,300,0

32235,13,0,13,49,238,0,0,249,171,78,GXXXXXXXXXXXXXXXXXXXGXXXXXXXXXXXXXXXXXXXGXXXXXXXXXXXXXXXXXXXGXXXXXXXXXXXXXXXXXXXGXXXXXXXXXXXXXXXXXXXGXXXXXXXXXXXXXXXXXXXGXXXXXXXXXXXXXXXXXXXGXXXXXXXXXXXXXXXXXXXGXXXXXXXXXXXXXXXXXXXGXXXXXXXXXXXXXXXXXXXGXXXXXXXXXXXXXXXXXXXGXXXXXXXXXXXXXXXXXXXGXXXXXXXXXXXXXXXXXXX,0,300,0
32256,13,0,13,43,244,0,0,255,170,85,GXXXXXXXXXXXXXXXXXXXGXXXXXXXXXXXXXXXXXXXGXXXXXXXXXXXXXXXXXXXGXXXXXXXXXXXXXXXXXXXGXXXXXXXXXXXXXXXXXXXGXXXXXXXXXXXXXXXXXXXGXXXXXXXXXXXXXXXXXXXGXXXXXXXXXXXXXXXXXXXGXXXXXXXXXXXXXXXXXXXGXXXXXXXXXXXXXXXXXXXGXXXXXXXXXXXXXXXXXXXGXXXXXXXXXXXXXXXXXXXGXXXXXXXXXXXXXXXXXXX,0,300,0
32277,13,0,13,39,248,0,0,260,171,89,GXXXXXXXXXXXXXXXXXXXGXXXXXXXXXXXXXXXXXXXGXXXXXXXXXXXXXXXXXXXGXXXXXXXXXXXXXXXXXXXGXXXXXXXXXXXXXXXXXXXGXXXXXXXXXXXXXXXXXXXGXXXXXXXXXXXXXXXXXXXGXXXXXXXXXXXXXXXXXXXGXXXXXXXXXXXXXXXXXXXGXXXXXXXXXXXXXXXXXXXGXXXXXXXXXXXXXXXXXXXGXXXXXXXXXXXXXXXXXXXGXXXXXXXXXXXXXXXXXXX,0,300,0
32298,13,0,13,44,243,0,0,255,170,85,GXXXXXXXXXXXXXXXXXXXGXXXXXXXXXXXXXXXXXXXGXXXXXXXXXXXXXXXXXXXGXXXXXXXXXXXXXXXXXXXGXXXXXXXXXXXXXXXXXXXGXXXXXXXXXXXXXXXXXXXGXXXXXXXXXXXXXXXXXXXGXXXXXXXXXXXXXXXXXXXGXXXXXXXXXXXXXXXXXXXGXXXXXXXXXXXXXXXXXXXGXXXXXXXXXXXXXXXXXXXGXXXXXXXXXXXXXXXXXXXGXXXXXXXXXXXXXXXXXXX,0,300,0
32319,13,0,13,43,244,0,0,256,169,87,GXXXXXXXXXXXXXXXXXXXGXXXXXXXXXXXXXXXXXXXGXXXXXXXXXXXXXXXXXXXGXXXXXXXXXXXXXXXXXXXGXXXXXXXXXXXXXXXXXXXGXXXXXXXXXXXXXXXXXXXGXXXXXXXXXXXXXXXXXXXGXXXXXXXXXXXXXXXXXXXGXXXXXXXXXXXXXXXXXXXGXXXXXXXXXXXXXXXXXXXGXXXXXXXXXXXXXXXXXXXGXXXXXXXXXXXXXXXXXXXGXXXXXXXXXXXXXXXXXXX,0,300,0

32340,13,0,13,45,242,0,0,254,169,85,GXXXXXXXXXXXXXXXXXXXGXXXXXXXXXXXXXXXXXXXGXXXXXXXXXXXXXXXXXXXGXXXXXXXXXXXXXXXXXXXGXXXXXXXXXXXXXXXXXXXGXXXXXXXXXXXXXXXXXXXGXXXXXXXXXXXXXXXXXXXGXXXXXXXXXXXXXXXXXXXGXXXXXXXXXXXXXXXXXXXGXXXXXXXXXXXXXXXXXXXGXXXXXXXXXXXXXXXXXXXGXXXXXXXXXXXXXXXXXXXGXXXXXXXXXXXXXXXXXXX,0,300,0
32361,13,0,13,41,246,0,0,258,168,90,GXXXXXXXXXXXXXXXXXXXGXXXXXXXXXXXXXXXXXXXGXXXXXXXXXXXXXXXXXXXGXXXXXXXXXXXXXXXXXXXGXXXXXXXXXXXXXXXXXXXGXXXXXXXXXXXXXXXXXXXGXXXXXXXXXXXXXXXXXXXGXXXXXXXXXXXXXXXXXXXGXXXXXXXXXXXXXXXXXXXGXXXXXXXXXXXXXXXXXXXGXXXXXXXXXXXXXXXXXXXGXXXXXXXXXXXXXXXXXXXGXXXXXXXXXXXXXXXXXXX,0,300,0
32382,13,0,13,40,247,0,0,259,166,93,GXXXXXXXXXXXXXXXXXXXGXXXXXXXXXXXXXXXXXXXGXXXXXXXXXXXXXXXXXXXGXXXXXXXXXXXXXXXXXXXGXXXXXXXXXXXXXXXXXXXGXXXXXXXXXXXXXXXXXXXGXXXXXXXXXXXXXXXXXXXGXXXXXXXXXXXXXXXXXXXGXXXXXXXXXXXXXXXXXXXGXXXXXXXXXXXXXXXXXXXGXXXXXXXXXXXXXXXXXXXGXXXXXXXXXXXXXXXXXXXGXXXXXXXXXXXXXXXXXXX,0,300,0
32403,13,0,13,36,251,0,0,262,166,96,GXXXXXXXXXXXXXXXXXXXGXXXXXXXXXXXXXXXXXXXGXXXXXXXXXXXXXXXXXXXGXXXXXXXXXXXXXXXXXXXGXXXXXXXXXXXXXXXXXXXGXXXXXXXXXXXXXXXXXXXGXXXXXXXXXXXXXXXXXXXGXXXXXXXXXXXXXXXXXXXGXXXXXXXXXXXXXXXXXXXGXXXXXXXXXXXXXXXXXXXGXXXXXXXXXXXXXXXXXXXGXXXXXXXXXXXXXXXXXXXGXXXXXXXXXXXXXXXXXXX,0,300,0
32424,13,0,13,30,257,0,0,268,168,100,GXXXXXXXXXXXXXXXXXXXGXXXXXXXXXXXXXXXXXXXGXXXXXXXXXXXXXXXXXXXGXXXXXXXXXXXXXXXXXXXGXXXXXXXXXXXXXXXXXXXGXXXXXXXXXXXXXXXXXXXGXXXXXXXXXXXXXXXXXXXGXXXXXXXXXXXXXXXXXXXGXXXXXXXXXXXXXXXXXXXGXXXXXXXXXXXXXXXXXXXGXXXXXXXXXXXXXXXXXXXGXXXXXXXXXXXXXXXXXXXGXXXXXXXXXXXXXXXXXXX,0,300,0

32445,13,0,13,32,255,0,0,267,168,99,GXXXXXXXXXXXXXXXXXXXGXXXXXXXXXXXXXXXXXXXGXXXXXXXXXXXXXXXXXXXGXXXXXXXXXXXXXXXXXXXGXXXXXXXXXXXXXXXXXXXGXXXXXXXXXXXXXXXXXXXGXXXXXXXXXXXXXXXXXXXGXXXXXXXXXXXXXXXXXXXGXXXXXXXXXXXXXXXXXXXGXXXXXXXXXXXXXXXXXXXGXXXXXXXXXXXXXXXXXXXGXXXXXXXXXXXXXXXXXXXGXXXXXXXXXXXXXXXXXXX,0,300,0
32466,13,0,13,27,260,0,0,272,172,100,GXXXXXXXXXXXXXXXXXXXGXXXXXXXXXXXXXXXXXXXGXXXXXXXXXXXXXXXXXXXGXXXXXXXXXXXXXXXXXXXGXXXXXXXXXXXXXXXXXXXGXXXXXXXXXXXXXXXXXXXGXXXXXXXXXXXXXXXXXXXGXXXXXXXXXXXXXXXXXXXGXXXXXXXXXXXXXXXXXXXGXXXXXXXXXXXXXXXXXXXGXXXXXXXXXXXXXXXXXXXGXXXXXXXXXXXXXXXXXXXGXXXXXXXXXXXXXXXXXXX,0,300,0
32487,13,0,13,30,257,0,0,269,172,97,GXXXXXXXXXXXXXXXXXXXGXXXXXXXXXXXXXXXXXXXGXXXXXXXXXXXXXXXXXXXGXXXXXXXXXXXXXXXXXXXGXXXXXXXXXXXXXXXXXXXGXXXXXXXXXXXXXXXXXXXGXXXXXXXXXXXXXXXXXXXGXXXXXXXXXXXXXXXXXXXGXXXXXXXXXXXXXXXXXXXGXXXXXXXXXXXXXXXXXXXGXXXXXXXXXXXXXXXXXXXGXXXXXXXXXXXXXXXXXXXGXXXXXXXXXXXXXXXXXXX,0,300,0
32508,13,0,13,33,254,0,0,266,171,95,GXXXXXXXXXXXXXXXXXXXGXXXXXXXXXXXXXXXXXXXGXXXXXXXXXXXXXXXXXXXGXXXXXXXXXXXXXXXXXXXGXXXXXXXXXXXXXXXXXXXGXXXXXXXXXXXXXXXXXXXGXXXXXXXXXXXXXXXXXXXGXXXXXXXXXXXXXXXXXXXGXXXXXXXXXXXXXXXXXXXGXXXXXXXXXXXXXXXXXXXGXXXXXXXXXXXXXXXXXXXGXXXXXXXXXXXXXXXXXXXGXXXXXXXXXXXXXXXXXXX,0,300,0
32529,13,0,13,28,259,0,0,271,175,96,GXXXXXXXXXXXXXXXXXXXGXXXXXXXXXXXXXXXXXXXGXXXXXXXXXXXXXXXXXXXGXXXXXXXXXXXXXXXXXXXGXXXXXXXXXXXXXXXXXXXGXXXXXXXXXXXXXXXXXXXGXXXXXXXXXXXXXXXXXXXGXXXXXXXXXXXXXXXXXXXGXXXXXXXXXXXXXXXXXXXGXXXXXXXXXXXXXXXXXXXGXXXXXXXXXXXXXXXXXXXGXXXXXXXXXXXXXXXXXXXGXXXXXXXXXXXXXXXXXXX,0,300,0

32550,13,0,13,31,256,0,0,268,172,96,GXXXXXXXXXXXXXXXXXXXGXXXXXXXXXXXXXXXXXXXGXXXXXXXXXXXXXXXXXXXGXXXXXXXXXXXXXXXXXXXGXXXXXXXXXXXXXXXXXXXGXXXXXXXXXXXXXXXXXXXGXXXXXXXXXXXXXXXXXXXGXXXXXXXXXXXXXXXXXXXGXXXXXXXXXXXXXXXXXXXGXXXXXXXXXXXXXXXXXXXGXXXXXXXXXXXXXXXXXXXGXXXXXXXXXXXXXXXXXXXGXXXXXXXXXXXXXXXXXXX,0,300,0
32571,13,0,13,30,257,0,0,268,174,94,GXXXXXXXXXXXXXXXXXXXGXXXXXXXXXXXXXXXXXXXGXXXXXXXXXXXXXXXXXXXGXXXXXXXXXXXXXXXXXXXGXXXXXXXXXXXXXXXXXXXGXXXXXXXXXXXXXXXXXXXGXXXXXXXXXXXXXXXXXXXGXXXXXXXXXXXXXXXXXXXGXXXXXXXXXXXXXXXXXXXGXXXXXXXXXXXXXXXXXXXGXXXXXXXXXXXXXXXXXXXGXXXXXXXXXXXXXXXXXXXGXXXXXXXXXXXXXXXXXXX,0,300,0
32592,13,0,13,32,255,0,0,267,176,91,GXXXXXXXXXXXXXXXXXXXGXXXXXXXXXXXXXXXXXXXGXXXXXXXXXXXXXXXXXXXGXXXXXXXXXXXXXXXXXXXGXXXXXXXXXXXXXXXXXXXGXXXXXXXXXXXXXXXXXXXGXXXXXXXXXXXXXXXXXXXGXXXXXXXXXXXXXXXXXXXGXXXXXXXXXXXXXXXXXXXGXXXXXXXXXXXXXXXXXXXGXXXXXXXXXXXXXXXXXXXGXXXXXXXXXXXXXXXXXXXGXXXXXXXXXXXXXXXXXXX,0,300,0
32613,13,0,13,39,248,0,0,259,173,86,GXXXXXXXXXXXXXXXXXXXGXXXXXXXXXXXXXXXXXXXGXXXXXXXXXXXXXXXXXXXGXXXXXXXXXXXXXXXXXXXGXXXXXXXXXXXXXXXXXXXGXXXXXXXXXXXXXXXXXXXGXXXXXXXXXXXXXXXXXXXGXXXXXXXXXXXXXXXXXXXGXXXXXXXXXXXXXXXXXXXGXXXXXXXXXXXXXXXXXXXGXXXXXXXXXXXXXXXXXXXGXXXXXXXXXXXXXXXXXXXGXXXXXXXXXXXXXXXXXXX,0,300,0
32634,13,0,13,40,247,0,0,259,172,87,GXXXXXXXXXXXXXXXXXXXGXXXXXXXXXXXXXXXXXXXGXXXXXXXXXXXXXXXXXXXGXXXXXXXXXXXXXXXXXXXGXXXXXXXXXXXXXXXXXXXGXXXXXXXXXXXXXXXXXXXGXXXXXXXXXXXXXXXXXXXGXXXXXXXXXXXXXXXXXXXGXXXXXXXXXXXXXXXXXXXGXXXXXXXXXXXXXXXXXXXGXXXXXXXXXXXXXXXXXXXGXXXXXXXXXXXXXXXXXXXGXXXXXXXXXXXXXXXXXXX,0,300,0

32655,13,0,13,46,241,0,0,253,168,85,GXXXXXXXXXXXXXXXXXXXGXXXXXXXXXXXXXXXXXXXGXXXXXXXXXXXXXXXXXXXGXXXXXXXXXXXXXXXXXXXGXXXXXXXXXXXXXXXXXXXGXXXXXXXXXXXXXXXXXXXGXXXXXXXXXXXXXXXXXXXGXXXXXXXXXXXXXXXXXXXGXXXXXXXXXXXXXXXXXXXGXXXXXXXXXXXXXXXXXXXGXXXXXXXXXXXXXXXXXXXGXXXXXXXXXXXXXXXXXXXGXXXXXXXXXXXXXXXXXXX,0,300,0
32676,13,0,13,47,240,0,0,252,172,80,GXXXXXXXXXXXXXXXXXXXGXXXXXXXXXXXXXXXXXXXGXXXXXXXXXXXXXXXXXXXGXXXXXXXXXXXXXXXXXXXGXXXXXXXXXXXXXXXXXXXGXXXXXXXXXXXXXXXXXXXGXXXXXXXXXXXXXXXXXXXGXXXXXXXXXXXXXXXXXXXGXXXXXXXXXXXXXXXXXXXGXXXXXXXXXXXXXXXXXXXGXXXXXXXXXXXXXXXXXXXGXXXXXXXXXXXXXXXXXXXGXXXXXXXXXXXXXXXXXXX,0,300,0
32697,13,0,13,43,244,0,0,255,176,79,GXXXXXXXXXXXXXXXXXXXGXXXXXXXXXXXXXXXXXXXGXXXXXXXXXXXXXXXXXXXGXXXXXXXXXXXXXXXXXXXGXXXXXXXXXXXXXXXXXXXGXXXXXXXXXXXXXXXXXXXGXXXXXXXXXXXXXXXXXXXGXXXXXXXXXXXXXXXXXXXGXXXXXXXXXXXXXXXXXXXGXXXXXXXXXXXXXXXXXXXGXXXXXXXXXXXXXXXXXXXGXXXXXXXXXXXXXXXXXXXGXXXXXXXXXXXXXXXXXXX,0,300,0
32718,13,0,13,49,238,0,0,250,174,76,GXXXXXXXXXXXXXXXXXXXGXXXXXXXXXXXXXXXXXXXGXXXXXXXXXXXXXXXXXXXGXXXXXXXXXXXXXXXXXXXGXXXXXXXXXXXXXXXXXXXGXXXXXXXXXXXXXXXXXXXGXXXXXXXXXXXXXXXXXXXGXXXXXXXXXXXXXXXXXXXGXXXXXXXXXXXXXXXXXXXGXXXXXXXXXXXXXXXXXXXGXXXXXXXXXXXXXXXXXXXGXXXXXXXXXXXXXXXXXXXGXXXXXXXXXXXXXXXXXXX,0,300,0
32739,13,0,13,48,239,0,0,251,172,79,GXXXXXXXXXXXXXXXXXXXGXXXXXXXXXXXXXXXXXXXGXXXXXXXXXXXXXXXXXXXGXXXXXXXXXXXXXXXXXXXGXXXXXXXXXXXXXXXXXXXGXXXXXXXXXXXXXXXXXXXGXXXXXXXXXXXXXXXXXXXGXXXXXXXXXXXXXXXXXXXGXXXXXXXXXXXXXXXXXXXGXXXXXXXXXXXXXXXXXXXGXXXXXXXXXXXXXXXXXXXGXXXXXXXXXXXXXXXXXXXGXXXXXXXXXXXXXXXXXXX,0,300,0

32760,13,0,13,53,234,0,0,246,170,76,GXXXXXXXXXXXXXXXXXXXGXXXXXXXXXXXXXXXXXXXGXXXXXXXXXXXXXXXXXXXGXXXXXXXXXXXXXXXXXXXGXXXXXXXXXXXXXXXXXXXGXXXXXXXXXXXXXXXXXXXGXXXXXXXXXXXXXXXXXXXGXXXXXXXXXXXXXXXXXXXGXXXXXXXXXXXXXXXXXXXGXXXXXXXXXXXXXXXXXXXGXXXXXXXXXXXXXXXXXXXGXXXXXXXXXXXXXXXXXXXGXXXXXXXXXXXXXXXXXXX,0,300,0
32781,13,0,13,50,237,0,0,249,171,78,GXXXXXXXXXXXXXXXXXXXGXXXXXXXXXXXXXXXXXXXGXXXXXXXXXXXXXXXXXXXGXXXXXXXXXXXXXXXXXXXGXXXXXXXXXXXXXXXXXXXGXXXXXXXXXXXXXXXXXXXGXXXXXXXXXXXXXXXXXXXGXXXXXXXXXXXXXXXXXXXGXXXXXXXXXXXXXXXXXXXGXXXXXXXXXXXXXXXXXXXGXXXXXXXXXXXXXXXXXXXGXXXXXXXXXXXXXXXXXXXGXXXXXXXXXXXXXXXXXXX,0,300,0
32802,13,0,13,47,240,0,0,252,174,78,GXXXXXXXXXXXXXXXXXXXGXXXXXXXXXXXXXXXXXXXGXXXXXXXXXXXXXXXXXXXGXXXXXXXXXXXXXXXXXXXGXXXXXXXXXXXXXXXXXXXGXXXXXXXXXXXXXXXXXXXGXXXXXXXXXXXXXXXXXXXGXXXXXXXXXXXXXXXXXXXGXXXXXXXXXXXXXXXXXXXGXXXXXXXXXXXXXXXXXXXGXXXXXXXXXXXXXXXXXXXGXXXXXXXXXXXXXXXXXXXGXXXXXXXXXXXXXXXXXXX,0,300,0
32823,13,0,13,51,236,0,0,248,179,69,GXXXXXXXXXXXXXXXXXXXGXXXXXXXXXXXXXXXXXXXGXXXXXXXXXXXXXXXXXXXGXXXXXXXXXXXXXXXXXXXGXXXXXXXXXXXXXXXXXXXGXXXXXXXXXXXXXXXXXXXGXXXXXXXXXXXXXXXXXXXGXXXXXXXXXXXXXXXXXXXGXXXXXXXXXXXXXXXXXXXGXXXXXXXXXXXXXXXXXXXGXXXXXXXXXXXXXXXXXXXGXXXXXXXXXXXXXXXXXXXGXXXXXXXXXXXXXXXXXXX,0,300,0
32844,13,0,13,52,235,0,0,247,181,66,GXXXXXXXXXXXXXXXXXXXGXXXXXXXXXXXXXXXXXXXGXXXXXXXXXXXXXXXXXXXGXXXXXXXXXXXXXXXXXXXGXXXXXXXXXXXXXXXXXXXGXXXXXXXXXXXXXXXXXXXGXXXXXXXXXXXXXXXXXXXGXXXXXXXXXXXXXXXXXXXGXXXXXXXXXXXXXXXXXXXGXXXXXXXXXXXXXXXXXXXGXXXXXXXXXXXXXXXXXXXGXXXXXXXXXXXXXXXXXXXGXXXXXXXXXXXXXXXXXXX,0,300,0

32865,13,0,13,53,234,0,0,246,175,71,GXXXXXXXXXXXXXXXXXXXGXXXXXXXXXXXXXXXXXXXGXXXXXXXXXXXXXXXXXXXGXXXXXXXXXXXXXXXXXXXGXXXXXXXXXXXXXXXXXXXGXXXXXXXXXXXXXXXXXXXGXXXXXXXXXXXXXXXXXXXGXXXXXXXXXXXXXXXXXXXGXXXXXXXXXXXXXXXXXXXGXXXXXXXXXXXXXXXXXXXGXXXXXXXXXXXXXXXXXXXGXXXXXXXXXXXXXXXXXXXGXXXXXXXXXXXXXXXXXXX,0,300,0
32886,13,0,13,53,234,0,0,246,178,68,GXXXXXXXXXXXXXXXXXXXGXXXXXXXXXXXXXXXXXXXGXXXXXXXXXXXXXXXXXXXGXXXXXXXXXXXXXXXXXXXGXXXXXXXXXXXXXXXXXXXGXXXXXXXXXXXXXXXXXXXGXXXXXXXXXXXXXXXXXXXGXXXXXXXXXXXXXXXXXXXGXXXXXXXXXXXXXXXXXXXGXXXXXXXXXXXXXXXXXXXGXXXXXXXXXXXXXXXXXXXGXXXXXXXXXXXXXXXXXXXGXXXXXXXXXXXXXXXXXXX,0,300,0
32907,13,0,13,57,230,0,0,242,172,70,GXXXXXXXXXXXXXXXXXXXGXXXXXXXXXXXXXXXXXXXGXXXXXXXXXXXXXXXXXXXGXXXXXXXXXXXXXXXXXXXGXXXXXXXXXXXXXXXXXXXGXXXXXXXXXXXXXXXXXXXGXXXXXXXXXXXXXXXXXXXGXXXXXXXXXXXXXXXXXXXGXXXXXXXXXXXXXXXXXXXGXXXXXXXXXXXXXXXXXXXGXXXXXXXXXXXXXXXXXXXGXXXXXXXXXXXXXXXXXXXGXXXXXXXXXXXXXXXXXXX,0,300,0
32928,14,1,13,54,232,0,0,243,169,74,GXXXXXXXXXXXXXXXXXXXGXXXXXXXXXXXXXXXXXXXGAXXXXXXXXXXXXXXXXXXGXXXXXXXXXXXXXXXXXXXGXXXXXXXXXXXXXXXXXXXGXXXXXXXXXXXXXXXXXXXGXXXXXXXXXXXXXXXXXXXGXXXXXXXXXXXXXXXXXXXGXXXXXXXXXXXXXXXXXXXGXXXXXXXXXXXXXXXXXXXGXXXXXXXXXXXXXXXXXXXGXXXXXXXXXXXXXXXXXXXGXXXXXXXXXXXXXXXXXXX,0,300,0
32949,14,1,13,50,236,0,0,249,165,84,GXXXXXXXXXXXXXXXXXXXGXXXXXXXXXXXXXXXXXXXGAXXXXXXXXXXXXXXXXXXGXXXXXXXXXXXXXXXXXXXGXXXXXXXXXXXXXXXXXXXGXXXXXXXXXXXXXXXXXXXGXXXXXXXXXXXXXXXXXXXGXXXXXXXXXXXXXXXXXXXGXXXXXXXXXXXXXXXXXXXGXXXXXXXXXXXXXXXXXXXGXXXXXXXXXXXXXXXXXXXGXXXXXXXXXXXXXXXXXXXGXXXXXXXXXXXXXXXXXXX,0,300,0

32970,14,1,13,43,243,0,0,256,172,84,GXXXXXXXXXXXXXXXXXXXGXXXXXXXXXXXXXXXXXXXGAXXXXXXXXXXXXXXXXXXGXXXXXXXXXXXXXXXXXXXGXXXXXXXXXXXXXXXXXXXGXXXXXXXXXXXXXXXXXXXGXXXXXXXXXXXXXXXXXXXGXXXXXXXXXXXXXXXXXXXGXXXXXXXXXXXXXXXXXXXGXXXXXXXXXXXXXXXXXXXGXXXXXXXXXXXXXXXXXXXGXXXXXXXXXXXXXXXXXXXGXXXXXXXXXXXXXXXXXXX,0,300,0
32991,14,1,13,43,243,0,0,256,169,87,GXXXXXXXXXXXXXXXXXXXGXXXXXXXXXXXXXXXXXXXGAXXXXXXXXXXXXXXXXXXGXXXXXXXXXXXXXXXXXXXGXXXXXXXXXXXXXXXXXXXGXXXXXXXXXXXXXXXXXXXGXXXXXXXXXXXXXXXXXXXGXXXXXXXXXXXXXXXXXXXGXXXXXXXXXXXXXXXXXXXGXXXXXXXXXXXXXXXXXXXGXXXXXXXXXXXXXXXXXXXGXXXXXXXXXXXXXXXXXXXGXXXXXXXXXXXXXXXXXXX,0,300,0
33012,14,1,13,43,243,0,0,256,170,86,GXXXXXXXXXXXXXXXXXXXGXXXXXXXXXXXXXXXXXXXGAXXXXXXXXXXXXXXXXXXGXXXXXXXXXXXXXXXXXXXGXXXXXXXXXXXXXXXXXXXGXXXXXXXXXXXXXXXXXXXGXXXXXXXXXXXXXXXXXXXGXXXXXXXXXXXXXXXXXXXGXXXXXXXXXXXXXXXXXXXGXXXXXXXXXXXXXXXXXXXGXXXXXXXXXXXXXXXXXXXGXXXXXXXXXXXXXXXXXXXGXXXXXXXXXXXXXXXXXXX,0,300,0
33033,14,1,13,47,239,0,0,252,168,84,GXXXXXXXXXXXXXXXXXXXGXXXXXXXXXXXXXXXXXXXGAXXXXXXXXXXXXXXXXXXGXXXXXXXXXXXXXXXXXXXGXXXXXXXXXXXXXXXXXXXGXXXXXXXXXXXXXXXXXXXGXXXXXXXXXXXXXXXXXXXGXXXXXXXXXXXXXXXXXXXGXXXXXXXXXXXXXXXXXXXGXXXXXXXXXXXXXXXXXXXGXXXXXXXXXXXXXXXXXXXGXXXXXXXXXXXXXXXXXXXGXXXXXXXXXXXXXXXXXXX,0,300,0
33054,14,1,13,42,244,0,0,257,173,84,GXXXXXXXXXXXXXXXXXXXGXXXXXXXXXXXXXXXXXXXGAXXXXXXXXXXXXXXXXXXGXXXXXXXXXXXXXXXXXXXGXXXXXXXXXXXXXXXXXXXGXXXXXXXXXXXXXXXXXXXGXXXXXXXXXXXXXXXXXXXGXXXXXXXXXXXXXXXXXXXGXXXXXXXXXXXXXXXXXXXGXXXXXXXXXXXXXXXXXXXGXXXXXXXXXXXXXXXXXXXGXXXXXXXXXXXXXXXXXXXGXXXXXXXXXXXXXXXXXXX,0,300,0

33075,14,1,13,44,242,0,0,254,168,86,GXXXXXXXXXXXXXXXXXXXGXXXXXXXXXXXXXXXXXXXGAXXXXXXXXXXXXXXXXXXGXXXXXXXXXXXXXXXXXXXGXXXXXXXXXXXXXXXXXXXGXXXXXXXXXXXXXXXXXXXGXXXXXXXXXXXXXXXXXXXGXXXXXXXXXXXXXXXXXXXGXXXXXXXXXXXXXXXXXXXGXXXXXXXXXXXXXXXXXXXGXXXXXXXXXXXXXXXXXXXGXXXXXXXXXXXXXXXXXXXGXXXXXXXXXXXXXXXXXXX,0,300,0
33096,14,1,13,44,242,0,0,254,167,87,GXXXXXXXXXXXXXXXXXXXGXXXXXXXXXXXXXXXXXXXGAXXXXXXXXXXXXXXXXXXGXXXXXXXXXXXXXXXXXXXGXXXXXXXXXXXXXXXXXXXGXXXXXXXXXXXXXXXXXXXGXXXXXXXXXXXXXXXXXXXGXXXXXXXXXXXXXXXXXXXGXXXXXXXXXXXXXXXXXXXGXXXXXXXXXXXXXXXXXXXGXXXXXXXXXXXXXXXXXXXGXXXXXXXXXXXXXXXXXXXGXXXXXXXXXXXXXXXXXXX,0,300,0
33117,14,1,13,40,246,0,0,258,170,88,GXXXXXXXXXXXXXXXXXXXGXXXXXXXXXXXXXXXXXXXGAXXXXXXXXXXXXXXXXXXGXXXXXXXXXXXXXXXXXXXGXXXXXXXXXXXXXXXXXXXGXXXXXXXXXXXXXXXXXXXGXXXXXXXXXXXXXXXXXXXGXXXXXXXXXXXXXXXXXXXGXXXXXXXXXXXXXXXXXXXGXXXXXXXXXXXXXXXXXXXGXXXXXXXXXXXXXXXXXXXGXXXXXXXXXXXXXXXXXXXGXXXXXXXXXXXXXXXXXXX,0,300,0
33138,14,1,13,41,245,0,0,257,168,89,GXXXXXXXXXXXXXXXXXXXGXXXXXXXXXXXXXXXXXXXGAXXXXXXXXXXXXXXXXXXGXXXXXXXXXXXXXXXXXXXGXXXXXXXXXXXXXXXXXXXGXXXXXXXXXXXXXXXXXXXGXXXXXXXXXXXXXXXXXXXGXXXXXXXXXXXXXXXXXXXGXXXXXXXXXXXXXXXXXXXGXXXXXXXXXXXXXXXXXXXGXXXXXXXXXXXXXXXXXXXGXXXXXXXXXXXXXXXXXXXGXXXXXXXXXXXXXXXXXXX,0,300,0
33159,14,1,13,41,245,0,0,257,173,84,GXXXXXXXXXXXXXXXXXXXGXXXXXXXXXXXXXXXXXXXGAXXXXXXXXXXXXXXXXXXGXXXXXXXXXXXXXXXXXXXGXXXXXXXXXXXXXXXXXXXGXXXXXXXXXXXXXXXXXXXGXXXXXXXXXXXXXXXXXXXGXXXXXXXXXXXXXXXXXXXGXXXXXXXXXXXXXXXXXXXGXXXXXXXXXXXXXXXXXXXGXXXXXXXXXXXXXXXXXXXGXXXXXXXXXXXXXXXXXXXGXXXXXXXXXXXXXXXXXXX,0,300,0

33180,15,1,14,42,243,0,0,255,170,85,GXXXXXXXXXXXXXXXXXXXGXXXXXXXXXXXXXXXXXXXGOXXXXXXXXXXXXXXXXXXGXXXXXXXXXXXXXXXXXXXGXXXXXXXXXXXXXXXXXXXGXXXXXXXXXXXXXXXXXXXGXXXXXXXXXXXXXXXXXXXGXXXXXXXXXXXXXXXXXXXGXXXXXXXXXXXXXXXXXXXGXXXXXXXXXXXXXXXXXXXGXXXXXXXXXXXXXXXXXXXGXXXXXXXXXXXXXXXXXXXGAXXXXXXXXXXXXXXXXXX,0,300,0
33201,14,1,13,44,242,0,0,253,172,81,GXXXXXXXXXXXXXXXXXXXGXXXXXXXXXXXXXXXXXXXGXXXXXXXXXXXXXXXXXXXGXXXXXXXXXXXXXXXXXXXGXXXXXXXXXXXXXXXXXXXGXXXXXXXXXXXXXXXXXXXGXXXXXXXXXXXXXXXXXXXGXXXXXXXXXXXXXXXXXXXGXXXXXXXXXXXXXXXXXXXGXXXXXXXXXXXXXXXXXXXGXXXXXXXXXXXXXXXXXXXGXXXXXXXXXXXXXXXXXXXGAXXXXXXXXXXXXXXXXXX,0,300,0
33222,14,1,13,47,239,0,0,251,170,81,GXXXXXXXXXXXXXXXXXXXGXXXXXXXXXXXXXXXXXXXGXXXXXXXXXXXXXXXXXXXGXXXXXXXXXXXXXXXXXXXGXXXXXXXXXXXXXXXXXXXGXXXXXXXXXXXXXXXXXXXGXXXXXXXXXXXXXXXXXXXGXXXXXXXXXXXXXXXXXXXGXXXXXXXXXXXXXXXXXXXGXXXXXXXXXXXXXXXXXXXGXXXXXXXXXXXXXXXXXXXGXXXXXXXXXXXXXXXXXXXGAXXXXXXXXXXXXXXXXXX,0,300,0
33243,14,1,13,52,234,0,0,246,171,75,GXXXXXXXXXXXXXXXXXXXGXXXXXXXXXXXXXXXXXXXGXXXXXXXXXXXXXXXXXXXGXXXXXXXXXXXXXXXXXXXGXXXXXXXXXXXXXXXXXXXGXXXXXXXXXXXXXXXXXXXGXXXXXXXXXXXXXXXXXXXGXXXXXXXXXXXXXXXXXXXGXXXXXXXXXXXXXXXXXXXGXXXXXXXXXXXXXXXXXXXGXXXXXXXXXXXXXXXXXXXGXXXXXXXXXXXXXXXXXXXGAXXXXXXXXXXXXXXXXXX,0,300,0
33264,13,0,13,52,235,0,0,247,168,79,GXXXXXXXXXXXXXXXXXXXGXXXXXXXXXXXXXXXXXXXGXXXXXXXXXXXXXXXXXXXGXXXXXXXXXXXXXXXXXXXGXXXXXXXXXXXXXXXXXXXGXXXXXXXXXXXXXXXXXXXGXXXXXXXXXXXXXXXXXXXGXXXXXXXXXXXXXXXXXXXGXXXXXXXXXXXXXXXXXXXGXXXXXXXXXXXXXXXXXXXGXXXXXXXXXXXXXXXXXXXGXXXXXXXXXXXXXXXXXXXGXXXXXXXXXXXXXXXXXXX,0,300,0

33285,13,0,13,46,241,0,0,252,172,80,GXXXXXXXXXXXXXXXXXXXGXXXXXXXXXXXXXXXXXXXGXXXXXXXXXXXXXXXXXXXGXXXXXXXXXXXXXXXXXXXGXXXXXXXXXXXXXXXXXXXGXXXXXXXXXXXXXXXXXXXGXXXXXXXXXXXXXXXXXXXGXXXXXXXXXXXXXXXXXXXGXXXXXXXXXXXXXXXXXXXGXXXXXXXXXXXXXXXXXXXGXXXXXXXXXXXXXXXXXXXGXXXXXXXXXXXXXXXXXXXGXXXXXXXXXXXXXXXXXXX,0,300,0
33306,13,0,13,48,239,0,0,252,171,81,GXXXXXXXXXXXXXXXXXXXGXXXXXXXXXXXXXXXXXXXGXXXXXXXXXXXXXXXXXXXGXXXXXXXXXXXXXXXXXXXGXXXXXXXXXXXXXXXXXXXGXXXXXXXXXXXXXXXXXXXGXXXXXXXXXXXXXXXXXXXGXXXXXXXXXXXXXXXXXXXGXXXXXXXXXXXXXXXXXXXGXXXXXXXXXXXXXXXXXXXGXXXXXXXXXXXXXXXXXXXGXXXXXXXXXXXXXXXXXXXGXXXXXXXXXXXXXXXXXXX,0,300,0
33327,13,0,13,47,240,0,0,253,172,81,GXXXXXXXXXXXXXXXXXXXGXXXXXXXXXXXXXXXXXXXGXXXXXXXXXXXXXXXXXXXGXXXXXXXXXXXXXXXXXXXGXXXXXXXXXXXXXXXXXXXGXXXXXXXXXXXXXXXXXXXGXXXXXXXXXXXXXXXXXXXGXXXXXXXXXXXXXXXXXXXGXXXXXXXXXXXXXXXXXXXGXXXXXXXXXXXXXXXXXXXGXXXXXXXXXXXXXXXXXXXGXXXXXXXXXXXXXXXXXXXGXXXXXXXXXXXXXXXXXXX,0,300,0
33348,13,0,13,47,240,0,0,253,175,78,GXXXXXXXXXXXXXXXXXXXGXXXXXXXXXXXXXXXXXXXGXXXXXXXXXXXXXXXXXXXGXXXXXXXXXXXXXXXXXXXGXXXXXXXXXXXXXXXXXXXGXXXXXXXXXXXXXXXXXXXGXXXXXXXXXXXXXXXXXXXGXXXXXXXXXXXXXXXXXXXGXXXXXXXXXXXXXXXXXXXGXXXXXXXXXXXXXXXXXXXGXXXXXXXXXXXXXXXXXXXGXXXXXXXXXXXXXXXXXXXGXXXXXXXXXXXXXXXXXXX,0,300,0
33369,13,0,13,50,237,0,0,251,171,80,GXXXXXXXXXXXXXXXXXXXGXXXXXXXXXXXXXXXXXXXGXXXXXXXXXXXXXXXXXXXGXXXXXXXXXXXXXXXXXXXGXXXXXXXXXXXXXXXXXXXGXXXXXXXXXXXXXXXXXXXGXXXXXXXXXXXXXXXXXXXGXXXXXXXXXXXXXXXXXXXGXXXXXXXXXXXXXXXXXXXGXXXXXXXXXXXXXXXXXXXGXXXXXXXXXXXXXXXXXXXGXXXXXXXXXXXXXXXXXXXGXXXXXXXXXXXXXXXXXXX,0,300,0

33390,13,0,13,50,237,0,0,251,172,79,GXXXXXXXXXXXXXXXXXXXGXXXXXXXXXXXXXXXXXXXGXXXXXXXXXXXXXXXXXXXGXXXXXXXXXXXXXXXXXXXGXXXXXXXXXXXXXXXXXXXGXXXXXXXXXXXXXXXXXXXGXXXXXXXXXXXXXXXXXXXGXXXXXXXXXXXXXXXXXXXGXXXXXXXXXXXXXXXXXXXGXXXXXXXXXXXXXXXXXXXGXXXXXXXXXXXXXXXXXXXGXXXXXXXXXXXXXXXXXXXGXXXXXXXXXXXXXXXXXXX,0,300,0
33411,13,0,13,51,236,0,0,249,172,77,GXXXXXXXXXXXXXXXXXXXGXXXXXXXXXXXXXXXXXXXGXXXXXXXXXXXXXXXXXXXGXXXXXXXXXXXXXXXXXXXGXXXXXXXXXXXXXXXXXXXGXXXXXXXXXXXXXXXXXXXGXXXXXXXXXXXXXXXXXXXGXXXXXXXXXXXXXXXXXXXGXXXXXXXXXXXXXXXXXXXGXXXXXXXXXXXXXXXXXXXGXXXXXXXXXXXXXXXXXXXGXXXXXXXXXXXXXXXXXXXGXXXXXXXXXXXXXXXXXXX,0,300,0
33432,13,0,13,53,234,0,0,247,170,77,GXXXXXXXXXXXXXXXXXXXGXXXXXXXXXXXXXXXXXXXGXXXXXXXXXXXXXXXXXXXGXXXXXXXXXXXXXXXXXXXGXXXXXXXXXXXXXXXXXXXGXXXXXXXXXXXXXXXXXXXGXXXXXXXXXXXXXXXXXXXGXXXXXXXXXXXXXXXXXXXGXXXXXXXXXXXXXXXXXXXGXXXXXXXXXXXXXXXXXXXGXXXXXXXXXXXXXXXXXXXGXXXXXXXXXXXXXXXXXXXGXXXXXXXXXXXXXXXXXXX,0,300,0
33453,13,0,13,48,239,0,0,252,173,79,GXXXXXXXXXXXXXXXXXXXGXXXXXXXXXXXXXXXXXXXGXXXXXXXXXXXXXXXXXXXGXXXXXXXXXXXXXXXXXXXGXXXXXXXXXXXXXXXXXXXGXXXXXXXXXXXXXXXXXXXGXXXXXXXXXXXXXXXXXXXGXXXXXXXXXXXXXXXXXXXGXXXXXXXXXXXXXXXXXXXGXXXXXXXXXXXXXXXXXXXGXXXXXXXXXXXXXXXXXXXGXXXXXXXXXXXXXXXXXXXGXXXXXXXXXXXXXXXXXXX,0,300,0
33474,13,0,13,42,245,0,0,257,175,82,GXXXXXXXXXXXXXXXXXXXGXXXXXXXXXXXXXXXXXXXGXXXXXXXXXXXXXXXXXXXGXXXXXXXXXXXXXXXXXXXGXXXXXXXXXXXXXXXXXXXGXXXXXXXXXXXXXXXXXXXGXXXXXXXXXXXXXXXXXXXGXXXXXXXXXXXXXXXXXXXGXXXXXXXXXXXXXXXXXXXGXXXXXXXXXXXXXXXXXXXGXXXXXXXXXXXXXXXXXXXGXXXXXXXXXXXXXXXXXXXGXXXXXXXXXXXXXXXXXXX,0,300,0

33495,13,0,13,43,244,0,0,257,176,81,GXXXXXXXXXXXXXXXXXXXGXXXXXXXXXXXXXXXXXXXGXXXXXXXXXXXXXXXXXXXGXXXXXXXXXXXXXXXXXXXGXXXXXXXXXXXXXXXXXXXGXXXXXXXXXXXXXXXXXXXGXXXXXXXXXXXXXXXXXXXGXXXXXXXXXXXXXXXXXXXGXXXXXXXXXXXXXXXXXXXGXXXXXXXXXXXXXXXXXXXGXXXXXXXXXXXXXXXXXXXGXXXXXXXXXXXXXXXXXXXGXXXXXXXXXXXXXXXXXXX,0,300,0
33516,13,0,13,46,241,0,0,253,173,80,GXXXXXXXXXXXXXXXXXXXGXXXXXXXXXXXXXXXXXXXGXXXXXXXXXXXXXXXXXXXGXXXXXXXXXXXXXXXXXXXGXXXXXXXXXXXXXXXXXXXGXXXXXXXXXXXXXXXXXXXGXXXXXXXXXXXXXXXXXXXGXXXXXXXXXXXXXXXXXXXGXXXXXXXXXXXXXXXXXXXGXXXXXXXXXXXXXXXXXXXGXXXXXXXXXXXXXXXXXXXGXXXXXXXXXXXXXXXXXXXGXXXXXXXXXXXXXXXXXXX,0,300,0
33537,14,1,13,44,242,0,0,254,175,79,GXXXXXXXXXXXXXXXXXXXGXXXXXXXXXXXXXXXXXXXGXXXXXXXXXXXXXXXXXXXGXXXXXXXXXXXXXXXXXXXGAXXXXXXXXXXXXXXXXXXGXXXXXXXXXXXXXXXXXXXGXXXXXXXXXXXXXXXXXXXGXXXXXXXXXXXXXXXXXXXGXXXXXXXXXXXXXXXXXXXGXXXXXXXXXXXXXXXXXXXGXXXXXXXXXXXXXXXXXXXGXXXXXXXXXXXXXXXXXXXGXXXXXXXXXXXXXXXXXXX,0,300,0
33558,13,0,13,44,243,0,0,256,172,84,GXXXXXXXXXXXXXXXXXXXGXXXXXXXXXXXXXXXXXXXGXXXXXXXXXXXXXXXXXXXGXXXXXXXXXXXXXXXXXXXGXXXXXXXXXXXXXXXXXXXGXXXXXXXXXXXXXXXXXXXGXXXXXXXXXXXXXXXXXXXGXXXXXXXXXXXXXXXXXXXGXXXXXXXXXXXXXXXXXXXGXXXXXXXXXXXXXXXXXXXGXXXXXXXXXXXXXXXXXXXGXXXXXXXXXXXXXXXXXXXGXXXXXXXXXXXXXXXXXXX,0,300,0
33579,14,1,13,41,245,0,0,258,174,84,GXXXXXXXXXXXXXXXXXXXGAXXXXXXXXXXXXXXXXXXGXXXXXXXXXXXXXXXXXXXGXXXXXXXXXXXXXXXXXXXGXXXXXXXXXXXXXXXXXXXGXXXXXXXXXXXXXXXXXXXGXXXXXXXXXXXXXXXXXXXGXXXXXXXXXXXXXXXXXXXGXXXXXXXXXXXXXXXXXXXGXXXXXXXXXXXXXXXXXXXGXXXXXXXXXXXXXXXXXXXGXXXXXXXXXXXXXXXXXXXGXXXXXXXXXXXXXXXXXXX,0,300,0

33600,14,1,13,43,243,0,0,256,174,82,GXXXXXXXXXXXXXXXXXXXGAXXXXXXXXXXXXXXXXXXGXXXXXXXXXXXXXXXXXXXGXXXXXXXXXXXXXXXXXXXGXXXXXXXXXXXXXXXXXXXGXXXXXXXXXXXXXXXXXXXGXXXXXXXXXXXXXXXXXXXGXXXXXXXXXXXXXXXXXXXGXXXXXXXXXXXXXXXXXXXGXXXXXXXXXXXXXXXXXXXGXXXXXXXXXXXXXXXXXXXGXXXXXXXXXXXXXXXXXXXGXXXXXXXXXXXXXXXXXXX,0,300,0
33621,14,1,13,45,241,0,0,254,174,80,GXXXXXXXXXXXXXXXXXXXGAXXXXXXXXXXXXXXXXXXGXXXXXXXXXXXXXXXXXXXGXXXXXXXXXXXXXXXXXXXGXXXXXXXXXXXXXXXXXXXGXXXXXXXXXXXXXXXXXXXGXXXXXXXXXXXXXXXXXXXGXXXXXXXXXXXXXXXXXXXGXXXXXXXXXXXXXXXXXXXGXXXXXXXXXXXXXXXXXXXGXXXXXXXXXXXXXXXXXXXGXXXXXXXXXXXXXXXXXXXGXXXXXXXXXXXXXXXXXXX,0,300,0
33642,14,1,13,46,240,0,0,252,176,76,GXXXXXXXXXXXXXXXXXXXGAXXXXXXXXXXXXXXXXXXGXXXXXXXXXXXXXXXXXXXGXXXXXXXXXXXXXXXXXXXGXXXXXXXXXXXXXXXXXXXGXXXXXXXXXXXXXXXXXXXGXXXXXXXXXXXXXXXXXXXGXXXXXXXXXXXXXXXXXXXGXXXXXXXXXXXXXXXXXXXGXXXXXXXXXXXXXXXXXXXGXXXXXXXXXXXXXXXXXXXGXXXXXXXXXXXXXXXXXXXGXXXXXXXXXXXXXXXXXXX,0,300,0
33663,14,1,13,50,236,0,0,248,172,76,GXXXXXXXXXXXXXXXXXXXGAXXXXXXXXXXXXXXXXXXGXXXXXXXXXXXXXXXXXXXGXXXXXXXXXXXXXXXXXXXGXXXXXXXXXXXXXXXXXXXGXXXXXXXXXXXXXXXXXXXGXXXXXXXXXXXXXXXXXXXGXXXXXXXXXXXXXXXXXXXGXXXXXXXXXXXXXXXXXXXGXXXXXXXXXXXXXXXXXXXGXXXXXXXXXXXXXXXXXXXGXXXXXXXXXXXXXXXXXXXGXXXXXXXXXXXXXXXXXXX,0,300,0
33684,14,1,13,51,235,0,0,247,172,75,GXXXXXXXXXXXXXXXXXXXGAXXXXXXXXXXXXXXXXXXGXXXXXXXXXXXXXXXXXXXGXXXXXXXXXXXXXXXXXXXGXXXXXXXXXXXXXXXXXXXGXXXXXXXXXXXXXXXXXXXGXXXXXXXXXXXXXXXXXXXGXXXXXXXXXXXXXXXXXXXGXXXXXXXXXXXXXXXXXXXGXXXXXXXXXXXXXXXXXXXGXXXXXXXXXXXXXXXXXXXGXXXXXXXXXXXXXXXXXXXGXXXXXXXXXXXXXXXXXXX,0,300,0

33705,14,1,13,49,237,0,0,249,175,74,GXXXXXXXXXXXXXXXXXXXGAXXXXXXXXXXXXXXXXXXGXXXXXXXXXXXXXXXXXXXGXXXXXXXXXXXXXXXXXXXGXXXXXXXXXXXXXXXXXXXGXXXXXXXXXXXXXXXXXXXGXXXXXXXXXXXXXXXXXXXGXXXXXXXXXXXXXXXXXXXGXXXXXXXXXXXXXXXXXXXGXXXXXXXXXXXXXXXXXXXGXXXXXXXXXXXXXXXXXXXGXXXXXXXXXXXXXXXXXXXGXXXXXXXXXXXXXXXXXXX,0,300,0
33726,14,1,13,52,234,0,0,246,179,67,GXXXXXXXXXXXXXXXXXXXGAXXXXXXXXXXXXXXXXXXGXXXXXXXXXXXXXXXXXXXGXXXXXXXXXXXXXXXXXXXGXXXXXXXXXXXXXXXXXXXGXXXXXXXXXXXXXXXXXXXGXXXXXXXXXXXXXXXXXXXGXXXXXXXXXXXXXXXXXXXGXXXXXXXXXXXXXXXXXXXGXXXXXXXXXXXXXXXXXXXGXXXXXXXXXXXXXXXXXXXGXXXXXXXXXXXXXXXXXXXGXXXXXXXXXXXXXXXXXXX,0,300,0
33747,14,1,13,58,228,0,0,240,175,65,GXXXXXXXXXXXXXXXXXXXGAXXXXXXXXXXXXXXXXXXGXXXXXXXXXXXXXXXXXXXGXXXXXXXXXXXXXXXXXXXGXXXXXXXXXXXXXXXXXXXGXXXXXXXXXXXXXXXXXXXGXXXXXXXXXXXXXXXXXXXGXXXXXXXXXXXXXXXXXXXGXXXXXXXXXXXXXXXXXXXGXXXXXXXXXXXXXXXXXXXGXXXXXXXXXXXXXXXXXXXGXXXXXXXXXXXXXXXXXXXGXXXXXXXXXXXXXXXXXXX,0,300,0
33768,14,1,13,54,232,0,0,242,173,69,GXXXXXXXXXXXXXXXXXXXGAXXXXXXXXXXXXXXXXXXGXXXXXXXXXXXXXXXXXXXGXXXXXXXXXXXXXXXXXXXGXXXXXXXXXXXXXXXXXXXGXXXXXXXXXXXXXXXXXXXGXXXXXXXXXXXXXXXXXXXGXXXXXXXXXXXXXXXXXXXGXXXXXXXXXXXXXXXXXXXGXXXXXXXXXXXXXXXXXXXGXXXXXXXXXXXXXXXXXXXGXXXXXXXXXXXXXXXXXXXGXXXXXXXXXXXXXXXXXXX,0,300,0
33789,14,1,13,50,236,0,0,248,176,72,GXXXXXXXXXXXXXXXXXXXGAXXXXXXXXXXXXXXXXXXGXXXXXXXXXXXXXXXXXXXGXXXXXXXXXXXXXXXXXXXGXXXXXXXXXXXXXXXXXXXGXXXXXXXXXXXXXXXXXXXGXXXXXXXXXXXXXXXXXXXGXXXXXXXXXXXXXXXXXXXGXXXXXXXXXXXXXXXXXXXGXXXXXXXXXXXXXXXXXXXGXXXXXXXXXXXXXXXXXXXGXXXXXXXXXXXXXXXXXXXGXXXXXXXXXXXXXXXXXXX,0,300,0

33810,14,1,13,52,234,0,0,245,173,72,GXXXXXXXXXXXXXXXXXXXGAXXXXXXXXXXXXXXXXXXGXXXXXXXXXXXXXXXXXXXGXXXXXXXXXXXXXXXXXXXGXXXXXXXXXXXXXXXXXXXGXXXXXXXXXXXXXXXXXXXGXXXXXXXXXXXXXXXXXXXGXXXXXXXXXXXXXXXXXXXGXXXXXXXXXXXXXXXXXXXGXXXXXXXXXXXXXXXXXXXGXXXXXXXXXXXXXXXXXXXGXXXXXXXXXXXXXXXXXXXGXXXXXXXXXXXXXXXXXXX,0,300,0
33831,14,1,13,52,234,0,0,246,172,74,GXXXXXXXXXXXXXXXXXXXGAXXXXXXXXXXXXXXXXXXGXXXXXXXXXXXXXXXXXXXGXXXXXXXXXXXXXXXXXXXGXXXXXXXXXXXXXXXXXXXGXXXXXXXXXXXXXXXXXXXGXXXXXXXXXXXXXXXXXXXGXXXXXXXXXXXXXXXXXXXGXXXXXXXXXXXXXXXXXXXGXXXXXXXXXXXXXXXXXXXGXXXXXXXXXXXXXXXXXXXGXXXXXXXXXXXXXXXXXXXGXXXXXXXXXXXXXXXXXXX,0,300,0
33852,13,0,13,53,234,0,0,247,171,76,GXXXXXXXXXXXXXXXXXXXGXXXXXXXXXXXXXXXXXXXGXXXXXXXXXXXXXXXXXXXGXXXXXXXXXXXXXXXXXXXGXXXXXXXXXXXXXXXXXXXGXXXXXXXXXXXXXXXXXXXGXXXXXXXXXXXXXXXXXXXGXXXXXXXXXXXXXXXXXXXGXXXXXXXXXXXXXXXXXXXGXXXXXXXXXXXXXXXXXXXGXXXXXXXXXXXXXXXXXXXGXXXXXXXXXXXXXXXXXXXGXXXXXXXXXXXXXXXXXXX,0,300,0
33873,13,0,13,49,238,0,0,251,173,78,GXXXXXXXXXXXXXXXXXXXGXXXXXXXXXXXXXXXXXXXGXXXXXXXXXXXXXXXXXXXGXXXXXXXXXXXXXXXXXXXGXXXXXXXXXXXXXXXXXXXGXXXXXXXXXXXXXXXXXXXGXXXXXXXXXXXXXXXXXXXGXXXXXXXXXXXXXXXXXXXGXXXXXXXXXXXXXXXXXXXGXXXXXXXXXXXXXXXXXXXGXXXXXXXXXXXXXXXXXXXGXXXXXXXXXXXXXXXXXXXGXXXXXXXXXXXXXXXXXXX,0,300,0
33894,13,0,13,52,235,0,0,248,171,77,GXXXXXXXXXXXXXXXXXXXGXXXXXXXXXXXXXXXXXXXGXXXXXXXXXXXXXXXXXXXGXXXXXXXXXXXXXXXXXXXGXXXXXXXXXXXXXXXXXXXGXXXXXXXXXXXXXXXXXXXGXXXXXXXXXXXXXXXXXXXGXXXXXXXXXXXXXXXXXXXGXXXXXXXXXXXXXXXXXXXGXXXXXXXXXXXXXXXXXXXGXXXXXXXXXXXXXXXXXXXGXXXXXXXXXXXXXXXXXXXGXXXXXXXXXXXXXXXXXXX,0,300,0

33915,13,0,13,54,233,0,0,246,173,73,GXXXXXXXXXXXXXXXXXXXGXXXXXXXXXXXXXXXXXXXGXXXXXXXXXXXXXXXXXXXGXXXXXXXXXXXXXXXXXXXGXXXXXXXXXXXXXXXXXXXGXXXXXXXXXXXXXXXXXXXGXXXXXXXXXXXXXXXXXXXGXXXXXXXXXXXXXXXXXXXGXXXXXXXXXXXXXXXXXXXGXXXXXXXXXXXXXXXXXXXGXXXXXXXXXXXXXXXXXXXGXXXXXXXXXXXXXXXXXXXGXXXXXXXXXXXXXXXXXXX,0,300,0
33936,13,0,13,49,238,0,0,248,171,77,GXXXXXXXXXXXXXXXXXXXGXXXXXXXXXXXXXXXXXXXGXXXXXXXXXXXXXXXXXXXGXXXXXXXXXXXXXXXXXXXGXXXXXXXXXXXXXXXXXXXGXXXXXXXXXXXXXXXXXXXGXXXXXXXXXXXXXXXXXXXGXXXXXXXXXXXXXXXXXXXGXXXXXXXXXXXXXXXXXXXGXXXXXXXXXXXXXXXXXXXGXXXXXXXXXXXXXXXXXXXGXXXXXXXXXXXXXXXXXXXGXXXXXXXXXXXXXXXXXXX,0,300,0
33957,13,0,13,48,239,0,0,252,169,83,GXXXXXXXXXXXXXXXXXXXGXXXXXXXXXXXXXXXXXXXGXXXXXXXXXXXXXXXXXXXGXXXXXXXXXXXXXXXXXXXGXXXXXXXXXXXXXXXXXXXGXXXXXXXXXXXXXXXXXXXGXXXXXXXXXXXXXXXXXXXGXXXXXXXXXXXXXXXXXXXGXXXXXXXXXXXXXXXXXXXGXXXXXXXXXXXXXXXXXXXGXXXXXXXXXXXXXXXXXXXGXXXXXXXXXXXXXXXXXXXGXXXXXXXXXXXXXXXXXXX,0,300,0
33978,13,0,13,48,239,0,0,252,172,80,GXXXXXXXXXXXXXXXXXXXGXXXXXXXXXXXXXXXXXXXGXXXXXXXXXXXXXXXXXXXGXXXXXXXXXXXXXXXXXXXGXXXXXXXXXXXXXXXXXXXGXXXXXXXXXXXXXXXXXXXGXXXXXXXXXXXXXXXXXXXGXXXXXXXXXXXXXXXXXXXGXXXXXXXXXXXXXXXXXXXGXXXXXXXXXXXXXXXXXXXGXXXXXXXXXXXXXXXXXXXGXXXXXXXXXXXXXXXXXXXGXXXXXXXXXXXXXXXXXXX,0,300,0
33999,13,0,13,48,239,0,0,251,168,83,GXXXXXXXXXXXXXXXXXXXGXXXXXXXXXXXXXXXXXXXGXXXXXXXXXXXXXXXXXXXGXXXXXXXXXXXXXXXXXXXGXXXXXXXXXXXXXXXXXXXGXXXXXXXXXXXXXXXXXXXGXXXXXXXXXXXXXXXXXXXGXXXXXXXXXXXXXXXXXXXGXXXXXXXXXXXXXXXXXXXGXXXXXXXXXXXXXXXXXXXGXXXXXXXXXXXXXXXXXXXGXXXXXXXXXXXXXXXXXXXGXXXXXXXXXXXXXXXXXXX,0,300,0

34020,13,0,13,44,243,0,0,255,166,89,GXXXXXXXXXXXXXXXXXXXGXXXXXXXXXXXXXXXXXXXGXXXXXXXXXXXXXXXXXXXGXXXXXXXXXXXXXXXXXXXGXXXXXXXXXXXXXXXXXXXGXXXXXXXXXXXXXXXXXXXGXXXXXXXXXXXXXXXXXXXGXXXXXXXXXXXXXXXXXXXGXXXXXXXXXXXXXXXXXXXGXXXXXXXXXXXXXXXXXXXGXXXXXXXXXXXXXXXXXXXGXXXXXXXXXXXXXXXXXXXGXXXXXXXXXXXXXXXXXXX,0,300,0
34041,13,0,13,44,243,0,0,255,169,86,GXXXXXXXXXXXXXXXXXXXGXXXXXXXXXXXXXXXXXXXGXXXXXXXXXXXXXXXXXXXGXXXXXXXXXXXXXXXXXXXGXXXXXXXXXXXXXXXXXXXGXXXXXXXXXXXXXXXXXXXGXXXXXXXXXXXXXXXXXXXGXXXXXXXXXXXXXXXXXXXGXXXXXXXXXXXXXXXXXXXGXXXXXXXXXXXXXXXXXXXGXXXXXXXXXXXXXXXXXXXGXXXXXXXXXXXXXXXXXXXGXXXXXXXXXXXXXXXXXXX,0,300,0
34062,13,0,13,43,244,0,0,256,168,88,GXXXXXXXXXXXXXXXXXXXGXXXXXXXXXXXXXXXXXXXGXXXXXXXXXXXXXXXXXXXGXXXXXXXXXXXXXXXXXXXGXXXXXXXXXXXXXXXXXXXGXXXXXXXXXXXXXXXXXXXGXXXXXXXXXXXXXXXXXXXGXXXXXXXXXXXXXXXXXXXGXXXXXXXXXXXXXXXXXXXGXXXXXXXXXXXXXXXXXXXGXXXXXXXXXXXXXXXXXXXGXXXXXXXXXXXXXXXXXXXGXXXXXXXXXXXXXXXXXXX,0,300,0
34083,13,0,13,42,245,0,0,257,169,88,GXXXXXXXXXXXXXXXXXXXGXXXXXXXXXXXXXXXXXXXGXXXXXXXXXXXXXXXXXXXGXXXXXXXXXXXXXXXXXXXGXXXXXXXXXXXXXXXXXXXGXXXXXXXXXXXXXXXXXXXGXXXXXXXXXXXXXXXXXXXGXXXXXXXXXXXXXXXXXXXGXXXXXXXXXXXXXXXXXXXGXXXXXXXXXXXXXXXXXXXGXXXXXXXXXXXXXXXXXXXGXXXXXXXXXXXXXXXXXXXGXXXXXXXXXXXXXXXXXXX,0,300,0
34104,13,0,13,42,245,0,0,257,169,88,GXXXXXXXXXXXXXXXXXXXGXXXXXXXXXXXXXXXXXXXGXXXXXXXXXXXXXXXXXXXGXXXXXXXXXXXXXXXXXXXGXXXXXXXXXXXXXXXXXXXGXXXXXXXXXXXXXXXXXXXGXXXXXXXXXXXXXXXXXXXGXXXXXXXXXXXXXXXXXXXGXXXXXXXXXXXXXXXXXXXGXXXXXXXXXXXXXXXXXXXGXXXXXXXXXXXXXXXXXXXGXXXXXXXXXXXXXXXXXXXGXXXXXXXXXXXXXXXXXXX,0,300,0

34125,13,0,13,45,242,0,0,254,167,87,GXXXXXXXXXXXXXXXXXXXGXXXXXXXXXXXXXXXXXXXGXXXXXXXXXXXXXXXXXXXGXXXXXXXXXXXXXXXXXXXGXXXXXXXXXXXXXXXXXXXGXXXXXXXXXXXXXXXXXXXGXXXXXXXXXXXXXXXXXXXGXXXXXXXXXXXXXXXXXXXGXXXXXXXXXXXXXXXXXXXGXXXXXXXXXXXXXXXXXXXGXXXXXXXXXXXXXXXXXXXGXXXXXXXXXXXXXXXXXXXGXXXXXXXXXXXXXXXXXXX,0,300,0
34146,13,0,13,44,243,0,0,255,170,85,GXXXXXXXXXXXXXXXXXXXGXXXXXXXXXXXXXXXXXXXGXXXXXXXXXXXXXXXXXXXGXXXXXXXXXXXXXXXXXXXGXXXXXXXXXXXXXXXXXXXGXXXXXXXXXXXXXXXXXXXGXXXXXXXXXXXXXXXXXXXGXXXXXXXXXXXXXXXXXXXGXXXXXXXXXXXXXXXXXXXGXXXXXXXXXXXXXXXXXXXGXXXXXXXXXXXXXXXXXXXGXXXXXXXXXXXXXXXXXXXGXXXXXXXXXXXXXXXXXXX,0,300,0
34167,13,0,13,47,240,0,0,252,176,76,GXXXXXXXXXXXXXXXXXXXGXXXXXXXXXXXXXXXXXXXGXXXXXXXXXXXXXXXXXXXGXXXXXXXXXXXXXXXXXXXGXXXXXXXXXXXXXXXXXXXGXXXXXXXXXXXXXXXXXXXGXXXXXXXXXXXXXXXXXXXGXXXXXXXXXXXXXXXXXXXGXXXXXXXXXXXXXXXXXXXGXXXXXXXXXXXXXXXXXXXGXXXXXXXXXXXXXXXXXXXGXXXXXXXXXXXXXXXXXXXGXXXXXXXXXXXXXXXXXXX,0,300,0
34188,13,0,13,50,237,0,0,248,171,77,GXXXXXXXXXXXXXXXXXXXGXXXXXXXXXXXXXXXXXXXGXXXXXXXXXXXXXXXXXXXGXXXXXXXXXXXXXXXXXXXGXXXXXXXXXXXXXXXXXXXGXXXXXXXXXXXXXXXXXXXGXXXXXXXXXXXXXXXXXXXGXXXXXXXXXXXXXXXXXXXGXXXXXXXXXXXXXXXXXXXGXXXXXXXXXXXXXXXXXXXGXXXXXXXXXXXXXXXXXXXGXXXXXXXXXXXXXXXXXXXGXXXXXXXXXXXXXXXXXXX,0,300,0
34209,13,0,13,51,236,0,0,248,171,77,GXXXXXXXXXXXXXXXXXXXGXXXXXXXXXXXXXXXXXXXGXXXXXXXXXXXXXXXXXXXGXXXXXXXXXXXXXXXXXXXGXXXXXXXXXXXXXXXXXXXGXXXXXXXXXXXXXXXXXXXGXXXXXXXXXXXXXXXXXXXGXXXXXXXXXXXXXXXXXXXGXXXXXXXXXXXXXXXXXXXGXXXXXXXXXXXXXXXXXXXGXXXXXXXXXXXXXXXXXXXGXXXXXXXXXXXXXXXXXXXGXXXXXXXXXXXXXXXXXXX,0,300,0

34230,13,0,13,52,235,0,0,246,172,74,GXXXXXXXXXXXXXXXXXXXGXXXXXXXXXXXXXXXXXXXGXXXXXXXXXXXXXXXXXXXGXXXXXXXXXXXXXXXXXXXGXXXXXXXXXXXXXXXXXXXGXXXXXXXXXXXXXXXXXXXGXXXXXXXXXXXXXXXXXXXGXXXXXXXXXXXXXXXXXXXGXXXXXXXXXXXXXXXXXXXGXXXXXXXXXXXXXXXXXXXGXXXXXXXXXXXXXXXXXXXGXXXXXXXXXXXXXXXXXXXGXXXXXXXXXXXXXXXXXXX,0,300,0
34251,13,0,13,50,237,0,0,250,174,76,GXXXXXXXXXXXXXXXXXXXGXXXXXXXXXXXXXXXXXXXGXXXXXXXXXXXXXXXXXXXGXXXXXXXXXXXXXXXXXXXGXXXXXXXXXXXXXXXXXXXGXXXXXXXXXXXXXXXXXXXGXXXXXXXXXXXXXXXXXXXGXXXXXXXXXXXXXXXXXXXGXXXXXXXXXXXXXXXXXXXGXXXXXXXXXXXXXXXXXXXGXXXXXXXXXXXXXXXXXXXGXXXXXXXXXXXXXXXXXXXGXXXXXXXXXXXXXXXXXXX,0,300,0
34272,13,0,13,49,238,0,0,251,175,76,GXXXXXXXXXXXXXXXXXXXGXXXXXXXXXXXXXXXXXXXGXXXXXXXXXXXXXXXXXXXGXXXXXXXXXXXXXXXXXXXGXXXXXXXXXXXXXXXXXXXGXXXXXXXXXXXXXXXXXXXGXXXXXXXXXXXXXXXXXXXGXXXXXXXXXXXXXXXXXXXGXXXXXXXXXXXXXXXXXXXGXXXXXXXXXXXXXXXXXXXGXXXXXXXXXXXXXXXXXXXGXXXXXXXXXXXXXXXXXXXGXXXXXXXXXXXXXXXXXXX,0,300,0
34293,13,0,13,52,235,0,0,248,174,74,GXXXXXXXXXXXXXXXXXXXGXXXXXXXXXXXXXXXXXXXGXXXXXXXXXXXXXXXXXXXGXXXXXXXXXXXXXXXXXXXGXXXXXXXXXXXXXXXXXXXGXXXXXXXXXXXXXXXXXXXGXXXXXXXXXXXXXXXXXXXGXXXXXXXXXXXXXXXXXXXGXXXXXXXXXXXXXXXXXXXGXXXXXXXXXXXXXXXXXXXGXXXXXXXXXXXXXXXXXXXGXXXXXXXXXXXXXXXXXXXGXXXXXXXXXXXXXXXXXXX,0,300,0
34314,13,0,13,52,235,0,0,247,171,76,GXXXXXXXXXXXXXXXXXXXGXXXXXXXXXXXXXXXXXXXGXXXXXXXXXXXXXXXXXXXGXXXXXXXXXXXXXXXXXXXGXXXXXXXXXXXXXXXXXXXGXXXXXXXXXXXXXXXXXXXGXXXXXXXXXXXXXXXXXXXGXXXXXXXXXXXXXXXXXXXGXXXXXXXXXXXXXXXXXXXGXXXXXXXXXXXXXXXXXXXGXXXXXXXXXXXXXXXXXXXGXXXXXXXXXXXXXXXXXXXGXXXXXXXXXXXXXXXXXXX,0,300,0

34335,14,1,13,48,238,0,0,250,172,78,GXXXXXXXXXXXXXXXXXXXGXXXXXXXXXXXXXXXXXXXGXXXXXXXXXXXXXXXXXXXGXXXXXXXXXXXXXXXXXXXGXXXXXXXXXXXXXXXXXXXGXXXXXXXXXXXXXXXXXXXGXXXXXXXXXXXXXXXXXXXGXXXXXXXXXXXXXXXXXXXGXXXXXXXXXXXXXXXXXXXGXXXXXXXXXXXXXXXXXXXGAXXXXXXXXXXXXXXXXXXGXXXXXXXXXXXXXXXXXXXGXXXXXXXXXXXXXXXXXXX,0,300,0
34356,15,2,13,49,236,0,0,248,171,77,GAXXXXXXXXXXXXXXXXXXGXXXXXXXXXXXXXXXXXXXGXXXXXXXXXXXXXXXXXXXGXXXXXXXXXXXXXXXXXXXGXXXXXXXXXXXXXXXXXXXGXXXXXXXXXXXXXXXXXXXGXXXXXXXXXXXXXXXXXXXGXXXXXXXXXXXXXXXXXXXGXXXXXXXXXXXXXXXXXXXGXXXXXXXXXXXXXXXXXXXGAXXXXXXXXXXXXXXXXXXGXXXXXXXXXXXXXXXXXXXGXXXXXXXXXXXXXXXXXXX,0,300,0
34377,14,1,13,50,236,0,0,247,171,76,GAXXXXXXXXXXXXXXXXXXGXXXXXXXXXXXXXXXXXXXGXXXXXXXXXXXXXXXXXXXGXXXXXXXXXXXXXXXXXXXGXXXXXXXXXXXXXXXXXXXGXXXXXXXXXXXXXXXXXXXGXXXXXXXXXXXXXXXXXXXGXXXXXXXXXXXXXXXXXXXGXXXXXXXXXXXXXXXXXXXGXXXXXXXXXXXXXXXXXXXGXXXXXXXXXXXXXXXXXXXGXXXXXXXXXXXXXXXXXXXGXXXXXXXXXXXXXXXXXXX,0,300,0
34398,14,1,13,46,240,0,0,251,174,77,GAXXXXXXXXXXXXXXXXXXGXXXXXXXXXXXXXXXXXXXGXXXXXXXXXXXXXXXXXXXGXXXXXXXXXXXXXXXXXXXGXXXXXXXXXXXXXXXXXXXGXXXXXXXXXXXXXXXXXXXGXXXXXXXXXXXXXXXXXXXGXXXXXXXXXXXXXXXXXXXGXXXXXXXXXXXXXXXXXXXGXXXXXXXXXXXXXXXXXXXGXXXXXXXXXXXXXXXXXXXGXXXXXXXXXXXXXXXXXXXGXXXXXXXXXXXXXXXXXXX,0,300,0
34419,14,1,13,46,240,0,0,252,174,78,GAXXXXXXXXXXXXXXXXXXGXXXXXXXXXXXXXXXXXXXGXXXXXXXXXXXXXXXXXXXGXXXXXXXXXXXXXXXXXXXGXXXXXXXXXXXXXXXXXXXGXXXXXXXXXXXXXXXXXXXGXXXXXXXXXXXXXXXXXXXGXXXXXXXXXXXXXXXXXXXGXXXXXXXXXXXXXXXXXXXGXXXXXXXXXXXXXXXXXXXGXXXXXXXXXXXXXXXXXXXGXXXXXXXXXXXXXXXXXXXGXXXXXXXXXXXXXXXXXXX,0,300,0

34440,14,1,13,40,246,0,0,259,175,84,GAXXXXXXXXXXXXXXXXXXGXXXXXXXXXXXXXXXXXXXGXXXXXXXXXXXXXXXXXXXGXXXXXXXXXXXXXXXXXXXGXXXXXXXXXXXXXXXXXXXGXXXXXXXXXXXXXXXXXXXGXXXXXXXXXXXXXXXXXXXGXXXXXXXXXXXXXXXXXXXGXXXXXXXXXXXXXXXXXXXGXXXXXXXXXXXXXXXXXXXGXXXXXXXXXXXXXXXXXXXGXXXXXXXXXXXXXXXXXXXGXXXXXXXXXXXXXXXXXXX,0,300,0
34461,14,1,13,40,246,0,0,259,171,88,GAXXXXXXXXXXXXXXXXXXGXXXXXXXXXXXXXXXXXXXGXXXXXXXXXXXXXXXXXXXGXXXXXXXXXXXXXXXXXXXGXXXXXXXXXXXXXXXXXXXGXXXXXXXXXXXXXXXXXXXGXXXXXXXXXXXXXXXXXXXGXXXXXXXXXXXXXXXXXXXGXXXXXXXXXXXXXXXXXXXGXXXXXXXXXXXXXXXXXXXGXXXXXXXXXXXXXXXXXXXGXXXXXXXXXXXXXXXXXXXGXXXXXXXXXXXXXXXXXXX,0,300,0
34482,14,1,13,41,245,0,0,258,171,87,GAXXXXXXXXXXXXXXXXXXGXXXXXXXXXXXXXXXXXXXGXXXXXXXXXXXXXXXXXXXGXXXXXXXXXXXXXXXXXXXGXXXXXXXXXXXXXXXXXXXGXXXXXXXXXXXXXXXXXXXGXXXXXXXXXXXXXXXXXXXGXXXXXXXXXXXXXXXXXXXGXXXXXXXXXXXXXXXXXXXGXXXXXXXXXXXXXXXXXXXGXXXXXXXXXXXXXXXXXXXGXXXXXXXXXXXXXXXXXXXGXXXXXXXXXXXXXXXXXXX,0,300,0
34503,14,1,13,40,246,0,0,259,177,82,GAXXXXXXXXXXXXXXXXXXGXXXXXXXXXXXXXXXXXXXGXXXXXXXXXXXXXXXXXXXGXXXXXXXXXXXXXXXXXXXGXXXXXXXXXXXXXXXXXXXGXXXXXXXXXXXXXXXXXXXGXXXXXXXXXXXXXXXXXXXGXXXXXXXXXXXXXXXXXXXGXXXXXXXXXXXXXXXXXXXGXXXXXXXXXXXXXXXXXXXGXXXXXXXXXXXXXXXXXXXGXXXXXXXXXXXXXXXXXXXGXXXXXXXXXXXXXXXXXXX,0,300,0
34524,14,1,13,42,244,0,0,257,175,82,GAXXXXXXXXXXXXXXXXXXGXXXXXXXXXXXXXXXXXXXGXXXXXXXXXXXXXXXXXXXGXXXXXXXXXXXXXXXXXXXGXXXXXXXXXXXXXXXXXXXGXXXXXXXXXXXXXXXXXXXGXXXXXXXXXXXXXXXXXXXGXXXXXXXXXXXXXXXXXXXGXXXXXXXXXXXXXXXXXXXGXXXXXXXXXXXXXXXXXXXGXXXXXXXXXXXXXXXXXXXGXXXXXXXXXXXXXXXXXXXGXXXXXXXXXXXXXXXXXXX,0,300,0

34545,14,1,13,42,244,0,0,257,173,84,GAXXXXXXXXXXXXXXXXXXGXXXXXXXXXXXXXXXXXXXGXXXXXXXXXXXXXXXXXXXGXXXXXXXXXXXXXXXXXXXGXXXXXXXXXXXXXXXXXXXGXXXXXXXXXXXXXXXXXXXGXXXXXXXXXXXXXXXXXXXGXXXXXXXXXXXXXXXXXXXGXXXXXXXXXXXXXXXXXXXGXXXXXXXXXXXXXXXXXXXGXXXXXXXXXXXXXXXXXXXGXXXXXXXXXXXXXXXXXXXGXXXXXXXXXXXXXXXXXXX,0,300,0
34566,14,1,13,43,243,0,0,256,172,84,GAXXXXXXXXXXXXXXXXXXGXXXXXXXXXXXXXXXXXXXGXXXXXXXXXXXXXXXXXXXGXXXXXXXXXXXXXXXXXXXGXXXXXXXXXXXXXXXXXXXGXXXXXXXXXXXXXXXXXXXGXXXXXXXXXXXXXXXXXXXGXXXXXXXXXXXXXXXXXXXGXXXXXXXXXXXXXXXXXXXGXXXXXXXXXXXXXXXXXXXGXXXXXXXXXXXXXXXXXXXGXXXXXXXXXXXXXXXXXXXGXXXXXXXXXXXXXXXXXXX,0,300,0
34587,14,1,13,40,246,0,0,258,176,82,GAXXXXXXXXXXXXXXXXXXGXXXXXXXXXXXXXXXXXXXGXXXXXXXXXXXXXXXXXXXGXXXXXXXXXXXXXXXXXXXGXXXXXXXXXXXXXXXXXXXGXXXXXXXXXXXXXXXXXXXGXXXXXXXXXXXXXXXXXXXGXXXXXXXXXXXXXXXXXXXGXXXXXXXXXXXXXXXXXXXGXXXXXXXXXXXXXXXXXXXGXXXXXXXXXXXXXXXXXXXGXXXXXXXXXXXXXXXXXXXGXXXXXXXXXXXXXXXXXXX,0,300,0
34608,14,1,13,44,242,0,0,255,173,82,GAXXXXXXXXXXXXXXXXXXGXXXXXXXXXXXXXXXXXXXGXXXXXXXXXXXXXXXXXXXGXXXXXXXXXXXXXXXXXXXGXXXXXXXXXXXXXXXXXXXGXXXXXXXXXXXXXXXXXXXGXXXXXXXXXXXXXXXXXXXGXXXXXXXXXXXXXXXXXXXGXXXXXXXXXXXXXXXXXXXGXXXXXXXXXXXXXXXXXXXGXXXXXXXXXXXXXXXXXXXGXXXXXXXXXXXXXXXXXXXGXXXXXXXXXXXXXXXXXXX,0,300,0
34629,14,1,13,45,241,0,0,252,174,78,GAXXXXXXXXXXXXXXXXXXGXXXXXXXXXXXXXXXXXXXGXXXXXXXXXXXXXXXXXXXGXXXXXXXXXXXXXXXXXXXGXXXXXXXXXXXXXXXXXXXGXXXXXXXXXXXXXXXXXXXGXXXXXXXXXXXXXXXXXXXGXXXXXXXXXXXXXXXXXXXGXXXXXXXXXXXXXXXXXXXGXXXXXXXXXXXXXXXXXXXGXXXXXXXXXXXXXXXXXXXGXXXXXXXXXXXXXXXXXXXGXXXXXXXXXXXXXXXXXXX,0,300,0

34650,14,0,14,42,244,0,0,256,178,78,GOXXXXXXXXXXXXXXXXXXGXXXXXXXXXXXXXXXXXXXGXXXXXXXXXXXXXXXXXXXGXXXXXXXXXXXXXXXXXXXGXXXXXXXXXXXXXXXXXXXGXXXXXXXXXXXXXXXXXXXGXXXXXXXXXXXXXXXXXXXGXXXXXXXXXXXXXXXXXXXGXXXXXXXXXXXXXXXXXXXGXXXXXXXXXXXXXXXXXXXGXXXXXXXXXXXXXXXXXXXGXXXXXXXXXXXXXXXXXXXGXXXXXXXXXXXXXXXXXXX,0,300,0
34671,13,0,13,49,238,0,0,250,177,73,GXXXXXXXXXXXXXXXXXXXGXXXXXXXXXXXXXXXXXXXGXXXXXXXXXXXXXXXXXXXGXXXXXXXXXXXXXXXXXXXGXXXXXXXXXXXXXXXXXXXGXXXXXXXXXXXXXXXXXXXGXXXXXXXXXXXXXXXXXXXGXXXXXXXXXXXXXXXXXXXGXXXXXXXXXXXXXXXXXXXGXXXXXXXXXXXXXXXXXXXGXXXXXXXXXXXXXXXXXXXGXXXXXXXXXXXXXXXXXXXGXXXXXXXXXXXXXXXXXXX,0,300,0
34692,13,0,13,49,238,0,0,249,177,72,GXXXXXXXXXXXXXXXXXXXGXXXXXXXXXXXXXXXXXXXGXXXXXXXXXXXXXXXXXXXGXXXXXXXXXXXXXXXXXXXGXXXXXXXXXXXXXXXXXXXGXXXXXXXXXXXXXXXXXXXGXXXXXXXXXXXXXXXXXXXGXXXXXXXXXXXXXXXXXXXGXXXXXXXXXXXXXXXXXXXGXXXXXXXXXXXXXXXXXXXGXXXXXXXXXXXXXXXXXXXGXXXXXXXXXXXXXXXXXXXGXXXXXXXXXXXXXXXXXXX,0,300,0
34713,13,0,13,52,235,0,0,246,173,73,GXXXXXXXXXXXXXXXXXXXGXXXXXXXXXXXXXXXXXXXGXXXXXXXXXXXXXXXXXXXGXXXXXXXXXXXXXXXXXXXGXXXXXXXXXXXXXXXXXXXGXXXXXXXXXXXXXXXXXXXGXXXXXXXXXXXXXXXXXXXGXXXXXXXXXXXXXXXXXXXGXXXXXXXXXXXXXXXXXXXGXXXXXXXXXXXXXXXXXXXGXXXXXXXXXXXXXXXXXXXGXXXXXXXXXXXXXXXXXXXGXXXXXXXXXXXXXXXXXXX,0,300,0
34734,13,0,13,48,239,0,0,251,175,76,GXXXXXXXXXXXXXXXXXXXGXXXXXXXXXXXXXXXXXXXGXXXXXXXXXXXXXXXXXXXGXXXXXXXXXXXXXXXXXXXGXXXXXXXXXXXXXXXXXXXGXXXXXXXXXXXXXXXXXXXGXXXXXXXXXXXXXXXXXXXGXXXXXXXXXXXXXXXXXXXGXXXXXXXXXXXXXXXXXXXGXXXXXXXXXXXXXXXXXXXGXXXXXXXXXXXXXXXXXXXGXXXXXXXXXXXXXXXXXXXGXXXXXXXXXXXXXXXXXXX,0,300,0

34755,13,0,13,48,239,0,0,250,175,75,GXXXXXXXXXXXXXXXXXXXGXXXXXXXXXXXXXXXXXXXGXXXXXXXXXXXXXXXXXXXGXXXXXXXXXXXXXXXXXXXGXXXXXXXXXXXXXXXXXXXGXXXXXXXXXXXXXXXXXXXGXXXXXXXXXXXXXXXXXXXGXXXXXXXXXXXXXXXXXXXGXXXXXXXXXXXXXXXXXXXGXXXXXXXXXXXXXXXXXXXGXXXXXXXXXXXXXXXXXXXGXXXXXXXXXXXXXXXXXXXGXXXXXXXXXXXXXXXXXXX,0,300,0
34776,13,0,13,47,240,0,0,252,176,76,GXXXXXXXXXXXXXXXXXXXGXXXXXXXXXXXXXXXXXXXGXXXXXXXXXXXXXXXXXXXGXXXXXXXXXXXXXXXXXXXGXXXXXXXXXXXXXXXXXXXGXXXXXXXXXXXXXXXXXXXGXXXXXXXXXXXXXXXXXXXGXXXXXXXXXXXXXXXXXXXGXXXXXXXXXXXXXXXXXXXGXXXXXXXXXXXXXXXXXXXGXXXXXXXXXXXXXXXXXXXGXXXXXXXXXXXXXXXXXXXGXXXXXXXXXXXXXXXXXXX,0,300,0
34797,13,0,13,50,237,0,0,249,172,77,GXXXXXXXXXXXXXXXXXXXGXXXXXXXXXXXXXXXXXXXGXXXXXXXXXXXXXXXXXXXGXXXXXXXXXXXXXXXXXXXGXXXXXXXXXXXXXXXXXXXGXXXXXXXXXXXXXXXXXXXGXXXXXXXXXXXXXXXXXXXGXXXXXXXXXXXXXXXXXXXGXXXXXXXXXXXXXXXXXXXGXXXXXXXXXXXXXXXXXXXGXXXXXXXXXXXXXXXXXXXGXXXXXXXXXXXXXXXXXXXGXXXXXXXXXXXXXXXXXXX,0,300,0
34818,13,0,13,48,239,0,0,251,173,78,GXXXXXXXXXXXXXXXXXXXGXXXXXXXXXXXXXXXXXXXGXXXXXXXXXXXXXXXXXXXGXXXXXXXXXXXXXXXXXXXGXXXXXXXXXXXXXXXXXXXGXXXXXXXXXXXXXXXXXXXGXXXXXXXXXXXXXXXXXXXGXXXXXXXXXXXXXXXXXXXGXXXXXXXXXXXXXXXXXXXGXXXXXXXXXXXXXXXXXXXGXXXXXXXXXXXXXXXXXXXGXXXXXXXXXXXXXXXXXXXGXXXXXXXXXXXXXXXXXXX,0,300,0
34839,13,0,13,45,242,0,0,254,171,83,GXXXXXXXXXXXXXXXXXXXGXXXXXXXXXXXXXXXXXXXGXXXXXXXXXXXXXXXXXXXGXXXXXXXXXXXXXXXXXXXGXXXXXXXXXXXXXXXXXXXGXXXXXXXXXXXXXXXXXXXGXXXXXXXXXXXXXXXXXXXGXXXXXXXXXXXXXXXXXXXGXXXXXXXXXXXXXXXXXXXGXXXXXXXXXXXXXXXXXXXGXXXXXXXXXXXXXXXXXXXGXXXXXXXXXXXXXXXXXXXGXXXXXXXXXXXXXXXXXXX,0,300,0

34860,13,0,13,42,245,0,0,257,170,87,GXXXXXXXXXXXXXXXXXXXGXXXXXXXXXXXXXXXXXXXGXXXXXXXXXXXXXXXXXXXGXXXXXXXXXXXXXXXXXXXGXXXXXXXXXXXXXXXXXXXGXXXXXXXXXXXXXXXXXXXGXXXXXXXXXXXXXXXXXXXGXXXXXXXXXXXXXXXXXXXGXXXXXXXXXXXXXXXXXXXGXXXXXXXXXXXXXXXXXXXGXXXXXXXXXXXXXXXXXXXGXXXXXXXXXXXXXXXXXXXGXXXXXXXXXXXXXXXXXXX,0,300,0
34881,13,0,13,39,248,0,0,260,173,87,GXXXXXXXXXXXXXXXXXXXGXXXXXXXXXXXXXXXXXXXGXXXXXXXXXXXXXXXXXXXGXXXXXXXXXXXXXXXXXXXGXXXXXXXXXXXXXXXXXXXGXXXXXXXXXXXXXXXXXXXGXXXXXXXXXXXXXXXXXXXGXXXXXXXXXXXXXXXXXXXGXXXXXXXXXXXXXXXXXXXGXXXXXXXXXXXXXXXXXXXGXXXXXXXXXXXXXXXXXXXGXXXXXXXXXXXXXXXXXXXGXXXXXXXXXXXXXXXXXXX,0,300,0
34902,13,0,13,41,246,0,0,256,170,86,GXXXXXXXXXXXXXXXXXXXGXXXXXXXXXXXXXXXXXXXGXXXXXXXXXXXXXXXXXXXGXXXXXXXXXXXXXXXXXXXGXXXXXXXXXXXXXXXXXXXGXXXXXXXXXXXXXXXXXXXGXXXXXXXXXXXXXXXXXXXGXXXXXXXXXXXXXXXXXXXGXXXXXXXXXXXXXXXXXXXGXXXXXXXXXXXXXXXXXXXGXXXXXXXXXXXXXXXXXXXGXXXXXXXXXXXXXXXXXXXGXXXXXXXXXXXXXXXXXXX,0,300,0
34923,13,0,13,41,246,0,0,258,176,82,GXXXXXXXXXXXXXXXXXXXGXXXXXXXXXXXXXXXXXXXGXXXXXXXXXXXXXXXXXXXGXXXXXXXXXXXXXXXXXXXGXXXXXXXXXXXXXXXXXXXGXXXXXXXXXXXXXXXXXXXGXXXXXXXXXXXXXXXXXXXGXXXXXXXXXXXXXXXXXXXGXXXXXXXXXXXXXXXXXXXGXXXXXXXXXXXXXXXXXXXGXXXXXXXXXXXXXXXXXXXGXXXXXXXXXXXXXXXXXXXGXXXXXXXXXXXXXXXXXXX,0,300,0
34944,13,0,13,45,242,0,0,254,172,82,GXXXXXXXXXXXXXXXXXXXGXXXXXXXXXXXXXXXXXXXGXXXXXXXXXXXXXXXXXXXGXXXXXXXXXXXXXXXXXXXGXXXXXXXXXXXXXXXXXXXGXXXXXXXXXXXXXXXXXXXGXXXXXXXXXXXXXXXXXXXGXXXXXXXXXXXXXXXXXXXGXXXXXXXXXXXXXXXXXXXGXXXXXXXXXXXXXXXXXXXGXXXXXXXXXXXXXXXXXXXGXXXXXXXXXXXXXXXXXXXGXXXXXXXXXXXXXXXXXXX,0,300,0

34965,13,0,13,41,246,0,0,258,174,84,GXXXXXXXXXXXXXXXXXXXGXXXXXXXXXXXXXXXXXXXGXXXXXXXXXXXXXXXXXXXGXXXXXXXXXXXXXXXXXXXGXXXXXXXXXXXXXXXXXXXGXXXXXXXXXXXXXXXXXXXGXXXXXXXXXXXXXXXXXXXGXXXXXXXXXXXXXXXXXXXGXXXXXXXXXXXXXXXXXXXGXXXXXXXXXXXXXXXXXXXGXXXXXXXXXXXXXXXXXXXGXXXXXXXXXXXXXXXXXXXGXXXXXXXXXXXXXXXXXXX,0,300,0
34986,13,0,13,44,243,0,0,255,173,82,GXXXXXXXXXXXXXXXXXXXGXXXXXXXXXXXXXXXXXXXGXXXXXXXXXXXXXXXXXXXGXXXXXXXXXXXXXXXXXXXGXXXXXXXXXXXXXXXXXXXGXXXXXXXXXXXXXXXXXXXGXXXXXXXXXXXXXXXXXXXGXXXXXXXXXXXXXXXXXXXGXXXXXXXXXXXXXXXXXXXGXXXXXXXXXXXXXXXXXXXGXXXXXXXXXXXXXXXXXXXGXXXXXXXXXXXXXXXXXXXGXXXXXXXXXXXXXXXXXXX,0,300,0
35007,13,0,13,42,245,0,0,257,171,86,GXXXXXXXXXXXXXXXXXXXGXXXXXXXXXXXXXXXXXXXGXXXXXXXXXXXXXXXXXXXGXXXXXXXXXXXXXXXXXXXGXXXXXXXXXXXXXXXXXXXGXXXXXXXXXXXXXXXXXXXGXXXXXXXXXXXXXXXXXXXGXXXXXXXXXXXXXXXXXXXGXXXXXXXXXXXXXXXXXXXGXXXXXXXXXXXXXXXXXXXGXXXXXXXXXXXXXXXXXXXGXXXXXXXXXXXXXXXXXXXGXXXXXXXXXXXXXXXXXXX,0,300,0
35028,13,0,13,40,247,0,0,259,170,89,GXXXXXXXXXXXXXXXXXXXGXXXXXXXXXXXXXXXXXXXGXXXXXXXXXXXXXXXXXXXGXXXXXXXXXXXXXXXXXXXGXXXXXXXXXXXXXXXXXXXGXXXXXXXXXXXXXXXXXXXGXXXXXXXXXXXXXXXXXXXGXXXXXXXXXXXXXXXXXXXGXXXXXXXXXXXXXXXXXXXGXXXXXXXXXXXXXXXXXXXGXXXXXXXXXXXXXXXXXXXGXXXXXXXXXXXXXXXXXXXGXXXXXXXXXXXXXXXXXXX,0,300,0
35049,13,0,13,37,250,0,0,262,173,89,GXXXXXXXXXXXXXXXXXXXGXXXXXXXXXXXXXXXXXXXGXXXXXXXXXXXXXXXXXXXGXXXXXXXXXXXXXXXXXXXGXXXXXXXXXXXXXXXXXXXGXXXXXXXXXXXXXXXXXXXGXXXXXXXXXXXXXXXXXXXGXXXXXXXXXXXXXXXXXXXGXXXXXXXXXXXXXXXXXXXGXXXXXXXXXXXXXXXXXXXGXXXXXXXXXXXXXXXXXXXGXXXXXXXXXXXXXXXXXXXGXXXXXXXXXXXXXXXXXXX,0,300,0

35070,13,0,13,37,250,0,0,262,171,91,GXXXXXXXXXXXXXXXXXXXGXXXXXXXXXXXXXXXXXXXGXXXXXXXXXXXXXXXXXXXGXXXXXXXXXXXXXXXXXXXGXXXXXXXXXXXXXXXXXXXGXXXXXXXXXXXXXXXXXXXGXXXXXXXXXXXXXXXXXXXGXXXXXXXXXXXXXXXXXXXGXXXXXXXXXXXXXXXXXXXGXXXXXXXXXXXXXXXXXXXGXXXXXXXXXXXXXXXXXXXGXXXXXXXXXXXXXXXXXXXGXXXXXXXXXXXXXXXXXXX,0,300,0
35091,13,0,13,40,247,0,0,259,171,88,GXXXXXXXXXXXXXXXXXXXGXXXXXXXXXXXXXXXXXXXGXXXXXXXXXXXXXXXXXXXGXXXXXXXXXXXXXXXXXXXGXXXXXXXXXXXXXXXXXXXGXXXXXXXXXXXXXXXXXXXGXXXXXXXXXXXXXXXXXXXGXXXXXXXXXXXXXXXXXXXGXXXXXXXXXXXXXXXXXXXGXXXXXXXXXXXXXXXXXXXGXXXXXXXXXXXXXXXXXXXGXXXXXXXXXXXXXXXXXXXGXXXXXXXXXXXXXXXXXXX,0,300,0
35112,13,0,13,41,246,0,0,258,173,85,GXXXXXXXXXXXXXXXXXXXGXXXXXXXXXXXXXXXXXXXGXXXXXXXXXXXXXXXXXXXGXXXXXXXXXXXXXXXXXXXGXXXXXXXXXXXXXXXXXXXGXXXXXXXXXXXXXXXXXXXGXXXXXXXXXXXXXXXXXXXGXXXXXXXXXXXXXXXXXXXGXXXXXXXXXXXXXXXXXXXGXXXXXXXXXXXXXXXXXXXGXXXXXXXXXXXXXXXXXXXGXXXXXXXXXXXXXXXXXXXGXXXXXXXXXXXXXXXXXXX,0,300,0
35133,13,0,13,40,247,0,0,259,171,88,GXXXXXXXXXXXXXXXXXXXGXXXXXXXXXXXXXXXXXXXGXXXXXXXXXXXXXXXXXXXGXXXXXXXXXXXXXXXXXXXGXXXXXXXXXXXXXXXXXXXGXXXXXXXXXXXXXXXXXXXGXXXXXXXXXXXXXXXXXXXGXXXXXXXXXXXXXXXXXXXGXXXXXXXXXXXXXXXXXXXGXXXXXXXXXXXXXXXXXXXGXXXXXXXXXXXXXXXXXXXGXXXXXXXXXXXXXXXXXXXGXXXXXXXXXXXXXXXXXXX,0,300,0
35154,13,0,13,38,249,0,0,259,172,87,GXXXXXXXXXXXXXXXXXXXGXXXXXXXXXXXXXXXXXXXGXXXXXXXXXXXXXXXXXXXGXXXXXXXXXXXXXXXXXXXGXXXXXXXXXXXXXXXXXXXGXXXXXXXXXXXXXXXXXXXGXXXXXXXXXXXXXXXXXXXGXXXXXXXXXXXXXXXXXXXGXXXXXXXXXXXXXXXXXXXGXXXXXXXXXXXXXXXXXXXGXXXXXXXXXXXXXXXXXXXGXXXXXXXXXXXXXXXXXXXGXXXXXXXXXXXXXXXXXXX,0,300,0

35175,13,0,13,39,248,0,0,260,179,81,GXXXXXXXXXXXXXXXXXXXGXXXXXXXXXXXXXXXXXXXGXXXXXXXXXXXXXXXXXXXGXXXXXXXXXXXXXXXXXXXGXXXXXXXXXXXXXXXXXXXGXXXXXXXXXXXXXXXXXXXGXXXXXXXXXXXXXXXXXXXGXXXXXXXXXXXXXXXXXXXGXXXXXXXXXXXXXXXXXXXGXXXXXXXXXXXXXXXXXXXGXXXXXXXXXXXXXXXXXXXGXXXXXXXXXXXXXXXXXXXGXXXXXXXXXXXXXXXXXXX,0,300,0
35196,13,0,13,45,242,0,0,254,176,78,GXXXXXXXXXXXXXXXXXXXGXXXXXXXXXXXXXXXXXXXGXXXXXXXXXXXXXXXXXXXGXXXXXXXXXXXXXXXXXXXGXXXXXXXXXXXXXXXXXXXGXXXXXXXXXXXXXXXXXXXGXXXXXXXXXXXXXXXXXXXGXXXXXXXXXXXXXXXXXXXGXXXXXXXXXXXXXXXXXXXGXXXXXXXXXXXXXXXXXXXGXXXXXXXXXXXXXXXXXXXGXXXXXXXXXXXXXXXXXXXGXXXXXXXXXXXXXXXXXXX,0,300,0
35217,13,0,13,45,242,0,0,254,180,74,GXXXXXXXXXXXXXXXXXXXGXXXXXXXXXXXXXXXXXXXGXXXXXXXXXXXXXXXXXXXGXXXXXXXXXXXXXXXXXXXGXXXXXXXXXXXXXXXXXXXGXXXXXXXXXXXXXXXXXXXGXXXXXXXXXXXXXXXXXXXGXXXXXXXXXXXXXXXXXXXGXXXXXXXXXXXXXXXXXXXGXXXXXXXXXXXXXXXXXXXGXXXXXXXXXXXXXXXXXXXGXXXXXXXXXXXXXXXXXXXGXXXXXXXXXXXXXXXXXXX,0,300,0
35238,13,0,13,46,241,0,0,253,181,72,GXXXXXXXXXXXXXXXXXXXGXXXXXXXXXXXXXXXXXXXGXXXXXXXXXXXXXXXXXXXGXXXXXXXXXXXXXXXXXXXGXXXXXXXXXXXXXXXXXXXGXXXXXXXXXXXXXXXXXXXGXXXXXXXXXXXXXXXXXXXGXXXXXXXXXXXXXXXXXXXGXXXXXXXXXXXXXXXXXXXGXXXXXXXXXXXXXXXXXXXGXXXXXXXXXXXXXXXXXXXGXXXXXXXXXXXXXXXXXXXGXXXXXXXXXXXXXXXXXXX,0,300,0
35259,13,0,13,46,241,0,0,253,177,76,GXXXXXXXXXXXXXXXXXXXGXXXXXXXXXXXXXXXXXXXGXXXXXXXXXXXXXXXXXXXGXXXXXXXXXXXXXXXXXXXGXXXXXXXXXXXXXXXXXXXGXXXXXXXXXXXXXXXXXXXGXXXXXXXXXXXXXXXXXXXGXXXXXXXXXXXXXXXXXXXGXXXXXXXXXXXXXXXXXXXGXXXXXXXXXXXXXXXXXXXGXXXXXXXXXXXXXXXXXXXGXXXXXXXXXXXXXXXXXXXGXXXXXXXXXXXXXXXXXXX,0,300,0

35280,13,0,13,50,237,0,0,250,176,74,GXXXXXXXXXXXXXXXXXXXGXXXXXXXXXXXXXXXXXXXGXXXXXXXXXXXXXXXXXXXGXXXXXXXXXXXXXXXXXXXGXXXXXXXXXXXXXXXXXXXGXXXXXXXXXXXXXXXXXXXGXXXXXXXXXXXXXXXXXXXGXXXXXXXXXXXXXXXXXXXGXXXXXXXXXXXXXXXXXXXGXXXXXXXXXXXXXXXXXXXGXXXXXXXXXXXXXXXXXXXGXXXXXXXXXXXXXXXXXXXGXXXXXXXXXXXXXXXXXXX,0,300,0
35301,13,0,13,48,239,0,0,252,178,74,GXXXXXXXXXXXXXXXXXXXGXXXXXXXXXXXXXXXXXXXGXXXXXXXXXXXXXXXXXXXGXXXXXXXXXXXXXXXXXXXGXXXXXXXXXXXXXXXXXXXGXXXXXXXXXXXXXXXXXXXGXXXXXXXXXXXXXXXXXXXGXXXXXXXXXXXXXXXXXXXGXXXXXXXXXXXXXXXXXXXGXXXXXXXXXXXXXXXXXXXGXXXXXXXXXXXXXXXXXXXGXXXXXXXXXXXXXXXXXXXGXXXXXXXXXXXXXXXXXXX,0,300,0
35322,13,0,13,52,235,0,0,248,173,75,GXXXXXXXXXXXXXXXXXXXGXXXXXXXXXXXXXXXXXXXGXXXXXXXXXXXXXXXXXXXGXXXXXXXXXXXXXXXXXXXGXXXXXXXXXXXXXXXXXXXGXXXXXXXXXXXXXXXXXXXGXXXXXXXXXXXXXXXXXXXGXXXXXXXXXXXXXXXXXXXGXXXXXXXXXXXXXXXXXXXGXXXXXXXXXXXXXXXXXXXGXXXXXXXXXXXXXXXXXXXGXXXXXXXXXXXXXXXXXXXGXXXXXXXXXXXXXXXXXXX,0,300,0
35343,13,0,13,48,239,0,0,252,173,79,GXXXXXXXXXXXXXXXXXXXGXXXXXXXXXXXXXXXXXXXGXXXXXXXXXXXXXXXXXXXGXXXXXXXXXXXXXXXXXXXGXXXXXXXXXXXXXXXXXXXGXXXXXXXXXXXXXXXXXXXGXXXXXXXXXXXXXXXXXXXGXXXXXXXXXXXXXXXXXXXGXXXXXXXXXXXXXXXXXXXGXXXXXXXXXXXXXXXXXXXGXXXXXXXXXXXXXXXXXXXGXXXXXXXXXXXXXXXXXXXGXXXXXXXXXXXXXXXXXXX,0,300,0
35364,13,0,13,43,244,0,0,258,175,83,GXXXXXXXXXXXXXXXXXXXGXXXXXXXXXXXXXXXXXXXGXXXXXXXXXXXXXXXXXXXGXXXXXXXXXXXXXXXXXXXGXXXXXXXXXXXXXXXXXXXGXXXXXXXXXXXXXXXXXXXGXXXXXXXXXXXXXXXXXXXGXXXXXXXXXXXXXXXXXXXGXXXXXXXXXXXXXXXXXXXGXXXXXXXXXXXXXXXXXXXGXXXXXXXXXXXXXXXXXXXGXXXXXXXXXXXXXXXXXXXGXXXXXXXXXXXXXXXXXXX,0,300,0

35385,13,0,13,43,244,0,0,258,177,81,GXXXXXXXXXXXXXXXXXXXGXXXXXXXXXXXXXXXXXXXGXXXXXXXXXXXXXXXXXXXGXXXXXXXXXXXXXXXXXXXGXXXXXXXXXXXXXXXXXXXGXXXXXXXXXXXXXXXXXXXGXXXXXXXXXXXXXXXXXXXGXXXXXXXXXXXXXXXXXXXGXXXXXXXXXXXXXXXXXXXGXXXXXXXXXXXXXXXXXXXGXXXXXXXXXXXXXXXXXXXGXXXXXXXXXXXXXXXXXXXGXXXXXXXXXXXXXXXXXXX,0,300,0
35406,13,0,13,47,240,0,0,254,175,79,GXXXXXXXXXXXXXXXXXXXGXXXXXXXXXXXXXXXXXXXGXXXXXXXXXXXXXXXXXXXGXXXXXXXXXXXXXXXXXXXGXXXXXXXXXXXXXXXXXXXGXXXXXXXXXXXXXXXXXXXGXXXXXXXXXXXXXXXXXXXGXXXXXXXXXXXXXXXXXXXGXXXXXXXXXXXXXXXXXXXGXXXXXXXXXXXXXXXXXXXGXXXXXXXXXXXXXXXXXXXGXXXXXXXXXXXXXXXXXXXGXXXXXXXXXXXXXXXXXXX,0,300,0
35427,13,0,13,41,246,0,0,259,178,81,GXXXXXXXXXXXXXXXXXXXGXXXXXXXXXXXXXXXXXXXGXXXXXXXXXXXXXXXXXXXGXXXXXXXXXXXXXXXXXXXGXXXXXXXXXXXXXXXXXXXGXXXXXXXXXXXXXXXXXXXGXXXXXXXXXXXXXXXXXXXGXXXXXXXXXXXXXXXXXXXGXXXXXXXXXXXXXXXXXXXGXXXXXXXXXXXXXXXXXXXGXXXXXXXXXXXXXXXXXXXGXXXXXXXXXXXXXXXXXXXGXXXXXXXXXXXXXXXXXXX,0,300,0
35448,13,0,13,40,247,0,0,260,182,78,GXXXXXXXXXXXXXXXXXXXGXXXXXXXXXXXXXXXXXXXGXXXXXXXXXXXXXXXXXXXGXXXXXXXXXXXXXXXXXXXGXXXXXXXXXXXXXXXXXXXGXXXXXXXXXXXXXXXXXXXGXXXXXXXXXXXXXXXXXXXGXXXXXXXXXXXXXXXXXXXGXXXXXXXXXXXXXXXXXXXGXXXXXXXXXXXXXXXXXXXGXXXXXXXXXXXXXXXXXXXGXXXXXXXXXXXXXXXXXXXGXXXXXXXXXXXXXXXXXXX,0,300,0
35469,13,0,13,42,245,0,0,257,176,81,GXXXXXXXXXXXXXXXXXXXGXXXXXXXXXXXXXXXXXXXGXXXXXXXXXXXXXXXXXXXGXXXXXXXXXXXXXXXXXXXGXXXXXXXXXXXXXXXXXXXGXXXXXXXXXXXXXXXXXXXGXXXXXXXXXXXXXXXXXXXGXXXXXXXXXXXXXXXXXXXGXXXXXXXXXXXXXXXXXXXGXXXXXXXXXXXXXXXXXXXGXXXXXXXXXXXXXXXXXXXGXXXXXXXXXXXXXXXXXXXGXXXXXXXXXXXXXXXXXXX,0,300,0

35490,13,0,13,43,244,0,0,257,175,82,GXXXXXXXXXXXXXXXXXXXGXXXXXXXXXXXXXXXXXXXGXXXXXXXXXXXXXXXXXXXGXXXXXXXXXXXXXXXXXXXGXXXXXXXXXXXXXXXXXXXGXXXXXXXXXXXXXXXXXXXGXXXXXXXXXXXXXXXXXXXGXXXXXXXXXXXXXXXXXXXGXXXXXXXXXXXXXXXXXXXGXXXXXXXXXXXXXXXXXXXGXXXXXXXXXXXXXXXXXXXGXXXXXXXXXXXXXXXXXXXGXXXXXXXXXXXXXXXXXXX,0,300,0
35511,13,0,13,41,246,0,0,259,178,81,GXXXXXXXXXXXXXXXXXXXGXXXXXXXXXXXXXXXXXXXGXXXXXXXXXXXXXXXXXXXGXXXXXXXXXXXXXXXXXXXGXXXXXXXXXXXXXXXXXXXGXXXXXXXXXXXXXXXXXXXGXXXXXXXXXXXXXXXXXXXGXXXXXXXXXXXXXXXXXXXGXXXXXXXXXXXXXXXXXXXGXXXXXXXXXXXXXXXXXXXGXXXXXXXXXXXXXXXXXXXGXXXXXXXXXXXXXXXXXXXGXXXXXXXXXXXXXXXXXXX,0,300,0
35532,13,0,13,39,248,0,0,261,181,80,GXXXXXXXXXXXXXXXXXXXGXXXXXXXXXXXXXXXXXXXGXXXXXXXXXXXXXXXXXXXGXXXXXXXXXXXXXXXXXXXGXXXXXXXXXXXXXXXXXXXGXXXXXXXXXXXXXXXXXXXGXXXXXXXXXXXXXXXXXXXGXXXXXXXXXXXXXXXXXXXGXXXXXXXXXXXXXXXXXXXGXXXXXXXXXXXXXXXXXXXGXXXXXXXXXXXXXXXXXXXGXXXXXXXXXXXXXXXXXXXGXXXXXXXXXXXXXXXXXXX,0,300,0
35553,14,1,13,41,245,0,0,258,182,76,GXXXXXXXXXXXXXXXXXXXGXXXXXXXXXXXXXXXXXXXGXXXXXXXXXXXXXXXXXXXGXXXXXXXXXXXXXXXXXXXGXXXXXXXXXXXXXXXXXXXGXXXXXXXXXXXXXXXXXXXGXXXXXXXXXXXXXXXXXXXGXXXXXXXXXXXXXXXXXXXGXXXXXXXXXXXXXXXXXXXGXXXXXXXXXXXXXXXXXXXGAXXXXXXXXXXXXXXXXXXGXXXXXXXXXXXXXXXXXXXGXXXXXXXXXXXXXXXXXXX,0,300,0
35574,14,1,13,42,244,0,0,257,179,78,GXXXXXXXXXXXXXXXXXXXGXXXXXXXXXXXXXXXXXXXGXXXXXXXXXXXXXXXXXXXGXXXXXXXXXXXXXXXXXXXGXXXXXXXXXXXXXXXXXXXGXXXXXXXXXXXXXXXXXXXGXXXXXXXXXXXXXXXXXXXGXXXXXXXXXXXXXXXXXXXGXXXXXXXXXXXXXXXXXXXGXXXXXXXXXXXXXXXXXXXGAXXXXXXXXXXXXXXXXXXGXXXXXXXXXXXXXXXXXXXGXXXXXXXXXXXXXXXXXXX,0,300,0

35595,14,1,13,41,245,0,0,258,181,77,GXXXXXXXXXXXXXXXXXXXGXXXXXXXXXXXXXXXXXXXGXXXXXXXXXXXXXXXXXXXGXXXXXXXXXXXXXXXXXXXGXXXXXXXXXXXXXXXXXXXGXXXXXXXXXXXXXXXXXXXGXXXXXXXXXXXXXXXXXXXGXXXXXXXXXXXXXXXXXXXGXXXXXXXXXXXXXXXXXXXGXXXXXXXXXXXXXXXXXXXGAXXXXXXXXXXXXXXXXXXGXXXXXXXXXXXXXXXXXXXGXXXXXXXXXXXXXXXXXXX,0,300,0
35616,13,0,13,39,248,0,0,260,180,80,GXXXXXXXXXXXXXXXXXXXGXXXXXXXXXXXXXXXXXXXGXXXXXXXXXXXXXXXXXXXGXXXXXXXXXXXXXXXXXXXGXXXXXXXXXXXXXXXXXXXGXXXXXXXXXXXXXXXXXXXGXXXXXXXXXXXXXXXXXXXGXXXXXXXXXXXXXXXXXXXGXXXXXXXXXXXXXXXXXXXGXXXXXXXXXXXXXXXXXXXGXXXXXXXXXXXXXXXXXXXGXXXXXXXXXXXXXXXXXXXGXXXXXXXXXXXXXXXXXXX,0,300,0
35637,13,0,13,39,248,0,0,260,179,81,GXXXXXXXXXXXXXXXXXXXGXXXXXXXXXXXXXXXXXXXGXXXXXXXXXXXXXXXXXXXGXXXXXXXXXXXXXXXXXXXGXXXXXXXXXXXXXXXXXXXGXXXXXXXXXXXXXXXXXXXGXXXXXXXXXXXXXXXXXXXGXXXXXXXXXXXXXXXXXXXGXXXXXXXXXXXXXXXXXXXGXXXXXXXXXXXXXXXXXXXGXXXXXXXXXXXXXXXXXXXGXXXXXXXXXXXXXXXXXXXGXXXXXXXXXXXXXXXXXXX,0,300,0
35658,13,0,13,44,243,0,0,255,174,81,GXXXXXXXXXXXXXXXXXXXGXXXXXXXXXXXXXXXXXXXGXXXXXXXXXXXXXXXXXXXGXXXXXXXXXXXXXXXXXXXGXXXXXXXXXXXXXXXXXXXGXXXXXXXXXXXXXXXXXXXGXXXXXXXXXXXXXXXXXXXGXXXXXXXXXXXXXXXXXXXGXXXXXXXXXXXXXXXXXXXGXXXXXXXXXXXXXXXXXXXGXXXXXXXXXXXXXXXXXXXGXXXXXXXXXXXXXXXXXXXGXXXXXXXXXXXXXXXXXXX,0,300,0
35679,13,0,13,43,244,0,0,257,177,80,GXXXXXXXXXXXXXXXXXXXGXXXXXXXXXXXXXXXXXXXGXXXXXXXXXXXXXXXXXXXGXXXXXXXXXXXXXXXXXXXGXXXXXXXXXXXXXXXXXXXGXXXXXXXXXXXXXXXXXXXGXXXXXXXXXXXXXXXXXXXGXXXXXXXXXXXXXXXXXXXGXXXXXXXXXXXXXXXXXXXGXXXXXXXXXXXXXXXXXXXGXXXXXXXXXXXXXXXXXXXGXXXXXXXXXXXXXXXXXXXGXXXXXXXXXXXXXXXXXXX,0,300,0

35700,13,0,13,45,242,0,0,255,177,78,GXXXXXXXXXXXXXXXXXXXGXXXXXXXXXXXXXXXXXXXGXXXXXXXXXXXXXXXXXXXGXXXXXXXXXXXXXXXXXXXGXXXXXXXXXXXXXXXXXXXGXXXXXXXXXXXXXXXXXXXGXXXXXXXXXXXXXXXXXXXGXXXXXXXXXXXXXXXXXXXGXXXXXXXXXXXXXXXXXXXGXXXXXXXXXXXXXXXXXXXGXXXXXXXXXXXXXXXXXXXGXXXXXXXXXXXXXXXXXXXGXXXXXXXXXXXXXXXXXXX,0,300,0
35721,13,0,13,47,240,0,0,253,176,77,GXXXXXXXXXXXXXXXXXXXGXXXXXXXXXXXXXXXXXXXGXXXXXXXXXXXXXXXXXXXGXXXXXXXXXXXXXXXXXXXGXXXXXXXXXXXXXXXXXXXGXXXXXXXXXXXXXXXXXXXGXXXXXXXXXXXXXXXXXXXGXXXXXXXXXXXXXXXXXXXGXXXXXXXXXXXXXXXXXXXGXXXXXXXXXXXXXXXXXXXGXXXXXXXXXXXXXXXXXXXGXXXXXXXXXXXXXXXXXXXGXXXXXXXXXXXXXXXXXXX,0,300,0
35742,13,0,13,46,241,0,0,253,177,76,GXXXXXXXXXXXXXXXXXXXGXXXXXXXXXXXXXXXXXXXGXXXXXXXXXXXXXXXXXXXGXXXXXXXXXXXXXXXXXXXGXXXXXXXXXXXXXXXXXXXGXXXXXXXXXXXXXXXXXXXGXXXXXXXXXXXXXXXXXXXGXXXXXXXXXXXXXXXXXXXGXXXXXXXXXXXXXXXXXXXGXXXXXXXXXXXXXXXXXXXGXXXXXXXXXXXXXXXXXXXGXXXXXXXXXXXXXXXXXXXGXXXXXXXXXXXXXXXXXXX,0,300,0
35763,13,0,13,44,243,0,0,255,179,76,GXXXXXXXXXXXXXXXXXXXGXXXXXXXXXXXXXXXXXXXGXXXXXXXXXXXXXXXXXXXGXXXXXXXXXXXXXXXXXXXGXXXXXXXXXXXXXXXXXXXGXXXXXXXXXXXXXXXXXXXGXXXXXXXXXXXXXXXXXXXGXXXXXXXXXXXXXXXXXXXGXXXXXXXXXXXXXXXXXXXGXXXXXXXXXXXXXXXXXXXGXXXXXXXXXXXXXXXXXXXGXXXXXXXXXXXXXXXXXXXGXXXXXXXXXXXXXXXXXXX,0,300,0
35784,13,0,13,43,244,0,0,256,182,74,GXXXXXXXXXXXXXXXXXXXGXXXXXXXXXXXXXXXXXXXGXXXXXXXXXXXXXXXXXXXGXXXXXXXXXXXXXXXXXXXGXXXXXXXXXXXXXXXXXXXGXXXXXXXXXXXXXXXXXXXGXXXXXXXXXXXXXXXXXXXGXXXXXXXXXXXXXXXXXXXGXXXXXXXXXXXXXXXXXXXGXXXXXXXXXXXXXXXXXXXGXXXXXXXXXXXXXXXXXXXGXXXXXXXXXXXXXXXXXXXGXXXXXXXXXXXXXXXXXXX,0,300,0

35805,13,0,13,38,249,0,0,261,182,79,GXXXXXXXXXXXXXXXXXXXGXXXXXXXXXXXXXXXXXXXGXXXXXXXXXXXXXXXXXXXGXXXXXXXXXXXXXXXXXXXGXXXXXXXXXXXXXXXXXXXGXXXXXXXXXXXXXXXXXXXGXXXXXXXXXXXXXXXXXXXGXXXXXXXXXXXXXXXXXXXGXXXXXXXXXXXXXXXXXXXGXXXXXXXXXXXXXXXXXXXGXXXXXXXXXXXXXXXXXXXGXXXXXXXXXXXXXXXXXXXGXXXXXXXXXXXXXXXXXXX,0,300,0
35826,13,0,13,38,249,0,0,261,182,79,GXXXXXXXXXXXXXXXXXXXGXXXXXXXXXXXXXXXXXXXGXXXXXXXXXXXXXXXXXXXGXXXXXXXXXXXXXXXXXXXGXXXXXXXXXXXXXXXXXXXGXXXXXXXXXXXXXXXXXXXGXXXXXXXXXXXXXXXXXXXGXXXXXXXXXXXXXXXXXXXGXXXXXXXXXXXXXXXXXXXGXXXXXXXXXXXXXXXXXXXGXXXXXXXXXXXXXXXXXXXGXXXXXXXXXXXXXXXXXXXGXXXXXXXXXXXXXXXXXXX,0,300,0
35847,13,0,13,41,246,0,0,258,180,78,GXXXXXXXXXXXXXXXXXXXGXXXXXXXXXXXXXXXXXXXGXXXXXXXXXXXXXXXXXXXGXXXXXXXXXXXXXXXXXXXGXXXXXXXXXXXXXXXXXXXGXXXXXXXXXXXXXXXXXXXGXXXXXXXXXXXXXXXXXXXGXXXXXXXXXXXXXXXXXXXGXXXXXXXXXXXXXXXXXXXGXXXXXXXXXXXXXXXXXXXGXXXXXXXXXXXXXXXXXXXGXXXXXXXXXXXXXXXXXXXGXXXXXXXXXXXXXXXXXXX,0,300,0
35868,13,0,13,41,246,0,0,257,176,81,GXXXXXXXXXXXXXXXXXXXGXXXXXXXXXXXXXXXXXXXGXXXXXXXXXXXXXXXXXXXGXXXXXXXXXXXXXXXXXXXGXXXXXXXXXXXXXXXXXXXGXXXXXXXXXXXXXXXXXXXGXXXXXXXXXXXXXXXXXXXGXXXXXXXXXXXXXXXXXXXGXXXXXXXXXXXXXXXXXXXGXXXXXXXXXXXXXXXXXXXGXXXXXXXXXXXXXXXXXXXGXXXXXXXXXXXXXXXXXXXGXXXXXXXXXXXXXXXXXXX,0,300,0
35889,13,0,13,37,250,0,0,261,180,81,GXXXXXXXXXXXXXXXXXXXGXXXXXXXXXXXXXXXXXXXGXXXXXXXXXXXXXXXXXXXGXXXXXXXXXXXXXXXXXXXGXXXXXXXXXXXXXXXXXXXGXXXXXXXXXXXXXXXXXXXGXXXXXXXXXXXXXXXXXXXGXXXXXXXXXXXXXXXXXXXGXXXXXXXXXXXXXXXXXXXGXXXXXXXXXXXXXXXXXXXGXXXXXXXXXXXXXXXXXXXGXXXXXXXXXXXXXXXXXXXGXXXXXXXXXXXXXXXXXXX,0,300,0

35910,13,0,13,33,254,0,0,266,179,87,GXXXXXXXXXXXXXXXXXXXGXXXXXXXXXXXXXXXXXXXGXXXXXXXXXXXXXXXXXXXGXXXXXXXXXXXXXXXXXXXGXXXXXXXXXXXXXXXXXXXGXXXXXXXXXXXXXXXXXXXGXXXXXXXXXXXXXXXXXXXGXXXXXXXXXXXXXXXXXXXGXXXXXXXXXXXXXXXXXXXGXXXXXXXXXXXXXXXXXXXGXXXXXXXXXXXXXXXXXXXGXXXXXXXXXXXXXXXXXXXGXXXXXXXXXXXXXXXXXXX,0,300,0
35931,13,0,13,30,257,0,0,269,180,89,GXXXXXXXXXXXXXXXXXXXGXXXXXXXXXXXXXXXXXXXGXXXXXXXXXXXXXXXXXXXGXXXXXXXXXXXXXXXXXXXGXXXXXXXXXXXXXXXXXXXGXXXXXXXXXXXXXXXXXXXGXXXXXXXXXXXXXXXXXXXGXXXXXXXXXXXXXXXXXXXGXXXXXXXXXXXXXXXXXXXGXXXXXXXXXXXXXXXXXXXGXXXXXXXXXXXXXXXXXXXGXXXXXXXXXXXXXXXXXXXGXXXXXXXXXXXXXXXXXXX,0,300,0
35952,13,0,13,32,255,0,0,267,178,89,GXXXXXXXXXXXXXXXXXXXGXXXXXXXXXXXXXXXXXXXGXXXXXXXXXXXXXXXXXXXGXXXXXXXXXXXXXXXXXXXGXXXXXXXXXXXXXXXXXXXGXXXXXXXXXXXXXXXXXXXGXXXXXXXXXXXXXXXXXXXGXXXXXXXXXXXXXXXXXXXGXXXXXXXXXXXXXXXXXXXGXXXXXXXXXXXXXXXXXXXGXXXXXXXXXXXXXXXXXXXGXXXXXXXXXXXXXXXXXXXGXXXXXXXXXXXXXXXXXXX,0,300,0
35973,13,0,13,32,255,0,0,267,178,89,GXXXXXXXXXXXXXXXXXXXGXXXXXXXXXXXXXXXXXXXGXXXXXXXXXXXXXXXXXXXGXXXXXXXXXXXXXXXXXXXGXXXXXXXXXXXXXXXXXXXGXXXXXXXXXXXXXXXXXXXGXXXXXXXXXXXXXXXXXXXGXXXXXXXXXXXXXXXXXXXGXXXXXXXXXXXXXXXXXXXGXXXXXXXXXXXXXXXXXXXGXXXXXXXXXXXXXXXXXXXGXXXXXXXXXXXXXXXXXXXGXXXXXXXXXXXXXXXXXXX,0,300,0
35994,13,0,13,34,253,0,0,265,182,83,GXXXXXXXXXXXXXXXXXXXGXXXXXXXXXXXXXXXXXXXGXXXXXXXXXXXXXXXXXXXGXXXXXXXXXXXXXXXXXXXGXXXXXXXXXXXXXXXXXXXGXXXXXXXXXXXXXXXXXXXGXXXXXXXXXXXXXXXXXXXGXXXXXXXXXXXXXXXXXXXGXXXXXXXXXXXXXXXXXXXGXXXXXXXXXXXXXXXXXXXGXXXXXXXXXXXXXXXXXXXGXXXXXXXXXXXXXXXXXXXGXXXXXXXXXXXXXXXXXXX,0,300,0

36015,13,0,13,38,249,0,0,261,182,79,GXXXXXXXXXXXXXXXXXXXGXXXXXXXXXXXXXXXXXXXGXXXXXXXXXXXXXXXXXXXGXXXXXXXXXXXXXXXXXXXGXXXXXXXXXXXXXXXXXXXGXXXXXXXXXXXXXXXXXXXGXXXXXXXXXXXXXXXXXXXGXXXXXXXXXXXXXXXXXXXGXXXXXXXXXXXXXXXXXXXGXXXXXXXXXXXXXXXXXXXGXXXXXXXXXXXXXXXXXXXGXXXXXXXXXXXXXXXXXXXGXXXXXXXXXXXXXXXXXXX,0,300,0
36036,13,0,13,41,246,0,0,258,184,74,GXXXXXXXXXXXXXXXXXXXGXXXXXXXXXXXXXXXXXXXGXXXXXXXXXXXXXXXXXXXGXXXXXXXXXXXXXXXXXXXGXXXXXXXXXXXXXXXXXXXGXXXXXXXXXXXXXXXXXXXGXXXXXXXXXXXXXXXXXXXGXXXXXXXXXXXXXXXXXXXGXXXXXXXXXXXXXXXXXXXGXXXXXXXXXXXXXXXXXXXGXXXXXXXXXXXXXXXXXXXGXXXXXXXXXXXXXXXXXXXGXXXXXXXXXXXXXXXXXXX,0,300,0
36057,13,0,13,41,246,0,0,258,184,74,GXXXXXXXXXXXXXXXXXXXGXXXXXXXXXXXXXXXXXXXGXXXXXXXXXXXXXXXXXXXGXXXXXXXXXXXXXXXXXXXGXXXXXXXXXXXXXXXXXXXGXXXXXXXXXXXXXXXXXXXGXXXXXXXXXXXXXXXXXXXGXXXXXXXXXXXXXXXXXXXGXXXXXXXXXXXXXXXXXXXGXXXXXXXXXXXXXXXXXXXGXXXXXXXXXXXXXXXXXXXGXXXXXXXXXXXXXXXXXXXGXXXXXXXXXXXXXXXXXXX,0,300,0
36078,13,0,13,41,246,0,0,258,186,72,GXXXXXXXXXXXXXXXXXXXGXXXXXXXXXXXXXXXXXXXGXXXXXXXXXXXXXXXXXXXGXXXXXXXXXXXXXXXXXXXGXXXXXXXXXXXXXXXXXXXGXXXXXXXXXXXXXXXXXXXGXXXXXXXXXXXXXXXXXXXGXXXXXXXXXXXXXXXXXXXGXXXXXXXXXXXXXXXXXXXGXXXXXXXXXXXXXXXXXXXGXXXXXXXXXXXXXXXXXXXGXXXXXXXXXXXXXXXXXXXGXXXXXXXXXXXXXXXXXXX,0,300,0
36099,13,0,13,49,238,0,0,250,182,68,GXXXXXXXXXXXXXXXXXXXGXXXXXXXXXXXXXXXXXXXGXXXXXXXXXXXXXXXXXXXGXXXXXXXXXXXXXXXXXXXGXXXXXXXXXXXXXXXXXXXGXXXXXXXXXXXXXXXXXXXGXXXXXXXXXXXXXXXXXXXGXXXXXXXXXXXXXXXXXXXGXXXXXXXXXXXXXXXXXXXGXXXXXXXXXXXXXXXXXXXGXXXXXXXXXXXXXXXXXXXGXXXXXXXXXXXXXXXXXXXGXXXXXXXXXXXXXXXXXXX,0,300,0

36120,13,0,13,53,234,0,0,246,178,68,GXXXXXXXXXXXXXXXXXXXGXXXXXXXXXXXXXXXXXXXGXXXXXXXXXXXXXXXXXXXGXXXXXXXXXXXXXXXXXXXGXXXXXXXXXXXXXXXXXXXGXXXXXXXXXXXXXXXXXXXGXXXXXXXXXXXXXXXXXXXGXXXXXXXXXXXXXXXXXXXGXXXXXXXXXXXXXXXXXXXGXXXXXXXXXXXXXXXXXXXGXXXXXXXXXXXXXXXXXXXGXXXXXXXXXXXXXXXXXXXGXXXXXXXXXXXXXXXXXXX,0,300,0
36141,13,0,13,52,235,0,0,247,179,68,GXXXXXXXXXXXXXXXXXXXGXXXXXXXXXXXXXXXXXXXGXXXXXXXXXXXXXXXXXXXGXXXXXXXXXXXXXXXXXXXGXXXXXXXXXXXXXXXXXXXGXXXXXXXXXXXXXXXXXXXGXXXXXXXXXXXXXXXXXXXGXXXXXXXXXXXXXXXXXXXGXXXXXXXXXXXXXXXXXXXGXXXXXXXXXXXXXXXXXXXGXXXXXXXXXXXXXXXXXXXGXXXXXXXXXXXXXXXXXXXGXXXXXXXXXXXXXXXXXXX,0,300,0
36162,13,0,13,48,239,0,0,251,181,70,GXXXXXXXXXXXXXXXXXXXGXXXXXXXXXXXXXXXXXXXGXXXXXXXXXXXXXXXXXXXGXXXXXXXXXXXXXXXXXXXGXXXXXXXXXXXXXXXXXXXGXXXXXXXXXXXXXXXXXXXGXXXXXXXXXXXXXXXXXXXGXXXXXXXXXXXXXXXXXXXGXXXXXXXXXXXXXXXXXXXGXXXXXXXXXXXXXXXXXXXGXXXXXXXXXXXXXXXXXXXGXXXXXXXXXXXXXXXXXXXGXXXXXXXXXXXXXXXXXXX,0,300,0
36183,13,0,13,50,237,0,0,249,182,67,GXXXXXXXXXXXXXXXXXXXGXXXXXXXXXXXXXXXXXXXGXXXXXXXXXXXXXXXXXXXGXXXXXXXXXXXXXXXXXXXGXXXXXXXXXXXXXXXXXXXGXXXXXXXXXXXXXXXXXXXGXXXXXXXXXXXXXXXXXXXGXXXXXXXXXXXXXXXXXXXGXXXXXXXXXXXXXXXXXXXGXXXXXXXXXXXXXXXXXXXGXXXXXXXXXXXXXXXXXXXGXXXXXXXXXXXXXXXXXXXGXXXXXXXXXXXXXXXXXXX,0,300,0
36204,13,0,13,44,243,0,0,254,184,70,GXXXXXXXXXXXXXXXXXXXGXXXXXXXXXXXXXXXXXXXGXXXXXXXXXXXXXXXXXXXGXXXXXXXXXXXXXXXXXXXGXXXXXXXXXXXXXXXXXXXGXXXXXXXXXXXXXXXXXXXGXXXXXXXXXXXXXXXXXXXGXXXXXXXXXXXXXXXXXXXGXXXXXXXXXXXXXXXXXXXGXXXXXXXXXXXXXXXXXXXGXXXXXXXXXXXXXXXXXXXGXXXXXXXXXXXXXXXXXXXGXXXXXXXXXXXXXXXXXXX,0,300,0

36225,13,0,13,47,240,0,0,252,179,73,GXXXXXXXXXXXXXXXXXXXGXXXXXXXXXXXXXXXXXXXGXXXXXXXXXXXXXXXXXXXGXXXXXXXXXXXXXXXXXXXGXXXXXXXXXXXXXXXXXXXGXXXXXXXXXXXXXXXXXXXGXXXXXXXXXXXXXXXXXXXGXXXXXXXXXXXXXXXXXXXGXXXXXXXXXXXXXXXXXXXGXXXXXXXXXXXXXXXXXXXGXXXXXXXXXXXXXXXXXXXGXXXXXXXXXXXXXXXXXXXGXXXXXXXXXXXXXXXXXXX,0,300,0
36246,13,0,13,44,243,0,0,255,179,76,GXXXXXXXXXXXXXXXXXXXGXXXXXXXXXXXXXXXXXXXGXXXXXXXXXXXXXXXXXXXGXXXXXXXXXXXXXXXXXXXGXXXXXXXXXXXXXXXXXXXGXXXXXXXXXXXXXXXXXXXGXXXXXXXXXXXXXXXXXXXGXXXXXXXXXXXXXXXXXXXGXXXXXXXXXXXXXXXXXXXGXXXXXXXXXXXXXXXXXXXGXXXXXXXXXXXXXXXXXXXGXXXXXXXXXXXXXXXXXXXGXXXXXXXXXXXXXXXXXXX,0,300,0
36267,13,0,13,48,239,0,0,251,178,73,GXXXXXXXXXXXXXXXXXXXGXXXXXXXXXXXXXXXXXXXGXXXXXXXXXXXXXXXXXXXGXXXXXXXXXXXXXXXXXXXGXXXXXXXXXXXXXXXXXXXGXXXXXXXXXXXXXXXXXXXGXXXXXXXXXXXXXXXXXXXGXXXXXXXXXXXXXXXXXXXGXXXXXXXXXXXXXXXXXXXGXXXXXXXXXXXXXXXXXXXGXXXXXXXXXXXXXXXXXXXGXXXXXXXXXXXXXXXXXXXGXXXXXXXXXXXXXXXXXXX,0,300,0
36288,13,0,13,46,241,0,0,253,182,71,GXXXXXXXXXXXXXXXXXXXGXXXXXXXXXXXXXXXXXXXGXXXXXXXXXXXXXXXXXXXGXXXXXXXXXXXXXXXXXXXGXXXXXXXXXXXXXXXXXXXGXXXXXXXXXXXXXXXXXXXGXXXXXXXXXXXXXXXXXXXGXXXXXXXXXXXXXXXXXXXGXXXXXXXXXXXXXXXXXXXGXXXXXXXXXXXXXXXXXXXGXXXXXXXXXXXXXXXXXXXGXXXXXXXXXXXXXXXXXXXGXXXXXXXXXXXXXXXXXXX,0,300,0
36309,13,0,13,47,240,0,0,252,179,73,GXXXXXXXXXXXXXXXXXXXGXXXXXXXXXXXXXXXXXXXGXXXXXXXXXXXXXXXXXXXGXXXXXXXXXXXXXXXXXXXGXXXXXXXXXXXXXXXXXXXGXXXXXXXXXXXXXXXXXXXGXXXXXXXXXXXXXXXXXXXGXXXXXXXXXXXXXXXXXXXGXXXXXXXXXXXXXXXXXXXGXXXXXXXXXXXXXXXXXXXGXXXXXXXXXXXXXXXXXXXGXXXXXXXXXXXXXXXXXXXGXXXXXXXXXXXXXXXXXXX,0,300,0

36330,13,0,13,47,240,0,0,252,184,68,GXXXXXXXXXXXXXXXXXXXGXXXXXXXXXXXXXXXXXXXGXXXXXXXXXXXXXXXXXXXGXXXXXXXXXXXXXXXXXXXGXXXXXXXXXXXXXXXXXXXGXXXXXXXXXXXXXXXXXXXGXXXXXXXXXXXXXXXXXXXGXXXXXXXXXXXXXXXXXXXGXXXXXXXXXXXXXXXXXXXGXXXXXXXXXXXXXXXXXXXGXXXXXXXXXXXXXXXXXXXGXXXXXXXXXXXXXXXXXXXGXXXXXXXXXXXXXXXXXXX,0,300,0
36351,13,0,13,49,238,0,0,251,185,66,GXXXXXXXXXXXXXXXXXXXGXXXXXXXXXXXXXXXXXXXGXXXXXXXXXXXXXXXXXXXGXXXXXXXXXXXXXXXXXXXGXXXXXXXXXXXXXXXXXXXGXXXXXXXXXXXXXXXXXXXGXXXXXXXXXXXXXXXXXXXGXXXXXXXXXXXXXXXXXXXGXXXXXXXXXXXXXXXXXXXGXXXXXXXXXXXXXXXXXXXGXXXXXXXXXXXXXXXXXXXGXXXXXXXXXXXXXXXXXXXGXXXXXXXXXXXXXXXXXXX,0,300,0
36372,13,0,13,48,239,0,0,251,183,68,GXXXXXXXXXXXXXXXXXXXGXXXXXXXXXXXXXXXXXXXGXXXXXXXXXXXXXXXXXXXGXXXXXXXXXXXXXXXXXXXGXXXXXXXXXXXXXXXXXXXGXXXXXXXXXXXXXXXXXXXGXXXXXXXXXXXXXXXXXXXGXXXXXXXXXXXXXXXXXXXGXXXXXXXXXXXXXXXXXXXGXXXXXXXXXXXXXXXXXXXGXXXXXXXXXXXXXXXXXXXGXXXXXXXXXXXXXXXXXXXGXXXXXXXXXXXXXXXXXXX,0,300,0
36393,13,0,13,51,236,0,0,248,177,71,GXXXXXXXXXXXXXXXXXXXGXXXXXXXXXXXXXXXXXXXGXXXXXXXXXXXXXXXXXXXGXXXXXXXXXXXXXXXXXXXGXXXXXXXXXXXXXXXXXXXGXXXXXXXXXXXXXXXXXXXGXXXXXXXXXXXXXXXXXXXGXXXXXXXXXXXXXXXXXXXGXXXXXXXXXXXXXXXXXXXGXXXXXXXXXXXXXXXXXXXGXXXXXXXXXXXXXXXXXXXGXXXXXXXXXXXXXXXXXXXGXXXXXXXXXXXXXXXXXXX,0,300,0
36414,13,0,13,49,238,0,0,251,179,72,GXXXXXXXXXXXXXXXXXXXGXXXXXXXXXXXXXXXXXXXGXXXXXXXXXXXXXXXXXXXGXXXXXXXXXXXXXXXXXXXGXXXXXXXXXXXXXXXXXXXGXXXXXXXXXXXXXXXXXXXGXXXXXXXXXXXXXXXXXXXGXXXXXXXXXXXXXXXXXXXGXXXXXXXXXXXXXXXXXXXGXXXXXXXXXXXXXXXXXXXGXXXXXXXXXXXXXXXXXXXGXXXXXXXXXXXXXXXXXXXGXXXXXXXXXXXXXXXXXXX,0,300,0

36435,13,0,13,50,237,0,0,250,178,72,GXXXXXXXXXXXXXXXXXXXGXXXXXXXXXXXXXXXXXXXGXXXXXXXXXXXXXXXXXXXGXXXXXXXXXXXXXXXXXXXGXXXXXXXXXXXXXXXXXXXGXXXXXXXXXXXXXXXXXXXGXXXXXXXXXXXXXXXXXXXGXXXXXXXXXXXXXXXXXXXGXXXXXXXXXXXXXXXXXXXGXXXXXXXXXXXXXXXXXXXGXXXXXXXXXXXXXXXXXXXGXXXXXXXXXXXXXXXXXXXGXXXXXXXXXXXXXXXXXXX,0,300,0
36456,13,0,13,47,240,0,0,253,179,74,GXXXXXXXXXXXXXXXXXXXGXXXXXXXXXXXXXXXXXXXGXXXXXXXXXXXXXXXXXXXGXXXXXXXXXXXXXXXXXXXGXXXXXXXXXXXXXXXXXXXGXXXXXXXXXXXXXXXXXXXGXXXXXXXXXXXXXXXXXXXGXXXXXXXXXXXXXXXXXXXGXXXXXXXXXXXXXXXXXXXGXXXXXXXXXXXXXXXXXXXGXXXXXXXXXXXXXXXXXXXGXXXXXXXXXXXXXXXXXXXGXXXXXXXXXXXXXXXXXXX,0,300,0
36477,13,0,13,43,244,0,0,256,178,78,GXXXXXXXXXXXXXXXXXXXGXXXXXXXXXXXXXXXXXXXGXXXXXXXXXXXXXXXXXXXGXXXXXXXXXXXXXXXXXXXGXXXXXXXXXXXXXXXXXXXGXXXXXXXXXXXXXXXXXXXGXXXXXXXXXXXXXXXXXXXGXXXXXXXXXXXXXXXXXXXGXXXXXXXXXXXXXXXXXXXGXXXXXXXXXXXXXXXXXXXGXXXXXXXXXXXXXXXXXXXGXXXXXXXXXXXXXXXXXXXGXXXXXXXXXXXXXXXXXXX,0,300,0
36498,13,0,13,45,242,0,0,256,177,79,GXXXXXXXXXXXXXXXXXXXGXXXXXXXXXXXXXXXXXXXGXXXXXXXXXXXXXXXXXXXGXXXXXXXXXXXXXXXXXXXGXXXXXXXXXXXXXXXXXXXGXXXXXXXXXXXXXXXXXXXGXXXXXXXXXXXXXXXXXXXGXXXXXXXXXXXXXXXXXXXGXXXXXXXXXXXXXXXXXXXGXXXXXXXXXXXXXXXXXXXGXXXXXXXXXXXXXXXXXXXGXXXXXXXXXXXXXXXXXXXGXXXXXXXXXXXXXXXXXXX,0,300,0
36519,13,0,13,45,242,0,0,256,177,79,GXXXXXXXXXXXXXXXXXXXGXXXXXXXXXXXXXXXXXXXGXXXXXXXXXXXXXXXXXXXGXXXXXXXXXXXXXXXXXXXGXXXXXXXXXXXXXXXXXXXGXXXXXXXXXXXXXXXXXXXGXXXXXXXXXXXXXXXXXXXGXXXXXXXXXXXXXXXXXXXGXXXXXXXXXXXXXXXXXXXGXXXXXXXXXXXXXXXXXXXGXXXXXXXXXXXXXXXXXXXGXXXXXXXXXXXXXXXXXXXGXXXXXXXXXXXXXXXXXXX,0,300,0

36540,14,1,13,49,237,0,0,251,178,73,GXXXXXXXXXXXXXXXXXXXGXXXXXXXXXXXXXXXXXXXGXXXXXXXXXXXXXXXXXXXGXXXXXXXXXXXXXXXXXXXGXXXXXXXXXXXXXXXXXXXGXXXXXXXXXXXXXXXXXXXGXXXXXXXXXXXXXXXXXXXGXXXXXXXXXXXXXXXXXXXGXXXXXXXXXXXXXXXXXXXGXXXXXXXXXXXXXXXXXXXGXXXXXXXXXXXXXXXXXXXGXXXXXXXXXXXXXXXXXXXGAXXXXXXXXXXXXXXXXXX,0,300,0
36561,13,0,13,42,245,0,0,258,178,80,GXXXXXXXXXXXXXXXXXXXGXXXXXXXXXXXXXXXXXXXGXXXXXXXXXXXXXXXXXXXGXXXXXXXXXXXXXXXXXXXGXXXXXXXXXXXXXXXXXXXGXXXXXXXXXXXXXXXXXXXGXXXXXXXXXXXXXXXXXXXGXXXXXXXXXXXXXXXXXXXGXXXXXXXXXXXXXXXXXXXGXXXXXXXXXXXXXXXXXXXGXXXXXXXXXXXXXXXXXXXGXXXXXXXXXXXXXXXXXXXGXXXXXXXXXXXXXXXXXXX,0,300,0
36582,13,0,13,38,249,0,0,263,177,86,GXXXXXXXXXXXXXXXXXXXGXXXXXXXXXXXXXXXXXXXGXXXXXXXXXXXXXXXXXXXGXXXXXXXXXXXXXXXXXXXGXXXXXXXXXXXXXXXXXXXGXXXXXXXXXXXXXXXXXXXGXXXXXXXXXXXXXXXXXXXGXXXXXXXXXXXXXXXXXXXGXXXXXXXXXXXXXXXXXXXGXXXXXXXXXXXXXXXXXXXGXXXXXXXXXXXXXXXXXXXGXXXXXXXXXXXXXXXXXXXGXXXXXXXXXXXXXXXXXXX,0,300,0
36603,13,0,13,35,252,0,0,266,179,87,GXXXXXXXXXXXXXXXXXXXGXXXXXXXXXXXXXXXXXXXGXXXXXXXXXXXXXXXXXXXGXXXXXXXXXXXXXXXXXXXGXXXXXXXXXXXXXXXXXXXGXXXXXXXXXXXXXXXXXXXGXXXXXXXXXXXXXXXXXXXGXXXXXXXXXXXXXXXXXXXGXXXXXXXXXXXXXXXXXXXGXXXXXXXXXXXXXXXXXXXGXXXXXXXXXXXXXXXXXXXGXXXXXXXXXXXXXXXXXXXGXXXXXXXXXXXXXXXXXXX,0,300,0
36624,13,0,13,34,253,0,0,266,179,87,GXXXXXXXXXXXXXXXXXXXGXXXXXXXXXXXXXXXXXXXGXXXXXXXXXXXXXXXXXXXGXXXXXXXXXXXXXXXXXXXGXXXXXXXXXXXXXXXXXXXGXXXXXXXXXXXXXXXXXXXGXXXXXXXXXXXXXXXXXXXGXXXXXXXXXXXXXXXXXXXGXXXXXXXXXXXXXXXXXXXGXXXXXXXXXXXXXXXXXXXGXXXXXXXXXXXXXXXXXXXGXXXXXXXXXXXXXXXXXXXGXXXXXXXXXXXXXXXXXXX,0,300,0

36645,13,0,13,38,249,0,0,262,177,85,GXXXXXXXXXXXXXXXXXXXGXXXXXXXXXXXXXXXXXXXGXXXXXXXXXXXXXXXXXXXGXXXXXXXXXXXXXXXXXXXGXXXXXXXXXXXXXXXXXXXGXXXXXXXXXXXXXXXXXXXGXXXXXXXXXXXXXXXXXXXGXXXXXXXXXXXXXXXXXXXGXXXXXXXXXXXXXXXXXXXGXXXXXXXXXXXXXXXXXXXGXXXXXXXXXXXXXXXXXXXGXXXXXXXXXXXXXXXXXXXGXXXXXXXXXXXXXXXXXXX,0,300,0
36666,13,0,13,40,247,0,0,260,180,80,GXXXXXXXXXXXXXXXXXXXGXXXXXXXXXXXXXXXXXXXGXXXXXXXXXXXXXXXXXXXGXXXXXXXXXXXXXXXXXXXGXXXXXXXXXXXXXXXXXXXGXXXXXXXXXXXXXXXXXXXGXXXXXXXXXXXXXXXXXXXGXXXXXXXXXXXXXXXXXXXGXXXXXXXXXXXXXXXXXXXGXXXXXXXXXXXXXXXXXXXGXXXXXXXXXXXXXXXXXXXGXXXXXXXXXXXXXXXXXXXGXXXXXXXXXXXXXXXXXXX,0,300,0
36687,13,0,13,37,250,0,0,262,186,76,GXXXXXXXXXXXXXXXXXXXGXXXXXXXXXXXXXXXXXXXGXXXXXXXXXXXXXXXXXXXGXXXXXXXXXXXXXXXXXXXGXXXXXXXXXXXXXXXXXXXGXXXXXXXXXXXXXXXXXXXGXXXXXXXXXXXXXXXXXXXGXXXXXXXXXXXXXXXXXXXGXXXXXXXXXXXXXXXXXXXGXXXXXXXXXXXXXXXXXXXGXXXXXXXXXXXXXXXXXXXGXXXXXXXXXXXXXXXXXXXGXXXXXXXXXXXXXXXXXXX,0,300,0
36708,13,0,13,43,244,0,0,257,187,70,GXXXXXXXXXXXXXXXXXXXGXXXXXXXXXXXXXXXXXXXGXXXXXXXXXXXXXXXXXXXGXXXXXXXXXXXXXXXXXXXGXXXXXXXXXXXXXXXXXXXGXXXXXXXXXXXXXXXXXXXGXXXXXXXXXXXXXXXXXXXGXXXXXXXXXXXXXXXXXXXGXXXXXXXXXXXXXXXXXXXGXXXXXXXXXXXXXXXXXXXGXXXXXXXXXXXXXXXXXXXGXXXXXXXXXXXXXXXXXXXGXXXXXXXXXXXXXXXXXXX,0,300,0
36729,13,0,13,44,243,0,0,256,185,71,GXXXXXXXXXXXXXXXXXXXGXXXXXXXXXXXXXXXXXXXGXXXXXXXXXXXXXXXXXXXGXXXXXXXXXXXXXXXXXXXGXXXXXXXXXXXXXXXXXXXGXXXXXXXXXXXXXXXXXXXGXXXXXXXXXXXXXXXXXXXGXXXXXXXXXXXXXXXXXXXGXXXXXXXXXXXXXXXXXXXGXXXXXXXXXXXXXXXXXXXGXXXXXXXXXXXXXXXXXXXGXXXXXXXXXXXXXXXXXXXGXXXXXXXXXXXXXXXXXXX,0,300,0

36750,13,0,13,45,242,0,0,254,182,72,GXXXXXXXXXXXXXXXXXXXGXXXXXXXXXXXXXXXXXXXGXXXXXXXXXXXXXXXXXXXGXXXXXXXXXXXXXXXXXXXGXXXXXXXXXXXXXXXXXXXGXXXXXXXXXXXXXXXXXXXGXXXXXXXXXXXXXXXXXXXGXXXXXXXXXXXXXXXXXXXGXXXXXXXXXXXXXXXXXXXGXXXXXXXXXXXXXXXXXXXGXXXXXXXXXXXXXXXXXXXGXXXXXXXXXXXXXXXXXXXGXXXXXXXXXXXXXXXXXXX,0,300,0
36771,13,0,13,42,245,0,0,257,184,73,GXXXXXXXXXXXXXXXXXXXGXXXXXXXXXXXXXXXXXXXGXXXXXXXXXXXXXXXXXXXGXXXXXXXXXXXXXXXXXXXGXXXXXXXXXXXXXXXXXXXGXXXXXXXXXXXXXXXXXXXGXXXXXXXXXXXXXXXXXXXGXXXXXXXXXXXXXXXXXXXGXXXXXXXXXXXXXXXXXXXGXXXXXXXXXXXXXXXXXXXGXXXXXXXXXXXXXXXXXXXGXXXXXXXXXXXXXXXXXXXGXXXXXXXXXXXXXXXXXXX,0,300,0
36792,13,0,13,44,243,0,0,255,183,72,GXXXXXXXXXXXXXXXXXXXGXXXXXXXXXXXXXXXXXXXGXXXXXXXXXXXXXXXXXXXGXXXXXXXXXXXXXXXXXXXGXXXXXXXXXXXXXXXXXXXGXXXXXXXXXXXXXXXXXXXGXXXXXXXXXXXXXXXXXXXGXXXXXXXXXXXXXXXXXXXGXXXXXXXXXXXXXXXXXXXGXXXXXXXXXXXXXXXXXXXGXXXXXXXXXXXXXXXXXXXGXXXXXXXXXXXXXXXXXXXGXXXXXXXXXXXXXXXXXXX,0,300,0
36813,13,0,13,46,241,0,0,254,182,72,GXXXXXXXXXXXXXXXXXXXGXXXXXXXXXXXXXXXXXXXGXXXXXXXXXXXXXXXXXXXGXXXXXXXXXXXXXXXXXXXGXXXXXXXXXXXXXXXXXXXGXXXXXXXXXXXXXXXXXXXGXXXXXXXXXXXXXXXXXXXGXXXXXXXXXXXXXXXXXXXGXXXXXXXXXXXXXXXXXXXGXXXXXXXXXXXXXXXXXXXGXXXXXXXXXXXXXXXXXXXGXXXXXXXXXXXXXXXXXXXGXXXXXXXXXXXXXXXXXXX,0,300,0
36834,13,0,13,41,246,0,0,259,182,77,GXXXXXXXXXXXXXXXXXXXGXXXXXXXXXXXXXXXXXXXGXXXXXXXXXXXXXXXXXXXGXXXXXXXXXXXXXXXXXXXGXXXXXXXXXXXXXXXXXXXGXXXXXXXXXXXXXXXXXXXGXXXXXXXXXXXXXXXXXXXGXXXXXXXXXXXXXXXXXXXGXXXXXXXXXXXXXXXXXXXGXXXXXXXXXXXXXXXXXXXGXXXXXXXXXXXXXXXXXXXGXXXXXXXXXXXXXXXXXXXGXXXXXXXXXXXXXXXXXXX,0,300,0

36855,13,0,13,38,249,0,0,261,182,79,GXXXXXXXXXXXXXXXXXXXGXXXXXXXXXXXXXXXXXXXGXXXXXXXXXXXXXXXXXXXGXXXXXXXXXXXXXXXXXXXGXXXXXXXXXXXXXXXXXXXGXXXXXXXXXXXXXXXXXXXGXXXXXXXXXXXXXXXXXXXGXXXXXXXXXXXXXXXXXXXGXXXXXXXXXXXXXXXXXXXGXXXXXXXXXXXXXXXXXXXGXXXXXXXXXXXXXXXXXXXGXXXXXXXXXXXXXXXXXXXGXXXXXXXXXXXXXXXXXXX,0,300,0
36876,13,0,13,41,246,0,0,259,178,81,GXXXXXXXXXXXXXXXXXXXGXXXXXXXXXXXXXXXXXXXGXXXXXXXXXXXXXXXXXXXGXXXXXXXXXXXXXXXXXXXGXXXXXXXXXXXXXXXXXXXGXXXXXXXXXXXXXXXXXXXGXXXXXXXXXXXXXXXXXXXGXXXXXXXXXXXXXXXXXXXGXXXXXXXXXXXXXXXXXXXGXXXXXXXXXXXXXXXXXXXGXXXXXXXXXXXXXXXXXXXGXXXXXXXXXXXXXXXXXXXGXXXXXXXXXXXXXXXXXXX,0,300,0
36897,13,0,13,37,250,0,0,263,184,79,GXXXXXXXXXXXXXXXXXXXGXXXXXXXXXXXXXXXXXXXGXXXXXXXXXXXXXXXXXXXGXXXXXXXXXXXXXXXXXXXGXXXXXXXXXXXXXXXXXXXGXXXXXXXXXXXXXXXXXXXGXXXXXXXXXXXXXXXXXXXGXXXXXXXXXXXXXXXXXXXGXXXXXXXXXXXXXXXXXXXGXXXXXXXXXXXXXXXXXXXGXXXXXXXXXXXXXXXXXXXGXXXXXXXXXXXXXXXXXXXGXXXXXXXXXXXXXXXXXXX,0,300,0
36918,13,0,13,32,255,0,0,268,186,82,GXXXXXXXXXXXXXXXXXXXGXXXXXXXXXXXXXXXXXXXGXXXXXXXXXXXXXXXXXXXGXXXXXXXXXXXXXXXXXXXGXXXXXXXXXXXXXXXXXXXGXXXXXXXXXXXXXXXXXXXGXXXXXXXXXXXXXXXXXXXGXXXXXXXXXXXXXXXXXXXGXXXXXXXXXXXXXXXXXXXGXXXXXXXXXXXXXXXXXXXGXXXXXXXXXXXXXXXXXXXGXXXXXXXXXXXXXXXXXXXGXXXXXXXXXXXXXXXXXXX,0,300,0
36939,13,0,13,31,256,0,0,269,186,83,GXXXXXXXXXXXXXXXXXXXGXXXXXXXXXXXXXXXXXXXGXXXXXXXXXXXXXXXXXXXGXXXXXXXXXXXXXXXXXXXGXXXXXXXXXXXXXXXXXXXGXXXXXXXXXXXXXXXXXXXGXXXXXXXXXXXXXXXXXXXGXXXXXXXXXXXXXXXXXXXGXXXXXXXXXXXXXXXXXXXGXXXXXXXXXXXXXXXXXXXGXXXXXXXXXXXXXXXXXXXGXXXXXXXXXXXXXXXXXXXGXXXXXXXXXXXXXXXXXXX,0,300,0

36960,13,0,13,35,252,0,0,265,187,78,GXXXXXXXXXXXXXXXXXXXGXXXXXXXXXXXXXXXXXXXGXXXXXXXXXXXXXXXXXXXGXXXXXXXXXXXXXXXXXXXGXXXXXXXXXXXXXXXXXXXGXXXXXXXXXXXXXXXXXXXGXXXXXXXXXXXXXXXXXXXGXXXXXXXXXXXXXXXXXXXGXXXXXXXXXXXXXXXXXXXGXXXXXXXXXXXXXXXXXXXGXXXXXXXXXXXXXXXXXXXGXXXXXXXXXXXXXXXXXXXGXXXXXXXXXXXXXXXXXXX,0,300,0
36981,13,0,13,39,248,0,0,260,185,75,GXXXXXXXXXXXXXXXXXXXGXXXXXXXXXXXXXXXXXXXGXXXXXXXXXXXXXXXXXXXGXXXXXXXXXXXXXXXXXXXGXXXXXXXXXXXXXXXXXXXGXXXXXXXXXXXXXXXXXXXGXXXXXXXXXXXXXXXXXXXGXXXXXXXXXXXXXXXXXXXGXXXXXXXXXXXXXXXXXXXGXXXXXXXXXXXXXXXXXXXGXXXXXXXXXXXXXXXXXXXGXXXXXXXXXXXXXXXXXXXGXXXXXXXXXXXXXXXXXXX,0,300,0
37002,14,1,13,40,246,0,0,258,180,78,GXXXXXXXXXXXXXXXXXXXGXXXXXXXXXXXXXXXXXXXGXXXXXXXXXXXXXXXXXXXGXXXXXXXXXXXXXXXXXXXGXXXXXXXXXXXXXXXXXXXGXXXXXXXXXXXXXXXXXXXGAXXXXXXXXXXXXXXXXXXGXXXXXXXXXXXXXXXXXXXGXXXXXXXXXXXXXXXXXXXGXXXXXXXXXXXXXXXXXXXGXXXXXXXXXXXXXXXXXXXGXXXXXXXXXXXXXXXXXXXGXXXXXXXXXXXXXXXXXXX,0,300,0
37023,14,1,13,37,249,0,0,261,183,78,GXXXXXXXXXXXXXXXXXXXGXXXXXXXXXXXXXXXXXXXGXXXXXXXXXXXXXXXXXXXGXXXXXXXXXXXXXXXXXXXGXXXXXXXXXXXXXXXXXXXGXXXXXXXXXXXXXXXXXXXGAXXXXXXXXXXXXXXXXXXGXXXXXXXXXXXXXXXXXXXGXXXXXXXXXXXXXXXXXXXGXXXXXXXXXXXXXXXXXXXGXXXXXXXXXXXXXXXXXXXGXXXXXXXXXXXXXXXXXXXGXXXXXXXXXXXXXXXXXXX,0,300,0
37044,14,1,13,35,251,0,0,263,183,80,GXXXXXXXXXXXXXXXXXXXGXXXXXXXXXXXXXXXXXXXGXXXXXXXXXXXXXXXXXXXGXXXXXXXXXXXXXXXXXXXGXXXXXXXXXXXXXXXXXXXGXXXXXXXXXXXXXXXXXXXGAXXXXXXXXXXXXXXXXXXGXXXXXXXXXXXXXXXXXXXGXXXXXXXXXXXXXXXXXXXGXXXXXXXXXXXXXXXXXXXGXXXXXXXXXXXXXXXXXXXGXXXXXXXXXXXXXXXXXXXGXXXXXXXXXXXXXXXXXXX,0,300,0

37065,14,1,13,37,249,0,0,260,181,79,GXXXXXXXXXXXXXXXXXXXGXXXXXXXXXXXXXXXXXXXGXXXXXXXXXXXXXXXXXXXGXXXXXXXXXXXXXXXXXXXGXXXXXXXXXXXXXXXXXXXGXXXXXXXXXXXXXXXXXXXGAXXXXXXXXXXXXXXXXXXGXXXXXXXXXXXXXXXXXXXGXXXXXXXXXXXXXXXXXXXGXXXXXXXXXXXXXXXXXXXGXXXXXXXXXXXXXXXXXXXGXXXXXXXXXXXXXXXXXXXGXXXXXXXXXXXXXXXXXXX,0,300,0
37086,14,1,13,35,251,0,0,263,180,83,GXXXXXXXXXXXXXXXXXXXGXXXXXXXXXXXXXXXXXXXGXXXXXXXXXXXXXXXXXXXGXXXXXXXXXXXXXXXXXXXGXXXXXXXXXXXXXXXXXXXGXXXXXXXXXXXXXXXXXXXGAXXXXXXXXXXXXXXXXXXGXXXXXXXXXXXXXXXXXXXGXXXXXXXXXXXXXXXXXXXGXXXXXXXXXXXXXXXXXXXGXXXXXXXXXXXXXXXXXXXGXXXXXXXXXXXXXXXXXXXGXXXXXXXXXXXXXXXXXXX,0,300,0
37107,13,0,13,33,254,0,0,266,179,87,GXXXXXXXXXXXXXXXXXXXGXXXXXXXXXXXXXXXXXXXGXXXXXXXXXXXXXXXXXXXGXXXXXXXXXXXXXXXXXXXGXXXXXXXXXXXXXXXXXXXGXXXXXXXXXXXXXXXXXXXGXXXXXXXXXXXXXXXXXXXGXXXXXXXXXXXXXXXXXXXGXXXXXXXXXXXXXXXXXXXGXXXXXXXXXXXXXXXXXXXGXXXXXXXXXXXXXXXXXXXGXXXXXXXXXXXXXXXXXXXGXXXXXXXXXXXXXXXXXXX,0,300,0
37128,13,0,13,34,253,0,0,265,179,86,GXXXXXXXXXXXXXXXXXXXGXXXXXXXXXXXXXXXXXXXGXXXXXXXXXXXXXXXXXXXGXXXXXXXXXXXXXXXXXXXGXXXXXXXXXXXXXXXXXXXGXXXXXXXXXXXXXXXXXXXGXXXXXXXXXXXXXXXXXXXGXXXXXXXXXXXXXXXXXXXGXXXXXXXXXXXXXXXXXXXGXXXXXXXXXXXXXXXXXXXGXXXXXXXXXXXXXXXXXXXGXXXXXXXXXXXXXXXXXXXGXXXXXXXXXXXXXXXXXXX,0,300,0
37149,13,0,13,33,254,0,0,266,180,86,GXXXXXXXXXXXXXXXXXXXGXXXXXXXXXXXXXXXXXXXGXXXXXXXXXXXXXXXXXXXGXXXXXXXXXXXXXXXXXXXGXXXXXXXXXXXXXXXXXXXGXXXXXXXXXXXXXXXXXXXGXXXXXXXXXXXXXXXXXXXGXXXXXXXXXXXXXXXXXXXGXXXXXXXXXXXXXXXXXXXGXXXXXXXXXXXXXXXXXXXGXXXXXXXXXXXXXXXXXXXGXXXXXXXXXXXXXXXXXXXGXXXXXXXXXXXXXXXXXXX,0,300,0

37170,13,0,13,30,257,0,0,269,185,84,GXXXXXXXXXXXXXXXXXXXGXXXXXXXXXXXXXXXXXXXGXXXXXXXXXXXXXXXXXXXGXXXXXXXXXXXXXXXXXXXGXXXXXXXXXXXXXXXXXXXGXXXXXXXXXXXXXXXXXXXGXXXXXXXXXXXXXXXXXXXGXXXXXXXXXXXXXXXXXXXGXXXXXXXXXXXXXXXXXXXGXXXXXXXXXXXXXXXXXXXGXXXXXXXXXXXXXXXXXXXGXXXXXXXXXXXXXXXXXXXGXXXXXXXXXXXXXXXXXXX,0,300,0
37191,13,0,13,32,255,0,0,267,184,83,GXXXXXXXXXXXXXXXXXXXGXXXXXXXXXXXXXXXXXXXGXXXXXXXXXXXXXXXXXXXGXXXXXXXXXXXXXXXXXXXGXXXXXXXXXXXXXXXXXXXGXXXXXXXXXXXXXXXXXXXGXXXXXXXXXXXXXXXXXXXGXXXXXXXXXXXXXXXXXXXGXXXXXXXXXXXXXXXXXXXGXXXXXXXXXXXXXXXXXXXGXXXXXXXXXXXXXXXXXXXGXXXXXXXXXXXXXXXXXXXGXXXXXXXXXXXXXXXXXXX,0,300,0
37212,13,0,13,33,254,0,0,266,185,81,GXXXXXXXXXXXXXXXXXXXGXXXXXXXXXXXXXXXXXXXGXXXXXXXXXXXXXXXXXXXGXXXXXXXXXXXXXXXXXXXGXXXXXXXXXXXXXXXXXXXGXXXXXXXXXXXXXXXXXXXGXXXXXXXXXXXXXXXXXXXGXXXXXXXXXXXXXXXXXXXGXXXXXXXXXXXXXXXXXXXGXXXXXXXXXXXXXXXXXXXGXXXXXXXXXXXXXXXXXXXGXXXXXXXXXXXXXXXXXXXGXXXXXXXXXXXXXXXXXXX,0,300,0
37233,13,0,13,35,252,0,0,264,188,76,GXXXXXXXXXXXXXXXXXXXGXXXXXXXXXXXXXXXXXXXGXXXXXXXXXXXXXXXXXXXGXXXXXXXXXXXXXXXXXXXGXXXXXXXXXXXXXXXXXXXGXXXXXXXXXXXXXXXXXXXGXXXXXXXXXXXXXXXXXXXGXXXXXXXXXXXXXXXXXXXGXXXXXXXXXXXXXXXXXXXGXXXXXXXXXXXXXXXXXXXGXXXXXXXXXXXXXXXXXXXGXXXXXXXXXXXXXXXXXXXGXXXXXXXXXXXXXXXXXXX,0,300,0
37254,13,0,13,37,250,0,0,262,188,74,GXXXXXXXXXXXXXXXXXXXGXXXXXXXXXXXXXXXXXXXGXXXXXXXXXXXXXXXXXXXGXXXXXXXXXXXXXXXXXXXGXXXXXXXXXXXXXXXXXXXGXXXXXXXXXXXXXXXXXXXGXXXXXXXXXXXXXXXXXXXGXXXXXXXXXXXXXXXXXXXGXXXXXXXXXXXXXXXXXXXGXXXXXXXXXXXXXXXXXXXGXXXXXXXXXXXXXXXXXXXGXXXXXXXXXXXXXXXXXXXGXXXXXXXXXXXXXXXXXXX,0,300,0

37275,13,0,13,40,247,0,0,259,186,73,GXXXXXXXXXXXXXXXXXXXGXXXXXXXXXXXXXXXXXXXGXXXXXXXXXXXXXXXXXXXGXXXXXXXXXXXXXXXXXXXGXXXXXXXXXXXXXXXXXXXGXXXXXXXXXXXXXXXXXXXGXXXXXXXXXXXXXXXXXXXGXXXXXXXXXXXXXXXXXXXGXXXXXXXXXXXXXXXXXXXGXXXXXXXXXXXXXXXXXXXGXXXXXXXXXXXXXXXXXXXGXXXXXXXXXXXXXXXXXXXGXXXXXXXXXXXXXXXXXXX,0,300,0
37296,13,0,13,41,246,0,0,259,191,68,GXXXXXXXXXXXXXXXXXXXGXXXXXXXXXXXXXXXXXXXGXXXXXXXXXXXXXXXXXXXGXXXXXXXXXXXXXXXXXXXGXXXXXXXXXXXXXXXXXXXGXXXXXXXXXXXXXXXXXXXGXXXXXXXXXXXXXXXXXXXGXXXXXXXXXXXXXXXXXXXGXXXXXXXXXXXXXXXXXXXGXXXXXXXXXXXXXXXXXXXGXXXXXXXXXXXXXXXXXXXGXXXXXXXXXXXXXXXXXXXGXXXXXXXXXXXXXXXXXXX,0,300,0
37317,13,0,13,43,244,0,0,257,187,70,GXXXXXXXXXXXXXXXXXXXGXXXXXXXXXXXXXXXXXXXGXXXXXXXXXXXXXXXXXXXGXXXXXXXXXXXXXXXXXXXGXXXXXXXXXXXXXXXXXXXGXXXXXXXXXXXXXXXXXXXGXXXXXXXXXXXXXXXXXXXGXXXXXXXXXXXXXXXXXXXGXXXXXXXXXXXXXXXXXXXGXXXXXXXXXXXXXXXXXXXGXXXXXXXXXXXXXXXXXXXGXXXXXXXXXXXXXXXXXXXGXXXXXXXXXXXXXXXXXXX,0,300,0
37338,13,0,13,47,240,0,0,253,187,66,GXXXXXXXXXXXXXXXXXXXGXXXXXXXXXXXXXXXXXXXGXXXXXXXXXXXXXXXXXXXGXXXXXXXXXXXXXXXXXXXGXXXXXXXXXXXXXXXXXXXGXXXXXXXXXXXXXXXXXXXGXXXXXXXXXXXXXXXXXXXGXXXXXXXXXXXXXXXXXXXGXXXXXXXXXXXXXXXXXXXGXXXXXXXXXXXXXXXXXXXGXXXXXXXXXXXXXXXXXXXGXXXXXXXXXXXXXXXXXXXGXXXXXXXXXXXXXXXXXXX,0,300,0
37359,13,0,13,54,233,0,0,246,186,60,GXXXXXXXXXXXXXXXXXXXGXXXXXXXXXXXXXXXXXXXGXXXXXXXXXXXXXXXXXXXGXXXXXXXXXXXXXXXXXXXGXXXXXXXXXXXXXXXXXXXGXXXXXXXXXXXXXXXXXXXGXXXXXXXXXXXXXXXXXXXGXXXXXXXXXXXXXXXXXXXGXXXXXXXXXXXXXXXXXXXGXXXXXXXXXXXXXXXXXXXGXXXXXXXXXXXXXXXXXXXGXXXXXXXXXXXXXXXXXXXGXXXXXXXXXXXXXXXXXXX,0,300,0

37380,13,0,13,52,235,0,0,247,188,59,GXXXXXXXXXXXXXXXXXXXGXXXXXXXXXXXXXXXXXXXGXXXXXXXXXXXXXXXXXXXGXXXXXXXXXXXXXXXXXXXGXXXXXXXXXXXXXXXXXXXGXXXXXXXXXXXXXXXXXXXGXXXXXXXXXXXXXXXXXXXGXXXXXXXXXXXXXXXXXXXGXXXXXXXXXXXXXXXXXXXGXXXXXXXXXXXXXXXXXXXGXXXXXXXXXXXXXXXXXXXGXXXXXXXXXXXXXXXXXXXGXXXXXXXXXXXXXXXXXXX,0,300,0
37401,13,0,13,58,229,0,0,242,186,56,GXXXXXXXXXXXXXXXXXXXGXXXXXXXXXXXXXXXXXXXGXXXXXXXXXXXXXXXXXXXGXXXXXXXXXXXXXXXXXXXGXXXXXXXXXXXXXXXXXXXGXXXXXXXXXXXXXXXXXXXGXXXXXXXXXXXXXXXXXXXGXXXXXXXXXXXXXXXXXXXGXXXXXXXXXXXXXXXXXXXGXXXXXXXXXXXXXXXXXXXGXXXXXXXXXXXXXXXXXXXGXXXXXXXXXXXXXXXXXXXGXXXXXXXXXXXXXXXXXXX,0,300,0
37422,13,0,13,59,228,0,0,241,186,55,GXXXXXXXXXXXXXXXXXXXGXXXXXXXXXXXXXXXXXXXGXXXXXXXXXXXXXXXXXXXGXXXXXXXXXXXXXXXXXXXGXXXXXXXXXXXXXXXXXXXGXXXXXXXXXXXXXXXXXXXGXXXXXXXXXXXXXXXXXXXGXXXXXXXXXXXXXXXXXXXGXXXXXXXXXXXXXXXXXXXGXXXXXXXXXXXXXXXXXXXGXXXXXXXXXXXXXXXXXXXGXXXXXXXXXXXXXXXXXXXGXXXXXXXXXXXXXXXXXXX,0,300,0
37443,14,1,13,56,230,0,0,243,185,58,GXXXXXXXXXXXXXXXXXXXGXXXXXXXXXXXXXXXXXXXGXXXXXXXXXXXXXXXXXXXGXXXXXXXXXXXXXXXXXXXGXXXXXXXXXXXXXXXXXXXGXXXXXXXXXXXXXXXXXXXGAXXXXXXXXXXXXXXXXXXGXXXXXXXXXXXXXXXXXXXGXXXXXXXXXXXXXXXXXXXGXXXXXXXXXXXXXXXXXXXGXXXXXXXXXXXXXXXXXXXGXXXXXXXXXXXXXXXXXXXGXXXXXXXXXXXXXXXXXXX,0,300,0
37464,14,1,13,56,230,0,0,242,182,60,GXXXXXXXXXXXXXXXXXXXGXXXXXXXXXXXXXXXXXXXGXXXXXXXXXXXXXXXXXXXGXXXXXXXXXXXXXXXXXXXGXXXXXXXXXXXXXXXXXXXGXXXXXXXXXXXXXXXXXXXGAXXXXXXXXXXXXXXXXXXGXXXXXXXXXXXXXXXXXXXGXXXXXXXXXXXXXXXXXXXGXXXXXXXXXXXXXXXXXXXGXXXXXXXXXXXXXXXXXXXGXXXXXXXXXXXXXXXXXXXGXXXXXXXXXXXXXXXXXXX,0,300,0

37485,14,1,13,55,231,0,0,244,185,59,GXXXXXXXXXXXXXXXXXXXGXXXXXXXXXXXXXXXXXXXGXXXXXXXXXXXXXXXXXXXGXXXXXXXXXXXXXXXXXXXGXXXXXXXXXXXXXXXXXXXGXXXXXXXXXXXXXXXXXXXGAXXXXXXXXXXXXXXXXXXGXXXXXXXXXXXXXXXXXXXGXXXXXXXXXXXXXXXXXXXGXXXXXXXXXXXXXXXXXXXGXXXXXXXXXXXXXXXXXXXGXXXXXXXXXXXXXXXXXXXGXXXXXXXXXXXXXXXXXXX,0,300,0
37506,14,1,13,58,228,0,0,242,182,60,GXXXXXXXXXXXXXXXXXXXGXXXXXXXXXXXXXXXXXXXGXXXXXXXXXXXXXXXXXXXGXXXXXXXXXXXXXXXXXXXGXXXXXXXXXXXXXXXXXXXGXXXXXXXXXXXXXXXXXXXGAXXXXXXXXXXXXXXXXXXGXXXXXXXXXXXXXXXXXXXGXXXXXXXXXXXXXXXXXXXGXXXXXXXXXXXXXXXXXXXGXXXXXXXXXXXXXXXXXXXGXXXXXXXXXXXXXXXXXXXGXXXXXXXXXXXXXXXXXXX,0,300,0
37527,14,1,13,59,227,0,0,241,183,58,GXXXXXXXXXXXXXXXXXXXGXXXXXXXXXXXXXXXXXXXGXXXXXXXXXXXXXXXXXXXGXXXXXXXXXXXXXXXXXXXGXXXXXXXXXXXXXXXXXXXGXXXXXXXXXXXXXXXXXXXGAXXXXXXXXXXXXXXXXXXGXXXXXXXXXXXXXXXXXXXGXXXXXXXXXXXXXXXXXXXGXXXXXXXXXXXXXXXXXXXGXXXXXXXXXXXXXXXXXXXGXXXXXXXXXXXXXXXXXXXGXXXXXXXXXXXXXXXXXXX,0,300,0
37548,14,1,13,56,230,0,0,242,184,58,GXXXXXXXXXXXXXXXXXXXGXXXXXXXXXXXXXXXXXXXGXXXXXXXXXXXXXXXXXXXGXXXXXXXXXXXXXXXXXXXGXXXXXXXXXXXXXXXXXXXGXXXXXXXXXXXXXXXXXXXGAXXXXXXXXXXXXXXXXXXGXXXXXXXXXXXXXXXXXXXGXXXXXXXXXXXXXXXXXXXGXXXXXXXXXXXXXXXXXXXGXXXXXXXXXXXXXXXXXXXGXXXXXXXXXXXXXXXXXXXGXXXXXXXXXXXXXXXXXXX,0,300,0
37569,14,1,13,51,235,0,0,248,182,66,GXXXXXXXXXXXXXXXXXXXGXXXXXXXXXXXXXXXXXXXGXXXXXXXXXXXXXXXXXXXGXXXXXXXXXXXXXXXXXXXGXXXXXXXXXXXXXXXXXXXGXXXXXXXXXXXXXXXXXXXGAXXXXXXXXXXXXXXXXXXGXXXXXXXXXXXXXXXXXXXGXXXXXXXXXXXXXXXXXXXGXXXXXXXXXXXXXXXXXXXGXXXXXXXXXXXXXXXXXXXGXXXXXXXXXXXXXXXXXXXGXXXXXXXXXXXXXXXXXXX,0,300,0

37590,15,2,13,48,237,0,0,250,182,68,GXXXXXXXXXXXXXXXXXXXGXXXXXXXXXXXXXXXXXXXGAXXXXXXXXXXXXXXXXXXGXXXXXXXXXXXXXXXXXXXGXXXXXXXXXXXXXXXXXXXGXXXXXXXXXXXXXXXXXXXGAXXXXXXXXXXXXXXXXXXGXXXXXXXXXXXXXXXXXXXGXXXXXXXXXXXXXXXXXXXGXXXXXXXXXXXXXXXXXXXGXXXXXXXXXXXXXXXXXXXGXXXXXXXXXXXXXXXXXXXGXXXXXXXXXXXXXXXXXXX,0,300,0
37611,15,2,13,42,243,0,0,256,182,74,GXXXXXXXXXXXXXXXXXXXGXXXXXXXXXXXXXXXXXXXGAXXXXXXXXXXXXXXXXXXGXXXXXXXXXXXXXXXXXXXGXXXXXXXXXXXXXXXXXXXGXXXXXXXXXXXXXXXXXXXGAXXXXXXXXXXXXXXXXXXGXXXXXXXXXXXXXXXXXXXGXXXXXXXXXXXXXXXXXXXGXXXXXXXXXXXXXXXXXXXGXXXXXXXXXXXXXXXXXXXGXXXXXXXXXXXXXXXXXXXGXXXXXXXXXXXXXXXXXXX,0,300,0
37632,15,2,13,41,244,0,0,257,183,74,GXXXXXXXXXXXXXXXXXXXGXXXXXXXXXXXXXXXXXXXGAXXXXXXXXXXXXXXXXXXGXXXXXXXXXXXXXXXXXXXGXXXXXXXXXXXXXXXXXXXGXXXXXXXXXXXXXXXXXXXGAXXXXXXXXXXXXXXXXXXGXXXXXXXXXXXXXXXXXXXGXXXXXXXXXXXXXXXXXXXGXXXXXXXXXXXXXXXXXXXGXXXXXXXXXXXXXXXXXXXGXXXXXXXXXXXXXXXXXXXGXXXXXXXXXXXXXXXXXXX,0,300,0
37653,15,2,13,43,242,0,0,255,183,72,GXXXXXXXXXXXXXXXXXXXGXXXXXXXXXXXXXXXXXXXGAXXXXXXXXXXXXXXXXXXGXXXXXXXXXXXXXXXXXXXGXXXXXXXXXXXXXXXXXXXGXXXXXXXXXXXXXXXXXXXGAXXXXXXXXXXXXXXXXXXGXXXXXXXXXXXXXXXXXXXGXXXXXXXXXXXXXXXXXXXGXXXXXXXXXXXXXXXXXXXGXXXXXXXXXXXXXXXXXXXGXXXXXXXXXXXXXXXXXXXGXXXXXXXXXXXXXXXXXXX,0,300,0
37674,15,2,13,41,244,0,0,257,184,73,GXXXXXXXXXXXXXXXXXXXGXXXXXXXXXXXXXXXXXXXGAXXXXXXXXXXXXXXXXXXGXXXXXXXXXXXXXXXXXXXGXXXXXXXXXXXXXXXXXXXGXXXXXXXXXXXXXXXXXXXGAXXXXXXXXXXXXXXXXXXGXXXXXXXXXXXXXXXXXXXGXXXXXXXXXXXXXXXXXXXGXXXXXXXXXXXXXXXXXXXGXXXXXXXXXXXXXXXXXXXGXXXXXXXXXXXXXXXXXXXGXXXXXXXXXXXXXXXXXXX,0,300,0

37695,14,1,13,35,251,0,0,263,188,75,GXXXXXXXXXXXXXXXXXXXGXXXXXXXXXXXXXXXXXXXGXXXXXXXXXXXXXXXXXXXGXXXXXXXXXXXXXXXXXXXGXXXXXXXXXXXXXXXXXXXGXXXXXXXXXXXXXXXXXXXGAXXXXXXXXXXXXXXXXXXGXXXXXXXXXXXXXXXXXXXGXXXXXXXXXXXXXXXXXXXGXXXXXXXXXXXXXXXXXXXGXXXXXXXXXXXXXXXXXXXGXXXXXXXXXXXXXXXXXXXGXXXXXXXXXXXXXXXXXXX,0,300,0
37716,14,1,13,34,252,0,0,265,189,76,GXXXXXXXXXXXXXXXXXXXGXXXXXXXXXXXXXXXXXXXGXXXXXXXXXXXXXXXXXXXGXXXXXXXXXXXXXXXXXXXGXXXXXXXXXXXXXXXXXXXGXXXXXXXXXXXXXXXXXXXGAXXXXXXXXXXXXXXXXXXGXXXXXXXXXXXXXXXXXXXGXXXXXXXXXXXXXXXXXXXGXXXXXXXXXXXXXXXXXXXGXXXXXXXXXXXXXXXXXXXGXXXXXXXXXXXXXXXXXXXGXXXXXXXXXXXXXXXXXXX,0,300,0
37737,14,0,14,30,256,0,0,269,190,79,GXXXXXXXXXXXXXXXXXXXGXXXXXXXXXXXXXXXXXXXGXXXXXXXXXXXXXXXXXXXGXXXXXXXXXXXXXXXXXXXGXXXXXXXXXXXXXXXXXXXGXXXXXXXXXXXXXXXXXXXGOXXXXXXXXXXXXXXXXXXGXXXXXXXXXXXXXXXXXXXGXXXXXXXXXXXXXXXXXXXGXXXXXXXXXXXXXXXXXXXGXXXXXXXXXXXXXXXXXXXGXXXXXXXXXXXXXXXXXXXGXXXXXXXXXXXXXXXXXXX,0,300,0
37758,13,0,13,36,251,0,0,264,182,82,GXXXXXXXXXXXXXXXXXXXGXXXXXXXXXXXXXXXXXXXGXXXXXXXXXXXXXXXXXXXGXXXXXXXXXXXXXXXXXXXGXXXXXXXXXXXXXXXXXXXGXXXXXXXXXXXXXXXXXXXGXXXXXXXXXXXXXXXXXXXGXXXXXXXXXXXXXXXXXXXGXXXXXXXXXXXXXXXXXXXGXXXXXXXXXXXXXXXXXXXGXXXXXXXXXXXXXXXXXXXGXXXXXXXXXXXXXXXXXXXGXXXXXXXXXXXXXXXXXXX,0,300,0
37779,13,0,13,36,251,0,0,264,184,80,GXXXXXXXXXXXXXXXXXXXGXXXXXXXXXXXXXXXXXXXGXXXXXXXXXXXXXXXXXXXGXXXXXXXXXXXXXXXXXXXGXXXXXXXXXXXXXXXXXXXGXXXXXXXXXXXXXXXXXXXGXXXXXXXXXXXXXXXXXXXGXXXXXXXXXXXXXXXXXXXGXXXXXXXXXXXXXXXXXXXGXXXXXXXXXXXXXXXXXXXGXXXXXXXXXXXXXXXXXXXGXXXXXXXXXXXXXXXXXXXGXXXXXXXXXXXXXXXXXXX,0,300,0

37800,13,0,13,37,250,0,0,263,184,79,GXXXXXXXXXXXXXXXXXXXGXXXXXXXXXXXXXXXXXXXGXXXXXXXXXXXXXXXXXXXGXXXXXXXXXXXXXXXXXXXGXXXXXXXXXXXXXXXXXXXGXXXXXXXXXXXXXXXXXXXGXXXXXXXXXXXXXXXXXXXGXXXXXXXXXXXXXXXXXXXGXXXXXXXXXXXXXXXXXXXGXXXXXXXXXXXXXXXXXXXGXXXXXXXXXXXXXXXXXXXGXXXXXXXXXXXXXXXXXXXGXXXXXXXXXXXXXXXXXXX,0,300,0
37821,13,0,13,33,254,0,0,266,186,80,GXXXXXXXXXXXXXXXXXXXGXXXXXXXXXXXXXXXXXXXGXXXXXXXXXXXXXXXXXXXGXXXXXXXXXXXXXXXXXXXGXXXXXXXXXXXXXXXXXXXGXXXXXXXXXXXXXXXXXXXGXXXXXXXXXXXXXXXXXXXGXXXXXXXXXXXXXXXXXXXGXXXXXXXXXXXXXXXXXXXGXXXXXXXXXXXXXXXXXXXGXXXXXXXXXXXXXXXXXXXGXXXXXXXXXXXXXXXXXXXGXXXXXXXXXXXXXXXXXXX,0,300,0
37842,13,0,13,37,250,0,0,261,180,81,GXXXXXXXXXXXXXXXXXXXGXXXXXXXXXXXXXXXXXXXGXXXXXXXXXXXXXXXXXXXGXXXXXXXXXXXXXXXXXXXGXXXXXXXXXXXXXXXXXXXGXXXXXXXXXXXXXXXXXXXGXXXXXXXXXXXXXXXXXXXGXXXXXXXXXXXXXXXXXXXGXXXXXXXXXXXXXXXXXXXGXXXXXXXXXXXXXXXXXXXGXXXXXXXXXXXXXXXXXXXGXXXXXXXXXXXXXXXXXXXGXXXXXXXXXXXXXXXXXXX,0,300,0
37863,13,0,13,35,252,0,0,263,180,83,GXXXXXXXXXXXXXXXXXXXGXXXXXXXXXXXXXXXXXXXGXXXXXXXXXXXXXXXXXXXGXXXXXXXXXXXXXXXXXXXGXXXXXXXXXXXXXXXXXXXGXXXXXXXXXXXXXXXXXXXGXXXXXXXXXXXXXXXXXXXGXXXXXXXXXXXXXXXXXXXGXXXXXXXXXXXXXXXXXXXGXXXXXXXXXXXXXXXXXXXGXXXXXXXXXXXXXXXXXXXGXXXXXXXXXXXXXXXXXXXGXXXXXXXXXXXXXXXXXXX,0,300,0
37884,13,0,13,32,255,0,0,267,179,88,GXXXXXXXXXXXXXXXXXXXGXXXXXXXXXXXXXXXXXXXGXXXXXXXXXXXXXXXXXXXGXXXXXXXXXXXXXXXXXXXGXXXXXXXXXXXXXXXXXXXGXXXXXXXXXXXXXXXXXXXGXXXXXXXXXXXXXXXXXXXGXXXXXXXXXXXXXXXXXXXGXXXXXXXXXXXXXXXXXXXGXXXXXXXXXXXXXXXXXXXGXXXXXXXXXXXXXXXXXXXGXXXXXXXXXXXXXXXXXXXGXXXXXXXXXXXXXXXXXXX,0,300,0

37905,13,0,13,29,258,0,0,269,182,87,GXXXXXXXXXXXXXXXXXXXGXXXXXXXXXXXXXXXXXXXGXXXXXXXXXXXXXXXXXXXGXXXXXXXXXXXXXXXXXXXGXXXXXXXXXXXXXXXXXXXGXXXXXXXXXXXXXXXXXXXGXXXXXXXXXXXXXXXXXXXGXXXXXXXXXXXXXXXXXXXGXXXXXXXXXXXXXXXXXXXGXXXXXXXXXXXXXXXXXXXGXXXXXXXXXXXXXXXXXXXGXXXXXXXXXXXXXXXXXXXGXXXXXXXXXXXXXXXXXXX,0,300,0
37926,13,0,13,28,259,0,0,271,187,84,GXXXXXXXXXXXXXXXXXXXGXXXXXXXXXXXXXXXXXXXGXXXXXXXXXXXXXXXXXXXGXXXXXXXXXXXXXXXXXXXGXXXXXXXXXXXXXXXXXXXGXXXXXXXXXXXXXXXXXXXGXXXXXXXXXXXXXXXXXXXGXXXXXXXXXXXXXXXXXXXGXXXXXXXXXXXXXXXXXXXGXXXXXXXXXXXXXXXXXXXGXXXXXXXXXXXXXXXXXXXGXXXXXXXXXXXXXXXXXXXGXXXXXXXXXXXXXXXXXXX,0,300,0
37947,13,0,13,34,253,0,0,265,190,75,GXXXXXXXXXXXXXXXXXXXGXXXXXXXXXXXXXXXXXXXGXXXXXXXXXXXXXXXXXXXGXXXXXXXXXXXXXXXXXXXGXXXXXXXXXXXXXXXXXXXGXXXXXXXXXXXXXXXXXXXGXXXXXXXXXXXXXXXXXXXGXXXXXXXXXXXXXXXXXXXGXXXXXXXXXXXXXXXXXXXGXXXXXXXXXXXXXXXXXXXGXXXXXXXXXXXXXXXXXXXGXXXXXXXXXXXXXXXXXXXGXXXXXXXXXXXXXXXXXXX,0,300,0
37968,13,0,13,38,249,0,0,260,188,72,GXXXXXXXXXXXXXXXXXXXGXXXXXXXXXXXXXXXXXXXGXXXXXXXXXXXXXXXXXXXGXXXXXXXXXXXXXXXXXXXGXXXXXXXXXXXXXXXXXXXGXXXXXXXXXXXXXXXXXXXGXXXXXXXXXXXXXXXXXXXGXXXXXXXXXXXXXXXXXXXGXXXXXXXXXXXXXXXXXXXGXXXXXXXXXXXXXXXXXXXGXXXXXXXXXXXXXXXXXXXGXXXXXXXXXXXXXXXXXXXGXXXXXXXXXXXXXXXXXXX,0,300,0
37989,13,0,13,37,250,0,0,262,188,74,GXXXXXXXXXXXXXXXXXXXGXXXXXXXXXXXXXXXXXXXGXXXXXXXXXXXXXXXXXXXGXXXXXXXXXXXXXXXXXXXGXXXXXXXXXXXXXXXXXXXGXXXXXXXXXXXXXXXXXXXGXXXXXXXXXXXXXXXXXXXGXXXXXXXXXXXXXXXXXXXGXXXXXXXXXXXXXXXXXXXGXXXXXXXXXXXXXXXXXXXGXXXXXXXXXXXXXXXXXXXGXXXXXXXXXXXXXXXXXXXGXXXXXXXXXXXXXXXXXXX,0,300,0

38010,13,0,13,41,246,0,0,258,186,72,GXXXXXXXXXXXXXXXXXXXGXXXXXXXXXXXXXXXXXXXGXXXXXXXXXXXXXXXXXXXGXXXXXXXXXXXXXXXXXXXGXXXXXXXXXXXXXXXXXXXGXXXXXXXXXXXXXXXXXXXGXXXXXXXXXXXXXXXXXXXGXXXXXXXXXXXXXXXXXXXGXXXXXXXXXXXXXXXXXXXGXXXXXXXXXXXXXXXXXXXGXXXXXXXXXXXXXXXXXXXGXXXXXXXXXXXXXXXXXXXGXXXXXXXXXXXXXXXXXXX,0,300,0
38031,13,0,13,44,243,0,0,255,185,70,GXXXXXXXXXXXXXXXXXXXGXXXXXXXXXXXXXXXXXXXGXXXXXXXXXXXXXXXXXXXGXXXXXXXXXXXXXXXXXXXGXXXXXXXXXXXXXXXXXXXGXXXXXXXXXXXXXXXXXXXGXXXXXXXXXXXXXXXXXXXGXXXXXXXXXXXXXXXXXXXGXXXXXXXXXXXXXXXXXXXGXXXXXXXXXXXXXXXXXXXGXXXXXXXXXXXXXXXXXXXGXXXXXXXXXXXXXXXXXXXGXXXXXXXXXXXXXXXXXXX,0,300,0
38052,14,1,13,41,245,0,0,256,192,64,GXXXXXXXXXXXXXXXXXXXGXXXXXXXXXXXXXXXXXXXGXXXXXXXXXXXXXXXXXXXGXXXXXXXXXXXXXXXXXXXGXXXXXXXXXXXXXXXXXXXGXXXXXXXXXXXXXXXXXXXGXXXXXXXXXXXXXXXXXXXGAXXXXXXXXXXXXXXXXXXGXXXXXXXXXXXXXXXXXXXGXXXXXXXXXXXXXXXXXXXGXXXXXXXXXXXXXXXXXXXGXXXXXXXXXXXXXXXXXXXGXXXXXXXXXXXXXXXXXXX,0,300,0
38073,14,1,13,46,240,0,0,252,189,63,GXXXXXXXXXXXXXXXXXXXGXXXXXXXXXXXXXXXXXXXGXXXXXXXXXXXXXXXXXXXGXXXXXXXXXXXXXXXXXXXGXXXXXXXXXXXXXXXXXXXGXXXXXXXXXXXXXXXXXXXGXXXXXXXXXXXXXXXXXXXGAXXXXXXXXXXXXXXXXXXGXXXXXXXXXXXXXXXXXXXGXXXXXXXXXXXXXXXXXXXGXXXXXXXXXXXXXXXXXXXGXXXXXXXXXXXXXXXXXXXGXXXXXXXXXXXXXXXXXXX,0,300,0
38094,14,1,13,43,243,0,0,255,187,68,GXXXXXXXXXXXXXXXXXXXGXXXXXXXXXXXXXXXXXXXGXXXXXXXXXXXXXXXXXXXGXXXXXXXXXXXXXXXXXXXGXXXXXXXXXXXXXXXXXXXGXXXXXXXXXXXXXXXXXXXGXXXXXXXXXXXXXXXXXXXGAXXXXXXXXXXXXXXXXXXGXXXXXXXXXXXXXXXXXXXGXXXXXXXXXXXXXXXXXXXGXXXXXXXXXXXXXXXXXXXGXXXXXXXXXXXXXXXXXXXGXXXXXXXXXXXXXXXXXXX,0,300,0

38115,14,1,13,44,242,0,0,254,188,66,GXXXXXXXXXXXXXXXXXXXGXXXXXXXXXXXXXXXXXXXGXXXXXXXXXXXXXXXXXXXGXXXXXXXXXXXXXXXXXXXGXXXXXXXXXXXXXXXXXXXGXXXXXXXXXXXXXXXXXXXGXXXXXXXXXXXXXXXXXXXGAXXXXXXXXXXXXXXXXXXGXXXXXXXXXXXXXXXXXXXGXXXXXXXXXXXXXXXXXXXGXXXXXXXXXXXXXXXXXXXGXXXXXXXXXXXXXXXXXXXGXXXXXXXXXXXXXXXXXXX,0,300,0
38136,14,1,13,44,242,0,0,254,185,69,GXXXXXXXXXXXXXXXXXXXGXXXXXXXXXXXXXXXXXXXGXXXXXXXXXXXXXXXXXXXGXXXXXXXXXXXXXXXXXXXGXXXXXXXXXXXXXXXXXXXGXXXXXXXXXXXXXXXXXXXGXXXXXXXXXXXXXXXXXXXGAXXXXXXXXXXXXXXXXXXGXXXXXXXXXXXXXXXXXXXGXXXXXXXXXXXXXXXXXXXGXXXXXXXXXXXXXXXXXXXGXXXXXXXXXXXXXXXXXXXGXXXXXXXXXXXXXXXXXXX,0,300,0
38157,14,1,13,45,241,0,0,253,186,67,GXXXXXXXXXXXXXXXXXXXGXXXXXXXXXXXXXXXXXXXGXXXXXXXXXXXXXXXXXXXGXXXXXXXXXXXXXXXXXXXGXXXXXXXXXXXXXXXXXXXGXXXXXXXXXXXXXXXXXXXGXXXXXXXXXXXXXXXXXXXGAXXXXXXXXXXXXXXXXXXGXXXXXXXXXXXXXXXXXXXGXXXXXXXXXXXXXXXXXXXGXXXXXXXXXXXXXXXXXXXGXXXXXXXXXXXXXXXXXXXGXXXXXXXXXXXXXXXXXXX,0,300,0
38178,14,1,13,45,241,0,0,253,187,66,GXXXXXXXXXXXXXXXXXXXGXXXXXXXXXXXXXXXXXXXGXXXXXXXXXXXXXXXXXXXGXXXXXXXXXXXXXXXXXXXGXXXXXXXXXXXXXXXXXXXGXXXXXXXXXXXXXXXXXXXGXXXXXXXXXXXXXXXXXXXGAXXXXXXXXXXXXXXXXXXGXXXXXXXXXXXXXXXXXXXGXXXXXXXXXXXXXXXXXXXGXXXXXXXXXXXXXXXXXXXGXXXXXXXXXXXXXXXXXXXGXXXXXXXXXXXXXXXXXXX,0,300,0
38199,14,0,14,45,241,0,0,253,186,67,GXXXXXXXXXXXXXXXXXXXGXXXXXXXXXXXXXXXXXXXGXXXXXXXXXXXXXXXXXXXGXXXXXXXXXXXXXXXXXXXGXXXXXXXXXXXXXXXXXXXGXXXXXXXXXXXXXXXXXXXGXXXXXXXXXXXXXXXXXXXGOXXXXXXXXXXXXXXXXXXGXXXXXXXXXXXXXXXXXXXGXXXXXXXXXXXXXXXXXXXGXXXXXXXXXXXXXXXXXXXGXXXXXXXXXXXXXXXXXXXGXXXXXXXXXXXXXXXXXXX,0,300,0

38220,13,0,13,42,245,0,0,257,186,71,GXXXXXXXXXXXXXXXXXXXGXXXXXXXXXXXXXXXXXXXGXXXXXXXXXXXXXXXXXXXGXXXXXXXXXXXXXXXXXXXGXXXXXXXXXXXXXXXXXXXGXXXXXXXXXXXXXXXXXXXGXXXXXXXXXXXXXXXXXXXGXXXXXXXXXXXXXXXXXXXGXXXXXXXXXXXXXXXXXXXGXXXXXXXXXXXXXXXXXXXGXXXXXXXXXXXXXXXXXXXGXXXXXXXXXXXXXXXXXXXGXXXXXXXXXXXXXXXXXXX,0,300,0
38241,13,0,13,44,243,0,0,255,190,65,GXXXXXXXXXXXXXXXXXXXGXXXXXXXXXXXXXXXXXXXGXXXXXXXXXXXXXXXXXXXGXXXXXXXXXXXXXXXXXXXGXXXXXXXXXXXXXXXXXXXGXXXXXXXXXXXXXXXXXXXGXXXXXXXXXXXXXXXXXXXGXXXXXXXXXXXXXXXXXXXGXXXXXXXXXXXXXXXXXXXGXXXXXXXXXXXXXXXXXXXGXXXXXXXXXXXXXXXXXXXGXXXXXXXXXXXXXXXXXXXGXXXXXXXXXXXXXXXXXXX,0,300,0
38262,13,0,13,48,239,0,0,250,184,66,GXXXXXXXXXXXXXXXXXXXGXXXXXXXXXXXXXXXXXXXGXXXXXXXXXXXXXXXXXXXGXXXXXXXXXXXXXXXXXXXGXXXXXXXXXXXXXXXXXXXGXXXXXXXXXXXXXXXXXXXGXXXXXXXXXXXXXXXXXXXGXXXXXXXXXXXXXXXXXXXGXXXXXXXXXXXXXXXXXXXGXXXXXXXXXXXXXXXXXXXGXXXXXXXXXXXXXXXXXXXGXXXXXXXXXXXXXXXXXXXGXXXXXXXXXXXXXXXXXXX,0,300,0
38283,13,0,13,43,244,0,0,256,188,68,GXXXXXXXXXXXXXXXXXXXGXXXXXXXXXXXXXXXXXXXGXXXXXXXXXXXXXXXXXXXGXXXXXXXXXXXXXXXXXXXGXXXXXXXXXXXXXXXXXXXGXXXXXXXXXXXXXXXXXXXGXXXXXXXXXXXXXXXXXXXGXXXXXXXXXXXXXXXXXXXGXXXXXXXXXXXXXXXXXXXGXXXXXXXXXXXXXXXXXXXGXXXXXXXXXXXXXXXXXXXGXXXXXXXXXXXXXXXXXXXGXXXXXXXXXXXXXXXXXXX,0,300,0
38304,13,0,13,37,250,0,0,263,193,70,GXXXXXXXXXXXXXXXXXXXGXXXXXXXXXXXXXXXXXXXGXXXXXXXXXXXXXXXXXXXGXXXXXXXXXXXXXXXXXXXGXXXXXXXXXXXXXXXXXXXGXXXXXXXXXXXXXXXXXXXGXXXXXXXXXXXXXXXXXXXGXXXXXXXXXXXXXXXXXXXGXXXXXXXXXXXXXXXXXXXGXXXXXXXXXXXXXXXXXXXGXXXXXXXXXXXXXXXXXXXGXXXXXXXXXXXXXXXXXXXGXXXXXXXXXXXXXXXXXXX,0,300,0

38325,13,0,13,39,248,0,0,261,193,68,GXXXXXXXXXXXXXXXXXXXGXXXXXXXXXXXXXXXXXXXGXXXXXXXXXXXXXXXXXXXGXXXXXXXXXXXXXXXXXXXGXXXXXXXXXXXXXXXXXXXGXXXXXXXXXXXXXXXXXXXGXXXXXXXXXXXXXXXXXXXGXXXXXXXXXXXXXXXXXXXGXXXXXXXXXXXXXXXXXXXGXXXXXXXXXXXXXXXXXXXGXXXXXXXXXXXXXXXXXXXGXXXXXXXXXXXXXXXXXXXGXXXXXXXXXXXXXXXXXXX,0,300,0
38346,13,0,13,41,246,0,0,258,188,70,GXXXXXXXXXXXXXXXXXXXGXXXXXXXXXXXXXXXXXXXGXXXXXXXXXXXXXXXXXXXGXXXXXXXXXXXXXXXXXXXGXXXXXXXXXXXXXXXXXXXGXXXXXXXXXXXXXXXXXXXGXXXXXXXXXXXXXXXXXXXGXXXXXXXXXXXXXXXXXXXGXXXXXXXXXXXXXXXXXXXGXXXXXXXXXXXXXXXXXXXGXXXXXXXXXXXXXXXXXXXGXXXXXXXXXXXXXXXXXXXGXXXXXXXXXXXXXXXXXXX,0,300,0
38367,13,0,13,46,241,0,0,254,185,69,GXXXXXXXXXXXXXXXXXXXGXXXXXXXXXXXXXXXXXXXGXXXXXXXXXXXXXXXXXXXGXXXXXXXXXXXXXXXXXXXGXXXXXXXXXXXXXXXXXXXGXXXXXXXXXXXXXXXXXXXGXXXXXXXXXXXXXXXXXXXGXXXXXXXXXXXXXXXXXXXGXXXXXXXXXXXXXXXXXXXGXXXXXXXXXXXXXXXXXXXGXXXXXXXXXXXXXXXXXXXGXXXXXXXXXXXXXXXXXXXGXXXXXXXXXXXXXXXXXXX,0,300,0
38388,13,0,13,49,238,0,0,251,186,65,GXXXXXXXXXXXXXXXXXXXGXXXXXXXXXXXXXXXXXXXGXXXXXXXXXXXXXXXXXXXGXXXXXXXXXXXXXXXXXXXGXXXXXXXXXXXXXXXXXXXGXXXXXXXXXXXXXXXXXXXGXXXXXXXXXXXXXXXXXXXGXXXXXXXXXXXXXXXXXXXGXXXXXXXXXXXXXXXXXXXGXXXXXXXXXXXXXXXXXXXGXXXXXXXXXXXXXXXXXXXGXXXXXXXXXXXXXXXXXXXGXXXXXXXXXXXXXXXXXXX,0,300,0
38409,13,0,13,52,235,0,0,248,188,60,GXXXXXXXXXXXXXXXXXXXGXXXXXXXXXXXXXXXXXXXGXXXXXXXXXXXXXXXXXXXGXXXXXXXXXXXXXXXXXXXGXXXXXXXXXXXXXXXXXXXGXXXXXXXXXXXXXXXXXXXGXXXXXXXXXXXXXXXXXXXGXXXXXXXXXXXXXXXXXXXGXXXXXXXXXXXXXXXXXXXGXXXXXXXXXXXXXXXXXXXGXXXXXXXXXXXXXXXXXXXGXXXXXXXXXXXXXXXXXXXGXXXXXXXXXXXXXXXXXXX,0,300,0

38430,13,0,13,49,238,0,0,249,186,63,GXXXXXXXXXXXXXXXXXXXGXXXXXXXXXXXXXXXXXXXGXXXXXXXXXXXXXXXXXXXGXXXXXXXXXXXXXXXXXXXGXXXXXXXXXXXXXXXXXXXGXXXXXXXXXXXXXXXXXXXGXXXXXXXXXXXXXXXXXXXGXXXXXXXXXXXXXXXXXXXGXXXXXXXXXXXXXXXXXXXGXXXXXXXXXXXXXXXXXXXGXXXXXXXXXXXXXXXXXXXGXXXXXXXXXXXXXXXXXXXGXXXXXXXXXXXXXXXXXXX,0,300,0
38451,14,1,13,49,237,0,0,249,183,66,GXXXXXXXXXXXXXXXXXXXGXXXXXXXXXXXXXXXXXXXGXXXXXXXXXXXXXXXXXXXGXXXXXXXXXXXXXXXXXXXGXXXXXXXXXXXXXXXXXXXGXXXXXXXXXXXXXXXXXXXGXXXXXXXXXXXXXXXXXXXGXXXXXXXXXXXXXXXXXXXGXXXXXXXXXXXXXXXXXXXGXXXXXXXXXXXXXXXXXXXGXXXXXXXXXXXXXXXXXXXGAXXXXXXXXXXXXXXXXXXGXXXXXXXXXXXXXXXXXXX,0,300,0
38472,14,1,13,49,237,0,0,249,180,69,GXXXXXXXXXXXXXXXXXXXGXXXXXXXXXXXXXXXXXXXGXXXXXXXXXXXXXXXXXXXGXXXXXXXXXXXXXXXXXXXGXXXXXXXXXXXXXXXXXXXGXXXXXXXXXXXXXXXXXXXGXXXXXXXXXXXXXXXXXXXGXXXXXXXXXXXXXXXXXXXGXXXXXXXXXXXXXXXXXXXGXXXXXXXXXXXXXXXXXXXGXXXXXXXXXXXXXXXXXXXGAXXXXXXXXXXXXXXXXXXGXXXXXXXXXXXXXXXXXXX,0,300,0
38493,14,1,13,44,242,0,0,253,182,71,GXXXXXXXXXXXXXXXXXXXGXXXXXXXXXXXXXXXXXXXGXXXXXXXXXXXXXXXXXXXGXXXXXXXXXXXXXXXXXXXGXXXXXXXXXXXXXXXXXXXGXXXXXXXXXXXXXXXXXXXGXXXXXXXXXXXXXXXXXXXGXXXXXXXXXXXXXXXXXXXGXXXXXXXXXXXXXXXXXXXGXXXXXXXXXXXXXXXXXXXGXXXXXXXXXXXXXXXXXXXGAXXXXXXXXXXXXXXXXXXGXXXXXXXXXXXXXXXXXXX,0,300,0
38514,14,1,13,42,244,0,0,256,184,72,GXXXXXXXXXXXXXXXXXXXGXXXXXXXXXXXXXXXXXXXGXXXXXXXXXXXXXXXXXXXGXXXXXXXXXXXXXXXXXXXGXXXXXXXXXXXXXXXXXXXGXXXXXXXXXXXXXXXXXXXGXXXXXXXXXXXXXXXXXXXGXXXXXXXXXXXXXXXXXXXGXXXXXXXXXXXXXXXXXXXGXXXXXXXXXXXXXXXXXXXGXXXXXXXXXXXXXXXXXXXGAXXXXXXXXXXXXXXXXXXGXXXXXXXXXXXXXXXXXXX,0,300,0

38535,14,1,13,37,249,0,0,261,185,76,GXXXXXXXXXXXXXXXXXXXGXXXXXXXXXXXXXXXXXXXGXXXXXXXXXXXXXXXXXXXGXXXXXXXXXXXXXXXXXXXGXXXXXXXXXXXXXXXXXXXGXXXXXXXXXXXXXXXXXXXGXXXXXXXXXXXXXXXXXXXGXXXXXXXXXXXXXXXXXXXGXXXXXXXXXXXXXXXXXXXGXXXXXXXXXXXXXXXXXXXGXXXXXXXXXXXXXXXXXXXGAXXXXXXXXXXXXXXXXXXGXXXXXXXXXXXXXXXXXXX,0,300,0
38556,14,1,13,38,248,0,0,259,187,72,GXXXXXXXXXXXXXXXXXXXGXXXXXXXXXXXXXXXXXXXGXXXXXXXXXXXXXXXXXXXGXXXXXXXXXXXXXXXXXXXGXXXXXXXXXXXXXXXXXXXGXXXXXXXXXXXXXXXXXXXGXXXXXXXXXXXXXXXXXXXGXXXXXXXXXXXXXXXXXXXGXXXXXXXXXXXXXXXXXXXGXXXXXXXXXXXXXXXXXXXGXXXXXXXXXXXXXXXXXXXGAXXXXXXXXXXXXXXXXXXGXXXXXXXXXXXXXXXXXXX,0,300,0
38577,14,1,13,35,251,0,0,263,188,75,GXXXXXXXXXXXXXXXXXXXGXXXXXXXXXXXXXXXXXXXGXXXXXXXXXXXXXXXXXXXGXXXXXXXXXXXXXXXXXXXGXXXXXXXXXXXXXXXXXXXGXXXXXXXXXXXXXXXXXXXGXXXXXXXXXXXXXXXXXXXGXXXXXXXXXXXXXXXXXXXGXXXXXXXXXXXXXXXXXXXGXXXXXXXXXXXXXXXXXXXGXXXXXXXXXXXXXXXXXXXGAXXXXXXXXXXXXXXXXXXGXXXXXXXXXXXXXXXXXXX,0,300,0
38598,14,0,14,31,255,0,0,267,187,80,GXXXXXXXXXXXXXXXXXXXGXXXXXXXXXXXXXXXXXXXGXXXXXXXXXXXXXXXXXXXGXXXXXXXXXXXXXXXXXXXGXXXXXXXXXXXXXXXXXXXGXXXXXXXXXXXXXXXXXXXGXXXXXXXXXXXXXXXXXXXGXXXXXXXXXXXXXXXXXXXGXXXXXXXXXXXXXXXXXXXGXXXXXXXXXXXXXXXXXXXGXXXXXXXXXXXXXXXXXXXGOXXXXXXXXXXXXXXXXXXGXXXXXXXXXXXXXXXXXXX,0,300,0
38619,13,0,13,35,252,0,0,264,187,77,GXXXXXXXXXXXXXXXXXXXGXXXXXXXXXXXXXXXXXXXGXXXXXXXXXXXXXXXXXXXGXXXXXXXXXXXXXXXXXXXGXXXXXXXXXXXXXXXXXXXGXXXXXXXXXXXXXXXXXXXGXXXXXXXXXXXXXXXXXXXGXXXXXXXXXXXXXXXXXXXGXXXXXXXXXXXXXXXXXXXGXXXXXXXXXXXXXXXXXXXGXXXXXXXXXXXXXXXXXXXGXXXXXXXXXXXXXXXXXXXGXXXXXXXXXXXXXXXXXXX,0,300,0

38640,13,0,13,39,248,0,0,260,190,70,GXXXXXXXXXXXXXXXXXXXGXXXXXXXXXXXXXXXXXXXGXXXXXXXXXXXXXXXXXXXGXXXXXXXXXXXXXXXXXXXGXXXXXXXXXXXXXXXXXXXGXXXXXXXXXXXXXXXXXXXGXXXXXXXXXXXXXXXXXXXGXXXXXXXXXXXXXXXXXXXGXXXXXXXXXXXXXXXXXXXGXXXXXXXXXXXXXXXXXXXGXXXXXXXXXXXXXXXXXXXGXXXXXXXXXXXXXXXXXXXGXXXXXXXXXXXXXXXXXXX,0,300,0
38661,13,0,13,43,244,0,0,254,188,66,GXXXXXXXXXXXXXXXXXXXGXXXXXXXXXXXXXXXXXXXGXXXXXXXXXXXXXXXXXXXGXXXXXXXXXXXXXXXXXXXGXXXXXXXXXXXXXXXXXXXGXXXXXXXXXXXXXXXXXXXGXXXXXXXXXXXXXXXXXXXGXXXXXXXXXXXXXXXXXXXGXXXXXXXXXXXXXXXXXXXGXXXXXXXXXXXXXXXXXXXGXXXXXXXXXXXXXXXXXXXGXXXXXXXXXXXXXXXXXXXGXXXXXXXXXXXXXXXXXXX,0,300,0
38682,13,0,13,41,246,0,0,257,192,65,GXXXXXXXXXXXXXXXXXXXGXXXXXXXXXXXXXXXXXXXGXXXXXXXXXXXXXXXXXXXGXXXXXXXXXXXXXXXXXXXGXXXXXXXXXXXXXXXXXXXGXXXXXXXXXXXXXXXXXXXGXXXXXXXXXXXXXXXXXXXGXXXXXXXXXXXXXXXXXXXGXXXXXXXXXXXXXXXXXXXGXXXXXXXXXXXXXXXXXXXGXXXXXXXXXXXXXXXXXXXGXXXXXXXXXXXXXXXXXXXGXXXXXXXXXXXXXXXXXXX,0,300,0
38703,13,0,13,42,245,0,0,257,189,68,GXXXXXXXXXXXXXXXXXXXGXXXXXXXXXXXXXXXXXXXGXXXXXXXXXXXXXXXXXXXGXXXXXXXXXXXXXXXXXXXGXXXXXXXXXXXXXXXXXXXGXXXXXXXXXXXXXXXXXXXGXXXXXXXXXXXXXXXXXXXGXXXXXXXXXXXXXXXXXXXGXXXXXXXXXXXXXXXXXXXGXXXXXXXXXXXXXXXXXXXGXXXXXXXXXXXXXXXXXXXGXXXXXXXXXXXXXXXXXXXGXXXXXXXXXXXXXXXXXXX,0,300,0
38724,13,0,13,42,245,0,0,257,188,69,GXXXXXXXXXXXXXXXXXXXGXXXXXXXXXXXXXXXXXXXGXXXXXXXXXXXXXXXXXXXGXXXXXXXXXXXXXXXXXXXGXXXXXXXXXXXXXXXXXXXGXXXXXXXXXXXXXXXXXXXGXXXXXXXXXXXXXXXXXXXGXXXXXXXXXXXXXXXXXXXGXXXXXXXXXXXXXXXXXXXGXXXXXXXXXXXXXXXXXXXGXXXXXXXXXXXXXXXXXXXGXXXXXXXXXXXXXXXXXXXGXXXXXXXXXXXXXXXXXXX,0,300,0

38745,13,0,13,41,246,0,0,256,184,72,GXXXXXXXXXXXXXXXXXXXGXXXXXXXXXXXXXXXXXXXGXXXXXXXXXXXXXXXXXXXGXXXXXXXXXXXXXXXXXXXGXXXXXXXXXXXXXXXXXXXGXXXXXXXXXXXXXXXXXXXGXXXXXXXXXXXXXXXXXXXGXXXXXXXXXXXXXXXXXXXGXXXXXXXXXXXXXXXXXXXGXXXXXXXXXXXXXXXXXXXGXXXXXXXXXXXXXXXXXXXGXXXXXXXXXXXXXXXXXXXGXXXXXXXXXXXXXXXXXXX,0,300,0
38766,14,1,13,39,247,0,0,259,187,72,GXXXXXXXXXXXXXXXXXXXGAXXXXXXXXXXXXXXXXXXGXXXXXXXXXXXXXXXXXXXGXXXXXXXXXXXXXXXXXXXGXXXXXXXXXXXXXXXXXXXGXXXXXXXXXXXXXXXXXXXGXXXXXXXXXXXXXXXXXXXGXXXXXXXXXXXXXXXXXXXGXXXXXXXXXXXXXXXXXXXGXXXXXXXXXXXXXXXXXXXGXXXXXXXXXXXXXXXXXXXGXXXXXXXXXXXXXXXXXXXGXXXXXXXXXXXXXXXXXXX,0,300,0
38787,14,1,13,40,246,0,0,258,185,73,GXXXXXXXXXXXXXXXXXXXGAXXXXXXXXXXXXXXXXXXGXXXXXXXXXXXXXXXXXXXGXXXXXXXXXXXXXXXXXXXGXXXXXXXXXXXXXXXXXXXGXXXXXXXXXXXXXXXXXXXGXXXXXXXXXXXXXXXXXXXGXXXXXXXXXXXXXXXXXXXGXXXXXXXXXXXXXXXXXXXGXXXXXXXXXXXXXXXXXXXGXXXXXXXXXXXXXXXXXXXGXXXXXXXXXXXXXXXXXXXGXXXXXXXXXXXXXXXXXXX,0,300,0
38808,14,1,13,37,249,0,0,260,184,76,GXXXXXXXXXXXXXXXXXXXGAXXXXXXXXXXXXXXXXXXGXXXXXXXXXXXXXXXXXXXGXXXXXXXXXXXXXXXXXXXGXXXXXXXXXXXXXXXXXXXGXXXXXXXXXXXXXXXXXXXGXXXXXXXXXXXXXXXXXXXGXXXXXXXXXXXXXXXXXXXGXXXXXXXXXXXXXXXXXXXGXXXXXXXXXXXXXXXXXXXGXXXXXXXXXXXXXXXXXXXGXXXXXXXXXXXXXXXXXXXGXXXXXXXXXXXXXXXXXXX,0,300,0
38829,14,1,13,37,249,0,0,262,188,74,GXXXXXXXXXXXXXXXXXXXGAXXXXXXXXXXXXXXXXXXGXXXXXXXXXXXXXXXXXXXGXXXXXXXXXXXXXXXXXXXGXXXXXXXXXXXXXXXXXXXGXXXXXXXXXXXXXXXXXXXGXXXXXXXXXXXXXXXXXXXGXXXXXXXXXXXXXXXXXXXGXXXXXXXXXXXXXXXXXXXGXXXXXXXXXXXXXXXXXXXGXXXXXXXXXXXXXXXXXXXGXXXXXXXXXXXXXXXXXXXGXXXXXXXXXXXXXXXXXXX,0,300,0

38850,14,1,13,36,250,0,0,263,187,76,GXXXXXXXXXXXXXXXXXXXGAXXXXXXXXXXXXXXXXXXGXXXXXXXXXXXXXXXXXXXGXXXXXXXXXXXXXXXXXXXGXXXXXXXXXXXXXXXXXXXGXXXXXXXXXXXXXXXXXXXGXXXXXXXXXXXXXXXXXXXGXXXXXXXXXXXXXXXXXXXGXXXXXXXXXXXXXXXXXXXGXXXXXXXXXXXXXXXXXXXGXXXXXXXXXXXXXXXXXXXGXXXXXXXXXXXXXXXXXXXGXXXXXXXXXXXXXXXXXXX,0,300,0
38871,14,1,13,37,249,0,0,262,190,72,GXXXXXXXXXXXXXXXXXXXGAXXXXXXXXXXXXXXXXXXGXXXXXXXXXXXXXXXXXXXGXXXXXXXXXXXXXXXXXXXGXXXXXXXXXXXXXXXXXXXGXXXXXXXXXXXXXXXXXXXGXXXXXXXXXXXXXXXXXXXGXXXXXXXXXXXXXXXXXXXGXXXXXXXXXXXXXXXXXXXGXXXXXXXXXXXXXXXXXXXGXXXXXXXXXXXXXXXXXXXGXXXXXXXXXXXXXXXXXXXGXXXXXXXXXXXXXXXXXXX,0,300,0
38892,14,1,13,38,248,0,0,261,189,72,GXXXXXXXXXXXXXXXXXXXGAXXXXXXXXXXXXXXXXXXGXXXXXXXXXXXXXXXXXXXGXXXXXXXXXXXXXXXXXXXGXXXXXXXXXXXXXXXXXXXGXXXXXXXXXXXXXXXXXXXGXXXXXXXXXXXXXXXXXXXGXXXXXXXXXXXXXXXXXXXGXXXXXXXXXXXXXXXXXXXGXXXXXXXXXXXXXXXXXXXGXXXXXXXXXXXXXXXXXXXGXXXXXXXXXXXXXXXXXXXGXXXXXXXXXXXXXXXXXXX,0,300,0
38913,14,1,13,41,245,0,0,259,188,71,GXXXXXXXXXXXXXXXXXXXGAXXXXXXXXXXXXXXXXXXGXXXXXXXXXXXXXXXXXXXGXXXXXXXXXXXXXXXXXXXGXXXXXXXXXXXXXXXXXXXGXXXXXXXXXXXXXXXXXXXGXXXXXXXXXXXXXXXXXXXGXXXXXXXXXXXXXXXXXXXGXXXXXXXXXXXXXXXXXXXGXXXXXXXXXXXXXXXXXXXGXXXXXXXXXXXXXXXXXXXGXXXXXXXXXXXXXXXXXXXGXXXXXXXXXXXXXXXXXXX,0,300,0
38934,14,0,14,39,247,0,0,260,191,69,GXXXXXXXXXXXXXXXXXXXGOXXXXXXXXXXXXXXXXXXGXXXXXXXXXXXXXXXXXXXGXXXXXXXXXXXXXXXXXXXGXXXXXXXXXXXXXXXXXXXGXXXXXXXXXXXXXXXXXXXGXXXXXXXXXXXXXXXXXXXGXXXXXXXXXXXXXXXXXXXGXXXXXXXXXXXXXXXXXXXGXXXXXXXXXXXXXXXXXXXGXXXXXXXXXXXXXXXXXXXGXXXXXXXXXXXXXXXXXXXGXXXXXXXXXXXXXXXXXXX,0,300,0

38955,13,0,13,42,245,0,0,256,187,69,GXXXXXXXXXXXXXXXXXXXGXXXXXXXXXXXXXXXXXXXGXXXXXXXXXXXXXXXXXXXGXXXXXXXXXXXXXXXXXXXGXXXXXXXXXXXXXXXXXXXGXXXXXXXXXXXXXXXXXXXGXXXXXXXXXXXXXXXXXXXGXXXXXXXXXXXXXXXXXXXGXXXXXXXXXXXXXXXXXXXGXXXXXXXXXXXXXXXXXXXGXXXXXXXXXXXXXXXXXXXGXXXXXXXXXXXXXXXXXXXGXXXXXXXXXXXXXXXXXXX,0,300,0
38976,13,0,13,40,247,0,0,259,190,69,GXXXXXXXXXXXXXXXXXXXGXXXXXXXXXXXXXXXXXXXGXXXXXXXXXXXXXXXXXXXGXXXXXXXXXXXXXXXXXXXGXXXXXXXXXXXXXXXXXXXGXXXXXXXXXXXXXXXXXXXGXXXXXXXXXXXXXXXXXXXGXXXXXXXXXXXXXXXXXXXGXXXXXXXXXXXXXXXXXXXGXXXXXXXXXXXXXXXXXXXGXXXXXXXXXXXXXXXXXXXGXXXXXXXXXXXXXXXXXXXGXXXXXXXXXXXXXXXXXXX,0,300,0
38997,13,0,13,42,245,0,0,257,188,69,GXXXXXXXXXXXXXXXXXXXGXXXXXXXXXXXXXXXXXXXGXXXXXXXXXXXXXXXXXXXGXXXXXXXXXXXXXXXXXXXGXXXXXXXXXXXXXXXXXXXGXXXXXXXXXXXXXXXXXXXGXXXXXXXXXXXXXXXXXXXGXXXXXXXXXXXXXXXXXXXGXXXXXXXXXXXXXXXXXXXGXXXXXXXXXXXXXXXXXXXGXXXXXXXXXXXXXXXXXXXGXXXXXXXXXXXXXXXXXXXGXXXXXXXXXXXXXXXXXXX,0,300,0
39018,13,0,13,41,246,0,0,258,189,69,GXXXXXXXXXXXXXXXXXXXGXXXXXXXXXXXXXXXXXXXGXXXXXXXXXXXXXXXXXXXGXXXXXXXXXXXXXXXXXXXGXXXXXXXXXXXXXXXXXXXGXXXXXXXXXXXXXXXXXXXGXXXXXXXXXXXXXXXXXXXGXXXXXXXXXXXXXXXXXXXGXXXXXXXXXXXXXXXXXXXGXXXXXXXXXXXXXXXXXXXGXXXXXXXXXXXXXXXXXXXGXXXXXXXXXXXXXXXXXXXGXXXXXXXXXXXXXXXXXXX,0,300,0
39039,13,0,13,43,244,0,0,256,191,65,GXXXXXXXXXXXXXXXXXXXGXXXXXXXXXXXXXXXXXXXGXXXXXXXXXXXXXXXXXXXGXXXXXXXXXXXXXXXXXXXGXXXXXXXXXXXXXXXXXXXGXXXXXXXXXXXXXXXXXXXGXXXXXXXXXXXXXXXXXXXGXXXXXXXXXXXXXXXXXXXGXXXXXXXXXXXXXXXXXXXGXXXXXXXXXXXXXXXXXXXGXXXXXXXXXXXXXXXXXXXGXXXXXXXXXXXXXXXXXXXGXXXXXXXXXXXXXXXXXXX,0,300,0

39060,13,0,13,45,242,0,0,254,188,66,GXXXXXXXXXXXXXXXXXXXGXXXXXXXXXXXXXXXXXXXGXXXXXXXXXXXXXXXXXXXGXXXXXXXXXXXXXXXXXXXGXXXXXXXXXXXXXXXXXXXGXXXXXXXXXXXXXXXXXXXGXXXXXXXXXXXXXXXXXXXGXXXXXXXXXXXXXXXXXXXGXXXXXXXXXXXXXXXXXXXGXXXXXXXXXXXXXXXXXXXGXXXXXXXXXXXXXXXXXXXGXXXXXXXXXXXXXXXXXXXGXXXXXXXXXXXXXXXXXXX,0,300,0
39081,13,0,13,40,247,0,0,259,189,70,GXXXXXXXXXXXXXXXXXXXGXXXXXXXXXXXXXXXXXXXGXXXXXXXXXXXXXXXXXXXGXXXXXXXXXXXXXXXXXXXGXXXXXXXXXXXXXXXXXXXGXXXXXXXXXXXXXXXXXXXGXXXXXXXXXXXXXXXXXXXGXXXXXXXXXXXXXXXXXXXGXXXXXXXXXXXXXXXXXXXGXXXXXXXXXXXXXXXXXXXGXXXXXXXXXXXXXXXXXXXGXXXXXXXXXXXXXXXXXXXGXXXXXXXXXXXXXXXXXXX,0,300,0
39102,13,0,13,47,240,0,0,252,188,64,GXXXXXXXXXXXXXXXXXXXGXXXXXXXXXXXXXXXXXXXGXXXXXXXXXXXXXXXXXXXGXXXXXXXXXXXXXXXXXXXGXXXXXXXXXXXXXXXXXXXGXXXXXXXXXXXXXXXXXXXGXXXXXXXXXXXXXXXXXXXGXXXXXXXXXXXXXXXXXXXGXXXXXXXXXXXXXXXXXXXGXXXXXXXXXXXXXXXXXXXGXXXXXXXXXXXXXXXXXXXGXXXXXXXXXXXXXXXXXXXGXXXXXXXXXXXXXXXXXXX,0,300,0
39123,13,0,13,47,240,0,0,252,189,63,GXXXXXXXXXXXXXXXXXXXGXXXXXXXXXXXXXXXXXXXGXXXXXXXXXXXXXXXXXXXGXXXXXXXXXXXXXXXXXXXGXXXXXXXXXXXXXXXXXXXGXXXXXXXXXXXXXXXXXXXGXXXXXXXXXXXXXXXXXXXGXXXXXXXXXXXXXXXXXXXGXXXXXXXXXXXXXXXXXXXGXXXXXXXXXXXXXXXXXXXGXXXXXXXXXXXXXXXXXXXGXXXXXXXXXXXXXXXXXXXGXXXXXXXXXXXXXXXXXXX,0,300,0
39144,13,0,13,48,239,0,0,250,188,62,GXXXXXXXXXXXXXXXXXXXGXXXXXXXXXXXXXXXXXXXGXXXXXXXXXXXXXXXXXXXGXXXXXXXXXXXXXXXXXXXGXXXXXXXXXXXXXXXXXXXGXXXXXXXXXXXXXXXXXXXGXXXXXXXXXXXXXXXXXXXGXXXXXXXXXXXXXXXXXXXGXXXXXXXXXXXXXXXXXXXGXXXXXXXXXXXXXXXXXXXGXXXXXXXXXXXXXXXXXXXGXXXXXXXXXXXXXXXXXXXGXXXXXXXXXXXXXXXXXXX,0,300,0

39165,13,0,13,44,243,0,0,255,186,69,GXXXXXXXXXXXXXXXXXXXGXXXXXXXXXXXXXXXXXXXGXXXXXXXXXXXXXXXXXXXGXXXXXXXXXXXXXXXXXXXGXXXXXXXXXXXXXXXXXXXGXXXXXXXXXXXXXXXXXXXGXXXXXXXXXXXXXXXXXXXGXXXXXXXXXXXXXXXXXXXGXXXXXXXXXXXXXXXXXXXGXXXXXXXXXXXXXXXXXXXGXXXXXXXXXXXXXXXXXXXGXXXXXXXXXXXXXXXXXXXGXXXXXXXXXXXXXXXXXXX,0,300,0
39186,13,0,13,40,247,0,0,259,189,70,GXXXXXXXXXXXXXXXXXXXGXXXXXXXXXXXXXXXXXXXGXXXXXXXXXXXXXXXXXXXGXXXXXXXXXXXXXXXXXXXGXXXXXXXXXXXXXXXXXXXGXXXXXXXXXXXXXXXXXXXGXXXXXXXXXXXXXXXXXXXGXXXXXXXXXXXXXXXXXXXGXXXXXXXXXXXXXXXXXXXGXXXXXXXXXXXXXXXXXXXGXXXXXXXXXXXXXXXXXXXGXXXXXXXXXXXXXXXXXXXGXXXXXXXXXXXXXXXXXXX,0,300,0
39207,13,0,13,39,248,0,0,260,193,67,GXXXXXXXXXXXXXXXXXXXGXXXXXXXXXXXXXXXXXXXGXXXXXXXXXXXXXXXXXXXGXXXXXXXXXXXXXXXXXXXGXXXXXXXXXXXXXXXXXXXGXXXXXXXXXXXXXXXXXXXGXXXXXXXXXXXXXXXXXXXGXXXXXXXXXXXXXXXXXXXGXXXXXXXXXXXXXXXXXXXGXXXXXXXXXXXXXXXXXXXGXXXXXXXXXXXXXXXXXXXGXXXXXXXXXXXXXXXXXXXGXXXXXXXXXXXXXXXXXXX,0,300,0
39228,13,0,13,38,249,0,0,260,189,71,GXXXXXXXXXXXXXXXXXXXGXXXXXXXXXXXXXXXXXXXGXXXXXXXXXXXXXXXXXXXGXXXXXXXXXXXXXXXXXXXGXXXXXXXXXXXXXXXXXXXGXXXXXXXXXXXXXXXXXXXGXXXXXXXXXXXXXXXXXXXGXXXXXXXXXXXXXXXXXXXGXXXXXXXXXXXXXXXXXXXGXXXXXXXXXXXXXXXXXXXGXXXXXXXXXXXXXXXXXXXGXXXXXXXXXXXXXXXXXXXGXXXXXXXXXXXXXXXXXXX,0,300,0
39249,13,0,13,36,251,0,0,263,189,74,GXXXXXXXXXXXXXXXXXXXGXXXXXXXXXXXXXXXXXXXGXXXXXXXXXXXXXXXXXXXGXXXXXXXXXXXXXXXXXXXGXXXXXXXXXXXXXXXXXXXGXXXXXXXXXXXXXXXXXXXGXXXXXXXXXXXXXXXXXXXGXXXXXXXXXXXXXXXXXXXGXXXXXXXXXXXXXXXXXXXGXXXXXXXXXXXXXXXXXXXGXXXXXXXXXXXXXXXXXXXGXXXXXXXXXXXXXXXXXXXGXXXXXXXXXXXXXXXXXXX,0,300,0

39270,13,0,13,34,253,0,0,265,186,79,GXXXXXXXXXXXXXXXXXXXGXXXXXXXXXXXXXXXXXXXGXXXXXXXXXXXXXXXXXXXGXXXXXXXXXXXXXXXXXXXGXXXXXXXXXXXXXXXXXXXGXXXXXXXXXXXXXXXXXXXGXXXXXXXXXXXXXXXXXXXGXXXXXXXXXXXXXXXXXXXGXXXXXXXXXXXXXXXXXXXGXXXXXXXXXXXXXXXXXXXGXXXXXXXXXXXXXXXXXXXGXXXXXXXXXXXXXXXXXXXGXXXXXXXXXXXXXXXXXXX,0,300,0
39291,13,0,13,33,254,0,0,266,187,79,GXXXXXXXXXXXXXXXXXXXGXXXXXXXXXXXXXXXXXXXGXXXXXXXXXXXXXXXXXXXGXXXXXXXXXXXXXXXXXXXGXXXXXXXXXXXXXXXXXXXGXXXXXXXXXXXXXXXXXXXGXXXXXXXXXXXXXXXXXXXGXXXXXXXXXXXXXXXXXXXGXXXXXXXXXXXXXXXXXXXGXXXXXXXXXXXXXXXXXXXGXXXXXXXXXXXXXXXXXXXGXXXXXXXXXXXXXXXXXXXGXXXXXXXXXXXXXXXXXXX,0,300,0
39312,13,0,13,29,258,0,0,269,188,81,GXXXXXXXXXXXXXXXXXXXGXXXXXXXXXXXXXXXXXXXGXXXXXXXXXXXXXXXXXXXGXXXXXXXXXXXXXXXXXXXGXXXXXXXXXXXXXXXXXXXGXXXXXXXXXXXXXXXXXXXGXXXXXXXXXXXXXXXXXXXGXXXXXXXXXXXXXXXXXXXGXXXXXXXXXXXXXXXXXXXGXXXXXXXXXXXXXXXXXXXGXXXXXXXXXXXXXXXXXXXGXXXXXXXXXXXXXXXXXXXGXXXXXXXXXXXXXXXXXXX,0,300,0
39333,13,0,13,28,259,0,0,271,192,79,GXXXXXXXXXXXXXXXXXXXGXXXXXXXXXXXXXXXXXXXGXXXXXXXXXXXXXXXXXXXGXXXXXXXXXXXXXXXXXXXGXXXXXXXXXXXXXXXXXXXGXXXXXXXXXXXXXXXXXXXGXXXXXXXXXXXXXXXXXXXGXXXXXXXXXXXXXXXXXXXGXXXXXXXXXXXXXXXXXXXGXXXXXXXXXXXXXXXXXXXGXXXXXXXXXXXXXXXXXXXGXXXXXXXXXXXXXXXXXXXGXXXXXXXXXXXXXXXXXXX,0,300,0
39354,13,0,13,22,265,0,0,277,197,80,GXXXXXXXXXXXXXXXXXXXGXXXXXXXXXXXXXXXXXXXGXXXXXXXXXXXXXXXXXXXGXXXXXXXXXXXXXXXXXXXGXXXXXXXXXXXXXXXXXXXGXXXXXXXXXXXXXXXXXXXGXXXXXXXXXXXXXXXXXXXGXXXXXXXXXXXXXXXXXXXGXXXXXXXXXXXXXXXXXXXGXXXXXXXXXXXXXXXXXXXGXXXXXXXXXXXXXXXXXXXGXXXXXXXXXXXXXXXXXXXGXXXXXXXXXXXXXXXXXXX,0,300,0

39375,13,0,13,25,262,0,0,274,196,78,GXXXXXXXXXXXXXXXXXXXGXXXXXXXXXXXXXXXXXXXGXXXXXXXXXXXXXXXXXXXGXXXXXXXXXXXXXXXXXXXGXXXXXXXXXXXXXXXXXXXGXXXXXXXXXXXXXXXXXXXGXXXXXXXXXXXXXXXXXXXGXXXXXXXXXXXXXXXXXXXGXXXXXXXXXXXXXXXXXXXGXXXXXXXXXXXXXXXXXXXGXXXXXXXXXXXXXXXXXXXGXXXXXXXXXXXXXXXXXXXGXXXXXXXXXXXXXXXXXXX,0,300,0
39396,13,0,13,27,260,0,0,272,195,77,GXXXXXXXXXXXXXXXXXXXGXXXXXXXXXXXXXXXXXXXGXXXXXXXXXXXXXXXXXXXGXXXXXXXXXXXXXXXXXXXGXXXXXXXXXXXXXXXXXXXGXXXXXXXXXXXXXXXXXXXGXXXXXXXXXXXXXXXXXXXGXXXXXXXXXXXXXXXXXXXGXXXXXXXXXXXXXXXXXXXGXXXXXXXXXXXXXXXXXXXGXXXXXXXXXXXXXXXXXXXGXXXXXXXXXXXXXXXXXXXGXXXXXXXXXXXXXXXXXXX,0,300,0
39417,13,0,13,30,257,0,0,270,196,74,GXXXXXXXXXXXXXXXXXXXGXXXXXXXXXXXXXXXXXXXGXXXXXXXXXXXXXXXXXXXGXXXXXXXXXXXXXXXXXXXGXXXXXXXXXXXXXXXXXXXGXXXXXXXXXXXXXXXXXXXGXXXXXXXXXXXXXXXXXXXGXXXXXXXXXXXXXXXXXXXGXXXXXXXXXXXXXXXXXXXGXXXXXXXXXXXXXXXXXXXGXXXXXXXXXXXXXXXXXXXGXXXXXXXXXXXXXXXXXXXGXXXXXXXXXXXXXXXXXXX,0,300,0
39438,13,0,13,29,258,0,0,270,193,77,GXXXXXXXXXXXXXXXXXXXGXXXXXXXXXXXXXXXXXXXGXXXXXXXXXXXXXXXXXXXGXXXXXXXXXXXXXXXXXXXGXXXXXXXXXXXXXXXXXXXGXXXXXXXXXXXXXXXXXXXGXXXXXXXXXXXXXXXXXXXGXXXXXXXXXXXXXXXXXXXGXXXXXXXXXXXXXXXXXXXGXXXXXXXXXXXXXXXXXXXGXXXXXXXXXXXXXXXXXXXGXXXXXXXXXXXXXXXXXXXGXXXXXXXXXXXXXXXXXXX,0,300,0
39459,13,0,13,31,256,0,0,267,189,78,GXXXXXXXXXXXXXXXXXXXGXXXXXXXXXXXXXXXXXXXGXXXXXXXXXXXXXXXXXXXGXXXXXXXXXXXXXXXXXXXGXXXXXXXXXXXXXXXXXXXGXXXXXXXXXXXXXXXXXXXGXXXXXXXXXXXXXXXXXXXGXXXXXXXXXXXXXXXXXXXGXXXXXXXXXXXXXXXXXXXGXXXXXXXXXXXXXXXXXXXGXXXXXXXXXXXXXXXXXXXGXXXXXXXXXXXXXXXXXXXGXXXXXXXXXXXXXXXXXXX,0,300,0

39480,13,0,13,34,253,0,0,265,189,76,GXXXXXXXXXXXXXXXXXXXGXXXXXXXXXXXXXXXXXXXGXXXXXXXXXXXXXXXXXXXGXXXXXXXXXXXXXXXXXXXGXXXXXXXXXXXXXXXXXXXGXXXXXXXXXXXXXXXXXXXGXXXXXXXXXXXXXXXXXXXGXXXXXXXXXXXXXXXXXXXGXXXXXXXXXXXXXXXXXXXGXXXXXXXXXXXXXXXXXXXGXXXXXXXXXXXXXXXXXXXGXXXXXXXXXXXXXXXXXXXGXXXXXXXXXXXXXXXXXXX,0,300,0
39501,13,0,13,35,252,0,0,264,189,75,GXXXXXXXXXXXXXXXXXXXGXXXXXXXXXXXXXXXXXXXGXXXXXXXXXXXXXXXXXXXGXXXXXXXXXXXXXXXXXXXGXXXXXXXXXXXXXXXXXXXGXXXXXXXXXXXXXXXXXXXGXXXXXXXXXXXXXXXXXXXGXXXXXXXXXXXXXXXXXXXGXXXXXXXXXXXXXXXXXXXGXXXXXXXXXXXXXXXXXXXGXXXXXXXXXXXXXXXXXXXGXXXXXXXXXXXXXXXXXXXGXXXXXXXXXXXXXXXXXXX,0,300,0
39522,13,0,13,38,249,0,0,261,188,73,GXXXXXXXXXXXXXXXXXXXGXXXXXXXXXXXXXXXXXXXGXXXXXXXXXXXXXXXXXXXGXXXXXXXXXXXXXXXXXXXGXXXXXXXXXXXXXXXXXXXGXXXXXXXXXXXXXXXXXXXGXXXXXXXXXXXXXXXXXXXGXXXXXXXXXXXXXXXXXXXGXXXXXXXXXXXXXXXXXXXGXXXXXXXXXXXXXXXXXXXGXXXXXXXXXXXXXXXXXXXGXXXXXXXXXXXXXXXXXXXGXXXXXXXXXXXXXXXXXXX,0,300,0
39543,13,0,13,39,248,0,0,260,187,73,GXXXXXXXXXXXXXXXXXXXGXXXXXXXXXXXXXXXXXXXGXXXXXXXXXXXXXXXXXXXGXXXXXXXXXXXXXXXXXXXGXXXXXXXXXXXXXXXXXXXGXXXXXXXXXXXXXXXXXXXGXXXXXXXXXXXXXXXXXXXGXXXXXXXXXXXXXXXXXXXGXXXXXXXXXXXXXXXXXXXGXXXXXXXXXXXXXXXXXXXGXXXXXXXXXXXXXXXXXXXGXXXXXXXXXXXXXXXXXXXGXXXXXXXXXXXXXXXXXXX,0,300,0
39564,13,0,13,35,252,0,0,264,191,73,GXXXXXXXXXXXXXXXXXXXGXXXXXXXXXXXXXXXXXXXGXXXXXXXXXXXXXXXXXXXGXXXXXXXXXXXXXXXXXXXGXXXXXXXXXXXXXXXXXXXGXXXXXXXXXXXXXXXXXXXGXXXXXXXXXXXXXXXXXXXGXXXXXXXXXXXXXXXXXXXGXXXXXXXXXXXXXXXXXXXGXXXXXXXXXXXXXXXXXXXGXXXXXXXXXXXXXXXXXXXGXXXXXXXXXXXXXXXXXXXGXXXXXXXXXXXXXXXXXXX,0,300,0

39585,13,0,13,38,249,0,0,261,191,70,GXXXXXXXXXXXXXXXXXXXGXXXXXXXXXXXXXXXXXXXGXXXXXXXXXXXXXXXXXXXGXXXXXXXXXXXXXXXXXXXGXXXXXXXXXXXXXXXXXXXGXXXXXXXXXXXXXXXXXXXGXXXXXXXXXXXXXXXXXXXGXXXXXXXXXXXXXXXXXXXGXXXXXXXXXXXXXXXXXXXGXXXXXXXXXXXXXXXXXXXGXXXXXXXXXXXXXXXXXXXGXXXXXXXXXXXXXXXXXXXGXXXXXXXXXXXXXXXXXXX,0,300,0
39606,13,0,13,42,245,0,0,258,190,68,GXXXXXXXXXXXXXXXXXXXGXXXXXXXXXXXXXXXXXXXGXXXXXXXXXXXXXXXXXXXGXXXXXXXXXXXXXXXXXXXGXXXXXXXXXXXXXXXXXXXGXXXXXXXXXXXXXXXXXXXGXXXXXXXXXXXXXXXXXXXGXXXXXXXXXXXXXXXXXXXGXXXXXXXXXXXXXXXXXXXGXXXXXXXXXXXXXXXXXXXGXXXXXXXXXXXXXXXXXXXGXXXXXXXXXXXXXXXXXXXGXXXXXXXXXXXXXXXXXXX,0,300,0
39627,14,1,13,41,245,0,0,258,192,66,GXXXXXXXXXXXXXXXXXXXGXXXXXXXXXXXXXXXXXXXGXXXXXXXXXXXXXXXXXXXGXXXXXXXXXXXXXXXXXXXGXXXXXXXXXXXXXXXXXXXGXXXXXXXXXXXXXXXXXXXGXXXXXXXXXXXXXXXXXXXGAXXXXXXXXXXXXXXXXXXGXXXXXXXXXXXXXXXXXXXGXXXXXXXXXXXXXXXXXXXGXXXXXXXXXXXXXXXXXXXGXXXXXXXXXXXXXXXXXXXGXXXXXXXXXXXXXXXXXXX,0,300,0
39648,14,1,13,43,243,0,0,256,195,61,GXXXXXXXXXXXXXXXXXXXGXXXXXXXXXXXXXXXXXXXGXXXXXXXXXXXXXXXXXXXGXXXXXXXXXXXXXXXXXXXGXXXXXXXXXXXXXXXXXXXGXXXXXXXXXXXXXXXXXXXGXXXXXXXXXXXXXXXXXXXGAXXXXXXXXXXXXXXXXXXGXXXXXXXXXXXXXXXXXXXGXXXXXXXXXXXXXXXXXXXGXXXXXXXXXXXXXXXXXXXGXXXXXXXXXXXXXXXXXXXGXXXXXXXXXXXXXXXXXXX,0,300,0
39669,14,1,13,45,241,0,0,254,192,62,GXXXXXXXXXXXXXXXXXXXGXXXXXXXXXXXXXXXXXXXGXXXXXXXXXXXXXXXXXXXGXXXXXXXXXXXXXXXXXXXGXXXXXXXXXXXXXXXXXXXGXXXXXXXXXXXXXXXXXXXGXXXXXXXXXXXXXXXXXXXGAXXXXXXXXXXXXXXXXXXGXXXXXXXXXXXXXXXXXXXGXXXXXXXXXXXXXXXXXXXGXXXXXXXXXXXXXXXXXXXGXXXXXXXXXXXXXXXXXXXGXXXXXXXXXXXXXXXXXXX,0,300,0

39690,14,1,13,47,239,0,0,252,190,62,GXXXXXXXXXXXXXXXXXXXGXXXXXXXXXXXXXXXXXXXGXXXXXXXXXXXXXXXXXXXGXXXXXXXXXXXXXXXXXXXGXXXXXXXXXXXXXXXXXXXGXXXXXXXXXXXXXXXXXXXGXXXXXXXXXXXXXXXXXXXGAXXXXXXXXXXXXXXXXXXGXXXXXXXXXXXXXXXXXXXGXXXXXXXXXXXXXXXXXXXGXXXXXXXXXXXXXXXXXXXGXXXXXXXXXXXXXXXXXXXGXXXXXXXXXXXXXXXXXXX,0,300,0
39711,14,1,13,47,239,0,0,252,190,62,GXXXXXXXXXXXXXXXXXXXGXXXXXXXXXXXXXXXXXXXGXXXXXXXXXXXXXXXXXXXGXXXXXXXXXXXXXXXXXXXGXXXXXXXXXXXXXXXXXXXGXXXXXXXXXXXXXXXXXXXGXXXXXXXXXXXXXXXXXXXGAXXXXXXXXXXXXXXXXXXGXXXXXXXXXXXXXXXXXXXGXXXXXXXXXXXXXXXXXXXGXXXXXXXXXXXXXXXXXXXGXXXXXXXXXXXXXXXXXXXGXXXXXXXXXXXXXXXXXXX,0,300,0
39732,14,1,13,45,241,0,0,254,188,66,GXXXXXXXXXXXXXXXXXXXGXXXXXXXXXXXXXXXXXXXGXXXXXXXXXXXXXXXXXXXGXXXXXXXXXXXXXXXXXXXGXXXXXXXXXXXXXXXXXXXGXXXXXXXXXXXXXXXXXXXGXXXXXXXXXXXXXXXXXXXGAXXXXXXXXXXXXXXXXXXGXXXXXXXXXXXXXXXXXXXGXXXXXXXXXXXXXXXXXXXGXXXXXXXXXXXXXXXXXXXGXXXXXXXXXXXXXXXXXXXGXXXXXXXXXXXXXXXXXXX,0,300,0
39753,14,1,13,46,240,0,0,252,190,62,GXXXXXXXXXXXXXXXXXXXGXXXXXXXXXXXXXXXXXXXGXXXXXXXXXXXXXXXXXXXGXXXXXXXXXXXXXXXXXXXGXXXXXXXXXXXXXXXXXXXGXXXXXXXXXXXXXXXXXXXGXXXXXXXXXXXXXXXXXXXGAXXXXXXXXXXXXXXXXXXGXXXXXXXXXXXXXXXXXXXGXXXXXXXXXXXXXXXXXXXGXXXXXXXXXXXXXXXXXXXGXXXXXXXXXXXXXXXXXXXGXXXXXXXXXXXXXXXXXXX,0,300,0
39774,14,0,14,47,239,0,0,251,192,59,GXXXXXXXXXXXXXXXXXXXGXXXXXXXXXXXXXXXXXXXGXXXXXXXXXXXXXXXXXXXGXXXXXXXXXXXXXXXXXXXGXXXXXXXXXXXXXXXXXXXGXXXXXXXXXXXXXXXXXXXGXXXXXXXXXXXXXXXXXXXGOXXXXXXXXXXXXXXXXXXGXXXXXXXXXXXXXXXXXXXGXXXXXXXXXXXXXXXXXXXGXXXXXXXXXXXXXXXXXXXGXXXXXXXXXXXXXXXXXXXGXXXXXXXXXXXXXXXXXXX,0,300,0

39795,14,0,14,48,238,0,0,250,191,59,GXXXXXXXXXXXXXXXXXXXGXXXXXXXXXXXXXXXXXXXGXXXXXXXXXXXXXXXXXXXGXXXXXXXXXXXXXXXXXXXGXXXXXXXXXXXXXXXXXXXGXXXXXXXXXXXXXXXXXXXGXXXXXXXXXXXXXXXXXXXGOXXXXXXXXXXXXXXXXXXGXXXXXXXXXXXXXXXXXXXGXXXXXXXXXXXXXXXXXXXGXXXXXXXXXXXXXXXXXXXGXXXXXXXXXXXXXXXXXXXGXXXXXXXXXXXXXXXXXXX,0,300,0
39816,13,0,13,45,242,0,0,253,190,63,GXXXXXXXXXXXXXXXXXXXGXXXXXXXXXXXXXXXXXXXGXXXXXXXXXXXXXXXXXXXGXXXXXXXXXXXXXXXXXXXGXXXXXXXXXXXXXXXXXXXGXXXXXXXXXXXXXXXXXXXGXXXXXXXXXXXXXXXXXXXGXXXXXXXXXXXXXXXXXXXGXXXXXXXXXXXXXXXXXXXGXXXXXXXXXXXXXXXXXXXGXXXXXXXXXXXXXXXXXXXGXXXXXXXXXXXXXXXXXXXGXXXXXXXXXXXXXXXXXXX,0,300,0
39837,13,0,13,39,248,0,0,260,196,64,GXXXXXXXXXXXXXXXXXXXGXXXXXXXXXXXXXXXXXXXGXXXXXXXXXXXXXXXXXXXGXXXXXXXXXXXXXXXXXXXGXXXXXXXXXXXXXXXXXXXGXXXXXXXXXXXXXXXXXXXGXXXXXXXXXXXXXXXXXXXGXXXXXXXXXXXXXXXXXXXGXXXXXXXXXXXXXXXXXXXGXXXXXXXXXXXXXXXXXXXGXXXXXXXXXXXXXXXXXXXGXXXXXXXXXXXXXXXXXXXGXXXXXXXXXXXXXXXXXXX,0,300,0
39858,13,0,13,41,246,0,0,258,195,63,GXXXXXXXXXXXXXXXXXXXGXXXXXXXXXXXXXXXXXXXGXXXXXXXXXXXXXXXXXXXGXXXXXXXXXXXXXXXXXXXGXXXXXXXXXXXXXXXXXXXGXXXXXXXXXXXXXXXXXXXGXXXXXXXXXXXXXXXXXXXGXXXXXXXXXXXXXXXXXXXGXXXXXXXXXXXXXXXXXXXGXXXXXXXXXXXXXXXXXXXGXXXXXXXXXXXXXXXXXXXGXXXXXXXXXXXXXXXXXXXGXXXXXXXXXXXXXXXXXXX,0,300,0
39879,13,0,13,41,246,0,0,259,190,69,GXXXXXXXXXXXXXXXXXXXGXXXXXXXXXXXXXXXXXXXGXXXXXXXXXXXXXXXXXXXGXXXXXXXXXXXXXXXXXXXGXXXXXXXXXXXXXXXXXXXGXXXXXXXXXXXXXXXXXXXGXXXXXXXXXXXXXXXXXXXGXXXXXXXXXXXXXXXXXXXGXXXXXXXXXXXXXXXXXXXGXXXXXXXXXXXXXXXXXXXGXXXXXXXXXXXXXXXXXXXGXXXXXXXXXXXXXXXXXXXGXXXXXXXXXXXXXXXXXXX,0,300,0

39900,13,0,13,35,252,0,0,265,189,76,GXXXXXXXXXXXXXXXXXXXGXXXXXXXXXXXXXXXXXXXGXXXXXXXXXXXXXXXXXXXGXXXXXXXXXXXXXXXXXXXGXXXXXXXXXXXXXXXXXXXGXXXXXXXXXXXXXXXXXXXGXXXXXXXXXXXXXXXXXXXGXXXXXXXXXXXXXXXXXXXGXXXXXXXXXXXXXXXXXXXGXXXXXXXXXXXXXXXXXXXGXXXXXXXXXXXXXXXXXXXGXXXXXXXXXXXXXXXXXXXGXXXXXXXXXXXXXXXXXXX,0,300,0
39921,13,0,13,31,256,0,0,268,188,80,GXXXXXXXXXXXXXXXXXXXGXXXXXXXXXXXXXXXXXXXGXXXXXXXXXXXXXXXXXXXGXXXXXXXXXXXXXXXXXXXGXXXXXXXXXXXXXXXXXXXGXXXXXXXXXXXXXXXXXXXGXXXXXXXXXXXXXXXXXXXGXXXXXXXXXXXXXXXXXXXGXXXXXXXXXXXXXXXXXXXGXXXXXXXXXXXXXXXXXXXGXXXXXXXXXXXXXXXXXXXGXXXXXXXXXXXXXXXXXXXGXXXXXXXXXXXXXXXXXXX,0,300,0
39942,13,0,13,30,257,0,0,269,190,79,GXXXXXXXXXXXXXXXXXXXGXXXXXXXXXXXXXXXXXXXGXXXXXXXXXXXXXXXXXXXGXXXXXXXXXXXXXXXXXXXGXXXXXXXXXXXXXXXXXXXGXXXXXXXXXXXXXXXXXXXGXXXXXXXXXXXXXXXXXXXGXXXXXXXXXXXXXXXXXXXGXXXXXXXXXXXXXXXXXXXGXXXXXXXXXXXXXXXXXXXGXXXXXXXXXXXXXXXXXXXGXXXXXXXXXXXXXXXXXXXGXXXXXXXXXXXXXXXXXXX,0,300,0
39963,13,0,13,30,257,0,0,269,194,75,GXXXXXXXXXXXXXXXXXXXGXXXXXXXXXXXXXXXXXXXGXXXXXXXXXXXXXXXXXXXGXXXXXXXXXXXXXXXXXXXGXXXXXXXXXXXXXXXXXXXGXXXXXXXXXXXXXXXXXXXGXXXXXXXXXXXXXXXXXXXGXXXXXXXXXXXXXXXXXXXGXXXXXXXXXXXXXXXXXXXGXXXXXXXXXXXXXXXXXXXGXXXXXXXXXXXXXXXXXXXGXXXXXXXXXXXXXXXXXXXGXXXXXXXXXXXXXXXXXXX,0,300,0
39984,13,0,13,34,253,0,0,265,192,73,GXXXXXXXXXXXXXXXXXXXGXXXXXXXXXXXXXXXXXXXGXXXXXXXXXXXXXXXXXXXGXXXXXXXXXXXXXXXXXXXGXXXXXXXXXXXXXXXXXXXGXXXXXXXXXXXXXXXXXXXGXXXXXXXXXXXXXXXXXXXGXXXXXXXXXXXXXXXXXXXGXXXXXXXXXXXXXXXXXXXGXXXXXXXXXXXXXXXXXXXGXXXXXXXXXXXXXXXXXXXGXXXXXXXXXXXXXXXXXXXGXXXXXXXXXXXXXXXXXXX,0,300,0

40005,14,1,13,29,257,0,0,269,194,75,GXXXXXXXXXXXXXXXXXXXGXXXXXXXXXXXXXXXXXXXGXXXXXXXXXXXXXXXXXXXGXXXXXXXXXXXXXXXXXXXGXXXXXXXXXXXXXXXXXXXGXXXXXXXXXXXXXXXXXXXGXXXXXXXXXXXXXXXXXXXGXXXXXXXXXXXXXXXXXXXGAXXXXXXXXXXXXXXXXXXGXXXXXXXXXXXXXXXXXXXGXXXXXXXXXXXXXXXXXXXGXXXXXXXXXXXXXXXXXXXGXXXXXXXXXXXXXXXXXXX,0,300,0
40026,14,1,13,31,255,0,0,268,189,79,GXXXXXXXXXXXXXXXXXXXGXXXXXXXXXXXXXXXXXXXGXXXXXXXXXXXXXXXXXXXGXXXXXXXXXXXXXXXXXXXGXXXXXXXXXXXXXXXXXXXGXXXXXXXXXXXXXXXXXXXGXXXXXXXXXXXXXXXXXXXGXXXXXXXXXXXXXXXXXXXGAXXXXXXXXXXXXXXXXXXGXXXXXXXXXXXXXXXXXXXGXXXXXXXXXXXXXXXXXXXGXXXXXXXXXXXXXXXXXXXGXXXXXXXXXXXXXXXXXXX,0,300,0
40047,14,1,13,31,255,0,0,268,189,79,GXXXXXXXXXXXXXXXXXXXGXXXXXXXXXXXXXXXXXXXGXXXXXXXXXXXXXXXXXXXGXXXXXXXXXXXXXXXXXXXGXXXXXXXXXXXXXXXXXXXGXXXXXXXXXXXXXXXXXXXGXXXXXXXXXXXXXXXXXXXGXXXXXXXXXXXXXXXXXXXGAXXXXXXXXXXXXXXXXXXGXXXXXXXXXXXXXXXXXXXGXXXXXXXXXXXXXXXXXXXGXXXXXXXXXXXXXXXXXXXGXXXXXXXXXXXXXXXXXXX,0,300,0
40068,14,1,13,30,256,0,0,269,190,79,GXXXXXXXXXXXXXXXXXXXGXXXXXXXXXXXXXXXXXXXGXXXXXXXXXXXXXXXXXXXGXXXXXXXXXXXXXXXXXXXGXXXXXXXXXXXXXXXXXXXGXXXXXXXXXXXXXXXXXXXGXXXXXXXXXXXXXXXXXXXGXXXXXXXXXXXXXXXXXXXGAXXXXXXXXXXXXXXXXXXGXXXXXXXXXXXXXXXXXXXGXXXXXXXXXXXXXXXXXXXGXXXXXXXXXXXXXXXXXXXGXXXXXXXXXXXXXXXXXXX,0,300,0
40089,14,1,13,28,258,0,0,271,195,76,GXXXXXXXXXXXXXXXXXXXGXXXXXXXXXXXXXXXXXXXGXXXXXXXXXXXXXXXXXXXGXXXXXXXXXXXXXXXXXXXGXXXXXXXXXXXXXXXXXXXGXXXXXXXXXXXXXXXXXXXGXXXXXXXXXXXXXXXXXXXGXXXXXXXXXXXXXXXXXXXGAXXXXXXXXXXXXXXXXXXGXXXXXXXXXXXXXXXXXXXGXXXXXXXXXXXXXXXXXXXGXXXXXXXXXXXXXXXXXXXGXXXXXXXXXXXXXXXXXXX,0,300,0

40110,14,1,13,32,254,0,0,267,195,72,GXXXXXXXXXXXXXXXXXXXGXXXXXXXXXXXXXXXXXXXGXXXXXXXXXXXXXXXXXXXGXXXXXXXXXXXXXXXXXXXGXXXXXXXXXXXXXXXXXXXGXXXXXXXXXXXXXXXXXXXGXXXXXXXXXXXXXXXXXXXGXXXXXXXXXXXXXXXXXXXGAXXXXXXXXXXXXXXXXXXGXXXXXXXXXXXXXXXXXXXGXXXXXXXXXXXXXXXXXXXGXXXXXXXXXXXXXXXXXXXGXXXXXXXXXXXXXXXXXXX,0,300,0
40131,14,1,13,38,248,0,0,261,196,65,GXXXXXXXXXXXXXXXXXXXGXXXXXXXXXXXXXXXXXXXGXXXXXXXXXXXXXXXXXXXGXXXXXXXXXXXXXXXXXXXGXXXXXXXXXXXXXXXXXXXGXXXXXXXXXXXXXXXXXXXGXXXXXXXXXXXXXXXXXXXGXXXXXXXXXXXXXXXXXXXGAXXXXXXXXXXXXXXXXXXGXXXXXXXXXXXXXXXXXXXGXXXXXXXXXXXXXXXXXXXGXXXXXXXXXXXXXXXXXXXGXXXXXXXXXXXXXXXXXXX,0,300,0
40152,14,1,13,43,243,0,0,256,195,61,GXXXXXXXXXXXXXXXXXXXGXXXXXXXXXXXXXXXXXXXGXXXXXXXXXXXXXXXXXXXGXXXXXXXXXXXXXXXXXXXGXXXXXXXXXXXXXXXXXXXGXXXXXXXXXXXXXXXXXXXGXXXXXXXXXXXXXXXXXXXGXXXXXXXXXXXXXXXXXXXGAXXXXXXXXXXXXXXXXXXGXXXXXXXXXXXXXXXXXXXGXXXXXXXXXXXXXXXXXXXGXXXXXXXXXXXXXXXXXXXGXXXXXXXXXXXXXXXXXXX,0,300,0
40173,14,0,14,45,241,0,0,253,193,60,GXXXXXXXXXXXXXXXXXXXGXXXXXXXXXXXXXXXXXXXGXXXXXXXXXXXXXXXXXXXGXXXXXXXXXXXXXXXXXXXGXXXXXXXXXXXXXXXXXXXGXXXXXXXXXXXXXXXXXXXGXXXXXXXXXXXXXXXXXXXGXXXXXXXXXXXXXXXXXXXGOXXXXXXXXXXXXXXXXXXGXXXXXXXXXXXXXXXXXXXGXXXXXXXXXXXXXXXXXXXGXXXXXXXXXXXXXXXXXXXGXXXXXXXXXXXXXXXXXXX,0,300,0
40194,14,0,14,47,239,0,0,252,194,58,GXXXXXXXXXXXXXXXXXXXGXXXXXXXXXXXXXXXXXXXGXXXXXXXXXXXXXXXXXXXGXXXXXXXXXXXXXXXXXXXGXXXXXXXXXXXXXXXXXXXGXXXXXXXXXXXXXXXXXXXGXXXXXXXXXXXXXXXXXXXGXXXXXXXXXXXXXXXXXXXGOXXXXXXXXXXXXXXXXXXGXXXXXXXXXXXXXXXXXXXGXXXXXXXXXXXXXXXXXXXGXXXXXXXXXXXXXXXXXXXGXXXXXXXXXXXXXXXXXXX,0,300,0

40215,13,0,13,44,243,0,0,255,192,63,GXXXXXXXXXXXXXXXXXXXGXXXXXXXXXXXXXXXXXXXGXXXXXXXXXXXXXXXXXXXGXXXXXXXXXXXXXXXXXXXGXXXXXXXXXXXXXXXXXXXGXXXXXXXXXXXXXXXXXXXGXXXXXXXXXXXXXXXXXXXGXXXXXXXXXXXXXXXXXXXGXXXXXXXXXXXXXXXXXXXGXXXXXXXXXXXXXXXXXXXGXXXXXXXXXXXXXXXXXXXGXXXXXXXXXXXXXXXXXXXGXXXXXXXXXXXXXXXXXXX,0,300,0
40236,13,0,13,44,243,0,0,255,194,61,GXXXXXXXXXXXXXXXXXXXGXXXXXXXXXXXXXXXXXXXGXXXXXXXXXXXXXXXXXXXGXXXXXXXXXXXXXXXXXXXGXXXXXXXXXXXXXXXXXXXGXXXXXXXXXXXXXXXXXXXGXXXXXXXXXXXXXXXXXXXGXXXXXXXXXXXXXXXXXXXGXXXXXXXXXXXXXXXXXXXGXXXXXXXXXXXXXXXXXXXGXXXXXXXXXXXXXXXXXXXGXXXXXXXXXXXXXXXXXXXGXXXXXXXXXXXXXXXXXXX,0,300,0
40257,13,0,13,43,244,0,0,256,189,67,GXXXXXXXXXXXXXXXXXXXGXXXXXXXXXXXXXXXXXXXGXXXXXXXXXXXXXXXXXXXGXXXXXXXXXXXXXXXXXXXGXXXXXXXXXXXXXXXXXXXGXXXXXXXXXXXXXXXXXXXGXXXXXXXXXXXXXXXXXXXGXXXXXXXXXXXXXXXXXXXGXXXXXXXXXXXXXXXXXXXGXXXXXXXXXXXXXXXXXXXGXXXXXXXXXXXXXXXXXXXGXXXXXXXXXXXXXXXXXXXGXXXXXXXXXXXXXXXXXXX,0,300,0
40278,13,0,13,41,246,0,0,258,190,68,GXXXXXXXXXXXXXXXXXXXGXXXXXXXXXXXXXXXXXXXGXXXXXXXXXXXXXXXXXXXGXXXXXXXXXXXXXXXXXXXGXXXXXXXXXXXXXXXXXXXGXXXXXXXXXXXXXXXXXXXGXXXXXXXXXXXXXXXXXXXGXXXXXXXXXXXXXXXXXXXGXXXXXXXXXXXXXXXXXXXGXXXXXXXXXXXXXXXXXXXGXXXXXXXXXXXXXXXXXXXGXXXXXXXXXXXXXXXXXXXGXXXXXXXXXXXXXXXXXXX,0,300,0
40299,13,0,13,38,249,0,0,262,190,72,GXXXXXXXXXXXXXXXXXXXGXXXXXXXXXXXXXXXXXXXGXXXXXXXXXXXXXXXXXXXGXXXXXXXXXXXXXXXXXXXGXXXXXXXXXXXXXXXXXXXGXXXXXXXXXXXXXXXXXXXGXXXXXXXXXXXXXXXXXXXGXXXXXXXXXXXXXXXXXXXGXXXXXXXXXXXXXXXXXXXGXXXXXXXXXXXXXXXXXXXGXXXXXXXXXXXXXXXXXXXGXXXXXXXXXXXXXXXXXXXGXXXXXXXXXXXXXXXXXXX,0,300,0

40320,13,0,13,37,250,0,0,262,195,67,GXXXXXXXXXXXXXXXXXXXGXXXXXXXXXXXXXXXXXXXGXXXXXXXXXXXXXXXXXXXGXXXXXXXXXXXXXXXXXXXGXXXXXXXXXXXXXXXXXXXGXXXXXXXXXXXXXXXXXXXGXXXXXXXXXXXXXXXXXXXGXXXXXXXXXXXXXXXXXXXGXXXXXXXXXXXXXXXXXXXGXXXXXXXXXXXXXXXXXXXGXXXXXXXXXXXXXXXXXXXGXXXXXXXXXXXXXXXXXXXGXXXXXXXXXXXXXXXXXXX,0,300,0
40341,13,0,13,32,255,0,0,267,197,70,GXXXXXXXXXXXXXXXXXXXGXXXXXXXXXXXXXXXXXXXGXXXXXXXXXXXXXXXXXXXGXXXXXXXXXXXXXXXXXXXGXXXXXXXXXXXXXXXXXXXGXXXXXXXXXXXXXXXXXXXGXXXXXXXXXXXXXXXXXXXGXXXXXXXXXXXXXXXXXXXGXXXXXXXXXXXXXXXXXXXGXXXXXXXXXXXXXXXXXXXGXXXXXXXXXXXXXXXXXXXGXXXXXXXXXXXXXXXXXXXGXXXXXXXXXXXXXXXXXXX,0,300,0
40362,13,0,13,30,257,0,0,269,198,71,GXXXXXXXXXXXXXXXXXXXGXXXXXXXXXXXXXXXXXXXGXXXXXXXXXXXXXXXXXXXGXXXXXXXXXXXXXXXXXXXGXXXXXXXXXXXXXXXXXXXGXXXXXXXXXXXXXXXXXXXGXXXXXXXXXXXXXXXXXXXGXXXXXXXXXXXXXXXXXXXGXXXXXXXXXXXXXXXXXXXGXXXXXXXXXXXXXXXXXXXGXXXXXXXXXXXXXXXXXXXGXXXXXXXXXXXXXXXXXXXGXXXXXXXXXXXXXXXXXXX,0,300,0
40383,13,0,13,29,258,0,0,269,195,74,GXXXXXXXXXXXXXXXXXXXGXXXXXXXXXXXXXXXXXXXGXXXXXXXXXXXXXXXXXXXGXXXXXXXXXXXXXXXXXXXGXXXXXXXXXXXXXXXXXXXGXXXXXXXXXXXXXXXXXXXGXXXXXXXXXXXXXXXXXXXGXXXXXXXXXXXXXXXXXXXGXXXXXXXXXXXXXXXXXXXGXXXXXXXXXXXXXXXXXXXGXXXXXXXXXXXXXXXXXXXGXXXXXXXXXXXXXXXXXXXGXXXXXXXXXXXXXXXXXXX,0,300,0
40404,13,0,13,31,256,0,0,268,196,72,GXXXXXXXXXXXXXXXXXXXGXXXXXXXXXXXXXXXXXXXGXXXXXXXXXXXXXXXXXXXGXXXXXXXXXXXXXXXXXXXGXXXXXXXXXXXXXXXXXXXGXXXXXXXXXXXXXXXXXXXGXXXXXXXXXXXXXXXXXXXGXXXXXXXXXXXXXXXXXXXGXXXXXXXXXXXXXXXXXXXGXXXXXXXXXXXXXXXXXXXGXXXXXXXXXXXXXXXXXXXGXXXXXXXXXXXXXXXXXXXGXXXXXXXXXXXXXXXXXXX,0,300,0

40425,13,0,13,36,251,0,0,263,192,71,GXXXXXXXXXXXXXXXXXXXGXXXXXXXXXXXXXXXXXXXGXXXXXXXXXXXXXXXXXXXGXXXXXXXXXXXXXXXXXXXGXXXXXXXXXXXXXXXXXXXGXXXXXXXXXXXXXXXXXXXGXXXXXXXXXXXXXXXXXXXGXXXXXXXXXXXXXXXXXXXGXXXXXXXXXXXXXXXXXXXGXXXXXXXXXXXXXXXXXXXGXXXXXXXXXXXXXXXXXXXGXXXXXXXXXXXXXXXXXXXGXXXXXXXXXXXXXXXXXXX,0,300,0
40446,13,0,13,36,251,0,0,263,194,69,GXXXXXXXXXXXXXXXXXXXGXXXXXXXXXXXXXXXXXXXGXXXXXXXXXXXXXXXXXXXGXXXXXXXXXXXXXXXXXXXGXXXXXXXXXXXXXXXXXXXGXXXXXXXXXXXXXXXXXXXGXXXXXXXXXXXXXXXXXXXGXXXXXXXXXXXXXXXXXXXGXXXXXXXXXXXXXXXXXXXGXXXXXXXXXXXXXXXXXXXGXXXXXXXXXXXXXXXXXXXGXXXXXXXXXXXXXXXXXXXGXXXXXXXXXXXXXXXXXXX,0,300,0
40467,13,0,13,40,247,0,0,259,191,68,GXXXXXXXXXXXXXXXXXXXGXXXXXXXXXXXXXXXXXXXGXXXXXXXXXXXXXXXXXXXGXXXXXXXXXXXXXXXXXXXGXXXXXXXXXXXXXXXXXXXGXXXXXXXXXXXXXXXXXXXGXXXXXXXXXXXXXXXXXXXGXXXXXXXXXXXXXXXXXXXGXXXXXXXXXXXXXXXXXXXGXXXXXXXXXXXXXXXXXXXGXXXXXXXXXXXXXXXXXXXGXXXXXXXXXXXXXXXXXXXGXXXXXXXXXXXXXXXXXXX,0,300,0
40488,13,0,13,37,250,0,0,262,191,71,GXXXXXXXXXXXXXXXXXXXGXXXXXXXXXXXXXXXXXXXGXXXXXXXXXXXXXXXXXXXGXXXXXXXXXXXXXXXXXXXGXXXXXXXXXXXXXXXXXXXGXXXXXXXXXXXXXXXXXXXGXXXXXXXXXXXXXXXXXXXGXXXXXXXXXXXXXXXXXXXGXXXXXXXXXXXXXXXXXXXGXXXXXXXXXXXXXXXXXXXGXXXXXXXXXXXXXXXXXXXGXXXXXXXXXXXXXXXXXXXGXXXXXXXXXXXXXXXXXXX,0,300,0
40509,13,0,13,32,255,0,0,266,193,73,GXXXXXXXXXXXXXXXXXXXGXXXXXXXXXXXXXXXXXXXGXXXXXXXXXXXXXXXXXXXGXXXXXXXXXXXXXXXXXXXGXXXXXXXXXXXXXXXXXXXGXXXXXXXXXXXXXXXXXXXGXXXXXXXXXXXXXXXXXXXGXXXXXXXXXXXXXXXXXXXGXXXXXXXXXXXXXXXXXXXGXXXXXXXXXXXXXXXXXXXGXXXXXXXXXXXXXXXXXXXGXXXXXXXXXXXXXXXXXXXGXXXXXXXXXXXXXXXXXXX,0,300,0

40530,13,0,13,33,254,0,0,266,192,74,GXXXXXXXXXXXXXXXXXXXGXXXXXXXXXXXXXXXXXXXGXXXXXXXXXXXXXXXXXXXGXXXXXXXXXXXXXXXXXXXGXXXXXXXXXXXXXXXXXXXGXXXXXXXXXXXXXXXXXXXGXXXXXXXXXXXXXXXXXXXGXXXXXXXXXXXXXXXXXXXGXXXXXXXXXXXXXXXXXXXGXXXXXXXXXXXXXXXXXXXGXXXXXXXXXXXXXXXXXXXGXXXXXXXXXXXXXXXXXXXGXXXXXXXXXXXXXXXXXXX,0,300,0
40551,13,0,13,35,252,0,0,264,194,70,GXXXXXXXXXXXXXXXXXXXGXXXXXXXXXXXXXXXXXXXGXXXXXXXXXXXXXXXXXXXGXXXXXXXXXXXXXXXXXXXGXXXXXXXXXXXXXXXXXXXGXXXXXXXXXXXXXXXXXXXGXXXXXXXXXXXXXXXXXXXGXXXXXXXXXXXXXXXXXXXGXXXXXXXXXXXXXXXXXXXGXXXXXXXXXXXXXXXXXXXGXXXXXXXXXXXXXXXXXXXGXXXXXXXXXXXXXXXXXXXGXXXXXXXXXXXXXXXXXXX,0,300,0
40572,13,0,13,32,255,0,0,267,198,69,GXXXXXXXXXXXXXXXXXXXGXXXXXXXXXXXXXXXXXXXGXXXXXXXXXXXXXXXXXXXGXXXXXXXXXXXXXXXXXXXGXXXXXXXXXXXXXXXXXXXGXXXXXXXXXXXXXXXXXXXGXXXXXXXXXXXXXXXXXXXGXXXXXXXXXXXXXXXXXXXGXXXXXXXXXXXXXXXXXXXGXXXXXXXXXXXXXXXXXXXGXXXXXXXXXXXXXXXXXXXGXXXXXXXXXXXXXXXXXXXGXXXXXXXXXXXXXXXXXXX,0,300,0
40593,13,0,13,34,253,0,0,265,195,70,GXXXXXXXXXXXXXXXXXXXGXXXXXXXXXXXXXXXXXXXGXXXXXXXXXXXXXXXXXXXGXXXXXXXXXXXXXXXXXXXGXXXXXXXXXXXXXXXXXXXGXXXXXXXXXXXXXXXXXXXGXXXXXXXXXXXXXXXXXXXGXXXXXXXXXXXXXXXXXXXGXXXXXXXXXXXXXXXXXXXGXXXXXXXXXXXXXXXXXXXGXXXXXXXXXXXXXXXXXXXGXXXXXXXXXXXXXXXXXXXGXXXXXXXXXXXXXXXXXXX,0,300,0
40614,13,0,13,35,252,0,0,264,195,69,GXXXXXXXXXXXXXXXXXXXGXXXXXXXXXXXXXXXXXXXGXXXXXXXXXXXXXXXXXXXGXXXXXXXXXXXXXXXXXXXGXXXXXXXXXXXXXXXXXXXGXXXXXXXXXXXXXXXXXXXGXXXXXXXXXXXXXXXXXXXGXXXXXXXXXXXXXXXXXXXGXXXXXXXXXXXXXXXXXXXGXXXXXXXXXXXXXXXXXXXGXXXXXXXXXXXXXXXXXXXGXXXXXXXXXXXXXXXXXXXGXXXXXXXXXXXXXXXXXXX,0,300,0

40635,13,0,13,35,252,0,0,264,203,61,GXXXXXXXXXXXXXXXXXXXGXXXXXXXXXXXXXXXXXXXGXXXXXXXXXXXXXXXXXXXGXXXXXXXXXXXXXXXXXXXGXXXXXXXXXXXXXXXXXXXGXXXXXXXXXXXXXXXXXXXGXXXXXXXXXXXXXXXXXXXGXXXXXXXXXXXXXXXXXXXGXXXXXXXXXXXXXXXXXXXGXXXXXXXXXXXXXXXXXXXGXXXXXXXXXXXXXXXXXXXGXXXXXXXXXXXXXXXXXXXGXXXXXXXXXXXXXXXXXXX,0,300,0
40656,13,0,13,37,250,0,0,262,201,61,GXXXXXXXXXXXXXXXXXXXGXXXXXXXXXXXXXXXXXXXGXXXXXXXXXXXXXXXXXXXGXXXXXXXXXXXXXXXXXXXGXXXXXXXXXXXXXXXXXXXGXXXXXXXXXXXXXXXXXXXGXXXXXXXXXXXXXXXXXXXGXXXXXXXXXXXXXXXXXXXGXXXXXXXXXXXXXXXXXXXGXXXXXXXXXXXXXXXXXXXGXXXXXXXXXXXXXXXXXXXGXXXXXXXXXXXXXXXXXXXGXXXXXXXXXXXXXXXXXXX,0,300,0
40677,13,0,13,35,252,0,0,265,202,63,GXXXXXXXXXXXXXXXXXXXGXXXXXXXXXXXXXXXXXXXGXXXXXXXXXXXXXXXXXXXGXXXXXXXXXXXXXXXXXXXGXXXXXXXXXXXXXXXXXXXGXXXXXXXXXXXXXXXXXXXGXXXXXXXXXXXXXXXXXXXGXXXXXXXXXXXXXXXXXXXGXXXXXXXXXXXXXXXXXXXGXXXXXXXXXXXXXXXXXXXGXXXXXXXXXXXXXXXXXXXGXXXXXXXXXXXXXXXXXXXGXXXXXXXXXXXXXXXXXXX,0,300,0
40698,13,0,13,36,251,0,0,263,198,65,GXXXXXXXXXXXXXXXXXXXGXXXXXXXXXXXXXXXXXXXGXXXXXXXXXXXXXXXXXXXGXXXXXXXXXXXXXXXXXXXGXXXXXXXXXXXXXXXXXXXGXXXXXXXXXXXXXXXXXXXGXXXXXXXXXXXXXXXXXXXGXXXXXXXXXXXXXXXXXXXGXXXXXXXXXXXXXXXXXXXGXXXXXXXXXXXXXXXXXXXGXXXXXXXXXXXXXXXXXXXGXXXXXXXXXXXXXXXXXXXGXXXXXXXXXXXXXXXXXXX,0,300,0
40719,13,0,13,38,249,0,0,262,195,67,GXXXXXXXXXXXXXXXXXXXGXXXXXXXXXXXXXXXXXXXGXXXXXXXXXXXXXXXXXXXGXXXXXXXXXXXXXXXXXXXGXXXXXXXXXXXXXXXXXXXGXXXXXXXXXXXXXXXXXXXGXXXXXXXXXXXXXXXXXXXGXXXXXXXXXXXXXXXXXXXGXXXXXXXXXXXXXXXXXXXGXXXXXXXXXXXXXXXXXXXGXXXXXXXXXXXXXXXXXXXGXXXXXXXXXXXXXXXXXXXGXXXXXXXXXXXXXXXXXXX,0,300,0

40740,13,0,13,39,248,0,0,260,193,67,GXXXXXXXXXXXXXXXXXXXGXXXXXXXXXXXXXXXXXXXGXXXXXXXXXXXXXXXXXXXGXXXXXXXXXXXXXXXXXXXGXXXXXXXXXXXXXXXXXXXGXXXXXXXXXXXXXXXXXXXGXXXXXXXXXXXXXXXXXXXGXXXXXXXXXXXXXXXXXXXGXXXXXXXXXXXXXXXXXXXGXXXXXXXXXXXXXXXXXXXGXXXXXXXXXXXXXXXXXXXGXXXXXXXXXXXXXXXXXXXGXXXXXXXXXXXXXXXXXXX,0,300,0
40761,13,0,13,37,250,0,0,263,197,66,GXXXXXXXXXXXXXXXXXXXGXXXXXXXXXXXXXXXXXXXGXXXXXXXXXXXXXXXXXXXGXXXXXXXXXXXXXXXXXXXGXXXXXXXXXXXXXXXXXXXGXXXXXXXXXXXXXXXXXXXGXXXXXXXXXXXXXXXXXXXGXXXXXXXXXXXXXXXXXXXGXXXXXXXXXXXXXXXXXXXGXXXXXXXXXXXXXXXXXXXGXXXXXXXXXXXXXXXXXXXGXXXXXXXXXXXXXXXXXXXGXXXXXXXXXXXXXXXXXXX,0,300,0
40782,13,0,13,34,253,0,0,265,196,69,GXXXXXXXXXXXXXXXXXXXGXXXXXXXXXXXXXXXXXXXGXXXXXXXXXXXXXXXXXXXGXXXXXXXXXXXXXXXXXXXGXXXXXXXXXXXXXXXXXXXGXXXXXXXXXXXXXXXXXXXGXXXXXXXXXXXXXXXXXXXGXXXXXXXXXXXXXXXXXXXGXXXXXXXXXXXXXXXXXXXGXXXXXXXXXXXXXXXXXXXGXXXXXXXXXXXXXXXXXXXGXXXXXXXXXXXXXXXXXXXGXXXXXXXXXXXXXXXXXXX,0,300,0
40803,13,0,13,32,255,0,0,267,197,70,GXXXXXXXXXXXXXXXXXXXGXXXXXXXXXXXXXXXXXXXGXXXXXXXXXXXXXXXXXXXGXXXXXXXXXXXXXXXXXXXGXXXXXXXXXXXXXXXXXXXGXXXXXXXXXXXXXXXXXXXGXXXXXXXXXXXXXXXXXXXGXXXXXXXXXXXXXXXXXXXGXXXXXXXXXXXXXXXXXXXGXXXXXXXXXXXXXXXXXXXGXXXXXXXXXXXXXXXXXXXGXXXXXXXXXXXXXXXXXXXGXXXXXXXXXXXXXXXXXXX,0,300,0
40824,13,0,13,31,256,0,0,268,198,70,GXXXXXXXXXXXXXXXXXXXGXXXXXXXXXXXXXXXXXXXGXXXXXXXXXXXXXXXXXXXGXXXXXXXXXXXXXXXXXXXGXXXXXXXXXXXXXXXXXXXGXXXXXXXXXXXXXXXXXXXGXXXXXXXXXXXXXXXXXXXGXXXXXXXXXXXXXXXXXXXGXXXXXXXXXXXXXXXXXXXGXXXXXXXXXXXXXXXXXXXGXXXXXXXXXXXXXXXXXXXGXXXXXXXXXXXXXXXXXXXGXXXXXXXXXXXXXXXXXXX,0,300,0

40845,13,0,13,33,254,0,0,266,198,68,GXXXXXXXXXXXXXXXXXXXGXXXXXXXXXXXXXXXXXXXGXXXXXXXXXXXXXXXXXXXGXXXXXXXXXXXXXXXXXXXGXXXXXXXXXXXXXXXXXXXGXXXXXXXXXXXXXXXXXXXGXXXXXXXXXXXXXXXXXXXGXXXXXXXXXXXXXXXXXXXGXXXXXXXXXXXXXXXXXXXGXXXXXXXXXXXXXXXXXXXGXXXXXXXXXXXXXXXXXXXGXXXXXXXXXXXXXXXXXXXGXXXXXXXXXXXXXXXXXXX,0,300,0
40866,13,0,13,34,253,0,0,265,196,69,GXXXXXXXXXXXXXXXXXXXGXXXXXXXXXXXXXXXXXXXGXXXXXXXXXXXXXXXXXXXGXXXXXXXXXXXXXXXXXXXGXXXXXXXXXXXXXXXXXXXGXXXXXXXXXXXXXXXXXXXGXXXXXXXXXXXXXXXXXXXGXXXXXXXXXXXXXXXXXXXGXXXXXXXXXXXXXXXXXXXGXXXXXXXXXXXXXXXXXXXGXXXXXXXXXXXXXXXXXXXGXXXXXXXXXXXXXXXXXXXGXXXXXXXXXXXXXXXXXXX,0,300,0
40887,13,0,13,35,252,0,0,264,196,68,GXXXXXXXXXXXXXXXXXXXGXXXXXXXXXXXXXXXXXXXGXXXXXXXXXXXXXXXXXXXGXXXXXXXXXXXXXXXXXXXGXXXXXXXXXXXXXXXXXXXGXXXXXXXXXXXXXXXXXXXGXXXXXXXXXXXXXXXXXXXGXXXXXXXXXXXXXXXXXXXGXXXXXXXXXXXXXXXXXXXGXXXXXXXXXXXXXXXXXXXGXXXXXXXXXXXXXXXXXXXGXXXXXXXXXXXXXXXXXXXGXXXXXXXXXXXXXXXXXXX,0,300,0
40908,13,0,13,36,251,0,0,263,194,69,GXXXXXXXXXXXXXXXXXXXGXXXXXXXXXXXXXXXXXXXGXXXXXXXXXXXXXXXXXXXGXXXXXXXXXXXXXXXXXXXGXXXXXXXXXXXXXXXXXXXGXXXXXXXXXXXXXXXXXXXGXXXXXXXXXXXXXXXXXXXGXXXXXXXXXXXXXXXXXXXGXXXXXXXXXXXXXXXXXXXGXXXXXXXXXXXXXXXXXXXGXXXXXXXXXXXXXXXXXXXGXXXXXXXXXXXXXXXXXXXGXXXXXXXXXXXXXXXXXXX,0,300,0
40929,13,0,13,35,252,0,0,263,192,71,GXXXXXXXXXXXXXXXXXXXGXXXXXXXXXXXXXXXXXXXGXXXXXXXXXXXXXXXXXXXGXXXXXXXXXXXXXXXXXXXGXXXXXXXXXXXXXXXXXXXGXXXXXXXXXXXXXXXXXXXGXXXXXXXXXXXXXXXXXXXGXXXXXXXXXXXXXXXXXXXGXXXXXXXXXXXXXXXXXXXGXXXXXXXXXXXXXXXXXXXGXXXXXXXXXXXXXXXXXXXGXXXXXXXXXXXXXXXXXXXGXXXXXXXXXXXXXXXXXXX,0,300,0

40950,13,0,13,34,253,0,0,265,194,71,GXXXXXXXXXXXXXXXXXXXGXXXXXXXXXXXXXXXXXXXGXXXXXXXXXXXXXXXXXXXGXXXXXXXXXXXXXXXXXXXGXXXXXXXXXXXXXXXXXXXGXXXXXXXXXXXXXXXXXXXGXXXXXXXXXXXXXXXXXXXGXXXXXXXXXXXXXXXXXXXGXXXXXXXXXXXXXXXXXXXGXXXXXXXXXXXXXXXXXXXGXXXXXXXXXXXXXXXXXXXGXXXXXXXXXXXXXXXXXXXGXXXXXXXXXXXXXXXXXXX,0,300,0
40971,13,0,13,32,255,0,0,267,195,72,GXXXXXXXXXXXXXXXXXXXGXXXXXXXXXXXXXXXXXXXGXXXXXXXXXXXXXXXXXXXGXXXXXXXXXXXXXXXXXXXGXXXXXXXXXXXXXXXXXXXGXXXXXXXXXXXXXXXXXXXGXXXXXXXXXXXXXXXXXXXGXXXXXXXXXXXXXXXXXXXGXXXXXXXXXXXXXXXXXXXGXXXXXXXXXXXXXXXXXXXGXXXXXXXXXXXXXXXXXXXGXXXXXXXXXXXXXXXXXXXGXXXXXXXXXXXXXXXXXXX,0,300,0
40992,13,0,13,34,253,0,0,265,194,71,GXXXXXXXXXXXXXXXXXXXGXXXXXXXXXXXXXXXXXXXGXXXXXXXXXXXXXXXXXXXGXXXXXXXXXXXXXXXXXXXGXXXXXXXXXXXXXXXXXXXGXXXXXXXXXXXXXXXXXXXGXXXXXXXXXXXXXXXXXXXGXXXXXXXXXXXXXXXXXXXGXXXXXXXXXXXXXXXXXXXGXXXXXXXXXXXXXXXXXXXGXXXXXXXXXXXXXXXXXXXGXXXXXXXXXXXXXXXXXXXGXXXXXXXXXXXXXXXXXXX,0,300,0
41013,13,0,13,37,250,0,0,262,195,67,GXXXXXXXXXXXXXXXXXXXGXXXXXXXXXXXXXXXXXXXGXXXXXXXXXXXXXXXXXXXGXXXXXXXXXXXXXXXXXXXGXXXXXXXXXXXXXXXXXXXGXXXXXXXXXXXXXXXXXXXGXXXXXXXXXXXXXXXXXXXGXXXXXXXXXXXXXXXXXXXGXXXXXXXXXXXXXXXXXXXGXXXXXXXXXXXXXXXXXXXGXXXXXXXXXXXXXXXXXXXGXXXXXXXXXXXXXXXXXXXGXXXXXXXXXXXXXXXXXXX,0,300,0
41034,13,0,13,40,247,0,0,259,197,62,GXXXXXXXXXXXXXXXXXXXGXXXXXXXXXXXXXXXXXXXGXXXXXXXXXXXXXXXXXXXGXXXXXXXXXXXXXXXXXXXGXXXXXXXXXXXXXXXXXXXGXXXXXXXXXXXXXXXXXXXGXXXXXXXXXXXXXXXXXXXGXXXXXXXXXXXXXXXXXXXGXXXXXXXXXXXXXXXXXXXGXXXXXXXXXXXXXXXXXXXGXXXXXXXXXXXXXXXXXXXGXXXXXXXXXXXXXXXXXXXGXXXXXXXXXXXXXXXXXXX,0,300,0

41055,13,0,13,38,249,0,0,261,195,66,GXXXXXXXXXXXXXXXXXXXGXXXXXXXXXXXXXXXXXXXGXXXXXXXXXXXXXXXXXXXGXXXXXXXXXXXXXXXXXXXGXXXXXXXXXXXXXXXXXXXGXXXXXXXXXXXXXXXXXXXGXXXXXXXXXXXXXXXXXXXGXXXXXXXXXXXXXXXXXXXGXXXXXXXXXXXXXXXXXXXGXXXXXXXXXXXXXXXXXXXGXXXXXXXXXXXXXXXXXXXGXXXXXXXXXXXXXXXXXXXGXXXXXXXXXXXXXXXXXXX,0,300,0
41076,13,0,13,41,246,0,0,258,192,66,GXXXXXXXXXXXXXXXXXXXGXXXXXXXXXXXXXXXXXXXGXXXXXXXXXXXXXXXXXXXGXXXXXXXXXXXXXXXXXXXGXXXXXXXXXXXXXXXXXXXGXXXXXXXXXXXXXXXXXXXGXXXXXXXXXXXXXXXXXXXGXXXXXXXXXXXXXXXXXXXGXXXXXXXXXXXXXXXXXXXGXXXXXXXXXXXXXXXXXXXGXXXXXXXXXXXXXXXXXXXGXXXXXXXXXXXXXXXXXXXGXXXXXXXXXXXXXXXXXXX,0,300,0
41097,13,0,13,40,247,0,0,259,195,64,GXXXXXXXXXXXXXXXXXXXGXXXXXXXXXXXXXXXXXXXGXXXXXXXXXXXXXXXXXXXGXXXXXXXXXXXXXXXXXXXGXXXXXXXXXXXXXXXXXXXGXXXXXXXXXXXXXXXXXXXGXXXXXXXXXXXXXXXXXXXGXXXXXXXXXXXXXXXXXXXGXXXXXXXXXXXXXXXXXXXGXXXXXXXXXXXXXXXXXXXGXXXXXXXXXXXXXXXXXXXGXXXXXXXXXXXXXXXXXXXGXXXXXXXXXXXXXXXXXXX,0,300,0
41118,13,0,13,42,245,0,0,257,194,63,GXXXXXXXXXXXXXXXXXXXGXXXXXXXXXXXXXXXXXXXGXXXXXXXXXXXXXXXXXXXGXXXXXXXXXXXXXXXXXXXGXXXXXXXXXXXXXXXXXXXGXXXXXXXXXXXXXXXXXXXGXXXXXXXXXXXXXXXXXXXGXXXXXXXXXXXXXXXXXXXGXXXXXXXXXXXXXXXXXXXGXXXXXXXXXXXXXXXXXXXGXXXXXXXXXXXXXXXXXXXGXXXXXXXXXXXXXXXXXXXGXXXXXXXXXXXXXXXXXXX,0,300,0
41139,13,0,13,44,243,0,0,255,193,62,GXXXXXXXXXXXXXXXXXXXGXXXXXXXXXXXXXXXXXXXGXXXXXXXXXXXXXXXXXXXGXXXXXXXXXXXXXXXXXXXGXXXXXXXXXXXXXXXXXXXGXXXXXXXXXXXXXXXXXXXGXXXXXXXXXXXXXXXXXXXGXXXXXXXXXXXXXXXXXXXGXXXXXXXXXXXXXXXXXXXGXXXXXXXXXXXXXXXXXXXGXXXXXXXXXXXXXXXXXXXGXXXXXXXXXXXXXXXXXXXGXXXXXXXXXXXXXXXXXXX,0,300,0

41160,13,0,13,41,246,0,0,258,196,62,GXXXXXXXXXXXXXXXXXXXGXXXXXXXXXXXXXXXXXXXGXXXXXXXXXXXXXXXXXXXGXXXXXXXXXXXXXXXXXXXGXXXXXXXXXXXXXXXXXXXGXXXXXXXXXXXXXXXXXXXGXXXXXXXXXXXXXXXXXXXGXXXXXXXXXXXXXXXXXXXGXXXXXXXXXXXXXXXXXXXGXXXXXXXXXXXXXXXXXXXGXXXXXXXXXXXXXXXXXXXGXXXXXXXXXXXXXXXXXXXGXXXXXXXXXXXXXXXXXXX,0,300,0
41181,13,0,13,40,247,0,0,259,199,60,GXXXXXXXXXXXXXXXXXXXGXXXXXXXXXXXXXXXXXXXGXXXXXXXXXXXXXXXXXXXGXXXXXXXXXXXXXXXXXXXGXXXXXXXXXXXXXXXXXXXGXXXXXXXXXXXXXXXXXXXGXXXXXXXXXXXXXXXXXXXGXXXXXXXXXXXXXXXXXXXGXXXXXXXXXXXXXXXXXXXGXXXXXXXXXXXXXXXXXXXGXXXXXXXXXXXXXXXXXXXGXXXXXXXXXXXXXXXXXXXGXXXXXXXXXXXXXXXXXXX,0,300,0
41202,13,0,13,33,254,0,0,266,204,62,GXXXXXXXXXXXXXXXXXXXGXXXXXXXXXXXXXXXXXXXGXXXXXXXXXXXXXXXXXXXGXXXXXXXXXXXXXXXXXXXGXXXXXXXXXXXXXXXXXXXGXXXXXXXXXXXXXXXXXXXGXXXXXXXXXXXXXXXXXXXGXXXXXXXXXXXXXXXXXXXGXXXXXXXXXXXXXXXXXXXGXXXXXXXXXXXXXXXXXXXGXXXXXXXXXXXXXXXXXXXGXXXXXXXXXXXXXXXXXXXGXXXXXXXXXXXXXXXXXXX,0,300,0
41223,13,0,13,39,248,0,0,260,203,57,GXXXXXXXXXXXXXXXXXXXGXXXXXXXXXXXXXXXXXXXGXXXXXXXXXXXXXXXXXXXGXXXXXXXXXXXXXXXXXXXGXXXXXXXXXXXXXXXXXXXGXXXXXXXXXXXXXXXXXXXGXXXXXXXXXXXXXXXXXXXGXXXXXXXXXXXXXXXXXXXGXXXXXXXXXXXXXXXXXXXGXXXXXXXXXXXXXXXXXXXGXXXXXXXXXXXXXXXXXXXGXXXXXXXXXXXXXXXXXXXGXXXXXXXXXXXXXXXXXXX,0,300,0
41244,13,0,13,43,244,0,0,256,198,58,GXXXXXXXXXXXXXXXXXXXGXXXXXXXXXXXXXXXXXXXGXXXXXXXXXXXXXXXXXXXGXXXXXXXXXXXXXXXXXXXGXXXXXXXXXXXXXXXXXXXGXXXXXXXXXXXXXXXXXXXGXXXXXXXXXXXXXXXXXXXGXXXXXXXXXXXXXXXXXXXGXXXXXXXXXXXXXXXXXXXGXXXXXXXXXXXXXXXXXXXGXXXXXXXXXXXXXXXXXXXGXXXXXXXXXXXXXXXXXXXGXXXXXXXXXXXXXXXXXXX,0,300,0

41265,13,0,13,40,247,0,0,259,196,63,GXXXXXXXXXXXXXXXXXXXGXXXXXXXXXXXXXXXXXXXGXXXXXXXXXXXXXXXXXXXGXXXXXXXXXXXXXXXXXXXGXXXXXXXXXXXXXXXXXXXGXXXXXXXXXXXXXXXXXXXGXXXXXXXXXXXXXXXXXXXGXXXXXXXXXXXXXXXXXXXGXXXXXXXXXXXXXXXXXXXGXXXXXXXXXXXXXXXXXXXGXXXXXXXXXXXXXXXXXXXGXXXXXXXXXXXXXXXXXXXGXXXXXXXXXXXXXXXXXXX,0,300,0
41286,13,0,13,37,250,0,0,261,196,65,GXXXXXXXXXXXXXXXXXXXGXXXXXXXXXXXXXXXXXXXGXXXXXXXXXXXXXXXXXXXGXXXXXXXXXXXXXXXXXXXGXXXXXXXXXXXXXXXXXXXGXXXXXXXXXXXXXXXXXXXGXXXXXXXXXXXXXXXXXXXGXXXXXXXXXXXXXXXXXXXGXXXXXXXXXXXXXXXXXXXGXXXXXXXXXXXXXXXXXXXGXXXXXXXXXXXXXXXXXXXGXXXXXXXXXXXXXXXXXXXGXXXXXXXXXXXXXXXXXXX,0,300,0
41307,13,0,13,34,253,0,0,265,195,70,GXXXXXXXXXXXXXXXXXXXGXXXXXXXXXXXXXXXXXXXGXXXXXXXXXXXXXXXXXXXGXXXXXXXXXXXXXXXXXXXGXXXXXXXXXXXXXXXXXXXGXXXXXXXXXXXXXXXXXXXGXXXXXXXXXXXXXXXXXXXGXXXXXXXXXXXXXXXXXXXGXXXXXXXXXXXXXXXXXXXGXXXXXXXXXXXXXXXXXXXGXXXXXXXXXXXXXXXXXXXGXXXXXXXXXXXXXXXXXXXGXXXXXXXXXXXXXXXXXXX,0,300,0
41328,13,0,13,35,252,0,0,264,195,69,GXXXXXXXXXXXXXXXXXXXGXXXXXXXXXXXXXXXXXXXGXXXXXXXXXXXXXXXXXXXGXXXXXXXXXXXXXXXXXXXGXXXXXXXXXXXXXXXXXXXGXXXXXXXXXXXXXXXXXXXGXXXXXXXXXXXXXXXXXXXGXXXXXXXXXXXXXXXXXXXGXXXXXXXXXXXXXXXXXXXGXXXXXXXXXXXXXXXXXXXGXXXXXXXXXXXXXXXXXXXGXXXXXXXXXXXXXXXXXXXGXXXXXXXXXXXXXXXXXXX,0,300,0
41349,13,0,13,30,257,0,0,269,198,71,GXXXXXXXXXXXXXXXXXXXGXXXXXXXXXXXXXXXXXXXGXXXXXXXXXXXXXXXXXXXGXXXXXXXXXXXXXXXXXXXGXXXXXXXXXXXXXXXXXXXGXXXXXXXXXXXXXXXXXXXGXXXXXXXXXXXXXXXXXXXGXXXXXXXXXXXXXXXXXXXGXXXXXXXXXXXXXXXXXXXGXXXXXXXXXXXXXXXXXXXGXXXXXXXXXXXXXXXXXXXGXXXXXXXXXXXXXXXXXXXGXXXXXXXXXXXXXXXXXXX,0,300,0

41370,13,0,13,31,256,0,0,268,198,70,GXXXXXXXXXXXXXXXXXXXGXXXXXXXXXXXXXXXXXXXGXXXXXXXXXXXXXXXXXXXGXXXXXXXXXXXXXXXXXXXGXXXXXXXXXXXXXXXXXXXGXXXXXXXXXXXXXXXXXXXGXXXXXXXXXXXXXXXXXXXGXXXXXXXXXXXXXXXXXXXGXXXXXXXXXXXXXXXXXXXGXXXXXXXXXXXXXXXXXXXGXXXXXXXXXXXXXXXXXXXGXXXXXXXXXXXXXXXXXXXGXXXXXXXXXXXXXXXXXXX,0,300,0
41391,13,0,13,31,256,0,0,267,196,71,GXXXXXXXXXXXXXXXXXXXGXXXXXXXXXXXXXXXXXXXGXXXXXXXXXXXXXXXXXXXGXXXXXXXXXXXXXXXXXXXGXXXXXXXXXXXXXXXXXXXGXXXXXXXXXXXXXXXXXXXGXXXXXXXXXXXXXXXXXXXGXXXXXXXXXXXXXXXXXXXGXXXXXXXXXXXXXXXXXXXGXXXXXXXXXXXXXXXXXXXGXXXXXXXXXXXXXXXXXXXGXXXXXXXXXXXXXXXXXXXGXXXXXXXXXXXXXXXXXXX,0,300,0
41412,13,0,13,29,258,0,0,270,194,76,GXXXXXXXXXXXXXXXXXXXGXXXXXXXXXXXXXXXXXXXGXXXXXXXXXXXXXXXXXXXGXXXXXXXXXXXXXXXXXXXGXXXXXXXXXXXXXXXXXXXGXXXXXXXXXXXXXXXXXXXGXXXXXXXXXXXXXXXXXXXGXXXXXXXXXXXXXXXXXXXGXXXXXXXXXXXXXXXXXXXGXXXXXXXXXXXXXXXXXXXGXXXXXXXXXXXXXXXXXXXGXXXXXXXXXXXXXXXXXXXGXXXXXXXXXXXXXXXXXXX,0,300,0
41433,13,0,13,25,262,0,0,274,197,77,GXXXXXXXXXXXXXXXXXXXGXXXXXXXXXXXXXXXXXXXGXXXXXXXXXXXXXXXXXXXGXXXXXXXXXXXXXXXXXXXGXXXXXXXXXXXXXXXXXXXGXXXXXXXXXXXXXXXXXXXGXXXXXXXXXXXXXXXXXXXGXXXXXXXXXXXXXXXXXXXGXXXXXXXXXXXXXXXXXXXGXXXXXXXXXXXXXXXXXXXGXXXXXXXXXXXXXXXXXXXGXXXXXXXXXXXXXXXXXXXGXXXXXXXXXXXXXXXXXXX,0,300,0
41454,13,0,13,25,262,0,0,274,199,75,GXXXXXXXXXXXXXXXXXXXGXXXXXXXXXXXXXXXXXXXGXXXXXXXXXXXXXXXXXXXGXXXXXXXXXXXXXXXXXXXGXXXXXXXXXXXXXXXXXXXGXXXXXXXXXXXXXXXXXXXGXXXXXXXXXXXXXXXXXXXGXXXXXXXXXXXXXXXXXXXGXXXXXXXXXXXXXXXXXXXGXXXXXXXXXXXXXXXXXXXGXXXXXXXXXXXXXXXXXXXGXXXXXXXXXXXXXXXXXXXGXXXXXXXXXXXXXXXXXXX,0,300,0

41475,13,0,13,26,261,0,0,273,198,75,GXXXXXXXXXXXXXXXXXXXGXXXXXXXXXXXXXXXXXXXGXXXXXXXXXXXXXXXXXXXGXXXXXXXXXXXXXXXXXXXGXXXXXXXXXXXXXXXXXXXGXXXXXXXXXXXXXXXXXXXGXXXXXXXXXXXXXXXXXXXGXXXXXXXXXXXXXXXXXXXGXXXXXXXXXXXXXXXXXXXGXXXXXXXXXXXXXXXXXXXGXXXXXXXXXXXXXXXXXXXGXXXXXXXXXXXXXXXXXXXGXXXXXXXXXXXXXXXXXXX,0,300,0
41496,13,0,13,29,258,0,0,270,199,71,GXXXXXXXXXXXXXXXXXXXGXXXXXXXXXXXXXXXXXXXGXXXXXXXXXXXXXXXXXXXGXXXXXXXXXXXXXXXXXXXGXXXXXXXXXXXXXXXXXXXGXXXXXXXXXXXXXXXXXXXGXXXXXXXXXXXXXXXXXXXGXXXXXXXXXXXXXXXXXXXGXXXXXXXXXXXXXXXXXXXGXXXXXXXXXXXXXXXXXXXGXXXXXXXXXXXXXXXXXXXGXXXXXXXXXXXXXXXXXXXGXXXXXXXXXXXXXXXXXXX,0,300,0
41517,13,0,13,36,251,0,0,263,193,70,GXXXXXXXXXXXXXXXXXXXGXXXXXXXXXXXXXXXXXXXGXXXXXXXXXXXXXXXXXXXGXXXXXXXXXXXXXXXXXXXGXXXXXXXXXXXXXXXXXXXGXXXXXXXXXXXXXXXXXXXGXXXXXXXXXXXXXXXXXXXGXXXXXXXXXXXXXXXXXXXGXXXXXXXXXXXXXXXXXXXGXXXXXXXXXXXXXXXXXXXGXXXXXXXXXXXXXXXXXXXGXXXXXXXXXXXXXXXXXXXGXXXXXXXXXXXXXXXXXXX,0,300,0
41538,13,0,13,35,252,0,0,264,195,69,GXXXXXXXXXXXXXXXXXXXGXXXXXXXXXXXXXXXXXXXGXXXXXXXXXXXXXXXXXXXGXXXXXXXXXXXXXXXXXXXGXXXXXXXXXXXXXXXXXXXGXXXXXXXXXXXXXXXXXXXGXXXXXXXXXXXXXXXXXXXGXXXXXXXXXXXXXXXXXXXGXXXXXXXXXXXXXXXXXXXGXXXXXXXXXXXXXXXXXXXGXXXXXXXXXXXXXXXXXXXGXXXXXXXXXXXXXXXXXXXGXXXXXXXXXXXXXXXXXXX,0,300,0
41559,13,0,13,33,254,0,0,266,200,66,GXXXXXXXXXXXXXXXXXXXGXXXXXXXXXXXXXXXXXXXGXXXXXXXXXXXXXXXXXXXGXXXXXXXXXXXXXXXXXXXGXXXXXXXXXXXXXXXXXXXGXXXXXXXXXXXXXXXXXXXGXXXXXXXXXXXXXXXXXXXGXXXXXXXXXXXXXXXXXXXGXXXXXXXXXXXXXXXXXXXGXXXXXXXXXXXXXXXXXXXGXXXXXXXXXXXXXXXXXXXGXXXXXXXXXXXXXXXXXXXGXXXXXXXXXXXXXXXXXXX,0,300,0

41580,13,0,13,37,250,0,0,262,200,62,GXXXXXXXXXXXXXXXXXXXGXXXXXXXXXXXXXXXXXXXGXXXXXXXXXXXXXXXXXXXGXXXXXXXXXXXXXXXXXXXGXXXXXXXXXXXXXXXXXXXGXXXXXXXXXXXXXXXXXXXGXXXXXXXXXXXXXXXXXXXGXXXXXXXXXXXXXXXXXXXGXXXXXXXXXXXXXXXXXXXGXXXXXXXXXXXXXXXXXXXGXXXXXXXXXXXXXXXXXXXGXXXXXXXXXXXXXXXXXXXGXXXXXXXXXXXXXXXXXXX,0,300,0
41601,13,0,13,38,249,0,0,261,199,62,GXXXXXXXXXXXXXXXXXXXGXXXXXXXXXXXXXXXXXXXGXXXXXXXXXXXXXXXXXXXGXXXXXXXXXXXXXXXXXXXGXXXXXXXXXXXXXXXXXXXGXXXXXXXXXXXXXXXXXXXGXXXXXXXXXXXXXXXXXXXGXXXXXXXXXXXXXXXXXXXGXXXXXXXXXXXXXXXXXXXGXXXXXXXXXXXXXXXXXXXGXXXXXXXXXXXXXXXXXXXGXXXXXXXXXXXXXXXXXXXGXXXXXXXXXXXXXXXXXXX,0,300,0
41622,13,0,13,39,248,0,0,260,197,63,GXXXXXXXXXXXXXXXXXXXGXXXXXXXXXXXXXXXXXXXGXXXXXXXXXXXXXXXXXXXGXXXXXXXXXXXXXXXXXXXGXXXXXXXXXXXXXXXXXXXGXXXXXXXXXXXXXXXXXXXGXXXXXXXXXXXXXXXXXXXGXXXXXXXXXXXXXXXXXXXGXXXXXXXXXXXXXXXXXXXGXXXXXXXXXXXXXXXXXXXGXXXXXXXXXXXXXXXXXXXGXXXXXXXXXXXXXXXXXXXGXXXXXXXXXXXXXXXXXXX,0,300,0
41643,13,0,13,35,252,0,0,264,198,66,GXXXXXXXXXXXXXXXXXXXGXXXXXXXXXXXXXXXXXXXGXXXXXXXXXXXXXXXXXXXGXXXXXXXXXXXXXXXXXXXGXXXXXXXXXXXXXXXXXXXGXXXXXXXXXXXXXXXXXXXGXXXXXXXXXXXXXXXXXXXGXXXXXXXXXXXXXXXXXXXGXXXXXXXXXXXXXXXXXXXGXXXXXXXXXXXXXXXXXXXGXXXXXXXXXXXXXXXXXXXGXXXXXXXXXXXXXXXXXXXGXXXXXXXXXXXXXXXXXXX,0,300,0
41664,13,0,13,31,256,0,0,266,200,66,GXXXXXXXXXXXXXXXXXXXGXXXXXXXXXXXXXXXXXXXGXXXXXXXXXXXXXXXXXXXGXXXXXXXXXXXXXXXXXXXGXXXXXXXXXXXXXXXXXXXGXXXXXXXXXXXXXXXXXXXGXXXXXXXXXXXXXXXXXXXGXXXXXXXXXXXXXXXXXXXGXXXXXXXXXXXXXXXXXXXGXXXXXXXXXXXXXXXXXXXGXXXXXXXXXXXXXXXXXXXGXXXXXXXXXXXXXXXXXXXGXXXXXXXXXXXXXXXXXXX,0,300,0

41685,13,0,13,30,257,0,0,269,200,69,GXXXXXXXXXXXXXXXXXXXGXXXXXXXXXXXXXXXXXXXGXXXXXXXXXXXXXXXXXXXGXXXXXXXXXXXXXXXXXXXGXXXXXXXXXXXXXXXXXXXGXXXXXXXXXXXXXXXXXXXGXXXXXXXXXXXXXXXXXXXGXXXXXXXXXXXXXXXXXXXGXXXXXXXXXXXXXXXXXXXGXXXXXXXXXXXXXXXXXXXGXXXXXXXXXXXXXXXXXXXGXXXXXXXXXXXXXXXXXXXGXXXXXXXXXXXXXXXXXXX,0,300,0
41706,14,1,13,34,252,0,0,264,200,64,GXXXXXXXXXXXXXXXXXXXGXXXXXXXXXXXXXXXXXXXGXXXXXXXXXXXXXXXXXXXGXXXXXXXXXXXXXXXXXXXGXXXXXXXXXXXXXXXXXXXGXXXXXXXXXXXXXXXXXXXGXXXXXXXXXXXXXXXXXXXGXXXXXXXXXXXXXXXXXXXGXXXXXXXXXXXXXXXXXXXGXXXXXXXXXXXXXXXXXXXGAXXXXXXXXXXXXXXXXXXGXXXXXXXXXXXXXXXXXXXGXXXXXXXXXXXXXXXXXXX,0,300,0
41727,14,1,13,35,251,0,0,264,198,66,GXXXXXXXXXXXXXXXXXXXGXXXXXXXXXXXXXXXXXXXGXXXXXXXXXXXXXXXXXXXGXXXXXXXXXXXXXXXXXXXGXXXXXXXXXXXXXXXXXXXGXXXXXXXXXXXXXXXXXXXGXXXXXXXXXXXXXXXXXXXGXXXXXXXXXXXXXXXXXXXGXXXXXXXXXXXXXXXXXXXGXXXXXXXXXXXXXXXXXXXGAXXXXXXXXXXXXXXXXXXGXXXXXXXXXXXXXXXXXXXGXXXXXXXXXXXXXXXXXXX,0,300,0
41748,14,1,13,39,247,0,0,260,201,59,GXXXXXXXXXXXXXXXXXXXGXXXXXXXXXXXXXXXXXXXGXXXXXXXXXXXXXXXXXXXGXXXXXXXXXXXXXXXXXXXGXXXXXXXXXXXXXXXXXXXGXXXXXXXXXXXXXXXXXXXGXXXXXXXXXXXXXXXXXXXGXXXXXXXXXXXXXXXXXXXGXXXXXXXXXXXXXXXXXXXGXXXXXXXXXXXXXXXXXXXGAXXXXXXXXXXXXXXXXXXGXXXXXXXXXXXXXXXXXXXGXXXXXXXXXXXXXXXXXXX,0,300,0
41769,14,1,13,35,251,0,0,264,197,67,GXXXXXXXXXXXXXXXXXXXGXXXXXXXXXXXXXXXXXXXGXXXXXXXXXXXXXXXXXXXGXXXXXXXXXXXXXXXXXXXGXXXXXXXXXXXXXXXXXXXGXXXXXXXXXXXXXXXXXXXGXXXXXXXXXXXXXXXXXXXGXXXXXXXXXXXXXXXXXXXGXXXXXXXXXXXXXXXXXXXGXXXXXXXXXXXXXXXXXXXGAXXXXXXXXXXXXXXXXXXGXXXXXXXXXXXXXXXXXXXGXXXXXXXXXXXXXXXXXXX,0,300,0

41790,14,1,13,37,249,0,0,262,199,63,GXXXXXXXXXXXXXXXXXXXGXXXXXXXXXXXXXXXXXXXGXXXXXXXXXXXXXXXXXXXGXXXXXXXXXXXXXXXXXXXGXXXXXXXXXXXXXXXXXXXGXXXXXXXXXXXXXXXXXXXGXXXXXXXXXXXXXXXXXXXGXXXXXXXXXXXXXXXXXXXGXXXXXXXXXXXXXXXXXXXGXXXXXXXXXXXXXXXXXXXGAXXXXXXXXXXXXXXXXXXGXXXXXXXXXXXXXXXXXXXGXXXXXXXXXXXXXXXXXXX,0,300,0
41811,14,1,13,42,244,0,0,257,197,60,GXXXXXXXXXXXXXXXXXXXGXXXXXXXXXXXXXXXXXXXGXXXXXXXXXXXXXXXXXXXGXXXXXXXXXXXXXXXXXXXGXXXXXXXXXXXXXXXXXXXGXXXXXXXXXXXXXXXXXXXGXXXXXXXXXXXXXXXXXXXGXXXXXXXXXXXXXXXXXXXGXXXXXXXXXXXXXXXXXXXGXXXXXXXXXXXXXXXXXXXGAXXXXXXXXXXXXXXXXXXGXXXXXXXXXXXXXXXXXXXGXXXXXXXXXXXXXXXXXXX,0,300,0
41832,14,1,13,42,244,0,0,255,203,52,GXXXXXXXXXXXXXXXXXXXGXXXXXXXXXXXXXXXXXXXGXXXXXXXXXXXXXXXXXXXGXXXXXXXXXXXXXXXXXXXGXXXXXXXXXXXXXXXXXXXGXXXXXXXXXXXXXXXXXXXGXXXXXXXXXXXXXXXXXXXGXXXXXXXXXXXXXXXXXXXGXXXXXXXXXXXXXXXXXXXGXXXXXXXXXXXXXXXXXXXGAXXXXXXXXXXXXXXXXXXGXXXXXXXXXXXXXXXXXXXGXXXXXXXXXXXXXXXXXXX,0,300,0
41853,14,1,13,42,244,0,0,256,202,54,GXXXXXXXXXXXXXXXXXXXGXXXXXXXXXXXXXXXXXXXGXXXXXXXXXXXXXXXXXXXGXXXXXXXXXXXXXXXXXXXGXXXXXXXXXXXXXXXXXXXGXXXXXXXXXXXXXXXXXXXGXXXXXXXXXXXXXXXXXXXGXXXXXXXXXXXXXXXXXXXGXXXXXXXXXXXXXXXXXXXGXXXXXXXXXXXXXXXXXXXGAXXXXXXXXXXXXXXXXXXGXXXXXXXXXXXXXXXXXXXGXXXXXXXXXXXXXXXXXXX,0,300,0
41874,14,1,13,44,242,0,0,254,200,54,GXXXXXXXXXXXXXXXXXXXGXXXXXXXXXXXXXXXXXXXGXXXXXXXXXXXXXXXXXXXGXXXXXXXXXXXXXXXXXXXGXXXXXXXXXXXXXXXXXXXGXXXXXXXXXXXXXXXXXXXGXXXXXXXXXXXXXXXXXXXGXXXXXXXXXXXXXXXXXXXGXXXXXXXXXXXXXXXXXXXGXXXXXXXXXXXXXXXXXXXGAXXXXXXXXXXXXXXXXXXGXXXXXXXXXXXXXXXXXXXGXXXXXXXXXXXXXXXXXXX,0,300,0

41895,14,1,13,43,243,0,0,255,203,52,GXXXXXXXXXXXXXXXXXXXGXXXXXXXXXXXXXXXXXXXGXXXXXXXXXXXXXXXXXXXGXXXXXXXXXXXXXXXXXXXGXXXXXXXXXXXXXXXXXXXGXXXXXXXXXXXXXXXXXXXGXXXXXXXXXXXXXXXXXXXGXXXXXXXXXXXXXXXXXXXGXXXXXXXXXXXXXXXXXXXGXXXXXXXXXXXXXXXXXXXGAXXXXXXXXXXXXXXXXXXGXXXXXXXXXXXXXXXXXXXGXXXXXXXXXXXXXXXXXXX,0,300,0
41916,14,0,14,47,239,0,0,251,203,48,GXXXXXXXXXXXXXXXXXXXGXXXXXXXXXXXXXXXXXXXGXXXXXXXXXXXXXXXXXXXGXXXXXXXXXXXXXXXXXXXGXXXXXXXXXXXXXXXXXXXGXXXXXXXXXXXXXXXXXXXGXXXXXXXXXXXXXXXXXXXGXXXXXXXXXXXXXXXXXXXGXXXXXXXXXXXXXXXXXXXGXXXXXXXXXXXXXXXXXXXGOXXXXXXXXXXXXXXXXXXGXXXXXXXXXXXXXXXXXXXGXXXXXXXXXXXXXXXXXXX,0,300,0
41937,14,0,14,44,242,0,0,253,202,51,GXXXXXXXXXXXXXXXXXXXGXXXXXXXXXXXXXXXXXXXGXXXXXXXXXXXXXXXXXXXGXXXXXXXXXXXXXXXXXXXGXXXXXXXXXXXXXXXXXXXGXXXXXXXXXXXXXXXXXXXGXXXXXXXXXXXXXXXXXXXGXXXXXXXXXXXXXXXXXXXGXXXXXXXXXXXXXXXXXXXGXXXXXXXXXXXXXXXXXXXGOXXXXXXXXXXXXXXXXXXGXXXXXXXXXXXXXXXXXXXGXXXXXXXXXXXXXXXXXXX,0,300,0
41958,13,0,13,42,245,0,0,257,200,57,GXXXXXXXXXXXXXXXXXXXGXXXXXXXXXXXXXXXXXXXGXXXXXXXXXXXXXXXXXXXGXXXXXXXXXXXXXXXXXXXGXXXXXXXXXXXXXXXXXXXGXXXXXXXXXXXXXXXXXXXGXXXXXXXXXXXXXXXXXXXGXXXXXXXXXXXXXXXXXXXGXXXXXXXXXXXXXXXXXXXGXXXXXXXXXXXXXXXXXXXGXXXXXXXXXXXXXXXXXXXGXXXXXXXXXXXXXXXXXXXGXXXXXXXXXXXXXXXXXXX,0,300,0
41979,13,0,13,42,245,0,0,257,200,57,GXXXXXXXXXXXXXXXXXXXGXXXXXXXXXXXXXXXXXXXGXXXXXXXXXXXXXXXXXXXGXXXXXXXXXXXXXXXXXXXGXXXXXXXXXXXXXXXXXXXGXXXXXXXXXXXXXXXXXXXGXXXXXXXXXXXXXXXXXXXGXXXXXXXXXXXXXXXXXXXGXXXXXXXXXXXXXXXXXXXGXXXXXXXXXXXXXXXXXXXGXXXXXXXXXXXXXXXXXXXGXXXXXXXXXXXXXXXXXXXGXXXXXXXXXXXXXXXXXXX,0,300,0

42000,13,0,13,44,243,0,0,255,199,56,GXXXXXXXXXXXXXXXXXXXGXXXXXXXXXXXXXXXXXXXGXXXXXXXXXXXXXXXXXXXGXXXXXXXXXXXXXXXXXXXGXXXXXXXXXXXXXXXXXXXGXXXXXXXXXXXXXXXXXXXGXXXXXXXXXXXXXXXXXXXGXXXXXXXXXXXXXXXXXXXGXXXXXXXXXXXXXXXXXXXGXXXXXXXXXXXXXXXXXXXGXXXXXXXXXXXXXXXXXXXGXXXXXXXXXXXXXXXXXXXGXXXXXXXXXXXXXXXXXXX,0,300,0
42021,13,0,13,39,248,0,0,260,200,60,GXXXXXXXXXXXXXXXXXXXGXXXXXXXXXXXXXXXXXXXGXXXXXXXXXXXXXXXXXXXGXXXXXXXXXXXXXXXXXXXGXXXXXXXXXXXXXXXXXXXGXXXXXXXXXXXXXXXXXXXGXXXXXXXXXXXXXXXXXXXGXXXXXXXXXXXXXXXXXXXGXXXXXXXXXXXXXXXXXXXGXXXXXXXXXXXXXXXXXXXGXXXXXXXXXXXXXXXXXXXGXXXXXXXXXXXXXXXXXXXGXXXXXXXXXXXXXXXXXXX,0,300,0
42042,14,1,13,34,252,0,0,264,198,66,GXXXXXXXXXXXXXXXXXXXGXXXXXXXXXXXXXXXXXXXGXXXXXXXXXXXXXXXXXXXGXXXXXXXXXXXXXXXXXXXGXXXXXXXXXXXXXXXXXXXGXXXXXXXXXXXXXXXXXXXGXXXXXXXXXXXXXXXXXXXGXXXXXXXXXXXXXXXXXXXGXXXXXXXXXXXXXXXXXXXGXXXXXXXXXXXXXXXXXXXGAXXXXXXXXXXXXXXXXXXGXXXXXXXXXXXXXXXXXXXGXXXXXXXXXXXXXXXXXXX,0,300,0
42063,14,1,13,33,253,0,0,265,198,67,GXXXXXXXXXXXXXXXXXXXGXXXXXXXXXXXXXXXXXXXGXXXXXXXXXXXXXXXXXXXGXXXXXXXXXXXXXXXXXXXGXXXXXXXXXXXXXXXXXXXGXXXXXXXXXXXXXXXXXXXGXXXXXXXXXXXXXXXXXXXGXXXXXXXXXXXXXXXXXXXGXXXXXXXXXXXXXXXXXXXGXXXXXXXXXXXXXXXXXXXGAXXXXXXXXXXXXXXXXXXGXXXXXXXXXXXXXXXXXXXGXXXXXXXXXXXXXXXXXXX,0,300,0
42084,14,1,13,30,256,0,0,267,202,65,GXXXXXXXXXXXXXXXXXXXGXXXXXXXXXXXXXXXXXXXGXXXXXXXXXXXXXXXXXXXGXXXXXXXXXXXXXXXXXXXGXXXXXXXXXXXXXXXXXXXGXXXXXXXXXXXXXXXXXXXGXXXXXXXXXXXXXXXXXXXGXXXXXXXXXXXXXXXXXXXGXXXXXXXXXXXXXXXXXXXGXXXXXXXXXXXXXXXXXXXGAXXXXXXXXXXXXXXXXXXGXXXXXXXXXXXXXXXXXXXGXXXXXXXXXXXXXXXXXXX,0,300,0

42105,14,0,14,29,257,0,0,269,199,70,GXXXXXXXXXXXXXXXXXXXGXXXXXXXXXXXXXXXXXXXGXXXXXXXXXXXXXXXXXXXGXXXXXXXXXXXXXXXXXXXGXXXXXXXXXXXXXXXXXXXGXXXXXXXXXXXXXXXXXXXGXXXXXXXXXXXXXXXXXXXGXXXXXXXXXXXXXXXXXXXGXXXXXXXXXXXXXXXXXXXGXXXXXXXXXXXXXXXXXXXGOXXXXXXXXXXXXXXXXXXGXXXXXXXXXXXXXXXXXXXGXXXXXXXXXXXXXXXXXXX,0,300,0
42126,14,0,14,31,255,0,0,267,195,72,GXXXXXXXXXXXXXXXXXXXGXXXXXXXXXXXXXXXXXXXGXXXXXXXXXXXXXXXXXXXGXXXXXXXXXXXXXXXXXXXGXXXXXXXXXXXXXXXXXXXGXXXXXXXXXXXXXXXXXXXGXXXXXXXXXXXXXXXXXXXGXXXXXXXXXXXXXXXXXXXGXXXXXXXXXXXXXXXXXXXGXXXXXXXXXXXXXXXXXXXGOXXXXXXXXXXXXXXXXXXGXXXXXXXXXXXXXXXXXXXGXXXXXXXXXXXXXXXXXXX,0,300,0
42147,14,0,14,34,252,0,0,264,197,67,GXXXXXXXXXXXXXXXXXXXGXXXXXXXXXXXXXXXXXXXGXXXXXXXXXXXXXXXXXXXGXXXXXXXXXXXXXXXXXXXGXXXXXXXXXXXXXXXXXXXGXXXXXXXXXXXXXXXXXXXGXXXXXXXXXXXXXXXXXXXGXXXXXXXXXXXXXXXXXXXGXXXXXXXXXXXXXXXXXXXGXXXXXXXXXXXXXXXXXXXGOXXXXXXXXXXXXXXXXXXGXXXXXXXXXXXXXXXXXXXGXXXXXXXXXXXXXXXXXXX,0,300,0
42168,13,0,13,33,254,0,0,266,198,68,GXXXXXXXXXXXXXXXXXXXGXXXXXXXXXXXXXXXXXXXGXXXXXXXXXXXXXXXXXXXGXXXXXXXXXXXXXXXXXXXGXXXXXXXXXXXXXXXXXXXGXXXXXXXXXXXXXXXXXXXGXXXXXXXXXXXXXXXXXXXGXXXXXXXXXXXXXXXXXXXGXXXXXXXXXXXXXXXXXXXGXXXXXXXXXXXXXXXXXXXGXXXXXXXXXXXXXXXXXXXGXXXXXXXXXXXXXXXXXXXGXXXXXXXXXXXXXXXXXXX,0,300,0
42189,13,0,13,30,257,0,0,269,199,70,GXXXXXXXXXXXXXXXXXXXGXXXXXXXXXXXXXXXXXXXGXXXXXXXXXXXXXXXXXXXGXXXXXXXXXXXXXXXXXXXGXXXXXXXXXXXXXXXXXXXGXXXXXXXXXXXXXXXXXXXGXXXXXXXXXXXXXXXXXXXGXXXXXXXXXXXXXXXXXXXGXXXXXXXXXXXXXXXXXXXGXXXXXXXXXXXXXXXXXXXGXXXXXXXXXXXXXXXXXXXGXXXXXXXXXXXXXXXXXXXGXXXXXXXXXXXXXXXXXXX,0,300,0

42210,13,0,13,32,255,0,0,267,200,67,GXXXXXXXXXXXXXXXXXXXGXXXXXXXXXXXXXXXXXXXGXXXXXXXXXXXXXXXXXXXGXXXXXXXXXXXXXXXXXXXGXXXXXXXXXXXXXXXXXXXGXXXXXXXXXXXXXXXXXXXGXXXXXXXXXXXXXXXXXXXGXXXXXXXXXXXXXXXXXXXGXXXXXXXXXXXXXXXXXXXGXXXXXXXXXXXXXXXXXXXGXXXXXXXXXXXXXXXXXXXGXXXXXXXXXXXXXXXXXXXGXXXXXXXXXXXXXXXXXXX,0,300,0
42231,13,0,13,33,254,0,0,265,199,66,GXXXXXXXXXXXXXXXXXXXGXXXXXXXXXXXXXXXXXXXGXXXXXXXXXXXXXXXXXXXGXXXXXXXXXXXXXXXXXXXGXXXXXXXXXXXXXXXXXXXGXXXXXXXXXXXXXXXXXXXGXXXXXXXXXXXXXXXXXXXGXXXXXXXXXXXXXXXXXXXGXXXXXXXXXXXXXXXXXXXGXXXXXXXXXXXXXXXXXXXGXXXXXXXXXXXXXXXXXXXGXXXXXXXXXXXXXXXXXXXGXXXXXXXXXXXXXXXXXXX,0,300,0
42252,13,0,13,33,254,0,0,266,200,66,GXXXXXXXXXXXXXXXXXXXGXXXXXXXXXXXXXXXXXXXGXXXXXXXXXXXXXXXXXXXGXXXXXXXXXXXXXXXXXXXGXXXXXXXXXXXXXXXXXXXGXXXXXXXXXXXXXXXXXXXGXXXXXXXXXXXXXXXXXXXGXXXXXXXXXXXXXXXXXXXGXXXXXXXXXXXXXXXXXXXGXXXXXXXXXXXXXXXXXXXGXXXXXXXXXXXXXXXXXXXGXXXXXXXXXXXXXXXXXXXGXXXXXXXXXXXXXXXXXXX,0,300,0
42273,13,0,13,33,254,0,0,266,200,66,GXXXXXXXXXXXXXXXXXXXGXXXXXXXXXXXXXXXXXXXGXXXXXXXXXXXXXXXXXXXGXXXXXXXXXXXXXXXXXXXGXXXXXXXXXXXXXXXXXXXGXXXXXXXXXXXXXXXXXXXGXXXXXXXXXXXXXXXXXXXGXXXXXXXXXXXXXXXXXXXGXXXXXXXXXXXXXXXXXXXGXXXXXXXXXXXXXXXXXXXGXXXXXXXXXXXXXXXXXXXGXXXXXXXXXXXXXXXXXXXGXXXXXXXXXXXXXXXXXXX,0,300,0
42294,13,0,13,36,251,0,0,263,196,67,GXXXXXXXXXXXXXXXXXXXGXXXXXXXXXXXXXXXXXXXGXXXXXXXXXXXXXXXXXXXGXXXXXXXXXXXXXXXXXXXGXXXXXXXXXXXXXXXXXXXGXXXXXXXXXXXXXXXXXXXGXXXXXXXXXXXXXXXXXXXGXXXXXXXXXXXXXXXXXXXGXXXXXXXXXXXXXXXXXXXGXXXXXXXXXXXXXXXXXXXGXXXXXXXXXXXXXXXXXXXGXXXXXXXXXXXXXXXXXXXGXXXXXXXXXXXXXXXXXXX,0,300,0

42315,13,0,13,32,255,0,0,267,197,70,GXXXXXXXXXXXXXXXXXXXGXXXXXXXXXXXXXXXXXXXGXXXXXXXXXXXXXXXXXXXGXXXXXXXXXXXXXXXXXXXGXXXXXXXXXXXXXXXXXXXGXXXXXXXXXXXXXXXXXXXGXXXXXXXXXXXXXXXXXXXGXXXXXXXXXXXXXXXXXXXGXXXXXXXXXXXXXXXXXXXGXXXXXXXXXXXXXXXXXXXGXXXXXXXXXXXXXXXXXXXGXXXXXXXXXXXXXXXXXXXGXXXXXXXXXXXXXXXXXXX,0,300,0
42336,14,1,13,31,255,0,0,267,198,69,GXXXXXXXXXXXXXXXXXXXGAXXXXXXXXXXXXXXXXXXGXXXXXXXXXXXXXXXXXXXGXXXXXXXXXXXXXXXXXXXGXXXXXXXXXXXXXXXXXXXGXXXXXXXXXXXXXXXXXXXGXXXXXXXXXXXXXXXXXXXGXXXXXXXXXXXXXXXXXXXGXXXXXXXXXXXXXXXXXXXGXXXXXXXXXXXXXXXXXXXGXXXXXXXXXXXXXXXXXXXGXXXXXXXXXXXXXXXXXXXGXXXXXXXXXXXXXXXXXXX,0,300,0
42357,14,1,13,33,253,0,0,265,199,66,GXXXXXXXXXXXXXXXXXXXGAXXXXXXXXXXXXXXXXXXGXXXXXXXXXXXXXXXXXXXGXXXXXXXXXXXXXXXXXXXGXXXXXXXXXXXXXXXXXXXGXXXXXXXXXXXXXXXXXXXGXXXXXXXXXXXXXXXXXXXGXXXXXXXXXXXXXXXXXXXGXXXXXXXXXXXXXXXXXXXGXXXXXXXXXXXXXXXXXXXGXXXXXXXXXXXXXXXXXXXGXXXXXXXXXXXXXXXXXXXGXXXXXXXXXXXXXXXXXXX,0,300,0
42378,14,1,13,35,251,0,0,263,200,63,GXXXXXXXXXXXXXXXXXXXGAXXXXXXXXXXXXXXXXXXGXXXXXXXXXXXXXXXXXXXGXXXXXXXXXXXXXXXXXXXGXXXXXXXXXXXXXXXXXXXGXXXXXXXXXXXXXXXXXXXGXXXXXXXXXXXXXXXXXXXGXXXXXXXXXXXXXXXXXXXGXXXXXXXXXXXXXXXXXXXGXXXXXXXXXXXXXXXXXXXGXXXXXXXXXXXXXXXXXXXGXXXXXXXXXXXXXXXXXXXGXXXXXXXXXXXXXXXXXXX,0,300,0
42399,14,1,13,37,249,0,0,261,202,59,GXXXXXXXXXXXXXXXXXXXGAXXXXXXXXXXXXXXXXXXGXXXXXXXXXXXXXXXXXXXGXXXXXXXXXXXXXXXXXXXGXXXXXXXXXXXXXXXXXXXGXXXXXXXXXXXXXXXXXXXGXXXXXXXXXXXXXXXXXXXGXXXXXXXXXXXXXXXXXXXGXXXXXXXXXXXXXXXXXXXGXXXXXXXXXXXXXXXXXXXGXXXXXXXXXXXXXXXXXXXGXXXXXXXXXXXXXXXXXXXGXXXXXXXXXXXXXXXXXXX,0,300,0

42420,14,1,13,35,251,0,0,262,203,59,GXXXXXXXXXXXXXXXXXXXGAXXXXXXXXXXXXXXXXXXGXXXXXXXXXXXXXXXXXXXGXXXXXXXXXXXXXXXXXXXGXXXXXXXXXXXXXXXXXXXGXXXXXXXXXXXXXXXXXXXGXXXXXXXXXXXXXXXXXXXGXXXXXXXXXXXXXXXXXXXGXXXXXXXXXXXXXXXXXXXGXXXXXXXXXXXXXXXXXXXGXXXXXXXXXXXXXXXXXXXGXXXXXXXXXXXXXXXXXXXGXXXXXXXXXXXXXXXXXXX,0,300,0
42441,14,1,13,39,247,0,0,259,202,57,GXXXXXXXXXXXXXXXXXXXGAXXXXXXXXXXXXXXXXXXGXXXXXXXXXXXXXXXXXXXGXXXXXXXXXXXXXXXXXXXGXXXXXXXXXXXXXXXXXXXGXXXXXXXXXXXXXXXXXXXGXXXXXXXXXXXXXXXXXXXGXXXXXXXXXXXXXXXXXXXGXXXXXXXXXXXXXXXXXXXGXXXXXXXXXXXXXXXXXXXGXXXXXXXXXXXXXXXXXXXGXXXXXXXXXXXXXXXXXXXGXXXXXXXXXXXXXXXXXXX,0,300,0
42462,14,1,13,35,251,0,0,263,201,62,GXXXXXXXXXXXXXXXXXXXGAXXXXXXXXXXXXXXXXXXGXXXXXXXXXXXXXXXXXXXGXXXXXXXXXXXXXXXXXXXGXXXXXXXXXXXXXXXXXXXGXXXXXXXXXXXXXXXXXXXGXXXXXXXXXXXXXXXXXXXGXXXXXXXXXXXXXXXXXXXGXXXXXXXXXXXXXXXXXXXGXXXXXXXXXXXXXXXXXXXGXXXXXXXXXXXXXXXXXXXGXXXXXXXXXXXXXXXXXXXGXXXXXXXXXXXXXXXXXXX,0,300,0
42483,15,2,13,35,250,0,0,261,198,63,GXXXXXXXXXXXXXXXXXXXGAXXXXXXXXXXXXXXXXXXGXXXXXXXXXXXXXXXXXXXGXXXXXXXXXXXXXXXXXXXGAXXXXXXXXXXXXXXXXXXGXXXXXXXXXXXXXXXXXXXGXXXXXXXXXXXXXXXXXXXGXXXXXXXXXXXXXXXXXXXGXXXXXXXXXXXXXXXXXXXGXXXXXXXXXXXXXXXXXXXGXXXXXXXXXXXXXXXXXXXGXXXXXXXXXXXXXXXXXXXGXXXXXXXXXXXXXXXXXXX,0,300,0
42504,15,1,14,37,248,0,0,260,197,63,GXXXXXXXXXXXXXXXXXXXGOXXXXXXXXXXXXXXXXXXGXXXXXXXXXXXXXXXXXXXGXXXXXXXXXXXXXXXXXXXGAXXXXXXXXXXXXXXXXXXGXXXXXXXXXXXXXXXXXXXGXXXXXXXXXXXXXXXXXXXGXXXXXXXXXXXXXXXXXXXGXXXXXXXXXXXXXXXXXXXGXXXXXXXXXXXXXXXXXXXGXXXXXXXXXXXXXXXXXXXGXXXXXXXXXXXXXXXXXXXGXXXXXXXXXXXXXXXXXXX,0,300,0

42525,15,0,15,36,249,0,0,261,199,62,GXXXXXXXXXXXXXXXXXXXGOXXXXXXXXXXXXXXXXXXGXXXXXXXXXXXXXXXXXXXGXXXXXXXXXXXXXXXXXXXGOXXXXXXXXXXXXXXXXXXGXXXXXXXXXXXXXXXXXXXGXXXXXXXXXXXXXXXXXXXGXXXXXXXXXXXXXXXXXXXGXXXXXXXXXXXXXXXXXXXGXXXXXXXXXXXXXXXXXXXGXXXXXXXXXXXXXXXXXXXGXXXXXXXXXXXXXXXXXXXGXXXXXXXXXXXXXXXXXXX,0,300,0
42546,15,0,15,39,246,0,0,258,198,60,GXXXXXXXXXXXXXXXXXXXGOXXXXXXXXXXXXXXXXXXGXXXXXXXXXXXXXXXXXXXGXXXXXXXXXXXXXXXXXXXGOXXXXXXXXXXXXXXXXXXGXXXXXXXXXXXXXXXXXXXGXXXXXXXXXXXXXXXXXXXGXXXXXXXXXXXXXXXXXXXGXXXXXXXXXXXXXXXXXXXGXXXXXXXXXXXXXXXXXXXGXXXXXXXXXXXXXXXXXXXGXXXXXXXXXXXXXXXXXXXGXXXXXXXXXXXXXXXXXXX,0,300,0
42567,14,1,13,40,246,0,0,258,196,62,GXXXXXXXXXXXXXXXXXXXGXXXXXXXXXXXXXXXXXXXGXXXXXXXXXXXXXXXXXXXGXXXXXXXXXXXXXXXXXXXGXXXXXXXXXXXXXXXXXXXGXXXXXXXXXXXXXXXXXXXGXXXXXXXXXXXXXXXXXXXGXXXXXXXXXXXXXXXXXXXGXXXXXXXXXXXXXXXXXXXGAXXXXXXXXXXXXXXXXXXGXXXXXXXXXXXXXXXXXXXGXXXXXXXXXXXXXXXXXXXGXXXXXXXXXXXXXXXXXXX,0,300,0
42588,14,1,13,41,245,0,0,257,196,61,GXXXXXXXXXXXXXXXXXXXGXXXXXXXXXXXXXXXXXXXGXXXXXXXXXXXXXXXXXXXGXXXXXXXXXXXXXXXXXXXGXXXXXXXXXXXXXXXXXXXGXXXXXXXXXXXXXXXXXXXGXXXXXXXXXXXXXXXXXXXGXXXXXXXXXXXXXXXXXXXGXXXXXXXXXXXXXXXXXXXGAXXXXXXXXXXXXXXXXXXGXXXXXXXXXXXXXXXXXXXGXXXXXXXXXXXXXXXXXXXGXXXXXXXXXXXXXXXXXXX,0,300,0
42609,14,1,13,43,243,0,0,255,197,58,GXXXXXXXXXXXXXXXXXXXGXXXXXXXXXXXXXXXXXXXGXXXXXXXXXXXXXXXXXXXGXXXXXXXXXXXXXXXXXXXGXXXXXXXXXXXXXXXXXXXGXXXXXXXXXXXXXXXXXXXGXXXXXXXXXXXXXXXXXXXGXXXXXXXXXXXXXXXXXXXGXXXXXXXXXXXXXXXXXXXGAXXXXXXXXXXXXXXXXXXGXXXXXXXXXXXXXXXXXXXGXXXXXXXXXXXXXXXXXXXGXXXXXXXXXXXXXXXXXXX,0,300,0

42630,14,1,13,39,247,0,0,259,199,60,GXXXXXXXXXXXXXXXXXXXGXXXXXXXXXXXXXXXXXXXGXXXXXXXXXXXXXXXXXXXGXXXXXXXXXXXXXXXXXXXGXXXXXXXXXXXXXXXXXXXGXXXXXXXXXXXXXXXXXXXGXXXXXXXXXXXXXXXXXXXGXXXXXXXXXXXXXXXXXXXGXXXXXXXXXXXXXXXXXXXGAXXXXXXXXXXXXXXXXXXGXXXXXXXXXXXXXXXXXXXGXXXXXXXXXXXXXXXXXXXGXXXXXXXXXXXXXXXXXXX,0,300,0
42651,14,1,13,39,247,0,0,259,198,61,GXXXXXXXXXXXXXXXXXXXGXXXXXXXXXXXXXXXXXXXGXXXXXXXXXXXXXXXXXXXGXXXXXXXXXXXXXXXXXXXGXXXXXXXXXXXXXXXXXXXGXXXXXXXXXXXXXXXXXXXGXXXXXXXXXXXXXXXXXXXGXXXXXXXXXXXXXXXXXXXGXXXXXXXXXXXXXXXXXXXGAXXXXXXXXXXXXXXXXXXGXXXXXXXXXXXXXXXXXXXGXXXXXXXXXXXXXXXXXXXGXXXXXXXXXXXXXXXXXXX,0,300,0
42672,14,1,13,37,249,0,0,261,198,63,GXXXXXXXXXXXXXXXXXXXGXXXXXXXXXXXXXXXXXXXGXXXXXXXXXXXXXXXXXXXGXXXXXXXXXXXXXXXXXXXGXXXXXXXXXXXXXXXXXXXGXXXXXXXXXXXXXXXXXXXGXXXXXXXXXXXXXXXXXXXGXXXXXXXXXXXXXXXXXXXGXXXXXXXXXXXXXXXXXXXGAXXXXXXXXXXXXXXXXXXGXXXXXXXXXXXXXXXXXXXGXXXXXXXXXXXXXXXXXXXGXXXXXXXXXXXXXXXXXXX,0,300,0
42693,14,1,13,35,251,0,0,263,196,67,GXXXXXXXXXXXXXXXXXXXGXXXXXXXXXXXXXXXXXXXGXXXXXXXXXXXXXXXXXXXGXXXXXXXXXXXXXXXXXXXGXXXXXXXXXXXXXXXXXXXGXXXXXXXXXXXXXXXXXXXGXXXXXXXXXXXXXXXXXXXGXXXXXXXXXXXXXXXXXXXGXXXXXXXXXXXXXXXXXXXGAXXXXXXXXXXXXXXXXXXGXXXXXXXXXXXXXXXXXXXGXXXXXXXXXXXXXXXXXXXGXXXXXXXXXXXXXXXXXXX,0,300,0
42714,14,1,13,35,251,0,0,263,198,65,GXXXXXXXXXXXXXXXXXXXGXXXXXXXXXXXXXXXXXXXGXXXXXXXXXXXXXXXXXXXGXXXXXXXXXXXXXXXXXXXGXXXXXXXXXXXXXXXXXXXGXXXXXXXXXXXXXXXXXXXGXXXXXXXXXXXXXXXXXXXGXXXXXXXXXXXXXXXXXXXGXXXXXXXXXXXXXXXXXXXGAXXXXXXXXXXXXXXXXXXGXXXXXXXXXXXXXXXXXXXGXXXXXXXXXXXXXXXXXXXGXXXXXXXXXXXXXXXXXXX,0,300,0

42735,14,0,14,37,249,0,0,261,200,61,GXXXXXXXXXXXXXXXXXXXGXXXXXXXXXXXXXXXXXXXGXXXXXXXXXXXXXXXXXXXGXXXXXXXXXXXXXXXXXXXGXXXXXXXXXXXXXXXXXXXGXXXXXXXXXXXXXXXXXXXGXXXXXXXXXXXXXXXXXXXGXXXXXXXXXXXXXXXXXXXGXXXXXXXXXXXXXXXXXXXGOXXXXXXXXXXXXXXXXXXGXXXXXXXXXXXXXXXXXXXGXXXXXXXXXXXXXXXXXXXGXXXXXXXXXXXXXXXXXXX,0,300,0
42756,13,0,13,35,252,0,0,264,201,63,GXXXXXXXXXXXXXXXXXXXGXXXXXXXXXXXXXXXXXXXGXXXXXXXXXXXXXXXXXXXGXXXXXXXXXXXXXXXXXXXGXXXXXXXXXXXXXXXXXXXGXXXXXXXXXXXXXXXXXXXGXXXXXXXXXXXXXXXXXXXGXXXXXXXXXXXXXXXXXXXGXXXXXXXXXXXXXXXXXXXGXXXXXXXXXXXXXXXXXXXGXXXXXXXXXXXXXXXXXXXGXXXXXXXXXXXXXXXXXXXGXXXXXXXXXXXXXXXXXXX,0,300,0
42777,13,0,13,36,251,0,0,263,201,62,GXXXXXXXXXXXXXXXXXXXGXXXXXXXXXXXXXXXXXXXGXXXXXXXXXXXXXXXXXXXGXXXXXXXXXXXXXXXXXXXGXXXXXXXXXXXXXXXXXXXGXXXXXXXXXXXXXXXXXXXGXXXXXXXXXXXXXXXXXXXGXXXXXXXXXXXXXXXXXXXGXXXXXXXXXXXXXXXXXXXGXXXXXXXXXXXXXXXXXXXGXXXXXXXXXXXXXXXXXXXGXXXXXXXXXXXXXXXXXXXGXXXXXXXXXXXXXXXXXXX,0,300,0
42798,13,0,13,37,250,0,0,262,198,64,GXXXXXXXXXXXXXXXXXXXGXXXXXXXXXXXXXXXXXXXGXXXXXXXXXXXXXXXXXXXGXXXXXXXXXXXXXXXXXXXGXXXXXXXXXXXXXXXXXXXGXXXXXXXXXXXXXXXXXXXGXXXXXXXXXXXXXXXXXXXGXXXXXXXXXXXXXXXXXXXGXXXXXXXXXXXXXXXXXXXGXXXXXXXXXXXXXXXXXXXGXXXXXXXXXXXXXXXXXXXGXXXXXXXXXXXXXXXXXXXGXXXXXXXXXXXXXXXXXXX,0,300,0
42819,13,0,13,34,253,0,0,264,200,64,GXXXXXXXXXXXXXXXXXXXGXXXXXXXXXXXXXXXXXXXGXXXXXXXXXXXXXXXXXXXGXXXXXXXXXXXXXXXXXXXGXXXXXXXXXXXXXXXXXXXGXXXXXXXXXXXXXXXXXXXGXXXXXXXXXXXXXXXXXXXGXXXXXXXXXXXXXXXXXXXGXXXXXXXXXXXXXXXXXXXGXXXXXXXXXXXXXXXXXXXGXXXXXXXXXXXXXXXXXXXGXXXXXXXXXXXXXXXXXXXGXXXXXXXXXXXXXXXXXXX,0,300,0

42840,13,0,13,36,251,0,0,263,201,62,GXXXXXXXXXXXXXXXXXXXGXXXXXXXXXXXXXXXXXXXGXXXXXXXXXXXXXXXXXXXGXXXXXXXXXXXXXXXXXXXGXXXXXXXXXXXXXXXXXXXGXXXXXXXXXXXXXXXXXXXGXXXXXXXXXXXXXXXXXXXGXXXXXXXXXXXXXXXXXXXGXXXXXXXXXXXXXXXXXXXGXXXXXXXXXXXXXXXXXXXGXXXXXXXXXXXXXXXXXXXGXXXXXXXXXXXXXXXXXXXGXXXXXXXXXXXXXXXXXXX,0,300,0
42861,13,0,13,40,247,0,0,259,201,58,GXXXXXXXXXXXXXXXXXXXGXXXXXXXXXXXXXXXXXXXGXXXXXXXXXXXXXXXXXXXGXXXXXXXXXXXXXXXXXXXGXXXXXXXXXXXXXXXXXXXGXXXXXXXXXXXXXXXXXXXGXXXXXXXXXXXXXXXXXXXGXXXXXXXXXXXXXXXXXXXGXXXXXXXXXXXXXXXXXXXGXXXXXXXXXXXXXXXXXXXGXXXXXXXXXXXXXXXXXXXGXXXXXXXXXXXXXXXXXXXGXXXXXXXXXXXXXXXXXXX,0,300,0
42882,13,0,13,38,249,0,0,261,202,59,GXXXXXXXXXXXXXXXXXXXGXXXXXXXXXXXXXXXXXXXGXXXXXXXXXXXXXXXXXXXGXXXXXXXXXXXXXXXXXXXGXXXXXXXXXXXXXXXXXXXGXXXXXXXXXXXXXXXXXXXGXXXXXXXXXXXXXXXXXXXGXXXXXXXXXXXXXXXXXXXGXXXXXXXXXXXXXXXXXXXGXXXXXXXXXXXXXXXXXXXGXXXXXXXXXXXXXXXXXXXGXXXXXXXXXXXXXXXXXXXGXXXXXXXXXXXXXXXXXXX,0,300,0
42903,14,1,13,37,249,0,0,261,205,56,GXXXXXXXXXXXXXXXXXXXGXXXXXXXXXXXXXXXXXXXGXXXXXXXXXXXXXXXXXXXGXXXXXXXXXXXXXXXXXXXGXXXXXXXXXXXXXXXXXXXGXXXXXXXXXXXXXXXXXXXGXXXXXXXXXXXXXXXXXXXGXXXXXXXXXXXXXXXXXXXGXXXXXXXXXXXXXXXXXXXGAXXXXXXXXXXXXXXXXXXGXXXXXXXXXXXXXXXXXXXGXXXXXXXXXXXXXXXXXXXGXXXXXXXXXXXXXXXXXXX,0,300,0
42924,14,0,14,37,249,0,0,261,206,55,GXXXXXXXXXXXXXXXXXXXGXXXXXXXXXXXXXXXXXXXGXXXXXXXXXXXXXXXXXXXGXXXXXXXXXXXXXXXXXXXGXXXXXXXXXXXXXXXXXXXGXXXXXXXXXXXXXXXXXXXGXXXXXXXXXXXXXXXXXXXGXXXXXXXXXXXXXXXXXXXGXXXXXXXXXXXXXXXXXXXGOXXXXXXXXXXXXXXXXXXGXXXXXXXXXXXXXXXXXXXGXXXXXXXXXXXXXXXXXXXGXXXXXXXXXXXXXXXXXXX,0,300,0

42945,14,0,14,40,246,0,0,259,202,57,GXXXXXXXXXXXXXXXXXXXGXXXXXXXXXXXXXXXXXXXGXXXXXXXXXXXXXXXXXXXGXXXXXXXXXXXXXXXXXXXGXXXXXXXXXXXXXXXXXXXGXXXXXXXXXXXXXXXXXXXGXXXXXXXXXXXXXXXXXXXGXXXXXXXXXXXXXXXXXXXGXXXXXXXXXXXXXXXXXXXGOXXXXXXXXXXXXXXXXXXGXXXXXXXXXXXXXXXXXXXGXXXXXXXXXXXXXXXXXXXGXXXXXXXXXXXXXXXXXXX,0,300,0
42966,13,0,13,36,251,0,0,263,203,60,GXXXXXXXXXXXXXXXXXXXGXXXXXXXXXXXXXXXXXXXGXXXXXXXXXXXXXXXXXXXGXXXXXXXXXXXXXXXXXXXGXXXXXXXXXXXXXXXXXXXGXXXXXXXXXXXXXXXXXXXGXXXXXXXXXXXXXXXXXXXGXXXXXXXXXXXXXXXXXXXGXXXXXXXXXXXXXXXXXXXGXXXXXXXXXXXXXXXXXXXGXXXXXXXXXXXXXXXXXXXGXXXXXXXXXXXXXXXXXXXGXXXXXXXXXXXXXXXXXXX,0,300,0
42987,13,0,13,37,250,0,0,261,203,58,GXXXXXXXXXXXXXXXXXXXGXXXXXXXXXXXXXXXXXXXGXXXXXXXXXXXXXXXXXXXGXXXXXXXXXXXXXXXXXXXGXXXXXXXXXXXXXXXXXXXGXXXXXXXXXXXXXXXXXXXGXXXXXXXXXXXXXXXXXXXGXXXXXXXXXXXXXXXXXXXGXXXXXXXXXXXXXXXXXXXGXXXXXXXXXXXXXXXXXXXGXXXXXXXXXXXXXXXXXXXGXXXXXXXXXXXXXXXXXXXGXXXXXXXXXXXXXXXXXXX,0,300,0
43008,13,0,13,40,247,0,0,259,203,56,GXXXXXXXXXXXXXXXXXXXGXXXXXXXXXXXXXXXXXXXGXXXXXXXXXXXXXXXXXXXGXXXXXXXXXXXXXXXXXXXGXXXXXXXXXXXXXXXXXXXGXXXXXXXXXXXXXXXXXXXGXXXXXXXXXXXXXXXXXXXGXXXXXXXXXXXXXXXXXXXGXXXXXXXXXXXXXXXXXXXGXXXXXXXXXXXXXXXXXXXGXXXXXXXXXXXXXXXXXXXGXXXXXXXXXXXXXXXXXXXGXXXXXXXXXXXXXXXXXXX,0,300,0
43029,13,0,13,39,248,0,0,260,205,55,GXXXXXXXXXXXXXXXXXXXGXXXXXXXXXXXXXXXXXXXGXXXXXXXXXXXXXXXXXXXGXXXXXXXXXXXXXXXXXXXGXXXXXXXXXXXXXXXXXXXGXXXXXXXXXXXXXXXXXXXGXXXXXXXXXXXXXXXXXXXGXXXXXXXXXXXXXXXXXXXGXXXXXXXXXXXXXXXXXXXGXXXXXXXXXXXXXXXXXXXGXXXXXXXXXXXXXXXXXXXGXXXXXXXXXXXXXXXXXXXGXXXXXXXXXXXXXXXXXXX,0,300,0

43050,13,0,13,42,245,0,0,257,200,57,GXXXXXXXXXXXXXXXXXXXGXXXXXXXXXXXXXXXXXXXGXXXXXXXXXXXXXXXXXXXGXXXXXXXXXXXXXXXXXXXGXXXXXXXXXXXXXXXXXXXGXXXXXXXXXXXXXXXXXXXGXXXXXXXXXXXXXXXXXXXGXXXXXXXXXXXXXXXXXXXGXXXXXXXXXXXXXXXXXXXGXXXXXXXXXXXXXXXXXXXGXXXXXXXXXXXXXXXXXXXGXXXXXXXXXXXXXXXXXXXGXXXXXXXXXXXXXXXXXXX,0,300,0
43071,14,1,13,38,248,0,0,260,200,60,GAXXXXXXXXXXXXXXXXXXGXXXXXXXXXXXXXXXXXXXGXXXXXXXXXXXXXXXXXXXGXXXXXXXXXXXXXXXXXXXGXXXXXXXXXXXXXXXXXXXGXXXXXXXXXXXXXXXXXXXGXXXXXXXXXXXXXXXXXXXGXXXXXXXXXXXXXXXXXXXGXXXXXXXXXXXXXXXXXXXGXXXXXXXXXXXXXXXXXXXGXXXXXXXXXXXXXXXXXXXGXXXXXXXXXXXXXXXXXXXGXXXXXXXXXXXXXXXXXXX,0,300,0
43092,14,1,13,37,249,0,0,261,201,60,GAXXXXXXXXXXXXXXXXXXGXXXXXXXXXXXXXXXXXXXGXXXXXXXXXXXXXXXXXXXGXXXXXXXXXXXXXXXXXXXGXXXXXXXXXXXXXXXXXXXGXXXXXXXXXXXXXXXXXXXGXXXXXXXXXXXXXXXXXXXGXXXXXXXXXXXXXXXXXXXGXXXXXXXXXXXXXXXXXXXGXXXXXXXXXXXXXXXXXXXGXXXXXXXXXXXXXXXXXXXGXXXXXXXXXXXXXXXXXXXGXXXXXXXXXXXXXXXXXXX,0,300,0
43113,14,0,14,38,248,0,0,260,200,60,GOXXXXXXXXXXXXXXXXXXGXXXXXXXXXXXXXXXXXXXGXXXXXXXXXXXXXXXXXXXGXXXXXXXXXXXXXXXXXXXGXXXXXXXXXXXXXXXXXXXGXXXXXXXXXXXXXXXXXXXGXXXXXXXXXXXXXXXXXXXGXXXXXXXXXXXXXXXXXXXGXXXXXXXXXXXXXXXXXXXGXXXXXXXXXXXXXXXXXXXGXXXXXXXXXXXXXXXXXXXGXXXXXXXXXXXXXXXXXXXGXXXXXXXXXXXXXXXXXXX,0,300,0
43134,15,1,14,37,248,0,0,260,203,57,GOXXXXXXXXXXXXXXXXXXGXXXXXXXXXXXXXXXXXXXGXXXXXXXXXXXXXXXXXXXGXXXXXXXXXXXXXXXXXXXGXXXXXXXXXXXXXXXXXXXGXXXXXXXXXXXXXXXXXXXGXXXXXXXXXXXXXXXXXXXGXXXXXXXXXXXXXXXXXXXGXXXXXXXXXXXXXXXXXXXGXXXXXXXXXXXXXXXXXXXGXXXXXXXXXXXXXXXXXXXGAXXXXXXXXXXXXXXXXXXGXXXXXXXXXXXXXXXXXXX,0,300,0

43155,14,1,13,34,252,0,0,264,203,61,GXXXXXXXXXXXXXXXXXXXGXXXXXXXXXXXXXXXXXXXGXXXXXXXXXXXXXXXXXXXGXXXXXXXXXXXXXXXXXXXGXXXXXXXXXXXXXXXXXXXGXXXXXXXXXXXXXXXXXXXGXXXXXXXXXXXXXXXXXXXGXXXXXXXXXXXXXXXXXXXGXXXXXXXXXXXXXXXXXXXGXXXXXXXXXXXXXXXXXXXGXXXXXXXXXXXXXXXXXXXGAXXXXXXXXXXXXXXXXXXGXXXXXXXXXXXXXXXXXXX,0,300,0
43176,14,1,13,34,252,0,0,264,200,64,GXXXXXXXXXXXXXXXXXXXGXXXXXXXXXXXXXXXXXXXGXXXXXXXXXXXXXXXXXXXGXXXXXXXXXXXXXXXXXXXGXXXXXXXXXXXXXXXXXXXGXXXXXXXXXXXXXXXXXXXGXXXXXXXXXXXXXXXXXXXGXXXXXXXXXXXXXXXXXXXGXXXXXXXXXXXXXXXXXXXGXXXXXXXXXXXXXXXXXXXGXXXXXXXXXXXXXXXXXXXGAXXXXXXXXXXXXXXXXXXGXXXXXXXXXXXXXXXXXXX,0,300,0
43197,14,1,13,30,256,0,0,268,201,67,GXXXXXXXXXXXXXXXXXXXGXXXXXXXXXXXXXXXXXXXGXXXXXXXXXXXXXXXXXXXGXXXXXXXXXXXXXXXXXXXGXXXXXXXXXXXXXXXXXXXGXXXXXXXXXXXXXXXXXXXGXXXXXXXXXXXXXXXXXXXGXXXXXXXXXXXXXXXXXXXGXXXXXXXXXXXXXXXXXXXGXXXXXXXXXXXXXXXXXXXGXXXXXXXXXXXXXXXXXXXGAXXXXXXXXXXXXXXXXXXGXXXXXXXXXXXXXXXXXXX,0,300,0
43218,14,1,13,30,256,0,0,268,201,67,GXXXXXXXXXXXXXXXXXXXGXXXXXXXXXXXXXXXXXXXGXXXXXXXXXXXXXXXXXXXGXXXXXXXXXXXXXXXXXXXGXXXXXXXXXXXXXXXXXXXGXXXXXXXXXXXXXXXXXXXGXXXXXXXXXXXXXXXXXXXGXXXXXXXXXXXXXXXXXXXGXXXXXXXXXXXXXXXXXXXGXXXXXXXXXXXXXXXXXXXGXXXXXXXXXXXXXXXXXXXGAXXXXXXXXXXXXXXXXXXGXXXXXXXXXXXXXXXXXXX,0,300,0
43239,14,1,13,31,255,0,0,267,202,65,GXXXXXXXXXXXXXXXXXXXGXXXXXXXXXXXXXXXXXXXGXXXXXXXXXXXXXXXXXXXGXXXXXXXXXXXXXXXXXXXGXXXXXXXXXXXXXXXXXXXGXXXXXXXXXXXXXXXXXXXGXXXXXXXXXXXXXXXXXXXGXXXXXXXXXXXXXXXXXXXGXXXXXXXXXXXXXXXXXXXGXXXXXXXXXXXXXXXXXXXGXXXXXXXXXXXXXXXXXXXGAXXXXXXXXXXXXXXXXXXGXXXXXXXXXXXXXXXXXXX,0,300,0

43260,14,1,13,27,259,0,0,271,205,66,GXXXXXXXXXXXXXXXXXXXGXXXXXXXXXXXXXXXXXXXGXXXXXXXXXXXXXXXXXXXGXXXXXXXXXXXXXXXXXXXGXXXXXXXXXXXXXXXXXXXGXXXXXXXXXXXXXXXXXXXGXXXXXXXXXXXXXXXXXXXGXXXXXXXXXXXXXXXXXXXGXXXXXXXXXXXXXXXXXXXGXXXXXXXXXXXXXXXXXXXGXXXXXXXXXXXXXXXXXXXGAXXXXXXXXXXXXXXXXXXGXXXXXXXXXXXXXXXXXXX,0,300,0
43281,14,1,13,32,254,0,0,267,202,65,GXXXXXXXXXXXXXXXXXXXGXXXXXXXXXXXXXXXXXXXGXXXXXXXXXXXXXXXXXXXGXXXXXXXXXXXXXXXXXXXGXXXXXXXXXXXXXXXXXXXGXXXXXXXXXXXXXXXXXXXGXXXXXXXXXXXXXXXXXXXGXXXXXXXXXXXXXXXXXXXGXXXXXXXXXXXXXXXXXXXGXXXXXXXXXXXXXXXXXXXGXXXXXXXXXXXXXXXXXXXGAXXXXXXXXXXXXXXXXXXGXXXXXXXXXXXXXXXXXXX,0,300,0
43302,14,1,13,32,254,0,0,266,203,63,GXXXXXXXXXXXXXXXXXXXGXXXXXXXXXXXXXXXXXXXGXXXXXXXXXXXXXXXXXXXGXXXXXXXXXXXXXXXXXXXGXXXXXXXXXXXXXXXXXXXGXXXXXXXXXXXXXXXXXXXGXXXXXXXXXXXXXXXXXXXGXXXXXXXXXXXXXXXXXXXGXXXXXXXXXXXXXXXXXXXGXXXXXXXXXXXXXXXXXXXGXXXXXXXXXXXXXXXXXXXGAXXXXXXXXXXXXXXXXXXGXXXXXXXXXXXXXXXXXXX,0,300,0
43323,13,0,13,33,254,0,0,267,201,66,GXXXXXXXXXXXXXXXXXXXGXXXXXXXXXXXXXXXXXXXGXXXXXXXXXXXXXXXXXXXGXXXXXXXXXXXXXXXXXXXGXXXXXXXXXXXXXXXXXXXGXXXXXXXXXXXXXXXXXXXGXXXXXXXXXXXXXXXXXXXGXXXXXXXXXXXXXXXXXXXGXXXXXXXXXXXXXXXXXXXGXXXXXXXXXXXXXXXXXXXGXXXXXXXXXXXXXXXXXXXGXXXXXXXXXXXXXXXXXXXGXXXXXXXXXXXXXXXXXXX,0,300,0
43344,13,0,13,37,250,0,0,263,200,63,GXXXXXXXXXXXXXXXXXXXGXXXXXXXXXXXXXXXXXXXGXXXXXXXXXXXXXXXXXXXGXXXXXXXXXXXXXXXXXXXGXXXXXXXXXXXXXXXXXXXGXXXXXXXXXXXXXXXXXXXGXXXXXXXXXXXXXXXXXXXGXXXXXXXXXXXXXXXXXXXGXXXXXXXXXXXXXXXXXXXGXXXXXXXXXXXXXXXXXXXGXXXXXXXXXXXXXXXXXXXGXXXXXXXXXXXXXXXXXXXGXXXXXXXXXXXXXXXXXXX,0,300,0

43365,13,0,13,38,249,0,0,262,197,65,GXXXXXXXXXXXXXXXXXXXGXXXXXXXXXXXXXXXXXXXGXXXXXXXXXXXXXXXXXXXGXXXXXXXXXXXXXXXXXXXGXXXXXXXXXXXXXXXXXXXGXXXXXXXXXXXXXXXXXXXGXXXXXXXXXXXXXXXXXXXGXXXXXXXXXXXXXXXXXXXGXXXXXXXXXXXXXXXXXXXGXXXXXXXXXXXXXXXXXXXGXXXXXXXXXXXXXXXXXXXGXXXXXXXXXXXXXXXXXXXGXXXXXXXXXXXXXXXXXXX,0,300,0
43386,14,1,13,34,252,0,0,264,198,66,GXXXXXXXXXXXXXXXXXXXGXXXXXXXXXXXXXXXXXXXGXXXXXXXXXXXXXXXXXXXGXXXXXXXXXXXXXXXXXXXGXXXXXXXXXXXXXXXXXXXGXXXXXXXXXXXXXXXXXXXGXXXXXXXXXXXXXXXXXXXGAXXXXXXXXXXXXXXXXXXGXXXXXXXXXXXXXXXXXXXGXXXXXXXXXXXXXXXXXXXGXXXXXXXXXXXXXXXXXXXGXXXXXXXXXXXXXXXXXXXGXXXXXXXXXXXXXXXXXXX,0,300,0
43407,14,1,13,28,258,0,0,269,200,69,GXXXXXXXXXXXXXXXXXXXGXXXXXXXXXXXXXXXXXXXGXXXXXXXXXXXXXXXXXXXGXXXXXXXXXXXXXXXXXXXGXXXXXXXXXXXXXXXXXXXGXXXXXXXXXXXXXXXXXXXGXXXXXXXXXXXXXXXXXXXGAXXXXXXXXXXXXXXXXXXGXXXXXXXXXXXXXXXXXXXGXXXXXXXXXXXXXXXXXXXGXXXXXXXXXXXXXXXXXXXGXXXXXXXXXXXXXXXXXXXGXXXXXXXXXXXXXXXXXXX,0,300,0
43428,14,1,13,28,258,0,0,270,202,68,GXXXXXXXXXXXXXXXXXXXGXXXXXXXXXXXXXXXXXXXGXXXXXXXXXXXXXXXXXXXGXXXXXXXXXXXXXXXXXXXGXXXXXXXXXXXXXXXXXXXGXXXXXXXXXXXXXXXXXXXGXXXXXXXXXXXXXXXXXXXGAXXXXXXXXXXXXXXXXXXGXXXXXXXXXXXXXXXXXXXGXXXXXXXXXXXXXXXXXXXGXXXXXXXXXXXXXXXXXXXGXXXXXXXXXXXXXXXXXXXGXXXXXXXXXXXXXXXXXXX,0,300,0
43449,14,1,13,27,259,0,0,271,200,71,GXXXXXXXXXXXXXXXXXXXGXXXXXXXXXXXXXXXXXXXGXXXXXXXXXXXXXXXXXXXGXXXXXXXXXXXXXXXXXXXGXXXXXXXXXXXXXXXXXXXGXXXXXXXXXXXXXXXXXXXGXXXXXXXXXXXXXXXXXXXGAXXXXXXXXXXXXXXXXXXGXXXXXXXXXXXXXXXXXXXGXXXXXXXXXXXXXXXXXXXGXXXXXXXXXXXXXXXXXXXGXXXXXXXXXXXXXXXXXXXGXXXXXXXXXXXXXXXXXXX,0,300,0

43470,14,1,13,30,256,0,0,268,201,67,GXXXXXXXXXXXXXXXXXXXGXXXXXXXXXXXXXXXXXXXGXXXXXXXXXXXXXXXXXXXGXXXXXXXXXXXXXXXXXXXGXXXXXXXXXXXXXXXXXXXGXXXXXXXXXXXXXXXXXXXGXXXXXXXXXXXXXXXXXXXGAXXXXXXXXXXXXXXXXXXGXXXXXXXXXXXXXXXXXXXGXXXXXXXXXXXXXXXXXXXGXXXXXXXXXXXXXXXXXXXGXXXXXXXXXXXXXXXXXXXGXXXXXXXXXXXXXXXXXXX,0,300,0
43491,14,1,13,31,255,0,0,267,203,64,GXXXXXXXXXXXXXXXXXXXGXXXXXXXXXXXXXXXXXXXGXXXXXXXXXXXXXXXXXXXGXXXXXXXXXXXXXXXXXXXGXXXXXXXXXXXXXXXXXXXGXXXXXXXXXXXXXXXXXXXGXXXXXXXXXXXXXXXXXXXGAXXXXXXXXXXXXXXXXXXGXXXXXXXXXXXXXXXXXXXGXXXXXXXXXXXXXXXXXXXGXXXXXXXXXXXXXXXXXXXGXXXXXXXXXXXXXXXXXXXGXXXXXXXXXXXXXXXXXXX,0,300,0
43512,14,1,13,33,253,0,0,265,203,62,GXXXXXXXXXXXXXXXXXXXGXXXXXXXXXXXXXXXXXXXGXXXXXXXXXXXXXXXXXXXGXXXXXXXXXXXXXXXXXXXGXXXXXXXXXXXXXXXXXXXGXXXXXXXXXXXXXXXXXXXGXXXXXXXXXXXXXXXXXXXGAXXXXXXXXXXXXXXXXXXGXXXXXXXXXXXXXXXXXXXGXXXXXXXXXXXXXXXXXXXGXXXXXXXXXXXXXXXXXXXGXXXXXXXXXXXXXXXXXXXGXXXXXXXXXXXXXXXXXXX,0,300,0
43533,14,1,13,37,249,0,0,261,202,59,GXXXXXXXXXXXXXXXXXXXGXXXXXXXXXXXXXXXXXXXGXXXXXXXXXXXXXXXXXXXGXXXXXXXXXXXXXXXXXXXGXXXXXXXXXXXXXXXXXXXGXXXXXXXXXXXXXXXXXXXGXXXXXXXXXXXXXXXXXXXGAXXXXXXXXXXXXXXXXXXGXXXXXXXXXXXXXXXXXXXGXXXXXXXXXXXXXXXXXXXGXXXXXXXXXXXXXXXXXXXGXXXXXXXXXXXXXXXXXXXGXXXXXXXXXXXXXXXXXXX,0,300,0
43554,14,1,13,37,249,0,0,261,201,60,GXXXXXXXXXXXXXXXXXXXGXXXXXXXXXXXXXXXXXXXGXXXXXXXXXXXXXXXXXXXGXXXXXXXXXXXXXXXXXXXGXXXXXXXXXXXXXXXXXXXGXXXXXXXXXXXXXXXXXXXGXXXXXXXXXXXXXXXXXXXGAXXXXXXXXXXXXXXXXXXGXXXXXXXXXXXXXXXXXXXGXXXXXXXXXXXXXXXXXXXGXXXXXXXXXXXXXXXXXXXGXXXXXXXXXXXXXXXXXXXGXXXXXXXXXXXXXXXXXXX,0,300,0

43575,14,1,13,38,248,0,0,260,199,61,GXXXXXXXXXXXXXXXXXXXGXXXXXXXXXXXXXXXXXXXGXXXXXXXXXXXXXXXXXXXGXXXXXXXXXXXXXXXXXXXGXXXXXXXXXXXXXXXXXXXGXXXXXXXXXXXXXXXXXXXGXXXXXXXXXXXXXXXXXXXGAXXXXXXXXXXXXXXXXXXGXXXXXXXXXXXXXXXXXXXGXXXXXXXXXXXXXXXXXXXGXXXXXXXXXXXXXXXXXXXGXXXXXXXXXXXXXXXXXXXGXXXXXXXXXXXXXXXXXXX,0,300,0
43596,14,1,13,35,251,0,0,263,198,65,GXXXXXXXXXXXXXXXXXXXGXXXXXXXXXXXXXXXXXXXGXXXXXXXXXXXXXXXXXXXGXXXXXXXXXXXXXXXXXXXGXXXXXXXXXXXXXXXXXXXGXXXXXXXXXXXXXXXXXXXGXXXXXXXXXXXXXXXXXXXGAXXXXXXXXXXXXXXXXXXGXXXXXXXXXXXXXXXXXXXGXXXXXXXXXXXXXXXXXXXGXXXXXXXXXXXXXXXXXXXGXXXXXXXXXXXXXXXXXXXGXXXXXXXXXXXXXXXXXXX,0,300,0
43617,14,1,13,36,250,0,0,262,200,62,GXXXXXXXXXXXXXXXXXXXGXXXXXXXXXXXXXXXXXXXGXXXXXXXXXXXXXXXXXXXGXXXXXXXXXXXXXXXXXXXGXXXXXXXXXXXXXXXXXXXGXXXXXXXXXXXXXXXXXXXGXXXXXXXXXXXXXXXXXXXGAXXXXXXXXXXXXXXXXXXGXXXXXXXXXXXXXXXXXXXGXXXXXXXXXXXXXXXXXXXGXXXXXXXXXXXXXXXXXXXGXXXXXXXXXXXXXXXXXXXGXXXXXXXXXXXXXXXXXXX,0,300,0
43638,13,0,13,32,255,0,0,267,203,64,GXXXXXXXXXXXXXXXXXXXGXXXXXXXXXXXXXXXXXXXGXXXXXXXXXXXXXXXXXXXGXXXXXXXXXXXXXXXXXXXGXXXXXXXXXXXXXXXXXXXGXXXXXXXXXXXXXXXXXXXGXXXXXXXXXXXXXXXXXXXGXXXXXXXXXXXXXXXXXXXGXXXXXXXXXXXXXXXXXXXGXXXXXXXXXXXXXXXXXXXGXXXXXXXXXXXXXXXXXXXGXXXXXXXXXXXXXXXXXXXGXXXXXXXXXXXXXXXXXXX,0,300,0
43659,13,0,13,28,259,0,0,271,206,65,GXXXXXXXXXXXXXXXXXXXGXXXXXXXXXXXXXXXXXXXGXXXXXXXXXXXXXXXXXXXGXXXXXXXXXXXXXXXXXXXGXXXXXXXXXXXXXXXXXXXGXXXXXXXXXXXXXXXXXXXGXXXXXXXXXXXXXXXXXXXGXXXXXXXXXXXXXXXXXXXGXXXXXXXXXXXXXXXXXXXGXXXXXXXXXXXXXXXXXXXGXXXXXXXXXXXXXXXXXXXGXXXXXXXXXXXXXXXXXXXGXXXXXXXXXXXXXXXXXXX,0,300,0

43680,13,0,13,29,258,0,0,270,205,65,GXXXXXXXXXXXXXXXXXXXGXXXXXXXXXXXXXXXXXXXGXXXXXXXXXXXXXXXXXXXGXXXXXXXXXXXXXXXXXXXGXXXXXXXXXXXXXXXXXXXGXXXXXXXXXXXXXXXXXXXGXXXXXXXXXXXXXXXXXXXGXXXXXXXXXXXXXXXXXXXGXXXXXXXXXXXXXXXXXXXGXXXXXXXXXXXXXXXXXXXGXXXXXXXXXXXXXXXXXXXGXXXXXXXXXXXXXXXXXXXGXXXXXXXXXXXXXXXXXXX,0,300,0
43701,13,0,13,29,258,0,0,270,203,67,GXXXXXXXXXXXXXXXXXXXGXXXXXXXXXXXXXXXXXXXGXXXXXXXXXXXXXXXXXXXGXXXXXXXXXXXXXXXXXXXGXXXXXXXXXXXXXXXXXXXGXXXXXXXXXXXXXXXXXXXGXXXXXXXXXXXXXXXXXXXGXXXXXXXXXXXXXXXXXXXGXXXXXXXXXXXXXXXXXXXGXXXXXXXXXXXXXXXXXXXGXXXXXXXXXXXXXXXXXXXGXXXXXXXXXXXXXXXXXXXGXXXXXXXXXXXXXXXXXXX,0,300,0
43722,13,0,13,32,255,0,0,267,205,62,GXXXXXXXXXXXXXXXXXXXGXXXXXXXXXXXXXXXXXXXGXXXXXXXXXXXXXXXXXXXGXXXXXXXXXXXXXXXXXXXGXXXXXXXXXXXXXXXXXXXGXXXXXXXXXXXXXXXXXXXGXXXXXXXXXXXXXXXXXXXGXXXXXXXXXXXXXXXXXXXGXXXXXXXXXXXXXXXXXXXGXXXXXXXXXXXXXXXXXXXGXXXXXXXXXXXXXXXXXXXGXXXXXXXXXXXXXXXXXXXGXXXXXXXXXXXXXXXXXXX,0,300,0
43743,13,0,13,32,255,0,0,267,204,63,GXXXXXXXXXXXXXXXXXXXGXXXXXXXXXXXXXXXXXXXGXXXXXXXXXXXXXXXXXXXGXXXXXXXXXXXXXXXXXXXGXXXXXXXXXXXXXXXXXXXGXXXXXXXXXXXXXXXXXXXGXXXXXXXXXXXXXXXXXXXGXXXXXXXXXXXXXXXXXXXGXXXXXXXXXXXXXXXXXXXGXXXXXXXXXXXXXXXXXXXGXXXXXXXXXXXXXXXXXXXGXXXXXXXXXXXXXXXXXXXGXXXXXXXXXXXXXXXXXXX,0,300,0
43764,13,0,13,32,255,0,0,266,201,65,GXXXXXXXXXXXXXXXXXXXGXXXXXXXXXXXXXXXXXXXGXXXXXXXXXXXXXXXXXXXGXXXXXXXXXXXXXXXXXXXGXXXXXXXXXXXXXXXXXXXGXXXXXXXXXXXXXXXXXXXGXXXXXXXXXXXXXXXXXXXGXXXXXXXXXXXXXXXXXXXGXXXXXXXXXXXXXXXXXXXGXXXXXXXXXXXXXXXXXXXGXXXXXXXXXXXXXXXXXXXGXXXXXXXXXXXXXXXXXXXGXXXXXXXXXXXXXXXXXXX,0,300,0

43785,13,0,13,33,254,0,0,266,199,67,GXXXXXXXXXXXXXXXXXXXGXXXXXXXXXXXXXXXXXXXGXXXXXXXXXXXXXXXXXXXGXXXXXXXXXXXXXXXXXXXGXXXXXXXXXXXXXXXXXXXGXXXXXXXXXXXXXXXXXXXGXXXXXXXXXXXXXXXXXXXGXXXXXXXXXXXXXXXXXXXGXXXXXXXXXXXXXXXXXXXGXXXXXXXXXXXXXXXXXXXGXXXXXXXXXXXXXXXXXXXGXXXXXXXXXXXXXXXXXXXGXXXXXXXXXXXXXXXXXXX,0,300,0
43806,13,0,13,36,251,0,0,263,200,63,GXXXXXXXXXXXXXXXXXXXGXXXXXXXXXXXXXXXXXXXGXXXXXXXXXXXXXXXXXXXGXXXXXXXXXXXXXXXXXXXGXXXXXXXXXXXXXXXXXXXGXXXXXXXXXXXXXXXXXXXGXXXXXXXXXXXXXXXXXXXGXXXXXXXXXXXXXXXXXXXGXXXXXXXXXXXXXXXXXXXGXXXXXXXXXXXXXXXXXXXGXXXXXXXXXXXXXXXXXXXGXXXXXXXXXXXXXXXXXXXGXXXXXXXXXXXXXXXXXXX,0,300,0
43827,14,1,13,39,247,0,0,259,205,54,GXXXXXXXXXXXXXXXXXXXGXXXXXXXXXXXXXXXXXXXGXXXXXXXXXXXXXXXXXXXGXXXXXXXXXXXXXXXXXXXGXXXXXXXXXXXXXXXXXXXGXXXXXXXXXXXXXXXXXXXGXXXXXXXXXXXXXXXXXXXGXXXXXXXXXXXXXXXXXXXGXXXXXXXXXXXXXXXXXXXGXXXXXXXXXXXXXXXXXXXGAXXXXXXXXXXXXXXXXXXGXXXXXXXXXXXXXXXXXXXGXXXXXXXXXXXXXXXXXXX,0,300,0
43848,14,1,13,34,252,0,0,263,204,59,GXXXXXXXXXXXXXXXXXXXGXXXXXXXXXXXXXXXXXXXGXXXXXXXXXXXXXXXXXXXGXXXXXXXXXXXXXXXXXXXGXXXXXXXXXXXXXXXXXXXGXXXXXXXXXXXXXXXXXXXGXXXXXXXXXXXXXXXXXXXGXXXXXXXXXXXXXXXXXXXGXXXXXXXXXXXXXXXXXXXGXXXXXXXXXXXXXXXXXXXGAXXXXXXXXXXXXXXXXXXGXXXXXXXXXXXXXXXXXXXGXXXXXXXXXXXXXXXXXXX,0,300,0
43869,14,1,13,37,249,0,0,261,202,59,GXXXXXXXXXXXXXXXXXXXGXXXXXXXXXXXXXXXXXXXGXXXXXXXXXXXXXXXXXXXGXXXXXXXXXXXXXXXXXXXGXXXXXXXXXXXXXXXXXXXGXXXXXXXXXXXXXXXXXXXGXXXXXXXXXXXXXXXXXXXGXXXXXXXXXXXXXXXXXXXGXXXXXXXXXXXXXXXXXXXGXXXXXXXXXXXXXXXXXXXGAXXXXXXXXXXXXXXXXXXGXXXXXXXXXXXXXXXXXXXGXXXXXXXXXXXXXXXXXXX,0,300,0

43890,14,1,13,40,246,0,0,257,198,59,GXXXXXXXXXXXXXXXXXXXGXXXXXXXXXXXXXXXXXXXGXXXXXXXXXXXXXXXXXXXGXXXXXXXXXXXXXXXXXXXGXXXXXXXXXXXXXXXXXXXGXXXXXXXXXXXXXXXXXXXGXXXXXXXXXXXXXXXXXXXGXXXXXXXXXXXXXXXXXXXGXXXXXXXXXXXXXXXXXXXGXXXXXXXXXXXXXXXXXXXGAXXXXXXXXXXXXXXXXXXGXXXXXXXXXXXXXXXXXXXGXXXXXXXXXXXXXXXXXXX,0,300,0
43911,14,1,13,36,250,0,0,262,203,59,GXXXXXXXXXXXXXXXXXXXGXXXXXXXXXXXXXXXXXXXGXXXXXXXXXXXXXXXXXXXGXXXXXXXXXXXXXXXXXXXGXXXXXXXXXXXXXXXXXXXGXXXXXXXXXXXXXXXXXXXGXXXXXXXXXXXXXXXXXXXGXXXXXXXXXXXXXXXXXXXGXXXXXXXXXXXXXXXXXXXGXXXXXXXXXXXXXXXXXXXGAXXXXXXXXXXXXXXXXXXGXXXXXXXXXXXXXXXXXXXGXXXXXXXXXXXXXXXXXXX,0,300,0
43932,14,1,13,34,252,0,0,264,205,59,GXXXXXXXXXXXXXXXXXXXGXXXXXXXXXXXXXXXXXXXGXXXXXXXXXXXXXXXXXXXGXXXXXXXXXXXXXXXXXXXGXXXXXXXXXXXXXXXXXXXGXXXXXXXXXXXXXXXXXXXGXXXXXXXXXXXXXXXXXXXGXXXXXXXXXXXXXXXXXXXGXXXXXXXXXXXXXXXXXXXGXXXXXXXXXXXXXXXXXXXGAXXXXXXXXXXXXXXXXXXGXXXXXXXXXXXXXXXXXXXGXXXXXXXXXXXXXXXXXXX,0,300,0
43953,14,1,13,35,251,0,0,263,201,62,GXXXXXXXXXXXXXXXXXXXGXXXXXXXXXXXXXXXXXXXGXXXXXXXXXXXXXXXXXXXGXXXXXXXXXXXXXXXXXXXGXXXXXXXXXXXXXXXXXXXGXXXXXXXXXXXXXXXXXXXGXXXXXXXXXXXXXXXXXXXGXXXXXXXXXXXXXXXXXXXGXXXXXXXXXXXXXXXXXXXGXXXXXXXXXXXXXXXXXXXGAXXXXXXXXXXXXXXXXXXGXXXXXXXXXXXXXXXXXXXGXXXXXXXXXXXXXXXXXXX,0,300,0
43974,14,1,13,30,256,0,0,268,204,64,GXXXXXXXXXXXXXXXXXXXGXXXXXXXXXXXXXXXXXXXGXXXXXXXXXXXXXXXXXXXGXXXXXXXXXXXXXXXXXXXGXXXXXXXXXXXXXXXXXXXGXXXXXXXXXXXXXXXXXXXGXXXXXXXXXXXXXXXXXXXGXXXXXXXXXXXXXXXXXXXGXXXXXXXXXXXXXXXXXXXGXXXXXXXXXXXXXXXXXXXGAXXXXXXXXXXXXXXXXXXGXXXXXXXXXXXXXXXXXXXGXXXXXXXXXXXXXXXXXXX,0,300,0

43995,14,1,13,32,254,0,0,265,205,60,GXXXXXXXXXXXXXXXXXXXGXXXXXXXXXXXXXXXXXXXGXXXXXXXXXXXXXXXXXXXGXXXXXXXXXXXXXXXXXXXGXXXXXXXXXXXXXXXXXXXGXXXXXXXXXXXXXXXXXXXGXXXXXXXXXXXXXXXXXXXGXXXXXXXXXXXXXXXXXXXGXXXXXXXXXXXXXXXXXXXGXXXXXXXXXXXXXXXXXXXGAXXXXXXXXXXXXXXXXXXGXXXXXXXXXXXXXXXXXXXGXXXXXXXXXXXXXXXXXXX,0,300,0
44016,14,1,13,30,256,0,0,268,206,62,GXXXXXXXXXXXXXXXXXXXGXXXXXXXXXXXXXXXXXXXGXXXXXXXXXXXXXXXXXXXGXXXXXXXXXXXXXXXXXXXGXXXXXXXXXXXXXXXXXXXGXXXXXXXXXXXXXXXXXXXGXXXXXXXXXXXXXXXXXXXGXXXXXXXXXXXXXXXXXXXGXXXXXXXXXXXXXXXXXXXGXXXXXXXXXXXXXXXXXXXGAXXXXXXXXXXXXXXXXXXGXXXXXXXXXXXXXXXXXXXGXXXXXXXXXXXXXXXXXXX,0,300,0
44037,14,1,13,34,252,0,0,264,201,63,GXXXXXXXXXXXXXXXXXXXGXXXXXXXXXXXXXXXXXXXGXXXXXXXXXXXXXXXXXXXGXXXXXXXXXXXXXXXXXXXGXXXXXXXXXXXXXXXXXXXGXXXXXXXXXXXXXXXXXXXGXXXXXXXXXXXXXXXXXXXGXXXXXXXXXXXXXXXXXXXGXXXXXXXXXXXXXXXXXXXGXXXXXXXXXXXXXXXXXXXGAXXXXXXXXXXXXXXXXXXGXXXXXXXXXXXXXXXXXXXGXXXXXXXXXXXXXXXXXXX,0,300,0
44058,14,1,13,31,255,0,0,266,202,64,GXXXXXXXXXXXXXXXXXXXGXXXXXXXXXXXXXXXXXXXGXXXXXXXXXXXXXXXXXXXGXXXXXXXXXXXXXXXXXXXGXXXXXXXXXXXXXXXXXXXGXXXXXXXXXXXXXXXXXXXGXXXXXXXXXXXXXXXXXXXGXXXXXXXXXXXXXXXXXXXGXXXXXXXXXXXXXXXXXXXGXXXXXXXXXXXXXXXXXXXGAXXXXXXXXXXXXXXXXXXGXXXXXXXXXXXXXXXXXXXGXXXXXXXXXXXXXXXXXXX,0,300,0
44079,14,1,13,32,254,0,0,265,201,64,GXXXXXXXXXXXXXXXXXXXGXXXXXXXXXXXXXXXXXXXGXXXXXXXXXXXXXXXXXXXGXXXXXXXXXXXXXXXXXXXGXXXXXXXXXXXXXXXXXXXGXXXXXXXXXXXXXXXXXXXGXXXXXXXXXXXXXXXXXXXGXXXXXXXXXXXXXXXXXXXGXXXXXXXXXXXXXXXXXXXGXXXXXXXXXXXXXXXXXXXGAXXXXXXXXXXXXXXXXXXGXXXXXXXXXXXXXXXXXXXGXXXXXXXXXXXXXXXXXXX,0,300,0

44100,14,1,13,28,258,0,0,270,203,67,GXXXXXXXXXXXXXXXXXXXGXXXXXXXXXXXXXXXXXXXGXXXXXXXXXXXXXXXXXXXGXXXXXXXXXXXXXXXXXXXGXXXXXXXXXXXXXXXXXXXGXXXXXXXXXXXXXXXXXXXGXXXXXXXXXXXXXXXXXXXGXXXXXXXXXXXXXXXXXXXGXXXXXXXXXXXXXXXXXXXGXXXXXXXXXXXXXXXXXXXGAXXXXXXXXXXXXXXXXXXGXXXXXXXXXXXXXXXXXXXGXXXXXXXXXXXXXXXXXXX,0,300,0
44121,14,1,13,28,258,0,0,270,206,64,GXXXXXXXXXXXXXXXXXXXGXXXXXXXXXXXXXXXXXXXGXXXXXXXXXXXXXXXXXXXGXXXXXXXXXXXXXXXXXXXGXXXXXXXXXXXXXXXXXXXGXXXXXXXXXXXXXXXXXXXGXXXXXXXXXXXXXXXXXXXGXXXXXXXXXXXXXXXXXXXGXXXXXXXXXXXXXXXXXXXGXXXXXXXXXXXXXXXXXXXGAXXXXXXXXXXXXXXXXXXGXXXXXXXXXXXXXXXXXXXGXXXXXXXXXXXXXXXXXXX,0,300,0
44142,14,1,13,30,256,0,0,268,201,67,GXXXXXXXXXXXXXXXXXXXGXXXXXXXXXXXXXXXXXXXGXXXXXXXXXXXXXXXXXXXGXXXXXXXXXXXXXXXXXXXGXXXXXXXXXXXXXXXXXXXGXXXXXXXXXXXXXXXXXXXGXXXXXXXXXXXXXXXXXXXGXXXXXXXXXXXXXXXXXXXGXXXXXXXXXXXXXXXXXXXGXXXXXXXXXXXXXXXXXXXGAXXXXXXXXXXXXXXXXXXGXXXXXXXXXXXXXXXXXXXGXXXXXXXXXXXXXXXXXXX,0,300,0
44163,14,1,13,29,257,0,0,269,201,68,GXXXXXXXXXXXXXXXXXXXGXXXXXXXXXXXXXXXXXXXGXXXXXXXXXXXXXXXXXXXGXXXXXXXXXXXXXXXXXXXGXXXXXXXXXXXXXXXXXXXGXXXXXXXXXXXXXXXXXXXGXXXXXXXXXXXXXXXXXXXGXXXXXXXXXXXXXXXXXXXGXXXXXXXXXXXXXXXXXXXGXXXXXXXXXXXXXXXXXXXGAXXXXXXXXXXXXXXXXXXGXXXXXXXXXXXXXXXXXXXGXXXXXXXXXXXXXXXXXXX,0,300,0
44184,14,1,13,28,258,0,0,270,199,71,GXXXXXXXXXXXXXXXXXXXGXXXXXXXXXXXXXXXXXXXGXXXXXXXXXXXXXXXXXXXGXXXXXXXXXXXXXXXXXXXGXXXXXXXXXXXXXXXXXXXGXXXXXXXXXXXXXXXXXXXGXXXXXXXXXXXXXXXXXXXGXXXXXXXXXXXXXXXXXXXGXXXXXXXXXXXXXXXXXXXGXXXXXXXXXXXXXXXXXXXGAXXXXXXXXXXXXXXXXXXGXXXXXXXXXXXXXXXXXXXGXXXXXXXXXXXXXXXXXXX,0,300,0

44205,14,1,13,28,258,0,0,270,198,72,GXXXXXXXXXXXXXXXXXXXGXXXXXXXXXXXXXXXXXXXGXXXXXXXXXXXXXXXXXXXGXXXXXXXXXXXXXXXXXXXGXXXXXXXXXXXXXXXXXXXGXXXXXXXXXXXXXXXXXXXGXXXXXXXXXXXXXXXXXXXGXXXXXXXXXXXXXXXXXXXGXXXXXXXXXXXXXXXXXXXGXXXXXXXXXXXXXXXXXXXGAXXXXXXXXXXXXXXXXXXGXXXXXXXXXXXXXXXXXXXGXXXXXXXXXXXXXXXXXXX,0,300,0
44226,13,0,13,29,258,0,0,270,199,71,GXXXXXXXXXXXXXXXXXXXGXXXXXXXXXXXXXXXXXXXGXXXXXXXXXXXXXXXXXXXGXXXXXXXXXXXXXXXXXXXGXXXXXXXXXXXXXXXXXXXGXXXXXXXXXXXXXXXXXXXGXXXXXXXXXXXXXXXXXXXGXXXXXXXXXXXXXXXXXXXGXXXXXXXXXXXXXXXXXXXGXXXXXXXXXXXXXXXXXXXGXXXXXXXXXXXXXXXXXXXGXXXXXXXXXXXXXXXXXXXGXXXXXXXXXXXXXXXXXXX,0,300,0
44247,13,0,13,26,261,0,0,272,203,69,GXXXXXXXXXXXXXXXXXXXGXXXXXXXXXXXXXXXXXXXGXXXXXXXXXXXXXXXXXXXGXXXXXXXXXXXXXXXXXXXGXXXXXXXXXXXXXXXXXXXGXXXXXXXXXXXXXXXXXXXGXXXXXXXXXXXXXXXXXXXGXXXXXXXXXXXXXXXXXXXGXXXXXXXXXXXXXXXXXXXGXXXXXXXXXXXXXXXXXXXGXXXXXXXXXXXXXXXXXXXGXXXXXXXXXXXXXXXXXXXGXXXXXXXXXXXXXXXXXXX,0,300,0
44268,13,0,13,30,257,0,0,269,203,66,GXXXXXXXXXXXXXXXXXXXGXXXXXXXXXXXXXXXXXXXGXXXXXXXXXXXXXXXXXXXGXXXXXXXXXXXXXXXXXXXGXXXXXXXXXXXXXXXXXXXGXXXXXXXXXXXXXXXXXXXGXXXXXXXXXXXXXXXXXXXGXXXXXXXXXXXXXXXXXXXGXXXXXXXXXXXXXXXXXXXGXXXXXXXXXXXXXXXXXXXGXXXXXXXXXXXXXXXXXXXGXXXXXXXXXXXXXXXXXXXGXXXXXXXXXXXXXXXXXXX,0,300,0
44289,13,0,13,29,258,0,0,270,206,64,GXXXXXXXXXXXXXXXXXXXGXXXXXXXXXXXXXXXXXXXGXXXXXXXXXXXXXXXXXXXGXXXXXXXXXXXXXXXXXXXGXXXXXXXXXXXXXXXXXXXGXXXXXXXXXXXXXXXXXXXGXXXXXXXXXXXXXXXXXXXGXXXXXXXXXXXXXXXXXXXGXXXXXXXXXXXXXXXXXXXGXXXXXXXXXXXXXXXXXXXGXXXXXXXXXXXXXXXXXXXGXXXXXXXXXXXXXXXXXXXGXXXXXXXXXXXXXXXXXXX,0,300,0

44310,13,0,13,32,255,0,0,267,206,61,GXXXXXXXXXXXXXXXXXXXGXXXXXXXXXXXXXXXXXXXGXXXXXXXXXXXXXXXXXXXGXXXXXXXXXXXXXXXXXXXGXXXXXXXXXXXXXXXXXXXGXXXXXXXXXXXXXXXXXXXGXXXXXXXXXXXXXXXXXXXGXXXXXXXXXXXXXXXXXXXGXXXXXXXXXXXXXXXXXXXGXXXXXXXXXXXXXXXXXXXGXXXXXXXXXXXXXXXXXXXGXXXXXXXXXXXXXXXXXXXGXXXXXXXXXXXXXXXXXXX,0,300,0
44331,13,0,13,35,252,0,0,264,202,62,GXXXXXXXXXXXXXXXXXXXGXXXXXXXXXXXXXXXXXXXGXXXXXXXXXXXXXXXXXXXGXXXXXXXXXXXXXXXXXXXGXXXXXXXXXXXXXXXXXXXGXXXXXXXXXXXXXXXXXXXGXXXXXXXXXXXXXXXXXXXGXXXXXXXXXXXXXXXXXXXGXXXXXXXXXXXXXXXXXXXGXXXXXXXXXXXXXXXXXXXGXXXXXXXXXXXXXXXXXXXGXXXXXXXXXXXXXXXXXXXGXXXXXXXXXXXXXXXXXXX,0,300,0
44352,13,0,13,33,254,0,0,266,205,61,GXXXXXXXXXXXXXXXXXXXGXXXXXXXXXXXXXXXXXXXGXXXXXXXXXXXXXXXXXXXGXXXXXXXXXXXXXXXXXXXGXXXXXXXXXXXXXXXXXXXGXXXXXXXXXXXXXXXXXXXGXXXXXXXXXXXXXXXXXXXGXXXXXXXXXXXXXXXXXXXGXXXXXXXXXXXXXXXXXXXGXXXXXXXXXXXXXXXXXXXGXXXXXXXXXXXXXXXXXXXGXXXXXXXXXXXXXXXXXXXGXXXXXXXXXXXXXXXXXXX,0,300,0
44373,13,0,13,34,253,0,0,264,206,58,GXXXXXXXXXXXXXXXXXXXGXXXXXXXXXXXXXXXXXXXGXXXXXXXXXXXXXXXXXXXGXXXXXXXXXXXXXXXXXXXGXXXXXXXXXXXXXXXXXXXGXXXXXXXXXXXXXXXXXXXGXXXXXXXXXXXXXXXXXXXGXXXXXXXXXXXXXXXXXXXGXXXXXXXXXXXXXXXXXXXGXXXXXXXXXXXXXXXXXXXGXXXXXXXXXXXXXXXXXXXGXXXXXXXXXXXXXXXXXXXGXXXXXXXXXXXXXXXXXXX,0,300,0
44394,13,0,13,36,251,0,0,263,207,56,GXXXXXXXXXXXXXXXXXXXGXXXXXXXXXXXXXXXXXXXGXXXXXXXXXXXXXXXXXXXGXXXXXXXXXXXXXXXXXXXGXXXXXXXXXXXXXXXXXXXGXXXXXXXXXXXXXXXXXXXGXXXXXXXXXXXXXXXXXXXGXXXXXXXXXXXXXXXXXXXGXXXXXXXXXXXXXXXXXXXGXXXXXXXXXXXXXXXXXXXGXXXXXXXXXXXXXXXXXXXGXXXXXXXXXXXXXXXXXXXGXXXXXXXXXXXXXXXXXXX,0,300,0

44415,13,0,13,36,251,0,0,263,202,61,GXXXXXXXXXXXXXXXXXXXGXXXXXXXXXXXXXXXXXXXGXXXXXXXXXXXXXXXXXXXGXXXXXXXXXXXXXXXXXXXGXXXXXXXXXXXXXXXXXXXGXXXXXXXXXXXXXXXXXXXGXXXXXXXXXXXXXXXXXXXGXXXXXXXXXXXXXXXXXXXGXXXXXXXXXXXXXXXXXXXGXXXXXXXXXXXXXXXXXXXGXXXXXXXXXXXXXXXXXXXGXXXXXXXXXXXXXXXXXXXGXXXXXXXXXXXXXXXXXXX,0,300,0
44436,13,0,13,36,251,0,0,263,202,61,GXXXXXXXXXXXXXXXXXXXGXXXXXXXXXXXXXXXXXXXGXXXXXXXXXXXXXXXXXXXGXXXXXXXXXXXXXXXXXXXGXXXXXXXXXXXXXXXXXXXGXXXXXXXXXXXXXXXXXXXGXXXXXXXXXXXXXXXXXXXGXXXXXXXXXXXXXXXXXXXGXXXXXXXXXXXXXXXXXXXGXXXXXXXXXXXXXXXXXXXGXXXXXXXXXXXXXXXXXXXGXXXXXXXXXXXXXXXXXXXGXXXXXXXXXXXXXXXXXXX,0,300,0
44457,13,0,13,33,254,0,0,266,209,57,GXXXXXXXXXXXXXXXXXXXGXXXXXXXXXXXXXXXXXXXGXXXXXXXXXXXXXXXXXXXGXXXXXXXXXXXXXXXXXXXGXXXXXXXXXXXXXXXXXXXGXXXXXXXXXXXXXXXXXXXGXXXXXXXXXXXXXXXXXXXGXXXXXXXXXXXXXXXXXXXGXXXXXXXXXXXXXXXXXXXGXXXXXXXXXXXXXXXXXXXGXXXXXXXXXXXXXXXXXXXGXXXXXXXXXXXXXXXXXXXGXXXXXXXXXXXXXXXXXXX,0,300,0
44478,13,0,13,41,246,0,0,257,200,57,GXXXXXXXXXXXXXXXXXXXGXXXXXXXXXXXXXXXXXXXGXXXXXXXXXXXXXXXXXXXGXXXXXXXXXXXXXXXXXXXGXXXXXXXXXXXXXXXXXXXGXXXXXXXXXXXXXXXXXXXGXXXXXXXXXXXXXXXXXXXGXXXXXXXXXXXXXXXXXXXGXXXXXXXXXXXXXXXXXXXGXXXXXXXXXXXXXXXXXXXGXXXXXXXXXXXXXXXXXXXGXXXXXXXXXXXXXXXXXXXGXXXXXXXXXXXXXXXXXXX,0,300,0
44499,13,0,13,39,248,0,0,259,203,56,GXXXXXXXXXXXXXXXXXXXGXXXXXXXXXXXXXXXXXXXGXXXXXXXXXXXXXXXXXXXGXXXXXXXXXXXXXXXXXXXGXXXXXXXXXXXXXXXXXXXGXXXXXXXXXXXXXXXXXXXGXXXXXXXXXXXXXXXXXXXGXXXXXXXXXXXXXXXXXXXGXXXXXXXXXXXXXXXXXXXGXXXXXXXXXXXXXXXXXXXGXXXXXXXXXXXXXXXXXXXGXXXXXXXXXXXXXXXXXXXGXXXXXXXXXXXXXXXXXXX,0,300,0

44520,13,0,13,40,247,0,0,258,206,52,GXXXXXXXXXXXXXXXXXXXGXXXXXXXXXXXXXXXXXXXGXXXXXXXXXXXXXXXXXXXGXXXXXXXXXXXXXXXXXXXGXXXXXXXXXXXXXXXXXXXGXXXXXXXXXXXXXXXXXXXGXXXXXXXXXXXXXXXXXXXGXXXXXXXXXXXXXXXXXXXGXXXXXXXXXXXXXXXXXXXGXXXXXXXXXXXXXXXXXXXGXXXXXXXXXXXXXXXXXXXGXXXXXXXXXXXXXXXXXXXGXXXXXXXXXXXXXXXXXXX,0,300,0
44541,13,0,13,40,247,0,0,259,206,53,GXXXXXXXXXXXXXXXXXXXGXXXXXXXXXXXXXXXXXXXGXXXXXXXXXXXXXXXXXXXGXXXXXXXXXXXXXXXXXXXGXXXXXXXXXXXXXXXXXXXGXXXXXXXXXXXXXXXXXXXGXXXXXXXXXXXXXXXXXXXGXXXXXXXXXXXXXXXXXXXGXXXXXXXXXXXXXXXXXXXGXXXXXXXXXXXXXXXXXXXGXXXXXXXXXXXXXXXXXXXGXXXXXXXXXXXXXXXXXXXGXXXXXXXXXXXXXXXXXXX,0,300,0
44562,13,0,13,43,244,0,0,256,202,54,GXXXXXXXXXXXXXXXXXXXGXXXXXXXXXXXXXXXXXXXGXXXXXXXXXXXXXXXXXXXGXXXXXXXXXXXXXXXXXXXGXXXXXXXXXXXXXXXXXXXGXXXXXXXXXXXXXXXXXXXGXXXXXXXXXXXXXXXXXXXGXXXXXXXXXXXXXXXXXXXGXXXXXXXXXXXXXXXXXXXGXXXXXXXXXXXXXXXXXXXGXXXXXXXXXXXXXXXXXXXGXXXXXXXXXXXXXXXXXXXGXXXXXXXXXXXXXXXXXXX,0,300,0
44583,13,0,13,37,250,0,0,262,204,58,GXXXXXXXXXXXXXXXXXXXGXXXXXXXXXXXXXXXXXXXGXXXXXXXXXXXXXXXXXXXGXXXXXXXXXXXXXXXXXXXGXXXXXXXXXXXXXXXXXXXGXXXXXXXXXXXXXXXXXXXGXXXXXXXXXXXXXXXXXXXGXXXXXXXXXXXXXXXXXXXGXXXXXXXXXXXXXXXXXXXGXXXXXXXXXXXXXXXXXXXGXXXXXXXXXXXXXXXXXXXGXXXXXXXXXXXXXXXXXXXGXXXXXXXXXXXXXXXXXXX,0,300,0
44604,13,0,13,37,250,0,0,262,202,60,GXXXXXXXXXXXXXXXXXXXGXXXXXXXXXXXXXXXXXXXGXXXXXXXXXXXXXXXXXXXGXXXXXXXXXXXXXXXXXXXGXXXXXXXXXXXXXXXXXXXGXXXXXXXXXXXXXXXXXXXGXXXXXXXXXXXXXXXXXXXGXXXXXXXXXXXXXXXXXXXGXXXXXXXXXXXXXXXXXXXGXXXXXXXXXXXXXXXXXXXGXXXXXXXXXXXXXXXXXXXGXXXXXXXXXXXXXXXXXXXGXXXXXXXXXXXXXXXXXXX,0,300,0

44625,13,0,13,35,252,0,0,264,201,63,GXXXXXXXXXXXXXXXXXXXGXXXXXXXXXXXXXXXXXXXGXXXXXXXXXXXXXXXXXXXGXXXXXXXXXXXXXXXXXXXGXXXXXXXXXXXXXXXXXXXGXXXXXXXXXXXXXXXXXXXGXXXXXXXXXXXXXXXXXXXGXXXXXXXXXXXXXXXXXXXGXXXXXXXXXXXXXXXXXXXGXXXXXXXXXXXXXXXXXXXGXXXXXXXXXXXXXXXXXXXGXXXXXXXXXXXXXXXXXXXGXXXXXXXXXXXXXXXXXXX,0,300,0
44646,13,0,13,38,249,0,0,262,201,61,GXXXXXXXXXXXXXXXXXXXGXXXXXXXXXXXXXXXXXXXGXXXXXXXXXXXXXXXXXXXGXXXXXXXXXXXXXXXXXXXGXXXXXXXXXXXXXXXXXXXGXXXXXXXXXXXXXXXXXXXGXXXXXXXXXXXXXXXXXXXGXXXXXXXXXXXXXXXXXXXGXXXXXXXXXXXXXXXXXXXGXXXXXXXXXXXXXXXXXXXGXXXXXXXXXXXXXXXXXXXGXXXXXXXXXXXXXXXXXXXGXXXXXXXXXXXXXXXXXXX,0,300,0
44667,13,0,13,33,254,0,0,268,204,64,GXXXXXXXXXXXXXXXXXXXGXXXXXXXXXXXXXXXXXXXGXXXXXXXXXXXXXXXXXXXGXXXXXXXXXXXXXXXXXXXGXXXXXXXXXXXXXXXXXXXGXXXXXXXXXXXXXXXXXXXGXXXXXXXXXXXXXXXXXXXGXXXXXXXXXXXXXXXXXXXGXXXXXXXXXXXXXXXXXXXGXXXXXXXXXXXXXXXXXXXGXXXXXXXXXXXXXXXXXXXGXXXXXXXXXXXXXXXXXXXGXXXXXXXXXXXXXXXXXXX,0,300,0
44688,13,0,13,33,254,0,0,268,203,65,GXXXXXXXXXXXXXXXXXXXGXXXXXXXXXXXXXXXXXXXGXXXXXXXXXXXXXXXXXXXGXXXXXXXXXXXXXXXXXXXGXXXXXXXXXXXXXXXXXXXGXXXXXXXXXXXXXXXXXXXGXXXXXXXXXXXXXXXXXXXGXXXXXXXXXXXXXXXXXXXGXXXXXXXXXXXXXXXXXXXGXXXXXXXXXXXXXXXXXXXGXXXXXXXXXXXXXXXXXXXGXXXXXXXXXXXXXXXXXXXGXXXXXXXXXXXXXXXXXXX,0,300,0
44709,13,0,13,34,253,0,0,268,200,68,GXXXXXXXXXXXXXXXXXXXGXXXXXXXXXXXXXXXXXXXGXXXXXXXXXXXXXXXXXXXGXXXXXXXXXXXXXXXXXXXGXXXXXXXXXXXXXXXXXXXGXXXXXXXXXXXXXXXXXXXGXXXXXXXXXXXXXXXXXXXGXXXXXXXXXXXXXXXXXXXGXXXXXXXXXXXXXXXXXXXGXXXXXXXXXXXXXXXXXXXGXXXXXXXXXXXXXXXXXXXGXXXXXXXXXXXXXXXXXXXGXXXXXXXXXXXXXXXXXXX,0,300,0

44730,13,0,13,34,253,0,0,267,200,67,GXXXXXXXXXXXXXXXXXXXGXXXXXXXXXXXXXXXXXXXGXXXXXXXXXXXXXXXXXXXGXXXXXXXXXXXXXXXXXXXGXXXXXXXXXXXXXXXXXXXGXXXXXXXXXXXXXXXXXXXGXXXXXXXXXXXXXXXXXXXGXXXXXXXXXXXXXXXXXXXGXXXXXXXXXXXXXXXXXXXGXXXXXXXXXXXXXXXXXXXGXXXXXXXXXXXXXXXXXXXGXXXXXXXXXXXXXXXXXXXGXXXXXXXXXXXXXXXXXXX,0,300,0
44751,13,0,13,33,254,0,0,269,199,70,GXXXXXXXXXXXXXXXXXXXGXXXXXXXXXXXXXXXXXXXGXXXXXXXXXXXXXXXXXXXGXXXXXXXXXXXXXXXXXXXGXXXXXXXXXXXXXXXXXXXGXXXXXXXXXXXXXXXXXXXGXXXXXXXXXXXXXXXXXXXGXXXXXXXXXXXXXXXXXXXGXXXXXXXXXXXXXXXXXXXGXXXXXXXXXXXXXXXXXXXGXXXXXXXXXXXXXXXXXXXGXXXXXXXXXXXXXXXXXXXGXXXXXXXXXXXXXXXXXXX,0,300,0
44772,13,0,13,30,257,0,0,271,201,70,GXXXXXXXXXXXXXXXXXXXGXXXXXXXXXXXXXXXXXXXGXXXXXXXXXXXXXXXXXXXGXXXXXXXXXXXXXXXXXXXGXXXXXXXXXXXXXXXXXXXGXXXXXXXXXXXXXXXXXXXGXXXXXXXXXXXXXXXXXXXGXXXXXXXXXXXXXXXXXXXGXXXXXXXXXXXXXXXXXXXGXXXXXXXXXXXXXXXXXXXGXXXXXXXXXXXXXXXXXXXGXXXXXXXXXXXXXXXXXXXGXXXXXXXXXXXXXXXXXXX,0,300,0
44793,13,0,13,33,254,0,0,268,205,63,GXXXXXXXXXXXXXXXXXXXGXXXXXXXXXXXXXXXXXXXGXXXXXXXXXXXXXXXXXXXGXXXXXXXXXXXXXXXXXXXGXXXXXXXXXXXXXXXXXXXGXXXXXXXXXXXXXXXXXXXGXXXXXXXXXXXXXXXXXXXGXXXXXXXXXXXXXXXXXXXGXXXXXXXXXXXXXXXXXXXGXXXXXXXXXXXXXXXXXXXGXXXXXXXXXXXXXXXXXXXGXXXXXXXXXXXXXXXXXXXGXXXXXXXXXXXXXXXXXXX,0,300,0
44814,13,0,13,32,255,0,0,269,202,67,GXXXXXXXXXXXXXXXXXXXGXXXXXXXXXXXXXXXXXXXGXXXXXXXXXXXXXXXXXXXGXXXXXXXXXXXXXXXXXXXGXXXXXXXXXXXXXXXXXXXGXXXXXXXXXXXXXXXXXXXGXXXXXXXXXXXXXXXXXXXGXXXXXXXXXXXXXXXXXXXGXXXXXXXXXXXXXXXXXXXGXXXXXXXXXXXXXXXXXXXGXXXXXXXXXXXXXXXXXXXGXXXXXXXXXXXXXXXXXXXGXXXXXXXXXXXXXXXXXXX,0,300,0

44835,13,0,13,32,255,0,0,269,204,65,GXXXXXXXXXXXXXXXXXXXGXXXXXXXXXXXXXXXXXXXGXXXXXXXXXXXXXXXXXXXGXXXXXXXXXXXXXXXXXXXGXXXXXXXXXXXXXXXXXXXGXXXXXXXXXXXXXXXXXXXGXXXXXXXXXXXXXXXXXXXGXXXXXXXXXXXXXXXXXXXGXXXXXXXXXXXXXXXXXXXGXXXXXXXXXXXXXXXXXXXGXXXXXXXXXXXXXXXXXXXGXXXXXXXXXXXXXXXXXXXGXXXXXXXXXXXXXXXXXXX,0,300,0
44856,13,0,13,31,256,0,0,270,208,62,GXXXXXXXXXXXXXXXXXXXGXXXXXXXXXXXXXXXXXXXGXXXXXXXXXXXXXXXXXXXGXXXXXXXXXXXXXXXXXXXGXXXXXXXXXXXXXXXXXXXGXXXXXXXXXXXXXXXXXXXGXXXXXXXXXXXXXXXXXXXGXXXXXXXXXXXXXXXXXXXGXXXXXXXXXXXXXXXXXXXGXXXXXXXXXXXXXXXXXXXGXXXXXXXXXXXXXXXXXXXGXXXXXXXXXXXXXXXXXXXGXXXXXXXXXXXXXXXXXXX,0,300,0
44877,13,0,13,32,255,0,0,269,207,62,GXXXXXXXXXXXXXXXXXXXGXXXXXXXXXXXXXXXXXXXGXXXXXXXXXXXXXXXXXXXGXXXXXXXXXXXXXXXXXXXGXXXXXXXXXXXXXXXXXXXGXXXXXXXXXXXXXXXXXXXGXXXXXXXXXXXXXXXXXXXGXXXXXXXXXXXXXXXXXXXGXXXXXXXXXXXXXXXXXXXGXXXXXXXXXXXXXXXXXXXGXXXXXXXXXXXXXXXXXXXGXXXXXXXXXXXXXXXXXXXGXXXXXXXXXXXXXXXXXXX,0,300,0
44898,13,0,13,30,257,0,0,270,210,60,GXXXXXXXXXXXXXXXXXXXGXXXXXXXXXXXXXXXXXXXGXXXXXXXXXXXXXXXXXXXGXXXXXXXXXXXXXXXXXXXGXXXXXXXXXXXXXXXXXXXGXXXXXXXXXXXXXXXXXXXGXXXXXXXXXXXXXXXXXXXGXXXXXXXXXXXXXXXXXXXGXXXXXXXXXXXXXXXXXXXGXXXXXXXXXXXXXXXXXXXGXXXXXXXXXXXXXXXXXXXGXXXXXXXXXXXXXXXXXXXGXXXXXXXXXXXXXXXXXXX,0,300,0
44919,13,0,13,31,256,0,0,269,207,62,GXXXXXXXXXXXXXXXXXXXGXXXXXXXXXXXXXXXXXXXGXXXXXXXXXXXXXXXXXXXGXXXXXXXXXXXXXXXXXXXGXXXXXXXXXXXXXXXXXXXGXXXXXXXXXXXXXXXXXXXGXXXXXXXXXXXXXXXXXXXGXXXXXXXXXXXXXXXXXXXGXXXXXXXXXXXXXXXXXXXGXXXXXXXXXXXXXXXXXXXGXXXXXXXXXXXXXXXXXXXGXXXXXXXXXXXXXXXXXXXGXXXXXXXXXXXXXXXXXXX,0,300,0

44940,13,0,13,34,253,0,0,266,205,61,GXXXXXXXXXXXXXXXXXXXGXXXXXXXXXXXXXXXXXXXGXXXXXXXXXXXXXXXXXXXGXXXXXXXXXXXXXXXXXXXGXXXXXXXXXXXXXXXXXXXGXXXXXXXXXXXXXXXXXXXGXXXXXXXXXXXXXXXXXXXGXXXXXXXXXXXXXXXXXXXGXXXXXXXXXXXXXXXXXXXGXXXXXXXXXXXXXXXXXXXGXXXXXXXXXXXXXXXXXXXGXXXXXXXXXXXXXXXXXXXGXXXXXXXXXXXXXXXXXXX,0,300,0
44961,13,0,13,34,253,0,0,266,204,62,GXXXXXXXXXXXXXXXXXXXGXXXXXXXXXXXXXXXXXXXGXXXXXXXXXXXXXXXXXXXGXXXXXXXXXXXXXXXXXXXGXXXXXXXXXXXXXXXXXXXGXXXXXXXXXXXXXXXXXXXGXXXXXXXXXXXXXXXXXXXGXXXXXXXXXXXXXXXXXXXGXXXXXXXXXXXXXXXXXXXGXXXXXXXXXXXXXXXXXXXGXXXXXXXXXXXXXXXXXXXGXXXXXXXXXXXXXXXXXXXGXXXXXXXXXXXXXXXXXXX,0,300,0
44982,13,0,13,37,250,0,0,263,206,57,GXXXXXXXXXXXXXXXXXXXGXXXXXXXXXXXXXXXXXXXGXXXXXXXXXXXXXXXXXXXGXXXXXXXXXXXXXXXXXXXGXXXXXXXXXXXXXXXXXXXGXXXXXXXXXXXXXXXXXXXGXXXXXXXXXXXXXXXXXXXGXXXXXXXXXXXXXXXXXXXGXXXXXXXXXXXXXXXXXXXGXXXXXXXXXXXXXXXXXXXGXXXXXXXXXXXXXXXXXXXGXXXXXXXXXXXXXXXXXXXGXXXXXXXXXXXXXXXXXXX,0,300,0
45003,14,1,13,36,250,0,0,263,210,53,GXXXXXXXXXXXXXXXXXXXGXXXXXXXXXXXXXXXXXXXGXXXXXXXXXXXXXXXXXXXGXXXXXXXXXXXXXXXXXXXGXXXXXXXXXXXXXXXXXXXGXXXXXXXXXXXXXXXXXXXGXXXXXXXXXXXXXXXXXXXGAXXXXXXXXXXXXXXXXXXGXXXXXXXXXXXXXXXXXXXGXXXXXXXXXXXXXXXXXXXGXXXXXXXXXXXXXXXXXXXGXXXXXXXXXXXXXXXXXXXGXXXXXXXXXXXXXXXXXXX,0,300,0
45024,14,1,13,39,247,0,0,260,206,54,GXXXXXXXXXXXXXXXXXXXGXXXXXXXXXXXXXXXXXXXGXXXXXXXXXXXXXXXXXXXGXXXXXXXXXXXXXXXXXXXGXXXXXXXXXXXXXXXXXXXGXXXXXXXXXXXXXXXXXXXGXXXXXXXXXXXXXXXXXXXGAXXXXXXXXXXXXXXXXXXGXXXXXXXXXXXXXXXXXXXGXXXXXXXXXXXXXXXXXXXGXXXXXXXXXXXXXXXXXXXGXXXXXXXXXXXXXXXXXXXGXXXXXXXXXXXXXXXXXXX,0,300,0

45045,14,1,13,41,245,0,0,258,203,55,GXXXXXXXXXXXXXXXXXXXGXXXXXXXXXXXXXXXXXXXGXXXXXXXXXXXXXXXXXXXGXXXXXXXXXXXXXXXXXXXGXXXXXXXXXXXXXXXXXXXGXXXXXXXXXXXXXXXXXXXGXXXXXXXXXXXXXXXXXXXGAXXXXXXXXXXXXXXXXXXGXXXXXXXXXXXXXXXXXXXGXXXXXXXXXXXXXXXXXXXGXXXXXXXXXXXXXXXXXXXGXXXXXXXXXXXXXXXXXXXGXXXXXXXXXXXXXXXXXXX,0,300,0
45066,14,1,13,38,248,0,0,261,204,57,GXXXXXXXXXXXXXXXXXXXGXXXXXXXXXXXXXXXXXXXGXXXXXXXXXXXXXXXXXXXGXXXXXXXXXXXXXXXXXXXGXXXXXXXXXXXXXXXXXXXGXXXXXXXXXXXXXXXXXXXGXXXXXXXXXXXXXXXXXXXGAXXXXXXXXXXXXXXXXXXGXXXXXXXXXXXXXXXXXXXGXXXXXXXXXXXXXXXXXXXGXXXXXXXXXXXXXXXXXXXGXXXXXXXXXXXXXXXXXXXGXXXXXXXXXXXXXXXXXXX,0,300,0
45087,14,1,13,37,249,0,0,260,203,57,GXXXXXXXXXXXXXXXXXXXGXXXXXXXXXXXXXXXXXXXGXXXXXXXXXXXXXXXXXXXGXXXXXXXXXXXXXXXXXXXGXXXXXXXXXXXXXXXXXXXGXXXXXXXXXXXXXXXXXXXGXXXXXXXXXXXXXXXXXXXGAXXXXXXXXXXXXXXXXXXGXXXXXXXXXXXXXXXXXXXGXXXXXXXXXXXXXXXXXXXGXXXXXXXXXXXXXXXXXXXGXXXXXXXXXXXXXXXXXXXGXXXXXXXXXXXXXXXXXXX,0,300,0
45108,14,1,13,35,251,0,0,263,203,60,GXXXXXXXXXXXXXXXXXXXGXXXXXXXXXXXXXXXXXXXGXXXXXXXXXXXXXXXXXXXGXXXXXXXXXXXXXXXXXXXGXXXXXXXXXXXXXXXXXXXGXXXXXXXXXXXXXXXXXXXGXXXXXXXXXXXXXXXXXXXGAXXXXXXXXXXXXXXXXXXGXXXXXXXXXXXXXXXXXXXGXXXXXXXXXXXXXXXXXXXGXXXXXXXXXXXXXXXXXXXGXXXXXXXXXXXXXXXXXXXGXXXXXXXXXXXXXXXXXXX,0,300,0
45129,14,1,13,36,250,0,0,262,202,60,GXXXXXXXXXXXXXXXXXXXGXXXXXXXXXXXXXXXXXXXGXXXXXXXXXXXXXXXXXXXGXXXXXXXXXXXXXXXXXXXGXXXXXXXXXXXXXXXXXXXGXXXXXXXXXXXXXXXXXXXGXXXXXXXXXXXXXXXXXXXGAXXXXXXXXXXXXXXXXXXGXXXXXXXXXXXXXXXXXXXGXXXXXXXXXXXXXXXXXXXGXXXXXXXXXXXXXXXXXXXGXXXXXXXXXXXXXXXXXXXGXXXXXXXXXXXXXXXXXXX,0,300,0

45150,14,1,13,37,249,0,0,260,200,60,GXXXXXXXXXXXXXXXXXXXGXXXXXXXXXXXXXXXXXXXGXXXXXXXXXXXXXXXXXXXGXXXXXXXXXXXXXXXXXXXGXXXXXXXXXXXXXXXXXXXGXXXXXXXXXXXXXXXXXXXGXXXXXXXXXXXXXXXXXXXGAXXXXXXXXXXXXXXXXXXGXXXXXXXXXXXXXXXXXXXGXXXXXXXXXXXXXXXXXXXGXXXXXXXXXXXXXXXXXXXGXXXXXXXXXXXXXXXXXXXGXXXXXXXXXXXXXXXXXXX,0,300,0
45171,14,1,13,39,247,0,0,259,199,60,GXXXXXXXXXXXXXXXXXXXGXXXXXXXXXXXXXXXXXXXGXXXXXXXXXXXXXXXXXXXGXXXXXXXXXXXXXXXXXXXGXXXXXXXXXXXXXXXXXXXGXXXXXXXXXXXXXXXXXXXGXXXXXXXXXXXXXXXXXXXGAXXXXXXXXXXXXXXXXXXGXXXXXXXXXXXXXXXXXXXGXXXXXXXXXXXXXXXXXXXGXXXXXXXXXXXXXXXXXXXGXXXXXXXXXXXXXXXXXXXGXXXXXXXXXXXXXXXXXXX,0,300,0
45192,14,1,13,37,249,0,0,261,200,61,GXXXXXXXXXXXXXXXXXXXGXXXXXXXXXXXXXXXXXXXGXXXXXXXXXXXXXXXXXXXGXXXXXXXXXXXXXXXXXXXGXXXXXXXXXXXXXXXXXXXGXXXXXXXXXXXXXXXXXXXGXXXXXXXXXXXXXXXXXXXGAXXXXXXXXXXXXXXXXXXGXXXXXXXXXXXXXXXXXXXGXXXXXXXXXXXXXXXXXXXGXXXXXXXXXXXXXXXXXXXGXXXXXXXXXXXXXXXXXXXGXXXXXXXXXXXXXXXXXXX,0,300,0
45213,14,1,13,37,249,0,0,261,203,58,GXXXXXXXXXXXXXXXXXXXGXXXXXXXXXXXXXXXXXXXGXXXXXXXXXXXXXXXXXXXGXXXXXXXXXXXXXXXXXXXGXXXXXXXXXXXXXXXXXXXGXXXXXXXXXXXXXXXXXXXGXXXXXXXXXXXXXXXXXXXGAXXXXXXXXXXXXXXXXXXGXXXXXXXXXXXXXXXXXXXGXXXXXXXXXXXXXXXXXXXGXXXXXXXXXXXXXXXXXXXGXXXXXXXXXXXXXXXXXXXGXXXXXXXXXXXXXXXXXXX,0,300,0
45234,14,1,13,36,250,0,0,262,203,59,GXXXXXXXXXXXXXXXXXXXGXXXXXXXXXXXXXXXXXXXGXXXXXXXXXXXXXXXXXXXGXXXXXXXXXXXXXXXXXXXGXXXXXXXXXXXXXXXXXXXGXXXXXXXXXXXXXXXXXXXGXXXXXXXXXXXXXXXXXXXGAXXXXXXXXXXXXXXXXXXGXXXXXXXXXXXXXXXXXXXGXXXXXXXXXXXXXXXXXXXGXXXXXXXXXXXXXXXXXXXGXXXXXXXXXXXXXXXXXXXGXXXXXXXXXXXXXXXXXXX,0,300,0

45255,14,1,13,37,249,0,0,261,200,61,GXXXXXXXXXXXXXXXXXXXGXXXXXXXXXXXXXXXXXXXGXXXXXXXXXXXXXXXXXXXGXXXXXXXXXXXXXXXXXXXGXXXXXXXXXXXXXXXXXXXGXXXXXXXXXXXXXXXXXXXGXXXXXXXXXXXXXXXXXXXGAXXXXXXXXXXXXXXXXXXGXXXXXXXXXXXXXXXXXXXGXXXXXXXXXXXXXXXXXXXGXXXXXXXXXXXXXXXXXXXGXXXXXXXXXXXXXXXXXXXGXXXXXXXXXXXXXXXXXXX,0,300,0
45276,14,0,14,40,246,0,0,258,199,59,GXXXXXXXXXXXXXXXXXXXGXXXXXXXXXXXXXXXXXXXGXXXXXXXXXXXXXXXXXXXGXXXXXXXXXXXXXXXXXXXGXXXXXXXXXXXXXXXXXXXGXXXXXXXXXXXXXXXXXXXGXXXXXXXXXXXXXXXXXXXGOXXXXXXXXXXXXXXXXXXGXXXXXXXXXXXXXXXXXXXGXXXXXXXXXXXXXXXXXXXGXXXXXXXXXXXXXXXXXXXGXXXXXXXXXXXXXXXXXXXGXXXXXXXXXXXXXXXXXXX,0,300,0
45297,14,0,14,36,250,0,0,262,200,62,GXXXXXXXXXXXXXXXXXXXGXXXXXXXXXXXXXXXXXXXGXXXXXXXXXXXXXXXXXXXGXXXXXXXXXXXXXXXXXXXGXXXXXXXXXXXXXXXXXXXGXXXXXXXXXXXXXXXXXXXGXXXXXXXXXXXXXXXXXXXGOXXXXXXXXXXXXXXXXXXGXXXXXXXXXXXXXXXXXXXGXXXXXXXXXXXXXXXXXXXGXXXXXXXXXXXXXXXXXXXGXXXXXXXXXXXXXXXXXXXGXXXXXXXXXXXXXXXXXXX,0,300,0
45318,13,0,13,32,255,0,0,267,201,66,GXXXXXXXXXXXXXXXXXXXGXXXXXXXXXXXXXXXXXXXGXXXXXXXXXXXXXXXXXXXGXXXXXXXXXXXXXXXXXXXGXXXXXXXXXXXXXXXXXXXGXXXXXXXXXXXXXXXXXXXGXXXXXXXXXXXXXXXXXXXGXXXXXXXXXXXXXXXXXXXGXXXXXXXXXXXXXXXXXXXGXXXXXXXXXXXXXXXXXXXGXXXXXXXXXXXXXXXXXXXGXXXXXXXXXXXXXXXXXXXGXXXXXXXXXXXXXXXXXXX,0,300,0
45339,13,0,13,32,255,0,0,267,203,64,GXXXXXXXXXXXXXXXXXXXGXXXXXXXXXXXXXXXXXXXGXXXXXXXXXXXXXXXXXXXGXXXXXXXXXXXXXXXXXXXGXXXXXXXXXXXXXXXXXXXGXXXXXXXXXXXXXXXXXXXGXXXXXXXXXXXXXXXXXXXGXXXXXXXXXXXXXXXXXXXGXXXXXXXXXXXXXXXXXXXGXXXXXXXXXXXXXXXXXXXGXXXXXXXXXXXXXXXXXXXGXXXXXXXXXXXXXXXXXXXGXXXXXXXXXXXXXXXXXXX,0,300,0

45360,13,0,13,31,256,0,0,268,202,66,GXXXXXXXXXXXXXXXXXXXGXXXXXXXXXXXXXXXXXXXGXXXXXXXXXXXXXXXXXXXGXXXXXXXXXXXXXXXXXXXGXXXXXXXXXXXXXXXXXXXGXXXXXXXXXXXXXXXXXXXGXXXXXXXXXXXXXXXXXXXGXXXXXXXXXXXXXXXXXXXGXXXXXXXXXXXXXXXXXXXGXXXXXXXXXXXXXXXXXXXGXXXXXXXXXXXXXXXXXXXGXXXXXXXXXXXXXXXXXXXGXXXXXXXXXXXXXXXXXXX,0,300,0
45381,13,0,13,31,256,0,0,268,203,65,GXXXXXXXXXXXXXXXXXXXGXXXXXXXXXXXXXXXXXXXGXXXXXXXXXXXXXXXXXXXGXXXXXXXXXXXXXXXXXXXGXXXXXXXXXXXXXXXXXXXGXXXXXXXXXXXXXXXXXXXGXXXXXXXXXXXXXXXXXXXGXXXXXXXXXXXXXXXXXXXGXXXXXXXXXXXXXXXXXXXGXXXXXXXXXXXXXXXXXXXGXXXXXXXXXXXXXXXXXXXGXXXXXXXXXXXXXXXXXXXGXXXXXXXXXXXXXXXXXXX,0,300,0
45402,13,0,13,33,254,0,0,266,199,67,GXXXXXXXXXXXXXXXXXXXGXXXXXXXXXXXXXXXXXXXGXXXXXXXXXXXXXXXXXXXGXXXXXXXXXXXXXXXXXXXGXXXXXXXXXXXXXXXXXXXGXXXXXXXXXXXXXXXXXXXGXXXXXXXXXXXXXXXXXXXGXXXXXXXXXXXXXXXXXXXGXXXXXXXXXXXXXXXXXXXGXXXXXXXXXXXXXXXXXXXGXXXXXXXXXXXXXXXXXXXGXXXXXXXXXXXXXXXXXXXGXXXXXXXXXXXXXXXXXXX,0,300,0
45423,13,0,13,33,254,0,0,266,199,67,GXXXXXXXXXXXXXXXXXXXGXXXXXXXXXXXXXXXXXXXGXXXXXXXXXXXXXXXXXXXGXXXXXXXXXXXXXXXXXXXGXXXXXXXXXXXXXXXXXXXGXXXXXXXXXXXXXXXXXXXGXXXXXXXXXXXXXXXXXXXGXXXXXXXXXXXXXXXXXXXGXXXXXXXXXXXXXXXXXXXGXXXXXXXXXXXXXXXXXXXGXXXXXXXXXXXXXXXXXXXGXXXXXXXXXXXXXXXXXXXGXXXXXXXXXXXXXXXXXXX,0,300,0
45444,13,0,13,30,257,0,0,269,203,66,GXXXXXXXXXXXXXXXXXXXGXXXXXXXXXXXXXXXXXXXGXXXXXXXXXXXXXXXXXXXGXXXXXXXXXXXXXXXXXXXGXXXXXXXXXXXXXXXXXXXGXXXXXXXXXXXXXXXXXXXGXXXXXXXXXXXXXXXXXXXGXXXXXXXXXXXXXXXXXXXGXXXXXXXXXXXXXXXXXXXGXXXXXXXXXXXXXXXXXXXGXXXXXXXXXXXXXXXXXXXGXXXXXXXXXXXXXXXXXXXGXXXXXXXXXXXXXXXXXXX,0,300,0

45465,13,0,13,25,262,0,0,274,204,70,GXXXXXXXXXXXXXXXXXXXGXXXXXXXXXXXXXXXXXXXGXXXXXXXXXXXXXXXXXXXGXXXXXXXXXXXXXXXXXXXGXXXXXXXXXXXXXXXXXXXGXXXXXXXXXXXXXXXXXXXGXXXXXXXXXXXXXXXXXXXGXXXXXXXXXXXXXXXXXXXGXXXXXXXXXXXXXXXXXXXGXXXXXXXXXXXXXXXXXXXGXXXXXXXXXXXXXXXXXXXGXXXXXXXXXXXXXXXXXXXGXXXXXXXXXXXXXXXXXXX,0,300,0
45486,13,0,13,27,260,0,0,272,201,71,GXXXXXXXXXXXXXXXXXXXGXXXXXXXXXXXXXXXXXXXGXXXXXXXXXXXXXXXXXXXGXXXXXXXXXXXXXXXXXXXGXXXXXXXXXXXXXXXXXXXGXXXXXXXXXXXXXXXXXXXGXXXXXXXXXXXXXXXXXXXGXXXXXXXXXXXXXXXXXXXGXXXXXXXXXXXXXXXXXXXGXXXXXXXXXXXXXXXXXXXGXXXXXXXXXXXXXXXXXXXGXXXXXXXXXXXXXXXXXXXGXXXXXXXXXXXXXXXXXXX,0,300,0
45507,13,0,13,26,261,0,0,273,202,71,GXXXXXXXXXXXXXXXXXXXGXXXXXXXXXXXXXXXXXXXGXXXXXXXXXXXXXXXXXXXGXXXXXXXXXXXXXXXXXXXGXXXXXXXXXXXXXXXXXXXGXXXXXXXXXXXXXXXXXXXGXXXXXXXXXXXXXXXXXXXGXXXXXXXXXXXXXXXXXXXGXXXXXXXXXXXXXXXXXXXGXXXXXXXXXXXXXXXXXXXGXXXXXXXXXXXXXXXXXXXGXXXXXXXXXXXXXXXXXXXGXXXXXXXXXXXXXXXXXXX,0,300,0
45528,13,0,13,23,264,0,0,275,203,72,GXXXXXXXXXXXXXXXXXXXGXXXXXXXXXXXXXXXXXXXGXXXXXXXXXXXXXXXXXXXGXXXXXXXXXXXXXXXXXXXGXXXXXXXXXXXXXXXXXXXGXXXXXXXXXXXXXXXXXXXGXXXXXXXXXXXXXXXXXXXGXXXXXXXXXXXXXXXXXXXGXXXXXXXXXXXXXXXXXXXGXXXXXXXXXXXXXXXXXXXGXXXXXXXXXXXXXXXXXXXGXXXXXXXXXXXXXXXXXXXGXXXXXXXXXXXXXXXXXXX,0,300,0
45549,13,0,13,24,263,0,0,275,209,66,GXXXXXXXXXXXXXXXXXXXGXXXXXXXXXXXXXXXXXXXGXXXXXXXXXXXXXXXXXXXGXXXXXXXXXXXXXXXXXXXGXXXXXXXXXXXXXXXXXXXGXXXXXXXXXXXXXXXXXXXGXXXXXXXXXXXXXXXXXXXGXXXXXXXXXXXXXXXXXXXGXXXXXXXXXXXXXXXXXXXGXXXXXXXXXXXXXXXXXXXGXXXXXXXXXXXXXXXXXXXGXXXXXXXXXXXXXXXXXXXGXXXXXXXXXXXXXXXXXXX,0,300,0

45570,13,0,13,29,258,0,0,270,205,65,GXXXXXXXXXXXXXXXXXXXGXXXXXXXXXXXXXXXXXXXGXXXXXXXXXXXXXXXXXXXGXXXXXXXXXXXXXXXXXXXGXXXXXXXXXXXXXXXXXXXGXXXXXXXXXXXXXXXXXXXGXXXXXXXXXXXXXXXXXXXGXXXXXXXXXXXXXXXXXXXGXXXXXXXXXXXXXXXXXXXGXXXXXXXXXXXXXXXXXXXGXXXXXXXXXXXXXXXXXXXGXXXXXXXXXXXXXXXXXXXGXXXXXXXXXXXXXXXXXXX,0,300,0
45591,13,0,13,32,255,0,0,267,203,64,GXXXXXXXXXXXXXXXXXXXGXXXXXXXXXXXXXXXXXXXGXXXXXXXXXXXXXXXXXXXGXXXXXXXXXXXXXXXXXXXGXXXXXXXXXXXXXXXXXXXGXXXXXXXXXXXXXXXXXXXGXXXXXXXXXXXXXXXXXXXGXXXXXXXXXXXXXXXXXXXGXXXXXXXXXXXXXXXXXXXGXXXXXXXXXXXXXXXXXXXGXXXXXXXXXXXXXXXXXXXGXXXXXXXXXXXXXXXXXXXGXXXXXXXXXXXXXXXXXXX,0,300,0
45612,13,0,13,34,253,0,0,265,204,61,GXXXXXXXXXXXXXXXXXXXGXXXXXXXXXXXXXXXXXXXGXXXXXXXXXXXXXXXXXXXGXXXXXXXXXXXXXXXXXXXGXXXXXXXXXXXXXXXXXXXGXXXXXXXXXXXXXXXXXXXGXXXXXXXXXXXXXXXXXXXGXXXXXXXXXXXXXXXXXXXGXXXXXXXXXXXXXXXXXXXGXXXXXXXXXXXXXXXXXXXGXXXXXXXXXXXXXXXXXXXGXXXXXXXXXXXXXXXXXXXGXXXXXXXXXXXXXXXXXXX,0,300,0
45633,13,0,13,33,254,0,0,266,202,64,GXXXXXXXXXXXXXXXXXXXGXXXXXXXXXXXXXXXXXXXGXXXXXXXXXXXXXXXXXXXGXXXXXXXXXXXXXXXXXXXGXXXXXXXXXXXXXXXXXXXGXXXXXXXXXXXXXXXXXXXGXXXXXXXXXXXXXXXXXXXGXXXXXXXXXXXXXXXXXXXGXXXXXXXXXXXXXXXXXXXGXXXXXXXXXXXXXXXXXXXGXXXXXXXXXXXXXXXXXXXGXXXXXXXXXXXXXXXXXXXGXXXXXXXXXXXXXXXXXXX,0,300,0
45654,13,0,13,34,253,0,0,265,203,62,GXXXXXXXXXXXXXXXXXXXGXXXXXXXXXXXXXXXXXXXGXXXXXXXXXXXXXXXXXXXGXXXXXXXXXXXXXXXXXXXGXXXXXXXXXXXXXXXXXXXGXXXXXXXXXXXXXXXXXXXGXXXXXXXXXXXXXXXXXXXGXXXXXXXXXXXXXXXXXXXGXXXXXXXXXXXXXXXXXXXGXXXXXXXXXXXXXXXXXXXGXXXXXXXXXXXXXXXXXXXGXXXXXXXXXXXXXXXXXXXGXXXXXXXXXXXXXXXXXXX,0,300,0

45675,13,0,13,33,254,0,0,266,204,62,GXXXXXXXXXXXXXXXXXXXGXXXXXXXXXXXXXXXXXXXGXXXXXXXXXXXXXXXXXXXGXXXXXXXXXXXXXXXXXXXGXXXXXXXXXXXXXXXXXXXGXXXXXXXXXXXXXXXXXXXGXXXXXXXXXXXXXXXXXXXGXXXXXXXXXXXXXXXXXXXGXXXXXXXXXXXXXXXXXXXGXXXXXXXXXXXXXXXXXXXGXXXXXXXXXXXXXXXXXXXGXXXXXXXXXXXXXXXXXXXGXXXXXXXXXXXXXXXXXXX,0,300,0
45696,13,0,13,33,254,0,0,266,205,61,GXXXXXXXXXXXXXXXXXXXGXXXXXXXXXXXXXXXXXXXGXXXXXXXXXXXXXXXXXXXGXXXXXXXXXXXXXXXXXXXGXXXXXXXXXXXXXXXXXXXGXXXXXXXXXXXXXXXXXXXGXXXXXXXXXXXXXXXXXXXGXXXXXXXXXXXXXXXXXXXGXXXXXXXXXXXXXXXXXXXGXXXXXXXXXXXXXXXXXXXGXXXXXXXXXXXXXXXXXXXGXXXXXXXXXXXXXXXXXXXGXXXXXXXXXXXXXXXXXXX,0,300,0
45717,13,0,13,30,257,0,0,269,206,63,GXXXXXXXXXXXXXXXXXXXGXXXXXXXXXXXXXXXXXXXGXXXXXXXXXXXXXXXXXXXGXXXXXXXXXXXXXXXXXXXGXXXXXXXXXXXXXXXXXXXGXXXXXXXXXXXXXXXXXXXGXXXXXXXXXXXXXXXXXXXGXXXXXXXXXXXXXXXXXXXGXXXXXXXXXXXXXXXXXXXGXXXXXXXXXXXXXXXXXXXGXXXXXXXXXXXXXXXXXXXGXXXXXXXXXXXXXXXXXXXGXXXXXXXXXXXXXXXXXXX,0,300,0
45738,13,0,13,37,250,0,0,262,202,60,GXXXXXXXXXXXXXXXXXXXGXXXXXXXXXXXXXXXXXXXGXXXXXXXXXXXXXXXXXXXGXXXXXXXXXXXXXXXXXXXGXXXXXXXXXXXXXXXXXXXGXXXXXXXXXXXXXXXXXXXGXXXXXXXXXXXXXXXXXXXGXXXXXXXXXXXXXXXXXXXGXXXXXXXXXXXXXXXXXXXGXXXXXXXXXXXXXXXXXXXGXXXXXXXXXXXXXXXXXXXGXXXXXXXXXXXXXXXXXXXGXXXXXXXXXXXXXXXXXXX,0,300,0
45759,13,0,13,35,252,0,0,264,204,60,GXXXXXXXXXXXXXXXXXXXGXXXXXXXXXXXXXXXXXXXGXXXXXXXXXXXXXXXXXXXGXXXXXXXXXXXXXXXXXXXGXXXXXXXXXXXXXXXXXXXGXXXXXXXXXXXXXXXXXXXGXXXXXXXXXXXXXXXXXXXGXXXXXXXXXXXXXXXXXXXGXXXXXXXXXXXXXXXXXXXGXXXXXXXXXXXXXXXXXXXGXXXXXXXXXXXXXXXXXXXGXXXXXXXXXXXXXXXXXXXGXXXXXXXXXXXXXXXXXXX,0,300,0

45780,13,0,13,35,252,0,0,264,203,61,GXXXXXXXXXXXXXXXXXXXGXXXXXXXXXXXXXXXXXXXGXXXXXXXXXXXXXXXXXXXGXXXXXXXXXXXXXXXXXXXGXXXXXXXXXXXXXXXXXXXGXXXXXXXXXXXXXXXXXXXGXXXXXXXXXXXXXXXXXXXGXXXXXXXXXXXXXXXXXXXGXXXXXXXXXXXXXXXXXXXGXXXXXXXXXXXXXXXXXXXGXXXXXXXXXXXXXXXXXXXGXXXXXXXXXXXXXXXXXXXGXXXXXXXXXXXXXXXXXXX,0,300,0
45801,13,0,13,36,251,0,0,263,205,58,GXXXXXXXXXXXXXXXXXXXGXXXXXXXXXXXXXXXXXXXGXXXXXXXXXXXXXXXXXXXGXXXXXXXXXXXXXXXXXXXGXXXXXXXXXXXXXXXXXXXGXXXXXXXXXXXXXXXXXXXGXXXXXXXXXXXXXXXXXXXGXXXXXXXXXXXXXXXXXXXGXXXXXXXXXXXXXXXXXXXGXXXXXXXXXXXXXXXXXXXGXXXXXXXXXXXXXXXXXXXGXXXXXXXXXXXXXXXXXXXGXXXXXXXXXXXXXXXXXXX,0,300,0
45822,13,0,13,39,248,0,0,260,205,55,GXXXXXXXXXXXXXXXXXXXGXXXXXXXXXXXXXXXXXXXGXXXXXXXXXXXXXXXXXXXGXXXXXXXXXXXXXXXXXXXGXXXXXXXXXXXXXXXXXXXGXXXXXXXXXXXXXXXXXXXGXXXXXXXXXXXXXXXXXXXGXXXXXXXXXXXXXXXXXXXGXXXXXXXXXXXXXXXXXXXGXXXXXXXXXXXXXXXXXXXGXXXXXXXXXXXXXXXXXXXGXXXXXXXXXXXXXXXXXXXGXXXXXXXXXXXXXXXXXXX,0,300,0
45843,13,0,13,39,248,0,0,260,201,59,GXXXXXXXXXXXXXXXXXXXGXXXXXXXXXXXXXXXXXXXGXXXXXXXXXXXXXXXXXXXGXXXXXXXXXXXXXXXXXXXGXXXXXXXXXXXXXXXXXXXGXXXXXXXXXXXXXXXXXXXGXXXXXXXXXXXXXXXXXXXGXXXXXXXXXXXXXXXXXXXGXXXXXXXXXXXXXXXXXXXGXXXXXXXXXXXXXXXXXXXGXXXXXXXXXXXXXXXXXXXGXXXXXXXXXXXXXXXXXXXGXXXXXXXXXXXXXXXXXXX,0,300,0
45864,13,0,13,36,251,0,0,263,206,57,GXXXXXXXXXXXXXXXXXXXGXXXXXXXXXXXXXXXXXXXGXXXXXXXXXXXXXXXXXXXGXXXXXXXXXXXXXXXXXXXGXXXXXXXXXXXXXXXXXXXGXXXXXXXXXXXXXXXXXXXGXXXXXXXXXXXXXXXXXXXGXXXXXXXXXXXXXXXXXXXGXXXXXXXXXXXXXXXXXXXGXXXXXXXXXXXXXXXXXXXGXXXXXXXXXXXXXXXXXXXGXXXXXXXXXXXXXXXXXXXGXXXXXXXXXXXXXXXXXXX,0,300,0

45885,13,0,13,33,254,0,0,265,204,61,GXXXXXXXXXXXXXXXXXXXGXXXXXXXXXXXXXXXXXXXGXXXXXXXXXXXXXXXXXXXGXXXXXXXXXXXXXXXXXXXGXXXXXXXXXXXXXXXXXXXGXXXXXXXXXXXXXXXXXXXGXXXXXXXXXXXXXXXXXXXGXXXXXXXXXXXXXXXXXXXGXXXXXXXXXXXXXXXXXXXGXXXXXXXXXXXXXXXXXXXGXXXXXXXXXXXXXXXXXXXGXXXXXXXXXXXXXXXXXXXGXXXXXXXXXXXXXXXXXXX,0,300,0
45906,13,0,13,29,258,0,0,269,204,65,GXXXXXXXXXXXXXXXXXXXGXXXXXXXXXXXXXXXXXXXGXXXXXXXXXXXXXXXXXXXGXXXXXXXXXXXXXXXXXXXGXXXXXXXXXXXXXXXXXXXGXXXXXXXXXXXXXXXXXXXGXXXXXXXXXXXXXXXXXXXGXXXXXXXXXXXXXXXXXXXGXXXXXXXXXXXXXXXXXXXGXXXXXXXXXXXXXXXXXXXGXXXXXXXXXXXXXXXXXXXGXXXXXXXXXXXXXXXXXXXGXXXXXXXXXXXXXXXXXXX,0,300,0
45927,13,0,13,30,257,0,0,269,208,61,GXXXXXXXXXXXXXXXXXXXGXXXXXXXXXXXXXXXXXXXGXXXXXXXXXXXXXXXXXXXGXXXXXXXXXXXXXXXXXXXGXXXXXXXXXXXXXXXXXXXGXXXXXXXXXXXXXXXXXXXGXXXXXXXXXXXXXXXXXXXGXXXXXXXXXXXXXXXXXXXGXXXXXXXXXXXXXXXXXXXGXXXXXXXXXXXXXXXXXXXGXXXXXXXXXXXXXXXXXXXGXXXXXXXXXXXXXXXXXXXGXXXXXXXXXXXXXXXXXXX,0,300,0
45948,13,0,13,38,249,0,0,261,201,60,GXXXXXXXXXXXXXXXXXXXGXXXXXXXXXXXXXXXXXXXGXXXXXXXXXXXXXXXXXXXGXXXXXXXXXXXXXXXXXXXGXXXXXXXXXXXXXXXXXXXGXXXXXXXXXXXXXXXXXXXGXXXXXXXXXXXXXXXXXXXGXXXXXXXXXXXXXXXXXXXGXXXXXXXXXXXXXXXXXXXGXXXXXXXXXXXXXXXXXXXGXXXXXXXXXXXXXXXXXXXGXXXXXXXXXXXXXXXXXXXGXXXXXXXXXXXXXXXXXXX,0,300,0
45969,13,0,13,34,253,0,0,265,202,63,GXXXXXXXXXXXXXXXXXXXGXXXXXXXXXXXXXXXXXXXGXXXXXXXXXXXXXXXXXXXGXXXXXXXXXXXXXXXXXXXGXXXXXXXXXXXXXXXXXXXGXXXXXXXXXXXXXXXXXXXGXXXXXXXXXXXXXXXXXXXGXXXXXXXXXXXXXXXXXXXGXXXXXXXXXXXXXXXXXXXGXXXXXXXXXXXXXXXXXXXGXXXXXXXXXXXXXXXXXXXGXXXXXXXXXXXXXXXXXXXGXXXXXXXXXXXXXXXXXXX,0,300,0

45990,13,0,13,32,255,0,0,267,201,66,GXXXXXXXXXXXXXXXXXXXGXXXXXXXXXXXXXXXXXXXGXXXXXXXXXXXXXXXXXXXGXXXXXXXXXXXXXXXXXXXGXXXXXXXXXXXXXXXXXXXGXXXXXXXXXXXXXXXXXXXGXXXXXXXXXXXXXXXXXXXGXXXXXXXXXXXXXXXXXXXGXXXXXXXXXXXXXXXXXXXGXXXXXXXXXXXXXXXXXXXGXXXXXXXXXXXXXXXXXXXGXXXXXXXXXXXXXXXXXXXGXXXXXXXXXXXXXXXXXXX,0,300,0
46011,13,0,13,31,256,0,0,268,203,65,GXXXXXXXXXXXXXXXXXXXGXXXXXXXXXXXXXXXXXXXGXXXXXXXXXXXXXXXXXXXGXXXXXXXXXXXXXXXXXXXGXXXXXXXXXXXXXXXXXXXGXXXXXXXXXXXXXXXXXXXGXXXXXXXXXXXXXXXXXXXGXXXXXXXXXXXXXXXXXXXGXXXXXXXXXXXXXXXXXXXGXXXXXXXXXXXXXXXXXXXGXXXXXXXXXXXXXXXXXXXGXXXXXXXXXXXXXXXXXXXGXXXXXXXXXXXXXXXXXXX,0,300,0
46032,13,0,13,32,255,0,0,267,206,61,GXXXXXXXXXXXXXXXXXXXGXXXXXXXXXXXXXXXXXXXGXXXXXXXXXXXXXXXXXXXGXXXXXXXXXXXXXXXXXXXGXXXXXXXXXXXXXXXXXXXGXXXXXXXXXXXXXXXXXXXGXXXXXXXXXXXXXXXXXXXGXXXXXXXXXXXXXXXXXXXGXXXXXXXXXXXXXXXXXXXGXXXXXXXXXXXXXXXXXXXGXXXXXXXXXXXXXXXXXXXGXXXXXXXXXXXXXXXXXXXGXXXXXXXXXXXXXXXXXXX,0,300,0
46053,14,1,13,35,251,0,0,263,204,59,GXXXXXXXXXXXXXXXXXXXGXXXXXXXXXXXXXXXXXXXGXXXXXXXXXXXXXXXXXXXGXXXXXXXXXXXXXXXXXXXGXXXXXXXXXXXXXXXXXXXGXXXXXXXXXXXXXXXXXXXGXXXXXXXXXXXXXXXXXXXGXXXXXXXXXXXXXXXXXXXGXXXXXXXXXXXXXXXXXXXGAXXXXXXXXXXXXXXXXXXGXXXXXXXXXXXXXXXXXXXGXXXXXXXXXXXXXXXXXXXGXXXXXXXXXXXXXXXXXXX,0,300,0
46074,14,1,13,33,253,0,0,265,204,61,GXXXXXXXXXXXXXXXXXXXGXXXXXXXXXXXXXXXXXXXGXXXXXXXXXXXXXXXXXXXGXXXXXXXXXXXXXXXXXXXGXXXXXXXXXXXXXXXXXXXGXXXXXXXXXXXXXXXXXXXGXXXXXXXXXXXXXXXXXXXGXXXXXXXXXXXXXXXXXXXGXXXXXXXXXXXXXXXXXXXGAXXXXXXXXXXXXXXXXXXGXXXXXXXXXXXXXXXXXXXGXXXXXXXXXXXXXXXXXXXGXXXXXXXXXXXXXXXXXXX,0,300,0

46095,14,0,14,31,255,0,0,266,203,63,GXXXXXXXXXXXXXXXXXXXGXXXXXXXXXXXXXXXXXXXGXXXXXXXXXXXXXXXXXXXGXXXXXXXXXXXXXXXXXXXGXXXXXXXXXXXXXXXXXXXGXXXXXXXXXXXXXXXXXXXGXXXXXXXXXXXXXXXXXXXGXXXXXXXXXXXXXXXXXXXGXXXXXXXXXXXXXXXXXXXGOXXXXXXXXXXXXXXXXXXGXXXXXXXXXXXXXXXXXXXGXXXXXXXXXXXXXXXXXXXGXXXXXXXXXXXXXXXXXXX,0,300,0
46116,13,0,13,32,255,0,0,267,205,62,GXXXXXXXXXXXXXXXXXXXGXXXXXXXXXXXXXXXXXXXGXXXXXXXXXXXXXXXXXXXGXXXXXXXXXXXXXXXXXXXGXXXXXXXXXXXXXXXXXXXGXXXXXXXXXXXXXXXXXXXGXXXXXXXXXXXXXXXXXXXGXXXXXXXXXXXXXXXXXXXGXXXXXXXXXXXXXXXXXXXGXXXXXXXXXXXXXXXXXXXGXXXXXXXXXXXXXXXXXXXGXXXXXXXXXXXXXXXXXXXGXXXXXXXXXXXXXXXXXXX,0,300,0
46137,13,0,13,29,258,0,0,270,205,65,GXXXXXXXXXXXXXXXXXXXGXXXXXXXXXXXXXXXXXXXGXXXXXXXXXXXXXXXXXXXGXXXXXXXXXXXXXXXXXXXGXXXXXXXXXXXXXXXXXXXGXXXXXXXXXXXXXXXXXXXGXXXXXXXXXXXXXXXXXXXGXXXXXXXXXXXXXXXXXXXGXXXXXXXXXXXXXXXXXXXGXXXXXXXXXXXXXXXXXXXGXXXXXXXXXXXXXXXXXXXGXXXXXXXXXXXXXXXXXXXGXXXXXXXXXXXXXXXXXXX,0,300,0
46158,13,0,13,31,256,0,0,268,204,64,GXXXXXXXXXXXXXXXXXXXGXXXXXXXXXXXXXXXXXXXGXXXXXXXXXXXXXXXXXXXGXXXXXXXXXXXXXXXXXXXGXXXXXXXXXXXXXXXXXXXGXXXXXXXXXXXXXXXXXXXGXXXXXXXXXXXXXXXXXXXGXXXXXXXXXXXXXXXXXXXGXXXXXXXXXXXXXXXXXXXGXXXXXXXXXXXXXXXXXXXGXXXXXXXXXXXXXXXXXXXGXXXXXXXXXXXXXXXXXXXGXXXXXXXXXXXXXXXXXXX,0,300,0
46179,13,0,13,34,253,0,0,263,204,59,GXXXXXXXXXXXXXXXXXXXGXXXXXXXXXXXXXXXXXXXGXXXXXXXXXXXXXXXXXXXGXXXXXXXXXXXXXXXXXXXGXXXXXXXXXXXXXXXXXXXGXXXXXXXXXXXXXXXXXXXGXXXXXXXXXXXXXXXXXXXGXXXXXXXXXXXXXXXXXXXGXXXXXXXXXXXXXXXXXXXGXXXXXXXXXXXXXXXXXXXGXXXXXXXXXXXXXXXXXXXGXXXXXXXXXXXXXXXXXXXGXXXXXXXXXXXXXXXXXXX,0,300,0

46200,13,0,13,35,252,0,0,264,203,61,GXXXXXXXXXXXXXXXXXXXGXXXXXXXXXXXXXXXXXXXGXXXXXXXXXXXXXXXXXXXGXXXXXXXXXXXXXXXXXXXGXXXXXXXXXXXXXXXXXXXGXXXXXXXXXXXXXXXXXXXGXXXXXXXXXXXXXXXXXXXGXXXXXXXXXXXXXXXXXXXGXXXXXXXXXXXXXXXXXXXGXXXXXXXXXXXXXXXXXXXGXXXXXXXXXXXXXXXXXXXGXXXXXXXXXXXXXXXXXXXGXXXXXXXXXXXXXXXXXXX,0,300,0
46221,13,0,13,33,254,0,0,266,203,63,GXXXXXXXXXXXXXXXXXXXGXXXXXXXXXXXXXXXXXXXGXXXXXXXXXXXXXXXXXXXGXXXXXXXXXXXXXXXXXXXGXXXXXXXXXXXXXXXXXXXGXXXXXXXXXXXXXXXXXXXGXXXXXXXXXXXXXXXXXXXGXXXXXXXXXXXXXXXXXXXGXXXXXXXXXXXXXXXXXXXGXXXXXXXXXXXXXXXXXXXGXXXXXXXXXXXXXXXXXXXGXXXXXXXXXXXXXXXXXXXGXXXXXXXXXXXXXXXXXXX,0,300,0
46242,13,0,13,34,253,0,0,265,208,57,GXXXXXXXXXXXXXXXXXXXGXXXXXXXXXXXXXXXXXXXGXXXXXXXXXXXXXXXXXXXGXXXXXXXXXXXXXXXXXXXGXXXXXXXXXXXXXXXXXXXGXXXXXXXXXXXXXXXXXXXGXXXXXXXXXXXXXXXXXXXGXXXXXXXXXXXXXXXXXXXGXXXXXXXXXXXXXXXXXXXGXXXXXXXXXXXXXXXXXXXGXXXXXXXXXXXXXXXXXXXGXXXXXXXXXXXXXXXXXXXGXXXXXXXXXXXXXXXXXXX,0,300,0
46263,13,0,13,40,247,0,0,259,200,59,GXXXXXXXXXXXXXXXXXXXGXXXXXXXXXXXXXXXXXXXGXXXXXXXXXXXXXXXXXXXGXXXXXXXXXXXXXXXXXXXGXXXXXXXXXXXXXXXXXXXGXXXXXXXXXXXXXXXXXXXGXXXXXXXXXXXXXXXXXXXGXXXXXXXXXXXXXXXXXXXGXXXXXXXXXXXXXXXXXXXGXXXXXXXXXXXXXXXXXXXGXXXXXXXXXXXXXXXXXXXGXXXXXXXXXXXXXXXXXXXGXXXXXXXXXXXXXXXXXXX,0,300,0
46284,13,0,13,37,250,0,0,262,202,60,GXXXXXXXXXXXXXXXXXXXGXXXXXXXXXXXXXXXXXXXGXXXXXXXXXXXXXXXXXXXGXXXXXXXXXXXXXXXXXXXGXXXXXXXXXXXXXXXXXXXGXXXXXXXXXXXXXXXXXXXGXXXXXXXXXXXXXXXXXXXGXXXXXXXXXXXXXXXXXXXGXXXXXXXXXXXXXXXXXXXGXXXXXXXXXXXXXXXXXXXGXXXXXXXXXXXXXXXXXXXGXXXXXXXXXXXXXXXXXXXGXXXXXXXXXXXXXXXXXXX,0,300,0

46305,13,0,13,36,251,0,0,263,203,60,GXXXXXXXXXXXXXXXXXXXGXXXXXXXXXXXXXXXXXXXGXXXXXXXXXXXXXXXXXXXGXXXXXXXXXXXXXXXXXXXGXXXXXXXXXXXXXXXXXXXGXXXXXXXXXXXXXXXXXXXGXXXXXXXXXXXXXXXXXXXGXXXXXXXXXXXXXXXXXXXGXXXXXXXXXXXXXXXXXXXGXXXXXXXXXXXXXXXXXXXGXXXXXXXXXXXXXXXXXXXGXXXXXXXXXXXXXXXXXXXGXXXXXXXXXXXXXXXXXXX,0,300,0
46326,13,0,13,38,249,0,0,262,203,59,GXXXXXXXXXXXXXXXXXXXGXXXXXXXXXXXXXXXXXXXGXXXXXXXXXXXXXXXXXXXGXXXXXXXXXXXXXXXXXXXGXXXXXXXXXXXXXXXXXXXGXXXXXXXXXXXXXXXXXXXGXXXXXXXXXXXXXXXXXXXGXXXXXXXXXXXXXXXXXXXGXXXXXXXXXXXXXXXXXXXGXXXXXXXXXXXXXXXXXXXGXXXXXXXXXXXXXXXXXXXGXXXXXXXXXXXXXXXXXXXGXXXXXXXXXXXXXXXXXXX,0,300,0
46347,13,0,13,40,247,0,0,259,204,55,GXXXXXXXXXXXXXXXXXXXGXXXXXXXXXXXXXXXXXXXGXXXXXXXXXXXXXXXXXXXGXXXXXXXXXXXXXXXXXXXGXXXXXXXXXXXXXXXXXXXGXXXXXXXXXXXXXXXXXXXGXXXXXXXXXXXXXXXXXXXGXXXXXXXXXXXXXXXXXXXGXXXXXXXXXXXXXXXXXXXGXXXXXXXXXXXXXXXXXXXGXXXXXXXXXXXXXXXXXXXGXXXXXXXXXXXXXXXXXXXGXXXXXXXXXXXXXXXXXXX,0,300,0
46368,13,0,13,37,250,0,0,263,205,58,GXXXXXXXXXXXXXXXXXXXGXXXXXXXXXXXXXXXXXXXGXXXXXXXXXXXXXXXXXXXGXXXXXXXXXXXXXXXXXXXGXXXXXXXXXXXXXXXXXXXGXXXXXXXXXXXXXXXXXXXGXXXXXXXXXXXXXXXXXXXGXXXXXXXXXXXXXXXXXXXGXXXXXXXXXXXXXXXXXXXGXXXXXXXXXXXXXXXXXXXGXXXXXXXXXXXXXXXXXXXGXXXXXXXXXXXXXXXXXXXGXXXXXXXXXXXXXXXXXXX,0,300,0
46389,13,0,13,35,252,0,0,264,206,58,GXXXXXXXXXXXXXXXXXXXGXXXXXXXXXXXXXXXXXXXGXXXXXXXXXXXXXXXXXXXGXXXXXXXXXXXXXXXXXXXGXXXXXXXXXXXXXXXXXXXGXXXXXXXXXXXXXXXXXXXGXXXXXXXXXXXXXXXXXXXGXXXXXXXXXXXXXXXXXXXGXXXXXXXXXXXXXXXXXXXGXXXXXXXXXXXXXXXXXXXGXXXXXXXXXXXXXXXXXXXGXXXXXXXXXXXXXXXXXXXGXXXXXXXXXXXXXXXXXXX,0,300,0

46410,13,0,13,35,252,0,0,265,209,56,GXXXXXXXXXXXXXXXXXXXGXXXXXXXXXXXXXXXXXXXGXXXXXXXXXXXXXXXXXXXGXXXXXXXXXXXXXXXXXXXGXXXXXXXXXXXXXXXXXXXGXXXXXXXXXXXXXXXXXXXGXXXXXXXXXXXXXXXXXXXGXXXXXXXXXXXXXXXXXXXGXXXXXXXXXXXXXXXXXXXGXXXXXXXXXXXXXXXXXXXGXXXXXXXXXXXXXXXXXXXGXXXXXXXXXXXXXXXXXXXGXXXXXXXXXXXXXXXXXXX,0,300,0
46431,13,0,13,35,252,0,0,265,208,57,GXXXXXXXXXXXXXXXXXXXGXXXXXXXXXXXXXXXXXXXGXXXXXXXXXXXXXXXXXXXGXXXXXXXXXXXXXXXXXXXGXXXXXXXXXXXXXXXXXXXGXXXXXXXXXXXXXXXXXXXGXXXXXXXXXXXXXXXXXXXGXXXXXXXXXXXXXXXXXXXGXXXXXXXXXXXXXXXXXXXGXXXXXXXXXXXXXXXXXXXGXXXXXXXXXXXXXXXXXXXGXXXXXXXXXXXXXXXXXXXGXXXXXXXXXXXXXXXXXXX,0,300,0
46452,13,0,13,36,251,0,0,264,204,60,GXXXXXXXXXXXXXXXXXXXGXXXXXXXXXXXXXXXXXXXGXXXXXXXXXXXXXXXXXXXGXXXXXXXXXXXXXXXXXXXGXXXXXXXXXXXXXXXXXXXGXXXXXXXXXXXXXXXXXXXGXXXXXXXXXXXXXXXXXXXGXXXXXXXXXXXXXXXXXXXGXXXXXXXXXXXXXXXXXXXGXXXXXXXXXXXXXXXXXXXGXXXXXXXXXXXXXXXXXXXGXXXXXXXXXXXXXXXXXXXGXXXXXXXXXXXXXXXXXXX,0,300,0
46473,13,0,13,37,250,0,0,264,202,62,GXXXXXXXXXXXXXXXXXXXGXXXXXXXXXXXXXXXXXXXGXXXXXXXXXXXXXXXXXXXGXXXXXXXXXXXXXXXXXXXGXXXXXXXXXXXXXXXXXXXGXXXXXXXXXXXXXXXXXXXGXXXXXXXXXXXXXXXXXXXGXXXXXXXXXXXXXXXXXXXGXXXXXXXXXXXXXXXXXXXGXXXXXXXXXXXXXXXXXXXGXXXXXXXXXXXXXXXXXXXGXXXXXXXXXXXXXXXXXXXGXXXXXXXXXXXXXXXXXXX,0,300,0
46494,13,0,13,32,255,0,0,269,203,66,GXXXXXXXXXXXXXXXXXXXGXXXXXXXXXXXXXXXXXXXGXXXXXXXXXXXXXXXXXXXGXXXXXXXXXXXXXXXXXXXGXXXXXXXXXXXXXXXXXXXGXXXXXXXXXXXXXXXXXXXGXXXXXXXXXXXXXXXXXXXGXXXXXXXXXXXXXXXXXXXGXXXXXXXXXXXXXXXXXXXGXXXXXXXXXXXXXXXXXXXGXXXXXXXXXXXXXXXXXXXGXXXXXXXXXXXXXXXXXXXGXXXXXXXXXXXXXXXXXXX,0,300,0

46515,13,0,13,32,255,0,0,269,203,66,GXXXXXXXXXXXXXXXXXXXGXXXXXXXXXXXXXXXXXXXGXXXXXXXXXXXXXXXXXXXGXXXXXXXXXXXXXXXXXXXGXXXXXXXXXXXXXXXXXXXGXXXXXXXXXXXXXXXXXXXGXXXXXXXXXXXXXXXXXXXGXXXXXXXXXXXXXXXXXXXGXXXXXXXXXXXXXXXXXXXGXXXXXXXXXXXXXXXXXXXGXXXXXXXXXXXXXXXXXXXGXXXXXXXXXXXXXXXXXXXGXXXXXXXXXXXXXXXXXXX,0,300,0
46536,13,0,13,34,253,0,0,267,204,63,GXXXXXXXXXXXXXXXXXXXGXXXXXXXXXXXXXXXXXXXGXXXXXXXXXXXXXXXXXXXGXXXXXXXXXXXXXXXXXXXGXXXXXXXXXXXXXXXXXXXGXXXXXXXXXXXXXXXXXXXGXXXXXXXXXXXXXXXXXXXGXXXXXXXXXXXXXXXXXXXGXXXXXXXXXXXXXXXXXXXGXXXXXXXXXXXXXXXXXXXGXXXXXXXXXXXXXXXXXXXGXXXXXXXXXXXXXXXXXXXGXXXXXXXXXXXXXXXXXXX,0,300,0
46557,13,0,13,37,250,0,0,264,203,61,GXXXXXXXXXXXXXXXXXXXGXXXXXXXXXXXXXXXXXXXGXXXXXXXXXXXXXXXXXXXGXXXXXXXXXXXXXXXXXXXGXXXXXXXXXXXXXXXXXXXGXXXXXXXXXXXXXXXXXXXGXXXXXXXXXXXXXXXXXXXGXXXXXXXXXXXXXXXXXXXGXXXXXXXXXXXXXXXXXXXGXXXXXXXXXXXXXXXXXXXGXXXXXXXXXXXXXXXXXXXGXXXXXXXXXXXXXXXXXXXGXXXXXXXXXXXXXXXXXXX,0,300,0
46578,13,0,13,36,251,0,0,265,201,64,GXXXXXXXXXXXXXXXXXXXGXXXXXXXXXXXXXXXXXXXGXXXXXXXXXXXXXXXXXXXGXXXXXXXXXXXXXXXXXXXGXXXXXXXXXXXXXXXXXXXGXXXXXXXXXXXXXXXXXXXGXXXXXXXXXXXXXXXXXXXGXXXXXXXXXXXXXXXXXXXGXXXXXXXXXXXXXXXXXXXGXXXXXXXXXXXXXXXXXXXGXXXXXXXXXXXXXXXXXXXGXXXXXXXXXXXXXXXXXXXGXXXXXXXXXXXXXXXXXXX,0,300,0
46599,13,0,13,33,254,0,0,267,203,64,GXXXXXXXXXXXXXXXXXXXGXXXXXXXXXXXXXXXXXXXGXXXXXXXXXXXXXXXXXXXGXXXXXXXXXXXXXXXXXXXGXXXXXXXXXXXXXXXXXXXGXXXXXXXXXXXXXXXXXXXGXXXXXXXXXXXXXXXXXXXGXXXXXXXXXXXXXXXXXXXGXXXXXXXXXXXXXXXXXXXGXXXXXXXXXXXXXXXXXXXGXXXXXXXXXXXXXXXXXXXGXXXXXXXXXXXXXXXXXXXGXXXXXXXXXXXXXXXXXXX,0,300,0

46620,13,0,13,32,255,0,0,268,207,61,GXXXXXXXXXXXXXXXXXXXGXXXXXXXXXXXXXXXXXXXGXXXXXXXXXXXXXXXXXXXGXXXXXXXXXXXXXXXXXXXGXXXXXXXXXXXXXXXXXXXGXXXXXXXXXXXXXXXXXXXGXXXXXXXXXXXXXXXXXXXGXXXXXXXXXXXXXXXXXXXGXXXXXXXXXXXXXXXXXXXGXXXXXXXXXXXXXXXXXXXGXXXXXXXXXXXXXXXXXXXGXXXXXXXXXXXXXXXXXXXGXXXXXXXXXXXXXXXXXXX,0,300,0
46641,13,0,13,29,258,0,0,270,211,59,GXXXXXXXXXXXXXXXXXXXGXXXXXXXXXXXXXXXXXXXGXXXXXXXXXXXXXXXXXXXGXXXXXXXXXXXXXXXXXXXGXXXXXXXXXXXXXXXXXXXGXXXXXXXXXXXXXXXXXXXGXXXXXXXXXXXXXXXXXXXGXXXXXXXXXXXXXXXXXXXGXXXXXXXXXXXXXXXXXXXGXXXXXXXXXXXXXXXXXXXGXXXXXXXXXXXXXXXXXXXGXXXXXXXXXXXXXXXXXXXGXXXXXXXXXXXXXXXXXXX,0,300,0
46662,13,0,13,31,256,0,0,268,208,60,GXXXXXXXXXXXXXXXXXXXGXXXXXXXXXXXXXXXXXXXGXXXXXXXXXXXXXXXXXXXGXXXXXXXXXXXXXXXXXXXGXXXXXXXXXXXXXXXXXXXGXXXXXXXXXXXXXXXXXXXGXXXXXXXXXXXXXXXXXXXGXXXXXXXXXXXXXXXXXXXGXXXXXXXXXXXXXXXXXXXGXXXXXXXXXXXXXXXXXXXGXXXXXXXXXXXXXXXXXXXGXXXXXXXXXXXXXXXXXXXGXXXXXXXXXXXXXXXXXXX,0,300,0
46683,14,1,13,32,254,0,0,266,205,61,GXXXXXXXXXXXXXXXXXXXGXXXXXXXXXXXXXXXXXXXGXXXXXXXXXXXXXXXXXXXGXXXXXXXXXXXXXXXXXXXGXXXXXXXXXXXXXXXXXXXGXXXXXXXXXXXXXXXXXXXGXXXXXXXXXXXXXXXXXXXGAXXXXXXXXXXXXXXXXXXGXXXXXXXXXXXXXXXXXXXGXXXXXXXXXXXXXXXXXXXGXXXXXXXXXXXXXXXXXXXGXXXXXXXXXXXXXXXXXXXGXXXXXXXXXXXXXXXXXXX,0,300,0
46704,14,0,14,34,252,0,0,264,203,61,GXXXXXXXXXXXXXXXXXXXGXXXXXXXXXXXXXXXXXXXGXXXXXXXXXXXXXXXXXXXGXXXXXXXXXXXXXXXXXXXGXXXXXXXXXXXXXXXXXXXGXXXXXXXXXXXXXXXXXXXGXXXXXXXXXXXXXXXXXXXGOXXXXXXXXXXXXXXXXXXGXXXXXXXXXXXXXXXXXXXGXXXXXXXXXXXXXXXXXXXGXXXXXXXXXXXXXXXXXXXGXXXXXXXXXXXXXXXXXXXGXXXXXXXXXXXXXXXXXXX,0,300,0

46725,14,0,14,36,250,0,0,262,203,59,GXXXXXXXXXXXXXXXXXXXGXXXXXXXXXXXXXXXXXXXGXXXXXXXXXXXXXXXXXXXGXXXXXXXXXXXXXXXXXXXGXXXXXXXXXXXXXXXXXXXGXXXXXXXXXXXXXXXXXXXGXXXXXXXXXXXXXXXXXXXGOXXXXXXXXXXXXXXXXXXGXXXXXXXXXXXXXXXXXXXGXXXXXXXXXXXXXXXXXXXGXXXXXXXXXXXXXXXXXXXGXXXXXXXXXXXXXXXXXXXGXXXXXXXXXXXXXXXXXXX,0,300,0
46746,14,0,14,30,256,0,0,268,209,59,GXXXXXXXXXXXXXXXXXXXGXXXXXXXXXXXXXXXXXXXGXXXXXXXXXXXXXXXXXXXGXXXXXXXXXXXXXXXXXXXGXXXXXXXXXXXXXXXXXXXGXXXXXXXXXXXXXXXXXXXGXXXXXXXXXXXXXXXXXXXGOXXXXXXXXXXXXXXXXXXGXXXXXXXXXXXXXXXXXXXGXXXXXXXXXXXXXXXXXXXGXXXXXXXXXXXXXXXXXXXGXXXXXXXXXXXXXXXXXXXGXXXXXXXXXXXXXXXXXXX,0,300,0
46767,13,0,13,28,259,0,0,271,207,64,GXXXXXXXXXXXXXXXXXXXGXXXXXXXXXXXXXXXXXXXGXXXXXXXXXXXXXXXXXXXGXXXXXXXXXXXXXXXXXXXGXXXXXXXXXXXXXXXXXXXGXXXXXXXXXXXXXXXXXXXGXXXXXXXXXXXXXXXXXXXGXXXXXXXXXXXXXXXXXXXGXXXXXXXXXXXXXXXXXXXGXXXXXXXXXXXXXXXXXXXGXXXXXXXXXXXXXXXXXXXGXXXXXXXXXXXXXXXXXXXGXXXXXXXXXXXXXXXXXXX,0,300,0
46788,13,0,13,30,257,0,0,269,208,61,GXXXXXXXXXXXXXXXXXXXGXXXXXXXXXXXXXXXXXXXGXXXXXXXXXXXXXXXXXXXGXXXXXXXXXXXXXXXXXXXGXXXXXXXXXXXXXXXXXXXGXXXXXXXXXXXXXXXXXXXGXXXXXXXXXXXXXXXXXXXGXXXXXXXXXXXXXXXXXXXGXXXXXXXXXXXXXXXXXXXGXXXXXXXXXXXXXXXXXXXGXXXXXXXXXXXXXXXXXXXGXXXXXXXXXXXXXXXXXXXGXXXXXXXXXXXXXXXXXXX,0,300,0
46809,13,0,13,35,252,0,0,264,207,57,GXXXXXXXXXXXXXXXXXXXGXXXXXXXXXXXXXXXXXXXGXXXXXXXXXXXXXXXXXXXGXXXXXXXXXXXXXXXXXXXGXXXXXXXXXXXXXXXXXXXGXXXXXXXXXXXXXXXXXXXGXXXXXXXXXXXXXXXXXXXGXXXXXXXXXXXXXXXXXXXGXXXXXXXXXXXXXXXXXXXGXXXXXXXXXXXXXXXXXXXGXXXXXXXXXXXXXXXXXXXGXXXXXXXXXXXXXXXXXXXGXXXXXXXXXXXXXXXXXXX,0,300,0

46830,13,0,13,29,258,0,0,270,207,63,GXXXXXXXXXXXXXXXXXXXGXXXXXXXXXXXXXXXXXXXGXXXXXXXXXXXXXXXXXXXGXXXXXXXXXXXXXXXXXXXGXXXXXXXXXXXXXXXXXXXGXXXXXXXXXXXXXXXXXXXGXXXXXXXXXXXXXXXXXXXGXXXXXXXXXXXXXXXXXXXGXXXXXXXXXXXXXXXXXXXGXXXXXXXXXXXXXXXXXXXGXXXXXXXXXXXXXXXXXXXGXXXXXXXXXXXXXXXXXXXGXXXXXXXXXXXXXXXXXXX,0,300,0
46851,13,0,13,26,261,0,0,273,208,65,GXXXXXXXXXXXXXXXXXXXGXXXXXXXXXXXXXXXXXXXGXXXXXXXXXXXXXXXXXXXGXXXXXXXXXXXXXXXXXXXGXXXXXXXXXXXXXXXXXXXGXXXXXXXXXXXXXXXXXXXGXXXXXXXXXXXXXXXXXXXGXXXXXXXXXXXXXXXXXXXGXXXXXXXXXXXXXXXXXXXGXXXXXXXXXXXXXXXXXXXGXXXXXXXXXXXXXXXXXXXGXXXXXXXXXXXXXXXXXXXGXXXXXXXXXXXXXXXXXXX,0,300,0
46872,13,0,13,29,258,0,0,270,207,63,GXXXXXXXXXXXXXXXXXXXGXXXXXXXXXXXXXXXXXXXGXXXXXXXXXXXXXXXXXXXGXXXXXXXXXXXXXXXXXXXGXXXXXXXXXXXXXXXXXXXGXXXXXXXXXXXXXXXXXXXGXXXXXXXXXXXXXXXXXXXGXXXXXXXXXXXXXXXXXXXGXXXXXXXXXXXXXXXXXXXGXXXXXXXXXXXXXXXXXXXGXXXXXXXXXXXXXXXXXXXGXXXXXXXXXXXXXXXXXXXGXXXXXXXXXXXXXXXXXXX,0,300,0
46893,13,0,13,32,255,0,0,266,206,60,GXXXXXXXXXXXXXXXXXXXGXXXXXXXXXXXXXXXXXXXGXXXXXXXXXXXXXXXXXXXGXXXXXXXXXXXXXXXXXXXGXXXXXXXXXXXXXXXXXXXGXXXXXXXXXXXXXXXXXXXGXXXXXXXXXXXXXXXXXXXGXXXXXXXXXXXXXXXXXXXGXXXXXXXXXXXXXXXXXXXGXXXXXXXXXXXXXXXXXXXGXXXXXXXXXXXXXXXXXXXGXXXXXXXXXXXXXXXXXXXGXXXXXXXXXXXXXXXXXXX,0,300,0
46914,13,0,13,30,257,0,0,269,208,61,GXXXXXXXXXXXXXXXXXXXGXXXXXXXXXXXXXXXXXXXGXXXXXXXXXXXXXXXXXXXGXXXXXXXXXXXXXXXXXXXGXXXXXXXXXXXXXXXXXXXGXXXXXXXXXXXXXXXXXXXGXXXXXXXXXXXXXXXXXXXGXXXXXXXXXXXXXXXXXXXGXXXXXXXXXXXXXXXXXXXGXXXXXXXXXXXXXXXXXXXGXXXXXXXXXXXXXXXXXXXGXXXXXXXXXXXXXXXXXXXGXXXXXXXXXXXXXXXXXXX,0,300,0

46935,13,0,13,30,257,0,0,269,206,63,GXXXXXXXXXXXXXXXXXXXGXXXXXXXXXXXXXXXXXXXGXXXXXXXXXXXXXXXXXXXGXXXXXXXXXXXXXXXXXXXGXXXXXXXXXXXXXXXXXXXGXXXXXXXXXXXXXXXXXXXGXXXXXXXXXXXXXXXXXXXGXXXXXXXXXXXXXXXXXXXGXXXXXXXXXXXXXXXXXXXGXXXXXXXXXXXXXXXXXXXGXXXXXXXXXXXXXXXXXXXGXXXXXXXXXXXXXXXXXXXGXXXXXXXXXXXXXXXXXXX,0,300,0
46956,13,0,13,32,255,0,0,267,206,61,GXXXXXXXXXXXXXXXXXXXGXXXXXXXXXXXXXXXXXXXGXXXXXXXXXXXXXXXXXXXGXXXXXXXXXXXXXXXXXXXGXXXXXXXXXXXXXXXXXXXGXXXXXXXXXXXXXXXXXXXGXXXXXXXXXXXXXXXXXXXGXXXXXXXXXXXXXXXXXXXGXXXXXXXXXXXXXXXXXXXGXXXXXXXXXXXXXXXXXXXGXXXXXXXXXXXXXXXXXXXGXXXXXXXXXXXXXXXXXXXGXXXXXXXXXXXXXXXXXXX,0,300,0
46977,13,0,13,30,257,0,0,269,212,57,GXXXXXXXXXXXXXXXXXXXGXXXXXXXXXXXXXXXXXXXGXXXXXXXXXXXXXXXXXXXGXXXXXXXXXXXXXXXXXXXGXXXXXXXXXXXXXXXXXXXGXXXXXXXXXXXXXXXXXXXGXXXXXXXXXXXXXXXXXXXGXXXXXXXXXXXXXXXXXXXGXXXXXXXXXXXXXXXXXXXGXXXXXXXXXXXXXXXXXXXGXXXXXXXXXXXXXXXXXXXGXXXXXXXXXXXXXXXXXXXGXXXXXXXXXXXXXXXXXXX,0,300,0
46998,13,0,13,34,253,0,0,265,210,55,GXXXXXXXXXXXXXXXXXXXGXXXXXXXXXXXXXXXXXXXGXXXXXXXXXXXXXXXXXXXGXXXXXXXXXXXXXXXXXXXGXXXXXXXXXXXXXXXXXXXGXXXXXXXXXXXXXXXXXXXGXXXXXXXXXXXXXXXXXXXGXXXXXXXXXXXXXXXXXXXGXXXXXXXXXXXXXXXXXXXGXXXXXXXXXXXXXXXXXXXGXXXXXXXXXXXXXXXXXXXGXXXXXXXXXXXXXXXXXXXGXXXXXXXXXXXXXXXXXXX,0,300,0
47019,13,0,13,35,252,0,0,264,208,56,GXXXXXXXXXXXXXXXXXXXGXXXXXXXXXXXXXXXXXXXGXXXXXXXXXXXXXXXXXXXGXXXXXXXXXXXXXXXXXXXGXXXXXXXXXXXXXXXXXXXGXXXXXXXXXXXXXXXXXXXGXXXXXXXXXXXXXXXXXXXGXXXXXXXXXXXXXXXXXXXGXXXXXXXXXXXXXXXXXXXGXXXXXXXXXXXXXXXXXXXGXXXXXXXXXXXXXXXXXXXGXXXXXXXXXXXXXXXXXXXGXXXXXXXXXXXXXXXXXXX,0,300,0

47040,13,0,13,32,255,0,0,267,212,55,GXXXXXXXXXXXXXXXXXXXGXXXXXXXXXXXXXXXXXXXGXXXXXXXXXXXXXXXXXXXGXXXXXXXXXXXXXXXXXXXGXXXXXXXXXXXXXXXXXXXGXXXXXXXXXXXXXXXXXXXGXXXXXXXXXXXXXXXXXXXGXXXXXXXXXXXXXXXXXXXGXXXXXXXXXXXXXXXXXXXGXXXXXXXXXXXXXXXXXXXGXXXXXXXXXXXXXXXXXXXGXXXXXXXXXXXXXXXXXXXGXXXXXXXXXXXXXXXXXXX,0,300,0
47061,13,0,13,35,252,0,0,264,212,52,GXXXXXXXXXXXXXXXXXXXGXXXXXXXXXXXXXXXXXXXGXXXXXXXXXXXXXXXXXXXGXXXXXXXXXXXXXXXXXXXGXXXXXXXXXXXXXXXXXXXGXXXXXXXXXXXXXXXXXXXGXXXXXXXXXXXXXXXXXXXGXXXXXXXXXXXXXXXXXXXGXXXXXXXXXXXXXXXXXXXGXXXXXXXXXXXXXXXXXXXGXXXXXXXXXXXXXXXXXXXGXXXXXXXXXXXXXXXXXXXGXXXXXXXXXXXXXXXXXXX,0,300,0
47082,13,0,13,39,248,0,0,260,209,51,GXXXXXXXXXXXXXXXXXXXGXXXXXXXXXXXXXXXXXXXGXXXXXXXXXXXXXXXXXXXGXXXXXXXXXXXXXXXXXXXGXXXXXXXXXXXXXXXXXXXGXXXXXXXXXXXXXXXXXXXGXXXXXXXXXXXXXXXXXXXGXXXXXXXXXXXXXXXXXXXGXXXXXXXXXXXXXXXXXXXGXXXXXXXXXXXXXXXXXXXGXXXXXXXXXXXXXXXXXXXGXXXXXXXXXXXXXXXXXXXGXXXXXXXXXXXXXXXXXXX,0,300,0
47103,13,0,13,31,256,0,0,268,209,59,GXXXXXXXXXXXXXXXXXXXGXXXXXXXXXXXXXXXXXXXGXXXXXXXXXXXXXXXXXXXGXXXXXXXXXXXXXXXXXXXGXXXXXXXXXXXXXXXXXXXGXXXXXXXXXXXXXXXXXXXGXXXXXXXXXXXXXXXXXXXGXXXXXXXXXXXXXXXXXXXGXXXXXXXXXXXXXXXXXXXGXXXXXXXXXXXXXXXXXXXGXXXXXXXXXXXXXXXXXXXGXXXXXXXXXXXXXXXXXXXGXXXXXXXXXXXXXXXXXXX,0,300,0
47124,13,0,13,34,253,0,0,264,207,57,GXXXXXXXXXXXXXXXXXXXGXXXXXXXXXXXXXXXXXXXGXXXXXXXXXXXXXXXXXXXGXXXXXXXXXXXXXXXXXXXGXXXXXXXXXXXXXXXXXXXGXXXXXXXXXXXXXXXXXXXGXXXXXXXXXXXXXXXXXXXGXXXXXXXXXXXXXXXXXXXGXXXXXXXXXXXXXXXXXXXGXXXXXXXXXXXXXXXXXXXGXXXXXXXXXXXXXXXXXXXGXXXXXXXXXXXXXXXXXXXGXXXXXXXXXXXXXXXXXXX,0,300,0

47145,13,0,13,35,252,0,0,264,208,56,GXXXXXXXXXXXXXXXXXXXGXXXXXXXXXXXXXXXXXXXGXXXXXXXXXXXXXXXXXXXGXXXXXXXXXXXXXXXXXXXGXXXXXXXXXXXXXXXXXXXGXXXXXXXXXXXXXXXXXXXGXXXXXXXXXXXXXXXXXXXGXXXXXXXXXXXXXXXXXXXGXXXXXXXXXXXXXXXXXXXGXXXXXXXXXXXXXXXXXXXGXXXXXXXXXXXXXXXXXXXGXXXXXXXXXXXXXXXXXXXGXXXXXXXXXXXXXXXXXXX,0,300,0
47166,13,0,13,32,255,0,0,267,213,54,GXXXXXXXXXXXXXXXXXXXGXXXXXXXXXXXXXXXXXXXGXXXXXXXXXXXXXXXXXXXGXXXXXXXXXXXXXXXXXXXGXXXXXXXXXXXXXXXXXXXGXXXXXXXXXXXXXXXXXXXGXXXXXXXXXXXXXXXXXXXGXXXXXXXXXXXXXXXXXXXGXXXXXXXXXXXXXXXXXXXGXXXXXXXXXXXXXXXXXXXGXXXXXXXXXXXXXXXXXXXGXXXXXXXXXXXXXXXXXXXGXXXXXXXXXXXXXXXXXXX,0,300,0
47187,13,0,13,35,252,0,0,264,210,54,GXXXXXXXXXXXXXXXXXXXGXXXXXXXXXXXXXXXXXXXGXXXXXXXXXXXXXXXXXXXGXXXXXXXXXXXXXXXXXXXGXXXXXXXXXXXXXXXXXXXGXXXXXXXXXXXXXXXXXXXGXXXXXXXXXXXXXXXXXXXGXXXXXXXXXXXXXXXXXXXGXXXXXXXXXXXXXXXXXXXGXXXXXXXXXXXXXXXXXXXGXXXXXXXXXXXXXXXXXXXGXXXXXXXXXXXXXXXXXXXGXXXXXXXXXXXXXXXXXXX,0,300,0
47208,13,0,13,42,245,0,0,257,204,53,GXXXXXXXXXXXXXXXXXXXGXXXXXXXXXXXXXXXXXXXGXXXXXXXXXXXXXXXXXXXGXXXXXXXXXXXXXXXXXXXGXXXXXXXXXXXXXXXXXXXGXXXXXXXXXXXXXXXXXXXGXXXXXXXXXXXXXXXXXXXGXXXXXXXXXXXXXXXXXXXGXXXXXXXXXXXXXXXXXXXGXXXXXXXXXXXXXXXXXXXGXXXXXXXXXXXXXXXXXXXGXXXXXXXXXXXXXXXXXXXGXXXXXXXXXXXXXXXXXXX,0,300,0
47229,14,1,13,40,246,0,0,258,206,52,GXXXXXXXXXXXXXXXXXXXGXXXXXXXXXXXXXXXXXXXGXXXXXXXXXXXXXXXXXXXGXXXXXXXXXXXXXXXXXXXGXXXXXXXXXXXXXXXXXXXGXXXXXXXXXXXXXXXXXXXGAXXXXXXXXXXXXXXXXXXGXXXXXXXXXXXXXXXXXXXGXXXXXXXXXXXXXXXXXXXGXXXXXXXXXXXXXXXXXXXGXXXXXXXXXXXXXXXXXXXGXXXXXXXXXXXXXXXXXXXGXXXXXXXXXXXXXXXXXXX,0,300,0

47250,14,1,13,36,250,0,0,262,209,53,GXXXXXXXXXXXXXXXXXXXGXXXXXXXXXXXXXXXXXXXGXXXXXXXXXXXXXXXXXXXGXXXXXXXXXXXXXXXXXXXGXXXXXXXXXXXXXXXXXXXGXXXXXXXXXXXXXXXXXXXGAXXXXXXXXXXXXXXXXXXGXXXXXXXXXXXXXXXXXXXGXXXXXXXXXXXXXXXXXXXGXXXXXXXXXXXXXXXXXXXGXXXXXXXXXXXXXXXXXXXGXXXXXXXXXXXXXXXXXXXGXXXXXXXXXXXXXXXXXXX,0,300,0
47271,13,0,13,31,256,0,0,268,212,56,GXXXXXXXXXXXXXXXXXXXGXXXXXXXXXXXXXXXXXXXGXXXXXXXXXXXXXXXXXXXGXXXXXXXXXXXXXXXXXXXGXXXXXXXXXXXXXXXXXXXGXXXXXXXXXXXXXXXXXXXGXXXXXXXXXXXXXXXXXXXGXXXXXXXXXXXXXXXXXXXGXXXXXXXXXXXXXXXXXXXGXXXXXXXXXXXXXXXXXXXGXXXXXXXXXXXXXXXXXXXGXXXXXXXXXXXXXXXXXXXGXXXXXXXXXXXXXXXXXXX,0,300,0
47292,13,0,13,30,257,0,0,269,213,56,GXXXXXXXXXXXXXXXXXXXGXXXXXXXXXXXXXXXXXXXGXXXXXXXXXXXXXXXXXXXGXXXXXXXXXXXXXXXXXXXGXXXXXXXXXXXXXXXXXXXGXXXXXXXXXXXXXXXXXXXGXXXXXXXXXXXXXXXXXXXGXXXXXXXXXXXXXXXXXXXGXXXXXXXXXXXXXXXXXXXGXXXXXXXXXXXXXXXXXXXGXXXXXXXXXXXXXXXXXXXGXXXXXXXXXXXXXXXXXXXGXXXXXXXXXXXXXXXXXXX,0,300,0
47313,13,0,13,29,258,0,0,269,209,60,GXXXXXXXXXXXXXXXXXXXGXXXXXXXXXXXXXXXXXXXGXXXXXXXXXXXXXXXXXXXGXXXXXXXXXXXXXXXXXXXGXXXXXXXXXXXXXXXXXXXGXXXXXXXXXXXXXXXXXXXGXXXXXXXXXXXXXXXXXXXGXXXXXXXXXXXXXXXXXXXGXXXXXXXXXXXXXXXXXXXGXXXXXXXXXXXXXXXXXXXGXXXXXXXXXXXXXXXXXXXGXXXXXXXXXXXXXXXXXXXGXXXXXXXXXXXXXXXXXXX,0,300,0
47334,13,0,13,29,258,0,0,269,210,59,GXXXXXXXXXXXXXXXXXXXGXXXXXXXXXXXXXXXXXXXGXXXXXXXXXXXXXXXXXXXGXXXXXXXXXXXXXXXXXXXGXXXXXXXXXXXXXXXXXXXGXXXXXXXXXXXXXXXXXXXGXXXXXXXXXXXXXXXXXXXGXXXXXXXXXXXXXXXXXXXGXXXXXXXXXXXXXXXXXXXGXXXXXXXXXXXXXXXXXXXGXXXXXXXXXXXXXXXXXXXGXXXXXXXXXXXXXXXXXXXGXXXXXXXXXXXXXXXXXXX,0,300,0

47355,13,0,13,31,256,0,0,268,206,62,GXXXXXXXXXXXXXXXXXXXGXXXXXXXXXXXXXXXXXXXGXXXXXXXXXXXXXXXXXXXGXXXXXXXXXXXXXXXXXXXGXXXXXXXXXXXXXXXXXXXGXXXXXXXXXXXXXXXXXXXGXXXXXXXXXXXXXXXXXXXGXXXXXXXXXXXXXXXXXXXGXXXXXXXXXXXXXXXXXXXGXXXXXXXXXXXXXXXXXXXGXXXXXXXXXXXXXXXXXXXGXXXXXXXXXXXXXXXXXXXGXXXXXXXXXXXXXXXXXXX,0,300,0
47376,13,0,13,32,255,0,0,267,205,62,GXXXXXXXXXXXXXXXXXXXGXXXXXXXXXXXXXXXXXXXGXXXXXXXXXXXXXXXXXXXGXXXXXXXXXXXXXXXXXXXGXXXXXXXXXXXXXXXXXXXGXXXXXXXXXXXXXXXXXXXGXXXXXXXXXXXXXXXXXXXGXXXXXXXXXXXXXXXXXXXGXXXXXXXXXXXXXXXXXXXGXXXXXXXXXXXXXXXXXXXGXXXXXXXXXXXXXXXXXXXGXXXXXXXXXXXXXXXXXXXGXXXXXXXXXXXXXXXXXXX,0,300,0
47397,13,0,13,28,259,0,0,271,208,63,GXXXXXXXXXXXXXXXXXXXGXXXXXXXXXXXXXXXXXXXGXXXXXXXXXXXXXXXXXXXGXXXXXXXXXXXXXXXXXXXGXXXXXXXXXXXXXXXXXXXGXXXXXXXXXXXXXXXXXXXGXXXXXXXXXXXXXXXXXXXGXXXXXXXXXXXXXXXXXXXGXXXXXXXXXXXXXXXXXXXGXXXXXXXXXXXXXXXXXXXGXXXXXXXXXXXXXXXXXXXGXXXXXXXXXXXXXXXXXXXGXXXXXXXXXXXXXXXXXXX,0,300,0
47418,13,0,13,26,261,0,0,273,204,69,GXXXXXXXXXXXXXXXXXXXGXXXXXXXXXXXXXXXXXXXGXXXXXXXXXXXXXXXXXXXGXXXXXXXXXXXXXXXXXXXGXXXXXXXXXXXXXXXXXXXGXXXXXXXXXXXXXXXXXXXGXXXXXXXXXXXXXXXXXXXGXXXXXXXXXXXXXXXXXXXGXXXXXXXXXXXXXXXXXXXGXXXXXXXXXXXXXXXXXXXGXXXXXXXXXXXXXXXXXXXGXXXXXXXXXXXXXXXXXXXGXXXXXXXXXXXXXXXXXXX,0,300,0
47439,13,0,13,28,259,0,0,271,205,66,GXXXXXXXXXXXXXXXXXXXGXXXXXXXXXXXXXXXXXXXGXXXXXXXXXXXXXXXXXXXGXXXXXXXXXXXXXXXXXXXGXXXXXXXXXXXXXXXXXXXGXXXXXXXXXXXXXXXXXXXGXXXXXXXXXXXXXXXXXXXGXXXXXXXXXXXXXXXXXXXGXXXXXXXXXXXXXXXXXXXGXXXXXXXXXXXXXXXXXXXGXXXXXXXXXXXXXXXXXXXGXXXXXXXXXXXXXXXXXXXGXXXXXXXXXXXXXXXXXXX,0,300,0

47460,13,0,13,29,258,0,0,270,203,67,GXXXXXXXXXXXXXXXXXXXGXXXXXXXXXXXXXXXXXXXGXXXXXXXXXXXXXXXXXXXGXXXXXXXXXXXXXXXXXXXGXXXXXXXXXXXXXXXXXXXGXXXXXXXXXXXXXXXXXXXGXXXXXXXXXXXXXXXXXXXGXXXXXXXXXXXXXXXXXXXGXXXXXXXXXXXXXXXXXXXGXXXXXXXXXXXXXXXXXXXGXXXXXXXXXXXXXXXXXXXGXXXXXXXXXXXXXXXXXXXGXXXXXXXXXXXXXXXXXXX,0,300,0
47481,13,0,13,28,259,0,0,271,205,66,GXXXXXXXXXXXXXXXXXXXGXXXXXXXXXXXXXXXXXXXGXXXXXXXXXXXXXXXXXXXGXXXXXXXXXXXXXXXXXXXGXXXXXXXXXXXXXXXXXXXGXXXXXXXXXXXXXXXXXXXGXXXXXXXXXXXXXXXXXXXGXXXXXXXXXXXXXXXXXXXGXXXXXXXXXXXXXXXXXXXGXXXXXXXXXXXXXXXXXXXGXXXXXXXXXXXXXXXXXXXGXXXXXXXXXXXXXXXXXXXGXXXXXXXXXXXXXXXXXXX,0,300,0
47502,13,0,13,29,258,0,0,270,205,65,GXXXXXXXXXXXXXXXXXXXGXXXXXXXXXXXXXXXXXXXGXXXXXXXXXXXXXXXXXXXGXXXXXXXXXXXXXXXXXXXGXXXXXXXXXXXXXXXXXXXGXXXXXXXXXXXXXXXXXXXGXXXXXXXXXXXXXXXXXXXGXXXXXXXXXXXXXXXXXXXGXXXXXXXXXXXXXXXXXXXGXXXXXXXXXXXXXXXXXXXGXXXXXXXXXXXXXXXXXXXGXXXXXXXXXXXXXXXXXXXGXXXXXXXXXXXXXXXXXXX,0,300,0
47523,13,0,13,26,261,0,0,272,208,64,GXXXXXXXXXXXXXXXXXXXGXXXXXXXXXXXXXXXXXXXGXXXXXXXXXXXXXXXXXXXGXXXXXXXXXXXXXXXXXXXGXXXXXXXXXXXXXXXXXXXGXXXXXXXXXXXXXXXXXXXGXXXXXXXXXXXXXXXXXXXGXXXXXXXXXXXXXXXXXXXGXXXXXXXXXXXXXXXXXXXGXXXXXXXXXXXXXXXXXXXGXXXXXXXXXXXXXXXXXXXGXXXXXXXXXXXXXXXXXXXGXXXXXXXXXXXXXXXXXXX,0,300,0
47544,13,0,13,27,260,0,0,272,209,63,GXXXXXXXXXXXXXXXXXXXGXXXXXXXXXXXXXXXXXXXGXXXXXXXXXXXXXXXXXXXGXXXXXXXXXXXXXXXXXXXGXXXXXXXXXXXXXXXXXXXGXXXXXXXXXXXXXXXXXXXGXXXXXXXXXXXXXXXXXXXGXXXXXXXXXXXXXXXXXXXGXXXXXXXXXXXXXXXXXXXGXXXXXXXXXXXXXXXXXXXGXXXXXXXXXXXXXXXXXXXGXXXXXXXXXXXXXXXXXXXGXXXXXXXXXXXXXXXXXXX,0,300,0

47565,13,0,13,31,256,0,0,268,210,58,GXXXXXXXXXXXXXXXXXXXGXXXXXXXXXXXXXXXXXXXGXXXXXXXXXXXXXXXXXXXGXXXXXXXXXXXXXXXXXXXGXXXXXXXXXXXXXXXXXXXGXXXXXXXXXXXXXXXXXXXGXXXXXXXXXXXXXXXXXXXGXXXXXXXXXXXXXXXXXXXGXXXXXXXXXXXXXXXXXXXGXXXXXXXXXXXXXXXXXXXGXXXXXXXXXXXXXXXXXXXGXXXXXXXXXXXXXXXXXXXGXXXXXXXXXXXXXXXXXXX,0,300,0
47586,13,0,13,31,256,0,0,268,205,63,GXXXXXXXXXXXXXXXXXXXGXXXXXXXXXXXXXXXXXXXGXXXXXXXXXXXXXXXXXXXGXXXXXXXXXXXXXXXXXXXGXXXXXXXXXXXXXXXXXXXGXXXXXXXXXXXXXXXXXXXGXXXXXXXXXXXXXXXXXXXGXXXXXXXXXXXXXXXXXXXGXXXXXXXXXXXXXXXXXXXGXXXXXXXXXXXXXXXXXXXGXXXXXXXXXXXXXXXXXXXGXXXXXXXXXXXXXXXXXXXGXXXXXXXXXXXXXXXXXXX,0,300,0
47607,13,0,13,29,258,0,0,270,206,64,GXXXXXXXXXXXXXXXXXXXGXXXXXXXXXXXXXXXXXXXGXXXXXXXXXXXXXXXXXXXGXXXXXXXXXXXXXXXXXXXGXXXXXXXXXXXXXXXXXXXGXXXXXXXXXXXXXXXXXXXGXXXXXXXXXXXXXXXXXXXGXXXXXXXXXXXXXXXXXXXGXXXXXXXXXXXXXXXXXXXGXXXXXXXXXXXXXXXXXXXGXXXXXXXXXXXXXXXXXXXGXXXXXXXXXXXXXXXXXXXGXXXXXXXXXXXXXXXXXXX,0,300,0
47628,13,0,13,30,257,0,0,270,209,61,GXXXXXXXXXXXXXXXXXXXGXXXXXXXXXXXXXXXXXXXGXXXXXXXXXXXXXXXXXXXGXXXXXXXXXXXXXXXXXXXGXXXXXXXXXXXXXXXXXXXGXXXXXXXXXXXXXXXXXXXGXXXXXXXXXXXXXXXXXXXGXXXXXXXXXXXXXXXXXXXGXXXXXXXXXXXXXXXXXXXGXXXXXXXXXXXXXXXXXXXGXXXXXXXXXXXXXXXXXXXGXXXXXXXXXXXXXXXXXXXGXXXXXXXXXXXXXXXXXXX,0,300,0
47649,13,0,13,31,256,0,0,269,211,58,GXXXXXXXXXXXXXXXXXXXGXXXXXXXXXXXXXXXXXXXGXXXXXXXXXXXXXXXXXXXGXXXXXXXXXXXXXXXXXXXGXXXXXXXXXXXXXXXXXXXGXXXXXXXXXXXXXXXXXXXGXXXXXXXXXXXXXXXXXXXGXXXXXXXXXXXXXXXXXXXGXXXXXXXXXXXXXXXXXXXGXXXXXXXXXXXXXXXXXXXGXXXXXXXXXXXXXXXXXXXGXXXXXXXXXXXXXXXXXXXGXXXXXXXXXXXXXXXXXXX,0,300,0

47670,13,0,13,34,253,0,0,266,206,60,GXXXXXXXXXXXXXXXXXXXGXXXXXXXXXXXXXXXXXXXGXXXXXXXXXXXXXXXXXXXGXXXXXXXXXXXXXXXXXXXGXXXXXXXXXXXXXXXXXXXGXXXXXXXXXXXXXXXXXXXGXXXXXXXXXXXXXXXXXXXGXXXXXXXXXXXXXXXXXXXGXXXXXXXXXXXXXXXXXXXGXXXXXXXXXXXXXXXXXXXGXXXXXXXXXXXXXXXXXXXGXXXXXXXXXXXXXXXXXXXGXXXXXXXXXXXXXXXXXXX,0,300,0
47691,13,0,13,32,255,0,0,267,207,60,GXXXXXXXXXXXXXXXXXXXGXXXXXXXXXXXXXXXXXXXGXXXXXXXXXXXXXXXXXXXGXXXXXXXXXXXXXXXXXXXGXXXXXXXXXXXXXXXXXXXGXXXXXXXXXXXXXXXXXXXGXXXXXXXXXXXXXXXXXXXGXXXXXXXXXXXXXXXXXXXGXXXXXXXXXXXXXXXXXXXGXXXXXXXXXXXXXXXXXXXGXXXXXXXXXXXXXXXXXXXGXXXXXXXXXXXXXXXXXXXGXXXXXXXXXXXXXXXXXXX,0,300,0
47712,13,0,13,34,253,0,0,265,211,54,GXXXXXXXXXXXXXXXXXXXGXXXXXXXXXXXXXXXXXXXGXXXXXXXXXXXXXXXXXXXGXXXXXXXXXXXXXXXXXXXGXXXXXXXXXXXXXXXXXXXGXXXXXXXXXXXXXXXXXXXGXXXXXXXXXXXXXXXXXXXGXXXXXXXXXXXXXXXXXXXGXXXXXXXXXXXXXXXXXXXGXXXXXXXXXXXXXXXXXXXGXXXXXXXXXXXXXXXXXXXGXXXXXXXXXXXXXXXXXXXGXXXXXXXXXXXXXXXXXXX,0,300,0
47733,13,0,13,36,251,0,0,263,212,51,GXXXXXXXXXXXXXXXXXXXGXXXXXXXXXXXXXXXXXXXGXXXXXXXXXXXXXXXXXXXGXXXXXXXXXXXXXXXXXXXGXXXXXXXXXXXXXXXXXXXGXXXXXXXXXXXXXXXXXXXGXXXXXXXXXXXXXXXXXXXGXXXXXXXXXXXXXXXXXXXGXXXXXXXXXXXXXXXXXXXGXXXXXXXXXXXXXXXXXXXGXXXXXXXXXXXXXXXXXXXGXXXXXXXXXXXXXXXXXXXGXXXXXXXXXXXXXXXXXXX,0,300,0
47754,13,0,13,40,247,0,0,260,209,51,GXXXXXXXXXXXXXXXXXXXGXXXXXXXXXXXXXXXXXXXGXXXXXXXXXXXXXXXXXXXGXXXXXXXXXXXXXXXXXXXGXXXXXXXXXXXXXXXXXXXGXXXXXXXXXXXXXXXXXXXGXXXXXXXXXXXXXXXXXXXGXXXXXXXXXXXXXXXXXXXGXXXXXXXXXXXXXXXXXXXGXXXXXXXXXXXXXXXXXXXGXXXXXXXXXXXXXXXXXXXGXXXXXXXXXXXXXXXXXXXGXXXXXXXXXXXXXXXXXXX,0,300,0

47775,13,0,13,37,250,0,0,263,212,51,GXXXXXXXXXXXXXXXXXXXGXXXXXXXXXXXXXXXXXXXGXXXXXXXXXXXXXXXXXXXGXXXXXXXXXXXXXXXXXXXGXXXXXXXXXXXXXXXXXXXGXXXXXXXXXXXXXXXXXXXGXXXXXXXXXXXXXXXXXXXGXXXXXXXXXXXXXXXXXXXGXXXXXXXXXXXXXXXXXXXGXXXXXXXXXXXXXXXXXXXGXXXXXXXXXXXXXXXXXXXGXXXXXXXXXXXXXXXXXXXGXXXXXXXXXXXXXXXXXXX,0,300,0
47796,13,0,13,34,253,0,0,266,212,54,GXXXXXXXXXXXXXXXXXXXGXXXXXXXXXXXXXXXXXXXGXXXXXXXXXXXXXXXXXXXGXXXXXXXXXXXXXXXXXXXGXXXXXXXXXXXXXXXXXXXGXXXXXXXXXXXXXXXXXXXGXXXXXXXXXXXXXXXXXXXGXXXXXXXXXXXXXXXXXXXGXXXXXXXXXXXXXXXXXXXGXXXXXXXXXXXXXXXXXXXGXXXXXXXXXXXXXXXXXXXGXXXXXXXXXXXXXXXXXXXGXXXXXXXXXXXXXXXXXXX,0,300,0
47817,13,0,13,36,251,0,0,264,212,52,GXXXXXXXXXXXXXXXXXXXGXXXXXXXXXXXXXXXXXXXGXXXXXXXXXXXXXXXXXXXGXXXXXXXXXXXXXXXXXXXGXXXXXXXXXXXXXXXXXXXGXXXXXXXXXXXXXXXXXXXGXXXXXXXXXXXXXXXXXXXGXXXXXXXXXXXXXXXXXXXGXXXXXXXXXXXXXXXXXXXGXXXXXXXXXXXXXXXXXXXGXXXXXXXXXXXXXXXXXXXGXXXXXXXXXXXXXXXXXXXGXXXXXXXXXXXXXXXXXXX,0,300,0
47838,14,1,13,32,254,0,0,266,212,54,GXXXXXXXXXXXXXXXXXXXGXXXXXXXXXXXXXXXXXXXGXXXXXXXXXXXXXXXXXXXGXXXXXXXXXXXXXXXXXXXGXXXXXXXXXXXXXXXXXXXGXXXXXXXXXXXXXXXXXXXGXXXXXXXXXXXXXXXXXXXGXXXXXXXXXXXXXXXXXXXGAXXXXXXXXXXXXXXXXXXGXXXXXXXXXXXXXXXXXXXGXXXXXXXXXXXXXXXXXXXGXXXXXXXXXXXXXXXXXXXGXXXXXXXXXXXXXXXXXXX,0,300,0
47859,14,1,13,34,252,0,0,264,213,51,GXXXXXXXXXXXXXXXXXXXGXXXXXXXXXXXXXXXXXXXGXXXXXXXXXXXXXXXXXXXGXXXXXXXXXXXXXXXXXXXGXXXXXXXXXXXXXXXXXXXGXXXXXXXXXXXXXXXXXXXGXXXXXXXXXXXXXXXXXXXGXXXXXXXXXXXXXXXXXXXGAXXXXXXXXXXXXXXXXXXGXXXXXXXXXXXXXXXXXXXGXXXXXXXXXXXXXXXXXXXGXXXXXXXXXXXXXXXXXXXGXXXXXXXXXXXXXXXXXXX,0,300,0

47880,14,1,13,33,253,0,0,265,215,50,GXXXXXXXXXXXXXXXXXXXGXXXXXXXXXXXXXXXXXXXGXXXXXXXXXXXXXXXXXXXGXXXXXXXXXXXXXXXXXXXGXXXXXXXXXXXXXXXXXXXGXXXXXXXXXXXXXXXXXXXGXXXXXXXXXXXXXXXXXXXGXXXXXXXXXXXXXXXXXXXGAXXXXXXXXXXXXXXXXXXGXXXXXXXXXXXXXXXXXXXGXXXXXXXXXXXXXXXXXXXGXXXXXXXXXXXXXXXXXXXGXXXXXXXXXXXXXXXXXXX,0,300,0
47901,14,1,13,32,254,0,0,267,213,54,GXXXXXXXXXXXXXXXXXXXGXXXXXXXXXXXXXXXXXXXGXXXXXXXXXXXXXXXXXXXGXXXXXXXXXXXXXXXXXXXGXXXXXXXXXXXXXXXXXXXGXXXXXXXXXXXXXXXXXXXGXXXXXXXXXXXXXXXXXXXGXXXXXXXXXXXXXXXXXXXGAXXXXXXXXXXXXXXXXXXGXXXXXXXXXXXXXXXXXXXGXXXXXXXXXXXXXXXXXXXGXXXXXXXXXXXXXXXXXXXGXXXXXXXXXXXXXXXXXXX,0,300,0
47922,14,1,13,35,251,0,0,264,213,51,GXXXXXXXXXXXXXXXXXXXGXXXXXXXXXXXXXXXXXXXGXXXXXXXXXXXXXXXXXXXGXXXXXXXXXXXXXXXXXXXGXXXXXXXXXXXXXXXXXXXGXXXXXXXXXXXXXXXXXXXGXXXXXXXXXXXXXXXXXXXGXXXXXXXXXXXXXXXXXXXGAXXXXXXXXXXXXXXXXXXGXXXXXXXXXXXXXXXXXXXGXXXXXXXXXXXXXXXXXXXGXXXXXXXXXXXXXXXXXXXGXXXXXXXXXXXXXXXXXXX,0,300,0
47943,14,1,13,37,249,0,0,262,209,53,GXXXXXXXXXXXXXXXXXXXGXXXXXXXXXXXXXXXXXXXGXXXXXXXXXXXXXXXXXXXGXXXXXXXXXXXXXXXXXXXGXXXXXXXXXXXXXXXXXXXGXXXXXXXXXXXXXXXXXXXGXXXXXXXXXXXXXXXXXXXGXXXXXXXXXXXXXXXXXXXGAXXXXXXXXXXXXXXXXXXGXXXXXXXXXXXXXXXXXXXGXXXXXXXXXXXXXXXXXXXGXXXXXXXXXXXXXXXXXXXGXXXXXXXXXXXXXXXXXXX,0,300,0
47964,14,1,13,36,250,0,0,263,208,55,GXXXXXXXXXXXXXXXXXXXGXXXXXXXXXXXXXXXXXXXGXXXXXXXXXXXXXXXXXXXGXXXXXXXXXXXXXXXXXXXGXXXXXXXXXXXXXXXXXXXGXXXXXXXXXXXXXXXXXXXGXXXXXXXXXXXXXXXXXXXGXXXXXXXXXXXXXXXXXXXGAXXXXXXXXXXXXXXXXXXGXXXXXXXXXXXXXXXXXXXGXXXXXXXXXXXXXXXXXXXGXXXXXXXXXXXXXXXXXXXGXXXXXXXXXXXXXXXXXXX,0,300,0

47985,14,1,13,37,249,0,0,263,209,54,GXXXXXXXXXXXXXXXXXXXGXXXXXXXXXXXXXXXXXXXGXXXXXXXXXXXXXXXXXXXGXXXXXXXXXXXXXXXXXXXGXXXXXXXXXXXXXXXXXXXGXXXXXXXXXXXXXXXXXXXGXXXXXXXXXXXXXXXXXXXGXXXXXXXXXXXXXXXXXXXGAXXXXXXXXXXXXXXXXXXGXXXXXXXXXXXXXXXXXXXGXXXXXXXXXXXXXXXXXXXGXXXXXXXXXXXXXXXXXXXGXXXXXXXXXXXXXXXXXXX,0,300,0
48006,13,0,13,39,248,0,0,262,209,53,GXXXXXXXXXXXXXXXXXXXGXXXXXXXXXXXXXXXXXXXGXXXXXXXXXXXXXXXXXXXGXXXXXXXXXXXXXXXXXXXGXXXXXXXXXXXXXXXXXXXGXXXXXXXXXXXXXXXXXXXGXXXXXXXXXXXXXXXXXXXGXXXXXXXXXXXXXXXXXXXGXXXXXXXXXXXXXXXXXXXGXXXXXXXXXXXXXXXXXXXGXXXXXXXXXXXXXXXXXXXGXXXXXXXXXXXXXXXXXXXGXXXXXXXXXXXXXXXXXXX,0,300,0
48027,13,0,13,38,249,0,0,262,209,53,GXXXXXXXXXXXXXXXXXXXGXXXXXXXXXXXXXXXXXXXGXXXXXXXXXXXXXXXXXXXGXXXXXXXXXXXXXXXXXXXGXXXXXXXXXXXXXXXXXXXGXXXXXXXXXXXXXXXXXXXGXXXXXXXXXXXXXXXXXXXGXXXXXXXXXXXXXXXXXXXGXXXXXXXXXXXXXXXXXXXGXXXXXXXXXXXXXXXXXXXGXXXXXXXXXXXXXXXXXXXGXXXXXXXXXXXXXXXXXXXGXXXXXXXXXXXXXXXXXXX,0,300,0
48048,13,0,13,34,253,0,0,267,212,55,GXXXXXXXXXXXXXXXXXXXGXXXXXXXXXXXXXXXXXXXGXXXXXXXXXXXXXXXXXXXGXXXXXXXXXXXXXXXXXXXGXXXXXXXXXXXXXXXXXXXGXXXXXXXXXXXXXXXXXXXGXXXXXXXXXXXXXXXXXXXGXXXXXXXXXXXXXXXXXXXGXXXXXXXXXXXXXXXXXXXGXXXXXXXXXXXXXXXXXXXGXXXXXXXXXXXXXXXXXXXGXXXXXXXXXXXXXXXXXXXGXXXXXXXXXXXXXXXXXXX,0,300,0
48069,13,0,13,28,259,0,0,271,213,58,GXXXXXXXXXXXXXXXXXXXGXXXXXXXXXXXXXXXXXXXGXXXXXXXXXXXXXXXXXXXGXXXXXXXXXXXXXXXXXXXGXXXXXXXXXXXXXXXXXXXGXXXXXXXXXXXXXXXXXXXGXXXXXXXXXXXXXXXXXXXGXXXXXXXXXXXXXXXXXXXGXXXXXXXXXXXXXXXXXXXGXXXXXXXXXXXXXXXXXXXGXXXXXXXXXXXXXXXXXXXGXXXXXXXXXXXXXXXXXXXGXXXXXXXXXXXXXXXXXXX,0,300,0

48090,13,0,13,30,257,0,0,270,213,57,GXXXXXXXXXXXXXXXXXXXGXXXXXXXXXXXXXXXXXXXGXXXXXXXXXXXXXXXXXXXGXXXXXXXXXXXXXXXXXXXGXXXXXXXXXXXXXXXXXXXGXXXXXXXXXXXXXXXXXXXGXXXXXXXXXXXXXXXXXXXGXXXXXXXXXXXXXXXXXXXGXXXXXXXXXXXXXXXXXXXGXXXXXXXXXXXXXXXXXXXGXXXXXXXXXXXXXXXXXXXGXXXXXXXXXXXXXXXXXXXGXXXXXXXXXXXXXXXXXXX,0,300,0
48111,13,0,13,30,257,0,0,270,212,58,GXXXXXXXXXXXXXXXXXXXGXXXXXXXXXXXXXXXXXXXGXXXXXXXXXXXXXXXXXXXGXXXXXXXXXXXXXXXXXXXGXXXXXXXXXXXXXXXXXXXGXXXXXXXXXXXXXXXXXXXGXXXXXXXXXXXXXXXXXXXGXXXXXXXXXXXXXXXXXXXGXXXXXXXXXXXXXXXXXXXGXXXXXXXXXXXXXXXXXXXGXXXXXXXXXXXXXXXXXXXGXXXXXXXXXXXXXXXXXXXGXXXXXXXXXXXXXXXXXXX,0,300,0
48132,13,0,13,30,257,0,0,271,207,64,GXXXXXXXXXXXXXXXXXXXGXXXXXXXXXXXXXXXXXXXGXXXXXXXXXXXXXXXXXXXGXXXXXXXXXXXXXXXXXXXGXXXXXXXXXXXXXXXXXXXGXXXXXXXXXXXXXXXXXXXGXXXXXXXXXXXXXXXXXXXGXXXXXXXXXXXXXXXXXXXGXXXXXXXXXXXXXXXXXXXGXXXXXXXXXXXXXXXXXXXGXXXXXXXXXXXXXXXXXXXGXXXXXXXXXXXXXXXXXXXGXXXXXXXXXXXXXXXXXXX,0,300,0
48153,13,0,13,29,258,0,0,271,208,63,GXXXXXXXXXXXXXXXXXXXGXXXXXXXXXXXXXXXXXXXGXXXXXXXXXXXXXXXXXXXGXXXXXXXXXXXXXXXXXXXGXXXXXXXXXXXXXXXXXXXGXXXXXXXXXXXXXXXXXXXGXXXXXXXXXXXXXXXXXXXGXXXXXXXXXXXXXXXXXXXGXXXXXXXXXXXXXXXXXXXGXXXXXXXXXXXXXXXXXXXGXXXXXXXXXXXXXXXXXXXGXXXXXXXXXXXXXXXXXXXGXXXXXXXXXXXXXXXXXXX,0,300,0
48174,13,0,13,28,259,0,0,272,209,63,GXXXXXXXXXXXXXXXXXXXGXXXXXXXXXXXXXXXXXXXGXXXXXXXXXXXXXXXXXXXGXXXXXXXXXXXXXXXXXXXGXXXXXXXXXXXXXXXXXXXGXXXXXXXXXXXXXXXXXXXGXXXXXXXXXXXXXXXXXXXGXXXXXXXXXXXXXXXXXXXGXXXXXXXXXXXXXXXXXXXGXXXXXXXXXXXXXXXXXXXGXXXXXXXXXXXXXXXXXXXGXXXXXXXXXXXXXXXXXXXGXXXXXXXXXXXXXXXXXXX,0,300,0

48195,13,0,13,34,253,0,0,266,210,56,GXXXXXXXXXXXXXXXXXXXGXXXXXXXXXXXXXXXXXXXGXXXXXXXXXXXXXXXXXXXGXXXXXXXXXXXXXXXXXXXGXXXXXXXXXXXXXXXXXXXGXXXXXXXXXXXXXXXXXXXGXXXXXXXXXXXXXXXXXXXGXXXXXXXXXXXXXXXXXXXGXXXXXXXXXXXXXXXXXXXGXXXXXXXXXXXXXXXXXXXGXXXXXXXXXXXXXXXXXXXGXXXXXXXXXXXXXXXXXXXGXXXXXXXXXXXXXXXXXXX,0,300,0
48216,13,0,13,31,256,0,0,268,211,57,GXXXXXXXXXXXXXXXXXXXGXXXXXXXXXXXXXXXXXXXGXXXXXXXXXXXXXXXXXXXGXXXXXXXXXXXXXXXXXXXGXXXXXXXXXXXXXXXXXXXGXXXXXXXXXXXXXXXXXXXGXXXXXXXXXXXXXXXXXXXGXXXXXXXXXXXXXXXXXXXGXXXXXXXXXXXXXXXXXXXGXXXXXXXXXXXXXXXXXXXGXXXXXXXXXXXXXXXXXXXGXXXXXXXXXXXXXXXXXXXGXXXXXXXXXXXXXXXXXXX,0,300,0
48237,13,0,13,29,258,0,0,271,212,59,GXXXXXXXXXXXXXXXXXXXGXXXXXXXXXXXXXXXXXXXGXXXXXXXXXXXXXXXXXXXGXXXXXXXXXXXXXXXXXXXGXXXXXXXXXXXXXXXXXXXGXXXXXXXXXXXXXXXXXXXGXXXXXXXXXXXXXXXXXXXGXXXXXXXXXXXXXXXXXXXGXXXXXXXXXXXXXXXXXXXGXXXXXXXXXXXXXXXXXXXGXXXXXXXXXXXXXXXXXXXGXXXXXXXXXXXXXXXXXXXGXXXXXXXXXXXXXXXXXXX,0,300,0
48258,13,0,13,31,256,0,0,269,212,57,GXXXXXXXXXXXXXXXXXXXGXXXXXXXXXXXXXXXXXXXGXXXXXXXXXXXXXXXXXXXGXXXXXXXXXXXXXXXXXXXGXXXXXXXXXXXXXXXXXXXGXXXXXXXXXXXXXXXXXXXGXXXXXXXXXXXXXXXXXXXGXXXXXXXXXXXXXXXXXXXGXXXXXXXXXXXXXXXXXXXGXXXXXXXXXXXXXXXXXXXGXXXXXXXXXXXXXXXXXXXGXXXXXXXXXXXXXXXXXXXGXXXXXXXXXXXXXXXXXXX,0,300,0
48279,13,0,13,32,255,0,0,268,213,55,GXXXXXXXXXXXXXXXXXXXGXXXXXXXXXXXXXXXXXXXGXXXXXXXXXXXXXXXXXXXGXXXXXXXXXXXXXXXXXXXGXXXXXXXXXXXXXXXXXXXGXXXXXXXXXXXXXXXXXXXGXXXXXXXXXXXXXXXXXXXGXXXXXXXXXXXXXXXXXXXGXXXXXXXXXXXXXXXXXXXGXXXXXXXXXXXXXXXXXXXGXXXXXXXXXXXXXXXXXXXGXXXXXXXXXXXXXXXXXXXGXXXXXXXXXXXXXXXXXXX,0,300,0

48300,13,0,13,34,253,0,0,266,210,56,GXXXXXXXXXXXXXXXXXXXGXXXXXXXXXXXXXXXXXXXGXXXXXXXXXXXXXXXXXXXGXXXXXXXXXXXXXXXXXXXGXXXXXXXXXXXXXXXXXXXGXXXXXXXXXXXXXXXXXXXGXXXXXXXXXXXXXXXXXXXGXXXXXXXXXXXXXXXXXXXGXXXXXXXXXXXXXXXXXXXGXXXXXXXXXXXXXXXXXXXGXXXXXXXXXXXXXXXXXXXGXXXXXXXXXXXXXXXXXXXGXXXXXXXXXXXXXXXXXXX,0,300,0
48321,13,0,13,36,251,0,0,264,209,55,GXXXXXXXXXXXXXXXXXXXGXXXXXXXXXXXXXXXXXXXGXXXXXXXXXXXXXXXXXXXGXXXXXXXXXXXXXXXXXXXGXXXXXXXXXXXXXXXXXXXGXXXXXXXXXXXXXXXXXXXGXXXXXXXXXXXXXXXXXXXGXXXXXXXXXXXXXXXXXXXGXXXXXXXXXXXXXXXXXXXGXXXXXXXXXXXXXXXXXXXGXXXXXXXXXXXXXXXXXXXGXXXXXXXXXXXXXXXXXXXGXXXXXXXXXXXXXXXXXXX,0,300,0
48342,13,0,13,38,249,0,0,262,208,54,GXXXXXXXXXXXXXXXXXXXGXXXXXXXXXXXXXXXXXXXGXXXXXXXXXXXXXXXXXXXGXXXXXXXXXXXXXXXXXXXGXXXXXXXXXXXXXXXXXXXGXXXXXXXXXXXXXXXXXXXGXXXXXXXXXXXXXXXXXXXGXXXXXXXXXXXXXXXXXXXGXXXXXXXXXXXXXXXXXXXGXXXXXXXXXXXXXXXXXXXGXXXXXXXXXXXXXXXXXXXGXXXXXXXXXXXXXXXXXXXGXXXXXXXXXXXXXXXXXXX,0,300,0
48363,14,1,13,35,251,0,0,263,209,54,GXXXXXXXXXXXXXXXXXXXGXXXXXXXXXXXXXXXXXXXGXXXXXXXXXXXXXXXXXXXGXXXXXXXXXXXXXXXXXXXGXXXXXXXXXXXXXXXXXXXGXXXXXXXXXXXXXXXXXXXGXXXXXXXXXXXXXXXXXXXGXXXXXXXXXXXXXXXXXXXGXXXXXXXXXXXXXXXXXXXGXXXXXXXXXXXXXXXXXXXGXXXXXXXXXXXXXXXXXXXGXXXXXXXXXXXXXXXXXXXGAXXXXXXXXXXXXXXXXXX,0,300,0
48384,14,1,13,34,252,0,0,266,209,57,GXXXXXXXXXXXXXXXXXXXGXXXXXXXXXXXXXXXXXXXGXXXXXXXXXXXXXXXXXXXGXXXXXXXXXXXXXXXXXXXGXXXXXXXXXXXXXXXXXXXGXXXXXXXXXXXXXXXXXXXGXXXXXXXXXXXXXXXXXXXGXXXXXXXXXXXXXXXXXXXGXXXXXXXXXXXXXXXXXXXGXXXXXXXXXXXXXXXXXXXGXXXXXXXXXXXXXXXXXXXGXXXXXXXXXXXXXXXXXXXGAXXXXXXXXXXXXXXXXXX,0,300,0

48405,14,1,13,34,252,0,0,266,211,55,GXXXXXXXXXXXXXXXXXXXGXXXXXXXXXXXXXXXXXXXGXXXXXXXXXXXXXXXXXXXGXXXXXXXXXXXXXXXXXXXGXXXXXXXXXXXXXXXXXXXGXXXXXXXXXXXXXXXXXXXGXXXXXXXXXXXXXXXXXXXGXXXXXXXXXXXXXXXXXXXGXXXXXXXXXXXXXXXXXXXGXXXXXXXXXXXXXXXXXXXGXXXXXXXXXXXXXXXXXXXGXXXXXXXXXXXXXXXXXXXGAXXXXXXXXXXXXXXXXXX,0,300,0
48426,14,1,13,32,254,0,0,268,211,57,GXXXXXXXXXXXXXXXXXXXGXXXXXXXXXXXXXXXXXXXGXXXXXXXXXXXXXXXXXXXGXXXXXXXXXXXXXXXXXXXGXXXXXXXXXXXXXXXXXXXGXXXXXXXXXXXXXXXXXXXGXXXXXXXXXXXXXXXXXXXGXXXXXXXXXXXXXXXXXXXGXXXXXXXXXXXXXXXXXXXGXXXXXXXXXXXXXXXXXXXGXXXXXXXXXXXXXXXXXXXGXXXXXXXXXXXXXXXXXXXGAXXXXXXXXXXXXXXXXXX,0,300,0
48447,14,1,13,33,253,0,0,267,211,56,GXXXXXXXXXXXXXXXXXXXGXXXXXXXXXXXXXXXXXXXGXXXXXXXXXXXXXXXXXXXGXXXXXXXXXXXXXXXXXXXGXXXXXXXXXXXXXXXXXXXGXXXXXXXXXXXXXXXXXXXGXXXXXXXXXXXXXXXXXXXGXXXXXXXXXXXXXXXXXXXGXXXXXXXXXXXXXXXXXXXGXXXXXXXXXXXXXXXXXXXGXXXXXXXXXXXXXXXXXXXGXXXXXXXXXXXXXXXXXXXGAXXXXXXXXXXXXXXXXXX,0,300,0
48468,13,0,13,33,254,0,0,266,209,57,GXXXXXXXXXXXXXXXXXXXGXXXXXXXXXXXXXXXXXXXGXXXXXXXXXXXXXXXXXXXGXXXXXXXXXXXXXXXXXXXGXXXXXXXXXXXXXXXXXXXGXXXXXXXXXXXXXXXXXXXGXXXXXXXXXXXXXXXXXXXGXXXXXXXXXXXXXXXXXXXGXXXXXXXXXXXXXXXXXXXGXXXXXXXXXXXXXXXXXXXGXXXXXXXXXXXXXXXXXXXGXXXXXXXXXXXXXXXXXXXGXXXXXXXXXXXXXXXXXXX,0,300,0
48489,13,0,13,33,254,0,0,267,210,57,GXXXXXXXXXXXXXXXXXXXGXXXXXXXXXXXXXXXXXXXGXXXXXXXXXXXXXXXXXXXGXXXXXXXXXXXXXXXXXXXGXXXXXXXXXXXXXXXXXXXGXXXXXXXXXXXXXXXXXXXGXXXXXXXXXXXXXXXXXXXGXXXXXXXXXXXXXXXXXXXGXXXXXXXXXXXXXXXXXXXGXXXXXXXXXXXXXXXXXXXGXXXXXXXXXXXXXXXXXXXGXXXXXXXXXXXXXXXXXXXGXXXXXXXXXXXXXXXXXXX,0,300,0

48510,13,0,13,35,252,0,0,265,210,55,GXXXXXXXXXXXXXXXXXXXGXXXXXXXXXXXXXXXXXXXGXXXXXXXXXXXXXXXXXXXGXXXXXXXXXXXXXXXXXXXGXXXXXXXXXXXXXXXXXXXGXXXXXXXXXXXXXXXXXXXGXXXXXXXXXXXXXXXXXXXGXXXXXXXXXXXXXXXXXXXGXXXXXXXXXXXXXXXXXXXGXXXXXXXXXXXXXXXXXXXGXXXXXXXXXXXXXXXXXXXGXXXXXXXXXXXXXXXXXXXGXXXXXXXXXXXXXXXXXXX,0,300,0
48531,13,0,13,35,252,0,0,264,212,52,GXXXXXXXXXXXXXXXXXXXGXXXXXXXXXXXXXXXXXXXGXXXXXXXXXXXXXXXXXXXGXXXXXXXXXXXXXXXXXXXGXXXXXXXXXXXXXXXXXXXGXXXXXXXXXXXXXXXXXXXGXXXXXXXXXXXXXXXXXXXGXXXXXXXXXXXXXXXXXXXGXXXXXXXXXXXXXXXXXXXGXXXXXXXXXXXXXXXXXXXGXXXXXXXXXXXXXXXXXXXGXXXXXXXXXXXXXXXXXXXGXXXXXXXXXXXXXXXXXXX,0,300,0
48552,13,0,13,34,253,0,0,266,212,54,GXXXXXXXXXXXXXXXXXXXGXXXXXXXXXXXXXXXXXXXGXXXXXXXXXXXXXXXXXXXGXXXXXXXXXXXXXXXXXXXGXXXXXXXXXXXXXXXXXXXGXXXXXXXXXXXXXXXXXXXGXXXXXXXXXXXXXXXXXXXGXXXXXXXXXXXXXXXXXXXGXXXXXXXXXXXXXXXXXXXGXXXXXXXXXXXXXXXXXXXGXXXXXXXXXXXXXXXXXXXGXXXXXXXXXXXXXXXXXXXGXXXXXXXXXXXXXXXXXXX,0,300,0
48573,13,0,13,31,256,0,0,269,213,56,GXXXXXXXXXXXXXXXXXXXGXXXXXXXXXXXXXXXXXXXGXXXXXXXXXXXXXXXXXXXGXXXXXXXXXXXXXXXXXXXGXXXXXXXXXXXXXXXXXXXGXXXXXXXXXXXXXXXXXXXGXXXXXXXXXXXXXXXXXXXGXXXXXXXXXXXXXXXXXXXGXXXXXXXXXXXXXXXXXXXGXXXXXXXXXXXXXXXXXXXGXXXXXXXXXXXXXXXXXXXGXXXXXXXXXXXXXXXXXXXGXXXXXXXXXXXXXXXXXXX,0,300,0
48594,13,0,13,31,256,0,0,268,215,53,GXXXXXXXXXXXXXXXXXXXGXXXXXXXXXXXXXXXXXXXGXXXXXXXXXXXXXXXXXXXGXXXXXXXXXXXXXXXXXXXGXXXXXXXXXXXXXXXXXXXGXXXXXXXXXXXXXXXXXXXGXXXXXXXXXXXXXXXXXXXGXXXXXXXXXXXXXXXXXXXGXXXXXXXXXXXXXXXXXXXGXXXXXXXXXXXXXXXXXXXGXXXXXXXXXXXXXXXXXXXGXXXXXXXXXXXXXXXXXXXGXXXXXXXXXXXXXXXXXXX,0,300,0

48615,13,0,13,29,258,0,0,270,219,51,GXXXXXXXXXXXXXXXXXXXGXXXXXXXXXXXXXXXXXXXGXXXXXXXXXXXXXXXXXXXGXXXXXXXXXXXXXXXXXXXGXXXXXXXXXXXXXXXXXXXGXXXXXXXXXXXXXXXXXXXGXXXXXXXXXXXXXXXXXXXGXXXXXXXXXXXXXXXXXXXGXXXXXXXXXXXXXXXXXXXGXXXXXXXXXXXXXXXXXXXGXXXXXXXXXXXXXXXXXXXGXXXXXXXXXXXXXXXXXXXGXXXXXXXXXXXXXXXXXXX,0,300,0
48636,13,0,13,34,253,0,0,265,217,48,GXXXXXXXXXXXXXXXXXXXGXXXXXXXXXXXXXXXXXXXGXXXXXXXXXXXXXXXXXXXGXXXXXXXXXXXXXXXXXXXGXXXXXXXXXXXXXXXXXXXGXXXXXXXXXXXXXXXXXXXGXXXXXXXXXXXXXXXXXXXGXXXXXXXXXXXXXXXXXXXGXXXXXXXXXXXXXXXXXXXGXXXXXXXXXXXXXXXXXXXGXXXXXXXXXXXXXXXXXXXGXXXXXXXXXXXXXXXXXXXGXXXXXXXXXXXXXXXXXXX,0,300,0
48657,13,0,13,34,253,0,0,265,215,50,GXXXXXXXXXXXXXXXXXXXGXXXXXXXXXXXXXXXXXXXGXXXXXXXXXXXXXXXXXXXGXXXXXXXXXXXXXXXXXXXGXXXXXXXXXXXXXXXXXXXGXXXXXXXXXXXXXXXXXXXGXXXXXXXXXXXXXXXXXXXGXXXXXXXXXXXXXXXXXXXGXXXXXXXXXXXXXXXXXXXGXXXXXXXXXXXXXXXXXXXGXXXXXXXXXXXXXXXXXXXGXXXXXXXXXXXXXXXXXXXGXXXXXXXXXXXXXXXXXXX,0,300,0
48678,13,0,13,38,249,0,0,261,210,51,GXXXXXXXXXXXXXXXXXXXGXXXXXXXXXXXXXXXXXXXGXXXXXXXXXXXXXXXXXXXGXXXXXXXXXXXXXXXXXXXGXXXXXXXXXXXXXXXXXXXGXXXXXXXXXXXXXXXXXXXGXXXXXXXXXXXXXXXXXXXGXXXXXXXXXXXXXXXXXXXGXXXXXXXXXXXXXXXXXXXGXXXXXXXXXXXXXXXXXXXGXXXXXXXXXXXXXXXXXXXGXXXXXXXXXXXXXXXXXXXGXXXXXXXXXXXXXXXXXXX,0,300,0
48699,13,0,13,38,249,0,0,261,209,52,GXXXXXXXXXXXXXXXXXXXGXXXXXXXXXXXXXXXXXXXGXXXXXXXXXXXXXXXXXXXGXXXXXXXXXXXXXXXXXXXGXXXXXXXXXXXXXXXXXXXGXXXXXXXXXXXXXXXXXXXGXXXXXXXXXXXXXXXXXXXGXXXXXXXXXXXXXXXXXXXGXXXXXXXXXXXXXXXXXXXGXXXXXXXXXXXXXXXXXXXGXXXXXXXXXXXXXXXXXXXGXXXXXXXXXXXXXXXXXXXGXXXXXXXXXXXXXXXXXXX,0,300,0

48720,13,0,13,33,254,0,0,266,213,53,GXXXXXXXXXXXXXXXXXXXGXXXXXXXXXXXXXXXXXXXGXXXXXXXXXXXXXXXXXXXGXXXXXXXXXXXXXXXXXXXGXXXXXXXXXXXXXXXXXXXGXXXXXXXXXXXXXXXXXXXGXXXXXXXXXXXXXXXXXXXGXXXXXXXXXXXXXXXXXXXGXXXXXXXXXXXXXXXXXXXGXXXXXXXXXXXXXXXXXXXGXXXXXXXXXXXXXXXXXXXGXXXXXXXXXXXXXXXXXXXGXXXXXXXXXXXXXXXXXXX,0,300,0
48741,13,0,13,34,253,0,0,265,212,53,GXXXXXXXXXXXXXXXXXXXGXXXXXXXXXXXXXXXXXXXGXXXXXXXXXXXXXXXXXXXGXXXXXXXXXXXXXXXXXXXGXXXXXXXXXXXXXXXXXXXGXXXXXXXXXXXXXXXXXXXGXXXXXXXXXXXXXXXXXXXGXXXXXXXXXXXXXXXXXXXGXXXXXXXXXXXXXXXXXXXGXXXXXXXXXXXXXXXXXXXGXXXXXXXXXXXXXXXXXXXGXXXXXXXXXXXXXXXXXXXGXXXXXXXXXXXXXXXXXXX,0,300,0
48762,13,0,13,30,257,0,0,269,213,56,GXXXXXXXXXXXXXXXXXXXGXXXXXXXXXXXXXXXXXXXGXXXXXXXXXXXXXXXXXXXGXXXXXXXXXXXXXXXXXXXGXXXXXXXXXXXXXXXXXXXGXXXXXXXXXXXXXXXXXXXGXXXXXXXXXXXXXXXXXXXGXXXXXXXXXXXXXXXXXXXGXXXXXXXXXXXXXXXXXXXGXXXXXXXXXXXXXXXXXXXGXXXXXXXXXXXXXXXXXXXGXXXXXXXXXXXXXXXXXXXGXXXXXXXXXXXXXXXXXXX,0,300,0
48783,13,0,13,34,253,0,0,265,208,57,GXXXXXXXXXXXXXXXXXXXGXXXXXXXXXXXXXXXXXXXGXXXXXXXXXXXXXXXXXXXGXXXXXXXXXXXXXXXXXXXGXXXXXXXXXXXXXXXXXXXGXXXXXXXXXXXXXXXXXXXGXXXXXXXXXXXXXXXXXXXGXXXXXXXXXXXXXXXXXXXGXXXXXXXXXXXXXXXXXXXGXXXXXXXXXXXXXXXXXXXGXXXXXXXXXXXXXXXXXXXGXXXXXXXXXXXXXXXXXXXGXXXXXXXXXXXXXXXXXXX,0,300,0
48804,13,0,13,37,250,0,0,261,211,50,GXXXXXXXXXXXXXXXXXXXGXXXXXXXXXXXXXXXXXXXGXXXXXXXXXXXXXXXXXXXGXXXXXXXXXXXXXXXXXXXGXXXXXXXXXXXXXXXXXXXGXXXXXXXXXXXXXXXXXXXGXXXXXXXXXXXXXXXXXXXGXXXXXXXXXXXXXXXXXXXGXXXXXXXXXXXXXXXXXXXGXXXXXXXXXXXXXXXXXXXGXXXXXXXXXXXXXXXXXXXGXXXXXXXXXXXXXXXXXXXGXXXXXXXXXXXXXXXXXXX,0,300,0

48825,13,0,13,38,249,0,0,262,208,54,GXXXXXXXXXXXXXXXXXXXGXXXXXXXXXXXXXXXXXXXGXXXXXXXXXXXXXXXXXXXGXXXXXXXXXXXXXXXXXXXGXXXXXXXXXXXXXXXXXXXGXXXXXXXXXXXXXXXXXXXGXXXXXXXXXXXXXXXXXXXGXXXXXXXXXXXXXXXXXXXGXXXXXXXXXXXXXXXXXXXGXXXXXXXXXXXXXXXXXXXGXXXXXXXXXXXXXXXXXXXGXXXXXXXXXXXXXXXXXXXGXXXXXXXXXXXXXXXXXXX,0,300,0
48846,13,0,13,37,250,0,0,263,211,52,GXXXXXXXXXXXXXXXXXXXGXXXXXXXXXXXXXXXXXXXGXXXXXXXXXXXXXXXXXXXGXXXXXXXXXXXXXXXXXXXGXXXXXXXXXXXXXXXXXXXGXXXXXXXXXXXXXXXXXXXGXXXXXXXXXXXXXXXXXXXGXXXXXXXXXXXXXXXXXXXGXXXXXXXXXXXXXXXXXXXGXXXXXXXXXXXXXXXXXXXGXXXXXXXXXXXXXXXXXXXGXXXXXXXXXXXXXXXXXXXGXXXXXXXXXXXXXXXXXXX,0,300,0
48867,13,0,13,38,249,0,0,262,210,52,GXXXXXXXXXXXXXXXXXXXGXXXXXXXXXXXXXXXXXXXGXXXXXXXXXXXXXXXXXXXGXXXXXXXXXXXXXXXXXXXGXXXXXXXXXXXXXXXXXXXGXXXXXXXXXXXXXXXXXXXGXXXXXXXXXXXXXXXXXXXGXXXXXXXXXXXXXXXXXXXGXXXXXXXXXXXXXXXXXXXGXXXXXXXXXXXXXXXXXXXGXXXXXXXXXXXXXXXXXXXGXXXXXXXXXXXXXXXXXXXGXXXXXXXXXXXXXXXXXXX,0,300,0
48888,13,0,13,34,253,0,0,266,210,56,GXXXXXXXXXXXXXXXXXXXGXXXXXXXXXXXXXXXXXXXGXXXXXXXXXXXXXXXXXXXGXXXXXXXXXXXXXXXXXXXGXXXXXXXXXXXXXXXXXXXGXXXXXXXXXXXXXXXXXXXGXXXXXXXXXXXXXXXXXXXGXXXXXXXXXXXXXXXXXXXGXXXXXXXXXXXXXXXXXXXGXXXXXXXXXXXXXXXXXXXGXXXXXXXXXXXXXXXXXXXGXXXXXXXXXXXXXXXXXXXGXXXXXXXXXXXXXXXXXXX,0,300,0
48909,13,0,13,33,254,0,0,267,211,56,GXXXXXXXXXXXXXXXXXXXGXXXXXXXXXXXXXXXXXXXGXXXXXXXXXXXXXXXXXXXGXXXXXXXXXXXXXXXXXXXGXXXXXXXXXXXXXXXXXXXGXXXXXXXXXXXXXXXXXXXGXXXXXXXXXXXXXXXXXXXGXXXXXXXXXXXXXXXXXXXGXXXXXXXXXXXXXXXXXXXGXXXXXXXXXXXXXXXXXXXGXXXXXXXXXXXXXXXXXXXGXXXXXXXXXXXXXXXXXXXGXXXXXXXXXXXXXXXXXXX,0,300,0

48930,13,0,13,28,259,0,0,270,213,57,GXXXXXXXXXXXXXXXXXXXGXXXXXXXXXXXXXXXXXXXGXXXXXXXXXXXXXXXXXXXGXXXXXXXXXXXXXXXXXXXGXXXXXXXXXXXXXXXXXXXGXXXXXXXXXXXXXXXXXXXGXXXXXXXXXXXXXXXXXXXGXXXXXXXXXXXXXXXXXXXGXXXXXXXXXXXXXXXXXXXGXXXXXXXXXXXXXXXXXXXGXXXXXXXXXXXXXXXXXXXGXXXXXXXXXXXXXXXXXXXGXXXXXXXXXXXXXXXXXXX,0,300,0
48951,13,0,13,31,256,0,0,268,213,55,GXXXXXXXXXXXXXXXXXXXGXXXXXXXXXXXXXXXXXXXGXXXXXXXXXXXXXXXXXXXGXXXXXXXXXXXXXXXXXXXGXXXXXXXXXXXXXXXXXXXGXXXXXXXXXXXXXXXXXXXGXXXXXXXXXXXXXXXXXXXGXXXXXXXXXXXXXXXXXXXGXXXXXXXXXXXXXXXXXXXGXXXXXXXXXXXXXXXXXXXGXXXXXXXXXXXXXXXXXXXGXXXXXXXXXXXXXXXXXXXGXXXXXXXXXXXXXXXXXXX,0,300,0
48972,13,0,13,35,252,0,0,264,210,54,GXXXXXXXXXXXXXXXXXXXGXXXXXXXXXXXXXXXXXXXGXXXXXXXXXXXXXXXXXXXGXXXXXXXXXXXXXXXXXXXGXXXXXXXXXXXXXXXXXXXGXXXXXXXXXXXXXXXXXXXGXXXXXXXXXXXXXXXXXXXGXXXXXXXXXXXXXXXXXXXGXXXXXXXXXXXXXXXXXXXGXXXXXXXXXXXXXXXXXXXGXXXXXXXXXXXXXXXXXXXGXXXXXXXXXXXXXXXXXXXGXXXXXXXXXXXXXXXXXXX,0,300,0
48993,13,0,13,37,250,0,0,262,210,52,GXXXXXXXXXXXXXXXXXXXGXXXXXXXXXXXXXXXXXXXGXXXXXXXXXXXXXXXXXXXGXXXXXXXXXXXXXXXXXXXGXXXXXXXXXXXXXXXXXXXGXXXXXXXXXXXXXXXXXXXGXXXXXXXXXXXXXXXXXXXGXXXXXXXXXXXXXXXXXXXGXXXXXXXXXXXXXXXXXXXGXXXXXXXXXXXXXXXXXXXGXXXXXXXXXXXXXXXXXXXGXXXXXXXXXXXXXXXXXXXGXXXXXXXXXXXXXXXXXXX,0,300,0
49014,13,0,13,34,253,0,0,265,213,52,GXXXXXXXXXXXXXXXXXXXGXXXXXXXXXXXXXXXXXXXGXXXXXXXXXXXXXXXXXXXGXXXXXXXXXXXXXXXXXXXGXXXXXXXXXXXXXXXXXXXGXXXXXXXXXXXXXXXXXXXGXXXXXXXXXXXXXXXXXXXGXXXXXXXXXXXXXXXXXXXGXXXXXXXXXXXXXXXXXXXGXXXXXXXXXXXXXXXXXXXGXXXXXXXXXXXXXXXXXXXGXXXXXXXXXXXXXXXXXXXGXXXXXXXXXXXXXXXXXXX,0,300,0

49035,13,0,13,30,257,0,0,268,216,52,GXXXXXXXXXXXXXXXXXXXGXXXXXXXXXXXXXXXXXXXGXXXXXXXXXXXXXXXXXXXGXXXXXXXXXXXXXXXXXXXGXXXXXXXXXXXXXXXXXXXGXXXXXXXXXXXXXXXXXXXGXXXXXXXXXXXXXXXXXXXGXXXXXXXXXXXXXXXXXXXGXXXXXXXXXXXXXXXXXXXGXXXXXXXXXXXXXXXXXXXGXXXXXXXXXXXXXXXXXXXGXXXXXXXXXXXXXXXXXXXGXXXXXXXXXXXXXXXXXXX,0,300,0
49056,13,0,13,30,257,0,0,269,215,54,GXXXXXXXXXXXXXXXXXXXGXXXXXXXXXXXXXXXXXXXGXXXXXXXXXXXXXXXXXXXGXXXXXXXXXXXXXXXXXXXGXXXXXXXXXXXXXXXXXXXGXXXXXXXXXXXXXXXXXXXGXXXXXXXXXXXXXXXXXXXGXXXXXXXXXXXXXXXXXXXGXXXXXXXXXXXXXXXXXXXGXXXXXXXXXXXXXXXXXXXGXXXXXXXXXXXXXXXXXXXGXXXXXXXXXXXXXXXXXXXGXXXXXXXXXXXXXXXXXXX,0,300,0
49077,13,0,13,30,257,0,0,269,217,52,GXXXXXXXXXXXXXXXXXXXGXXXXXXXXXXXXXXXXXXXGXXXXXXXXXXXXXXXXXXXGXXXXXXXXXXXXXXXXXXXGXXXXXXXXXXXXXXXXXXXGXXXXXXXXXXXXXXXXXXXGXXXXXXXXXXXXXXXXXXXGXXXXXXXXXXXXXXXXXXXGXXXXXXXXXXXXXXXXXXXGXXXXXXXXXXXXXXXXXXXGXXXXXXXXXXXXXXXXXXXGXXXXXXXXXXXXXXXXXXXGXXXXXXXXXXXXXXXXXXX,0,300,0
49098,13,0,13,29,258,0,0,270,219,51,GXXXXXXXXXXXXXXXXXXXGXXXXXXXXXXXXXXXXXXXGXXXXXXXXXXXXXXXXXXXGXXXXXXXXXXXXXXXXXXXGXXXXXXXXXXXXXXXXXXXGXXXXXXXXXXXXXXXXXXXGXXXXXXXXXXXXXXXXXXXGXXXXXXXXXXXXXXXXXXXGXXXXXXXXXXXXXXXXXXXGXXXXXXXXXXXXXXXXXXXGXXXXXXXXXXXXXXXXXXXGXXXXXXXXXXXXXXXXXXXGXXXXXXXXXXXXXXXXXXX,0,300,0
49119,13,0,13,27,260,0,0,272,219,53,GXXXXXXXXXXXXXXXXXXXGXXXXXXXXXXXXXXXXXXXGXXXXXXXXXXXXXXXXXXXGXXXXXXXXXXXXXXXXXXXGXXXXXXXXXXXXXXXXXXXGXXXXXXXXXXXXXXXXXXXGXXXXXXXXXXXXXXXXXXXGXXXXXXXXXXXXXXXXXXXGXXXXXXXXXXXXXXXXXXXGXXXXXXXXXXXXXXXXXXXGXXXXXXXXXXXXXXXXXXXGXXXXXXXXXXXXXXXXXXXGXXXXXXXXXXXXXXXXXXX,0,300,0

49140,13,0,13,28,259,0,0,271,218,53,GXXXXXXXXXXXXXXXXXXXGXXXXXXXXXXXXXXXXXXXGXXXXXXXXXXXXXXXXXXXGXXXXXXXXXXXXXXXXXXXGXXXXXXXXXXXXXXXXXXXGXXXXXXXXXXXXXXXXXXXGXXXXXXXXXXXXXXXXXXXGXXXXXXXXXXXXXXXXXXXGXXXXXXXXXXXXXXXXXXXGXXXXXXXXXXXXXXXXXXXGXXXXXXXXXXXXXXXXXXXGXXXXXXXXXXXXXXXXXXXGXXXXXXXXXXXXXXXXXXX,0,300,0
49161,13,0,13,33,254,0,0,266,212,54,GXXXXXXXXXXXXXXXXXXXGXXXXXXXXXXXXXXXXXXXGXXXXXXXXXXXXXXXXXXXGXXXXXXXXXXXXXXXXXXXGXXXXXXXXXXXXXXXXXXXGXXXXXXXXXXXXXXXXXXXGXXXXXXXXXXXXXXXXXXXGXXXXXXXXXXXXXXXXXXXGXXXXXXXXXXXXXXXXXXXGXXXXXXXXXXXXXXXXXXXGXXXXXXXXXXXXXXXXXXXGXXXXXXXXXXXXXXXXXXXGXXXXXXXXXXXXXXXXXXX,0,300,0
49182,13,0,13,31,256,0,0,268,214,54,GXXXXXXXXXXXXXXXXXXXGXXXXXXXXXXXXXXXXXXXGXXXXXXXXXXXXXXXXXXXGXXXXXXXXXXXXXXXXXXXGXXXXXXXXXXXXXXXXXXXGXXXXXXXXXXXXXXXXXXXGXXXXXXXXXXXXXXXXXXXGXXXXXXXXXXXXXXXXXXXGXXXXXXXXXXXXXXXXXXXGXXXXXXXXXXXXXXXXXXXGXXXXXXXXXXXXXXXXXXXGXXXXXXXXXXXXXXXXXXXGXXXXXXXXXXXXXXXXXXX,0,300,0
49203,13,0,13,29,258,0,0,270,215,55,GXXXXXXXXXXXXXXXXXXXGXXXXXXXXXXXXXXXXXXXGXXXXXXXXXXXXXXXXXXXGXXXXXXXXXXXXXXXXXXXGXXXXXXXXXXXXXXXXXXXGXXXXXXXXXXXXXXXXXXXGXXXXXXXXXXXXXXXXXXXGXXXXXXXXXXXXXXXXXXXGXXXXXXXXXXXXXXXXXXXGXXXXXXXXXXXXXXXXXXXGXXXXXXXXXXXXXXXXXXXGXXXXXXXXXXXXXXXXXXXGXXXXXXXXXXXXXXXXXXX,0,300,0
49224,13,0,13,30,257,0,0,269,214,55,GXXXXXXXXXXXXXXXXXXXGXXXXXXXXXXXXXXXXXXXGXXXXXXXXXXXXXXXXXXXGXXXXXXXXXXXXXXXXXXXGXXXXXXXXXXXXXXXXXXXGXXXXXXXXXXXXXXXXXXXGXXXXXXXXXXXXXXXXXXXGXXXXXXXXXXXXXXXXXXXGXXXXXXXXXXXXXXXXXXXGXXXXXXXXXXXXXXXXXXXGXXXXXXXXXXXXXXXXXXXGXXXXXXXXXXXXXXXXXXXGXXXXXXXXXXXXXXXXXXX,0,300,0

49245,13,0,13,31,256,0,0,268,214,54,GXXXXXXXXXXXXXXXXXXXGXXXXXXXXXXXXXXXXXXXGXXXXXXXXXXXXXXXXXXXGXXXXXXXXXXXXXXXXXXXGXXXXXXXXXXXXXXXXXXXGXXXXXXXXXXXXXXXXXXXGXXXXXXXXXXXXXXXXXXXGXXXXXXXXXXXXXXXXXXXGXXXXXXXXXXXXXXXXXXXGXXXXXXXXXXXXXXXXXXXGXXXXXXXXXXXXXXXXXXXGXXXXXXXXXXXXXXXXXXXGXXXXXXXXXXXXXXXXXXX,0,300,0
49266,13,0,13,32,255,0,0,267,212,55,GXXXXXXXXXXXXXXXXXXXGXXXXXXXXXXXXXXXXXXXGXXXXXXXXXXXXXXXXXXXGXXXXXXXXXXXXXXXXXXXGXXXXXXXXXXXXXXXXXXXGXXXXXXXXXXXXXXXXXXXGXXXXXXXXXXXXXXXXXXXGXXXXXXXXXXXXXXXXXXXGXXXXXXXXXXXXXXXXXXXGXXXXXXXXXXXXXXXXXXXGXXXXXXXXXXXXXXXXXXXGXXXXXXXXXXXXXXXXXXXGXXXXXXXXXXXXXXXXXXX,0,300,0
49287,13,0,13,31,256,0,0,268,212,56,GXXXXXXXXXXXXXXXXXXXGXXXXXXXXXXXXXXXXXXXGXXXXXXXXXXXXXXXXXXXGXXXXXXXXXXXXXXXXXXXGXXXXXXXXXXXXXXXXXXXGXXXXXXXXXXXXXXXXXXXGXXXXXXXXXXXXXXXXXXXGXXXXXXXXXXXXXXXXXXXGXXXXXXXXXXXXXXXXXXXGXXXXXXXXXXXXXXXXXXXGXXXXXXXXXXXXXXXXXXXGXXXXXXXXXXXXXXXXXXXGXXXXXXXXXXXXXXXXXXX,0,300,0
49308,13,0,13,31,256,0,0,268,212,56,GXXXXXXXXXXXXXXXXXXXGXXXXXXXXXXXXXXXXXXXGXXXXXXXXXXXXXXXXXXXGXXXXXXXXXXXXXXXXXXXGXXXXXXXXXXXXXXXXXXXGXXXXXXXXXXXXXXXXXXXGXXXXXXXXXXXXXXXXXXXGXXXXXXXXXXXXXXXXXXXGXXXXXXXXXXXXXXXXXXXGXXXXXXXXXXXXXXXXXXXGXXXXXXXXXXXXXXXXXXXGXXXXXXXXXXXXXXXXXXXGXXXXXXXXXXXXXXXXXXX,0,300,0
49329,13,0,13,26,261,0,0,273,216,57,GXXXXXXXXXXXXXXXXXXXGXXXXXXXXXXXXXXXXXXXGXXXXXXXXXXXXXXXXXXXGXXXXXXXXXXXXXXXXXXXGXXXXXXXXXXXXXXXXXXXGXXXXXXXXXXXXXXXXXXXGXXXXXXXXXXXXXXXXXXXGXXXXXXXXXXXXXXXXXXXGXXXXXXXXXXXXXXXXXXXGXXXXXXXXXXXXXXXXXXXGXXXXXXXXXXXXXXXXXXXGXXXXXXXXXXXXXXXXXXXGXXXXXXXXXXXXXXXXXXX,0,300,0

49350,13,0,13,31,256,0,0,268,212,56,GXXXXXXXXXXXXXXXXXXXGXXXXXXXXXXXXXXXXXXXGXXXXXXXXXXXXXXXXXXXGXXXXXXXXXXXXXXXXXXXGXXXXXXXXXXXXXXXXXXXGXXXXXXXXXXXXXXXXXXXGXXXXXXXXXXXXXXXXXXXGXXXXXXXXXXXXXXXXXXXGXXXXXXXXXXXXXXXXXXXGXXXXXXXXXXXXXXXXXXXGXXXXXXXXXXXXXXXXXXXGXXXXXXXXXXXXXXXXXXXGXXXXXXXXXXXXXXXXXXX,0,300,0
49371,13,0,13,32,255,0,0,267,212,55,GXXXXXXXXXXXXXXXXXXXGXXXXXXXXXXXXXXXXXXXGXXXXXXXXXXXXXXXXXXXGXXXXXXXXXXXXXXXXXXXGXXXXXXXXXXXXXXXXXXXGXXXXXXXXXXXXXXXXXXXGXXXXXXXXXXXXXXXXXXXGXXXXXXXXXXXXXXXXXXXGXXXXXXXXXXXXXXXXXXXGXXXXXXXXXXXXXXXXXXXGXXXXXXXXXXXXXXXXXXXGXXXXXXXXXXXXXXXXXXXGXXXXXXXXXXXXXXXXXXX,0,300,0
49392,13,0,13,32,255,0,0,267,214,53,GXXXXXXXXXXXXXXXXXXXGXXXXXXXXXXXXXXXXXXXGXXXXXXXXXXXXXXXXXXXGXXXXXXXXXXXXXXXXXXXGXXXXXXXXXXXXXXXXXXXGXXXXXXXXXXXXXXXXXXXGXXXXXXXXXXXXXXXXXXXGXXXXXXXXXXXXXXXXXXXGXXXXXXXXXXXXXXXXXXXGXXXXXXXXXXXXXXXXXXXGXXXXXXXXXXXXXXXXXXXGXXXXXXXXXXXXXXXXXXXGXXXXXXXXXXXXXXXXXXX,0,300,0
49413,13,0,13,29,258,0,0,270,215,55,GXXXXXXXXXXXXXXXXXXXGXXXXXXXXXXXXXXXXXXXGXXXXXXXXXXXXXXXXXXXGXXXXXXXXXXXXXXXXXXXGXXXXXXXXXXXXXXXXXXXGXXXXXXXXXXXXXXXXXXXGXXXXXXXXXXXXXXXXXXXGXXXXXXXXXXXXXXXXXXXGXXXXXXXXXXXXXXXXXXXGXXXXXXXXXXXXXXXXXXXGXXXXXXXXXXXXXXXXXXXGXXXXXXXXXXXXXXXXXXXGXXXXXXXXXXXXXXXXXXX,0,300,0
49434,13,0,13,26,261,0,0,273,221,52,GXXXXXXXXXXXXXXXXXXXGXXXXXXXXXXXXXXXXXXXGXXXXXXXXXXXXXXXXXXXGXXXXXXXXXXXXXXXXXXXGXXXXXXXXXXXXXXXXXXXGXXXXXXXXXXXXXXXXXXXGXXXXXXXXXXXXXXXXXXXGXXXXXXXXXXXXXXXXXXXGXXXXXXXXXXXXXXXXXXXGXXXXXXXXXXXXXXXXXXXGXXXXXXXXXXXXXXXXXXXGXXXXXXXXXXXXXXXXXXXGXXXXXXXXXXXXXXXXXXX,0,300,0

49455,13,0,13,25,262,0,0,274,220,54,GXXXXXXXXXXXXXXXXXXXGXXXXXXXXXXXXXXXXXXXGXXXXXXXXXXXXXXXXXXXGXXXXXXXXXXXXXXXXXXXGXXXXXXXXXXXXXXXXXXXGXXXXXXXXXXXXXXXXXXXGXXXXXXXXXXXXXXXXXXXGXXXXXXXXXXXXXXXXXXXGXXXXXXXXXXXXXXXXXXXGXXXXXXXXXXXXXXXXXXXGXXXXXXXXXXXXXXXXXXXGXXXXXXXXXXXXXXXXXXXGXXXXXXXXXXXXXXXXXXX,0,300,0
49476,13,0,13,26,261,0,0,273,216,57,GXXXXXXXXXXXXXXXXXXXGXXXXXXXXXXXXXXXXXXXGXXXXXXXXXXXXXXXXXXXGXXXXXXXXXXXXXXXXXXXGXXXXXXXXXXXXXXXXXXXGXXXXXXXXXXXXXXXXXXXGXXXXXXXXXXXXXXXXXXXGXXXXXXXXXXXXXXXXXXXGXXXXXXXXXXXXXXXXXXXGXXXXXXXXXXXXXXXXXXXGXXXXXXXXXXXXXXXXXXXGXXXXXXXXXXXXXXXXXXXGXXXXXXXXXXXXXXXXXXX,0,300,0
49497,13,0,13,28,259,0,0,271,218,53,GXXXXXXXXXXXXXXXXXXXGXXXXXXXXXXXXXXXXXXXGXXXXXXXXXXXXXXXXXXXGXXXXXXXXXXXXXXXXXXXGXXXXXXXXXXXXXXXXXXXGXXXXXXXXXXXXXXXXXXXGXXXXXXXXXXXXXXXXXXXGXXXXXXXXXXXXXXXXXXXGXXXXXXXXXXXXXXXXXXXGXXXXXXXXXXXXXXXXXXXGXXXXXXXXXXXXXXXXXXXGXXXXXXXXXXXXXXXXXXXGXXXXXXXXXXXXXXXXXXX,0,300,0
49518,13,0,13,33,254,0,0,266,215,51,GXXXXXXXXXXXXXXXXXXXGXXXXXXXXXXXXXXXXXXXGXXXXXXXXXXXXXXXXXXXGXXXXXXXXXXXXXXXXXXXGXXXXXXXXXXXXXXXXXXXGXXXXXXXXXXXXXXXXXXXGXXXXXXXXXXXXXXXXXXXGXXXXXXXXXXXXXXXXXXXGXXXXXXXXXXXXXXXXXXXGXXXXXXXXXXXXXXXXXXXGXXXXXXXXXXXXXXXXXXXGXXXXXXXXXXXXXXXXXXXGXXXXXXXXXXXXXXXXXXX,0,300,0
49539,13,0,13,30,257,0,0,269,217,52,GXXXXXXXXXXXXXXXXXXXGXXXXXXXXXXXXXXXXXXXGXXXXXXXXXXXXXXXXXXXGXXXXXXXXXXXXXXXXXXXGXXXXXXXXXXXXXXXXXXXGXXXXXXXXXXXXXXXXXXXGXXXXXXXXXXXXXXXXXXXGXXXXXXXXXXXXXXXXXXXGXXXXXXXXXXXXXXXXXXXGXXXXXXXXXXXXXXXXXXXGXXXXXXXXXXXXXXXXXXXGXXXXXXXXXXXXXXXXXXXGXXXXXXXXXXXXXXXXXXX,0,300,0

49560,13,0,13,32,255,0,0,267,220,47,GXXXXXXXXXXXXXXXXXXXGXXXXXXXXXXXXXXXXXXXGXXXXXXXXXXXXXXXXXXXGXXXXXXXXXXXXXXXXXXXGXXXXXXXXXXXXXXXXXXXGXXXXXXXXXXXXXXXXXXXGXXXXXXXXXXXXXXXXXXXGXXXXXXXXXXXXXXXXXXXGXXXXXXXXXXXXXXXXXXXGXXXXXXXXXXXXXXXXXXXGXXXXXXXXXXXXXXXXXXXGXXXXXXXXXXXXXXXXXXXGXXXXXXXXXXXXXXXXXXX,0,300,0
49581,13,0,13,28,259,0,0,271,220,51,GXXXXXXXXXXXXXXXXXXXGXXXXXXXXXXXXXXXXXXXGXXXXXXXXXXXXXXXXXXXGXXXXXXXXXXXXXXXXXXXGXXXXXXXXXXXXXXXXXXXGXXXXXXXXXXXXXXXXXXXGXXXXXXXXXXXXXXXXXXXGXXXXXXXXXXXXXXXXXXXGXXXXXXXXXXXXXXXXXXXGXXXXXXXXXXXXXXXXXXXGXXXXXXXXXXXXXXXXXXXGXXXXXXXXXXXXXXXXXXXGXXXXXXXXXXXXXXXXXXX,0,300,0
49602,13,0,13,33,254,0,0,265,214,51,GXXXXXXXXXXXXXXXXXXXGXXXXXXXXXXXXXXXXXXXGXXXXXXXXXXXXXXXXXXXGXXXXXXXXXXXXXXXXXXXGXXXXXXXXXXXXXXXXXXXGXXXXXXXXXXXXXXXXXXXGXXXXXXXXXXXXXXXXXXXGXXXXXXXXXXXXXXXXXXXGXXXXXXXXXXXXXXXXXXXGXXXXXXXXXXXXXXXXXXXGXXXXXXXXXXXXXXXXXXXGXXXXXXXXXXXXXXXXXXXGXXXXXXXXXXXXXXXXXXX,0,300,0
49623,14,1,13,30,256,0,0,268,216,52,GXXXXXXXXXXXXXXXXXXXGXXXXXXXXXXXXXXXXXXXGXXXXXXXXXXXXXXXXXXXGXXXXXXXXXXXXXXXXXXXGXXXXXXXXXXXXXXXXXXXGXXXXXXXXXXXXXXXXXXXGXXXXXXXXXXXXXXXXXXXGXXXXXXXXXXXXXXXXXXXGXXXXXXXXXXXXXXXXXXXGAXXXXXXXXXXXXXXXXXXGXXXXXXXXXXXXXXXXXXXGXXXXXXXXXXXXXXXXXXXGXXXXXXXXXXXXXXXXXXX,0,300,0
49644,14,1,13,29,257,0,0,269,216,53,GXXXXXXXXXXXXXXXXXXXGXXXXXXXXXXXXXXXXXXXGXXXXXXXXXXXXXXXXXXXGXXXXXXXXXXXXXXXXXXXGXXXXXXXXXXXXXXXXXXXGXXXXXXXXXXXXXXXXXXXGXXXXXXXXXXXXXXXXXXXGXXXXXXXXXXXXXXXXXXXGXXXXXXXXXXXXXXXXXXXGAXXXXXXXXXXXXXXXXXXGXXXXXXXXXXXXXXXXXXXGXXXXXXXXXXXXXXXXXXXGXXXXXXXXXXXXXXXXXXX,0,300,0

49665,14,1,13,24,262,0,0,273,217,56,GXXXXXXXXXXXXXXXXXXXGXXXXXXXXXXXXXXXXXXXGXXXXXXXXXXXXXXXXXXXGXXXXXXXXXXXXXXXXXXXGXXXXXXXXXXXXXXXXXXXGXXXXXXXXXXXXXXXXXXXGXXXXXXXXXXXXXXXXXXXGXXXXXXXXXXXXXXXXXXXGXXXXXXXXXXXXXXXXXXXGAXXXXXXXXXXXXXXXXXXGXXXXXXXXXXXXXXXXXXXGXXXXXXXXXXXXXXXXXXXGXXXXXXXXXXXXXXXXXXX,0,300,0
49686,13,0,13,25,262,0,0,274,217,57,GXXXXXXXXXXXXXXXXXXXGXXXXXXXXXXXXXXXXXXXGXXXXXXXXXXXXXXXXXXXGXXXXXXXXXXXXXXXXXXXGXXXXXXXXXXXXXXXXXXXGXXXXXXXXXXXXXXXXXXXGXXXXXXXXXXXXXXXXXXXGXXXXXXXXXXXXXXXXXXXGXXXXXXXXXXXXXXXXXXXGXXXXXXXXXXXXXXXXXXXGXXXXXXXXXXXXXXXXXXXGXXXXXXXXXXXXXXXXXXXGXXXXXXXXXXXXXXXXXXX,0,300,0
49707,13,0,13,25,262,0,0,273,218,55,GXXXXXXXXXXXXXXXXXXXGXXXXXXXXXXXXXXXXXXXGXXXXXXXXXXXXXXXXXXXGXXXXXXXXXXXXXXXXXXXGXXXXXXXXXXXXXXXXXXXGXXXXXXXXXXXXXXXXXXXGXXXXXXXXXXXXXXXXXXXGXXXXXXXXXXXXXXXXXXXGXXXXXXXXXXXXXXXXXXXGXXXXXXXXXXXXXXXXXXXGXXXXXXXXXXXXXXXXXXXGXXXXXXXXXXXXXXXXXXXGXXXXXXXXXXXXXXXXXXX,0,300,0
49728,13,0,13,29,258,0,0,270,215,55,GXXXXXXXXXXXXXXXXXXXGXXXXXXXXXXXXXXXXXXXGXXXXXXXXXXXXXXXXXXXGXXXXXXXXXXXXXXXXXXXGXXXXXXXXXXXXXXXXXXXGXXXXXXXXXXXXXXXXXXXGXXXXXXXXXXXXXXXXXXXGXXXXXXXXXXXXXXXXXXXGXXXXXXXXXXXXXXXXXXXGXXXXXXXXXXXXXXXXXXXGXXXXXXXXXXXXXXXXXXXGXXXXXXXXXXXXXXXXXXXGXXXXXXXXXXXXXXXXXXX,0,300,0
49749,13,0,13,28,259,0,0,271,216,55,GXXXXXXXXXXXXXXXXXXXGXXXXXXXXXXXXXXXXXXXGXXXXXXXXXXXXXXXXXXXGXXXXXXXXXXXXXXXXXXXGXXXXXXXXXXXXXXXXXXXGXXXXXXXXXXXXXXXXXXXGXXXXXXXXXXXXXXXXXXXGXXXXXXXXXXXXXXXXXXXGXXXXXXXXXXXXXXXXXXXGXXXXXXXXXXXXXXXXXXXGXXXXXXXXXXXXXXXXXXXGXXXXXXXXXXXXXXXXXXXGXXXXXXXXXXXXXXXXXXX,0,300,0

49770,13,0,13,22,265,0,0,277,217,60,GXXXXXXXXXXXXXXXXXXXGXXXXXXXXXXXXXXXXXXXGXXXXXXXXXXXXXXXXXXXGXXXXXXXXXXXXXXXXXXXGXXXXXXXXXXXXXXXXXXXGXXXXXXXXXXXXXXXXXXXGXXXXXXXXXXXXXXXXXXXGXXXXXXXXXXXXXXXXXXXGXXXXXXXXXXXXXXXXXXXGXXXXXXXXXXXXXXXXXXXGXXXXXXXXXXXXXXXXXXXGXXXXXXXXXXXXXXXXXXXGXXXXXXXXXXXXXXXXXXX,0,300,0
49791,13,0,13,24,263,0,0,275,218,57,GXXXXXXXXXXXXXXXXXXXGXXXXXXXXXXXXXXXXXXXGXXXXXXXXXXXXXXXXXXXGXXXXXXXXXXXXXXXXXXXGXXXXXXXXXXXXXXXXXXXGXXXXXXXXXXXXXXXXXXXGXXXXXXXXXXXXXXXXXXXGXXXXXXXXXXXXXXXXXXXGXXXXXXXXXXXXXXXXXXXGXXXXXXXXXXXXXXXXXXXGXXXXXXXXXXXXXXXXXXXGXXXXXXXXXXXXXXXXXXXGXXXXXXXXXXXXXXXXXXX,0,300,0
49812,13,0,13,28,259,0,0,271,216,55,GXXXXXXXXXXXXXXXXXXXGXXXXXXXXXXXXXXXXXXXGXXXXXXXXXXXXXXXXXXXGXXXXXXXXXXXXXXXXXXXGXXXXXXXXXXXXXXXXXXXGXXXXXXXXXXXXXXXXXXXGXXXXXXXXXXXXXXXXXXXGXXXXXXXXXXXXXXXXXXXGXXXXXXXXXXXXXXXXXXXGXXXXXXXXXXXXXXXXXXXGXXXXXXXXXXXXXXXXXXXGXXXXXXXXXXXXXXXXXXXGXXXXXXXXXXXXXXXXXXX,0,300,0
49833,13,0,13,26,261,0,0,272,218,54,GXXXXXXXXXXXXXXXXXXXGXXXXXXXXXXXXXXXXXXXGXXXXXXXXXXXXXXXXXXXGXXXXXXXXXXXXXXXXXXXGXXXXXXXXXXXXXXXXXXXGXXXXXXXXXXXXXXXXXXXGXXXXXXXXXXXXXXXXXXXGXXXXXXXXXXXXXXXXXXXGXXXXXXXXXXXXXXXXXXXGXXXXXXXXXXXXXXXXXXXGXXXXXXXXXXXXXXXXXXXGXXXXXXXXXXXXXXXXXXXGXXXXXXXXXXXXXXXXXXX,0,300,0
49854,13,0,13,26,261,0,0,273,215,58,GXXXXXXXXXXXXXXXXXXXGXXXXXXXXXXXXXXXXXXXGXXXXXXXXXXXXXXXXXXXGXXXXXXXXXXXXXXXXXXXGXXXXXXXXXXXXXXXXXXXGXXXXXXXXXXXXXXXXXXXGXXXXXXXXXXXXXXXXXXXGXXXXXXXXXXXXXXXXXXXGXXXXXXXXXXXXXXXXXXXGXXXXXXXXXXXXXXXXXXXGXXXXXXXXXXXXXXXXXXXGXXXXXXXXXXXXXXXXXXXGXXXXXXXXXXXXXXXXXXX,0,300,0

49875,13,0,13,26,261,0,0,273,219,54,GXXXXXXXXXXXXXXXXXXXGXXXXXXXXXXXXXXXXXXXGXXXXXXXXXXXXXXXXXXXGXXXXXXXXXXXXXXXXXXXGXXXXXXXXXXXXXXXXXXXGXXXXXXXXXXXXXXXXXXXGXXXXXXXXXXXXXXXXXXXGXXXXXXXXXXXXXXXXXXXGXXXXXXXXXXXXXXXXXXXGXXXXXXXXXXXXXXXXXXXGXXXXXXXXXXXXXXXXXXXGXXXXXXXXXXXXXXXXXXXGXXXXXXXXXXXXXXXXXXX,0,300,0
49896,13,0,13,26,261,0,0,273,219,54,GXXXXXXXXXXXXXXXXXXXGXXXXXXXXXXXXXXXXXXXGXXXXXXXXXXXXXXXXXXXGXXXXXXXXXXXXXXXXXXXGXXXXXXXXXXXXXXXXXXXGXXXXXXXXXXXXXXXXXXXGXXXXXXXXXXXXXXXXXXXGXXXXXXXXXXXXXXXXXXXGXXXXXXXXXXXXXXXXXXXGXXXXXXXXXXXXXXXXXXXGXXXXXXXXXXXXXXXXXXXGXXXXXXXXXXXXXXXXXXXGXXXXXXXXXXXXXXXXXXX,0,300,0
49917,13,0,13,28,259,0,0,271,218,53,GXXXXXXXXXXXXXXXXXXXGXXXXXXXXXXXXXXXXXXXGXXXXXXXXXXXXXXXXXXXGXXXXXXXXXXXXXXXXXXXGXXXXXXXXXXXXXXXXXXXGXXXXXXXXXXXXXXXXXXXGXXXXXXXXXXXXXXXXXXXGXXXXXXXXXXXXXXXXXXXGXXXXXXXXXXXXXXXXXXXGXXXXXXXXXXXXXXXXXXXGXXXXXXXXXXXXXXXXXXXGXXXXXXXXXXXXXXXXXXXGXXXXXXXXXXXXXXXXXXX,0,300,0
49938,13,0,13,30,257,0,0,269,218,51,GXXXXXXXXXXXXXXXXXXXGXXXXXXXXXXXXXXXXXXXGXXXXXXXXXXXXXXXXXXXGXXXXXXXXXXXXXXXXXXXGXXXXXXXXXXXXXXXXXXXGXXXXXXXXXXXXXXXXXXXGXXXXXXXXXXXXXXXXXXXGXXXXXXXXXXXXXXXXXXXGXXXXXXXXXXXXXXXXXXXGXXXXXXXXXXXXXXXXXXXGXXXXXXXXXXXXXXXXXXXGXXXXXXXXXXXXXXXXXXXGXXXXXXXXXXXXXXXXXXX,0,300,0
49959,13,0,13,27,260,0,0,272,220,52,GXXXXXXXXXXXXXXXXXXXGXXXXXXXXXXXXXXXXXXXGXXXXXXXXXXXXXXXXXXXGXXXXXXXXXXXXXXXXXXXGXXXXXXXXXXXXXXXXXXXGXXXXXXXXXXXXXXXXXXXGXXXXXXXXXXXXXXXXXXXGXXXXXXXXXXXXXXXXXXXGXXXXXXXXXXXXXXXXXXXGXXXXXXXXXXXXXXXXXXXGXXXXXXXXXXXXXXXXXXXGXXXXXXXXXXXXXXXXXXXGXXXXXXXXXXXXXXXXXXX,0,300,0

