iterCounter, dimersInMT, activeDimersInMT, inactiveDimersInMT, activeDimersFree,inactiveDimersFree, longestProtoFilament, lengthOfMT, totalGTPs, activeGTPs,inactiveGTPs, mtRepresentation, DeHydro Katanins, Hydro Katanins, Bonded Katanins

21,0,0,0,0,0,0,0,0,0,0,XXXXXXXXXXXXXXXXXXXXXXXXXXXXXXXXXXXXXXXXXXXXXXXXXXXXXXXXXXXXXXXXXXXXXXXXXXXXXXXXXXXXXXXXXXXXXXXXXXXXXXXXXXXXXXXXXXXXXXXXXXXXXXXXXXXXXXXXXXXXXXXXXXXXXXXXXXXXXXXXXXXXXXXXXXXXXXXXXXXXXXXXXXXXXXXXXXXXXXXXXXXXXXXXXXXXXXXXXXXXXXXXXXXXXXXXXXXXXXXXXXXXXXXXXXXXXXXXXXXX,0,0,0
42,0,0,0,0,0,0,0,0,0,0,XXXXXXXXXXXXXXXXXXXXXXXXXXXXXXXXXXXXXXXXXXXXXXXXXXXXXXXXXXXXXXXXXXXXXXXXXXXXXXXXXXXXXXXXXXXXXXXXXXXXXXXXXXXXXXXXXXXXXXXXXXXXXXXXXXXXXXXXXXXXXXXXXXXXXXXXXXXXXXXXXXXXXXXXXXXXXXXXXXXXXXXXXXXXXXXXXXXXXXXXXXXXXXXXXXXXXXXXXXXXXXXXXXXXXXXXXXXXXXXXXXXXXXXXXXXXXXXXXXXX,0,0,0
63,0,0,0,0,0,0,0,0,0,0,XXXXXXXXXXXXXXXXXXXXXXXXXXXXXXXXXXXXXXXXXXXXXXXXXXXXXXXXXXXXXXXXXXXXXXXXXXXXXXXXXXXXXXXXXXXXXXXXXXXXXXXXXXXXXXXXXXXXXXXXXXXXXXXXXXXXXXXXXXXXXXXXXXXXXXXXXXXXXXXXXXXXXXXXXXXXXXXXXXXXXXXXXXXXXXXXXXXXXXXXXXXXXXXXXXXXXXXXXXXXXXXXXXXXXXXXXXXXXXXXXXXXXXXXXXXXXXXXXXXX,0,0,0
84,0,0,0,0,0,0,0,0,0,0,XXXXXXXXXXXXXXXXXXXXXXXXXXXXXXXXXXXXXXXXXXXXXXXXXXXXXXXXXXXXXXXXXXXXXXXXXXXXXXXXXXXXXXXXXXXXXXXXXXXXXXXXXXXXXXXXXXXXXXXXXXXXXXXXXXXXXXXXXXXXXXXXXXXXXXXXXXXXXXXXXXXXXXXXXXXXXXXXXXXXXXXXXXXXXXXXXXXXXXXXXXXXXXXXXXXXXXXXXXXXXXXXXXXXXXXXXXXXXXXXXXXXXXXXXXXXXXXXXXXX,0,0,0

105,3,3,0,297,0,0,0,300,300,0,XXXXXXXXXXXXXXXXXXXXGXXXXXXXXXXXXXXXXXXXXXXXXXXXXXXXXXXXXXXXXXXXXXXXXXXXXXXXXXXXXXXXXXXXXXXXXXXXXXXXXXXXXXXXXXXXXXXXXXXXGXXXXXXXXXXXXXXXXXXXXXXXXXXXXXXXXXXXXXXXXXXXXXXXXXXXXXXXXXXXXXXXXXXXXXXXXXXXXXXXXXXXXXXXXXXXXXXXXXXXXXXXXXXXXXXXXXXXXXXXGXXXXXXXXXXXXXXXXXXX,0,300,0
126,3,3,0,297,0,0,0,300,300,0,XXXXXXXXXXXXXXXXXXXXGXXXXXXXXXXXXXXXXXXXXXXXXXXXXXXXXXXXXXXXXXXXXXXXXXXXXXXXXXXXXXXXXXXXXXXXXXXXXXXXXXXXXXXXXXXXXXXXXXXXGXXXXXXXXXXXXXXXXXXXXXXXXXXXXXXXXXXXXXXXXXXXXXXXXXXXXXXXXXXXXXXXXXXXXXXXXXXXXXXXXXXXXXXXXXXXXXXXXXXXXXXXXXXXXXXXXXXXXXXXGXXXXXXXXXXXXXXXXXXX,0,300,0
147,6,6,0,294,0,0,0,300,300,0,XXXXXXXXXXXXXXXXXXXXGXXXXXXXXXXXXXXXXXXXXXXXXXXXXXXXXXXXXXXXGXXXXXXXXXXXXXXXXXXXXXXXXXXXXXXXXXXXXXXXXXXXXXXXXXXXXXXXXXXXGXXXXXXXXXXXXXXXXXXXGXXXXXXXXXXXXXXXXXXXXXXXXXXXXXXXXXXXXXXXGXXXXXXXXXXXXXXXXXXXXXXXXXXXXXXXXXXXXXXXXXXXXXXXXXXXXXXXXXXXGXXXXXXXXXXXXXXXXXXX,0,300,0
168,7,7,0,293,0,0,0,300,300,0,XXXXXXXXXXXXXXXXXXXXGXXXXXXXXXXXXXXXXXXXXXXXXXXXXXXXXXXXXXXXGXXXXXXXXXXXXXXXXXXXXXXXXXXXXXXXXXXXXXXXXXXXXXXXXXXXXXXXXXXXGXXXXXXXXXXXXXXXXXXXGAXXXXXXXXXXXXXXXXXXXXXXXXXXXXXXXXXXXXXXGXXXXXXXXXXXXXXXXXXXXXXXXXXXXXXXXXXXXXXXXXXXXXXXXXXXXXXXXXXXGXXXXXXXXXXXXXXXXXXX,0,300,0
189,11,11,0,289,0,0,0,300,300,0,GXXXXXXXXXXXXXXXXXXXGXXXXXXXXXXXXXXXXXXXXXXXXXXXXXXXXXXXXXXXGAXXXXXXXXXXXXXXXXXXXXXXXXXXXXXXXXXXXXXXGXXXXXXXXXXXXXXXXXXXGXXXXXXXXXXXXXXXXXXXGAXXXXXXXXXXXXXXXXXXXXXXXXXXXXXXXXXXXXXXGXXXXXXXXXXXXXXXXXXXXXXXXXXXXXXXXXXXXXXXGXXXXXXXXXXXXXXXXXXXGXXXXXXXXXXXXXXXXXXX,0,300,0

210,11,11,0,289,0,0,0,300,300,0,GXXXXXXXXXXXXXXXXXXXGXXXXXXXXXXXXXXXXXXXXXXXXXXXXXXXXXXXXXXXGAXXXXXXXXXXXXXXXXXXXXXXXXXXXXXXXXXXXXXXGXXXXXXXXXXXXXXXXXXXGXXXXXXXXXXXXXXXXXXXGAXXXXXXXXXXXXXXXXXXXXXXXXXXXXXXXXXXXXXXGXXXXXXXXXXXXXXXXXXXXXXXXXXXXXXXXXXXXXXXGXXXXXXXXXXXXXXXXXXXGXXXXXXXXXXXXXXXXXXX,0,300,0
231,12,12,0,288,0,0,0,300,300,0,GXXXXXXXXXXXXXXXXXXXGXXXXXXXXXXXXXXXXXXXXXXXXXXXXXXXXXXXXXXXGAXXXXXXXXXXXXXXXXXXGXXXXXXXXXXXXXXXXXXXGXXXXXXXXXXXXXXXXXXXGXXXXXXXXXXXXXXXXXXXGAXXXXXXXXXXXXXXXXXXXXXXXXXXXXXXXXXXXXXXGXXXXXXXXXXXXXXXXXXXXXXXXXXXXXXXXXXXXXXXGXXXXXXXXXXXXXXXXXXXGXXXXXXXXXXXXXXXXXXX,0,300,0
252,12,12,0,288,0,0,0,300,300,0,GXXXXXXXXXXXXXXXXXXXGXXXXXXXXXXXXXXXXXXXXXXXXXXXXXXXXXXXXXXXGAXXXXXXXXXXXXXXXXXXGXXXXXXXXXXXXXXXXXXXGXXXXXXXXXXXXXXXXXXXGXXXXXXXXXXXXXXXXXXXGAXXXXXXXXXXXXXXXXXXXXXXXXXXXXXXXXXXXXXXGXXXXXXXXXXXXXXXXXXXXXXXXXXXXXXXXXXXXXXXGXXXXXXXXXXXXXXXXXXXGXXXXXXXXXXXXXXXXXXX,0,300,0
273,12,12,0,288,0,0,0,300,300,0,GXXXXXXXXXXXXXXXXXXXGXXXXXXXXXXXXXXXXXXXXXXXXXXXXXXXXXXXXXXXGAXXXXXXXXXXXXXXXXXXGXXXXXXXXXXXXXXXXXXXGXXXXXXXXXXXXXXXXXXXGXXXXXXXXXXXXXXXXXXXGAXXXXXXXXXXXXXXXXXXXXXXXXXXXXXXXXXXXXXXGXXXXXXXXXXXXXXXXXXXXXXXXXXXXXXXXXXXXXXXGXXXXXXXXXXXXXXXXXXXGXXXXXXXXXXXXXXXXXXX,0,300,0
294,12,12,0,288,0,0,0,300,300,0,GXXXXXXXXXXXXXXXXXXXGXXXXXXXXXXXXXXXXXXXXXXXXXXXXXXXXXXXXXXXGAXXXXXXXXXXXXXXXXXXGXXXXXXXXXXXXXXXXXXXGXXXXXXXXXXXXXXXXXXXGXXXXXXXXXXXXXXXXXXXGAXXXXXXXXXXXXXXXXXXXXXXXXXXXXXXXXXXXXXXGXXXXXXXXXXXXXXXXXXXXXXXXXXXXXXXXXXXXXXXGXXXXXXXXXXXXXXXXXXXGXXXXXXXXXXXXXXXXXXX,0,300,0

315,13,12,1,274,13,0,0,298,298,0,GXXXXXXXXXXXXXXXXXXXGXXXXXXXXXXXXXXXXXXXXXXXXXXXXXXXXXXXXXXXGAXXXXXXXXXXXXXXXXXXGXXXXXXXXXXXXXXXXXXXGXXXXXXXXXXXXXXXXXXXGXXXXXXXXXXXXXXXXXXXGAXXXXXXXXXXXXXXXXXXGXXXXXXXXXXXXXXXXXXXGXXXXXXXXXXXXXXXXXXXXXXXXXXXXXXXXXXXXXXXGXXXXXXXXXXXXXXXXXXXGXXXXXXXXXXXXXXXXXXX,0,300,0
336,13,12,1,262,25,0,0,286,286,0,GXXXXXXXXXXXXXXXXXXXGXXXXXXXXXXXXXXXXXXXXXXXXXXXXXXXXXXXXXXXGAXXXXXXXXXXXXXXXXXXGXXXXXXXXXXXXXXXXXXXGXXXXXXXXXXXXXXXXXXXGXXXXXXXXXXXXXXXXXXXGAXXXXXXXXXXXXXXXXXXGXXXXXXXXXXXXXXXXXXXGXXXXXXXXXXXXXXXXXXXXXXXXXXXXXXXXXXXXXXXGXXXXXXXXXXXXXXXXXXXGXXXXXXXXXXXXXXXXXXX,0,300,0
357,12,9,3,254,34,0,0,275,275,0,GXXXXXXXXXXXXXXXXXXXGXXXXXXXXXXXXXXXXXXXXXXXXXXXXXXXXXXXXXXXGXXXXXXXXXXXXXXXXXXXGXXXXXXXXXXXXXXXXXXXGXXXXXXXXXXXXXXXXXXXGXXXXXXXXXXXXXXXXXXXGAXXXXXXXXXXXXXXXXXXGXXXXXXXXXXXXXXXXXXXGXXXXXXXXXXXXXXXXXXXXXXXXXXXXXXXXXXXXXXXGXXXXXXXXXXXXXXXXXXXGXXXXXXXXXXXXXXXXXXX,0,300,0
378,13,9,4,249,38,0,0,256,256,0,GXXXXXXXXXXXXXXXXXXXGXXXXXXXXXXXXXXXXXXXXXXXXXXXXXXXXXXXXXXXGAXXXXXXXXXXXXXXXXXXGXXXXXXXXXXXXXXXXXXXGXXXXXXXXXXXXXXXXXXXGXXXXXXXXXXXXXXXXXXXGAXXXXXXXXXXXXXXXXXXGXXXXXXXXXXXXXXXXXXXGXXXXXXXXXXXXXXXXXXXXXXXXXXXXXXXXXXXXXXXGXXXXXXXXXXXXXXXXXXXGXXXXXXXXXXXXXXXXXXX,0,300,0
399,13,7,6,244,43,0,0,240,240,0,GXXXXXXXXXXXXXXXXXXXGXXXXXXXXXXXXXXXXXXXXXXXXXXXXXXXXXXXXXXXGAXXXXXXXXXXXXXXXXXXGXXXXXXXXXXXXXXXXXXXGXXXXXXXXXXXXXXXXXXXGXXXXXXXXXXXXXXXXXXXGAXXXXXXXXXXXXXXXXXXGXXXXXXXXXXXXXXXXXXXGXXXXXXXXXXXXXXXXXXXXXXXXXXXXXXXXXXXXXXXGXXXXXXXXXXXXXXXXXXXGXXXXXXXXXXXXXXXXXXX,0,300,0

420,13,7,6,248,39,0,0,222,222,0,GXXXXXXXXXXXXXXXXXXXGXXXXXXXXXXXXXXXXXXXXXXXXXXXXXXXXXXXXXXXGAXXXXXXXXXXXXXXXXXXGXXXXXXXXXXXXXXXXXXXGXXXXXXXXXXXXXXXXXXXGXXXXXXXXXXXXXXXXXXXGAXXXXXXXXXXXXXXXXXXGXXXXXXXXXXXXXXXXXXXGXXXXXXXXXXXXXXXXXXXXXXXXXXXXXXXXXXXXXXXGXXXXXXXXXXXXXXXXXXXGXXXXXXXXXXXXXXXXXXX,0,300,0
441,14,7,7,242,44,0,0,212,212,0,GXXXXXXXXXXXXXXXXXXXGXXXXXXXXXXXXXXXXXXXXXXXXXXXXXXXXXXXXXXXGAXXXXXXXXXXXXXXXXXXGXXXXXXXXXXXXXXXXXXXGXXXXXXXXXXXXXXXXXXXGXXXXXXXXXXXXXXXXXXXGAXXXXXXXXXXXXXXXXXXGXXXXXXXXXXXXXXXXXXXGXXXXXXXXXXXXXXXXXXXGXXXXXXXXXXXXXXXXXXXGXXXXXXXXXXXXXXXXXXXGXXXXXXXXXXXXXXXXXXX,0,300,0
462,14,7,7,232,54,0,0,201,201,0,GXXXXXXXXXXXXXXXXXXXGXXXXXXXXXXXXXXXXXXXXXXXXXXXXXXXXXXXXXXXGAXXXXXXXXXXXXXXXXXXGXXXXXXXXXXXXXXXXXXXGXXXXXXXXXXXXXXXXXXXGXXXXXXXXXXXXXXXXXXXGAXXXXXXXXXXXXXXXXXXGXXXXXXXXXXXXXXXXXXXGXXXXXXXXXXXXXXXXXXXGXXXXXXXXXXXXXXXXXXXGXXXXXXXXXXXXXXXXXXXGXXXXXXXXXXXXXXXXXXX,0,300,0
483,14,6,8,226,60,0,0,181,181,0,GXXXXXXXXXXXXXXXXXXXGXXXXXXXXXXXXXXXXXXXXXXXXXXXXXXXXXXXXXXXGAXXXXXXXXXXXXXXXXXXGXXXXXXXXXXXXXXXXXXXGXXXXXXXXXXXXXXXXXXXGXXXXXXXXXXXXXXXXXXXGOXXXXXXXXXXXXXXXXXXGXXXXXXXXXXXXXXXXXXXGXXXXXXXXXXXXXXXXXXXGXXXXXXXXXXXXXXXXXXXGXXXXXXXXXXXXXXXXXXXGXXXXXXXXXXXXXXXXXXX,0,300,0
504,13,5,8,225,62,0,0,166,166,0,GXXXXXXXXXXXXXXXXXXXGXXXXXXXXXXXXXXXXXXXXXXXXXXXXXXXXXXXXXXXGAXXXXXXXXXXXXXXXXXXGXXXXXXXXXXXXXXXXXXXGXXXXXXXXXXXXXXXXXXXGXXXXXXXXXXXXXXXXXXXGXXXXXXXXXXXXXXXXXXXGXXXXXXXXXXXXXXXXXXXGXXXXXXXXXXXXXXXXXXXGXXXXXXXXXXXXXXXXXXXGXXXXXXXXXXXXXXXXXXXGXXXXXXXXXXXXXXXXXXX,0,300,0

525,14,6,8,220,66,0,0,142,141,1,GXXXXXXXXXXXXXXXXXXXGXXXXXXXXXXXXXXXXXXXXXXXXXXXXXXXXXXXXXXXGAXXXXXXXXXXXXXXXXXXGXXXXXXXXXXXXXXXXXXXGXXXXXXXXXXXXXXXXXXXGXXXXXXXXXXXXXXXXXXXGAXXXXXXXXXXXXXXXXXXGXXXXXXXXXXXXXXXXXXXGXXXXXXXXXXXXXXXXXXXGXXXXXXXXXXXXXXXXXXXGXXXXXXXXXXXXXXXXXXXGXXXXXXXXXXXXXXXXXXX,0,300,0
546,14,6,8,217,69,0,0,132,128,4,GXXXXXXXXXXXXXXXXXXXGXXXXXXXXXXXXXXXXXXXXXXXXXXXXXXXXXXXXXXXGAXXXXXXXXXXXXXXXXXXGXXXXXXXXXXXXXXXXXXXGXXXXXXXXXXXXXXXXXXXGXXXXXXXXXXXXXXXXXXXGAXXXXXXXXXXXXXXXXXXGXXXXXXXXXXXXXXXXXXXGXXXXXXXXXXXXXXXXXXXGXXXXXXXXXXXXXXXXXXXGXXXXXXXXXXXXXXXXXXXGXXXXXXXXXXXXXXXXXXX,0,300,0
567,15,4,11,208,77,0,0,118,112,6,GXXXXXXXXXXXXXXXXXXXGXXXXXXXXXXXXXXXXXXXGXXXXXXXXXXXXXXXXXXXGAXXXXXXXXXXXXXXXXXXGXXXXXXXXXXXXXXXXXXXGXXXXXXXXXXXXXXXXXXXGXXXXXXXXXXXXXXXXXXXGAXXXXXXXXXXXXXXXXXXGXXXXXXXXXXXXXXXXXXXGXXXXXXXXXXXXXXXXXXXGXXXXXXXXXXXXXXXXXXXGXXXXXXXXXXXXXXXXXXXGXXXXXXXXXXXXXXXXXXX,0,300,0
588,15,3,12,195,90,0,0,111,99,12,GXXXXXXXXXXXXXXXXXXXGXXXXXXXXXXXXXXXXXXXGXXXXXXXXXXXXXXXXXXXGAXXXXXXXXXXXXXXXXXXGXXXXXXXXXXXXXXXXXXXGXXXXXXXXXXXXXXXXXXXGXXXXXXXXXXXXXXXXXXXGAXXXXXXXXXXXXXXXXXXGXXXXXXXXXXXXXXXXXXXGXXXXXXXXXXXXXXXXXXXGXXXXXXXXXXXXXXXXXXXGXXXXXXXXXXXXXXXXXXXGXXXXXXXXXXXXXXXXXXX,0,300,0
609,15,3,12,192,93,0,0,105,87,18,GXXXXXXXXXXXXXXXXXXXGXXXXXXXXXXXXXXXXXXXGXXXXXXXXXXXXXXXXXXXGAXXXXXXXXXXXXXXXXXXGXXXXXXXXXXXXXXXXXXXGXXXXXXXXXXXXXXXXXXXGXXXXXXXXXXXXXXXXXXXGAXXXXXXXXXXXXXXXXXXGXXXXXXXXXXXXXXXXXXXGXXXXXXXXXXXXXXXXXXXGXXXXXXXXXXXXXXXXXXXGXXXXXXXXXXXXXXXXXXXGXXXXXXXXXXXXXXXXXXX,0,300,0

630,15,3,12,194,91,0,0,103,74,29,GXXXXXXXXXXXXXXXXXXXGXXXXXXXXXXXXXXXXXXXGXXXXXXXXXXXXXXXXXXXGAXXXXXXXXXXXXXXXXXXGXXXXXXXXXXXXXXXXXXXGXXXXXXXXXXXXXXXXXXXGXXXXXXXXXXXXXXXXXXXGAXXXXXXXXXXXXXXXXXXGXXXXXXXXXXXXXXXXXXXGXXXXXXXXXXXXXXXXXXXGXXXXXXXXXXXXXXXXXXXGXXXXXXXXXXXXXXXXXXXGXXXXXXXXXXXXXXXXXXX,0,300,0
651,15,3,12,196,89,0,0,100,58,42,GXXXXXXXXXXXXXXXXXXXGXXXXXXXXXXXXXXXXXXXGXXXXXXXXXXXXXXXXXXXGAXXXXXXXXXXXXXXXXXXGXXXXXXXXXXXXXXXXXXXGXXXXXXXXXXXXXXXXXXXGXXXXXXXXXXXXXXXXXXXGAXXXXXXXXXXXXXXXXXXGXXXXXXXXXXXXXXXXXXXGXXXXXXXXXXXXXXXXXXXGXXXXXXXXXXXXXXXXXXXGXXXXXXXXXXXXXXXXXXXGXXXXXXXXXXXXXXXXXXX,0,300,0
672,15,3,12,189,96,0,0,107,53,54,GXXXXXXXXXXXXXXXXXXXGXXXXXXXXXXXXXXXXXXXGXXXXXXXXXXXXXXXXXXXGAXXXXXXXXXXXXXXXXXXGXXXXXXXXXXXXXXXXXXXGXXXXXXXXXXXXXXXXXXXGXXXXXXXXXXXXXXXXXXXGAXXXXXXXXXXXXXXXXXXGXXXXXXXXXXXXXXXXXXXGXXXXXXXXXXXXXXXXXXXGXXXXXXXXXXXXXXXXXXXGXXXXXXXXXXXXXXXXXXXGXXXXXXXXXXXXXXXXXXX,0,300,0
693,15,3,12,188,97,0,0,109,46,63,GXXXXXXXXXXXXXXXXXXXGXXXXXXXXXXXXXXXXXXXGXXXXXXXXXXXXXXXXXXXGAXXXXXXXXXXXXXXXXXXGXXXXXXXXXXXXXXXXXXXGXXXXXXXXXXXXXXXXXXXGXXXXXXXXXXXXXXXXXXXGAXXXXXXXXXXXXXXXXXXGXXXXXXXXXXXXXXXXXXXGXXXXXXXXXXXXXXXXXXXGXXXXXXXXXXXXXXXXXXXGXXXXXXXXXXXXXXXXXXXGXXXXXXXXXXXXXXXXXXX,0,300,0
714,15,3,12,182,103,0,0,114,38,76,GXXXXXXXXXXXXXXXXXXXGXXXXXXXXXXXXXXXXXXXGXXXXXXXXXXXXXXXXXXXGAXXXXXXXXXXXXXXXXXXGXXXXXXXXXXXXXXXXXXXGXXXXXXXXXXXXXXXXXXXGXXXXXXXXXXXXXXXXXXXGAXXXXXXXXXXXXXXXXXXGXXXXXXXXXXXXXXXXXXXGXXXXXXXXXXXXXXXXXXXGXXXXXXXXXXXXXXXXXXXGXXXXXXXXXXXXXXXXXXXGXXXXXXXXXXXXXXXXXXX,0,300,0

735,16,3,13,181,103,0,0,114,30,84,GXXXXXXXXXXXXXXXXXXXGXXXXXXXXXXXXXXXXXXXGXXXXXXXXXXXXXXXXXXXGAXXXXXXXXXXXXXXXXXXGXXXXXXXXXXXXXXXXXXXGXXXXXXXXXXXXXXXXXXXGXXXXXXXXXXXXXXXXXXXGAXXXXXXXXXXXXXXXXXXGXXXXXXXXXXXXXXXXXXXGAXXXXXXXXXXXXXXXXXXGXXXXXXXXXXXXXXXXXXXGXXXXXXXXXXXXXXXXXXXGXXXXXXXXXXXXXXXXXXX,0,300,0
756,15,2,13,167,118,0,0,128,28,100,GXXXXXXXXXXXXXXXXXXXGXXXXXXXXXXXXXXXXXXXGXXXXXXXXXXXXXXXXXXXGXXXXXXXXXXXXXXXXXXXGXXXXXXXXXXXXXXXXXXXGXXXXXXXXXXXXXXXXXXXGXXXXXXXXXXXXXXXXXXXGAXXXXXXXXXXXXXXXXXXGXXXXXXXXXXXXXXXXXXXGAXXXXXXXXXXXXXXXXXXGXXXXXXXXXXXXXXXXXXXGXXXXXXXXXXXXXXXXXXXGXXXXXXXXXXXXXXXXXXX,0,300,0
777,15,2,13,164,121,0,0,133,22,111,GXXXXXXXXXXXXXXXXXXXGXXXXXXXXXXXXXXXXXXXGXXXXXXXXXXXXXXXXXXXGXXXXXXXXXXXXXXXXXXXGXXXXXXXXXXXXXXXXXXXGXXXXXXXXXXXXXXXXXXXGXXXXXXXXXXXXXXXXXXXGAXXXXXXXXXXXXXXXXXXGXXXXXXXXXXXXXXXXXXXGAXXXXXXXXXXXXXXXXXXGXXXXXXXXXXXXXXXXXXXGXXXXXXXXXXXXXXXXXXXGXXXXXXXXXXXXXXXXXXX,0,300,0
798,15,2,13,144,141,0,0,151,20,131,GXXXXXXXXXXXXXXXXXXXGXXXXXXXXXXXXXXXXXXXGXXXXXXXXXXXXXXXXXXXGXXXXXXXXXXXXXXXXXXXGXXXXXXXXXXXXXXXXXXXGXXXXXXXXXXXXXXXXXXXGXXXXXXXXXXXXXXXXXXXGAXXXXXXXXXXXXXXXXXXGXXXXXXXXXXXXXXXXXXXGAXXXXXXXXXXXXXXXXXXGXXXXXXXXXXXXXXXXXXXGXXXXXXXXXXXXXXXXXXXGXXXXXXXXXXXXXXXXXXX,0,300,0
819,15,2,13,132,153,0,0,164,17,147,GXXXXXXXXXXXXXXXXXXXGXXXXXXXXXXXXXXXXXXXGXXXXXXXXXXXXXXXXXXXGXXXXXXXXXXXXXXXXXXXGXXXXXXXXXXXXXXXXXXXGXXXXXXXXXXXXXXXXXXXGXXXXXXXXXXXXXXXXXXXGAXXXXXXXXXXXXXXXXXXGXXXXXXXXXXXXXXXXXXXGAXXXXXXXXXXXXXXXXXXGXXXXXXXXXXXXXXXXXXXGXXXXXXXXXXXXXXXXXXXGXXXXXXXXXXXXXXXXXXX,0,300,0

840,15,2,13,121,164,0,0,176,16,160,GXXXXXXXXXXXXXXXXXXXGXXXXXXXXXXXXXXXXXXXGXXXXXXXXXXXXXXXXXXXGXXXXXXXXXXXXXXXXXXXGXXXXXXXXXXXXXXXXXXXGXXXXXXXXXXXXXXXXXXXGXXXXXXXXXXXXXXXXXXXGAXXXXXXXXXXXXXXXXXXGXXXXXXXXXXXXXXXXXXXGAXXXXXXXXXXXXXXXXXXGXXXXXXXXXXXXXXXXXXXGXXXXXXXXXXXXXXXXXXXGXXXXXXXXXXXXXXXXXXX,0,300,0
861,15,2,13,114,171,0,0,181,15,166,GXXXXXXXXXXXXXXXXXXXGXXXXXXXXXXXXXXXXXXXGXXXXXXXXXXXXXXXXXXXGXXXXXXXXXXXXXXXXXXXGXXXXXXXXXXXXXXXXXXXGXXXXXXXXXXXXXXXXXXXGXXXXXXXXXXXXXXXXXXXGAXXXXXXXXXXXXXXXXXXGXXXXXXXXXXXXXXXXXXXGAXXXXXXXXXXXXXXXXXXGXXXXXXXXXXXXXXXXXXXGXXXXXXXXXXXXXXXXXXXGXXXXXXXXXXXXXXXXXXX,0,300,0
882,15,1,14,106,179,0,0,191,16,175,GXXXXXXXXXXXXXXXXXXXGXXXXXXXXXXXXXXXXXXXGXXXXXXXXXXXXXXXXXXXGXXXXXXXXXXXXXXXXXXXGXXXXXXXXXXXXXXXXXXXGXXXXXXXXXXXXXXXXXXXGXXXXXXXXXXXXXXXXXXXGAXXXXXXXXXXXXXXXXXXGXXXXXXXXXXXXXXXXXXXGOXXXXXXXXXXXXXXXXXXGXXXXXXXXXXXXXXXXXXXGXXXXXXXXXXXXXXXXXXXGXXXXXXXXXXXXXXXXXXX,0,300,0
903,13,0,13,101,186,0,0,197,14,183,GXXXXXXXXXXXXXXXXXXXGXXXXXXXXXXXXXXXXXXXGXXXXXXXXXXXXXXXXXXXGXXXXXXXXXXXXXXXXXXXGXXXXXXXXXXXXXXXXXXXGXXXXXXXXXXXXXXXXXXXGXXXXXXXXXXXXXXXXXXXGXXXXXXXXXXXXXXXXXXXGXXXXXXXXXXXXXXXXXXXGXXXXXXXXXXXXXXXXXXXGXXXXXXXXXXXXXXXXXXXGXXXXXXXXXXXXXXXXXXXGXXXXXXXXXXXXXXXXXXX,0,300,0
924,13,0,13,91,196,0,0,208,11,197,GXXXXXXXXXXXXXXXXXXXGXXXXXXXXXXXXXXXXXXXGXXXXXXXXXXXXXXXXXXXGXXXXXXXXXXXXXXXXXXXGXXXXXXXXXXXXXXXXXXXGXXXXXXXXXXXXXXXXXXXGXXXXXXXXXXXXXXXXXXXGXXXXXXXXXXXXXXXXXXXGXXXXXXXXXXXXXXXXXXXGXXXXXXXXXXXXXXXXXXXGXXXXXXXXXXXXXXXXXXXGXXXXXXXXXXXXXXXXXXXGXXXXXXXXXXXXXXXXXXX,0,300,0

945,13,0,13,77,210,0,0,222,10,212,GXXXXXXXXXXXXXXXXXXXGXXXXXXXXXXXXXXXXXXXGXXXXXXXXXXXXXXXXXXXGXXXXXXXXXXXXXXXXXXXGXXXXXXXXXXXXXXXXXXXGXXXXXXXXXXXXXXXXXXXGXXXXXXXXXXXXXXXXXXXGXXXXXXXXXXXXXXXXXXXGXXXXXXXXXXXXXXXXXXXGXXXXXXXXXXXXXXXXXXXGXXXXXXXXXXXXXXXXXXXGXXXXXXXXXXXXXXXXXXXGXXXXXXXXXXXXXXXXXXX,0,300,0
966,13,0,13,70,217,0,0,227,10,217,GXXXXXXXXXXXXXXXXXXXGXXXXXXXXXXXXXXXXXXXGXXXXXXXXXXXXXXXXXXXGXXXXXXXXXXXXXXXXXXXGXXXXXXXXXXXXXXXXXXXGXXXXXXXXXXXXXXXXXXXGXXXXXXXXXXXXXXXXXXXGXXXXXXXXXXXXXXXXXXXGXXXXXXXXXXXXXXXXXXXGXXXXXXXXXXXXXXXXXXXGXXXXXXXXXXXXXXXXXXXGXXXXXXXXXXXXXXXXXXXGXXXXXXXXXXXXXXXXXXX,0,300,0
987,14,1,13,58,228,0,0,240,18,222,GXXXXXXXXXXXXXXXXXXXGXXXXXXXXXXXXXXXXXXXGAXXXXXXXXXXXXXXXXXXGXXXXXXXXXXXXXXXXXXXGXXXXXXXXXXXXXXXXXXXGXXXXXXXXXXXXXXXXXXXGXXXXXXXXXXXXXXXXXXXGXXXXXXXXXXXXXXXXXXXGXXXXXXXXXXXXXXXXXXXGXXXXXXXXXXXXXXXXXXXGXXXXXXXXXXXXXXXXXXXGXXXXXXXXXXXXXXXXXXXGXXXXXXXXXXXXXXXXXXX,0,300,0
1008,14,1,13,57,229,0,0,241,21,220,GXXXXXXXXXXXXXXXXXXXGXXXXXXXXXXXXXXXXXXXGAXXXXXXXXXXXXXXXXXXGXXXXXXXXXXXXXXXXXXXGXXXXXXXXXXXXXXXXXXXGXXXXXXXXXXXXXXXXXXXGXXXXXXXXXXXXXXXXXXXGXXXXXXXXXXXXXXXXXXXGXXXXXXXXXXXXXXXXXXXGXXXXXXXXXXXXXXXXXXXGXXXXXXXXXXXXXXXXXXXGXXXXXXXXXXXXXXXXXXXGXXXXXXXXXXXXXXXXXXX,0,300,0
1029,14,1,13,53,233,0,0,245,22,223,GXXXXXXXXXXXXXXXXXXXGXXXXXXXXXXXXXXXXXXXGAXXXXXXXXXXXXXXXXXXGXXXXXXXXXXXXXXXXXXXGXXXXXXXXXXXXXXXXXXXGXXXXXXXXXXXXXXXXXXXGXXXXXXXXXXXXXXXXXXXGXXXXXXXXXXXXXXXXXXXGXXXXXXXXXXXXXXXXXXXGXXXXXXXXXXXXXXXXXXXGXXXXXXXXXXXXXXXXXXXGXXXXXXXXXXXXXXXXXXXGXXXXXXXXXXXXXXXXXXX,0,300,0

1050,14,1,13,48,238,0,0,249,28,221,GXXXXXXXXXXXXXXXXXXXGXXXXXXXXXXXXXXXXXXXGAXXXXXXXXXXXXXXXXXXGXXXXXXXXXXXXXXXXXXXGXXXXXXXXXXXXXXXXXXXGXXXXXXXXXXXXXXXXXXXGXXXXXXXXXXXXXXXXXXXGXXXXXXXXXXXXXXXXXXXGXXXXXXXXXXXXXXXXXXXGXXXXXXXXXXXXXXXXXXXGXXXXXXXXXXXXXXXXXXXGXXXXXXXXXXXXXXXXXXXGXXXXXXXXXXXXXXXXXXX,0,300,0
1071,14,1,13,57,229,0,0,241,31,210,GXXXXXXXXXXXXXXXXXXXGXXXXXXXXXXXXXXXXXXXGAXXXXXXXXXXXXXXXXXXGXXXXXXXXXXXXXXXXXXXGXXXXXXXXXXXXXXXXXXXGXXXXXXXXXXXXXXXXXXXGXXXXXXXXXXXXXXXXXXXGXXXXXXXXXXXXXXXXXXXGXXXXXXXXXXXXXXXXXXXGXXXXXXXXXXXXXXXXXXXGXXXXXXXXXXXXXXXXXXXGXXXXXXXXXXXXXXXXXXXGXXXXXXXXXXXXXXXXXXX,0,300,0
1092,14,1,13,63,223,0,0,235,33,202,GXXXXXXXXXXXXXXXXXXXGXXXXXXXXXXXXXXXXXXXGAXXXXXXXXXXXXXXXXXXGXXXXXXXXXXXXXXXXXXXGXXXXXXXXXXXXXXXXXXXGXXXXXXXXXXXXXXXXXXXGXXXXXXXXXXXXXXXXXXXGXXXXXXXXXXXXXXXXXXXGXXXXXXXXXXXXXXXXXXXGXXXXXXXXXXXXXXXXXXXGXXXXXXXXXXXXXXXXXXXGXXXXXXXXXXXXXXXXXXXGXXXXXXXXXXXXXXXXXXX,0,300,0
1113,14,1,13,77,209,0,0,221,26,195,GXXXXXXXXXXXXXXXXXXXGXXXXXXXXXXXXXXXXXXXGAXXXXXXXXXXXXXXXXXXGXXXXXXXXXXXXXXXXXXXGXXXXXXXXXXXXXXXXXXXGXXXXXXXXXXXXXXXXXXXGXXXXXXXXXXXXXXXXXXXGXXXXXXXXXXXXXXXXXXXGXXXXXXXXXXXXXXXXXXXGXXXXXXXXXXXXXXXXXXXGXXXXXXXXXXXXXXXXXXXGXXXXXXXXXXXXXXXXXXXGXXXXXXXXXXXXXXXXXXX,0,300,0
1134,14,1,13,72,214,0,0,226,28,198,GXXXXXXXXXXXXXXXXXXXGXXXXXXXXXXXXXXXXXXXGAXXXXXXXXXXXXXXXXXXGXXXXXXXXXXXXXXXXXXXGXXXXXXXXXXXXXXXXXXXGXXXXXXXXXXXXXXXXXXXGXXXXXXXXXXXXXXXXXXXGXXXXXXXXXXXXXXXXXXXGXXXXXXXXXXXXXXXXXXXGXXXXXXXXXXXXXXXXXXXGXXXXXXXXXXXXXXXXXXXGXXXXXXXXXXXXXXXXXXXGXXXXXXXXXXXXXXXXXXX,0,300,0

1155,15,2,13,80,205,0,0,218,40,178,GXXXXXXXXXXXXXXXXXXXGXXXXXXXXXXXXXXXXXXXGAXXXXXXXXXXXXXXXXXXGAXXXXXXXXXXXXXXXXXXGXXXXXXXXXXXXXXXXXXXGXXXXXXXXXXXXXXXXXXXGXXXXXXXXXXXXXXXXXXXGXXXXXXXXXXXXXXXXXXXGXXXXXXXXXXXXXXXXXXXGXXXXXXXXXXXXXXXXXXXGXXXXXXXXXXXXXXXXXXXGXXXXXXXXXXXXXXXXXXXGXXXXXXXXXXXXXXXXXXX,0,300,0
1176,15,1,14,92,193,0,0,206,36,170,GXXXXXXXXXXXXXXXXXXXGXXXXXXXXXXXXXXXXXXXGAXXXXXXXXXXXXXXXXXXGOXXXXXXXXXXXXXXXXXXGXXXXXXXXXXXXXXXXXXXGXXXXXXXXXXXXXXXXXXXGXXXXXXXXXXXXXXXXXXXGXXXXXXXXXXXXXXXXXXXGXXXXXXXXXXXXXXXXXXXGXXXXXXXXXXXXXXXXXXXGXXXXXXXXXXXXXXXXXXXGXXXXXXXXXXXXXXXXXXXGXXXXXXXXXXXXXXXXXXX,0,300,0
1197,15,0,15,99,186,0,0,199,42,157,GXXXXXXXXXXXXXXXXXXXGXXXXXXXXXXXXXXXXXXXGOXXXXXXXXXXXXXXXXXXGOXXXXXXXXXXXXXXXXXXGXXXXXXXXXXXXXXXXXXXGXXXXXXXXXXXXXXXXXXXGXXXXXXXXXXXXXXXXXXXGXXXXXXXXXXXXXXXXXXXGXXXXXXXXXXXXXXXXXXXGXXXXXXXXXXXXXXXXXXXGXXXXXXXXXXXXXXXXXXXGXXXXXXXXXXXXXXXXXXXGXXXXXXXXXXXXXXXXXXX,0,300,0
1218,13,0,13,102,185,0,0,197,41,156,GXXXXXXXXXXXXXXXXXXXGXXXXXXXXXXXXXXXXXXXGXXXXXXXXXXXXXXXXXXXGXXXXXXXXXXXXXXXXXXXGXXXXXXXXXXXXXXXXXXXGXXXXXXXXXXXXXXXXXXXGXXXXXXXXXXXXXXXXXXXGXXXXXXXXXXXXXXXXXXXGXXXXXXXXXXXXXXXXXXXGXXXXXXXXXXXXXXXXXXXGXXXXXXXXXXXXXXXXXXXGXXXXXXXXXXXXXXXXXXXGXXXXXXXXXXXXXXXXXXX,0,300,0
1239,13,0,13,100,187,0,0,199,42,157,GXXXXXXXXXXXXXXXXXXXGXXXXXXXXXXXXXXXXXXXGXXXXXXXXXXXXXXXXXXXGXXXXXXXXXXXXXXXXXXXGXXXXXXXXXXXXXXXXXXXGXXXXXXXXXXXXXXXXXXXGXXXXXXXXXXXXXXXXXXXGXXXXXXXXXXXXXXXXXXXGXXXXXXXXXXXXXXXXXXXGXXXXXXXXXXXXXXXXXXXGXXXXXXXXXXXXXXXXXXXGXXXXXXXXXXXXXXXXXXXGXXXXXXXXXXXXXXXXXXX,0,300,0

1260,13,0,13,108,179,0,0,191,37,154,GXXXXXXXXXXXXXXXXXXXGXXXXXXXXXXXXXXXXXXXGXXXXXXXXXXXXXXXXXXXGXXXXXXXXXXXXXXXXXXXGXXXXXXXXXXXXXXXXXXXGXXXXXXXXXXXXXXXXXXXGXXXXXXXXXXXXXXXXXXXGXXXXXXXXXXXXXXXXXXXGXXXXXXXXXXXXXXXXXXXGXXXXXXXXXXXXXXXXXXXGXXXXXXXXXXXXXXXXXXXGXXXXXXXXXXXXXXXXXXXGXXXXXXXXXXXXXXXXXXX,0,300,0
1281,14,1,13,112,174,0,0,185,35,150,GXXXXXXXXXXXXXXXXXXXGXXXXXXXXXXXXXXXXXXXGXXXXXXXXXXXXXXXXXXXGXXXXXXXXXXXXXXXXXXXGXXXXXXXXXXXXXXXXXXXGAXXXXXXXXXXXXXXXXXXGXXXXXXXXXXXXXXXXXXXGXXXXXXXXXXXXXXXXXXXGXXXXXXXXXXXXXXXXXXXGXXXXXXXXXXXXXXXXXXXGXXXXXXXXXXXXXXXXXXXGXXXXXXXXXXXXXXXXXXXGXXXXXXXXXXXXXXXXXXX,0,300,0
1302,13,0,13,109,178,0,0,190,39,151,GXXXXXXXXXXXXXXXXXXXGXXXXXXXXXXXXXXXXXXXGXXXXXXXXXXXXXXXXXXXGXXXXXXXXXXXXXXXXXXXGXXXXXXXXXXXXXXXXXXXGXXXXXXXXXXXXXXXXXXXGXXXXXXXXXXXXXXXXXXXGXXXXXXXXXXXXXXXXXXXGXXXXXXXXXXXXXXXXXXXGXXXXXXXXXXXXXXXXXXXGXXXXXXXXXXXXXXXXXXXGXXXXXXXXXXXXXXXXXXXGXXXXXXXXXXXXXXXXXXX,0,300,0
1323,13,0,13,107,180,0,0,192,35,157,GXXXXXXXXXXXXXXXXXXXGXXXXXXXXXXXXXXXXXXXGXXXXXXXXXXXXXXXXXXXGXXXXXXXXXXXXXXXXXXXGXXXXXXXXXXXXXXXXXXXGXXXXXXXXXXXXXXXXXXXGXXXXXXXXXXXXXXXXXXXGXXXXXXXXXXXXXXXXXXXGXXXXXXXXXXXXXXXXXXXGXXXXXXXXXXXXXXXXXXXGXXXXXXXXXXXXXXXXXXXGXXXXXXXXXXXXXXXXXXXGXXXXXXXXXXXXXXXXXXX,0,300,0
1344,13,0,13,105,182,0,0,192,38,154,GXXXXXXXXXXXXXXXXXXXGXXXXXXXXXXXXXXXXXXXGXXXXXXXXXXXXXXXXXXXGXXXXXXXXXXXXXXXXXXXGXXXXXXXXXXXXXXXXXXXGXXXXXXXXXXXXXXXXXXXGXXXXXXXXXXXXXXXXXXXGXXXXXXXXXXXXXXXXXXXGXXXXXXXXXXXXXXXXXXXGXXXXXXXXXXXXXXXXXXXGXXXXXXXXXXXXXXXXXXXGXXXXXXXXXXXXXXXXXXXGXXXXXXXXXXXXXXXXXXX,0,300,0

1365,13,0,13,112,175,0,0,187,44,143,GXXXXXXXXXXXXXXXXXXXGXXXXXXXXXXXXXXXXXXXGXXXXXXXXXXXXXXXXXXXGXXXXXXXXXXXXXXXXXXXGXXXXXXXXXXXXXXXXXXXGXXXXXXXXXXXXXXXXXXXGXXXXXXXXXXXXXXXXXXXGXXXXXXXXXXXXXXXXXXXGXXXXXXXXXXXXXXXXXXXGXXXXXXXXXXXXXXXXXXXGXXXXXXXXXXXXXXXXXXXGXXXXXXXXXXXXXXXXXXXGXXXXXXXXXXXXXXXXXXX,0,300,0
1386,13,0,13,116,171,0,0,183,45,138,GXXXXXXXXXXXXXXXXXXXGXXXXXXXXXXXXXXXXXXXGXXXXXXXXXXXXXXXXXXXGXXXXXXXXXXXXXXXXXXXGXXXXXXXXXXXXXXXXXXXGXXXXXXXXXXXXXXXXXXXGXXXXXXXXXXXXXXXXXXXGXXXXXXXXXXXXXXXXXXXGXXXXXXXXXXXXXXXXXXXGXXXXXXXXXXXXXXXXXXXGXXXXXXXXXXXXXXXXXXXGXXXXXXXXXXXXXXXXXXXGXXXXXXXXXXXXXXXXXXX,0,300,0
1407,14,1,13,122,164,0,0,174,33,141,GXXXXXXXXXXXXXXXXXXXGXXXXXXXXXXXXXXXXXXXGXXXXXXXXXXXXXXXXXXXGAXXXXXXXXXXXXXXXXXXGXXXXXXXXXXXXXXXXXXXGXXXXXXXXXXXXXXXXXXXGXXXXXXXXXXXXXXXXXXXGXXXXXXXXXXXXXXXXXXXGXXXXXXXXXXXXXXXXXXXGXXXXXXXXXXXXXXXXXXXGXXXXXXXXXXXXXXXXXXXGXXXXXXXXXXXXXXXXXXXGXXXXXXXXXXXXXXXXXXX,0,300,0
1428,14,1,13,120,166,0,0,178,35,143,GXXXXXXXXXXXXXXXXXXXGXXXXXXXXXXXXXXXXXXXGXXXXXXXXXXXXXXXXXXXGAXXXXXXXXXXXXXXXXXXGXXXXXXXXXXXXXXXXXXXGXXXXXXXXXXXXXXXXXXXGXXXXXXXXXXXXXXXXXXXGXXXXXXXXXXXXXXXXXXXGXXXXXXXXXXXXXXXXXXXGXXXXXXXXXXXXXXXXXXXGXXXXXXXXXXXXXXXXXXXGXXXXXXXXXXXXXXXXXXXGXXXXXXXXXXXXXXXXXXX,0,300,0
1449,14,1,13,110,176,0,0,188,45,143,GXXXXXXXXXXXXXXXXXXXGXXXXXXXXXXXXXXXXXXXGXXXXXXXXXXXXXXXXXXXGAXXXXXXXXXXXXXXXXXXGXXXXXXXXXXXXXXXXXXXGXXXXXXXXXXXXXXXXXXXGXXXXXXXXXXXXXXXXXXXGXXXXXXXXXXXXXXXXXXXGXXXXXXXXXXXXXXXXXXXGXXXXXXXXXXXXXXXXXXXGXXXXXXXXXXXXXXXXXXXGXXXXXXXXXXXXXXXXXXXGXXXXXXXXXXXXXXXXXXX,0,300,0

1470,15,2,13,112,173,0,0,185,40,145,GXXXXXXXXXXXXXXXXXXXGXXXXXXXXXXXXXXXXXXXGXXXXXXXXXXXXXXXXXXXGAAXXXXXXXXXXXXXXXXXGXXXXXXXXXXXXXXXXXXXGXXXXXXXXXXXXXXXXXXXGXXXXXXXXXXXXXXXXXXXGXXXXXXXXXXXXXXXXXXXGXXXXXXXXXXXXXXXXXXXGXXXXXXXXXXXXXXXXXXXGXXXXXXXXXXXXXXXXXXXGXXXXXXXXXXXXXXXXXXXGXXXXXXXXXXXXXXXXXXX,0,300,0
1491,15,2,13,115,170,0,0,181,37,144,GXXXXXXXXXXXXXXXXXXXGXXXXXXXXXXXXXXXXXXXGXXXXXXXXXXXXXXXXXXXGAAXXXXXXXXXXXXXXXXXGXXXXXXXXXXXXXXXXXXXGXXXXXXXXXXXXXXXXXXXGXXXXXXXXXXXXXXXXXXXGXXXXXXXXXXXXXXXXXXXGXXXXXXXXXXXXXXXXXXXGXXXXXXXXXXXXXXXXXXXGXXXXXXXXXXXXXXXXXXXGXXXXXXXXXXXXXXXXXXXGXXXXXXXXXXXXXXXXXXX,0,300,0
1512,15,2,13,108,177,0,0,189,33,156,GXXXXXXXXXXXXXXXXXXXGXXXXXXXXXXXXXXXXXXXGXXXXXXXXXXXXXXXXXXXGAAXXXXXXXXXXXXXXXXXGXXXXXXXXXXXXXXXXXXXGXXXXXXXXXXXXXXXXXXXGXXXXXXXXXXXXXXXXXXXGXXXXXXXXXXXXXXXXXXXGXXXXXXXXXXXXXXXXXXXGXXXXXXXXXXXXXXXXXXXGXXXXXXXXXXXXXXXXXXXGXXXXXXXXXXXXXXXXXXXGXXXXXXXXXXXXXXXXXXX,0,300,0
1533,17,4,13,104,179,0,0,190,30,160,GXXXXXXXXXXXXXXXXXXXGXXXXXXXXXXXXXXXXXXXGXXXXXXXXXXXXXXXXXXXGAAXXXXXXXXXXXXXXXXXGXXXXXXXXXXXXXXXXXXXGXXXXXXXXXXXXXXXXXXXGXXXXXXXXXXXXXXXXXXXGAXXXXXXXXXXXXXXXXXXGXXXXXXXXXXXXXXXXXXXGXXXXXXXXXXXXXXXXXXXGXXXXXXXXXXXXXXXXXXXGXXXXXXXXXXXXXXXXXXXGAXXXXXXXXXXXXXXXXXX,0,300,0
1554,17,3,14,101,182,0,0,194,30,164,GXXXXXXXXXXXXXXXXXXXGXXXXXXXXXXXXXXXXXXXGXXXXXXXXXXXXXXXXXXXGAAXXXXXXXXXXXXXXXXXGXXXXXXXXXXXXXXXXXXXGXXXXXXXXXXXXXXXXXXXGXXXXXXXXXXXXXXXXXXXGAXXXXXXXXXXXXXXXXXXGXXXXXXXXXXXXXXXXXXXGXXXXXXXXXXXXXXXXXXXGXXXXXXXXXXXXXXXXXXXGXXXXXXXXXXXXXXXXXXXGOXXXXXXXXXXXXXXXXXX,0,300,0

1575,17,3,14,100,183,0,0,195,35,160,GXXXXXXXXXXXXXXXXXXXGXXXXXXXXXXXXXXXXXXXGXXXXXXXXXXXXXXXXXXXGAAXXXXXXXXXXXXXXXXXGXXXXXXXXXXXXXXXXXXXGXXXXXXXXXXXXXXXXXXXGXXXXXXXXXXXXXXXXXXXGAXXXXXXXXXXXXXXXXXXGXXXXXXXXXXXXXXXXXXXGXXXXXXXXXXXXXXXXXXXGXXXXXXXXXXXXXXXXXXXGXXXXXXXXXXXXXXXXXXXGOXXXXXXXXXXXXXXXXXX,0,300,0
1596,17,3,14,103,180,0,0,192,29,163,GXXXXXXXXXXXXXXXXXXXGXXXXXXXXXXXXXXXXXXXGXXXXXXXXXXXXXXXXXXXGAAXXXXXXXXXXXXXXXXXGXXXXXXXXXXXXXXXXXXXGXXXXXXXXXXXXXXXXXXXGXXXXXXXXXXXXXXXXXXXGAXXXXXXXXXXXXXXXXXXGXXXXXXXXXXXXXXXXXXXGXXXXXXXXXXXXXXXXXXXGXXXXXXXXXXXXXXXXXXXGXXXXXXXXXXXXXXXXXXXGOXXXXXXXXXXXXXXXXXX,0,300,0
1617,16,3,13,102,182,0,0,194,30,164,GXXXXXXXXXXXXXXXXXXXGXXXXXXXXXXXXXXXXXXXGXXXXXXXXXXXXXXXXXXXGAAXXXXXXXXXXXXXXXXXGXXXXXXXXXXXXXXXXXXXGXXXXXXXXXXXXXXXXXXXGXXXXXXXXXXXXXXXXXXXGAXXXXXXXXXXXXXXXXXXGXXXXXXXXXXXXXXXXXXXGXXXXXXXXXXXXXXXXXXXGXXXXXXXXXXXXXXXXXXXGXXXXXXXXXXXXXXXXXXXGXXXXXXXXXXXXXXXXXXX,0,300,0
1638,17,4,13,93,190,0,0,201,31,170,GXXXXXXXXXXXXXXXXXXXGXXXXXXXXXXXXXXXXXXXGXXXXXXXXXXXXXXXXXXXGAAXXXXXXXXXXXXXXXXXGXXXXXXXXXXXXXXXXXXXGXXXXXXXXXXXXXXXXXXXGXXXXXXXXXXXXXXXXXXXGAXXXXXXXXXXXXXXXXXXGXXXXXXXXXXXXXXXXXXXGXXXXXXXXXXXXXXXXXXXGXXXXXXXXXXXXXXXXXXXGXXXXXXXXXXXXXXXXXXXGAXXXXXXXXXXXXXXXXXX,0,300,0
1659,17,4,13,93,190,0,0,202,34,168,GXXXXXXXXXXXXXXXXXXXGXXXXXXXXXXXXXXXXXXXGXXXXXXXXXXXXXXXXXXXGAAXXXXXXXXXXXXXXXXXGXXXXXXXXXXXXXXXXXXXGXXXXXXXXXXXXXXXXXXXGXXXXXXXXXXXXXXXXXXXGAXXXXXXXXXXXXXXXXXXGXXXXXXXXXXXXXXXXXXXGXXXXXXXXXXXXXXXXXXXGXXXXXXXXXXXXXXXXXXXGXXXXXXXXXXXXXXXXXXXGAXXXXXXXXXXXXXXXXXX,0,300,0

1680,17,4,13,89,194,0,0,205,34,171,GXXXXXXXXXXXXXXXXXXXGXXXXXXXXXXXXXXXXXXXGXXXXXXXXXXXXXXXXXXXGAAXXXXXXXXXXXXXXXXXGXXXXXXXXXXXXXXXXXXXGXXXXXXXXXXXXXXXXXXXGXXXXXXXXXXXXXXXXXXXGAXXXXXXXXXXXXXXXXXXGXXXXXXXXXXXXXXXXXXXGXXXXXXXXXXXXXXXXXXXGXXXXXXXXXXXXXXXXXXXGXXXXXXXXXXXXXXXXXXXGAXXXXXXXXXXXXXXXXXX,0,300,0
1701,17,4,13,90,193,0,0,205,30,175,GXXXXXXXXXXXXXXXXXXXGXXXXXXXXXXXXXXXXXXXGXXXXXXXXXXXXXXXXXXXGAAXXXXXXXXXXXXXXXXXGXXXXXXXXXXXXXXXXXXXGXXXXXXXXXXXXXXXXXXXGXXXXXXXXXXXXXXXXXXXGAXXXXXXXXXXXXXXXXXXGXXXXXXXXXXXXXXXXXXXGXXXXXXXXXXXXXXXXXXXGXXXXXXXXXXXXXXXXXXXGXXXXXXXXXXXXXXXXXXXGAXXXXXXXXXXXXXXXXXX,0,300,0
1722,17,4,13,89,194,0,0,206,32,174,GXXXXXXXXXXXXXXXXXXXGXXXXXXXXXXXXXXXXXXXGXXXXXXXXXXXXXXXXXXXGAAXXXXXXXXXXXXXXXXXGXXXXXXXXXXXXXXXXXXXGXXXXXXXXXXXXXXXXXXXGXXXXXXXXXXXXXXXXXXXGAXXXXXXXXXXXXXXXXXXGXXXXXXXXXXXXXXXXXXXGXXXXXXXXXXXXXXXXXXXGXXXXXXXXXXXXXXXXXXXGXXXXXXXXXXXXXXXXXXXGAXXXXXXXXXXXXXXXXXX,0,300,0
1743,17,4,13,92,191,0,0,203,35,168,GXXXXXXXXXXXXXXXXXXXGXXXXXXXXXXXXXXXXXXXGXXXXXXXXXXXXXXXXXXXGAAXXXXXXXXXXXXXXXXXGXXXXXXXXXXXXXXXXXXXGXXXXXXXXXXXXXXXXXXXGXXXXXXXXXXXXXXXXXXXGAXXXXXXXXXXXXXXXXXXGXXXXXXXXXXXXXXXXXXXGXXXXXXXXXXXXXXXXXXXGXXXXXXXXXXXXXXXXXXXGXXXXXXXXXXXXXXXXXXXGAXXXXXXXXXXXXXXXXXX,0,300,0
1764,17,4,13,90,193,0,0,206,39,167,GXXXXXXXXXXXXXXXXXXXGXXXXXXXXXXXXXXXXXXXGXXXXXXXXXXXXXXXXXXXGAAXXXXXXXXXXXXXXXXXGXXXXXXXXXXXXXXXXXXXGXXXXXXXXXXXXXXXXXXXGXXXXXXXXXXXXXXXXXXXGAXXXXXXXXXXXXXXXXXXGXXXXXXXXXXXXXXXXXXXGXXXXXXXXXXXXXXXXXXXGXXXXXXXXXXXXXXXXXXXGXXXXXXXXXXXXXXXXXXXGAXXXXXXXXXXXXXXXXXX,0,300,0

1785,18,4,14,91,191,0,0,204,39,165,GXXXXXXXXXXXXXXXXXXXGXXXXXXXXXXXXXXXXXXXGAXXXXXXXXXXXXXXXXXXGAAXXXXXXXXXXXXXXXXXGXXXXXXXXXXXXXXXXXXXGXXXXXXXXXXXXXXXXXXXGXXXXXXXXXXXXXXXXXXXGOXXXXXXXXXXXXXXXXXXGXXXXXXXXXXXXXXXXXXXGXXXXXXXXXXXXXXXXXXXGXXXXXXXXXXXXXXXXXXXGXXXXXXXXXXXXXXXXXXXGAXXXXXXXXXXXXXXXXXX,0,300,0
1806,16,3,13,84,200,0,0,213,43,170,GXXXXXXXXXXXXXXXXXXXGXXXXXXXXXXXXXXXXXXXGAXXXXXXXXXXXXXXXXXXGAXXXXXXXXXXXXXXXXXXGXXXXXXXXXXXXXXXXXXXGXXXXXXXXXXXXXXXXXXXGXXXXXXXXXXXXXXXXXXXGXXXXXXXXXXXXXXXXXXXGXXXXXXXXXXXXXXXXXXXGXXXXXXXXXXXXXXXXXXXGXXXXXXXXXXXXXXXXXXXGXXXXXXXXXXXXXXXXXXXGAXXXXXXXXXXXXXXXXXX,0,300,0
1827,16,2,14,88,196,0,0,207,41,166,GXXXXXXXXXXXXXXXXXXXGXXXXXXXXXXXXXXXXXXXGAXXXXXXXXXXXXXXXXXXGOXXXXXXXXXXXXXXXXXXGXXXXXXXXXXXXXXXXXXXGXXXXXXXXXXXXXXXXXXXGXXXXXXXXXXXXXXXXXXXGXXXXXXXXXXXXXXXXXXXGXXXXXXXXXXXXXXXXXXXGXXXXXXXXXXXXXXXXXXXGXXXXXXXXXXXXXXXXXXXGXXXXXXXXXXXXXXXXXXXGAXXXXXXXXXXXXXXXXXX,0,300,0
1848,16,2,14,88,196,0,0,208,39,169,GXXXXXXXXXXXXXXXXXXXGXXXXXXXXXXXXXXXXXXXGAXXXXXXXXXXXXXXXXXXGOXXXXXXXXXXXXXXXXXXGXXXXXXXXXXXXXXXXXXXGXXXXXXXXXXXXXXXXXXXGXXXXXXXXXXXXXXXXXXXGXXXXXXXXXXXXXXXXXXXGXXXXXXXXXXXXXXXXXXXGXXXXXXXXXXXXXXXXXXXGXXXXXXXXXXXXXXXXXXXGXXXXXXXXXXXXXXXXXXXGAXXXXXXXXXXXXXXXXXX,0,300,0
1869,15,2,13,94,191,0,0,203,43,160,GXXXXXXXXXXXXXXXXXXXGXXXXXXXXXXXXXXXXXXXGAXXXXXXXXXXXXXXXXXXGXXXXXXXXXXXXXXXXXXXGXXXXXXXXXXXXXXXXXXXGXXXXXXXXXXXXXXXXXXXGXXXXXXXXXXXXXXXXXXXGXXXXXXXXXXXXXXXXXXXGXXXXXXXXXXXXXXXXXXXGXXXXXXXXXXXXXXXXXXXGXXXXXXXXXXXXXXXXXXXGXXXXXXXXXXXXXXXXXXXGAXXXXXXXXXXXXXXXXXX,0,300,0

1890,15,2,13,98,187,0,0,198,46,152,GXXXXXXXXXXXXXXXXXXXGXXXXXXXXXXXXXXXXXXXGAXXXXXXXXXXXXXXXXXXGXXXXXXXXXXXXXXXXXXXGXXXXXXXXXXXXXXXXXXXGXXXXXXXXXXXXXXXXXXXGXXXXXXXXXXXXXXXXXXXGXXXXXXXXXXXXXXXXXXXGXXXXXXXXXXXXXXXXXXXGXXXXXXXXXXXXXXXXXXXGXXXXXXXXXXXXXXXXXXXGXXXXXXXXXXXXXXXXXXXGAXXXXXXXXXXXXXXXXXX,0,300,0
1911,15,2,13,104,181,0,0,193,42,151,GXXXXXXXXXXXXXXXXXXXGXXXXXXXXXXXXXXXXXXXGAXXXXXXXXXXXXXXXXXXGXXXXXXXXXXXXXXXXXXXGXXXXXXXXXXXXXXXXXXXGXXXXXXXXXXXXXXXXXXXGXXXXXXXXXXXXXXXXXXXGXXXXXXXXXXXXXXXXXXXGXXXXXXXXXXXXXXXXXXXGXXXXXXXXXXXXXXXXXXXGXXXXXXXXXXXXXXXXXXXGXXXXXXXXXXXXXXXXXXXGAXXXXXXXXXXXXXXXXXX,0,300,0
1932,15,1,14,105,180,0,0,192,47,145,GXXXXXXXXXXXXXXXXXXXGXXXXXXXXXXXXXXXXXXXGOXXXXXXXXXXXXXXXXXXGXXXXXXXXXXXXXXXXXXXGXXXXXXXXXXXXXXXXXXXGXXXXXXXXXXXXXXXXXXXGXXXXXXXXXXXXXXXXXXXGXXXXXXXXXXXXXXXXXXXGXXXXXXXXXXXXXXXXXXXGXXXXXXXXXXXXXXXXXXXGXXXXXXXXXXXXXXXXXXXGXXXXXXXXXXXXXXXXXXXGAXXXXXXXXXXXXXXXXXX,0,300,0
1953,14,1,13,103,183,0,0,193,43,150,GXXXXXXXXXXXXXXXXXXXGXXXXXXXXXXXXXXXXXXXGXXXXXXXXXXXXXXXXXXXGXXXXXXXXXXXXXXXXXXXGXXXXXXXXXXXXXXXXXXXGXXXXXXXXXXXXXXXXXXXGXXXXXXXXXXXXXXXXXXXGXXXXXXXXXXXXXXXXXXXGXXXXXXXXXXXXXXXXXXXGXXXXXXXXXXXXXXXXXXXGXXXXXXXXXXXXXXXXXXXGXXXXXXXXXXXXXXXXXXXGAXXXXXXXXXXXXXXXXXX,0,300,0
1974,13,0,13,100,187,0,0,199,42,157,GXXXXXXXXXXXXXXXXXXXGXXXXXXXXXXXXXXXXXXXGXXXXXXXXXXXXXXXXXXXGXXXXXXXXXXXXXXXXXXXGXXXXXXXXXXXXXXXXXXXGXXXXXXXXXXXXXXXXXXXGXXXXXXXXXXXXXXXXXXXGXXXXXXXXXXXXXXXXXXXGXXXXXXXXXXXXXXXXXXXGXXXXXXXXXXXXXXXXXXXGXXXXXXXXXXXXXXXXXXXGXXXXXXXXXXXXXXXXXXXGXXXXXXXXXXXXXXXXXXX,0,300,0

1995,13,0,13,98,189,0,0,200,37,163,GXXXXXXXXXXXXXXXXXXXGXXXXXXXXXXXXXXXXXXXGXXXXXXXXXXXXXXXXXXXGXXXXXXXXXXXXXXXXXXXGXXXXXXXXXXXXXXXXXXXGXXXXXXXXXXXXXXXXXXXGXXXXXXXXXXXXXXXXXXXGXXXXXXXXXXXXXXXXXXXGXXXXXXXXXXXXXXXXXXXGXXXXXXXXXXXXXXXXXXXGXXXXXXXXXXXXXXXXXXXGXXXXXXXXXXXXXXXXXXXGXXXXXXXXXXXXXXXXXXX,0,300,0
2016,13,0,13,99,188,0,0,200,35,165,GXXXXXXXXXXXXXXXXXXXGXXXXXXXXXXXXXXXXXXXGXXXXXXXXXXXXXXXXXXXGXXXXXXXXXXXXXXXXXXXGXXXXXXXXXXXXXXXXXXXGXXXXXXXXXXXXXXXXXXXGXXXXXXXXXXXXXXXXXXXGXXXXXXXXXXXXXXXXXXXGXXXXXXXXXXXXXXXXXXXGXXXXXXXXXXXXXXXXXXXGXXXXXXXXXXXXXXXXXXXGXXXXXXXXXXXXXXXXXXXGXXXXXXXXXXXXXXXXXXX,0,300,0
2037,13,0,13,104,183,0,0,195,34,161,GXXXXXXXXXXXXXXXXXXXGXXXXXXXXXXXXXXXXXXXGXXXXXXXXXXXXXXXXXXXGXXXXXXXXXXXXXXXXXXXGXXXXXXXXXXXXXXXXXXXGXXXXXXXXXXXXXXXXXXXGXXXXXXXXXXXXXXXXXXXGXXXXXXXXXXXXXXXXXXXGXXXXXXXXXXXXXXXXXXXGXXXXXXXXXXXXXXXXXXXGXXXXXXXXXXXXXXXXXXXGXXXXXXXXXXXXXXXXXXXGXXXXXXXXXXXXXXXXXXX,0,300,0
2058,13,0,13,105,182,0,0,194,32,162,GXXXXXXXXXXXXXXXXXXXGXXXXXXXXXXXXXXXXXXXGXXXXXXXXXXXXXXXXXXXGXXXXXXXXXXXXXXXXXXXGXXXXXXXXXXXXXXXXXXXGXXXXXXXXXXXXXXXXXXXGXXXXXXXXXXXXXXXXXXXGXXXXXXXXXXXXXXXXXXXGXXXXXXXXXXXXXXXXXXXGXXXXXXXXXXXXXXXXXXXGXXXXXXXXXXXXXXXXXXXGXXXXXXXXXXXXXXXXXXXGXXXXXXXXXXXXXXXXXXX,0,300,0
2079,13,0,13,106,181,0,0,193,30,163,GXXXXXXXXXXXXXXXXXXXGXXXXXXXXXXXXXXXXXXXGXXXXXXXXXXXXXXXXXXXGXXXXXXXXXXXXXXXXXXXGXXXXXXXXXXXXXXXXXXXGXXXXXXXXXXXXXXXXXXXGXXXXXXXXXXXXXXXXXXXGXXXXXXXXXXXXXXXXXXXGXXXXXXXXXXXXXXXXXXXGXXXXXXXXXXXXXXXXXXXGXXXXXXXXXXXXXXXXXXXGXXXXXXXXXXXXXXXXXXXGXXXXXXXXXXXXXXXXXXX,0,300,0

2100,13,0,13,96,191,0,0,203,37,166,GXXXXXXXXXXXXXXXXXXXGXXXXXXXXXXXXXXXXXXXGXXXXXXXXXXXXXXXXXXXGXXXXXXXXXXXXXXXXXXXGXXXXXXXXXXXXXXXXXXXGXXXXXXXXXXXXXXXXXXXGXXXXXXXXXXXXXXXXXXXGXXXXXXXXXXXXXXXXXXXGXXXXXXXXXXXXXXXXXXXGXXXXXXXXXXXXXXXXXXXGXXXXXXXXXXXXXXXXXXXGXXXXXXXXXXXXXXXXXXXGXXXXXXXXXXXXXXXXXXX,0,300,0
2121,13,0,13,99,188,0,0,200,33,167,GXXXXXXXXXXXXXXXXXXXGXXXXXXXXXXXXXXXXXXXGXXXXXXXXXXXXXXXXXXXGXXXXXXXXXXXXXXXXXXXGXXXXXXXXXXXXXXXXXXXGXXXXXXXXXXXXXXXXXXXGXXXXXXXXXXXXXXXXXXXGXXXXXXXXXXXXXXXXXXXGXXXXXXXXXXXXXXXXXXXGXXXXXXXXXXXXXXXXXXXGXXXXXXXXXXXXXXXXXXXGXXXXXXXXXXXXXXXXXXXGXXXXXXXXXXXXXXXXXXX,0,300,0
2142,13,0,13,101,186,0,0,197,34,163,GXXXXXXXXXXXXXXXXXXXGXXXXXXXXXXXXXXXXXXXGXXXXXXXXXXXXXXXXXXXGXXXXXXXXXXXXXXXXXXXGXXXXXXXXXXXXXXXXXXXGXXXXXXXXXXXXXXXXXXXGXXXXXXXXXXXXXXXXXXXGXXXXXXXXXXXXXXXXXXXGXXXXXXXXXXXXXXXXXXXGXXXXXXXXXXXXXXXXXXXGXXXXXXXXXXXXXXXXXXXGXXXXXXXXXXXXXXXXXXXGXXXXXXXXXXXXXXXXXXX,0,300,0
2163,13,0,13,99,188,0,0,200,34,166,GXXXXXXXXXXXXXXXXXXXGXXXXXXXXXXXXXXXXXXXGXXXXXXXXXXXXXXXXXXXGXXXXXXXXXXXXXXXXXXXGXXXXXXXXXXXXXXXXXXXGXXXXXXXXXXXXXXXXXXXGXXXXXXXXXXXXXXXXXXXGXXXXXXXXXXXXXXXXXXXGXXXXXXXXXXXXXXXXXXXGXXXXXXXXXXXXXXXXXXXGXXXXXXXXXXXXXXXXXXXGXXXXXXXXXXXXXXXXXXXGXXXXXXXXXXXXXXXXXXX,0,300,0
2184,13,0,13,99,188,0,0,200,36,164,GXXXXXXXXXXXXXXXXXXXGXXXXXXXXXXXXXXXXXXXGXXXXXXXXXXXXXXXXXXXGXXXXXXXXXXXXXXXXXXXGXXXXXXXXXXXXXXXXXXXGXXXXXXXXXXXXXXXXXXXGXXXXXXXXXXXXXXXXXXXGXXXXXXXXXXXXXXXXXXXGXXXXXXXXXXXXXXXXXXXGXXXXXXXXXXXXXXXXXXXGXXXXXXXXXXXXXXXXXXXGXXXXXXXXXXXXXXXXXXXGXXXXXXXXXXXXXXXXXXX,0,300,0

2205,13,0,13,96,191,0,0,203,42,161,GXXXXXXXXXXXXXXXXXXXGXXXXXXXXXXXXXXXXXXXGXXXXXXXXXXXXXXXXXXXGXXXXXXXXXXXXXXXXXXXGXXXXXXXXXXXXXXXXXXXGXXXXXXXXXXXXXXXXXXXGXXXXXXXXXXXXXXXXXXXGXXXXXXXXXXXXXXXXXXXGXXXXXXXXXXXXXXXXXXXGXXXXXXXXXXXXXXXXXXXGXXXXXXXXXXXXXXXXXXXGXXXXXXXXXXXXXXXXXXXGXXXXXXXXXXXXXXXXXXX,0,300,0
2226,13,0,13,92,195,0,0,207,35,172,GXXXXXXXXXXXXXXXXXXXGXXXXXXXXXXXXXXXXXXXGXXXXXXXXXXXXXXXXXXXGXXXXXXXXXXXXXXXXXXXGXXXXXXXXXXXXXXXXXXXGXXXXXXXXXXXXXXXXXXXGXXXXXXXXXXXXXXXXXXXGXXXXXXXXXXXXXXXXXXXGXXXXXXXXXXXXXXXXXXXGXXXXXXXXXXXXXXXXXXXGXXXXXXXXXXXXXXXXXXXGXXXXXXXXXXXXXXXXXXXGXXXXXXXXXXXXXXXXXXX,0,300,0
2247,13,0,13,92,195,0,0,208,36,172,GXXXXXXXXXXXXXXXXXXXGXXXXXXXXXXXXXXXXXXXGXXXXXXXXXXXXXXXXXXXGXXXXXXXXXXXXXXXXXXXGXXXXXXXXXXXXXXXXXXXGXXXXXXXXXXXXXXXXXXXGXXXXXXXXXXXXXXXXXXXGXXXXXXXXXXXXXXXXXXXGXXXXXXXXXXXXXXXXXXXGXXXXXXXXXXXXXXXXXXXGXXXXXXXXXXXXXXXXXXXGXXXXXXXXXXXXXXXXXXXGXXXXXXXXXXXXXXXXXXX,0,300,0
2268,13,0,13,85,202,0,0,214,43,171,GXXXXXXXXXXXXXXXXXXXGXXXXXXXXXXXXXXXXXXXGXXXXXXXXXXXXXXXXXXXGXXXXXXXXXXXXXXXXXXXGXXXXXXXXXXXXXXXXXXXGXXXXXXXXXXXXXXXXXXXGXXXXXXXXXXXXXXXXXXXGXXXXXXXXXXXXXXXXXXXGXXXXXXXXXXXXXXXXXXXGXXXXXXXXXXXXXXXXXXXGXXXXXXXXXXXXXXXXXXXGXXXXXXXXXXXXXXXXXXXGXXXXXXXXXXXXXXXXXXX,0,300,0
2289,13,0,13,89,198,0,0,210,43,167,GXXXXXXXXXXXXXXXXXXXGXXXXXXXXXXXXXXXXXXXGXXXXXXXXXXXXXXXXXXXGXXXXXXXXXXXXXXXXXXXGXXXXXXXXXXXXXXXXXXXGXXXXXXXXXXXXXXXXXXXGXXXXXXXXXXXXXXXXXXXGXXXXXXXXXXXXXXXXXXXGXXXXXXXXXXXXXXXXXXXGXXXXXXXXXXXXXXXXXXXGXXXXXXXXXXXXXXXXXXXGXXXXXXXXXXXXXXXXXXXGXXXXXXXXXXXXXXXXXXX,0,300,0

2310,13,0,13,84,203,0,0,215,44,171,GXXXXXXXXXXXXXXXXXXXGXXXXXXXXXXXXXXXXXXXGXXXXXXXXXXXXXXXXXXXGXXXXXXXXXXXXXXXXXXXGXXXXXXXXXXXXXXXXXXXGXXXXXXXXXXXXXXXXXXXGXXXXXXXXXXXXXXXXXXXGXXXXXXXXXXXXXXXXXXXGXXXXXXXXXXXXXXXXXXXGXXXXXXXXXXXXXXXXXXXGXXXXXXXXXXXXXXXXXXXGXXXXXXXXXXXXXXXXXXXGXXXXXXXXXXXXXXXXXXX,0,300,0
2331,13,0,13,88,199,0,0,211,43,168,GXXXXXXXXXXXXXXXXXXXGXXXXXXXXXXXXXXXXXXXGXXXXXXXXXXXXXXXXXXXGXXXXXXXXXXXXXXXXXXXGXXXXXXXXXXXXXXXXXXXGXXXXXXXXXXXXXXXXXXXGXXXXXXXXXXXXXXXXXXXGXXXXXXXXXXXXXXXXXXXGXXXXXXXXXXXXXXXXXXXGXXXXXXXXXXXXXXXXXXXGXXXXXXXXXXXXXXXXXXXGXXXXXXXXXXXXXXXXXXXGXXXXXXXXXXXXXXXXXXX,0,300,0
2352,13,0,13,96,191,0,0,203,43,160,GXXXXXXXXXXXXXXXXXXXGXXXXXXXXXXXXXXXXXXXGXXXXXXXXXXXXXXXXXXXGXXXXXXXXXXXXXXXXXXXGXXXXXXXXXXXXXXXXXXXGXXXXXXXXXXXXXXXXXXXGXXXXXXXXXXXXXXXXXXXGXXXXXXXXXXXXXXXXXXXGXXXXXXXXXXXXXXXXXXXGXXXXXXXXXXXXXXXXXXXGXXXXXXXXXXXXXXXXXXXGXXXXXXXXXXXXXXXXXXXGXXXXXXXXXXXXXXXXXXX,0,300,0
2373,13,0,13,91,196,0,0,208,40,168,GXXXXXXXXXXXXXXXXXXXGXXXXXXXXXXXXXXXXXXXGXXXXXXXXXXXXXXXXXXXGXXXXXXXXXXXXXXXXXXXGXXXXXXXXXXXXXXXXXXXGXXXXXXXXXXXXXXXXXXXGXXXXXXXXXXXXXXXXXXXGXXXXXXXXXXXXXXXXXXXGXXXXXXXXXXXXXXXXXXXGXXXXXXXXXXXXXXXXXXXGXXXXXXXXXXXXXXXXXXXGXXXXXXXXXXXXXXXXXXXGXXXXXXXXXXXXXXXXXXX,0,300,0
2394,13,0,13,95,192,0,0,204,33,171,GXXXXXXXXXXXXXXXXXXXGXXXXXXXXXXXXXXXXXXXGXXXXXXXXXXXXXXXXXXXGXXXXXXXXXXXXXXXXXXXGXXXXXXXXXXXXXXXXXXXGXXXXXXXXXXXXXXXXXXXGXXXXXXXXXXXXXXXXXXXGXXXXXXXXXXXXXXXXXXXGXXXXXXXXXXXXXXXXXXXGXXXXXXXXXXXXXXXXXXXGXXXXXXXXXXXXXXXXXXXGXXXXXXXXXXXXXXXXXXXGXXXXXXXXXXXXXXXXXXX,0,300,0

2415,13,0,13,90,197,0,0,209,37,172,GXXXXXXXXXXXXXXXXXXXGXXXXXXXXXXXXXXXXXXXGXXXXXXXXXXXXXXXXXXXGXXXXXXXXXXXXXXXXXXXGXXXXXXXXXXXXXXXXXXXGXXXXXXXXXXXXXXXXXXXGXXXXXXXXXXXXXXXXXXXGXXXXXXXXXXXXXXXXXXXGXXXXXXXXXXXXXXXXXXXGXXXXXXXXXXXXXXXXXXXGXXXXXXXXXXXXXXXXXXXGXXXXXXXXXXXXXXXXXXXGXXXXXXXXXXXXXXXXXXX,0,300,0
2436,13,0,13,87,200,0,0,212,37,175,GXXXXXXXXXXXXXXXXXXXGXXXXXXXXXXXXXXXXXXXGXXXXXXXXXXXXXXXXXXXGXXXXXXXXXXXXXXXXXXXGXXXXXXXXXXXXXXXXXXXGXXXXXXXXXXXXXXXXXXXGXXXXXXXXXXXXXXXXXXXGXXXXXXXXXXXXXXXXXXXGXXXXXXXXXXXXXXXXXXXGXXXXXXXXXXXXXXXXXXXGXXXXXXXXXXXXXXXXXXXGXXXXXXXXXXXXXXXXXXXGXXXXXXXXXXXXXXXXXXX,0,300,0
2457,13,0,13,95,192,0,0,204,36,168,GXXXXXXXXXXXXXXXXXXXGXXXXXXXXXXXXXXXXXXXGXXXXXXXXXXXXXXXXXXXGXXXXXXXXXXXXXXXXXXXGXXXXXXXXXXXXXXXXXXXGXXXXXXXXXXXXXXXXXXXGXXXXXXXXXXXXXXXXXXXGXXXXXXXXXXXXXXXXXXXGXXXXXXXXXXXXXXXXXXXGXXXXXXXXXXXXXXXXXXXGXXXXXXXXXXXXXXXXXXXGXXXXXXXXXXXXXXXXXXXGXXXXXXXXXXXXXXXXXXX,0,300,0
2478,13,0,13,94,193,0,0,205,34,171,GXXXXXXXXXXXXXXXXXXXGXXXXXXXXXXXXXXXXXXXGXXXXXXXXXXXXXXXXXXXGXXXXXXXXXXXXXXXXXXXGXXXXXXXXXXXXXXXXXXXGXXXXXXXXXXXXXXXXXXXGXXXXXXXXXXXXXXXXXXXGXXXXXXXXXXXXXXXXXXXGXXXXXXXXXXXXXXXXXXXGXXXXXXXXXXXXXXXXXXXGXXXXXXXXXXXXXXXXXXXGXXXXXXXXXXXXXXXXXXXGXXXXXXXXXXXXXXXXXXX,0,300,0
2499,13,0,13,96,191,0,0,203,40,163,GXXXXXXXXXXXXXXXXXXXGXXXXXXXXXXXXXXXXXXXGXXXXXXXXXXXXXXXXXXXGXXXXXXXXXXXXXXXXXXXGXXXXXXXXXXXXXXXXXXXGXXXXXXXXXXXXXXXXXXXGXXXXXXXXXXXXXXXXXXXGXXXXXXXXXXXXXXXXXXXGXXXXXXXXXXXXXXXXXXXGXXXXXXXXXXXXXXXXXXXGXXXXXXXXXXXXXXXXXXXGXXXXXXXXXXXXXXXXXXXGXXXXXXXXXXXXXXXXXXX,0,300,0

2520,13,0,13,97,190,0,0,203,43,160,GXXXXXXXXXXXXXXXXXXXGXXXXXXXXXXXXXXXXXXXGXXXXXXXXXXXXXXXXXXXGXXXXXXXXXXXXXXXXXXXGXXXXXXXXXXXXXXXXXXXGXXXXXXXXXXXXXXXXXXXGXXXXXXXXXXXXXXXXXXXGXXXXXXXXXXXXXXXXXXXGXXXXXXXXXXXXXXXXXXXGXXXXXXXXXXXXXXXXXXXGXXXXXXXXXXXXXXXXXXXGXXXXXXXXXXXXXXXXXXXGXXXXXXXXXXXXXXXXXXX,0,300,0
2541,13,0,13,95,192,0,0,205,46,159,GXXXXXXXXXXXXXXXXXXXGXXXXXXXXXXXXXXXXXXXGXXXXXXXXXXXXXXXXXXXGXXXXXXXXXXXXXXXXXXXGXXXXXXXXXXXXXXXXXXXGXXXXXXXXXXXXXXXXXXXGXXXXXXXXXXXXXXXXXXXGXXXXXXXXXXXXXXXXXXXGXXXXXXXXXXXXXXXXXXXGXXXXXXXXXXXXXXXXXXXGXXXXXXXXXXXXXXXXXXXGXXXXXXXXXXXXXXXXXXXGXXXXXXXXXXXXXXXXXXX,0,300,0
2562,13,0,13,96,191,0,0,204,46,158,GXXXXXXXXXXXXXXXXXXXGXXXXXXXXXXXXXXXXXXXGXXXXXXXXXXXXXXXXXXXGXXXXXXXXXXXXXXXXXXXGXXXXXXXXXXXXXXXXXXXGXXXXXXXXXXXXXXXXXXXGXXXXXXXXXXXXXXXXXXXGXXXXXXXXXXXXXXXXXXXGXXXXXXXXXXXXXXXXXXXGXXXXXXXXXXXXXXXXXXXGXXXXXXXXXXXXXXXXXXXGXXXXXXXXXXXXXXXXXXXGXXXXXXXXXXXXXXXXXXX,0,300,0
2583,13,0,13,98,189,0,0,201,43,158,GXXXXXXXXXXXXXXXXXXXGXXXXXXXXXXXXXXXXXXXGXXXXXXXXXXXXXXXXXXXGXXXXXXXXXXXXXXXXXXXGXXXXXXXXXXXXXXXXXXXGXXXXXXXXXXXXXXXXXXXGXXXXXXXXXXXXXXXXXXXGXXXXXXXXXXXXXXXXXXXGXXXXXXXXXXXXXXXXXXXGXXXXXXXXXXXXXXXXXXXGXXXXXXXXXXXXXXXXXXXGXXXXXXXXXXXXXXXXXXXGXXXXXXXXXXXXXXXXXXX,0,300,0
2604,13,0,13,94,193,0,0,203,43,160,GXXXXXXXXXXXXXXXXXXXGXXXXXXXXXXXXXXXXXXXGXXXXXXXXXXXXXXXXXXXGXXXXXXXXXXXXXXXXXXXGXXXXXXXXXXXXXXXXXXXGXXXXXXXXXXXXXXXXXXXGXXXXXXXXXXXXXXXXXXXGXXXXXXXXXXXXXXXXXXXGXXXXXXXXXXXXXXXXXXXGXXXXXXXXXXXXXXXXXXXGXXXXXXXXXXXXXXXXXXXGXXXXXXXXXXXXXXXXXXXGXXXXXXXXXXXXXXXXXXX,0,300,0

2625,13,0,13,95,192,0,0,204,43,161,GXXXXXXXXXXXXXXXXXXXGXXXXXXXXXXXXXXXXXXXGXXXXXXXXXXXXXXXXXXXGXXXXXXXXXXXXXXXXXXXGXXXXXXXXXXXXXXXXXXXGXXXXXXXXXXXXXXXXXXXGXXXXXXXXXXXXXXXXXXXGXXXXXXXXXXXXXXXXXXXGXXXXXXXXXXXXXXXXXXXGXXXXXXXXXXXXXXXXXXXGXXXXXXXXXXXXXXXXXXXGXXXXXXXXXXXXXXXXXXXGXXXXXXXXXXXXXXXXXXX,0,300,0
2646,14,1,13,100,186,0,0,198,37,161,GXXXXXXXXXXXXXXXXXXXGXXXXXXXXXXXXXXXXXXXGXXXXXXXXXXXXXXXXXXXGXXXXXXXXXXXXXXXXXXXGXXXXXXXXXXXXXXXXXXXGXXXXXXXXXXXXXXXXXXXGAXXXXXXXXXXXXXXXXXXGXXXXXXXXXXXXXXXXXXXGXXXXXXXXXXXXXXXXXXXGXXXXXXXXXXXXXXXXXXXGXXXXXXXXXXXXXXXXXXXGXXXXXXXXXXXXXXXXXXXGXXXXXXXXXXXXXXXXXXX,0,300,0
2667,14,1,13,92,194,0,0,205,40,165,GXXXXXXXXXXXXXXXXXXXGXXXXXXXXXXXXXXXXXXXGXXXXXXXXXXXXXXXXXXXGXXXXXXXXXXXXXXXXXXXGXXXXXXXXXXXXXXXXXXXGXXXXXXXXXXXXXXXXXXXGAXXXXXXXXXXXXXXXXXXGXXXXXXXXXXXXXXXXXXXGXXXXXXXXXXXXXXXXXXXGXXXXXXXXXXXXXXXXXXXGXXXXXXXXXXXXXXXXXXXGXXXXXXXXXXXXXXXXXXXGXXXXXXXXXXXXXXXXXXX,0,300,0
2688,14,1,13,87,199,0,0,211,42,169,GXXXXXXXXXXXXXXXXXXXGXXXXXXXXXXXXXXXXXXXGXXXXXXXXXXXXXXXXXXXGXXXXXXXXXXXXXXXXXXXGXXXXXXXXXXXXXXXXXXXGXXXXXXXXXXXXXXXXXXXGAXXXXXXXXXXXXXXXXXXGXXXXXXXXXXXXXXXXXXXGXXXXXXXXXXXXXXXXXXXGXXXXXXXXXXXXXXXXXXXGXXXXXXXXXXXXXXXXXXXGXXXXXXXXXXXXXXXXXXXGXXXXXXXXXXXXXXXXXXX,0,300,0
2709,14,1,13,90,196,0,0,208,41,167,GXXXXXXXXXXXXXXXXXXXGXXXXXXXXXXXXXXXXXXXGXXXXXXXXXXXXXXXXXXXGXXXXXXXXXXXXXXXXXXXGXXXXXXXXXXXXXXXXXXXGXXXXXXXXXXXXXXXXXXXGAXXXXXXXXXXXXXXXXXXGXXXXXXXXXXXXXXXXXXXGXXXXXXXXXXXXXXXXXXXGXXXXXXXXXXXXXXXXXXXGXXXXXXXXXXXXXXXXXXXGXXXXXXXXXXXXXXXXXXXGXXXXXXXXXXXXXXXXXXX,0,300,0

2730,14,1,13,92,194,0,0,205,48,157,GXXXXXXXXXXXXXXXXXXXGXXXXXXXXXXXXXXXXXXXGXXXXXXXXXXXXXXXXXXXGXXXXXXXXXXXXXXXXXXXGXXXXXXXXXXXXXXXXXXXGXXXXXXXXXXXXXXXXXXXGAXXXXXXXXXXXXXXXXXXGXXXXXXXXXXXXXXXXXXXGXXXXXXXXXXXXXXXXXXXGXXXXXXXXXXXXXXXXXXXGXXXXXXXXXXXXXXXXXXXGXXXXXXXXXXXXXXXXXXXGXXXXXXXXXXXXXXXXXXX,0,300,0
2751,14,1,13,97,189,0,0,200,44,156,GXXXXXXXXXXXXXXXXXXXGXXXXXXXXXXXXXXXXXXXGXXXXXXXXXXXXXXXXXXXGXXXXXXXXXXXXXXXXXXXGXXXXXXXXXXXXXXXXXXXGXXXXXXXXXXXXXXXXXXXGAXXXXXXXXXXXXXXXXXXGXXXXXXXXXXXXXXXXXXXGXXXXXXXXXXXXXXXXXXXGXXXXXXXXXXXXXXXXXXXGXXXXXXXXXXXXXXXXXXXGXXXXXXXXXXXXXXXXXXXGXXXXXXXXXXXXXXXXXXX,0,300,0
2772,14,1,13,94,192,0,0,203,47,156,GXXXXXXXXXXXXXXXXXXXGXXXXXXXXXXXXXXXXXXXGXXXXXXXXXXXXXXXXXXXGXXXXXXXXXXXXXXXXXXXGXXXXXXXXXXXXXXXXXXXGXXXXXXXXXXXXXXXXXXXGAXXXXXXXXXXXXXXXXXXGXXXXXXXXXXXXXXXXXXXGXXXXXXXXXXXXXXXXXXXGXXXXXXXXXXXXXXXXXXXGXXXXXXXXXXXXXXXXXXXGXXXXXXXXXXXXXXXXXXXGXXXXXXXXXXXXXXXXXXX,0,300,0
2793,14,1,13,98,188,0,0,199,52,147,GXXXXXXXXXXXXXXXXXXXGXXXXXXXXXXXXXXXXXXXGXXXXXXXXXXXXXXXXXXXGXXXXXXXXXXXXXXXXXXXGXXXXXXXXXXXXXXXXXXXGXXXXXXXXXXXXXXXXXXXGAXXXXXXXXXXXXXXXXXXGXXXXXXXXXXXXXXXXXXXGXXXXXXXXXXXXXXXXXXXGXXXXXXXXXXXXXXXXXXXGXXXXXXXXXXXXXXXXXXXGXXXXXXXXXXXXXXXXXXXGXXXXXXXXXXXXXXXXXXX,0,300,0
2814,14,1,13,100,186,0,0,198,52,146,GXXXXXXXXXXXXXXXXXXXGXXXXXXXXXXXXXXXXXXXGXXXXXXXXXXXXXXXXXXXGXXXXXXXXXXXXXXXXXXXGXXXXXXXXXXXXXXXXXXXGXXXXXXXXXXXXXXXXXXXGAXXXXXXXXXXXXXXXXXXGXXXXXXXXXXXXXXXXXXXGXXXXXXXXXXXXXXXXXXXGXXXXXXXXXXXXXXXXXXXGXXXXXXXXXXXXXXXXXXXGXXXXXXXXXXXXXXXXXXXGXXXXXXXXXXXXXXXXXXX,0,300,0

2835,14,1,13,102,184,0,0,195,51,144,GXXXXXXXXXXXXXXXXXXXGXXXXXXXXXXXXXXXXXXXGXXXXXXXXXXXXXXXXXXXGXXXXXXXXXXXXXXXXXXXGXXXXXXXXXXXXXXXXXXXGXXXXXXXXXXXXXXXXXXXGAXXXXXXXXXXXXXXXXXXGXXXXXXXXXXXXXXXXXXXGXXXXXXXXXXXXXXXXXXXGXXXXXXXXXXXXXXXXXXXGXXXXXXXXXXXXXXXXXXXGXXXXXXXXXXXXXXXXXXXGXXXXXXXXXXXXXXXXXXX,0,300,0
2856,13,0,13,108,179,0,0,190,51,139,GXXXXXXXXXXXXXXXXXXXGXXXXXXXXXXXXXXXXXXXGXXXXXXXXXXXXXXXXXXXGXXXXXXXXXXXXXXXXXXXGXXXXXXXXXXXXXXXXXXXGXXXXXXXXXXXXXXXXXXXGXXXXXXXXXXXXXXXXXXXGXXXXXXXXXXXXXXXXXXXGXXXXXXXXXXXXXXXXXXXGXXXXXXXXXXXXXXXXXXXGXXXXXXXXXXXXXXXXXXXGXXXXXXXXXXXXXXXXXXXGXXXXXXXXXXXXXXXXXXX,0,300,0
2877,13,0,13,114,173,0,0,184,42,142,GXXXXXXXXXXXXXXXXXXXGXXXXXXXXXXXXXXXXXXXGXXXXXXXXXXXXXXXXXXXGXXXXXXXXXXXXXXXXXXXGXXXXXXXXXXXXXXXXXXXGXXXXXXXXXXXXXXXXXXXGXXXXXXXXXXXXXXXXXXXGXXXXXXXXXXXXXXXXXXXGXXXXXXXXXXXXXXXXXXXGXXXXXXXXXXXXXXXXXXXGXXXXXXXXXXXXXXXXXXXGXXXXXXXXXXXXXXXXXXXGXXXXXXXXXXXXXXXXXXX,0,300,0
2898,13,0,13,109,178,0,0,189,45,144,GXXXXXXXXXXXXXXXXXXXGXXXXXXXXXXXXXXXXXXXGXXXXXXXXXXXXXXXXXXXGXXXXXXXXXXXXXXXXXXXGXXXXXXXXXXXXXXXXXXXGXXXXXXXXXXXXXXXXXXXGXXXXXXXXXXXXXXXXXXXGXXXXXXXXXXXXXXXXXXXGXXXXXXXXXXXXXXXXXXXGXXXXXXXXXXXXXXXXXXXGXXXXXXXXXXXXXXXXXXXGXXXXXXXXXXXXXXXXXXXGXXXXXXXXXXXXXXXXXXX,0,300,0
2919,13,0,13,110,177,0,0,188,39,149,GXXXXXXXXXXXXXXXXXXXGXXXXXXXXXXXXXXXXXXXGXXXXXXXXXXXXXXXXXXXGXXXXXXXXXXXXXXXXXXXGXXXXXXXXXXXXXXXXXXXGXXXXXXXXXXXXXXXXXXXGXXXXXXXXXXXXXXXXXXXGXXXXXXXXXXXXXXXXXXXGXXXXXXXXXXXXXXXXXXXGXXXXXXXXXXXXXXXXXXXGXXXXXXXXXXXXXXXXXXXGXXXXXXXXXXXXXXXXXXXGXXXXXXXXXXXXXXXXXXX,0,300,0

2940,14,1,13,104,182,0,0,194,35,159,GXXXXXXXXXXXXXXXXXXXGXXXXXXXXXXXXXXXXXXXGXXXXXXXXXXXXXXXXXXXGAXXXXXXXXXXXXXXXXXXGXXXXXXXXXXXXXXXXXXXGXXXXXXXXXXXXXXXXXXXGXXXXXXXXXXXXXXXXXXXGXXXXXXXXXXXXXXXXXXXGXXXXXXXXXXXXXXXXXXXGXXXXXXXXXXXXXXXXXXXGXXXXXXXXXXXXXXXXXXXGXXXXXXXXXXXXXXXXXXXGXXXXXXXXXXXXXXXXXXX,0,300,0
2961,14,1,13,99,187,0,0,198,39,159,GXXXXXXXXXXXXXXXXXXXGXXXXXXXXXXXXXXXXXXXGXXXXXXXXXXXXXXXXXXXGAXXXXXXXXXXXXXXXXXXGXXXXXXXXXXXXXXXXXXXGXXXXXXXXXXXXXXXXXXXGXXXXXXXXXXXXXXXXXXXGXXXXXXXXXXXXXXXXXXXGXXXXXXXXXXXXXXXXXXXGXXXXXXXXXXXXXXXXXXXGXXXXXXXXXXXXXXXXXXXGXXXXXXXXXXXXXXXXXXXGXXXXXXXXXXXXXXXXXXX,0,300,0
2982,14,1,13,97,189,0,0,201,42,159,GXXXXXXXXXXXXXXXXXXXGXXXXXXXXXXXXXXXXXXXGXXXXXXXXXXXXXXXXXXXGAXXXXXXXXXXXXXXXXXXGXXXXXXXXXXXXXXXXXXXGXXXXXXXXXXXXXXXXXXXGXXXXXXXXXXXXXXXXXXXGXXXXXXXXXXXXXXXXXXXGXXXXXXXXXXXXXXXXXXXGXXXXXXXXXXXXXXXXXXXGXXXXXXXXXXXXXXXXXXXGXXXXXXXXXXXXXXXXXXXGXXXXXXXXXXXXXXXXXXX,0,300,0
3003,14,1,13,97,189,0,0,198,43,155,GXXXXXXXXXXXXXXXXXXXGXXXXXXXXXXXXXXXXXXXGXXXXXXXXXXXXXXXXXXXGAXXXXXXXXXXXXXXXXXXGXXXXXXXXXXXXXXXXXXXGXXXXXXXXXXXXXXXXXXXGXXXXXXXXXXXXXXXXXXXGXXXXXXXXXXXXXXXXXXXGXXXXXXXXXXXXXXXXXXXGXXXXXXXXXXXXXXXXXXXGXXXXXXXXXXXXXXXXXXXGXXXXXXXXXXXXXXXXXXXGXXXXXXXXXXXXXXXXXXX,0,300,0
3024,14,1,13,97,189,0,0,200,42,158,GXXXXXXXXXXXXXXXXXXXGXXXXXXXXXXXXXXXXXXXGXXXXXXXXXXXXXXXXXXXGAXXXXXXXXXXXXXXXXXXGXXXXXXXXXXXXXXXXXXXGXXXXXXXXXXXXXXXXXXXGXXXXXXXXXXXXXXXXXXXGXXXXXXXXXXXXXXXXXXXGXXXXXXXXXXXXXXXXXXXGXXXXXXXXXXXXXXXXXXXGXXXXXXXXXXXXXXXXXXXGXXXXXXXXXXXXXXXXXXXGXXXXXXXXXXXXXXXXXXX,0,300,0

3045,14,1,13,96,190,0,0,202,39,163,GXXXXXXXXXXXXXXXXXXXGXXXXXXXXXXXXXXXXXXXGXXXXXXXXXXXXXXXXXXXGAXXXXXXXXXXXXXXXXXXGXXXXXXXXXXXXXXXXXXXGXXXXXXXXXXXXXXXXXXXGXXXXXXXXXXXXXXXXXXXGXXXXXXXXXXXXXXXXXXXGXXXXXXXXXXXXXXXXXXXGXXXXXXXXXXXXXXXXXXXGXXXXXXXXXXXXXXXXXXXGXXXXXXXXXXXXXXXXXXXGXXXXXXXXXXXXXXXXXXX,0,300,0
3066,14,1,13,87,199,0,0,210,45,165,GXXXXXXXXXXXXXXXXXXXGXXXXXXXXXXXXXXXXXXXGXXXXXXXXXXXXXXXXXXXGAXXXXXXXXXXXXXXXXXXGXXXXXXXXXXXXXXXXXXXGXXXXXXXXXXXXXXXXXXXGXXXXXXXXXXXXXXXXXXXGXXXXXXXXXXXXXXXXXXXGXXXXXXXXXXXXXXXXXXXGXXXXXXXXXXXXXXXXXXXGXXXXXXXXXXXXXXXXXXXGXXXXXXXXXXXXXXXXXXXGXXXXXXXXXXXXXXXXXXX,0,300,0
3087,14,1,13,88,198,0,0,211,39,172,GXXXXXXXXXXXXXXXXXXXGXXXXXXXXXXXXXXXXXXXGXXXXXXXXXXXXXXXXXXXGAXXXXXXXXXXXXXXXXXXGXXXXXXXXXXXXXXXXXXXGXXXXXXXXXXXXXXXXXXXGXXXXXXXXXXXXXXXXXXXGXXXXXXXXXXXXXXXXXXXGXXXXXXXXXXXXXXXXXXXGXXXXXXXXXXXXXXXXXXXGXXXXXXXXXXXXXXXXXXXGXXXXXXXXXXXXXXXXXXXGXXXXXXXXXXXXXXXXXXX,0,300,0
3108,14,1,13,90,196,0,0,209,46,163,GXXXXXXXXXXXXXXXXXXXGXXXXXXXXXXXXXXXXXXXGXXXXXXXXXXXXXXXXXXXGAXXXXXXXXXXXXXXXXXXGXXXXXXXXXXXXXXXXXXXGXXXXXXXXXXXXXXXXXXXGXXXXXXXXXXXXXXXXXXXGXXXXXXXXXXXXXXXXXXXGXXXXXXXXXXXXXXXXXXXGXXXXXXXXXXXXXXXXXXXGXXXXXXXXXXXXXXXXXXXGXXXXXXXXXXXXXXXXXXXGXXXXXXXXXXXXXXXXXXX,0,300,0
3129,14,1,13,83,203,0,0,216,51,165,GXXXXXXXXXXXXXXXXXXXGXXXXXXXXXXXXXXXXXXXGXXXXXXXXXXXXXXXXXXXGAXXXXXXXXXXXXXXXXXXGXXXXXXXXXXXXXXXXXXXGXXXXXXXXXXXXXXXXXXXGXXXXXXXXXXXXXXXXXXXGXXXXXXXXXXXXXXXXXXXGXXXXXXXXXXXXXXXXXXXGXXXXXXXXXXXXXXXXXXXGXXXXXXXXXXXXXXXXXXXGXXXXXXXXXXXXXXXXXXXGXXXXXXXXXXXXXXXXXXX,0,300,0

3150,14,1,13,92,194,0,0,208,42,166,GXXXXXXXXXXXXXXXXXXXGXXXXXXXXXXXXXXXXXXXGXXXXXXXXXXXXXXXXXXXGAXXXXXXXXXXXXXXXXXXGXXXXXXXXXXXXXXXXXXXGXXXXXXXXXXXXXXXXXXXGXXXXXXXXXXXXXXXXXXXGXXXXXXXXXXXXXXXXXXXGXXXXXXXXXXXXXXXXXXXGXXXXXXXXXXXXXXXXXXXGXXXXXXXXXXXXXXXXXXXGXXXXXXXXXXXXXXXXXXXGXXXXXXXXXXXXXXXXXXX,0,300,0
3171,14,1,13,90,196,0,0,209,47,162,GXXXXXXXXXXXXXXXXXXXGXXXXXXXXXXXXXXXXXXXGXXXXXXXXXXXXXXXXXXXGAXXXXXXXXXXXXXXXXXXGXXXXXXXXXXXXXXXXXXXGXXXXXXXXXXXXXXXXXXXGXXXXXXXXXXXXXXXXXXXGXXXXXXXXXXXXXXXXXXXGXXXXXXXXXXXXXXXXXXXGXXXXXXXXXXXXXXXXXXXGXXXXXXXXXXXXXXXXXXXGXXXXXXXXXXXXXXXXXXXGXXXXXXXXXXXXXXXXXXX,0,300,0
3192,14,1,13,91,195,0,0,207,47,160,GXXXXXXXXXXXXXXXXXXXGXXXXXXXXXXXXXXXXXXXGXXXXXXXXXXXXXXXXXXXGAXXXXXXXXXXXXXXXXXXGXXXXXXXXXXXXXXXXXXXGXXXXXXXXXXXXXXXXXXXGXXXXXXXXXXXXXXXXXXXGXXXXXXXXXXXXXXXXXXXGXXXXXXXXXXXXXXXXXXXGXXXXXXXXXXXXXXXXXXXGXXXXXXXXXXXXXXXXXXXGXXXXXXXXXXXXXXXXXXXGXXXXXXXXXXXXXXXXXXX,0,300,0
3213,14,1,13,93,193,0,0,206,41,165,GXXXXXXXXXXXXXXXXXXXGXXXXXXXXXXXXXXXXXXXGXXXXXXXXXXXXXXXXXXXGAXXXXXXXXXXXXXXXXXXGXXXXXXXXXXXXXXXXXXXGXXXXXXXXXXXXXXXXXXXGXXXXXXXXXXXXXXXXXXXGXXXXXXXXXXXXXXXXXXXGXXXXXXXXXXXXXXXXXXXGXXXXXXXXXXXXXXXXXXXGXXXXXXXXXXXXXXXXXXXGXXXXXXXXXXXXXXXXXXXGXXXXXXXXXXXXXXXXXXX,0,300,0
3234,14,1,13,97,189,0,0,202,40,162,GXXXXXXXXXXXXXXXXXXXGXXXXXXXXXXXXXXXXXXXGXXXXXXXXXXXXXXXXXXXGAXXXXXXXXXXXXXXXXXXGXXXXXXXXXXXXXXXXXXXGXXXXXXXXXXXXXXXXXXXGXXXXXXXXXXXXXXXXXXXGXXXXXXXXXXXXXXXXXXXGXXXXXXXXXXXXXXXXXXXGXXXXXXXXXXXXXXXXXXXGXXXXXXXXXXXXXXXXXXXGXXXXXXXXXXXXXXXXXXXGXXXXXXXXXXXXXXXXXXX,0,300,0

3255,13,0,13,90,197,0,0,210,43,167,GXXXXXXXXXXXXXXXXXXXGXXXXXXXXXXXXXXXXXXXGXXXXXXXXXXXXXXXXXXXGXXXXXXXXXXXXXXXXXXXGXXXXXXXXXXXXXXXXXXXGXXXXXXXXXXXXXXXXXXXGXXXXXXXXXXXXXXXXXXXGXXXXXXXXXXXXXXXXXXXGXXXXXXXXXXXXXXXXXXXGXXXXXXXXXXXXXXXXXXXGXXXXXXXXXXXXXXXXXXXGXXXXXXXXXXXXXXXXXXXGXXXXXXXXXXXXXXXXXXX,0,300,0
3276,13,0,13,85,202,0,0,216,48,168,GXXXXXXXXXXXXXXXXXXXGXXXXXXXXXXXXXXXXXXXGXXXXXXXXXXXXXXXXXXXGXXXXXXXXXXXXXXXXXXXGXXXXXXXXXXXXXXXXXXXGXXXXXXXXXXXXXXXXXXXGXXXXXXXXXXXXXXXXXXXGXXXXXXXXXXXXXXXXXXXGXXXXXXXXXXXXXXXXXXXGXXXXXXXXXXXXXXXXXXXGXXXXXXXXXXXXXXXXXXXGXXXXXXXXXXXXXXXXXXXGXXXXXXXXXXXXXXXXXXX,0,300,0
3297,13,0,13,79,208,0,0,222,58,164,GXXXXXXXXXXXXXXXXXXXGXXXXXXXXXXXXXXXXXXXGXXXXXXXXXXXXXXXXXXXGXXXXXXXXXXXXXXXXXXXGXXXXXXXXXXXXXXXXXXXGXXXXXXXXXXXXXXXXXXXGXXXXXXXXXXXXXXXXXXXGXXXXXXXXXXXXXXXXXXXGXXXXXXXXXXXXXXXXXXXGXXXXXXXXXXXXXXXXXXXGXXXXXXXXXXXXXXXXXXXGXXXXXXXXXXXXXXXXXXXGXXXXXXXXXXXXXXXXXXX,0,300,0
3318,13,0,13,81,206,0,0,220,55,165,GXXXXXXXXXXXXXXXXXXXGXXXXXXXXXXXXXXXXXXXGXXXXXXXXXXXXXXXXXXXGXXXXXXXXXXXXXXXXXXXGXXXXXXXXXXXXXXXXXXXGXXXXXXXXXXXXXXXXXXXGXXXXXXXXXXXXXXXXXXXGXXXXXXXXXXXXXXXXXXXGXXXXXXXXXXXXXXXXXXXGXXXXXXXXXXXXXXXXXXXGXXXXXXXXXXXXXXXXXXXGXXXXXXXXXXXXXXXXXXXGXXXXXXXXXXXXXXXXXXX,0,300,0
3339,13,0,13,81,206,0,0,220,52,168,GXXXXXXXXXXXXXXXXXXXGXXXXXXXXXXXXXXXXXXXGXXXXXXXXXXXXXXXXXXXGXXXXXXXXXXXXXXXXXXXGXXXXXXXXXXXXXXXXXXXGXXXXXXXXXXXXXXXXXXXGXXXXXXXXXXXXXXXXXXXGXXXXXXXXXXXXXXXXXXXGXXXXXXXXXXXXXXXXXXXGXXXXXXXXXXXXXXXXXXXGXXXXXXXXXXXXXXXXXXXGXXXXXXXXXXXXXXXXXXXGXXXXXXXXXXXXXXXXXXX,0,300,0

3360,13,0,13,81,206,0,0,220,49,171,GXXXXXXXXXXXXXXXXXXXGXXXXXXXXXXXXXXXXXXXGXXXXXXXXXXXXXXXXXXXGXXXXXXXXXXXXXXXXXXXGXXXXXXXXXXXXXXXXXXXGXXXXXXXXXXXXXXXXXXXGXXXXXXXXXXXXXXXXXXXGXXXXXXXXXXXXXXXXXXXGXXXXXXXXXXXXXXXXXXXGXXXXXXXXXXXXXXXXXXXGXXXXXXXXXXXXXXXXXXXGXXXXXXXXXXXXXXXXXXXGXXXXXXXXXXXXXXXXXXX,0,300,0
3381,13,0,13,83,204,0,0,218,47,171,GXXXXXXXXXXXXXXXXXXXGXXXXXXXXXXXXXXXXXXXGXXXXXXXXXXXXXXXXXXXGXXXXXXXXXXXXXXXXXXXGXXXXXXXXXXXXXXXXXXXGXXXXXXXXXXXXXXXXXXXGXXXXXXXXXXXXXXXXXXXGXXXXXXXXXXXXXXXXXXXGXXXXXXXXXXXXXXXXXXXGXXXXXXXXXXXXXXXXXXXGXXXXXXXXXXXXXXXXXXXGXXXXXXXXXXXXXXXXXXXGXXXXXXXXXXXXXXXXXXX,0,300,0
3402,13,0,13,87,200,0,0,214,50,164,GXXXXXXXXXXXXXXXXXXXGXXXXXXXXXXXXXXXXXXXGXXXXXXXXXXXXXXXXXXXGXXXXXXXXXXXXXXXXXXXGXXXXXXXXXXXXXXXXXXXGXXXXXXXXXXXXXXXXXXXGXXXXXXXXXXXXXXXXXXXGXXXXXXXXXXXXXXXXXXXGXXXXXXXXXXXXXXXXXXXGXXXXXXXXXXXXXXXXXXXGXXXXXXXXXXXXXXXXXXXGXXXXXXXXXXXXXXXXXXXGXXXXXXXXXXXXXXXXXXX,0,300,0
3423,13,0,13,88,199,0,0,214,50,164,GXXXXXXXXXXXXXXXXXXXGXXXXXXXXXXXXXXXXXXXGXXXXXXXXXXXXXXXXXXXGXXXXXXXXXXXXXXXXXXXGXXXXXXXXXXXXXXXXXXXGXXXXXXXXXXXXXXXXXXXGXXXXXXXXXXXXXXXXXXXGXXXXXXXXXXXXXXXXXXXGXXXXXXXXXXXXXXXXXXXGXXXXXXXXXXXXXXXXXXXGXXXXXXXXXXXXXXXXXXXGXXXXXXXXXXXXXXXXXXXGXXXXXXXXXXXXXXXXXXX,0,300,0
3444,13,0,13,87,200,0,0,214,51,163,GXXXXXXXXXXXXXXXXXXXGXXXXXXXXXXXXXXXXXXXGXXXXXXXXXXXXXXXXXXXGXXXXXXXXXXXXXXXXXXXGXXXXXXXXXXXXXXXXXXXGXXXXXXXXXXXXXXXXXXXGXXXXXXXXXXXXXXXXXXXGXXXXXXXXXXXXXXXXXXXGXXXXXXXXXXXXXXXXXXXGXXXXXXXXXXXXXXXXXXXGXXXXXXXXXXXXXXXXXXXGXXXXXXXXXXXXXXXXXXXGXXXXXXXXXXXXXXXXXXX,0,300,0

3465,14,1,13,86,200,0,0,214,53,161,GXXXXXXXXXXXXXXXXXXXGXXXXXXXXXXXXXXXXXXXGXXXXXXXXXXXXXXXXXXXGXXXXXXXXXXXXXXXXXXXGXXXXXXXXXXXXXXXXXXXGXXXXXXXXXXXXXXXXXXXGXXXXXXXXXXXXXXXXXXXGXXXXXXXXXXXXXXXXXXXGXXXXXXXXXXXXXXXXXXXGAXXXXXXXXXXXXXXXXXXGXXXXXXXXXXXXXXXXXXXGXXXXXXXXXXXXXXXXXXXGXXXXXXXXXXXXXXXXXXX,0,300,0
3486,14,1,13,88,198,0,0,212,56,156,GXXXXXXXXXXXXXXXXXXXGXXXXXXXXXXXXXXXXXXXGXXXXXXXXXXXXXXXXXXXGXXXXXXXXXXXXXXXXXXXGXXXXXXXXXXXXXXXXXXXGXXXXXXXXXXXXXXXXXXXGXXXXXXXXXXXXXXXXXXXGXXXXXXXXXXXXXXXXXXXGXXXXXXXXXXXXXXXXXXXGAXXXXXXXXXXXXXXXXXXGXXXXXXXXXXXXXXXXXXXGXXXXXXXXXXXXXXXXXXXGXXXXXXXXXXXXXXXXXXX,0,300,0
3507,14,1,13,93,193,0,0,207,63,144,GXXXXXXXXXXXXXXXXXXXGXXXXXXXXXXXXXXXXXXXGXXXXXXXXXXXXXXXXXXXGXXXXXXXXXXXXXXXXXXXGXXXXXXXXXXXXXXXXXXXGXXXXXXXXXXXXXXXXXXXGXXXXXXXXXXXXXXXXXXXGXXXXXXXXXXXXXXXXXXXGXXXXXXXXXXXXXXXXXXXGAXXXXXXXXXXXXXXXXXXGXXXXXXXXXXXXXXXXXXXGXXXXXXXXXXXXXXXXXXXGXXXXXXXXXXXXXXXXXXX,0,300,0
3528,14,1,13,101,185,0,0,199,52,147,GXXXXXXXXXXXXXXXXXXXGXXXXXXXXXXXXXXXXXXXGXXXXXXXXXXXXXXXXXXXGXXXXXXXXXXXXXXXXXXXGXXXXXXXXXXXXXXXXXXXGXXXXXXXXXXXXXXXXXXXGXXXXXXXXXXXXXXXXXXXGXXXXXXXXXXXXXXXXXXXGXXXXXXXXXXXXXXXXXXXGAXXXXXXXXXXXXXXXXXXGXXXXXXXXXXXXXXXXXXXGXXXXXXXXXXXXXXXXXXXGXXXXXXXXXXXXXXXXXXX,0,300,0
3549,15,2,13,99,186,0,0,201,50,151,GXXXXXXXXXXXXXXXXXXXGXXXXXXXXXXXXXXXXXXXGAXXXXXXXXXXXXXXXXXXGXXXXXXXXXXXXXXXXXXXGXXXXXXXXXXXXXXXXXXXGXXXXXXXXXXXXXXXXXXXGXXXXXXXXXXXXXXXXXXXGXXXXXXXXXXXXXXXXXXXGXXXXXXXXXXXXXXXXXXXGAXXXXXXXXXXXXXXXXXXGXXXXXXXXXXXXXXXXXXXGXXXXXXXXXXXXXXXXXXXGXXXXXXXXXXXXXXXXXXX,0,300,0

3570,15,2,13,102,183,0,0,197,50,147,GXXXXXXXXXXXXXXXXXXXGXXXXXXXXXXXXXXXXXXXGAXXXXXXXXXXXXXXXXXXGXXXXXXXXXXXXXXXXXXXGXXXXXXXXXXXXXXXXXXXGXXXXXXXXXXXXXXXXXXXGXXXXXXXXXXXXXXXXXXXGXXXXXXXXXXXXXXXXXXXGXXXXXXXXXXXXXXXXXXXGAXXXXXXXXXXXXXXXXXXGXXXXXXXXXXXXXXXXXXXGXXXXXXXXXXXXXXXXXXXGXXXXXXXXXXXXXXXXXXX,0,300,0
3591,15,2,13,96,189,0,0,202,57,145,GXXXXXXXXXXXXXXXXXXXGXXXXXXXXXXXXXXXXXXXGAXXXXXXXXXXXXXXXXXXGXXXXXXXXXXXXXXXXXXXGXXXXXXXXXXXXXXXXXXXGXXXXXXXXXXXXXXXXXXXGXXXXXXXXXXXXXXXXXXXGXXXXXXXXXXXXXXXXXXXGXXXXXXXXXXXXXXXXXXXGAXXXXXXXXXXXXXXXXXXGXXXXXXXXXXXXXXXXXXXGXXXXXXXXXXXXXXXXXXXGXXXXXXXXXXXXXXXXXXX,0,300,0
3612,15,2,13,101,184,0,0,196,52,144,GXXXXXXXXXXXXXXXXXXXGXXXXXXXXXXXXXXXXXXXGAXXXXXXXXXXXXXXXXXXGXXXXXXXXXXXXXXXXXXXGXXXXXXXXXXXXXXXXXXXGXXXXXXXXXXXXXXXXXXXGXXXXXXXXXXXXXXXXXXXGXXXXXXXXXXXXXXXXXXXGXXXXXXXXXXXXXXXXXXXGAXXXXXXXXXXXXXXXXXXGXXXXXXXXXXXXXXXXXXXGXXXXXXXXXXXXXXXXXXXGXXXXXXXXXXXXXXXXXXX,0,300,0
3633,15,2,13,107,178,0,0,190,46,144,GXXXXXXXXXXXXXXXXXXXGXXXXXXXXXXXXXXXXXXXGAXXXXXXXXXXXXXXXXXXGXXXXXXXXXXXXXXXXXXXGXXXXXXXXXXXXXXXXXXXGXXXXXXXXXXXXXXXXXXXGXXXXXXXXXXXXXXXXXXXGXXXXXXXXXXXXXXXXXXXGXXXXXXXXXXXXXXXXXXXGAXXXXXXXXXXXXXXXXXXGXXXXXXXXXXXXXXXXXXXGXXXXXXXXXXXXXXXXXXXGXXXXXXXXXXXXXXXXXXX,0,300,0
3654,15,2,13,108,177,0,0,189,49,140,GXXXXXXXXXXXXXXXXXXXGXXXXXXXXXXXXXXXXXXXGAXXXXXXXXXXXXXXXXXXGXXXXXXXXXXXXXXXXXXXGXXXXXXXXXXXXXXXXXXXGXXXXXXXXXXXXXXXXXXXGXXXXXXXXXXXXXXXXXXXGXXXXXXXXXXXXXXXXXXXGXXXXXXXXXXXXXXXXXXXGAXXXXXXXXXXXXXXXXXXGXXXXXXXXXXXXXXXXXXXGXXXXXXXXXXXXXXXXXXXGXXXXXXXXXXXXXXXXXXX,0,300,0

3675,15,2,13,109,176,0,0,189,51,138,GXXXXXXXXXXXXXXXXXXXGXXXXXXXXXXXXXXXXXXXGAXXXXXXXXXXXXXXXXXXGXXXXXXXXXXXXXXXXXXXGXXXXXXXXXXXXXXXXXXXGXXXXXXXXXXXXXXXXXXXGXXXXXXXXXXXXXXXXXXXGXXXXXXXXXXXXXXXXXXXGXXXXXXXXXXXXXXXXXXXGAXXXXXXXXXXXXXXXXXXGXXXXXXXXXXXXXXXXXXXGXXXXXXXXXXXXXXXXXXXGXXXXXXXXXXXXXXXXXXX,0,300,0
3696,15,1,14,109,176,0,0,189,55,134,GXXXXXXXXXXXXXXXXXXXGXXXXXXXXXXXXXXXXXXXGAXXXXXXXXXXXXXXXXXXGXXXXXXXXXXXXXXXXXXXGXXXXXXXXXXXXXXXXXXXGXXXXXXXXXXXXXXXXXXXGXXXXXXXXXXXXXXXXXXXGXXXXXXXXXXXXXXXXXXXGXXXXXXXXXXXXXXXXXXXGOXXXXXXXXXXXXXXXXXXGXXXXXXXXXXXXXXXXXXXGXXXXXXXXXXXXXXXXXXXGXXXXXXXXXXXXXXXXXXX,0,300,0
3717,14,1,13,108,178,0,0,191,50,141,GXXXXXXXXXXXXXXXXXXXGXXXXXXXXXXXXXXXXXXXGAXXXXXXXXXXXXXXXXXXGXXXXXXXXXXXXXXXXXXXGXXXXXXXXXXXXXXXXXXXGXXXXXXXXXXXXXXXXXXXGXXXXXXXXXXXXXXXXXXXGXXXXXXXXXXXXXXXXXXXGXXXXXXXXXXXXXXXXXXXGXXXXXXXXXXXXXXXXXXXGXXXXXXXXXXXXXXXXXXXGXXXXXXXXXXXXXXXXXXXGXXXXXXXXXXXXXXXXXXX,0,300,0
3738,15,2,13,104,181,0,0,194,49,145,GXXXXXXXXXXXXXXXXXXXGXXXXXXXXXXXXXXXXXXXGAXXXXXXXXXXXXXXXXXXGXXXXXXXXXXXXXXXXXXXGXXXXXXXXXXXXXXXXXXXGXXXXXXXXXXXXXXXXXXXGXXXXXXXXXXXXXXXXXXXGXXXXXXXXXXXXXXXXXXXGXXXXXXXXXXXXXXXXXXXGXXXXXXXXXXXXXXXXXXXGXXXXXXXXXXXXXXXXXXXGXXXXXXXXXXXXXXXXXXXGAXXXXXXXXXXXXXXXXXX,0,300,0
3759,15,2,13,104,181,0,0,192,48,144,GXXXXXXXXXXXXXXXXXXXGXXXXXXXXXXXXXXXXXXXGAXXXXXXXXXXXXXXXXXXGXXXXXXXXXXXXXXXXXXXGXXXXXXXXXXXXXXXXXXXGXXXXXXXXXXXXXXXXXXXGXXXXXXXXXXXXXXXXXXXGXXXXXXXXXXXXXXXXXXXGXXXXXXXXXXXXXXXXXXXGXXXXXXXXXXXXXXXXXXXGXXXXXXXXXXXXXXXXXXXGXXXXXXXXXXXXXXXXXXXGAXXXXXXXXXXXXXXXXXX,0,300,0

3780,15,2,13,109,176,0,0,189,42,147,GXXXXXXXXXXXXXXXXXXXGXXXXXXXXXXXXXXXXXXXGAXXXXXXXXXXXXXXXXXXGXXXXXXXXXXXXXXXXXXXGXXXXXXXXXXXXXXXXXXXGXXXXXXXXXXXXXXXXXXXGXXXXXXXXXXXXXXXXXXXGXXXXXXXXXXXXXXXXXXXGXXXXXXXXXXXXXXXXXXXGXXXXXXXXXXXXXXXXXXXGXXXXXXXXXXXXXXXXXXXGXXXXXXXXXXXXXXXXXXXGAXXXXXXXXXXXXXXXXXX,0,300,0
3801,15,2,13,101,184,0,0,198,46,152,GXXXXXXXXXXXXXXXXXXXGXXXXXXXXXXXXXXXXXXXGAXXXXXXXXXXXXXXXXXXGXXXXXXXXXXXXXXXXXXXGXXXXXXXXXXXXXXXXXXXGXXXXXXXXXXXXXXXXXXXGXXXXXXXXXXXXXXXXXXXGXXXXXXXXXXXXXXXXXXXGXXXXXXXXXXXXXXXXXXXGXXXXXXXXXXXXXXXXXXXGXXXXXXXXXXXXXXXXXXXGXXXXXXXXXXXXXXXXXXXGAXXXXXXXXXXXXXXXXXX,0,300,0
3822,15,2,13,100,185,0,0,199,44,155,GXXXXXXXXXXXXXXXXXXXGXXXXXXXXXXXXXXXXXXXGAXXXXXXXXXXXXXXXXXXGXXXXXXXXXXXXXXXXXXXGXXXXXXXXXXXXXXXXXXXGXXXXXXXXXXXXXXXXXXXGXXXXXXXXXXXXXXXXXXXGXXXXXXXXXXXXXXXXXXXGXXXXXXXXXXXXXXXXXXXGXXXXXXXXXXXXXXXXXXXGXXXXXXXXXXXXXXXXXXXGXXXXXXXXXXXXXXXXXXXGAXXXXXXXXXXXXXXXXXX,0,300,0
3843,15,2,13,99,186,0,0,199,45,154,GXXXXXXXXXXXXXXXXXXXGXXXXXXXXXXXXXXXXXXXGAXXXXXXXXXXXXXXXXXXGXXXXXXXXXXXXXXXXXXXGXXXXXXXXXXXXXXXXXXXGXXXXXXXXXXXXXXXXXXXGXXXXXXXXXXXXXXXXXXXGXXXXXXXXXXXXXXXXXXXGXXXXXXXXXXXXXXXXXXXGXXXXXXXXXXXXXXXXXXXGXXXXXXXXXXXXXXXXXXXGXXXXXXXXXXXXXXXXXXXGAXXXXXXXXXXXXXXXXXX,0,300,0
3864,15,2,13,98,187,0,0,201,46,155,GXXXXXXXXXXXXXXXXXXXGXXXXXXXXXXXXXXXXXXXGAXXXXXXXXXXXXXXXXXXGXXXXXXXXXXXXXXXXXXXGXXXXXXXXXXXXXXXXXXXGXXXXXXXXXXXXXXXXXXXGXXXXXXXXXXXXXXXXXXXGXXXXXXXXXXXXXXXXXXXGXXXXXXXXXXXXXXXXXXXGXXXXXXXXXXXXXXXXXXXGXXXXXXXXXXXXXXXXXXXGXXXXXXXXXXXXXXXXXXXGAXXXXXXXXXXXXXXXXXX,0,300,0

3885,15,1,14,96,189,0,0,202,42,160,GXXXXXXXXXXXXXXXXXXXGXXXXXXXXXXXXXXXXXXXGOXXXXXXXXXXXXXXXXXXGXXXXXXXXXXXXXXXXXXXGXXXXXXXXXXXXXXXXXXXGXXXXXXXXXXXXXXXXXXXGXXXXXXXXXXXXXXXXXXXGXXXXXXXXXXXXXXXXXXXGXXXXXXXXXXXXXXXXXXXGXXXXXXXXXXXXXXXXXXXGXXXXXXXXXXXXXXXXXXXGXXXXXXXXXXXXXXXXXXXGAXXXXXXXXXXXXXXXXXX,0,300,0
3906,14,1,13,89,197,0,0,209,44,165,GXXXXXXXXXXXXXXXXXXXGXXXXXXXXXXXXXXXXXXXGXXXXXXXXXXXXXXXXXXXGXXXXXXXXXXXXXXXXXXXGXXXXXXXXXXXXXXXXXXXGXXXXXXXXXXXXXXXXXXXGXXXXXXXXXXXXXXXXXXXGXXXXXXXXXXXXXXXXXXXGXXXXXXXXXXXXXXXXXXXGXXXXXXXXXXXXXXXXXXXGXXXXXXXXXXXXXXXXXXXGXXXXXXXXXXXXXXXXXXXGAXXXXXXXXXXXXXXXXXX,0,300,0
3927,14,0,14,92,194,0,0,206,44,162,GXXXXXXXXXXXXXXXXXXXGXXXXXXXXXXXXXXXXXXXGXXXXXXXXXXXXXXXXXXXGXXXXXXXXXXXXXXXXXXXGXXXXXXXXXXXXXXXXXXXGXXXXXXXXXXXXXXXXXXXGXXXXXXXXXXXXXXXXXXXGXXXXXXXXXXXXXXXXXXXGXXXXXXXXXXXXXXXXXXXGXXXXXXXXXXXXXXXXXXXGXXXXXXXXXXXXXXXXXXXGXXXXXXXXXXXXXXXXXXXGOXXXXXXXXXXXXXXXXXX,0,300,0
3948,14,0,14,87,199,0,0,211,49,162,GXXXXXXXXXXXXXXXXXXXGXXXXXXXXXXXXXXXXXXXGXXXXXXXXXXXXXXXXXXXGXXXXXXXXXXXXXXXXXXXGXXXXXXXXXXXXXXXXXXXGXXXXXXXXXXXXXXXXXXXGXXXXXXXXXXXXXXXXXXXGXXXXXXXXXXXXXXXXXXXGXXXXXXXXXXXXXXXXXXXGXXXXXXXXXXXXXXXXXXXGXXXXXXXXXXXXXXXXXXXGXXXXXXXXXXXXXXXXXXXGOXXXXXXXXXXXXXXXXXX,0,300,0
3969,13,0,13,80,207,0,0,219,55,164,GXXXXXXXXXXXXXXXXXXXGXXXXXXXXXXXXXXXXXXXGXXXXXXXXXXXXXXXXXXXGXXXXXXXXXXXXXXXXXXXGXXXXXXXXXXXXXXXXXXXGXXXXXXXXXXXXXXXXXXXGXXXXXXXXXXXXXXXXXXXGXXXXXXXXXXXXXXXXXXXGXXXXXXXXXXXXXXXXXXXGXXXXXXXXXXXXXXXXXXXGXXXXXXXXXXXXXXXXXXXGXXXXXXXXXXXXXXXXXXXGXXXXXXXXXXXXXXXXXXX,0,300,0

3990,13,0,13,82,205,0,0,217,48,169,GXXXXXXXXXXXXXXXXXXXGXXXXXXXXXXXXXXXXXXXGXXXXXXXXXXXXXXXXXXXGXXXXXXXXXXXXXXXXXXXGXXXXXXXXXXXXXXXXXXXGXXXXXXXXXXXXXXXXXXXGXXXXXXXXXXXXXXXXXXXGXXXXXXXXXXXXXXXXXXXGXXXXXXXXXXXXXXXXXXXGXXXXXXXXXXXXXXXXXXXGXXXXXXXXXXXXXXXXXXXGXXXXXXXXXXXXXXXXXXXGXXXXXXXXXXXXXXXXXXX,0,300,0
4011,13,0,13,88,199,0,0,211,44,167,GXXXXXXXXXXXXXXXXXXXGXXXXXXXXXXXXXXXXXXXGXXXXXXXXXXXXXXXXXXXGXXXXXXXXXXXXXXXXXXXGXXXXXXXXXXXXXXXXXXXGXXXXXXXXXXXXXXXXXXXGXXXXXXXXXXXXXXXXXXXGXXXXXXXXXXXXXXXXXXXGXXXXXXXXXXXXXXXXXXXGXXXXXXXXXXXXXXXXXXXGXXXXXXXXXXXXXXXXXXXGXXXXXXXXXXXXXXXXXXXGXXXXXXXXXXXXXXXXXXX,0,300,0
4032,13,0,13,88,199,0,0,211,51,160,GXXXXXXXXXXXXXXXXXXXGXXXXXXXXXXXXXXXXXXXGXXXXXXXXXXXXXXXXXXXGXXXXXXXXXXXXXXXXXXXGXXXXXXXXXXXXXXXXXXXGXXXXXXXXXXXXXXXXXXXGXXXXXXXXXXXXXXXXXXXGXXXXXXXXXXXXXXXXXXXGXXXXXXXXXXXXXXXXXXXGXXXXXXXXXXXXXXXXXXXGXXXXXXXXXXXXXXXXXXXGXXXXXXXXXXXXXXXXXXXGXXXXXXXXXXXXXXXXXXX,0,300,0
4053,13,0,13,90,197,0,0,209,52,157,GXXXXXXXXXXXXXXXXXXXGXXXXXXXXXXXXXXXXXXXGXXXXXXXXXXXXXXXXXXXGXXXXXXXXXXXXXXXXXXXGXXXXXXXXXXXXXXXXXXXGXXXXXXXXXXXXXXXXXXXGXXXXXXXXXXXXXXXXXXXGXXXXXXXXXXXXXXXXXXXGXXXXXXXXXXXXXXXXXXXGXXXXXXXXXXXXXXXXXXXGXXXXXXXXXXXXXXXXXXXGXXXXXXXXXXXXXXXXXXXGXXXXXXXXXXXXXXXXXXX,0,300,0
4074,13,0,13,97,190,0,0,202,43,159,GXXXXXXXXXXXXXXXXXXXGXXXXXXXXXXXXXXXXXXXGXXXXXXXXXXXXXXXXXXXGXXXXXXXXXXXXXXXXXXXGXXXXXXXXXXXXXXXXXXXGXXXXXXXXXXXXXXXXXXXGXXXXXXXXXXXXXXXXXXXGXXXXXXXXXXXXXXXXXXXGXXXXXXXXXXXXXXXXXXXGXXXXXXXXXXXXXXXXXXXGXXXXXXXXXXXXXXXXXXXGXXXXXXXXXXXXXXXXXXXGXXXXXXXXXXXXXXXXXXX,0,300,0

4095,13,0,13,96,191,0,0,203,40,163,GXXXXXXXXXXXXXXXXXXXGXXXXXXXXXXXXXXXXXXXGXXXXXXXXXXXXXXXXXXXGXXXXXXXXXXXXXXXXXXXGXXXXXXXXXXXXXXXXXXXGXXXXXXXXXXXXXXXXXXXGXXXXXXXXXXXXXXXXXXXGXXXXXXXXXXXXXXXXXXXGXXXXXXXXXXXXXXXXXXXGXXXXXXXXXXXXXXXXXXXGXXXXXXXXXXXXXXXXXXXGXXXXXXXXXXXXXXXXXXXGXXXXXXXXXXXXXXXXXXX,0,300,0
4116,14,1,13,92,194,0,0,205,51,154,GXXXXXXXXXXXXXXXXXXXGXXXXXXXXXXXXXXXXXXXGXXXXXXXXXXXXXXXXXXXGXXXXXXXXXXXXXXXXXXXGXXXXXXXXXXXXXXXXXXXGXXXXXXXXXXXXXXXXXXXGXXXXXXXXXXXXXXXXXXXGXXXXXXXXXXXXXXXXXXXGXXXXXXXXXXXXXXXXXXXGAXXXXXXXXXXXXXXXXXXGXXXXXXXXXXXXXXXXXXXGXXXXXXXXXXXXXXXXXXXGXXXXXXXXXXXXXXXXXXX,0,300,0
4137,14,1,13,90,196,0,0,208,54,154,GXXXXXXXXXXXXXXXXXXXGXXXXXXXXXXXXXXXXXXXGXXXXXXXXXXXXXXXXXXXGXXXXXXXXXXXXXXXXXXXGXXXXXXXXXXXXXXXXXXXGXXXXXXXXXXXXXXXXXXXGXXXXXXXXXXXXXXXXXXXGXXXXXXXXXXXXXXXXXXXGXXXXXXXXXXXXXXXXXXXGAXXXXXXXXXXXXXXXXXXGXXXXXXXXXXXXXXXXXXXGXXXXXXXXXXXXXXXXXXXGXXXXXXXXXXXXXXXXXXX,0,300,0
4158,14,1,13,89,197,0,0,209,50,159,GXXXXXXXXXXXXXXXXXXXGXXXXXXXXXXXXXXXXXXXGXXXXXXXXXXXXXXXXXXXGXXXXXXXXXXXXXXXXXXXGXXXXXXXXXXXXXXXXXXXGXXXXXXXXXXXXXXXXXXXGXXXXXXXXXXXXXXXXXXXGXXXXXXXXXXXXXXXXXXXGXXXXXXXXXXXXXXXXXXXGAXXXXXXXXXXXXXXXXXXGXXXXXXXXXXXXXXXXXXXGXXXXXXXXXXXXXXXXXXXGXXXXXXXXXXXXXXXXXXX,0,300,0
4179,14,1,13,88,198,0,0,209,51,158,GXXXXXXXXXXXXXXXXXXXGXXXXXXXXXXXXXXXXXXXGXXXXXXXXXXXXXXXXXXXGXXXXXXXXXXXXXXXXXXXGXXXXXXXXXXXXXXXXXXXGXXXXXXXXXXXXXXXXXXXGXXXXXXXXXXXXXXXXXXXGXXXXXXXXXXXXXXXXXXXGXXXXXXXXXXXXXXXXXXXGAXXXXXXXXXXXXXXXXXXGXXXXXXXXXXXXXXXXXXXGXXXXXXXXXXXXXXXXXXXGXXXXXXXXXXXXXXXXXXX,0,300,0

4200,14,1,13,91,195,0,0,207,50,157,GXXXXXXXXXXXXXXXXXXXGXXXXXXXXXXXXXXXXXXXGXXXXXXXXXXXXXXXXXXXGXXXXXXXXXXXXXXXXXXXGXXXXXXXXXXXXXXXXXXXGXXXXXXXXXXXXXXXXXXXGXXXXXXXXXXXXXXXXXXXGXXXXXXXXXXXXXXXXXXXGXXXXXXXXXXXXXXXXXXXGAXXXXXXXXXXXXXXXXXXGXXXXXXXXXXXXXXXXXXXGXXXXXXXXXXXXXXXXXXXGXXXXXXXXXXXXXXXXXXX,0,300,0
4221,14,1,13,82,204,0,0,215,60,155,GXXXXXXXXXXXXXXXXXXXGXXXXXXXXXXXXXXXXXXXGXXXXXXXXXXXXXXXXXXXGXXXXXXXXXXXXXXXXXXXGXXXXXXXXXXXXXXXXXXXGXXXXXXXXXXXXXXXXXXXGXXXXXXXXXXXXXXXXXXXGXXXXXXXXXXXXXXXXXXXGXXXXXXXXXXXXXXXXXXXGAXXXXXXXXXXXXXXXXXXGXXXXXXXXXXXXXXXXXXXGXXXXXXXXXXXXXXXXXXXGXXXXXXXXXXXXXXXXXXX,0,300,0
4242,14,0,14,88,198,0,0,210,54,156,GXXXXXXXXXXXXXXXXXXXGXXXXXXXXXXXXXXXXXXXGXXXXXXXXXXXXXXXXXXXGXXXXXXXXXXXXXXXXXXXGXXXXXXXXXXXXXXXXXXXGXXXXXXXXXXXXXXXXXXXGXXXXXXXXXXXXXXXXXXXGXXXXXXXXXXXXXXXXXXXGXXXXXXXXXXXXXXXXXXXGOXXXXXXXXXXXXXXXXXXGXXXXXXXXXXXXXXXXXXXGXXXXXXXXXXXXXXXXXXXGXXXXXXXXXXXXXXXXXXX,0,300,0
4263,13,0,13,83,204,0,0,214,59,155,GXXXXXXXXXXXXXXXXXXXGXXXXXXXXXXXXXXXXXXXGXXXXXXXXXXXXXXXXXXXGXXXXXXXXXXXXXXXXXXXGXXXXXXXXXXXXXXXXXXXGXXXXXXXXXXXXXXXXXXXGXXXXXXXXXXXXXXXXXXXGXXXXXXXXXXXXXXXXXXXGXXXXXXXXXXXXXXXXXXXGXXXXXXXXXXXXXXXXXXXGXXXXXXXXXXXXXXXXXXXGXXXXXXXXXXXXXXXXXXXGXXXXXXXXXXXXXXXXXXX,0,300,0
4284,13,0,13,77,210,0,0,222,61,161,GXXXXXXXXXXXXXXXXXXXGXXXXXXXXXXXXXXXXXXXGXXXXXXXXXXXXXXXXXXXGXXXXXXXXXXXXXXXXXXXGXXXXXXXXXXXXXXXXXXXGXXXXXXXXXXXXXXXXXXXGXXXXXXXXXXXXXXXXXXXGXXXXXXXXXXXXXXXXXXXGXXXXXXXXXXXXXXXXXXXGXXXXXXXXXXXXXXXXXXXGXXXXXXXXXXXXXXXXXXXGXXXXXXXXXXXXXXXXXXXGXXXXXXXXXXXXXXXXXXX,0,300,0

4305,14,1,13,85,201,0,0,212,51,161,GXXXXXXXXXXXXXXXXXXXGXXXXXXXXXXXXXXXXXXXGAXXXXXXXXXXXXXXXXXXGXXXXXXXXXXXXXXXXXXXGXXXXXXXXXXXXXXXXXXXGXXXXXXXXXXXXXXXXXXXGXXXXXXXXXXXXXXXXXXXGXXXXXXXXXXXXXXXXXXXGXXXXXXXXXXXXXXXXXXXGXXXXXXXXXXXXXXXXXXXGXXXXXXXXXXXXXXXXXXXGXXXXXXXXXXXXXXXXXXXGXXXXXXXXXXXXXXXXXXX,0,300,0
4326,14,1,13,87,199,0,0,211,50,161,GXXXXXXXXXXXXXXXXXXXGXXXXXXXXXXXXXXXXXXXGAXXXXXXXXXXXXXXXXXXGXXXXXXXXXXXXXXXXXXXGXXXXXXXXXXXXXXXXXXXGXXXXXXXXXXXXXXXXXXXGXXXXXXXXXXXXXXXXXXXGXXXXXXXXXXXXXXXXXXXGXXXXXXXXXXXXXXXXXXXGXXXXXXXXXXXXXXXXXXXGXXXXXXXXXXXXXXXXXXXGXXXXXXXXXXXXXXXXXXXGXXXXXXXXXXXXXXXXXXX,0,300,0
4347,15,2,13,86,199,0,0,212,51,161,GXXXXXXXXXXXXXXXXXXXGXXXXXXXXXXXXXXXXXXXGAXXXXXXXXXXXXXXXXXXGXXXXXXXXXXXXXXXXXXXGXXXXXXXXXXXXXXXXXXXGXXXXXXXXXXXXXXXXXXXGXXXXXXXXXXXXXXXXXXXGXXXXXXXXXXXXXXXXXXXGAXXXXXXXXXXXXXXXXXXGXXXXXXXXXXXXXXXXXXXGXXXXXXXXXXXXXXXXXXXGXXXXXXXXXXXXXXXXXXXGXXXXXXXXXXXXXXXXXXX,0,300,0
4368,15,2,13,86,199,0,0,212,50,162,GXXXXXXXXXXXXXXXXXXXGXXXXXXXXXXXXXXXXXXXGAXXXXXXXXXXXXXXXXXXGXXXXXXXXXXXXXXXXXXXGXXXXXXXXXXXXXXXXXXXGXXXXXXXXXXXXXXXXXXXGXXXXXXXXXXXXXXXXXXXGXXXXXXXXXXXXXXXXXXXGAXXXXXXXXXXXXXXXXXXGXXXXXXXXXXXXXXXXXXXGXXXXXXXXXXXXXXXXXXXGXXXXXXXXXXXXXXXXXXXGXXXXXXXXXXXXXXXXXXX,0,300,0
4389,15,2,13,88,197,0,0,209,51,158,GXXXXXXXXXXXXXXXXXXXGXXXXXXXXXXXXXXXXXXXGAXXXXXXXXXXXXXXXXXXGXXXXXXXXXXXXXXXXXXXGXXXXXXXXXXXXXXXXXXXGXXXXXXXXXXXXXXXXXXXGXXXXXXXXXXXXXXXXXXXGXXXXXXXXXXXXXXXXXXXGAXXXXXXXXXXXXXXXXXXGXXXXXXXXXXXXXXXXXXXGXXXXXXXXXXXXXXXXXXXGXXXXXXXXXXXXXXXXXXXGXXXXXXXXXXXXXXXXXXX,0,300,0

4410,15,2,13,87,198,0,0,211,51,160,GXXXXXXXXXXXXXXXXXXXGXXXXXXXXXXXXXXXXXXXGAXXXXXXXXXXXXXXXXXXGXXXXXXXXXXXXXXXXXXXGXXXXXXXXXXXXXXXXXXXGXXXXXXXXXXXXXXXXXXXGXXXXXXXXXXXXXXXXXXXGXXXXXXXXXXXXXXXXXXXGAXXXXXXXXXXXXXXXXXXGXXXXXXXXXXXXXXXXXXXGXXXXXXXXXXXXXXXXXXXGXXXXXXXXXXXXXXXXXXXGXXXXXXXXXXXXXXXXXXX,0,300,0
4431,15,2,13,87,198,0,0,211,62,149,GXXXXXXXXXXXXXXXXXXXGXXXXXXXXXXXXXXXXXXXGAXXXXXXXXXXXXXXXXXXGXXXXXXXXXXXXXXXXXXXGXXXXXXXXXXXXXXXXXXXGXXXXXXXXXXXXXXXXXXXGXXXXXXXXXXXXXXXXXXXGXXXXXXXXXXXXXXXXXXXGAXXXXXXXXXXXXXXXXXXGXXXXXXXXXXXXXXXXXXXGXXXXXXXXXXXXXXXXXXXGXXXXXXXXXXXXXXXXXXXGXXXXXXXXXXXXXXXXXXX,0,300,0
4452,16,3,13,87,197,0,0,210,62,148,GXXXXXXXXXXXXXXXXXXXGXXXXXXXXXXXXXXXXXXXGAXXXXXXXXXXXXXXXXXXGXXXXXXXXXXXXXXXXXXXGXXXXXXXXXXXXXXXXXXXGXXXXXXXXXXXXXXXXXXXGXXXXXXXXXXXXXXXXXXXGXXXXXXXXXXXXXXXXXXXGAXXXXXXXXXXXXXXXXXXGXXXXXXXXXXXXXXXXXXXGXXXXXXXXXXXXXXXXXXXGXXXXXXXXXXXXXXXXXXXGAXXXXXXXXXXXXXXXXXX,0,300,0
4473,16,3,13,85,199,0,0,211,60,151,GXXXXXXXXXXXXXXXXXXXGXXXXXXXXXXXXXXXXXXXGAXXXXXXXXXXXXXXXXXXGXXXXXXXXXXXXXXXXXXXGXXXXXXXXXXXXXXXXXXXGXXXXXXXXXXXXXXXXXXXGXXXXXXXXXXXXXXXXXXXGXXXXXXXXXXXXXXXXXXXGAXXXXXXXXXXXXXXXXXXGXXXXXXXXXXXXXXXXXXXGXXXXXXXXXXXXXXXXXXXGXXXXXXXXXXXXXXXXXXXGAXXXXXXXXXXXXXXXXXX,0,300,0
4494,16,2,14,86,198,0,0,212,59,153,GXXXXXXXXXXXXXXXXXXXGXXXXXXXXXXXXXXXXXXXGAXXXXXXXXXXXXXXXXXXGXXXXXXXXXXXXXXXXXXXGXXXXXXXXXXXXXXXXXXXGXXXXXXXXXXXXXXXXXXXGXXXXXXXXXXXXXXXXXXXGXXXXXXXXXXXXXXXXXXXGOXXXXXXXXXXXXXXXXXXGXXXXXXXXXXXXXXXXXXXGXXXXXXXXXXXXXXXXXXXGXXXXXXXXXXXXXXXXXXXGAXXXXXXXXXXXXXXXXXX,0,300,0

4515,15,2,13,86,199,0,0,213,56,157,GXXXXXXXXXXXXXXXXXXXGXXXXXXXXXXXXXXXXXXXGAXXXXXXXXXXXXXXXXXXGXXXXXXXXXXXXXXXXXXXGXXXXXXXXXXXXXXXXXXXGXXXXXXXXXXXXXXXXXXXGXXXXXXXXXXXXXXXXXXXGXXXXXXXXXXXXXXXXXXXGXXXXXXXXXXXXXXXXXXXGXXXXXXXXXXXXXXXXXXXGXXXXXXXXXXXXXXXXXXXGXXXXXXXXXXXXXXXXXXXGAXXXXXXXXXXXXXXXXXX,0,300,0
4536,15,2,13,90,195,0,0,209,53,156,GXXXXXXXXXXXXXXXXXXXGXXXXXXXXXXXXXXXXXXXGAXXXXXXXXXXXXXXXXXXGXXXXXXXXXXXXXXXXXXXGXXXXXXXXXXXXXXXXXXXGXXXXXXXXXXXXXXXXXXXGXXXXXXXXXXXXXXXXXXXGXXXXXXXXXXXXXXXXXXXGXXXXXXXXXXXXXXXXXXXGXXXXXXXXXXXXXXXXXXXGXXXXXXXXXXXXXXXXXXXGXXXXXXXXXXXXXXXXXXXGAXXXXXXXXXXXXXXXXXX,0,300,0
4557,14,1,13,91,195,0,0,209,56,153,GXXXXXXXXXXXXXXXXXXXGXXXXXXXXXXXXXXXXXXXGAXXXXXXXXXXXXXXXXXXGXXXXXXXXXXXXXXXXXXXGXXXXXXXXXXXXXXXXXXXGXXXXXXXXXXXXXXXXXXXGXXXXXXXXXXXXXXXXXXXGXXXXXXXXXXXXXXXXXXXGXXXXXXXXXXXXXXXXXXXGXXXXXXXXXXXXXXXXXXXGXXXXXXXXXXXXXXXXXXXGXXXXXXXXXXXXXXXXXXXGXXXXXXXXXXXXXXXXXXX,0,300,0
4578,14,1,13,84,202,0,0,215,59,156,GXXXXXXXXXXXXXXXXXXXGXXXXXXXXXXXXXXXXXXXGAXXXXXXXXXXXXXXXXXXGXXXXXXXXXXXXXXXXXXXGXXXXXXXXXXXXXXXXXXXGXXXXXXXXXXXXXXXXXXXGXXXXXXXXXXXXXXXXXXXGXXXXXXXXXXXXXXXXXXXGXXXXXXXXXXXXXXXXXXXGXXXXXXXXXXXXXXXXXXXGXXXXXXXXXXXXXXXXXXXGXXXXXXXXXXXXXXXXXXXGXXXXXXXXXXXXXXXXXXX,0,300,0
4599,14,1,13,84,202,0,0,215,59,156,GXXXXXXXXXXXXXXXXXXXGXXXXXXXXXXXXXXXXXXXGAXXXXXXXXXXXXXXXXXXGXXXXXXXXXXXXXXXXXXXGXXXXXXXXXXXXXXXXXXXGXXXXXXXXXXXXXXXXXXXGXXXXXXXXXXXXXXXXXXXGXXXXXXXXXXXXXXXXXXXGXXXXXXXXXXXXXXXXXXXGXXXXXXXXXXXXXXXXXXXGXXXXXXXXXXXXXXXXXXXGXXXXXXXXXXXXXXXXXXXGXXXXXXXXXXXXXXXXXXX,0,300,0

4620,13,0,13,85,202,0,0,215,65,150,GXXXXXXXXXXXXXXXXXXXGXXXXXXXXXXXXXXXXXXXGXXXXXXXXXXXXXXXXXXXGXXXXXXXXXXXXXXXXXXXGXXXXXXXXXXXXXXXXXXXGXXXXXXXXXXXXXXXXXXXGXXXXXXXXXXXXXXXXXXXGXXXXXXXXXXXXXXXXXXXGXXXXXXXXXXXXXXXXXXXGXXXXXXXXXXXXXXXXXXXGXXXXXXXXXXXXXXXXXXXGXXXXXXXXXXXXXXXXXXXGXXXXXXXXXXXXXXXXXXX,0,300,0
4641,13,0,13,89,198,0,0,211,67,144,GXXXXXXXXXXXXXXXXXXXGXXXXXXXXXXXXXXXXXXXGXXXXXXXXXXXXXXXXXXXGXXXXXXXXXXXXXXXXXXXGXXXXXXXXXXXXXXXXXXXGXXXXXXXXXXXXXXXXXXXGXXXXXXXXXXXXXXXXXXXGXXXXXXXXXXXXXXXXXXXGXXXXXXXXXXXXXXXXXXXGXXXXXXXXXXXXXXXXXXXGXXXXXXXXXXXXXXXXXXXGXXXXXXXXXXXXXXXXXXXGXXXXXXXXXXXXXXXXXXX,0,300,0
4662,13,0,13,95,192,0,0,205,59,146,GXXXXXXXXXXXXXXXXXXXGXXXXXXXXXXXXXXXXXXXGXXXXXXXXXXXXXXXXXXXGXXXXXXXXXXXXXXXXXXXGXXXXXXXXXXXXXXXXXXXGXXXXXXXXXXXXXXXXXXXGXXXXXXXXXXXXXXXXXXXGXXXXXXXXXXXXXXXXXXXGXXXXXXXXXXXXXXXXXXXGXXXXXXXXXXXXXXXXXXXGXXXXXXXXXXXXXXXXXXXGXXXXXXXXXXXXXXXXXXXGXXXXXXXXXXXXXXXXXXX,0,300,0
4683,13,0,13,95,192,0,0,205,59,146,GXXXXXXXXXXXXXXXXXXXGXXXXXXXXXXXXXXXXXXXGXXXXXXXXXXXXXXXXXXXGXXXXXXXXXXXXXXXXXXXGXXXXXXXXXXXXXXXXXXXGXXXXXXXXXXXXXXXXXXXGXXXXXXXXXXXXXXXXXXXGXXXXXXXXXXXXXXXXXXXGXXXXXXXXXXXXXXXXXXXGXXXXXXXXXXXXXXXXXXXGXXXXXXXXXXXXXXXXXXXGXXXXXXXXXXXXXXXXXXXGXXXXXXXXXXXXXXXXXXX,0,300,0
4704,13,0,13,98,189,0,0,202,58,144,GXXXXXXXXXXXXXXXXXXXGXXXXXXXXXXXXXXXXXXXGXXXXXXXXXXXXXXXXXXXGXXXXXXXXXXXXXXXXXXXGXXXXXXXXXXXXXXXXXXXGXXXXXXXXXXXXXXXXXXXGXXXXXXXXXXXXXXXXXXXGXXXXXXXXXXXXXXXXXXXGXXXXXXXXXXXXXXXXXXXGXXXXXXXXXXXXXXXXXXXGXXXXXXXXXXXXXXXXXXXGXXXXXXXXXXXXXXXXXXXGXXXXXXXXXXXXXXXXXXX,0,300,0

4725,13,0,13,91,196,0,0,209,58,151,GXXXXXXXXXXXXXXXXXXXGXXXXXXXXXXXXXXXXXXXGXXXXXXXXXXXXXXXXXXXGXXXXXXXXXXXXXXXXXXXGXXXXXXXXXXXXXXXXXXXGXXXXXXXXXXXXXXXXXXXGXXXXXXXXXXXXXXXXXXXGXXXXXXXXXXXXXXXXXXXGXXXXXXXXXXXXXXXXXXXGXXXXXXXXXXXXXXXXXXXGXXXXXXXXXXXXXXXXXXXGXXXXXXXXXXXXXXXXXXXGXXXXXXXXXXXXXXXXXXX,0,300,0
4746,13,0,13,85,202,0,0,214,56,158,GXXXXXXXXXXXXXXXXXXXGXXXXXXXXXXXXXXXXXXXGXXXXXXXXXXXXXXXXXXXGXXXXXXXXXXXXXXXXXXXGXXXXXXXXXXXXXXXXXXXGXXXXXXXXXXXXXXXXXXXGXXXXXXXXXXXXXXXXXXXGXXXXXXXXXXXXXXXXXXXGXXXXXXXXXXXXXXXXXXXGXXXXXXXXXXXXXXXXXXXGXXXXXXXXXXXXXXXXXXXGXXXXXXXXXXXXXXXXXXXGXXXXXXXXXXXXXXXXXXX,0,300,0
4767,13,0,13,82,205,0,0,217,64,153,GXXXXXXXXXXXXXXXXXXXGXXXXXXXXXXXXXXXXXXXGXXXXXXXXXXXXXXXXXXXGXXXXXXXXXXXXXXXXXXXGXXXXXXXXXXXXXXXXXXXGXXXXXXXXXXXXXXXXXXXGXXXXXXXXXXXXXXXXXXXGXXXXXXXXXXXXXXXXXXXGXXXXXXXXXXXXXXXXXXXGXXXXXXXXXXXXXXXXXXXGXXXXXXXXXXXXXXXXXXXGXXXXXXXXXXXXXXXXXXXGXXXXXXXXXXXXXXXXXXX,0,300,0
4788,13,0,13,83,204,0,0,216,57,159,GXXXXXXXXXXXXXXXXXXXGXXXXXXXXXXXXXXXXXXXGXXXXXXXXXXXXXXXXXXXGXXXXXXXXXXXXXXXXXXXGXXXXXXXXXXXXXXXXXXXGXXXXXXXXXXXXXXXXXXXGXXXXXXXXXXXXXXXXXXXGXXXXXXXXXXXXXXXXXXXGXXXXXXXXXXXXXXXXXXXGXXXXXXXXXXXXXXXXXXXGXXXXXXXXXXXXXXXXXXXGXXXXXXXXXXXXXXXXXXXGXXXXXXXXXXXXXXXXXXX,0,300,0
4809,13,0,13,87,200,0,0,211,55,156,GXXXXXXXXXXXXXXXXXXXGXXXXXXXXXXXXXXXXXXXGXXXXXXXXXXXXXXXXXXXGXXXXXXXXXXXXXXXXXXXGXXXXXXXXXXXXXXXXXXXGXXXXXXXXXXXXXXXXXXXGXXXXXXXXXXXXXXXXXXXGXXXXXXXXXXXXXXXXXXXGXXXXXXXXXXXXXXXXXXXGXXXXXXXXXXXXXXXXXXXGXXXXXXXXXXXXXXXXXXXGXXXXXXXXXXXXXXXXXXXGXXXXXXXXXXXXXXXXXXX,0,300,0

4830,13,0,13,87,200,0,0,212,57,155,GXXXXXXXXXXXXXXXXXXXGXXXXXXXXXXXXXXXXXXXGXXXXXXXXXXXXXXXXXXXGXXXXXXXXXXXXXXXXXXXGXXXXXXXXXXXXXXXXXXXGXXXXXXXXXXXXXXXXXXXGXXXXXXXXXXXXXXXXXXXGXXXXXXXXXXXXXXXXXXXGXXXXXXXXXXXXXXXXXXXGXXXXXXXXXXXXXXXXXXXGXXXXXXXXXXXXXXXXXXXGXXXXXXXXXXXXXXXXXXXGXXXXXXXXXXXXXXXXXXX,0,300,0
4851,14,1,13,80,206,0,0,217,56,161,GXXXXXXXXXXXXXXXXXXXGXXXXXXXXXXXXXXXXXXXGXXXXXXXXXXXXXXXXXXXGAXXXXXXXXXXXXXXXXXXGXXXXXXXXXXXXXXXXXXXGXXXXXXXXXXXXXXXXXXXGXXXXXXXXXXXXXXXXXXXGXXXXXXXXXXXXXXXXXXXGXXXXXXXXXXXXXXXXXXXGXXXXXXXXXXXXXXXXXXXGXXXXXXXXXXXXXXXXXXXGXXXXXXXXXXXXXXXXXXXGXXXXXXXXXXXXXXXXXXX,0,300,0
4872,14,1,13,70,216,0,0,227,63,164,GXXXXXXXXXXXXXXXXXXXGXXXXXXXXXXXXXXXXXXXGXXXXXXXXXXXXXXXXXXXGAXXXXXXXXXXXXXXXXXXGXXXXXXXXXXXXXXXXXXXGXXXXXXXXXXXXXXXXXXXGXXXXXXXXXXXXXXXXXXXGXXXXXXXXXXXXXXXXXXXGXXXXXXXXXXXXXXXXXXXGXXXXXXXXXXXXXXXXXXXGXXXXXXXXXXXXXXXXXXXGXXXXXXXXXXXXXXXXXXXGXXXXXXXXXXXXXXXXXXX,0,300,0
4893,14,1,13,74,212,0,0,223,63,160,GXXXXXXXXXXXXXXXXXXXGXXXXXXXXXXXXXXXXXXXGXXXXXXXXXXXXXXXXXXXGAXXXXXXXXXXXXXXXXXXGXXXXXXXXXXXXXXXXXXXGXXXXXXXXXXXXXXXXXXXGXXXXXXXXXXXXXXXXXXXGXXXXXXXXXXXXXXXXXXXGXXXXXXXXXXXXXXXXXXXGXXXXXXXXXXXXXXXXXXXGXXXXXXXXXXXXXXXXXXXGXXXXXXXXXXXXXXXXXXXGXXXXXXXXXXXXXXXXXXX,0,300,0
4914,14,1,13,82,204,0,0,216,53,163,GXXXXXXXXXXXXXXXXXXXGXXXXXXXXXXXXXXXXXXXGXXXXXXXXXXXXXXXXXXXGAXXXXXXXXXXXXXXXXXXGXXXXXXXXXXXXXXXXXXXGXXXXXXXXXXXXXXXXXXXGXXXXXXXXXXXXXXXXXXXGXXXXXXXXXXXXXXXXXXXGXXXXXXXXXXXXXXXXXXXGXXXXXXXXXXXXXXXXXXXGXXXXXXXXXXXXXXXXXXXGXXXXXXXXXXXXXXXXXXXGXXXXXXXXXXXXXXXXXXX,0,300,0

4935,14,1,13,76,210,0,0,222,54,168,GXXXXXXXXXXXXXXXXXXXGXXXXXXXXXXXXXXXXXXXGXXXXXXXXXXXXXXXXXXXGAXXXXXXXXXXXXXXXXXXGXXXXXXXXXXXXXXXXXXXGXXXXXXXXXXXXXXXXXXXGXXXXXXXXXXXXXXXXXXXGXXXXXXXXXXXXXXXXXXXGXXXXXXXXXXXXXXXXXXXGXXXXXXXXXXXXXXXXXXXGXXXXXXXXXXXXXXXXXXXGXXXXXXXXXXXXXXXXXXXGXXXXXXXXXXXXXXXXXXX,0,300,0
4956,14,1,13,79,207,0,0,219,55,164,GXXXXXXXXXXXXXXXXXXXGXXXXXXXXXXXXXXXXXXXGXXXXXXXXXXXXXXXXXXXGAXXXXXXXXXXXXXXXXXXGXXXXXXXXXXXXXXXXXXXGXXXXXXXXXXXXXXXXXXXGXXXXXXXXXXXXXXXXXXXGXXXXXXXXXXXXXXXXXXXGXXXXXXXXXXXXXXXXXXXGXXXXXXXXXXXXXXXXXXXGXXXXXXXXXXXXXXXXXXXGXXXXXXXXXXXXXXXXXXXGXXXXXXXXXXXXXXXXXXX,0,300,0
4977,14,0,14,78,208,0,0,220,61,159,GXXXXXXXXXXXXXXXXXXXGXXXXXXXXXXXXXXXXXXXGXXXXXXXXXXXXXXXXXXXGOXXXXXXXXXXXXXXXXXXGXXXXXXXXXXXXXXXXXXXGXXXXXXXXXXXXXXXXXXXGXXXXXXXXXXXXXXXXXXXGXXXXXXXXXXXXXXXXXXXGXXXXXXXXXXXXXXXXXXXGXXXXXXXXXXXXXXXXXXXGXXXXXXXXXXXXXXXXXXXGXXXXXXXXXXXXXXXXXXXGXXXXXXXXXXXXXXXXXXX,0,300,0
4998,15,1,14,75,210,0,0,221,58,163,GXXXXXXXXXXXXXXXXXXXGXXXXXXXXXXXXXXXXXXXGXXXXXXXXXXXXXXXXXXXGOAXXXXXXXXXXXXXXXXXGXXXXXXXXXXXXXXXXXXXGXXXXXXXXXXXXXXXXXXXGXXXXXXXXXXXXXXXXXXXGXXXXXXXXXXXXXXXXXXXGXXXXXXXXXXXXXXXXXXXGXXXXXXXXXXXXXXXXXXXGXXXXXXXXXXXXXXXXXXXGXXXXXXXXXXXXXXXXXXXGXXXXXXXXXXXXXXXXXXX,0,300,0
5019,14,1,13,75,211,0,0,223,61,162,GXXXXXXXXXXXXXXXXXXXGXXXXXXXXXXXXXXXXXXXGXXXXXXXXXXXXXXXXXXXGXAXXXXXXXXXXXXXXXXXGXXXXXXXXXXXXXXXXXXXGXXXXXXXXXXXXXXXXXXXGXXXXXXXXXXXXXXXXXXXGXXXXXXXXXXXXXXXXXXXGXXXXXXXXXXXXXXXXXXXGXXXXXXXXXXXXXXXXXXXGXXXXXXXXXXXXXXXXXXXGXXXXXXXXXXXXXXXXXXXGXXXXXXXXXXXXXXXXXXX,0,300,0

5040,13,0,13,76,211,0,0,222,63,159,GXXXXXXXXXXXXXXXXXXXGXXXXXXXXXXXXXXXXXXXGXXXXXXXXXXXXXXXXXXXGXXXXXXXXXXXXXXXXXXXGXXXXXXXXXXXXXXXXXXXGXXXXXXXXXXXXXXXXXXXGXXXXXXXXXXXXXXXXXXXGXXXXXXXXXXXXXXXXXXXGXXXXXXXXXXXXXXXXXXXGXXXXXXXXXXXXXXXXXXXGXXXXXXXXXXXXXXXXXXXGXXXXXXXXXXXXXXXXXXXGXXXXXXXXXXXXXXXXXXX,0,300,0
5061,13,0,13,73,214,0,0,226,61,165,GXXXXXXXXXXXXXXXXXXXGXXXXXXXXXXXXXXXXXXXGXXXXXXXXXXXXXXXXXXXGXXXXXXXXXXXXXXXXXXXGXXXXXXXXXXXXXXXXXXXGXXXXXXXXXXXXXXXXXXXGXXXXXXXXXXXXXXXXXXXGXXXXXXXXXXXXXXXXXXXGXXXXXXXXXXXXXXXXXXXGXXXXXXXXXXXXXXXXXXXGXXXXXXXXXXXXXXXXXXXGXXXXXXXXXXXXXXXXXXXGXXXXXXXXXXXXXXXXXXX,0,300,0
5082,13,0,13,72,215,0,0,227,62,165,GXXXXXXXXXXXXXXXXXXXGXXXXXXXXXXXXXXXXXXXGXXXXXXXXXXXXXXXXXXXGXXXXXXXXXXXXXXXXXXXGXXXXXXXXXXXXXXXXXXXGXXXXXXXXXXXXXXXXXXXGXXXXXXXXXXXXXXXXXXXGXXXXXXXXXXXXXXXXXXXGXXXXXXXXXXXXXXXXXXXGXXXXXXXXXXXXXXXXXXXGXXXXXXXXXXXXXXXXXXXGXXXXXXXXXXXXXXXXXXXGXXXXXXXXXXXXXXXXXXX,0,300,0
5103,13,0,13,80,207,0,0,219,62,157,GXXXXXXXXXXXXXXXXXXXGXXXXXXXXXXXXXXXXXXXGXXXXXXXXXXXXXXXXXXXGXXXXXXXXXXXXXXXXXXXGXXXXXXXXXXXXXXXXXXXGXXXXXXXXXXXXXXXXXXXGXXXXXXXXXXXXXXXXXXXGXXXXXXXXXXXXXXXXXXXGXXXXXXXXXXXXXXXXXXXGXXXXXXXXXXXXXXXXXXXGXXXXXXXXXXXXXXXXXXXGXXXXXXXXXXXXXXXXXXXGXXXXXXXXXXXXXXXXXXX,0,300,0
5124,13,0,13,84,203,0,0,214,62,152,GXXXXXXXXXXXXXXXXXXXGXXXXXXXXXXXXXXXXXXXGXXXXXXXXXXXXXXXXXXXGXXXXXXXXXXXXXXXXXXXGXXXXXXXXXXXXXXXXXXXGXXXXXXXXXXXXXXXXXXXGXXXXXXXXXXXXXXXXXXXGXXXXXXXXXXXXXXXXXXXGXXXXXXXXXXXXXXXXXXXGXXXXXXXXXXXXXXXXXXXGXXXXXXXXXXXXXXXXXXXGXXXXXXXXXXXXXXXXXXXGXXXXXXXXXXXXXXXXXXX,0,300,0

5145,13,0,13,89,198,0,0,210,57,153,GXXXXXXXXXXXXXXXXXXXGXXXXXXXXXXXXXXXXXXXGXXXXXXXXXXXXXXXXXXXGXXXXXXXXXXXXXXXXXXXGXXXXXXXXXXXXXXXXXXXGXXXXXXXXXXXXXXXXXXXGXXXXXXXXXXXXXXXXXXXGXXXXXXXXXXXXXXXXXXXGXXXXXXXXXXXXXXXXXXXGXXXXXXXXXXXXXXXXXXXGXXXXXXXXXXXXXXXXXXXGXXXXXXXXXXXXXXXXXXXGXXXXXXXXXXXXXXXXXXX,0,300,0
5166,13,0,13,84,203,0,0,214,64,150,GXXXXXXXXXXXXXXXXXXXGXXXXXXXXXXXXXXXXXXXGXXXXXXXXXXXXXXXXXXXGXXXXXXXXXXXXXXXXXXXGXXXXXXXXXXXXXXXXXXXGXXXXXXXXXXXXXXXXXXXGXXXXXXXXXXXXXXXXXXXGXXXXXXXXXXXXXXXXXXXGXXXXXXXXXXXXXXXXXXXGXXXXXXXXXXXXXXXXXXXGXXXXXXXXXXXXXXXXXXXGXXXXXXXXXXXXXXXXXXXGXXXXXXXXXXXXXXXXXXX,0,300,0
5187,13,0,13,83,204,0,0,216,63,153,GXXXXXXXXXXXXXXXXXXXGXXXXXXXXXXXXXXXXXXXGXXXXXXXXXXXXXXXXXXXGXXXXXXXXXXXXXXXXXXXGXXXXXXXXXXXXXXXXXXXGXXXXXXXXXXXXXXXXXXXGXXXXXXXXXXXXXXXXXXXGXXXXXXXXXXXXXXXXXXXGXXXXXXXXXXXXXXXXXXXGXXXXXXXXXXXXXXXXXXXGXXXXXXXXXXXXXXXXXXXGXXXXXXXXXXXXXXXXXXXGXXXXXXXXXXXXXXXXXXX,0,300,0
5208,13,0,13,88,199,0,0,211,60,151,GXXXXXXXXXXXXXXXXXXXGXXXXXXXXXXXXXXXXXXXGXXXXXXXXXXXXXXXXXXXGXXXXXXXXXXXXXXXXXXXGXXXXXXXXXXXXXXXXXXXGXXXXXXXXXXXXXXXXXXXGXXXXXXXXXXXXXXXXXXXGXXXXXXXXXXXXXXXXXXXGXXXXXXXXXXXXXXXXXXXGXXXXXXXXXXXXXXXXXXXGXXXXXXXXXXXXXXXXXXXGXXXXXXXXXXXXXXXXXXXGXXXXXXXXXXXXXXXXXXX,0,300,0
5229,13,0,13,91,196,0,0,208,65,143,GXXXXXXXXXXXXXXXXXXXGXXXXXXXXXXXXXXXXXXXGXXXXXXXXXXXXXXXXXXXGXXXXXXXXXXXXXXXXXXXGXXXXXXXXXXXXXXXXXXXGXXXXXXXXXXXXXXXXXXXGXXXXXXXXXXXXXXXXXXXGXXXXXXXXXXXXXXXXXXXGXXXXXXXXXXXXXXXXXXXGXXXXXXXXXXXXXXXXXXXGXXXXXXXXXXXXXXXXXXXGXXXXXXXXXXXXXXXXXXXGXXXXXXXXXXXXXXXXXXX,0,300,0

5250,14,1,13,92,194,0,0,205,61,144,GXXXXXXXXXXXXXXXXXXXGXXXXXXXXXXXXXXXXXXXGXXXXXXXXXXXXXXXXXXXGXXXXXXXXXXXXXXXXXXXGXXXXXXXXXXXXXXXXXXXGXXXXXXXXXXXXXXXXXXXGXXXXXXXXXXXXXXXXXXXGXXXXXXXXXXXXXXXXXXXGXXXXXXXXXXXXXXXXXXXGXXXXXXXXXXXXXXXXXXXGXXXXXXXXXXXXXXXXXXXGAXXXXXXXXXXXXXXXXXXGXXXXXXXXXXXXXXXXXXX,0,300,0
5271,15,2,13,91,194,0,0,206,60,146,GXXXXXXXXXXXXXXXXXXXGXXXXXXXXXXXXXXXXXXXGXXXXXXXXXXXXXXXXXXXGXXXXXXXXXXXXXXXXXXXGAXXXXXXXXXXXXXXXXXXGXXXXXXXXXXXXXXXXXXXGXXXXXXXXXXXXXXXXXXXGXXXXXXXXXXXXXXXXXXXGXXXXXXXXXXXXXXXXXXXGXXXXXXXXXXXXXXXXXXXGXXXXXXXXXXXXXXXXXXXGAXXXXXXXXXXXXXXXXXXGXXXXXXXXXXXXXXXXXXX,0,300,0
5292,15,2,13,94,191,0,0,203,65,138,GXXXXXXXXXXXXXXXXXXXGXXXXXXXXXXXXXXXXXXXGXXXXXXXXXXXXXXXXXXXGXXXXXXXXXXXXXXXXXXXGAXXXXXXXXXXXXXXXXXXGXXXXXXXXXXXXXXXXXXXGXXXXXXXXXXXXXXXXXXXGXXXXXXXXXXXXXXXXXXXGXXXXXXXXXXXXXXXXXXXGXXXXXXXXXXXXXXXXXXXGXXXXXXXXXXXXXXXXXXXGAXXXXXXXXXXXXXXXXXXGXXXXXXXXXXXXXXXXXXX,0,300,0
5313,15,2,13,93,192,0,0,204,61,143,GXXXXXXXXXXXXXXXXXXXGXXXXXXXXXXXXXXXXXXXGXXXXXXXXXXXXXXXXXXXGXXXXXXXXXXXXXXXXXXXGAXXXXXXXXXXXXXXXXXXGXXXXXXXXXXXXXXXXXXXGXXXXXXXXXXXXXXXXXXXGXXXXXXXXXXXXXXXXXXXGXXXXXXXXXXXXXXXXXXXGXXXXXXXXXXXXXXXXXXXGXXXXXXXXXXXXXXXXXXXGAXXXXXXXXXXXXXXXXXXGXXXXXXXXXXXXXXXXXXX,0,300,0
5334,15,2,13,97,188,0,0,199,56,143,GXXXXXXXXXXXXXXXXXXXGXXXXXXXXXXXXXXXXXXXGXXXXXXXXXXXXXXXXXXXGXXXXXXXXXXXXXXXXXXXGAXXXXXXXXXXXXXXXXXXGXXXXXXXXXXXXXXXXXXXGXXXXXXXXXXXXXXXXXXXGXXXXXXXXXXXXXXXXXXXGXXXXXXXXXXXXXXXXXXXGXXXXXXXXXXXXXXXXXXXGXXXXXXXXXXXXXXXXXXXGAXXXXXXXXXXXXXXXXXXGXXXXXXXXXXXXXXXXXXX,0,300,0

5355,15,2,13,93,192,0,0,203,61,142,GXXXXXXXXXXXXXXXXXXXGXXXXXXXXXXXXXXXXXXXGXXXXXXXXXXXXXXXXXXXGXXXXXXXXXXXXXXXXXXXGAXXXXXXXXXXXXXXXXXXGXXXXXXXXXXXXXXXXXXXGXXXXXXXXXXXXXXXXXXXGXXXXXXXXXXXXXXXXXXXGXXXXXXXXXXXXXXXXXXXGXXXXXXXXXXXXXXXXXXXGXXXXXXXXXXXXXXXXXXXGAXXXXXXXXXXXXXXXXXXGXXXXXXXXXXXXXXXXXXX,0,300,0
5376,15,2,13,95,190,0,0,202,64,138,GXXXXXXXXXXXXXXXXXXXGXXXXXXXXXXXXXXXXXXXGXXXXXXXXXXXXXXXXXXXGXXXXXXXXXXXXXXXXXXXGAXXXXXXXXXXXXXXXXXXGXXXXXXXXXXXXXXXXXXXGXXXXXXXXXXXXXXXXXXXGXXXXXXXXXXXXXXXXXXXGXXXXXXXXXXXXXXXXXXXGXXXXXXXXXXXXXXXXXXXGXXXXXXXXXXXXXXXXXXXGAXXXXXXXXXXXXXXXXXXGXXXXXXXXXXXXXXXXXXX,0,300,0
5397,16,3,13,93,191,0,0,201,65,136,GXXXXXXXXXXXXXXXXXXXGXXXXXXXXXXXXXXXXXXXGXXXXXXXXXXXXXXXXXXXGXXXXXXXXXXXXXXXXXXXGAXXXXXXXXXXXXXXXXXXGXXXXXXXXXXXXXXXXXXXGXXXXXXXXXXXXXXXXXXXGXXXXXXXXXXXXXXXXXXXGXXXXXXXXXXXXXXXXXXXGXXXXXXXXXXXXXXXXXXXGXXXXXXXXXXXXXXXXXXXGAXXXXXXXXXXXXXXXXXXGAXXXXXXXXXXXXXXXXXX,0,300,0
5418,17,4,13,98,185,0,0,197,61,136,GXXXXXXXXXXXXXXXXXXXGXXXXXXXXXXXXXXXXXXXGAXXXXXXXXXXXXXXXXXXGXXXXXXXXXXXXXXXXXXXGAXXXXXXXXXXXXXXXXXXGXXXXXXXXXXXXXXXXXXXGXXXXXXXXXXXXXXXXXXXGXXXXXXXXXXXXXXXXXXXGXXXXXXXXXXXXXXXXXXXGXXXXXXXXXXXXXXXXXXXGXXXXXXXXXXXXXXXXXXXGAXXXXXXXXXXXXXXXXXXGAXXXXXXXXXXXXXXXXXX,0,300,0
5439,17,4,13,93,190,0,0,200,62,138,GXXXXXXXXXXXXXXXXXXXGXXXXXXXXXXXXXXXXXXXGAXXXXXXXXXXXXXXXXXXGXXXXXXXXXXXXXXXXXXXGAXXXXXXXXXXXXXXXXXXGXXXXXXXXXXXXXXXXXXXGXXXXXXXXXXXXXXXXXXXGXXXXXXXXXXXXXXXXXXXGXXXXXXXXXXXXXXXXXXXGXXXXXXXXXXXXXXXXXXXGXXXXXXXXXXXXXXXXXXXGAXXXXXXXXXXXXXXXXXXGAXXXXXXXXXXXXXXXXXX,0,300,0

5460,17,4,13,98,185,0,0,196,58,138,GXXXXXXXXXXXXXXXXXXXGXXXXXXXXXXXXXXXXXXXGAXXXXXXXXXXXXXXXXXXGXXXXXXXXXXXXXXXXXXXGAXXXXXXXXXXXXXXXXXXGXXXXXXXXXXXXXXXXXXXGXXXXXXXXXXXXXXXXXXXGXXXXXXXXXXXXXXXXXXXGXXXXXXXXXXXXXXXXXXXGXXXXXXXXXXXXXXXXXXXGXXXXXXXXXXXXXXXXXXXGAXXXXXXXXXXXXXXXXXXGAXXXXXXXXXXXXXXXXXX,0,300,0
5481,16,2,14,98,186,0,0,198,53,145,GXXXXXXXXXXXXXXXXXXXGXXXXXXXXXXXXXXXXXXXGAXXXXXXXXXXXXXXXXXXGXXXXXXXXXXXXXXXXXXXGXXXXXXXXXXXXXXXXXXXGXXXXXXXXXXXXXXXXXXXGXXXXXXXXXXXXXXXXXXXGXXXXXXXXXXXXXXXXXXXGXXXXXXXXXXXXXXXXXXXGXXXXXXXXXXXXXXXXXXXGXXXXXXXXXXXXXXXXXXXGOXXXXXXXXXXXXXXXXXXGAXXXXXXXXXXXXXXXXXX,0,300,0
5502,16,3,13,90,194,0,0,205,53,152,GAXXXXXXXXXXXXXXXXXXGXXXXXXXXXXXXXXXXXXXGAXXXXXXXXXXXXXXXXXXGXXXXXXXXXXXXXXXXXXXGXXXXXXXXXXXXXXXXXXXGXXXXXXXXXXXXXXXXXXXGXXXXXXXXXXXXXXXXXXXGXXXXXXXXXXXXXXXXXXXGXXXXXXXXXXXXXXXXXXXGXXXXXXXXXXXXXXXXXXXGXXXXXXXXXXXXXXXXXXXGXXXXXXXXXXXXXXXXXXXGAXXXXXXXXXXXXXXXXXX,0,300,0
5523,16,3,13,85,199,0,0,211,53,158,GAXXXXXXXXXXXXXXXXXXGXXXXXXXXXXXXXXXXXXXGAXXXXXXXXXXXXXXXXXXGXXXXXXXXXXXXXXXXXXXGXXXXXXXXXXXXXXXXXXXGXXXXXXXXXXXXXXXXXXXGXXXXXXXXXXXXXXXXXXXGXXXXXXXXXXXXXXXXXXXGXXXXXXXXXXXXXXXXXXXGXXXXXXXXXXXXXXXXXXXGXXXXXXXXXXXXXXXXXXXGXXXXXXXXXXXXXXXXXXXGAXXXXXXXXXXXXXXXXXX,0,300,0
5544,16,2,14,85,199,0,0,209,50,159,GOXXXXXXXXXXXXXXXXXXGXXXXXXXXXXXXXXXXXXXGAXXXXXXXXXXXXXXXXXXGXXXXXXXXXXXXXXXXXXXGXXXXXXXXXXXXXXXXXXXGXXXXXXXXXXXXXXXXXXXGXXXXXXXXXXXXXXXXXXXGXXXXXXXXXXXXXXXXXXXGXXXXXXXXXXXXXXXXXXXGXXXXXXXXXXXXXXXXXXXGXXXXXXXXXXXXXXXXXXXGXXXXXXXXXXXXXXXXXXXGAXXXXXXXXXXXXXXXXXX,0,300,0

5565,15,1,14,83,202,0,0,214,52,162,GXXXXXXXXXXXXXXXXXXXGXXXXXXXXXXXXXXXXXXXGOXXXXXXXXXXXXXXXXXXGXXXXXXXXXXXXXXXXXXXGXXXXXXXXXXXXXXXXXXXGXXXXXXXXXXXXXXXXXXXGXXXXXXXXXXXXXXXXXXXGXXXXXXXXXXXXXXXXXXXGXXXXXXXXXXXXXXXXXXXGXXXXXXXXXXXXXXXXXXXGXXXXXXXXXXXXXXXXXXXGXXXXXXXXXXXXXXXXXXXGAXXXXXXXXXXXXXXXXXX,0,300,0
5586,15,1,14,77,208,0,0,220,59,161,GXXXXXXXXXXXXXXXXXXXGXXXXXXXXXXXXXXXXXXXGOXXXXXXXXXXXXXXXXXXGXXXXXXXXXXXXXXXXXXXGXXXXXXXXXXXXXXXXXXXGXXXXXXXXXXXXXXXXXXXGXXXXXXXXXXXXXXXXXXXGXXXXXXXXXXXXXXXXXXXGXXXXXXXXXXXXXXXXXXXGXXXXXXXXXXXXXXXXXXXGXXXXXXXXXXXXXXXXXXXGXXXXXXXXXXXXXXXXXXXGAXXXXXXXXXXXXXXXXXX,0,300,0
5607,14,1,13,78,208,0,0,219,63,156,GXXXXXXXXXXXXXXXXXXXGXXXXXXXXXXXXXXXXXXXGXXXXXXXXXXXXXXXXXXXGXXXXXXXXXXXXXXXXXXXGXXXXXXXXXXXXXXXXXXXGXXXXXXXXXXXXXXXXXXXGXXXXXXXXXXXXXXXXXXXGXXXXXXXXXXXXXXXXXXXGXXXXXXXXXXXXXXXXXXXGXXXXXXXXXXXXXXXXXXXGXXXXXXXXXXXXXXXXXXXGXXXXXXXXXXXXXXXXXXXGAXXXXXXXXXXXXXXXXXX,0,300,0
5628,14,0,14,78,208,0,0,220,69,151,GXXXXXXXXXXXXXXXXXXXGXXXXXXXXXXXXXXXXXXXGXXXXXXXXXXXXXXXXXXXGXXXXXXXXXXXXXXXXXXXGXXXXXXXXXXXXXXXXXXXGXXXXXXXXXXXXXXXXXXXGXXXXXXXXXXXXXXXXXXXGXXXXXXXXXXXXXXXXXXXGXXXXXXXXXXXXXXXXXXXGXXXXXXXXXXXXXXXXXXXGXXXXXXXXXXXXXXXXXXXGXXXXXXXXXXXXXXXXXXXGOXXXXXXXXXXXXXXXXXX,0,300,0
5649,14,0,14,77,209,0,0,221,66,155,GXXXXXXXXXXXXXXXXXXXGXXXXXXXXXXXXXXXXXXXGXXXXXXXXXXXXXXXXXXXGXXXXXXXXXXXXXXXXXXXGXXXXXXXXXXXXXXXXXXXGXXXXXXXXXXXXXXXXXXXGXXXXXXXXXXXXXXXXXXXGXXXXXXXXXXXXXXXXXXXGXXXXXXXXXXXXXXXXXXXGXXXXXXXXXXXXXXXXXXXGXXXXXXXXXXXXXXXXXXXGXXXXXXXXXXXXXXXXXXXGOXXXXXXXXXXXXXXXXXX,0,300,0

5670,13,0,13,81,206,0,0,217,67,150,GXXXXXXXXXXXXXXXXXXXGXXXXXXXXXXXXXXXXXXXGXXXXXXXXXXXXXXXXXXXGXXXXXXXXXXXXXXXXXXXGXXXXXXXXXXXXXXXXXXXGXXXXXXXXXXXXXXXXXXXGXXXXXXXXXXXXXXXXXXXGXXXXXXXXXXXXXXXXXXXGXXXXXXXXXXXXXXXXXXXGXXXXXXXXXXXXXXXXXXXGXXXXXXXXXXXXXXXXXXXGXXXXXXXXXXXXXXXXXXXGXXXXXXXXXXXXXXXXXXX,0,300,0
5691,13,0,13,79,208,0,0,216,61,155,GXXXXXXXXXXXXXXXXXXXGXXXXXXXXXXXXXXXXXXXGXXXXXXXXXXXXXXXXXXXGXXXXXXXXXXXXXXXXXXXGXXXXXXXXXXXXXXXXXXXGXXXXXXXXXXXXXXXXXXXGXXXXXXXXXXXXXXXXXXXGXXXXXXXXXXXXXXXXXXXGXXXXXXXXXXXXXXXXXXXGXXXXXXXXXXXXXXXXXXXGXXXXXXXXXXXXXXXXXXXGXXXXXXXXXXXXXXXXXXXGXXXXXXXXXXXXXXXXXXX,0,300,0
5712,13,0,13,84,203,0,0,214,59,155,GXXXXXXXXXXXXXXXXXXXGXXXXXXXXXXXXXXXXXXXGXXXXXXXXXXXXXXXXXXXGXXXXXXXXXXXXXXXXXXXGXXXXXXXXXXXXXXXXXXXGXXXXXXXXXXXXXXXXXXXGXXXXXXXXXXXXXXXXXXXGXXXXXXXXXXXXXXXXXXXGXXXXXXXXXXXXXXXXXXXGXXXXXXXXXXXXXXXXXXXGXXXXXXXXXXXXXXXXXXXGXXXXXXXXXXXXXXXXXXXGXXXXXXXXXXXXXXXXXXX,0,300,0
5733,13,0,13,85,202,0,0,214,61,153,GXXXXXXXXXXXXXXXXXXXGXXXXXXXXXXXXXXXXXXXGXXXXXXXXXXXXXXXXXXXGXXXXXXXXXXXXXXXXXXXGXXXXXXXXXXXXXXXXXXXGXXXXXXXXXXXXXXXXXXXGXXXXXXXXXXXXXXXXXXXGXXXXXXXXXXXXXXXXXXXGXXXXXXXXXXXXXXXXXXXGXXXXXXXXXXXXXXXXXXXGXXXXXXXXXXXXXXXXXXXGXXXXXXXXXXXXXXXXXXXGXXXXXXXXXXXXXXXXXXX,0,300,0
5754,13,0,13,87,200,0,0,212,60,152,GXXXXXXXXXXXXXXXXXXXGXXXXXXXXXXXXXXXXXXXGXXXXXXXXXXXXXXXXXXXGXXXXXXXXXXXXXXXXXXXGXXXXXXXXXXXXXXXXXXXGXXXXXXXXXXXXXXXXXXXGXXXXXXXXXXXXXXXXXXXGXXXXXXXXXXXXXXXXXXXGXXXXXXXXXXXXXXXXXXXGXXXXXXXXXXXXXXXXXXXGXXXXXXXXXXXXXXXXXXXGXXXXXXXXXXXXXXXXXXXGXXXXXXXXXXXXXXXXXXX,0,300,0

5775,13,0,13,94,193,0,0,204,62,142,GXXXXXXXXXXXXXXXXXXXGXXXXXXXXXXXXXXXXXXXGXXXXXXXXXXXXXXXXXXXGXXXXXXXXXXXXXXXXXXXGXXXXXXXXXXXXXXXXXXXGXXXXXXXXXXXXXXXXXXXGXXXXXXXXXXXXXXXXXXXGXXXXXXXXXXXXXXXXXXXGXXXXXXXXXXXXXXXXXXXGXXXXXXXXXXXXXXXXXXXGXXXXXXXXXXXXXXXXXXXGXXXXXXXXXXXXXXXXXXXGXXXXXXXXXXXXXXXXXXX,0,300,0
5796,13,0,13,89,198,0,0,209,63,146,GXXXXXXXXXXXXXXXXXXXGXXXXXXXXXXXXXXXXXXXGXXXXXXXXXXXXXXXXXXXGXXXXXXXXXXXXXXXXXXXGXXXXXXXXXXXXXXXXXXXGXXXXXXXXXXXXXXXXXXXGXXXXXXXXXXXXXXXXXXXGXXXXXXXXXXXXXXXXXXXGXXXXXXXXXXXXXXXXXXXGXXXXXXXXXXXXXXXXXXXGXXXXXXXXXXXXXXXXXXXGXXXXXXXXXXXXXXXXXXXGXXXXXXXXXXXXXXXXXXX,0,300,0
5817,13,0,13,88,199,0,0,211,64,147,GXXXXXXXXXXXXXXXXXXXGXXXXXXXXXXXXXXXXXXXGXXXXXXXXXXXXXXXXXXXGXXXXXXXXXXXXXXXXXXXGXXXXXXXXXXXXXXXXXXXGXXXXXXXXXXXXXXXXXXXGXXXXXXXXXXXXXXXXXXXGXXXXXXXXXXXXXXXXXXXGXXXXXXXXXXXXXXXXXXXGXXXXXXXXXXXXXXXXXXXGXXXXXXXXXXXXXXXXXXXGXXXXXXXXXXXXXXXXXXXGXXXXXXXXXXXXXXXXXXX,0,300,0
5838,13,0,13,87,200,0,0,212,65,147,GXXXXXXXXXXXXXXXXXXXGXXXXXXXXXXXXXXXXXXXGXXXXXXXXXXXXXXXXXXXGXXXXXXXXXXXXXXXXXXXGXXXXXXXXXXXXXXXXXXXGXXXXXXXXXXXXXXXXXXXGXXXXXXXXXXXXXXXXXXXGXXXXXXXXXXXXXXXXXXXGXXXXXXXXXXXXXXXXXXXGXXXXXXXXXXXXXXXXXXXGXXXXXXXXXXXXXXXXXXXGXXXXXXXXXXXXXXXXXXXGXXXXXXXXXXXXXXXXXXX,0,300,0
5859,13,0,13,83,204,0,0,214,68,146,GXXXXXXXXXXXXXXXXXXXGXXXXXXXXXXXXXXXXXXXGXXXXXXXXXXXXXXXXXXXGXXXXXXXXXXXXXXXXXXXGXXXXXXXXXXXXXXXXXXXGXXXXXXXXXXXXXXXXXXXGXXXXXXXXXXXXXXXXXXXGXXXXXXXXXXXXXXXXXXXGXXXXXXXXXXXXXXXXXXXGXXXXXXXXXXXXXXXXXXXGXXXXXXXXXXXXXXXXXXXGXXXXXXXXXXXXXXXXXXXGXXXXXXXXXXXXXXXXXXX,0,300,0

5880,13,0,13,85,202,0,0,214,74,140,GXXXXXXXXXXXXXXXXXXXGXXXXXXXXXXXXXXXXXXXGXXXXXXXXXXXXXXXXXXXGXXXXXXXXXXXXXXXXXXXGXXXXXXXXXXXXXXXXXXXGXXXXXXXXXXXXXXXXXXXGXXXXXXXXXXXXXXXXXXXGXXXXXXXXXXXXXXXXXXXGXXXXXXXXXXXXXXXXXXXGXXXXXXXXXXXXXXXXXXXGXXXXXXXXXXXXXXXXXXXGXXXXXXXXXXXXXXXXXXXGXXXXXXXXXXXXXXXXXXX,0,300,0
5901,13,0,13,95,192,0,0,204,68,136,GXXXXXXXXXXXXXXXXXXXGXXXXXXXXXXXXXXXXXXXGXXXXXXXXXXXXXXXXXXXGXXXXXXXXXXXXXXXXXXXGXXXXXXXXXXXXXXXXXXXGXXXXXXXXXXXXXXXXXXXGXXXXXXXXXXXXXXXXXXXGXXXXXXXXXXXXXXXXXXXGXXXXXXXXXXXXXXXXXXXGXXXXXXXXXXXXXXXXXXXGXXXXXXXXXXXXXXXXXXXGXXXXXXXXXXXXXXXXXXXGXXXXXXXXXXXXXXXXXXX,0,300,0
5922,13,0,13,98,189,0,0,201,70,131,GXXXXXXXXXXXXXXXXXXXGXXXXXXXXXXXXXXXXXXXGXXXXXXXXXXXXXXXXXXXGXXXXXXXXXXXXXXXXXXXGXXXXXXXXXXXXXXXXXXXGXXXXXXXXXXXXXXXXXXXGXXXXXXXXXXXXXXXXXXXGXXXXXXXXXXXXXXXXXXXGXXXXXXXXXXXXXXXXXXXGXXXXXXXXXXXXXXXXXXXGXXXXXXXXXXXXXXXXXXXGXXXXXXXXXXXXXXXXXXXGXXXXXXXXXXXXXXXXXXX,0,300,0
5943,13,0,13,98,189,0,0,201,67,134,GXXXXXXXXXXXXXXXXXXXGXXXXXXXXXXXXXXXXXXXGXXXXXXXXXXXXXXXXXXXGXXXXXXXXXXXXXXXXXXXGXXXXXXXXXXXXXXXXXXXGXXXXXXXXXXXXXXXXXXXGXXXXXXXXXXXXXXXXXXXGXXXXXXXXXXXXXXXXXXXGXXXXXXXXXXXXXXXXXXXGXXXXXXXXXXXXXXXXXXXGXXXXXXXXXXXXXXXXXXXGXXXXXXXXXXXXXXXXXXXGXXXXXXXXXXXXXXXXXXX,0,300,0
5964,14,1,13,91,195,0,0,205,72,133,GXXXXXXXXXXXXXXXXXXXGXXXXXXXXXXXXXXXXXXXGXXXXXXXXXXXXXXXXXXXGXXXXXXXXXXXXXXXXXXXGXXXXXXXXXXXXXXXXXXXGXXXXXXXXXXXXXXXXXXXGXXXXXXXXXXXXXXXXXXXGXXXXXXXXXXXXXXXXXXXGXXXXXXXXXXXXXXXXXXXGXXXXXXXXXXXXXXXXXXXGXXXXXXXXXXXXXXXXXXXGXXXXXXXXXXXXXXXXXXXGAXXXXXXXXXXXXXXXXXX,0,300,0

5985,14,1,13,90,196,0,0,208,73,135,GXXXXXXXXXXXXXXXXXXXGXXXXXXXXXXXXXXXXXXXGXXXXXXXXXXXXXXXXXXXGXXXXXXXXXXXXXXXXXXXGXXXXXXXXXXXXXXXXXXXGXXXXXXXXXXXXXXXXXXXGXXXXXXXXXXXXXXXXXXXGXXXXXXXXXXXXXXXXXXXGXXXXXXXXXXXXXXXXXXXGXXXXXXXXXXXXXXXXXXXGXXXXXXXXXXXXXXXXXXXGXXXXXXXXXXXXXXXXXXXGAXXXXXXXXXXXXXXXXXX,0,300,0
6006,14,1,13,90,196,0,0,208,73,135,GXXXXXXXXXXXXXXXXXXXGXXXXXXXXXXXXXXXXXXXGXXXXXXXXXXXXXXXXXXXGXXXXXXXXXXXXXXXXXXXGXXXXXXXXXXXXXXXXXXXGXXXXXXXXXXXXXXXXXXXGXXXXXXXXXXXXXXXXXXXGXXXXXXXXXXXXXXXXXXXGXXXXXXXXXXXXXXXXXXXGXXXXXXXXXXXXXXXXXXXGXXXXXXXXXXXXXXXXXXXGXXXXXXXXXXXXXXXXXXXGAXXXXXXXXXXXXXXXXXX,0,300,0
6027,14,1,13,89,197,0,0,209,72,137,GXXXXXXXXXXXXXXXXXXXGXXXXXXXXXXXXXXXXXXXGXXXXXXXXXXXXXXXXXXXGXXXXXXXXXXXXXXXXXXXGXXXXXXXXXXXXXXXXXXXGXXXXXXXXXXXXXXXXXXXGXXXXXXXXXXXXXXXXXXXGXXXXXXXXXXXXXXXXXXXGXXXXXXXXXXXXXXXXXXXGXXXXXXXXXXXXXXXXXXXGXXXXXXXXXXXXXXXXXXXGXXXXXXXXXXXXXXXXXXXGAXXXXXXXXXXXXXXXXXX,0,300,0
6048,14,1,13,94,192,0,0,203,63,140,GXXXXXXXXXXXXXXXXXXXGXXXXXXXXXXXXXXXXXXXGXXXXXXXXXXXXXXXXXXXGXXXXXXXXXXXXXXXXXXXGXXXXXXXXXXXXXXXXXXXGXXXXXXXXXXXXXXXXXXXGXXXXXXXXXXXXXXXXXXXGXXXXXXXXXXXXXXXXXXXGXXXXXXXXXXXXXXXXXXXGXXXXXXXXXXXXXXXXXXXGXXXXXXXXXXXXXXXXXXXGXXXXXXXXXXXXXXXXXXXGAXXXXXXXXXXXXXXXXXX,0,300,0
6069,15,2,13,96,189,0,0,201,68,133,GXXXXXXXXXXXXXXXXXXXGXXXXXXXXXXXXXXXXXXXGXXXXXXXXXXXXXXXXXXXGXXXXXXXXXXXXXXXXXXXGXXXXXXXXXXXXXXXXXXXGAXXXXXXXXXXXXXXXXXXGXXXXXXXXXXXXXXXXXXXGXXXXXXXXXXXXXXXXXXXGXXXXXXXXXXXXXXXXXXXGXXXXXXXXXXXXXXXXXXXGXXXXXXXXXXXXXXXXXXXGXXXXXXXXXXXXXXXXXXXGAXXXXXXXXXXXXXXXXXX,0,300,0

6090,15,2,13,91,194,0,0,206,64,142,GXXXXXXXXXXXXXXXXXXXGXXXXXXXXXXXXXXXXXXXGXXXXXXXXXXXXXXXXXXXGXXXXXXXXXXXXXXXXXXXGXXXXXXXXXXXXXXXXXXXGAXXXXXXXXXXXXXXXXXXGXXXXXXXXXXXXXXXXXXXGXXXXXXXXXXXXXXXXXXXGXXXXXXXXXXXXXXXXXXXGXXXXXXXXXXXXXXXXXXXGXXXXXXXXXXXXXXXXXXXGXXXXXXXXXXXXXXXXXXXGAXXXXXXXXXXXXXXXXXX,0,300,0
6111,15,2,13,92,193,0,0,206,63,143,GXXXXXXXXXXXXXXXXXXXGXXXXXXXXXXXXXXXXXXXGXXXXXXXXXXXXXXXXXXXGXXXXXXXXXXXXXXXXXXXGXXXXXXXXXXXXXXXXXXXGAXXXXXXXXXXXXXXXXXXGXXXXXXXXXXXXXXXXXXXGXXXXXXXXXXXXXXXXXXXGXXXXXXXXXXXXXXXXXXXGXXXXXXXXXXXXXXXXXXXGXXXXXXXXXXXXXXXXXXXGXXXXXXXXXXXXXXXXXXXGAXXXXXXXXXXXXXXXXXX,0,300,0
6132,15,2,13,91,194,0,0,206,64,142,GXXXXXXXXXXXXXXXXXXXGXXXXXXXXXXXXXXXXXXXGXXXXXXXXXXXXXXXXXXXGXXXXXXXXXXXXXXXXXXXGXXXXXXXXXXXXXXXXXXXGAXXXXXXXXXXXXXXXXXXGXXXXXXXXXXXXXXXXXXXGXXXXXXXXXXXXXXXXXXXGXXXXXXXXXXXXXXXXXXXGXXXXXXXXXXXXXXXXXXXGXXXXXXXXXXXXXXXXXXXGXXXXXXXXXXXXXXXXXXXGAXXXXXXXXXXXXXXXXXX,0,300,0
6153,15,2,13,85,200,0,0,212,61,151,GXXXXXXXXXXXXXXXXXXXGXXXXXXXXXXXXXXXXXXXGXXXXXXXXXXXXXXXXXXXGXXXXXXXXXXXXXXXXXXXGXXXXXXXXXXXXXXXXXXXGAXXXXXXXXXXXXXXXXXXGXXXXXXXXXXXXXXXXXXXGXXXXXXXXXXXXXXXXXXXGXXXXXXXXXXXXXXXXXXXGXXXXXXXXXXXXXXXXXXXGXXXXXXXXXXXXXXXXXXXGXXXXXXXXXXXXXXXXXXXGAXXXXXXXXXXXXXXXXXX,0,300,0
6174,15,1,14,76,209,0,0,221,65,156,GXXXXXXXXXXXXXXXXXXXGXXXXXXXXXXXXXXXXXXXGXXXXXXXXXXXXXXXXXXXGXXXXXXXXXXXXXXXXXXXGXXXXXXXXXXXXXXXXXXXGAXXXXXXXXXXXXXXXXXXGXXXXXXXXXXXXXXXXXXXGXXXXXXXXXXXXXXXXXXXGXXXXXXXXXXXXXXXXXXXGXXXXXXXXXXXXXXXXXXXGXXXXXXXXXXXXXXXXXXXGXXXXXXXXXXXXXXXXXXXGOXXXXXXXXXXXXXXXXXX,0,300,0

6195,15,1,14,76,209,0,0,220,61,159,GXXXXXXXXXXXXXXXXXXXGXXXXXXXXXXXXXXXXXXXGXXXXXXXXXXXXXXXXXXXGXXXXXXXXXXXXXXXXXXXGXXXXXXXXXXXXXXXXXXXGAXXXXXXXXXXXXXXXXXXGXXXXXXXXXXXXXXXXXXXGXXXXXXXXXXXXXXXXXXXGXXXXXXXXXXXXXXXXXXXGXXXXXXXXXXXXXXXXXXXGXXXXXXXXXXXXXXXXXXXGXXXXXXXXXXXXXXXXXXXGOXXXXXXXXXXXXXXXXXX,0,300,0
6216,14,0,14,72,214,0,0,225,63,162,GXXXXXXXXXXXXXXXXXXXGXXXXXXXXXXXXXXXXXXXGXXXXXXXXXXXXXXXXXXXGXXXXXXXXXXXXXXXXXXXGXXXXXXXXXXXXXXXXXXXGOXXXXXXXXXXXXXXXXXXGXXXXXXXXXXXXXXXXXXXGXXXXXXXXXXXXXXXXXXXGXXXXXXXXXXXXXXXXXXXGXXXXXXXXXXXXXXXXXXXGXXXXXXXXXXXXXXXXXXXGXXXXXXXXXXXXXXXXXXXGXXXXXXXXXXXXXXXXXXX,0,300,0
6237,14,0,14,75,211,0,0,223,62,161,GXXXXXXXXXXXXXXXXXXXGXXXXXXXXXXXXXXXXXXXGXXXXXXXXXXXXXXXXXXXGXXXXXXXXXXXXXXXXXXXGXXXXXXXXXXXXXXXXXXXGOXXXXXXXXXXXXXXXXXXGXXXXXXXXXXXXXXXXXXXGXXXXXXXXXXXXXXXXXXXGXXXXXXXXXXXXXXXXXXXGXXXXXXXXXXXXXXXXXXXGXXXXXXXXXXXXXXXXXXXGXXXXXXXXXXXXXXXXXXXGXXXXXXXXXXXXXXXXXXX,0,300,0
6258,13,0,13,78,209,0,0,221,67,154,GXXXXXXXXXXXXXXXXXXXGXXXXXXXXXXXXXXXXXXXGXXXXXXXXXXXXXXXXXXXGXXXXXXXXXXXXXXXXXXXGXXXXXXXXXXXXXXXXXXXGXXXXXXXXXXXXXXXXXXXGXXXXXXXXXXXXXXXXXXXGXXXXXXXXXXXXXXXXXXXGXXXXXXXXXXXXXXXXXXXGXXXXXXXXXXXXXXXXXXXGXXXXXXXXXXXXXXXXXXXGXXXXXXXXXXXXXXXXXXXGXXXXXXXXXXXXXXXXXXX,0,300,0
6279,13,0,13,81,206,0,0,218,67,151,GXXXXXXXXXXXXXXXXXXXGXXXXXXXXXXXXXXXXXXXGXXXXXXXXXXXXXXXXXXXGXXXXXXXXXXXXXXXXXXXGXXXXXXXXXXXXXXXXXXXGXXXXXXXXXXXXXXXXXXXGXXXXXXXXXXXXXXXXXXXGXXXXXXXXXXXXXXXXXXXGXXXXXXXXXXXXXXXXXXXGXXXXXXXXXXXXXXXXXXXGXXXXXXXXXXXXXXXXXXXGXXXXXXXXXXXXXXXXXXXGXXXXXXXXXXXXXXXXXXX,0,300,0

6300,13,0,13,80,207,0,0,219,71,148,GXXXXXXXXXXXXXXXXXXXGXXXXXXXXXXXXXXXXXXXGXXXXXXXXXXXXXXXXXXXGXXXXXXXXXXXXXXXXXXXGXXXXXXXXXXXXXXXXXXXGXXXXXXXXXXXXXXXXXXXGXXXXXXXXXXXXXXXXXXXGXXXXXXXXXXXXXXXXXXXGXXXXXXXXXXXXXXXXXXXGXXXXXXXXXXXXXXXXXXXGXXXXXXXXXXXXXXXXXXXGXXXXXXXXXXXXXXXXXXXGXXXXXXXXXXXXXXXXXXX,0,300,0
6321,13,0,13,86,201,0,0,213,76,137,GXXXXXXXXXXXXXXXXXXXGXXXXXXXXXXXXXXXXXXXGXXXXXXXXXXXXXXXXXXXGXXXXXXXXXXXXXXXXXXXGXXXXXXXXXXXXXXXXXXXGXXXXXXXXXXXXXXXXXXXGXXXXXXXXXXXXXXXXXXXGXXXXXXXXXXXXXXXXXXXGXXXXXXXXXXXXXXXXXXXGXXXXXXXXXXXXXXXXXXXGXXXXXXXXXXXXXXXXXXXGXXXXXXXXXXXXXXXXXXXGXXXXXXXXXXXXXXXXXXX,0,300,0
6342,13,0,13,90,197,0,0,209,71,138,GXXXXXXXXXXXXXXXXXXXGXXXXXXXXXXXXXXXXXXXGXXXXXXXXXXXXXXXXXXXGXXXXXXXXXXXXXXXXXXXGXXXXXXXXXXXXXXXXXXXGXXXXXXXXXXXXXXXXXXXGXXXXXXXXXXXXXXXXXXXGXXXXXXXXXXXXXXXXXXXGXXXXXXXXXXXXXXXXXXXGXXXXXXXXXXXXXXXXXXXGXXXXXXXXXXXXXXXXXXXGXXXXXXXXXXXXXXXXXXXGXXXXXXXXXXXXXXXXXXX,0,300,0
6363,13,0,13,91,196,0,0,209,72,137,GXXXXXXXXXXXXXXXXXXXGXXXXXXXXXXXXXXXXXXXGXXXXXXXXXXXXXXXXXXXGXXXXXXXXXXXXXXXXXXXGXXXXXXXXXXXXXXXXXXXGXXXXXXXXXXXXXXXXXXXGXXXXXXXXXXXXXXXXXXXGXXXXXXXXXXXXXXXXXXXGXXXXXXXXXXXXXXXXXXXGXXXXXXXXXXXXXXXXXXXGXXXXXXXXXXXXXXXXXXXGXXXXXXXXXXXXXXXXXXXGXXXXXXXXXXXXXXXXXXX,0,300,0
6384,14,1,13,98,188,0,0,201,63,138,GXXXXXXXXXXXXXXXXXXXGXXXXXXXXXXXXXXXXXXXGXXXXXXXXXXXXXXXXXXXGXXXXXXXXXXXXXXXXXXXGXXXXXXXXXXXXXXXXXXXGXXXXXXXXXXXXXXXXXXXGXXXXXXXXXXXXXXXXXXXGXXXXXXXXXXXXXXXXXXXGXXXXXXXXXXXXXXXXXXXGXXXXXXXXXXXXXXXXXXXGXXXXXXXXXXXXXXXXXXXGXXXXXXXXXXXXXXXXXXXGAXXXXXXXXXXXXXXXXXX,0,300,0

6405,14,1,13,93,193,0,0,206,70,136,GXXXXXXXXXXXXXXXXXXXGXXXXXXXXXXXXXXXXXXXGXXXXXXXXXXXXXXXXXXXGXXXXXXXXXXXXXXXXXXXGXXXXXXXXXXXXXXXXXXXGXXXXXXXXXXXXXXXXXXXGXXXXXXXXXXXXXXXXXXXGXXXXXXXXXXXXXXXXXXXGXXXXXXXXXXXXXXXXXXXGXXXXXXXXXXXXXXXXXXXGXXXXXXXXXXXXXXXXXXXGXXXXXXXXXXXXXXXXXXXGAXXXXXXXXXXXXXXXXXX,0,300,0
6426,14,1,13,93,193,0,0,205,68,137,GXXXXXXXXXXXXXXXXXXXGXXXXXXXXXXXXXXXXXXXGXXXXXXXXXXXXXXXXXXXGXXXXXXXXXXXXXXXXXXXGXXXXXXXXXXXXXXXXXXXGXXXXXXXXXXXXXXXXXXXGXXXXXXXXXXXXXXXXXXXGXXXXXXXXXXXXXXXXXXXGXXXXXXXXXXXXXXXXXXXGXXXXXXXXXXXXXXXXXXXGXXXXXXXXXXXXXXXXXXXGXXXXXXXXXXXXXXXXXXXGAXXXXXXXXXXXXXXXXXX,0,300,0
6447,14,1,13,85,201,0,0,213,73,140,GXXXXXXXXXXXXXXXXXXXGXXXXXXXXXXXXXXXXXXXGXXXXXXXXXXXXXXXXXXXGXXXXXXXXXXXXXXXXXXXGXXXXXXXXXXXXXXXXXXXGXXXXXXXXXXXXXXXXXXXGXXXXXXXXXXXXXXXXXXXGXXXXXXXXXXXXXXXXXXXGXXXXXXXXXXXXXXXXXXXGXXXXXXXXXXXXXXXXXXXGXXXXXXXXXXXXXXXXXXXGXXXXXXXXXXXXXXXXXXXGAXXXXXXXXXXXXXXXXXX,0,300,0
6468,14,1,13,81,205,0,0,218,74,144,GXXXXXXXXXXXXXXXXXXXGXXXXXXXXXXXXXXXXXXXGXXXXXXXXXXXXXXXXXXXGXXXXXXXXXXXXXXXXXXXGXXXXXXXXXXXXXXXXXXXGXXXXXXXXXXXXXXXXXXXGXXXXXXXXXXXXXXXXXXXGXXXXXXXXXXXXXXXXXXXGXXXXXXXXXXXXXXXXXXXGXXXXXXXXXXXXXXXXXXXGXXXXXXXXXXXXXXXXXXXGXXXXXXXXXXXXXXXXXXXGAXXXXXXXXXXXXXXXXXX,0,300,0
6489,14,1,13,81,205,0,0,218,77,141,GXXXXXXXXXXXXXXXXXXXGXXXXXXXXXXXXXXXXXXXGXXXXXXXXXXXXXXXXXXXGXXXXXXXXXXXXXXXXXXXGXXXXXXXXXXXXXXXXXXXGXXXXXXXXXXXXXXXXXXXGXXXXXXXXXXXXXXXXXXXGXXXXXXXXXXXXXXXXXXXGXXXXXXXXXXXXXXXXXXXGXXXXXXXXXXXXXXXXXXXGXXXXXXXXXXXXXXXXXXXGXXXXXXXXXXXXXXXXXXXGAXXXXXXXXXXXXXXXXXX,0,300,0

6510,14,1,13,89,197,0,0,210,70,140,GXXXXXXXXXXXXXXXXXXXGXXXXXXXXXXXXXXXXXXXGXXXXXXXXXXXXXXXXXXXGXXXXXXXXXXXXXXXXXXXGXXXXXXXXXXXXXXXXXXXGXXXXXXXXXXXXXXXXXXXGXXXXXXXXXXXXXXXXXXXGXXXXXXXXXXXXXXXXXXXGXXXXXXXXXXXXXXXXXXXGXXXXXXXXXXXXXXXXXXXGXXXXXXXXXXXXXXXXXXXGXXXXXXXXXXXXXXXXXXXGAXXXXXXXXXXXXXXXXXX,0,300,0
6531,14,1,13,88,198,0,0,211,72,139,GXXXXXXXXXXXXXXXXXXXGXXXXXXXXXXXXXXXXXXXGXXXXXXXXXXXXXXXXXXXGXXXXXXXXXXXXXXXXXXXGXXXXXXXXXXXXXXXXXXXGXXXXXXXXXXXXXXXXXXXGXXXXXXXXXXXXXXXXXXXGXXXXXXXXXXXXXXXXXXXGXXXXXXXXXXXXXXXXXXXGXXXXXXXXXXXXXXXXXXXGXXXXXXXXXXXXXXXXXXXGXXXXXXXXXXXXXXXXXXXGAXXXXXXXXXXXXXXXXXX,0,300,0
6552,14,1,13,90,196,0,0,208,73,135,GXXXXXXXXXXXXXXXXXXXGXXXXXXXXXXXXXXXXXXXGXXXXXXXXXXXXXXXXXXXGXXXXXXXXXXXXXXXXXXXGXXXXXXXXXXXXXXXXXXXGXXXXXXXXXXXXXXXXXXXGXXXXXXXXXXXXXXXXXXXGXXXXXXXXXXXXXXXXXXXGXXXXXXXXXXXXXXXXXXXGXXXXXXXXXXXXXXXXXXXGXXXXXXXXXXXXXXXXXXXGXXXXXXXXXXXXXXXXXXXGAXXXXXXXXXXXXXXXXXX,0,300,0
6573,14,0,14,91,195,0,0,207,71,136,GXXXXXXXXXXXXXXXXXXXGXXXXXXXXXXXXXXXXXXXGXXXXXXXXXXXXXXXXXXXGXXXXXXXXXXXXXXXXXXXGXXXXXXXXXXXXXXXXXXXGXXXXXXXXXXXXXXXXXXXGXXXXXXXXXXXXXXXXXXXGXXXXXXXXXXXXXXXXXXXGXXXXXXXXXXXXXXXXXXXGXXXXXXXXXXXXXXXXXXXGXXXXXXXXXXXXXXXXXXXGXXXXXXXXXXXXXXXXXXXGOXXXXXXXXXXXXXXXXXX,0,300,0
6594,14,0,14,96,190,0,0,202,66,136,GXXXXXXXXXXXXXXXXXXXGXXXXXXXXXXXXXXXXXXXGXXXXXXXXXXXXXXXXXXXGXXXXXXXXXXXXXXXXXXXGXXXXXXXXXXXXXXXXXXXGXXXXXXXXXXXXXXXXXXXGXXXXXXXXXXXXXXXXXXXGXXXXXXXXXXXXXXXXXXXGXXXXXXXXXXXXXXXXXXXGXXXXXXXXXXXXXXXXXXXGXXXXXXXXXXXXXXXXXXXGXXXXXXXXXXXXXXXXXXXGOXXXXXXXXXXXXXXXXXX,0,300,0

6615,13,0,13,93,194,0,0,205,70,135,GXXXXXXXXXXXXXXXXXXXGXXXXXXXXXXXXXXXXXXXGXXXXXXXXXXXXXXXXXXXGXXXXXXXXXXXXXXXXXXXGXXXXXXXXXXXXXXXXXXXGXXXXXXXXXXXXXXXXXXXGXXXXXXXXXXXXXXXXXXXGXXXXXXXXXXXXXXXXXXXGXXXXXXXXXXXXXXXXXXXGXXXXXXXXXXXXXXXXXXXGXXXXXXXXXXXXXXXXXXXGXXXXXXXXXXXXXXXXXXXGXXXXXXXXXXXXXXXXXXX,0,300,0
6636,13,0,13,92,195,0,0,207,68,139,GXXXXXXXXXXXXXXXXXXXGXXXXXXXXXXXXXXXXXXXGXXXXXXXXXXXXXXXXXXXGXXXXXXXXXXXXXXXXXXXGXXXXXXXXXXXXXXXXXXXGXXXXXXXXXXXXXXXXXXXGXXXXXXXXXXXXXXXXXXXGXXXXXXXXXXXXXXXXXXXGXXXXXXXXXXXXXXXXXXXGXXXXXXXXXXXXXXXXXXXGXXXXXXXXXXXXXXXXXXXGXXXXXXXXXXXXXXXXXXXGXXXXXXXXXXXXXXXXXXX,0,300,0
6657,13,0,13,88,199,0,0,212,68,144,GXXXXXXXXXXXXXXXXXXXGXXXXXXXXXXXXXXXXXXXGXXXXXXXXXXXXXXXXXXXGXXXXXXXXXXXXXXXXXXXGXXXXXXXXXXXXXXXXXXXGXXXXXXXXXXXXXXXXXXXGXXXXXXXXXXXXXXXXXXXGXXXXXXXXXXXXXXXXXXXGXXXXXXXXXXXXXXXXXXXGXXXXXXXXXXXXXXXXXXXGXXXXXXXXXXXXXXXXXXXGXXXXXXXXXXXXXXXXXXXGXXXXXXXXXXXXXXXXXXX,0,300,0
6678,13,0,13,85,202,0,0,215,67,148,GXXXXXXXXXXXXXXXXXXXGXXXXXXXXXXXXXXXXXXXGXXXXXXXXXXXXXXXXXXXGXXXXXXXXXXXXXXXXXXXGXXXXXXXXXXXXXXXXXXXGXXXXXXXXXXXXXXXXXXXGXXXXXXXXXXXXXXXXXXXGXXXXXXXXXXXXXXXXXXXGXXXXXXXXXXXXXXXXXXXGXXXXXXXXXXXXXXXXXXXGXXXXXXXXXXXXXXXXXXXGXXXXXXXXXXXXXXXXXXXGXXXXXXXXXXXXXXXXXXX,0,300,0
6699,13,0,13,84,203,0,0,216,77,139,GXXXXXXXXXXXXXXXXXXXGXXXXXXXXXXXXXXXXXXXGXXXXXXXXXXXXXXXXXXXGXXXXXXXXXXXXXXXXXXXGXXXXXXXXXXXXXXXXXXXGXXXXXXXXXXXXXXXXXXXGXXXXXXXXXXXXXXXXXXXGXXXXXXXXXXXXXXXXXXXGXXXXXXXXXXXXXXXXXXXGXXXXXXXXXXXXXXXXXXXGXXXXXXXXXXXXXXXXXXXGXXXXXXXXXXXXXXXXXXXGXXXXXXXXXXXXXXXXXXX,0,300,0

6720,14,1,13,82,204,0,0,217,76,141,GXXXXXXXXXXXXXXXXXXXGXXXXXXXXXXXXXXXXXXXGXXXXXXXXXXXXXXXXXXXGXXXXXXXXXXXXXXXXXXXGXXXXXXXXXXXXXXXXXXXGXXXXXXXXXXXXXXXXXXXGXXXXXXXXXXXXXXXXXXXGAXXXXXXXXXXXXXXXXXXGXXXXXXXXXXXXXXXXXXXGXXXXXXXXXXXXXXXXXXXGXXXXXXXXXXXXXXXXXXXGXXXXXXXXXXXXXXXXXXXGXXXXXXXXXXXXXXXXXXX,0,300,0
6741,14,1,13,78,208,0,0,220,77,143,GXXXXXXXXXXXXXXXXXXXGXXXXXXXXXXXXXXXXXXXGXXXXXXXXXXXXXXXXXXXGXXXXXXXXXXXXXXXXXXXGXXXXXXXXXXXXXXXXXXXGXXXXXXXXXXXXXXXXXXXGXXXXXXXXXXXXXXXXXXXGAXXXXXXXXXXXXXXXXXXGXXXXXXXXXXXXXXXXXXXGXXXXXXXXXXXXXXXXXXXGXXXXXXXXXXXXXXXXXXXGXXXXXXXXXXXXXXXXXXXGXXXXXXXXXXXXXXXXXXX,0,300,0
6762,14,1,13,80,206,0,0,221,74,147,GXXXXXXXXXXXXXXXXXXXGXXXXXXXXXXXXXXXXXXXGXXXXXXXXXXXXXXXXXXXGXXXXXXXXXXXXXXXXXXXGXXXXXXXXXXXXXXXXXXXGXXXXXXXXXXXXXXXXXXXGXXXXXXXXXXXXXXXXXXXGAXXXXXXXXXXXXXXXXXXGXXXXXXXXXXXXXXXXXXXGXXXXXXXXXXXXXXXXXXXGXXXXXXXXXXXXXXXXXXXGXXXXXXXXXXXXXXXXXXXGXXXXXXXXXXXXXXXXXXX,0,300,0
6783,14,1,13,76,210,0,0,225,72,153,GXXXXXXXXXXXXXXXXXXXGXXXXXXXXXXXXXXXXXXXGXXXXXXXXXXXXXXXXXXXGXXXXXXXXXXXXXXXXXXXGXXXXXXXXXXXXXXXXXXXGXXXXXXXXXXXXXXXXXXXGXXXXXXXXXXXXXXXXXXXGAXXXXXXXXXXXXXXXXXXGXXXXXXXXXXXXXXXXXXXGXXXXXXXXXXXXXXXXXXXGXXXXXXXXXXXXXXXXXXXGXXXXXXXXXXXXXXXXXXXGXXXXXXXXXXXXXXXXXXX,0,300,0
6804,14,1,13,69,217,0,0,230,73,157,GXXXXXXXXXXXXXXXXXXXGXXXXXXXXXXXXXXXXXXXGXXXXXXXXXXXXXXXXXXXGXXXXXXXXXXXXXXXXXXXGXXXXXXXXXXXXXXXXXXXGXXXXXXXXXXXXXXXXXXXGXXXXXXXXXXXXXXXXXXXGAXXXXXXXXXXXXXXXXXXGXXXXXXXXXXXXXXXXXXXGXXXXXXXXXXXXXXXXXXXGXXXXXXXXXXXXXXXXXXXGXXXXXXXXXXXXXXXXXXXGXXXXXXXXXXXXXXXXXXX,0,300,0

6825,14,1,13,74,212,0,0,225,69,156,GXXXXXXXXXXXXXXXXXXXGXXXXXXXXXXXXXXXXXXXGXXXXXXXXXXXXXXXXXXXGXXXXXXXXXXXXXXXXXXXGXXXXXXXXXXXXXXXXXXXGXXXXXXXXXXXXXXXXXXXGXXXXXXXXXXXXXXXXXXXGAXXXXXXXXXXXXXXXXXXGXXXXXXXXXXXXXXXXXXXGXXXXXXXXXXXXXXXXXXXGXXXXXXXXXXXXXXXXXXXGXXXXXXXXXXXXXXXXXXXGXXXXXXXXXXXXXXXXXXX,0,300,0
6846,14,1,13,67,219,0,0,232,69,163,GXXXXXXXXXXXXXXXXXXXGXXXXXXXXXXXXXXXXXXXGXXXXXXXXXXXXXXXXXXXGXXXXXXXXXXXXXXXXXXXGXXXXXXXXXXXXXXXXXXXGXXXXXXXXXXXXXXXXXXXGXXXXXXXXXXXXXXXXXXXGAXXXXXXXXXXXXXXXXXXGXXXXXXXXXXXXXXXXXXXGXXXXXXXXXXXXXXXXXXXGXXXXXXXXXXXXXXXXXXXGXXXXXXXXXXXXXXXXXXXGXXXXXXXXXXXXXXXXXXX,0,300,0
6867,14,1,13,69,217,0,0,230,69,161,GXXXXXXXXXXXXXXXXXXXGXXXXXXXXXXXXXXXXXXXGXXXXXXXXXXXXXXXXXXXGXXXXXXXXXXXXXXXXXXXGXXXXXXXXXXXXXXXXXXXGXXXXXXXXXXXXXXXXXXXGXXXXXXXXXXXXXXXXXXXGAXXXXXXXXXXXXXXXXXXGXXXXXXXXXXXXXXXXXXXGXXXXXXXXXXXXXXXXXXXGXXXXXXXXXXXXXXXXXXXGXXXXXXXXXXXXXXXXXXXGXXXXXXXXXXXXXXXXXXX,0,300,0
6888,14,1,13,70,216,0,0,229,72,157,GXXXXXXXXXXXXXXXXXXXGXXXXXXXXXXXXXXXXXXXGXXXXXXXXXXXXXXXXXXXGXXXXXXXXXXXXXXXXXXXGXXXXXXXXXXXXXXXXXXXGXXXXXXXXXXXXXXXXXXXGXXXXXXXXXXXXXXXXXXXGAXXXXXXXXXXXXXXXXXXGXXXXXXXXXXXXXXXXXXXGXXXXXXXXXXXXXXXXXXXGXXXXXXXXXXXXXXXXXXXGXXXXXXXXXXXXXXXXXXXGXXXXXXXXXXXXXXXXXXX,0,300,0
6909,14,1,13,68,218,0,0,231,79,152,GXXXXXXXXXXXXXXXXXXXGXXXXXXXXXXXXXXXXXXXGXXXXXXXXXXXXXXXXXXXGXXXXXXXXXXXXXXXXXXXGXXXXXXXXXXXXXXXXXXXGXXXXXXXXXXXXXXXXXXXGXXXXXXXXXXXXXXXXXXXGAXXXXXXXXXXXXXXXXXXGXXXXXXXXXXXXXXXXXXXGXXXXXXXXXXXXXXXXXXXGXXXXXXXXXXXXXXXXXXXGXXXXXXXXXXXXXXXXXXXGXXXXXXXXXXXXXXXXXXX,0,300,0

6930,14,0,14,67,219,0,0,232,83,149,GXXXXXXXXXXXXXXXXXXXGXXXXXXXXXXXXXXXXXXXGXXXXXXXXXXXXXXXXXXXGXXXXXXXXXXXXXXXXXXXGXXXXXXXXXXXXXXXXXXXGXXXXXXXXXXXXXXXXXXXGXXXXXXXXXXXXXXXXXXXGOXXXXXXXXXXXXXXXXXXGXXXXXXXXXXXXXXXXXXXGXXXXXXXXXXXXXXXXXXXGXXXXXXXXXXXXXXXXXXXGXXXXXXXXXXXXXXXXXXXGXXXXXXXXXXXXXXXXXXX,0,300,0
6951,13,0,13,71,216,0,0,228,78,150,GXXXXXXXXXXXXXXXXXXXGXXXXXXXXXXXXXXXXXXXGXXXXXXXXXXXXXXXXXXXGXXXXXXXXXXXXXXXXXXXGXXXXXXXXXXXXXXXXXXXGXXXXXXXXXXXXXXXXXXXGXXXXXXXXXXXXXXXXXXXGXXXXXXXXXXXXXXXXXXXGXXXXXXXXXXXXXXXXXXXGXXXXXXXXXXXXXXXXXXXGXXXXXXXXXXXXXXXXXXXGXXXXXXXXXXXXXXXXXXXGXXXXXXXXXXXXXXXXXXX,0,300,0
6972,13,0,13,74,213,0,0,225,72,153,GXXXXXXXXXXXXXXXXXXXGXXXXXXXXXXXXXXXXXXXGXXXXXXXXXXXXXXXXXXXGXXXXXXXXXXXXXXXXXXXGXXXXXXXXXXXXXXXXXXXGXXXXXXXXXXXXXXXXXXXGXXXXXXXXXXXXXXXXXXXGXXXXXXXXXXXXXXXXXXXGXXXXXXXXXXXXXXXXXXXGXXXXXXXXXXXXXXXXXXXGXXXXXXXXXXXXXXXXXXXGXXXXXXXXXXXXXXXXXXXGXXXXXXXXXXXXXXXXXXX,0,300,0
6993,13,0,13,80,207,0,0,219,78,141,GXXXXXXXXXXXXXXXXXXXGXXXXXXXXXXXXXXXXXXXGXXXXXXXXXXXXXXXXXXXGXXXXXXXXXXXXXXXXXXXGXXXXXXXXXXXXXXXXXXXGXXXXXXXXXXXXXXXXXXXGXXXXXXXXXXXXXXXXXXXGXXXXXXXXXXXXXXXXXXXGXXXXXXXXXXXXXXXXXXXGXXXXXXXXXXXXXXXXXXXGXXXXXXXXXXXXXXXXXXXGXXXXXXXXXXXXXXXXXXXGXXXXXXXXXXXXXXXXXXX,0,300,0
7014,13,0,13,90,197,0,0,209,75,134,GXXXXXXXXXXXXXXXXXXXGXXXXXXXXXXXXXXXXXXXGXXXXXXXXXXXXXXXXXXXGXXXXXXXXXXXXXXXXXXXGXXXXXXXXXXXXXXXXXXXGXXXXXXXXXXXXXXXXXXXGXXXXXXXXXXXXXXXXXXXGXXXXXXXXXXXXXXXXXXXGXXXXXXXXXXXXXXXXXXXGXXXXXXXXXXXXXXXXXXXGXXXXXXXXXXXXXXXXXXXGXXXXXXXXXXXXXXXXXXXGXXXXXXXXXXXXXXXXXXX,0,300,0

7035,13,0,13,91,196,0,0,208,78,130,GXXXXXXXXXXXXXXXXXXXGXXXXXXXXXXXXXXXXXXXGXXXXXXXXXXXXXXXXXXXGXXXXXXXXXXXXXXXXXXXGXXXXXXXXXXXXXXXXXXXGXXXXXXXXXXXXXXXXXXXGXXXXXXXXXXXXXXXXXXXGXXXXXXXXXXXXXXXXXXXGXXXXXXXXXXXXXXXXXXXGXXXXXXXXXXXXXXXXXXXGXXXXXXXXXXXXXXXXXXXGXXXXXXXXXXXXXXXXXXXGXXXXXXXXXXXXXXXXXXX,0,300,0
7056,13,0,13,90,197,0,0,207,75,132,GXXXXXXXXXXXXXXXXXXXGXXXXXXXXXXXXXXXXXXXGXXXXXXXXXXXXXXXXXXXGXXXXXXXXXXXXXXXXXXXGXXXXXXXXXXXXXXXXXXXGXXXXXXXXXXXXXXXXXXXGXXXXXXXXXXXXXXXXXXXGXXXXXXXXXXXXXXXXXXXGXXXXXXXXXXXXXXXXXXXGXXXXXXXXXXXXXXXXXXXGXXXXXXXXXXXXXXXXXXXGXXXXXXXXXXXXXXXXXXXGXXXXXXXXXXXXXXXXXXX,0,300,0
7077,13,0,13,87,200,0,0,212,74,138,GXXXXXXXXXXXXXXXXXXXGXXXXXXXXXXXXXXXXXXXGXXXXXXXXXXXXXXXXXXXGXXXXXXXXXXXXXXXXXXXGXXXXXXXXXXXXXXXXXXXGXXXXXXXXXXXXXXXXXXXGXXXXXXXXXXXXXXXXXXXGXXXXXXXXXXXXXXXXXXXGXXXXXXXXXXXXXXXXXXXGXXXXXXXXXXXXXXXXXXXGXXXXXXXXXXXXXXXXXXXGXXXXXXXXXXXXXXXXXXXGXXXXXXXXXXXXXXXXXXX,0,300,0
7098,13,0,13,86,201,0,0,214,72,142,GXXXXXXXXXXXXXXXXXXXGXXXXXXXXXXXXXXXXXXXGXXXXXXXXXXXXXXXXXXXGXXXXXXXXXXXXXXXXXXXGXXXXXXXXXXXXXXXXXXXGXXXXXXXXXXXXXXXXXXXGXXXXXXXXXXXXXXXXXXXGXXXXXXXXXXXXXXXXXXXGXXXXXXXXXXXXXXXXXXXGXXXXXXXXXXXXXXXXXXXGXXXXXXXXXXXXXXXXXXXGXXXXXXXXXXXXXXXXXXXGXXXXXXXXXXXXXXXXXXX,0,300,0
7119,13,0,13,85,202,0,0,215,72,143,GXXXXXXXXXXXXXXXXXXXGXXXXXXXXXXXXXXXXXXXGXXXXXXXXXXXXXXXXXXXGXXXXXXXXXXXXXXXXXXXGXXXXXXXXXXXXXXXXXXXGXXXXXXXXXXXXXXXXXXXGXXXXXXXXXXXXXXXXXXXGXXXXXXXXXXXXXXXXXXXGXXXXXXXXXXXXXXXXXXXGXXXXXXXXXXXXXXXXXXXGXXXXXXXXXXXXXXXXXXXGXXXXXXXXXXXXXXXXXXXGXXXXXXXXXXXXXXXXXXX,0,300,0

7140,14,1,13,83,203,0,0,215,75,140,GXXXXXXXXXXXXXXXXXXXGXXXXXXXXXXXXXXXXXXXGXXXXXXXXXXXXXXXXXXXGXXXXXXXXXXXXXXXXXXXGXXXXXXXXXXXXXXXXXXXGXXXXXXXXXXXXXXXXXXXGAXXXXXXXXXXXXXXXXXXGXXXXXXXXXXXXXXXXXXXGXXXXXXXXXXXXXXXXXXXGXXXXXXXXXXXXXXXXXXXGXXXXXXXXXXXXXXXXXXXGXXXXXXXXXXXXXXXXXXXGXXXXXXXXXXXXXXXXXXX,0,300,0
7161,14,1,13,82,204,0,0,218,76,142,GXXXXXXXXXXXXXXXXXXXGXXXXXXXXXXXXXXXXXXXGXXXXXXXXXXXXXXXXXXXGXXXXXXXXXXXXXXXXXXXGXXXXXXXXXXXXXXXXXXXGXXXXXXXXXXXXXXXXXXXGAXXXXXXXXXXXXXXXXXXGXXXXXXXXXXXXXXXXXXXGXXXXXXXXXXXXXXXXXXXGXXXXXXXXXXXXXXXXXXXGXXXXXXXXXXXXXXXXXXXGXXXXXXXXXXXXXXXXXXXGXXXXXXXXXXXXXXXXXXX,0,300,0
7182,14,1,13,82,204,0,0,218,80,138,GXXXXXXXXXXXXXXXXXXXGXXXXXXXXXXXXXXXXXXXGXXXXXXXXXXXXXXXXXXXGXXXXXXXXXXXXXXXXXXXGXXXXXXXXXXXXXXXXXXXGXXXXXXXXXXXXXXXXXXXGAXXXXXXXXXXXXXXXXXXGXXXXXXXXXXXXXXXXXXXGXXXXXXXXXXXXXXXXXXXGXXXXXXXXXXXXXXXXXXXGXXXXXXXXXXXXXXXXXXXGXXXXXXXXXXXXXXXXXXXGXXXXXXXXXXXXXXXXXXX,0,300,0
7203,14,1,13,85,201,0,0,215,75,140,GXXXXXXXXXXXXXXXXXXXGXXXXXXXXXXXXXXXXXXXGXXXXXXXXXXXXXXXXXXXGXXXXXXXXXXXXXXXXXXXGXXXXXXXXXXXXXXXXXXXGXXXXXXXXXXXXXXXXXXXGAXXXXXXXXXXXXXXXXXXGXXXXXXXXXXXXXXXXXXXGXXXXXXXXXXXXXXXXXXXGXXXXXXXXXXXXXXXXXXXGXXXXXXXXXXXXXXXXXXXGXXXXXXXXXXXXXXXXXXXGXXXXXXXXXXXXXXXXXXX,0,300,0
7224,14,1,13,89,197,0,0,210,73,137,GXXXXXXXXXXXXXXXXXXXGXXXXXXXXXXXXXXXXXXXGXXXXXXXXXXXXXXXXXXXGXXXXXXXXXXXXXXXXXXXGXXXXXXXXXXXXXXXXXXXGXXXXXXXXXXXXXXXXXXXGAXXXXXXXXXXXXXXXXXXGXXXXXXXXXXXXXXXXXXXGXXXXXXXXXXXXXXXXXXXGXXXXXXXXXXXXXXXXXXXGXXXXXXXXXXXXXXXXXXXGXXXXXXXXXXXXXXXXXXXGXXXXXXXXXXXXXXXXXXX,0,300,0

7245,16,3,13,82,202,0,0,216,72,144,GAXXXXXXXXXXXXXXXXXXGXXXXXXXXXXXXXXXXXXXGXXXXXXXXXXXXXXXXXXXGXXXXXXXXXXXXXXXXXXXGXXXXXXXXXXXXXXXXXXXGXXXXXXXXXXXXXXXXXXXGAXXXXXXXXXXXXXXXXXXGXXXXXXXXXXXXXXXXXXXGXXXXXXXXXXXXXXXXXXXGXXXXXXXXXXXXXXXXXXXGXXXXXXXXXXXXXXXXXXXGAXXXXXXXXXXXXXXXXXXGXXXXXXXXXXXXXXXXXXX,0,300,0
7266,15,1,14,74,211,0,0,224,75,149,GOXXXXXXXXXXXXXXXXXXGXXXXXXXXXXXXXXXXXXXGXXXXXXXXXXXXXXXXXXXGXXXXXXXXXXXXXXXXXXXGXXXXXXXXXXXXXXXXXXXGXXXXXXXXXXXXXXXXXXXGXXXXXXXXXXXXXXXXXXXGXXXXXXXXXXXXXXXXXXXGXXXXXXXXXXXXXXXXXXXGXXXXXXXXXXXXXXXXXXXGXXXXXXXXXXXXXXXXXXXGAXXXXXXXXXXXXXXXXXXGXXXXXXXXXXXXXXXXXXX,0,300,0
7287,15,1,14,70,215,0,0,228,73,155,GOXXXXXXXXXXXXXXXXXXGXXXXXXXXXXXXXXXXXXXGXXXXXXXXXXXXXXXXXXXGXXXXXXXXXXXXXXXXXXXGXXXXXXXXXXXXXXXXXXXGXXXXXXXXXXXXXXXXXXXGXXXXXXXXXXXXXXXXXXXGXXXXXXXXXXXXXXXXXXXGXXXXXXXXXXXXXXXXXXXGXXXXXXXXXXXXXXXXXXXGXXXXXXXXXXXXXXXXXXXGAXXXXXXXXXXXXXXXXXXGXXXXXXXXXXXXXXXXXXX,0,300,0
7308,14,1,13,64,222,0,0,234,72,162,GXXXXXXXXXXXXXXXXXXXGXXXXXXXXXXXXXXXXXXXGXXXXXXXXXXXXXXXXXXXGXXXXXXXXXXXXXXXXXXXGXXXXXXXXXXXXXXXXXXXGXXXXXXXXXXXXXXXXXXXGXXXXXXXXXXXXXXXXXXXGXXXXXXXXXXXXXXXXXXXGXXXXXXXXXXXXXXXXXXXGXXXXXXXXXXXXXXXXXXXGXXXXXXXXXXXXXXXXXXXGAXXXXXXXXXXXXXXXXXXGXXXXXXXXXXXXXXXXXXX,0,300,0
7329,14,1,13,66,220,0,0,232,77,155,GXXXXXXXXXXXXXXXXXXXGXXXXXXXXXXXXXXXXXXXGXXXXXXXXXXXXXXXXXXXGXXXXXXXXXXXXXXXXXXXGXXXXXXXXXXXXXXXXXXXGXXXXXXXXXXXXXXXXXXXGXXXXXXXXXXXXXXXXXXXGXXXXXXXXXXXXXXXXXXXGXXXXXXXXXXXXXXXXXXXGXXXXXXXXXXXXXXXXXXXGXXXXXXXXXXXXXXXXXXXGAXXXXXXXXXXXXXXXXXXGXXXXXXXXXXXXXXXXXXX,0,300,0

7350,14,1,13,63,223,0,0,235,81,154,GXXXXXXXXXXXXXXXXXXXGXXXXXXXXXXXXXXXXXXXGXXXXXXXXXXXXXXXXXXXGXXXXXXXXXXXXXXXXXXXGXXXXXXXXXXXXXXXXXXXGXXXXXXXXXXXXXXXXXXXGXXXXXXXXXXXXXXXXXXXGXXXXXXXXXXXXXXXXXXXGXXXXXXXXXXXXXXXXXXXGXXXXXXXXXXXXXXXXXXXGXXXXXXXXXXXXXXXXXXXGAXXXXXXXXXXXXXXXXXXGXXXXXXXXXXXXXXXXXXX,0,300,0
7371,14,1,13,62,224,0,0,235,84,151,GXXXXXXXXXXXXXXXXXXXGXXXXXXXXXXXXXXXXXXXGXXXXXXXXXXXXXXXXXXXGXXXXXXXXXXXXXXXXXXXGXXXXXXXXXXXXXXXXXXXGXXXXXXXXXXXXXXXXXXXGXXXXXXXXXXXXXXXXXXXGXXXXXXXXXXXXXXXXXXXGXXXXXXXXXXXXXXXXXXXGXXXXXXXXXXXXXXXXXXXGXXXXXXXXXXXXXXXXXXXGAXXXXXXXXXXXXXXXXXXGXXXXXXXXXXXXXXXXXXX,0,300,0
7392,14,1,13,67,219,0,0,231,82,149,GXXXXXXXXXXXXXXXXXXXGXXXXXXXXXXXXXXXXXXXGXXXXXXXXXXXXXXXXXXXGXXXXXXXXXXXXXXXXXXXGXXXXXXXXXXXXXXXXXXXGXXXXXXXXXXXXXXXXXXXGXXXXXXXXXXXXXXXXXXXGXXXXXXXXXXXXXXXXXXXGXXXXXXXXXXXXXXXXXXXGXXXXXXXXXXXXXXXXXXXGXXXXXXXXXXXXXXXXXXXGAXXXXXXXXXXXXXXXXXXGXXXXXXXXXXXXXXXXXXX,0,300,0
7413,14,0,14,74,212,0,0,224,80,144,GXXXXXXXXXXXXXXXXXXXGXXXXXXXXXXXXXXXXXXXGXXXXXXXXXXXXXXXXXXXGXXXXXXXXXXXXXXXXXXXGXXXXXXXXXXXXXXXXXXXGXXXXXXXXXXXXXXXXXXXGXXXXXXXXXXXXXXXXXXXGXXXXXXXXXXXXXXXXXXXGXXXXXXXXXXXXXXXXXXXGXXXXXXXXXXXXXXXXXXXGXXXXXXXXXXXXXXXXXXXGOXXXXXXXXXXXXXXXXXXGXXXXXXXXXXXXXXXXXXX,0,300,0
7434,14,0,14,74,212,0,0,224,79,145,GXXXXXXXXXXXXXXXXXXXGXXXXXXXXXXXXXXXXXXXGXXXXXXXXXXXXXXXXXXXGXXXXXXXXXXXXXXXXXXXGXXXXXXXXXXXXXXXXXXXGXXXXXXXXXXXXXXXXXXXGXXXXXXXXXXXXXXXXXXXGXXXXXXXXXXXXXXXXXXXGXXXXXXXXXXXXXXXXXXXGXXXXXXXXXXXXXXXXXXXGXXXXXXXXXXXXXXXXXXXGOXXXXXXXXXXXXXXXXXXGXXXXXXXXXXXXXXXXXXX,0,300,0

7455,13,0,13,69,218,0,0,229,78,151,GXXXXXXXXXXXXXXXXXXXGXXXXXXXXXXXXXXXXXXXGXXXXXXXXXXXXXXXXXXXGXXXXXXXXXXXXXXXXXXXGXXXXXXXXXXXXXXXXXXXGXXXXXXXXXXXXXXXXXXXGXXXXXXXXXXXXXXXXXXXGXXXXXXXXXXXXXXXXXXXGXXXXXXXXXXXXXXXXXXXGXXXXXXXXXXXXXXXXXXXGXXXXXXXXXXXXXXXXXXXGXXXXXXXXXXXXXXXXXXXGXXXXXXXXXXXXXXXXXXX,0,300,0
7476,13,0,13,67,220,0,0,231,79,152,GXXXXXXXXXXXXXXXXXXXGXXXXXXXXXXXXXXXXXXXGXXXXXXXXXXXXXXXXXXXGXXXXXXXXXXXXXXXXXXXGXXXXXXXXXXXXXXXXXXXGXXXXXXXXXXXXXXXXXXXGXXXXXXXXXXXXXXXXXXXGXXXXXXXXXXXXXXXXXXXGXXXXXXXXXXXXXXXXXXXGXXXXXXXXXXXXXXXXXXXGXXXXXXXXXXXXXXXXXXXGXXXXXXXXXXXXXXXXXXXGXXXXXXXXXXXXXXXXXXX,0,300,0
7497,13,0,13,71,216,0,0,228,83,145,GXXXXXXXXXXXXXXXXXXXGXXXXXXXXXXXXXXXXXXXGXXXXXXXXXXXXXXXXXXXGXXXXXXXXXXXXXXXXXXXGXXXXXXXXXXXXXXXXXXXGXXXXXXXXXXXXXXXXXXXGXXXXXXXXXXXXXXXXXXXGXXXXXXXXXXXXXXXXXXXGXXXXXXXXXXXXXXXXXXXGXXXXXXXXXXXXXXXXXXXGXXXXXXXXXXXXXXXXXXXGXXXXXXXXXXXXXXXXXXXGXXXXXXXXXXXXXXXXXXX,0,300,0
7518,13,0,13,73,214,0,0,226,85,141,GXXXXXXXXXXXXXXXXXXXGXXXXXXXXXXXXXXXXXXXGXXXXXXXXXXXXXXXXXXXGXXXXXXXXXXXXXXXXXXXGXXXXXXXXXXXXXXXXXXXGXXXXXXXXXXXXXXXXXXXGXXXXXXXXXXXXXXXXXXXGXXXXXXXXXXXXXXXXXXXGXXXXXXXXXXXXXXXXXXXGXXXXXXXXXXXXXXXXXXXGXXXXXXXXXXXXXXXXXXXGXXXXXXXXXXXXXXXXXXXGXXXXXXXXXXXXXXXXXXX,0,300,0
7539,13,0,13,77,210,0,0,223,86,137,GXXXXXXXXXXXXXXXXXXXGXXXXXXXXXXXXXXXXXXXGXXXXXXXXXXXXXXXXXXXGXXXXXXXXXXXXXXXXXXXGXXXXXXXXXXXXXXXXXXXGXXXXXXXXXXXXXXXXXXXGXXXXXXXXXXXXXXXXXXXGXXXXXXXXXXXXXXXXXXXGXXXXXXXXXXXXXXXXXXXGXXXXXXXXXXXXXXXXXXXGXXXXXXXXXXXXXXXXXXXGXXXXXXXXXXXXXXXXXXXGXXXXXXXXXXXXXXXXXXX,0,300,0

7560,14,1,13,83,203,0,0,216,81,135,GXXXXXXXXXXXXXXXXXXXGXXXXXXXXXXXXXXXXXXXGXXXXXXXXXXXXXXXXXXXGXXXXXXXXXXXXXXXXXXXGXXXXXXXXXXXXXXXXXXXGXXXXXXXXXXXXXXXXXXXGXXXXXXXXXXXXXXXXXXXGXXXXXXXXXXXXXXXXXXXGXXXXXXXXXXXXXXXXXXXGXXXXXXXXXXXXXXXXXXXGAXXXXXXXXXXXXXXXXXXGXXXXXXXXXXXXXXXXXXXGXXXXXXXXXXXXXXXXXXX,0,300,0
7581,14,1,13,83,203,0,0,215,76,139,GXXXXXXXXXXXXXXXXXXXGXXXXXXXXXXXXXXXXXXXGXXXXXXXXXXXXXXXXXXXGXXXXXXXXXXXXXXXXXXXGXXXXXXXXXXXXXXXXXXXGXXXXXXXXXXXXXXXXXXXGXXXXXXXXXXXXXXXXXXXGXXXXXXXXXXXXXXXXXXXGXXXXXXXXXXXXXXXXXXXGXXXXXXXXXXXXXXXXXXXGAXXXXXXXXXXXXXXXXXXGXXXXXXXXXXXXXXXXXXXGXXXXXXXXXXXXXXXXXXX,0,300,0
7602,14,1,13,79,207,0,0,219,77,142,GXXXXXXXXXXXXXXXXXXXGXXXXXXXXXXXXXXXXXXXGXXXXXXXXXXXXXXXXXXXGXXXXXXXXXXXXXXXXXXXGXXXXXXXXXXXXXXXXXXXGXXXXXXXXXXXXXXXXXXXGXXXXXXXXXXXXXXXXXXXGXXXXXXXXXXXXXXXXXXXGXXXXXXXXXXXXXXXXXXXGXXXXXXXXXXXXXXXXXXXGAXXXXXXXXXXXXXXXXXXGXXXXXXXXXXXXXXXXXXXGXXXXXXXXXXXXXXXXXXX,0,300,0
7623,14,0,14,84,202,0,0,213,75,138,GXXXXXXXXXXXXXXXXXXXGXXXXXXXXXXXXXXXXXXXGXXXXXXXXXXXXXXXXXXXGXXXXXXXXXXXXXXXXXXXGXXXXXXXXXXXXXXXXXXXGXXXXXXXXXXXXXXXXXXXGXXXXXXXXXXXXXXXXXXXGXXXXXXXXXXXXXXXXXXXGXXXXXXXXXXXXXXXXXXXGXXXXXXXXXXXXXXXXXXXGOXXXXXXXXXXXXXXXXXXGXXXXXXXXXXXXXXXXXXXGXXXXXXXXXXXXXXXXXXX,0,300,0
7644,14,0,14,82,204,0,0,216,78,138,GXXXXXXXXXXXXXXXXXXXGXXXXXXXXXXXXXXXXXXXGXXXXXXXXXXXXXXXXXXXGXXXXXXXXXXXXXXXXXXXGXXXXXXXXXXXXXXXXXXXGXXXXXXXXXXXXXXXXXXXGXXXXXXXXXXXXXXXXXXXGXXXXXXXXXXXXXXXXXXXGXXXXXXXXXXXXXXXXXXXGXXXXXXXXXXXXXXXXXXXGOXXXXXXXXXXXXXXXXXXGXXXXXXXXXXXXXXXXXXXGXXXXXXXXXXXXXXXXXXX,0,300,0

7665,13,0,13,81,206,0,0,218,80,138,GXXXXXXXXXXXXXXXXXXXGXXXXXXXXXXXXXXXXXXXGXXXXXXXXXXXXXXXXXXXGXXXXXXXXXXXXXXXXXXXGXXXXXXXXXXXXXXXXXXXGXXXXXXXXXXXXXXXXXXXGXXXXXXXXXXXXXXXXXXXGXXXXXXXXXXXXXXXXXXXGXXXXXXXXXXXXXXXXXXXGXXXXXXXXXXXXXXXXXXXGXXXXXXXXXXXXXXXXXXXGXXXXXXXXXXXXXXXXXXXGXXXXXXXXXXXXXXXXXXX,0,300,0
7686,13,0,13,82,205,0,0,218,75,143,GXXXXXXXXXXXXXXXXXXXGXXXXXXXXXXXXXXXXXXXGXXXXXXXXXXXXXXXXXXXGXXXXXXXXXXXXXXXXXXXGXXXXXXXXXXXXXXXXXXXGXXXXXXXXXXXXXXXXXXXGXXXXXXXXXXXXXXXXXXXGXXXXXXXXXXXXXXXXXXXGXXXXXXXXXXXXXXXXXXXGXXXXXXXXXXXXXXXXXXXGXXXXXXXXXXXXXXXXXXXGXXXXXXXXXXXXXXXXXXXGXXXXXXXXXXXXXXXXXXX,0,300,0
7707,13,0,13,83,204,0,0,217,82,135,GXXXXXXXXXXXXXXXXXXXGXXXXXXXXXXXXXXXXXXXGXXXXXXXXXXXXXXXXXXXGXXXXXXXXXXXXXXXXXXXGXXXXXXXXXXXXXXXXXXXGXXXXXXXXXXXXXXXXXXXGXXXXXXXXXXXXXXXXXXXGXXXXXXXXXXXXXXXXXXXGXXXXXXXXXXXXXXXXXXXGXXXXXXXXXXXXXXXXXXXGXXXXXXXXXXXXXXXXXXXGXXXXXXXXXXXXXXXXXXXGXXXXXXXXXXXXXXXXXXX,0,300,0
7728,13,0,13,86,201,0,0,214,85,129,GXXXXXXXXXXXXXXXXXXXGXXXXXXXXXXXXXXXXXXXGXXXXXXXXXXXXXXXXXXXGXXXXXXXXXXXXXXXXXXXGXXXXXXXXXXXXXXXXXXXGXXXXXXXXXXXXXXXXXXXGXXXXXXXXXXXXXXXXXXXGXXXXXXXXXXXXXXXXXXXGXXXXXXXXXXXXXXXXXXXGXXXXXXXXXXXXXXXXXXXGXXXXXXXXXXXXXXXXXXXGXXXXXXXXXXXXXXXXXXXGXXXXXXXXXXXXXXXXXXX,0,300,0
7749,13,0,13,89,198,0,0,210,77,133,GXXXXXXXXXXXXXXXXXXXGXXXXXXXXXXXXXXXXXXXGXXXXXXXXXXXXXXXXXXXGXXXXXXXXXXXXXXXXXXXGXXXXXXXXXXXXXXXXXXXGXXXXXXXXXXXXXXXXXXXGXXXXXXXXXXXXXXXXXXXGXXXXXXXXXXXXXXXXXXXGXXXXXXXXXXXXXXXXXXXGXXXXXXXXXXXXXXXXXXXGXXXXXXXXXXXXXXXXXXXGXXXXXXXXXXXXXXXXXXXGXXXXXXXXXXXXXXXXXXX,0,300,0

7770,13,0,13,91,196,0,0,208,73,135,GXXXXXXXXXXXXXXXXXXXGXXXXXXXXXXXXXXXXXXXGXXXXXXXXXXXXXXXXXXXGXXXXXXXXXXXXXXXXXXXGXXXXXXXXXXXXXXXXXXXGXXXXXXXXXXXXXXXXXXXGXXXXXXXXXXXXXXXXXXXGXXXXXXXXXXXXXXXXXXXGXXXXXXXXXXXXXXXXXXXGXXXXXXXXXXXXXXXXXXXGXXXXXXXXXXXXXXXXXXXGXXXXXXXXXXXXXXXXXXXGXXXXXXXXXXXXXXXXXXX,0,300,0
7791,13,0,13,89,198,0,0,211,73,138,GXXXXXXXXXXXXXXXXXXXGXXXXXXXXXXXXXXXXXXXGXXXXXXXXXXXXXXXXXXXGXXXXXXXXXXXXXXXXXXXGXXXXXXXXXXXXXXXXXXXGXXXXXXXXXXXXXXXXXXXGXXXXXXXXXXXXXXXXXXXGXXXXXXXXXXXXXXXXXXXGXXXXXXXXXXXXXXXXXXXGXXXXXXXXXXXXXXXXXXXGXXXXXXXXXXXXXXXXXXXGXXXXXXXXXXXXXXXXXXXGXXXXXXXXXXXXXXXXXXX,0,300,0
7812,13,0,13,81,206,0,0,219,77,142,GXXXXXXXXXXXXXXXXXXXGXXXXXXXXXXXXXXXXXXXGXXXXXXXXXXXXXXXXXXXGXXXXXXXXXXXXXXXXXXXGXXXXXXXXXXXXXXXXXXXGXXXXXXXXXXXXXXXXXXXGXXXXXXXXXXXXXXXXXXXGXXXXXXXXXXXXXXXXXXXGXXXXXXXXXXXXXXXXXXXGXXXXXXXXXXXXXXXXXXXGXXXXXXXXXXXXXXXXXXXGXXXXXXXXXXXXXXXXXXXGXXXXXXXXXXXXXXXXXXX,0,300,0
7833,13,0,13,77,210,0,0,223,86,137,GXXXXXXXXXXXXXXXXXXXGXXXXXXXXXXXXXXXXXXXGXXXXXXXXXXXXXXXXXXXGXXXXXXXXXXXXXXXXXXXGXXXXXXXXXXXXXXXXXXXGXXXXXXXXXXXXXXXXXXXGXXXXXXXXXXXXXXXXXXXGXXXXXXXXXXXXXXXXXXXGXXXXXXXXXXXXXXXXXXXGXXXXXXXXXXXXXXXXXXXGXXXXXXXXXXXXXXXXXXXGXXXXXXXXXXXXXXXXXXXGXXXXXXXXXXXXXXXXXXX,0,300,0
7854,13,0,13,79,208,0,0,221,82,139,GXXXXXXXXXXXXXXXXXXXGXXXXXXXXXXXXXXXXXXXGXXXXXXXXXXXXXXXXXXXGXXXXXXXXXXXXXXXXXXXGXXXXXXXXXXXXXXXXXXXGXXXXXXXXXXXXXXXXXXXGXXXXXXXXXXXXXXXXXXXGXXXXXXXXXXXXXXXXXXXGXXXXXXXXXXXXXXXXXXXGXXXXXXXXXXXXXXXXXXXGXXXXXXXXXXXXXXXXXXXGXXXXXXXXXXXXXXXXXXXGXXXXXXXXXXXXXXXXXXX,0,300,0

7875,13,0,13,80,207,0,0,219,82,137,GXXXXXXXXXXXXXXXXXXXGXXXXXXXXXXXXXXXXXXXGXXXXXXXXXXXXXXXXXXXGXXXXXXXXXXXXXXXXXXXGXXXXXXXXXXXXXXXXXXXGXXXXXXXXXXXXXXXXXXXGXXXXXXXXXXXXXXXXXXXGXXXXXXXXXXXXXXXXXXXGXXXXXXXXXXXXXXXXXXXGXXXXXXXXXXXXXXXXXXXGXXXXXXXXXXXXXXXXXXXGXXXXXXXXXXXXXXXXXXXGXXXXXXXXXXXXXXXXXXX,0,300,0
7896,13,0,13,77,210,0,0,222,85,137,GXXXXXXXXXXXXXXXXXXXGXXXXXXXXXXXXXXXXXXXGXXXXXXXXXXXXXXXXXXXGXXXXXXXXXXXXXXXXXXXGXXXXXXXXXXXXXXXXXXXGXXXXXXXXXXXXXXXXXXXGXXXXXXXXXXXXXXXXXXXGXXXXXXXXXXXXXXXXXXXGXXXXXXXXXXXXXXXXXXXGXXXXXXXXXXXXXXXXXXXGXXXXXXXXXXXXXXXXXXXGXXXXXXXXXXXXXXXXXXXGXXXXXXXXXXXXXXXXXXX,0,300,0
7917,13,0,13,77,210,0,0,222,87,135,GXXXXXXXXXXXXXXXXXXXGXXXXXXXXXXXXXXXXXXXGXXXXXXXXXXXXXXXXXXXGXXXXXXXXXXXXXXXXXXXGXXXXXXXXXXXXXXXXXXXGXXXXXXXXXXXXXXXXXXXGXXXXXXXXXXXXXXXXXXXGXXXXXXXXXXXXXXXXXXXGXXXXXXXXXXXXXXXXXXXGXXXXXXXXXXXXXXXXXXXGXXXXXXXXXXXXXXXXXXXGXXXXXXXXXXXXXXXXXXXGXXXXXXXXXXXXXXXXXXX,0,300,0
7938,14,1,13,81,205,0,0,217,83,134,GXXXXXXXXXXXXXXXXXXXGXXXXXXXXXXXXXXXXXXXGXXXXXXXXXXXXXXXXXXXGXXXXXXXXXXXXXXXXXXXGXXXXXXXXXXXXXXXXXXXGAXXXXXXXXXXXXXXXXXXGXXXXXXXXXXXXXXXXXXXGXXXXXXXXXXXXXXXXXXXGXXXXXXXXXXXXXXXXXXXGXXXXXXXXXXXXXXXXXXXGXXXXXXXXXXXXXXXXXXXGXXXXXXXXXXXXXXXXXXXGXXXXXXXXXXXXXXXXXXX,0,300,0
7959,15,2,13,84,201,0,0,213,76,137,GXXXXXXXXXXXXXXXXXXXGXXXXXXXXXXXXXXXXXXXGXXXXXXXXXXXXXXXXXXXGXXXXXXXXXXXXXXXXXXXGXXXXXXXXXXXXXXXXXXXGAXXXXXXXXXXXXXXXXXXGXXXXXXXXXXXXXXXXXXXGXXXXXXXXXXXXXXXXXXXGXXXXXXXXXXXXXXXXXXXGAXXXXXXXXXXXXXXXXXXGXXXXXXXXXXXXXXXXXXXGXXXXXXXXXXXXXXXXXXXGXXXXXXXXXXXXXXXXXXX,0,300,0

7980,15,2,13,82,203,0,0,215,77,138,GXXXXXXXXXXXXXXXXXXXGXXXXXXXXXXXXXXXXXXXGXXXXXXXXXXXXXXXXXXXGXXXXXXXXXXXXXXXXXXXGXXXXXXXXXXXXXXXXXXXGAXXXXXXXXXXXXXXXXXXGXXXXXXXXXXXXXXXXXXXGXXXXXXXXXXXXXXXXXXXGXXXXXXXXXXXXXXXXXXXGAXXXXXXXXXXXXXXXXXXGXXXXXXXXXXXXXXXXXXXGXXXXXXXXXXXXXXXXXXXGXXXXXXXXXXXXXXXXXXX,0,300,0
8001,15,2,13,82,203,0,0,215,80,135,GXXXXXXXXXXXXXXXXXXXGXXXXXXXXXXXXXXXXXXXGXXXXXXXXXXXXXXXXXXXGXXXXXXXXXXXXXXXXXXXGXXXXXXXXXXXXXXXXXXXGAXXXXXXXXXXXXXXXXXXGXXXXXXXXXXXXXXXXXXXGXXXXXXXXXXXXXXXXXXXGXXXXXXXXXXXXXXXXXXXGAXXXXXXXXXXXXXXXXXXGXXXXXXXXXXXXXXXXXXXGXXXXXXXXXXXXXXXXXXXGXXXXXXXXXXXXXXXXXXX,0,300,0
8022,16,3,13,79,205,0,0,216,80,136,GXXXXXXXXXXXXXXXXXXXGXXXXXXXXXXXXXXXXXXXGXXXXXXXXXXXXXXXXXXXGXXXXXXXXXXXXXXXXXXXGAXXXXXXXXXXXXXXXXXXGAXXXXXXXXXXXXXXXXXXGXXXXXXXXXXXXXXXXXXXGXXXXXXXXXXXXXXXXXXXGXXXXXXXXXXXXXXXXXXXGAXXXXXXXXXXXXXXXXXXGXXXXXXXXXXXXXXXXXXXGXXXXXXXXXXXXXXXXXXXGXXXXXXXXXXXXXXXXXXX,0,300,0
8043,16,3,13,80,204,0,0,216,77,139,GXXXXXXXXXXXXXXXXXXXGXXXXXXXXXXXXXXXXXXXGXXXXXXXXXXXXXXXXXXXGXXXXXXXXXXXXXXXXXXXGAXXXXXXXXXXXXXXXXXXGAXXXXXXXXXXXXXXXXXXGXXXXXXXXXXXXXXXXXXXGXXXXXXXXXXXXXXXXXXXGXXXXXXXXXXXXXXXXXXXGAXXXXXXXXXXXXXXXXXXGXXXXXXXXXXXXXXXXXXXGXXXXXXXXXXXXXXXXXXXGXXXXXXXXXXXXXXXXXXX,0,300,0
8064,16,3,13,79,205,0,0,216,85,131,GXXXXXXXXXXXXXXXXXXXGXXXXXXXXXXXXXXXXXXXGXXXXXXXXXXXXXXXXXXXGXXXXXXXXXXXXXXXXXXXGAXXXXXXXXXXXXXXXXXXGAXXXXXXXXXXXXXXXXXXGXXXXXXXXXXXXXXXXXXXGXXXXXXXXXXXXXXXXXXXGXXXXXXXXXXXXXXXXXXXGAXXXXXXXXXXXXXXXXXXGXXXXXXXXXXXXXXXXXXXGXXXXXXXXXXXXXXXXXXXGXXXXXXXXXXXXXXXXXXX,0,300,0

8085,16,2,14,81,203,0,0,215,81,134,GXXXXXXXXXXXXXXXXXXXGXXXXXXXXXXXXXXXXXXXGXXXXXXXXXXXXXXXXXXXGXXXXXXXXXXXXXXXXXXXGAXXXXXXXXXXXXXXXXXXGOXXXXXXXXXXXXXXXXXXGXXXXXXXXXXXXXXXXXXXGXXXXXXXXXXXXXXXXXXXGXXXXXXXXXXXXXXXXXXXGAXXXXXXXXXXXXXXXXXXGXXXXXXXXXXXXXXXXXXXGXXXXXXXXXXXXXXXXXXXGXXXXXXXXXXXXXXXXXXX,0,300,0
8106,14,1,13,79,207,0,0,219,80,139,GXXXXXXXXXXXXXXXXXXXGXXXXXXXXXXXXXXXXXXXGXXXXXXXXXXXXXXXXXXXGXXXXXXXXXXXXXXXXXXXGXXXXXXXXXXXXXXXXXXXGXXXXXXXXXXXXXXXXXXXGXXXXXXXXXXXXXXXXXXXGXXXXXXXXXXXXXXXXXXXGXXXXXXXXXXXXXXXXXXXGAXXXXXXXXXXXXXXXXXXGXXXXXXXXXXXXXXXXXXXGXXXXXXXXXXXXXXXXXXXGXXXXXXXXXXXXXXXXXXX,0,300,0
8127,14,1,13,73,213,0,0,225,84,141,GXXXXXXXXXXXXXXXXXXXGXXXXXXXXXXXXXXXXXXXGXXXXXXXXXXXXXXXXXXXGXXXXXXXXXXXXXXXXXXXGXXXXXXXXXXXXXXXXXXXGXXXXXXXXXXXXXXXXXXXGXXXXXXXXXXXXXXXXXXXGXXXXXXXXXXXXXXXXXXXGXXXXXXXXXXXXXXXXXXXGAXXXXXXXXXXXXXXXXXXGXXXXXXXXXXXXXXXXXXXGXXXXXXXXXXXXXXXXXXXGXXXXXXXXXXXXXXXXXXX,0,300,0
8148,14,1,13,77,209,0,0,222,80,142,GXXXXXXXXXXXXXXXXXXXGXXXXXXXXXXXXXXXXXXXGXXXXXXXXXXXXXXXXXXXGXXXXXXXXXXXXXXXXXXXGXXXXXXXXXXXXXXXXXXXGXXXXXXXXXXXXXXXXXXXGXXXXXXXXXXXXXXXXXXXGXXXXXXXXXXXXXXXXXXXGXXXXXXXXXXXXXXXXXXXGAXXXXXXXXXXXXXXXXXXGXXXXXXXXXXXXXXXXXXXGXXXXXXXXXXXXXXXXXXXGXXXXXXXXXXXXXXXXXXX,0,300,0
8169,14,1,13,74,212,0,0,224,81,143,GXXXXXXXXXXXXXXXXXXXGXXXXXXXXXXXXXXXXXXXGXXXXXXXXXXXXXXXXXXXGXXXXXXXXXXXXXXXXXXXGXXXXXXXXXXXXXXXXXXXGXXXXXXXXXXXXXXXXXXXGXXXXXXXXXXXXXXXXXXXGXXXXXXXXXXXXXXXXXXXGXXXXXXXXXXXXXXXXXXXGAXXXXXXXXXXXXXXXXXXGXXXXXXXXXXXXXXXXXXXGXXXXXXXXXXXXXXXXXXXGXXXXXXXXXXXXXXXXXXX,0,300,0

8190,14,0,14,71,215,0,0,227,83,144,GXXXXXXXXXXXXXXXXXXXGXXXXXXXXXXXXXXXXXXXGXXXXXXXXXXXXXXXXXXXGXXXXXXXXXXXXXXXXXXXGXXXXXXXXXXXXXXXXXXXGXXXXXXXXXXXXXXXXXXXGXXXXXXXXXXXXXXXXXXXGXXXXXXXXXXXXXXXXXXXGXXXXXXXXXXXXXXXXXXXGOXXXXXXXXXXXXXXXXXXGXXXXXXXXXXXXXXXXXXXGXXXXXXXXXXXXXXXXXXXGXXXXXXXXXXXXXXXXXXX,0,300,0
8211,13,0,13,77,210,0,0,223,77,146,GXXXXXXXXXXXXXXXXXXXGXXXXXXXXXXXXXXXXXXXGXXXXXXXXXXXXXXXXXXXGXXXXXXXXXXXXXXXXXXXGXXXXXXXXXXXXXXXXXXXGXXXXXXXXXXXXXXXXXXXGXXXXXXXXXXXXXXXXXXXGXXXXXXXXXXXXXXXXXXXGXXXXXXXXXXXXXXXXXXXGXXXXXXXXXXXXXXXXXXXGXXXXXXXXXXXXXXXXXXXGXXXXXXXXXXXXXXXXXXXGXXXXXXXXXXXXXXXXXXX,0,300,0
8232,13,0,13,80,207,0,0,218,73,145,GXXXXXXXXXXXXXXXXXXXGXXXXXXXXXXXXXXXXXXXGXXXXXXXXXXXXXXXXXXXGXXXXXXXXXXXXXXXXXXXGXXXXXXXXXXXXXXXXXXXGXXXXXXXXXXXXXXXXXXXGXXXXXXXXXXXXXXXXXXXGXXXXXXXXXXXXXXXXXXXGXXXXXXXXXXXXXXXXXXXGXXXXXXXXXXXXXXXXXXXGXXXXXXXXXXXXXXXXXXXGXXXXXXXXXXXXXXXXXXXGXXXXXXXXXXXXXXXXXXX,0,300,0
8253,14,1,13,71,215,0,0,227,82,145,GAXXXXXXXXXXXXXXXXXXGXXXXXXXXXXXXXXXXXXXGXXXXXXXXXXXXXXXXXXXGXXXXXXXXXXXXXXXXXXXGXXXXXXXXXXXXXXXXXXXGXXXXXXXXXXXXXXXXXXXGXXXXXXXXXXXXXXXXXXXGXXXXXXXXXXXXXXXXXXXGXXXXXXXXXXXXXXXXXXXGXXXXXXXXXXXXXXXXXXXGXXXXXXXXXXXXXXXXXXXGXXXXXXXXXXXXXXXXXXXGXXXXXXXXXXXXXXXXXXX,0,300,0
8274,14,1,13,72,214,0,0,227,79,148,GAXXXXXXXXXXXXXXXXXXGXXXXXXXXXXXXXXXXXXXGXXXXXXXXXXXXXXXXXXXGXXXXXXXXXXXXXXXXXXXGXXXXXXXXXXXXXXXXXXXGXXXXXXXXXXXXXXXXXXXGXXXXXXXXXXXXXXXXXXXGXXXXXXXXXXXXXXXXXXXGXXXXXXXXXXXXXXXXXXXGXXXXXXXXXXXXXXXXXXXGXXXXXXXXXXXXXXXXXXXGXXXXXXXXXXXXXXXXXXXGXXXXXXXXXXXXXXXXXXX,0,300,0

8295,14,1,13,68,218,0,0,230,84,146,GAXXXXXXXXXXXXXXXXXXGXXXXXXXXXXXXXXXXXXXGXXXXXXXXXXXXXXXXXXXGXXXXXXXXXXXXXXXXXXXGXXXXXXXXXXXXXXXXXXXGXXXXXXXXXXXXXXXXXXXGXXXXXXXXXXXXXXXXXXXGXXXXXXXXXXXXXXXXXXXGXXXXXXXXXXXXXXXXXXXGXXXXXXXXXXXXXXXXXXXGXXXXXXXXXXXXXXXXXXXGXXXXXXXXXXXXXXXXXXXGXXXXXXXXXXXXXXXXXXX,0,300,0
8316,14,1,13,63,223,0,0,236,83,153,GAXXXXXXXXXXXXXXXXXXGXXXXXXXXXXXXXXXXXXXGXXXXXXXXXXXXXXXXXXXGXXXXXXXXXXXXXXXXXXXGXXXXXXXXXXXXXXXXXXXGXXXXXXXXXXXXXXXXXXXGXXXXXXXXXXXXXXXXXXXGXXXXXXXXXXXXXXXXXXXGXXXXXXXXXXXXXXXXXXXGXXXXXXXXXXXXXXXXXXXGXXXXXXXXXXXXXXXXXXXGXXXXXXXXXXXXXXXXXXXGXXXXXXXXXXXXXXXXXXX,0,300,0
8337,14,1,13,67,219,0,0,232,80,152,GAXXXXXXXXXXXXXXXXXXGXXXXXXXXXXXXXXXXXXXGXXXXXXXXXXXXXXXXXXXGXXXXXXXXXXXXXXXXXXXGXXXXXXXXXXXXXXXXXXXGXXXXXXXXXXXXXXXXXXXGXXXXXXXXXXXXXXXXXXXGXXXXXXXXXXXXXXXXXXXGXXXXXXXXXXXXXXXXXXXGXXXXXXXXXXXXXXXXXXXGXXXXXXXXXXXXXXXXXXXGXXXXXXXXXXXXXXXXXXXGXXXXXXXXXXXXXXXXXXX,0,300,0
8358,14,1,13,77,209,0,0,222,80,142,GAXXXXXXXXXXXXXXXXXXGXXXXXXXXXXXXXXXXXXXGXXXXXXXXXXXXXXXXXXXGXXXXXXXXXXXXXXXXXXXGXXXXXXXXXXXXXXXXXXXGXXXXXXXXXXXXXXXXXXXGXXXXXXXXXXXXXXXXXXXGXXXXXXXXXXXXXXXXXXXGXXXXXXXXXXXXXXXXXXXGXXXXXXXXXXXXXXXXXXXGXXXXXXXXXXXXXXXXXXXGXXXXXXXXXXXXXXXXXXXGXXXXXXXXXXXXXXXXXXX,0,300,0
8379,14,1,13,76,210,0,0,221,82,139,GAXXXXXXXXXXXXXXXXXXGXXXXXXXXXXXXXXXXXXXGXXXXXXXXXXXXXXXXXXXGXXXXXXXXXXXXXXXXXXXGXXXXXXXXXXXXXXXXXXXGXXXXXXXXXXXXXXXXXXXGXXXXXXXXXXXXXXXXXXXGXXXXXXXXXXXXXXXXXXXGXXXXXXXXXXXXXXXXXXXGXXXXXXXXXXXXXXXXXXXGXXXXXXXXXXXXXXXXXXXGXXXXXXXXXXXXXXXXXXXGXXXXXXXXXXXXXXXXXXX,0,300,0

8400,14,1,13,80,206,0,0,219,79,140,GAXXXXXXXXXXXXXXXXXXGXXXXXXXXXXXXXXXXXXXGXXXXXXXXXXXXXXXXXXXGXXXXXXXXXXXXXXXXXXXGXXXXXXXXXXXXXXXXXXXGXXXXXXXXXXXXXXXXXXXGXXXXXXXXXXXXXXXXXXXGXXXXXXXXXXXXXXXXXXXGXXXXXXXXXXXXXXXXXXXGXXXXXXXXXXXXXXXXXXXGXXXXXXXXXXXXXXXXXXXGXXXXXXXXXXXXXXXXXXXGXXXXXXXXXXXXXXXXXXX,0,300,0
8421,14,1,13,85,201,0,0,213,83,130,GAXXXXXXXXXXXXXXXXXXGXXXXXXXXXXXXXXXXXXXGXXXXXXXXXXXXXXXXXXXGXXXXXXXXXXXXXXXXXXXGXXXXXXXXXXXXXXXXXXXGXXXXXXXXXXXXXXXXXXXGXXXXXXXXXXXXXXXXXXXGXXXXXXXXXXXXXXXXXXXGXXXXXXXXXXXXXXXXXXXGXXXXXXXXXXXXXXXXXXXGXXXXXXXXXXXXXXXXXXXGXXXXXXXXXXXXXXXXXXXGXXXXXXXXXXXXXXXXXXX,0,300,0
8442,14,1,13,86,200,0,0,212,83,129,GAXXXXXXXXXXXXXXXXXXGXXXXXXXXXXXXXXXXXXXGXXXXXXXXXXXXXXXXXXXGXXXXXXXXXXXXXXXXXXXGXXXXXXXXXXXXXXXXXXXGXXXXXXXXXXXXXXXXXXXGXXXXXXXXXXXXXXXXXXXGXXXXXXXXXXXXXXXXXXXGXXXXXXXXXXXXXXXXXXXGXXXXXXXXXXXXXXXXXXXGXXXXXXXXXXXXXXXXXXXGXXXXXXXXXXXXXXXXXXXGXXXXXXXXXXXXXXXXXXX,0,300,0
8463,14,1,13,83,203,0,0,214,86,128,GAXXXXXXXXXXXXXXXXXXGXXXXXXXXXXXXXXXXXXXGXXXXXXXXXXXXXXXXXXXGXXXXXXXXXXXXXXXXXXXGXXXXXXXXXXXXXXXXXXXGXXXXXXXXXXXXXXXXXXXGXXXXXXXXXXXXXXXXXXXGXXXXXXXXXXXXXXXXXXXGXXXXXXXXXXXXXXXXXXXGXXXXXXXXXXXXXXXXXXXGXXXXXXXXXXXXXXXXXXXGXXXXXXXXXXXXXXXXXXXGXXXXXXXXXXXXXXXXXXX,0,300,0
8484,14,1,13,89,197,0,0,209,82,127,GAXXXXXXXXXXXXXXXXXXGXXXXXXXXXXXXXXXXXXXGXXXXXXXXXXXXXXXXXXXGXXXXXXXXXXXXXXXXXXXGXXXXXXXXXXXXXXXXXXXGXXXXXXXXXXXXXXXXXXXGXXXXXXXXXXXXXXXXXXXGXXXXXXXXXXXXXXXXXXXGXXXXXXXXXXXXXXXXXXXGXXXXXXXXXXXXXXXXXXXGXXXXXXXXXXXXXXXXXXXGXXXXXXXXXXXXXXXXXXXGXXXXXXXXXXXXXXXXXXX,0,300,0

8505,14,1,13,89,197,0,0,209,82,127,GAXXXXXXXXXXXXXXXXXXGXXXXXXXXXXXXXXXXXXXGXXXXXXXXXXXXXXXXXXXGXXXXXXXXXXXXXXXXXXXGXXXXXXXXXXXXXXXXXXXGXXXXXXXXXXXXXXXXXXXGXXXXXXXXXXXXXXXXXXXGXXXXXXXXXXXXXXXXXXXGXXXXXXXXXXXXXXXXXXXGXXXXXXXXXXXXXXXXXXXGXXXXXXXXXXXXXXXXXXXGXXXXXXXXXXXXXXXXXXXGXXXXXXXXXXXXXXXXXXX,0,300,0
8526,14,0,14,91,195,0,0,206,80,126,GOXXXXXXXXXXXXXXXXXXGXXXXXXXXXXXXXXXXXXXGXXXXXXXXXXXXXXXXXXXGXXXXXXXXXXXXXXXXXXXGXXXXXXXXXXXXXXXXXXXGXXXXXXXXXXXXXXXXXXXGXXXXXXXXXXXXXXXXXXXGXXXXXXXXXXXXXXXXXXXGXXXXXXXXXXXXXXXXXXXGXXXXXXXXXXXXXXXXXXXGXXXXXXXXXXXXXXXXXXXGXXXXXXXXXXXXXXXXXXXGXXXXXXXXXXXXXXXXXXX,0,300,0
8547,14,0,14,93,193,0,0,205,84,121,GOXXXXXXXXXXXXXXXXXXGXXXXXXXXXXXXXXXXXXXGXXXXXXXXXXXXXXXXXXXGXXXXXXXXXXXXXXXXXXXGXXXXXXXXXXXXXXXXXXXGXXXXXXXXXXXXXXXXXXXGXXXXXXXXXXXXXXXXXXXGXXXXXXXXXXXXXXXXXXXGXXXXXXXXXXXXXXXXXXXGXXXXXXXXXXXXXXXXXXXGXXXXXXXXXXXXXXXXXXXGXXXXXXXXXXXXXXXXXXXGXXXXXXXXXXXXXXXXXXX,0,300,0
8568,14,1,13,92,194,0,0,206,80,126,GXXXXXXXXXXXXXXXXXXXGXXXXXXXXXXXXXXXXXXXGXXXXXXXXXXXXXXXXXXXGXXXXXXXXXXXXXXXXXXXGXXXXXXXXXXXXXXXXXXXGXXXXXXXXXXXXXXXXXXXGXXXXXXXXXXXXXXXXXXXGXXXXXXXXXXXXXXXXXXXGXXXXXXXXXXXXXXXXXXXGXXXXXXXXXXXXXXXXXXXGXXXXXXXXXXXXXXXXXXXGAXXXXXXXXXXXXXXXXXXGXXXXXXXXXXXXXXXXXXX,0,300,0
8589,14,1,13,88,198,0,0,210,85,125,GXXXXXXXXXXXXXXXXXXXGXXXXXXXXXXXXXXXXXXXGXXXXXXXXXXXXXXXXXXXGXXXXXXXXXXXXXXXXXXXGXXXXXXXXXXXXXXXXXXXGXXXXXXXXXXXXXXXXXXXGXXXXXXXXXXXXXXXXXXXGXXXXXXXXXXXXXXXXXXXGXXXXXXXXXXXXXXXXXXXGXXXXXXXXXXXXXXXXXXXGXXXXXXXXXXXXXXXXXXXGAXXXXXXXXXXXXXXXXXXGXXXXXXXXXXXXXXXXXXX,0,300,0

8610,14,1,13,89,197,0,0,209,84,125,GXXXXXXXXXXXXXXXXXXXGXXXXXXXXXXXXXXXXXXXGXXXXXXXXXXXXXXXXXXXGXXXXXXXXXXXXXXXXXXXGXXXXXXXXXXXXXXXXXXXGXXXXXXXXXXXXXXXXXXXGXXXXXXXXXXXXXXXXXXXGXXXXXXXXXXXXXXXXXXXGXXXXXXXXXXXXXXXXXXXGXXXXXXXXXXXXXXXXXXXGXXXXXXXXXXXXXXXXXXXGAXXXXXXXXXXXXXXXXXXGXXXXXXXXXXXXXXXXXXX,0,300,0
8631,14,1,13,86,200,0,0,212,82,130,GXXXXXXXXXXXXXXXXXXXGXXXXXXXXXXXXXXXXXXXGXXXXXXXXXXXXXXXXXXXGXXXXXXXXXXXXXXXXXXXGXXXXXXXXXXXXXXXXXXXGXXXXXXXXXXXXXXXXXXXGXXXXXXXXXXXXXXXXXXXGXXXXXXXXXXXXXXXXXXXGXXXXXXXXXXXXXXXXXXXGXXXXXXXXXXXXXXXXXXXGXXXXXXXXXXXXXXXXXXXGAXXXXXXXXXXXXXXXXXXGXXXXXXXXXXXXXXXXXXX,0,300,0
8652,13,0,13,87,200,0,0,212,78,134,GXXXXXXXXXXXXXXXXXXXGXXXXXXXXXXXXXXXXXXXGXXXXXXXXXXXXXXXXXXXGXXXXXXXXXXXXXXXXXXXGXXXXXXXXXXXXXXXXXXXGXXXXXXXXXXXXXXXXXXXGXXXXXXXXXXXXXXXXXXXGXXXXXXXXXXXXXXXXXXXGXXXXXXXXXXXXXXXXXXXGXXXXXXXXXXXXXXXXXXXGXXXXXXXXXXXXXXXXXXXGXXXXXXXXXXXXXXXXXXXGXXXXXXXXXXXXXXXXXXX,0,300,0
8673,13,0,13,84,203,0,0,215,81,134,GXXXXXXXXXXXXXXXXXXXGXXXXXXXXXXXXXXXXXXXGXXXXXXXXXXXXXXXXXXXGXXXXXXXXXXXXXXXXXXXGXXXXXXXXXXXXXXXXXXXGXXXXXXXXXXXXXXXXXXXGXXXXXXXXXXXXXXXXXXXGXXXXXXXXXXXXXXXXXXXGXXXXXXXXXXXXXXXXXXXGXXXXXXXXXXXXXXXXXXXGXXXXXXXXXXXXXXXXXXXGXXXXXXXXXXXXXXXXXXXGXXXXXXXXXXXXXXXXXXX,0,300,0
8694,14,1,13,76,210,0,0,222,84,138,GXXXXXXXXXXXXXXXXXXXGXXXXXXXXXXXXXXXXXXXGXXXXXXXXXXXXXXXXXXXGAXXXXXXXXXXXXXXXXXXGXXXXXXXXXXXXXXXXXXXGXXXXXXXXXXXXXXXXXXXGXXXXXXXXXXXXXXXXXXXGXXXXXXXXXXXXXXXXXXXGXXXXXXXXXXXXXXXXXXXGXXXXXXXXXXXXXXXXXXXGXXXXXXXXXXXXXXXXXXXGXXXXXXXXXXXXXXXXXXXGXXXXXXXXXXXXXXXXXXX,0,300,0

8715,14,1,13,75,211,0,0,222,86,136,GXXXXXXXXXXXXXXXXXXXGXXXXXXXXXXXXXXXXXXXGXXXXXXXXXXXXXXXXXXXGAXXXXXXXXXXXXXXXXXXGXXXXXXXXXXXXXXXXXXXGXXXXXXXXXXXXXXXXXXXGXXXXXXXXXXXXXXXXXXXGXXXXXXXXXXXXXXXXXXXGXXXXXXXXXXXXXXXXXXXGXXXXXXXXXXXXXXXXXXXGXXXXXXXXXXXXXXXXXXXGXXXXXXXXXXXXXXXXXXXGXXXXXXXXXXXXXXXXXXX,0,300,0
8736,15,2,13,82,203,0,0,215,85,130,GXXXXXXXXXXXXXXXXXXXGXXXXXXXXXXXXXXXXXXXGXXXXXXXXXXXXXXXXXXXGAXXXXXXXXXXXXXXXXXXGXXXXXXXXXXXXXXXXXXXGXXXXXXXXXXXXXXXXXXXGXXXXXXXXXXXXXXXXXXXGAXXXXXXXXXXXXXXXXXXGXXXXXXXXXXXXXXXXXXXGXXXXXXXXXXXXXXXXXXXGXXXXXXXXXXXXXXXXXXXGXXXXXXXXXXXXXXXXXXXGXXXXXXXXXXXXXXXXXXX,0,300,0
8757,15,2,13,79,206,0,0,218,84,134,GXXXXXXXXXXXXXXXXXXXGXXXXXXXXXXXXXXXXXXXGXXXXXXXXXXXXXXXXXXXGAXXXXXXXXXXXXXXXXXXGXXXXXXXXXXXXXXXXXXXGXXXXXXXXXXXXXXXXXXXGXXXXXXXXXXXXXXXXXXXGAXXXXXXXXXXXXXXXXXXGXXXXXXXXXXXXXXXXXXXGXXXXXXXXXXXXXXXXXXXGXXXXXXXXXXXXXXXXXXXGXXXXXXXXXXXXXXXXXXXGXXXXXXXXXXXXXXXXXXX,0,300,0
8778,15,2,13,82,203,0,0,215,78,137,GXXXXXXXXXXXXXXXXXXXGXXXXXXXXXXXXXXXXXXXGXXXXXXXXXXXXXXXXXXXGAXXXXXXXXXXXXXXXXXXGXXXXXXXXXXXXXXXXXXXGXXXXXXXXXXXXXXXXXXXGXXXXXXXXXXXXXXXXXXXGAXXXXXXXXXXXXXXXXXXGXXXXXXXXXXXXXXXXXXXGXXXXXXXXXXXXXXXXXXXGXXXXXXXXXXXXXXXXXXXGXXXXXXXXXXXXXXXXXXXGXXXXXXXXXXXXXXXXXXX,0,300,0
8799,15,2,13,78,207,0,0,220,77,143,GXXXXXXXXXXXXXXXXXXXGXXXXXXXXXXXXXXXXXXXGXXXXXXXXXXXXXXXXXXXGAXXXXXXXXXXXXXXXXXXGXXXXXXXXXXXXXXXXXXXGXXXXXXXXXXXXXXXXXXXGXXXXXXXXXXXXXXXXXXXGAXXXXXXXXXXXXXXXXXXGXXXXXXXXXXXXXXXXXXXGXXXXXXXXXXXXXXXXXXXGXXXXXXXXXXXXXXXXXXXGXXXXXXXXXXXXXXXXXXXGXXXXXXXXXXXXXXXXXXX,0,300,0

8820,15,2,13,78,207,0,0,220,80,140,GXXXXXXXXXXXXXXXXXXXGXXXXXXXXXXXXXXXXXXXGXXXXXXXXXXXXXXXXXXXGAXXXXXXXXXXXXXXXXXXGXXXXXXXXXXXXXXXXXXXGXXXXXXXXXXXXXXXXXXXGXXXXXXXXXXXXXXXXXXXGAXXXXXXXXXXXXXXXXXXGXXXXXXXXXXXXXXXXXXXGXXXXXXXXXXXXXXXXXXXGXXXXXXXXXXXXXXXXXXXGXXXXXXXXXXXXXXXXXXXGXXXXXXXXXXXXXXXXXXX,0,300,0
8841,16,3,13,81,203,0,0,216,80,136,GXXXXXXXXXXXXXXXXXXXGXXXXXXXXXXXXXXXXXXXGXXXXXXXXXXXXXXXXXXXGAXXXXXXXXXXXXXXXXXXGXXXXXXXXXXXXXXXXXXXGXXXXXXXXXXXXXXXXXXXGAXXXXXXXXXXXXXXXXXXGAXXXXXXXXXXXXXXXXXXGXXXXXXXXXXXXXXXXXXXGXXXXXXXXXXXXXXXXXXXGXXXXXXXXXXXXXXXXXXXGXXXXXXXXXXXXXXXXXXXGXXXXXXXXXXXXXXXXXXX,0,300,0
8862,16,3,13,78,206,0,0,219,84,135,GXXXXXXXXXXXXXXXXXXXGXXXXXXXXXXXXXXXXXXXGXXXXXXXXXXXXXXXXXXXGAXXXXXXXXXXXXXXXXXXGXXXXXXXXXXXXXXXXXXXGXXXXXXXXXXXXXXXXXXXGAXXXXXXXXXXXXXXXXXXGAXXXXXXXXXXXXXXXXXXGXXXXXXXXXXXXXXXXXXXGXXXXXXXXXXXXXXXXXXXGXXXXXXXXXXXXXXXXXXXGXXXXXXXXXXXXXXXXXXXGXXXXXXXXXXXXXXXXXXX,0,300,0
8883,16,2,14,77,207,0,0,219,77,142,GXXXXXXXXXXXXXXXXXXXGXXXXXXXXXXXXXXXXXXXGXXXXXXXXXXXXXXXXXXXGOXXXXXXXXXXXXXXXXXXGXXXXXXXXXXXXXXXXXXXGXXXXXXXXXXXXXXXXXXXGAXXXXXXXXXXXXXXXXXXGAXXXXXXXXXXXXXXXXXXGXXXXXXXXXXXXXXXXXXXGXXXXXXXXXXXXXXXXXXXGXXXXXXXXXXXXXXXXXXXGXXXXXXXXXXXXXXXXXXXGXXXXXXXXXXXXXXXXXXX,0,300,0
8904,15,2,13,82,203,0,0,215,75,140,GXXXXXXXXXXXXXXXXXXXGXXXXXXXXXXXXXXXXXXXGXXXXXXXXXXXXXXXXXXXGXXXXXXXXXXXXXXXXXXXGXXXXXXXXXXXXXXXXXXXGXXXXXXXXXXXXXXXXXXXGAXXXXXXXXXXXXXXXXXXGAXXXXXXXXXXXXXXXXXXGXXXXXXXXXXXXXXXXXXXGXXXXXXXXXXXXXXXXXXXGXXXXXXXXXXXXXXXXXXXGXXXXXXXXXXXXXXXXXXXGXXXXXXXXXXXXXXXXXXX,0,300,0

8925,15,2,13,81,204,0,0,216,80,136,GXXXXXXXXXXXXXXXXXXXGXXXXXXXXXXXXXXXXXXXGXXXXXXXXXXXXXXXXXXXGXXXXXXXXXXXXXXXXXXXGXXXXXXXXXXXXXXXXXXXGXXXXXXXXXXXXXXXXXXXGAXXXXXXXXXXXXXXXXXXGAXXXXXXXXXXXXXXXXXXGXXXXXXXXXXXXXXXXXXXGXXXXXXXXXXXXXXXXXXXGXXXXXXXXXXXXXXXXXXXGXXXXXXXXXXXXXXXXXXXGXXXXXXXXXXXXXXXXXXX,0,300,0
8946,15,2,13,81,204,0,0,216,83,133,GXXXXXXXXXXXXXXXXXXXGXXXXXXXXXXXXXXXXXXXGXXXXXXXXXXXXXXXXXXXGXXXXXXXXXXXXXXXXXXXGXXXXXXXXXXXXXXXXXXXGXXXXXXXXXXXXXXXXXXXGAXXXXXXXXXXXXXXXXXXGAXXXXXXXXXXXXXXXXXXGXXXXXXXXXXXXXXXXXXXGXXXXXXXXXXXXXXXXXXXGXXXXXXXXXXXXXXXXXXXGXXXXXXXXXXXXXXXXXXXGXXXXXXXXXXXXXXXXXXX,0,300,0
8967,15,1,14,77,208,0,0,220,85,135,GXXXXXXXXXXXXXXXXXXXGXXXXXXXXXXXXXXXXXXXGXXXXXXXXXXXXXXXXXXXGXXXXXXXXXXXXXXXXXXXGXXXXXXXXXXXXXXXXXXXGXXXXXXXXXXXXXXXXXXXGAXXXXXXXXXXXXXXXXXXGOXXXXXXXXXXXXXXXXXXGXXXXXXXXXXXXXXXXXXXGXXXXXXXXXXXXXXXXXXXGXXXXXXXXXXXXXXXXXXXGXXXXXXXXXXXXXXXXXXXGXXXXXXXXXXXXXXXXXXX,0,300,0
8988,16,2,14,73,211,0,0,223,87,136,GXXXXXXXXXXXXXXXXXXXGAXXXXXXXXXXXXXXXXXXGXXXXXXXXXXXXXXXXXXXGXXXXXXXXXXXXXXXXXXXGXXXXXXXXXXXXXXXXXXXGXXXXXXXXXXXXXXXXXXXGAXXXXXXXXXXXXXXXXXXGOXXXXXXXXXXXXXXXXXXGXXXXXXXXXXXXXXXXXXXGXXXXXXXXXXXXXXXXXXXGXXXXXXXXXXXXXXXXXXXGXXXXXXXXXXXXXXXXXXXGXXXXXXXXXXXXXXXXXXX,0,300,0
9009,15,2,13,76,209,0,0,221,85,136,GXXXXXXXXXXXXXXXXXXXGAXXXXXXXXXXXXXXXXXXGXXXXXXXXXXXXXXXXXXXGXXXXXXXXXXXXXXXXXXXGXXXXXXXXXXXXXXXXXXXGXXXXXXXXXXXXXXXXXXXGAXXXXXXXXXXXXXXXXXXGXXXXXXXXXXXXXXXXXXXGXXXXXXXXXXXXXXXXXXXGXXXXXXXXXXXXXXXXXXXGXXXXXXXXXXXXXXXXXXXGXXXXXXXXXXXXXXXXXXXGXXXXXXXXXXXXXXXXXXX,0,300,0

9030,15,2,13,80,205,0,0,216,88,128,GXXXXXXXXXXXXXXXXXXXGAXXXXXXXXXXXXXXXXXXGXXXXXXXXXXXXXXXXXXXGXXXXXXXXXXXXXXXXXXXGXXXXXXXXXXXXXXXXXXXGXXXXXXXXXXXXXXXXXXXGAXXXXXXXXXXXXXXXXXXGXXXXXXXXXXXXXXXXXXXGXXXXXXXXXXXXXXXXXXXGXXXXXXXXXXXXXXXXXXXGXXXXXXXXXXXXXXXXXXXGXXXXXXXXXXXXXXXXXXXGXXXXXXXXXXXXXXXXXXX,0,300,0
9051,16,3,13,84,200,0,0,211,83,128,GXXXXXXXXXXXXXXXXXXXGAXXXXXXXXXXXXXXXXXXGXXXXXXXXXXXXXXXXXXXGAXXXXXXXXXXXXXXXXXXGXXXXXXXXXXXXXXXXXXXGXXXXXXXXXXXXXXXXXXXGAXXXXXXXXXXXXXXXXXXGXXXXXXXXXXXXXXXXXXXGXXXXXXXXXXXXXXXXXXXGXXXXXXXXXXXXXXXXXXXGXXXXXXXXXXXXXXXXXXXGXXXXXXXXXXXXXXXXXXXGXXXXXXXXXXXXXXXXXXX,0,300,0
9072,16,3,13,85,199,0,0,210,84,126,GXXXXXXXXXXXXXXXXXXXGAXXXXXXXXXXXXXXXXXXGXXXXXXXXXXXXXXXXXXXGAXXXXXXXXXXXXXXXXXXGXXXXXXXXXXXXXXXXXXXGXXXXXXXXXXXXXXXXXXXGAXXXXXXXXXXXXXXXXXXGXXXXXXXXXXXXXXXXXXXGXXXXXXXXXXXXXXXXXXXGXXXXXXXXXXXXXXXXXXXGXXXXXXXXXXXXXXXXXXXGXXXXXXXXXXXXXXXXXXXGXXXXXXXXXXXXXXXXXXX,0,300,0
9093,15,2,13,84,201,0,0,212,84,128,GXXXXXXXXXXXXXXXXXXXGXXXXXXXXXXXXXXXXXXXGXXXXXXXXXXXXXXXXXXXGAXXXXXXXXXXXXXXXXXXGXXXXXXXXXXXXXXXXXXXGXXXXXXXXXXXXXXXXXXXGAXXXXXXXXXXXXXXXXXXGXXXXXXXXXXXXXXXXXXXGXXXXXXXXXXXXXXXXXXXGXXXXXXXXXXXXXXXXXXXGXXXXXXXXXXXXXXXXXXXGXXXXXXXXXXXXXXXXXXXGXXXXXXXXXXXXXXXXXXX,0,300,0
9114,15,2,13,78,207,0,0,219,85,134,GXXXXXXXXXXXXXXXXXXXGXXXXXXXXXXXXXXXXXXXGXXXXXXXXXXXXXXXXXXXGAXXXXXXXXXXXXXXXXXXGXXXXXXXXXXXXXXXXXXXGXXXXXXXXXXXXXXXXXXXGAXXXXXXXXXXXXXXXXXXGXXXXXXXXXXXXXXXXXXXGXXXXXXXXXXXXXXXXXXXGXXXXXXXXXXXXXXXXXXXGXXXXXXXXXXXXXXXXXXXGXXXXXXXXXXXXXXXXXXXGXXXXXXXXXXXXXXXXXXX,0,300,0

9135,14,1,13,73,213,0,0,224,86,138,GXXXXXXXXXXXXXXXXXXXGXXXXXXXXXXXXXXXXXXXGXXXXXXXXXXXXXXXXXXXGXXXXXXXXXXXXXXXXXXXGXXXXXXXXXXXXXXXXXXXGXXXXXXXXXXXXXXXXXXXGAXXXXXXXXXXXXXXXXXXGXXXXXXXXXXXXXXXXXXXGXXXXXXXXXXXXXXXXXXXGXXXXXXXXXXXXXXXXXXXGXXXXXXXXXXXXXXXXXXXGXXXXXXXXXXXXXXXXXXXGXXXXXXXXXXXXXXXXXXX,0,300,0
9156,14,1,13,76,210,0,0,223,78,145,GXXXXXXXXXXXXXXXXXXXGXXXXXXXXXXXXXXXXXXXGXXXXXXXXXXXXXXXXXXXGXXXXXXXXXXXXXXXXXXXGXXXXXXXXXXXXXXXXXXXGXXXXXXXXXXXXXXXXXXXGAXXXXXXXXXXXXXXXXXXGXXXXXXXXXXXXXXXXXXXGXXXXXXXXXXXXXXXXXXXGXXXXXXXXXXXXXXXXXXXGXXXXXXXXXXXXXXXXXXXGXXXXXXXXXXXXXXXXXXXGXXXXXXXXXXXXXXXXXXX,0,300,0
9177,14,1,13,73,213,0,0,226,79,147,GXXXXXXXXXXXXXXXXXXXGXXXXXXXXXXXXXXXXXXXGXXXXXXXXXXXXXXXXXXXGXXXXXXXXXXXXXXXXXXXGXXXXXXXXXXXXXXXXXXXGXXXXXXXXXXXXXXXXXXXGAXXXXXXXXXXXXXXXXXXGXXXXXXXXXXXXXXXXXXXGXXXXXXXXXXXXXXXXXXXGXXXXXXXXXXXXXXXXXXXGXXXXXXXXXXXXXXXXXXXGXXXXXXXXXXXXXXXXXXXGXXXXXXXXXXXXXXXXXXX,0,300,0
9198,14,1,13,71,215,0,0,228,81,147,GXXXXXXXXXXXXXXXXXXXGXXXXXXXXXXXXXXXXXXXGXXXXXXXXXXXXXXXXXXXGXXXXXXXXXXXXXXXXXXXGXXXXXXXXXXXXXXXXXXXGXXXXXXXXXXXXXXXXXXXGAXXXXXXXXXXXXXXXXXXGXXXXXXXXXXXXXXXXXXXGXXXXXXXXXXXXXXXXXXXGXXXXXXXXXXXXXXXXXXXGXXXXXXXXXXXXXXXXXXXGXXXXXXXXXXXXXXXXXXXGXXXXXXXXXXXXXXXXXXX,0,300,0
9219,14,1,13,72,214,0,0,227,84,143,GXXXXXXXXXXXXXXXXXXXGXXXXXXXXXXXXXXXXXXXGXXXXXXXXXXXXXXXXXXXGXXXXXXXXXXXXXXXXXXXGXXXXXXXXXXXXXXXXXXXGXXXXXXXXXXXXXXXXXXXGAXXXXXXXXXXXXXXXXXXGXXXXXXXXXXXXXXXXXXXGXXXXXXXXXXXXXXXXXXXGXXXXXXXXXXXXXXXXXXXGXXXXXXXXXXXXXXXXXXXGXXXXXXXXXXXXXXXXXXXGXXXXXXXXXXXXXXXXXXX,0,300,0

9240,14,0,14,72,214,0,0,227,85,142,GXXXXXXXXXXXXXXXXXXXGXXXXXXXXXXXXXXXXXXXGXXXXXXXXXXXXXXXXXXXGXXXXXXXXXXXXXXXXXXXGXXXXXXXXXXXXXXXXXXXGXXXXXXXXXXXXXXXXXXXGOXXXXXXXXXXXXXXXXXXGXXXXXXXXXXXXXXXXXXXGXXXXXXXXXXXXXXXXXXXGXXXXXXXXXXXXXXXXXXXGXXXXXXXXXXXXXXXXXXXGXXXXXXXXXXXXXXXXXXXGXXXXXXXXXXXXXXXXXXX,0,300,0
9261,13,0,13,69,218,0,0,230,86,144,GXXXXXXXXXXXXXXXXXXXGXXXXXXXXXXXXXXXXXXXGXXXXXXXXXXXXXXXXXXXGXXXXXXXXXXXXXXXXXXXGXXXXXXXXXXXXXXXXXXXGXXXXXXXXXXXXXXXXXXXGXXXXXXXXXXXXXXXXXXXGXXXXXXXXXXXXXXXXXXXGXXXXXXXXXXXXXXXXXXXGXXXXXXXXXXXXXXXXXXXGXXXXXXXXXXXXXXXXXXXGXXXXXXXXXXXXXXXXXXXGXXXXXXXXXXXXXXXXXXX,0,300,0
9282,13,0,13,70,217,0,0,229,91,138,GXXXXXXXXXXXXXXXXXXXGXXXXXXXXXXXXXXXXXXXGXXXXXXXXXXXXXXXXXXXGXXXXXXXXXXXXXXXXXXXGXXXXXXXXXXXXXXXXXXXGXXXXXXXXXXXXXXXXXXXGXXXXXXXXXXXXXXXXXXXGXXXXXXXXXXXXXXXXXXXGXXXXXXXXXXXXXXXXXXXGXXXXXXXXXXXXXXXXXXXGXXXXXXXXXXXXXXXXXXXGXXXXXXXXXXXXXXXXXXXGXXXXXXXXXXXXXXXXXXX,0,300,0
9303,13,0,13,71,216,0,0,227,89,138,GXXXXXXXXXXXXXXXXXXXGXXXXXXXXXXXXXXXXXXXGXXXXXXXXXXXXXXXXXXXGXXXXXXXXXXXXXXXXXXXGXXXXXXXXXXXXXXXXXXXGXXXXXXXXXXXXXXXXXXXGXXXXXXXXXXXXXXXXXXXGXXXXXXXXXXXXXXXXXXXGXXXXXXXXXXXXXXXXXXXGXXXXXXXXXXXXXXXXXXXGXXXXXXXXXXXXXXXXXXXGXXXXXXXXXXXXXXXXXXXGXXXXXXXXXXXXXXXXXXX,0,300,0
9324,13,0,13,75,212,0,0,223,90,133,GXXXXXXXXXXXXXXXXXXXGXXXXXXXXXXXXXXXXXXXGXXXXXXXXXXXXXXXXXXXGXXXXXXXXXXXXXXXXXXXGXXXXXXXXXXXXXXXXXXXGXXXXXXXXXXXXXXXXXXXGXXXXXXXXXXXXXXXXXXXGXXXXXXXXXXXXXXXXXXXGXXXXXXXXXXXXXXXXXXXGXXXXXXXXXXXXXXXXXXXGXXXXXXXXXXXXXXXXXXXGXXXXXXXXXXXXXXXXXXXGXXXXXXXXXXXXXXXXXXX,0,300,0

9345,13,0,13,73,214,0,0,226,92,134,GXXXXXXXXXXXXXXXXXXXGXXXXXXXXXXXXXXXXXXXGXXXXXXXXXXXXXXXXXXXGXXXXXXXXXXXXXXXXXXXGXXXXXXXXXXXXXXXXXXXGXXXXXXXXXXXXXXXXXXXGXXXXXXXXXXXXXXXXXXXGXXXXXXXXXXXXXXXXXXXGXXXXXXXXXXXXXXXXXXXGXXXXXXXXXXXXXXXXXXXGXXXXXXXXXXXXXXXXXXXGXXXXXXXXXXXXXXXXXXXGXXXXXXXXXXXXXXXXXXX,0,300,0
9366,13,0,13,73,214,0,0,226,94,132,GXXXXXXXXXXXXXXXXXXXGXXXXXXXXXXXXXXXXXXXGXXXXXXXXXXXXXXXXXXXGXXXXXXXXXXXXXXXXXXXGXXXXXXXXXXXXXXXXXXXGXXXXXXXXXXXXXXXXXXXGXXXXXXXXXXXXXXXXXXXGXXXXXXXXXXXXXXXXXXXGXXXXXXXXXXXXXXXXXXXGXXXXXXXXXXXXXXXXXXXGXXXXXXXXXXXXXXXXXXXGXXXXXXXXXXXXXXXXXXXGXXXXXXXXXXXXXXXXXXX,0,300,0
9387,13,0,13,75,212,0,0,224,92,132,GXXXXXXXXXXXXXXXXXXXGXXXXXXXXXXXXXXXXXXXGXXXXXXXXXXXXXXXXXXXGXXXXXXXXXXXXXXXXXXXGXXXXXXXXXXXXXXXXXXXGXXXXXXXXXXXXXXXXXXXGXXXXXXXXXXXXXXXXXXXGXXXXXXXXXXXXXXXXXXXGXXXXXXXXXXXXXXXXXXXGXXXXXXXXXXXXXXXXXXXGXXXXXXXXXXXXXXXXXXXGXXXXXXXXXXXXXXXXXXXGXXXXXXXXXXXXXXXXXXX,0,300,0
9408,13,0,13,77,210,0,0,221,91,130,GXXXXXXXXXXXXXXXXXXXGXXXXXXXXXXXXXXXXXXXGXXXXXXXXXXXXXXXXXXXGXXXXXXXXXXXXXXXXXXXGXXXXXXXXXXXXXXXXXXXGXXXXXXXXXXXXXXXXXXXGXXXXXXXXXXXXXXXXXXXGXXXXXXXXXXXXXXXXXXXGXXXXXXXXXXXXXXXXXXXGXXXXXXXXXXXXXXXXXXXGXXXXXXXXXXXXXXXXXXXGXXXXXXXXXXXXXXXXXXXGXXXXXXXXXXXXXXXXXXX,0,300,0
9429,13,0,13,78,209,0,0,221,90,131,GXXXXXXXXXXXXXXXXXXXGXXXXXXXXXXXXXXXXXXXGXXXXXXXXXXXXXXXXXXXGXXXXXXXXXXXXXXXXXXXGXXXXXXXXXXXXXXXXXXXGXXXXXXXXXXXXXXXXXXXGXXXXXXXXXXXXXXXXXXXGXXXXXXXXXXXXXXXXXXXGXXXXXXXXXXXXXXXXXXXGXXXXXXXXXXXXXXXXXXXGXXXXXXXXXXXXXXXXXXXGXXXXXXXXXXXXXXXXXXXGXXXXXXXXXXXXXXXXXXX,0,300,0

9450,13,0,13,79,208,0,0,220,87,133,GXXXXXXXXXXXXXXXXXXXGXXXXXXXXXXXXXXXXXXXGXXXXXXXXXXXXXXXXXXXGXXXXXXXXXXXXXXXXXXXGXXXXXXXXXXXXXXXXXXXGXXXXXXXXXXXXXXXXXXXGXXXXXXXXXXXXXXXXXXXGXXXXXXXXXXXXXXXXXXXGXXXXXXXXXXXXXXXXXXXGXXXXXXXXXXXXXXXXXXXGXXXXXXXXXXXXXXXXXXXGXXXXXXXXXXXXXXXXXXXGXXXXXXXXXXXXXXXXXXX,0,300,0
9471,13,0,13,75,212,0,0,223,90,133,GXXXXXXXXXXXXXXXXXXXGXXXXXXXXXXXXXXXXXXXGXXXXXXXXXXXXXXXXXXXGXXXXXXXXXXXXXXXXXXXGXXXXXXXXXXXXXXXXXXXGXXXXXXXXXXXXXXXXXXXGXXXXXXXXXXXXXXXXXXXGXXXXXXXXXXXXXXXXXXXGXXXXXXXXXXXXXXXXXXXGXXXXXXXXXXXXXXXXXXXGXXXXXXXXXXXXXXXXXXXGXXXXXXXXXXXXXXXXXXXGXXXXXXXXXXXXXXXXXXX,0,300,0
9492,13,0,13,78,209,0,0,221,87,134,GXXXXXXXXXXXXXXXXXXXGXXXXXXXXXXXXXXXXXXXGXXXXXXXXXXXXXXXXXXXGXXXXXXXXXXXXXXXXXXXGXXXXXXXXXXXXXXXXXXXGXXXXXXXXXXXXXXXXXXXGXXXXXXXXXXXXXXXXXXXGXXXXXXXXXXXXXXXXXXXGXXXXXXXXXXXXXXXXXXXGXXXXXXXXXXXXXXXXXXXGXXXXXXXXXXXXXXXXXXXGXXXXXXXXXXXXXXXXXXXGXXXXXXXXXXXXXXXXXXX,0,300,0
9513,13,0,13,78,209,0,0,221,80,141,GXXXXXXXXXXXXXXXXXXXGXXXXXXXXXXXXXXXXXXXGXXXXXXXXXXXXXXXXXXXGXXXXXXXXXXXXXXXXXXXGXXXXXXXXXXXXXXXXXXXGXXXXXXXXXXXXXXXXXXXGXXXXXXXXXXXXXXXXXXXGXXXXXXXXXXXXXXXXXXXGXXXXXXXXXXXXXXXXXXXGXXXXXXXXXXXXXXXXXXXGXXXXXXXXXXXXXXXXXXXGXXXXXXXXXXXXXXXXXXXGXXXXXXXXXXXXXXXXXXX,0,300,0
9534,13,0,13,79,208,0,0,220,85,135,GXXXXXXXXXXXXXXXXXXXGXXXXXXXXXXXXXXXXXXXGXXXXXXXXXXXXXXXXXXXGXXXXXXXXXXXXXXXXXXXGXXXXXXXXXXXXXXXXXXXGXXXXXXXXXXXXXXXXXXXGXXXXXXXXXXXXXXXXXXXGXXXXXXXXXXXXXXXXXXXGXXXXXXXXXXXXXXXXXXXGXXXXXXXXXXXXXXXXXXXGXXXXXXXXXXXXXXXXXXXGXXXXXXXXXXXXXXXXXXXGXXXXXXXXXXXXXXXXXXX,0,300,0

9555,13,0,13,74,213,0,0,225,82,143,GXXXXXXXXXXXXXXXXXXXGXXXXXXXXXXXXXXXXXXXGXXXXXXXXXXXXXXXXXXXGXXXXXXXXXXXXXXXXXXXGXXXXXXXXXXXXXXXXXXXGXXXXXXXXXXXXXXXXXXXGXXXXXXXXXXXXXXXXXXXGXXXXXXXXXXXXXXXXXXXGXXXXXXXXXXXXXXXXXXXGXXXXXXXXXXXXXXXXXXXGXXXXXXXXXXXXXXXXXXXGXXXXXXXXXXXXXXXXXXXGXXXXXXXXXXXXXXXXXXX,0,300,0
9576,13,0,13,74,213,0,0,224,88,136,GXXXXXXXXXXXXXXXXXXXGXXXXXXXXXXXXXXXXXXXGXXXXXXXXXXXXXXXXXXXGXXXXXXXXXXXXXXXXXXXGXXXXXXXXXXXXXXXXXXXGXXXXXXXXXXXXXXXXXXXGXXXXXXXXXXXXXXXXXXXGXXXXXXXXXXXXXXXXXXXGXXXXXXXXXXXXXXXXXXXGXXXXXXXXXXXXXXXXXXXGXXXXXXXXXXXXXXXXXXXGXXXXXXXXXXXXXXXXXXXGXXXXXXXXXXXXXXXXXXX,0,300,0
9597,13,0,13,77,210,0,0,222,88,134,GXXXXXXXXXXXXXXXXXXXGXXXXXXXXXXXXXXXXXXXGXXXXXXXXXXXXXXXXXXXGXXXXXXXXXXXXXXXXXXXGXXXXXXXXXXXXXXXXXXXGXXXXXXXXXXXXXXXXXXXGXXXXXXXXXXXXXXXXXXXGXXXXXXXXXXXXXXXXXXXGXXXXXXXXXXXXXXXXXXXGXXXXXXXXXXXXXXXXXXXGXXXXXXXXXXXXXXXXXXXGXXXXXXXXXXXXXXXXXXXGXXXXXXXXXXXXXXXXXXX,0,300,0
9618,13,0,13,80,207,0,0,219,88,131,GXXXXXXXXXXXXXXXXXXXGXXXXXXXXXXXXXXXXXXXGXXXXXXXXXXXXXXXXXXXGXXXXXXXXXXXXXXXXXXXGXXXXXXXXXXXXXXXXXXXGXXXXXXXXXXXXXXXXXXXGXXXXXXXXXXXXXXXXXXXGXXXXXXXXXXXXXXXXXXXGXXXXXXXXXXXXXXXXXXXGXXXXXXXXXXXXXXXXXXXGXXXXXXXXXXXXXXXXXXXGXXXXXXXXXXXXXXXXXXXGXXXXXXXXXXXXXXXXXXX,0,300,0
9639,13,0,13,83,204,0,0,216,90,126,GXXXXXXXXXXXXXXXXXXXGXXXXXXXXXXXXXXXXXXXGXXXXXXXXXXXXXXXXXXXGXXXXXXXXXXXXXXXXXXXGXXXXXXXXXXXXXXXXXXXGXXXXXXXXXXXXXXXXXXXGXXXXXXXXXXXXXXXXXXXGXXXXXXXXXXXXXXXXXXXGXXXXXXXXXXXXXXXXXXXGXXXXXXXXXXXXXXXXXXXGXXXXXXXXXXXXXXXXXXXGXXXXXXXXXXXXXXXXXXXGXXXXXXXXXXXXXXXXXXX,0,300,0

9660,13,0,13,82,205,0,0,217,86,131,GXXXXXXXXXXXXXXXXXXXGXXXXXXXXXXXXXXXXXXXGXXXXXXXXXXXXXXXXXXXGXXXXXXXXXXXXXXXXXXXGXXXXXXXXXXXXXXXXXXXGXXXXXXXXXXXXXXXXXXXGXXXXXXXXXXXXXXXXXXXGXXXXXXXXXXXXXXXXXXXGXXXXXXXXXXXXXXXXXXXGXXXXXXXXXXXXXXXXXXXGXXXXXXXXXXXXXXXXXXXGXXXXXXXXXXXXXXXXXXXGXXXXXXXXXXXXXXXXXXX,0,300,0
9681,14,1,13,74,212,0,0,224,88,136,GXXXXXXXXXXXXXXXXXXXGAXXXXXXXXXXXXXXXXXXGXXXXXXXXXXXXXXXXXXXGXXXXXXXXXXXXXXXXXXXGXXXXXXXXXXXXXXXXXXXGXXXXXXXXXXXXXXXXXXXGXXXXXXXXXXXXXXXXXXXGXXXXXXXXXXXXXXXXXXXGXXXXXXXXXXXXXXXXXXXGXXXXXXXXXXXXXXXXXXXGXXXXXXXXXXXXXXXXXXXGXXXXXXXXXXXXXXXXXXXGXXXXXXXXXXXXXXXXXXX,0,300,0
9702,14,1,13,72,214,0,0,226,90,136,GXXXXXXXXXXXXXXXXXXXGAXXXXXXXXXXXXXXXXXXGXXXXXXXXXXXXXXXXXXXGXXXXXXXXXXXXXXXXXXXGXXXXXXXXXXXXXXXXXXXGXXXXXXXXXXXXXXXXXXXGXXXXXXXXXXXXXXXXXXXGXXXXXXXXXXXXXXXXXXXGXXXXXXXXXXXXXXXXXXXGXXXXXXXXXXXXXXXXXXXGXXXXXXXXXXXXXXXXXXXGXXXXXXXXXXXXXXXXXXXGXXXXXXXXXXXXXXXXXXX,0,300,0
9723,14,0,14,72,214,0,0,226,89,137,GXXXXXXXXXXXXXXXXXXXGOXXXXXXXXXXXXXXXXXXGXXXXXXXXXXXXXXXXXXXGXXXXXXXXXXXXXXXXXXXGXXXXXXXXXXXXXXXXXXXGXXXXXXXXXXXXXXXXXXXGXXXXXXXXXXXXXXXXXXXGXXXXXXXXXXXXXXXXXXXGXXXXXXXXXXXXXXXXXXXGXXXXXXXXXXXXXXXXXXXGXXXXXXXXXXXXXXXXXXXGXXXXXXXXXXXXXXXXXXXGXXXXXXXXXXXXXXXXXXX,0,300,0
9744,14,0,14,79,207,0,0,220,89,131,GXXXXXXXXXXXXXXXXXXXGOXXXXXXXXXXXXXXXXXXGXXXXXXXXXXXXXXXXXXXGXXXXXXXXXXXXXXXXXXXGXXXXXXXXXXXXXXXXXXXGXXXXXXXXXXXXXXXXXXXGXXXXXXXXXXXXXXXXXXXGXXXXXXXXXXXXXXXXXXXGXXXXXXXXXXXXXXXXXXXGXXXXXXXXXXXXXXXXXXXGXXXXXXXXXXXXXXXXXXXGXXXXXXXXXXXXXXXXXXXGXXXXXXXXXXXXXXXXXXX,0,300,0

9765,13,0,13,81,206,0,0,219,86,133,GXXXXXXXXXXXXXXXXXXXGXXXXXXXXXXXXXXXXXXXGXXXXXXXXXXXXXXXXXXXGXXXXXXXXXXXXXXXXXXXGXXXXXXXXXXXXXXXXXXXGXXXXXXXXXXXXXXXXXXXGXXXXXXXXXXXXXXXXXXXGXXXXXXXXXXXXXXXXXXXGXXXXXXXXXXXXXXXXXXXGXXXXXXXXXXXXXXXXXXXGXXXXXXXXXXXXXXXXXXXGXXXXXXXXXXXXXXXXXXXGXXXXXXXXXXXXXXXXXXX,0,300,0
9786,13,0,13,71,216,0,0,228,91,137,GXXXXXXXXXXXXXXXXXXXGXXXXXXXXXXXXXXXXXXXGXXXXXXXXXXXXXXXXXXXGXXXXXXXXXXXXXXXXXXXGXXXXXXXXXXXXXXXXXXXGXXXXXXXXXXXXXXXXXXXGXXXXXXXXXXXXXXXXXXXGXXXXXXXXXXXXXXXXXXXGXXXXXXXXXXXXXXXXXXXGXXXXXXXXXXXXXXXXXXXGXXXXXXXXXXXXXXXXXXXGXXXXXXXXXXXXXXXXXXXGXXXXXXXXXXXXXXXXXXX,0,300,0
9807,13,0,13,70,217,0,0,230,86,144,GXXXXXXXXXXXXXXXXXXXGXXXXXXXXXXXXXXXXXXXGXXXXXXXXXXXXXXXXXXXGXXXXXXXXXXXXXXXXXXXGXXXXXXXXXXXXXXXXXXXGXXXXXXXXXXXXXXXXXXXGXXXXXXXXXXXXXXXXXXXGXXXXXXXXXXXXXXXXXXXGXXXXXXXXXXXXXXXXXXXGXXXXXXXXXXXXXXXXXXXGXXXXXXXXXXXXXXXXXXXGXXXXXXXXXXXXXXXXXXXGXXXXXXXXXXXXXXXXXXX,0,300,0
9828,13,0,13,65,222,0,0,233,92,141,GXXXXXXXXXXXXXXXXXXXGXXXXXXXXXXXXXXXXXXXGXXXXXXXXXXXXXXXXXXXGXXXXXXXXXXXXXXXXXXXGXXXXXXXXXXXXXXXXXXXGXXXXXXXXXXXXXXXXXXXGXXXXXXXXXXXXXXXXXXXGXXXXXXXXXXXXXXXXXXXGXXXXXXXXXXXXXXXXXXXGXXXXXXXXXXXXXXXXXXXGXXXXXXXXXXXXXXXXXXXGXXXXXXXXXXXXXXXXXXXGXXXXXXXXXXXXXXXXXXX,0,300,0
9849,13,0,13,65,222,0,0,235,88,147,GXXXXXXXXXXXXXXXXXXXGXXXXXXXXXXXXXXXXXXXGXXXXXXXXXXXXXXXXXXXGXXXXXXXXXXXXXXXXXXXGXXXXXXXXXXXXXXXXXXXGXXXXXXXXXXXXXXXXXXXGXXXXXXXXXXXXXXXXXXXGXXXXXXXXXXXXXXXXXXXGXXXXXXXXXXXXXXXXXXXGXXXXXXXXXXXXXXXXXXXGXXXXXXXXXXXXXXXXXXXGXXXXXXXXXXXXXXXXXXXGXXXXXXXXXXXXXXXXXXX,0,300,0

9870,13,0,13,61,226,0,0,238,93,145,GXXXXXXXXXXXXXXXXXXXGXXXXXXXXXXXXXXXXXXXGXXXXXXXXXXXXXXXXXXXGXXXXXXXXXXXXXXXXXXXGXXXXXXXXXXXXXXXXXXXGXXXXXXXXXXXXXXXXXXXGXXXXXXXXXXXXXXXXXXXGXXXXXXXXXXXXXXXXXXXGXXXXXXXXXXXXXXXXXXXGXXXXXXXXXXXXXXXXXXXGXXXXXXXXXXXXXXXXXXXGXXXXXXXXXXXXXXXXXXXGXXXXXXXXXXXXXXXXXXX,0,300,0
9891,13,0,13,64,223,0,0,236,95,141,GXXXXXXXXXXXXXXXXXXXGXXXXXXXXXXXXXXXXXXXGXXXXXXXXXXXXXXXXXXXGXXXXXXXXXXXXXXXXXXXGXXXXXXXXXXXXXXXXXXXGXXXXXXXXXXXXXXXXXXXGXXXXXXXXXXXXXXXXXXXGXXXXXXXXXXXXXXXXXXXGXXXXXXXXXXXXXXXXXXXGXXXXXXXXXXXXXXXXXXXGXXXXXXXXXXXXXXXXXXXGXXXXXXXXXXXXXXXXXXXGXXXXXXXXXXXXXXXXXXX,0,300,0
9912,13,0,13,62,225,0,0,238,102,136,GXXXXXXXXXXXXXXXXXXXGXXXXXXXXXXXXXXXXXXXGXXXXXXXXXXXXXXXXXXXGXXXXXXXXXXXXXXXXXXXGXXXXXXXXXXXXXXXXXXXGXXXXXXXXXXXXXXXXXXXGXXXXXXXXXXXXXXXXXXXGXXXXXXXXXXXXXXXXXXXGXXXXXXXXXXXXXXXXXXXGXXXXXXXXXXXXXXXXXXXGXXXXXXXXXXXXXXXXXXXGXXXXXXXXXXXXXXXXXXXGXXXXXXXXXXXXXXXXXXX,0,300,0
9933,13,0,13,68,219,0,0,231,98,133,GXXXXXXXXXXXXXXXXXXXGXXXXXXXXXXXXXXXXXXXGXXXXXXXXXXXXXXXXXXXGXXXXXXXXXXXXXXXXXXXGXXXXXXXXXXXXXXXXXXXGXXXXXXXXXXXXXXXXXXXGXXXXXXXXXXXXXXXXXXXGXXXXXXXXXXXXXXXXXXXGXXXXXXXXXXXXXXXXXXXGXXXXXXXXXXXXXXXXXXXGXXXXXXXXXXXXXXXXXXXGXXXXXXXXXXXXXXXXXXXGXXXXXXXXXXXXXXXXXXX,0,300,0
9954,13,0,13,70,217,0,0,231,95,136,GXXXXXXXXXXXXXXXXXXXGXXXXXXXXXXXXXXXXXXXGXXXXXXXXXXXXXXXXXXXGXXXXXXXXXXXXXXXXXXXGXXXXXXXXXXXXXXXXXXXGXXXXXXXXXXXXXXXXXXXGXXXXXXXXXXXXXXXXXXXGXXXXXXXXXXXXXXXXXXXGXXXXXXXXXXXXXXXXXXXGXXXXXXXXXXXXXXXXXXXGXXXXXXXXXXXXXXXXXXXGXXXXXXXXXXXXXXXXXXXGXXXXXXXXXXXXXXXXXXX,0,300,0

9975,13,0,13,68,219,0,0,232,96,136,GXXXXXXXXXXXXXXXXXXXGXXXXXXXXXXXXXXXXXXXGXXXXXXXXXXXXXXXXXXXGXXXXXXXXXXXXXXXXXXXGXXXXXXXXXXXXXXXXXXXGXXXXXXXXXXXXXXXXXXXGXXXXXXXXXXXXXXXXXXXGXXXXXXXXXXXXXXXXXXXGXXXXXXXXXXXXXXXXXXXGXXXXXXXXXXXXXXXXXXXGXXXXXXXXXXXXXXXXXXXGXXXXXXXXXXXXXXXXXXXGXXXXXXXXXXXXXXXXXXX,0,300,0
9996,13,0,13,69,218,0,0,232,98,134,GXXXXXXXXXXXXXXXXXXXGXXXXXXXXXXXXXXXXXXXGXXXXXXXXXXXXXXXXXXXGXXXXXXXXXXXXXXXXXXXGXXXXXXXXXXXXXXXXXXXGXXXXXXXXXXXXXXXXXXXGXXXXXXXXXXXXXXXXXXXGXXXXXXXXXXXXXXXXXXXGXXXXXXXXXXXXXXXXXXXGXXXXXXXXXXXXXXXXXXXGXXXXXXXXXXXXXXXXXXXGXXXXXXXXXXXXXXXXXXXGXXXXXXXXXXXXXXXXXXX,0,300,0
10017,13,0,13,73,214,0,0,227,99,128,GXXXXXXXXXXXXXXXXXXXGXXXXXXXXXXXXXXXXXXXGXXXXXXXXXXXXXXXXXXXGXXXXXXXXXXXXXXXXXXXGXXXXXXXXXXXXXXXXXXXGXXXXXXXXXXXXXXXXXXXGXXXXXXXXXXXXXXXXXXXGXXXXXXXXXXXXXXXXXXXGXXXXXXXXXXXXXXXXXXXGXXXXXXXXXXXXXXXXXXXGXXXXXXXXXXXXXXXXXXXGXXXXXXXXXXXXXXXXXXXGXXXXXXXXXXXXXXXXXXX,0,300,0
10038,13,0,13,74,213,0,0,224,98,126,GXXXXXXXXXXXXXXXXXXXGXXXXXXXXXXXXXXXXXXXGXXXXXXXXXXXXXXXXXXXGXXXXXXXXXXXXXXXXXXXGXXXXXXXXXXXXXXXXXXXGXXXXXXXXXXXXXXXXXXXGXXXXXXXXXXXXXXXXXXXGXXXXXXXXXXXXXXXXXXXGXXXXXXXXXXXXXXXXXXXGXXXXXXXXXXXXXXXXXXXGXXXXXXXXXXXXXXXXXXXGXXXXXXXXXXXXXXXXXXXGXXXXXXXXXXXXXXXXXXX,0,300,0
10059,14,1,13,76,210,0,0,223,96,127,GXXXXXXXXXXXXXXXXXXXGXXXXXXXXXXXXXXXXXXXGXXXXXXXXXXXXXXXXXXXGXXXXXXXXXXXXXXXXXXXGXXXXXXXXXXXXXXXXXXXGXXXXXXXXXXXXXXXXXXXGXXXXXXXXXXXXXXXXXXXGAXXXXXXXXXXXXXXXXXXGXXXXXXXXXXXXXXXXXXXGXXXXXXXXXXXXXXXXXXXGXXXXXXXXXXXXXXXXXXXGXXXXXXXXXXXXXXXXXXXGXXXXXXXXXXXXXXXXXXX,0,300,0

10080,14,1,13,86,200,0,0,212,96,116,GXXXXXXXXXXXXXXXXXXXGXXXXXXXXXXXXXXXXXXXGXXXXXXXXXXXXXXXXXXXGXXXXXXXXXXXXXXXXXXXGXXXXXXXXXXXXXXXXXXXGXXXXXXXXXXXXXXXXXXXGXXXXXXXXXXXXXXXXXXXGAXXXXXXXXXXXXXXXXXXGXXXXXXXXXXXXXXXXXXXGXXXXXXXXXXXXXXXXXXXGXXXXXXXXXXXXXXXXXXXGXXXXXXXXXXXXXXXXXXXGXXXXXXXXXXXXXXXXXXX,0,300,0
10101,15,2,13,89,196,0,0,209,91,118,GXXXXXXXXXXXXXXXXXXXGXXXXXXXXXXXXXXXXXXXGAXXXXXXXXXXXXXXXXXXGXXXXXXXXXXXXXXXXXXXGXXXXXXXXXXXXXXXXXXXGXXXXXXXXXXXXXXXXXXXGXXXXXXXXXXXXXXXXXXXGAXXXXXXXXXXXXXXXXXXGXXXXXXXXXXXXXXXXXXXGXXXXXXXXXXXXXXXXXXXGXXXXXXXXXXXXXXXXXXXGXXXXXXXXXXXXXXXXXXXGXXXXXXXXXXXXXXXXXXX,0,300,0
10122,15,2,13,86,199,0,0,211,97,114,GXXXXXXXXXXXXXXXXXXXGXXXXXXXXXXXXXXXXXXXGAXXXXXXXXXXXXXXXXXXGXXXXXXXXXXXXXXXXXXXGXXXXXXXXXXXXXXXXXXXGXXXXXXXXXXXXXXXXXXXGXXXXXXXXXXXXXXXXXXXGAXXXXXXXXXXXXXXXXXXGXXXXXXXXXXXXXXXXXXXGXXXXXXXXXXXXXXXXXXXGXXXXXXXXXXXXXXXXXXXGXXXXXXXXXXXXXXXXXXXGXXXXXXXXXXXXXXXXXXX,0,300,0
10143,15,2,13,89,196,0,0,208,95,113,GXXXXXXXXXXXXXXXXXXXGXXXXXXXXXXXXXXXXXXXGAXXXXXXXXXXXXXXXXXXGXXXXXXXXXXXXXXXXXXXGXXXXXXXXXXXXXXXXXXXGXXXXXXXXXXXXXXXXXXXGXXXXXXXXXXXXXXXXXXXGAXXXXXXXXXXXXXXXXXXGXXXXXXXXXXXXXXXXXXXGXXXXXXXXXXXXXXXXXXXGXXXXXXXXXXXXXXXXXXXGXXXXXXXXXXXXXXXXXXXGXXXXXXXXXXXXXXXXXXX,0,300,0
10164,15,2,13,90,195,0,0,207,93,114,GXXXXXXXXXXXXXXXXXXXGXXXXXXXXXXXXXXXXXXXGAXXXXXXXXXXXXXXXXXXGXXXXXXXXXXXXXXXXXXXGXXXXXXXXXXXXXXXXXXXGXXXXXXXXXXXXXXXXXXXGXXXXXXXXXXXXXXXXXXXGAXXXXXXXXXXXXXXXXXXGXXXXXXXXXXXXXXXXXXXGXXXXXXXXXXXXXXXXXXXGXXXXXXXXXXXXXXXXXXXGXXXXXXXXXXXXXXXXXXXGXXXXXXXXXXXXXXXXXXX,0,300,0

10185,16,3,13,90,194,0,0,206,88,118,GXXXXXXXXXXXXXXXXXXXGAXXXXXXXXXXXXXXXXXXGAXXXXXXXXXXXXXXXXXXGXXXXXXXXXXXXXXXXXXXGXXXXXXXXXXXXXXXXXXXGXXXXXXXXXXXXXXXXXXXGXXXXXXXXXXXXXXXXXXXGAXXXXXXXXXXXXXXXXXXGXXXXXXXXXXXXXXXXXXXGXXXXXXXXXXXXXXXXXXXGXXXXXXXXXXXXXXXXXXXGXXXXXXXXXXXXXXXXXXXGXXXXXXXXXXXXXXXXXXX,0,300,0
10206,15,2,13,85,200,0,0,212,91,121,GXXXXXXXXXXXXXXXXXXXGAXXXXXXXXXXXXXXXXXXGAXXXXXXXXXXXXXXXXXXGXXXXXXXXXXXXXXXXXXXGXXXXXXXXXXXXXXXXXXXGXXXXXXXXXXXXXXXXXXXGXXXXXXXXXXXXXXXXXXXGXXXXXXXXXXXXXXXXXXXGXXXXXXXXXXXXXXXXXXXGXXXXXXXXXXXXXXXXXXXGXXXXXXXXXXXXXXXXXXXGXXXXXXXXXXXXXXXXXXXGXXXXXXXXXXXXXXXXXXX,0,300,0
10227,15,2,13,75,210,0,0,220,91,129,GXXXXXXXXXXXXXXXXXXXGAXXXXXXXXXXXXXXXXXXGAXXXXXXXXXXXXXXXXXXGXXXXXXXXXXXXXXXXXXXGXXXXXXXXXXXXXXXXXXXGXXXXXXXXXXXXXXXXXXXGXXXXXXXXXXXXXXXXXXXGXXXXXXXXXXXXXXXXXXXGXXXXXXXXXXXXXXXXXXXGXXXXXXXXXXXXXXXXXXXGXXXXXXXXXXXXXXXXXXXGXXXXXXXXXXXXXXXXXXXGXXXXXXXXXXXXXXXXXXX,0,300,0
10248,15,2,13,77,208,0,0,219,90,129,GXXXXXXXXXXXXXXXXXXXGAXXXXXXXXXXXXXXXXXXGAXXXXXXXXXXXXXXXXXXGXXXXXXXXXXXXXXXXXXXGXXXXXXXXXXXXXXXXXXXGXXXXXXXXXXXXXXXXXXXGXXXXXXXXXXXXXXXXXXXGXXXXXXXXXXXXXXXXXXXGXXXXXXXXXXXXXXXXXXXGXXXXXXXXXXXXXXXXXXXGXXXXXXXXXXXXXXXXXXXGXXXXXXXXXXXXXXXXXXXGXXXXXXXXXXXXXXXXXXX,0,300,0
10269,15,2,13,73,212,0,0,223,91,132,GXXXXXXXXXXXXXXXXXXXGAXXXXXXXXXXXXXXXXXXGAXXXXXXXXXXXXXXXXXXGXXXXXXXXXXXXXXXXXXXGXXXXXXXXXXXXXXXXXXXGXXXXXXXXXXXXXXXXXXXGXXXXXXXXXXXXXXXXXXXGXXXXXXXXXXXXXXXXXXXGXXXXXXXXXXXXXXXXXXXGXXXXXXXXXXXXXXXXXXXGXXXXXXXXXXXXXXXXXXXGXXXXXXXXXXXXXXXXXXXGXXXXXXXXXXXXXXXXXXX,0,300,0

10290,15,2,13,71,214,0,0,226,93,133,GXXXXXXXXXXXXXXXXXXXGAXXXXXXXXXXXXXXXXXXGAXXXXXXXXXXXXXXXXXXGXXXXXXXXXXXXXXXXXXXGXXXXXXXXXXXXXXXXXXXGXXXXXXXXXXXXXXXXXXXGXXXXXXXXXXXXXXXXXXXGXXXXXXXXXXXXXXXXXXXGXXXXXXXXXXXXXXXXXXXGXXXXXXXXXXXXXXXXXXXGXXXXXXXXXXXXXXXXXXXGXXXXXXXXXXXXXXXXXXXGXXXXXXXXXXXXXXXXXXX,0,300,0
10311,14,1,13,71,215,0,0,227,95,132,GXXXXXXXXXXXXXXXXXXXGAXXXXXXXXXXXXXXXXXXGXXXXXXXXXXXXXXXXXXXGXXXXXXXXXXXXXXXXXXXGXXXXXXXXXXXXXXXXXXXGXXXXXXXXXXXXXXXXXXXGXXXXXXXXXXXXXXXXXXXGXXXXXXXXXXXXXXXXXXXGXXXXXXXXXXXXXXXXXXXGXXXXXXXXXXXXXXXXXXXGXXXXXXXXXXXXXXXXXXXGXXXXXXXXXXXXXXXXXXXGXXXXXXXXXXXXXXXXXXX,0,300,0
10332,14,1,13,68,218,0,0,229,91,138,GXXXXXXXXXXXXXXXXXXXGAXXXXXXXXXXXXXXXXXXGXXXXXXXXXXXXXXXXXXXGXXXXXXXXXXXXXXXXXXXGXXXXXXXXXXXXXXXXXXXGXXXXXXXXXXXXXXXXXXXGXXXXXXXXXXXXXXXXXXXGXXXXXXXXXXXXXXXXXXXGXXXXXXXXXXXXXXXXXXXGXXXXXXXXXXXXXXXXXXXGXXXXXXXXXXXXXXXXXXXGXXXXXXXXXXXXXXXXXXXGXXXXXXXXXXXXXXXXXXX,0,300,0
10353,14,1,13,65,221,0,0,233,90,143,GXXXXXXXXXXXXXXXXXXXGAXXXXXXXXXXXXXXXXXXGXXXXXXXXXXXXXXXXXXXGXXXXXXXXXXXXXXXXXXXGXXXXXXXXXXXXXXXXXXXGXXXXXXXXXXXXXXXXXXXGXXXXXXXXXXXXXXXXXXXGXXXXXXXXXXXXXXXXXXXGXXXXXXXXXXXXXXXXXXXGXXXXXXXXXXXXXXXXXXXGXXXXXXXXXXXXXXXXXXXGXXXXXXXXXXXXXXXXXXXGXXXXXXXXXXXXXXXXXXX,0,300,0
10374,14,1,13,64,222,0,0,234,88,146,GXXXXXXXXXXXXXXXXXXXGAXXXXXXXXXXXXXXXXXXGXXXXXXXXXXXXXXXXXXXGXXXXXXXXXXXXXXXXXXXGXXXXXXXXXXXXXXXXXXXGXXXXXXXXXXXXXXXXXXXGXXXXXXXXXXXXXXXXXXXGXXXXXXXXXXXXXXXXXXXGXXXXXXXXXXXXXXXXXXXGXXXXXXXXXXXXXXXXXXXGXXXXXXXXXXXXXXXXXXXGXXXXXXXXXXXXXXXXXXXGXXXXXXXXXXXXXXXXXXX,0,300,0

10395,14,0,14,65,221,0,0,233,91,142,GXXXXXXXXXXXXXXXXXXXGOXXXXXXXXXXXXXXXXXXGXXXXXXXXXXXXXXXXXXXGXXXXXXXXXXXXXXXXXXXGXXXXXXXXXXXXXXXXXXXGXXXXXXXXXXXXXXXXXXXGXXXXXXXXXXXXXXXXXXXGXXXXXXXXXXXXXXXXXXXGXXXXXXXXXXXXXXXXXXXGXXXXXXXXXXXXXXXXXXXGXXXXXXXXXXXXXXXXXXXGXXXXXXXXXXXXXXXXXXXGXXXXXXXXXXXXXXXXXXX,0,300,0
10416,13,0,13,61,226,0,0,238,95,143,GXXXXXXXXXXXXXXXXXXXGXXXXXXXXXXXXXXXXXXXGXXXXXXXXXXXXXXXXXXXGXXXXXXXXXXXXXXXXXXXGXXXXXXXXXXXXXXXXXXXGXXXXXXXXXXXXXXXXXXXGXXXXXXXXXXXXXXXXXXXGXXXXXXXXXXXXXXXXXXXGXXXXXXXXXXXXXXXXXXXGXXXXXXXXXXXXXXXXXXXGXXXXXXXXXXXXXXXXXXXGXXXXXXXXXXXXXXXXXXXGXXXXXXXXXXXXXXXXXXX,0,300,0
10437,13,0,13,54,233,0,0,245,96,149,GXXXXXXXXXXXXXXXXXXXGXXXXXXXXXXXXXXXXXXXGXXXXXXXXXXXXXXXXXXXGXXXXXXXXXXXXXXXXXXXGXXXXXXXXXXXXXXXXXXXGXXXXXXXXXXXXXXXXXXXGXXXXXXXXXXXXXXXXXXXGXXXXXXXXXXXXXXXXXXXGXXXXXXXXXXXXXXXXXXXGXXXXXXXXXXXXXXXXXXXGXXXXXXXXXXXXXXXXXXXGXXXXXXXXXXXXXXXXXXXGXXXXXXXXXXXXXXXXXXX,0,300,0
10458,13,0,13,57,230,0,0,242,100,142,GXXXXXXXXXXXXXXXXXXXGXXXXXXXXXXXXXXXXXXXGXXXXXXXXXXXXXXXXXXXGXXXXXXXXXXXXXXXXXXXGXXXXXXXXXXXXXXXXXXXGXXXXXXXXXXXXXXXXXXXGXXXXXXXXXXXXXXXXXXXGXXXXXXXXXXXXXXXXXXXGXXXXXXXXXXXXXXXXXXXGXXXXXXXXXXXXXXXXXXXGXXXXXXXXXXXXXXXXXXXGXXXXXXXXXXXXXXXXXXXGXXXXXXXXXXXXXXXXXXX,0,300,0
10479,13,0,13,57,230,0,0,242,99,143,GXXXXXXXXXXXXXXXXXXXGXXXXXXXXXXXXXXXXXXXGXXXXXXXXXXXXXXXXXXXGXXXXXXXXXXXXXXXXXXXGXXXXXXXXXXXXXXXXXXXGXXXXXXXXXXXXXXXXXXXGXXXXXXXXXXXXXXXXXXXGXXXXXXXXXXXXXXXXXXXGXXXXXXXXXXXXXXXXXXXGXXXXXXXXXXXXXXXXXXXGXXXXXXXXXXXXXXXXXXXGXXXXXXXXXXXXXXXXXXXGXXXXXXXXXXXXXXXXXXX,0,300,0

10500,13,0,13,62,225,0,0,236,95,141,GXXXXXXXXXXXXXXXXXXXGXXXXXXXXXXXXXXXXXXXGXXXXXXXXXXXXXXXXXXXGXXXXXXXXXXXXXXXXXXXGXXXXXXXXXXXXXXXXXXXGXXXXXXXXXXXXXXXXXXXGXXXXXXXXXXXXXXXXXXXGXXXXXXXXXXXXXXXXXXXGXXXXXXXXXXXXXXXXXXXGXXXXXXXXXXXXXXXXXXXGXXXXXXXXXXXXXXXXXXXGXXXXXXXXXXXXXXXXXXXGXXXXXXXXXXXXXXXXXXX,0,300,0
10521,13,0,13,60,227,0,0,237,103,134,GXXXXXXXXXXXXXXXXXXXGXXXXXXXXXXXXXXXXXXXGXXXXXXXXXXXXXXXXXXXGXXXXXXXXXXXXXXXXXXXGXXXXXXXXXXXXXXXXXXXGXXXXXXXXXXXXXXXXXXXGXXXXXXXXXXXXXXXXXXXGXXXXXXXXXXXXXXXXXXXGXXXXXXXXXXXXXXXXXXXGXXXXXXXXXXXXXXXXXXXGXXXXXXXXXXXXXXXXXXXGXXXXXXXXXXXXXXXXXXXGXXXXXXXXXXXXXXXXXXX,0,300,0
10542,13,0,13,62,225,0,0,237,100,137,GXXXXXXXXXXXXXXXXXXXGXXXXXXXXXXXXXXXXXXXGXXXXXXXXXXXXXXXXXXXGXXXXXXXXXXXXXXXXXXXGXXXXXXXXXXXXXXXXXXXGXXXXXXXXXXXXXXXXXXXGXXXXXXXXXXXXXXXXXXXGXXXXXXXXXXXXXXXXXXXGXXXXXXXXXXXXXXXXXXXGXXXXXXXXXXXXXXXXXXXGXXXXXXXXXXXXXXXXXXXGXXXXXXXXXXXXXXXXXXXGXXXXXXXXXXXXXXXXXXX,0,300,0
10563,13,0,13,63,224,0,0,237,98,139,GXXXXXXXXXXXXXXXXXXXGXXXXXXXXXXXXXXXXXXXGXXXXXXXXXXXXXXXXXXXGXXXXXXXXXXXXXXXXXXXGXXXXXXXXXXXXXXXXXXXGXXXXXXXXXXXXXXXXXXXGXXXXXXXXXXXXXXXXXXXGXXXXXXXXXXXXXXXXXXXGXXXXXXXXXXXXXXXXXXXGXXXXXXXXXXXXXXXXXXXGXXXXXXXXXXXXXXXXXXXGXXXXXXXXXXXXXXXXXXXGXXXXXXXXXXXXXXXXXXX,0,300,0
10584,13,0,13,64,223,0,0,236,96,140,GXXXXXXXXXXXXXXXXXXXGXXXXXXXXXXXXXXXXXXXGXXXXXXXXXXXXXXXXXXXGXXXXXXXXXXXXXXXXXXXGXXXXXXXXXXXXXXXXXXXGXXXXXXXXXXXXXXXXXXXGXXXXXXXXXXXXXXXXXXXGXXXXXXXXXXXXXXXXXXXGXXXXXXXXXXXXXXXXXXXGXXXXXXXXXXXXXXXXXXXGXXXXXXXXXXXXXXXXXXXGXXXXXXXXXXXXXXXXXXXGXXXXXXXXXXXXXXXXXXX,0,300,0

10605,14,1,13,65,221,0,0,234,101,133,GAXXXXXXXXXXXXXXXXXXGXXXXXXXXXXXXXXXXXXXGXXXXXXXXXXXXXXXXXXXGXXXXXXXXXXXXXXXXXXXGXXXXXXXXXXXXXXXXXXXGXXXXXXXXXXXXXXXXXXXGXXXXXXXXXXXXXXXXXXXGXXXXXXXXXXXXXXXXXXXGXXXXXXXXXXXXXXXXXXXGXXXXXXXXXXXXXXXXXXXGXXXXXXXXXXXXXXXXXXXGXXXXXXXXXXXXXXXXXXXGXXXXXXXXXXXXXXXXXXX,0,300,0
10626,15,2,13,70,215,0,0,229,102,127,GAXXXXXXXXXXXXXXXXXXGXXXXXXXXXXXXXXXXXXXGXXXXXXXXXXXXXXXXXXXGXXXXXXXXXXXXXXXXXXXGXXXXXXXXXXXXXXXXXXXGAXXXXXXXXXXXXXXXXXXGXXXXXXXXXXXXXXXXXXXGXXXXXXXXXXXXXXXXXXXGXXXXXXXXXXXXXXXXXXXGXXXXXXXXXXXXXXXXXXXGXXXXXXXXXXXXXXXXXXXGXXXXXXXXXXXXXXXXXXXGXXXXXXXXXXXXXXXXXXX,0,300,0
10647,15,2,13,75,210,0,0,224,99,125,GAXXXXXXXXXXXXXXXXXXGXXXXXXXXXXXXXXXXXXXGXXXXXXXXXXXXXXXXXXXGXXXXXXXXXXXXXXXXXXXGXXXXXXXXXXXXXXXXXXXGAXXXXXXXXXXXXXXXXXXGXXXXXXXXXXXXXXXXXXXGXXXXXXXXXXXXXXXXXXXGXXXXXXXXXXXXXXXXXXXGXXXXXXXXXXXXXXXXXXXGXXXXXXXXXXXXXXXXXXXGXXXXXXXXXXXXXXXXXXXGXXXXXXXXXXXXXXXXXXX,0,300,0
10668,15,2,13,73,212,0,0,225,104,121,GAXXXXXXXXXXXXXXXXXXGXXXXXXXXXXXXXXXXXXXGXXXXXXXXXXXXXXXXXXXGXXXXXXXXXXXXXXXXXXXGXXXXXXXXXXXXXXXXXXXGAXXXXXXXXXXXXXXXXXXGXXXXXXXXXXXXXXXXXXXGXXXXXXXXXXXXXXXXXXXGXXXXXXXXXXXXXXXXXXXGXXXXXXXXXXXXXXXXXXXGXXXXXXXXXXXXXXXXXXXGXXXXXXXXXXXXXXXXXXXGXXXXXXXXXXXXXXXXXXX,0,300,0
10689,15,2,13,75,210,0,0,224,100,124,GAXXXXXXXXXXXXXXXXXXGXXXXXXXXXXXXXXXXXXXGXXXXXXXXXXXXXXXXXXXGXXXXXXXXXXXXXXXXXXXGXXXXXXXXXXXXXXXXXXXGAXXXXXXXXXXXXXXXXXXGXXXXXXXXXXXXXXXXXXXGXXXXXXXXXXXXXXXXXXXGXXXXXXXXXXXXXXXXXXXGXXXXXXXXXXXXXXXXXXXGXXXXXXXXXXXXXXXXXXXGXXXXXXXXXXXXXXXXXXXGXXXXXXXXXXXXXXXXXXX,0,300,0

10710,15,2,13,77,208,0,0,221,100,121,GAXXXXXXXXXXXXXXXXXXGXXXXXXXXXXXXXXXXXXXGXXXXXXXXXXXXXXXXXXXGXXXXXXXXXXXXXXXXXXXGXXXXXXXXXXXXXXXXXXXGAXXXXXXXXXXXXXXXXXXGXXXXXXXXXXXXXXXXXXXGXXXXXXXXXXXXXXXXXXXGXXXXXXXXXXXXXXXXXXXGXXXXXXXXXXXXXXXXXXXGXXXXXXXXXXXXXXXXXXXGXXXXXXXXXXXXXXXXXXXGXXXXXXXXXXXXXXXXXXX,0,300,0
10731,15,2,13,72,213,0,0,226,99,127,GAXXXXXXXXXXXXXXXXXXGXXXXXXXXXXXXXXXXXXXGXXXXXXXXXXXXXXXXXXXGXXXXXXXXXXXXXXXXXXXGXXXXXXXXXXXXXXXXXXXGAXXXXXXXXXXXXXXXXXXGXXXXXXXXXXXXXXXXXXXGXXXXXXXXXXXXXXXXXXXGXXXXXXXXXXXXXXXXXXXGXXXXXXXXXXXXXXXXXXXGXXXXXXXXXXXXXXXXXXXGXXXXXXXXXXXXXXXXXXXGXXXXXXXXXXXXXXXXXXX,0,300,0
10752,16,3,13,66,218,0,0,231,104,127,GAXXXXXXXXXXXXXXXXXXGXXXXXXXXXXXXXXXXXXXGXXXXXXXXXXXXXXXXXXXGXXXXXXXXXXXXXXXXXXXGXXXXXXXXXXXXXXXXXXXGAXXXXXXXXXXXXXXXXXXGXXXXXXXXXXXXXXXXXXXGXXXXXXXXXXXXXXXXXXXGAXXXXXXXXXXXXXXXXXXGXXXXXXXXXXXXXXXXXXXGXXXXXXXXXXXXXXXXXXXGXXXXXXXXXXXXXXXXXXXGXXXXXXXXXXXXXXXXXXX,0,300,0
10773,16,2,14,64,220,0,0,233,103,130,GOXXXXXXXXXXXXXXXXXXGXXXXXXXXXXXXXXXXXXXGXXXXXXXXXXXXXXXXXXXGXXXXXXXXXXXXXXXXXXXGXXXXXXXXXXXXXXXXXXXGAXXXXXXXXXXXXXXXXXXGXXXXXXXXXXXXXXXXXXXGXXXXXXXXXXXXXXXXXXXGAXXXXXXXXXXXXXXXXXXGXXXXXXXXXXXXXXXXXXXGXXXXXXXXXXXXXXXXXXXGXXXXXXXXXXXXXXXXXXXGXXXXXXXXXXXXXXXXXXX,0,300,0
10794,16,1,15,68,216,0,0,230,100,130,GOXXXXXXXXXXXXXXXXXXGXXXXXXXXXXXXXXXXXXXGXXXXXXXXXXXXXXXXXXXGXXXXXXXXXXXXXXXXXXXGXXXXXXXXXXXXXXXXXXXGAXXXXXXXXXXXXXXXXXXGXXXXXXXXXXXXXXXXXXXGXXXXXXXXXXXXXXXXXXXGOXXXXXXXXXXXXXXXXXXGXXXXXXXXXXXXXXXXXXXGXXXXXXXXXXXXXXXXXXXGXXXXXXXXXXXXXXXXXXXGXXXXXXXXXXXXXXXXXXX,0,300,0

10815,14,1,13,69,217,0,0,231,99,132,GXXXXXXXXXXXXXXXXXXXGXXXXXXXXXXXXXXXXXXXGXXXXXXXXXXXXXXXXXXXGXXXXXXXXXXXXXXXXXXXGXXXXXXXXXXXXXXXXXXXGAXXXXXXXXXXXXXXXXXXGXXXXXXXXXXXXXXXXXXXGXXXXXXXXXXXXXXXXXXXGXXXXXXXXXXXXXXXXXXXGXXXXXXXXXXXXXXXXXXXGXXXXXXXXXXXXXXXXXXXGXXXXXXXXXXXXXXXXXXXGXXXXXXXXXXXXXXXXXXX,0,300,0
10836,15,2,13,60,225,0,0,239,104,135,GXXXXXXXXXXXXXXXXXXXGXXXXXXXXXXXXXXXXXXXGXXXXXXXXXXXXXXXXXXXGAXXXXXXXXXXXXXXXXXXGXXXXXXXXXXXXXXXXXXXGAXXXXXXXXXXXXXXXXXXGXXXXXXXXXXXXXXXXXXXGXXXXXXXXXXXXXXXXXXXGXXXXXXXXXXXXXXXXXXXGXXXXXXXXXXXXXXXXXXXGXXXXXXXXXXXXXXXXXXXGXXXXXXXXXXXXXXXXXXXGXXXXXXXXXXXXXXXXXXX,0,300,0
10857,15,2,13,57,228,0,0,242,101,141,GXXXXXXXXXXXXXXXXXXXGXXXXXXXXXXXXXXXXXXXGXXXXXXXXXXXXXXXXXXXGAXXXXXXXXXXXXXXXXXXGXXXXXXXXXXXXXXXXXXXGAXXXXXXXXXXXXXXXXXXGXXXXXXXXXXXXXXXXXXXGXXXXXXXXXXXXXXXXXXXGXXXXXXXXXXXXXXXXXXXGXXXXXXXXXXXXXXXXXXXGXXXXXXXXXXXXXXXXXXXGXXXXXXXXXXXXXXXXXXXGXXXXXXXXXXXXXXXXXXX,0,300,0
10878,15,2,13,55,230,0,0,245,108,137,GXXXXXXXXXXXXXXXXXXXGXXXXXXXXXXXXXXXXXXXGXXXXXXXXXXXXXXXXXXXGAXXXXXXXXXXXXXXXXXXGXXXXXXXXXXXXXXXXXXXGAXXXXXXXXXXXXXXXXXXGXXXXXXXXXXXXXXXXXXXGXXXXXXXXXXXXXXXXXXXGXXXXXXXXXXXXXXXXXXXGXXXXXXXXXXXXXXXXXXXGXXXXXXXXXXXXXXXXXXXGXXXXXXXXXXXXXXXXXXXGXXXXXXXXXXXXXXXXXXX,0,300,0
10899,15,1,14,60,225,0,0,240,101,139,GXXXXXXXXXXXXXXXXXXXGXXXXXXXXXXXXXXXXXXXGXXXXXXXXXXXXXXXXXXXGAXXXXXXXXXXXXXXXXXXGXXXXXXXXXXXXXXXXXXXGOXXXXXXXXXXXXXXXXXXGXXXXXXXXXXXXXXXXXXXGXXXXXXXXXXXXXXXXXXXGXXXXXXXXXXXXXXXXXXXGXXXXXXXXXXXXXXXXXXXGXXXXXXXXXXXXXXXXXXXGXXXXXXXXXXXXXXXXXXXGXXXXXXXXXXXXXXXXXXX,0,300,0

10920,14,1,13,63,223,0,0,239,96,143,GXXXXXXXXXXXXXXXXXXXGXXXXXXXXXXXXXXXXXXXGXXXXXXXXXXXXXXXXXXXGAXXXXXXXXXXXXXXXXXXGXXXXXXXXXXXXXXXXXXXGXXXXXXXXXXXXXXXXXXXGXXXXXXXXXXXXXXXXXXXGXXXXXXXXXXXXXXXXXXXGXXXXXXXXXXXXXXXXXXXGXXXXXXXXXXXXXXXXXXXGXXXXXXXXXXXXXXXXXXXGXXXXXXXXXXXXXXXXXXXGXXXXXXXXXXXXXXXXXXX,0,300,0
10941,14,1,13,66,220,0,0,236,94,142,GXXXXXXXXXXXXXXXXXXXGXXXXXXXXXXXXXXXXXXXGXXXXXXXXXXXXXXXXXXXGAXXXXXXXXXXXXXXXXXXGXXXXXXXXXXXXXXXXXXXGXXXXXXXXXXXXXXXXXXXGXXXXXXXXXXXXXXXXXXXGXXXXXXXXXXXXXXXXXXXGXXXXXXXXXXXXXXXXXXXGXXXXXXXXXXXXXXXXXXXGXXXXXXXXXXXXXXXXXXXGXXXXXXXXXXXXXXXXXXXGXXXXXXXXXXXXXXXXXXX,0,300,0
10962,14,1,13,63,223,0,0,238,104,134,GXXXXXXXXXXXXXXXXXXXGXXXXXXXXXXXXXXXXXXXGXXXXXXXXXXXXXXXXXXXGAXXXXXXXXXXXXXXXXXXGXXXXXXXXXXXXXXXXXXXGXXXXXXXXXXXXXXXXXXXGXXXXXXXXXXXXXXXXXXXGXXXXXXXXXXXXXXXXXXXGXXXXXXXXXXXXXXXXXXXGXXXXXXXXXXXXXXXXXXXGXXXXXXXXXXXXXXXXXXXGXXXXXXXXXXXXXXXXXXXGXXXXXXXXXXXXXXXXXXX,0,300,0
10983,14,1,13,72,214,0,0,229,102,127,GXXXXXXXXXXXXXXXXXXXGXXXXXXXXXXXXXXXXXXXGXXXXXXXXXXXXXXXXXXXGAXXXXXXXXXXXXXXXXXXGXXXXXXXXXXXXXXXXXXXGXXXXXXXXXXXXXXXXXXXGXXXXXXXXXXXXXXXXXXXGXXXXXXXXXXXXXXXXXXXGXXXXXXXXXXXXXXXXXXXGXXXXXXXXXXXXXXXXXXXGXXXXXXXXXXXXXXXXXXXGXXXXXXXXXXXXXXXXXXXGXXXXXXXXXXXXXXXXXXX,0,300,0
11004,14,1,13,75,211,0,0,227,104,123,GXXXXXXXXXXXXXXXXXXXGXXXXXXXXXXXXXXXXXXXGXXXXXXXXXXXXXXXXXXXGAXXXXXXXXXXXXXXXXXXGXXXXXXXXXXXXXXXXXXXGXXXXXXXXXXXXXXXXXXXGXXXXXXXXXXXXXXXXXXXGXXXXXXXXXXXXXXXXXXXGXXXXXXXXXXXXXXXXXXXGXXXXXXXXXXXXXXXXXXXGXXXXXXXXXXXXXXXXXXXGXXXXXXXXXXXXXXXXXXXGXXXXXXXXXXXXXXXXXXX,0,300,0

11025,14,1,13,79,207,0,0,223,97,126,GXXXXXXXXXXXXXXXXXXXGXXXXXXXXXXXXXXXXXXXGXXXXXXXXXXXXXXXXXXXGAXXXXXXXXXXXXXXXXXXGXXXXXXXXXXXXXXXXXXXGXXXXXXXXXXXXXXXXXXXGXXXXXXXXXXXXXXXXXXXGXXXXXXXXXXXXXXXXXXXGXXXXXXXXXXXXXXXXXXXGXXXXXXXXXXXXXXXXXXXGXXXXXXXXXXXXXXXXXXXGXXXXXXXXXXXXXXXXXXXGXXXXXXXXXXXXXXXXXXX,0,300,0
11046,14,0,14,80,206,0,0,217,95,122,GXXXXXXXXXXXXXXXXXXXGXXXXXXXXXXXXXXXXXXXGXXXXXXXXXXXXXXXXXXXGOXXXXXXXXXXXXXXXXXXGXXXXXXXXXXXXXXXXXXXGXXXXXXXXXXXXXXXXXXXGXXXXXXXXXXXXXXXXXXXGXXXXXXXXXXXXXXXXXXXGXXXXXXXXXXXXXXXXXXXGXXXXXXXXXXXXXXXXXXXGXXXXXXXXXXXXXXXXXXXGXXXXXXXXXXXXXXXXXXXGXXXXXXXXXXXXXXXXXXX,0,300,0
11067,13,0,13,82,205,0,0,219,99,120,GXXXXXXXXXXXXXXXXXXXGXXXXXXXXXXXXXXXXXXXGXXXXXXXXXXXXXXXXXXXGXXXXXXXXXXXXXXXXXXXGXXXXXXXXXXXXXXXXXXXGXXXXXXXXXXXXXXXXXXXGXXXXXXXXXXXXXXXXXXXGXXXXXXXXXXXXXXXXXXXGXXXXXXXXXXXXXXXXXXXGXXXXXXXXXXXXXXXXXXXGXXXXXXXXXXXXXXXXXXXGXXXXXXXXXXXXXXXXXXXGXXXXXXXXXXXXXXXXXXX,0,300,0
11088,13,0,13,78,209,0,0,223,103,120,GXXXXXXXXXXXXXXXXXXXGXXXXXXXXXXXXXXXXXXXGXXXXXXXXXXXXXXXXXXXGXXXXXXXXXXXXXXXXXXXGXXXXXXXXXXXXXXXXXXXGXXXXXXXXXXXXXXXXXXXGXXXXXXXXXXXXXXXXXXXGXXXXXXXXXXXXXXXXXXXGXXXXXXXXXXXXXXXXXXXGXXXXXXXXXXXXXXXXXXXGXXXXXXXXXXXXXXXXXXXGXXXXXXXXXXXXXXXXXXXGXXXXXXXXXXXXXXXXXXX,0,300,0
11109,13,0,13,73,214,0,0,225,103,122,GXXXXXXXXXXXXXXXXXXXGXXXXXXXXXXXXXXXXXXXGXXXXXXXXXXXXXXXXXXXGXXXXXXXXXXXXXXXXXXXGXXXXXXXXXXXXXXXXXXXGXXXXXXXXXXXXXXXXXXXGXXXXXXXXXXXXXXXXXXXGXXXXXXXXXXXXXXXXXXXGXXXXXXXXXXXXXXXXXXXGXXXXXXXXXXXXXXXXXXXGXXXXXXXXXXXXXXXXXXXGXXXXXXXXXXXXXXXXXXXGXXXXXXXXXXXXXXXXXXX,0,300,0

11130,13,0,13,71,216,0,0,229,105,124,GXXXXXXXXXXXXXXXXXXXGXXXXXXXXXXXXXXXXXXXGXXXXXXXXXXXXXXXXXXXGXXXXXXXXXXXXXXXXXXXGXXXXXXXXXXXXXXXXXXXGXXXXXXXXXXXXXXXXXXXGXXXXXXXXXXXXXXXXXXXGXXXXXXXXXXXXXXXXXXXGXXXXXXXXXXXXXXXXXXXGXXXXXXXXXXXXXXXXXXXGXXXXXXXXXXXXXXXXXXXGXXXXXXXXXXXXXXXXXXXGXXXXXXXXXXXXXXXXXXX,0,300,0
11151,13,0,13,74,213,0,0,224,108,116,GXXXXXXXXXXXXXXXXXXXGXXXXXXXXXXXXXXXXXXXGXXXXXXXXXXXXXXXXXXXGXXXXXXXXXXXXXXXXXXXGXXXXXXXXXXXXXXXXXXXGXXXXXXXXXXXXXXXXXXXGXXXXXXXXXXXXXXXXXXXGXXXXXXXXXXXXXXXXXXXGXXXXXXXXXXXXXXXXXXXGXXXXXXXXXXXXXXXXXXXGXXXXXXXXXXXXXXXXXXXGXXXXXXXXXXXXXXXXXXXGXXXXXXXXXXXXXXXXXXX,0,300,0
11172,13,0,13,75,212,0,0,223,102,121,GXXXXXXXXXXXXXXXXXXXGXXXXXXXXXXXXXXXXXXXGXXXXXXXXXXXXXXXXXXXGXXXXXXXXXXXXXXXXXXXGXXXXXXXXXXXXXXXXXXXGXXXXXXXXXXXXXXXXXXXGXXXXXXXXXXXXXXXXXXXGXXXXXXXXXXXXXXXXXXXGXXXXXXXXXXXXXXXXXXXGXXXXXXXXXXXXXXXXXXXGXXXXXXXXXXXXXXXXXXXGXXXXXXXXXXXXXXXXXXXGXXXXXXXXXXXXXXXXXXX,0,300,0
11193,13,0,13,74,213,0,0,224,106,118,GXXXXXXXXXXXXXXXXXXXGXXXXXXXXXXXXXXXXXXXGXXXXXXXXXXXXXXXXXXXGXXXXXXXXXXXXXXXXXXXGXXXXXXXXXXXXXXXXXXXGXXXXXXXXXXXXXXXXXXXGXXXXXXXXXXXXXXXXXXXGXXXXXXXXXXXXXXXXXXXGXXXXXXXXXXXXXXXXXXXGXXXXXXXXXXXXXXXXXXXGXXXXXXXXXXXXXXXXXXXGXXXXXXXXXXXXXXXXXXXGXXXXXXXXXXXXXXXXXXX,0,300,0
11214,13,0,13,72,215,0,0,228,103,125,GXXXXXXXXXXXXXXXXXXXGXXXXXXXXXXXXXXXXXXXGXXXXXXXXXXXXXXXXXXXGXXXXXXXXXXXXXXXXXXXGXXXXXXXXXXXXXXXXXXXGXXXXXXXXXXXXXXXXXXXGXXXXXXXXXXXXXXXXXXXGXXXXXXXXXXXXXXXXXXXGXXXXXXXXXXXXXXXXXXXGXXXXXXXXXXXXXXXXXXXGXXXXXXXXXXXXXXXXXXXGXXXXXXXXXXXXXXXXXXXGXXXXXXXXXXXXXXXXXXX,0,300,0

11235,13,0,13,69,218,0,0,231,108,123,GXXXXXXXXXXXXXXXXXXXGXXXXXXXXXXXXXXXXXXXGXXXXXXXXXXXXXXXXXXXGXXXXXXXXXXXXXXXXXXXGXXXXXXXXXXXXXXXXXXXGXXXXXXXXXXXXXXXXXXXGXXXXXXXXXXXXXXXXXXXGXXXXXXXXXXXXXXXXXXXGXXXXXXXXXXXXXXXXXXXGXXXXXXXXXXXXXXXXXXXGXXXXXXXXXXXXXXXXXXXGXXXXXXXXXXXXXXXXXXXGXXXXXXXXXXXXXXXXXXX,0,300,0
11256,13,0,13,71,216,0,0,229,109,120,GXXXXXXXXXXXXXXXXXXXGXXXXXXXXXXXXXXXXXXXGXXXXXXXXXXXXXXXXXXXGXXXXXXXXXXXXXXXXXXXGXXXXXXXXXXXXXXXXXXXGXXXXXXXXXXXXXXXXXXXGXXXXXXXXXXXXXXXXXXXGXXXXXXXXXXXXXXXXXXXGXXXXXXXXXXXXXXXXXXXGXXXXXXXXXXXXXXXXXXXGXXXXXXXXXXXXXXXXXXXGXXXXXXXXXXXXXXXXXXXGXXXXXXXXXXXXXXXXXXX,0,300,0
11277,14,1,13,72,214,0,0,227,105,122,GXXXXXXXXXXXXXXXXXXXGXXXXXXXXXXXXXXXXXXXGXXXXXXXXXXXXXXXXXXXGXXXXXXXXXXXXXXXXXXXGXXXXXXXXXXXXXXXXXXXGXXXXXXXXXXXXXXXXXXXGXXXXXXXXXXXXXXXXXXXGAXXXXXXXXXXXXXXXXXXGXXXXXXXXXXXXXXXXXXXGXXXXXXXXXXXXXXXXXXXGXXXXXXXXXXXXXXXXXXXGXXXXXXXXXXXXXXXXXXXGXXXXXXXXXXXXXXXXXXX,0,300,0
11298,14,1,13,76,210,0,0,222,108,114,GXXXXXXXXXXXXXXXXXXXGXXXXXXXXXXXXXXXXXXXGXXXXXXXXXXXXXXXXXXXGXXXXXXXXXXXXXXXXXXXGXXXXXXXXXXXXXXXXXXXGXXXXXXXXXXXXXXXXXXXGXXXXXXXXXXXXXXXXXXXGAXXXXXXXXXXXXXXXXXXGXXXXXXXXXXXXXXXXXXXGXXXXXXXXXXXXXXXXXXXGXXXXXXXXXXXXXXXXXXXGXXXXXXXXXXXXXXXXXXXGXXXXXXXXXXXXXXXXXXX,0,300,0
11319,14,1,13,77,209,0,0,222,104,118,GXXXXXXXXXXXXXXXXXXXGXXXXXXXXXXXXXXXXXXXGXXXXXXXXXXXXXXXXXXXGXXXXXXXXXXXXXXXXXXXGXXXXXXXXXXXXXXXXXXXGXXXXXXXXXXXXXXXXXXXGXXXXXXXXXXXXXXXXXXXGAXXXXXXXXXXXXXXXXXXGXXXXXXXXXXXXXXXXXXXGXXXXXXXXXXXXXXXXXXXGXXXXXXXXXXXXXXXXXXXGXXXXXXXXXXXXXXXXXXXGXXXXXXXXXXXXXXXXXXX,0,300,0

11340,14,1,13,76,210,0,0,223,105,118,GXXXXXXXXXXXXXXXXXXXGXXXXXXXXXXXXXXXXXXXGXXXXXXXXXXXXXXXXXXXGXXXXXXXXXXXXXXXXXXXGXXXXXXXXXXXXXXXXXXXGXXXXXXXXXXXXXXXXXXXGXXXXXXXXXXXXXXXXXXXGAXXXXXXXXXXXXXXXXXXGXXXXXXXXXXXXXXXXXXXGXXXXXXXXXXXXXXXXXXXGXXXXXXXXXXXXXXXXXXXGXXXXXXXXXXXXXXXXXXXGXXXXXXXXXXXXXXXXXXX,0,300,0
11361,14,1,13,75,211,0,0,223,104,119,GXXXXXXXXXXXXXXXXXXXGXXXXXXXXXXXXXXXXXXXGXXXXXXXXXXXXXXXXXXXGXXXXXXXXXXXXXXXXXXXGXXXXXXXXXXXXXXXXXXXGXXXXXXXXXXXXXXXXXXXGXXXXXXXXXXXXXXXXXXXGAXXXXXXXXXXXXXXXXXXGXXXXXXXXXXXXXXXXXXXGXXXXXXXXXXXXXXXXXXXGXXXXXXXXXXXXXXXXXXXGXXXXXXXXXXXXXXXXXXXGXXXXXXXXXXXXXXXXXXX,0,300,0
11382,15,2,13,72,213,0,0,226,107,119,GXXXXXXXXXXXXXXXXXXXGXXXXXXXXXXXXXXXXXXXGXXXXXXXXXXXXXXXXXXXGAXXXXXXXXXXXXXXXXXXGXXXXXXXXXXXXXXXXXXXGXXXXXXXXXXXXXXXXXXXGXXXXXXXXXXXXXXXXXXXGAXXXXXXXXXXXXXXXXXXGXXXXXXXXXXXXXXXXXXXGXXXXXXXXXXXXXXXXXXXGXXXXXXXXXXXXXXXXXXXGXXXXXXXXXXXXXXXXXXXGXXXXXXXXXXXXXXXXXXX,0,300,0
11403,15,2,13,73,212,0,0,226,104,122,GXXXXXXXXXXXXXXXXXXXGXXXXXXXXXXXXXXXXXXXGXXXXXXXXXXXXXXXXXXXGAXXXXXXXXXXXXXXXXXXGXXXXXXXXXXXXXXXXXXXGXXXXXXXXXXXXXXXXXXXGXXXXXXXXXXXXXXXXXXXGAXXXXXXXXXXXXXXXXXXGXXXXXXXXXXXXXXXXXXXGXXXXXXXXXXXXXXXXXXXGXXXXXXXXXXXXXXXXXXXGXXXXXXXXXXXXXXXXXXXGXXXXXXXXXXXXXXXXXXX,0,300,0
11424,15,2,13,64,221,0,0,234,98,136,GXXXXXXXXXXXXXXXXXXXGXXXXXXXXXXXXXXXXXXXGXXXXXXXXXXXXXXXXXXXGAXXXXXXXXXXXXXXXXXXGXXXXXXXXXXXXXXXXXXXGXXXXXXXXXXXXXXXXXXXGXXXXXXXXXXXXXXXXXXXGAXXXXXXXXXXXXXXXXXXGXXXXXXXXXXXXXXXXXXXGXXXXXXXXXXXXXXXXXXXGXXXXXXXXXXXXXXXXXXXGXXXXXXXXXXXXXXXXXXXGXXXXXXXXXXXXXXXXXXX,0,300,0

11445,14,0,14,64,222,0,0,234,97,137,GXXXXXXXXXXXXXXXXXXXGXXXXXXXXXXXXXXXXXXXGXXXXXXXXXXXXXXXXXXXGOXXXXXXXXXXXXXXXXXXGXXXXXXXXXXXXXXXXXXXGXXXXXXXXXXXXXXXXXXXGXXXXXXXXXXXXXXXXXXXGXXXXXXXXXXXXXXXXXXXGXXXXXXXXXXXXXXXXXXXGXXXXXXXXXXXXXXXXXXXGXXXXXXXXXXXXXXXXXXXGXXXXXXXXXXXXXXXXXXXGXXXXXXXXXXXXXXXXXXX,0,300,0
11466,13,0,13,67,220,0,0,234,99,135,GXXXXXXXXXXXXXXXXXXXGXXXXXXXXXXXXXXXXXXXGXXXXXXXXXXXXXXXXXXXGXXXXXXXXXXXXXXXXXXXGXXXXXXXXXXXXXXXXXXXGXXXXXXXXXXXXXXXXXXXGXXXXXXXXXXXXXXXXXXXGXXXXXXXXXXXXXXXXXXXGXXXXXXXXXXXXXXXXXXXGXXXXXXXXXXXXXXXXXXXGXXXXXXXXXXXXXXXXXXXGXXXXXXXXXXXXXXXXXXXGXXXXXXXXXXXXXXXXXXX,0,300,0
11487,13,0,13,61,226,0,0,240,106,134,GXXXXXXXXXXXXXXXXXXXGXXXXXXXXXXXXXXXXXXXGXXXXXXXXXXXXXXXXXXXGXXXXXXXXXXXXXXXXXXXGXXXXXXXXXXXXXXXXXXXGXXXXXXXXXXXXXXXXXXXGXXXXXXXXXXXXXXXXXXXGXXXXXXXXXXXXXXXXXXXGXXXXXXXXXXXXXXXXXXXGXXXXXXXXXXXXXXXXXXXGXXXXXXXXXXXXXXXXXXXGXXXXXXXXXXXXXXXXXXXGXXXXXXXXXXXXXXXXXXX,0,300,0
11508,13,0,13,69,218,0,0,232,105,127,GXXXXXXXXXXXXXXXXXXXGXXXXXXXXXXXXXXXXXXXGXXXXXXXXXXXXXXXXXXXGXXXXXXXXXXXXXXXXXXXGXXXXXXXXXXXXXXXXXXXGXXXXXXXXXXXXXXXXXXXGXXXXXXXXXXXXXXXXXXXGXXXXXXXXXXXXXXXXXXXGXXXXXXXXXXXXXXXXXXXGXXXXXXXXXXXXXXXXXXXGXXXXXXXXXXXXXXXXXXXGXXXXXXXXXXXXXXXXXXXGXXXXXXXXXXXXXXXXXXX,0,300,0
11529,13,0,13,68,219,0,0,233,108,125,GXXXXXXXXXXXXXXXXXXXGXXXXXXXXXXXXXXXXXXXGXXXXXXXXXXXXXXXXXXXGXXXXXXXXXXXXXXXXXXXGXXXXXXXXXXXXXXXXXXXGXXXXXXXXXXXXXXXXXXXGXXXXXXXXXXXXXXXXXXXGXXXXXXXXXXXXXXXXXXXGXXXXXXXXXXXXXXXXXXXGXXXXXXXXXXXXXXXXXXXGXXXXXXXXXXXXXXXXXXXGXXXXXXXXXXXXXXXXXXXGXXXXXXXXXXXXXXXXXXX,0,300,0

11550,13,0,13,71,216,0,0,229,104,125,GXXXXXXXXXXXXXXXXXXXGXXXXXXXXXXXXXXXXXXXGXXXXXXXXXXXXXXXXXXXGXXXXXXXXXXXXXXXXXXXGXXXXXXXXXXXXXXXXXXXGXXXXXXXXXXXXXXXXXXXGXXXXXXXXXXXXXXXXXXXGXXXXXXXXXXXXXXXXXXXGXXXXXXXXXXXXXXXXXXXGXXXXXXXXXXXXXXXXXXXGXXXXXXXXXXXXXXXXXXXGXXXXXXXXXXXXXXXXXXXGXXXXXXXXXXXXXXXXXXX,0,300,0
11571,13,0,13,68,219,0,0,232,107,125,GXXXXXXXXXXXXXXXXXXXGXXXXXXXXXXXXXXXXXXXGXXXXXXXXXXXXXXXXXXXGXXXXXXXXXXXXXXXXXXXGXXXXXXXXXXXXXXXXXXXGXXXXXXXXXXXXXXXXXXXGXXXXXXXXXXXXXXXXXXXGXXXXXXXXXXXXXXXXXXXGXXXXXXXXXXXXXXXXXXXGXXXXXXXXXXXXXXXXXXXGXXXXXXXXXXXXXXXXXXXGXXXXXXXXXXXXXXXXXXXGXXXXXXXXXXXXXXXXXXX,0,300,0
11592,13,0,13,76,211,0,0,223,102,121,GXXXXXXXXXXXXXXXXXXXGXXXXXXXXXXXXXXXXXXXGXXXXXXXXXXXXXXXXXXXGXXXXXXXXXXXXXXXXXXXGXXXXXXXXXXXXXXXXXXXGXXXXXXXXXXXXXXXXXXXGXXXXXXXXXXXXXXXXXXXGXXXXXXXXXXXXXXXXXXXGXXXXXXXXXXXXXXXXXXXGXXXXXXXXXXXXXXXXXXXGXXXXXXXXXXXXXXXXXXXGXXXXXXXXXXXXXXXXXXXGXXXXXXXXXXXXXXXXXXX,0,300,0
11613,13,0,13,74,213,0,0,224,104,120,GXXXXXXXXXXXXXXXXXXXGXXXXXXXXXXXXXXXXXXXGXXXXXXXXXXXXXXXXXXXGXXXXXXXXXXXXXXXXXXXGXXXXXXXXXXXXXXXXXXXGXXXXXXXXXXXXXXXXXXXGXXXXXXXXXXXXXXXXXXXGXXXXXXXXXXXXXXXXXXXGXXXXXXXXXXXXXXXXXXXGXXXXXXXXXXXXXXXXXXXGXXXXXXXXXXXXXXXXXXXGXXXXXXXXXXXXXXXXXXXGXXXXXXXXXXXXXXXXXXX,0,300,0
11634,14,1,13,79,207,0,0,218,104,114,GXXXXXXXXXXXXXXXXXXXGXXXXXXXXXXXXXXXXXXXGXXXXXXXXXXXXXXXXXXXGXXXXXXXXXXXXXXXXXXXGAXXXXXXXXXXXXXXXXXXGXXXXXXXXXXXXXXXXXXXGXXXXXXXXXXXXXXXXXXXGXXXXXXXXXXXXXXXXXXXGXXXXXXXXXXXXXXXXXXXGXXXXXXXXXXXXXXXXXXXGXXXXXXXXXXXXXXXXXXXGXXXXXXXXXXXXXXXXXXXGXXXXXXXXXXXXXXXXXXX,0,300,0

11655,14,1,13,71,215,0,0,225,103,122,GXXXXXXXXXXXXXXXXXXXGXXXXXXXXXXXXXXXXXXXGXXXXXXXXXXXXXXXXXXXGXXXXXXXXXXXXXXXXXXXGAXXXXXXXXXXXXXXXXXXGXXXXXXXXXXXXXXXXXXXGXXXXXXXXXXXXXXXXXXXGXXXXXXXXXXXXXXXXXXXGXXXXXXXXXXXXXXXXXXXGXXXXXXXXXXXXXXXXXXXGXXXXXXXXXXXXXXXXXXXGXXXXXXXXXXXXXXXXXXXGXXXXXXXXXXXXXXXXXXX,0,300,0
11676,14,1,13,70,216,0,0,228,102,126,GXXXXXXXXXXXXXXXXXXXGXXXXXXXXXXXXXXXXXXXGXXXXXXXXXXXXXXXXXXXGXXXXXXXXXXXXXXXXXXXGAXXXXXXXXXXXXXXXXXXGXXXXXXXXXXXXXXXXXXXGXXXXXXXXXXXXXXXXXXXGXXXXXXXXXXXXXXXXXXXGXXXXXXXXXXXXXXXXXXXGXXXXXXXXXXXXXXXXXXXGXXXXXXXXXXXXXXXXXXXGXXXXXXXXXXXXXXXXXXXGXXXXXXXXXXXXXXXXXXX,0,300,0
11697,14,1,13,76,210,0,0,222,102,120,GXXXXXXXXXXXXXXXXXXXGXXXXXXXXXXXXXXXXXXXGXXXXXXXXXXXXXXXXXXXGXXXXXXXXXXXXXXXXXXXGAXXXXXXXXXXXXXXXXXXGXXXXXXXXXXXXXXXXXXXGXXXXXXXXXXXXXXXXXXXGXXXXXXXXXXXXXXXXXXXGXXXXXXXXXXXXXXXXXXXGXXXXXXXXXXXXXXXXXXXGXXXXXXXXXXXXXXXXXXXGXXXXXXXXXXXXXXXXXXXGXXXXXXXXXXXXXXXXXXX,0,300,0
11718,14,1,13,72,214,0,0,226,107,119,GXXXXXXXXXXXXXXXXXXXGXXXXXXXXXXXXXXXXXXXGXXXXXXXXXXXXXXXXXXXGXXXXXXXXXXXXXXXXXXXGAXXXXXXXXXXXXXXXXXXGXXXXXXXXXXXXXXXXXXXGXXXXXXXXXXXXXXXXXXXGXXXXXXXXXXXXXXXXXXXGXXXXXXXXXXXXXXXXXXXGXXXXXXXXXXXXXXXXXXXGXXXXXXXXXXXXXXXXXXXGXXXXXXXXXXXXXXXXXXXGXXXXXXXXXXXXXXXXXXX,0,300,0
11739,15,2,13,71,214,0,0,226,101,125,GXXXXXXXXXXXXXXXXXXXGXXXXXXXXXXXXXXXXXXXGXXXXXXXXXXXXXXXXXXXGXXXXXXXXXXXXXXXXXXXGAXXXXXXXXXXXXXXXXXXGXXXXXXXXXXXXXXXXXXXGAXXXXXXXXXXXXXXXXXXGXXXXXXXXXXXXXXXXXXXGXXXXXXXXXXXXXXXXXXXGXXXXXXXXXXXXXXXXXXXGXXXXXXXXXXXXXXXXXXXGXXXXXXXXXXXXXXXXXXXGXXXXXXXXXXXXXXXXXXX,0,300,0

11760,15,2,13,74,211,0,0,224,100,124,GXXXXXXXXXXXXXXXXXXXGXXXXXXXXXXXXXXXXXXXGXXXXXXXXXXXXXXXXXXXGXXXXXXXXXXXXXXXXXXXGAXXXXXXXXXXXXXXXXXXGXXXXXXXXXXXXXXXXXXXGAXXXXXXXXXXXXXXXXXXGXXXXXXXXXXXXXXXXXXXGXXXXXXXXXXXXXXXXXXXGXXXXXXXXXXXXXXXXXXXGXXXXXXXXXXXXXXXXXXXGXXXXXXXXXXXXXXXXXXXGXXXXXXXXXXXXXXXXXXX,0,300,0
11781,15,1,14,65,220,0,0,232,103,129,GXXXXXXXXXXXXXXXXXXXGXXXXXXXXXXXXXXXXXXXGXXXXXXXXXXXXXXXXXXXGXXXXXXXXXXXXXXXXXXXGAXXXXXXXXXXXXXXXXXXGXXXXXXXXXXXXXXXXXXXGOXXXXXXXXXXXXXXXXXXGXXXXXXXXXXXXXXXXXXXGXXXXXXXXXXXXXXXXXXXGXXXXXXXXXXXXXXXXXXXGXXXXXXXXXXXXXXXXXXXGXXXXXXXXXXXXXXXXXXXGXXXXXXXXXXXXXXXXXXX,0,300,0
11802,14,1,13,61,225,0,0,238,105,133,GXXXXXXXXXXXXXXXXXXXGXXXXXXXXXXXXXXXXXXXGXXXXXXXXXXXXXXXXXXXGXXXXXXXXXXXXXXXXXXXGAXXXXXXXXXXXXXXXXXXGXXXXXXXXXXXXXXXXXXXGXXXXXXXXXXXXXXXXXXXGXXXXXXXXXXXXXXXXXXXGXXXXXXXXXXXXXXXXXXXGXXXXXXXXXXXXXXXXXXXGXXXXXXXXXXXXXXXXXXXGXXXXXXXXXXXXXXXXXXXGXXXXXXXXXXXXXXXXXXX,0,300,0
11823,14,1,13,68,218,0,0,231,105,126,GXXXXXXXXXXXXXXXXXXXGXXXXXXXXXXXXXXXXXXXGXXXXXXXXXXXXXXXXXXXGXXXXXXXXXXXXXXXXXXXGAXXXXXXXXXXXXXXXXXXGXXXXXXXXXXXXXXXXXXXGXXXXXXXXXXXXXXXXXXXGXXXXXXXXXXXXXXXXXXXGXXXXXXXXXXXXXXXXXXXGXXXXXXXXXXXXXXXXXXXGXXXXXXXXXXXXXXXXXXXGXXXXXXXXXXXXXXXXXXXGXXXXXXXXXXXXXXXXXXX,0,300,0
11844,14,1,13,64,222,0,0,234,110,124,GXXXXXXXXXXXXXXXXXXXGXXXXXXXXXXXXXXXXXXXGXXXXXXXXXXXXXXXXXXXGXXXXXXXXXXXXXXXXXXXGAXXXXXXXXXXXXXXXXXXGXXXXXXXXXXXXXXXXXXXGXXXXXXXXXXXXXXXXXXXGXXXXXXXXXXXXXXXXXXXGXXXXXXXXXXXXXXXXXXXGXXXXXXXXXXXXXXXXXXXGXXXXXXXXXXXXXXXXXXXGXXXXXXXXXXXXXXXXXXXGXXXXXXXXXXXXXXXXXXX,0,300,0

11865,14,1,13,63,223,0,0,235,112,123,GXXXXXXXXXXXXXXXXXXXGXXXXXXXXXXXXXXXXXXXGXXXXXXXXXXXXXXXXXXXGXXXXXXXXXXXXXXXXXXXGAXXXXXXXXXXXXXXXXXXGXXXXXXXXXXXXXXXXXXXGXXXXXXXXXXXXXXXXXXXGXXXXXXXXXXXXXXXXXXXGXXXXXXXXXXXXXXXXXXXGXXXXXXXXXXXXXXXXXXXGXXXXXXXXXXXXXXXXXXXGXXXXXXXXXXXXXXXXXXXGXXXXXXXXXXXXXXXXXXX,0,300,0
11886,14,1,13,65,221,0,0,233,108,125,GXXXXXXXXXXXXXXXXXXXGXXXXXXXXXXXXXXXXXXXGXXXXXXXXXXXXXXXXXXXGXXXXXXXXXXXXXXXXXXXGAXXXXXXXXXXXXXXXXXXGXXXXXXXXXXXXXXXXXXXGXXXXXXXXXXXXXXXXXXXGXXXXXXXXXXXXXXXXXXXGXXXXXXXXXXXXXXXXXXXGXXXXXXXXXXXXXXXXXXXGXXXXXXXXXXXXXXXXXXXGXXXXXXXXXXXXXXXXXXXGXXXXXXXXXXXXXXXXXXX,0,300,0
11907,13,0,13,71,216,0,0,228,104,124,GXXXXXXXXXXXXXXXXXXXGXXXXXXXXXXXXXXXXXXXGXXXXXXXXXXXXXXXXXXXGXXXXXXXXXXXXXXXXXXXGXXXXXXXXXXXXXXXXXXXGXXXXXXXXXXXXXXXXXXXGXXXXXXXXXXXXXXXXXXXGXXXXXXXXXXXXXXXXXXXGXXXXXXXXXXXXXXXXXXXGXXXXXXXXXXXXXXXXXXXGXXXXXXXXXXXXXXXXXXXGXXXXXXXXXXXXXXXXXXXGXXXXXXXXXXXXXXXXXXX,0,300,0
11928,13,0,13,69,218,0,0,228,102,126,GXXXXXXXXXXXXXXXXXXXGXXXXXXXXXXXXXXXXXXXGXXXXXXXXXXXXXXXXXXXGXXXXXXXXXXXXXXXXXXXGXXXXXXXXXXXXXXXXXXXGXXXXXXXXXXXXXXXXXXXGXXXXXXXXXXXXXXXXXXXGXXXXXXXXXXXXXXXXXXXGXXXXXXXXXXXXXXXXXXXGXXXXXXXXXXXXXXXXXXXGXXXXXXXXXXXXXXXXXXXGXXXXXXXXXXXXXXXXXXXGXXXXXXXXXXXXXXXXXXX,0,300,0
11949,13,0,13,68,219,0,0,231,100,131,GXXXXXXXXXXXXXXXXXXXGXXXXXXXXXXXXXXXXXXXGXXXXXXXXXXXXXXXXXXXGXXXXXXXXXXXXXXXXXXXGXXXXXXXXXXXXXXXXXXXGXXXXXXXXXXXXXXXXXXXGXXXXXXXXXXXXXXXXXXXGXXXXXXXXXXXXXXXXXXXGXXXXXXXXXXXXXXXXXXXGXXXXXXXXXXXXXXXXXXXGXXXXXXXXXXXXXXXXXXXGXXXXXXXXXXXXXXXXXXXGXXXXXXXXXXXXXXXXXXX,0,300,0

11970,13,0,13,61,226,0,0,238,103,135,GXXXXXXXXXXXXXXXXXXXGXXXXXXXXXXXXXXXXXXXGXXXXXXXXXXXXXXXXXXXGXXXXXXXXXXXXXXXXXXXGXXXXXXXXXXXXXXXXXXXGXXXXXXXXXXXXXXXXXXXGXXXXXXXXXXXXXXXXXXXGXXXXXXXXXXXXXXXXXXXGXXXXXXXXXXXXXXXXXXXGXXXXXXXXXXXXXXXXXXXGXXXXXXXXXXXXXXXXXXXGXXXXXXXXXXXXXXXXXXXGXXXXXXXXXXXXXXXXXXX,0,300,0
11991,13,0,13,56,231,0,0,243,101,142,GXXXXXXXXXXXXXXXXXXXGXXXXXXXXXXXXXXXXXXXGXXXXXXXXXXXXXXXXXXXGXXXXXXXXXXXXXXXXXXXGXXXXXXXXXXXXXXXXXXXGXXXXXXXXXXXXXXXXXXXGXXXXXXXXXXXXXXXXXXXGXXXXXXXXXXXXXXXXXXXGXXXXXXXXXXXXXXXXXXXGXXXXXXXXXXXXXXXXXXXGXXXXXXXXXXXXXXXXXXXGXXXXXXXXXXXXXXXXXXXGXXXXXXXXXXXXXXXXXXX,0,300,0
12012,13,0,13,56,231,0,0,244,112,132,GXXXXXXXXXXXXXXXXXXXGXXXXXXXXXXXXXXXXXXXGXXXXXXXXXXXXXXXXXXXGXXXXXXXXXXXXXXXXXXXGXXXXXXXXXXXXXXXXXXXGXXXXXXXXXXXXXXXXXXXGXXXXXXXXXXXXXXXXXXXGXXXXXXXXXXXXXXXXXXXGXXXXXXXXXXXXXXXXXXXGXXXXXXXXXXXXXXXXXXXGXXXXXXXXXXXXXXXXXXXGXXXXXXXXXXXXXXXXXXXGXXXXXXXXXXXXXXXXXXX,0,300,0
12033,13,0,13,59,228,0,0,240,108,132,GXXXXXXXXXXXXXXXXXXXGXXXXXXXXXXXXXXXXXXXGXXXXXXXXXXXXXXXXXXXGXXXXXXXXXXXXXXXXXXXGXXXXXXXXXXXXXXXXXXXGXXXXXXXXXXXXXXXXXXXGXXXXXXXXXXXXXXXXXXXGXXXXXXXXXXXXXXXXXXXGXXXXXXXXXXXXXXXXXXXGXXXXXXXXXXXXXXXXXXXGXXXXXXXXXXXXXXXXXXXGXXXXXXXXXXXXXXXXXXXGXXXXXXXXXXXXXXXXXXX,0,300,0
12054,13,0,13,59,228,0,0,239,111,128,GXXXXXXXXXXXXXXXXXXXGXXXXXXXXXXXXXXXXXXXGXXXXXXXXXXXXXXXXXXXGXXXXXXXXXXXXXXXXXXXGXXXXXXXXXXXXXXXXXXXGXXXXXXXXXXXXXXXXXXXGXXXXXXXXXXXXXXXXXXXGXXXXXXXXXXXXXXXXXXXGXXXXXXXXXXXXXXXXXXXGXXXXXXXXXXXXXXXXXXXGXXXXXXXXXXXXXXXXXXXGXXXXXXXXXXXXXXXXXXXGXXXXXXXXXXXXXXXXXXX,0,300,0

12075,13,0,13,68,219,0,0,231,107,124,GXXXXXXXXXXXXXXXXXXXGXXXXXXXXXXXXXXXXXXXGXXXXXXXXXXXXXXXXXXXGXXXXXXXXXXXXXXXXXXXGXXXXXXXXXXXXXXXXXXXGXXXXXXXXXXXXXXXXXXXGXXXXXXXXXXXXXXXXXXXGXXXXXXXXXXXXXXXXXXXGXXXXXXXXXXXXXXXXXXXGXXXXXXXXXXXXXXXXXXXGXXXXXXXXXXXXXXXXXXXGXXXXXXXXXXXXXXXXXXXGXXXXXXXXXXXXXXXXXXX,0,300,0
12096,13,0,13,72,215,0,0,227,103,124,GXXXXXXXXXXXXXXXXXXXGXXXXXXXXXXXXXXXXXXXGXXXXXXXXXXXXXXXXXXXGXXXXXXXXXXXXXXXXXXXGXXXXXXXXXXXXXXXXXXXGXXXXXXXXXXXXXXXXXXXGXXXXXXXXXXXXXXXXXXXGXXXXXXXXXXXXXXXXXXXGXXXXXXXXXXXXXXXXXXXGXXXXXXXXXXXXXXXXXXXGXXXXXXXXXXXXXXXXXXXGXXXXXXXXXXXXXXXXXXXGXXXXXXXXXXXXXXXXXXX,0,300,0
12117,13,0,13,72,215,0,0,227,100,127,GXXXXXXXXXXXXXXXXXXXGXXXXXXXXXXXXXXXXXXXGXXXXXXXXXXXXXXXXXXXGXXXXXXXXXXXXXXXXXXXGXXXXXXXXXXXXXXXXXXXGXXXXXXXXXXXXXXXXXXXGXXXXXXXXXXXXXXXXXXXGXXXXXXXXXXXXXXXXXXXGXXXXXXXXXXXXXXXXXXXGXXXXXXXXXXXXXXXXXXXGXXXXXXXXXXXXXXXXXXXGXXXXXXXXXXXXXXXXXXXGXXXXXXXXXXXXXXXXXXX,0,300,0
12138,13,0,13,73,214,0,0,225,104,121,GXXXXXXXXXXXXXXXXXXXGXXXXXXXXXXXXXXXXXXXGXXXXXXXXXXXXXXXXXXXGXXXXXXXXXXXXXXXXXXXGXXXXXXXXXXXXXXXXXXXGXXXXXXXXXXXXXXXXXXXGXXXXXXXXXXXXXXXXXXXGXXXXXXXXXXXXXXXXXXXGXXXXXXXXXXXXXXXXXXXGXXXXXXXXXXXXXXXXXXXGXXXXXXXXXXXXXXXXXXXGXXXXXXXXXXXXXXXXXXXGXXXXXXXXXXXXXXXXXXX,0,300,0
12159,13,0,13,76,211,0,0,222,104,118,GXXXXXXXXXXXXXXXXXXXGXXXXXXXXXXXXXXXXXXXGXXXXXXXXXXXXXXXXXXXGXXXXXXXXXXXXXXXXXXXGXXXXXXXXXXXXXXXXXXXGXXXXXXXXXXXXXXXXXXXGXXXXXXXXXXXXXXXXXXXGXXXXXXXXXXXXXXXXXXXGXXXXXXXXXXXXXXXXXXXGXXXXXXXXXXXXXXXXXXXGXXXXXXXXXXXXXXXXXXXGXXXXXXXXXXXXXXXXXXXGXXXXXXXXXXXXXXXXXXX,0,300,0

12180,13,0,13,72,215,0,0,227,106,121,GXXXXXXXXXXXXXXXXXXXGXXXXXXXXXXXXXXXXXXXGXXXXXXXXXXXXXXXXXXXGXXXXXXXXXXXXXXXXXXXGXXXXXXXXXXXXXXXXXXXGXXXXXXXXXXXXXXXXXXXGXXXXXXXXXXXXXXXXXXXGXXXXXXXXXXXXXXXXXXXGXXXXXXXXXXXXXXXXXXXGXXXXXXXXXXXXXXXXXXXGXXXXXXXXXXXXXXXXXXXGXXXXXXXXXXXXXXXXXXXGXXXXXXXXXXXXXXXXXXX,0,300,0
12201,13,0,13,80,207,0,0,220,109,111,GXXXXXXXXXXXXXXXXXXXGXXXXXXXXXXXXXXXXXXXGXXXXXXXXXXXXXXXXXXXGXXXXXXXXXXXXXXXXXXXGXXXXXXXXXXXXXXXXXXXGXXXXXXXXXXXXXXXXXXXGXXXXXXXXXXXXXXXXXXXGXXXXXXXXXXXXXXXXXXXGXXXXXXXXXXXXXXXXXXXGXXXXXXXXXXXXXXXXXXXGXXXXXXXXXXXXXXXXXXXGXXXXXXXXXXXXXXXXXXXGXXXXXXXXXXXXXXXXXXX,0,300,0
12222,13,0,13,74,213,0,0,226,108,118,GXXXXXXXXXXXXXXXXXXXGXXXXXXXXXXXXXXXXXXXGXXXXXXXXXXXXXXXXXXXGXXXXXXXXXXXXXXXXXXXGXXXXXXXXXXXXXXXXXXXGXXXXXXXXXXXXXXXXXXXGXXXXXXXXXXXXXXXXXXXGXXXXXXXXXXXXXXXXXXXGXXXXXXXXXXXXXXXXXXXGXXXXXXXXXXXXXXXXXXXGXXXXXXXXXXXXXXXXXXXGXXXXXXXXXXXXXXXXXXXGXXXXXXXXXXXXXXXXXXX,0,300,0
12243,13,0,13,72,215,0,0,226,105,121,GXXXXXXXXXXXXXXXXXXXGXXXXXXXXXXXXXXXXXXXGXXXXXXXXXXXXXXXXXXXGXXXXXXXXXXXXXXXXXXXGXXXXXXXXXXXXXXXXXXXGXXXXXXXXXXXXXXXXXXXGXXXXXXXXXXXXXXXXXXXGXXXXXXXXXXXXXXXXXXXGXXXXXXXXXXXXXXXXXXXGXXXXXXXXXXXXXXXXXXXGXXXXXXXXXXXXXXXXXXXGXXXXXXXXXXXXXXXXXXXGXXXXXXXXXXXXXXXXXXX,0,300,0
12264,13,0,13,70,217,0,0,227,103,124,GXXXXXXXXXXXXXXXXXXXGXXXXXXXXXXXXXXXXXXXGXXXXXXXXXXXXXXXXXXXGXXXXXXXXXXXXXXXXXXXGXXXXXXXXXXXXXXXXXXXGXXXXXXXXXXXXXXXXXXXGXXXXXXXXXXXXXXXXXXXGXXXXXXXXXXXXXXXXXXXGXXXXXXXXXXXXXXXXXXXGXXXXXXXXXXXXXXXXXXXGXXXXXXXXXXXXXXXXXXXGXXXXXXXXXXXXXXXXXXXGXXXXXXXXXXXXXXXXXXX,0,300,0

12285,13,0,13,68,219,0,0,232,104,128,GXXXXXXXXXXXXXXXXXXXGXXXXXXXXXXXXXXXXXXXGXXXXXXXXXXXXXXXXXXXGXXXXXXXXXXXXXXXXXXXGXXXXXXXXXXXXXXXXXXXGXXXXXXXXXXXXXXXXXXXGXXXXXXXXXXXXXXXXXXXGXXXXXXXXXXXXXXXXXXXGXXXXXXXXXXXXXXXXXXXGXXXXXXXXXXXXXXXXXXXGXXXXXXXXXXXXXXXXXXXGXXXXXXXXXXXXXXXXXXXGXXXXXXXXXXXXXXXXXXX,0,300,0
12306,13,0,13,71,216,0,0,229,112,117,GXXXXXXXXXXXXXXXXXXXGXXXXXXXXXXXXXXXXXXXGXXXXXXXXXXXXXXXXXXXGXXXXXXXXXXXXXXXXXXXGXXXXXXXXXXXXXXXXXXXGXXXXXXXXXXXXXXXXXXXGXXXXXXXXXXXXXXXXXXXGXXXXXXXXXXXXXXXXXXXGXXXXXXXXXXXXXXXXXXXGXXXXXXXXXXXXXXXXXXXGXXXXXXXXXXXXXXXXXXXGXXXXXXXXXXXXXXXXXXXGXXXXXXXXXXXXXXXXXXX,0,300,0
12327,13,0,13,75,212,0,0,225,109,116,GXXXXXXXXXXXXXXXXXXXGXXXXXXXXXXXXXXXXXXXGXXXXXXXXXXXXXXXXXXXGXXXXXXXXXXXXXXXXXXXGXXXXXXXXXXXXXXXXXXXGXXXXXXXXXXXXXXXXXXXGXXXXXXXXXXXXXXXXXXXGXXXXXXXXXXXXXXXXXXXGXXXXXXXXXXXXXXXXXXXGXXXXXXXXXXXXXXXXXXXGXXXXXXXXXXXXXXXXXXXGXXXXXXXXXXXXXXXXXXXGXXXXXXXXXXXXXXXXXXX,0,300,0
12348,13,0,13,74,213,0,0,226,105,121,GXXXXXXXXXXXXXXXXXXXGXXXXXXXXXXXXXXXXXXXGXXXXXXXXXXXXXXXXXXXGXXXXXXXXXXXXXXXXXXXGXXXXXXXXXXXXXXXXXXXGXXXXXXXXXXXXXXXXXXXGXXXXXXXXXXXXXXXXXXXGXXXXXXXXXXXXXXXXXXXGXXXXXXXXXXXXXXXXXXXGXXXXXXXXXXXXXXXXXXXGXXXXXXXXXXXXXXXXXXXGXXXXXXXXXXXXXXXXXXXGXXXXXXXXXXXXXXXXXXX,0,300,0
12369,13,0,13,72,215,0,0,228,104,124,GXXXXXXXXXXXXXXXXXXXGXXXXXXXXXXXXXXXXXXXGXXXXXXXXXXXXXXXXXXXGXXXXXXXXXXXXXXXXXXXGXXXXXXXXXXXXXXXXXXXGXXXXXXXXXXXXXXXXXXXGXXXXXXXXXXXXXXXXXXXGXXXXXXXXXXXXXXXXXXXGXXXXXXXXXXXXXXXXXXXGXXXXXXXXXXXXXXXXXXXGXXXXXXXXXXXXXXXXXXXGXXXXXXXXXXXXXXXXXXXGXXXXXXXXXXXXXXXXXXX,0,300,0

12390,13,0,13,76,211,0,0,224,99,125,GXXXXXXXXXXXXXXXXXXXGXXXXXXXXXXXXXXXXXXXGXXXXXXXXXXXXXXXXXXXGXXXXXXXXXXXXXXXXXXXGXXXXXXXXXXXXXXXXXXXGXXXXXXXXXXXXXXXXXXXGXXXXXXXXXXXXXXXXXXXGXXXXXXXXXXXXXXXXXXXGXXXXXXXXXXXXXXXXXXXGXXXXXXXXXXXXXXXXXXXGXXXXXXXXXXXXXXXXXXXGXXXXXXXXXXXXXXXXXXXGXXXXXXXXXXXXXXXXXXX,0,300,0
12411,13,0,13,66,221,0,0,233,100,133,GXXXXXXXXXXXXXXXXXXXGXXXXXXXXXXXXXXXXXXXGXXXXXXXXXXXXXXXXXXXGXXXXXXXXXXXXXXXXXXXGXXXXXXXXXXXXXXXXXXXGXXXXXXXXXXXXXXXXXXXGXXXXXXXXXXXXXXXXXXXGXXXXXXXXXXXXXXXXXXXGXXXXXXXXXXXXXXXXXXXGXXXXXXXXXXXXXXXXXXXGXXXXXXXXXXXXXXXXXXXGXXXXXXXXXXXXXXXXXXXGXXXXXXXXXXXXXXXXXXX,0,300,0
12432,13,0,13,67,220,0,0,233,101,132,GXXXXXXXXXXXXXXXXXXXGXXXXXXXXXXXXXXXXXXXGXXXXXXXXXXXXXXXXXXXGXXXXXXXXXXXXXXXXXXXGXXXXXXXXXXXXXXXXXXXGXXXXXXXXXXXXXXXXXXXGXXXXXXXXXXXXXXXXXXXGXXXXXXXXXXXXXXXXXXXGXXXXXXXXXXXXXXXXXXXGXXXXXXXXXXXXXXXXXXXGXXXXXXXXXXXXXXXXXXXGXXXXXXXXXXXXXXXXXXXGXXXXXXXXXXXXXXXXXXX,0,300,0
12453,13,0,13,63,224,0,0,237,107,130,GXXXXXXXXXXXXXXXXXXXGXXXXXXXXXXXXXXXXXXXGXXXXXXXXXXXXXXXXXXXGXXXXXXXXXXXXXXXXXXXGXXXXXXXXXXXXXXXXXXXGXXXXXXXXXXXXXXXXXXXGXXXXXXXXXXXXXXXXXXXGXXXXXXXXXXXXXXXXXXXGXXXXXXXXXXXXXXXXXXXGXXXXXXXXXXXXXXXXXXXGXXXXXXXXXXXXXXXXXXXGXXXXXXXXXXXXXXXXXXXGXXXXXXXXXXXXXXXXXXX,0,300,0
12474,13,0,13,63,224,0,0,236,109,127,GXXXXXXXXXXXXXXXXXXXGXXXXXXXXXXXXXXXXXXXGXXXXXXXXXXXXXXXXXXXGXXXXXXXXXXXXXXXXXXXGXXXXXXXXXXXXXXXXXXXGXXXXXXXXXXXXXXXXXXXGXXXXXXXXXXXXXXXXXXXGXXXXXXXXXXXXXXXXXXXGXXXXXXXXXXXXXXXXXXXGXXXXXXXXXXXXXXXXXXXGXXXXXXXXXXXXXXXXXXXGXXXXXXXXXXXXXXXXXXXGXXXXXXXXXXXXXXXXXXX,0,300,0

12495,13,0,13,65,222,0,0,234,113,121,GXXXXXXXXXXXXXXXXXXXGXXXXXXXXXXXXXXXXXXXGXXXXXXXXXXXXXXXXXXXGXXXXXXXXXXXXXXXXXXXGXXXXXXXXXXXXXXXXXXXGXXXXXXXXXXXXXXXXXXXGXXXXXXXXXXXXXXXXXXXGXXXXXXXXXXXXXXXXXXXGXXXXXXXXXXXXXXXXXXXGXXXXXXXXXXXXXXXXXXXGXXXXXXXXXXXXXXXXXXXGXXXXXXXXXXXXXXXXXXXGXXXXXXXXXXXXXXXXXXX,0,300,0
12516,13,0,13,66,221,0,0,234,104,130,GXXXXXXXXXXXXXXXXXXXGXXXXXXXXXXXXXXXXXXXGXXXXXXXXXXXXXXXXXXXGXXXXXXXXXXXXXXXXXXXGXXXXXXXXXXXXXXXXXXXGXXXXXXXXXXXXXXXXXXXGXXXXXXXXXXXXXXXXXXXGXXXXXXXXXXXXXXXXXXXGXXXXXXXXXXXXXXXXXXXGXXXXXXXXXXXXXXXXXXXGXXXXXXXXXXXXXXXXXXXGXXXXXXXXXXXXXXXXXXXGXXXXXXXXXXXXXXXXXXX,0,300,0
12537,13,0,13,62,225,0,0,238,107,131,GXXXXXXXXXXXXXXXXXXXGXXXXXXXXXXXXXXXXXXXGXXXXXXXXXXXXXXXXXXXGXXXXXXXXXXXXXXXXXXXGXXXXXXXXXXXXXXXXXXXGXXXXXXXXXXXXXXXXXXXGXXXXXXXXXXXXXXXXXXXGXXXXXXXXXXXXXXXXXXXGXXXXXXXXXXXXXXXXXXXGXXXXXXXXXXXXXXXXXXXGXXXXXXXXXXXXXXXXXXXGXXXXXXXXXXXXXXXXXXXGXXXXXXXXXXXXXXXXXXX,0,300,0
12558,13,0,13,64,223,0,0,235,109,126,GXXXXXXXXXXXXXXXXXXXGXXXXXXXXXXXXXXXXXXXGXXXXXXXXXXXXXXXXXXXGXXXXXXXXXXXXXXXXXXXGXXXXXXXXXXXXXXXXXXXGXXXXXXXXXXXXXXXXXXXGXXXXXXXXXXXXXXXXXXXGXXXXXXXXXXXXXXXXXXXGXXXXXXXXXXXXXXXXXXXGXXXXXXXXXXXXXXXXXXXGXXXXXXXXXXXXXXXXXXXGXXXXXXXXXXXXXXXXXXXGXXXXXXXXXXXXXXXXXXX,0,300,0
12579,13,0,13,72,215,0,0,227,108,119,GXXXXXXXXXXXXXXXXXXXGXXXXXXXXXXXXXXXXXXXGXXXXXXXXXXXXXXXXXXXGXXXXXXXXXXXXXXXXXXXGXXXXXXXXXXXXXXXXXXXGXXXXXXXXXXXXXXXXXXXGXXXXXXXXXXXXXXXXXXXGXXXXXXXXXXXXXXXXXXXGXXXXXXXXXXXXXXXXXXXGXXXXXXXXXXXXXXXXXXXGXXXXXXXXXXXXXXXXXXXGXXXXXXXXXXXXXXXXXXXGXXXXXXXXXXXXXXXXXXX,0,300,0

12600,13,0,13,69,218,0,0,231,108,123,GXXXXXXXXXXXXXXXXXXXGXXXXXXXXXXXXXXXXXXXGXXXXXXXXXXXXXXXXXXXGXXXXXXXXXXXXXXXXXXXGXXXXXXXXXXXXXXXXXXXGXXXXXXXXXXXXXXXXXXXGXXXXXXXXXXXXXXXXXXXGXXXXXXXXXXXXXXXXXXXGXXXXXXXXXXXXXXXXXXXGXXXXXXXXXXXXXXXXXXXGXXXXXXXXXXXXXXXXXXXGXXXXXXXXXXXXXXXXXXXGXXXXXXXXXXXXXXXXXXX,0,300,0
12621,13,0,13,71,216,0,0,230,110,120,GXXXXXXXXXXXXXXXXXXXGXXXXXXXXXXXXXXXXXXXGXXXXXXXXXXXXXXXXXXXGXXXXXXXXXXXXXXXXXXXGXXXXXXXXXXXXXXXXXXXGXXXXXXXXXXXXXXXXXXXGXXXXXXXXXXXXXXXXXXXGXXXXXXXXXXXXXXXXXXXGXXXXXXXXXXXXXXXXXXXGXXXXXXXXXXXXXXXXXXXGXXXXXXXXXXXXXXXXXXXGXXXXXXXXXXXXXXXXXXXGXXXXXXXXXXXXXXXXXXX,0,300,0
12642,13,0,13,67,220,0,0,234,110,124,GXXXXXXXXXXXXXXXXXXXGXXXXXXXXXXXXXXXXXXXGXXXXXXXXXXXXXXXXXXXGXXXXXXXXXXXXXXXXXXXGXXXXXXXXXXXXXXXXXXXGXXXXXXXXXXXXXXXXXXXGXXXXXXXXXXXXXXXXXXXGXXXXXXXXXXXXXXXXXXXGXXXXXXXXXXXXXXXXXXXGXXXXXXXXXXXXXXXXXXXGXXXXXXXXXXXXXXXXXXXGXXXXXXXXXXXXXXXXXXXGXXXXXXXXXXXXXXXXXXX,0,300,0
12663,13,0,13,72,215,0,0,228,114,114,GXXXXXXXXXXXXXXXXXXXGXXXXXXXXXXXXXXXXXXXGXXXXXXXXXXXXXXXXXXXGXXXXXXXXXXXXXXXXXXXGXXXXXXXXXXXXXXXXXXXGXXXXXXXXXXXXXXXXXXXGXXXXXXXXXXXXXXXXXXXGXXXXXXXXXXXXXXXXXXXGXXXXXXXXXXXXXXXXXXXGXXXXXXXXXXXXXXXXXXXGXXXXXXXXXXXXXXXXXXXGXXXXXXXXXXXXXXXXXXXGXXXXXXXXXXXXXXXXXXX,0,300,0
12684,13,0,13,84,203,0,0,216,103,113,GXXXXXXXXXXXXXXXXXXXGXXXXXXXXXXXXXXXXXXXGXXXXXXXXXXXXXXXXXXXGXXXXXXXXXXXXXXXXXXXGXXXXXXXXXXXXXXXXXXXGXXXXXXXXXXXXXXXXXXXGXXXXXXXXXXXXXXXXXXXGXXXXXXXXXXXXXXXXXXXGXXXXXXXXXXXXXXXXXXXGXXXXXXXXXXXXXXXXXXXGXXXXXXXXXXXXXXXXXXXGXXXXXXXXXXXXXXXXXXXGXXXXXXXXXXXXXXXXXXX,0,300,0

12705,13,0,13,86,201,0,0,214,104,110,GXXXXXXXXXXXXXXXXXXXGXXXXXXXXXXXXXXXXXXXGXXXXXXXXXXXXXXXXXXXGXXXXXXXXXXXXXXXXXXXGXXXXXXXXXXXXXXXXXXXGXXXXXXXXXXXXXXXXXXXGXXXXXXXXXXXXXXXXXXXGXXXXXXXXXXXXXXXXXXXGXXXXXXXXXXXXXXXXXXXGXXXXXXXXXXXXXXXXXXXGXXXXXXXXXXXXXXXXXXXGXXXXXXXXXXXXXXXXXXXGXXXXXXXXXXXXXXXXXXX,0,300,0
12726,15,2,13,80,205,0,0,218,104,114,GXXXXXXXXXXXXXXXXXXXGXXXXXXXXXXXXXXXXXXXGXXXXXXXXXXXXXXXXXXXGXXXXXXXXXXXXXXXXXXXGXXXXXXXXXXXXXXXXXXXGAXXXXXXXXXXXXXXXXXXGXXXXXXXXXXXXXXXXXXXGXXXXXXXXXXXXXXXXXXXGXXXXXXXXXXXXXXXXXXXGXXXXXXXXXXXXXXXXXXXGAXXXXXXXXXXXXXXXXXXGXXXXXXXXXXXXXXXXXXXGXXXXXXXXXXXXXXXXXXX,0,300,0
12747,15,0,15,77,208,0,0,221,108,113,GXXXXXXXXXXXXXXXXXXXGXXXXXXXXXXXXXXXXXXXGXXXXXXXXXXXXXXXXXXXGXXXXXXXXXXXXXXXXXXXGXXXXXXXXXXXXXXXXXXXGOXXXXXXXXXXXXXXXXXXGXXXXXXXXXXXXXXXXXXXGXXXXXXXXXXXXXXXXXXXGXXXXXXXXXXXXXXXXXXXGXXXXXXXXXXXXXXXXXXXGOXXXXXXXXXXXXXXXXXXGXXXXXXXXXXXXXXXXXXXGXXXXXXXXXXXXXXXXXXX,0,300,0
12768,13,0,13,72,215,0,0,228,115,113,GXXXXXXXXXXXXXXXXXXXGXXXXXXXXXXXXXXXXXXXGXXXXXXXXXXXXXXXXXXXGXXXXXXXXXXXXXXXXXXXGXXXXXXXXXXXXXXXXXXXGXXXXXXXXXXXXXXXXXXXGXXXXXXXXXXXXXXXXXXXGXXXXXXXXXXXXXXXXXXXGXXXXXXXXXXXXXXXXXXXGXXXXXXXXXXXXXXXXXXXGXXXXXXXXXXXXXXXXXXXGXXXXXXXXXXXXXXXXXXXGXXXXXXXXXXXXXXXXXXX,0,300,0
12789,13,0,13,76,211,0,0,224,116,108,GXXXXXXXXXXXXXXXXXXXGXXXXXXXXXXXXXXXXXXXGXXXXXXXXXXXXXXXXXXXGXXXXXXXXXXXXXXXXXXXGXXXXXXXXXXXXXXXXXXXGXXXXXXXXXXXXXXXXXXXGXXXXXXXXXXXXXXXXXXXGXXXXXXXXXXXXXXXXXXXGXXXXXXXXXXXXXXXXXXXGXXXXXXXXXXXXXXXXXXXGXXXXXXXXXXXXXXXXXXXGXXXXXXXXXXXXXXXXXXXGXXXXXXXXXXXXXXXXXXX,0,300,0

12810,13,0,13,76,211,0,0,223,110,113,GXXXXXXXXXXXXXXXXXXXGXXXXXXXXXXXXXXXXXXXGXXXXXXXXXXXXXXXXXXXGXXXXXXXXXXXXXXXXXXXGXXXXXXXXXXXXXXXXXXXGXXXXXXXXXXXXXXXXXXXGXXXXXXXXXXXXXXXXXXXGXXXXXXXXXXXXXXXXXXXGXXXXXXXXXXXXXXXXXXXGXXXXXXXXXXXXXXXXXXXGXXXXXXXXXXXXXXXXXXXGXXXXXXXXXXXXXXXXXXXGXXXXXXXXXXXXXXXXXXX,0,300,0
12831,13,0,13,74,213,0,0,225,111,114,GXXXXXXXXXXXXXXXXXXXGXXXXXXXXXXXXXXXXXXXGXXXXXXXXXXXXXXXXXXXGXXXXXXXXXXXXXXXXXXXGXXXXXXXXXXXXXXXXXXXGXXXXXXXXXXXXXXXXXXXGXXXXXXXXXXXXXXXXXXXGXXXXXXXXXXXXXXXXXXXGXXXXXXXXXXXXXXXXXXXGXXXXXXXXXXXXXXXXXXXGXXXXXXXXXXXXXXXXXXXGXXXXXXXXXXXXXXXXXXXGXXXXXXXXXXXXXXXXXXX,0,300,0
12852,13,0,13,75,212,0,0,225,109,116,GXXXXXXXXXXXXXXXXXXXGXXXXXXXXXXXXXXXXXXXGXXXXXXXXXXXXXXXXXXXGXXXXXXXXXXXXXXXXXXXGXXXXXXXXXXXXXXXXXXXGXXXXXXXXXXXXXXXXXXXGXXXXXXXXXXXXXXXXXXXGXXXXXXXXXXXXXXXXXXXGXXXXXXXXXXXXXXXXXXXGXXXXXXXXXXXXXXXXXXXGXXXXXXXXXXXXXXXXXXXGXXXXXXXXXXXXXXXXXXXGXXXXXXXXXXXXXXXXXXX,0,300,0
12873,13,0,13,79,208,0,0,220,106,114,GXXXXXXXXXXXXXXXXXXXGXXXXXXXXXXXXXXXXXXXGXXXXXXXXXXXXXXXXXXXGXXXXXXXXXXXXXXXXXXXGXXXXXXXXXXXXXXXXXXXGXXXXXXXXXXXXXXXXXXXGXXXXXXXXXXXXXXXXXXXGXXXXXXXXXXXXXXXXXXXGXXXXXXXXXXXXXXXXXXXGXXXXXXXXXXXXXXXXXXXGXXXXXXXXXXXXXXXXXXXGXXXXXXXXXXXXXXXXXXXGXXXXXXXXXXXXXXXXXXX,0,300,0
12894,14,1,13,78,208,0,0,220,106,114,GXXXXXXXXXXXXXXXXXXXGXXXXXXXXXXXXXXXXXXXGXXXXXXXXXXXXXXXXXXXGXXXXXXXXXXXXXXXXXXXGXXXXXXXXXXXXXXXXXXXGXXXXXXXXXXXXXXXXXXXGXXXXXXXXXXXXXXXXXXXGXXXXXXXXXXXXXXXXXXXGXXXXXXXXXXXXXXXXXXXGAXXXXXXXXXXXXXXXXXXGXXXXXXXXXXXXXXXXXXXGXXXXXXXXXXXXXXXXXXXGXXXXXXXXXXXXXXXXXXX,0,300,0

12915,14,1,13,70,216,0,0,227,105,122,GXXXXXXXXXXXXXXXXXXXGXXXXXXXXXXXXXXXXXXXGXXXXXXXXXXXXXXXXXXXGXXXXXXXXXXXXXXXXXXXGXXXXXXXXXXXXXXXXXXXGXXXXXXXXXXXXXXXXXXXGXXXXXXXXXXXXXXXXXXXGXXXXXXXXXXXXXXXXXXXGXXXXXXXXXXXXXXXXXXXGAXXXXXXXXXXXXXXXXXXGXXXXXXXXXXXXXXXXXXXGXXXXXXXXXXXXXXXXXXXGXXXXXXXXXXXXXXXXXXX,0,300,0
12936,14,1,13,59,227,0,0,238,107,131,GXXXXXXXXXXXXXXXXXXXGXXXXXXXXXXXXXXXXXXXGXXXXXXXXXXXXXXXXXXXGXXXXXXXXXXXXXXXXXXXGXXXXXXXXXXXXXXXXXXXGXXXXXXXXXXXXXXXXXXXGXXXXXXXXXXXXXXXXXXXGXXXXXXXXXXXXXXXXXXXGXXXXXXXXXXXXXXXXXXXGAXXXXXXXXXXXXXXXXXXGXXXXXXXXXXXXXXXXXXXGXXXXXXXXXXXXXXXXXXXGXXXXXXXXXXXXXXXXXXX,0,300,0
12957,13,0,13,58,229,0,0,241,107,134,GXXXXXXXXXXXXXXXXXXXGXXXXXXXXXXXXXXXXXXXGXXXXXXXXXXXXXXXXXXXGXXXXXXXXXXXXXXXXXXXGXXXXXXXXXXXXXXXXXXXGXXXXXXXXXXXXXXXXXXXGXXXXXXXXXXXXXXXXXXXGXXXXXXXXXXXXXXXXXXXGXXXXXXXXXXXXXXXXXXXGXXXXXXXXXXXXXXXXXXXGXXXXXXXXXXXXXXXXXXXGXXXXXXXXXXXXXXXXXXXGXXXXXXXXXXXXXXXXXXX,0,300,0
12978,13,0,13,53,234,0,0,246,109,137,GXXXXXXXXXXXXXXXXXXXGXXXXXXXXXXXXXXXXXXXGXXXXXXXXXXXXXXXXXXXGXXXXXXXXXXXXXXXXXXXGXXXXXXXXXXXXXXXXXXXGXXXXXXXXXXXXXXXXXXXGXXXXXXXXXXXXXXXXXXXGXXXXXXXXXXXXXXXXXXXGXXXXXXXXXXXXXXXXXXXGXXXXXXXXXXXXXXXXXXXGXXXXXXXXXXXXXXXXXXXGXXXXXXXXXXXXXXXXXXXGXXXXXXXXXXXXXXXXXXX,0,300,0
12999,14,1,13,54,232,0,0,245,111,134,GXXXXXXXXXXXXXXXXXXXGXXXXXXXXXXXXXXXXXXXGXXXXXXXXXXXXXXXXXXXGXXXXXXXXXXXXXXXXXXXGXXXXXXXXXXXXXXXXXXXGXXXXXXXXXXXXXXXXXXXGXXXXXXXXXXXXXXXXXXXGAXXXXXXXXXXXXXXXXXXGXXXXXXXXXXXXXXXXXXXGXXXXXXXXXXXXXXXXXXXGXXXXXXXXXXXXXXXXXXXGXXXXXXXXXXXXXXXXXXXGXXXXXXXXXXXXXXXXXXX,0,300,0

13020,14,1,13,56,230,0,0,243,112,131,GXXXXXXXXXXXXXXXXXXXGXXXXXXXXXXXXXXXXXXXGXXXXXXXXXXXXXXXXXXXGXXXXXXXXXXXXXXXXXXXGXXXXXXXXXXXXXXXXXXXGXXXXXXXXXXXXXXXXXXXGXXXXXXXXXXXXXXXXXXXGAXXXXXXXXXXXXXXXXXXGXXXXXXXXXXXXXXXXXXXGXXXXXXXXXXXXXXXXXXXGXXXXXXXXXXXXXXXXXXXGXXXXXXXXXXXXXXXXXXXGXXXXXXXXXXXXXXXXXXX,0,300,0
13041,14,1,13,61,225,0,0,238,107,131,GXXXXXXXXXXXXXXXXXXXGXXXXXXXXXXXXXXXXXXXGXXXXXXXXXXXXXXXXXXXGXXXXXXXXXXXXXXXXXXXGXXXXXXXXXXXXXXXXXXXGXXXXXXXXXXXXXXXXXXXGXXXXXXXXXXXXXXXXXXXGAXXXXXXXXXXXXXXXXXXGXXXXXXXXXXXXXXXXXXXGXXXXXXXXXXXXXXXXXXXGXXXXXXXXXXXXXXXXXXXGXXXXXXXXXXXXXXXXXXXGXXXXXXXXXXXXXXXXXXX,0,300,0
13062,14,1,13,61,225,0,0,238,106,132,GXXXXXXXXXXXXXXXXXXXGXXXXXXXXXXXXXXXXXXXGXXXXXXXXXXXXXXXXXXXGXXXXXXXXXXXXXXXXXXXGXXXXXXXXXXXXXXXXXXXGXXXXXXXXXXXXXXXXXXXGXXXXXXXXXXXXXXXXXXXGAXXXXXXXXXXXXXXXXXXGXXXXXXXXXXXXXXXXXXXGXXXXXXXXXXXXXXXXXXXGXXXXXXXXXXXXXXXXXXXGXXXXXXXXXXXXXXXXXXXGXXXXXXXXXXXXXXXXXXX,0,300,0
13083,14,1,13,61,225,0,0,237,111,126,GXXXXXXXXXXXXXXXXXXXGXXXXXXXXXXXXXXXXXXXGXXXXXXXXXXXXXXXXXXXGXXXXXXXXXXXXXXXXXXXGXXXXXXXXXXXXXXXXXXXGXXXXXXXXXXXXXXXXXXXGXXXXXXXXXXXXXXXXXXXGAXXXXXXXXXXXXXXXXXXGXXXXXXXXXXXXXXXXXXXGXXXXXXXXXXXXXXXXXXXGXXXXXXXXXXXXXXXXXXXGXXXXXXXXXXXXXXXXXXXGXXXXXXXXXXXXXXXXXXX,0,300,0
13104,14,1,13,64,222,0,0,236,107,129,GXXXXXXXXXXXXXXXXXXXGXXXXXXXXXXXXXXXXXXXGXXXXXXXXXXXXXXXXXXXGXXXXXXXXXXXXXXXXXXXGXXXXXXXXXXXXXXXXXXXGXXXXXXXXXXXXXXXXXXXGXXXXXXXXXXXXXXXXXXXGAXXXXXXXXXXXXXXXXXXGXXXXXXXXXXXXXXXXXXXGXXXXXXXXXXXXXXXXXXXGXXXXXXXXXXXXXXXXXXXGXXXXXXXXXXXXXXXXXXXGXXXXXXXXXXXXXXXXXXX,0,300,0

13125,14,1,13,64,222,0,0,234,107,127,GXXXXXXXXXXXXXXXXXXXGXXXXXXXXXXXXXXXXXXXGXXXXXXXXXXXXXXXXXXXGXXXXXXXXXXXXXXXXXXXGXXXXXXXXXXXXXXXXXXXGXXXXXXXXXXXXXXXXXXXGXXXXXXXXXXXXXXXXXXXGAXXXXXXXXXXXXXXXXXXGXXXXXXXXXXXXXXXXXXXGXXXXXXXXXXXXXXXXXXXGXXXXXXXXXXXXXXXXXXXGXXXXXXXXXXXXXXXXXXXGXXXXXXXXXXXXXXXXXXX,0,300,0
13146,14,1,13,64,222,0,0,234,104,130,GXXXXXXXXXXXXXXXXXXXGXXXXXXXXXXXXXXXXXXXGXXXXXXXXXXXXXXXXXXXGXXXXXXXXXXXXXXXXXXXGXXXXXXXXXXXXXXXXXXXGXXXXXXXXXXXXXXXXXXXGXXXXXXXXXXXXXXXXXXXGAXXXXXXXXXXXXXXXXXXGXXXXXXXXXXXXXXXXXXXGXXXXXXXXXXXXXXXXXXXGXXXXXXXXXXXXXXXXXXXGXXXXXXXXXXXXXXXXXXXGXXXXXXXXXXXXXXXXXXX,0,300,0
13167,14,1,13,64,222,0,0,235,106,129,GXXXXXXXXXXXXXXXXXXXGXXXXXXXXXXXXXXXXXXXGXXXXXXXXXXXXXXXXXXXGXXXXXXXXXXXXXXXXXXXGXXXXXXXXXXXXXXXXXXXGXXXXXXXXXXXXXXXXXXXGXXXXXXXXXXXXXXXXXXXGAXXXXXXXXXXXXXXXXXXGXXXXXXXXXXXXXXXXXXXGXXXXXXXXXXXXXXXXXXXGXXXXXXXXXXXXXXXXXXXGXXXXXXXXXXXXXXXXXXXGXXXXXXXXXXXXXXXXXXX,0,300,0
13188,14,1,13,62,224,0,0,237,110,127,GXXXXXXXXXXXXXXXXXXXGXXXXXXXXXXXXXXXXXXXGXXXXXXXXXXXXXXXXXXXGXXXXXXXXXXXXXXXXXXXGXXXXXXXXXXXXXXXXXXXGXXXXXXXXXXXXXXXXXXXGXXXXXXXXXXXXXXXXXXXGAXXXXXXXXXXXXXXXXXXGXXXXXXXXXXXXXXXXXXXGXXXXXXXXXXXXXXXXXXXGXXXXXXXXXXXXXXXXXXXGXXXXXXXXXXXXXXXXXXXGXXXXXXXXXXXXXXXXXXX,0,300,0
13209,14,1,13,63,223,0,0,236,116,120,GXXXXXXXXXXXXXXXXXXXGXXXXXXXXXXXXXXXXXXXGXXXXXXXXXXXXXXXXXXXGXXXXXXXXXXXXXXXXXXXGXXXXXXXXXXXXXXXXXXXGXXXXXXXXXXXXXXXXXXXGXXXXXXXXXXXXXXXXXXXGAXXXXXXXXXXXXXXXXXXGXXXXXXXXXXXXXXXXXXXGXXXXXXXXXXXXXXXXXXXGXXXXXXXXXXXXXXXXXXXGXXXXXXXXXXXXXXXXXXXGXXXXXXXXXXXXXXXXXXX,0,300,0

13230,15,1,14,65,220,0,0,233,116,117,GXXXXXXXXXXXXXXXXXXXGXXXXXXXXXXXXXXXXXXXGXXXXXXXXXXXXXXXXXXXGXXXXXXXXXXXXXXXXXXXGXXXXXXXXXXXXXXXXXXXGXXXXXXXXXXXXXXXXXXXGOXXXXXXXXXXXXXXXXXXGAXXXXXXXXXXXXXXXXXXGXXXXXXXXXXXXXXXXXXXGXXXXXXXXXXXXXXXXXXXGXXXXXXXXXXXXXXXXXXXGXXXXXXXXXXXXXXXXXXXGXXXXXXXXXXXXXXXXXXX,0,300,0
13251,14,1,13,65,221,0,0,234,114,120,GXXXXXXXXXXXXXXXXXXXGXXXXXXXXXXXXXXXXXXXGXXXXXXXXXXXXXXXXXXXGXXXXXXXXXXXXXXXXXXXGXXXXXXXXXXXXXXXXXXXGXXXXXXXXXXXXXXXXXXXGXXXXXXXXXXXXXXXXXXXGAXXXXXXXXXXXXXXXXXXGXXXXXXXXXXXXXXXXXXXGXXXXXXXXXXXXXXXXXXXGXXXXXXXXXXXXXXXXXXXGXXXXXXXXXXXXXXXXXXXGXXXXXXXXXXXXXXXXXXX,0,300,0
13272,14,1,13,67,219,0,0,233,114,119,GXXXXXXXXXXXXXXXXXXXGXXXXXXXXXXXXXXXXXXXGXXXXXXXXXXXXXXXXXXXGXXXXXXXXXXXXXXXXXXXGXXXXXXXXXXXXXXXXXXXGXXXXXXXXXXXXXXXXXXXGXXXXXXXXXXXXXXXXXXXGAXXXXXXXXXXXXXXXXXXGXXXXXXXXXXXXXXXXXXXGXXXXXXXXXXXXXXXXXXXGXXXXXXXXXXXXXXXXXXXGXXXXXXXXXXXXXXXXXXXGXXXXXXXXXXXXXXXXXXX,0,300,0
13293,14,1,13,64,222,0,0,234,111,123,GXXXXXXXXXXXXXXXXXXXGXXXXXXXXXXXXXXXXXXXGXXXXXXXXXXXXXXXXXXXGXXXXXXXXXXXXXXXXXXXGXXXXXXXXXXXXXXXXXXXGXXXXXXXXXXXXXXXXXXXGXXXXXXXXXXXXXXXXXXXGAXXXXXXXXXXXXXXXXXXGXXXXXXXXXXXXXXXXXXXGXXXXXXXXXXXXXXXXXXXGXXXXXXXXXXXXXXXXXXXGXXXXXXXXXXXXXXXXXXXGXXXXXXXXXXXXXXXXXXX,0,300,0
13314,14,1,13,65,221,0,0,233,110,123,GXXXXXXXXXXXXXXXXXXXGXXXXXXXXXXXXXXXXXXXGXXXXXXXXXXXXXXXXXXXGXXXXXXXXXXXXXXXXXXXGXXXXXXXXXXXXXXXXXXXGXXXXXXXXXXXXXXXXXXXGXXXXXXXXXXXXXXXXXXXGAXXXXXXXXXXXXXXXXXXGXXXXXXXXXXXXXXXXXXXGXXXXXXXXXXXXXXXXXXXGXXXXXXXXXXXXXXXXXXXGXXXXXXXXXXXXXXXXXXXGXXXXXXXXXXXXXXXXXXX,0,300,0

13335,13,0,13,66,221,0,0,233,110,123,GXXXXXXXXXXXXXXXXXXXGXXXXXXXXXXXXXXXXXXXGXXXXXXXXXXXXXXXXXXXGXXXXXXXXXXXXXXXXXXXGXXXXXXXXXXXXXXXXXXXGXXXXXXXXXXXXXXXXXXXGXXXXXXXXXXXXXXXXXXXGXXXXXXXXXXXXXXXXXXXGXXXXXXXXXXXXXXXXXXXGXXXXXXXXXXXXXXXXXXXGXXXXXXXXXXXXXXXXXXXGXXXXXXXXXXXXXXXXXXXGXXXXXXXXXXXXXXXXXXX,0,300,0
13356,13,0,13,66,221,0,0,234,110,124,GXXXXXXXXXXXXXXXXXXXGXXXXXXXXXXXXXXXXXXXGXXXXXXXXXXXXXXXXXXXGXXXXXXXXXXXXXXXXXXXGXXXXXXXXXXXXXXXXXXXGXXXXXXXXXXXXXXXXXXXGXXXXXXXXXXXXXXXXXXXGXXXXXXXXXXXXXXXXXXXGXXXXXXXXXXXXXXXXXXXGXXXXXXXXXXXXXXXXXXXGXXXXXXXXXXXXXXXXXXXGXXXXXXXXXXXXXXXXXXXGXXXXXXXXXXXXXXXXXXX,0,300,0
13377,13,0,13,62,225,0,0,238,111,127,GXXXXXXXXXXXXXXXXXXXGXXXXXXXXXXXXXXXXXXXGXXXXXXXXXXXXXXXXXXXGXXXXXXXXXXXXXXXXXXXGXXXXXXXXXXXXXXXXXXXGXXXXXXXXXXXXXXXXXXXGXXXXXXXXXXXXXXXXXXXGXXXXXXXXXXXXXXXXXXXGXXXXXXXXXXXXXXXXXXXGXXXXXXXXXXXXXXXXXXXGXXXXXXXXXXXXXXXXXXXGXXXXXXXXXXXXXXXXXXXGXXXXXXXXXXXXXXXXXXX,0,300,0
13398,13,0,13,63,224,0,0,236,116,120,GXXXXXXXXXXXXXXXXXXXGXXXXXXXXXXXXXXXXXXXGXXXXXXXXXXXXXXXXXXXGXXXXXXXXXXXXXXXXXXXGXXXXXXXXXXXXXXXXXXXGXXXXXXXXXXXXXXXXXXXGXXXXXXXXXXXXXXXXXXXGXXXXXXXXXXXXXXXXXXXGXXXXXXXXXXXXXXXXXXXGXXXXXXXXXXXXXXXXXXXGXXXXXXXXXXXXXXXXXXXGXXXXXXXXXXXXXXXXXXXGXXXXXXXXXXXXXXXXXXX,0,300,0
13419,13,0,13,64,223,0,0,236,110,126,GXXXXXXXXXXXXXXXXXXXGXXXXXXXXXXXXXXXXXXXGXXXXXXXXXXXXXXXXXXXGXXXXXXXXXXXXXXXXXXXGXXXXXXXXXXXXXXXXXXXGXXXXXXXXXXXXXXXXXXXGXXXXXXXXXXXXXXXXXXXGXXXXXXXXXXXXXXXXXXXGXXXXXXXXXXXXXXXXXXXGXXXXXXXXXXXXXXXXXXXGXXXXXXXXXXXXXXXXXXXGXXXXXXXXXXXXXXXXXXXGXXXXXXXXXXXXXXXXXXX,0,300,0

13440,13,0,13,63,224,0,0,238,111,127,GXXXXXXXXXXXXXXXXXXXGXXXXXXXXXXXXXXXXXXXGXXXXXXXXXXXXXXXXXXXGXXXXXXXXXXXXXXXXXXXGXXXXXXXXXXXXXXXXXXXGXXXXXXXXXXXXXXXXXXXGXXXXXXXXXXXXXXXXXXXGXXXXXXXXXXXXXXXXXXXGXXXXXXXXXXXXXXXXXXXGXXXXXXXXXXXXXXXXXXXGXXXXXXXXXXXXXXXXXXXGXXXXXXXXXXXXXXXXXXXGXXXXXXXXXXXXXXXXXXX,0,300,0
13461,13,0,13,66,221,0,0,235,116,119,GXXXXXXXXXXXXXXXXXXXGXXXXXXXXXXXXXXXXXXXGXXXXXXXXXXXXXXXXXXXGXXXXXXXXXXXXXXXXXXXGXXXXXXXXXXXXXXXXXXXGXXXXXXXXXXXXXXXXXXXGXXXXXXXXXXXXXXXXXXXGXXXXXXXXXXXXXXXXXXXGXXXXXXXXXXXXXXXXXXXGXXXXXXXXXXXXXXXXXXXGXXXXXXXXXXXXXXXXXXXGXXXXXXXXXXXXXXXXXXXGXXXXXXXXXXXXXXXXXXX,0,300,0
13482,13,0,13,72,215,0,0,228,110,118,GXXXXXXXXXXXXXXXXXXXGXXXXXXXXXXXXXXXXXXXGXXXXXXXXXXXXXXXXXXXGXXXXXXXXXXXXXXXXXXXGXXXXXXXXXXXXXXXXXXXGXXXXXXXXXXXXXXXXXXXGXXXXXXXXXXXXXXXXXXXGXXXXXXXXXXXXXXXXXXXGXXXXXXXXXXXXXXXXXXXGXXXXXXXXXXXXXXXXXXXGXXXXXXXXXXXXXXXXXXXGXXXXXXXXXXXXXXXXXXXGXXXXXXXXXXXXXXXXXXX,0,300,0
13503,13,0,13,67,220,0,0,233,113,120,GXXXXXXXXXXXXXXXXXXXGXXXXXXXXXXXXXXXXXXXGXXXXXXXXXXXXXXXXXXXGXXXXXXXXXXXXXXXXXXXGXXXXXXXXXXXXXXXXXXXGXXXXXXXXXXXXXXXXXXXGXXXXXXXXXXXXXXXXXXXGXXXXXXXXXXXXXXXXXXXGXXXXXXXXXXXXXXXXXXXGXXXXXXXXXXXXXXXXXXXGXXXXXXXXXXXXXXXXXXXGXXXXXXXXXXXXXXXXXXXGXXXXXXXXXXXXXXXXXXX,0,300,0
13524,14,1,13,68,218,0,0,230,114,116,GXXXXXXXXXXXXXXXXXXXGXXXXXXXXXXXXXXXXXXXGXXXXXXXXXXXXXXXXXXXGXXXXXXXXXXXXXXXXXXXGXXXXXXXXXXXXXXXXXXXGXXXXXXXXXXXXXXXXXXXGXXXXXXXXXXXXXXXXXXXGXXXXXXXXXXXXXXXXXXXGAXXXXXXXXXXXXXXXXXXGXXXXXXXXXXXXXXXXXXXGXXXXXXXXXXXXXXXXXXXGXXXXXXXXXXXXXXXXXXXGXXXXXXXXXXXXXXXXXXX,0,300,0

13545,15,1,14,68,217,0,0,230,113,117,GXXXXXXXXXXXXXXXXXXXGAXXXXXXXXXXXXXXXXXXGXXXXXXXXXXXXXXXXXXXGXXXXXXXXXXXXXXXXXXXGXXXXXXXXXXXXXXXXXXXGXXXXXXXXXXXXXXXXXXXGXXXXXXXXXXXXXXXXXXXGXXXXXXXXXXXXXXXXXXXGOXXXXXXXXXXXXXXXXXXGXXXXXXXXXXXXXXXXXXXGXXXXXXXXXXXXXXXXXXXGXXXXXXXXXXXXXXXXXXXGXXXXXXXXXXXXXXXXXXX,0,300,0
13566,14,1,13,67,219,0,0,232,114,118,GXXXXXXXXXXXXXXXXXXXGAXXXXXXXXXXXXXXXXXXGXXXXXXXXXXXXXXXXXXXGXXXXXXXXXXXXXXXXXXXGXXXXXXXXXXXXXXXXXXXGXXXXXXXXXXXXXXXXXXXGXXXXXXXXXXXXXXXXXXXGXXXXXXXXXXXXXXXXXXXGXXXXXXXXXXXXXXXXXXXGXXXXXXXXXXXXXXXXXXXGXXXXXXXXXXXXXXXXXXXGXXXXXXXXXXXXXXXXXXXGXXXXXXXXXXXXXXXXXXX,0,300,0
13587,14,1,13,71,215,0,0,228,112,116,GXXXXXXXXXXXXXXXXXXXGAXXXXXXXXXXXXXXXXXXGXXXXXXXXXXXXXXXXXXXGXXXXXXXXXXXXXXXXXXXGXXXXXXXXXXXXXXXXXXXGXXXXXXXXXXXXXXXXXXXGXXXXXXXXXXXXXXXXXXXGXXXXXXXXXXXXXXXXXXXGXXXXXXXXXXXXXXXXXXXGXXXXXXXXXXXXXXXXXXXGXXXXXXXXXXXXXXXXXXXGXXXXXXXXXXXXXXXXXXXGXXXXXXXXXXXXXXXXXXX,0,300,0
13608,14,1,13,72,214,0,0,226,110,116,GXXXXXXXXXXXXXXXXXXXGAXXXXXXXXXXXXXXXXXXGXXXXXXXXXXXXXXXXXXXGXXXXXXXXXXXXXXXXXXXGXXXXXXXXXXXXXXXXXXXGXXXXXXXXXXXXXXXXXXXGXXXXXXXXXXXXXXXXXXXGXXXXXXXXXXXXXXXXXXXGXXXXXXXXXXXXXXXXXXXGXXXXXXXXXXXXXXXXXXXGXXXXXXXXXXXXXXXXXXXGXXXXXXXXXXXXXXXXXXXGXXXXXXXXXXXXXXXXXXX,0,300,0
13629,14,0,14,69,217,0,0,229,113,116,GXXXXXXXXXXXXXXXXXXXGOXXXXXXXXXXXXXXXXXXGXXXXXXXXXXXXXXXXXXXGXXXXXXXXXXXXXXXXXXXGXXXXXXXXXXXXXXXXXXXGXXXXXXXXXXXXXXXXXXXGXXXXXXXXXXXXXXXXXXXGXXXXXXXXXXXXXXXXXXXGXXXXXXXXXXXXXXXXXXXGXXXXXXXXXXXXXXXXXXXGXXXXXXXXXXXXXXXXXXXGXXXXXXXXXXXXXXXXXXXGXXXXXXXXXXXXXXXXXXX,0,300,0

13650,14,0,14,70,216,0,0,230,113,117,GXXXXXXXXXXXXXXXXXXXGOXXXXXXXXXXXXXXXXXXGXXXXXXXXXXXXXXXXXXXGXXXXXXXXXXXXXXXXXXXGXXXXXXXXXXXXXXXXXXXGXXXXXXXXXXXXXXXXXXXGXXXXXXXXXXXXXXXXXXXGXXXXXXXXXXXXXXXXXXXGXXXXXXXXXXXXXXXXXXXGXXXXXXXXXXXXXXXXXXXGXXXXXXXXXXXXXXXXXXXGXXXXXXXXXXXXXXXXXXXGXXXXXXXXXXXXXXXXXXX,0,300,0
13671,13,0,13,73,214,0,0,227,112,115,GXXXXXXXXXXXXXXXXXXXGXXXXXXXXXXXXXXXXXXXGXXXXXXXXXXXXXXXXXXXGXXXXXXXXXXXXXXXXXXXGXXXXXXXXXXXXXXXXXXXGXXXXXXXXXXXXXXXXXXXGXXXXXXXXXXXXXXXXXXXGXXXXXXXXXXXXXXXXXXXGXXXXXXXXXXXXXXXXXXXGXXXXXXXXXXXXXXXXXXXGXXXXXXXXXXXXXXXXXXXGXXXXXXXXXXXXXXXXXXXGXXXXXXXXXXXXXXXXXXX,0,300,0
13692,13,0,13,72,215,0,0,228,112,116,GXXXXXXXXXXXXXXXXXXXGXXXXXXXXXXXXXXXXXXXGXXXXXXXXXXXXXXXXXXXGXXXXXXXXXXXXXXXXXXXGXXXXXXXXXXXXXXXXXXXGXXXXXXXXXXXXXXXXXXXGXXXXXXXXXXXXXXXXXXXGXXXXXXXXXXXXXXXXXXXGXXXXXXXXXXXXXXXXXXXGXXXXXXXXXXXXXXXXXXXGXXXXXXXXXXXXXXXXXXXGXXXXXXXXXXXXXXXXXXXGXXXXXXXXXXXXXXXXXXX,0,300,0
13713,13,0,13,73,214,0,0,226,113,113,GXXXXXXXXXXXXXXXXXXXGXXXXXXXXXXXXXXXXXXXGXXXXXXXXXXXXXXXXXXXGXXXXXXXXXXXXXXXXXXXGXXXXXXXXXXXXXXXXXXXGXXXXXXXXXXXXXXXXXXXGXXXXXXXXXXXXXXXXXXXGXXXXXXXXXXXXXXXXXXXGXXXXXXXXXXXXXXXXXXXGXXXXXXXXXXXXXXXXXXXGXXXXXXXXXXXXXXXXXXXGXXXXXXXXXXXXXXXXXXXGXXXXXXXXXXXXXXXXXXX,0,300,0
13734,13,0,13,80,207,0,0,219,106,113,GXXXXXXXXXXXXXXXXXXXGXXXXXXXXXXXXXXXXXXXGXXXXXXXXXXXXXXXXXXXGXXXXXXXXXXXXXXXXXXXGXXXXXXXXXXXXXXXXXXXGXXXXXXXXXXXXXXXXXXXGXXXXXXXXXXXXXXXXXXXGXXXXXXXXXXXXXXXXXXXGXXXXXXXXXXXXXXXXXXXGXXXXXXXXXXXXXXXXXXXGXXXXXXXXXXXXXXXXXXXGXXXXXXXXXXXXXXXXXXXGXXXXXXXXXXXXXXXXXXX,0,300,0

13755,14,1,13,76,210,0,0,222,114,108,GXXXXXXXXXXXXXXXXXXXGXXXXXXXXXXXXXXXXXXXGXXXXXXXXXXXXXXXXXXXGXXXXXXXXXXXXXXXXXXXGXXXXXXXXXXXXXXXXXXXGAXXXXXXXXXXXXXXXXXXGXXXXXXXXXXXXXXXXXXXGXXXXXXXXXXXXXXXXXXXGXXXXXXXXXXXXXXXXXXXGXXXXXXXXXXXXXXXXXXXGXXXXXXXXXXXXXXXXXXXGXXXXXXXXXXXXXXXXXXXGXXXXXXXXXXXXXXXXXXX,0,300,0
13776,14,1,13,73,213,0,0,225,116,109,GXXXXXXXXXXXXXXXXXXXGXXXXXXXXXXXXXXXXXXXGXXXXXXXXXXXXXXXXXXXGXXXXXXXXXXXXXXXXXXXGXXXXXXXXXXXXXXXXXXXGAXXXXXXXXXXXXXXXXXXGXXXXXXXXXXXXXXXXXXXGXXXXXXXXXXXXXXXXXXXGXXXXXXXXXXXXXXXXXXXGXXXXXXXXXXXXXXXXXXXGXXXXXXXXXXXXXXXXXXXGXXXXXXXXXXXXXXXXXXXGXXXXXXXXXXXXXXXXXXX,0,300,0
13797,14,1,13,73,213,0,0,225,118,107,GXXXXXXXXXXXXXXXXXXXGXXXXXXXXXXXXXXXXXXXGXXXXXXXXXXXXXXXXXXXGXXXXXXXXXXXXXXXXXXXGXXXXXXXXXXXXXXXXXXXGAXXXXXXXXXXXXXXXXXXGXXXXXXXXXXXXXXXXXXXGXXXXXXXXXXXXXXXXXXXGXXXXXXXXXXXXXXXXXXXGXXXXXXXXXXXXXXXXXXXGXXXXXXXXXXXXXXXXXXXGXXXXXXXXXXXXXXXXXXXGXXXXXXXXXXXXXXXXXXX,0,300,0
13818,14,1,13,77,209,0,0,222,113,109,GXXXXXXXXXXXXXXXXXXXGXXXXXXXXXXXXXXXXXXXGXXXXXXXXXXXXXXXXXXXGXXXXXXXXXXXXXXXXXXXGXXXXXXXXXXXXXXXXXXXGAXXXXXXXXXXXXXXXXXXGXXXXXXXXXXXXXXXXXXXGXXXXXXXXXXXXXXXXXXXGXXXXXXXXXXXXXXXXXXXGXXXXXXXXXXXXXXXXXXXGXXXXXXXXXXXXXXXXXXXGXXXXXXXXXXXXXXXXXXXGXXXXXXXXXXXXXXXXXXX,0,300,0
13839,14,1,13,69,217,0,0,230,119,111,GXXXXXXXXXXXXXXXXXXXGXXXXXXXXXXXXXXXXXXXGXXXXXXXXXXXXXXXXXXXGXXXXXXXXXXXXXXXXXXXGXXXXXXXXXXXXXXXXXXXGAXXXXXXXXXXXXXXXXXXGXXXXXXXXXXXXXXXXXXXGXXXXXXXXXXXXXXXXXXXGXXXXXXXXXXXXXXXXXXXGXXXXXXXXXXXXXXXXXXXGXXXXXXXXXXXXXXXXXXXGXXXXXXXXXXXXXXXXXXXGXXXXXXXXXXXXXXXXXXX,0,300,0

13860,14,1,13,73,213,0,0,227,116,111,GXXXXXXXXXXXXXXXXXXXGXXXXXXXXXXXXXXXXXXXGXXXXXXXXXXXXXXXXXXXGXXXXXXXXXXXXXXXXXXXGXXXXXXXXXXXXXXXXXXXGAXXXXXXXXXXXXXXXXXXGXXXXXXXXXXXXXXXXXXXGXXXXXXXXXXXXXXXXXXXGXXXXXXXXXXXXXXXXXXXGXXXXXXXXXXXXXXXXXXXGXXXXXXXXXXXXXXXXXXXGXXXXXXXXXXXXXXXXXXXGXXXXXXXXXXXXXXXXXXX,0,300,0
13881,14,1,13,70,216,0,0,229,116,113,GXXXXXXXXXXXXXXXXXXXGXXXXXXXXXXXXXXXXXXXGXXXXXXXXXXXXXXXXXXXGXXXXXXXXXXXXXXXXXXXGXXXXXXXXXXXXXXXXXXXGAXXXXXXXXXXXXXXXXXXGXXXXXXXXXXXXXXXXXXXGXXXXXXXXXXXXXXXXXXXGXXXXXXXXXXXXXXXXXXXGXXXXXXXXXXXXXXXXXXXGXXXXXXXXXXXXXXXXXXXGXXXXXXXXXXXXXXXXXXXGXXXXXXXXXXXXXXXXXXX,0,300,0
13902,13,0,13,69,218,0,0,230,112,118,GXXXXXXXXXXXXXXXXXXXGXXXXXXXXXXXXXXXXXXXGXXXXXXXXXXXXXXXXXXXGXXXXXXXXXXXXXXXXXXXGXXXXXXXXXXXXXXXXXXXGXXXXXXXXXXXXXXXXXXXGXXXXXXXXXXXXXXXXXXXGXXXXXXXXXXXXXXXXXXXGXXXXXXXXXXXXXXXXXXXGXXXXXXXXXXXXXXXXXXXGXXXXXXXXXXXXXXXXXXXGXXXXXXXXXXXXXXXXXXXGXXXXXXXXXXXXXXXXXXX,0,300,0
13923,13,0,13,69,218,0,0,231,107,124,GXXXXXXXXXXXXXXXXXXXGXXXXXXXXXXXXXXXXXXXGXXXXXXXXXXXXXXXXXXXGXXXXXXXXXXXXXXXXXXXGXXXXXXXXXXXXXXXXXXXGXXXXXXXXXXXXXXXXXXXGXXXXXXXXXXXXXXXXXXXGXXXXXXXXXXXXXXXXXXXGXXXXXXXXXXXXXXXXXXXGXXXXXXXXXXXXXXXXXXXGXXXXXXXXXXXXXXXXXXXGXXXXXXXXXXXXXXXXXXXGXXXXXXXXXXXXXXXXXXX,0,300,0
13944,13,0,13,73,214,0,0,227,105,122,GXXXXXXXXXXXXXXXXXXXGXXXXXXXXXXXXXXXXXXXGXXXXXXXXXXXXXXXXXXXGXXXXXXXXXXXXXXXXXXXGXXXXXXXXXXXXXXXXXXXGXXXXXXXXXXXXXXXXXXXGXXXXXXXXXXXXXXXXXXXGXXXXXXXXXXXXXXXXXXXGXXXXXXXXXXXXXXXXXXXGXXXXXXXXXXXXXXXXXXXGXXXXXXXXXXXXXXXXXXXGXXXXXXXXXXXXXXXXXXXGXXXXXXXXXXXXXXXXXXX,0,300,0

13965,13,0,13,68,219,0,0,232,109,123,GXXXXXXXXXXXXXXXXXXXGXXXXXXXXXXXXXXXXXXXGXXXXXXXXXXXXXXXXXXXGXXXXXXXXXXXXXXXXXXXGXXXXXXXXXXXXXXXXXXXGXXXXXXXXXXXXXXXXXXXGXXXXXXXXXXXXXXXXXXXGXXXXXXXXXXXXXXXXXXXGXXXXXXXXXXXXXXXXXXXGXXXXXXXXXXXXXXXXXXXGXXXXXXXXXXXXXXXXXXXGXXXXXXXXXXXXXXXXXXXGXXXXXXXXXXXXXXXXXXX,0,300,0
13986,13,0,13,62,225,0,0,237,111,126,GXXXXXXXXXXXXXXXXXXXGXXXXXXXXXXXXXXXXXXXGXXXXXXXXXXXXXXXXXXXGXXXXXXXXXXXXXXXXXXXGXXXXXXXXXXXXXXXXXXXGXXXXXXXXXXXXXXXXXXXGXXXXXXXXXXXXXXXXXXXGXXXXXXXXXXXXXXXXXXXGXXXXXXXXXXXXXXXXXXXGXXXXXXXXXXXXXXXXXXXGXXXXXXXXXXXXXXXXXXXGXXXXXXXXXXXXXXXXXXXGXXXXXXXXXXXXXXXXXXX,0,300,0
14007,13,0,13,62,225,0,0,237,110,127,GXXXXXXXXXXXXXXXXXXXGXXXXXXXXXXXXXXXXXXXGXXXXXXXXXXXXXXXXXXXGXXXXXXXXXXXXXXXXXXXGXXXXXXXXXXXXXXXXXXXGXXXXXXXXXXXXXXXXXXXGXXXXXXXXXXXXXXXXXXXGXXXXXXXXXXXXXXXXXXXGXXXXXXXXXXXXXXXXXXXGXXXXXXXXXXXXXXXXXXXGXXXXXXXXXXXXXXXXXXXGXXXXXXXXXXXXXXXXXXXGXXXXXXXXXXXXXXXXXXX,0,300,0
14028,13,0,13,61,226,0,0,236,109,127,GXXXXXXXXXXXXXXXXXXXGXXXXXXXXXXXXXXXXXXXGXXXXXXXXXXXXXXXXXXXGXXXXXXXXXXXXXXXXXXXGXXXXXXXXXXXXXXXXXXXGXXXXXXXXXXXXXXXXXXXGXXXXXXXXXXXXXXXXXXXGXXXXXXXXXXXXXXXXXXXGXXXXXXXXXXXXXXXXXXXGXXXXXXXXXXXXXXXXXXXGXXXXXXXXXXXXXXXXXXXGXXXXXXXXXXXXXXXXXXXGXXXXXXXXXXXXXXXXXXX,0,300,0
14049,13,0,13,57,230,0,0,242,110,132,GXXXXXXXXXXXXXXXXXXXGXXXXXXXXXXXXXXXXXXXGXXXXXXXXXXXXXXXXXXXGXXXXXXXXXXXXXXXXXXXGXXXXXXXXXXXXXXXXXXXGXXXXXXXXXXXXXXXXXXXGXXXXXXXXXXXXXXXXXXXGXXXXXXXXXXXXXXXXXXXGXXXXXXXXXXXXXXXXXXXGXXXXXXXXXXXXXXXXXXXGXXXXXXXXXXXXXXXXXXXGXXXXXXXXXXXXXXXXXXXGXXXXXXXXXXXXXXXXXXX,0,300,0

14070,13,0,13,55,232,0,0,243,109,134,GXXXXXXXXXXXXXXXXXXXGXXXXXXXXXXXXXXXXXXXGXXXXXXXXXXXXXXXXXXXGXXXXXXXXXXXXXXXXXXXGXXXXXXXXXXXXXXXXXXXGXXXXXXXXXXXXXXXXXXXGXXXXXXXXXXXXXXXXXXXGXXXXXXXXXXXXXXXXXXXGXXXXXXXXXXXXXXXXXXXGXXXXXXXXXXXXXXXXXXXGXXXXXXXXXXXXXXXXXXXGXXXXXXXXXXXXXXXXXXXGXXXXXXXXXXXXXXXXXXX,0,300,0
14091,14,1,13,56,230,0,0,242,112,130,GXXXXXXXXXXXXXXXXXXXGAXXXXXXXXXXXXXXXXXXGXXXXXXXXXXXXXXXXXXXGXXXXXXXXXXXXXXXXXXXGXXXXXXXXXXXXXXXXXXXGXXXXXXXXXXXXXXXXXXXGXXXXXXXXXXXXXXXXXXXGXXXXXXXXXXXXXXXXXXXGXXXXXXXXXXXXXXXXXXXGXXXXXXXXXXXXXXXXXXXGXXXXXXXXXXXXXXXXXXXGXXXXXXXXXXXXXXXXXXXGXXXXXXXXXXXXXXXXXXX,0,300,0
14112,14,1,13,54,232,0,0,243,117,126,GXXXXXXXXXXXXXXXXXXXGAXXXXXXXXXXXXXXXXXXGXXXXXXXXXXXXXXXXXXXGXXXXXXXXXXXXXXXXXXXGXXXXXXXXXXXXXXXXXXXGXXXXXXXXXXXXXXXXXXXGXXXXXXXXXXXXXXXXXXXGXXXXXXXXXXXXXXXXXXXGXXXXXXXXXXXXXXXXXXXGXXXXXXXXXXXXXXXXXXXGXXXXXXXXXXXXXXXXXXXGXXXXXXXXXXXXXXXXXXXGXXXXXXXXXXXXXXXXXXX,0,300,0
14133,15,2,13,52,233,0,0,246,117,129,GXXXXXXXXXXXXXXXXXXXGAXXXXXXXXXXXXXXXXXXGXXXXXXXXXXXXXXXXXXXGXXXXXXXXXXXXXXXXXXXGXXXXXXXXXXXXXXXXXXXGXXXXXXXXXXXXXXXXXXXGXXXXXXXXXXXXXXXXXXXGXXXXXXXXXXXXXXXXXXXGXXXXXXXXXXXXXXXXXXXGXXXXXXXXXXXXXXXXXXXGXXXXXXXXXXXXXXXXXXXGXXXXXXXXXXXXXXXXXXXGAXXXXXXXXXXXXXXXXXX,0,300,0
14154,15,2,13,55,230,0,0,243,119,124,GXXXXXXXXXXXXXXXXXXXGAXXXXXXXXXXXXXXXXXXGXXXXXXXXXXXXXXXXXXXGXXXXXXXXXXXXXXXXXXXGXXXXXXXXXXXXXXXXXXXGXXXXXXXXXXXXXXXXXXXGXXXXXXXXXXXXXXXXXXXGXXXXXXXXXXXXXXXXXXXGXXXXXXXXXXXXXXXXXXXGXXXXXXXXXXXXXXXXXXXGXXXXXXXXXXXXXXXXXXXGXXXXXXXXXXXXXXXXXXXGAXXXXXXXXXXXXXXXXXX,0,300,0

14175,15,2,13,54,231,0,0,244,119,125,GXXXXXXXXXXXXXXXXXXXGAXXXXXXXXXXXXXXXXXXGXXXXXXXXXXXXXXXXXXXGXXXXXXXXXXXXXXXXXXXGXXXXXXXXXXXXXXXXXXXGXXXXXXXXXXXXXXXXXXXGXXXXXXXXXXXXXXXXXXXGXXXXXXXXXXXXXXXXXXXGXXXXXXXXXXXXXXXXXXXGXXXXXXXXXXXXXXXXXXXGXXXXXXXXXXXXXXXXXXXGXXXXXXXXXXXXXXXXXXXGAXXXXXXXXXXXXXXXXXX,0,300,0
14196,15,2,13,56,229,0,0,242,119,123,GXXXXXXXXXXXXXXXXXXXGAXXXXXXXXXXXXXXXXXXGXXXXXXXXXXXXXXXXXXXGXXXXXXXXXXXXXXXXXXXGXXXXXXXXXXXXXXXXXXXGXXXXXXXXXXXXXXXXXXXGXXXXXXXXXXXXXXXXXXXGXXXXXXXXXXXXXXXXXXXGXXXXXXXXXXXXXXXXXXXGXXXXXXXXXXXXXXXXXXXGXXXXXXXXXXXXXXXXXXXGXXXXXXXXXXXXXXXXXXXGAXXXXXXXXXXXXXXXXXX,0,300,0
14217,15,2,13,56,229,0,0,241,120,121,GXXXXXXXXXXXXXXXXXXXGAXXXXXXXXXXXXXXXXXXGXXXXXXXXXXXXXXXXXXXGXXXXXXXXXXXXXXXXXXXGXXXXXXXXXXXXXXXXXXXGXXXXXXXXXXXXXXXXXXXGXXXXXXXXXXXXXXXXXXXGXXXXXXXXXXXXXXXXXXXGXXXXXXXXXXXXXXXXXXXGXXXXXXXXXXXXXXXXXXXGXXXXXXXXXXXXXXXXXXXGXXXXXXXXXXXXXXXXXXXGAXXXXXXXXXXXXXXXXXX,0,300,0
14238,15,2,13,58,227,0,0,240,119,121,GXXXXXXXXXXXXXXXXXXXGAXXXXXXXXXXXXXXXXXXGXXXXXXXXXXXXXXXXXXXGXXXXXXXXXXXXXXXXXXXGXXXXXXXXXXXXXXXXXXXGXXXXXXXXXXXXXXXXXXXGXXXXXXXXXXXXXXXXXXXGXXXXXXXXXXXXXXXXXXXGXXXXXXXXXXXXXXXXXXXGXXXXXXXXXXXXXXXXXXXGXXXXXXXXXXXXXXXXXXXGXXXXXXXXXXXXXXXXXXXGAXXXXXXXXXXXXXXXXXX,0,300,0
14259,15,2,13,58,227,0,0,239,117,122,GXXXXXXXXXXXXXXXXXXXGAXXXXXXXXXXXXXXXXXXGXXXXXXXXXXXXXXXXXXXGXXXXXXXXXXXXXXXXXXXGXXXXXXXXXXXXXXXXXXXGXXXXXXXXXXXXXXXXXXXGXXXXXXXXXXXXXXXXXXXGXXXXXXXXXXXXXXXXXXXGXXXXXXXXXXXXXXXXXXXGXXXXXXXXXXXXXXXXXXXGXXXXXXXXXXXXXXXXXXXGXXXXXXXXXXXXXXXXXXXGAXXXXXXXXXXXXXXXXXX,0,300,0

14280,15,2,13,60,225,0,0,238,120,118,GXXXXXXXXXXXXXXXXXXXGAXXXXXXXXXXXXXXXXXXGXXXXXXXXXXXXXXXXXXXGXXXXXXXXXXXXXXXXXXXGXXXXXXXXXXXXXXXXXXXGXXXXXXXXXXXXXXXXXXXGXXXXXXXXXXXXXXXXXXXGXXXXXXXXXXXXXXXXXXXGXXXXXXXXXXXXXXXXXXXGXXXXXXXXXXXXXXXXXXXGXXXXXXXXXXXXXXXXXXXGXXXXXXXXXXXXXXXXXXXGAXXXXXXXXXXXXXXXXXX,0,300,0
14301,15,2,13,60,225,0,0,238,124,114,GXXXXXXXXXXXXXXXXXXXGAXXXXXXXXXXXXXXXXXXGXXXXXXXXXXXXXXXXXXXGXXXXXXXXXXXXXXXXXXXGXXXXXXXXXXXXXXXXXXXGXXXXXXXXXXXXXXXXXXXGXXXXXXXXXXXXXXXXXXXGXXXXXXXXXXXXXXXXXXXGXXXXXXXXXXXXXXXXXXXGXXXXXXXXXXXXXXXXXXXGXXXXXXXXXXXXXXXXXXXGXXXXXXXXXXXXXXXXXXXGAXXXXXXXXXXXXXXXXXX,0,300,0
14322,15,2,13,61,224,0,0,237,126,111,GXXXXXXXXXXXXXXXXXXXGAXXXXXXXXXXXXXXXXXXGXXXXXXXXXXXXXXXXXXXGXXXXXXXXXXXXXXXXXXXGXXXXXXXXXXXXXXXXXXXGXXXXXXXXXXXXXXXXXXXGXXXXXXXXXXXXXXXXXXXGXXXXXXXXXXXXXXXXXXXGXXXXXXXXXXXXXXXXXXXGXXXXXXXXXXXXXXXXXXXGXXXXXXXXXXXXXXXXXXXGXXXXXXXXXXXXXXXXXXXGAXXXXXXXXXXXXXXXXXX,0,300,0
14343,15,2,13,69,216,0,0,229,121,108,GXXXXXXXXXXXXXXXXXXXGAXXXXXXXXXXXXXXXXXXGXXXXXXXXXXXXXXXXXXXGXXXXXXXXXXXXXXXXXXXGXXXXXXXXXXXXXXXXXXXGXXXXXXXXXXXXXXXXXXXGXXXXXXXXXXXXXXXXXXXGXXXXXXXXXXXXXXXXXXXGXXXXXXXXXXXXXXXXXXXGXXXXXXXXXXXXXXXXXXXGXXXXXXXXXXXXXXXXXXXGXXXXXXXXXXXXXXXXXXXGAXXXXXXXXXXXXXXXXXX,0,300,0
14364,15,2,13,69,216,0,0,228,122,106,GXXXXXXXXXXXXXXXXXXXGAXXXXXXXXXXXXXXXXXXGXXXXXXXXXXXXXXXXXXXGXXXXXXXXXXXXXXXXXXXGXXXXXXXXXXXXXXXXXXXGXXXXXXXXXXXXXXXXXXXGXXXXXXXXXXXXXXXXXXXGXXXXXXXXXXXXXXXXXXXGXXXXXXXXXXXXXXXXXXXGXXXXXXXXXXXXXXXXXXXGXXXXXXXXXXXXXXXXXXXGXXXXXXXXXXXXXXXXXXXGAXXXXXXXXXXXXXXXXXX,0,300,0

14385,15,2,13,73,212,0,0,223,115,108,GXXXXXXXXXXXXXXXXXXXGAXXXXXXXXXXXXXXXXXXGXXXXXXXXXXXXXXXXXXXGXXXXXXXXXXXXXXXXXXXGXXXXXXXXXXXXXXXXXXXGXXXXXXXXXXXXXXXXXXXGXXXXXXXXXXXXXXXXXXXGXXXXXXXXXXXXXXXXXXXGXXXXXXXXXXXXXXXXXXXGXXXXXXXXXXXXXXXXXXXGXXXXXXXXXXXXXXXXXXXGXXXXXXXXXXXXXXXXXXXGAXXXXXXXXXXXXXXXXXX,0,300,0
14406,15,2,13,75,210,0,0,221,112,109,GXXXXXXXXXXXXXXXXXXXGAXXXXXXXXXXXXXXXXXXGXXXXXXXXXXXXXXXXXXXGXXXXXXXXXXXXXXXXXXXGXXXXXXXXXXXXXXXXXXXGXXXXXXXXXXXXXXXXXXXGXXXXXXXXXXXXXXXXXXXGXXXXXXXXXXXXXXXXXXXGXXXXXXXXXXXXXXXXXXXGXXXXXXXXXXXXXXXXXXXGXXXXXXXXXXXXXXXXXXXGXXXXXXXXXXXXXXXXXXXGAXXXXXXXXXXXXXXXXXX,0,300,0
14427,16,3,13,76,208,0,0,221,112,109,GXXXXXXXXXXXXXXXXXXXGAXXXXXXXXXXXXXXXXXXGXXXXXXXXXXXXXXXXXXXGXXXXXXXXXXXXXXXXXXXGXXXXXXXXXXXXXXXXXXXGXXXXXXXXXXXXXXXXXXXGXXXXXXXXXXXXXXXXXXXGXXXXXXXXXXXXXXXXXXXGXXXXXXXXXXXXXXXXXXXGXXXXXXXXXXXXXXXXXXXGXXXXXXXXXXXXXXXXXXXGAXXXXXXXXXXXXXXXXXXGAXXXXXXXXXXXXXXXXXX,0,300,0
14448,16,3,13,76,208,0,0,220,114,106,GXXXXXXXXXXXXXXXXXXXGAXXXXXXXXXXXXXXXXXXGXXXXXXXXXXXXXXXXXXXGXXXXXXXXXXXXXXXXXXXGXXXXXXXXXXXXXXXXXXXGXXXXXXXXXXXXXXXXXXXGXXXXXXXXXXXXXXXXXXXGXXXXXXXXXXXXXXXXXXXGXXXXXXXXXXXXXXXXXXXGXXXXXXXXXXXXXXXXXXXGXXXXXXXXXXXXXXXXXXXGAXXXXXXXXXXXXXXXXXXGAXXXXXXXXXXXXXXXXXX,0,300,0
14469,16,2,14,76,208,0,0,220,118,102,GXXXXXXXXXXXXXXXXXXXGAXXXXXXXXXXXXXXXXXXGXXXXXXXXXXXXXXXXXXXGXXXXXXXXXXXXXXXXXXXGXXXXXXXXXXXXXXXXXXXGXXXXXXXXXXXXXXXXXXXGXXXXXXXXXXXXXXXXXXXGXXXXXXXXXXXXXXXXXXXGXXXXXXXXXXXXXXXXXXXGXXXXXXXXXXXXXXXXXXXGXXXXXXXXXXXXXXXXXXXGAXXXXXXXXXXXXXXXXXXGOXXXXXXXXXXXXXXXXXX,0,300,0

14490,16,1,15,79,205,0,0,218,116,102,GXXXXXXXXXXXXXXXXXXXGOXXXXXXXXXXXXXXXXXXGXXXXXXXXXXXXXXXXXXXGXXXXXXXXXXXXXXXXXXXGXXXXXXXXXXXXXXXXXXXGXXXXXXXXXXXXXXXXXXXGXXXXXXXXXXXXXXXXXXXGXXXXXXXXXXXXXXXXXXXGXXXXXXXXXXXXXXXXXXXGXXXXXXXXXXXXXXXXXXXGXXXXXXXXXXXXXXXXXXXGAXXXXXXXXXXXXXXXXXXGOXXXXXXXXXXXXXXXXXX,0,300,0
14511,14,1,13,73,213,0,0,225,118,107,GXXXXXXXXXXXXXXXXXXXGXXXXXXXXXXXXXXXXXXXGXXXXXXXXXXXXXXXXXXXGXXXXXXXXXXXXXXXXXXXGXXXXXXXXXXXXXXXXXXXGXXXXXXXXXXXXXXXXXXXGXXXXXXXXXXXXXXXXXXXGXXXXXXXXXXXXXXXXXXXGXXXXXXXXXXXXXXXXXXXGXXXXXXXXXXXXXXXXXXXGXXXXXXXXXXXXXXXXXXXGAXXXXXXXXXXXXXXXXXXGXXXXXXXXXXXXXXXXXXX,0,300,0
14532,14,1,13,71,215,0,0,228,126,102,GXXXXXXXXXXXXXXXXXXXGXXXXXXXXXXXXXXXXXXXGXXXXXXXXXXXXXXXXXXXGXXXXXXXXXXXXXXXXXXXGXXXXXXXXXXXXXXXXXXXGXXXXXXXXXXXXXXXXXXXGXXXXXXXXXXXXXXXXXXXGXXXXXXXXXXXXXXXXXXXGXXXXXXXXXXXXXXXXXXXGXXXXXXXXXXXXXXXXXXXGXXXXXXXXXXXXXXXXXXXGAXXXXXXXXXXXXXXXXXXGXXXXXXXXXXXXXXXXXXX,0,300,0
14553,14,1,13,79,207,0,0,220,121,99,GXXXXXXXXXXXXXXXXXXXGXXXXXXXXXXXXXXXXXXXGXXXXXXXXXXXXXXXXXXXGXXXXXXXXXXXXXXXXXXXGXXXXXXXXXXXXXXXXXXXGXXXXXXXXXXXXXXXXXXXGXXXXXXXXXXXXXXXXXXXGXXXXXXXXXXXXXXXXXXXGXXXXXXXXXXXXXXXXXXXGXXXXXXXXXXXXXXXXXXXGXXXXXXXXXXXXXXXXXXXGAXXXXXXXXXXXXXXXXXXGXXXXXXXXXXXXXXXXXXX,0,300,0
14574,14,1,13,79,207,0,0,220,120,100,GXXXXXXXXXXXXXXXXXXXGXXXXXXXXXXXXXXXXXXXGXXXXXXXXXXXXXXXXXXXGXXXXXXXXXXXXXXXXXXXGXXXXXXXXXXXXXXXXXXXGXXXXXXXXXXXXXXXXXXXGXXXXXXXXXXXXXXXXXXXGXXXXXXXXXXXXXXXXXXXGXXXXXXXXXXXXXXXXXXXGXXXXXXXXXXXXXXXXXXXGXXXXXXXXXXXXXXXXXXXGAXXXXXXXXXXXXXXXXXXGXXXXXXXXXXXXXXXXXXX,0,300,0

14595,14,1,13,82,204,0,0,216,122,94,GXXXXXXXXXXXXXXXXXXXGXXXXXXXXXXXXXXXXXXXGXXXXXXXXXXXXXXXXXXXGXXXXXXXXXXXXXXXXXXXGXXXXXXXXXXXXXXXXXXXGXXXXXXXXXXXXXXXXXXXGXXXXXXXXXXXXXXXXXXXGXXXXXXXXXXXXXXXXXXXGXXXXXXXXXXXXXXXXXXXGXXXXXXXXXXXXXXXXXXXGXXXXXXXXXXXXXXXXXXXGAXXXXXXXXXXXXXXXXXXGXXXXXXXXXXXXXXXXXXX,0,300,0
14616,14,1,13,84,202,0,0,214,115,99,GXXXXXXXXXXXXXXXXXXXGXXXXXXXXXXXXXXXXXXXGXXXXXXXXXXXXXXXXXXXGXXXXXXXXXXXXXXXXXXXGXXXXXXXXXXXXXXXXXXXGXXXXXXXXXXXXXXXXXXXGXXXXXXXXXXXXXXXXXXXGXXXXXXXXXXXXXXXXXXXGXXXXXXXXXXXXXXXXXXXGXXXXXXXXXXXXXXXXXXXGXXXXXXXXXXXXXXXXXXXGAXXXXXXXXXXXXXXXXXXGXXXXXXXXXXXXXXXXXXX,0,300,0
14637,14,1,13,81,205,0,0,217,113,104,GXXXXXXXXXXXXXXXXXXXGXXXXXXXXXXXXXXXXXXXGXXXXXXXXXXXXXXXXXXXGXXXXXXXXXXXXXXXXXXXGXXXXXXXXXXXXXXXXXXXGXXXXXXXXXXXXXXXXXXXGXXXXXXXXXXXXXXXXXXXGXXXXXXXXXXXXXXXXXXXGXXXXXXXXXXXXXXXXXXXGXXXXXXXXXXXXXXXXXXXGXXXXXXXXXXXXXXXXXXXGAXXXXXXXXXXXXXXXXXXGXXXXXXXXXXXXXXXXXXX,0,300,0
14658,14,1,13,74,212,0,0,225,116,109,GXXXXXXXXXXXXXXXXXXXGXXXXXXXXXXXXXXXXXXXGXXXXXXXXXXXXXXXXXXXGXXXXXXXXXXXXXXXXXXXGXXXXXXXXXXXXXXXXXXXGXXXXXXXXXXXXXXXXXXXGXXXXXXXXXXXXXXXXXXXGXXXXXXXXXXXXXXXXXXXGXXXXXXXXXXXXXXXXXXXGXXXXXXXXXXXXXXXXXXXGXXXXXXXXXXXXXXXXXXXGAXXXXXXXXXXXXXXXXXXGXXXXXXXXXXXXXXXXXXX,0,300,0
14679,14,1,13,74,212,0,0,224,114,110,GXXXXXXXXXXXXXXXXXXXGXXXXXXXXXXXXXXXXXXXGXXXXXXXXXXXXXXXXXXXGXXXXXXXXXXXXXXXXXXXGXXXXXXXXXXXXXXXXXXXGXXXXXXXXXXXXXXXXXXXGXXXXXXXXXXXXXXXXXXXGXXXXXXXXXXXXXXXXXXXGXXXXXXXXXXXXXXXXXXXGXXXXXXXXXXXXXXXXXXXGXXXXXXXXXXXXXXXXXXXGAXXXXXXXXXXXXXXXXXXGXXXXXXXXXXXXXXXXXXX,0,300,0

14700,13,0,13,75,212,0,0,225,113,112,GXXXXXXXXXXXXXXXXXXXGXXXXXXXXXXXXXXXXXXXGXXXXXXXXXXXXXXXXXXXGXXXXXXXXXXXXXXXXXXXGXXXXXXXXXXXXXXXXXXXGXXXXXXXXXXXXXXXXXXXGXXXXXXXXXXXXXXXXXXXGXXXXXXXXXXXXXXXXXXXGXXXXXXXXXXXXXXXXXXXGXXXXXXXXXXXXXXXXXXXGXXXXXXXXXXXXXXXXXXXGXXXXXXXXXXXXXXXXXXXGXXXXXXXXXXXXXXXXXXX,0,300,0
14721,13,0,13,73,214,0,0,228,116,112,GXXXXXXXXXXXXXXXXXXXGXXXXXXXXXXXXXXXXXXXGXXXXXXXXXXXXXXXXXXXGXXXXXXXXXXXXXXXXXXXGXXXXXXXXXXXXXXXXXXXGXXXXXXXXXXXXXXXXXXXGXXXXXXXXXXXXXXXXXXXGXXXXXXXXXXXXXXXXXXXGXXXXXXXXXXXXXXXXXXXGXXXXXXXXXXXXXXXXXXXGXXXXXXXXXXXXXXXXXXXGXXXXXXXXXXXXXXXXXXXGXXXXXXXXXXXXXXXXXXX,0,300,0
14742,13,0,13,71,216,0,0,229,112,117,GXXXXXXXXXXXXXXXXXXXGXXXXXXXXXXXXXXXXXXXGXXXXXXXXXXXXXXXXXXXGXXXXXXXXXXXXXXXXXXXGXXXXXXXXXXXXXXXXXXXGXXXXXXXXXXXXXXXXXXXGXXXXXXXXXXXXXXXXXXXGXXXXXXXXXXXXXXXXXXXGXXXXXXXXXXXXXXXXXXXGXXXXXXXXXXXXXXXXXXXGXXXXXXXXXXXXXXXXXXXGXXXXXXXXXXXXXXXXXXXGXXXXXXXXXXXXXXXXXXX,0,300,0
14763,13,0,13,69,218,0,0,230,112,118,GXXXXXXXXXXXXXXXXXXXGXXXXXXXXXXXXXXXXXXXGXXXXXXXXXXXXXXXXXXXGXXXXXXXXXXXXXXXXXXXGXXXXXXXXXXXXXXXXXXXGXXXXXXXXXXXXXXXXXXXGXXXXXXXXXXXXXXXXXXXGXXXXXXXXXXXXXXXXXXXGXXXXXXXXXXXXXXXXXXXGXXXXXXXXXXXXXXXXXXXGXXXXXXXXXXXXXXXXXXXGXXXXXXXXXXXXXXXXXXXGXXXXXXXXXXXXXXXXXXX,0,300,0
14784,13,0,13,66,221,0,0,234,115,119,GXXXXXXXXXXXXXXXXXXXGXXXXXXXXXXXXXXXXXXXGXXXXXXXXXXXXXXXXXXXGXXXXXXXXXXXXXXXXXXXGXXXXXXXXXXXXXXXXXXXGXXXXXXXXXXXXXXXXXXXGXXXXXXXXXXXXXXXXXXXGXXXXXXXXXXXXXXXXXXXGXXXXXXXXXXXXXXXXXXXGXXXXXXXXXXXXXXXXXXXGXXXXXXXXXXXXXXXXXXXGXXXXXXXXXXXXXXXXXXXGXXXXXXXXXXXXXXXXXXX,0,300,0

14805,13,0,13,67,220,0,0,232,111,121,GXXXXXXXXXXXXXXXXXXXGXXXXXXXXXXXXXXXXXXXGXXXXXXXXXXXXXXXXXXXGXXXXXXXXXXXXXXXXXXXGXXXXXXXXXXXXXXXXXXXGXXXXXXXXXXXXXXXXXXXGXXXXXXXXXXXXXXXXXXXGXXXXXXXXXXXXXXXXXXXGXXXXXXXXXXXXXXXXXXXGXXXXXXXXXXXXXXXXXXXGXXXXXXXXXXXXXXXXXXXGXXXXXXXXXXXXXXXXXXXGXXXXXXXXXXXXXXXXXXX,0,300,0
14826,13,0,13,59,228,0,0,238,111,127,GXXXXXXXXXXXXXXXXXXXGXXXXXXXXXXXXXXXXXXXGXXXXXXXXXXXXXXXXXXXGXXXXXXXXXXXXXXXXXXXGXXXXXXXXXXXXXXXXXXXGXXXXXXXXXXXXXXXXXXXGXXXXXXXXXXXXXXXXXXXGXXXXXXXXXXXXXXXXXXXGXXXXXXXXXXXXXXXXXXXGXXXXXXXXXXXXXXXXXXXGXXXXXXXXXXXXXXXXXXXGXXXXXXXXXXXXXXXXXXXGXXXXXXXXXXXXXXXXXXX,0,300,0
14847,13,0,13,59,228,0,0,240,114,126,GXXXXXXXXXXXXXXXXXXXGXXXXXXXXXXXXXXXXXXXGXXXXXXXXXXXXXXXXXXXGXXXXXXXXXXXXXXXXXXXGXXXXXXXXXXXXXXXXXXXGXXXXXXXXXXXXXXXXXXXGXXXXXXXXXXXXXXXXXXXGXXXXXXXXXXXXXXXXXXXGXXXXXXXXXXXXXXXXXXXGXXXXXXXXXXXXXXXXXXXGXXXXXXXXXXXXXXXXXXXGXXXXXXXXXXXXXXXXXXXGXXXXXXXXXXXXXXXXXXX,0,300,0
14868,13,0,13,57,230,0,0,242,119,123,GXXXXXXXXXXXXXXXXXXXGXXXXXXXXXXXXXXXXXXXGXXXXXXXXXXXXXXXXXXXGXXXXXXXXXXXXXXXXXXXGXXXXXXXXXXXXXXXXXXXGXXXXXXXXXXXXXXXXXXXGXXXXXXXXXXXXXXXXXXXGXXXXXXXXXXXXXXXXXXXGXXXXXXXXXXXXXXXXXXXGXXXXXXXXXXXXXXXXXXXGXXXXXXXXXXXXXXXXXXXGXXXXXXXXXXXXXXXXXXXGXXXXXXXXXXXXXXXXXXX,0,300,0
14889,13,0,13,56,231,0,0,243,117,126,GXXXXXXXXXXXXXXXXXXXGXXXXXXXXXXXXXXXXXXXGXXXXXXXXXXXXXXXXXXXGXXXXXXXXXXXXXXXXXXXGXXXXXXXXXXXXXXXXXXXGXXXXXXXXXXXXXXXXXXXGXXXXXXXXXXXXXXXXXXXGXXXXXXXXXXXXXXXXXXXGXXXXXXXXXXXXXXXXXXXGXXXXXXXXXXXXXXXXXXXGXXXXXXXXXXXXXXXXXXXGXXXXXXXXXXXXXXXXXXXGXXXXXXXXXXXXXXXXXXX,0,300,0

14910,13,0,13,57,230,0,0,243,116,127,GXXXXXXXXXXXXXXXXXXXGXXXXXXXXXXXXXXXXXXXGXXXXXXXXXXXXXXXXXXXGXXXXXXXXXXXXXXXXXXXGXXXXXXXXXXXXXXXXXXXGXXXXXXXXXXXXXXXXXXXGXXXXXXXXXXXXXXXXXXXGXXXXXXXXXXXXXXXXXXXGXXXXXXXXXXXXXXXXXXXGXXXXXXXXXXXXXXXXXXXGXXXXXXXXXXXXXXXXXXXGXXXXXXXXXXXXXXXXXXXGXXXXXXXXXXXXXXXXXXX,0,300,0
14931,13,0,13,54,233,0,0,245,114,131,GXXXXXXXXXXXXXXXXXXXGXXXXXXXXXXXXXXXXXXXGXXXXXXXXXXXXXXXXXXXGXXXXXXXXXXXXXXXXXXXGXXXXXXXXXXXXXXXXXXXGXXXXXXXXXXXXXXXXXXXGXXXXXXXXXXXXXXXXXXXGXXXXXXXXXXXXXXXXXXXGXXXXXXXXXXXXXXXXXXXGXXXXXXXXXXXXXXXXXXXGXXXXXXXXXXXXXXXXXXXGXXXXXXXXXXXXXXXXXXXGXXXXXXXXXXXXXXXXXXX,0,300,0
14952,13,0,13,56,231,0,0,243,116,127,GXXXXXXXXXXXXXXXXXXXGXXXXXXXXXXXXXXXXXXXGXXXXXXXXXXXXXXXXXXXGXXXXXXXXXXXXXXXXXXXGXXXXXXXXXXXXXXXXXXXGXXXXXXXXXXXXXXXXXXXGXXXXXXXXXXXXXXXXXXXGXXXXXXXXXXXXXXXXXXXGXXXXXXXXXXXXXXXXXXXGXXXXXXXXXXXXXXXXXXXGXXXXXXXXXXXXXXXXXXXGXXXXXXXXXXXXXXXXXXXGXXXXXXXXXXXXXXXXXXX,0,300,0
14973,13,0,13,58,229,0,0,242,114,128,GXXXXXXXXXXXXXXXXXXXGXXXXXXXXXXXXXXXXXXXGXXXXXXXXXXXXXXXXXXXGXXXXXXXXXXXXXXXXXXXGXXXXXXXXXXXXXXXXXXXGXXXXXXXXXXXXXXXXXXXGXXXXXXXXXXXXXXXXXXXGXXXXXXXXXXXXXXXXXXXGXXXXXXXXXXXXXXXXXXXGXXXXXXXXXXXXXXXXXXXGXXXXXXXXXXXXXXXXXXXGXXXXXXXXXXXXXXXXXXXGXXXXXXXXXXXXXXXXXXX,0,300,0
14994,13,0,13,60,227,0,0,239,117,122,GXXXXXXXXXXXXXXXXXXXGXXXXXXXXXXXXXXXXXXXGXXXXXXXXXXXXXXXXXXXGXXXXXXXXXXXXXXXXXXXGXXXXXXXXXXXXXXXXXXXGXXXXXXXXXXXXXXXXXXXGXXXXXXXXXXXXXXXXXXXGXXXXXXXXXXXXXXXXXXXGXXXXXXXXXXXXXXXXXXXGXXXXXXXXXXXXXXXXXXXGXXXXXXXXXXXXXXXXXXXGXXXXXXXXXXXXXXXXXXXGXXXXXXXXXXXXXXXXXXX,0,300,0

15015,13,0,13,65,222,0,0,234,121,113,GXXXXXXXXXXXXXXXXXXXGXXXXXXXXXXXXXXXXXXXGXXXXXXXXXXXXXXXXXXXGXXXXXXXXXXXXXXXXXXXGXXXXXXXXXXXXXXXXXXXGXXXXXXXXXXXXXXXXXXXGXXXXXXXXXXXXXXXXXXXGXXXXXXXXXXXXXXXXXXXGXXXXXXXXXXXXXXXXXXXGXXXXXXXXXXXXXXXXXXXGXXXXXXXXXXXXXXXXXXXGXXXXXXXXXXXXXXXXXXXGXXXXXXXXXXXXXXXXXXX,0,300,0
15036,13,0,13,64,223,0,0,235,121,114,GXXXXXXXXXXXXXXXXXXXGXXXXXXXXXXXXXXXXXXXGXXXXXXXXXXXXXXXXXXXGXXXXXXXXXXXXXXXXXXXGXXXXXXXXXXXXXXXXXXXGXXXXXXXXXXXXXXXXXXXGXXXXXXXXXXXXXXXXXXXGXXXXXXXXXXXXXXXXXXXGXXXXXXXXXXXXXXXXXXXGXXXXXXXXXXXXXXXXXXXGXXXXXXXXXXXXXXXXXXXGXXXXXXXXXXXXXXXXXXXGXXXXXXXXXXXXXXXXXXX,0,300,0
15057,13,0,13,69,218,0,0,228,114,114,GXXXXXXXXXXXXXXXXXXXGXXXXXXXXXXXXXXXXXXXGXXXXXXXXXXXXXXXXXXXGXXXXXXXXXXXXXXXXXXXGXXXXXXXXXXXXXXXXXXXGXXXXXXXXXXXXXXXXXXXGXXXXXXXXXXXXXXXXXXXGXXXXXXXXXXXXXXXXXXXGXXXXXXXXXXXXXXXXXXXGXXXXXXXXXXXXXXXXXXXGXXXXXXXXXXXXXXXXXXXGXXXXXXXXXXXXXXXXXXXGXXXXXXXXXXXXXXXXXXX,0,300,0
15078,13,0,13,65,222,0,0,234,113,121,GXXXXXXXXXXXXXXXXXXXGXXXXXXXXXXXXXXXXXXXGXXXXXXXXXXXXXXXXXXXGXXXXXXXXXXXXXXXXXXXGXXXXXXXXXXXXXXXXXXXGXXXXXXXXXXXXXXXXXXXGXXXXXXXXXXXXXXXXXXXGXXXXXXXXXXXXXXXXXXXGXXXXXXXXXXXXXXXXXXXGXXXXXXXXXXXXXXXXXXXGXXXXXXXXXXXXXXXXXXXGXXXXXXXXXXXXXXXXXXXGXXXXXXXXXXXXXXXXXXX,0,300,0
15099,13,0,13,62,225,0,0,238,120,118,GXXXXXXXXXXXXXXXXXXXGXXXXXXXXXXXXXXXXXXXGXXXXXXXXXXXXXXXXXXXGXXXXXXXXXXXXXXXXXXXGXXXXXXXXXXXXXXXXXXXGXXXXXXXXXXXXXXXXXXXGXXXXXXXXXXXXXXXXXXXGXXXXXXXXXXXXXXXXXXXGXXXXXXXXXXXXXXXXXXXGXXXXXXXXXXXXXXXXXXXGXXXXXXXXXXXXXXXXXXXGXXXXXXXXXXXXXXXXXXXGXXXXXXXXXXXXXXXXXXX,0,300,0

15120,13,0,13,66,221,0,0,234,119,115,GXXXXXXXXXXXXXXXXXXXGXXXXXXXXXXXXXXXXXXXGXXXXXXXXXXXXXXXXXXXGXXXXXXXXXXXXXXXXXXXGXXXXXXXXXXXXXXXXXXXGXXXXXXXXXXXXXXXXXXXGXXXXXXXXXXXXXXXXXXXGXXXXXXXXXXXXXXXXXXXGXXXXXXXXXXXXXXXXXXXGXXXXXXXXXXXXXXXXXXXGXXXXXXXXXXXXXXXXXXXGXXXXXXXXXXXXXXXXXXXGXXXXXXXXXXXXXXXXXXX,0,300,0
15141,14,1,13,64,222,0,0,235,120,115,GAXXXXXXXXXXXXXXXXXXGXXXXXXXXXXXXXXXXXXXGXXXXXXXXXXXXXXXXXXXGXXXXXXXXXXXXXXXXXXXGXXXXXXXXXXXXXXXXXXXGXXXXXXXXXXXXXXXXXXXGXXXXXXXXXXXXXXXXXXXGXXXXXXXXXXXXXXXXXXXGXXXXXXXXXXXXXXXXXXXGXXXXXXXXXXXXXXXXXXXGXXXXXXXXXXXXXXXXXXXGXXXXXXXXXXXXXXXXXXXGXXXXXXXXXXXXXXXXXXX,0,300,0
15162,14,1,13,61,225,0,0,237,119,118,GAXXXXXXXXXXXXXXXXXXGXXXXXXXXXXXXXXXXXXXGXXXXXXXXXXXXXXXXXXXGXXXXXXXXXXXXXXXXXXXGXXXXXXXXXXXXXXXXXXXGXXXXXXXXXXXXXXXXXXXGXXXXXXXXXXXXXXXXXXXGXXXXXXXXXXXXXXXXXXXGXXXXXXXXXXXXXXXXXXXGXXXXXXXXXXXXXXXXXXXGXXXXXXXXXXXXXXXXXXXGXXXXXXXXXXXXXXXXXXXGXXXXXXXXXXXXXXXXXXX,0,300,0
15183,14,1,13,62,224,0,0,237,119,118,GAXXXXXXXXXXXXXXXXXXGXXXXXXXXXXXXXXXXXXXGXXXXXXXXXXXXXXXXXXXGXXXXXXXXXXXXXXXXXXXGXXXXXXXXXXXXXXXXXXXGXXXXXXXXXXXXXXXXXXXGXXXXXXXXXXXXXXXXXXXGXXXXXXXXXXXXXXXXXXXGXXXXXXXXXXXXXXXXXXXGXXXXXXXXXXXXXXXXXXXGXXXXXXXXXXXXXXXXXXXGXXXXXXXXXXXXXXXXXXXGXXXXXXXXXXXXXXXXXXX,0,300,0
15204,14,1,13,67,219,0,0,232,118,114,GAXXXXXXXXXXXXXXXXXXGXXXXXXXXXXXXXXXXXXXGXXXXXXXXXXXXXXXXXXXGXXXXXXXXXXXXXXXXXXXGXXXXXXXXXXXXXXXXXXXGXXXXXXXXXXXXXXXXXXXGXXXXXXXXXXXXXXXXXXXGXXXXXXXXXXXXXXXXXXXGXXXXXXXXXXXXXXXXXXXGXXXXXXXXXXXXXXXXXXXGXXXXXXXXXXXXXXXXXXXGXXXXXXXXXXXXXXXXXXXGXXXXXXXXXXXXXXXXXXX,0,300,0

15225,14,1,13,68,218,0,0,230,116,114,GAXXXXXXXXXXXXXXXXXXGXXXXXXXXXXXXXXXXXXXGXXXXXXXXXXXXXXXXXXXGXXXXXXXXXXXXXXXXXXXGXXXXXXXXXXXXXXXXXXXGXXXXXXXXXXXXXXXXXXXGXXXXXXXXXXXXXXXXXXXGXXXXXXXXXXXXXXXXXXXGXXXXXXXXXXXXXXXXXXXGXXXXXXXXXXXXXXXXXXXGXXXXXXXXXXXXXXXXXXXGXXXXXXXXXXXXXXXXXXXGXXXXXXXXXXXXXXXXXXX,0,300,0
15246,14,1,13,69,217,0,0,230,116,114,GAXXXXXXXXXXXXXXXXXXGXXXXXXXXXXXXXXXXXXXGXXXXXXXXXXXXXXXXXXXGXXXXXXXXXXXXXXXXXXXGXXXXXXXXXXXXXXXXXXXGXXXXXXXXXXXXXXXXXXXGXXXXXXXXXXXXXXXXXXXGXXXXXXXXXXXXXXXXXXXGXXXXXXXXXXXXXXXXXXXGXXXXXXXXXXXXXXXXXXXGXXXXXXXXXXXXXXXXXXXGXXXXXXXXXXXXXXXXXXXGXXXXXXXXXXXXXXXXXXX,0,300,0
15267,14,1,13,68,218,0,0,228,114,114,GAXXXXXXXXXXXXXXXXXXGXXXXXXXXXXXXXXXXXXXGXXXXXXXXXXXXXXXXXXXGXXXXXXXXXXXXXXXXXXXGXXXXXXXXXXXXXXXXXXXGXXXXXXXXXXXXXXXXXXXGXXXXXXXXXXXXXXXXXXXGXXXXXXXXXXXXXXXXXXXGXXXXXXXXXXXXXXXXXXXGXXXXXXXXXXXXXXXXXXXGXXXXXXXXXXXXXXXXXXXGXXXXXXXXXXXXXXXXXXXGXXXXXXXXXXXXXXXXXXX,0,300,0
15288,14,1,13,66,220,0,0,233,118,115,GAXXXXXXXXXXXXXXXXXXGXXXXXXXXXXXXXXXXXXXGXXXXXXXXXXXXXXXXXXXGXXXXXXXXXXXXXXXXXXXGXXXXXXXXXXXXXXXXXXXGXXXXXXXXXXXXXXXXXXXGXXXXXXXXXXXXXXXXXXXGXXXXXXXXXXXXXXXXXXXGXXXXXXXXXXXXXXXXXXXGXXXXXXXXXXXXXXXXXXXGXXXXXXXXXXXXXXXXXXXGXXXXXXXXXXXXXXXXXXXGXXXXXXXXXXXXXXXXXXX,0,300,0
15309,14,1,13,69,217,0,0,230,120,110,GAXXXXXXXXXXXXXXXXXXGXXXXXXXXXXXXXXXXXXXGXXXXXXXXXXXXXXXXXXXGXXXXXXXXXXXXXXXXXXXGXXXXXXXXXXXXXXXXXXXGXXXXXXXXXXXXXXXXXXXGXXXXXXXXXXXXXXXXXXXGXXXXXXXXXXXXXXXXXXXGXXXXXXXXXXXXXXXXXXXGXXXXXXXXXXXXXXXXXXXGXXXXXXXXXXXXXXXXXXXGXXXXXXXXXXXXXXXXXXXGXXXXXXXXXXXXXXXXXXX,0,300,0

15330,14,1,13,68,218,0,0,231,119,112,GAXXXXXXXXXXXXXXXXXXGXXXXXXXXXXXXXXXXXXXGXXXXXXXXXXXXXXXXXXXGXXXXXXXXXXXXXXXXXXXGXXXXXXXXXXXXXXXXXXXGXXXXXXXXXXXXXXXXXXXGXXXXXXXXXXXXXXXXXXXGXXXXXXXXXXXXXXXXXXXGXXXXXXXXXXXXXXXXXXXGXXXXXXXXXXXXXXXXXXXGXXXXXXXXXXXXXXXXXXXGXXXXXXXXXXXXXXXXXXXGXXXXXXXXXXXXXXXXXXX,0,300,0
15351,14,1,13,75,211,0,0,223,113,110,GAXXXXXXXXXXXXXXXXXXGXXXXXXXXXXXXXXXXXXXGXXXXXXXXXXXXXXXXXXXGXXXXXXXXXXXXXXXXXXXGXXXXXXXXXXXXXXXXXXXGXXXXXXXXXXXXXXXXXXXGXXXXXXXXXXXXXXXXXXXGXXXXXXXXXXXXXXXXXXXGXXXXXXXXXXXXXXXXXXXGXXXXXXXXXXXXXXXXXXXGXXXXXXXXXXXXXXXXXXXGXXXXXXXXXXXXXXXXXXXGXXXXXXXXXXXXXXXXXXX,0,300,0
15372,14,1,13,77,209,0,0,222,114,108,GAXXXXXXXXXXXXXXXXXXGXXXXXXXXXXXXXXXXXXXGXXXXXXXXXXXXXXXXXXXGXXXXXXXXXXXXXXXXXXXGXXXXXXXXXXXXXXXXXXXGXXXXXXXXXXXXXXXXXXXGXXXXXXXXXXXXXXXXXXXGXXXXXXXXXXXXXXXXXXXGXXXXXXXXXXXXXXXXXXXGXXXXXXXXXXXXXXXXXXXGXXXXXXXXXXXXXXXXXXXGXXXXXXXXXXXXXXXXXXXGXXXXXXXXXXXXXXXXXXX,0,300,0
15393,14,0,14,70,216,0,0,229,119,110,GOXXXXXXXXXXXXXXXXXXGXXXXXXXXXXXXXXXXXXXGXXXXXXXXXXXXXXXXXXXGXXXXXXXXXXXXXXXXXXXGXXXXXXXXXXXXXXXXXXXGXXXXXXXXXXXXXXXXXXXGXXXXXXXXXXXXXXXXXXXGXXXXXXXXXXXXXXXXXXXGXXXXXXXXXXXXXXXXXXXGXXXXXXXXXXXXXXXXXXXGXXXXXXXXXXXXXXXXXXXGXXXXXXXXXXXXXXXXXXXGXXXXXXXXXXXXXXXXXXX,0,300,0
15414,13,0,13,69,218,0,0,231,123,108,GXXXXXXXXXXXXXXXXXXXGXXXXXXXXXXXXXXXXXXXGXXXXXXXXXXXXXXXXXXXGXXXXXXXXXXXXXXXXXXXGXXXXXXXXXXXXXXXXXXXGXXXXXXXXXXXXXXXXXXXGXXXXXXXXXXXXXXXXXXXGXXXXXXXXXXXXXXXXXXXGXXXXXXXXXXXXXXXXXXXGXXXXXXXXXXXXXXXXXXXGXXXXXXXXXXXXXXXXXXXGXXXXXXXXXXXXXXXXXXXGXXXXXXXXXXXXXXXXXXX,0,300,0

15435,13,0,13,65,222,0,0,235,119,116,GXXXXXXXXXXXXXXXXXXXGXXXXXXXXXXXXXXXXXXXGXXXXXXXXXXXXXXXXXXXGXXXXXXXXXXXXXXXXXXXGXXXXXXXXXXXXXXXXXXXGXXXXXXXXXXXXXXXXXXXGXXXXXXXXXXXXXXXXXXXGXXXXXXXXXXXXXXXXXXXGXXXXXXXXXXXXXXXXXXXGXXXXXXXXXXXXXXXXXXXGXXXXXXXXXXXXXXXXXXXGXXXXXXXXXXXXXXXXXXXGXXXXXXXXXXXXXXXXXXX,0,300,0
15456,13,0,13,60,227,0,0,240,121,119,GXXXXXXXXXXXXXXXXXXXGXXXXXXXXXXXXXXXXXXXGXXXXXXXXXXXXXXXXXXXGXXXXXXXXXXXXXXXXXXXGXXXXXXXXXXXXXXXXXXXGXXXXXXXXXXXXXXXXXXXGXXXXXXXXXXXXXXXXXXXGXXXXXXXXXXXXXXXXXXXGXXXXXXXXXXXXXXXXXXXGXXXXXXXXXXXXXXXXXXXGXXXXXXXXXXXXXXXXXXXGXXXXXXXXXXXXXXXXXXXGXXXXXXXXXXXXXXXXXXX,0,300,0
15477,13,0,13,59,228,0,0,241,130,111,GXXXXXXXXXXXXXXXXXXXGXXXXXXXXXXXXXXXXXXXGXXXXXXXXXXXXXXXXXXXGXXXXXXXXXXXXXXXXXXXGXXXXXXXXXXXXXXXXXXXGXXXXXXXXXXXXXXXXXXXGXXXXXXXXXXXXXXXXXXXGXXXXXXXXXXXXXXXXXXXGXXXXXXXXXXXXXXXXXXXGXXXXXXXXXXXXXXXXXXXGXXXXXXXXXXXXXXXXXXXGXXXXXXXXXXXXXXXXXXXGXXXXXXXXXXXXXXXXXXX,0,300,0
15498,13,0,13,64,223,0,0,236,124,112,GXXXXXXXXXXXXXXXXXXXGXXXXXXXXXXXXXXXXXXXGXXXXXXXXXXXXXXXXXXXGXXXXXXXXXXXXXXXXXXXGXXXXXXXXXXXXXXXXXXXGXXXXXXXXXXXXXXXXXXXGXXXXXXXXXXXXXXXXXXXGXXXXXXXXXXXXXXXXXXXGXXXXXXXXXXXXXXXXXXXGXXXXXXXXXXXXXXXXXXXGXXXXXXXXXXXXXXXXXXXGXXXXXXXXXXXXXXXXXXXGXXXXXXXXXXXXXXXXXXX,0,300,0
15519,13,0,13,60,227,0,0,240,125,115,GXXXXXXXXXXXXXXXXXXXGXXXXXXXXXXXXXXXXXXXGXXXXXXXXXXXXXXXXXXXGXXXXXXXXXXXXXXXXXXXGXXXXXXXXXXXXXXXXXXXGXXXXXXXXXXXXXXXXXXXGXXXXXXXXXXXXXXXXXXXGXXXXXXXXXXXXXXXXXXXGXXXXXXXXXXXXXXXXXXXGXXXXXXXXXXXXXXXXXXXGXXXXXXXXXXXXXXXXXXXGXXXXXXXXXXXXXXXXXXXGXXXXXXXXXXXXXXXXXXX,0,300,0

15540,13,0,13,61,226,0,0,239,121,118,GXXXXXXXXXXXXXXXXXXXGXXXXXXXXXXXXXXXXXXXGXXXXXXXXXXXXXXXXXXXGXXXXXXXXXXXXXXXXXXXGXXXXXXXXXXXXXXXXXXXGXXXXXXXXXXXXXXXXXXXGXXXXXXXXXXXXXXXXXXXGXXXXXXXXXXXXXXXXXXXGXXXXXXXXXXXXXXXXXXXGXXXXXXXXXXXXXXXXXXXGXXXXXXXXXXXXXXXXXXXGXXXXXXXXXXXXXXXXXXXGXXXXXXXXXXXXXXXXXXX,0,300,0
15561,14,0,14,49,237,0,0,249,118,131,GXXXXXXXXXXXXXXXXXXXGXXXXXXXXXXXXXXXXXXXGXXXXXXXXXXXXXXXXXXXGXXXXXXXXXXXXXXXXXXXGOXXXXXXXXXXXXXXXXXXGXXXXXXXXXXXXXXXXXXXGXXXXXXXXXXXXXXXXXXXGXXXXXXXXXXXXXXXXXXXGXXXXXXXXXXXXXXXXXXXGXXXXXXXXXXXXXXXXXXXGXXXXXXXXXXXXXXXXXXXGXXXXXXXXXXXXXXXXXXXGXXXXXXXXXXXXXXXXXXX,0,300,0
15582,14,0,14,46,240,0,0,252,124,128,GXXXXXXXXXXXXXXXXXXXGXXXXXXXXXXXXXXXXXXXGXXXXXXXXXXXXXXXXXXXGXXXXXXXXXXXXXXXXXXXGOXXXXXXXXXXXXXXXXXXGXXXXXXXXXXXXXXXXXXXGXXXXXXXXXXXXXXXXXXXGXXXXXXXXXXXXXXXXXXXGXXXXXXXXXXXXXXXXXXXGXXXXXXXXXXXXXXXXXXXGXXXXXXXXXXXXXXXXXXXGXXXXXXXXXXXXXXXXXXXGXXXXXXXXXXXXXXXXXXX,0,300,0
15603,13,0,13,51,236,0,0,250,123,127,GXXXXXXXXXXXXXXXXXXXGXXXXXXXXXXXXXXXXXXXGXXXXXXXXXXXXXXXXXXXGXXXXXXXXXXXXXXXXXXXGXXXXXXXXXXXXXXXXXXXGXXXXXXXXXXXXXXXXXXXGXXXXXXXXXXXXXXXXXXXGXXXXXXXXXXXXXXXXXXXGXXXXXXXXXXXXXXXXXXXGXXXXXXXXXXXXXXXXXXXGXXXXXXXXXXXXXXXXXXXGXXXXXXXXXXXXXXXXXXXGXXXXXXXXXXXXXXXXXXX,0,300,0
15624,13,0,13,58,229,0,0,242,122,120,GXXXXXXXXXXXXXXXXXXXGXXXXXXXXXXXXXXXXXXXGXXXXXXXXXXXXXXXXXXXGXXXXXXXXXXXXXXXXXXXGXXXXXXXXXXXXXXXXXXXGXXXXXXXXXXXXXXXXXXXGXXXXXXXXXXXXXXXXXXXGXXXXXXXXXXXXXXXXXXXGXXXXXXXXXXXXXXXXXXXGXXXXXXXXXXXXXXXXXXXGXXXXXXXXXXXXXXXXXXXGXXXXXXXXXXXXXXXXXXXGXXXXXXXXXXXXXXXXXXX,0,300,0

15645,15,2,13,58,227,0,0,240,119,121,GXXXXXXXXXXXXXXXXXXXGXXXXXXXXXXXXXXXXXXXGXXXXXXXXXXXXXXXXXXXGXXXXXXXXXXXXXXXXXXXGAXXXXXXXXXXXXXXXXXXGXXXXXXXXXXXXXXXXXXXGXXXXXXXXXXXXXXXXXXXGXXXXXXXXXXXXXXXXXXXGXXXXXXXXXXXXXXXXXXXGAXXXXXXXXXXXXXXXXXXGXXXXXXXXXXXXXXXXXXXGXXXXXXXXXXXXXXXXXXXGXXXXXXXXXXXXXXXXXXX,0,300,0
15666,15,2,13,56,229,0,0,243,124,119,GXXXXXXXXXXXXXXXXXXXGXXXXXXXXXXXXXXXXXXXGXXXXXXXXXXXXXXXXXXXGXXXXXXXXXXXXXXXXXXXGAXXXXXXXXXXXXXXXXXXGXXXXXXXXXXXXXXXXXXXGXXXXXXXXXXXXXXXXXXXGXXXXXXXXXXXXXXXXXXXGXXXXXXXXXXXXXXXXXXXGAXXXXXXXXXXXXXXXXXXGXXXXXXXXXXXXXXXXXXXGXXXXXXXXXXXXXXXXXXXGXXXXXXXXXXXXXXXXXXX,0,300,0
15687,15,1,14,59,226,0,0,239,121,118,GXXXXXXXXXXXXXXXXXXXGXXXXXXXXXXXXXXXXXXXGXXXXXXXXXXXXXXXXXXXGXXXXXXXXXXXXXXXXXXXGOXXXXXXXXXXXXXXXXXXGXXXXXXXXXXXXXXXXXXXGXXXXXXXXXXXXXXXXXXXGXXXXXXXXXXXXXXXXXXXGXXXXXXXXXXXXXXXXXXXGAXXXXXXXXXXXXXXXXXXGXXXXXXXXXXXXXXXXXXXGXXXXXXXXXXXXXXXXXXXGXXXXXXXXXXXXXXXXXXX,0,300,0
15708,14,1,13,60,226,0,0,240,123,117,GXXXXXXXXXXXXXXXXXXXGXXXXXXXXXXXXXXXXXXXGXXXXXXXXXXXXXXXXXXXGXXXXXXXXXXXXXXXXXXXGXXXXXXXXXXXXXXXXXXXGXXXXXXXXXXXXXXXXXXXGXXXXXXXXXXXXXXXXXXXGXXXXXXXXXXXXXXXXXXXGXXXXXXXXXXXXXXXXXXXGAXXXXXXXXXXXXXXXXXXGXXXXXXXXXXXXXXXXXXXGXXXXXXXXXXXXXXXXXXXGXXXXXXXXXXXXXXXXXXX,0,300,0
15729,14,1,13,56,230,0,0,243,131,112,GXXXXXXXXXXXXXXXXXXXGXXXXXXXXXXXXXXXXXXXGXXXXXXXXXXXXXXXXXXXGXXXXXXXXXXXXXXXXXXXGXXXXXXXXXXXXXXXXXXXGXXXXXXXXXXXXXXXXXXXGXXXXXXXXXXXXXXXXXXXGXXXXXXXXXXXXXXXXXXXGXXXXXXXXXXXXXXXXXXXGAXXXXXXXXXXXXXXXXXXGXXXXXXXXXXXXXXXXXXXGXXXXXXXXXXXXXXXXXXXGXXXXXXXXXXXXXXXXXXX,0,300,0

15750,14,1,13,63,223,0,0,236,125,111,GXXXXXXXXXXXXXXXXXXXGXXXXXXXXXXXXXXXXXXXGXXXXXXXXXXXXXXXXXXXGXXXXXXXXXXXXXXXXXXXGXXXXXXXXXXXXXXXXXXXGXXXXXXXXXXXXXXXXXXXGXXXXXXXXXXXXXXXXXXXGXXXXXXXXXXXXXXXXXXXGXXXXXXXXXXXXXXXXXXXGAXXXXXXXXXXXXXXXXXXGXXXXXXXXXXXXXXXXXXXGXXXXXXXXXXXXXXXXXXXGXXXXXXXXXXXXXXXXXXX,0,300,0
15771,14,1,13,70,216,0,0,229,127,102,GXXXXXXXXXXXXXXXXXXXGXXXXXXXXXXXXXXXXXXXGXXXXXXXXXXXXXXXXXXXGXXXXXXXXXXXXXXXXXXXGXXXXXXXXXXXXXXXXXXXGXXXXXXXXXXXXXXXXXXXGXXXXXXXXXXXXXXXXXXXGXXXXXXXXXXXXXXXXXXXGXXXXXXXXXXXXXXXXXXXGAXXXXXXXXXXXXXXXXXXGXXXXXXXXXXXXXXXXXXXGXXXXXXXXXXXXXXXXXXXGXXXXXXXXXXXXXXXXXXX,0,300,0
15792,14,1,13,65,221,0,0,233,125,108,GXXXXXXXXXXXXXXXXXXXGXXXXXXXXXXXXXXXXXXXGXXXXXXXXXXXXXXXXXXXGXXXXXXXXXXXXXXXXXXXGXXXXXXXXXXXXXXXXXXXGXXXXXXXXXXXXXXXXXXXGXXXXXXXXXXXXXXXXXXXGXXXXXXXXXXXXXXXXXXXGXXXXXXXXXXXXXXXXXXXGAXXXXXXXXXXXXXXXXXXGXXXXXXXXXXXXXXXXXXXGXXXXXXXXXXXXXXXXXXXGXXXXXXXXXXXXXXXXXXX,0,300,0
15813,14,1,13,62,224,0,0,237,121,116,GXXXXXXXXXXXXXXXXXXXGXXXXXXXXXXXXXXXXXXXGXXXXXXXXXXXXXXXXXXXGXXXXXXXXXXXXXXXXXXXGXXXXXXXXXXXXXXXXXXXGXXXXXXXXXXXXXXXXXXXGXXXXXXXXXXXXXXXXXXXGXXXXXXXXXXXXXXXXXXXGXXXXXXXXXXXXXXXXXXXGAXXXXXXXXXXXXXXXXXXGXXXXXXXXXXXXXXXXXXXGXXXXXXXXXXXXXXXXXXXGXXXXXXXXXXXXXXXXXXX,0,300,0
15834,14,1,13,56,230,0,0,243,123,120,GXXXXXXXXXXXXXXXXXXXGXXXXXXXXXXXXXXXXXXXGXXXXXXXXXXXXXXXXXXXGXXXXXXXXXXXXXXXXXXXGXXXXXXXXXXXXXXXXXXXGXXXXXXXXXXXXXXXXXXXGXXXXXXXXXXXXXXXXXXXGXXXXXXXXXXXXXXXXXXXGXXXXXXXXXXXXXXXXXXXGAXXXXXXXXXXXXXXXXXXGXXXXXXXXXXXXXXXXXXXGXXXXXXXXXXXXXXXXXXXGXXXXXXXXXXXXXXXXXXX,0,300,0

15855,14,1,13,58,228,0,0,242,122,120,GXXXXXXXXXXXXXXXXXXXGXXXXXXXXXXXXXXXXXXXGXXXXXXXXXXXXXXXXXXXGXXXXXXXXXXXXXXXXXXXGXXXXXXXXXXXXXXXXXXXGXXXXXXXXXXXXXXXXXXXGXXXXXXXXXXXXXXXXXXXGXXXXXXXXXXXXXXXXXXXGXXXXXXXXXXXXXXXXXXXGAXXXXXXXXXXXXXXXXXXGXXXXXXXXXXXXXXXXXXXGXXXXXXXXXXXXXXXXXXXGXXXXXXXXXXXXXXXXXXX,0,300,0
15876,14,1,13,57,229,0,0,243,123,120,GXXXXXXXXXXXXXXXXXXXGXXXXXXXXXXXXXXXXXXXGXXXXXXXXXXXXXXXXXXXGXXXXXXXXXXXXXXXXXXXGXXXXXXXXXXXXXXXXXXXGXXXXXXXXXXXXXXXXXXXGXXXXXXXXXXXXXXXXXXXGXXXXXXXXXXXXXXXXXXXGXXXXXXXXXXXXXXXXXXXGAXXXXXXXXXXXXXXXXXXGXXXXXXXXXXXXXXXXXXXGXXXXXXXXXXXXXXXXXXXGXXXXXXXXXXXXXXXXXXX,0,300,0
15897,14,1,13,55,231,0,0,246,127,119,GXXXXXXXXXXXXXXXXXXXGXXXXXXXXXXXXXXXXXXXGXXXXXXXXXXXXXXXXXXXGXXXXXXXXXXXXXXXXXXXGXXXXXXXXXXXXXXXXXXXGXXXXXXXXXXXXXXXXXXXGXXXXXXXXXXXXXXXXXXXGXXXXXXXXXXXXXXXXXXXGXXXXXXXXXXXXXXXXXXXGAXXXXXXXXXXXXXXXXXXGXXXXXXXXXXXXXXXXXXXGXXXXXXXXXXXXXXXXXXXGXXXXXXXXXXXXXXXXXXX,0,300,0
15918,13,0,13,57,230,0,0,245,126,119,GXXXXXXXXXXXXXXXXXXXGXXXXXXXXXXXXXXXXXXXGXXXXXXXXXXXXXXXXXXXGXXXXXXXXXXXXXXXXXXXGXXXXXXXXXXXXXXXXXXXGXXXXXXXXXXXXXXXXXXXGXXXXXXXXXXXXXXXXXXXGXXXXXXXXXXXXXXXXXXXGXXXXXXXXXXXXXXXXXXXGXXXXXXXXXXXXXXXXXXXGXXXXXXXXXXXXXXXXXXXGXXXXXXXXXXXXXXXXXXXGXXXXXXXXXXXXXXXXXXX,0,300,0
15939,13,0,13,55,232,0,0,245,122,123,GXXXXXXXXXXXXXXXXXXXGXXXXXXXXXXXXXXXXXXXGXXXXXXXXXXXXXXXXXXXGXXXXXXXXXXXXXXXXXXXGXXXXXXXXXXXXXXXXXXXGXXXXXXXXXXXXXXXXXXXGXXXXXXXXXXXXXXXXXXXGXXXXXXXXXXXXXXXXXXXGXXXXXXXXXXXXXXXXXXXGXXXXXXXXXXXXXXXXXXXGXXXXXXXXXXXXXXXXXXXGXXXXXXXXXXXXXXXXXXXGXXXXXXXXXXXXXXXXXXX,0,300,0

15960,13,0,13,58,229,0,0,243,124,119,GXXXXXXXXXXXXXXXXXXXGXXXXXXXXXXXXXXXXXXXGXXXXXXXXXXXXXXXXXXXGXXXXXXXXXXXXXXXXXXXGXXXXXXXXXXXXXXXXXXXGXXXXXXXXXXXXXXXXXXXGXXXXXXXXXXXXXXXXXXXGXXXXXXXXXXXXXXXXXXXGXXXXXXXXXXXXXXXXXXXGXXXXXXXXXXXXXXXXXXXGXXXXXXXXXXXXXXXXXXXGXXXXXXXXXXXXXXXXXXXGXXXXXXXXXXXXXXXXXXX,0,300,0
15981,13,0,13,58,229,0,0,243,127,116,GXXXXXXXXXXXXXXXXXXXGXXXXXXXXXXXXXXXXXXXGXXXXXXXXXXXXXXXXXXXGXXXXXXXXXXXXXXXXXXXGXXXXXXXXXXXXXXXXXXXGXXXXXXXXXXXXXXXXXXXGXXXXXXXXXXXXXXXXXXXGXXXXXXXXXXXXXXXXXXXGXXXXXXXXXXXXXXXXXXXGXXXXXXXXXXXXXXXXXXXGXXXXXXXXXXXXXXXXXXXGXXXXXXXXXXXXXXXXXXXGXXXXXXXXXXXXXXXXXXX,0,300,0
16002,13,0,13,63,224,0,0,238,125,113,GXXXXXXXXXXXXXXXXXXXGXXXXXXXXXXXXXXXXXXXGXXXXXXXXXXXXXXXXXXXGXXXXXXXXXXXXXXXXXXXGXXXXXXXXXXXXXXXXXXXGXXXXXXXXXXXXXXXXXXXGXXXXXXXXXXXXXXXXXXXGXXXXXXXXXXXXXXXXXXXGXXXXXXXXXXXXXXXXXXXGXXXXXXXXXXXXXXXXXXXGXXXXXXXXXXXXXXXXXXXGXXXXXXXXXXXXXXXXXXXGXXXXXXXXXXXXXXXXXXX,0,300,0
16023,13,0,13,65,222,0,0,236,128,108,GXXXXXXXXXXXXXXXXXXXGXXXXXXXXXXXXXXXXXXXGXXXXXXXXXXXXXXXXXXXGXXXXXXXXXXXXXXXXXXXGXXXXXXXXXXXXXXXXXXXGXXXXXXXXXXXXXXXXXXXGXXXXXXXXXXXXXXXXXXXGXXXXXXXXXXXXXXXXXXXGXXXXXXXXXXXXXXXXXXXGXXXXXXXXXXXXXXXXXXXGXXXXXXXXXXXXXXXXXXXGXXXXXXXXXXXXXXXXXXXGXXXXXXXXXXXXXXXXXXX,0,300,0
16044,13,0,13,60,227,0,0,239,134,105,GXXXXXXXXXXXXXXXXXXXGXXXXXXXXXXXXXXXXXXXGXXXXXXXXXXXXXXXXXXXGXXXXXXXXXXXXXXXXXXXGXXXXXXXXXXXXXXXXXXXGXXXXXXXXXXXXXXXXXXXGXXXXXXXXXXXXXXXXXXXGXXXXXXXXXXXXXXXXXXXGXXXXXXXXXXXXXXXXXXXGXXXXXXXXXXXXXXXXXXXGXXXXXXXXXXXXXXXXXXXGXXXXXXXXXXXXXXXXXXXGXXXXXXXXXXXXXXXXXXX,0,300,0

16065,13,0,13,65,222,0,0,235,132,103,GXXXXXXXXXXXXXXXXXXXGXXXXXXXXXXXXXXXXXXXGXXXXXXXXXXXXXXXXXXXGXXXXXXXXXXXXXXXXXXXGXXXXXXXXXXXXXXXXXXXGXXXXXXXXXXXXXXXXXXXGXXXXXXXXXXXXXXXXXXXGXXXXXXXXXXXXXXXXXXXGXXXXXXXXXXXXXXXXXXXGXXXXXXXXXXXXXXXXXXXGXXXXXXXXXXXXXXXXXXXGXXXXXXXXXXXXXXXXXXXGXXXXXXXXXXXXXXXXXXX,0,300,0
16086,13,0,13,70,217,0,0,230,124,106,GXXXXXXXXXXXXXXXXXXXGXXXXXXXXXXXXXXXXXXXGXXXXXXXXXXXXXXXXXXXGXXXXXXXXXXXXXXXXXXXGXXXXXXXXXXXXXXXXXXXGXXXXXXXXXXXXXXXXXXXGXXXXXXXXXXXXXXXXXXXGXXXXXXXXXXXXXXXXXXXGXXXXXXXXXXXXXXXXXXXGXXXXXXXXXXXXXXXXXXXGXXXXXXXXXXXXXXXXXXXGXXXXXXXXXXXXXXXXXXXGXXXXXXXXXXXXXXXXXXX,0,300,0
16107,13,0,13,65,222,0,0,234,127,107,GXXXXXXXXXXXXXXXXXXXGXXXXXXXXXXXXXXXXXXXGXXXXXXXXXXXXXXXXXXXGXXXXXXXXXXXXXXXXXXXGXXXXXXXXXXXXXXXXXXXGXXXXXXXXXXXXXXXXXXXGXXXXXXXXXXXXXXXXXXXGXXXXXXXXXXXXXXXXXXXGXXXXXXXXXXXXXXXXXXXGXXXXXXXXXXXXXXXXXXXGXXXXXXXXXXXXXXXXXXXGXXXXXXXXXXXXXXXXXXXGXXXXXXXXXXXXXXXXXXX,0,300,0
16128,13,0,13,64,223,0,0,236,125,111,GXXXXXXXXXXXXXXXXXXXGXXXXXXXXXXXXXXXXXXXGXXXXXXXXXXXXXXXXXXXGXXXXXXXXXXXXXXXXXXXGXXXXXXXXXXXXXXXXXXXGXXXXXXXXXXXXXXXXXXXGXXXXXXXXXXXXXXXXXXXGXXXXXXXXXXXXXXXXXXXGXXXXXXXXXXXXXXXXXXXGXXXXXXXXXXXXXXXXXXXGXXXXXXXXXXXXXXXXXXXGXXXXXXXXXXXXXXXXXXXGXXXXXXXXXXXXXXXXXXX,0,300,0
16149,13,0,13,62,225,0,0,238,129,109,GXXXXXXXXXXXXXXXXXXXGXXXXXXXXXXXXXXXXXXXGXXXXXXXXXXXXXXXXXXXGXXXXXXXXXXXXXXXXXXXGXXXXXXXXXXXXXXXXXXXGXXXXXXXXXXXXXXXXXXXGXXXXXXXXXXXXXXXXXXXGXXXXXXXXXXXXXXXXXXXGXXXXXXXXXXXXXXXXXXXGXXXXXXXXXXXXXXXXXXXGXXXXXXXXXXXXXXXXXXXGXXXXXXXXXXXXXXXXXXXGXXXXXXXXXXXXXXXXXXX,0,300,0

16170,13,0,13,68,219,0,0,231,128,103,GXXXXXXXXXXXXXXXXXXXGXXXXXXXXXXXXXXXXXXXGXXXXXXXXXXXXXXXXXXXGXXXXXXXXXXXXXXXXXXXGXXXXXXXXXXXXXXXXXXXGXXXXXXXXXXXXXXXXXXXGXXXXXXXXXXXXXXXXXXXGXXXXXXXXXXXXXXXXXXXGXXXXXXXXXXXXXXXXXXXGXXXXXXXXXXXXXXXXXXXGXXXXXXXXXXXXXXXXXXXGXXXXXXXXXXXXXXXXXXXGXXXXXXXXXXXXXXXXXXX,0,300,0
16191,13,0,13,65,222,0,0,235,130,105,GXXXXXXXXXXXXXXXXXXXGXXXXXXXXXXXXXXXXXXXGXXXXXXXXXXXXXXXXXXXGXXXXXXXXXXXXXXXXXXXGXXXXXXXXXXXXXXXXXXXGXXXXXXXXXXXXXXXXXXXGXXXXXXXXXXXXXXXXXXXGXXXXXXXXXXXXXXXXXXXGXXXXXXXXXXXXXXXXXXXGXXXXXXXXXXXXXXXXXXXGXXXXXXXXXXXXXXXXXXXGXXXXXXXXXXXXXXXXXXXGXXXXXXXXXXXXXXXXXXX,0,300,0
16212,13,0,13,67,220,0,0,232,127,105,GXXXXXXXXXXXXXXXXXXXGXXXXXXXXXXXXXXXXXXXGXXXXXXXXXXXXXXXXXXXGXXXXXXXXXXXXXXXXXXXGXXXXXXXXXXXXXXXXXXXGXXXXXXXXXXXXXXXXXXXGXXXXXXXXXXXXXXXXXXXGXXXXXXXXXXXXXXXXXXXGXXXXXXXXXXXXXXXXXXXGXXXXXXXXXXXXXXXXXXXGXXXXXXXXXXXXXXXXXXXGXXXXXXXXXXXXXXXXXXXGXXXXXXXXXXXXXXXXXXX,0,300,0
16233,13,0,13,63,224,0,0,237,134,103,GXXXXXXXXXXXXXXXXXXXGXXXXXXXXXXXXXXXXXXXGXXXXXXXXXXXXXXXXXXXGXXXXXXXXXXXXXXXXXXXGXXXXXXXXXXXXXXXXXXXGXXXXXXXXXXXXXXXXXXXGXXXXXXXXXXXXXXXXXXXGXXXXXXXXXXXXXXXXXXXGXXXXXXXXXXXXXXXXXXXGXXXXXXXXXXXXXXXXXXXGXXXXXXXXXXXXXXXXXXXGXXXXXXXXXXXXXXXXXXXGXXXXXXXXXXXXXXXXXXX,0,300,0
16254,13,0,13,68,219,0,0,232,132,100,GXXXXXXXXXXXXXXXXXXXGXXXXXXXXXXXXXXXXXXXGXXXXXXXXXXXXXXXXXXXGXXXXXXXXXXXXXXXXXXXGXXXXXXXXXXXXXXXXXXXGXXXXXXXXXXXXXXXXXXXGXXXXXXXXXXXXXXXXXXXGXXXXXXXXXXXXXXXXXXXGXXXXXXXXXXXXXXXXXXXGXXXXXXXXXXXXXXXXXXXGXXXXXXXXXXXXXXXXXXXGXXXXXXXXXXXXXXXXXXXGXXXXXXXXXXXXXXXXXXX,0,300,0

16275,13,0,13,67,220,0,0,232,129,103,GXXXXXXXXXXXXXXXXXXXGXXXXXXXXXXXXXXXXXXXGXXXXXXXXXXXXXXXXXXXGXXXXXXXXXXXXXXXXXXXGXXXXXXXXXXXXXXXXXXXGXXXXXXXXXXXXXXXXXXXGXXXXXXXXXXXXXXXXXXXGXXXXXXXXXXXXXXXXXXXGXXXXXXXXXXXXXXXXXXXGXXXXXXXXXXXXXXXXXXXGXXXXXXXXXXXXXXXXXXXGXXXXXXXXXXXXXXXXXXXGXXXXXXXXXXXXXXXXXXX,0,300,0
16296,13,0,13,71,216,0,0,229,126,103,GXXXXXXXXXXXXXXXXXXXGXXXXXXXXXXXXXXXXXXXGXXXXXXXXXXXXXXXXXXXGXXXXXXXXXXXXXXXXXXXGXXXXXXXXXXXXXXXXXXXGXXXXXXXXXXXXXXXXXXXGXXXXXXXXXXXXXXXXXXXGXXXXXXXXXXXXXXXXXXXGXXXXXXXXXXXXXXXXXXXGXXXXXXXXXXXXXXXXXXXGXXXXXXXXXXXXXXXXXXXGXXXXXXXXXXXXXXXXXXXGXXXXXXXXXXXXXXXXXXX,0,300,0
16317,13,0,13,71,216,0,0,229,122,107,GXXXXXXXXXXXXXXXXXXXGXXXXXXXXXXXXXXXXXXXGXXXXXXXXXXXXXXXXXXXGXXXXXXXXXXXXXXXXXXXGXXXXXXXXXXXXXXXXXXXGXXXXXXXXXXXXXXXXXXXGXXXXXXXXXXXXXXXXXXXGXXXXXXXXXXXXXXXXXXXGXXXXXXXXXXXXXXXXXXXGXXXXXXXXXXXXXXXXXXXGXXXXXXXXXXXXXXXXXXXGXXXXXXXXXXXXXXXXXXXGXXXXXXXXXXXXXXXXXXX,0,300,0
16338,13,0,13,63,224,0,0,236,126,110,GXXXXXXXXXXXXXXXXXXXGXXXXXXXXXXXXXXXXXXXGXXXXXXXXXXXXXXXXXXXGXXXXXXXXXXXXXXXXXXXGXXXXXXXXXXXXXXXXXXXGXXXXXXXXXXXXXXXXXXXGXXXXXXXXXXXXXXXXXXXGXXXXXXXXXXXXXXXXXXXGXXXXXXXXXXXXXXXXXXXGXXXXXXXXXXXXXXXXXXXGXXXXXXXXXXXXXXXXXXXGXXXXXXXXXXXXXXXXXXXGXXXXXXXXXXXXXXXXXXX,0,300,0
16359,13,0,13,70,217,0,0,229,124,105,GXXXXXXXXXXXXXXXXXXXGXXXXXXXXXXXXXXXXXXXGXXXXXXXXXXXXXXXXXXXGXXXXXXXXXXXXXXXXXXXGXXXXXXXXXXXXXXXXXXXGXXXXXXXXXXXXXXXXXXXGXXXXXXXXXXXXXXXXXXXGXXXXXXXXXXXXXXXXXXXGXXXXXXXXXXXXXXXXXXXGXXXXXXXXXXXXXXXXXXXGXXXXXXXXXXXXXXXXXXXGXXXXXXXXXXXXXXXXXXXGXXXXXXXXXXXXXXXXXXX,0,300,0

16380,13,0,13,68,219,0,0,231,125,106,GXXXXXXXXXXXXXXXXXXXGXXXXXXXXXXXXXXXXXXXGXXXXXXXXXXXXXXXXXXXGXXXXXXXXXXXXXXXXXXXGXXXXXXXXXXXXXXXXXXXGXXXXXXXXXXXXXXXXXXXGXXXXXXXXXXXXXXXXXXXGXXXXXXXXXXXXXXXXXXXGXXXXXXXXXXXXXXXXXXXGXXXXXXXXXXXXXXXXXXXGXXXXXXXXXXXXXXXXXXXGXXXXXXXXXXXXXXXXXXXGXXXXXXXXXXXXXXXXXXX,0,300,0
16401,13,0,13,69,218,0,0,230,121,109,GXXXXXXXXXXXXXXXXXXXGXXXXXXXXXXXXXXXXXXXGXXXXXXXXXXXXXXXXXXXGXXXXXXXXXXXXXXXXXXXGXXXXXXXXXXXXXXXXXXXGXXXXXXXXXXXXXXXXXXXGXXXXXXXXXXXXXXXXXXXGXXXXXXXXXXXXXXXXXXXGXXXXXXXXXXXXXXXXXXXGXXXXXXXXXXXXXXXXXXXGXXXXXXXXXXXXXXXXXXXGXXXXXXXXXXXXXXXXXXXGXXXXXXXXXXXXXXXXXXX,0,300,0
16422,13,0,13,63,224,0,0,237,123,114,GXXXXXXXXXXXXXXXXXXXGXXXXXXXXXXXXXXXXXXXGXXXXXXXXXXXXXXXXXXXGXXXXXXXXXXXXXXXXXXXGXXXXXXXXXXXXXXXXXXXGXXXXXXXXXXXXXXXXXXXGXXXXXXXXXXXXXXXXXXXGXXXXXXXXXXXXXXXXXXXGXXXXXXXXXXXXXXXXXXXGXXXXXXXXXXXXXXXXXXXGXXXXXXXXXXXXXXXXXXXGXXXXXXXXXXXXXXXXXXXGXXXXXXXXXXXXXXXXXXX,0,300,0
16443,13,0,13,54,233,0,0,246,125,121,GXXXXXXXXXXXXXXXXXXXGXXXXXXXXXXXXXXXXXXXGXXXXXXXXXXXXXXXXXXXGXXXXXXXXXXXXXXXXXXXGXXXXXXXXXXXXXXXXXXXGXXXXXXXXXXXXXXXXXXXGXXXXXXXXXXXXXXXXXXXGXXXXXXXXXXXXXXXXXXXGXXXXXXXXXXXXXXXXXXXGXXXXXXXXXXXXXXXXXXXGXXXXXXXXXXXXXXXXXXXGXXXXXXXXXXXXXXXXXXXGXXXXXXXXXXXXXXXXXXX,0,300,0
16464,13,0,13,53,234,0,0,247,121,126,GXXXXXXXXXXXXXXXXXXXGXXXXXXXXXXXXXXXXXXXGXXXXXXXXXXXXXXXXXXXGXXXXXXXXXXXXXXXXXXXGXXXXXXXXXXXXXXXXXXXGXXXXXXXXXXXXXXXXXXXGXXXXXXXXXXXXXXXXXXXGXXXXXXXXXXXXXXXXXXXGXXXXXXXXXXXXXXXXXXXGXXXXXXXXXXXXXXXXXXXGXXXXXXXXXXXXXXXXXXXGXXXXXXXXXXXXXXXXXXXGXXXXXXXXXXXXXXXXXXX,0,300,0

16485,13,0,13,51,236,0,0,249,120,129,GXXXXXXXXXXXXXXXXXXXGXXXXXXXXXXXXXXXXXXXGXXXXXXXXXXXXXXXXXXXGXXXXXXXXXXXXXXXXXXXGXXXXXXXXXXXXXXXXXXXGXXXXXXXXXXXXXXXXXXXGXXXXXXXXXXXXXXXXXXXGXXXXXXXXXXXXXXXXXXXGXXXXXXXXXXXXXXXXXXXGXXXXXXXXXXXXXXXXXXXGXXXXXXXXXXXXXXXXXXXGXXXXXXXXXXXXXXXXXXXGXXXXXXXXXXXXXXXXXXX,0,300,0
16506,13,0,13,48,239,0,0,252,126,126,GXXXXXXXXXXXXXXXXXXXGXXXXXXXXXXXXXXXXXXXGXXXXXXXXXXXXXXXXXXXGXXXXXXXXXXXXXXXXXXXGXXXXXXXXXXXXXXXXXXXGXXXXXXXXXXXXXXXXXXXGXXXXXXXXXXXXXXXXXXXGXXXXXXXXXXXXXXXXXXXGXXXXXXXXXXXXXXXXXXXGXXXXXXXXXXXXXXXXXXXGXXXXXXXXXXXXXXXXXXXGXXXXXXXXXXXXXXXXXXXGXXXXXXXXXXXXXXXXXXX,0,300,0
16527,13,0,13,49,238,0,0,250,129,121,GXXXXXXXXXXXXXXXXXXXGXXXXXXXXXXXXXXXXXXXGXXXXXXXXXXXXXXXXXXXGXXXXXXXXXXXXXXXXXXXGXXXXXXXXXXXXXXXXXXXGXXXXXXXXXXXXXXXXXXXGXXXXXXXXXXXXXXXXXXXGXXXXXXXXXXXXXXXXXXXGXXXXXXXXXXXXXXXXXXXGXXXXXXXXXXXXXXXXXXXGXXXXXXXXXXXXXXXXXXXGXXXXXXXXXXXXXXXXXXXGXXXXXXXXXXXXXXXXXXX,0,300,0
16548,13,0,13,54,233,0,0,245,125,120,GXXXXXXXXXXXXXXXXXXXGXXXXXXXXXXXXXXXXXXXGXXXXXXXXXXXXXXXXXXXGXXXXXXXXXXXXXXXXXXXGXXXXXXXXXXXXXXXXXXXGXXXXXXXXXXXXXXXXXXXGXXXXXXXXXXXXXXXXXXXGXXXXXXXXXXXXXXXXXXXGXXXXXXXXXXXXXXXXXXXGXXXXXXXXXXXXXXXXXXXGXXXXXXXXXXXXXXXXXXXGXXXXXXXXXXXXXXXXXXXGXXXXXXXXXXXXXXXXXXX,0,300,0
16569,13,0,13,49,238,0,0,250,132,118,GXXXXXXXXXXXXXXXXXXXGXXXXXXXXXXXXXXXXXXXGXXXXXXXXXXXXXXXXXXXGXXXXXXXXXXXXXXXXXXXGXXXXXXXXXXXXXXXXXXXGXXXXXXXXXXXXXXXXXXXGXXXXXXXXXXXXXXXXXXXGXXXXXXXXXXXXXXXXXXXGXXXXXXXXXXXXXXXXXXXGXXXXXXXXXXXXXXXXXXXGXXXXXXXXXXXXXXXXXXXGXXXXXXXXXXXXXXXXXXXGXXXXXXXXXXXXXXXXXXX,0,300,0

16590,13,0,13,54,233,0,0,245,127,118,GXXXXXXXXXXXXXXXXXXXGXXXXXXXXXXXXXXXXXXXGXXXXXXXXXXXXXXXXXXXGXXXXXXXXXXXXXXXXXXXGXXXXXXXXXXXXXXXXXXXGXXXXXXXXXXXXXXXXXXXGXXXXXXXXXXXXXXXXXXXGXXXXXXXXXXXXXXXXXXXGXXXXXXXXXXXXXXXXXXXGXXXXXXXXXXXXXXXXXXXGXXXXXXXXXXXXXXXXXXXGXXXXXXXXXXXXXXXXXXXGXXXXXXXXXXXXXXXXXXX,0,300,0
16611,13,0,13,56,231,0,0,243,131,112,GXXXXXXXXXXXXXXXXXXXGXXXXXXXXXXXXXXXXXXXGXXXXXXXXXXXXXXXXXXXGXXXXXXXXXXXXXXXXXXXGXXXXXXXXXXXXXXXXXXXGXXXXXXXXXXXXXXXXXXXGXXXXXXXXXXXXXXXXXXXGXXXXXXXXXXXXXXXXXXXGXXXXXXXXXXXXXXXXXXXGXXXXXXXXXXXXXXXXXXXGXXXXXXXXXXXXXXXXXXXGXXXXXXXXXXXXXXXXXXXGXXXXXXXXXXXXXXXXXXX,0,300,0
16632,13,0,13,57,230,0,0,241,131,110,GXXXXXXXXXXXXXXXXXXXGXXXXXXXXXXXXXXXXXXXGXXXXXXXXXXXXXXXXXXXGXXXXXXXXXXXXXXXXXXXGXXXXXXXXXXXXXXXXXXXGXXXXXXXXXXXXXXXXXXXGXXXXXXXXXXXXXXXXXXXGXXXXXXXXXXXXXXXXXXXGXXXXXXXXXXXXXXXXXXXGXXXXXXXXXXXXXXXXXXXGXXXXXXXXXXXXXXXXXXXGXXXXXXXXXXXXXXXXXXXGXXXXXXXXXXXXXXXXXXX,0,300,0
16653,13,0,13,59,228,0,0,239,125,114,GXXXXXXXXXXXXXXXXXXXGXXXXXXXXXXXXXXXXXXXGXXXXXXXXXXXXXXXXXXXGXXXXXXXXXXXXXXXXXXXGXXXXXXXXXXXXXXXXXXXGXXXXXXXXXXXXXXXXXXXGXXXXXXXXXXXXXXXXXXXGXXXXXXXXXXXXXXXXXXXGXXXXXXXXXXXXXXXXXXXGXXXXXXXXXXXXXXXXXXXGXXXXXXXXXXXXXXXXXXXGXXXXXXXXXXXXXXXXXXXGXXXXXXXXXXXXXXXXXXX,0,300,0
16674,13,0,13,56,231,0,0,243,124,119,GXXXXXXXXXXXXXXXXXXXGXXXXXXXXXXXXXXXXXXXGXXXXXXXXXXXXXXXXXXXGXXXXXXXXXXXXXXXXXXXGXXXXXXXXXXXXXXXXXXXGXXXXXXXXXXXXXXXXXXXGXXXXXXXXXXXXXXXXXXXGXXXXXXXXXXXXXXXXXXXGXXXXXXXXXXXXXXXXXXXGXXXXXXXXXXXXXXXXXXXGXXXXXXXXXXXXXXXXXXXGXXXXXXXXXXXXXXXXXXXGXXXXXXXXXXXXXXXXXXX,0,300,0

16695,13,0,13,60,227,0,0,239,125,114,GXXXXXXXXXXXXXXXXXXXGXXXXXXXXXXXXXXXXXXXGXXXXXXXXXXXXXXXXXXXGXXXXXXXXXXXXXXXXXXXGXXXXXXXXXXXXXXXXXXXGXXXXXXXXXXXXXXXXXXXGXXXXXXXXXXXXXXXXXXXGXXXXXXXXXXXXXXXXXXXGXXXXXXXXXXXXXXXXXXXGXXXXXXXXXXXXXXXXXXXGXXXXXXXXXXXXXXXXXXXGXXXXXXXXXXXXXXXXXXXGXXXXXXXXXXXXXXXXXXX,0,300,0
16716,13,0,13,63,224,0,0,235,123,112,GXXXXXXXXXXXXXXXXXXXGXXXXXXXXXXXXXXXXXXXGXXXXXXXXXXXXXXXXXXXGXXXXXXXXXXXXXXXXXXXGXXXXXXXXXXXXXXXXXXXGXXXXXXXXXXXXXXXXXXXGXXXXXXXXXXXXXXXXXXXGXXXXXXXXXXXXXXXXXXXGXXXXXXXXXXXXXXXXXXXGXXXXXXXXXXXXXXXXXXXGXXXXXXXXXXXXXXXXXXXGXXXXXXXXXXXXXXXXXXXGXXXXXXXXXXXXXXXXXXX,0,300,0
16737,13,0,13,61,226,0,0,238,128,110,GXXXXXXXXXXXXXXXXXXXGXXXXXXXXXXXXXXXXXXXGXXXXXXXXXXXXXXXXXXXGXXXXXXXXXXXXXXXXXXXGXXXXXXXXXXXXXXXXXXXGXXXXXXXXXXXXXXXXXXXGXXXXXXXXXXXXXXXXXXXGXXXXXXXXXXXXXXXXXXXGXXXXXXXXXXXXXXXXXXXGXXXXXXXXXXXXXXXXXXXGXXXXXXXXXXXXXXXXXXXGXXXXXXXXXXXXXXXXXXXGXXXXXXXXXXXXXXXXXXX,0,300,0
16758,13,0,13,61,226,0,0,238,126,112,GXXXXXXXXXXXXXXXXXXXGXXXXXXXXXXXXXXXXXXXGXXXXXXXXXXXXXXXXXXXGXXXXXXXXXXXXXXXXXXXGXXXXXXXXXXXXXXXXXXXGXXXXXXXXXXXXXXXXXXXGXXXXXXXXXXXXXXXXXXXGXXXXXXXXXXXXXXXXXXXGXXXXXXXXXXXXXXXXXXXGXXXXXXXXXXXXXXXXXXXGXXXXXXXXXXXXXXXXXXXGXXXXXXXXXXXXXXXXXXXGXXXXXXXXXXXXXXXXXXX,0,300,0
16779,13,0,13,65,222,0,0,234,130,104,GXXXXXXXXXXXXXXXXXXXGXXXXXXXXXXXXXXXXXXXGXXXXXXXXXXXXXXXXXXXGXXXXXXXXXXXXXXXXXXXGXXXXXXXXXXXXXXXXXXXGXXXXXXXXXXXXXXXXXXXGXXXXXXXXXXXXXXXXXXXGXXXXXXXXXXXXXXXXXXXGXXXXXXXXXXXXXXXXXXXGXXXXXXXXXXXXXXXXXXXGXXXXXXXXXXXXXXXXXXXGXXXXXXXXXXXXXXXXXXXGXXXXXXXXXXXXXXXXXXX,0,300,0

16800,13,0,13,57,230,0,0,242,134,108,GXXXXXXXXXXXXXXXXXXXGXXXXXXXXXXXXXXXXXXXGXXXXXXXXXXXXXXXXXXXGXXXXXXXXXXXXXXXXXXXGXXXXXXXXXXXXXXXXXXXGXXXXXXXXXXXXXXXXXXXGXXXXXXXXXXXXXXXXXXXGXXXXXXXXXXXXXXXXXXXGXXXXXXXXXXXXXXXXXXXGXXXXXXXXXXXXXXXXXXXGXXXXXXXXXXXXXXXXXXXGXXXXXXXXXXXXXXXXXXXGXXXXXXXXXXXXXXXXXXX,0,300,0
16821,13,0,13,63,224,0,0,236,135,101,GXXXXXXXXXXXXXXXXXXXGXXXXXXXXXXXXXXXXXXXGXXXXXXXXXXXXXXXXXXXGXXXXXXXXXXXXXXXXXXXGXXXXXXXXXXXXXXXXXXXGXXXXXXXXXXXXXXXXXXXGXXXXXXXXXXXXXXXXXXXGXXXXXXXXXXXXXXXXXXXGXXXXXXXXXXXXXXXXXXXGXXXXXXXXXXXXXXXXXXXGXXXXXXXXXXXXXXXXXXXGXXXXXXXXXXXXXXXXXXXGXXXXXXXXXXXXXXXXXXX,0,300,0
16842,13,0,13,60,227,0,0,239,140,99,GXXXXXXXXXXXXXXXXXXXGXXXXXXXXXXXXXXXXXXXGXXXXXXXXXXXXXXXXXXXGXXXXXXXXXXXXXXXXXXXGXXXXXXXXXXXXXXXXXXXGXXXXXXXXXXXXXXXXXXXGXXXXXXXXXXXXXXXXXXXGXXXXXXXXXXXXXXXXXXXGXXXXXXXXXXXXXXXXXXXGXXXXXXXXXXXXXXXXXXXGXXXXXXXXXXXXXXXXXXXGXXXXXXXXXXXXXXXXXXXGXXXXXXXXXXXXXXXXXXX,0,300,0
16863,13,0,13,65,222,0,0,234,136,98,GXXXXXXXXXXXXXXXXXXXGXXXXXXXXXXXXXXXXXXXGXXXXXXXXXXXXXXXXXXXGXXXXXXXXXXXXXXXXXXXGXXXXXXXXXXXXXXXXXXXGXXXXXXXXXXXXXXXXXXXGXXXXXXXXXXXXXXXXXXXGXXXXXXXXXXXXXXXXXXXGXXXXXXXXXXXXXXXXXXXGXXXXXXXXXXXXXXXXXXXGXXXXXXXXXXXXXXXXXXXGXXXXXXXXXXXXXXXXXXXGXXXXXXXXXXXXXXXXXXX,0,300,0
16884,13,0,13,61,226,0,0,238,137,101,GXXXXXXXXXXXXXXXXXXXGXXXXXXXXXXXXXXXXXXXGXXXXXXXXXXXXXXXXXXXGXXXXXXXXXXXXXXXXXXXGXXXXXXXXXXXXXXXXXXXGXXXXXXXXXXXXXXXXXXXGXXXXXXXXXXXXXXXXXXXGXXXXXXXXXXXXXXXXXXXGXXXXXXXXXXXXXXXXXXXGXXXXXXXXXXXXXXXXXXXGXXXXXXXXXXXXXXXXXXXGXXXXXXXXXXXXXXXXXXXGXXXXXXXXXXXXXXXXXXX,0,300,0

16905,13,0,13,60,227,0,0,238,136,102,GXXXXXXXXXXXXXXXXXXXGXXXXXXXXXXXXXXXXXXXGXXXXXXXXXXXXXXXXXXXGXXXXXXXXXXXXXXXXXXXGXXXXXXXXXXXXXXXXXXXGXXXXXXXXXXXXXXXXXXXGXXXXXXXXXXXXXXXXXXXGXXXXXXXXXXXXXXXXXXXGXXXXXXXXXXXXXXXXXXXGXXXXXXXXXXXXXXXXXXXGXXXXXXXXXXXXXXXXXXXGXXXXXXXXXXXXXXXXXXXGXXXXXXXXXXXXXXXXXXX,0,300,0
16926,13,0,13,62,225,0,0,236,134,102,GXXXXXXXXXXXXXXXXXXXGXXXXXXXXXXXXXXXXXXXGXXXXXXXXXXXXXXXXXXXGXXXXXXXXXXXXXXXXXXXGXXXXXXXXXXXXXXXXXXXGXXXXXXXXXXXXXXXXXXXGXXXXXXXXXXXXXXXXXXXGXXXXXXXXXXXXXXXXXXXGXXXXXXXXXXXXXXXXXXXGXXXXXXXXXXXXXXXXXXXGXXXXXXXXXXXXXXXXXXXGXXXXXXXXXXXXXXXXXXXGXXXXXXXXXXXXXXXXXXX,0,300,0
16947,13,0,13,67,220,0,0,231,133,98,GXXXXXXXXXXXXXXXXXXXGXXXXXXXXXXXXXXXXXXXGXXXXXXXXXXXXXXXXXXXGXXXXXXXXXXXXXXXXXXXGXXXXXXXXXXXXXXXXXXXGXXXXXXXXXXXXXXXXXXXGXXXXXXXXXXXXXXXXXXXGXXXXXXXXXXXXXXXXXXXGXXXXXXXXXXXXXXXXXXXGXXXXXXXXXXXXXXXXXXXGXXXXXXXXXXXXXXXXXXXGXXXXXXXXXXXXXXXXXXXGXXXXXXXXXXXXXXXXXXX,0,300,0
16968,13,0,13,68,219,0,0,231,130,101,GXXXXXXXXXXXXXXXXXXXGXXXXXXXXXXXXXXXXXXXGXXXXXXXXXXXXXXXXXXXGXXXXXXXXXXXXXXXXXXXGXXXXXXXXXXXXXXXXXXXGXXXXXXXXXXXXXXXXXXXGXXXXXXXXXXXXXXXXXXXGXXXXXXXXXXXXXXXXXXXGXXXXXXXXXXXXXXXXXXXGXXXXXXXXXXXXXXXXXXXGXXXXXXXXXXXXXXXXXXXGXXXXXXXXXXXXXXXXXXXGXXXXXXXXXXXXXXXXXXX,0,300,0
16989,13,0,13,67,220,0,0,232,128,104,GXXXXXXXXXXXXXXXXXXXGXXXXXXXXXXXXXXXXXXXGXXXXXXXXXXXXXXXXXXXGXXXXXXXXXXXXXXXXXXXGXXXXXXXXXXXXXXXXXXXGXXXXXXXXXXXXXXXXXXXGXXXXXXXXXXXXXXXXXXXGXXXXXXXXXXXXXXXXXXXGXXXXXXXXXXXXXXXXXXXGXXXXXXXXXXXXXXXXXXXGXXXXXXXXXXXXXXXXXXXGXXXXXXXXXXXXXXXXXXXGXXXXXXXXXXXXXXXXXXX,0,300,0

17010,13,0,13,65,222,0,0,234,127,107,GXXXXXXXXXXXXXXXXXXXGXXXXXXXXXXXXXXXXXXXGXXXXXXXXXXXXXXXXXXXGXXXXXXXXXXXXXXXXXXXGXXXXXXXXXXXXXXXXXXXGXXXXXXXXXXXXXXXXXXXGXXXXXXXXXXXXXXXXXXXGXXXXXXXXXXXXXXXXXXXGXXXXXXXXXXXXXXXXXXXGXXXXXXXXXXXXXXXXXXXGXXXXXXXXXXXXXXXXXXXGXXXXXXXXXXXXXXXXXXXGXXXXXXXXXXXXXXXXXXX,0,300,0
17031,13,0,13,65,222,0,0,234,131,103,GXXXXXXXXXXXXXXXXXXXGXXXXXXXXXXXXXXXXXXXGXXXXXXXXXXXXXXXXXXXGXXXXXXXXXXXXXXXXXXXGXXXXXXXXXXXXXXXXXXXGXXXXXXXXXXXXXXXXXXXGXXXXXXXXXXXXXXXXXXXGXXXXXXXXXXXXXXXXXXXGXXXXXXXXXXXXXXXXXXXGXXXXXXXXXXXXXXXXXXXGXXXXXXXXXXXXXXXXXXXGXXXXXXXXXXXXXXXXXXXGXXXXXXXXXXXXXXXXXXX,0,300,0
17052,13,0,13,64,223,0,0,235,131,104,GXXXXXXXXXXXXXXXXXXXGXXXXXXXXXXXXXXXXXXXGXXXXXXXXXXXXXXXXXXXGXXXXXXXXXXXXXXXXXXXGXXXXXXXXXXXXXXXXXXXGXXXXXXXXXXXXXXXXXXXGXXXXXXXXXXXXXXXXXXXGXXXXXXXXXXXXXXXXXXXGXXXXXXXXXXXXXXXXXXXGXXXXXXXXXXXXXXXXXXXGXXXXXXXXXXXXXXXXXXXGXXXXXXXXXXXXXXXXXXXGXXXXXXXXXXXXXXXXXXX,0,300,0
17073,13,0,13,67,220,0,0,232,130,102,GXXXXXXXXXXXXXXXXXXXGXXXXXXXXXXXXXXXXXXXGXXXXXXXXXXXXXXXXXXXGXXXXXXXXXXXXXXXXXXXGXXXXXXXXXXXXXXXXXXXGXXXXXXXXXXXXXXXXXXXGXXXXXXXXXXXXXXXXXXXGXXXXXXXXXXXXXXXXXXXGXXXXXXXXXXXXXXXXXXXGXXXXXXXXXXXXXXXXXXXGXXXXXXXXXXXXXXXXXXXGXXXXXXXXXXXXXXXXXXXGXXXXXXXXXXXXXXXXXXX,0,300,0
17094,13,0,13,63,224,0,0,236,138,98,GXXXXXXXXXXXXXXXXXXXGXXXXXXXXXXXXXXXXXXXGXXXXXXXXXXXXXXXXXXXGXXXXXXXXXXXXXXXXXXXGXXXXXXXXXXXXXXXXXXXGXXXXXXXXXXXXXXXXXXXGXXXXXXXXXXXXXXXXXXXGXXXXXXXXXXXXXXXXXXXGXXXXXXXXXXXXXXXXXXXGXXXXXXXXXXXXXXXXXXXGXXXXXXXXXXXXXXXXXXXGXXXXXXXXXXXXXXXXXXXGXXXXXXXXXXXXXXXXXXX,0,300,0

17115,14,1,13,69,217,0,0,228,133,95,GXXXXXXXXXXXXXXXXXXXGXXXXXXXXXXXXXXXXXXXGXXXXXXXXXXXXXXXXXXXGXXXXXXXXXXXXXXXXXXXGXXXXXXXXXXXXXXXXXXXGXXXXXXXXXXXXXXXXXXXGXXXXXXXXXXXXXXXXXXXGXXXXXXXXXXXXXXXXXXXGXXXXXXXXXXXXXXXXXXXGAXXXXXXXXXXXXXXXXXXGXXXXXXXXXXXXXXXXXXXGXXXXXXXXXXXXXXXXXXXGXXXXXXXXXXXXXXXXXXX,0,300,0
17136,14,0,14,68,218,0,0,230,135,95,GXXXXXXXXXXXXXXXXXXXGXXXXXXXXXXXXXXXXXXXGXXXXXXXXXXXXXXXXXXXGXXXXXXXXXXXXXXXXXXXGXXXXXXXXXXXXXXXXXXXGXXXXXXXXXXXXXXXXXXXGXXXXXXXXXXXXXXXXXXXGXXXXXXXXXXXXXXXXXXXGXXXXXXXXXXXXXXXXXXXGOXXXXXXXXXXXXXXXXXXGXXXXXXXXXXXXXXXXXXXGXXXXXXXXXXXXXXXXXXXGXXXXXXXXXXXXXXXXXXX,0,300,0
17157,13,0,13,72,215,0,0,227,128,99,GXXXXXXXXXXXXXXXXXXXGXXXXXXXXXXXXXXXXXXXGXXXXXXXXXXXXXXXXXXXGXXXXXXXXXXXXXXXXXXXGXXXXXXXXXXXXXXXXXXXGXXXXXXXXXXXXXXXXXXXGXXXXXXXXXXXXXXXXXXXGXXXXXXXXXXXXXXXXXXXGXXXXXXXXXXXXXXXXXXXGXXXXXXXXXXXXXXXXXXXGXXXXXXXXXXXXXXXXXXXGXXXXXXXXXXXXXXXXXXXGXXXXXXXXXXXXXXXXXXX,0,300,0
17178,13,0,13,68,219,0,0,231,134,97,GXXXXXXXXXXXXXXXXXXXGXXXXXXXXXXXXXXXXXXXGXXXXXXXXXXXXXXXXXXXGXXXXXXXXXXXXXXXXXXXGXXXXXXXXXXXXXXXXXXXGXXXXXXXXXXXXXXXXXXXGXXXXXXXXXXXXXXXXXXXGXXXXXXXXXXXXXXXXXXXGXXXXXXXXXXXXXXXXXXXGXXXXXXXXXXXXXXXXXXXGXXXXXXXXXXXXXXXXXXXGXXXXXXXXXXXXXXXXXXXGXXXXXXXXXXXXXXXXXXX,0,300,0
17199,13,0,13,65,222,0,0,234,137,97,GXXXXXXXXXXXXXXXXXXXGXXXXXXXXXXXXXXXXXXXGXXXXXXXXXXXXXXXXXXXGXXXXXXXXXXXXXXXXXXXGXXXXXXXXXXXXXXXXXXXGXXXXXXXXXXXXXXXXXXXGXXXXXXXXXXXXXXXXXXXGXXXXXXXXXXXXXXXXXXXGXXXXXXXXXXXXXXXXXXXGXXXXXXXXXXXXXXXXXXXGXXXXXXXXXXXXXXXXXXXGXXXXXXXXXXXXXXXXXXXGXXXXXXXXXXXXXXXXXXX,0,300,0

17220,13,0,13,59,228,0,0,239,137,102,GXXXXXXXXXXXXXXXXXXXGXXXXXXXXXXXXXXXXXXXGXXXXXXXXXXXXXXXXXXXGXXXXXXXXXXXXXXXXXXXGXXXXXXXXXXXXXXXXXXXGXXXXXXXXXXXXXXXXXXXGXXXXXXXXXXXXXXXXXXXGXXXXXXXXXXXXXXXXXXXGXXXXXXXXXXXXXXXXXXXGXXXXXXXXXXXXXXXXXXXGXXXXXXXXXXXXXXXXXXXGXXXXXXXXXXXXXXXXXXXGXXXXXXXXXXXXXXXXXXX,0,300,0
17241,13,0,13,55,232,0,0,245,135,110,GXXXXXXXXXXXXXXXXXXXGXXXXXXXXXXXXXXXXXXXGXXXXXXXXXXXXXXXXXXXGXXXXXXXXXXXXXXXXXXXGXXXXXXXXXXXXXXXXXXXGXXXXXXXXXXXXXXXXXXXGXXXXXXXXXXXXXXXXXXXGXXXXXXXXXXXXXXXXXXXGXXXXXXXXXXXXXXXXXXXGXXXXXXXXXXXXXXXXXXXGXXXXXXXXXXXXXXXXXXXGXXXXXXXXXXXXXXXXXXXGXXXXXXXXXXXXXXXXXXX,0,300,0
17262,13,0,13,55,232,0,0,245,131,114,GXXXXXXXXXXXXXXXXXXXGXXXXXXXXXXXXXXXXXXXGXXXXXXXXXXXXXXXXXXXGXXXXXXXXXXXXXXXXXXXGXXXXXXXXXXXXXXXXXXXGXXXXXXXXXXXXXXXXXXXGXXXXXXXXXXXXXXXXXXXGXXXXXXXXXXXXXXXXXXXGXXXXXXXXXXXXXXXXXXXGXXXXXXXXXXXXXXXXXXXGXXXXXXXXXXXXXXXXXXXGXXXXXXXXXXXXXXXXXXXGXXXXXXXXXXXXXXXXXXX,0,300,0
17283,13,0,13,54,233,0,0,245,133,112,GXXXXXXXXXXXXXXXXXXXGXXXXXXXXXXXXXXXXXXXGXXXXXXXXXXXXXXXXXXXGXXXXXXXXXXXXXXXXXXXGXXXXXXXXXXXXXXXXXXXGXXXXXXXXXXXXXXXXXXXGXXXXXXXXXXXXXXXXXXXGXXXXXXXXXXXXXXXXXXXGXXXXXXXXXXXXXXXXXXXGXXXXXXXXXXXXXXXXXXXGXXXXXXXXXXXXXXXXXXXGXXXXXXXXXXXXXXXXXXXGXXXXXXXXXXXXXXXXXXX,0,300,0
17304,13,0,13,60,227,0,0,239,129,110,GXXXXXXXXXXXXXXXXXXXGXXXXXXXXXXXXXXXXXXXGXXXXXXXXXXXXXXXXXXXGXXXXXXXXXXXXXXXXXXXGXXXXXXXXXXXXXXXXXXXGXXXXXXXXXXXXXXXXXXXGXXXXXXXXXXXXXXXXXXXGXXXXXXXXXXXXXXXXXXXGXXXXXXXXXXXXXXXXXXXGXXXXXXXXXXXXXXXXXXXGXXXXXXXXXXXXXXXXXXXGXXXXXXXXXXXXXXXXXXXGXXXXXXXXXXXXXXXXXXX,0,300,0

17325,14,1,13,53,233,0,0,246,130,116,GAXXXXXXXXXXXXXXXXXXGXXXXXXXXXXXXXXXXXXXGXXXXXXXXXXXXXXXXXXXGXXXXXXXXXXXXXXXXXXXGXXXXXXXXXXXXXXXXXXXGXXXXXXXXXXXXXXXXXXXGXXXXXXXXXXXXXXXXXXXGXXXXXXXXXXXXXXXXXXXGXXXXXXXXXXXXXXXXXXXGXXXXXXXXXXXXXXXXXXXGXXXXXXXXXXXXXXXXXXXGXXXXXXXXXXXXXXXXXXXGXXXXXXXXXXXXXXXXXXX,0,300,0
17346,14,1,13,49,237,0,0,250,133,117,GAXXXXXXXXXXXXXXXXXXGXXXXXXXXXXXXXXXXXXXGXXXXXXXXXXXXXXXXXXXGXXXXXXXXXXXXXXXXXXXGXXXXXXXXXXXXXXXXXXXGXXXXXXXXXXXXXXXXXXXGXXXXXXXXXXXXXXXXXXXGXXXXXXXXXXXXXXXXXXXGXXXXXXXXXXXXXXXXXXXGXXXXXXXXXXXXXXXXXXXGXXXXXXXXXXXXXXXXXXXGXXXXXXXXXXXXXXXXXXXGXXXXXXXXXXXXXXXXXXX,0,300,0
17367,14,1,13,55,231,0,0,244,128,116,GAXXXXXXXXXXXXXXXXXXGXXXXXXXXXXXXXXXXXXXGXXXXXXXXXXXXXXXXXXXGXXXXXXXXXXXXXXXXXXXGXXXXXXXXXXXXXXXXXXXGXXXXXXXXXXXXXXXXXXXGXXXXXXXXXXXXXXXXXXXGXXXXXXXXXXXXXXXXXXXGXXXXXXXXXXXXXXXXXXXGXXXXXXXXXXXXXXXXXXXGXXXXXXXXXXXXXXXXXXXGXXXXXXXXXXXXXXXXXXXGXXXXXXXXXXXXXXXXXXX,0,300,0
17388,14,1,13,53,233,0,0,246,135,111,GAXXXXXXXXXXXXXXXXXXGXXXXXXXXXXXXXXXXXXXGXXXXXXXXXXXXXXXXXXXGXXXXXXXXXXXXXXXXXXXGXXXXXXXXXXXXXXXXXXXGXXXXXXXXXXXXXXXXXXXGXXXXXXXXXXXXXXXXXXXGXXXXXXXXXXXXXXXXXXXGXXXXXXXXXXXXXXXXXXXGXXXXXXXXXXXXXXXXXXXGXXXXXXXXXXXXXXXXXXXGXXXXXXXXXXXXXXXXXXXGXXXXXXXXXXXXXXXXXXX,0,300,0
17409,14,1,13,56,230,0,0,243,140,103,GAXXXXXXXXXXXXXXXXXXGXXXXXXXXXXXXXXXXXXXGXXXXXXXXXXXXXXXXXXXGXXXXXXXXXXXXXXXXXXXGXXXXXXXXXXXXXXXXXXXGXXXXXXXXXXXXXXXXXXXGXXXXXXXXXXXXXXXXXXXGXXXXXXXXXXXXXXXXXXXGXXXXXXXXXXXXXXXXXXXGXXXXXXXXXXXXXXXXXXXGXXXXXXXXXXXXXXXXXXXGXXXXXXXXXXXXXXXXXXXGXXXXXXXXXXXXXXXXXXX,0,300,0

17430,15,2,13,56,229,0,0,242,143,99,GAXXXXXXXXXXXXXXXXXXGXXXXXXXXXXXXXXXXXXXGXXXXXXXXXXXXXXXXXXXGXXXXXXXXXXXXXXXXXXXGXXXXXXXXXXXXXXXXXXXGAXXXXXXXXXXXXXXXXXXGXXXXXXXXXXXXXXXXXXXGXXXXXXXXXXXXXXXXXXXGXXXXXXXXXXXXXXXXXXXGXXXXXXXXXXXXXXXXXXXGXXXXXXXXXXXXXXXXXXXGXXXXXXXXXXXXXXXXXXXGXXXXXXXXXXXXXXXXXXX,0,300,0
17451,15,2,13,61,224,0,0,236,136,100,GAXXXXXXXXXXXXXXXXXXGXXXXXXXXXXXXXXXXXXXGXXXXXXXXXXXXXXXXXXXGXXXXXXXXXXXXXXXXXXXGXXXXXXXXXXXXXXXXXXXGAXXXXXXXXXXXXXXXXXXGXXXXXXXXXXXXXXXXXXXGXXXXXXXXXXXXXXXXXXXGXXXXXXXXXXXXXXXXXXXGXXXXXXXXXXXXXXXXXXXGXXXXXXXXXXXXXXXXXXXGXXXXXXXXXXXXXXXXXXXGXXXXXXXXXXXXXXXXXXX,0,300,0
17472,15,2,13,69,216,0,0,229,133,96,GAXXXXXXXXXXXXXXXXXXGXXXXXXXXXXXXXXXXXXXGXXXXXXXXXXXXXXXXXXXGXXXXXXXXXXXXXXXXXXXGXXXXXXXXXXXXXXXXXXXGAXXXXXXXXXXXXXXXXXXGXXXXXXXXXXXXXXXXXXXGXXXXXXXXXXXXXXXXXXXGXXXXXXXXXXXXXXXXXXXGXXXXXXXXXXXXXXXXXXXGXXXXXXXXXXXXXXXXXXXGXXXXXXXXXXXXXXXXXXXGXXXXXXXXXXXXXXXXXXX,0,300,0
17493,15,0,15,71,214,0,0,227,131,96,GOXXXXXXXXXXXXXXXXXXGXXXXXXXXXXXXXXXXXXXGXXXXXXXXXXXXXXXXXXXGXXXXXXXXXXXXXXXXXXXGXXXXXXXXXXXXXXXXXXXGOXXXXXXXXXXXXXXXXXXGXXXXXXXXXXXXXXXXXXXGXXXXXXXXXXXXXXXXXXXGXXXXXXXXXXXXXXXXXXXGXXXXXXXXXXXXXXXXXXXGXXXXXXXXXXXXXXXXXXXGXXXXXXXXXXXXXXXXXXXGXXXXXXXXXXXXXXXXXXX,0,300,0
17514,13,0,13,68,219,0,0,231,129,102,GXXXXXXXXXXXXXXXXXXXGXXXXXXXXXXXXXXXXXXXGXXXXXXXXXXXXXXXXXXXGXXXXXXXXXXXXXXXXXXXGXXXXXXXXXXXXXXXXXXXGXXXXXXXXXXXXXXXXXXXGXXXXXXXXXXXXXXXXXXXGXXXXXXXXXXXXXXXXXXXGXXXXXXXXXXXXXXXXXXXGXXXXXXXXXXXXXXXXXXXGXXXXXXXXXXXXXXXXXXXGXXXXXXXXXXXXXXXXXXXGXXXXXXXXXXXXXXXXXXX,0,300,0

17535,13,0,13,68,219,0,0,231,130,101,GXXXXXXXXXXXXXXXXXXXGXXXXXXXXXXXXXXXXXXXGXXXXXXXXXXXXXXXXXXXGXXXXXXXXXXXXXXXXXXXGXXXXXXXXXXXXXXXXXXXGXXXXXXXXXXXXXXXXXXXGXXXXXXXXXXXXXXXXXXXGXXXXXXXXXXXXXXXXXXXGXXXXXXXXXXXXXXXXXXXGXXXXXXXXXXXXXXXXXXXGXXXXXXXXXXXXXXXXXXXGXXXXXXXXXXXXXXXXXXXGXXXXXXXXXXXXXXXXXXX,0,300,0
17556,13,0,13,62,225,0,0,238,133,105,GXXXXXXXXXXXXXXXXXXXGXXXXXXXXXXXXXXXXXXXGXXXXXXXXXXXXXXXXXXXGXXXXXXXXXXXXXXXXXXXGXXXXXXXXXXXXXXXXXXXGXXXXXXXXXXXXXXXXXXXGXXXXXXXXXXXXXXXXXXXGXXXXXXXXXXXXXXXXXXXGXXXXXXXXXXXXXXXXXXXGXXXXXXXXXXXXXXXXXXXGXXXXXXXXXXXXXXXXXXXGXXXXXXXXXXXXXXXXXXXGXXXXXXXXXXXXXXXXXXX,0,300,0
17577,13,0,13,59,228,0,0,241,134,107,GXXXXXXXXXXXXXXXXXXXGXXXXXXXXXXXXXXXXXXXGXXXXXXXXXXXXXXXXXXXGXXXXXXXXXXXXXXXXXXXGXXXXXXXXXXXXXXXXXXXGXXXXXXXXXXXXXXXXXXXGXXXXXXXXXXXXXXXXXXXGXXXXXXXXXXXXXXXXXXXGXXXXXXXXXXXXXXXXXXXGXXXXXXXXXXXXXXXXXXXGXXXXXXXXXXXXXXXXXXXGXXXXXXXXXXXXXXXXXXXGXXXXXXXXXXXXXXXXXXX,0,300,0
17598,14,1,13,55,231,0,0,243,131,112,GXXXXXXXXXXXXXXXXXXXGXXXXXXXXXXXXXXXXXXXGXXXXXXXXXXXXXXXXXXXGXXXXXXXXXXXXXXXXXXXGXXXXXXXXXXXXXXXXXXXGXXXXXXXXXXXXXXXXXXXGXXXXXXXXXXXXXXXXXXXGXXXXXXXXXXXXXXXXXXXGXXXXXXXXXXXXXXXXXXXGXXXXXXXXXXXXXXXXXXXGAXXXXXXXXXXXXXXXXXXGXXXXXXXXXXXXXXXXXXXGXXXXXXXXXXXXXXXXXXX,0,300,0
17619,14,1,13,58,228,0,0,240,129,111,GXXXXXXXXXXXXXXXXXXXGXXXXXXXXXXXXXXXXXXXGXXXXXXXXXXXXXXXXXXXGXXXXXXXXXXXXXXXXXXXGXXXXXXXXXXXXXXXXXXXGXXXXXXXXXXXXXXXXXXXGXXXXXXXXXXXXXXXXXXXGXXXXXXXXXXXXXXXXXXXGXXXXXXXXXXXXXXXXXXXGXXXXXXXXXXXXXXXXXXXGAXXXXXXXXXXXXXXXXXXGXXXXXXXXXXXXXXXXXXXGXXXXXXXXXXXXXXXXXXX,0,300,0

17640,14,1,13,53,233,0,0,245,134,111,GXXXXXXXXXXXXXXXXXXXGXXXXXXXXXXXXXXXXXXXGXXXXXXXXXXXXXXXXXXXGXXXXXXXXXXXXXXXXXXXGXXXXXXXXXXXXXXXXXXXGXXXXXXXXXXXXXXXXXXXGXXXXXXXXXXXXXXXXXXXGXXXXXXXXXXXXXXXXXXXGXXXXXXXXXXXXXXXXXXXGXXXXXXXXXXXXXXXXXXXGAXXXXXXXXXXXXXXXXXXGXXXXXXXXXXXXXXXXXXXGXXXXXXXXXXXXXXXXXXX,0,300,0
17661,14,1,13,53,233,0,0,244,139,105,GAXXXXXXXXXXXXXXXXXXGXXXXXXXXXXXXXXXXXXXGXXXXXXXXXXXXXXXXXXXGXXXXXXXXXXXXXXXXXXXGXXXXXXXXXXXXXXXXXXXGXXXXXXXXXXXXXXXXXXXGXXXXXXXXXXXXXXXXXXXGXXXXXXXXXXXXXXXXXXXGXXXXXXXXXXXXXXXXXXXGXXXXXXXXXXXXXXXXXXXGXXXXXXXXXXXXXXXXXXXGXXXXXXXXXXXXXXXXXXXGXXXXXXXXXXXXXXXXXXX,0,300,0
17682,14,1,13,56,230,0,0,242,139,103,GAXXXXXXXXXXXXXXXXXXGXXXXXXXXXXXXXXXXXXXGXXXXXXXXXXXXXXXXXXXGXXXXXXXXXXXXXXXXXXXGXXXXXXXXXXXXXXXXXXXGXXXXXXXXXXXXXXXXXXXGXXXXXXXXXXXXXXXXXXXGXXXXXXXXXXXXXXXXXXXGXXXXXXXXXXXXXXXXXXXGXXXXXXXXXXXXXXXXXXXGXXXXXXXXXXXXXXXXXXXGXXXXXXXXXXXXXXXXXXXGXXXXXXXXXXXXXXXXXXX,0,300,0
17703,13,0,13,66,221,0,0,234,131,103,GXXXXXXXXXXXXXXXXXXXGXXXXXXXXXXXXXXXXXXXGXXXXXXXXXXXXXXXXXXXGXXXXXXXXXXXXXXXXXXXGXXXXXXXXXXXXXXXXXXXGXXXXXXXXXXXXXXXXXXXGXXXXXXXXXXXXXXXXXXXGXXXXXXXXXXXXXXXXXXXGXXXXXXXXXXXXXXXXXXXGXXXXXXXXXXXXXXXXXXXGXXXXXXXXXXXXXXXXXXXGXXXXXXXXXXXXXXXXXXXGXXXXXXXXXXXXXXXXXXX,0,300,0
17724,13,0,13,58,229,0,0,243,132,111,GXXXXXXXXXXXXXXXXXXXGXXXXXXXXXXXXXXXXXXXGXXXXXXXXXXXXXXXXXXXGXXXXXXXXXXXXXXXXXXXGXXXXXXXXXXXXXXXXXXXGXXXXXXXXXXXXXXXXXXXGXXXXXXXXXXXXXXXXXXXGXXXXXXXXXXXXXXXXXXXGXXXXXXXXXXXXXXXXXXXGXXXXXXXXXXXXXXXXXXXGXXXXXXXXXXXXXXXXXXXGXXXXXXXXXXXXXXXXXXXGXXXXXXXXXXXXXXXXXXX,0,300,0

17745,13,0,13,58,229,0,0,243,134,109,GXXXXXXXXXXXXXXXXXXXGXXXXXXXXXXXXXXXXXXXGXXXXXXXXXXXXXXXXXXXGXXXXXXXXXXXXXXXXXXXGXXXXXXXXXXXXXXXXXXXGXXXXXXXXXXXXXXXXXXXGXXXXXXXXXXXXXXXXXXXGXXXXXXXXXXXXXXXXXXXGXXXXXXXXXXXXXXXXXXXGXXXXXXXXXXXXXXXXXXXGXXXXXXXXXXXXXXXXXXXGXXXXXXXXXXXXXXXXXXXGXXXXXXXXXXXXXXXXXXX,0,300,0
17766,13,0,13,60,227,0,0,241,132,109,GXXXXXXXXXXXXXXXXXXXGXXXXXXXXXXXXXXXXXXXGXXXXXXXXXXXXXXXXXXXGXXXXXXXXXXXXXXXXXXXGXXXXXXXXXXXXXXXXXXXGXXXXXXXXXXXXXXXXXXXGXXXXXXXXXXXXXXXXXXXGXXXXXXXXXXXXXXXXXXXGXXXXXXXXXXXXXXXXXXXGXXXXXXXXXXXXXXXXXXXGXXXXXXXXXXXXXXXXXXXGXXXXXXXXXXXXXXXXXXXGXXXXXXXXXXXXXXXXXXX,0,300,0
17787,13,0,13,57,230,0,0,244,132,112,GXXXXXXXXXXXXXXXXXXXGXXXXXXXXXXXXXXXXXXXGXXXXXXXXXXXXXXXXXXXGXXXXXXXXXXXXXXXXXXXGXXXXXXXXXXXXXXXXXXXGXXXXXXXXXXXXXXXXXXXGXXXXXXXXXXXXXXXXXXXGXXXXXXXXXXXXXXXXXXXGXXXXXXXXXXXXXXXXXXXGXXXXXXXXXXXXXXXXXXXGXXXXXXXXXXXXXXXXXXXGXXXXXXXXXXXXXXXXXXXGXXXXXXXXXXXXXXXXXXX,0,300,0
17808,13,0,13,56,231,0,0,245,131,114,GXXXXXXXXXXXXXXXXXXXGXXXXXXXXXXXXXXXXXXXGXXXXXXXXXXXXXXXXXXXGXXXXXXXXXXXXXXXXXXXGXXXXXXXXXXXXXXXXXXXGXXXXXXXXXXXXXXXXXXXGXXXXXXXXXXXXXXXXXXXGXXXXXXXXXXXXXXXXXXXGXXXXXXXXXXXXXXXXXXXGXXXXXXXXXXXXXXXXXXXGXXXXXXXXXXXXXXXXXXXGXXXXXXXXXXXXXXXXXXXGXXXXXXXXXXXXXXXXXXX,0,300,0
17829,13,0,13,56,231,0,0,245,139,106,GXXXXXXXXXXXXXXXXXXXGXXXXXXXXXXXXXXXXXXXGXXXXXXXXXXXXXXXXXXXGXXXXXXXXXXXXXXXXXXXGXXXXXXXXXXXXXXXXXXXGXXXXXXXXXXXXXXXXXXXGXXXXXXXXXXXXXXXXXXXGXXXXXXXXXXXXXXXXXXXGXXXXXXXXXXXXXXXXXXXGXXXXXXXXXXXXXXXXXXXGXXXXXXXXXXXXXXXXXXXGXXXXXXXXXXXXXXXXXXXGXXXXXXXXXXXXXXXXXXX,0,300,0

17850,13,0,13,66,221,0,0,235,128,107,GXXXXXXXXXXXXXXXXXXXGXXXXXXXXXXXXXXXXXXXGXXXXXXXXXXXXXXXXXXXGXXXXXXXXXXXXXXXXXXXGXXXXXXXXXXXXXXXXXXXGXXXXXXXXXXXXXXXXXXXGXXXXXXXXXXXXXXXXXXXGXXXXXXXXXXXXXXXXXXXGXXXXXXXXXXXXXXXXXXXGXXXXXXXXXXXXXXXXXXXGXXXXXXXXXXXXXXXXXXXGXXXXXXXXXXXXXXXXXXXGXXXXXXXXXXXXXXXXXXX,0,300,0
17871,13,0,13,64,223,0,0,237,132,105,GXXXXXXXXXXXXXXXXXXXGXXXXXXXXXXXXXXXXXXXGXXXXXXXXXXXXXXXXXXXGXXXXXXXXXXXXXXXXXXXGXXXXXXXXXXXXXXXXXXXGXXXXXXXXXXXXXXXXXXXGXXXXXXXXXXXXXXXXXXXGXXXXXXXXXXXXXXXXXXXGXXXXXXXXXXXXXXXXXXXGXXXXXXXXXXXXXXXXXXXGXXXXXXXXXXXXXXXXXXXGXXXXXXXXXXXXXXXXXXXGXXXXXXXXXXXXXXXXXXX,0,300,0
17892,13,0,13,61,226,0,0,239,135,104,GXXXXXXXXXXXXXXXXXXXGXXXXXXXXXXXXXXXXXXXGXXXXXXXXXXXXXXXXXXXGXXXXXXXXXXXXXXXXXXXGXXXXXXXXXXXXXXXXXXXGXXXXXXXXXXXXXXXXXXXGXXXXXXXXXXXXXXXXXXXGXXXXXXXXXXXXXXXXXXXGXXXXXXXXXXXXXXXXXXXGXXXXXXXXXXXXXXXXXXXGXXXXXXXXXXXXXXXXXXXGXXXXXXXXXXXXXXXXXXXGXXXXXXXXXXXXXXXXXXX,0,300,0
17913,13,0,13,55,232,0,0,245,141,104,GXXXXXXXXXXXXXXXXXXXGXXXXXXXXXXXXXXXXXXXGXXXXXXXXXXXXXXXXXXXGXXXXXXXXXXXXXXXXXXXGXXXXXXXXXXXXXXXXXXXGXXXXXXXXXXXXXXXXXXXGXXXXXXXXXXXXXXXXXXXGXXXXXXXXXXXXXXXXXXXGXXXXXXXXXXXXXXXXXXXGXXXXXXXXXXXXXXXXXXXGXXXXXXXXXXXXXXXXXXXGXXXXXXXXXXXXXXXXXXXGXXXXXXXXXXXXXXXXXXX,0,300,0
17934,13,0,13,54,233,0,0,245,141,104,GXXXXXXXXXXXXXXXXXXXGXXXXXXXXXXXXXXXXXXXGXXXXXXXXXXXXXXXXXXXGXXXXXXXXXXXXXXXXXXXGXXXXXXXXXXXXXXXXXXXGXXXXXXXXXXXXXXXXXXXGXXXXXXXXXXXXXXXXXXXGXXXXXXXXXXXXXXXXXXXGXXXXXXXXXXXXXXXXXXXGXXXXXXXXXXXXXXXXXXXGXXXXXXXXXXXXXXXXXXXGXXXXXXXXXXXXXXXXXXXGXXXXXXXXXXXXXXXXXXX,0,300,0

17955,13,0,13,60,227,0,0,240,141,99,GXXXXXXXXXXXXXXXXXXXGXXXXXXXXXXXXXXXXXXXGXXXXXXXXXXXXXXXXXXXGXXXXXXXXXXXXXXXXXXXGXXXXXXXXXXXXXXXXXXXGXXXXXXXXXXXXXXXXXXXGXXXXXXXXXXXXXXXXXXXGXXXXXXXXXXXXXXXXXXXGXXXXXXXXXXXXXXXXXXXGXXXXXXXXXXXXXXXXXXXGXXXXXXXXXXXXXXXXXXXGXXXXXXXXXXXXXXXXXXXGXXXXXXXXXXXXXXXXXXX,0,300,0
17976,13,0,13,58,229,0,0,242,138,104,GXXXXXXXXXXXXXXXXXXXGXXXXXXXXXXXXXXXXXXXGXXXXXXXXXXXXXXXXXXXGXXXXXXXXXXXXXXXXXXXGXXXXXXXXXXXXXXXXXXXGXXXXXXXXXXXXXXXXXXXGXXXXXXXXXXXXXXXXXXXGXXXXXXXXXXXXXXXXXXXGXXXXXXXXXXXXXXXXXXXGXXXXXXXXXXXXXXXXXXXGXXXXXXXXXXXXXXXXXXXGXXXXXXXXXXXXXXXXXXXGXXXXXXXXXXXXXXXXXXX,0,300,0
17997,13,0,13,62,225,0,0,238,138,100,GXXXXXXXXXXXXXXXXXXXGXXXXXXXXXXXXXXXXXXXGXXXXXXXXXXXXXXXXXXXGXXXXXXXXXXXXXXXXXXXGXXXXXXXXXXXXXXXXXXXGXXXXXXXXXXXXXXXXXXXGXXXXXXXXXXXXXXXXXXXGXXXXXXXXXXXXXXXXXXXGXXXXXXXXXXXXXXXXXXXGXXXXXXXXXXXXXXXXXXXGXXXXXXXXXXXXXXXXXXXGXXXXXXXXXXXXXXXXXXXGXXXXXXXXXXXXXXXXXXX,0,300,0
18018,13,0,13,60,227,0,0,238,140,98,GXXXXXXXXXXXXXXXXXXXGXXXXXXXXXXXXXXXXXXXGXXXXXXXXXXXXXXXXXXXGXXXXXXXXXXXXXXXXXXXGXXXXXXXXXXXXXXXXXXXGXXXXXXXXXXXXXXXXXXXGXXXXXXXXXXXXXXXXXXXGXXXXXXXXXXXXXXXXXXXGXXXXXXXXXXXXXXXXXXXGXXXXXXXXXXXXXXXXXXXGXXXXXXXXXXXXXXXXXXXGXXXXXXXXXXXXXXXXXXXGXXXXXXXXXXXXXXXXXXX,0,300,0
18039,13,0,13,66,221,0,0,234,141,93,GXXXXXXXXXXXXXXXXXXXGXXXXXXXXXXXXXXXXXXXGXXXXXXXXXXXXXXXXXXXGXXXXXXXXXXXXXXXXXXXGXXXXXXXXXXXXXXXXXXXGXXXXXXXXXXXXXXXXXXXGXXXXXXXXXXXXXXXXXXXGXXXXXXXXXXXXXXXXXXXGXXXXXXXXXXXXXXXXXXXGXXXXXXXXXXXXXXXXXXXGXXXXXXXXXXXXXXXXXXXGXXXXXXXXXXXXXXXXXXXGXXXXXXXXXXXXXXXXXXX,0,300,0

18060,13,0,13,67,220,0,0,231,139,92,GXXXXXXXXXXXXXXXXXXXGXXXXXXXXXXXXXXXXXXXGXXXXXXXXXXXXXXXXXXXGXXXXXXXXXXXXXXXXXXXGXXXXXXXXXXXXXXXXXXXGXXXXXXXXXXXXXXXXXXXGXXXXXXXXXXXXXXXXXXXGXXXXXXXXXXXXXXXXXXXGXXXXXXXXXXXXXXXXXXXGXXXXXXXXXXXXXXXXXXXGXXXXXXXXXXXXXXXXXXXGXXXXXXXXXXXXXXXXXXXGXXXXXXXXXXXXXXXXXXX,0,300,0
18081,14,1,13,58,228,0,0,240,139,101,GXXXXXXXXXXXXXXXXXXXGXXXXXXXXXXXXXXXXXXXGXXXXXXXXXXXXXXXXXXXGAXXXXXXXXXXXXXXXXXXGXXXXXXXXXXXXXXXXXXXGXXXXXXXXXXXXXXXXXXXGXXXXXXXXXXXXXXXXXXXGXXXXXXXXXXXXXXXXXXXGXXXXXXXXXXXXXXXXXXXGXXXXXXXXXXXXXXXXXXXGXXXXXXXXXXXXXXXXXXXGXXXXXXXXXXXXXXXXXXXGXXXXXXXXXXXXXXXXXXX,0,300,0
18102,14,1,13,52,234,0,0,245,142,103,GXXXXXXXXXXXXXXXXXXXGXXXXXXXXXXXXXXXXXXXGXXXXXXXXXXXXXXXXXXXGAXXXXXXXXXXXXXXXXXXGXXXXXXXXXXXXXXXXXXXGXXXXXXXXXXXXXXXXXXXGXXXXXXXXXXXXXXXXXXXGXXXXXXXXXXXXXXXXXXXGXXXXXXXXXXXXXXXXXXXGXXXXXXXXXXXXXXXXXXXGXXXXXXXXXXXXXXXXXXXGXXXXXXXXXXXXXXXXXXXGXXXXXXXXXXXXXXXXXXX,0,300,0
18123,14,1,13,54,232,0,0,244,142,102,GXXXXXXXXXXXXXXXXXXXGXXXXXXXXXXXXXXXXXXXGXXXXXXXXXXXXXXXXXXXGAXXXXXXXXXXXXXXXXXXGXXXXXXXXXXXXXXXXXXXGXXXXXXXXXXXXXXXXXXXGXXXXXXXXXXXXXXXXXXXGXXXXXXXXXXXXXXXXXXXGXXXXXXXXXXXXXXXXXXXGXXXXXXXXXXXXXXXXXXXGXXXXXXXXXXXXXXXXXXXGXXXXXXXXXXXXXXXXXXXGXXXXXXXXXXXXXXXXXXX,0,300,0
18144,14,0,14,55,231,0,0,243,141,102,GXXXXXXXXXXXXXXXXXXXGXXXXXXXXXXXXXXXXXXXGXXXXXXXXXXXXXXXXXXXGOXXXXXXXXXXXXXXXXXXGXXXXXXXXXXXXXXXXXXXGXXXXXXXXXXXXXXXXXXXGXXXXXXXXXXXXXXXXXXXGXXXXXXXXXXXXXXXXXXXGXXXXXXXXXXXXXXXXXXXGXXXXXXXXXXXXXXXXXXXGXXXXXXXXXXXXXXXXXXXGXXXXXXXXXXXXXXXXXXXGXXXXXXXXXXXXXXXXXXX,0,300,0

18165,13,0,13,58,229,0,0,241,139,102,GXXXXXXXXXXXXXXXXXXXGXXXXXXXXXXXXXXXXXXXGXXXXXXXXXXXXXXXXXXXGXXXXXXXXXXXXXXXXXXXGXXXXXXXXXXXXXXXXXXXGXXXXXXXXXXXXXXXXXXXGXXXXXXXXXXXXXXXXXXXGXXXXXXXXXXXXXXXXXXXGXXXXXXXXXXXXXXXXXXXGXXXXXXXXXXXXXXXXXXXGXXXXXXXXXXXXXXXXXXXGXXXXXXXXXXXXXXXXXXXGXXXXXXXXXXXXXXXXXXX,0,300,0
18186,13,0,13,56,231,0,0,243,138,105,GXXXXXXXXXXXXXXXXXXXGXXXXXXXXXXXXXXXXXXXGXXXXXXXXXXXXXXXXXXXGXXXXXXXXXXXXXXXXXXXGXXXXXXXXXXXXXXXXXXXGXXXXXXXXXXXXXXXXXXXGXXXXXXXXXXXXXXXXXXXGXXXXXXXXXXXXXXXXXXXGXXXXXXXXXXXXXXXXXXXGXXXXXXXXXXXXXXXXXXXGXXXXXXXXXXXXXXXXXXXGXXXXXXXXXXXXXXXXXXXGXXXXXXXXXXXXXXXXXXX,0,300,0
18207,13,0,13,54,233,0,0,245,139,106,GXXXXXXXXXXXXXXXXXXXGXXXXXXXXXXXXXXXXXXXGXXXXXXXXXXXXXXXXXXXGXXXXXXXXXXXXXXXXXXXGXXXXXXXXXXXXXXXXXXXGXXXXXXXXXXXXXXXXXXXGXXXXXXXXXXXXXXXXXXXGXXXXXXXXXXXXXXXXXXXGXXXXXXXXXXXXXXXXXXXGXXXXXXXXXXXXXXXXXXXGXXXXXXXXXXXXXXXXXXXGXXXXXXXXXXXXXXXXXXXGXXXXXXXXXXXXXXXXXXX,0,300,0
18228,13,0,13,57,230,0,0,242,135,107,GXXXXXXXXXXXXXXXXXXXGXXXXXXXXXXXXXXXXXXXGXXXXXXXXXXXXXXXXXXXGXXXXXXXXXXXXXXXXXXXGXXXXXXXXXXXXXXXXXXXGXXXXXXXXXXXXXXXXXXXGXXXXXXXXXXXXXXXXXXXGXXXXXXXXXXXXXXXXXXXGXXXXXXXXXXXXXXXXXXXGXXXXXXXXXXXXXXXXXXXGXXXXXXXXXXXXXXXXXXXGXXXXXXXXXXXXXXXXXXXGXXXXXXXXXXXXXXXXXXX,0,300,0
18249,13,0,13,56,231,0,0,242,134,108,GXXXXXXXXXXXXXXXXXXXGXXXXXXXXXXXXXXXXXXXGXXXXXXXXXXXXXXXXXXXGXXXXXXXXXXXXXXXXXXXGXXXXXXXXXXXXXXXXXXXGXXXXXXXXXXXXXXXXXXXGXXXXXXXXXXXXXXXXXXXGXXXXXXXXXXXXXXXXXXXGXXXXXXXXXXXXXXXXXXXGXXXXXXXXXXXXXXXXXXXGXXXXXXXXXXXXXXXXXXXGXXXXXXXXXXXXXXXXXXXGXXXXXXXXXXXXXXXXXXX,0,300,0

18270,14,1,13,56,230,0,0,243,138,105,GAXXXXXXXXXXXXXXXXXXGXXXXXXXXXXXXXXXXXXXGXXXXXXXXXXXXXXXXXXXGXXXXXXXXXXXXXXXXXXXGXXXXXXXXXXXXXXXXXXXGXXXXXXXXXXXXXXXXXXXGXXXXXXXXXXXXXXXXXXXGXXXXXXXXXXXXXXXXXXXGXXXXXXXXXXXXXXXXXXXGXXXXXXXXXXXXXXXXXXXGXXXXXXXXXXXXXXXXXXXGXXXXXXXXXXXXXXXXXXXGXXXXXXXXXXXXXXXXXXX,0,300,0
18291,14,1,13,50,236,0,0,249,137,112,GAXXXXXXXXXXXXXXXXXXGXXXXXXXXXXXXXXXXXXXGXXXXXXXXXXXXXXXXXXXGXXXXXXXXXXXXXXXXXXXGXXXXXXXXXXXXXXXXXXXGXXXXXXXXXXXXXXXXXXXGXXXXXXXXXXXXXXXXXXXGXXXXXXXXXXXXXXXXXXXGXXXXXXXXXXXXXXXXXXXGXXXXXXXXXXXXXXXXXXXGXXXXXXXXXXXXXXXXXXXGXXXXXXXXXXXXXXXXXXXGXXXXXXXXXXXXXXXXXXX,0,300,0
18312,14,1,13,47,239,0,0,250,139,111,GAXXXXXXXXXXXXXXXXXXGXXXXXXXXXXXXXXXXXXXGXXXXXXXXXXXXXXXXXXXGXXXXXXXXXXXXXXXXXXXGXXXXXXXXXXXXXXXXXXXGXXXXXXXXXXXXXXXXXXXGXXXXXXXXXXXXXXXXXXXGXXXXXXXXXXXXXXXXXXXGXXXXXXXXXXXXXXXXXXXGXXXXXXXXXXXXXXXXXXXGXXXXXXXXXXXXXXXXXXXGXXXXXXXXXXXXXXXXXXXGXXXXXXXXXXXXXXXXXXX,0,300,0
18333,14,1,13,45,241,0,0,254,137,117,GAXXXXXXXXXXXXXXXXXXGXXXXXXXXXXXXXXXXXXXGXXXXXXXXXXXXXXXXXXXGXXXXXXXXXXXXXXXXXXXGXXXXXXXXXXXXXXXXXXXGXXXXXXXXXXXXXXXXXXXGXXXXXXXXXXXXXXXXXXXGXXXXXXXXXXXXXXXXXXXGXXXXXXXXXXXXXXXXXXXGXXXXXXXXXXXXXXXXXXXGXXXXXXXXXXXXXXXXXXXGXXXXXXXXXXXXXXXXXXXGXXXXXXXXXXXXXXXXXXX,0,300,0
18354,14,1,13,42,244,0,0,257,138,119,GAXXXXXXXXXXXXXXXXXXGXXXXXXXXXXXXXXXXXXXGXXXXXXXXXXXXXXXXXXXGXXXXXXXXXXXXXXXXXXXGXXXXXXXXXXXXXXXXXXXGXXXXXXXXXXXXXXXXXXXGXXXXXXXXXXXXXXXXXXXGXXXXXXXXXXXXXXXXXXXGXXXXXXXXXXXXXXXXXXXGXXXXXXXXXXXXXXXXXXXGXXXXXXXXXXXXXXXXXXXGXXXXXXXXXXXXXXXXXXXGXXXXXXXXXXXXXXXXXXX,0,300,0

18375,14,1,13,44,242,0,0,255,144,111,GAXXXXXXXXXXXXXXXXXXGXXXXXXXXXXXXXXXXXXXGXXXXXXXXXXXXXXXXXXXGXXXXXXXXXXXXXXXXXXXGXXXXXXXXXXXXXXXXXXXGXXXXXXXXXXXXXXXXXXXGXXXXXXXXXXXXXXXXXXXGXXXXXXXXXXXXXXXXXXXGXXXXXXXXXXXXXXXXXXXGXXXXXXXXXXXXXXXXXXXGXXXXXXXXXXXXXXXXXXXGXXXXXXXXXXXXXXXXXXXGXXXXXXXXXXXXXXXXXXX,0,300,0
18396,14,1,13,48,238,0,0,251,140,111,GAXXXXXXXXXXXXXXXXXXGXXXXXXXXXXXXXXXXXXXGXXXXXXXXXXXXXXXXXXXGXXXXXXXXXXXXXXXXXXXGXXXXXXXXXXXXXXXXXXXGXXXXXXXXXXXXXXXXXXXGXXXXXXXXXXXXXXXXXXXGXXXXXXXXXXXXXXXXXXXGXXXXXXXXXXXXXXXXXXXGXXXXXXXXXXXXXXXXXXXGXXXXXXXXXXXXXXXXXXXGXXXXXXXXXXXXXXXXXXXGXXXXXXXXXXXXXXXXXXX,0,300,0
18417,14,1,13,47,239,0,0,252,144,108,GAXXXXXXXXXXXXXXXXXXGXXXXXXXXXXXXXXXXXXXGXXXXXXXXXXXXXXXXXXXGXXXXXXXXXXXXXXXXXXXGXXXXXXXXXXXXXXXXXXXGXXXXXXXXXXXXXXXXXXXGXXXXXXXXXXXXXXXXXXXGXXXXXXXXXXXXXXXXXXXGXXXXXXXXXXXXXXXXXXXGXXXXXXXXXXXXXXXXXXXGXXXXXXXXXXXXXXXXXXXGXXXXXXXXXXXXXXXXXXXGXXXXXXXXXXXXXXXXXXX,0,300,0
18438,14,1,13,47,239,0,0,252,142,110,GAXXXXXXXXXXXXXXXXXXGXXXXXXXXXXXXXXXXXXXGXXXXXXXXXXXXXXXXXXXGXXXXXXXXXXXXXXXXXXXGXXXXXXXXXXXXXXXXXXXGXXXXXXXXXXXXXXXXXXXGXXXXXXXXXXXXXXXXXXXGXXXXXXXXXXXXXXXXXXXGXXXXXXXXXXXXXXXXXXXGXXXXXXXXXXXXXXXXXXXGXXXXXXXXXXXXXXXXXXXGXXXXXXXXXXXXXXXXXXXGXXXXXXXXXXXXXXXXXXX,0,300,0
18459,14,1,13,51,235,0,0,248,144,104,GAXXXXXXXXXXXXXXXXXXGXXXXXXXXXXXXXXXXXXXGXXXXXXXXXXXXXXXXXXXGXXXXXXXXXXXXXXXXXXXGXXXXXXXXXXXXXXXXXXXGXXXXXXXXXXXXXXXXXXXGXXXXXXXXXXXXXXXXXXXGXXXXXXXXXXXXXXXXXXXGXXXXXXXXXXXXXXXXXXXGXXXXXXXXXXXXXXXXXXXGXXXXXXXXXXXXXXXXXXXGXXXXXXXXXXXXXXXXXXXGXXXXXXXXXXXXXXXXXXX,0,300,0

18480,14,0,14,53,233,0,0,246,140,106,GOXXXXXXXXXXXXXXXXXXGXXXXXXXXXXXXXXXXXXXGXXXXXXXXXXXXXXXXXXXGXXXXXXXXXXXXXXXXXXXGXXXXXXXXXXXXXXXXXXXGXXXXXXXXXXXXXXXXXXXGXXXXXXXXXXXXXXXXXXXGXXXXXXXXXXXXXXXXXXXGXXXXXXXXXXXXXXXXXXXGXXXXXXXXXXXXXXXXXXXGXXXXXXXXXXXXXXXXXXXGXXXXXXXXXXXXXXXXXXXGXXXXXXXXXXXXXXXXXXX,0,300,0
18501,13,0,13,55,232,0,0,243,134,109,GXXXXXXXXXXXXXXXXXXXGXXXXXXXXXXXXXXXXXXXGXXXXXXXXXXXXXXXXXXXGXXXXXXXXXXXXXXXXXXXGXXXXXXXXXXXXXXXXXXXGXXXXXXXXXXXXXXXXXXXGXXXXXXXXXXXXXXXXXXXGXXXXXXXXXXXXXXXXXXXGXXXXXXXXXXXXXXXXXXXGXXXXXXXXXXXXXXXXXXXGXXXXXXXXXXXXXXXXXXXGXXXXXXXXXXXXXXXXXXXGXXXXXXXXXXXXXXXXXXX,0,300,0
18522,13,0,13,49,238,0,0,250,138,112,GXXXXXXXXXXXXXXXXXXXGXXXXXXXXXXXXXXXXXXXGXXXXXXXXXXXXXXXXXXXGXXXXXXXXXXXXXXXXXXXGXXXXXXXXXXXXXXXXXXXGXXXXXXXXXXXXXXXXXXXGXXXXXXXXXXXXXXXXXXXGXXXXXXXXXXXXXXXXXXXGXXXXXXXXXXXXXXXXXXXGXXXXXXXXXXXXXXXXXXXGXXXXXXXXXXXXXXXXXXXGXXXXXXXXXXXXXXXXXXXGXXXXXXXXXXXXXXXXXXX,0,300,0
18543,13,0,13,51,236,0,0,248,141,107,GXXXXXXXXXXXXXXXXXXXGXXXXXXXXXXXXXXXXXXXGXXXXXXXXXXXXXXXXXXXGXXXXXXXXXXXXXXXXXXXGXXXXXXXXXXXXXXXXXXXGXXXXXXXXXXXXXXXXXXXGXXXXXXXXXXXXXXXXXXXGXXXXXXXXXXXXXXXXXXXGXXXXXXXXXXXXXXXXXXXGXXXXXXXXXXXXXXXXXXXGXXXXXXXXXXXXXXXXXXXGXXXXXXXXXXXXXXXXXXXGXXXXXXXXXXXXXXXXXXX,0,300,0
18564,13,0,13,51,236,0,0,248,144,104,GXXXXXXXXXXXXXXXXXXXGXXXXXXXXXXXXXXXXXXXGXXXXXXXXXXXXXXXXXXXGXXXXXXXXXXXXXXXXXXXGXXXXXXXXXXXXXXXXXXXGXXXXXXXXXXXXXXXXXXXGXXXXXXXXXXXXXXXXXXXGXXXXXXXXXXXXXXXXXXXGXXXXXXXXXXXXXXXXXXXGXXXXXXXXXXXXXXXXXXXGXXXXXXXXXXXXXXXXXXXGXXXXXXXXXXXXXXXXXXXGXXXXXXXXXXXXXXXXXXX,0,300,0

18585,13,0,13,51,236,0,0,248,145,103,GXXXXXXXXXXXXXXXXXXXGXXXXXXXXXXXXXXXXXXXGXXXXXXXXXXXXXXXXXXXGXXXXXXXXXXXXXXXXXXXGXXXXXXXXXXXXXXXXXXXGXXXXXXXXXXXXXXXXXXXGXXXXXXXXXXXXXXXXXXXGXXXXXXXXXXXXXXXXXXXGXXXXXXXXXXXXXXXXXXXGXXXXXXXXXXXXXXXXXXXGXXXXXXXXXXXXXXXXXXXGXXXXXXXXXXXXXXXXXXXGXXXXXXXXXXXXXXXXXXX,0,300,0
18606,13,0,13,50,237,0,0,249,141,108,GXXXXXXXXXXXXXXXXXXXGXXXXXXXXXXXXXXXXXXXGXXXXXXXXXXXXXXXXXXXGXXXXXXXXXXXXXXXXXXXGXXXXXXXXXXXXXXXXXXXGXXXXXXXXXXXXXXXXXXXGXXXXXXXXXXXXXXXXXXXGXXXXXXXXXXXXXXXXXXXGXXXXXXXXXXXXXXXXXXXGXXXXXXXXXXXXXXXXXXXGXXXXXXXXXXXXXXXXXXXGXXXXXXXXXXXXXXXXXXXGXXXXXXXXXXXXXXXXXXX,0,300,0
18627,13,0,13,49,238,0,0,250,142,108,GXXXXXXXXXXXXXXXXXXXGXXXXXXXXXXXXXXXXXXXGXXXXXXXXXXXXXXXXXXXGXXXXXXXXXXXXXXXXXXXGXXXXXXXXXXXXXXXXXXXGXXXXXXXXXXXXXXXXXXXGXXXXXXXXXXXXXXXXXXXGXXXXXXXXXXXXXXXXXXXGXXXXXXXXXXXXXXXXXXXGXXXXXXXXXXXXXXXXXXXGXXXXXXXXXXXXXXXXXXXGXXXXXXXXXXXXXXXXXXXGXXXXXXXXXXXXXXXXXXX,0,300,0
18648,13,0,13,52,235,0,0,247,143,104,GXXXXXXXXXXXXXXXXXXXGXXXXXXXXXXXXXXXXXXXGXXXXXXXXXXXXXXXXXXXGXXXXXXXXXXXXXXXXXXXGXXXXXXXXXXXXXXXXXXXGXXXXXXXXXXXXXXXXXXXGXXXXXXXXXXXXXXXXXXXGXXXXXXXXXXXXXXXXXXXGXXXXXXXXXXXXXXXXXXXGXXXXXXXXXXXXXXXXXXXGXXXXXXXXXXXXXXXXXXXGXXXXXXXXXXXXXXXXXXXGXXXXXXXXXXXXXXXXXXX,0,300,0
18669,13,0,13,55,232,0,0,244,148,96,GXXXXXXXXXXXXXXXXXXXGXXXXXXXXXXXXXXXXXXXGXXXXXXXXXXXXXXXXXXXGXXXXXXXXXXXXXXXXXXXGXXXXXXXXXXXXXXXXXXXGXXXXXXXXXXXXXXXXXXXGXXXXXXXXXXXXXXXXXXXGXXXXXXXXXXXXXXXXXXXGXXXXXXXXXXXXXXXXXXXGXXXXXXXXXXXXXXXXXXXGXXXXXXXXXXXXXXXXXXXGXXXXXXXXXXXXXXXXXXXGXXXXXXXXXXXXXXXXXXX,0,300,0

18690,13,0,13,59,228,0,0,240,151,89,GXXXXXXXXXXXXXXXXXXXGXXXXXXXXXXXXXXXXXXXGXXXXXXXXXXXXXXXXXXXGXXXXXXXXXXXXXXXXXXXGXXXXXXXXXXXXXXXXXXXGXXXXXXXXXXXXXXXXXXXGXXXXXXXXXXXXXXXXXXXGXXXXXXXXXXXXXXXXXXXGXXXXXXXXXXXXXXXXXXXGXXXXXXXXXXXXXXXXXXXGXXXXXXXXXXXXXXXXXXXGXXXXXXXXXXXXXXXXXXXGXXXXXXXXXXXXXXXXXXX,0,300,0
18711,13,0,13,55,232,0,0,243,149,94,GXXXXXXXXXXXXXXXXXXXGXXXXXXXXXXXXXXXXXXXGXXXXXXXXXXXXXXXXXXXGXXXXXXXXXXXXXXXXXXXGXXXXXXXXXXXXXXXXXXXGXXXXXXXXXXXXXXXXXXXGXXXXXXXXXXXXXXXXXXXGXXXXXXXXXXXXXXXXXXXGXXXXXXXXXXXXXXXXXXXGXXXXXXXXXXXXXXXXXXXGXXXXXXXXXXXXXXXXXXXGXXXXXXXXXXXXXXXXXXXGXXXXXXXXXXXXXXXXXXX,0,300,0
18732,13,0,13,56,231,0,0,242,149,93,GXXXXXXXXXXXXXXXXXXXGXXXXXXXXXXXXXXXXXXXGXXXXXXXXXXXXXXXXXXXGXXXXXXXXXXXXXXXXXXXGXXXXXXXXXXXXXXXXXXXGXXXXXXXXXXXXXXXXXXXGXXXXXXXXXXXXXXXXXXXGXXXXXXXXXXXXXXXXXXXGXXXXXXXXXXXXXXXXXXXGXXXXXXXXXXXXXXXXXXXGXXXXXXXXXXXXXXXXXXXGXXXXXXXXXXXXXXXXXXXGXXXXXXXXXXXXXXXXXXX,0,300,0
18753,13,0,13,64,223,0,0,235,145,90,GXXXXXXXXXXXXXXXXXXXGXXXXXXXXXXXXXXXXXXXGXXXXXXXXXXXXXXXXXXXGXXXXXXXXXXXXXXXXXXXGXXXXXXXXXXXXXXXXXXXGXXXXXXXXXXXXXXXXXXXGXXXXXXXXXXXXXXXXXXXGXXXXXXXXXXXXXXXXXXXGXXXXXXXXXXXXXXXXXXXGXXXXXXXXXXXXXXXXXXXGXXXXXXXXXXXXXXXXXXXGXXXXXXXXXXXXXXXXXXXGXXXXXXXXXXXXXXXXXXX,0,300,0
18774,13,0,13,63,224,0,0,235,138,97,GXXXXXXXXXXXXXXXXXXXGXXXXXXXXXXXXXXXXXXXGXXXXXXXXXXXXXXXXXXXGXXXXXXXXXXXXXXXXXXXGXXXXXXXXXXXXXXXXXXXGXXXXXXXXXXXXXXXXXXXGXXXXXXXXXXXXXXXXXXXGXXXXXXXXXXXXXXXXXXXGXXXXXXXXXXXXXXXXXXXGXXXXXXXXXXXXXXXXXXXGXXXXXXXXXXXXXXXXXXXGXXXXXXXXXXXXXXXXXXXGXXXXXXXXXXXXXXXXXXX,0,300,0

18795,13,0,13,61,226,0,0,238,138,100,GXXXXXXXXXXXXXXXXXXXGXXXXXXXXXXXXXXXXXXXGXXXXXXXXXXXXXXXXXXXGXXXXXXXXXXXXXXXXXXXGXXXXXXXXXXXXXXXXXXXGXXXXXXXXXXXXXXXXXXXGXXXXXXXXXXXXXXXXXXXGXXXXXXXXXXXXXXXXXXXGXXXXXXXXXXXXXXXXXXXGXXXXXXXXXXXXXXXXXXXGXXXXXXXXXXXXXXXXXXXGXXXXXXXXXXXXXXXXXXXGXXXXXXXXXXXXXXXXXXX,0,300,0
18816,13,0,13,54,233,0,0,244,144,100,GXXXXXXXXXXXXXXXXXXXGXXXXXXXXXXXXXXXXXXXGXXXXXXXXXXXXXXXXXXXGXXXXXXXXXXXXXXXXXXXGXXXXXXXXXXXXXXXXXXXGXXXXXXXXXXXXXXXXXXXGXXXXXXXXXXXXXXXXXXXGXXXXXXXXXXXXXXXXXXXGXXXXXXXXXXXXXXXXXXXGXXXXXXXXXXXXXXXXXXXGXXXXXXXXXXXXXXXXXXXGXXXXXXXXXXXXXXXXXXXGXXXXXXXXXXXXXXXXXXX,0,300,0
18837,13,0,13,53,234,0,0,245,143,102,GXXXXXXXXXXXXXXXXXXXGXXXXXXXXXXXXXXXXXXXGXXXXXXXXXXXXXXXXXXXGXXXXXXXXXXXXXXXXXXXGXXXXXXXXXXXXXXXXXXXGXXXXXXXXXXXXXXXXXXXGXXXXXXXXXXXXXXXXXXXGXXXXXXXXXXXXXXXXXXXGXXXXXXXXXXXXXXXXXXXGXXXXXXXXXXXXXXXXXXXGXXXXXXXXXXXXXXXXXXXGXXXXXXXXXXXXXXXXXXXGXXXXXXXXXXXXXXXXXXX,0,300,0
18858,13,0,13,59,228,0,0,239,138,101,GXXXXXXXXXXXXXXXXXXXGXXXXXXXXXXXXXXXXXXXGXXXXXXXXXXXXXXXXXXXGXXXXXXXXXXXXXXXXXXXGXXXXXXXXXXXXXXXXXXXGXXXXXXXXXXXXXXXXXXXGXXXXXXXXXXXXXXXXXXXGXXXXXXXXXXXXXXXXXXXGXXXXXXXXXXXXXXXXXXXGXXXXXXXXXXXXXXXXXXXGXXXXXXXXXXXXXXXXXXXGXXXXXXXXXXXXXXXXXXXGXXXXXXXXXXXXXXXXXXX,0,300,0
18879,13,0,13,57,230,0,0,241,140,101,GXXXXXXXXXXXXXXXXXXXGXXXXXXXXXXXXXXXXXXXGXXXXXXXXXXXXXXXXXXXGXXXXXXXXXXXXXXXXXXXGXXXXXXXXXXXXXXXXXXXGXXXXXXXXXXXXXXXXXXXGXXXXXXXXXXXXXXXXXXXGXXXXXXXXXXXXXXXXXXXGXXXXXXXXXXXXXXXXXXXGXXXXXXXXXXXXXXXXXXXGXXXXXXXXXXXXXXXXXXXGXXXXXXXXXXXXXXXXXXXGXXXXXXXXXXXXXXXXXXX,0,300,0

18900,13,0,13,52,235,0,0,246,143,103,GXXXXXXXXXXXXXXXXXXXGXXXXXXXXXXXXXXXXXXXGXXXXXXXXXXXXXXXXXXXGXXXXXXXXXXXXXXXXXXXGXXXXXXXXXXXXXXXXXXXGXXXXXXXXXXXXXXXXXXXGXXXXXXXXXXXXXXXXXXXGXXXXXXXXXXXXXXXXXXXGXXXXXXXXXXXXXXXXXXXGXXXXXXXXXXXXXXXXXXXGXXXXXXXXXXXXXXXXXXXGXXXXXXXXXXXXXXXXXXXGXXXXXXXXXXXXXXXXXXX,0,300,0
18921,13,0,13,49,238,0,0,250,144,106,GXXXXXXXXXXXXXXXXXXXGXXXXXXXXXXXXXXXXXXXGXXXXXXXXXXXXXXXXXXXGXXXXXXXXXXXXXXXXXXXGXXXXXXXXXXXXXXXXXXXGXXXXXXXXXXXXXXXXXXXGXXXXXXXXXXXXXXXXXXXGXXXXXXXXXXXXXXXXXXXGXXXXXXXXXXXXXXXXXXXGXXXXXXXXXXXXXXXXXXXGXXXXXXXXXXXXXXXXXXXGXXXXXXXXXXXXXXXXXXXGXXXXXXXXXXXXXXXXXXX,0,300,0
18942,13,0,13,49,238,0,0,250,145,105,GXXXXXXXXXXXXXXXXXXXGXXXXXXXXXXXXXXXXXXXGXXXXXXXXXXXXXXXXXXXGXXXXXXXXXXXXXXXXXXXGXXXXXXXXXXXXXXXXXXXGXXXXXXXXXXXXXXXXXXXGXXXXXXXXXXXXXXXXXXXGXXXXXXXXXXXXXXXXXXXGXXXXXXXXXXXXXXXXXXXGXXXXXXXXXXXXXXXXXXXGXXXXXXXXXXXXXXXXXXXGXXXXXXXXXXXXXXXXXXXGXXXXXXXXXXXXXXXXXXX,0,300,0
18963,13,0,13,56,231,0,0,243,141,102,GXXXXXXXXXXXXXXXXXXXGXXXXXXXXXXXXXXXXXXXGXXXXXXXXXXXXXXXXXXXGXXXXXXXXXXXXXXXXXXXGXXXXXXXXXXXXXXXXXXXGXXXXXXXXXXXXXXXXXXXGXXXXXXXXXXXXXXXXXXXGXXXXXXXXXXXXXXXXXXXGXXXXXXXXXXXXXXXXXXXGXXXXXXXXXXXXXXXXXXXGXXXXXXXXXXXXXXXXXXXGXXXXXXXXXXXXXXXXXXXGXXXXXXXXXXXXXXXXXXX,0,300,0
18984,13,0,13,56,231,0,0,243,139,104,GXXXXXXXXXXXXXXXXXXXGXXXXXXXXXXXXXXXXXXXGXXXXXXXXXXXXXXXXXXXGXXXXXXXXXXXXXXXXXXXGXXXXXXXXXXXXXXXXXXXGXXXXXXXXXXXXXXXXXXXGXXXXXXXXXXXXXXXXXXXGXXXXXXXXXXXXXXXXXXXGXXXXXXXXXXXXXXXXXXXGXXXXXXXXXXXXXXXXXXXGXXXXXXXXXXXXXXXXXXXGXXXXXXXXXXXXXXXXXXXGXXXXXXXXXXXXXXXXXXX,0,300,0

19005,13,0,13,55,232,0,0,242,141,101,GXXXXXXXXXXXXXXXXXXXGXXXXXXXXXXXXXXXXXXXGXXXXXXXXXXXXXXXXXXXGXXXXXXXXXXXXXXXXXXXGXXXXXXXXXXXXXXXXXXXGXXXXXXXXXXXXXXXXXXXGXXXXXXXXXXXXXXXXXXXGXXXXXXXXXXXXXXXXXXXGXXXXXXXXXXXXXXXXXXXGXXXXXXXXXXXXXXXXXXXGXXXXXXXXXXXXXXXXXXXGXXXXXXXXXXXXXXXXXXXGXXXXXXXXXXXXXXXXXXX,0,300,0
19026,13,0,13,58,229,0,0,241,145,96,GXXXXXXXXXXXXXXXXXXXGXXXXXXXXXXXXXXXXXXXGXXXXXXXXXXXXXXXXXXXGXXXXXXXXXXXXXXXXXXXGXXXXXXXXXXXXXXXXXXXGXXXXXXXXXXXXXXXXXXXGXXXXXXXXXXXXXXXXXXXGXXXXXXXXXXXXXXXXXXXGXXXXXXXXXXXXXXXXXXXGXXXXXXXXXXXXXXXXXXXGXXXXXXXXXXXXXXXXXXXGXXXXXXXXXXXXXXXXXXXGXXXXXXXXXXXXXXXXXXX,0,300,0
19047,13,0,13,60,227,0,0,239,140,99,GXXXXXXXXXXXXXXXXXXXGXXXXXXXXXXXXXXXXXXXGXXXXXXXXXXXXXXXXXXXGXXXXXXXXXXXXXXXXXXXGXXXXXXXXXXXXXXXXXXXGXXXXXXXXXXXXXXXXXXXGXXXXXXXXXXXXXXXXXXXGXXXXXXXXXXXXXXXXXXXGXXXXXXXXXXXXXXXXXXXGXXXXXXXXXXXXXXXXXXXGXXXXXXXXXXXXXXXXXXXGXXXXXXXXXXXXXXXXXXXGXXXXXXXXXXXXXXXXXXX,0,300,0
19068,13,0,13,58,229,0,0,241,140,101,GXXXXXXXXXXXXXXXXXXXGXXXXXXXXXXXXXXXXXXXGXXXXXXXXXXXXXXXXXXXGXXXXXXXXXXXXXXXXXXXGXXXXXXXXXXXXXXXXXXXGXXXXXXXXXXXXXXXXXXXGXXXXXXXXXXXXXXXXXXXGXXXXXXXXXXXXXXXXXXXGXXXXXXXXXXXXXXXXXXXGXXXXXXXXXXXXXXXXXXXGXXXXXXXXXXXXXXXXXXXGXXXXXXXXXXXXXXXXXXXGXXXXXXXXXXXXXXXXXXX,0,300,0
19089,13,0,13,55,232,0,0,244,145,99,GXXXXXXXXXXXXXXXXXXXGXXXXXXXXXXXXXXXXXXXGXXXXXXXXXXXXXXXXXXXGXXXXXXXXXXXXXXXXXXXGXXXXXXXXXXXXXXXXXXXGXXXXXXXXXXXXXXXXXXXGXXXXXXXXXXXXXXXXXXXGXXXXXXXXXXXXXXXXXXXGXXXXXXXXXXXXXXXXXXXGXXXXXXXXXXXXXXXXXXXGXXXXXXXXXXXXXXXXXXXGXXXXXXXXXXXXXXXXXXXGXXXXXXXXXXXXXXXXXXX,0,300,0

19110,13,0,13,56,231,0,0,244,147,97,GXXXXXXXXXXXXXXXXXXXGXXXXXXXXXXXXXXXXXXXGXXXXXXXXXXXXXXXXXXXGXXXXXXXXXXXXXXXXXXXGXXXXXXXXXXXXXXXXXXXGXXXXXXXXXXXXXXXXXXXGXXXXXXXXXXXXXXXXXXXGXXXXXXXXXXXXXXXXXXXGXXXXXXXXXXXXXXXXXXXGXXXXXXXXXXXXXXXXXXXGXXXXXXXXXXXXXXXXXXXGXXXXXXXXXXXXXXXXXXXGXXXXXXXXXXXXXXXXXXX,0,300,0
19131,13,0,13,57,230,0,0,242,145,97,GXXXXXXXXXXXXXXXXXXXGXXXXXXXXXXXXXXXXXXXGXXXXXXXXXXXXXXXXXXXGXXXXXXXXXXXXXXXXXXXGXXXXXXXXXXXXXXXXXXXGXXXXXXXXXXXXXXXXXXXGXXXXXXXXXXXXXXXXXXXGXXXXXXXXXXXXXXXXXXXGXXXXXXXXXXXXXXXXXXXGXXXXXXXXXXXXXXXXXXXGXXXXXXXXXXXXXXXXXXXGXXXXXXXXXXXXXXXXXXXGXXXXXXXXXXXXXXXXXXX,0,300,0
19152,13,0,13,50,237,0,0,249,146,103,GXXXXXXXXXXXXXXXXXXXGXXXXXXXXXXXXXXXXXXXGXXXXXXXXXXXXXXXXXXXGXXXXXXXXXXXXXXXXXXXGXXXXXXXXXXXXXXXXXXXGXXXXXXXXXXXXXXXXXXXGXXXXXXXXXXXXXXXXXXXGXXXXXXXXXXXXXXXXXXXGXXXXXXXXXXXXXXXXXXXGXXXXXXXXXXXXXXXXXXXGXXXXXXXXXXXXXXXXXXXGXXXXXXXXXXXXXXXXXXXGXXXXXXXXXXXXXXXXXXX,0,300,0
19173,14,1,13,53,233,0,0,246,148,98,GXXXXXXXXXXXXXXXXXXXGXXXXXXXXXXXXXXXXXXXGXXXXXXXXXXXXXXXXXXXGXXXXXXXXXXXXXXXXXXXGXXXXXXXXXXXXXXXXXXXGXXXXXXXXXXXXXXXXXXXGAXXXXXXXXXXXXXXXXXXGXXXXXXXXXXXXXXXXXXXGXXXXXXXXXXXXXXXXXXXGXXXXXXXXXXXXXXXXXXXGXXXXXXXXXXXXXXXXXXXGXXXXXXXXXXXXXXXXXXXGXXXXXXXXXXXXXXXXXXX,0,300,0
19194,14,1,13,51,235,0,0,248,150,98,GXXXXXXXXXXXXXXXXXXXGXXXXXXXXXXXXXXXXXXXGXXXXXXXXXXXXXXXXXXXGXXXXXXXXXXXXXXXXXXXGXXXXXXXXXXXXXXXXXXXGXXXXXXXXXXXXXXXXXXXGAXXXXXXXXXXXXXXXXXXGXXXXXXXXXXXXXXXXXXXGXXXXXXXXXXXXXXXXXXXGXXXXXXXXXXXXXXXXXXXGXXXXXXXXXXXXXXXXXXXGXXXXXXXXXXXXXXXXXXXGXXXXXXXXXXXXXXXXXXX,0,300,0

19215,13,0,13,53,234,0,0,246,154,92,GXXXXXXXXXXXXXXXXXXXGXXXXXXXXXXXXXXXXXXXGXXXXXXXXXXXXXXXXXXXGXXXXXXXXXXXXXXXXXXXGXXXXXXXXXXXXXXXXXXXGXXXXXXXXXXXXXXXXXXXGXXXXXXXXXXXXXXXXXXXGXXXXXXXXXXXXXXXXXXXGXXXXXXXXXXXXXXXXXXXGXXXXXXXXXXXXXXXXXXXGXXXXXXXXXXXXXXXXXXXGXXXXXXXXXXXXXXXXXXXGXXXXXXXXXXXXXXXXXXX,0,300,0
19236,14,1,13,52,234,0,0,245,152,93,GXXXXXXXXXXXXXXXXXXXGXXXXXXXXXXXXXXXXXXXGXXXXXXXXXXXXXXXXXXXGXXXXXXXXXXXXXXXXXXXGXXXXXXXXXXXXXXXXXXXGXXXXXXXXXXXXXXXXXXXGXXXXXXXXXXXXXXXXXXXGXXXXXXXXXXXXXXXXXXXGXXXXXXXXXXXXXXXXXXXGXXXXXXXXXXXXXXXXXXXGAXXXXXXXXXXXXXXXXXXGXXXXXXXXXXXXXXXXXXXGXXXXXXXXXXXXXXXXXXX,0,300,0
19257,14,1,13,57,229,0,0,241,145,96,GXXXXXXXXXXXXXXXXXXXGXXXXXXXXXXXXXXXXXXXGXXXXXXXXXXXXXXXXXXXGXXXXXXXXXXXXXXXXXXXGXXXXXXXXXXXXXXXXXXXGXXXXXXXXXXXXXXXXXXXGXXXXXXXXXXXXXXXXXXXGXXXXXXXXXXXXXXXXXXXGXXXXXXXXXXXXXXXXXXXGXXXXXXXXXXXXXXXXXXXGAXXXXXXXXXXXXXXXXXXGXXXXXXXXXXXXXXXXXXXGXXXXXXXXXXXXXXXXXXX,0,300,0
19278,14,1,13,56,230,0,0,242,146,96,GXXXXXXXXXXXXXXXXXXXGXXXXXXXXXXXXXXXXXXXGXXXXXXXXXXXXXXXXXXXGXXXXXXXXXXXXXXXXXXXGXXXXXXXXXXXXXXXXXXXGXXXXXXXXXXXXXXXXXXXGXXXXXXXXXXXXXXXXXXXGXXXXXXXXXXXXXXXXXXXGXXXXXXXXXXXXXXXXXXXGXXXXXXXXXXXXXXXXXXXGAXXXXXXXXXXXXXXXXXXGXXXXXXXXXXXXXXXXXXXGXXXXXXXXXXXXXXXXXXX,0,300,0
19299,14,1,13,60,226,0,0,238,143,95,GXXXXXXXXXXXXXXXXXXXGXXXXXXXXXXXXXXXXXXXGXXXXXXXXXXXXXXXXXXXGXXXXXXXXXXXXXXXXXXXGXXXXXXXXXXXXXXXXXXXGXXXXXXXXXXXXXXXXXXXGXXXXXXXXXXXXXXXXXXXGXXXXXXXXXXXXXXXXXXXGXXXXXXXXXXXXXXXXXXXGXXXXXXXXXXXXXXXXXXXGAXXXXXXXXXXXXXXXXXXGXXXXXXXXXXXXXXXXXXXGXXXXXXXXXXXXXXXXXXX,0,300,0

19320,15,2,13,59,226,0,0,237,144,93,GXXXXXXXXXXXXXXXXXXXGXXXXXXXXXXXXXXXXXXXGXXXXXXXXXXXXXXXXXXXGXXXXXXXXXXXXXXXXXXXGXXXXXXXXXXXXXXXXXXXGAXXXXXXXXXXXXXXXXXXGXXXXXXXXXXXXXXXXXXXGXXXXXXXXXXXXXXXXXXXGXXXXXXXXXXXXXXXXXXXGXXXXXXXXXXXXXXXXXXXGAXXXXXXXXXXXXXXXXXXGXXXXXXXXXXXXXXXXXXXGXXXXXXXXXXXXXXXXXXX,0,300,0
19341,15,2,13,55,230,0,0,241,142,99,GXXXXXXXXXXXXXXXXXXXGXXXXXXXXXXXXXXXXXXXGXXXXXXXXXXXXXXXXXXXGXXXXXXXXXXXXXXXXXXXGXXXXXXXXXXXXXXXXXXXGAXXXXXXXXXXXXXXXXXXGXXXXXXXXXXXXXXXXXXXGXXXXXXXXXXXXXXXXXXXGXXXXXXXXXXXXXXXXXXXGXXXXXXXXXXXXXXXXXXXGAXXXXXXXXXXXXXXXXXXGXXXXXXXXXXXXXXXXXXXGXXXXXXXXXXXXXXXXXXX,0,300,0
19362,15,2,13,53,232,0,0,244,150,94,GXXXXXXXXXXXXXXXXXXXGXXXXXXXXXXXXXXXXXXXGXXXXXXXXXXXXXXXXXXXGXXXXXXXXXXXXXXXXXXXGXXXXXXXXXXXXXXXXXXXGAXXXXXXXXXXXXXXXXXXGXXXXXXXXXXXXXXXXXXXGXXXXXXXXXXXXXXXXXXXGXXXXXXXXXXXXXXXXXXXGXXXXXXXXXXXXXXXXXXXGAXXXXXXXXXXXXXXXXXXGXXXXXXXXXXXXXXXXXXXGXXXXXXXXXXXXXXXXXXX,0,300,0
19383,15,1,14,61,224,0,0,236,144,92,GXXXXXXXXXXXXXXXXXXXGXXXXXXXXXXXXXXXXXXXGXXXXXXXXXXXXXXXXXXXGXXXXXXXXXXXXXXXXXXXGXXXXXXXXXXXXXXXXXXXGOXXXXXXXXXXXXXXXXXXGXXXXXXXXXXXXXXXXXXXGXXXXXXXXXXXXXXXXXXXGXXXXXXXXXXXXXXXXXXXGXXXXXXXXXXXXXXXXXXXGAXXXXXXXXXXXXXXXXXXGXXXXXXXXXXXXXXXXXXXGXXXXXXXXXXXXXXXXXXX,0,300,0
19404,14,1,13,64,222,0,0,234,139,95,GXXXXXXXXXXXXXXXXXXXGXXXXXXXXXXXXXXXXXXXGXXXXXXXXXXXXXXXXXXXGXXXXXXXXXXXXXXXXXXXGXXXXXXXXXXXXXXXXXXXGXXXXXXXXXXXXXXXXXXXGXXXXXXXXXXXXXXXXXXXGXXXXXXXXXXXXXXXXXXXGXXXXXXXXXXXXXXXXXXXGXXXXXXXXXXXXXXXXXXXGAXXXXXXXXXXXXXXXXXXGXXXXXXXXXXXXXXXXXXXGXXXXXXXXXXXXXXXXXXX,0,300,0

19425,14,1,13,62,224,0,0,236,140,96,GXXXXXXXXXXXXXXXXXXXGXXXXXXXXXXXXXXXXXXXGXXXXXXXXXXXXXXXXXXXGXXXXXXXXXXXXXXXXXXXGXXXXXXXXXXXXXXXXXXXGXXXXXXXXXXXXXXXXXXXGXXXXXXXXXXXXXXXXXXXGXXXXXXXXXXXXXXXXXXXGXXXXXXXXXXXXXXXXXXXGXXXXXXXXXXXXXXXXXXXGAXXXXXXXXXXXXXXXXXXGXXXXXXXXXXXXXXXXXXXGXXXXXXXXXXXXXXXXXXX,0,300,0
19446,14,1,13,63,223,0,0,235,140,95,GXXXXXXXXXXXXXXXXXXXGXXXXXXXXXXXXXXXXXXXGXXXXXXXXXXXXXXXXXXXGXXXXXXXXXXXXXXXXXXXGXXXXXXXXXXXXXXXXXXXGXXXXXXXXXXXXXXXXXXXGXXXXXXXXXXXXXXXXXXXGXXXXXXXXXXXXXXXXXXXGXXXXXXXXXXXXXXXXXXXGXXXXXXXXXXXXXXXXXXXGAXXXXXXXXXXXXXXXXXXGXXXXXXXXXXXXXXXXXXXGXXXXXXXXXXXXXXXXXXX,0,300,0
19467,14,1,13,63,223,0,0,235,142,93,GXXXXXXXXXXXXXXXXXXXGXXXXXXXXXXXXXXXXXXXGXXXXXXXXXXXXXXXXXXXGXXXXXXXXXXXXXXXXXXXGXXXXXXXXXXXXXXXXXXXGXXXXXXXXXXXXXXXXXXXGXXXXXXXXXXXXXXXXXXXGXXXXXXXXXXXXXXXXXXXGXXXXXXXXXXXXXXXXXXXGXXXXXXXXXXXXXXXXXXXGAXXXXXXXXXXXXXXXXXXGXXXXXXXXXXXXXXXXXXXGXXXXXXXXXXXXXXXXXXX,0,300,0
19488,14,1,13,60,226,0,0,238,147,91,GXXXXXXXXXXXXXXXXXXXGXXXXXXXXXXXXXXXXXXXGXXXXXXXXXXXXXXXXXXXGXXXXXXXXXXXXXXXXXXXGXXXXXXXXXXXXXXXXXXXGXXXXXXXXXXXXXXXXXXXGXXXXXXXXXXXXXXXXXXXGXXXXXXXXXXXXXXXXXXXGXXXXXXXXXXXXXXXXXXXGXXXXXXXXXXXXXXXXXXXGAXXXXXXXXXXXXXXXXXXGXXXXXXXXXXXXXXXXXXXGXXXXXXXXXXXXXXXXXXX,0,300,0
19509,13,0,13,59,228,0,0,239,147,92,GXXXXXXXXXXXXXXXXXXXGXXXXXXXXXXXXXXXXXXXGXXXXXXXXXXXXXXXXXXXGXXXXXXXXXXXXXXXXXXXGXXXXXXXXXXXXXXXXXXXGXXXXXXXXXXXXXXXXXXXGXXXXXXXXXXXXXXXXXXXGXXXXXXXXXXXXXXXXXXXGXXXXXXXXXXXXXXXXXXXGXXXXXXXXXXXXXXXXXXXGXXXXXXXXXXXXXXXXXXXGXXXXXXXXXXXXXXXXXXXGXXXXXXXXXXXXXXXXXXX,0,300,0

19530,13,0,13,53,234,0,0,246,146,100,GXXXXXXXXXXXXXXXXXXXGXXXXXXXXXXXXXXXXXXXGXXXXXXXXXXXXXXXXXXXGXXXXXXXXXXXXXXXXXXXGXXXXXXXXXXXXXXXXXXXGXXXXXXXXXXXXXXXXXXXGXXXXXXXXXXXXXXXXXXXGXXXXXXXXXXXXXXXXXXXGXXXXXXXXXXXXXXXXXXXGXXXXXXXXXXXXXXXXXXXGXXXXXXXXXXXXXXXXXXXGXXXXXXXXXXXXXXXXXXXGXXXXXXXXXXXXXXXXXXX,0,300,0
19551,13,0,13,50,237,0,0,250,148,102,GXXXXXXXXXXXXXXXXXXXGXXXXXXXXXXXXXXXXXXXGXXXXXXXXXXXXXXXXXXXGXXXXXXXXXXXXXXXXXXXGXXXXXXXXXXXXXXXXXXXGXXXXXXXXXXXXXXXXXXXGXXXXXXXXXXXXXXXXXXXGXXXXXXXXXXXXXXXXXXXGXXXXXXXXXXXXXXXXXXXGXXXXXXXXXXXXXXXXXXXGXXXXXXXXXXXXXXXXXXXGXXXXXXXXXXXXXXXXXXXGXXXXXXXXXXXXXXXXXXX,0,300,0
19572,13,0,13,49,238,0,0,250,147,103,GXXXXXXXXXXXXXXXXXXXGXXXXXXXXXXXXXXXXXXXGXXXXXXXXXXXXXXXXXXXGXXXXXXXXXXXXXXXXXXXGXXXXXXXXXXXXXXXXXXXGXXXXXXXXXXXXXXXXXXXGXXXXXXXXXXXXXXXXXXXGXXXXXXXXXXXXXXXXXXXGXXXXXXXXXXXXXXXXXXXGXXXXXXXXXXXXXXXXXXXGXXXXXXXXXXXXXXXXXXXGXXXXXXXXXXXXXXXXXXXGXXXXXXXXXXXXXXXXXXX,0,300,0
19593,13,0,13,49,238,0,0,251,144,107,GXXXXXXXXXXXXXXXXXXXGXXXXXXXXXXXXXXXXXXXGXXXXXXXXXXXXXXXXXXXGXXXXXXXXXXXXXXXXXXXGXXXXXXXXXXXXXXXXXXXGXXXXXXXXXXXXXXXXXXXGXXXXXXXXXXXXXXXXXXXGXXXXXXXXXXXXXXXXXXXGXXXXXXXXXXXXXXXXXXXGXXXXXXXXXXXXXXXXXXXGXXXXXXXXXXXXXXXXXXXGXXXXXXXXXXXXXXXXXXXGXXXXXXXXXXXXXXXXXXX,0,300,0
19614,13,0,13,52,235,0,0,248,141,107,GXXXXXXXXXXXXXXXXXXXGXXXXXXXXXXXXXXXXXXXGXXXXXXXXXXXXXXXXXXXGXXXXXXXXXXXXXXXXXXXGXXXXXXXXXXXXXXXXXXXGXXXXXXXXXXXXXXXXXXXGXXXXXXXXXXXXXXXXXXXGXXXXXXXXXXXXXXXXXXXGXXXXXXXXXXXXXXXXXXXGXXXXXXXXXXXXXXXXXXXGXXXXXXXXXXXXXXXXXXXGXXXXXXXXXXXXXXXXXXXGXXXXXXXXXXXXXXXXXXX,0,300,0

19635,13,0,13,47,240,0,0,252,147,105,GXXXXXXXXXXXXXXXXXXXGXXXXXXXXXXXXXXXXXXXGXXXXXXXXXXXXXXXXXXXGXXXXXXXXXXXXXXXXXXXGXXXXXXXXXXXXXXXXXXXGXXXXXXXXXXXXXXXXXXXGXXXXXXXXXXXXXXXXXXXGXXXXXXXXXXXXXXXXXXXGXXXXXXXXXXXXXXXXXXXGXXXXXXXXXXXXXXXXXXXGXXXXXXXXXXXXXXXXXXXGXXXXXXXXXXXXXXXXXXXGXXXXXXXXXXXXXXXXXXX,0,300,0
19656,13,0,13,45,242,0,0,255,148,107,GXXXXXXXXXXXXXXXXXXXGXXXXXXXXXXXXXXXXXXXGXXXXXXXXXXXXXXXXXXXGXXXXXXXXXXXXXXXXXXXGXXXXXXXXXXXXXXXXXXXGXXXXXXXXXXXXXXXXXXXGXXXXXXXXXXXXXXXXXXXGXXXXXXXXXXXXXXXXXXXGXXXXXXXXXXXXXXXXXXXGXXXXXXXXXXXXXXXXXXXGXXXXXXXXXXXXXXXXXXXGXXXXXXXXXXXXXXXXXXXGXXXXXXXXXXXXXXXXXXX,0,300,0
19677,13,0,13,51,236,0,0,248,141,107,GXXXXXXXXXXXXXXXXXXXGXXXXXXXXXXXXXXXXXXXGXXXXXXXXXXXXXXXXXXXGXXXXXXXXXXXXXXXXXXXGXXXXXXXXXXXXXXXXXXXGXXXXXXXXXXXXXXXXXXXGXXXXXXXXXXXXXXXXXXXGXXXXXXXXXXXXXXXXXXXGXXXXXXXXXXXXXXXXXXXGXXXXXXXXXXXXXXXXXXXGXXXXXXXXXXXXXXXXXXXGXXXXXXXXXXXXXXXXXXXGXXXXXXXXXXXXXXXXXXX,0,300,0
19698,13,0,13,54,233,0,0,246,141,105,GXXXXXXXXXXXXXXXXXXXGXXXXXXXXXXXXXXXXXXXGXXXXXXXXXXXXXXXXXXXGXXXXXXXXXXXXXXXXXXXGXXXXXXXXXXXXXXXXXXXGXXXXXXXXXXXXXXXXXXXGXXXXXXXXXXXXXXXXXXXGXXXXXXXXXXXXXXXXXXXGXXXXXXXXXXXXXXXXXXXGXXXXXXXXXXXXXXXXXXXGXXXXXXXXXXXXXXXXXXXGXXXXXXXXXXXXXXXXXXXGXXXXXXXXXXXXXXXXXXX,0,300,0
19719,13,0,13,49,238,0,0,251,148,103,GXXXXXXXXXXXXXXXXXXXGXXXXXXXXXXXXXXXXXXXGXXXXXXXXXXXXXXXXXXXGXXXXXXXXXXXXXXXXXXXGXXXXXXXXXXXXXXXXXXXGXXXXXXXXXXXXXXXXXXXGXXXXXXXXXXXXXXXXXXXGXXXXXXXXXXXXXXXXXXXGXXXXXXXXXXXXXXXXXXXGXXXXXXXXXXXXXXXXXXXGXXXXXXXXXXXXXXXXXXXGXXXXXXXXXXXXXXXXXXXGXXXXXXXXXXXXXXXXXXX,0,300,0

19740,13,0,13,45,242,0,0,254,151,103,GXXXXXXXXXXXXXXXXXXXGXXXXXXXXXXXXXXXXXXXGXXXXXXXXXXXXXXXXXXXGXXXXXXXXXXXXXXXXXXXGXXXXXXXXXXXXXXXXXXXGXXXXXXXXXXXXXXXXXXXGXXXXXXXXXXXXXXXXXXXGXXXXXXXXXXXXXXXXXXXGXXXXXXXXXXXXXXXXXXXGXXXXXXXXXXXXXXXXXXXGXXXXXXXXXXXXXXXXXXXGXXXXXXXXXXXXXXXXXXXGXXXXXXXXXXXXXXXXXXX,0,300,0
19761,13,0,13,51,236,0,0,249,150,99,GXXXXXXXXXXXXXXXXXXXGXXXXXXXXXXXXXXXXXXXGXXXXXXXXXXXXXXXXXXXGXXXXXXXXXXXXXXXXXXXGXXXXXXXXXXXXXXXXXXXGXXXXXXXXXXXXXXXXXXXGXXXXXXXXXXXXXXXXXXXGXXXXXXXXXXXXXXXXXXXGXXXXXXXXXXXXXXXXXXXGXXXXXXXXXXXXXXXXXXXGXXXXXXXXXXXXXXXXXXXGXXXXXXXXXXXXXXXXXXXGXXXXXXXXXXXXXXXXXXX,0,300,0
19782,13,0,13,53,234,0,0,245,145,100,GXXXXXXXXXXXXXXXXXXXGXXXXXXXXXXXXXXXXXXXGXXXXXXXXXXXXXXXXXXXGXXXXXXXXXXXXXXXXXXXGXXXXXXXXXXXXXXXXXXXGXXXXXXXXXXXXXXXXXXXGXXXXXXXXXXXXXXXXXXXGXXXXXXXXXXXXXXXXXXXGXXXXXXXXXXXXXXXXXXXGXXXXXXXXXXXXXXXXXXXGXXXXXXXXXXXXXXXXXXXGXXXXXXXXXXXXXXXXXXXGXXXXXXXXXXXXXXXXXXX,0,300,0
19803,13,0,13,54,233,0,0,246,145,101,GXXXXXXXXXXXXXXXXXXXGXXXXXXXXXXXXXXXXXXXGXXXXXXXXXXXXXXXXXXXGXXXXXXXXXXXXXXXXXXXGXXXXXXXXXXXXXXXXXXXGXXXXXXXXXXXXXXXXXXXGXXXXXXXXXXXXXXXXXXXGXXXXXXXXXXXXXXXXXXXGXXXXXXXXXXXXXXXXXXXGXXXXXXXXXXXXXXXXXXXGXXXXXXXXXXXXXXXXXXXGXXXXXXXXXXXXXXXXXXXGXXXXXXXXXXXXXXXXXXX,0,300,0
19824,13,0,13,55,232,0,0,244,143,101,GXXXXXXXXXXXXXXXXXXXGXXXXXXXXXXXXXXXXXXXGXXXXXXXXXXXXXXXXXXXGXXXXXXXXXXXXXXXXXXXGXXXXXXXXXXXXXXXXXXXGXXXXXXXXXXXXXXXXXXXGXXXXXXXXXXXXXXXXXXXGXXXXXXXXXXXXXXXXXXXGXXXXXXXXXXXXXXXXXXXGXXXXXXXXXXXXXXXXXXXGXXXXXXXXXXXXXXXXXXXGXXXXXXXXXXXXXXXXXXXGXXXXXXXXXXXXXXXXXXX,0,300,0

19845,13,0,13,49,238,0,0,251,142,109,GXXXXXXXXXXXXXXXXXXXGXXXXXXXXXXXXXXXXXXXGXXXXXXXXXXXXXXXXXXXGXXXXXXXXXXXXXXXXXXXGXXXXXXXXXXXXXXXXXXXGXXXXXXXXXXXXXXXXXXXGXXXXXXXXXXXXXXXXXXXGXXXXXXXXXXXXXXXXXXXGXXXXXXXXXXXXXXXXXXXGXXXXXXXXXXXXXXXXXXXGXXXXXXXXXXXXXXXXXXXGXXXXXXXXXXXXXXXXXXXGXXXXXXXXXXXXXXXXXXX,0,300,0
19866,13,0,13,53,234,0,0,247,144,103,GXXXXXXXXXXXXXXXXXXXGXXXXXXXXXXXXXXXXXXXGXXXXXXXXXXXXXXXXXXXGXXXXXXXXXXXXXXXXXXXGXXXXXXXXXXXXXXXXXXXGXXXXXXXXXXXXXXXXXXXGXXXXXXXXXXXXXXXXXXXGXXXXXXXXXXXXXXXXXXXGXXXXXXXXXXXXXXXXXXXGXXXXXXXXXXXXXXXXXXXGXXXXXXXXXXXXXXXXXXXGXXXXXXXXXXXXXXXXXXXGXXXXXXXXXXXXXXXXXXX,0,300,0
19887,13,0,13,55,232,0,0,245,142,103,GXXXXXXXXXXXXXXXXXXXGXXXXXXXXXXXXXXXXXXXGXXXXXXXXXXXXXXXXXXXGXXXXXXXXXXXXXXXXXXXGXXXXXXXXXXXXXXXXXXXGXXXXXXXXXXXXXXXXXXXGXXXXXXXXXXXXXXXXXXXGXXXXXXXXXXXXXXXXXXXGXXXXXXXXXXXXXXXXXXXGXXXXXXXXXXXXXXXXXXXGXXXXXXXXXXXXXXXXXXXGXXXXXXXXXXXXXXXXXXXGXXXXXXXXXXXXXXXXXXX,0,300,0
19908,13,0,13,52,235,0,0,248,143,105,GXXXXXXXXXXXXXXXXXXXGXXXXXXXXXXXXXXXXXXXGXXXXXXXXXXXXXXXXXXXGXXXXXXXXXXXXXXXXXXXGXXXXXXXXXXXXXXXXXXXGXXXXXXXXXXXXXXXXXXXGXXXXXXXXXXXXXXXXXXXGXXXXXXXXXXXXXXXXXXXGXXXXXXXXXXXXXXXXXXXGXXXXXXXXXXXXXXXXXXXGXXXXXXXXXXXXXXXXXXXGXXXXXXXXXXXXXXXXXXXGXXXXXXXXXXXXXXXXXXX,0,300,0
19929,13,0,13,50,237,0,0,251,145,106,GXXXXXXXXXXXXXXXXXXXGXXXXXXXXXXXXXXXXXXXGXXXXXXXXXXXXXXXXXXXGXXXXXXXXXXXXXXXXXXXGXXXXXXXXXXXXXXXXXXXGXXXXXXXXXXXXXXXXXXXGXXXXXXXXXXXXXXXXXXXGXXXXXXXXXXXXXXXXXXXGXXXXXXXXXXXXXXXXXXXGXXXXXXXXXXXXXXXXXXXGXXXXXXXXXXXXXXXXXXXGXXXXXXXXXXXXXXXXXXXGXXXXXXXXXXXXXXXXXXX,0,300,0

19950,13,0,13,46,241,0,0,254,148,106,GXXXXXXXXXXXXXXXXXXXGXXXXXXXXXXXXXXXXXXXGXXXXXXXXXXXXXXXXXXXGXXXXXXXXXXXXXXXXXXXGXXXXXXXXXXXXXXXXXXXGXXXXXXXXXXXXXXXXXXXGXXXXXXXXXXXXXXXXXXXGXXXXXXXXXXXXXXXXXXXGXXXXXXXXXXXXXXXXXXXGXXXXXXXXXXXXXXXXXXXGXXXXXXXXXXXXXXXXXXXGXXXXXXXXXXXXXXXXXXXGXXXXXXXXXXXXXXXXXXX,0,300,0
19971,14,1,13,44,242,0,0,255,148,107,GXXXXXXXXXXXXXXXXXXXGXXXXXXXXXXXXXXXXXXXGXXXXXXXXXXXXXXXXXXXGXXXXXXXXXXXXXXXXXXXGXXXXXXXXXXXXXXXXXXXGXXXXXXXXXXXXXXXXXXXGXXXXXXXXXXXXXXXXXXXGAXXXXXXXXXXXXXXXXXXGXXXXXXXXXXXXXXXXXXXGXXXXXXXXXXXXXXXXXXXGXXXXXXXXXXXXXXXXXXXGXXXXXXXXXXXXXXXXXXXGXXXXXXXXXXXXXXXXXXX,0,300,0
19992,14,1,13,45,241,0,0,254,151,103,GXXXXXXXXXXXXXXXXXXXGXXXXXXXXXXXXXXXXXXXGXXXXXXXXXXXXXXXXXXXGXXXXXXXXXXXXXXXXXXXGXXXXXXXXXXXXXXXXXXXGXXXXXXXXXXXXXXXXXXXGXXXXXXXXXXXXXXXXXXXGAXXXXXXXXXXXXXXXXXXGXXXXXXXXXXXXXXXXXXXGXXXXXXXXXXXXXXXXXXXGXXXXXXXXXXXXXXXXXXXGXXXXXXXXXXXXXXXXXXXGXXXXXXXXXXXXXXXXXXX,0,300,0
20013,14,1,13,46,240,0,0,252,151,101,GXXXXXXXXXXXXXXXXXXXGXXXXXXXXXXXXXXXXXXXGXXXXXXXXXXXXXXXXXXXGXXXXXXXXXXXXXXXXXXXGXXXXXXXXXXXXXXXXXXXGXXXXXXXXXXXXXXXXXXXGXXXXXXXXXXXXXXXXXXXGAXXXXXXXXXXXXXXXXXXGXXXXXXXXXXXXXXXXXXXGXXXXXXXXXXXXXXXXXXXGXXXXXXXXXXXXXXXXXXXGXXXXXXXXXXXXXXXXXXXGXXXXXXXXXXXXXXXXXXX,0,300,0
20034,14,1,13,51,235,0,0,248,154,94,GXXXXXXXXXXXXXXXXXXXGXXXXXXXXXXXXXXXXXXXGXXXXXXXXXXXXXXXXXXXGXXXXXXXXXXXXXXXXXXXGXXXXXXXXXXXXXXXXXXXGXXXXXXXXXXXXXXXXXXXGXXXXXXXXXXXXXXXXXXXGAXXXXXXXXXXXXXXXXXXGXXXXXXXXXXXXXXXXXXXGXXXXXXXXXXXXXXXXXXXGXXXXXXXXXXXXXXXXXXXGXXXXXXXXXXXXXXXXXXXGXXXXXXXXXXXXXXXXXXX,0,300,0

20055,13,0,13,60,227,0,0,240,144,96,GXXXXXXXXXXXXXXXXXXXGXXXXXXXXXXXXXXXXXXXGXXXXXXXXXXXXXXXXXXXGXXXXXXXXXXXXXXXXXXXGXXXXXXXXXXXXXXXXXXXGXXXXXXXXXXXXXXXXXXXGXXXXXXXXXXXXXXXXXXXGXXXXXXXXXXXXXXXXXXXGXXXXXXXXXXXXXXXXXXXGXXXXXXXXXXXXXXXXXXXGXXXXXXXXXXXXXXXXXXXGXXXXXXXXXXXXXXXXXXXGXXXXXXXXXXXXXXXXXXX,0,300,0
20076,13,0,13,65,222,0,0,234,141,93,GXXXXXXXXXXXXXXXXXXXGXXXXXXXXXXXXXXXXXXXGXXXXXXXXXXXXXXXXXXXGXXXXXXXXXXXXXXXXXXXGXXXXXXXXXXXXXXXXXXXGXXXXXXXXXXXXXXXXXXXGXXXXXXXXXXXXXXXXXXXGXXXXXXXXXXXXXXXXXXXGXXXXXXXXXXXXXXXXXXXGXXXXXXXXXXXXXXXXXXXGXXXXXXXXXXXXXXXXXXXGXXXXXXXXXXXXXXXXXXXGXXXXXXXXXXXXXXXXXXX,0,300,0
20097,13,0,13,63,224,0,0,237,144,93,GXXXXXXXXXXXXXXXXXXXGXXXXXXXXXXXXXXXXXXXGXXXXXXXXXXXXXXXXXXXGXXXXXXXXXXXXXXXXXXXGXXXXXXXXXXXXXXXXXXXGXXXXXXXXXXXXXXXXXXXGXXXXXXXXXXXXXXXXXXXGXXXXXXXXXXXXXXXXXXXGXXXXXXXXXXXXXXXXXXXGXXXXXXXXXXXXXXXXXXXGXXXXXXXXXXXXXXXXXXXGXXXXXXXXXXXXXXXXXXXGXXXXXXXXXXXXXXXXXXX,0,300,0
20118,13,0,13,64,223,0,0,236,143,93,GXXXXXXXXXXXXXXXXXXXGXXXXXXXXXXXXXXXXXXXGXXXXXXXXXXXXXXXXXXXGXXXXXXXXXXXXXXXXXXXGXXXXXXXXXXXXXXXXXXXGXXXXXXXXXXXXXXXXXXXGXXXXXXXXXXXXXXXXXXXGXXXXXXXXXXXXXXXXXXXGXXXXXXXXXXXXXXXXXXXGXXXXXXXXXXXXXXXXXXXGXXXXXXXXXXXXXXXXXXXGXXXXXXXXXXXXXXXXXXXGXXXXXXXXXXXXXXXXXXX,0,300,0
20139,13,0,13,64,223,0,0,236,144,92,GXXXXXXXXXXXXXXXXXXXGXXXXXXXXXXXXXXXXXXXGXXXXXXXXXXXXXXXXXXXGXXXXXXXXXXXXXXXXXXXGXXXXXXXXXXXXXXXXXXXGXXXXXXXXXXXXXXXXXXXGXXXXXXXXXXXXXXXXXXXGXXXXXXXXXXXXXXXXXXXGXXXXXXXXXXXXXXXXXXXGXXXXXXXXXXXXXXXXXXXGXXXXXXXXXXXXXXXXXXXGXXXXXXXXXXXXXXXXXXXGXXXXXXXXXXXXXXXXXXX,0,300,0

20160,13,0,13,60,227,0,0,238,142,96,GXXXXXXXXXXXXXXXXXXXGXXXXXXXXXXXXXXXXXXXGXXXXXXXXXXXXXXXXXXXGXXXXXXXXXXXXXXXXXXXGXXXXXXXXXXXXXXXXXXXGXXXXXXXXXXXXXXXXXXXGXXXXXXXXXXXXXXXXXXXGXXXXXXXXXXXXXXXXXXXGXXXXXXXXXXXXXXXXXXXGXXXXXXXXXXXXXXXXXXXGXXXXXXXXXXXXXXXXXXXGXXXXXXXXXXXXXXXXXXXGXXXXXXXXXXXXXXXXXXX,0,300,0
20181,13,0,13,58,229,0,0,241,143,98,GXXXXXXXXXXXXXXXXXXXGXXXXXXXXXXXXXXXXXXXGXXXXXXXXXXXXXXXXXXXGXXXXXXXXXXXXXXXXXXXGXXXXXXXXXXXXXXXXXXXGXXXXXXXXXXXXXXXXXXXGXXXXXXXXXXXXXXXXXXXGXXXXXXXXXXXXXXXXXXXGXXXXXXXXXXXXXXXXXXXGXXXXXXXXXXXXXXXXXXXGXXXXXXXXXXXXXXXXXXXGXXXXXXXXXXXXXXXXXXXGXXXXXXXXXXXXXXXXXXX,0,300,0
20202,13,0,13,56,231,0,0,243,139,104,GXXXXXXXXXXXXXXXXXXXGXXXXXXXXXXXXXXXXXXXGXXXXXXXXXXXXXXXXXXXGXXXXXXXXXXXXXXXXXXXGXXXXXXXXXXXXXXXXXXXGXXXXXXXXXXXXXXXXXXXGXXXXXXXXXXXXXXXXXXXGXXXXXXXXXXXXXXXXXXXGXXXXXXXXXXXXXXXXXXXGXXXXXXXXXXXXXXXXXXXGXXXXXXXXXXXXXXXXXXXGXXXXXXXXXXXXXXXXXXXGXXXXXXXXXXXXXXXXXXX,0,300,0
20223,13,0,13,54,233,0,0,245,137,108,GXXXXXXXXXXXXXXXXXXXGXXXXXXXXXXXXXXXXXXXGXXXXXXXXXXXXXXXXXXXGXXXXXXXXXXXXXXXXXXXGXXXXXXXXXXXXXXXXXXXGXXXXXXXXXXXXXXXXXXXGXXXXXXXXXXXXXXXXXXXGXXXXXXXXXXXXXXXXXXXGXXXXXXXXXXXXXXXXXXXGXXXXXXXXXXXXXXXXXXXGXXXXXXXXXXXXXXXXXXXGXXXXXXXXXXXXXXXXXXXGXXXXXXXXXXXXXXXXXXX,0,300,0
20244,13,0,13,51,236,0,0,248,144,104,GXXXXXXXXXXXXXXXXXXXGXXXXXXXXXXXXXXXXXXXGXXXXXXXXXXXXXXXXXXXGXXXXXXXXXXXXXXXXXXXGXXXXXXXXXXXXXXXXXXXGXXXXXXXXXXXXXXXXXXXGXXXXXXXXXXXXXXXXXXXGXXXXXXXXXXXXXXXXXXXGXXXXXXXXXXXXXXXXXXXGXXXXXXXXXXXXXXXXXXXGXXXXXXXXXXXXXXXXXXXGXXXXXXXXXXXXXXXXXXXGXXXXXXXXXXXXXXXXXXX,0,300,0

20265,13,0,13,51,236,0,0,246,141,105,GXXXXXXXXXXXXXXXXXXXGXXXXXXXXXXXXXXXXXXXGXXXXXXXXXXXXXXXXXXXGXXXXXXXXXXXXXXXXXXXGXXXXXXXXXXXXXXXXXXXGXXXXXXXXXXXXXXXXXXXGXXXXXXXXXXXXXXXXXXXGXXXXXXXXXXXXXXXXXXXGXXXXXXXXXXXXXXXXXXXGXXXXXXXXXXXXXXXXXXXGXXXXXXXXXXXXXXXXXXXGXXXXXXXXXXXXXXXXXXXGXXXXXXXXXXXXXXXXXXX,0,300,0
20286,13,0,13,44,243,0,0,255,146,109,GXXXXXXXXXXXXXXXXXXXGXXXXXXXXXXXXXXXXXXXGXXXXXXXXXXXXXXXXXXXGXXXXXXXXXXXXXXXXXXXGXXXXXXXXXXXXXXXXXXXGXXXXXXXXXXXXXXXXXXXGXXXXXXXXXXXXXXXXXXXGXXXXXXXXXXXXXXXXXXXGXXXXXXXXXXXXXXXXXXXGXXXXXXXXXXXXXXXXXXXGXXXXXXXXXXXXXXXXXXXGXXXXXXXXXXXXXXXXXXXGXXXXXXXXXXXXXXXXXXX,0,300,0
20307,13,0,13,44,243,0,0,257,146,111,GXXXXXXXXXXXXXXXXXXXGXXXXXXXXXXXXXXXXXXXGXXXXXXXXXXXXXXXXXXXGXXXXXXXXXXXXXXXXXXXGXXXXXXXXXXXXXXXXXXXGXXXXXXXXXXXXXXXXXXXGXXXXXXXXXXXXXXXXXXXGXXXXXXXXXXXXXXXXXXXGXXXXXXXXXXXXXXXXXXXGXXXXXXXXXXXXXXXXXXXGXXXXXXXXXXXXXXXXXXXGXXXXXXXXXXXXXXXXXXXGXXXXXXXXXXXXXXXXXXX,0,300,0
20328,13,0,13,45,242,0,0,256,148,108,GXXXXXXXXXXXXXXXXXXXGXXXXXXXXXXXXXXXXXXXGXXXXXXXXXXXXXXXXXXXGXXXXXXXXXXXXXXXXXXXGXXXXXXXXXXXXXXXXXXXGXXXXXXXXXXXXXXXXXXXGXXXXXXXXXXXXXXXXXXXGXXXXXXXXXXXXXXXXXXXGXXXXXXXXXXXXXXXXXXXGXXXXXXXXXXXXXXXXXXXGXXXXXXXXXXXXXXXXXXXGXXXXXXXXXXXXXXXXXXXGXXXXXXXXXXXXXXXXXXX,0,300,0
20349,13,0,13,46,241,0,0,255,145,110,GXXXXXXXXXXXXXXXXXXXGXXXXXXXXXXXXXXXXXXXGXXXXXXXXXXXXXXXXXXXGXXXXXXXXXXXXXXXXXXXGXXXXXXXXXXXXXXXXXXXGXXXXXXXXXXXXXXXXXXXGXXXXXXXXXXXXXXXXXXXGXXXXXXXXXXXXXXXXXXXGXXXXXXXXXXXXXXXXXXXGXXXXXXXXXXXXXXXXXXXGXXXXXXXXXXXXXXXXXXXGXXXXXXXXXXXXXXXXXXXGXXXXXXXXXXXXXXXXXXX,0,300,0

20370,13,0,13,49,238,0,0,251,145,106,GXXXXXXXXXXXXXXXXXXXGXXXXXXXXXXXXXXXXXXXGXXXXXXXXXXXXXXXXXXXGXXXXXXXXXXXXXXXXXXXGXXXXXXXXXXXXXXXXXXXGXXXXXXXXXXXXXXXXXXXGXXXXXXXXXXXXXXXXXXXGXXXXXXXXXXXXXXXXXXXGXXXXXXXXXXXXXXXXXXXGXXXXXXXXXXXXXXXXXXXGXXXXXXXXXXXXXXXXXXXGXXXXXXXXXXXXXXXXXXXGXXXXXXXXXXXXXXXXXXX,0,300,0
20391,13,0,13,51,236,0,0,248,146,102,GXXXXXXXXXXXXXXXXXXXGXXXXXXXXXXXXXXXXXXXGXXXXXXXXXXXXXXXXXXXGXXXXXXXXXXXXXXXXXXXGXXXXXXXXXXXXXXXXXXXGXXXXXXXXXXXXXXXXXXXGXXXXXXXXXXXXXXXXXXXGXXXXXXXXXXXXXXXXXXXGXXXXXXXXXXXXXXXXXXXGXXXXXXXXXXXXXXXXXXXGXXXXXXXXXXXXXXXXXXXGXXXXXXXXXXXXXXXXXXXGXXXXXXXXXXXXXXXXXXX,0,300,0
20412,13,0,13,54,233,0,0,246,147,99,GXXXXXXXXXXXXXXXXXXXGXXXXXXXXXXXXXXXXXXXGXXXXXXXXXXXXXXXXXXXGXXXXXXXXXXXXXXXXXXXGXXXXXXXXXXXXXXXXXXXGXXXXXXXXXXXXXXXXXXXGXXXXXXXXXXXXXXXXXXXGXXXXXXXXXXXXXXXXXXXGXXXXXXXXXXXXXXXXXXXGXXXXXXXXXXXXXXXXXXXGXXXXXXXXXXXXXXXXXXXGXXXXXXXXXXXXXXXXXXXGXXXXXXXXXXXXXXXXXXX,0,300,0
20433,13,0,13,52,235,0,0,248,148,100,GXXXXXXXXXXXXXXXXXXXGXXXXXXXXXXXXXXXXXXXGXXXXXXXXXXXXXXXXXXXGXXXXXXXXXXXXXXXXXXXGXXXXXXXXXXXXXXXXXXXGXXXXXXXXXXXXXXXXXXXGXXXXXXXXXXXXXXXXXXXGXXXXXXXXXXXXXXXXXXXGXXXXXXXXXXXXXXXXXXXGXXXXXXXXXXXXXXXXXXXGXXXXXXXXXXXXXXXXXXXGXXXXXXXXXXXXXXXXXXXGXXXXXXXXXXXXXXXXXXX,0,300,0
20454,13,0,13,58,229,0,0,242,148,94,GXXXXXXXXXXXXXXXXXXXGXXXXXXXXXXXXXXXXXXXGXXXXXXXXXXXXXXXXXXXGXXXXXXXXXXXXXXXXXXXGXXXXXXXXXXXXXXXXXXXGXXXXXXXXXXXXXXXXXXXGXXXXXXXXXXXXXXXXXXXGXXXXXXXXXXXXXXXXXXXGXXXXXXXXXXXXXXXXXXXGXXXXXXXXXXXXXXXXXXXGXXXXXXXXXXXXXXXXXXXGXXXXXXXXXXXXXXXXXXXGXXXXXXXXXXXXXXXXXXX,0,300,0

20475,14,1,13,52,234,0,0,247,148,99,GAXXXXXXXXXXXXXXXXXXGXXXXXXXXXXXXXXXXXXXGXXXXXXXXXXXXXXXXXXXGXXXXXXXXXXXXXXXXXXXGXXXXXXXXXXXXXXXXXXXGXXXXXXXXXXXXXXXXXXXGXXXXXXXXXXXXXXXXXXXGXXXXXXXXXXXXXXXXXXXGXXXXXXXXXXXXXXXXXXXGXXXXXXXXXXXXXXXXXXXGXXXXXXXXXXXXXXXXXXXGXXXXXXXXXXXXXXXXXXXGXXXXXXXXXXXXXXXXXXX,0,300,0
20496,14,1,13,48,238,0,0,250,151,99,GAXXXXXXXXXXXXXXXXXXGXXXXXXXXXXXXXXXXXXXGXXXXXXXXXXXXXXXXXXXGXXXXXXXXXXXXXXXXXXXGXXXXXXXXXXXXXXXXXXXGXXXXXXXXXXXXXXXXXXXGXXXXXXXXXXXXXXXXXXXGXXXXXXXXXXXXXXXXXXXGXXXXXXXXXXXXXXXXXXXGXXXXXXXXXXXXXXXXXXXGXXXXXXXXXXXXXXXXXXXGXXXXXXXXXXXXXXXXXXXGXXXXXXXXXXXXXXXXXXX,0,300,0
20517,15,2,13,48,237,0,0,248,149,99,GAXXXXXXXXXXXXXXXXXXGXXXXXXXXXXXXXXXXXXXGAXXXXXXXXXXXXXXXXXXGXXXXXXXXXXXXXXXXXXXGXXXXXXXXXXXXXXXXXXXGXXXXXXXXXXXXXXXXXXXGXXXXXXXXXXXXXXXXXXXGXXXXXXXXXXXXXXXXXXXGXXXXXXXXXXXXXXXXXXXGXXXXXXXXXXXXXXXXXXXGXXXXXXXXXXXXXXXXXXXGXXXXXXXXXXXXXXXXXXXGXXXXXXXXXXXXXXXXXXX,0,300,0
20538,15,2,13,50,235,0,0,246,145,101,GAXXXXXXXXXXXXXXXXXXGXXXXXXXXXXXXXXXXXXXGAXXXXXXXXXXXXXXXXXXGXXXXXXXXXXXXXXXXXXXGXXXXXXXXXXXXXXXXXXXGXXXXXXXXXXXXXXXXXXXGXXXXXXXXXXXXXXXXXXXGXXXXXXXXXXXXXXXXXXXGXXXXXXXXXXXXXXXXXXXGXXXXXXXXXXXXXXXXXXXGXXXXXXXXXXXXXXXXXXXGXXXXXXXXXXXXXXXXXXXGXXXXXXXXXXXXXXXXXXX,0,300,0
20559,15,2,13,49,236,0,0,248,148,100,GAXXXXXXXXXXXXXXXXXXGXXXXXXXXXXXXXXXXXXXGAXXXXXXXXXXXXXXXXXXGXXXXXXXXXXXXXXXXXXXGXXXXXXXXXXXXXXXXXXXGXXXXXXXXXXXXXXXXXXXGXXXXXXXXXXXXXXXXXXXGXXXXXXXXXXXXXXXXXXXGXXXXXXXXXXXXXXXXXXXGXXXXXXXXXXXXXXXXXXXGXXXXXXXXXXXXXXXXXXXGXXXXXXXXXXXXXXXXXXXGXXXXXXXXXXXXXXXXXXX,0,300,0

20580,15,2,13,49,236,0,0,247,148,99,GAXXXXXXXXXXXXXXXXXXGXXXXXXXXXXXXXXXXXXXGAXXXXXXXXXXXXXXXXXXGXXXXXXXXXXXXXXXXXXXGXXXXXXXXXXXXXXXXXXXGXXXXXXXXXXXXXXXXXXXGXXXXXXXXXXXXXXXXXXXGXXXXXXXXXXXXXXXXXXXGXXXXXXXXXXXXXXXXXXXGXXXXXXXXXXXXXXXXXXXGXXXXXXXXXXXXXXXXXXXGXXXXXXXXXXXXXXXXXXXGXXXXXXXXXXXXXXXXXXX,0,300,0
20601,15,2,13,49,236,0,0,247,153,94,GAXXXXXXXXXXXXXXXXXXGXXXXXXXXXXXXXXXXXXXGAXXXXXXXXXXXXXXXXXXGXXXXXXXXXXXXXXXXXXXGXXXXXXXXXXXXXXXXXXXGXXXXXXXXXXXXXXXXXXXGXXXXXXXXXXXXXXXXXXXGXXXXXXXXXXXXXXXXXXXGXXXXXXXXXXXXXXXXXXXGXXXXXXXXXXXXXXXXXXXGXXXXXXXXXXXXXXXXXXXGXXXXXXXXXXXXXXXXXXXGXXXXXXXXXXXXXXXXXXX,0,300,0
20622,15,2,13,56,229,0,0,241,153,88,GAXXXXXXXXXXXXXXXXXXGXXXXXXXXXXXXXXXXXXXGAXXXXXXXXXXXXXXXXXXGXXXXXXXXXXXXXXXXXXXGXXXXXXXXXXXXXXXXXXXGXXXXXXXXXXXXXXXXXXXGXXXXXXXXXXXXXXXXXXXGXXXXXXXXXXXXXXXXXXXGXXXXXXXXXXXXXXXXXXXGXXXXXXXXXXXXXXXXXXXGXXXXXXXXXXXXXXXXXXXGXXXXXXXXXXXXXXXXXXXGXXXXXXXXXXXXXXXXXXX,0,300,0
20643,15,2,13,58,227,0,0,238,149,89,GAXXXXXXXXXXXXXXXXXXGXXXXXXXXXXXXXXXXXXXGAXXXXXXXXXXXXXXXXXXGXXXXXXXXXXXXXXXXXXXGXXXXXXXXXXXXXXXXXXXGXXXXXXXXXXXXXXXXXXXGXXXXXXXXXXXXXXXXXXXGXXXXXXXXXXXXXXXXXXXGXXXXXXXXXXXXXXXXXXXGXXXXXXXXXXXXXXXXXXXGXXXXXXXXXXXXXXXXXXXGXXXXXXXXXXXXXXXXXXXGXXXXXXXXXXXXXXXXXXX,0,300,0
20664,15,2,13,62,223,0,0,235,147,88,GAXXXXXXXXXXXXXXXXXXGXXXXXXXXXXXXXXXXXXXGAXXXXXXXXXXXXXXXXXXGXXXXXXXXXXXXXXXXXXXGXXXXXXXXXXXXXXXXXXXGXXXXXXXXXXXXXXXXXXXGXXXXXXXXXXXXXXXXXXXGXXXXXXXXXXXXXXXXXXXGXXXXXXXXXXXXXXXXXXXGXXXXXXXXXXXXXXXXXXXGXXXXXXXXXXXXXXXXXXXGXXXXXXXXXXXXXXXXXXXGXXXXXXXXXXXXXXXXXXX,0,300,0

20685,15,2,13,61,224,0,0,236,148,88,GAXXXXXXXXXXXXXXXXXXGXXXXXXXXXXXXXXXXXXXGAXXXXXXXXXXXXXXXXXXGXXXXXXXXXXXXXXXXXXXGXXXXXXXXXXXXXXXXXXXGXXXXXXXXXXXXXXXXXXXGXXXXXXXXXXXXXXXXXXXGXXXXXXXXXXXXXXXXXXXGXXXXXXXXXXXXXXXXXXXGXXXXXXXXXXXXXXXXXXXGXXXXXXXXXXXXXXXXXXXGXXXXXXXXXXXXXXXXXXXGXXXXXXXXXXXXXXXXXXX,0,300,0
20706,15,2,13,61,224,0,0,236,147,89,GAXXXXXXXXXXXXXXXXXXGXXXXXXXXXXXXXXXXXXXGAXXXXXXXXXXXXXXXXXXGXXXXXXXXXXXXXXXXXXXGXXXXXXXXXXXXXXXXXXXGXXXXXXXXXXXXXXXXXXXGXXXXXXXXXXXXXXXXXXXGXXXXXXXXXXXXXXXXXXXGXXXXXXXXXXXXXXXXXXXGXXXXXXXXXXXXXXXXXXXGXXXXXXXXXXXXXXXXXXXGXXXXXXXXXXXXXXXXXXXGXXXXXXXXXXXXXXXXXXX,0,300,0
20727,15,1,14,57,228,0,0,240,150,90,GOXXXXXXXXXXXXXXXXXXGXXXXXXXXXXXXXXXXXXXGAXXXXXXXXXXXXXXXXXXGXXXXXXXXXXXXXXXXXXXGXXXXXXXXXXXXXXXXXXXGXXXXXXXXXXXXXXXXXXXGXXXXXXXXXXXXXXXXXXXGXXXXXXXXXXXXXXXXXXXGXXXXXXXXXXXXXXXXXXXGXXXXXXXXXXXXXXXXXXXGXXXXXXXXXXXXXXXXXXXGXXXXXXXXXXXXXXXXXXXGXXXXXXXXXXXXXXXXXXX,0,300,0
20748,15,1,14,57,228,0,0,240,149,91,GOXXXXXXXXXXXXXXXXXXGXXXXXXXXXXXXXXXXXXXGAXXXXXXXXXXXXXXXXXXGXXXXXXXXXXXXXXXXXXXGXXXXXXXXXXXXXXXXXXXGXXXXXXXXXXXXXXXXXXXGXXXXXXXXXXXXXXXXXXXGXXXXXXXXXXXXXXXXXXXGXXXXXXXXXXXXXXXXXXXGXXXXXXXXXXXXXXXXXXXGXXXXXXXXXXXXXXXXXXXGXXXXXXXXXXXXXXXXXXXGXXXXXXXXXXXXXXXXXXX,0,300,0
20769,14,1,13,52,234,0,0,245,151,94,GXXXXXXXXXXXXXXXXXXXGXXXXXXXXXXXXXXXXXXXGAXXXXXXXXXXXXXXXXXXGXXXXXXXXXXXXXXXXXXXGXXXXXXXXXXXXXXXXXXXGXXXXXXXXXXXXXXXXXXXGXXXXXXXXXXXXXXXXXXXGXXXXXXXXXXXXXXXXXXXGXXXXXXXXXXXXXXXXXXXGXXXXXXXXXXXXXXXXXXXGXXXXXXXXXXXXXXXXXXXGXXXXXXXXXXXXXXXXXXXGXXXXXXXXXXXXXXXXXXX,0,300,0

20790,14,1,13,53,233,0,0,245,148,97,GXXXXXXXXXXXXXXXXXXXGXXXXXXXXXXXXXXXXXXXGAXXXXXXXXXXXXXXXXXXGXXXXXXXXXXXXXXXXXXXGXXXXXXXXXXXXXXXXXXXGXXXXXXXXXXXXXXXXXXXGXXXXXXXXXXXXXXXXXXXGXXXXXXXXXXXXXXXXXXXGXXXXXXXXXXXXXXXXXXXGXXXXXXXXXXXXXXXXXXXGXXXXXXXXXXXXXXXXXXXGXXXXXXXXXXXXXXXXXXXGXXXXXXXXXXXXXXXXXXX,0,300,0
20811,13,0,13,56,231,0,0,243,144,99,GXXXXXXXXXXXXXXXXXXXGXXXXXXXXXXXXXXXXXXXGXXXXXXXXXXXXXXXXXXXGXXXXXXXXXXXXXXXXXXXGXXXXXXXXXXXXXXXXXXXGXXXXXXXXXXXXXXXXXXXGXXXXXXXXXXXXXXXXXXXGXXXXXXXXXXXXXXXXXXXGXXXXXXXXXXXXXXXXXXXGXXXXXXXXXXXXXXXXXXXGXXXXXXXXXXXXXXXXXXXGXXXXXXXXXXXXXXXXXXXGXXXXXXXXXXXXXXXXXXX,0,300,0
20832,13,0,13,55,232,0,0,243,147,96,GXXXXXXXXXXXXXXXXXXXGXXXXXXXXXXXXXXXXXXXGXXXXXXXXXXXXXXXXXXXGXXXXXXXXXXXXXXXXXXXGXXXXXXXXXXXXXXXXXXXGXXXXXXXXXXXXXXXXXXXGXXXXXXXXXXXXXXXXXXXGXXXXXXXXXXXXXXXXXXXGXXXXXXXXXXXXXXXXXXXGXXXXXXXXXXXXXXXXXXXGXXXXXXXXXXXXXXXXXXXGXXXXXXXXXXXXXXXXXXXGXXXXXXXXXXXXXXXXXXX,0,300,0
20853,13,0,13,54,233,0,0,245,145,100,GXXXXXXXXXXXXXXXXXXXGXXXXXXXXXXXXXXXXXXXGXXXXXXXXXXXXXXXXXXXGXXXXXXXXXXXXXXXXXXXGXXXXXXXXXXXXXXXXXXXGXXXXXXXXXXXXXXXXXXXGXXXXXXXXXXXXXXXXXXXGXXXXXXXXXXXXXXXXXXXGXXXXXXXXXXXXXXXXXXXGXXXXXXXXXXXXXXXXXXXGXXXXXXXXXXXXXXXXXXXGXXXXXXXXXXXXXXXXXXXGXXXXXXXXXXXXXXXXXXX,0,300,0
20874,13,0,13,54,233,0,0,245,145,100,GXXXXXXXXXXXXXXXXXXXGXXXXXXXXXXXXXXXXXXXGXXXXXXXXXXXXXXXXXXXGXXXXXXXXXXXXXXXXXXXGXXXXXXXXXXXXXXXXXXXGXXXXXXXXXXXXXXXXXXXGXXXXXXXXXXXXXXXXXXXGXXXXXXXXXXXXXXXXXXXGXXXXXXXXXXXXXXXXXXXGXXXXXXXXXXXXXXXXXXXGXXXXXXXXXXXXXXXXXXXGXXXXXXXXXXXXXXXXXXXGXXXXXXXXXXXXXXXXXXX,0,300,0

20895,13,0,13,50,237,0,0,249,146,103,GXXXXXXXXXXXXXXXXXXXGXXXXXXXXXXXXXXXXXXXGXXXXXXXXXXXXXXXXXXXGXXXXXXXXXXXXXXXXXXXGXXXXXXXXXXXXXXXXXXXGXXXXXXXXXXXXXXXXXXXGXXXXXXXXXXXXXXXXXXXGXXXXXXXXXXXXXXXXXXXGXXXXXXXXXXXXXXXXXXXGXXXXXXXXXXXXXXXXXXXGXXXXXXXXXXXXXXXXXXXGXXXXXXXXXXXXXXXXXXXGXXXXXXXXXXXXXXXXXXX,0,300,0
20916,13,0,13,52,235,0,0,247,145,102,GXXXXXXXXXXXXXXXXXXXGXXXXXXXXXXXXXXXXXXXGXXXXXXXXXXXXXXXXXXXGXXXXXXXXXXXXXXXXXXXGXXXXXXXXXXXXXXXXXXXGXXXXXXXXXXXXXXXXXXXGXXXXXXXXXXXXXXXXXXXGXXXXXXXXXXXXXXXXXXXGXXXXXXXXXXXXXXXXXXXGXXXXXXXXXXXXXXXXXXXGXXXXXXXXXXXXXXXXXXXGXXXXXXXXXXXXXXXXXXXGXXXXXXXXXXXXXXXXXXX,0,300,0
20937,13,0,13,55,232,0,0,243,141,102,GXXXXXXXXXXXXXXXXXXXGXXXXXXXXXXXXXXXXXXXGXXXXXXXXXXXXXXXXXXXGXXXXXXXXXXXXXXXXXXXGXXXXXXXXXXXXXXXXXXXGXXXXXXXXXXXXXXXXXXXGXXXXXXXXXXXXXXXXXXXGXXXXXXXXXXXXXXXXXXXGXXXXXXXXXXXXXXXXXXXGXXXXXXXXXXXXXXXXXXXGXXXXXXXXXXXXXXXXXXXGXXXXXXXXXXXXXXXXXXXGXXXXXXXXXXXXXXXXXXX,0,300,0
20958,13,0,13,51,236,0,0,248,145,103,GXXXXXXXXXXXXXXXXXXXGXXXXXXXXXXXXXXXXXXXGXXXXXXXXXXXXXXXXXXXGXXXXXXXXXXXXXXXXXXXGXXXXXXXXXXXXXXXXXXXGXXXXXXXXXXXXXXXXXXXGXXXXXXXXXXXXXXXXXXXGXXXXXXXXXXXXXXXXXXXGXXXXXXXXXXXXXXXXXXXGXXXXXXXXXXXXXXXXXXXGXXXXXXXXXXXXXXXXXXXGXXXXXXXXXXXXXXXXXXXGXXXXXXXXXXXXXXXXXXX,0,300,0
20979,13,0,13,50,237,0,0,248,144,104,GXXXXXXXXXXXXXXXXXXXGXXXXXXXXXXXXXXXXXXXGXXXXXXXXXXXXXXXXXXXGXXXXXXXXXXXXXXXXXXXGXXXXXXXXXXXXXXXXXXXGXXXXXXXXXXXXXXXXXXXGXXXXXXXXXXXXXXXXXXXGXXXXXXXXXXXXXXXXXXXGXXXXXXXXXXXXXXXXXXXGXXXXXXXXXXXXXXXXXXXGXXXXXXXXXXXXXXXXXXXGXXXXXXXXXXXXXXXXXXXGXXXXXXXXXXXXXXXXXXX,0,300,0

21000,13,0,13,48,239,0,0,251,150,101,GXXXXXXXXXXXXXXXXXXXGXXXXXXXXXXXXXXXXXXXGXXXXXXXXXXXXXXXXXXXGXXXXXXXXXXXXXXXXXXXGXXXXXXXXXXXXXXXXXXXGXXXXXXXXXXXXXXXXXXXGXXXXXXXXXXXXXXXXXXXGXXXXXXXXXXXXXXXXXXXGXXXXXXXXXXXXXXXXXXXGXXXXXXXXXXXXXXXXXXXGXXXXXXXXXXXXXXXXXXXGXXXXXXXXXXXXXXXXXXXGXXXXXXXXXXXXXXXXXXX,0,300,0
21021,13,0,13,47,240,0,0,252,151,101,GXXXXXXXXXXXXXXXXXXXGXXXXXXXXXXXXXXXXXXXGXXXXXXXXXXXXXXXXXXXGXXXXXXXXXXXXXXXXXXXGXXXXXXXXXXXXXXXXXXXGXXXXXXXXXXXXXXXXXXXGXXXXXXXXXXXXXXXXXXXGXXXXXXXXXXXXXXXXXXXGXXXXXXXXXXXXXXXXXXXGXXXXXXXXXXXXXXXXXXXGXXXXXXXXXXXXXXXXXXXGXXXXXXXXXXXXXXXXXXXGXXXXXXXXXXXXXXXXXXX,0,300,0
21042,13,0,13,50,237,0,0,249,149,100,GXXXXXXXXXXXXXXXXXXXGXXXXXXXXXXXXXXXXXXXGXXXXXXXXXXXXXXXXXXXGXXXXXXXXXXXXXXXXXXXGXXXXXXXXXXXXXXXXXXXGXXXXXXXXXXXXXXXXXXXGXXXXXXXXXXXXXXXXXXXGXXXXXXXXXXXXXXXXXXXGXXXXXXXXXXXXXXXXXXXGXXXXXXXXXXXXXXXXXXXGXXXXXXXXXXXXXXXXXXXGXXXXXXXXXXXXXXXXXXXGXXXXXXXXXXXXXXXXXXX,0,300,0
21063,13,0,13,54,233,0,0,245,147,98,GXXXXXXXXXXXXXXXXXXXGXXXXXXXXXXXXXXXXXXXGXXXXXXXXXXXXXXXXXXXGXXXXXXXXXXXXXXXXXXXGXXXXXXXXXXXXXXXXXXXGXXXXXXXXXXXXXXXXXXXGXXXXXXXXXXXXXXXXXXXGXXXXXXXXXXXXXXXXXXXGXXXXXXXXXXXXXXXXXXXGXXXXXXXXXXXXXXXXXXXGXXXXXXXXXXXXXXXXXXXGXXXXXXXXXXXXXXXXXXXGXXXXXXXXXXXXXXXXXXX,0,300,0
21084,13,0,13,49,238,0,0,249,150,99,GXXXXXXXXXXXXXXXXXXXGXXXXXXXXXXXXXXXXXXXGXXXXXXXXXXXXXXXXXXXGXXXXXXXXXXXXXXXXXXXGXXXXXXXXXXXXXXXXXXXGXXXXXXXXXXXXXXXXXXXGXXXXXXXXXXXXXXXXXXXGXXXXXXXXXXXXXXXXXXXGXXXXXXXXXXXXXXXXXXXGXXXXXXXXXXXXXXXXXXXGXXXXXXXXXXXXXXXXXXXGXXXXXXXXXXXXXXXXXXXGXXXXXXXXXXXXXXXXXXX,0,300,0

21105,13,0,13,51,236,0,0,248,149,99,GXXXXXXXXXXXXXXXXXXXGXXXXXXXXXXXXXXXXXXXGXXXXXXXXXXXXXXXXXXXGXXXXXXXXXXXXXXXXXXXGXXXXXXXXXXXXXXXXXXXGXXXXXXXXXXXXXXXXXXXGXXXXXXXXXXXXXXXXXXXGXXXXXXXXXXXXXXXXXXXGXXXXXXXXXXXXXXXXXXXGXXXXXXXXXXXXXXXXXXXGXXXXXXXXXXXXXXXXXXXGXXXXXXXXXXXXXXXXXXXGXXXXXXXXXXXXXXXXXXX,0,300,0
21126,13,0,13,46,241,0,0,253,153,100,GXXXXXXXXXXXXXXXXXXXGXXXXXXXXXXXXXXXXXXXGXXXXXXXXXXXXXXXXXXXGXXXXXXXXXXXXXXXXXXXGXXXXXXXXXXXXXXXXXXXGXXXXXXXXXXXXXXXXXXXGXXXXXXXXXXXXXXXXXXXGXXXXXXXXXXXXXXXXXXXGXXXXXXXXXXXXXXXXXXXGXXXXXXXXXXXXXXXXXXXGXXXXXXXXXXXXXXXXXXXGXXXXXXXXXXXXXXXXXXXGXXXXXXXXXXXXXXXXXXX,0,300,0
21147,13,0,13,49,238,0,0,250,150,100,GXXXXXXXXXXXXXXXXXXXGXXXXXXXXXXXXXXXXXXXGXXXXXXXXXXXXXXXXXXXGXXXXXXXXXXXXXXXXXXXGXXXXXXXXXXXXXXXXXXXGXXXXXXXXXXXXXXXXXXXGXXXXXXXXXXXXXXXXXXXGXXXXXXXXXXXXXXXXXXXGXXXXXXXXXXXXXXXXXXXGXXXXXXXXXXXXXXXXXXXGXXXXXXXXXXXXXXXXXXXGXXXXXXXXXXXXXXXXXXXGXXXXXXXXXXXXXXXXXXX,0,300,0
21168,13,0,13,50,237,0,0,249,147,102,GXXXXXXXXXXXXXXXXXXXGXXXXXXXXXXXXXXXXXXXGXXXXXXXXXXXXXXXXXXXGXXXXXXXXXXXXXXXXXXXGXXXXXXXXXXXXXXXXXXXGXXXXXXXXXXXXXXXXXXXGXXXXXXXXXXXXXXXXXXXGXXXXXXXXXXXXXXXXXXXGXXXXXXXXXXXXXXXXXXXGXXXXXXXXXXXXXXXXXXXGXXXXXXXXXXXXXXXXXXXGXXXXXXXXXXXXXXXXXXXGXXXXXXXXXXXXXXXXXXX,0,300,0
21189,13,0,13,49,238,0,0,249,150,99,GXXXXXXXXXXXXXXXXXXXGXXXXXXXXXXXXXXXXXXXGXXXXXXXXXXXXXXXXXXXGXXXXXXXXXXXXXXXXXXXGXXXXXXXXXXXXXXXXXXXGXXXXXXXXXXXXXXXXXXXGXXXXXXXXXXXXXXXXXXXGXXXXXXXXXXXXXXXXXXXGXXXXXXXXXXXXXXXXXXXGXXXXXXXXXXXXXXXXXXXGXXXXXXXXXXXXXXXXXXXGXXXXXXXXXXXXXXXXXXXGXXXXXXXXXXXXXXXXXXX,0,300,0

21210,13,0,13,48,239,0,0,250,148,102,GXXXXXXXXXXXXXXXXXXXGXXXXXXXXXXXXXXXXXXXGXXXXXXXXXXXXXXXXXXXGXXXXXXXXXXXXXXXXXXXGXXXXXXXXXXXXXXXXXXXGXXXXXXXXXXXXXXXXXXXGXXXXXXXXXXXXXXXXXXXGXXXXXXXXXXXXXXXXXXXGXXXXXXXXXXXXXXXXXXXGXXXXXXXXXXXXXXXXXXXGXXXXXXXXXXXXXXXXXXXGXXXXXXXXXXXXXXXXXXXGXXXXXXXXXXXXXXXXXXX,0,300,0
21231,13,0,13,42,245,0,0,257,152,105,GXXXXXXXXXXXXXXXXXXXGXXXXXXXXXXXXXXXXXXXGXXXXXXXXXXXXXXXXXXXGXXXXXXXXXXXXXXXXXXXGXXXXXXXXXXXXXXXXXXXGXXXXXXXXXXXXXXXXXXXGXXXXXXXXXXXXXXXXXXXGXXXXXXXXXXXXXXXXXXXGXXXXXXXXXXXXXXXXXXXGXXXXXXXXXXXXXXXXXXXGXXXXXXXXXXXXXXXXXXXGXXXXXXXXXXXXXXXXXXXGXXXXXXXXXXXXXXXXXXX,0,300,0
21252,13,0,13,45,242,0,0,254,146,108,GXXXXXXXXXXXXXXXXXXXGXXXXXXXXXXXXXXXXXXXGXXXXXXXXXXXXXXXXXXXGXXXXXXXXXXXXXXXXXXXGXXXXXXXXXXXXXXXXXXXGXXXXXXXXXXXXXXXXXXXGXXXXXXXXXXXXXXXXXXXGXXXXXXXXXXXXXXXXXXXGXXXXXXXXXXXXXXXXXXXGXXXXXXXXXXXXXXXXXXXGXXXXXXXXXXXXXXXXXXXGXXXXXXXXXXXXXXXXXXXGXXXXXXXXXXXXXXXXXXX,0,300,0
21273,13,0,13,41,246,0,0,259,151,108,GXXXXXXXXXXXXXXXXXXXGXXXXXXXXXXXXXXXXXXXGXXXXXXXXXXXXXXXXXXXGXXXXXXXXXXXXXXXXXXXGXXXXXXXXXXXXXXXXXXXGXXXXXXXXXXXXXXXXXXXGXXXXXXXXXXXXXXXXXXXGXXXXXXXXXXXXXXXXXXXGXXXXXXXXXXXXXXXXXXXGXXXXXXXXXXXXXXXXXXXGXXXXXXXXXXXXXXXXXXXGXXXXXXXXXXXXXXXXXXXGXXXXXXXXXXXXXXXXXXX,0,300,0
21294,13,0,13,48,239,0,0,251,151,100,GXXXXXXXXXXXXXXXXXXXGXXXXXXXXXXXXXXXXXXXGXXXXXXXXXXXXXXXXXXXGXXXXXXXXXXXXXXXXXXXGXXXXXXXXXXXXXXXXXXXGXXXXXXXXXXXXXXXXXXXGXXXXXXXXXXXXXXXXXXXGXXXXXXXXXXXXXXXXXXXGXXXXXXXXXXXXXXXXXXXGXXXXXXXXXXXXXXXXXXXGXXXXXXXXXXXXXXXXXXXGXXXXXXXXXXXXXXXXXXXGXXXXXXXXXXXXXXXXXXX,0,300,0

21315,13,0,13,48,239,0,0,251,148,103,GXXXXXXXXXXXXXXXXXXXGXXXXXXXXXXXXXXXXXXXGXXXXXXXXXXXXXXXXXXXGXXXXXXXXXXXXXXXXXXXGXXXXXXXXXXXXXXXXXXXGXXXXXXXXXXXXXXXXXXXGXXXXXXXXXXXXXXXXXXXGXXXXXXXXXXXXXXXXXXXGXXXXXXXXXXXXXXXXXXXGXXXXXXXXXXXXXXXXXXXGXXXXXXXXXXXXXXXXXXXGXXXXXXXXXXXXXXXXXXXGXXXXXXXXXXXXXXXXXXX,0,300,0
21336,13,0,13,56,231,0,0,243,145,98,GXXXXXXXXXXXXXXXXXXXGXXXXXXXXXXXXXXXXXXXGXXXXXXXXXXXXXXXXXXXGXXXXXXXXXXXXXXXXXXXGXXXXXXXXXXXXXXXXXXXGXXXXXXXXXXXXXXXXXXXGXXXXXXXXXXXXXXXXXXXGXXXXXXXXXXXXXXXXXXXGXXXXXXXXXXXXXXXXXXXGXXXXXXXXXXXXXXXXXXXGXXXXXXXXXXXXXXXXXXXGXXXXXXXXXXXXXXXXXXXGXXXXXXXXXXXXXXXXXXX,0,300,0
21357,13,0,13,56,231,0,0,242,148,94,GXXXXXXXXXXXXXXXXXXXGXXXXXXXXXXXXXXXXXXXGXXXXXXXXXXXXXXXXXXXGXXXXXXXXXXXXXXXXXXXGXXXXXXXXXXXXXXXXXXXGXXXXXXXXXXXXXXXXXXXGXXXXXXXXXXXXXXXXXXXGXXXXXXXXXXXXXXXXXXXGXXXXXXXXXXXXXXXXXXXGXXXXXXXXXXXXXXXXXXXGXXXXXXXXXXXXXXXXXXXGXXXXXXXXXXXXXXXXXXXGXXXXXXXXXXXXXXXXXXX,0,300,0
21378,14,1,13,53,233,0,0,245,153,92,GXXXXXXXXXXXXXXXXXXXGXXXXXXXXXXXXXXXXXXXGXXXXXXXXXXXXXXXXXXXGXXXXXXXXXXXXXXXXXXXGXXXXXXXXXXXXXXXXXXXGXXXXXXXXXXXXXXXXXXXGXXXXXXXXXXXXXXXXXXXGXXXXXXXXXXXXXXXXXXXGXXXXXXXXXXXXXXXXXXXGXXXXXXXXXXXXXXXXXXXGAXXXXXXXXXXXXXXXXXXGXXXXXXXXXXXXXXXXXXXGXXXXXXXXXXXXXXXXXXX,0,300,0
21399,14,0,14,51,235,0,0,245,154,91,GXXXXXXXXXXXXXXXXXXXGXXXXXXXXXXXXXXXXXXXGXXXXXXXXXXXXXXXXXXXGXXXXXXXXXXXXXXXXXXXGXXXXXXXXXXXXXXXXXXXGXXXXXXXXXXXXXXXXXXXGXXXXXXXXXXXXXXXXXXXGXXXXXXXXXXXXXXXXXXXGXXXXXXXXXXXXXXXXXXXGXXXXXXXXXXXXXXXXXXXGOXXXXXXXXXXXXXXXXXXGXXXXXXXXXXXXXXXXXXXGXXXXXXXXXXXXXXXXXXX,0,300,0

21420,13,0,13,53,234,0,0,245,151,94,GXXXXXXXXXXXXXXXXXXXGXXXXXXXXXXXXXXXXXXXGXXXXXXXXXXXXXXXXXXXGXXXXXXXXXXXXXXXXXXXGXXXXXXXXXXXXXXXXXXXGXXXXXXXXXXXXXXXXXXXGXXXXXXXXXXXXXXXXXXXGXXXXXXXXXXXXXXXXXXXGXXXXXXXXXXXXXXXXXXXGXXXXXXXXXXXXXXXXXXXGXXXXXXXXXXXXXXXXXXXGXXXXXXXXXXXXXXXXXXXGXXXXXXXXXXXXXXXXXXX,0,300,0
21441,13,0,13,51,236,0,0,248,149,99,GXXXXXXXXXXXXXXXXXXXGXXXXXXXXXXXXXXXXXXXGXXXXXXXXXXXXXXXXXXXGXXXXXXXXXXXXXXXXXXXGXXXXXXXXXXXXXXXXXXXGXXXXXXXXXXXXXXXXXXXGXXXXXXXXXXXXXXXXXXXGXXXXXXXXXXXXXXXXXXXGXXXXXXXXXXXXXXXXXXXGXXXXXXXXXXXXXXXXXXXGXXXXXXXXXXXXXXXXXXXGXXXXXXXXXXXXXXXXXXXGXXXXXXXXXXXXXXXXXXX,0,300,0
21462,13,0,13,46,241,0,0,253,153,100,GXXXXXXXXXXXXXXXXXXXGXXXXXXXXXXXXXXXXXXXGXXXXXXXXXXXXXXXXXXXGXXXXXXXXXXXXXXXXXXXGXXXXXXXXXXXXXXXXXXXGXXXXXXXXXXXXXXXXXXXGXXXXXXXXXXXXXXXXXXXGXXXXXXXXXXXXXXXXXXXGXXXXXXXXXXXXXXXXXXXGXXXXXXXXXXXXXXXXXXXGXXXXXXXXXXXXXXXXXXXGXXXXXXXXXXXXXXXXXXXGXXXXXXXXXXXXXXXXXXX,0,300,0
21483,13,0,13,46,241,0,0,253,152,101,GXXXXXXXXXXXXXXXXXXXGXXXXXXXXXXXXXXXXXXXGXXXXXXXXXXXXXXXXXXXGXXXXXXXXXXXXXXXXXXXGXXXXXXXXXXXXXXXXXXXGXXXXXXXXXXXXXXXXXXXGXXXXXXXXXXXXXXXXXXXGXXXXXXXXXXXXXXXXXXXGXXXXXXXXXXXXXXXXXXXGXXXXXXXXXXXXXXXXXXXGXXXXXXXXXXXXXXXXXXXGXXXXXXXXXXXXXXXXXXXGXXXXXXXXXXXXXXXXXXX,0,300,0
21504,13,0,13,46,241,0,0,253,154,99,GXXXXXXXXXXXXXXXXXXXGXXXXXXXXXXXXXXXXXXXGXXXXXXXXXXXXXXXXXXXGXXXXXXXXXXXXXXXXXXXGXXXXXXXXXXXXXXXXXXXGXXXXXXXXXXXXXXXXXXXGXXXXXXXXXXXXXXXXXXXGXXXXXXXXXXXXXXXXXXXGXXXXXXXXXXXXXXXXXXXGXXXXXXXXXXXXXXXXXXXGXXXXXXXXXXXXXXXXXXXGXXXXXXXXXXXXXXXXXXXGXXXXXXXXXXXXXXXXXXX,0,300,0

21525,13,0,13,46,241,0,0,253,160,93,GXXXXXXXXXXXXXXXXXXXGXXXXXXXXXXXXXXXXXXXGXXXXXXXXXXXXXXXXXXXGXXXXXXXXXXXXXXXXXXXGXXXXXXXXXXXXXXXXXXXGXXXXXXXXXXXXXXXXXXXGXXXXXXXXXXXXXXXXXXXGXXXXXXXXXXXXXXXXXXXGXXXXXXXXXXXXXXXXXXXGXXXXXXXXXXXXXXXXXXXGXXXXXXXXXXXXXXXXXXXGXXXXXXXXXXXXXXXXXXXGXXXXXXXXXXXXXXXXXXX,0,300,0
21546,13,0,13,47,240,0,0,252,160,92,GXXXXXXXXXXXXXXXXXXXGXXXXXXXXXXXXXXXXXXXGXXXXXXXXXXXXXXXXXXXGXXXXXXXXXXXXXXXXXXXGXXXXXXXXXXXXXXXXXXXGXXXXXXXXXXXXXXXXXXXGXXXXXXXXXXXXXXXXXXXGXXXXXXXXXXXXXXXXXXXGXXXXXXXXXXXXXXXXXXXGXXXXXXXXXXXXXXXXXXXGXXXXXXXXXXXXXXXXXXXGXXXXXXXXXXXXXXXXXXXGXXXXXXXXXXXXXXXXXXX,0,300,0
21567,13,0,13,44,243,0,0,254,161,93,GXXXXXXXXXXXXXXXXXXXGXXXXXXXXXXXXXXXXXXXGXXXXXXXXXXXXXXXXXXXGXXXXXXXXXXXXXXXXXXXGXXXXXXXXXXXXXXXXXXXGXXXXXXXXXXXXXXXXXXXGXXXXXXXXXXXXXXXXXXXGXXXXXXXXXXXXXXXXXXXGXXXXXXXXXXXXXXXXXXXGXXXXXXXXXXXXXXXXXXXGXXXXXXXXXXXXXXXXXXXGXXXXXXXXXXXXXXXXXXXGXXXXXXXXXXXXXXXXXXX,0,300,0
21588,13,0,13,51,236,0,0,247,152,95,GXXXXXXXXXXXXXXXXXXXGXXXXXXXXXXXXXXXXXXXGXXXXXXXXXXXXXXXXXXXGXXXXXXXXXXXXXXXXXXXGXXXXXXXXXXXXXXXXXXXGXXXXXXXXXXXXXXXXXXXGXXXXXXXXXXXXXXXXXXXGXXXXXXXXXXXXXXXXXXXGXXXXXXXXXXXXXXXXXXXGXXXXXXXXXXXXXXXXXXXGXXXXXXXXXXXXXXXXXXXGXXXXXXXXXXXXXXXXXXXGXXXXXXXXXXXXXXXXXXX,0,300,0
21609,13,0,13,55,232,0,0,244,154,90,GXXXXXXXXXXXXXXXXXXXGXXXXXXXXXXXXXXXXXXXGXXXXXXXXXXXXXXXXXXXGXXXXXXXXXXXXXXXXXXXGXXXXXXXXXXXXXXXXXXXGXXXXXXXXXXXXXXXXXXXGXXXXXXXXXXXXXXXXXXXGXXXXXXXXXXXXXXXXXXXGXXXXXXXXXXXXXXXXXXXGXXXXXXXXXXXXXXXXXXXGXXXXXXXXXXXXXXXXXXXGXXXXXXXXXXXXXXXXXXXGXXXXXXXXXXXXXXXXXXX,0,300,0

21630,13,0,13,58,229,0,0,240,152,88,GXXXXXXXXXXXXXXXXXXXGXXXXXXXXXXXXXXXXXXXGXXXXXXXXXXXXXXXXXXXGXXXXXXXXXXXXXXXXXXXGXXXXXXXXXXXXXXXXXXXGXXXXXXXXXXXXXXXXXXXGXXXXXXXXXXXXXXXXXXXGXXXXXXXXXXXXXXXXXXXGXXXXXXXXXXXXXXXXXXXGXXXXXXXXXXXXXXXXXXXGXXXXXXXXXXXXXXXXXXXGXXXXXXXXXXXXXXXXXXXGXXXXXXXXXXXXXXXXXXX,0,300,0
21651,13,0,13,62,225,0,0,237,153,84,GXXXXXXXXXXXXXXXXXXXGXXXXXXXXXXXXXXXXXXXGXXXXXXXXXXXXXXXXXXXGXXXXXXXXXXXXXXXXXXXGXXXXXXXXXXXXXXXXXXXGXXXXXXXXXXXXXXXXXXXGXXXXXXXXXXXXXXXXXXXGXXXXXXXXXXXXXXXXXXXGXXXXXXXXXXXXXXXXXXXGXXXXXXXXXXXXXXXXXXXGXXXXXXXXXXXXXXXXXXXGXXXXXXXXXXXXXXXXXXXGXXXXXXXXXXXXXXXXXXX,0,300,0
21672,13,0,13,61,226,0,0,236,151,85,GXXXXXXXXXXXXXXXXXXXGXXXXXXXXXXXXXXXXXXXGXXXXXXXXXXXXXXXXXXXGXXXXXXXXXXXXXXXXXXXGXXXXXXXXXXXXXXXXXXXGXXXXXXXXXXXXXXXXXXXGXXXXXXXXXXXXXXXXXXXGXXXXXXXXXXXXXXXXXXXGXXXXXXXXXXXXXXXXXXXGXXXXXXXXXXXXXXXXXXXGXXXXXXXXXXXXXXXXXXXGXXXXXXXXXXXXXXXXXXXGXXXXXXXXXXXXXXXXXXX,0,300,0
21693,13,0,13,62,225,0,0,236,146,90,GXXXXXXXXXXXXXXXXXXXGXXXXXXXXXXXXXXXXXXXGXXXXXXXXXXXXXXXXXXXGXXXXXXXXXXXXXXXXXXXGXXXXXXXXXXXXXXXXXXXGXXXXXXXXXXXXXXXXXXXGXXXXXXXXXXXXXXXXXXXGXXXXXXXXXXXXXXXXXXXGXXXXXXXXXXXXXXXXXXXGXXXXXXXXXXXXXXXXXXXGXXXXXXXXXXXXXXXXXXXGXXXXXXXXXXXXXXXXXXXGXXXXXXXXXXXXXXXXXXX,0,300,0
21714,13,0,13,60,227,0,0,239,149,90,GXXXXXXXXXXXXXXXXXXXGXXXXXXXXXXXXXXXXXXXGXXXXXXXXXXXXXXXXXXXGXXXXXXXXXXXXXXXXXXXGXXXXXXXXXXXXXXXXXXXGXXXXXXXXXXXXXXXXXXXGXXXXXXXXXXXXXXXXXXXGXXXXXXXXXXXXXXXXXXXGXXXXXXXXXXXXXXXXXXXGXXXXXXXXXXXXXXXXXXXGXXXXXXXXXXXXXXXXXXXGXXXXXXXXXXXXXXXXXXXGXXXXXXXXXXXXXXXXXXX,0,300,0

21735,13,0,13,57,230,0,0,241,150,91,GXXXXXXXXXXXXXXXXXXXGXXXXXXXXXXXXXXXXXXXGXXXXXXXXXXXXXXXXXXXGXXXXXXXXXXXXXXXXXXXGXXXXXXXXXXXXXXXXXXXGXXXXXXXXXXXXXXXXXXXGXXXXXXXXXXXXXXXXXXXGXXXXXXXXXXXXXXXXXXXGXXXXXXXXXXXXXXXXXXXGXXXXXXXXXXXXXXXXXXXGXXXXXXXXXXXXXXXXXXXGXXXXXXXXXXXXXXXXXXXGXXXXXXXXXXXXXXXXXXX,0,300,0
21756,13,0,13,54,233,0,0,244,153,91,GXXXXXXXXXXXXXXXXXXXGXXXXXXXXXXXXXXXXXXXGXXXXXXXXXXXXXXXXXXXGXXXXXXXXXXXXXXXXXXXGXXXXXXXXXXXXXXXXXXXGXXXXXXXXXXXXXXXXXXXGXXXXXXXXXXXXXXXXXXXGXXXXXXXXXXXXXXXXXXXGXXXXXXXXXXXXXXXXXXXGXXXXXXXXXXXXXXXXXXXGXXXXXXXXXXXXXXXXXXXGXXXXXXXXXXXXXXXXXXXGXXXXXXXXXXXXXXXXXXX,0,300,0
21777,13,0,13,55,232,0,0,244,151,93,GXXXXXXXXXXXXXXXXXXXGXXXXXXXXXXXXXXXXXXXGXXXXXXXXXXXXXXXXXXXGXXXXXXXXXXXXXXXXXXXGXXXXXXXXXXXXXXXXXXXGXXXXXXXXXXXXXXXXXXXGXXXXXXXXXXXXXXXXXXXGXXXXXXXXXXXXXXXXXXXGXXXXXXXXXXXXXXXXXXXGXXXXXXXXXXXXXXXXXXXGXXXXXXXXXXXXXXXXXXXGXXXXXXXXXXXXXXXXXXXGXXXXXXXXXXXXXXXXXXX,0,300,0
21798,13,0,13,57,230,0,0,242,151,91,GXXXXXXXXXXXXXXXXXXXGXXXXXXXXXXXXXXXXXXXGXXXXXXXXXXXXXXXXXXXGXXXXXXXXXXXXXXXXXXXGXXXXXXXXXXXXXXXXXXXGXXXXXXXXXXXXXXXXXXXGXXXXXXXXXXXXXXXXXXXGXXXXXXXXXXXXXXXXXXXGXXXXXXXXXXXXXXXXXXXGXXXXXXXXXXXXXXXXXXXGXXXXXXXXXXXXXXXXXXXGXXXXXXXXXXXXXXXXXXXGXXXXXXXXXXXXXXXXXXX,0,300,0
21819,13,0,13,52,235,0,0,247,157,90,GXXXXXXXXXXXXXXXXXXXGXXXXXXXXXXXXXXXXXXXGXXXXXXXXXXXXXXXXXXXGXXXXXXXXXXXXXXXXXXXGXXXXXXXXXXXXXXXXXXXGXXXXXXXXXXXXXXXXXXXGXXXXXXXXXXXXXXXXXXXGXXXXXXXXXXXXXXXXXXXGXXXXXXXXXXXXXXXXXXXGXXXXXXXXXXXXXXXXXXXGXXXXXXXXXXXXXXXXXXXGXXXXXXXXXXXXXXXXXXXGXXXXXXXXXXXXXXXXXXX,0,300,0

21840,13,0,13,55,232,0,0,246,154,92,GXXXXXXXXXXXXXXXXXXXGXXXXXXXXXXXXXXXXXXXGXXXXXXXXXXXXXXXXXXXGXXXXXXXXXXXXXXXXXXXGXXXXXXXXXXXXXXXXXXXGXXXXXXXXXXXXXXXXXXXGXXXXXXXXXXXXXXXXXXXGXXXXXXXXXXXXXXXXXXXGXXXXXXXXXXXXXXXXXXXGXXXXXXXXXXXXXXXXXXXGXXXXXXXXXXXXXXXXXXXGXXXXXXXXXXXXXXXXXXXGXXXXXXXXXXXXXXXXXXX,0,300,0
21861,13,0,13,57,230,0,0,243,149,94,GXXXXXXXXXXXXXXXXXXXGXXXXXXXXXXXXXXXXXXXGXXXXXXXXXXXXXXXXXXXGXXXXXXXXXXXXXXXXXXXGXXXXXXXXXXXXXXXXXXXGXXXXXXXXXXXXXXXXXXXGXXXXXXXXXXXXXXXXXXXGXXXXXXXXXXXXXXXXXXXGXXXXXXXXXXXXXXXXXXXGXXXXXXXXXXXXXXXXXXXGXXXXXXXXXXXXXXXXXXXGXXXXXXXXXXXXXXXXXXXGXXXXXXXXXXXXXXXXXXX,0,300,0
21882,13,0,13,51,236,0,0,249,151,98,GXXXXXXXXXXXXXXXXXXXGXXXXXXXXXXXXXXXXXXXGXXXXXXXXXXXXXXXXXXXGXXXXXXXXXXXXXXXXXXXGXXXXXXXXXXXXXXXXXXXGXXXXXXXXXXXXXXXXXXXGXXXXXXXXXXXXXXXXXXXGXXXXXXXXXXXXXXXXXXXGXXXXXXXXXXXXXXXXXXXGXXXXXXXXXXXXXXXXXXXGXXXXXXXXXXXXXXXXXXXGXXXXXXXXXXXXXXXXXXXGXXXXXXXXXXXXXXXXXXX,0,300,0
21903,13,0,13,47,240,0,0,252,153,99,GXXXXXXXXXXXXXXXXXXXGXXXXXXXXXXXXXXXXXXXGXXXXXXXXXXXXXXXXXXXGXXXXXXXXXXXXXXXXXXXGXXXXXXXXXXXXXXXXXXXGXXXXXXXXXXXXXXXXXXXGXXXXXXXXXXXXXXXXXXXGXXXXXXXXXXXXXXXXXXXGXXXXXXXXXXXXXXXXXXXGXXXXXXXXXXXXXXXXXXXGXXXXXXXXXXXXXXXXXXXGXXXXXXXXXXXXXXXXXXXGXXXXXXXXXXXXXXXXXXX,0,300,0
21924,13,0,13,47,240,0,0,252,151,101,GXXXXXXXXXXXXXXXXXXXGXXXXXXXXXXXXXXXXXXXGXXXXXXXXXXXXXXXXXXXGXXXXXXXXXXXXXXXXXXXGXXXXXXXXXXXXXXXXXXXGXXXXXXXXXXXXXXXXXXXGXXXXXXXXXXXXXXXXXXXGXXXXXXXXXXXXXXXXXXXGXXXXXXXXXXXXXXXXXXXGXXXXXXXXXXXXXXXXXXXGXXXXXXXXXXXXXXXXXXXGXXXXXXXXXXXXXXXXXXXGXXXXXXXXXXXXXXXXXXX,0,300,0

21945,13,0,13,46,241,0,0,253,155,98,GXXXXXXXXXXXXXXXXXXXGXXXXXXXXXXXXXXXXXXXGXXXXXXXXXXXXXXXXXXXGXXXXXXXXXXXXXXXXXXXGXXXXXXXXXXXXXXXXXXXGXXXXXXXXXXXXXXXXXXXGXXXXXXXXXXXXXXXXXXXGXXXXXXXXXXXXXXXXXXXGXXXXXXXXXXXXXXXXXXXGXXXXXXXXXXXXXXXXXXXGXXXXXXXXXXXXXXXXXXXGXXXXXXXXXXXXXXXXXXXGXXXXXXXXXXXXXXXXXXX,0,300,0
21966,13,0,13,52,235,0,0,246,152,94,GXXXXXXXXXXXXXXXXXXXGXXXXXXXXXXXXXXXXXXXGXXXXXXXXXXXXXXXXXXXGXXXXXXXXXXXXXXXXXXXGXXXXXXXXXXXXXXXXXXXGXXXXXXXXXXXXXXXXXXXGXXXXXXXXXXXXXXXXXXXGXXXXXXXXXXXXXXXXXXXGXXXXXXXXXXXXXXXXXXXGXXXXXXXXXXXXXXXXXXXGXXXXXXXXXXXXXXXXXXXGXXXXXXXXXXXXXXXXXXXGXXXXXXXXXXXXXXXXXXX,0,300,0
21987,14,1,13,51,235,0,0,246,150,96,GXXXXXXXXXXXXXXXXXXXGXXXXXXXXXXXXXXXXXXXGAXXXXXXXXXXXXXXXXXXGXXXXXXXXXXXXXXXXXXXGXXXXXXXXXXXXXXXXXXXGXXXXXXXXXXXXXXXXXXXGXXXXXXXXXXXXXXXXXXXGXXXXXXXXXXXXXXXXXXXGXXXXXXXXXXXXXXXXXXXGXXXXXXXXXXXXXXXXXXXGXXXXXXXXXXXXXXXXXXXGXXXXXXXXXXXXXXXXXXXGXXXXXXXXXXXXXXXXXXX,0,300,0
22008,14,1,13,51,235,0,0,247,152,95,GXXXXXXXXXXXXXXXXXXXGXXXXXXXXXXXXXXXXXXXGAXXXXXXXXXXXXXXXXXXGXXXXXXXXXXXXXXXXXXXGXXXXXXXXXXXXXXXXXXXGXXXXXXXXXXXXXXXXXXXGXXXXXXXXXXXXXXXXXXXGXXXXXXXXXXXXXXXXXXXGXXXXXXXXXXXXXXXXXXXGXXXXXXXXXXXXXXXXXXXGXXXXXXXXXXXXXXXXXXXGXXXXXXXXXXXXXXXXXXXGXXXXXXXXXXXXXXXXXXX,0,300,0
22029,14,1,13,52,234,0,0,245,154,91,GXXXXXXXXXXXXXXXXXXXGXXXXXXXXXXXXXXXXXXXGAXXXXXXXXXXXXXXXXXXGXXXXXXXXXXXXXXXXXXXGXXXXXXXXXXXXXXXXXXXGXXXXXXXXXXXXXXXXXXXGXXXXXXXXXXXXXXXXXXXGXXXXXXXXXXXXXXXXXXXGXXXXXXXXXXXXXXXXXXXGXXXXXXXXXXXXXXXXXXXGXXXXXXXXXXXXXXXXXXXGXXXXXXXXXXXXXXXXXXXGXXXXXXXXXXXXXXXXXXX,0,300,0

22050,14,0,14,58,228,0,0,239,151,88,GXXXXXXXXXXXXXXXXXXXGXXXXXXXXXXXXXXXXXXXGOXXXXXXXXXXXXXXXXXXGXXXXXXXXXXXXXXXXXXXGXXXXXXXXXXXXXXXXXXXGXXXXXXXXXXXXXXXXXXXGXXXXXXXXXXXXXXXXXXXGXXXXXXXXXXXXXXXXXXXGXXXXXXXXXXXXXXXXXXXGXXXXXXXXXXXXXXXXXXXGXXXXXXXXXXXXXXXXXXXGXXXXXXXXXXXXXXXXXXXGXXXXXXXXXXXXXXXXXXX,0,300,0
22071,13,0,13,62,225,0,0,238,146,92,GXXXXXXXXXXXXXXXXXXXGXXXXXXXXXXXXXXXXXXXGXXXXXXXXXXXXXXXXXXXGXXXXXXXXXXXXXXXXXXXGXXXXXXXXXXXXXXXXXXXGXXXXXXXXXXXXXXXXXXXGXXXXXXXXXXXXXXXXXXXGXXXXXXXXXXXXXXXXXXXGXXXXXXXXXXXXXXXXXXXGXXXXXXXXXXXXXXXXXXXGXXXXXXXXXXXXXXXXXXXGXXXXXXXXXXXXXXXXXXXGXXXXXXXXXXXXXXXXXXX,0,300,0
22092,13,0,13,60,227,0,0,240,149,91,GXXXXXXXXXXXXXXXXXXXGXXXXXXXXXXXXXXXXXXXGXXXXXXXXXXXXXXXXXXXGXXXXXXXXXXXXXXXXXXXGXXXXXXXXXXXXXXXXXXXGXXXXXXXXXXXXXXXXXXXGXXXXXXXXXXXXXXXXXXXGXXXXXXXXXXXXXXXXXXXGXXXXXXXXXXXXXXXXXXXGXXXXXXXXXXXXXXXXXXXGXXXXXXXXXXXXXXXXXXXGXXXXXXXXXXXXXXXXXXXGXXXXXXXXXXXXXXXXXXX,0,300,0
22113,13,0,13,60,227,0,0,240,150,90,GXXXXXXXXXXXXXXXXXXXGXXXXXXXXXXXXXXXXXXXGXXXXXXXXXXXXXXXXXXXGXXXXXXXXXXXXXXXXXXXGXXXXXXXXXXXXXXXXXXXGXXXXXXXXXXXXXXXXXXXGXXXXXXXXXXXXXXXXXXXGXXXXXXXXXXXXXXXXXXXGXXXXXXXXXXXXXXXXXXXGXXXXXXXXXXXXXXXXXXXGXXXXXXXXXXXXXXXXXXXGXXXXXXXXXXXXXXXXXXXGXXXXXXXXXXXXXXXXXXX,0,300,0
22134,13,0,13,59,228,0,0,241,153,88,GXXXXXXXXXXXXXXXXXXXGXXXXXXXXXXXXXXXXXXXGXXXXXXXXXXXXXXXXXXXGXXXXXXXXXXXXXXXXXXXGXXXXXXXXXXXXXXXXXXXGXXXXXXXXXXXXXXXXXXXGXXXXXXXXXXXXXXXXXXXGXXXXXXXXXXXXXXXXXXXGXXXXXXXXXXXXXXXXXXXGXXXXXXXXXXXXXXXXXXXGXXXXXXXXXXXXXXXXXXXGXXXXXXXXXXXXXXXXXXXGXXXXXXXXXXXXXXXXXXX,0,300,0

22155,13,0,13,58,229,0,0,241,152,89,GXXXXXXXXXXXXXXXXXXXGXXXXXXXXXXXXXXXXXXXGXXXXXXXXXXXXXXXXXXXGXXXXXXXXXXXXXXXXXXXGXXXXXXXXXXXXXXXXXXXGXXXXXXXXXXXXXXXXXXXGXXXXXXXXXXXXXXXXXXXGXXXXXXXXXXXXXXXXXXXGXXXXXXXXXXXXXXXXXXXGXXXXXXXXXXXXXXXXXXXGXXXXXXXXXXXXXXXXXXXGXXXXXXXXXXXXXXXXXXXGXXXXXXXXXXXXXXXXXXX,0,300,0
22176,13,0,13,50,237,0,0,248,149,99,GXXXXXXXXXXXXXXXXXXXGXXXXXXXXXXXXXXXXXXXGXXXXXXXXXXXXXXXXXXXGXXXXXXXXXXXXXXXXXXXGXXXXXXXXXXXXXXXXXXXGXXXXXXXXXXXXXXXXXXXGXXXXXXXXXXXXXXXXXXXGXXXXXXXXXXXXXXXXXXXGXXXXXXXXXXXXXXXXXXXGXXXXXXXXXXXXXXXXXXXGXXXXXXXXXXXXXXXXXXXGXXXXXXXXXXXXXXXXXXXGXXXXXXXXXXXXXXXXXXX,0,300,0
22197,13,0,13,46,241,0,0,253,149,104,GXXXXXXXXXXXXXXXXXXXGXXXXXXXXXXXXXXXXXXXGXXXXXXXXXXXXXXXXXXXGXXXXXXXXXXXXXXXXXXXGXXXXXXXXXXXXXXXXXXXGXXXXXXXXXXXXXXXXXXXGXXXXXXXXXXXXXXXXXXXGXXXXXXXXXXXXXXXXXXXGXXXXXXXXXXXXXXXXXXXGXXXXXXXXXXXXXXXXXXXGXXXXXXXXXXXXXXXXXXXGXXXXXXXXXXXXXXXXXXXGXXXXXXXXXXXXXXXXXXX,0,300,0
22218,13,0,13,46,241,0,0,253,146,107,GXXXXXXXXXXXXXXXXXXXGXXXXXXXXXXXXXXXXXXXGXXXXXXXXXXXXXXXXXXXGXXXXXXXXXXXXXXXXXXXGXXXXXXXXXXXXXXXXXXXGXXXXXXXXXXXXXXXXXXXGXXXXXXXXXXXXXXXXXXXGXXXXXXXXXXXXXXXXXXXGXXXXXXXXXXXXXXXXXXXGXXXXXXXXXXXXXXXXXXXGXXXXXXXXXXXXXXXXXXXGXXXXXXXXXXXXXXXXXXXGXXXXXXXXXXXXXXXXXXX,0,300,0
22239,13,0,13,44,243,0,0,255,145,110,GXXXXXXXXXXXXXXXXXXXGXXXXXXXXXXXXXXXXXXXGXXXXXXXXXXXXXXXXXXXGXXXXXXXXXXXXXXXXXXXGXXXXXXXXXXXXXXXXXXXGXXXXXXXXXXXXXXXXXXXGXXXXXXXXXXXXXXXXXXXGXXXXXXXXXXXXXXXXXXXGXXXXXXXXXXXXXXXXXXXGXXXXXXXXXXXXXXXXXXXGXXXXXXXXXXXXXXXXXXXGXXXXXXXXXXXXXXXXXXXGXXXXXXXXXXXXXXXXXXX,0,300,0

22260,13,0,13,42,245,0,0,257,152,105,GXXXXXXXXXXXXXXXXXXXGXXXXXXXXXXXXXXXXXXXGXXXXXXXXXXXXXXXXXXXGXXXXXXXXXXXXXXXXXXXGXXXXXXXXXXXXXXXXXXXGXXXXXXXXXXXXXXXXXXXGXXXXXXXXXXXXXXXXXXXGXXXXXXXXXXXXXXXXXXXGXXXXXXXXXXXXXXXXXXXGXXXXXXXXXXXXXXXXXXXGXXXXXXXXXXXXXXXXXXXGXXXXXXXXXXXXXXXXXXXGXXXXXXXXXXXXXXXXXXX,0,300,0
22281,13,0,13,44,243,0,0,255,148,107,GXXXXXXXXXXXXXXXXXXXGXXXXXXXXXXXXXXXXXXXGXXXXXXXXXXXXXXXXXXXGXXXXXXXXXXXXXXXXXXXGXXXXXXXXXXXXXXXXXXXGXXXXXXXXXXXXXXXXXXXGXXXXXXXXXXXXXXXXXXXGXXXXXXXXXXXXXXXXXXXGXXXXXXXXXXXXXXXXXXXGXXXXXXXXXXXXXXXXXXXGXXXXXXXXXXXXXXXXXXXGXXXXXXXXXXXXXXXXXXXGXXXXXXXXXXXXXXXXXXX,0,300,0
22302,13,0,13,43,244,0,0,256,151,105,GXXXXXXXXXXXXXXXXXXXGXXXXXXXXXXXXXXXXXXXGXXXXXXXXXXXXXXXXXXXGXXXXXXXXXXXXXXXXXXXGXXXXXXXXXXXXXXXXXXXGXXXXXXXXXXXXXXXXXXXGXXXXXXXXXXXXXXXXXXXGXXXXXXXXXXXXXXXXXXXGXXXXXXXXXXXXXXXXXXXGXXXXXXXXXXXXXXXXXXXGXXXXXXXXXXXXXXXXXXXGXXXXXXXXXXXXXXXXXXXGXXXXXXXXXXXXXXXXXXX,0,300,0
22323,13,0,13,43,244,0,0,256,152,104,GXXXXXXXXXXXXXXXXXXXGXXXXXXXXXXXXXXXXXXXGXXXXXXXXXXXXXXXXXXXGXXXXXXXXXXXXXXXXXXXGXXXXXXXXXXXXXXXXXXXGXXXXXXXXXXXXXXXXXXXGXXXXXXXXXXXXXXXXXXXGXXXXXXXXXXXXXXXXXXXGXXXXXXXXXXXXXXXXXXXGXXXXXXXXXXXXXXXXXXXGXXXXXXXXXXXXXXXXXXXGXXXXXXXXXXXXXXXXXXXGXXXXXXXXXXXXXXXXXXX,0,300,0
22344,13,0,13,45,242,0,0,254,152,102,GXXXXXXXXXXXXXXXXXXXGXXXXXXXXXXXXXXXXXXXGXXXXXXXXXXXXXXXXXXXGXXXXXXXXXXXXXXXXXXXGXXXXXXXXXXXXXXXXXXXGXXXXXXXXXXXXXXXXXXXGXXXXXXXXXXXXXXXXXXXGXXXXXXXXXXXXXXXXXXXGXXXXXXXXXXXXXXXXXXXGXXXXXXXXXXXXXXXXXXXGXXXXXXXXXXXXXXXXXXXGXXXXXXXXXXXXXXXXXXXGXXXXXXXXXXXXXXXXXXX,0,300,0

22365,13,0,13,45,242,0,0,254,152,102,GXXXXXXXXXXXXXXXXXXXGXXXXXXXXXXXXXXXXXXXGXXXXXXXXXXXXXXXXXXXGXXXXXXXXXXXXXXXXXXXGXXXXXXXXXXXXXXXXXXXGXXXXXXXXXXXXXXXXXXXGXXXXXXXXXXXXXXXXXXXGXXXXXXXXXXXXXXXXXXXGXXXXXXXXXXXXXXXXXXXGXXXXXXXXXXXXXXXXXXXGXXXXXXXXXXXXXXXXXXXGXXXXXXXXXXXXXXXXXXXGXXXXXXXXXXXXXXXXXXX,0,300,0
22386,13,0,13,48,239,0,0,251,152,99,GXXXXXXXXXXXXXXXXXXXGXXXXXXXXXXXXXXXXXXXGXXXXXXXXXXXXXXXXXXXGXXXXXXXXXXXXXXXXXXXGXXXXXXXXXXXXXXXXXXXGXXXXXXXXXXXXXXXXXXXGXXXXXXXXXXXXXXXXXXXGXXXXXXXXXXXXXXXXXXXGXXXXXXXXXXXXXXXXXXXGXXXXXXXXXXXXXXXXXXXGXXXXXXXXXXXXXXXXXXXGXXXXXXXXXXXXXXXXXXXGXXXXXXXXXXXXXXXXXXX,0,300,0
22407,13,0,13,52,235,0,0,247,149,98,GXXXXXXXXXXXXXXXXXXXGXXXXXXXXXXXXXXXXXXXGXXXXXXXXXXXXXXXXXXXGXXXXXXXXXXXXXXXXXXXGXXXXXXXXXXXXXXXXXXXGXXXXXXXXXXXXXXXXXXXGXXXXXXXXXXXXXXXXXXXGXXXXXXXXXXXXXXXXXXXGXXXXXXXXXXXXXXXXXXXGXXXXXXXXXXXXXXXXXXXGXXXXXXXXXXXXXXXXXXXGXXXXXXXXXXXXXXXXXXXGXXXXXXXXXXXXXXXXXXX,0,300,0
22428,13,0,13,54,233,0,0,245,152,93,GXXXXXXXXXXXXXXXXXXXGXXXXXXXXXXXXXXXXXXXGXXXXXXXXXXXXXXXXXXXGXXXXXXXXXXXXXXXXXXXGXXXXXXXXXXXXXXXXXXXGXXXXXXXXXXXXXXXXXXXGXXXXXXXXXXXXXXXXXXXGXXXXXXXXXXXXXXXXXXXGXXXXXXXXXXXXXXXXXXXGXXXXXXXXXXXXXXXXXXXGXXXXXXXXXXXXXXXXXXXGXXXXXXXXXXXXXXXXXXXGXXXXXXXXXXXXXXXXXXX,0,300,0
22449,13,0,13,54,233,0,0,244,154,90,GXXXXXXXXXXXXXXXXXXXGXXXXXXXXXXXXXXXXXXXGXXXXXXXXXXXXXXXXXXXGXXXXXXXXXXXXXXXXXXXGXXXXXXXXXXXXXXXXXXXGXXXXXXXXXXXXXXXXXXXGXXXXXXXXXXXXXXXXXXXGXXXXXXXXXXXXXXXXXXXGXXXXXXXXXXXXXXXXXXXGXXXXXXXXXXXXXXXXXXXGXXXXXXXXXXXXXXXXXXXGXXXXXXXXXXXXXXXXXXXGXXXXXXXXXXXXXXXXXXX,0,300,0

22470,13,0,13,52,235,0,0,247,156,91,GXXXXXXXXXXXXXXXXXXXGXXXXXXXXXXXXXXXXXXXGXXXXXXXXXXXXXXXXXXXGXXXXXXXXXXXXXXXXXXXGXXXXXXXXXXXXXXXXXXXGXXXXXXXXXXXXXXXXXXXGXXXXXXXXXXXXXXXXXXXGXXXXXXXXXXXXXXXXXXXGXXXXXXXXXXXXXXXXXXXGXXXXXXXXXXXXXXXXXXXGXXXXXXXXXXXXXXXXXXXGXXXXXXXXXXXXXXXXXXXGXXXXXXXXXXXXXXXXXXX,0,300,0
22491,13,0,13,51,236,0,0,248,159,89,GXXXXXXXXXXXXXXXXXXXGXXXXXXXXXXXXXXXXXXXGXXXXXXXXXXXXXXXXXXXGXXXXXXXXXXXXXXXXXXXGXXXXXXXXXXXXXXXXXXXGXXXXXXXXXXXXXXXXXXXGXXXXXXXXXXXXXXXXXXXGXXXXXXXXXXXXXXXXXXXGXXXXXXXXXXXXXXXXXXXGXXXXXXXXXXXXXXXXXXXGXXXXXXXXXXXXXXXXXXXGXXXXXXXXXXXXXXXXXXXGXXXXXXXXXXXXXXXXXXX,0,300,0
22512,13,0,13,57,230,0,0,243,156,87,GXXXXXXXXXXXXXXXXXXXGXXXXXXXXXXXXXXXXXXXGXXXXXXXXXXXXXXXXXXXGXXXXXXXXXXXXXXXXXXXGXXXXXXXXXXXXXXXXXXXGXXXXXXXXXXXXXXXXXXXGXXXXXXXXXXXXXXXXXXXGXXXXXXXXXXXXXXXXXXXGXXXXXXXXXXXXXXXXXXXGXXXXXXXXXXXXXXXXXXXGXXXXXXXXXXXXXXXXXXXGXXXXXXXXXXXXXXXXXXXGXXXXXXXXXXXXXXXXXXX,0,300,0
22533,13,0,13,57,230,0,0,243,152,91,GXXXXXXXXXXXXXXXXXXXGXXXXXXXXXXXXXXXXXXXGXXXXXXXXXXXXXXXXXXXGXXXXXXXXXXXXXXXXXXXGXXXXXXXXXXXXXXXXXXXGXXXXXXXXXXXXXXXXXXXGXXXXXXXXXXXXXXXXXXXGXXXXXXXXXXXXXXXXXXXGXXXXXXXXXXXXXXXXXXXGXXXXXXXXXXXXXXXXXXXGXXXXXXXXXXXXXXXXXXXGXXXXXXXXXXXXXXXXXXXGXXXXXXXXXXXXXXXXXXX,0,300,0
22554,13,0,13,58,229,0,0,241,155,86,GXXXXXXXXXXXXXXXXXXXGXXXXXXXXXXXXXXXXXXXGXXXXXXXXXXXXXXXXXXXGXXXXXXXXXXXXXXXXXXXGXXXXXXXXXXXXXXXXXXXGXXXXXXXXXXXXXXXXXXXGXXXXXXXXXXXXXXXXXXXGXXXXXXXXXXXXXXXXXXXGXXXXXXXXXXXXXXXXXXXGXXXXXXXXXXXXXXXXXXXGXXXXXXXXXXXXXXXXXXXGXXXXXXXXXXXXXXXXXXXGXXXXXXXXXXXXXXXXXXX,0,300,0

22575,13,0,13,55,232,0,0,245,156,89,GXXXXXXXXXXXXXXXXXXXGXXXXXXXXXXXXXXXXXXXGXXXXXXXXXXXXXXXXXXXGXXXXXXXXXXXXXXXXXXXGXXXXXXXXXXXXXXXXXXXGXXXXXXXXXXXXXXXXXXXGXXXXXXXXXXXXXXXXXXXGXXXXXXXXXXXXXXXXXXXGXXXXXXXXXXXXXXXXXXXGXXXXXXXXXXXXXXXXXXXGXXXXXXXXXXXXXXXXXXXGXXXXXXXXXXXXXXXXXXXGXXXXXXXXXXXXXXXXXXX,0,300,0
22596,13,0,13,54,233,0,0,246,158,88,GXXXXXXXXXXXXXXXXXXXGXXXXXXXXXXXXXXXXXXXGXXXXXXXXXXXXXXXXXXXGXXXXXXXXXXXXXXXXXXXGXXXXXXXXXXXXXXXXXXXGXXXXXXXXXXXXXXXXXXXGXXXXXXXXXXXXXXXXXXXGXXXXXXXXXXXXXXXXXXXGXXXXXXXXXXXXXXXXXXXGXXXXXXXXXXXXXXXXXXXGXXXXXXXXXXXXXXXXXXXGXXXXXXXXXXXXXXXXXXXGXXXXXXXXXXXXXXXXXXX,0,300,0
22617,13,0,13,52,235,0,0,249,157,92,GXXXXXXXXXXXXXXXXXXXGXXXXXXXXXXXXXXXXXXXGXXXXXXXXXXXXXXXXXXXGXXXXXXXXXXXXXXXXXXXGXXXXXXXXXXXXXXXXXXXGXXXXXXXXXXXXXXXXXXXGXXXXXXXXXXXXXXXXXXXGXXXXXXXXXXXXXXXXXXXGXXXXXXXXXXXXXXXXXXXGXXXXXXXXXXXXXXXXXXXGXXXXXXXXXXXXXXXXXXXGXXXXXXXXXXXXXXXXXXXGXXXXXXXXXXXXXXXXXXX,0,300,0
22638,13,0,13,54,233,0,0,247,155,92,GXXXXXXXXXXXXXXXXXXXGXXXXXXXXXXXXXXXXXXXGXXXXXXXXXXXXXXXXXXXGXXXXXXXXXXXXXXXXXXXGXXXXXXXXXXXXXXXXXXXGXXXXXXXXXXXXXXXXXXXGXXXXXXXXXXXXXXXXXXXGXXXXXXXXXXXXXXXXXXXGXXXXXXXXXXXXXXXXXXXGXXXXXXXXXXXXXXXXXXXGXXXXXXXXXXXXXXXXXXXGXXXXXXXXXXXXXXXXXXXGXXXXXXXXXXXXXXXXXXX,0,300,0
22659,13,0,13,51,236,0,0,250,160,90,GXXXXXXXXXXXXXXXXXXXGXXXXXXXXXXXXXXXXXXXGXXXXXXXXXXXXXXXXXXXGXXXXXXXXXXXXXXXXXXXGXXXXXXXXXXXXXXXXXXXGXXXXXXXXXXXXXXXXXXXGXXXXXXXXXXXXXXXXXXXGXXXXXXXXXXXXXXXXXXXGXXXXXXXXXXXXXXXXXXXGXXXXXXXXXXXXXXXXXXXGXXXXXXXXXXXXXXXXXXXGXXXXXXXXXXXXXXXXXXXGXXXXXXXXXXXXXXXXXXX,0,300,0

22680,13,0,13,50,237,0,0,251,157,94,GXXXXXXXXXXXXXXXXXXXGXXXXXXXXXXXXXXXXXXXGXXXXXXXXXXXXXXXXXXXGXXXXXXXXXXXXXXXXXXXGXXXXXXXXXXXXXXXXXXXGXXXXXXXXXXXXXXXXXXXGXXXXXXXXXXXXXXXXXXXGXXXXXXXXXXXXXXXXXXXGXXXXXXXXXXXXXXXXXXXGXXXXXXXXXXXXXXXXXXXGXXXXXXXXXXXXXXXXXXXGXXXXXXXXXXXXXXXXXXXGXXXXXXXXXXXXXXXXXXX,0,300,0
22701,13,0,13,51,236,0,0,249,157,92,GXXXXXXXXXXXXXXXXXXXGXXXXXXXXXXXXXXXXXXXGXXXXXXXXXXXXXXXXXXXGXXXXXXXXXXXXXXXXXXXGXXXXXXXXXXXXXXXXXXXGXXXXXXXXXXXXXXXXXXXGXXXXXXXXXXXXXXXXXXXGXXXXXXXXXXXXXXXXXXXGXXXXXXXXXXXXXXXXXXXGXXXXXXXXXXXXXXXXXXXGXXXXXXXXXXXXXXXXXXXGXXXXXXXXXXXXXXXXXXXGXXXXXXXXXXXXXXXXXXX,0,300,0
22722,14,1,13,53,233,0,0,246,160,86,GXXXXXXXXXXXXXXXXXXXGXXXXXXXXXXXXXXXXXXXGXXXXXXXXXXXXXXXXXXXGXXXXXXXXXXXXXXXXXXXGXXXXXXXXXXXXXXXXXXXGXXXXXXXXXXXXXXXXXXXGAXXXXXXXXXXXXXXXXXXGXXXXXXXXXXXXXXXXXXXGXXXXXXXXXXXXXXXXXXXGXXXXXXXXXXXXXXXXXXXGXXXXXXXXXXXXXXXXXXXGXXXXXXXXXXXXXXXXXXXGXXXXXXXXXXXXXXXXXXX,0,300,0
22743,14,1,13,54,232,0,0,245,151,94,GXXXXXXXXXXXXXXXXXXXGXXXXXXXXXXXXXXXXXXXGXXXXXXXXXXXXXXXXXXXGXXXXXXXXXXXXXXXXXXXGXXXXXXXXXXXXXXXXXXXGXXXXXXXXXXXXXXXXXXXGAXXXXXXXXXXXXXXXXXXGXXXXXXXXXXXXXXXXXXXGXXXXXXXXXXXXXXXXXXXGXXXXXXXXXXXXXXXXXXXGXXXXXXXXXXXXXXXXXXXGXXXXXXXXXXXXXXXXXXXGXXXXXXXXXXXXXXXXXXX,0,300,0
22764,14,1,13,50,236,0,0,249,158,91,GXXXXXXXXXXXXXXXXXXXGXXXXXXXXXXXXXXXXXXXGXXXXXXXXXXXXXXXXXXXGXXXXXXXXXXXXXXXXXXXGXXXXXXXXXXXXXXXXXXXGXXXXXXXXXXXXXXXXXXXGAXXXXXXXXXXXXXXXXXXGXXXXXXXXXXXXXXXXXXXGXXXXXXXXXXXXXXXXXXXGXXXXXXXXXXXXXXXXXXXGXXXXXXXXXXXXXXXXXXXGXXXXXXXXXXXXXXXXXXXGXXXXXXXXXXXXXXXXXXX,0,300,0

22785,14,1,13,47,239,0,0,253,155,98,GXXXXXXXXXXXXXXXXXXXGXXXXXXXXXXXXXXXXXXXGXXXXXXXXXXXXXXXXXXXGXXXXXXXXXXXXXXXXXXXGXXXXXXXXXXXXXXXXXXXGXXXXXXXXXXXXXXXXXXXGAXXXXXXXXXXXXXXXXXXGXXXXXXXXXXXXXXXXXXXGXXXXXXXXXXXXXXXXXXXGXXXXXXXXXXXXXXXXXXXGXXXXXXXXXXXXXXXXXXXGXXXXXXXXXXXXXXXXXXXGXXXXXXXXXXXXXXXXXXX,0,300,0
22806,14,1,13,47,239,0,0,252,153,99,GXXXXXXXXXXXXXXXXXXXGXXXXXXXXXXXXXXXXXXXGXXXXXXXXXXXXXXXXXXXGXXXXXXXXXXXXXXXXXXXGXXXXXXXXXXXXXXXXXXXGXXXXXXXXXXXXXXXXXXXGAXXXXXXXXXXXXXXXXXXGXXXXXXXXXXXXXXXXXXXGXXXXXXXXXXXXXXXXXXXGXXXXXXXXXXXXXXXXXXXGXXXXXXXXXXXXXXXXXXXGXXXXXXXXXXXXXXXXXXXGXXXXXXXXXXXXXXXXXXX,0,300,0
22827,14,1,13,46,240,0,0,253,157,96,GXXXXXXXXXXXXXXXXXXXGXXXXXXXXXXXXXXXXXXXGXXXXXXXXXXXXXXXXXXXGXXXXXXXXXXXXXXXXXXXGXXXXXXXXXXXXXXXXXXXGXXXXXXXXXXXXXXXXXXXGAXXXXXXXXXXXXXXXXXXGXXXXXXXXXXXXXXXXXXXGXXXXXXXXXXXXXXXXXXXGXXXXXXXXXXXXXXXXXXXGXXXXXXXXXXXXXXXXXXXGXXXXXXXXXXXXXXXXXXXGXXXXXXXXXXXXXXXXXXX,0,300,0
22848,14,1,13,48,238,0,0,250,156,94,GXXXXXXXXXXXXXXXXXXXGXXXXXXXXXXXXXXXXXXXGXXXXXXXXXXXXXXXXXXXGXXXXXXXXXXXXXXXXXXXGXXXXXXXXXXXXXXXXXXXGXXXXXXXXXXXXXXXXXXXGAXXXXXXXXXXXXXXXXXXGXXXXXXXXXXXXXXXXXXXGXXXXXXXXXXXXXXXXXXXGXXXXXXXXXXXXXXXXXXXGXXXXXXXXXXXXXXXXXXXGXXXXXXXXXXXXXXXXXXXGXXXXXXXXXXXXXXXXXXX,0,300,0
22869,14,1,13,47,239,0,0,251,151,100,GXXXXXXXXXXXXXXXXXXXGXXXXXXXXXXXXXXXXXXXGXXXXXXXXXXXXXXXXXXXGXXXXXXXXXXXXXXXXXXXGXXXXXXXXXXXXXXXXXXXGXXXXXXXXXXXXXXXXXXXGAXXXXXXXXXXXXXXXXXXGXXXXXXXXXXXXXXXXXXXGXXXXXXXXXXXXXXXXXXXGXXXXXXXXXXXXXXXXXXXGXXXXXXXXXXXXXXXXXXXGXXXXXXXXXXXXXXXXXXXGXXXXXXXXXXXXXXXXXXX,0,300,0

22890,14,0,14,50,236,0,0,248,153,95,GXXXXXXXXXXXXXXXXXXXGXXXXXXXXXXXXXXXXXXXGXXXXXXXXXXXXXXXXXXXGXXXXXXXXXXXXXXXXXXXGXXXXXXXXXXXXXXXXXXXGXXXXXXXXXXXXXXXXXXXGOXXXXXXXXXXXXXXXXXXGXXXXXXXXXXXXXXXXXXXGXXXXXXXXXXXXXXXXXXXGXXXXXXXXXXXXXXXXXXXGXXXXXXXXXXXXXXXXXXXGXXXXXXXXXXXXXXXXXXXGXXXXXXXXXXXXXXXXXXX,0,300,0
22911,13,0,13,48,239,0,0,250,154,96,GXXXXXXXXXXXXXXXXXXXGXXXXXXXXXXXXXXXXXXXGXXXXXXXXXXXXXXXXXXXGXXXXXXXXXXXXXXXXXXXGXXXXXXXXXXXXXXXXXXXGXXXXXXXXXXXXXXXXXXXGXXXXXXXXXXXXXXXXXXXGXXXXXXXXXXXXXXXXXXXGXXXXXXXXXXXXXXXXXXXGXXXXXXXXXXXXXXXXXXXGXXXXXXXXXXXXXXXXXXXGXXXXXXXXXXXXXXXXXXXGXXXXXXXXXXXXXXXXXXX,0,300,0
22932,13,0,13,50,237,0,0,249,154,95,GXXXXXXXXXXXXXXXXXXXGXXXXXXXXXXXXXXXXXXXGXXXXXXXXXXXXXXXXXXXGXXXXXXXXXXXXXXXXXXXGXXXXXXXXXXXXXXXXXXXGXXXXXXXXXXXXXXXXXXXGXXXXXXXXXXXXXXXXXXXGXXXXXXXXXXXXXXXXXXXGXXXXXXXXXXXXXXXXXXXGXXXXXXXXXXXXXXXXXXXGXXXXXXXXXXXXXXXXXXXGXXXXXXXXXXXXXXXXXXXGXXXXXXXXXXXXXXXXXXX,0,300,0
22953,13,0,13,54,233,0,0,244,155,89,GXXXXXXXXXXXXXXXXXXXGXXXXXXXXXXXXXXXXXXXGXXXXXXXXXXXXXXXXXXXGXXXXXXXXXXXXXXXXXXXGXXXXXXXXXXXXXXXXXXXGXXXXXXXXXXXXXXXXXXXGXXXXXXXXXXXXXXXXXXXGXXXXXXXXXXXXXXXXXXXGXXXXXXXXXXXXXXXXXXXGXXXXXXXXXXXXXXXXXXXGXXXXXXXXXXXXXXXXXXXGXXXXXXXXXXXXXXXXXXXGXXXXXXXXXXXXXXXXXXX,0,300,0
22974,13,0,13,50,237,0,0,249,156,93,GXXXXXXXXXXXXXXXXXXXGXXXXXXXXXXXXXXXXXXXGXXXXXXXXXXXXXXXXXXXGXXXXXXXXXXXXXXXXXXXGXXXXXXXXXXXXXXXXXXXGXXXXXXXXXXXXXXXXXXXGXXXXXXXXXXXXXXXXXXXGXXXXXXXXXXXXXXXXXXXGXXXXXXXXXXXXXXXXXXXGXXXXXXXXXXXXXXXXXXXGXXXXXXXXXXXXXXXXXXXGXXXXXXXXXXXXXXXXXXXGXXXXXXXXXXXXXXXXXXX,0,300,0

22995,13,0,13,51,236,0,0,248,155,93,GXXXXXXXXXXXXXXXXXXXGXXXXXXXXXXXXXXXXXXXGXXXXXXXXXXXXXXXXXXXGXXXXXXXXXXXXXXXXXXXGXXXXXXXXXXXXXXXXXXXGXXXXXXXXXXXXXXXXXXXGXXXXXXXXXXXXXXXXXXXGXXXXXXXXXXXXXXXXXXXGXXXXXXXXXXXXXXXXXXXGXXXXXXXXXXXXXXXXXXXGXXXXXXXXXXXXXXXXXXXGXXXXXXXXXXXXXXXXXXXGXXXXXXXXXXXXXXXXXXX,0,300,0
23016,13,0,13,51,236,0,0,248,156,92,GXXXXXXXXXXXXXXXXXXXGXXXXXXXXXXXXXXXXXXXGXXXXXXXXXXXXXXXXXXXGXXXXXXXXXXXXXXXXXXXGXXXXXXXXXXXXXXXXXXXGXXXXXXXXXXXXXXXXXXXGXXXXXXXXXXXXXXXXXXXGXXXXXXXXXXXXXXXXXXXGXXXXXXXXXXXXXXXXXXXGXXXXXXXXXXXXXXXXXXXGXXXXXXXXXXXXXXXXXXXGXXXXXXXXXXXXXXXXXXXGXXXXXXXXXXXXXXXXXXX,0,300,0
23037,13,0,13,52,235,0,0,247,163,84,GXXXXXXXXXXXXXXXXXXXGXXXXXXXXXXXXXXXXXXXGXXXXXXXXXXXXXXXXXXXGXXXXXXXXXXXXXXXXXXXGXXXXXXXXXXXXXXXXXXXGXXXXXXXXXXXXXXXXXXXGXXXXXXXXXXXXXXXXXXXGXXXXXXXXXXXXXXXXXXXGXXXXXXXXXXXXXXXXXXXGXXXXXXXXXXXXXXXXXXXGXXXXXXXXXXXXXXXXXXXGXXXXXXXXXXXXXXXXXXXGXXXXXXXXXXXXXXXXXXX,0,300,0
23058,13,0,13,52,235,0,0,247,164,83,GXXXXXXXXXXXXXXXXXXXGXXXXXXXXXXXXXXXXXXXGXXXXXXXXXXXXXXXXXXXGXXXXXXXXXXXXXXXXXXXGXXXXXXXXXXXXXXXXXXXGXXXXXXXXXXXXXXXXXXXGXXXXXXXXXXXXXXXXXXXGXXXXXXXXXXXXXXXXXXXGXXXXXXXXXXXXXXXXXXXGXXXXXXXXXXXXXXXXXXXGXXXXXXXXXXXXXXXXXXXGXXXXXXXXXXXXXXXXXXXGXXXXXXXXXXXXXXXXXXX,0,300,0
23079,13,0,13,54,233,0,0,245,165,80,GXXXXXXXXXXXXXXXXXXXGXXXXXXXXXXXXXXXXXXXGXXXXXXXXXXXXXXXXXXXGXXXXXXXXXXXXXXXXXXXGXXXXXXXXXXXXXXXXXXXGXXXXXXXXXXXXXXXXXXXGXXXXXXXXXXXXXXXXXXXGXXXXXXXXXXXXXXXXXXXGXXXXXXXXXXXXXXXXXXXGXXXXXXXXXXXXXXXXXXXGXXXXXXXXXXXXXXXXXXXGXXXXXXXXXXXXXXXXXXXGXXXXXXXXXXXXXXXXXXX,0,300,0

23100,13,0,13,52,235,0,0,247,165,82,GXXXXXXXXXXXXXXXXXXXGXXXXXXXXXXXXXXXXXXXGXXXXXXXXXXXXXXXXXXXGXXXXXXXXXXXXXXXXXXXGXXXXXXXXXXXXXXXXXXXGXXXXXXXXXXXXXXXXXXXGXXXXXXXXXXXXXXXXXXXGXXXXXXXXXXXXXXXXXXXGXXXXXXXXXXXXXXXXXXXGXXXXXXXXXXXXXXXXXXXGXXXXXXXXXXXXXXXXXXXGXXXXXXXXXXXXXXXXXXXGXXXXXXXXXXXXXXXXXXX,0,300,0
23121,13,0,13,56,231,0,0,243,160,83,GXXXXXXXXXXXXXXXXXXXGXXXXXXXXXXXXXXXXXXXGXXXXXXXXXXXXXXXXXXXGXXXXXXXXXXXXXXXXXXXGXXXXXXXXXXXXXXXXXXXGXXXXXXXXXXXXXXXXXXXGXXXXXXXXXXXXXXXXXXXGXXXXXXXXXXXXXXXXXXXGXXXXXXXXXXXXXXXXXXXGXXXXXXXXXXXXXXXXXXXGXXXXXXXXXXXXXXXXXXXGXXXXXXXXXXXXXXXXXXXGXXXXXXXXXXXXXXXXXXX,0,300,0
23142,13,0,13,60,227,0,0,239,158,81,GXXXXXXXXXXXXXXXXXXXGXXXXXXXXXXXXXXXXXXXGXXXXXXXXXXXXXXXXXXXGXXXXXXXXXXXXXXXXXXXGXXXXXXXXXXXXXXXXXXXGXXXXXXXXXXXXXXXXXXXGXXXXXXXXXXXXXXXXXXXGXXXXXXXXXXXXXXXXXXXGXXXXXXXXXXXXXXXXXXXGXXXXXXXXXXXXXXXXXXXGXXXXXXXXXXXXXXXXXXXGXXXXXXXXXXXXXXXXXXXGXXXXXXXXXXXXXXXXXXX,0,300,0
23163,14,1,13,57,229,0,0,241,163,78,GXXXXXXXXXXXXXXXXXXXGXXXXXXXXXXXXXXXXXXXGAXXXXXXXXXXXXXXXXXXGXXXXXXXXXXXXXXXXXXXGXXXXXXXXXXXXXXXXXXXGXXXXXXXXXXXXXXXXXXXGXXXXXXXXXXXXXXXXXXXGXXXXXXXXXXXXXXXXXXXGXXXXXXXXXXXXXXXXXXXGXXXXXXXXXXXXXXXXXXXGXXXXXXXXXXXXXXXXXXXGXXXXXXXXXXXXXXXXXXXGXXXXXXXXXXXXXXXXXXX,0,300,0
23184,14,1,13,55,231,0,0,242,164,78,GXXXXXXXXXXXXXXXXXXXGXXXXXXXXXXXXXXXXXXXGAXXXXXXXXXXXXXXXXXXGXXXXXXXXXXXXXXXXXXXGXXXXXXXXXXXXXXXXXXXGXXXXXXXXXXXXXXXXXXXGXXXXXXXXXXXXXXXXXXXGXXXXXXXXXXXXXXXXXXXGXXXXXXXXXXXXXXXXXXXGXXXXXXXXXXXXXXXXXXXGXXXXXXXXXXXXXXXXXXXGXXXXXXXXXXXXXXXXXXXGXXXXXXXXXXXXXXXXXXX,0,300,0

23205,15,2,13,55,230,0,0,242,162,80,GXXXXXXXXXXXXXXXXXXXGXXXXXXXXXXXXXXXXXXXGAXXXXXXXXXXXXXXXXXXGXXXXXXXXXXXXXXXXXXXGXXXXXXXXXXXXXXXXXXXGAXXXXXXXXXXXXXXXXXXGXXXXXXXXXXXXXXXXXXXGXXXXXXXXXXXXXXXXXXXGXXXXXXXXXXXXXXXXXXXGXXXXXXXXXXXXXXXXXXXGXXXXXXXXXXXXXXXXXXXGXXXXXXXXXXXXXXXXXXXGXXXXXXXXXXXXXXXXXXX,0,300,0
23226,15,2,13,54,231,0,0,242,160,82,GXXXXXXXXXXXXXXXXXXXGXXXXXXXXXXXXXXXXXXXGAXXXXXXXXXXXXXXXXXXGXXXXXXXXXXXXXXXXXXXGXXXXXXXXXXXXXXXXXXXGAXXXXXXXXXXXXXXXXXXGXXXXXXXXXXXXXXXXXXXGXXXXXXXXXXXXXXXXXXXGXXXXXXXXXXXXXXXXXXXGXXXXXXXXXXXXXXXXXXXGXXXXXXXXXXXXXXXXXXXGXXXXXXXXXXXXXXXXXXXGXXXXXXXXXXXXXXXXXXX,0,300,0
23247,15,2,13,50,235,0,0,247,161,86,GXXXXXXXXXXXXXXXXXXXGXXXXXXXXXXXXXXXXXXXGAXXXXXXXXXXXXXXXXXXGXXXXXXXXXXXXXXXXXXXGXXXXXXXXXXXXXXXXXXXGAXXXXXXXXXXXXXXXXXXGXXXXXXXXXXXXXXXXXXXGXXXXXXXXXXXXXXXXXXXGXXXXXXXXXXXXXXXXXXXGXXXXXXXXXXXXXXXXXXXGXXXXXXXXXXXXXXXXXXXGXXXXXXXXXXXXXXXXXXXGXXXXXXXXXXXXXXXXXXX,0,300,0
23268,15,2,13,55,230,0,0,242,160,82,GXXXXXXXXXXXXXXXXXXXGXXXXXXXXXXXXXXXXXXXGAXXXXXXXXXXXXXXXXXXGXXXXXXXXXXXXXXXXXXXGXXXXXXXXXXXXXXXXXXXGAXXXXXXXXXXXXXXXXXXGXXXXXXXXXXXXXXXXXXXGXXXXXXXXXXXXXXXXXXXGXXXXXXXXXXXXXXXXXXXGXXXXXXXXXXXXXXXXXXXGXXXXXXXXXXXXXXXXXXXGXXXXXXXXXXXXXXXXXXXGXXXXXXXXXXXXXXXXXXX,0,300,0
23289,15,2,13,58,227,0,0,239,154,85,GXXXXXXXXXXXXXXXXXXXGXXXXXXXXXXXXXXXXXXXGAXXXXXXXXXXXXXXXXXXGXXXXXXXXXXXXXXXXXXXGXXXXXXXXXXXXXXXXXXXGAXXXXXXXXXXXXXXXXXXGXXXXXXXXXXXXXXXXXXXGXXXXXXXXXXXXXXXXXXXGXXXXXXXXXXXXXXXXXXXGXXXXXXXXXXXXXXXXXXXGXXXXXXXXXXXXXXXXXXXGXXXXXXXXXXXXXXXXXXXGXXXXXXXXXXXXXXXXXXX,0,300,0

23310,14,1,13,58,228,0,0,241,156,85,GXXXXXXXXXXXXXXXXXXXGXXXXXXXXXXXXXXXXXXXGAXXXXXXXXXXXXXXXXXXGXXXXXXXXXXXXXXXXXXXGXXXXXXXXXXXXXXXXXXXGXXXXXXXXXXXXXXXXXXXGXXXXXXXXXXXXXXXXXXXGXXXXXXXXXXXXXXXXXXXGXXXXXXXXXXXXXXXXXXXGXXXXXXXXXXXXXXXXXXXGXXXXXXXXXXXXXXXXXXXGXXXXXXXXXXXXXXXXXXXGXXXXXXXXXXXXXXXXXXX,0,300,0
23331,14,1,13,55,231,0,0,244,157,87,GXXXXXXXXXXXXXXXXXXXGXXXXXXXXXXXXXXXXXXXGAXXXXXXXXXXXXXXXXXXGXXXXXXXXXXXXXXXXXXXGXXXXXXXXXXXXXXXXXXXGXXXXXXXXXXXXXXXXXXXGXXXXXXXXXXXXXXXXXXXGXXXXXXXXXXXXXXXXXXXGXXXXXXXXXXXXXXXXXXXGXXXXXXXXXXXXXXXXXXXGXXXXXXXXXXXXXXXXXXXGXXXXXXXXXXXXXXXXXXXGXXXXXXXXXXXXXXXXXXX,0,300,0
23352,14,1,13,56,230,0,0,243,156,87,GXXXXXXXXXXXXXXXXXXXGXXXXXXXXXXXXXXXXXXXGAXXXXXXXXXXXXXXXXXXGXXXXXXXXXXXXXXXXXXXGXXXXXXXXXXXXXXXXXXXGXXXXXXXXXXXXXXXXXXXGXXXXXXXXXXXXXXXXXXXGXXXXXXXXXXXXXXXXXXXGXXXXXXXXXXXXXXXXXXXGXXXXXXXXXXXXXXXXXXXGXXXXXXXXXXXXXXXXXXXGXXXXXXXXXXXXXXXXXXXGXXXXXXXXXXXXXXXXXXX,0,300,0
23373,14,1,13,55,231,0,0,243,155,88,GXXXXXXXXXXXXXXXXXXXGXXXXXXXXXXXXXXXXXXXGAXXXXXXXXXXXXXXXXXXGXXXXXXXXXXXXXXXXXXXGXXXXXXXXXXXXXXXXXXXGXXXXXXXXXXXXXXXXXXXGXXXXXXXXXXXXXXXXXXXGXXXXXXXXXXXXXXXXXXXGXXXXXXXXXXXXXXXXXXXGXXXXXXXXXXXXXXXXXXXGXXXXXXXXXXXXXXXXXXXGXXXXXXXXXXXXXXXXXXXGXXXXXXXXXXXXXXXXXXX,0,300,0
23394,15,2,13,50,235,0,0,248,160,88,GXXXXXXXXXXXXXXXXXXXGXXXXXXXXXXXXXXXXXXXGAAXXXXXXXXXXXXXXXXXGXXXXXXXXXXXXXXXXXXXGXXXXXXXXXXXXXXXXXXXGXXXXXXXXXXXXXXXXXXXGXXXXXXXXXXXXXXXXXXXGXXXXXXXXXXXXXXXXXXXGXXXXXXXXXXXXXXXXXXXGXXXXXXXXXXXXXXXXXXXGXXXXXXXXXXXXXXXXXXXGXXXXXXXXXXXXXXXXXXXGXXXXXXXXXXXXXXXXXXX,0,300,0

23415,15,2,13,52,233,0,0,246,161,85,GXXXXXXXXXXXXXXXXXXXGXXXXXXXXXXXXXXXXXXXGAAXXXXXXXXXXXXXXXXXGXXXXXXXXXXXXXXXXXXXGXXXXXXXXXXXXXXXXXXXGXXXXXXXXXXXXXXXXXXXGXXXXXXXXXXXXXXXXXXXGXXXXXXXXXXXXXXXXXXXGXXXXXXXXXXXXXXXXXXXGXXXXXXXXXXXXXXXXXXXGXXXXXXXXXXXXXXXXXXXGXXXXXXXXXXXXXXXXXXXGXXXXXXXXXXXXXXXXXXX,0,300,0
23436,15,2,13,48,237,0,0,250,158,92,GXXXXXXXXXXXXXXXXXXXGXXXXXXXXXXXXXXXXXXXGAAXXXXXXXXXXXXXXXXXGXXXXXXXXXXXXXXXXXXXGXXXXXXXXXXXXXXXXXXXGXXXXXXXXXXXXXXXXXXXGXXXXXXXXXXXXXXXXXXXGXXXXXXXXXXXXXXXXXXXGXXXXXXXXXXXXXXXXXXXGXXXXXXXXXXXXXXXXXXXGXXXXXXXXXXXXXXXXXXXGXXXXXXXXXXXXXXXXXXXGXXXXXXXXXXXXXXXXXXX,0,300,0
23457,15,2,13,44,241,0,0,253,161,92,GXXXXXXXXXXXXXXXXXXXGXXXXXXXXXXXXXXXXXXXGAAXXXXXXXXXXXXXXXXXGXXXXXXXXXXXXXXXXXXXGXXXXXXXXXXXXXXXXXXXGXXXXXXXXXXXXXXXXXXXGXXXXXXXXXXXXXXXXXXXGXXXXXXXXXXXXXXXXXXXGXXXXXXXXXXXXXXXXXXXGXXXXXXXXXXXXXXXXXXXGXXXXXXXXXXXXXXXXXXXGXXXXXXXXXXXXXXXXXXXGXXXXXXXXXXXXXXXXXXX,0,300,0
23478,15,2,13,44,241,0,0,255,157,98,GXXXXXXXXXXXXXXXXXXXGXXXXXXXXXXXXXXXXXXXGAAXXXXXXXXXXXXXXXXXGXXXXXXXXXXXXXXXXXXXGXXXXXXXXXXXXXXXXXXXGXXXXXXXXXXXXXXXXXXXGXXXXXXXXXXXXXXXXXXXGXXXXXXXXXXXXXXXXXXXGXXXXXXXXXXXXXXXXXXXGXXXXXXXXXXXXXXXXXXXGXXXXXXXXXXXXXXXXXXXGXXXXXXXXXXXXXXXXXXXGXXXXXXXXXXXXXXXXXXX,0,300,0
23499,15,2,13,42,243,0,0,257,155,102,GXXXXXXXXXXXXXXXXXXXGXXXXXXXXXXXXXXXXXXXGAAXXXXXXXXXXXXXXXXXGXXXXXXXXXXXXXXXXXXXGXXXXXXXXXXXXXXXXXXXGXXXXXXXXXXXXXXXXXXXGXXXXXXXXXXXXXXXXXXXGXXXXXXXXXXXXXXXXXXXGXXXXXXXXXXXXXXXXXXXGXXXXXXXXXXXXXXXXXXXGXXXXXXXXXXXXXXXXXXXGXXXXXXXXXXXXXXXXXXXGXXXXXXXXXXXXXXXXXXX,0,300,0

23520,15,2,13,40,245,0,0,257,159,98,GXXXXXXXXXXXXXXXXXXXGXXXXXXXXXXXXXXXXXXXGAAXXXXXXXXXXXXXXXXXGXXXXXXXXXXXXXXXXXXXGXXXXXXXXXXXXXXXXXXXGXXXXXXXXXXXXXXXXXXXGXXXXXXXXXXXXXXXXXXXGXXXXXXXXXXXXXXXXXXXGXXXXXXXXXXXXXXXXXXXGXXXXXXXXXXXXXXXXXXXGXXXXXXXXXXXXXXXXXXXGXXXXXXXXXXXXXXXXXXXGXXXXXXXXXXXXXXXXXXX,0,300,0
23541,14,1,13,43,243,0,0,256,158,98,GXXXXXXXXXXXXXXXXXXXGXXXXXXXXXXXXXXXXXXXGXAXXXXXXXXXXXXXXXXXGXXXXXXXXXXXXXXXXXXXGXXXXXXXXXXXXXXXXXXXGXXXXXXXXXXXXXXXXXXXGXXXXXXXXXXXXXXXXXXXGXXXXXXXXXXXXXXXXXXXGXXXXXXXXXXXXXXXXXXXGXXXXXXXXXXXXXXXXXXXGXXXXXXXXXXXXXXXXXXXGXXXXXXXXXXXXXXXXXXXGXXXXXXXXXXXXXXXXXXX,0,300,0
23562,13,0,13,43,244,0,0,257,159,98,GXXXXXXXXXXXXXXXXXXXGXXXXXXXXXXXXXXXXXXXGXXXXXXXXXXXXXXXXXXXGXXXXXXXXXXXXXXXXXXXGXXXXXXXXXXXXXXXXXXXGXXXXXXXXXXXXXXXXXXXGXXXXXXXXXXXXXXXXXXXGXXXXXXXXXXXXXXXXXXXGXXXXXXXXXXXXXXXXXXXGXXXXXXXXXXXXXXXXXXXGXXXXXXXXXXXXXXXXXXXGXXXXXXXXXXXXXXXXXXXGXXXXXXXXXXXXXXXXXXX,0,300,0
23583,13,0,13,43,244,0,0,256,160,96,GXXXXXXXXXXXXXXXXXXXGXXXXXXXXXXXXXXXXXXXGXXXXXXXXXXXXXXXXXXXGXXXXXXXXXXXXXXXXXXXGXXXXXXXXXXXXXXXXXXXGXXXXXXXXXXXXXXXXXXXGXXXXXXXXXXXXXXXXXXXGXXXXXXXXXXXXXXXXXXXGXXXXXXXXXXXXXXXXXXXGXXXXXXXXXXXXXXXXXXXGXXXXXXXXXXXXXXXXXXXGXXXXXXXXXXXXXXXXXXXGXXXXXXXXXXXXXXXXXXX,0,300,0
23604,13,0,13,51,236,0,0,248,155,93,GXXXXXXXXXXXXXXXXXXXGXXXXXXXXXXXXXXXXXXXGXXXXXXXXXXXXXXXXXXXGXXXXXXXXXXXXXXXXXXXGXXXXXXXXXXXXXXXXXXXGXXXXXXXXXXXXXXXXXXXGXXXXXXXXXXXXXXXXXXXGXXXXXXXXXXXXXXXXXXXGXXXXXXXXXXXXXXXXXXXGXXXXXXXXXXXXXXXXXXXGXXXXXXXXXXXXXXXXXXXGXXXXXXXXXXXXXXXXXXXGXXXXXXXXXXXXXXXXXXX,0,300,0

23625,13,0,13,51,236,0,0,248,160,88,GXXXXXXXXXXXXXXXXXXXGXXXXXXXXXXXXXXXXXXXGXXXXXXXXXXXXXXXXXXXGXXXXXXXXXXXXXXXXXXXGXXXXXXXXXXXXXXXXXXXGXXXXXXXXXXXXXXXXXXXGXXXXXXXXXXXXXXXXXXXGXXXXXXXXXXXXXXXXXXXGXXXXXXXXXXXXXXXXXXXGXXXXXXXXXXXXXXXXXXXGXXXXXXXXXXXXXXXXXXXGXXXXXXXXXXXXXXXXXXXGXXXXXXXXXXXXXXXXXXX,0,300,0
23646,13,0,13,47,240,0,0,249,161,88,GXXXXXXXXXXXXXXXXXXXGXXXXXXXXXXXXXXXXXXXGXXXXXXXXXXXXXXXXXXXGXXXXXXXXXXXXXXXXXXXGXXXXXXXXXXXXXXXXXXXGXXXXXXXXXXXXXXXXXXXGXXXXXXXXXXXXXXXXXXXGXXXXXXXXXXXXXXXXXXXGXXXXXXXXXXXXXXXXXXXGXXXXXXXXXXXXXXXXXXXGXXXXXXXXXXXXXXXXXXXGXXXXXXXXXXXXXXXXXXXGXXXXXXXXXXXXXXXXXXX,0,300,0
23667,13,0,13,44,243,0,0,254,157,97,GXXXXXXXXXXXXXXXXXXXGXXXXXXXXXXXXXXXXXXXGXXXXXXXXXXXXXXXXXXXGXXXXXXXXXXXXXXXXXXXGXXXXXXXXXXXXXXXXXXXGXXXXXXXXXXXXXXXXXXXGXXXXXXXXXXXXXXXXXXXGXXXXXXXXXXXXXXXXXXXGXXXXXXXXXXXXXXXXXXXGXXXXXXXXXXXXXXXXXXXGXXXXXXXXXXXXXXXXXXXGXXXXXXXXXXXXXXXXXXXGXXXXXXXXXXXXXXXXXXX,0,300,0
23688,13,0,13,45,242,0,0,254,158,96,GXXXXXXXXXXXXXXXXXXXGXXXXXXXXXXXXXXXXXXXGXXXXXXXXXXXXXXXXXXXGXXXXXXXXXXXXXXXXXXXGXXXXXXXXXXXXXXXXXXXGXXXXXXXXXXXXXXXXXXXGXXXXXXXXXXXXXXXXXXXGXXXXXXXXXXXXXXXXXXXGXXXXXXXXXXXXXXXXXXXGXXXXXXXXXXXXXXXXXXXGXXXXXXXXXXXXXXXXXXXGXXXXXXXXXXXXXXXXXXXGXXXXXXXXXXXXXXXXXXX,0,300,0
23709,13,0,13,46,241,0,0,252,159,93,GXXXXXXXXXXXXXXXXXXXGXXXXXXXXXXXXXXXXXXXGXXXXXXXXXXXXXXXXXXXGXXXXXXXXXXXXXXXXXXXGXXXXXXXXXXXXXXXXXXXGXXXXXXXXXXXXXXXXXXXGXXXXXXXXXXXXXXXXXXXGXXXXXXXXXXXXXXXXXXXGXXXXXXXXXXXXXXXXXXXGXXXXXXXXXXXXXXXXXXXGXXXXXXXXXXXXXXXXXXXGXXXXXXXXXXXXXXXXXXXGXXXXXXXXXXXXXXXXXXX,0,300,0

23730,13,0,13,45,242,0,0,254,162,92,GXXXXXXXXXXXXXXXXXXXGXXXXXXXXXXXXXXXXXXXGXXXXXXXXXXXXXXXXXXXGXXXXXXXXXXXXXXXXXXXGXXXXXXXXXXXXXXXXXXXGXXXXXXXXXXXXXXXXXXXGXXXXXXXXXXXXXXXXXXXGXXXXXXXXXXXXXXXXXXXGXXXXXXXXXXXXXXXXXXXGXXXXXXXXXXXXXXXXXXXGXXXXXXXXXXXXXXXXXXXGXXXXXXXXXXXXXXXXXXXGXXXXXXXXXXXXXXXXXXX,0,300,0
23751,13,0,13,51,236,0,0,248,163,85,GXXXXXXXXXXXXXXXXXXXGXXXXXXXXXXXXXXXXXXXGXXXXXXXXXXXXXXXXXXXGXXXXXXXXXXXXXXXXXXXGXXXXXXXXXXXXXXXXXXXGXXXXXXXXXXXXXXXXXXXGXXXXXXXXXXXXXXXXXXXGXXXXXXXXXXXXXXXXXXXGXXXXXXXXXXXXXXXXXXXGXXXXXXXXXXXXXXXXXXXGXXXXXXXXXXXXXXXXXXXGXXXXXXXXXXXXXXXXXXXGXXXXXXXXXXXXXXXXXXX,0,300,0
23772,13,0,13,51,236,0,0,248,163,85,GXXXXXXXXXXXXXXXXXXXGXXXXXXXXXXXXXXXXXXXGXXXXXXXXXXXXXXXXXXXGXXXXXXXXXXXXXXXXXXXGXXXXXXXXXXXXXXXXXXXGXXXXXXXXXXXXXXXXXXXGXXXXXXXXXXXXXXXXXXXGXXXXXXXXXXXXXXXXXXXGXXXXXXXXXXXXXXXXXXXGXXXXXXXXXXXXXXXXXXXGXXXXXXXXXXXXXXXXXXXGXXXXXXXXXXXXXXXXXXXGXXXXXXXXXXXXXXXXXXX,0,300,0
23793,13,0,13,52,235,0,0,247,165,82,GXXXXXXXXXXXXXXXXXXXGXXXXXXXXXXXXXXXXXXXGXXXXXXXXXXXXXXXXXXXGXXXXXXXXXXXXXXXXXXXGXXXXXXXXXXXXXXXXXXXGXXXXXXXXXXXXXXXXXXXGXXXXXXXXXXXXXXXXXXXGXXXXXXXXXXXXXXXXXXXGXXXXXXXXXXXXXXXXXXXGXXXXXXXXXXXXXXXXXXXGXXXXXXXXXXXXXXXXXXXGXXXXXXXXXXXXXXXXXXXGXXXXXXXXXXXXXXXXXXX,0,300,0
23814,13,0,13,51,236,0,0,248,161,87,GXXXXXXXXXXXXXXXXXXXGXXXXXXXXXXXXXXXXXXXGXXXXXXXXXXXXXXXXXXXGXXXXXXXXXXXXXXXXXXXGXXXXXXXXXXXXXXXXXXXGXXXXXXXXXXXXXXXXXXXGXXXXXXXXXXXXXXXXXXXGXXXXXXXXXXXXXXXXXXXGXXXXXXXXXXXXXXXXXXXGXXXXXXXXXXXXXXXXXXXGXXXXXXXXXXXXXXXXXXXGXXXXXXXXXXXXXXXXXXXGXXXXXXXXXXXXXXXXXXX,0,300,0

23835,13,0,13,47,240,0,0,252,159,93,GXXXXXXXXXXXXXXXXXXXGXXXXXXXXXXXXXXXXXXXGXXXXXXXXXXXXXXXXXXXGXXXXXXXXXXXXXXXXXXXGXXXXXXXXXXXXXXXXXXXGXXXXXXXXXXXXXXXXXXXGXXXXXXXXXXXXXXXXXXXGXXXXXXXXXXXXXXXXXXXGXXXXXXXXXXXXXXXXXXXGXXXXXXXXXXXXXXXXXXXGXXXXXXXXXXXXXXXXXXXGXXXXXXXXXXXXXXXXXXXGXXXXXXXXXXXXXXXXXXX,0,300,0
23856,13,0,13,47,240,0,0,252,162,90,GXXXXXXXXXXXXXXXXXXXGXXXXXXXXXXXXXXXXXXXGXXXXXXXXXXXXXXXXXXXGXXXXXXXXXXXXXXXXXXXGXXXXXXXXXXXXXXXXXXXGXXXXXXXXXXXXXXXXXXXGXXXXXXXXXXXXXXXXXXXGXXXXXXXXXXXXXXXXXXXGXXXXXXXXXXXXXXXXXXXGXXXXXXXXXXXXXXXXXXXGXXXXXXXXXXXXXXXXXXXGXXXXXXXXXXXXXXXXXXXGXXXXXXXXXXXXXXXXXXX,0,300,0
23877,13,0,13,48,239,0,0,251,163,88,GXXXXXXXXXXXXXXXXXXXGXXXXXXXXXXXXXXXXXXXGXXXXXXXXXXXXXXXXXXXGXXXXXXXXXXXXXXXXXXXGXXXXXXXXXXXXXXXXXXXGXXXXXXXXXXXXXXXXXXXGXXXXXXXXXXXXXXXXXXXGXXXXXXXXXXXXXXXXXXXGXXXXXXXXXXXXXXXXXXXGXXXXXXXXXXXXXXXXXXXGXXXXXXXXXXXXXXXXXXXGXXXXXXXXXXXXXXXXXXXGXXXXXXXXXXXXXXXXXXX,0,300,0
23898,13,0,13,44,243,0,0,255,163,92,GXXXXXXXXXXXXXXXXXXXGXXXXXXXXXXXXXXXXXXXGXXXXXXXXXXXXXXXXXXXGXXXXXXXXXXXXXXXXXXXGXXXXXXXXXXXXXXXXXXXGXXXXXXXXXXXXXXXXXXXGXXXXXXXXXXXXXXXXXXXGXXXXXXXXXXXXXXXXXXXGXXXXXXXXXXXXXXXXXXXGXXXXXXXXXXXXXXXXXXXGXXXXXXXXXXXXXXXXXXXGXXXXXXXXXXXXXXXXXXXGXXXXXXXXXXXXXXXXXXX,0,300,0
23919,13,0,13,46,241,0,0,253,163,90,GXXXXXXXXXXXXXXXXXXXGXXXXXXXXXXXXXXXXXXXGXXXXXXXXXXXXXXXXXXXGXXXXXXXXXXXXXXXXXXXGXXXXXXXXXXXXXXXXXXXGXXXXXXXXXXXXXXXXXXXGXXXXXXXXXXXXXXXXXXXGXXXXXXXXXXXXXXXXXXXGXXXXXXXXXXXXXXXXXXXGXXXXXXXXXXXXXXXXXXXGXXXXXXXXXXXXXXXXXXXGXXXXXXXXXXXXXXXXXXXGXXXXXXXXXXXXXXXXXXX,0,300,0

23940,13,0,13,45,242,0,0,254,166,88,GXXXXXXXXXXXXXXXXXXXGXXXXXXXXXXXXXXXXXXXGXXXXXXXXXXXXXXXXXXXGXXXXXXXXXXXXXXXXXXXGXXXXXXXXXXXXXXXXXXXGXXXXXXXXXXXXXXXXXXXGXXXXXXXXXXXXXXXXXXXGXXXXXXXXXXXXXXXXXXXGXXXXXXXXXXXXXXXXXXXGXXXXXXXXXXXXXXXXXXXGXXXXXXXXXXXXXXXXXXXGXXXXXXXXXXXXXXXXXXXGXXXXXXXXXXXXXXXXXXX,0,300,0
23961,13,0,13,49,238,0,0,250,165,85,GXXXXXXXXXXXXXXXXXXXGXXXXXXXXXXXXXXXXXXXGXXXXXXXXXXXXXXXXXXXGXXXXXXXXXXXXXXXXXXXGXXXXXXXXXXXXXXXXXXXGXXXXXXXXXXXXXXXXXXXGXXXXXXXXXXXXXXXXXXXGXXXXXXXXXXXXXXXXXXXGXXXXXXXXXXXXXXXXXXXGXXXXXXXXXXXXXXXXXXXGXXXXXXXXXXXXXXXXXXXGXXXXXXXXXXXXXXXXXXXGXXXXXXXXXXXXXXXXXXX,0,300,0
23982,13,0,13,48,239,0,0,250,163,87,GXXXXXXXXXXXXXXXXXXXGXXXXXXXXXXXXXXXXXXXGXXXXXXXXXXXXXXXXXXXGXXXXXXXXXXXXXXXXXXXGXXXXXXXXXXXXXXXXXXXGXXXXXXXXXXXXXXXXXXXGXXXXXXXXXXXXXXXXXXXGXXXXXXXXXXXXXXXXXXXGXXXXXXXXXXXXXXXXXXXGXXXXXXXXXXXXXXXXXXXGXXXXXXXXXXXXXXXXXXXGXXXXXXXXXXXXXXXXXXXGXXXXXXXXXXXXXXXXXXX,0,300,0
24003,13,0,13,51,236,0,0,248,162,86,GXXXXXXXXXXXXXXXXXXXGXXXXXXXXXXXXXXXXXXXGXXXXXXXXXXXXXXXXXXXGXXXXXXXXXXXXXXXXXXXGXXXXXXXXXXXXXXXXXXXGXXXXXXXXXXXXXXXXXXXGXXXXXXXXXXXXXXXXXXXGXXXXXXXXXXXXXXXXXXXGXXXXXXXXXXXXXXXXXXXGXXXXXXXXXXXXXXXXXXXGXXXXXXXXXXXXXXXXXXXGXXXXXXXXXXXXXXXXXXXGXXXXXXXXXXXXXXXXXXX,0,300,0
24024,13,0,13,47,240,0,0,251,162,89,GXXXXXXXXXXXXXXXXXXXGXXXXXXXXXXXXXXXXXXXGXXXXXXXXXXXXXXXXXXXGXXXXXXXXXXXXXXXXXXXGXXXXXXXXXXXXXXXXXXXGXXXXXXXXXXXXXXXXXXXGXXXXXXXXXXXXXXXXXXXGXXXXXXXXXXXXXXXXXXXGXXXXXXXXXXXXXXXXXXXGXXXXXXXXXXXXXXXXXXXGXXXXXXXXXXXXXXXXXXXGXXXXXXXXXXXXXXXXXXXGXXXXXXXXXXXXXXXXXXX,0,300,0

24045,13,0,13,47,240,0,0,252,160,92,GXXXXXXXXXXXXXXXXXXXGXXXXXXXXXXXXXXXXXXXGXXXXXXXXXXXXXXXXXXXGXXXXXXXXXXXXXXXXXXXGXXXXXXXXXXXXXXXXXXXGXXXXXXXXXXXXXXXXXXXGXXXXXXXXXXXXXXXXXXXGXXXXXXXXXXXXXXXXXXXGXXXXXXXXXXXXXXXXXXXGXXXXXXXXXXXXXXXXXXXGXXXXXXXXXXXXXXXXXXXGXXXXXXXXXXXXXXXXXXXGXXXXXXXXXXXXXXXXXXX,0,300,0
24066,13,0,13,49,238,0,0,250,162,88,GXXXXXXXXXXXXXXXXXXXGXXXXXXXXXXXXXXXXXXXGXXXXXXXXXXXXXXXXXXXGXXXXXXXXXXXXXXXXXXXGXXXXXXXXXXXXXXXXXXXGXXXXXXXXXXXXXXXXXXXGXXXXXXXXXXXXXXXXXXXGXXXXXXXXXXXXXXXXXXXGXXXXXXXXXXXXXXXXXXXGXXXXXXXXXXXXXXXXXXXGXXXXXXXXXXXXXXXXXXXGXXXXXXXXXXXXXXXXXXXGXXXXXXXXXXXXXXXXXXX,0,300,0
24087,13,0,13,46,241,0,0,253,164,89,GXXXXXXXXXXXXXXXXXXXGXXXXXXXXXXXXXXXXXXXGXXXXXXXXXXXXXXXXXXXGXXXXXXXXXXXXXXXXXXXGXXXXXXXXXXXXXXXXXXXGXXXXXXXXXXXXXXXXXXXGXXXXXXXXXXXXXXXXXXXGXXXXXXXXXXXXXXXXXXXGXXXXXXXXXXXXXXXXXXXGXXXXXXXXXXXXXXXXXXXGXXXXXXXXXXXXXXXXXXXGXXXXXXXXXXXXXXXXXXXGXXXXXXXXXXXXXXXXXXX,0,300,0
24108,13,0,13,50,237,0,0,249,166,83,GXXXXXXXXXXXXXXXXXXXGXXXXXXXXXXXXXXXXXXXGXXXXXXXXXXXXXXXXXXXGXXXXXXXXXXXXXXXXXXXGXXXXXXXXXXXXXXXXXXXGXXXXXXXXXXXXXXXXXXXGXXXXXXXXXXXXXXXXXXXGXXXXXXXXXXXXXXXXXXXGXXXXXXXXXXXXXXXXXXXGXXXXXXXXXXXXXXXXXXXGXXXXXXXXXXXXXXXXXXXGXXXXXXXXXXXXXXXXXXXGXXXXXXXXXXXXXXXXXXX,0,300,0
24129,13,0,13,51,236,0,0,248,167,81,GXXXXXXXXXXXXXXXXXXXGXXXXXXXXXXXXXXXXXXXGXXXXXXXXXXXXXXXXXXXGXXXXXXXXXXXXXXXXXXXGXXXXXXXXXXXXXXXXXXXGXXXXXXXXXXXXXXXXXXXGXXXXXXXXXXXXXXXXXXXGXXXXXXXXXXXXXXXXXXXGXXXXXXXXXXXXXXXXXXXGXXXXXXXXXXXXXXXXXXXGXXXXXXXXXXXXXXXXXXXGXXXXXXXXXXXXXXXXXXXGXXXXXXXXXXXXXXXXXXX,0,300,0

24150,13,0,13,58,229,0,0,241,163,78,GXXXXXXXXXXXXXXXXXXXGXXXXXXXXXXXXXXXXXXXGXXXXXXXXXXXXXXXXXXXGXXXXXXXXXXXXXXXXXXXGXXXXXXXXXXXXXXXXXXXGXXXXXXXXXXXXXXXXXXXGXXXXXXXXXXXXXXXXXXXGXXXXXXXXXXXXXXXXXXXGXXXXXXXXXXXXXXXXXXXGXXXXXXXXXXXXXXXXXXXGXXXXXXXXXXXXXXXXXXXGXXXXXXXXXXXXXXXXXXXGXXXXXXXXXXXXXXXXXXX,0,300,0
24171,13,0,13,54,233,0,0,243,165,78,GXXXXXXXXXXXXXXXXXXXGXXXXXXXXXXXXXXXXXXXGXXXXXXXXXXXXXXXXXXXGXXXXXXXXXXXXXXXXXXXGXXXXXXXXXXXXXXXXXXXGXXXXXXXXXXXXXXXXXXXGXXXXXXXXXXXXXXXXXXXGXXXXXXXXXXXXXXXXXXXGXXXXXXXXXXXXXXXXXXXGXXXXXXXXXXXXXXXXXXXGXXXXXXXXXXXXXXXXXXXGXXXXXXXXXXXXXXXXXXXGXXXXXXXXXXXXXXXXXXX,0,300,0
24192,13,0,13,54,233,0,0,245,166,79,GXXXXXXXXXXXXXXXXXXXGXXXXXXXXXXXXXXXXXXXGXXXXXXXXXXXXXXXXXXXGXXXXXXXXXXXXXXXXXXXGXXXXXXXXXXXXXXXXXXXGXXXXXXXXXXXXXXXXXXXGXXXXXXXXXXXXXXXXXXXGXXXXXXXXXXXXXXXXXXXGXXXXXXXXXXXXXXXXXXXGXXXXXXXXXXXXXXXXXXXGXXXXXXXXXXXXXXXXXXXGXXXXXXXXXXXXXXXXXXXGXXXXXXXXXXXXXXXXXXX,0,300,0
24213,13,0,13,57,230,0,0,242,165,77,GXXXXXXXXXXXXXXXXXXXGXXXXXXXXXXXXXXXXXXXGXXXXXXXXXXXXXXXXXXXGXXXXXXXXXXXXXXXXXXXGXXXXXXXXXXXXXXXXXXXGXXXXXXXXXXXXXXXXXXXGXXXXXXXXXXXXXXXXXXXGXXXXXXXXXXXXXXXXXXXGXXXXXXXXXXXXXXXXXXXGXXXXXXXXXXXXXXXXXXXGXXXXXXXXXXXXXXXXXXXGXXXXXXXXXXXXXXXXXXXGXXXXXXXXXXXXXXXXXXX,0,300,0
24234,13,0,13,48,239,0,0,251,166,85,GXXXXXXXXXXXXXXXXXXXGXXXXXXXXXXXXXXXXXXXGXXXXXXXXXXXXXXXXXXXGXXXXXXXXXXXXXXXXXXXGXXXXXXXXXXXXXXXXXXXGXXXXXXXXXXXXXXXXXXXGXXXXXXXXXXXXXXXXXXXGXXXXXXXXXXXXXXXXXXXGXXXXXXXXXXXXXXXXXXXGXXXXXXXXXXXXXXXXXXXGXXXXXXXXXXXXXXXXXXXGXXXXXXXXXXXXXXXXXXXGXXXXXXXXXXXXXXXXXXX,0,300,0

24255,13,0,13,45,242,0,0,252,165,87,GXXXXXXXXXXXXXXXXXXXGXXXXXXXXXXXXXXXXXXXGXXXXXXXXXXXXXXXXXXXGXXXXXXXXXXXXXXXXXXXGXXXXXXXXXXXXXXXXXXXGXXXXXXXXXXXXXXXXXXXGXXXXXXXXXXXXXXXXXXXGXXXXXXXXXXXXXXXXXXXGXXXXXXXXXXXXXXXXXXXGXXXXXXXXXXXXXXXXXXXGXXXXXXXXXXXXXXXXXXXGXXXXXXXXXXXXXXXXXXXGXXXXXXXXXXXXXXXXXXX,0,300,0
24276,13,0,13,41,246,0,0,258,164,94,GXXXXXXXXXXXXXXXXXXXGXXXXXXXXXXXXXXXXXXXGXXXXXXXXXXXXXXXXXXXGXXXXXXXXXXXXXXXXXXXGXXXXXXXXXXXXXXXXXXXGXXXXXXXXXXXXXXXXXXXGXXXXXXXXXXXXXXXXXXXGXXXXXXXXXXXXXXXXXXXGXXXXXXXXXXXXXXXXXXXGXXXXXXXXXXXXXXXXXXXGXXXXXXXXXXXXXXXXXXXGXXXXXXXXXXXXXXXXXXXGXXXXXXXXXXXXXXXXXXX,0,300,0
24297,13,0,13,42,245,0,0,257,169,88,GXXXXXXXXXXXXXXXXXXXGXXXXXXXXXXXXXXXXXXXGXXXXXXXXXXXXXXXXXXXGXXXXXXXXXXXXXXXXXXXGXXXXXXXXXXXXXXXXXXXGXXXXXXXXXXXXXXXXXXXGXXXXXXXXXXXXXXXXXXXGXXXXXXXXXXXXXXXXXXXGXXXXXXXXXXXXXXXXXXXGXXXXXXXXXXXXXXXXXXXGXXXXXXXXXXXXXXXXXXXGXXXXXXXXXXXXXXXXXXXGXXXXXXXXXXXXXXXXXXX,0,300,0
24318,13,0,13,44,243,0,0,255,166,89,GXXXXXXXXXXXXXXXXXXXGXXXXXXXXXXXXXXXXXXXGXXXXXXXXXXXXXXXXXXXGXXXXXXXXXXXXXXXXXXXGXXXXXXXXXXXXXXXXXXXGXXXXXXXXXXXXXXXXXXXGXXXXXXXXXXXXXXXXXXXGXXXXXXXXXXXXXXXXXXXGXXXXXXXXXXXXXXXXXXXGXXXXXXXXXXXXXXXXXXXGXXXXXXXXXXXXXXXXXXXGXXXXXXXXXXXXXXXXXXXGXXXXXXXXXXXXXXXXXXX,0,300,0
24339,13,0,13,49,238,0,0,250,162,88,GXXXXXXXXXXXXXXXXXXXGXXXXXXXXXXXXXXXXXXXGXXXXXXXXXXXXXXXXXXXGXXXXXXXXXXXXXXXXXXXGXXXXXXXXXXXXXXXXXXXGXXXXXXXXXXXXXXXXXXXGXXXXXXXXXXXXXXXXXXXGXXXXXXXXXXXXXXXXXXXGXXXXXXXXXXXXXXXXXXXGXXXXXXXXXXXXXXXXXXXGXXXXXXXXXXXXXXXXXXXGXXXXXXXXXXXXXXXXXXXGXXXXXXXXXXXXXXXXXXX,0,300,0

24360,13,0,13,45,242,0,0,254,163,91,GXXXXXXXXXXXXXXXXXXXGXXXXXXXXXXXXXXXXXXXGXXXXXXXXXXXXXXXXXXXGXXXXXXXXXXXXXXXXXXXGXXXXXXXXXXXXXXXXXXXGXXXXXXXXXXXXXXXXXXXGXXXXXXXXXXXXXXXXXXXGXXXXXXXXXXXXXXXXXXXGXXXXXXXXXXXXXXXXXXXGXXXXXXXXXXXXXXXXXXXGXXXXXXXXXXXXXXXXXXXGXXXXXXXXXXXXXXXXXXXGXXXXXXXXXXXXXXXXXXX,0,300,0
24381,13,0,13,47,240,0,0,252,160,92,GXXXXXXXXXXXXXXXXXXXGXXXXXXXXXXXXXXXXXXXGXXXXXXXXXXXXXXXXXXXGXXXXXXXXXXXXXXXXXXXGXXXXXXXXXXXXXXXXXXXGXXXXXXXXXXXXXXXXXXXGXXXXXXXXXXXXXXXXXXXGXXXXXXXXXXXXXXXXXXXGXXXXXXXXXXXXXXXXXXXGXXXXXXXXXXXXXXXXXXXGXXXXXXXXXXXXXXXXXXXGXXXXXXXXXXXXXXXXXXXGXXXXXXXXXXXXXXXXXXX,0,300,0
24402,13,0,13,46,241,0,0,253,162,91,GXXXXXXXXXXXXXXXXXXXGXXXXXXXXXXXXXXXXXXXGXXXXXXXXXXXXXXXXXXXGXXXXXXXXXXXXXXXXXXXGXXXXXXXXXXXXXXXXXXXGXXXXXXXXXXXXXXXXXXXGXXXXXXXXXXXXXXXXXXXGXXXXXXXXXXXXXXXXXXXGXXXXXXXXXXXXXXXXXXXGXXXXXXXXXXXXXXXXXXXGXXXXXXXXXXXXXXXXXXXGXXXXXXXXXXXXXXXXXXXGXXXXXXXXXXXXXXXXXXX,0,300,0
24423,13,0,13,43,244,0,0,255,161,94,GXXXXXXXXXXXXXXXXXXXGXXXXXXXXXXXXXXXXXXXGXXXXXXXXXXXXXXXXXXXGXXXXXXXXXXXXXXXXXXXGXXXXXXXXXXXXXXXXXXXGXXXXXXXXXXXXXXXXXXXGXXXXXXXXXXXXXXXXXXXGXXXXXXXXXXXXXXXXXXXGXXXXXXXXXXXXXXXXXXXGXXXXXXXXXXXXXXXXXXXGXXXXXXXXXXXXXXXXXXXGXXXXXXXXXXXXXXXXXXXGXXXXXXXXXXXXXXXXXXX,0,300,0
24444,13,0,13,42,245,0,0,258,162,96,GXXXXXXXXXXXXXXXXXXXGXXXXXXXXXXXXXXXXXXXGXXXXXXXXXXXXXXXXXXXGXXXXXXXXXXXXXXXXXXXGXXXXXXXXXXXXXXXXXXXGXXXXXXXXXXXXXXXXXXXGXXXXXXXXXXXXXXXXXXXGXXXXXXXXXXXXXXXXXXXGXXXXXXXXXXXXXXXXXXXGXXXXXXXXXXXXXXXXXXXGXXXXXXXXXXXXXXXXXXXGXXXXXXXXXXXXXXXXXXXGXXXXXXXXXXXXXXXXXXX,0,300,0

24465,13,0,13,40,247,0,0,260,165,95,GXXXXXXXXXXXXXXXXXXXGXXXXXXXXXXXXXXXXXXXGXXXXXXXXXXXXXXXXXXXGXXXXXXXXXXXXXXXXXXXGXXXXXXXXXXXXXXXXXXXGXXXXXXXXXXXXXXXXXXXGXXXXXXXXXXXXXXXXXXXGXXXXXXXXXXXXXXXXXXXGXXXXXXXXXXXXXXXXXXXGXXXXXXXXXXXXXXXXXXXGXXXXXXXXXXXXXXXXXXXGXXXXXXXXXXXXXXXXXXXGXXXXXXXXXXXXXXXXXXX,0,300,0
24486,14,1,13,41,245,0,0,258,169,89,GXXXXXXXXXXXXXXXXXXXGXXXXXXXXXXXXXXXXXXXGXXXXXXXXXXXXXXXXXXXGXXXXXXXXXXXXXXXXXXXGXXXXXXXXXXXXXXXXXXXGAXXXXXXXXXXXXXXXXXXGXXXXXXXXXXXXXXXXXXXGXXXXXXXXXXXXXXXXXXXGXXXXXXXXXXXXXXXXXXXGXXXXXXXXXXXXXXXXXXXGXXXXXXXXXXXXXXXXXXXGXXXXXXXXXXXXXXXXXXXGXXXXXXXXXXXXXXXXXXX,0,300,0
24507,14,1,13,45,241,0,0,254,169,85,GXXXXXXXXXXXXXXXXXXXGXXXXXXXXXXXXXXXXXXXGXXXXXXXXXXXXXXXXXXXGXXXXXXXXXXXXXXXXXXXGXXXXXXXXXXXXXXXXXXXGAXXXXXXXXXXXXXXXXXXGXXXXXXXXXXXXXXXXXXXGXXXXXXXXXXXXXXXXXXXGXXXXXXXXXXXXXXXXXXXGXXXXXXXXXXXXXXXXXXXGXXXXXXXXXXXXXXXXXXXGXXXXXXXXXXXXXXXXXXXGXXXXXXXXXXXXXXXXXXX,0,300,0
24528,14,0,14,51,235,0,0,248,165,83,GXXXXXXXXXXXXXXXXXXXGXXXXXXXXXXXXXXXXXXXGXXXXXXXXXXXXXXXXXXXGXXXXXXXXXXXXXXXXXXXGXXXXXXXXXXXXXXXXXXXGOXXXXXXXXXXXXXXXXXXGXXXXXXXXXXXXXXXXXXXGXXXXXXXXXXXXXXXXXXXGXXXXXXXXXXXXXXXXXXXGXXXXXXXXXXXXXXXXXXXGXXXXXXXXXXXXXXXXXXXGXXXXXXXXXXXXXXXXXXXGXXXXXXXXXXXXXXXXXXX,0,300,0
24549,14,0,14,55,231,0,0,244,166,78,GXXXXXXXXXXXXXXXXXXXGXXXXXXXXXXXXXXXXXXXGXXXXXXXXXXXXXXXXXXXGXXXXXXXXXXXXXXXXXXXGXXXXXXXXXXXXXXXXXXXGOXXXXXXXXXXXXXXXXXXGXXXXXXXXXXXXXXXXXXXGXXXXXXXXXXXXXXXXXXXGXXXXXXXXXXXXXXXXXXXGXXXXXXXXXXXXXXXXXXXGXXXXXXXXXXXXXXXXXXXGXXXXXXXXXXXXXXXXXXXGXXXXXXXXXXXXXXXXXXX,0,300,0

24570,13,0,13,58,229,0,0,242,165,77,GXXXXXXXXXXXXXXXXXXXGXXXXXXXXXXXXXXXXXXXGXXXXXXXXXXXXXXXXXXXGXXXXXXXXXXXXXXXXXXXGXXXXXXXXXXXXXXXXXXXGXXXXXXXXXXXXXXXXXXXGXXXXXXXXXXXXXXXXXXXGXXXXXXXXXXXXXXXXXXXGXXXXXXXXXXXXXXXXXXXGXXXXXXXXXXXXXXXXXXXGXXXXXXXXXXXXXXXXXXXGXXXXXXXXXXXXXXXXXXXGXXXXXXXXXXXXXXXXXXX,0,300,0
24591,13,0,13,56,231,0,0,244,172,72,GXXXXXXXXXXXXXXXXXXXGXXXXXXXXXXXXXXXXXXXGXXXXXXXXXXXXXXXXXXXGXXXXXXXXXXXXXXXXXXXGXXXXXXXXXXXXXXXXXXXGXXXXXXXXXXXXXXXXXXXGXXXXXXXXXXXXXXXXXXXGXXXXXXXXXXXXXXXXXXXGXXXXXXXXXXXXXXXXXXXGXXXXXXXXXXXXXXXXXXXGXXXXXXXXXXXXXXXXXXXGXXXXXXXXXXXXXXXXXXXGXXXXXXXXXXXXXXXXXXX,0,300,0
24612,13,0,13,51,236,0,0,248,173,75,GXXXXXXXXXXXXXXXXXXXGXXXXXXXXXXXXXXXXXXXGXXXXXXXXXXXXXXXXXXXGXXXXXXXXXXXXXXXXXXXGXXXXXXXXXXXXXXXXXXXGXXXXXXXXXXXXXXXXXXXGXXXXXXXXXXXXXXXXXXXGXXXXXXXXXXXXXXXXXXXGXXXXXXXXXXXXXXXXXXXGXXXXXXXXXXXXXXXXXXXGXXXXXXXXXXXXXXXXXXXGXXXXXXXXXXXXXXXXXXXGXXXXXXXXXXXXXXXXXXX,0,300,0
24633,13,0,13,52,235,0,0,247,175,72,GXXXXXXXXXXXXXXXXXXXGXXXXXXXXXXXXXXXXXXXGXXXXXXXXXXXXXXXXXXXGXXXXXXXXXXXXXXXXXXXGXXXXXXXXXXXXXXXXXXXGXXXXXXXXXXXXXXXXXXXGXXXXXXXXXXXXXXXXXXXGXXXXXXXXXXXXXXXXXXXGXXXXXXXXXXXXXXXXXXXGXXXXXXXXXXXXXXXXXXXGXXXXXXXXXXXXXXXXXXXGXXXXXXXXXXXXXXXXXXXGXXXXXXXXXXXXXXXXXXX,0,300,0
24654,13,0,13,53,234,0,0,246,175,71,GXXXXXXXXXXXXXXXXXXXGXXXXXXXXXXXXXXXXXXXGXXXXXXXXXXXXXXXXXXXGXXXXXXXXXXXXXXXXXXXGXXXXXXXXXXXXXXXXXXXGXXXXXXXXXXXXXXXXXXXGXXXXXXXXXXXXXXXXXXXGXXXXXXXXXXXXXXXXXXXGXXXXXXXXXXXXXXXXXXXGXXXXXXXXXXXXXXXXXXXGXXXXXXXXXXXXXXXXXXXGXXXXXXXXXXXXXXXXXXXGXXXXXXXXXXXXXXXXXXX,0,300,0

24675,13,0,13,52,235,0,0,247,173,74,GXXXXXXXXXXXXXXXXXXXGXXXXXXXXXXXXXXXXXXXGXXXXXXXXXXXXXXXXXXXGXXXXXXXXXXXXXXXXXXXGXXXXXXXXXXXXXXXXXXXGXXXXXXXXXXXXXXXXXXXGXXXXXXXXXXXXXXXXXXXGXXXXXXXXXXXXXXXXXXXGXXXXXXXXXXXXXXXXXXXGXXXXXXXXXXXXXXXXXXXGXXXXXXXXXXXXXXXXXXXGXXXXXXXXXXXXXXXXXXXGXXXXXXXXXXXXXXXXXXX,0,300,0
24696,14,1,13,54,232,0,0,244,169,75,GXXXXXXXXXXXXXXXXXXXGXXXXXXXXXXXXXXXXXXXGAXXXXXXXXXXXXXXXXXXGXXXXXXXXXXXXXXXXXXXGXXXXXXXXXXXXXXXXXXXGXXXXXXXXXXXXXXXXXXXGXXXXXXXXXXXXXXXXXXXGXXXXXXXXXXXXXXXXXXXGXXXXXXXXXXXXXXXXXXXGXXXXXXXXXXXXXXXXXXXGXXXXXXXXXXXXXXXXXXXGXXXXXXXXXXXXXXXXXXXGXXXXXXXXXXXXXXXXXXX,0,300,0
24717,14,1,13,55,231,0,0,243,166,77,GXXXXXXXXXXXXXXXXXXXGXXXXXXXXXXXXXXXXXXXGAXXXXXXXXXXXXXXXXXXGXXXXXXXXXXXXXXXXXXXGXXXXXXXXXXXXXXXXXXXGXXXXXXXXXXXXXXXXXXXGXXXXXXXXXXXXXXXXXXXGXXXXXXXXXXXXXXXXXXXGXXXXXXXXXXXXXXXXXXXGXXXXXXXXXXXXXXXXXXXGXXXXXXXXXXXXXXXXXXXGXXXXXXXXXXXXXXXXXXXGXXXXXXXXXXXXXXXXXXX,0,300,0
24738,14,1,13,55,231,0,0,242,164,78,GXXXXXXXXXXXXXXXXXXXGXXXXXXXXXXXXXXXXXXXGAXXXXXXXXXXXXXXXXXXGXXXXXXXXXXXXXXXXXXXGXXXXXXXXXXXXXXXXXXXGXXXXXXXXXXXXXXXXXXXGXXXXXXXXXXXXXXXXXXXGXXXXXXXXXXXXXXXXXXXGXXXXXXXXXXXXXXXXXXXGXXXXXXXXXXXXXXXXXXXGXXXXXXXXXXXXXXXXXXXGXXXXXXXXXXXXXXXXXXXGXXXXXXXXXXXXXXXXXXX,0,300,0
24759,14,1,13,54,232,0,0,244,166,78,GXXXXXXXXXXXXXXXXXXXGXXXXXXXXXXXXXXXXXXXGAXXXXXXXXXXXXXXXXXXGXXXXXXXXXXXXXXXXXXXGXXXXXXXXXXXXXXXXXXXGXXXXXXXXXXXXXXXXXXXGXXXXXXXXXXXXXXXXXXXGXXXXXXXXXXXXXXXXXXXGXXXXXXXXXXXXXXXXXXXGXXXXXXXXXXXXXXXXXXXGXXXXXXXXXXXXXXXXXXXGXXXXXXXXXXXXXXXXXXXGXXXXXXXXXXXXXXXXXXX,0,300,0

24780,14,1,13,52,234,0,0,246,169,77,GXXXXXXXXXXXXXXXXXXXGXXXXXXXXXXXXXXXXXXXGAXXXXXXXXXXXXXXXXXXGXXXXXXXXXXXXXXXXXXXGXXXXXXXXXXXXXXXXXXXGXXXXXXXXXXXXXXXXXXXGXXXXXXXXXXXXXXXXXXXGXXXXXXXXXXXXXXXXXXXGXXXXXXXXXXXXXXXXXXXGXXXXXXXXXXXXXXXXXXXGXXXXXXXXXXXXXXXXXXXGXXXXXXXXXXXXXXXXXXXGXXXXXXXXXXXXXXXXXXX,0,300,0
24801,13,0,13,50,237,0,0,247,165,82,GXXXXXXXXXXXXXXXXXXXGXXXXXXXXXXXXXXXXXXXGXXXXXXXXXXXXXXXXXXXGXXXXXXXXXXXXXXXXXXXGXXXXXXXXXXXXXXXXXXXGXXXXXXXXXXXXXXXXXXXGXXXXXXXXXXXXXXXXXXXGXXXXXXXXXXXXXXXXXXXGXXXXXXXXXXXXXXXXXXXGXXXXXXXXXXXXXXXXXXXGXXXXXXXXXXXXXXXXXXXGXXXXXXXXXXXXXXXXXXXGXXXXXXXXXXXXXXXXXXX,0,300,0
24822,13,0,13,47,240,0,0,252,169,83,GXXXXXXXXXXXXXXXXXXXGXXXXXXXXXXXXXXXXXXXGXXXXXXXXXXXXXXXXXXXGXXXXXXXXXXXXXXXXXXXGXXXXXXXXXXXXXXXXXXXGXXXXXXXXXXXXXXXXXXXGXXXXXXXXXXXXXXXXXXXGXXXXXXXXXXXXXXXXXXXGXXXXXXXXXXXXXXXXXXXGXXXXXXXXXXXXXXXXXXXGXXXXXXXXXXXXXXXXXXXGXXXXXXXXXXXXXXXXXXXGXXXXXXXXXXXXXXXXXXX,0,300,0
24843,13,0,13,47,240,0,0,252,170,82,GXXXXXXXXXXXXXXXXXXXGXXXXXXXXXXXXXXXXXXXGXXXXXXXXXXXXXXXXXXXGXXXXXXXXXXXXXXXXXXXGXXXXXXXXXXXXXXXXXXXGXXXXXXXXXXXXXXXXXXXGXXXXXXXXXXXXXXXXXXXGXXXXXXXXXXXXXXXXXXXGXXXXXXXXXXXXXXXXXXXGXXXXXXXXXXXXXXXXXXXGXXXXXXXXXXXXXXXXXXXGXXXXXXXXXXXXXXXXXXXGXXXXXXXXXXXXXXXXXXX,0,300,0
24864,13,0,13,46,241,0,0,253,170,83,GXXXXXXXXXXXXXXXXXXXGXXXXXXXXXXXXXXXXXXXGXXXXXXXXXXXXXXXXXXXGXXXXXXXXXXXXXXXXXXXGXXXXXXXXXXXXXXXXXXXGXXXXXXXXXXXXXXXXXXXGXXXXXXXXXXXXXXXXXXXGXXXXXXXXXXXXXXXXXXXGXXXXXXXXXXXXXXXXXXXGXXXXXXXXXXXXXXXXXXXGXXXXXXXXXXXXXXXXXXXGXXXXXXXXXXXXXXXXXXXGXXXXXXXXXXXXXXXXXXX,0,300,0

24885,13,0,13,43,244,0,0,256,166,90,GXXXXXXXXXXXXXXXXXXXGXXXXXXXXXXXXXXXXXXXGXXXXXXXXXXXXXXXXXXXGXXXXXXXXXXXXXXXXXXXGXXXXXXXXXXXXXXXXXXXGXXXXXXXXXXXXXXXXXXXGXXXXXXXXXXXXXXXXXXXGXXXXXXXXXXXXXXXXXXXGXXXXXXXXXXXXXXXXXXXGXXXXXXXXXXXXXXXXXXXGXXXXXXXXXXXXXXXXXXXGXXXXXXXXXXXXXXXXXXXGXXXXXXXXXXXXXXXXXXX,0,300,0
24906,13,0,13,39,248,0,0,260,169,91,GXXXXXXXXXXXXXXXXXXXGXXXXXXXXXXXXXXXXXXXGXXXXXXXXXXXXXXXXXXXGXXXXXXXXXXXXXXXXXXXGXXXXXXXXXXXXXXXXXXXGXXXXXXXXXXXXXXXXXXXGXXXXXXXXXXXXXXXXXXXGXXXXXXXXXXXXXXXXXXXGXXXXXXXXXXXXXXXXXXXGXXXXXXXXXXXXXXXXXXXGXXXXXXXXXXXXXXXXXXXGXXXXXXXXXXXXXXXXXXXGXXXXXXXXXXXXXXXXXXX,0,300,0
24927,13,0,13,38,249,0,0,260,168,92,GXXXXXXXXXXXXXXXXXXXGXXXXXXXXXXXXXXXXXXXGXXXXXXXXXXXXXXXXXXXGXXXXXXXXXXXXXXXXXXXGXXXXXXXXXXXXXXXXXXXGXXXXXXXXXXXXXXXXXXXGXXXXXXXXXXXXXXXXXXXGXXXXXXXXXXXXXXXXXXXGXXXXXXXXXXXXXXXXXXXGXXXXXXXXXXXXXXXXXXXGXXXXXXXXXXXXXXXXXXXGXXXXXXXXXXXXXXXXXXXGXXXXXXXXXXXXXXXXXXX,0,300,0
24948,13,0,13,37,250,0,0,262,168,94,GXXXXXXXXXXXXXXXXXXXGXXXXXXXXXXXXXXXXXXXGXXXXXXXXXXXXXXXXXXXGXXXXXXXXXXXXXXXXXXXGXXXXXXXXXXXXXXXXXXXGXXXXXXXXXXXXXXXXXXXGXXXXXXXXXXXXXXXXXXXGXXXXXXXXXXXXXXXXXXXGXXXXXXXXXXXXXXXXXXXGXXXXXXXXXXXXXXXXXXXGXXXXXXXXXXXXXXXXXXXGXXXXXXXXXXXXXXXXXXXGXXXXXXXXXXXXXXXXXXX,0,300,0
24969,13,0,13,34,253,0,0,265,169,96,GXXXXXXXXXXXXXXXXXXXGXXXXXXXXXXXXXXXXXXXGXXXXXXXXXXXXXXXXXXXGXXXXXXXXXXXXXXXXXXXGXXXXXXXXXXXXXXXXXXXGXXXXXXXXXXXXXXXXXXXGXXXXXXXXXXXXXXXXXXXGXXXXXXXXXXXXXXXXXXXGXXXXXXXXXXXXXXXXXXXGXXXXXXXXXXXXXXXXXXXGXXXXXXXXXXXXXXXXXXXGXXXXXXXXXXXXXXXXXXXGXXXXXXXXXXXXXXXXXXX,0,300,0

24990,13,0,13,31,256,0,0,269,174,95,GXXXXXXXXXXXXXXXXXXXGXXXXXXXXXXXXXXXXXXXGXXXXXXXXXXXXXXXXXXXGXXXXXXXXXXXXXXXXXXXGXXXXXXXXXXXXXXXXXXXGXXXXXXXXXXXXXXXXXXXGXXXXXXXXXXXXXXXXXXXGXXXXXXXXXXXXXXXXXXXGXXXXXXXXXXXXXXXXXXXGXXXXXXXXXXXXXXXXXXXGXXXXXXXXXXXXXXXXXXXGXXXXXXXXXXXXXXXXXXXGXXXXXXXXXXXXXXXXXXX,0,300,0
25011,13,0,13,32,255,0,0,268,178,90,GXXXXXXXXXXXXXXXXXXXGXXXXXXXXXXXXXXXXXXXGXXXXXXXXXXXXXXXXXXXGXXXXXXXXXXXXXXXXXXXGXXXXXXXXXXXXXXXXXXXGXXXXXXXXXXXXXXXXXXXGXXXXXXXXXXXXXXXXXXXGXXXXXXXXXXXXXXXXXXXGXXXXXXXXXXXXXXXXXXXGXXXXXXXXXXXXXXXXXXXGXXXXXXXXXXXXXXXXXXXGXXXXXXXXXXXXXXXXXXXGXXXXXXXXXXXXXXXXXXX,0,300,0
25032,13,0,13,38,249,0,0,262,172,90,GXXXXXXXXXXXXXXXXXXXGXXXXXXXXXXXXXXXXXXXGXXXXXXXXXXXXXXXXXXXGXXXXXXXXXXXXXXXXXXXGXXXXXXXXXXXXXXXXXXXGXXXXXXXXXXXXXXXXXXXGXXXXXXXXXXXXXXXXXXXGXXXXXXXXXXXXXXXXXXXGXXXXXXXXXXXXXXXXXXXGXXXXXXXXXXXXXXXXXXXGXXXXXXXXXXXXXXXXXXXGXXXXXXXXXXXXXXXXXXXGXXXXXXXXXXXXXXXXXXX,0,300,0
25053,13,0,13,39,248,0,0,262,172,90,GXXXXXXXXXXXXXXXXXXXGXXXXXXXXXXXXXXXXXXXGXXXXXXXXXXXXXXXXXXXGXXXXXXXXXXXXXXXXXXXGXXXXXXXXXXXXXXXXXXXGXXXXXXXXXXXXXXXXXXXGXXXXXXXXXXXXXXXXXXXGXXXXXXXXXXXXXXXXXXXGXXXXXXXXXXXXXXXXXXXGXXXXXXXXXXXXXXXXXXXGXXXXXXXXXXXXXXXXXXXGXXXXXXXXXXXXXXXXXXXGXXXXXXXXXXXXXXXXXXX,0,300,0
25074,13,0,13,41,246,0,0,260,170,90,GXXXXXXXXXXXXXXXXXXXGXXXXXXXXXXXXXXXXXXXGXXXXXXXXXXXXXXXXXXXGXXXXXXXXXXXXXXXXXXXGXXXXXXXXXXXXXXXXXXXGXXXXXXXXXXXXXXXXXXXGXXXXXXXXXXXXXXXXXXXGXXXXXXXXXXXXXXXXXXXGXXXXXXXXXXXXXXXXXXXGXXXXXXXXXXXXXXXXXXXGXXXXXXXXXXXXXXXXXXXGXXXXXXXXXXXXXXXXXXXGXXXXXXXXXXXXXXXXXXX,0,300,0

25095,13,0,13,40,247,0,0,261,171,90,GXXXXXXXXXXXXXXXXXXXGXXXXXXXXXXXXXXXXXXXGXXXXXXXXXXXXXXXXXXXGXXXXXXXXXXXXXXXXXXXGXXXXXXXXXXXXXXXXXXXGXXXXXXXXXXXXXXXXXXXGXXXXXXXXXXXXXXXXXXXGXXXXXXXXXXXXXXXXXXXGXXXXXXXXXXXXXXXXXXXGXXXXXXXXXXXXXXXXXXXGXXXXXXXXXXXXXXXXXXXGXXXXXXXXXXXXXXXXXXXGXXXXXXXXXXXXXXXXXXX,0,300,0
25116,13,0,13,39,248,0,0,261,172,89,GXXXXXXXXXXXXXXXXXXXGXXXXXXXXXXXXXXXXXXXGXXXXXXXXXXXXXXXXXXXGXXXXXXXXXXXXXXXXXXXGXXXXXXXXXXXXXXXXXXXGXXXXXXXXXXXXXXXXXXXGXXXXXXXXXXXXXXXXXXXGXXXXXXXXXXXXXXXXXXXGXXXXXXXXXXXXXXXXXXXGXXXXXXXXXXXXXXXXXXXGXXXXXXXXXXXXXXXXXXXGXXXXXXXXXXXXXXXXXXXGXXXXXXXXXXXXXXXXXXX,0,300,0
25137,13,0,13,39,248,0,0,261,173,88,GXXXXXXXXXXXXXXXXXXXGXXXXXXXXXXXXXXXXXXXGXXXXXXXXXXXXXXXXXXXGXXXXXXXXXXXXXXXXXXXGXXXXXXXXXXXXXXXXXXXGXXXXXXXXXXXXXXXXXXXGXXXXXXXXXXXXXXXXXXXGXXXXXXXXXXXXXXXXXXXGXXXXXXXXXXXXXXXXXXXGXXXXXXXXXXXXXXXXXXXGXXXXXXXXXXXXXXXXXXXGXXXXXXXXXXXXXXXXXXXGXXXXXXXXXXXXXXXXXXX,0,300,0
25158,13,0,13,39,248,0,0,261,171,90,GXXXXXXXXXXXXXXXXXXXGXXXXXXXXXXXXXXXXXXXGXXXXXXXXXXXXXXXXXXXGXXXXXXXXXXXXXXXXXXXGXXXXXXXXXXXXXXXXXXXGXXXXXXXXXXXXXXXXXXXGXXXXXXXXXXXXXXXXXXXGXXXXXXXXXXXXXXXXXXXGXXXXXXXXXXXXXXXXXXXGXXXXXXXXXXXXXXXXXXXGXXXXXXXXXXXXXXXXXXXGXXXXXXXXXXXXXXXXXXXGXXXXXXXXXXXXXXXXXXX,0,300,0
25179,13,0,13,41,246,0,0,259,172,87,GXXXXXXXXXXXXXXXXXXXGXXXXXXXXXXXXXXXXXXXGXXXXXXXXXXXXXXXXXXXGXXXXXXXXXXXXXXXXXXXGXXXXXXXXXXXXXXXXXXXGXXXXXXXXXXXXXXXXXXXGXXXXXXXXXXXXXXXXXXXGXXXXXXXXXXXXXXXXXXXGXXXXXXXXXXXXXXXXXXXGXXXXXXXXXXXXXXXXXXXGXXXXXXXXXXXXXXXXXXXGXXXXXXXXXXXXXXXXXXXGXXXXXXXXXXXXXXXXXXX,0,300,0

25200,13,0,13,43,244,0,0,257,172,85,GXXXXXXXXXXXXXXXXXXXGXXXXXXXXXXXXXXXXXXXGXXXXXXXXXXXXXXXXXXXGXXXXXXXXXXXXXXXXXXXGXXXXXXXXXXXXXXXXXXXGXXXXXXXXXXXXXXXXXXXGXXXXXXXXXXXXXXXXXXXGXXXXXXXXXXXXXXXXXXXGXXXXXXXXXXXXXXXXXXXGXXXXXXXXXXXXXXXXXXXGXXXXXXXXXXXXXXXXXXXGXXXXXXXXXXXXXXXXXXXGXXXXXXXXXXXXXXXXXXX,0,300,0
25221,13,0,13,48,239,0,0,252,172,80,GXXXXXXXXXXXXXXXXXXXGXXXXXXXXXXXXXXXXXXXGXXXXXXXXXXXXXXXXXXXGXXXXXXXXXXXXXXXXXXXGXXXXXXXXXXXXXXXXXXXGXXXXXXXXXXXXXXXXXXXGXXXXXXXXXXXXXXXXXXXGXXXXXXXXXXXXXXXXXXXGXXXXXXXXXXXXXXXXXXXGXXXXXXXXXXXXXXXXXXXGXXXXXXXXXXXXXXXXXXXGXXXXXXXXXXXXXXXXXXXGXXXXXXXXXXXXXXXXXXX,0,300,0
25242,13,0,13,49,238,0,0,251,175,76,GXXXXXXXXXXXXXXXXXXXGXXXXXXXXXXXXXXXXXXXGXXXXXXXXXXXXXXXXXXXGXXXXXXXXXXXXXXXXXXXGXXXXXXXXXXXXXXXXXXXGXXXXXXXXXXXXXXXXXXXGXXXXXXXXXXXXXXXXXXXGXXXXXXXXXXXXXXXXXXXGXXXXXXXXXXXXXXXXXXXGXXXXXXXXXXXXXXXXXXXGXXXXXXXXXXXXXXXXXXXGXXXXXXXXXXXXXXXXXXXGXXXXXXXXXXXXXXXXXXX,0,300,0
25263,13,0,13,54,233,0,0,247,171,76,GXXXXXXXXXXXXXXXXXXXGXXXXXXXXXXXXXXXXXXXGXXXXXXXXXXXXXXXXXXXGXXXXXXXXXXXXXXXXXXXGXXXXXXXXXXXXXXXXXXXGXXXXXXXXXXXXXXXXXXXGXXXXXXXXXXXXXXXXXXXGXXXXXXXXXXXXXXXXXXXGXXXXXXXXXXXXXXXXXXXGXXXXXXXXXXXXXXXXXXXGXXXXXXXXXXXXXXXXXXXGXXXXXXXXXXXXXXXXXXXGXXXXXXXXXXXXXXXXXXX,0,300,0
25284,13,0,13,52,235,0,0,249,171,78,GXXXXXXXXXXXXXXXXXXXGXXXXXXXXXXXXXXXXXXXGXXXXXXXXXXXXXXXXXXXGXXXXXXXXXXXXXXXXXXXGXXXXXXXXXXXXXXXXXXXGXXXXXXXXXXXXXXXXXXXGXXXXXXXXXXXXXXXXXXXGXXXXXXXXXXXXXXXXXXXGXXXXXXXXXXXXXXXXXXXGXXXXXXXXXXXXXXXXXXXGXXXXXXXXXXXXXXXXXXXGXXXXXXXXXXXXXXXXXXXGXXXXXXXXXXXXXXXXXXX,0,300,0

25305,13,0,13,51,236,0,0,250,171,79,GXXXXXXXXXXXXXXXXXXXGXXXXXXXXXXXXXXXXXXXGXXXXXXXXXXXXXXXXXXXGXXXXXXXXXXXXXXXXXXXGXXXXXXXXXXXXXXXXXXXGXXXXXXXXXXXXXXXXXXXGXXXXXXXXXXXXXXXXXXXGXXXXXXXXXXXXXXXXXXXGXXXXXXXXXXXXXXXXXXXGXXXXXXXXXXXXXXXXXXXGXXXXXXXXXXXXXXXXXXXGXXXXXXXXXXXXXXXXXXXGXXXXXXXXXXXXXXXXXXX,0,300,0
25326,13,0,13,50,237,0,0,250,170,80,GXXXXXXXXXXXXXXXXXXXGXXXXXXXXXXXXXXXXXXXGXXXXXXXXXXXXXXXXXXXGXXXXXXXXXXXXXXXXXXXGXXXXXXXXXXXXXXXXXXXGXXXXXXXXXXXXXXXXXXXGXXXXXXXXXXXXXXXXXXXGXXXXXXXXXXXXXXXXXXXGXXXXXXXXXXXXXXXXXXXGXXXXXXXXXXXXXXXXXXXGXXXXXXXXXXXXXXXXXXXGXXXXXXXXXXXXXXXXXXXGXXXXXXXXXXXXXXXXXXX,0,300,0
25347,13,0,13,49,238,0,0,249,167,82,GXXXXXXXXXXXXXXXXXXXGXXXXXXXXXXXXXXXXXXXGXXXXXXXXXXXXXXXXXXXGXXXXXXXXXXXXXXXXXXXGXXXXXXXXXXXXXXXXXXXGXXXXXXXXXXXXXXXXXXXGXXXXXXXXXXXXXXXXXXXGXXXXXXXXXXXXXXXXXXXGXXXXXXXXXXXXXXXXXXXGXXXXXXXXXXXXXXXXXXXGXXXXXXXXXXXXXXXXXXXGXXXXXXXXXXXXXXXXXXXGXXXXXXXXXXXXXXXXXXX,0,300,0
25368,13,0,13,53,234,0,0,246,172,74,GXXXXXXXXXXXXXXXXXXXGXXXXXXXXXXXXXXXXXXXGXXXXXXXXXXXXXXXXXXXGXXXXXXXXXXXXXXXXXXXGXXXXXXXXXXXXXXXXXXXGXXXXXXXXXXXXXXXXXXXGXXXXXXXXXXXXXXXXXXXGXXXXXXXXXXXXXXXXXXXGXXXXXXXXXXXXXXXXXXXGXXXXXXXXXXXXXXXXXXXGXXXXXXXXXXXXXXXXXXXGXXXXXXXXXXXXXXXXXXXGXXXXXXXXXXXXXXXXXXX,0,300,0
25389,13,0,13,57,230,0,0,242,168,74,GXXXXXXXXXXXXXXXXXXXGXXXXXXXXXXXXXXXXXXXGXXXXXXXXXXXXXXXXXXXGXXXXXXXXXXXXXXXXXXXGXXXXXXXXXXXXXXXXXXXGXXXXXXXXXXXXXXXXXXXGXXXXXXXXXXXXXXXXXXXGXXXXXXXXXXXXXXXXXXXGXXXXXXXXXXXXXXXXXXXGXXXXXXXXXXXXXXXXXXXGXXXXXXXXXXXXXXXXXXXGXXXXXXXXXXXXXXXXXXXGXXXXXXXXXXXXXXXXXXX,0,300,0

25410,13,0,13,57,230,0,0,242,171,71,GXXXXXXXXXXXXXXXXXXXGXXXXXXXXXXXXXXXXXXXGXXXXXXXXXXXXXXXXXXXGXXXXXXXXXXXXXXXXXXXGXXXXXXXXXXXXXXXXXXXGXXXXXXXXXXXXXXXXXXXGXXXXXXXXXXXXXXXXXXXGXXXXXXXXXXXXXXXXXXXGXXXXXXXXXXXXXXXXXXXGXXXXXXXXXXXXXXXXXXXGXXXXXXXXXXXXXXXXXXXGXXXXXXXXXXXXXXXXXXXGXXXXXXXXXXXXXXXXXXX,0,300,0
25431,13,0,13,56,231,0,0,243,173,70,GXXXXXXXXXXXXXXXXXXXGXXXXXXXXXXXXXXXXXXXGXXXXXXXXXXXXXXXXXXXGXXXXXXXXXXXXXXXXXXXGXXXXXXXXXXXXXXXXXXXGXXXXXXXXXXXXXXXXXXXGXXXXXXXXXXXXXXXXXXXGXXXXXXXXXXXXXXXXXXXGXXXXXXXXXXXXXXXXXXXGXXXXXXXXXXXXXXXXXXXGXXXXXXXXXXXXXXXXXXXGXXXXXXXXXXXXXXXXXXXGXXXXXXXXXXXXXXXXXXX,0,300,0
25452,13,0,13,55,232,0,0,244,169,75,GXXXXXXXXXXXXXXXXXXXGXXXXXXXXXXXXXXXXXXXGXXXXXXXXXXXXXXXXXXXGXXXXXXXXXXXXXXXXXXXGXXXXXXXXXXXXXXXXXXXGXXXXXXXXXXXXXXXXXXXGXXXXXXXXXXXXXXXXXXXGXXXXXXXXXXXXXXXXXXXGXXXXXXXXXXXXXXXXXXXGXXXXXXXXXXXXXXXXXXXGXXXXXXXXXXXXXXXXXXXGXXXXXXXXXXXXXXXXXXXGXXXXXXXXXXXXXXXXXXX,0,300,0
25473,13,0,13,52,235,0,0,247,172,75,GXXXXXXXXXXXXXXXXXXXGXXXXXXXXXXXXXXXXXXXGXXXXXXXXXXXXXXXXXXXGXXXXXXXXXXXXXXXXXXXGXXXXXXXXXXXXXXXXXXXGXXXXXXXXXXXXXXXXXXXGXXXXXXXXXXXXXXXXXXXGXXXXXXXXXXXXXXXXXXXGXXXXXXXXXXXXXXXXXXXGXXXXXXXXXXXXXXXXXXXGXXXXXXXXXXXXXXXXXXXGXXXXXXXXXXXXXXXXXXXGXXXXXXXXXXXXXXXXXXX,0,300,0
25494,13,0,13,52,235,0,0,246,170,76,GXXXXXXXXXXXXXXXXXXXGXXXXXXXXXXXXXXXXXXXGXXXXXXXXXXXXXXXXXXXGXXXXXXXXXXXXXXXXXXXGXXXXXXXXXXXXXXXXXXXGXXXXXXXXXXXXXXXXXXXGXXXXXXXXXXXXXXXXXXXGXXXXXXXXXXXXXXXXXXXGXXXXXXXXXXXXXXXXXXXGXXXXXXXXXXXXXXXXXXXGXXXXXXXXXXXXXXXXXXXGXXXXXXXXXXXXXXXXXXXGXXXXXXXXXXXXXXXXXXX,0,300,0

25515,13,0,13,52,235,0,0,247,169,78,GXXXXXXXXXXXXXXXXXXXGXXXXXXXXXXXXXXXXXXXGXXXXXXXXXXXXXXXXXXXGXXXXXXXXXXXXXXXXXXXGXXXXXXXXXXXXXXXXXXXGXXXXXXXXXXXXXXXXXXXGXXXXXXXXXXXXXXXXXXXGXXXXXXXXXXXXXXXXXXXGXXXXXXXXXXXXXXXXXXXGXXXXXXXXXXXXXXXXXXXGXXXXXXXXXXXXXXXXXXXGXXXXXXXXXXXXXXXXXXXGXXXXXXXXXXXXXXXXXXX,0,300,0
25536,13,0,13,52,235,0,0,247,167,80,GXXXXXXXXXXXXXXXXXXXGXXXXXXXXXXXXXXXXXXXGXXXXXXXXXXXXXXXXXXXGXXXXXXXXXXXXXXXXXXXGXXXXXXXXXXXXXXXXXXXGXXXXXXXXXXXXXXXXXXXGXXXXXXXXXXXXXXXXXXXGXXXXXXXXXXXXXXXXXXXGXXXXXXXXXXXXXXXXXXXGXXXXXXXXXXXXXXXXXXXGXXXXXXXXXXXXXXXXXXXGXXXXXXXXXXXXXXXXXXXGXXXXXXXXXXXXXXXXXXX,0,300,0
25557,13,0,13,50,237,0,0,248,166,82,GXXXXXXXXXXXXXXXXXXXGXXXXXXXXXXXXXXXXXXXGXXXXXXXXXXXXXXXXXXXGXXXXXXXXXXXXXXXXXXXGXXXXXXXXXXXXXXXXXXXGXXXXXXXXXXXXXXXXXXXGXXXXXXXXXXXXXXXXXXXGXXXXXXXXXXXXXXXXXXXGXXXXXXXXXXXXXXXXXXXGXXXXXXXXXXXXXXXXXXXGXXXXXXXXXXXXXXXXXXXGXXXXXXXXXXXXXXXXXXXGXXXXXXXXXXXXXXXXXXX,0,300,0
25578,13,0,13,46,241,0,0,253,171,82,GXXXXXXXXXXXXXXXXXXXGXXXXXXXXXXXXXXXXXXXGXXXXXXXXXXXXXXXXXXXGXXXXXXXXXXXXXXXXXXXGXXXXXXXXXXXXXXXXXXXGXXXXXXXXXXXXXXXXXXXGXXXXXXXXXXXXXXXXXXXGXXXXXXXXXXXXXXXXXXXGXXXXXXXXXXXXXXXXXXXGXXXXXXXXXXXXXXXXXXXGXXXXXXXXXXXXXXXXXXXGXXXXXXXXXXXXXXXXXXXGXXXXXXXXXXXXXXXXXXX,0,300,0
25599,13,0,13,46,241,0,0,253,171,82,GXXXXXXXXXXXXXXXXXXXGXXXXXXXXXXXXXXXXXXXGXXXXXXXXXXXXXXXXXXXGXXXXXXXXXXXXXXXXXXXGXXXXXXXXXXXXXXXXXXXGXXXXXXXXXXXXXXXXXXXGXXXXXXXXXXXXXXXXXXXGXXXXXXXXXXXXXXXXXXXGXXXXXXXXXXXXXXXXXXXGXXXXXXXXXXXXXXXXXXXGXXXXXXXXXXXXXXXXXXXGXXXXXXXXXXXXXXXXXXXGXXXXXXXXXXXXXXXXXXX,0,300,0

25620,13,0,13,45,242,0,0,254,171,83,GXXXXXXXXXXXXXXXXXXXGXXXXXXXXXXXXXXXXXXXGXXXXXXXXXXXXXXXXXXXGXXXXXXXXXXXXXXXXXXXGXXXXXXXXXXXXXXXXXXXGXXXXXXXXXXXXXXXXXXXGXXXXXXXXXXXXXXXXXXXGXXXXXXXXXXXXXXXXXXXGXXXXXXXXXXXXXXXXXXXGXXXXXXXXXXXXXXXXXXXGXXXXXXXXXXXXXXXXXXXGXXXXXXXXXXXXXXXXXXXGXXXXXXXXXXXXXXXXXXX,0,300,0
25641,13,0,13,46,241,0,0,253,168,85,GXXXXXXXXXXXXXXXXXXXGXXXXXXXXXXXXXXXXXXXGXXXXXXXXXXXXXXXXXXXGXXXXXXXXXXXXXXXXXXXGXXXXXXXXXXXXXXXXXXXGXXXXXXXXXXXXXXXXXXXGXXXXXXXXXXXXXXXXXXXGXXXXXXXXXXXXXXXXXXXGXXXXXXXXXXXXXXXXXXXGXXXXXXXXXXXXXXXXXXXGXXXXXXXXXXXXXXXXXXXGXXXXXXXXXXXXXXXXXXXGXXXXXXXXXXXXXXXXXXX,0,300,0
25662,13,0,13,44,243,0,0,254,170,84,GXXXXXXXXXXXXXXXXXXXGXXXXXXXXXXXXXXXXXXXGXXXXXXXXXXXXXXXXXXXGXXXXXXXXXXXXXXXXXXXGXXXXXXXXXXXXXXXXXXXGXXXXXXXXXXXXXXXXXXXGXXXXXXXXXXXXXXXXXXXGXXXXXXXXXXXXXXXXXXXGXXXXXXXXXXXXXXXXXXXGXXXXXXXXXXXXXXXXXXXGXXXXXXXXXXXXXXXXXXXGXXXXXXXXXXXXXXXXXXXGXXXXXXXXXXXXXXXXXXX,0,300,0
25683,13,0,13,42,245,0,0,258,170,88,GXXXXXXXXXXXXXXXXXXXGXXXXXXXXXXXXXXXXXXXGXXXXXXXXXXXXXXXXXXXGXXXXXXXXXXXXXXXXXXXGXXXXXXXXXXXXXXXXXXXGXXXXXXXXXXXXXXXXXXXGXXXXXXXXXXXXXXXXXXXGXXXXXXXXXXXXXXXXXXXGXXXXXXXXXXXXXXXXXXXGXXXXXXXXXXXXXXXXXXXGXXXXXXXXXXXXXXXXXXXGXXXXXXXXXXXXXXXXXXXGXXXXXXXXXXXXXXXXXXX,0,300,0
25704,13,0,13,39,248,0,0,261,170,91,GXXXXXXXXXXXXXXXXXXXGXXXXXXXXXXXXXXXXXXXGXXXXXXXXXXXXXXXXXXXGXXXXXXXXXXXXXXXXXXXGXXXXXXXXXXXXXXXXXXXGXXXXXXXXXXXXXXXXXXXGXXXXXXXXXXXXXXXXXXXGXXXXXXXXXXXXXXXXXXXGXXXXXXXXXXXXXXXXXXXGXXXXXXXXXXXXXXXXXXXGXXXXXXXXXXXXXXXXXXXGXXXXXXXXXXXXXXXXXXXGXXXXXXXXXXXXXXXXXXX,0,300,0

25725,13,0,13,40,247,0,0,259,168,91,GXXXXXXXXXXXXXXXXXXXGXXXXXXXXXXXXXXXXXXXGXXXXXXXXXXXXXXXXXXXGXXXXXXXXXXXXXXXXXXXGXXXXXXXXXXXXXXXXXXXGXXXXXXXXXXXXXXXXXXXGXXXXXXXXXXXXXXXXXXXGXXXXXXXXXXXXXXXXXXXGXXXXXXXXXXXXXXXXXXXGXXXXXXXXXXXXXXXXXXXGXXXXXXXXXXXXXXXXXXXGXXXXXXXXXXXXXXXXXXXGXXXXXXXXXXXXXXXXXXX,0,300,0
25746,13,0,13,41,246,0,0,259,171,88,GXXXXXXXXXXXXXXXXXXXGXXXXXXXXXXXXXXXXXXXGXXXXXXXXXXXXXXXXXXXGXXXXXXXXXXXXXXXXXXXGXXXXXXXXXXXXXXXXXXXGXXXXXXXXXXXXXXXXXXXGXXXXXXXXXXXXXXXXXXXGXXXXXXXXXXXXXXXXXXXGXXXXXXXXXXXXXXXXXXXGXXXXXXXXXXXXXXXXXXXGXXXXXXXXXXXXXXXXXXXGXXXXXXXXXXXXXXXXXXXGXXXXXXXXXXXXXXXXXXX,0,300,0
25767,13,0,13,42,245,0,0,258,172,86,GXXXXXXXXXXXXXXXXXXXGXXXXXXXXXXXXXXXXXXXGXXXXXXXXXXXXXXXXXXXGXXXXXXXXXXXXXXXXXXXGXXXXXXXXXXXXXXXXXXXGXXXXXXXXXXXXXXXXXXXGXXXXXXXXXXXXXXXXXXXGXXXXXXXXXXXXXXXXXXXGXXXXXXXXXXXXXXXXXXXGXXXXXXXXXXXXXXXXXXXGXXXXXXXXXXXXXXXXXXXGXXXXXXXXXXXXXXXXXXXGXXXXXXXXXXXXXXXXXXX,0,300,0
25788,13,0,13,43,244,0,0,257,170,87,GXXXXXXXXXXXXXXXXXXXGXXXXXXXXXXXXXXXXXXXGXXXXXXXXXXXXXXXXXXXGXXXXXXXXXXXXXXXXXXXGXXXXXXXXXXXXXXXXXXXGXXXXXXXXXXXXXXXXXXXGXXXXXXXXXXXXXXXXXXXGXXXXXXXXXXXXXXXXXXXGXXXXXXXXXXXXXXXXXXXGXXXXXXXXXXXXXXXXXXXGXXXXXXXXXXXXXXXXXXXGXXXXXXXXXXXXXXXXXXXGXXXXXXXXXXXXXXXXXXX,0,300,0
25809,13,0,13,42,245,0,0,257,167,90,GXXXXXXXXXXXXXXXXXXXGXXXXXXXXXXXXXXXXXXXGXXXXXXXXXXXXXXXXXXXGXXXXXXXXXXXXXXXXXXXGXXXXXXXXXXXXXXXXXXXGXXXXXXXXXXXXXXXXXXXGXXXXXXXXXXXXXXXXXXXGXXXXXXXXXXXXXXXXXXXGXXXXXXXXXXXXXXXXXXXGXXXXXXXXXXXXXXXXXXXGXXXXXXXXXXXXXXXXXXXGXXXXXXXXXXXXXXXXXXXGXXXXXXXXXXXXXXXXXXX,0,300,0

25830,13,0,13,36,251,0,0,263,169,94,GXXXXXXXXXXXXXXXXXXXGXXXXXXXXXXXXXXXXXXXGXXXXXXXXXXXXXXXXXXXGXXXXXXXXXXXXXXXXXXXGXXXXXXXXXXXXXXXXXXXGXXXXXXXXXXXXXXXXXXXGXXXXXXXXXXXXXXXXXXXGXXXXXXXXXXXXXXXXXXXGXXXXXXXXXXXXXXXXXXXGXXXXXXXXXXXXXXXXXXXGXXXXXXXXXXXXXXXXXXXGXXXXXXXXXXXXXXXXXXXGXXXXXXXXXXXXXXXXXXX,0,300,0
25851,13,0,13,37,250,0,0,262,173,89,GXXXXXXXXXXXXXXXXXXXGXXXXXXXXXXXXXXXXXXXGXXXXXXXXXXXXXXXXXXXGXXXXXXXXXXXXXXXXXXXGXXXXXXXXXXXXXXXXXXXGXXXXXXXXXXXXXXXXXXXGXXXXXXXXXXXXXXXXXXXGXXXXXXXXXXXXXXXXXXXGXXXXXXXXXXXXXXXXXXXGXXXXXXXXXXXXXXXXXXXGXXXXXXXXXXXXXXXXXXXGXXXXXXXXXXXXXXXXXXXGXXXXXXXXXXXXXXXXXXX,0,300,0
25872,13,0,13,36,251,0,0,263,173,90,GXXXXXXXXXXXXXXXXXXXGXXXXXXXXXXXXXXXXXXXGXXXXXXXXXXXXXXXXXXXGXXXXXXXXXXXXXXXXXXXGXXXXXXXXXXXXXXXXXXXGXXXXXXXXXXXXXXXXXXXGXXXXXXXXXXXXXXXXXXXGXXXXXXXXXXXXXXXXXXXGXXXXXXXXXXXXXXXXXXXGXXXXXXXXXXXXXXXXXXXGXXXXXXXXXXXXXXXXXXXGXXXXXXXXXXXXXXXXXXXGXXXXXXXXXXXXXXXXXXX,0,300,0
25893,13,0,13,39,248,0,0,260,170,90,GXXXXXXXXXXXXXXXXXXXGXXXXXXXXXXXXXXXXXXXGXXXXXXXXXXXXXXXXXXXGXXXXXXXXXXXXXXXXXXXGXXXXXXXXXXXXXXXXXXXGXXXXXXXXXXXXXXXXXXXGXXXXXXXXXXXXXXXXXXXGXXXXXXXXXXXXXXXXXXXGXXXXXXXXXXXXXXXXXXXGXXXXXXXXXXXXXXXXXXXGXXXXXXXXXXXXXXXXXXXGXXXXXXXXXXXXXXXXXXXGXXXXXXXXXXXXXXXXXXX,0,300,0
25914,13,0,13,36,251,0,0,263,173,90,GXXXXXXXXXXXXXXXXXXXGXXXXXXXXXXXXXXXXXXXGXXXXXXXXXXXXXXXXXXXGXXXXXXXXXXXXXXXXXXXGXXXXXXXXXXXXXXXXXXXGXXXXXXXXXXXXXXXXXXXGXXXXXXXXXXXXXXXXXXXGXXXXXXXXXXXXXXXXXXXGXXXXXXXXXXXXXXXXXXXGXXXXXXXXXXXXXXXXXXXGXXXXXXXXXXXXXXXXXXXGXXXXXXXXXXXXXXXXXXXGXXXXXXXXXXXXXXXXXXX,0,300,0

25935,13,0,13,38,249,0,0,261,172,89,GXXXXXXXXXXXXXXXXXXXGXXXXXXXXXXXXXXXXXXXGXXXXXXXXXXXXXXXXXXXGXXXXXXXXXXXXXXXXXXXGXXXXXXXXXXXXXXXXXXXGXXXXXXXXXXXXXXXXXXXGXXXXXXXXXXXXXXXXXXXGXXXXXXXXXXXXXXXXXXXGXXXXXXXXXXXXXXXXXXXGXXXXXXXXXXXXXXXXXXXGXXXXXXXXXXXXXXXXXXXGXXXXXXXXXXXXXXXXXXXGXXXXXXXXXXXXXXXXXXX,0,300,0
25956,13,0,13,41,246,0,0,258,181,77,GXXXXXXXXXXXXXXXXXXXGXXXXXXXXXXXXXXXXXXXGXXXXXXXXXXXXXXXXXXXGXXXXXXXXXXXXXXXXXXXGXXXXXXXXXXXXXXXXXXXGXXXXXXXXXXXXXXXXXXXGXXXXXXXXXXXXXXXXXXXGXXXXXXXXXXXXXXXXXXXGXXXXXXXXXXXXXXXXXXXGXXXXXXXXXXXXXXXXXXXGXXXXXXXXXXXXXXXXXXXGXXXXXXXXXXXXXXXXXXXGXXXXXXXXXXXXXXXXXXX,0,300,0
25977,14,1,13,43,243,0,0,255,177,78,GXXXXXXXXXXXXXXXXXXXGXXXXXXXXXXXXXXXXXXXGXXXXXXXXXXXXXXXXXXXGXXXXXXXXXXXXXXXXXXXGXXXXXXXXXXXXXXXXXXXGAXXXXXXXXXXXXXXXXXXGXXXXXXXXXXXXXXXXXXXGXXXXXXXXXXXXXXXXXXXGXXXXXXXXXXXXXXXXXXXGXXXXXXXXXXXXXXXXXXXGXXXXXXXXXXXXXXXXXXXGXXXXXXXXXXXXXXXXXXXGXXXXXXXXXXXXXXXXXXX,0,300,0
25998,14,1,13,44,242,0,0,254,175,79,GXXXXXXXXXXXXXXXXXXXGXXXXXXXXXXXXXXXXXXXGXXXXXXXXXXXXXXXXXXXGXXXXXXXXXXXXXXXXXXXGXXXXXXXXXXXXXXXXXXXGAXXXXXXXXXXXXXXXXXXGXXXXXXXXXXXXXXXXXXXGXXXXXXXXXXXXXXXXXXXGXXXXXXXXXXXXXXXXXXXGXXXXXXXXXXXXXXXXXXXGXXXXXXXXXXXXXXXXXXXGXXXXXXXXXXXXXXXXXXXGXXXXXXXXXXXXXXXXXXX,0,300,0
26019,14,0,14,43,243,0,0,255,171,84,GXXXXXXXXXXXXXXXXXXXGXXXXXXXXXXXXXXXXXXXGXXXXXXXXXXXXXXXXXXXGXXXXXXXXXXXXXXXXXXXGXXXXXXXXXXXXXXXXXXXGOXXXXXXXXXXXXXXXXXXGXXXXXXXXXXXXXXXXXXXGXXXXXXXXXXXXXXXXXXXGXXXXXXXXXXXXXXXXXXXGXXXXXXXXXXXXXXXXXXXGXXXXXXXXXXXXXXXXXXXGXXXXXXXXXXXXXXXXXXXGXXXXXXXXXXXXXXXXXXX,0,300,0

26040,14,0,14,41,245,0,0,257,173,84,GXXXXXXXXXXXXXXXXXXXGXXXXXXXXXXXXXXXXXXXGXXXXXXXXXXXXXXXXXXXGXXXXXXXXXXXXXXXXXXXGXXXXXXXXXXXXXXXXXXXGOXXXXXXXXXXXXXXXXXXGXXXXXXXXXXXXXXXXXXXGXXXXXXXXXXXXXXXXXXXGXXXXXXXXXXXXXXXXXXXGXXXXXXXXXXXXXXXXXXXGXXXXXXXXXXXXXXXXXXXGXXXXXXXXXXXXXXXXXXXGXXXXXXXXXXXXXXXXXXX,0,300,0
26061,13,0,13,41,246,0,0,258,172,86,GXXXXXXXXXXXXXXXXXXXGXXXXXXXXXXXXXXXXXXXGXXXXXXXXXXXXXXXXXXXGXXXXXXXXXXXXXXXXXXXGXXXXXXXXXXXXXXXXXXXGXXXXXXXXXXXXXXXXXXXGXXXXXXXXXXXXXXXXXXXGXXXXXXXXXXXXXXXXXXXGXXXXXXXXXXXXXXXXXXXGXXXXXXXXXXXXXXXXXXXGXXXXXXXXXXXXXXXXXXXGXXXXXXXXXXXXXXXXXXXGXXXXXXXXXXXXXXXXXXX,0,300,0
26082,13,0,13,45,242,0,0,255,171,84,GXXXXXXXXXXXXXXXXXXXGXXXXXXXXXXXXXXXXXXXGXXXXXXXXXXXXXXXXXXXGXXXXXXXXXXXXXXXXXXXGXXXXXXXXXXXXXXXXXXXGXXXXXXXXXXXXXXXXXXXGXXXXXXXXXXXXXXXXXXXGXXXXXXXXXXXXXXXXXXXGXXXXXXXXXXXXXXXXXXXGXXXXXXXXXXXXXXXXXXXGXXXXXXXXXXXXXXXXXXXGXXXXXXXXXXXXXXXXXXXGXXXXXXXXXXXXXXXXXXX,0,300,0
26103,13,0,13,47,240,0,0,253,175,78,GXXXXXXXXXXXXXXXXXXXGXXXXXXXXXXXXXXXXXXXGXXXXXXXXXXXXXXXXXXXGXXXXXXXXXXXXXXXXXXXGXXXXXXXXXXXXXXXXXXXGXXXXXXXXXXXXXXXXXXXGXXXXXXXXXXXXXXXXXXXGXXXXXXXXXXXXXXXXXXXGXXXXXXXXXXXXXXXXXXXGXXXXXXXXXXXXXXXXXXXGXXXXXXXXXXXXXXXXXXXGXXXXXXXXXXXXXXXXXXXGXXXXXXXXXXXXXXXXXXX,0,300,0
26124,13,0,13,50,237,0,0,249,167,82,GXXXXXXXXXXXXXXXXXXXGXXXXXXXXXXXXXXXXXXXGXXXXXXXXXXXXXXXXXXXGXXXXXXXXXXXXXXXXXXXGXXXXXXXXXXXXXXXXXXXGXXXXXXXXXXXXXXXXXXXGXXXXXXXXXXXXXXXXXXXGXXXXXXXXXXXXXXXXXXXGXXXXXXXXXXXXXXXXXXXGXXXXXXXXXXXXXXXXXXXGXXXXXXXXXXXXXXXXXXXGXXXXXXXXXXXXXXXXXXXGXXXXXXXXXXXXXXXXXXX,0,300,0

26145,13,0,13,50,237,0,0,250,168,82,GXXXXXXXXXXXXXXXXXXXGXXXXXXXXXXXXXXXXXXXGXXXXXXXXXXXXXXXXXXXGXXXXXXXXXXXXXXXXXXXGXXXXXXXXXXXXXXXXXXXGXXXXXXXXXXXXXXXXXXXGXXXXXXXXXXXXXXXXXXXGXXXXXXXXXXXXXXXXXXXGXXXXXXXXXXXXXXXXXXXGXXXXXXXXXXXXXXXXXXXGXXXXXXXXXXXXXXXXXXXGXXXXXXXXXXXXXXXXXXXGXXXXXXXXXXXXXXXXXXX,0,300,0
26166,13,0,13,46,241,0,0,253,168,85,GXXXXXXXXXXXXXXXXXXXGXXXXXXXXXXXXXXXXXXXGXXXXXXXXXXXXXXXXXXXGXXXXXXXXXXXXXXXXXXXGXXXXXXXXXXXXXXXXXXXGXXXXXXXXXXXXXXXXXXXGXXXXXXXXXXXXXXXXXXXGXXXXXXXXXXXXXXXXXXXGXXXXXXXXXXXXXXXXXXXGXXXXXXXXXXXXXXXXXXXGXXXXXXXXXXXXXXXXXXXGXXXXXXXXXXXXXXXXXXXGXXXXXXXXXXXXXXXXXXX,0,300,0
26187,13,0,13,50,237,0,0,249,167,82,GXXXXXXXXXXXXXXXXXXXGXXXXXXXXXXXXXXXXXXXGXXXXXXXXXXXXXXXXXXXGXXXXXXXXXXXXXXXXXXXGXXXXXXXXXXXXXXXXXXXGXXXXXXXXXXXXXXXXXXXGXXXXXXXXXXXXXXXXXXXGXXXXXXXXXXXXXXXXXXXGXXXXXXXXXXXXXXXXXXXGXXXXXXXXXXXXXXXXXXXGXXXXXXXXXXXXXXXXXXXGXXXXXXXXXXXXXXXXXXXGXXXXXXXXXXXXXXXXXXX,0,300,0
26208,13,0,13,48,239,0,0,251,166,85,GXXXXXXXXXXXXXXXXXXXGXXXXXXXXXXXXXXXXXXXGXXXXXXXXXXXXXXXXXXXGXXXXXXXXXXXXXXXXXXXGXXXXXXXXXXXXXXXXXXXGXXXXXXXXXXXXXXXXXXXGXXXXXXXXXXXXXXXXXXXGXXXXXXXXXXXXXXXXXXXGXXXXXXXXXXXXXXXXXXXGXXXXXXXXXXXXXXXXXXXGXXXXXXXXXXXXXXXXXXXGXXXXXXXXXXXXXXXXXXXGXXXXXXXXXXXXXXXXXXX,0,300,0
26229,13,0,13,46,241,0,0,254,166,88,GXXXXXXXXXXXXXXXXXXXGXXXXXXXXXXXXXXXXXXXGXXXXXXXXXXXXXXXXXXXGXXXXXXXXXXXXXXXXXXXGXXXXXXXXXXXXXXXXXXXGXXXXXXXXXXXXXXXXXXXGXXXXXXXXXXXXXXXXXXXGXXXXXXXXXXXXXXXXXXXGXXXXXXXXXXXXXXXXXXXGXXXXXXXXXXXXXXXXXXXGXXXXXXXXXXXXXXXXXXXGXXXXXXXXXXXXXXXXXXXGXXXXXXXXXXXXXXXXXXX,0,300,0

26250,13,0,13,41,246,0,0,259,168,91,GXXXXXXXXXXXXXXXXXXXGXXXXXXXXXXXXXXXXXXXGXXXXXXXXXXXXXXXXXXXGXXXXXXXXXXXXXXXXXXXGXXXXXXXXXXXXXXXXXXXGXXXXXXXXXXXXXXXXXXXGXXXXXXXXXXXXXXXXXXXGXXXXXXXXXXXXXXXXXXXGXXXXXXXXXXXXXXXXXXXGXXXXXXXXXXXXXXXXXXXGXXXXXXXXXXXXXXXXXXXGXXXXXXXXXXXXXXXXXXXGXXXXXXXXXXXXXXXXXXX,0,300,0
26271,13,0,13,39,248,0,0,261,169,92,GXXXXXXXXXXXXXXXXXXXGXXXXXXXXXXXXXXXXXXXGXXXXXXXXXXXXXXXXXXXGXXXXXXXXXXXXXXXXXXXGXXXXXXXXXXXXXXXXXXXGXXXXXXXXXXXXXXXXXXXGXXXXXXXXXXXXXXXXXXXGXXXXXXXXXXXXXXXXXXXGXXXXXXXXXXXXXXXXXXXGXXXXXXXXXXXXXXXXXXXGXXXXXXXXXXXXXXXXXXXGXXXXXXXXXXXXXXXXXXXGXXXXXXXXXXXXXXXXXXX,0,300,0
26292,13,0,13,37,250,0,0,263,167,96,GXXXXXXXXXXXXXXXXXXXGXXXXXXXXXXXXXXXXXXXGXXXXXXXXXXXXXXXXXXXGXXXXXXXXXXXXXXXXXXXGXXXXXXXXXXXXXXXXXXXGXXXXXXXXXXXXXXXXXXXGXXXXXXXXXXXXXXXXXXXGXXXXXXXXXXXXXXXXXXXGXXXXXXXXXXXXXXXXXXXGXXXXXXXXXXXXXXXXXXXGXXXXXXXXXXXXXXXXXXXGXXXXXXXXXXXXXXXXXXXGXXXXXXXXXXXXXXXXXXX,0,300,0
26313,13,0,13,38,249,0,0,262,173,89,GXXXXXXXXXXXXXXXXXXXGXXXXXXXXXXXXXXXXXXXGXXXXXXXXXXXXXXXXXXXGXXXXXXXXXXXXXXXXXXXGXXXXXXXXXXXXXXXXXXXGXXXXXXXXXXXXXXXXXXXGXXXXXXXXXXXXXXXXXXXGXXXXXXXXXXXXXXXXXXXGXXXXXXXXXXXXXXXXXXXGXXXXXXXXXXXXXXXXXXXGXXXXXXXXXXXXXXXXXXXGXXXXXXXXXXXXXXXXXXXGXXXXXXXXXXXXXXXXXXX,0,300,0
26334,13,0,13,39,248,0,0,261,174,87,GXXXXXXXXXXXXXXXXXXXGXXXXXXXXXXXXXXXXXXXGXXXXXXXXXXXXXXXXXXXGXXXXXXXXXXXXXXXXXXXGXXXXXXXXXXXXXXXXXXXGXXXXXXXXXXXXXXXXXXXGXXXXXXXXXXXXXXXXXXXGXXXXXXXXXXXXXXXXXXXGXXXXXXXXXXXXXXXXXXXGXXXXXXXXXXXXXXXXXXXGXXXXXXXXXXXXXXXXXXXGXXXXXXXXXXXXXXXXXXXGXXXXXXXXXXXXXXXXXXX,0,300,0

26355,13,0,13,45,242,0,0,255,172,83,GXXXXXXXXXXXXXXXXXXXGXXXXXXXXXXXXXXXXXXXGXXXXXXXXXXXXXXXXXXXGXXXXXXXXXXXXXXXXXXXGXXXXXXXXXXXXXXXXXXXGXXXXXXXXXXXXXXXXXXXGXXXXXXXXXXXXXXXXXXXGXXXXXXXXXXXXXXXXXXXGXXXXXXXXXXXXXXXXXXXGXXXXXXXXXXXXXXXXXXXGXXXXXXXXXXXXXXXXXXXGXXXXXXXXXXXXXXXXXXXGXXXXXXXXXXXXXXXXXXX,0,300,0
26376,13,0,13,43,244,0,0,257,174,83,GXXXXXXXXXXXXXXXXXXXGXXXXXXXXXXXXXXXXXXXGXXXXXXXXXXXXXXXXXXXGXXXXXXXXXXXXXXXXXXXGXXXXXXXXXXXXXXXXXXXGXXXXXXXXXXXXXXXXXXXGXXXXXXXXXXXXXXXXXXXGXXXXXXXXXXXXXXXXXXXGXXXXXXXXXXXXXXXXXXXGXXXXXXXXXXXXXXXXXXXGXXXXXXXXXXXXXXXXXXXGXXXXXXXXXXXXXXXXXXXGXXXXXXXXXXXXXXXXXXX,0,300,0
26397,13,0,13,39,248,0,0,261,175,86,GXXXXXXXXXXXXXXXXXXXGXXXXXXXXXXXXXXXXXXXGXXXXXXXXXXXXXXXXXXXGXXXXXXXXXXXXXXXXXXXGXXXXXXXXXXXXXXXXXXXGXXXXXXXXXXXXXXXXXXXGXXXXXXXXXXXXXXXXXXXGXXXXXXXXXXXXXXXXXXXGXXXXXXXXXXXXXXXXXXXGXXXXXXXXXXXXXXXXXXXGXXXXXXXXXXXXXXXXXXXGXXXXXXXXXXXXXXXXXXXGXXXXXXXXXXXXXXXXXXX,0,300,0
26418,13,0,13,40,247,0,0,260,173,87,GXXXXXXXXXXXXXXXXXXXGXXXXXXXXXXXXXXXXXXXGXXXXXXXXXXXXXXXXXXXGXXXXXXXXXXXXXXXXXXXGXXXXXXXXXXXXXXXXXXXGXXXXXXXXXXXXXXXXXXXGXXXXXXXXXXXXXXXXXXXGXXXXXXXXXXXXXXXXXXXGXXXXXXXXXXXXXXXXXXXGXXXXXXXXXXXXXXXXXXXGXXXXXXXXXXXXXXXXXXXGXXXXXXXXXXXXXXXXXXXGXXXXXXXXXXXXXXXXXXX,0,300,0
26439,13,0,13,43,244,0,0,257,172,85,GXXXXXXXXXXXXXXXXXXXGXXXXXXXXXXXXXXXXXXXGXXXXXXXXXXXXXXXXXXXGXXXXXXXXXXXXXXXXXXXGXXXXXXXXXXXXXXXXXXXGXXXXXXXXXXXXXXXXXXXGXXXXXXXXXXXXXXXXXXXGXXXXXXXXXXXXXXXXXXXGXXXXXXXXXXXXXXXXXXXGXXXXXXXXXXXXXXXXXXXGXXXXXXXXXXXXXXXXXXXGXXXXXXXXXXXXXXXXXXXGXXXXXXXXXXXXXXXXXXX,0,300,0

26460,13,0,13,45,242,0,0,255,176,79,GXXXXXXXXXXXXXXXXXXXGXXXXXXXXXXXXXXXXXXXGXXXXXXXXXXXXXXXXXXXGXXXXXXXXXXXXXXXXXXXGXXXXXXXXXXXXXXXXXXXGXXXXXXXXXXXXXXXXXXXGXXXXXXXXXXXXXXXXXXXGXXXXXXXXXXXXXXXXXXXGXXXXXXXXXXXXXXXXXXXGXXXXXXXXXXXXXXXXXXXGXXXXXXXXXXXXXXXXXXXGXXXXXXXXXXXXXXXXXXXGXXXXXXXXXXXXXXXXXXX,0,300,0
26481,13,0,13,45,242,0,0,255,176,79,GXXXXXXXXXXXXXXXXXXXGXXXXXXXXXXXXXXXXXXXGXXXXXXXXXXXXXXXXXXXGXXXXXXXXXXXXXXXXXXXGXXXXXXXXXXXXXXXXXXXGXXXXXXXXXXXXXXXXXXXGXXXXXXXXXXXXXXXXXXXGXXXXXXXXXXXXXXXXXXXGXXXXXXXXXXXXXXXXXXXGXXXXXXXXXXXXXXXXXXXGXXXXXXXXXXXXXXXXXXXGXXXXXXXXXXXXXXXXXXXGXXXXXXXXXXXXXXXXXXX,0,300,0
26502,13,0,13,46,241,0,0,254,175,79,GXXXXXXXXXXXXXXXXXXXGXXXXXXXXXXXXXXXXXXXGXXXXXXXXXXXXXXXXXXXGXXXXXXXXXXXXXXXXXXXGXXXXXXXXXXXXXXXXXXXGXXXXXXXXXXXXXXXXXXXGXXXXXXXXXXXXXXXXXXXGXXXXXXXXXXXXXXXXXXXGXXXXXXXXXXXXXXXXXXXGXXXXXXXXXXXXXXXXXXXGXXXXXXXXXXXXXXXXXXXGXXXXXXXXXXXXXXXXXXXGXXXXXXXXXXXXXXXXXXX,0,300,0
26523,13,0,13,47,240,0,0,253,179,74,GXXXXXXXXXXXXXXXXXXXGXXXXXXXXXXXXXXXXXXXGXXXXXXXXXXXXXXXXXXXGXXXXXXXXXXXXXXXXXXXGXXXXXXXXXXXXXXXXXXXGXXXXXXXXXXXXXXXXXXXGXXXXXXXXXXXXXXXXXXXGXXXXXXXXXXXXXXXXXXXGXXXXXXXXXXXXXXXXXXXGXXXXXXXXXXXXXXXXXXXGXXXXXXXXXXXXXXXXXXXGXXXXXXXXXXXXXXXXXXXGXXXXXXXXXXXXXXXXXXX,0,300,0
26544,13,0,13,50,237,0,0,250,177,73,GXXXXXXXXXXXXXXXXXXXGXXXXXXXXXXXXXXXXXXXGXXXXXXXXXXXXXXXXXXXGXXXXXXXXXXXXXXXXXXXGXXXXXXXXXXXXXXXXXXXGXXXXXXXXXXXXXXXXXXXGXXXXXXXXXXXXXXXXXXXGXXXXXXXXXXXXXXXXXXXGXXXXXXXXXXXXXXXXXXXGXXXXXXXXXXXXXXXXXXXGXXXXXXXXXXXXXXXXXXXGXXXXXXXXXXXXXXXXXXXGXXXXXXXXXXXXXXXXXXX,0,300,0

26565,13,0,13,49,238,0,0,251,176,75,GXXXXXXXXXXXXXXXXXXXGXXXXXXXXXXXXXXXXXXXGXXXXXXXXXXXXXXXXXXXGXXXXXXXXXXXXXXXXXXXGXXXXXXXXXXXXXXXXXXXGXXXXXXXXXXXXXXXXXXXGXXXXXXXXXXXXXXXXXXXGXXXXXXXXXXXXXXXXXXXGXXXXXXXXXXXXXXXXXXXGXXXXXXXXXXXXXXXXXXXGXXXXXXXXXXXXXXXXXXXGXXXXXXXXXXXXXXXXXXXGXXXXXXXXXXXXXXXXXXX,0,300,0
26586,13,0,13,51,236,0,0,249,172,77,GXXXXXXXXXXXXXXXXXXXGXXXXXXXXXXXXXXXXXXXGXXXXXXXXXXXXXXXXXXXGXXXXXXXXXXXXXXXXXXXGXXXXXXXXXXXXXXXXXXXGXXXXXXXXXXXXXXXXXXXGXXXXXXXXXXXXXXXXXXXGXXXXXXXXXXXXXXXXXXXGXXXXXXXXXXXXXXXXXXXGXXXXXXXXXXXXXXXXXXXGXXXXXXXXXXXXXXXXXXXGXXXXXXXXXXXXXXXXXXXGXXXXXXXXXXXXXXXXXXX,0,300,0
26607,13,0,13,48,239,0,0,250,171,79,GXXXXXXXXXXXXXXXXXXXGXXXXXXXXXXXXXXXXXXXGXXXXXXXXXXXXXXXXXXXGXXXXXXXXXXXXXXXXXXXGXXXXXXXXXXXXXXXXXXXGXXXXXXXXXXXXXXXXXXXGXXXXXXXXXXXXXXXXXXXGXXXXXXXXXXXXXXXXXXXGXXXXXXXXXXXXXXXXXXXGXXXXXXXXXXXXXXXXXXXGXXXXXXXXXXXXXXXXXXXGXXXXXXXXXXXXXXXXXXXGXXXXXXXXXXXXXXXXXXX,0,300,0
26628,13,0,13,44,243,0,0,255,176,79,GXXXXXXXXXXXXXXXXXXXGXXXXXXXXXXXXXXXXXXXGXXXXXXXXXXXXXXXXXXXGXXXXXXXXXXXXXXXXXXXGXXXXXXXXXXXXXXXXXXXGXXXXXXXXXXXXXXXXXXXGXXXXXXXXXXXXXXXXXXXGXXXXXXXXXXXXXXXXXXXGXXXXXXXXXXXXXXXXXXXGXXXXXXXXXXXXXXXXXXXGXXXXXXXXXXXXXXXXXXXGXXXXXXXXXXXXXXXXXXXGXXXXXXXXXXXXXXXXXXX,0,300,0
26649,13,0,13,45,242,0,0,253,176,77,GXXXXXXXXXXXXXXXXXXXGXXXXXXXXXXXXXXXXXXXGXXXXXXXXXXXXXXXXXXXGXXXXXXXXXXXXXXXXXXXGXXXXXXXXXXXXXXXXXXXGXXXXXXXXXXXXXXXXXXXGXXXXXXXXXXXXXXXXXXXGXXXXXXXXXXXXXXXXXXXGXXXXXXXXXXXXXXXXXXXGXXXXXXXXXXXXXXXXXXXGXXXXXXXXXXXXXXXXXXXGXXXXXXXXXXXXXXXXXXXGXXXXXXXXXXXXXXXXXXX,0,300,0

26670,13,0,13,46,241,0,0,253,172,81,GXXXXXXXXXXXXXXXXXXXGXXXXXXXXXXXXXXXXXXXGXXXXXXXXXXXXXXXXXXXGXXXXXXXXXXXXXXXXXXXGXXXXXXXXXXXXXXXXXXXGXXXXXXXXXXXXXXXXXXXGXXXXXXXXXXXXXXXXXXXGXXXXXXXXXXXXXXXXXXXGXXXXXXXXXXXXXXXXXXXGXXXXXXXXXXXXXXXXXXXGXXXXXXXXXXXXXXXXXXXGXXXXXXXXXXXXXXXXXXXGXXXXXXXXXXXXXXXXXXX,0,300,0
26691,14,1,13,40,246,0,0,257,174,83,GXXXXXXXXXXXXXXXXXXXGXXXXXXXXXXXXXXXXXXXGXXXXXXXXXXXXXXXXXXXGXXXXXXXXXXXXXXXXXXXGXXXXXXXXXXXXXXXXXXXGXXXXXXXXXXXXXXXXXXXGXXXXXXXXXXXXXXXXXXXGXXXXXXXXXXXXXXXXXXXGAXXXXXXXXXXXXXXXXXXGXXXXXXXXXXXXXXXXXXXGXXXXXXXXXXXXXXXXXXXGXXXXXXXXXXXXXXXXXXXGXXXXXXXXXXXXXXXXXXX,0,300,0
26712,14,1,13,38,248,0,0,258,176,82,GXXXXXXXXXXXXXXXXXXXGXXXXXXXXXXXXXXXXXXXGXXXXXXXXXXXXXXXXXXXGXXXXXXXXXXXXXXXXXXXGXXXXXXXXXXXXXXXXXXXGXXXXXXXXXXXXXXXXXXXGXXXXXXXXXXXXXXXXXXXGXXXXXXXXXXXXXXXXXXXGAXXXXXXXXXXXXXXXXXXGXXXXXXXXXXXXXXXXXXXGXXXXXXXXXXXXXXXXXXXGXXXXXXXXXXXXXXXXXXXGXXXXXXXXXXXXXXXXXXX,0,300,0
26733,14,1,13,38,248,0,0,259,174,85,GXXXXXXXXXXXXXXXXXXXGXXXXXXXXXXXXXXXXXXXGXXXXXXXXXXXXXXXXXXXGXXXXXXXXXXXXXXXXXXXGXXXXXXXXXXXXXXXXXXXGXXXXXXXXXXXXXXXXXXXGXXXXXXXXXXXXXXXXXXXGXXXXXXXXXXXXXXXXXXXGAXXXXXXXXXXXXXXXXXXGXXXXXXXXXXXXXXXXXXXGXXXXXXXXXXXXXXXXXXXGXXXXXXXXXXXXXXXXXXXGXXXXXXXXXXXXXXXXXXX,0,300,0
26754,14,1,13,39,247,0,0,259,172,87,GXXXXXXXXXXXXXXXXXXXGXXXXXXXXXXXXXXXXXXXGXXXXXXXXXXXXXXXXXXXGXXXXXXXXXXXXXXXXXXXGXXXXXXXXXXXXXXXXXXXGXXXXXXXXXXXXXXXXXXXGXXXXXXXXXXXXXXXXXXXGXXXXXXXXXXXXXXXXXXXGAXXXXXXXXXXXXXXXXXXGXXXXXXXXXXXXXXXXXXXGXXXXXXXXXXXXXXXXXXXGXXXXXXXXXXXXXXXXXXXGXXXXXXXXXXXXXXXXXXX,0,300,0

26775,14,1,13,35,251,0,0,263,170,93,GXXXXXXXXXXXXXXXXXXXGXXXXXXXXXXXXXXXXXXXGXXXXXXXXXXXXXXXXXXXGXXXXXXXXXXXXXXXXXXXGXXXXXXXXXXXXXXXXXXXGXXXXXXXXXXXXXXXXXXXGXXXXXXXXXXXXXXXXXXXGXXXXXXXXXXXXXXXXXXXGAXXXXXXXXXXXXXXXXXXGXXXXXXXXXXXXXXXXXXXGXXXXXXXXXXXXXXXXXXXGXXXXXXXXXXXXXXXXXXXGXXXXXXXXXXXXXXXXXXX,0,300,0
26796,14,1,13,32,254,0,0,266,173,93,GXXXXXXXXXXXXXXXXXXXGXXXXXXXXXXXXXXXXXXXGXXXXXXXXXXXXXXXXXXXGXXXXXXXXXXXXXXXXXXXGXXXXXXXXXXXXXXXXXXXGXXXXXXXXXXXXXXXXXXXGXXXXXXXXXXXXXXXXXXXGXXXXXXXXXXXXXXXXXXXGAXXXXXXXXXXXXXXXXXXGXXXXXXXXXXXXXXXXXXXGXXXXXXXXXXXXXXXXXXXGXXXXXXXXXXXXXXXXXXXGXXXXXXXXXXXXXXXXXXX,0,300,0
26817,14,1,13,34,252,0,0,264,174,90,GXXXXXXXXXXXXXXXXXXXGXXXXXXXXXXXXXXXXXXXGXXXXXXXXXXXXXXXXXXXGXXXXXXXXXXXXXXXXXXXGXXXXXXXXXXXXXXXXXXXGXXXXXXXXXXXXXXXXXXXGXXXXXXXXXXXXXXXXXXXGXXXXXXXXXXXXXXXXXXXGAXXXXXXXXXXXXXXXXXXGXXXXXXXXXXXXXXXXXXXGXXXXXXXXXXXXXXXXXXXGXXXXXXXXXXXXXXXXXXXGXXXXXXXXXXXXXXXXXXX,0,300,0
26838,14,1,13,33,253,0,0,264,174,90,GXXXXXXXXXXXXXXXXXXXGXXXXXXXXXXXXXXXXXXXGXXXXXXXXXXXXXXXXXXXGXXXXXXXXXXXXXXXXXXXGXXXXXXXXXXXXXXXXXXXGXXXXXXXXXXXXXXXXXXXGXXXXXXXXXXXXXXXXXXXGXXXXXXXXXXXXXXXXXXXGAXXXXXXXXXXXXXXXXXXGXXXXXXXXXXXXXXXXXXXGXXXXXXXXXXXXXXXXXXXGXXXXXXXXXXXXXXXXXXXGXXXXXXXXXXXXXXXXXXX,0,300,0
26859,14,1,13,33,253,0,0,263,174,89,GXXXXXXXXXXXXXXXXXXXGXXXXXXXXXXXXXXXXXXXGXXXXXXXXXXXXXXXXXXXGXXXXXXXXXXXXXXXXXXXGXXXXXXXXXXXXXXXXXXXGXXXXXXXXXXXXXXXXXXXGXXXXXXXXXXXXXXXXXXXGXXXXXXXXXXXXXXXXXXXGAXXXXXXXXXXXXXXXXXXGXXXXXXXXXXXXXXXXXXXGXXXXXXXXXXXXXXXXXXXGXXXXXXXXXXXXXXXXXXXGXXXXXXXXXXXXXXXXXXX,0,300,0

26880,14,1,13,35,251,0,0,263,174,89,GXXXXXXXXXXXXXXXXXXXGXXXXXXXXXXXXXXXXXXXGXXXXXXXXXXXXXXXXXXXGXXXXXXXXXXXXXXXXXXXGXXXXXXXXXXXXXXXXXXXGXXXXXXXXXXXXXXXXXXXGXXXXXXXXXXXXXXXXXXXGXXXXXXXXXXXXXXXXXXXGAXXXXXXXXXXXXXXXXXXGXXXXXXXXXXXXXXXXXXXGXXXXXXXXXXXXXXXXXXXGXXXXXXXXXXXXXXXXXXXGXXXXXXXXXXXXXXXXXXX,0,300,0
26901,14,1,13,41,245,0,0,256,169,87,GXXXXXXXXXXXXXXXXXXXGXXXXXXXXXXXXXXXXXXXGXXXXXXXXXXXXXXXXXXXGXXXXXXXXXXXXXXXXXXXGXXXXXXXXXXXXXXXXXXXGXXXXXXXXXXXXXXXXXXXGXXXXXXXXXXXXXXXXXXXGXXXXXXXXXXXXXXXXXXXGAXXXXXXXXXXXXXXXXXXGXXXXXXXXXXXXXXXXXXXGXXXXXXXXXXXXXXXXXXXGXXXXXXXXXXXXXXXXXXXGXXXXXXXXXXXXXXXXXXX,0,300,0
26922,14,1,13,38,248,0,0,260,168,92,GXXXXXXXXXXXXXXXXXXXGXXXXXXXXXXXXXXXXXXXGXXXXXXXXXXXXXXXXXXXGXXXXXXXXXXXXXXXXXXXGXXXXXXXXXXXXXXXXXXXGXXXXXXXXXXXXXXXXXXXGXXXXXXXXXXXXXXXXXXXGXXXXXXXXXXXXXXXXXXXGAXXXXXXXXXXXXXXXXXXGXXXXXXXXXXXXXXXXXXXGXXXXXXXXXXXXXXXXXXXGXXXXXXXXXXXXXXXXXXXGXXXXXXXXXXXXXXXXXXX,0,300,0
26943,14,1,13,40,246,0,0,258,172,86,GXXXXXXXXXXXXXXXXXXXGXXXXXXXXXXXXXXXXXXXGXXXXXXXXXXXXXXXXXXXGXXXXXXXXXXXXXXXXXXXGXXXXXXXXXXXXXXXXXXXGXXXXXXXXXXXXXXXXXXXGXXXXXXXXXXXXXXXXXXXGXXXXXXXXXXXXXXXXXXXGAXXXXXXXXXXXXXXXXXXGXXXXXXXXXXXXXXXXXXXGXXXXXXXXXXXXXXXXXXXGXXXXXXXXXXXXXXXXXXXGXXXXXXXXXXXXXXXXXXX,0,300,0
26964,13,0,13,43,244,0,0,255,169,86,GXXXXXXXXXXXXXXXXXXXGXXXXXXXXXXXXXXXXXXXGXXXXXXXXXXXXXXXXXXXGXXXXXXXXXXXXXXXXXXXGXXXXXXXXXXXXXXXXXXXGXXXXXXXXXXXXXXXXXXXGXXXXXXXXXXXXXXXXXXXGXXXXXXXXXXXXXXXXXXXGXXXXXXXXXXXXXXXXXXXGXXXXXXXXXXXXXXXXXXXGXXXXXXXXXXXXXXXXXXXGXXXXXXXXXXXXXXXXXXXGXXXXXXXXXXXXXXXXXXX,0,300,0

26985,13,0,13,41,246,0,0,258,175,83,GXXXXXXXXXXXXXXXXXXXGXXXXXXXXXXXXXXXXXXXGXXXXXXXXXXXXXXXXXXXGXXXXXXXXXXXXXXXXXXXGXXXXXXXXXXXXXXXXXXXGXXXXXXXXXXXXXXXXXXXGXXXXXXXXXXXXXXXXXXXGXXXXXXXXXXXXXXXXXXXGXXXXXXXXXXXXXXXXXXXGXXXXXXXXXXXXXXXXXXXGXXXXXXXXXXXXXXXXXXXGXXXXXXXXXXXXXXXXXXXGXXXXXXXXXXXXXXXXXXX,0,300,0
27006,13,0,13,44,243,0,0,254,172,82,GXXXXXXXXXXXXXXXXXXXGXXXXXXXXXXXXXXXXXXXGXXXXXXXXXXXXXXXXXXXGXXXXXXXXXXXXXXXXXXXGXXXXXXXXXXXXXXXXXXXGXXXXXXXXXXXXXXXXXXXGXXXXXXXXXXXXXXXXXXXGXXXXXXXXXXXXXXXXXXXGXXXXXXXXXXXXXXXXXXXGXXXXXXXXXXXXXXXXXXXGXXXXXXXXXXXXXXXXXXXGXXXXXXXXXXXXXXXXXXXGXXXXXXXXXXXXXXXXXXX,0,300,0
27027,13,0,13,45,242,0,0,253,176,77,GXXXXXXXXXXXXXXXXXXXGXXXXXXXXXXXXXXXXXXXGXXXXXXXXXXXXXXXXXXXGXXXXXXXXXXXXXXXXXXXGXXXXXXXXXXXXXXXXXXXGXXXXXXXXXXXXXXXXXXXGXXXXXXXXXXXXXXXXXXXGXXXXXXXXXXXXXXXXXXXGXXXXXXXXXXXXXXXXXXXGXXXXXXXXXXXXXXXXXXXGXXXXXXXXXXXXXXXXXXXGXXXXXXXXXXXXXXXXXXXGXXXXXXXXXXXXXXXXXXX,0,300,0
27048,13,0,13,52,235,0,0,247,173,74,GXXXXXXXXXXXXXXXXXXXGXXXXXXXXXXXXXXXXXXXGXXXXXXXXXXXXXXXXXXXGXXXXXXXXXXXXXXXXXXXGXXXXXXXXXXXXXXXXXXXGXXXXXXXXXXXXXXXXXXXGXXXXXXXXXXXXXXXXXXXGXXXXXXXXXXXXXXXXXXXGXXXXXXXXXXXXXXXXXXXGXXXXXXXXXXXXXXXXXXXGXXXXXXXXXXXXXXXXXXXGXXXXXXXXXXXXXXXXXXXGXXXXXXXXXXXXXXXXXXX,0,300,0
27069,13,0,13,47,240,0,0,252,171,81,GXXXXXXXXXXXXXXXXXXXGXXXXXXXXXXXXXXXXXXXGXXXXXXXXXXXXXXXXXXXGXXXXXXXXXXXXXXXXXXXGXXXXXXXXXXXXXXXXXXXGXXXXXXXXXXXXXXXXXXXGXXXXXXXXXXXXXXXXXXXGXXXXXXXXXXXXXXXXXXXGXXXXXXXXXXXXXXXXXXXGXXXXXXXXXXXXXXXXXXXGXXXXXXXXXXXXXXXXXXXGXXXXXXXXXXXXXXXXXXXGXXXXXXXXXXXXXXXXXXX,0,300,0

27090,13,0,13,45,242,0,0,253,172,81,GXXXXXXXXXXXXXXXXXXXGXXXXXXXXXXXXXXXXXXXGXXXXXXXXXXXXXXXXXXXGXXXXXXXXXXXXXXXXXXXGXXXXXXXXXXXXXXXXXXXGXXXXXXXXXXXXXXXXXXXGXXXXXXXXXXXXXXXXXXXGXXXXXXXXXXXXXXXXXXXGXXXXXXXXXXXXXXXXXXXGXXXXXXXXXXXXXXXXXXXGXXXXXXXXXXXXXXXXXXXGXXXXXXXXXXXXXXXXXXXGXXXXXXXXXXXXXXXXXXX,0,300,0
27111,13,0,13,43,244,0,0,256,172,84,GXXXXXXXXXXXXXXXXXXXGXXXXXXXXXXXXXXXXXXXGXXXXXXXXXXXXXXXXXXXGXXXXXXXXXXXXXXXXXXXGXXXXXXXXXXXXXXXXXXXGXXXXXXXXXXXXXXXXXXXGXXXXXXXXXXXXXXXXXXXGXXXXXXXXXXXXXXXXXXXGXXXXXXXXXXXXXXXXXXXGXXXXXXXXXXXXXXXXXXXGXXXXXXXXXXXXXXXXXXXGXXXXXXXXXXXXXXXXXXXGXXXXXXXXXXXXXXXXXXX,0,300,0
27132,13,0,13,40,247,0,0,259,175,84,GXXXXXXXXXXXXXXXXXXXGXXXXXXXXXXXXXXXXXXXGXXXXXXXXXXXXXXXXXXXGXXXXXXXXXXXXXXXXXXXGXXXXXXXXXXXXXXXXXXXGXXXXXXXXXXXXXXXXXXXGXXXXXXXXXXXXXXXXXXXGXXXXXXXXXXXXXXXXXXXGXXXXXXXXXXXXXXXXXXXGXXXXXXXXXXXXXXXXXXXGXXXXXXXXXXXXXXXXXXXGXXXXXXXXXXXXXXXXXXXGXXXXXXXXXXXXXXXXXXX,0,300,0
27153,13,0,13,40,247,0,0,259,174,85,GXXXXXXXXXXXXXXXXXXXGXXXXXXXXXXXXXXXXXXXGXXXXXXXXXXXXXXXXXXXGXXXXXXXXXXXXXXXXXXXGXXXXXXXXXXXXXXXXXXXGXXXXXXXXXXXXXXXXXXXGXXXXXXXXXXXXXXXXXXXGXXXXXXXXXXXXXXXXXXXGXXXXXXXXXXXXXXXXXXXGXXXXXXXXXXXXXXXXXXXGXXXXXXXXXXXXXXXXXXXGXXXXXXXXXXXXXXXXXXXGXXXXXXXXXXXXXXXXXXX,0,300,0
27174,13,0,13,42,245,0,0,257,173,84,GXXXXXXXXXXXXXXXXXXXGXXXXXXXXXXXXXXXXXXXGXXXXXXXXXXXXXXXXXXXGXXXXXXXXXXXXXXXXXXXGXXXXXXXXXXXXXXXXXXXGXXXXXXXXXXXXXXXXXXXGXXXXXXXXXXXXXXXXXXXGXXXXXXXXXXXXXXXXXXXGXXXXXXXXXXXXXXXXXXXGXXXXXXXXXXXXXXXXXXXGXXXXXXXXXXXXXXXXXXXGXXXXXXXXXXXXXXXXXXXGXXXXXXXXXXXXXXXXXXX,0,300,0

27195,13,0,13,40,247,0,0,259,173,86,GXXXXXXXXXXXXXXXXXXXGXXXXXXXXXXXXXXXXXXXGXXXXXXXXXXXXXXXXXXXGXXXXXXXXXXXXXXXXXXXGXXXXXXXXXXXXXXXXXXXGXXXXXXXXXXXXXXXXXXXGXXXXXXXXXXXXXXXXXXXGXXXXXXXXXXXXXXXXXXXGXXXXXXXXXXXXXXXXXXXGXXXXXXXXXXXXXXXXXXXGXXXXXXXXXXXXXXXXXXXGXXXXXXXXXXXXXXXXXXXGXXXXXXXXXXXXXXXXXXX,0,300,0
27216,13,0,13,40,247,0,0,259,172,87,GXXXXXXXXXXXXXXXXXXXGXXXXXXXXXXXXXXXXXXXGXXXXXXXXXXXXXXXXXXXGXXXXXXXXXXXXXXXXXXXGXXXXXXXXXXXXXXXXXXXGXXXXXXXXXXXXXXXXXXXGXXXXXXXXXXXXXXXXXXXGXXXXXXXXXXXXXXXXXXXGXXXXXXXXXXXXXXXXXXXGXXXXXXXXXXXXXXXXXXXGXXXXXXXXXXXXXXXXXXXGXXXXXXXXXXXXXXXXXXXGXXXXXXXXXXXXXXXXXXX,0,300,0
27237,13,0,13,42,245,0,0,257,174,83,GXXXXXXXXXXXXXXXXXXXGXXXXXXXXXXXXXXXXXXXGXXXXXXXXXXXXXXXXXXXGXXXXXXXXXXXXXXXXXXXGXXXXXXXXXXXXXXXXXXXGXXXXXXXXXXXXXXXXXXXGXXXXXXXXXXXXXXXXXXXGXXXXXXXXXXXXXXXXXXXGXXXXXXXXXXXXXXXXXXXGXXXXXXXXXXXXXXXXXXXGXXXXXXXXXXXXXXXXXXXGXXXXXXXXXXXXXXXXXXXGXXXXXXXXXXXXXXXXXXX,0,300,0
27258,13,0,13,43,244,0,0,256,174,82,GXXXXXXXXXXXXXXXXXXXGXXXXXXXXXXXXXXXXXXXGXXXXXXXXXXXXXXXXXXXGXXXXXXXXXXXXXXXXXXXGXXXXXXXXXXXXXXXXXXXGXXXXXXXXXXXXXXXXXXXGXXXXXXXXXXXXXXXXXXXGXXXXXXXXXXXXXXXXXXXGXXXXXXXXXXXXXXXXXXXGXXXXXXXXXXXXXXXXXXXGXXXXXXXXXXXXXXXXXXXGXXXXXXXXXXXXXXXXXXXGXXXXXXXXXXXXXXXXXXX,0,300,0
27279,13,0,13,44,243,0,0,255,176,79,GXXXXXXXXXXXXXXXXXXXGXXXXXXXXXXXXXXXXXXXGXXXXXXXXXXXXXXXXXXXGXXXXXXXXXXXXXXXXXXXGXXXXXXXXXXXXXXXXXXXGXXXXXXXXXXXXXXXXXXXGXXXXXXXXXXXXXXXXXXXGXXXXXXXXXXXXXXXXXXXGXXXXXXXXXXXXXXXXXXXGXXXXXXXXXXXXXXXXXXXGXXXXXXXXXXXXXXXXXXXGXXXXXXXXXXXXXXXXXXXGXXXXXXXXXXXXXXXXXXX,0,300,0

27300,13,0,13,44,243,0,0,256,174,82,GXXXXXXXXXXXXXXXXXXXGXXXXXXXXXXXXXXXXXXXGXXXXXXXXXXXXXXXXXXXGXXXXXXXXXXXXXXXXXXXGXXXXXXXXXXXXXXXXXXXGXXXXXXXXXXXXXXXXXXXGXXXXXXXXXXXXXXXXXXXGXXXXXXXXXXXXXXXXXXXGXXXXXXXXXXXXXXXXXXXGXXXXXXXXXXXXXXXXXXXGXXXXXXXXXXXXXXXXXXXGXXXXXXXXXXXXXXXXXXXGXXXXXXXXXXXXXXXXXXX,0,300,0
27321,13,0,13,44,243,0,0,256,176,80,GXXXXXXXXXXXXXXXXXXXGXXXXXXXXXXXXXXXXXXXGXXXXXXXXXXXXXXXXXXXGXXXXXXXXXXXXXXXXXXXGXXXXXXXXXXXXXXXXXXXGXXXXXXXXXXXXXXXXXXXGXXXXXXXXXXXXXXXXXXXGXXXXXXXXXXXXXXXXXXXGXXXXXXXXXXXXXXXXXXXGXXXXXXXXXXXXXXXXXXXGXXXXXXXXXXXXXXXXXXXGXXXXXXXXXXXXXXXXXXXGXXXXXXXXXXXXXXXXXXX,0,300,0
27342,14,1,13,45,241,0,0,255,181,74,GXXXXXXXXXXXXXXXXXXXGXXXXXXXXXXXXXXXXXXXGXXXXXXXXXXXXXXXXXXXGXXXXXXXXXXXXXXXXXXXGXXXXXXXXXXXXXXXXXXXGXXXXXXXXXXXXXXXXXXXGAXXXXXXXXXXXXXXXXXXGXXXXXXXXXXXXXXXXXXXGXXXXXXXXXXXXXXXXXXXGXXXXXXXXXXXXXXXXXXXGXXXXXXXXXXXXXXXXXXXGXXXXXXXXXXXXXXXXXXXGXXXXXXXXXXXXXXXXXXX,0,300,0
27363,14,1,13,48,238,0,0,251,178,73,GXXXXXXXXXXXXXXXXXXXGXXXXXXXXXXXXXXXXXXXGXXXXXXXXXXXXXXXXXXXGXXXXXXXXXXXXXXXXXXXGXXXXXXXXXXXXXXXXXXXGXXXXXXXXXXXXXXXXXXXGAXXXXXXXXXXXXXXXXXXGXXXXXXXXXXXXXXXXXXXGXXXXXXXXXXXXXXXXXXXGXXXXXXXXXXXXXXXXXXXGXXXXXXXXXXXXXXXXXXXGXXXXXXXXXXXXXXXXXXXGXXXXXXXXXXXXXXXXXXX,0,300,0
27384,14,0,14,42,244,0,0,257,180,77,GXXXXXXXXXXXXXXXXXXXGXXXXXXXXXXXXXXXXXXXGXXXXXXXXXXXXXXXXXXXGXXXXXXXXXXXXXXXXXXXGXXXXXXXXXXXXXXXXXXXGXXXXXXXXXXXXXXXXXXXGOXXXXXXXXXXXXXXXXXXGXXXXXXXXXXXXXXXXXXXGXXXXXXXXXXXXXXXXXXXGXXXXXXXXXXXXXXXXXXXGXXXXXXXXXXXXXXXXXXXGXXXXXXXXXXXXXXXXXXXGXXXXXXXXXXXXXXXXXXX,0,300,0

27405,13,0,13,44,243,0,0,256,178,78,GXXXXXXXXXXXXXXXXXXXGXXXXXXXXXXXXXXXXXXXGXXXXXXXXXXXXXXXXXXXGXXXXXXXXXXXXXXXXXXXGXXXXXXXXXXXXXXXXXXXGXXXXXXXXXXXXXXXXXXXGXXXXXXXXXXXXXXXXXXXGXXXXXXXXXXXXXXXXXXXGXXXXXXXXXXXXXXXXXXXGXXXXXXXXXXXXXXXXXXXGXXXXXXXXXXXXXXXXXXXGXXXXXXXXXXXXXXXXXXXGXXXXXXXXXXXXXXXXXXX,0,300,0
27426,13,0,13,41,246,0,0,258,180,78,GXXXXXXXXXXXXXXXXXXXGXXXXXXXXXXXXXXXXXXXGXXXXXXXXXXXXXXXXXXXGXXXXXXXXXXXXXXXXXXXGXXXXXXXXXXXXXXXXXXXGXXXXXXXXXXXXXXXXXXXGXXXXXXXXXXXXXXXXXXXGXXXXXXXXXXXXXXXXXXXGXXXXXXXXXXXXXXXXXXXGXXXXXXXXXXXXXXXXXXXGXXXXXXXXXXXXXXXXXXXGXXXXXXXXXXXXXXXXXXXGXXXXXXXXXXXXXXXXXXX,0,300,0
27447,13,0,13,46,241,0,0,252,179,73,GXXXXXXXXXXXXXXXXXXXGXXXXXXXXXXXXXXXXXXXGXXXXXXXXXXXXXXXXXXXGXXXXXXXXXXXXXXXXXXXGXXXXXXXXXXXXXXXXXXXGXXXXXXXXXXXXXXXXXXXGXXXXXXXXXXXXXXXXXXXGXXXXXXXXXXXXXXXXXXXGXXXXXXXXXXXXXXXXXXXGXXXXXXXXXXXXXXXXXXXGXXXXXXXXXXXXXXXXXXXGXXXXXXXXXXXXXXXXXXXGXXXXXXXXXXXXXXXXXXX,0,300,0
27468,14,1,13,52,234,0,0,247,171,76,GXXXXXXXXXXXXXXXXXXXGXXXXXXXXXXXXXXXXXXXGXXXXXXXXXXXXXXXXXXXGXXXXXXXXXXXXXXXXXXXGXXXXXXXXXXXXXXXXXXXGXXXXXXXXXXXXXXXXXXXGAXXXXXXXXXXXXXXXXXXGXXXXXXXXXXXXXXXXXXXGXXXXXXXXXXXXXXXXXXXGXXXXXXXXXXXXXXXXXXXGXXXXXXXXXXXXXXXXXXXGXXXXXXXXXXXXXXXXXXXGXXXXXXXXXXXXXXXXXXX,0,300,0
27489,14,1,13,52,234,0,0,247,173,74,GXXXXXXXXXXXXXXXXXXXGXXXXXXXXXXXXXXXXXXXGXXXXXXXXXXXXXXXXXXXGXXXXXXXXXXXXXXXXXXXGXXXXXXXXXXXXXXXXXXXGXXXXXXXXXXXXXXXXXXXGAXXXXXXXXXXXXXXXXXXGXXXXXXXXXXXXXXXXXXXGXXXXXXXXXXXXXXXXXXXGXXXXXXXXXXXXXXXXXXXGXXXXXXXXXXXXXXXXXXXGXXXXXXXXXXXXXXXXXXXGXXXXXXXXXXXXXXXXXXX,0,300,0

27510,14,1,13,52,234,0,0,247,170,77,GXXXXXXXXXXXXXXXXXXXGXXXXXXXXXXXXXXXXXXXGXXXXXXXXXXXXXXXXXXXGXXXXXXXXXXXXXXXXXXXGXXXXXXXXXXXXXXXXXXXGXXXXXXXXXXXXXXXXXXXGAXXXXXXXXXXXXXXXXXXGXXXXXXXXXXXXXXXXXXXGXXXXXXXXXXXXXXXXXXXGXXXXXXXXXXXXXXXXXXXGXXXXXXXXXXXXXXXXXXXGXXXXXXXXXXXXXXXXXXXGXXXXXXXXXXXXXXXXXXX,0,300,0
27531,14,1,13,53,233,0,0,245,169,76,GXXXXXXXXXXXXXXXXXXXGXXXXXXXXXXXXXXXXXXXGXXXXXXXXXXXXXXXXXXXGXXXXXXXXXXXXXXXXXXXGXXXXXXXXXXXXXXXXXXXGXXXXXXXXXXXXXXXXXXXGAXXXXXXXXXXXXXXXXXXGXXXXXXXXXXXXXXXXXXXGXXXXXXXXXXXXXXXXXXXGXXXXXXXXXXXXXXXXXXXGXXXXXXXXXXXXXXXXXXXGXXXXXXXXXXXXXXXXXXXGXXXXXXXXXXXXXXXXXXX,0,300,0
27552,14,1,13,50,236,0,0,249,171,78,GXXXXXXXXXXXXXXXXXXXGXXXXXXXXXXXXXXXXXXXGXXXXXXXXXXXXXXXXXXXGXXXXXXXXXXXXXXXXXXXGXXXXXXXXXXXXXXXXXXXGXXXXXXXXXXXXXXXXXXXGAXXXXXXXXXXXXXXXXXXGXXXXXXXXXXXXXXXXXXXGXXXXXXXXXXXXXXXXXXXGXXXXXXXXXXXXXXXXXXXGXXXXXXXXXXXXXXXXXXXGXXXXXXXXXXXXXXXXXXXGXXXXXXXXXXXXXXXXXXX,0,300,0
27573,14,1,13,51,235,0,0,247,168,79,GXXXXXXXXXXXXXXXXXXXGXXXXXXXXXXXXXXXXXXXGXXXXXXXXXXXXXXXXXXXGXXXXXXXXXXXXXXXXXXXGXXXXXXXXXXXXXXXXXXXGXXXXXXXXXXXXXXXXXXXGAXXXXXXXXXXXXXXXXXXGXXXXXXXXXXXXXXXXXXXGXXXXXXXXXXXXXXXXXXXGXXXXXXXXXXXXXXXXXXXGXXXXXXXXXXXXXXXXXXXGXXXXXXXXXXXXXXXXXXXGXXXXXXXXXXXXXXXXXXX,0,300,0
27594,14,1,13,51,235,0,0,246,170,76,GXXXXXXXXXXXXXXXXXXXGXXXXXXXXXXXXXXXXXXXGXXXXXXXXXXXXXXXXXXXGXXXXXXXXXXXXXXXXXXXGXXXXXXXXXXXXXXXXXXXGXXXXXXXXXXXXXXXXXXXGAXXXXXXXXXXXXXXXXXXGXXXXXXXXXXXXXXXXXXXGXXXXXXXXXXXXXXXXXXXGXXXXXXXXXXXXXXXXXXXGXXXXXXXXXXXXXXXXXXXGXXXXXXXXXXXXXXXXXXXGXXXXXXXXXXXXXXXXXXX,0,300,0

27615,14,1,13,48,238,0,0,250,170,80,GXXXXXXXXXXXXXXXXXXXGXXXXXXXXXXXXXXXXXXXGXXXXXXXXXXXXXXXXXXXGXXXXXXXXXXXXXXXXXXXGXXXXXXXXXXXXXXXXXXXGXXXXXXXXXXXXXXXXXXXGAXXXXXXXXXXXXXXXXXXGXXXXXXXXXXXXXXXXXXXGXXXXXXXXXXXXXXXXXXXGXXXXXXXXXXXXXXXXXXXGXXXXXXXXXXXXXXXXXXXGXXXXXXXXXXXXXXXXXXXGXXXXXXXXXXXXXXXXXXX,0,300,0
27636,14,1,13,47,239,0,0,251,171,80,GXXXXXXXXXXXXXXXXXXXGXXXXXXXXXXXXXXXXXXXGXXXXXXXXXXXXXXXXXXXGXXXXXXXXXXXXXXXXXXXGXXXXXXXXXXXXXXXXXXXGXXXXXXXXXXXXXXXXXXXGAXXXXXXXXXXXXXXXXXXGXXXXXXXXXXXXXXXXXXXGXXXXXXXXXXXXXXXXXXXGXXXXXXXXXXXXXXXXXXXGXXXXXXXXXXXXXXXXXXXGXXXXXXXXXXXXXXXXXXXGXXXXXXXXXXXXXXXXXXX,0,300,0
27657,15,2,13,42,243,0,0,255,172,83,GXXXXXXXXXXXXXXXXXXXGXXXXXXXXXXXXXXXXXXXGAXXXXXXXXXXXXXXXXXXGXXXXXXXXXXXXXXXXXXXGXXXXXXXXXXXXXXXXXXXGXXXXXXXXXXXXXXXXXXXGAXXXXXXXXXXXXXXXXXXGXXXXXXXXXXXXXXXXXXXGXXXXXXXXXXXXXXXXXXXGXXXXXXXXXXXXXXXXXXXGXXXXXXXXXXXXXXXXXXXGXXXXXXXXXXXXXXXXXXXGXXXXXXXXXXXXXXXXXXX,0,300,0
27678,15,2,13,45,240,0,0,252,174,78,GXXXXXXXXXXXXXXXXXXXGXXXXXXXXXXXXXXXXXXXGAXXXXXXXXXXXXXXXXXXGXXXXXXXXXXXXXXXXXXXGXXXXXXXXXXXXXXXXXXXGXXXXXXXXXXXXXXXXXXXGAXXXXXXXXXXXXXXXXXXGXXXXXXXXXXXXXXXXXXXGXXXXXXXXXXXXXXXXXXXGXXXXXXXXXXXXXXXXXXXGXXXXXXXXXXXXXXXXXXXGXXXXXXXXXXXXXXXXXXXGXXXXXXXXXXXXXXXXXXX,0,300,0
27699,15,2,13,48,237,0,0,249,175,74,GXXXXXXXXXXXXXXXXXXXGXXXXXXXXXXXXXXXXXXXGAXXXXXXXXXXXXXXXXXXGXXXXXXXXXXXXXXXXXXXGXXXXXXXXXXXXXXXXXXXGXXXXXXXXXXXXXXXXXXXGAXXXXXXXXXXXXXXXXXXGXXXXXXXXXXXXXXXXXXXGXXXXXXXXXXXXXXXXXXXGXXXXXXXXXXXXXXXXXXXGXXXXXXXXXXXXXXXXXXXGXXXXXXXXXXXXXXXXXXXGXXXXXXXXXXXXXXXXXXX,0,300,0

27720,14,0,14,49,237,0,0,249,173,76,GXXXXXXXXXXXXXXXXXXXGXXXXXXXXXXXXXXXXXXXGOXXXXXXXXXXXXXXXXXXGXXXXXXXXXXXXXXXXXXXGXXXXXXXXXXXXXXXXXXXGXXXXXXXXXXXXXXXXXXXGXXXXXXXXXXXXXXXXXXXGXXXXXXXXXXXXXXXXXXXGXXXXXXXXXXXXXXXXXXXGXXXXXXXXXXXXXXXXXXXGXXXXXXXXXXXXXXXXXXXGXXXXXXXXXXXXXXXXXXXGXXXXXXXXXXXXXXXXXXX,0,300,0
27741,14,0,14,44,242,0,0,253,173,80,GXXXXXXXXXXXXXXXXXXXGXXXXXXXXXXXXXXXXXXXGOXXXXXXXXXXXXXXXXXXGXXXXXXXXXXXXXXXXXXXGXXXXXXXXXXXXXXXXXXXGXXXXXXXXXXXXXXXXXXXGXXXXXXXXXXXXXXXXXXXGXXXXXXXXXXXXXXXXXXXGXXXXXXXXXXXXXXXXXXXGXXXXXXXXXXXXXXXXXXXGXXXXXXXXXXXXXXXXXXXGXXXXXXXXXXXXXXXXXXXGXXXXXXXXXXXXXXXXXXX,0,300,0
27762,13,0,13,41,246,0,0,257,174,83,GXXXXXXXXXXXXXXXXXXXGXXXXXXXXXXXXXXXXXXXGXXXXXXXXXXXXXXXXXXXGXXXXXXXXXXXXXXXXXXXGXXXXXXXXXXXXXXXXXXXGXXXXXXXXXXXXXXXXXXXGXXXXXXXXXXXXXXXXXXXGXXXXXXXXXXXXXXXXXXXGXXXXXXXXXXXXXXXXXXXGXXXXXXXXXXXXXXXXXXXGXXXXXXXXXXXXXXXXXXXGXXXXXXXXXXXXXXXXXXXGXXXXXXXXXXXXXXXXXXX,0,300,0
27783,13,0,13,41,246,0,0,258,174,84,GXXXXXXXXXXXXXXXXXXXGXXXXXXXXXXXXXXXXXXXGXXXXXXXXXXXXXXXXXXXGXXXXXXXXXXXXXXXXXXXGXXXXXXXXXXXXXXXXXXXGXXXXXXXXXXXXXXXXXXXGXXXXXXXXXXXXXXXXXXXGXXXXXXXXXXXXXXXXXXXGXXXXXXXXXXXXXXXXXXXGXXXXXXXXXXXXXXXXXXXGXXXXXXXXXXXXXXXXXXXGXXXXXXXXXXXXXXXXXXXGXXXXXXXXXXXXXXXXXXX,0,300,0
27804,13,0,13,42,245,0,0,257,174,83,GXXXXXXXXXXXXXXXXXXXGXXXXXXXXXXXXXXXXXXXGXXXXXXXXXXXXXXXXXXXGXXXXXXXXXXXXXXXXXXXGXXXXXXXXXXXXXXXXXXXGXXXXXXXXXXXXXXXXXXXGXXXXXXXXXXXXXXXXXXXGXXXXXXXXXXXXXXXXXXXGXXXXXXXXXXXXXXXXXXXGXXXXXXXXXXXXXXXXXXXGXXXXXXXXXXXXXXXXXXXGXXXXXXXXXXXXXXXXXXXGXXXXXXXXXXXXXXXXXXX,0,300,0

27825,13,0,13,46,241,0,0,253,172,81,GXXXXXXXXXXXXXXXXXXXGXXXXXXXXXXXXXXXXXXXGXXXXXXXXXXXXXXXXXXXGXXXXXXXXXXXXXXXXXXXGXXXXXXXXXXXXXXXXXXXGXXXXXXXXXXXXXXXXXXXGXXXXXXXXXXXXXXXXXXXGXXXXXXXXXXXXXXXXXXXGXXXXXXXXXXXXXXXXXXXGXXXXXXXXXXXXXXXXXXXGXXXXXXXXXXXXXXXXXXXGXXXXXXXXXXXXXXXXXXXGXXXXXXXXXXXXXXXXXXX,0,300,0
27846,13,0,13,42,245,0,0,256,170,86,GXXXXXXXXXXXXXXXXXXXGXXXXXXXXXXXXXXXXXXXGXXXXXXXXXXXXXXXXXXXGXXXXXXXXXXXXXXXXXXXGXXXXXXXXXXXXXXXXXXXGXXXXXXXXXXXXXXXXXXXGXXXXXXXXXXXXXXXXXXXGXXXXXXXXXXXXXXXXXXXGXXXXXXXXXXXXXXXXXXXGXXXXXXXXXXXXXXXXXXXGXXXXXXXXXXXXXXXXXXXGXXXXXXXXXXXXXXXXXXXGXXXXXXXXXXXXXXXXXXX,0,300,0
27867,13,0,13,43,244,0,0,256,171,85,GXXXXXXXXXXXXXXXXXXXGXXXXXXXXXXXXXXXXXXXGXXXXXXXXXXXXXXXXXXXGXXXXXXXXXXXXXXXXXXXGXXXXXXXXXXXXXXXXXXXGXXXXXXXXXXXXXXXXXXXGXXXXXXXXXXXXXXXXXXXGXXXXXXXXXXXXXXXXXXXGXXXXXXXXXXXXXXXXXXXGXXXXXXXXXXXXXXXXXXXGXXXXXXXXXXXXXXXXXXXGXXXXXXXXXXXXXXXXXXXGXXXXXXXXXXXXXXXXXXX,0,300,0
27888,13,0,13,38,249,0,0,261,178,83,GXXXXXXXXXXXXXXXXXXXGXXXXXXXXXXXXXXXXXXXGXXXXXXXXXXXXXXXXXXXGXXXXXXXXXXXXXXXXXXXGXXXXXXXXXXXXXXXXXXXGXXXXXXXXXXXXXXXXXXXGXXXXXXXXXXXXXXXXXXXGXXXXXXXXXXXXXXXXXXXGXXXXXXXXXXXXXXXXXXXGXXXXXXXXXXXXXXXXXXXGXXXXXXXXXXXXXXXXXXXGXXXXXXXXXXXXXXXXXXXGXXXXXXXXXXXXXXXXXXX,0,300,0
27909,13,0,13,39,248,0,0,260,177,83,GXXXXXXXXXXXXXXXXXXXGXXXXXXXXXXXXXXXXXXXGXXXXXXXXXXXXXXXXXXXGXXXXXXXXXXXXXXXXXXXGXXXXXXXXXXXXXXXXXXXGXXXXXXXXXXXXXXXXXXXGXXXXXXXXXXXXXXXXXXXGXXXXXXXXXXXXXXXXXXXGXXXXXXXXXXXXXXXXXXXGXXXXXXXXXXXXXXXXXXXGXXXXXXXXXXXXXXXXXXXGXXXXXXXXXXXXXXXXXXXGXXXXXXXXXXXXXXXXXXX,0,300,0

27930,13,0,13,35,252,0,0,264,178,86,GXXXXXXXXXXXXXXXXXXXGXXXXXXXXXXXXXXXXXXXGXXXXXXXXXXXXXXXXXXXGXXXXXXXXXXXXXXXXXXXGXXXXXXXXXXXXXXXXXXXGXXXXXXXXXXXXXXXXXXXGXXXXXXXXXXXXXXXXXXXGXXXXXXXXXXXXXXXXXXXGXXXXXXXXXXXXXXXXXXXGXXXXXXXXXXXXXXXXXXXGXXXXXXXXXXXXXXXXXXXGXXXXXXXXXXXXXXXXXXXGXXXXXXXXXXXXXXXXXXX,0,300,0
27951,13,0,13,44,243,0,0,255,171,84,GXXXXXXXXXXXXXXXXXXXGXXXXXXXXXXXXXXXXXXXGXXXXXXXXXXXXXXXXXXXGXXXXXXXXXXXXXXXXXXXGXXXXXXXXXXXXXXXXXXXGXXXXXXXXXXXXXXXXXXXGXXXXXXXXXXXXXXXXXXXGXXXXXXXXXXXXXXXXXXXGXXXXXXXXXXXXXXXXXXXGXXXXXXXXXXXXXXXXXXXGXXXXXXXXXXXXXXXXXXXGXXXXXXXXXXXXXXXXXXXGXXXXXXXXXXXXXXXXXXX,0,300,0
27972,13,0,13,43,244,0,0,256,176,80,GXXXXXXXXXXXXXXXXXXXGXXXXXXXXXXXXXXXXXXXGXXXXXXXXXXXXXXXXXXXGXXXXXXXXXXXXXXXXXXXGXXXXXXXXXXXXXXXXXXXGXXXXXXXXXXXXXXXXXXXGXXXXXXXXXXXXXXXXXXXGXXXXXXXXXXXXXXXXXXXGXXXXXXXXXXXXXXXXXXXGXXXXXXXXXXXXXXXXXXXGXXXXXXXXXXXXXXXXXXXGXXXXXXXXXXXXXXXXXXXGXXXXXXXXXXXXXXXXXXX,0,300,0
27993,13,0,13,45,242,0,0,254,174,80,GXXXXXXXXXXXXXXXXXXXGXXXXXXXXXXXXXXXXXXXGXXXXXXXXXXXXXXXXXXXGXXXXXXXXXXXXXXXXXXXGXXXXXXXXXXXXXXXXXXXGXXXXXXXXXXXXXXXXXXXGXXXXXXXXXXXXXXXXXXXGXXXXXXXXXXXXXXXXXXXGXXXXXXXXXXXXXXXXXXXGXXXXXXXXXXXXXXXXXXXGXXXXXXXXXXXXXXXXXXXGXXXXXXXXXXXXXXXXXXXGXXXXXXXXXXXXXXXXXXX,0,300,0
28014,13,0,13,41,246,0,0,258,178,80,GXXXXXXXXXXXXXXXXXXXGXXXXXXXXXXXXXXXXXXXGXXXXXXXXXXXXXXXXXXXGXXXXXXXXXXXXXXXXXXXGXXXXXXXXXXXXXXXXXXXGXXXXXXXXXXXXXXXXXXXGXXXXXXXXXXXXXXXXXXXGXXXXXXXXXXXXXXXXXXXGXXXXXXXXXXXXXXXXXXXGXXXXXXXXXXXXXXXXXXXGXXXXXXXXXXXXXXXXXXXGXXXXXXXXXXXXXXXXXXXGXXXXXXXXXXXXXXXXXXX,0,300,0

28035,13,0,13,41,246,0,0,258,179,79,GXXXXXXXXXXXXXXXXXXXGXXXXXXXXXXXXXXXXXXXGXXXXXXXXXXXXXXXXXXXGXXXXXXXXXXXXXXXXXXXGXXXXXXXXXXXXXXXXXXXGXXXXXXXXXXXXXXXXXXXGXXXXXXXXXXXXXXXXXXXGXXXXXXXXXXXXXXXXXXXGXXXXXXXXXXXXXXXXXXXGXXXXXXXXXXXXXXXXXXXGXXXXXXXXXXXXXXXXXXXGXXXXXXXXXXXXXXXXXXXGXXXXXXXXXXXXXXXXXXX,0,300,0
28056,13,0,13,47,240,0,0,252,173,79,GXXXXXXXXXXXXXXXXXXXGXXXXXXXXXXXXXXXXXXXGXXXXXXXXXXXXXXXXXXXGXXXXXXXXXXXXXXXXXXXGXXXXXXXXXXXXXXXXXXXGXXXXXXXXXXXXXXXXXXXGXXXXXXXXXXXXXXXXXXXGXXXXXXXXXXXXXXXXXXXGXXXXXXXXXXXXXXXXXXXGXXXXXXXXXXXXXXXXXXXGXXXXXXXXXXXXXXXXXXXGXXXXXXXXXXXXXXXXXXXGXXXXXXXXXXXXXXXXXXX,0,300,0
28077,13,0,13,48,239,0,0,251,173,78,GXXXXXXXXXXXXXXXXXXXGXXXXXXXXXXXXXXXXXXXGXXXXXXXXXXXXXXXXXXXGXXXXXXXXXXXXXXXXXXXGXXXXXXXXXXXXXXXXXXXGXXXXXXXXXXXXXXXXXXXGXXXXXXXXXXXXXXXXXXXGXXXXXXXXXXXXXXXXXXXGXXXXXXXXXXXXXXXXXXXGXXXXXXXXXXXXXXXXXXXGXXXXXXXXXXXXXXXXXXXGXXXXXXXXXXXXXXXXXXXGXXXXXXXXXXXXXXXXXXX,0,300,0
28098,13,0,13,47,240,0,0,252,174,78,GXXXXXXXXXXXXXXXXXXXGXXXXXXXXXXXXXXXXXXXGXXXXXXXXXXXXXXXXXXXGXXXXXXXXXXXXXXXXXXXGXXXXXXXXXXXXXXXXXXXGXXXXXXXXXXXXXXXXXXXGXXXXXXXXXXXXXXXXXXXGXXXXXXXXXXXXXXXXXXXGXXXXXXXXXXXXXXXXXXXGXXXXXXXXXXXXXXXXXXXGXXXXXXXXXXXXXXXXXXXGXXXXXXXXXXXXXXXXXXXGXXXXXXXXXXXXXXXXXXX,0,300,0
28119,13,0,13,42,245,0,0,257,175,82,GXXXXXXXXXXXXXXXXXXXGXXXXXXXXXXXXXXXXXXXGXXXXXXXXXXXXXXXXXXXGXXXXXXXXXXXXXXXXXXXGXXXXXXXXXXXXXXXXXXXGXXXXXXXXXXXXXXXXXXXGXXXXXXXXXXXXXXXXXXXGXXXXXXXXXXXXXXXXXXXGXXXXXXXXXXXXXXXXXXXGXXXXXXXXXXXXXXXXXXXGXXXXXXXXXXXXXXXXXXXGXXXXXXXXXXXXXXXXXXXGXXXXXXXXXXXXXXXXXXX,0,300,0

28140,13,0,13,40,247,0,0,259,176,83,GXXXXXXXXXXXXXXXXXXXGXXXXXXXXXXXXXXXXXXXGXXXXXXXXXXXXXXXXXXXGXXXXXXXXXXXXXXXXXXXGXXXXXXXXXXXXXXXXXXXGXXXXXXXXXXXXXXXXXXXGXXXXXXXXXXXXXXXXXXXGXXXXXXXXXXXXXXXXXXXGXXXXXXXXXXXXXXXXXXXGXXXXXXXXXXXXXXXXXXXGXXXXXXXXXXXXXXXXXXXGXXXXXXXXXXXXXXXXXXXGXXXXXXXXXXXXXXXXXXX,0,300,0
28161,13,0,13,40,247,0,0,259,175,84,GXXXXXXXXXXXXXXXXXXXGXXXXXXXXXXXXXXXXXXXGXXXXXXXXXXXXXXXXXXXGXXXXXXXXXXXXXXXXXXXGXXXXXXXXXXXXXXXXXXXGXXXXXXXXXXXXXXXXXXXGXXXXXXXXXXXXXXXXXXXGXXXXXXXXXXXXXXXXXXXGXXXXXXXXXXXXXXXXXXXGXXXXXXXXXXXXXXXXXXXGXXXXXXXXXXXXXXXXXXXGXXXXXXXXXXXXXXXXXXXGXXXXXXXXXXXXXXXXXXX,0,300,0
28182,14,1,13,39,247,0,0,260,175,85,GXXXXXXXXXXXXXXXXXXXGXXXXXXXXXXXXXXXXXXXGXXXXXXXXXXXXXXXXXXXGXXXXXXXXXXXXXXXXXXXGXXXXXXXXXXXXXXXXXXXGXXXXXXXXXXXXXXXXXXXGXXXXXXXXXXXXXXXXXXXGXXXXXXXXXXXXXXXXXXXGXXXXXXXXXXXXXXXXXXXGXXXXXXXXXXXXXXXXXXXGAXXXXXXXXXXXXXXXXXXGXXXXXXXXXXXXXXXXXXXGXXXXXXXXXXXXXXXXXXX,0,300,0
28203,14,1,13,39,247,0,0,260,177,83,GXXXXXXXXXXXXXXXXXXXGXXXXXXXXXXXXXXXXXXXGXXXXXXXXXXXXXXXXXXXGXXXXXXXXXXXXXXXXXXXGXXXXXXXXXXXXXXXXXXXGXXXXXXXXXXXXXXXXXXXGXXXXXXXXXXXXXXXXXXXGXXXXXXXXXXXXXXXXXXXGXXXXXXXXXXXXXXXXXXXGXXXXXXXXXXXXXXXXXXXGAXXXXXXXXXXXXXXXXXXGXXXXXXXXXXXXXXXXXXXGXXXXXXXXXXXXXXXXXXX,0,300,0
28224,14,1,13,49,237,0,0,250,170,80,GXXXXXXXXXXXXXXXXXXXGXXXXXXXXXXXXXXXXXXXGXXXXXXXXXXXXXXXXXXXGXXXXXXXXXXXXXXXXXXXGXXXXXXXXXXXXXXXXXXXGXXXXXXXXXXXXXXXXXXXGXXXXXXXXXXXXXXXXXXXGXXXXXXXXXXXXXXXXXXXGXXXXXXXXXXXXXXXXXXXGXXXXXXXXXXXXXXXXXXXGAXXXXXXXXXXXXXXXXXXGXXXXXXXXXXXXXXXXXXXGXXXXXXXXXXXXXXXXXXX,0,300,0

28245,14,1,13,46,240,0,0,251,171,80,GXXXXXXXXXXXXXXXXXXXGXXXXXXXXXXXXXXXXXXXGXXXXXXXXXXXXXXXXXXXGXXXXXXXXXXXXXXXXXXXGXXXXXXXXXXXXXXXXXXXGXXXXXXXXXXXXXXXXXXXGXXXXXXXXXXXXXXXXXXXGXXXXXXXXXXXXXXXXXXXGXXXXXXXXXXXXXXXXXXXGXXXXXXXXXXXXXXXXXXXGAXXXXXXXXXXXXXXXXXXGXXXXXXXXXXXXXXXXXXXGXXXXXXXXXXXXXXXXXXX,0,300,0
28266,14,1,13,44,242,0,0,255,172,83,GXXXXXXXXXXXXXXXXXXXGXXXXXXXXXXXXXXXXXXXGXXXXXXXXXXXXXXXXXXXGXXXXXXXXXXXXXXXXXXXGXXXXXXXXXXXXXXXXXXXGXXXXXXXXXXXXXXXXXXXGXXXXXXXXXXXXXXXXXXXGXXXXXXXXXXXXXXXXXXXGXXXXXXXXXXXXXXXXXXXGXXXXXXXXXXXXXXXXXXXGAXXXXXXXXXXXXXXXXXXGXXXXXXXXXXXXXXXXXXXGXXXXXXXXXXXXXXXXXXX,0,300,0
28287,14,1,13,47,239,0,0,251,171,80,GXXXXXXXXXXXXXXXXXXXGXXXXXXXXXXXXXXXXXXXGXXXXXXXXXXXXXXXXXXXGXXXXXXXXXXXXXXXXXXXGXXXXXXXXXXXXXXXXXXXGXXXXXXXXXXXXXXXXXXXGXXXXXXXXXXXXXXXXXXXGXXXXXXXXXXXXXXXXXXXGXXXXXXXXXXXXXXXXXXXGXXXXXXXXXXXXXXXXXXXGAXXXXXXXXXXXXXXXXXXGXXXXXXXXXXXXXXXXXXXGXXXXXXXXXXXXXXXXXXX,0,300,0
28308,13,0,13,44,243,0,0,256,172,84,GXXXXXXXXXXXXXXXXXXXGXXXXXXXXXXXXXXXXXXXGXXXXXXXXXXXXXXXXXXXGXXXXXXXXXXXXXXXXXXXGXXXXXXXXXXXXXXXXXXXGXXXXXXXXXXXXXXXXXXXGXXXXXXXXXXXXXXXXXXXGXXXXXXXXXXXXXXXXXXXGXXXXXXXXXXXXXXXXXXXGXXXXXXXXXXXXXXXXXXXGXXXXXXXXXXXXXXXXXXXGXXXXXXXXXXXXXXXXXXXGXXXXXXXXXXXXXXXXXXX,0,300,0
28329,13,0,13,45,242,0,0,254,168,86,GXXXXXXXXXXXXXXXXXXXGXXXXXXXXXXXXXXXXXXXGXXXXXXXXXXXXXXXXXXXGXXXXXXXXXXXXXXXXXXXGXXXXXXXXXXXXXXXXXXXGXXXXXXXXXXXXXXXXXXXGXXXXXXXXXXXXXXXXXXXGXXXXXXXXXXXXXXXXXXXGXXXXXXXXXXXXXXXXXXXGXXXXXXXXXXXXXXXXXXXGXXXXXXXXXXXXXXXXXXXGXXXXXXXXXXXXXXXXXXXGXXXXXXXXXXXXXXXXXXX,0,300,0

28350,13,0,13,40,247,0,0,259,171,88,GXXXXXXXXXXXXXXXXXXXGXXXXXXXXXXXXXXXXXXXGXXXXXXXXXXXXXXXXXXXGXXXXXXXXXXXXXXXXXXXGXXXXXXXXXXXXXXXXXXXGXXXXXXXXXXXXXXXXXXXGXXXXXXXXXXXXXXXXXXXGXXXXXXXXXXXXXXXXXXXGXXXXXXXXXXXXXXXXXXXGXXXXXXXXXXXXXXXXXXXGXXXXXXXXXXXXXXXXXXXGXXXXXXXXXXXXXXXXXXXGXXXXXXXXXXXXXXXXXXX,0,300,0
28371,13,0,13,41,246,0,0,258,172,86,GXXXXXXXXXXXXXXXXXXXGXXXXXXXXXXXXXXXXXXXGXXXXXXXXXXXXXXXXXXXGXXXXXXXXXXXXXXXXXXXGXXXXXXXXXXXXXXXXXXXGXXXXXXXXXXXXXXXXXXXGXXXXXXXXXXXXXXXXXXXGXXXXXXXXXXXXXXXXXXXGXXXXXXXXXXXXXXXXXXXGXXXXXXXXXXXXXXXXXXXGXXXXXXXXXXXXXXXXXXXGXXXXXXXXXXXXXXXXXXXGXXXXXXXXXXXXXXXXXXX,0,300,0
28392,13,0,13,40,247,0,0,258,173,85,GXXXXXXXXXXXXXXXXXXXGXXXXXXXXXXXXXXXXXXXGXXXXXXXXXXXXXXXXXXXGXXXXXXXXXXXXXXXXXXXGXXXXXXXXXXXXXXXXXXXGXXXXXXXXXXXXXXXXXXXGXXXXXXXXXXXXXXXXXXXGXXXXXXXXXXXXXXXXXXXGXXXXXXXXXXXXXXXXXXXGXXXXXXXXXXXXXXXXXXXGXXXXXXXXXXXXXXXXXXXGXXXXXXXXXXXXXXXXXXXGXXXXXXXXXXXXXXXXXXX,0,300,0
28413,13,0,13,39,248,0,0,260,174,86,GXXXXXXXXXXXXXXXXXXXGXXXXXXXXXXXXXXXXXXXGXXXXXXXXXXXXXXXXXXXGXXXXXXXXXXXXXXXXXXXGXXXXXXXXXXXXXXXXXXXGXXXXXXXXXXXXXXXXXXXGXXXXXXXXXXXXXXXXXXXGXXXXXXXXXXXXXXXXXXXGXXXXXXXXXXXXXXXXXXXGXXXXXXXXXXXXXXXXXXXGXXXXXXXXXXXXXXXXXXXGXXXXXXXXXXXXXXXXXXXGXXXXXXXXXXXXXXXXXXX,0,300,0
28434,13,0,13,33,254,0,0,266,179,87,GXXXXXXXXXXXXXXXXXXXGXXXXXXXXXXXXXXXXXXXGXXXXXXXXXXXXXXXXXXXGXXXXXXXXXXXXXXXXXXXGXXXXXXXXXXXXXXXXXXXGXXXXXXXXXXXXXXXXXXXGXXXXXXXXXXXXXXXXXXXGXXXXXXXXXXXXXXXXXXXGXXXXXXXXXXXXXXXXXXXGXXXXXXXXXXXXXXXXXXXGXXXXXXXXXXXXXXXXXXXGXXXXXXXXXXXXXXXXXXXGXXXXXXXXXXXXXXXXXXX,0,300,0

28455,13,0,13,37,250,0,0,261,173,88,GXXXXXXXXXXXXXXXXXXXGXXXXXXXXXXXXXXXXXXXGXXXXXXXXXXXXXXXXXXXGXXXXXXXXXXXXXXXXXXXGXXXXXXXXXXXXXXXXXXXGXXXXXXXXXXXXXXXXXXXGXXXXXXXXXXXXXXXXXXXGXXXXXXXXXXXXXXXXXXXGXXXXXXXXXXXXXXXXXXXGXXXXXXXXXXXXXXXXXXXGXXXXXXXXXXXXXXXXXXXGXXXXXXXXXXXXXXXXXXXGXXXXXXXXXXXXXXXXXXX,0,300,0
28476,13,0,13,37,250,0,0,262,172,90,GXXXXXXXXXXXXXXXXXXXGXXXXXXXXXXXXXXXXXXXGXXXXXXXXXXXXXXXXXXXGXXXXXXXXXXXXXXXXXXXGXXXXXXXXXXXXXXXXXXXGXXXXXXXXXXXXXXXXXXXGXXXXXXXXXXXXXXXXXXXGXXXXXXXXXXXXXXXXXXXGXXXXXXXXXXXXXXXXXXXGXXXXXXXXXXXXXXXXXXXGXXXXXXXXXXXXXXXXXXXGXXXXXXXXXXXXXXXXXXXGXXXXXXXXXXXXXXXXXXX,0,300,0
28497,13,0,13,37,250,0,0,262,172,90,GXXXXXXXXXXXXXXXXXXXGXXXXXXXXXXXXXXXXXXXGXXXXXXXXXXXXXXXXXXXGXXXXXXXXXXXXXXXXXXXGXXXXXXXXXXXXXXXXXXXGXXXXXXXXXXXXXXXXXXXGXXXXXXXXXXXXXXXXXXXGXXXXXXXXXXXXXXXXXXXGXXXXXXXXXXXXXXXXXXXGXXXXXXXXXXXXXXXXXXXGXXXXXXXXXXXXXXXXXXXGXXXXXXXXXXXXXXXXXXXGXXXXXXXXXXXXXXXXXXX,0,300,0
28518,13,0,13,34,253,0,0,265,171,94,GXXXXXXXXXXXXXXXXXXXGXXXXXXXXXXXXXXXXXXXGXXXXXXXXXXXXXXXXXXXGXXXXXXXXXXXXXXXXXXXGXXXXXXXXXXXXXXXXXXXGXXXXXXXXXXXXXXXXXXXGXXXXXXXXXXXXXXXXXXXGXXXXXXXXXXXXXXXXXXXGXXXXXXXXXXXXXXXXXXXGXXXXXXXXXXXXXXXXXXXGXXXXXXXXXXXXXXXXXXXGXXXXXXXXXXXXXXXXXXXGXXXXXXXXXXXXXXXXXXX,0,300,0
28539,13,0,13,36,251,0,0,262,174,88,GXXXXXXXXXXXXXXXXXXXGXXXXXXXXXXXXXXXXXXXGXXXXXXXXXXXXXXXXXXXGXXXXXXXXXXXXXXXXXXXGXXXXXXXXXXXXXXXXXXXGXXXXXXXXXXXXXXXXXXXGXXXXXXXXXXXXXXXXXXXGXXXXXXXXXXXXXXXXXXXGXXXXXXXXXXXXXXXXXXXGXXXXXXXXXXXXXXXXXXXGXXXXXXXXXXXXXXXXXXXGXXXXXXXXXXXXXXXXXXXGXXXXXXXXXXXXXXXXXXX,0,300,0

28560,13,0,13,38,249,0,0,261,172,89,GXXXXXXXXXXXXXXXXXXXGXXXXXXXXXXXXXXXXXXXGXXXXXXXXXXXXXXXXXXXGXXXXXXXXXXXXXXXXXXXGXXXXXXXXXXXXXXXXXXXGXXXXXXXXXXXXXXXXXXXGXXXXXXXXXXXXXXXXXXXGXXXXXXXXXXXXXXXXXXXGXXXXXXXXXXXXXXXXXXXGXXXXXXXXXXXXXXXXXXXGXXXXXXXXXXXXXXXXXXXGXXXXXXXXXXXXXXXXXXXGXXXXXXXXXXXXXXXXXXX,0,300,0
28581,13,0,13,38,249,0,0,261,175,86,GXXXXXXXXXXXXXXXXXXXGXXXXXXXXXXXXXXXXXXXGXXXXXXXXXXXXXXXXXXXGXXXXXXXXXXXXXXXXXXXGXXXXXXXXXXXXXXXXXXXGXXXXXXXXXXXXXXXXXXXGXXXXXXXXXXXXXXXXXXXGXXXXXXXXXXXXXXXXXXXGXXXXXXXXXXXXXXXXXXXGXXXXXXXXXXXXXXXXXXXGXXXXXXXXXXXXXXXXXXXGXXXXXXXXXXXXXXXXXXXGXXXXXXXXXXXXXXXXXXX,0,300,0
28602,13,0,13,41,246,0,0,258,173,85,GXXXXXXXXXXXXXXXXXXXGXXXXXXXXXXXXXXXXXXXGXXXXXXXXXXXXXXXXXXXGXXXXXXXXXXXXXXXXXXXGXXXXXXXXXXXXXXXXXXXGXXXXXXXXXXXXXXXXXXXGXXXXXXXXXXXXXXXXXXXGXXXXXXXXXXXXXXXXXXXGXXXXXXXXXXXXXXXXXXXGXXXXXXXXXXXXXXXXXXXGXXXXXXXXXXXXXXXXXXXGXXXXXXXXXXXXXXXXXXXGXXXXXXXXXXXXXXXXXXX,0,300,0
28623,13,0,13,42,245,0,0,257,175,82,GXXXXXXXXXXXXXXXXXXXGXXXXXXXXXXXXXXXXXXXGXXXXXXXXXXXXXXXXXXXGXXXXXXXXXXXXXXXXXXXGXXXXXXXXXXXXXXXXXXXGXXXXXXXXXXXXXXXXXXXGXXXXXXXXXXXXXXXXXXXGXXXXXXXXXXXXXXXXXXXGXXXXXXXXXXXXXXXXXXXGXXXXXXXXXXXXXXXXXXXGXXXXXXXXXXXXXXXXXXXGXXXXXXXXXXXXXXXXXXXGXXXXXXXXXXXXXXXXXXX,0,300,0
28644,13,0,13,49,238,0,0,250,173,77,GXXXXXXXXXXXXXXXXXXXGXXXXXXXXXXXXXXXXXXXGXXXXXXXXXXXXXXXXXXXGXXXXXXXXXXXXXXXXXXXGXXXXXXXXXXXXXXXXXXXGXXXXXXXXXXXXXXXXXXXGXXXXXXXXXXXXXXXXXXXGXXXXXXXXXXXXXXXXXXXGXXXXXXXXXXXXXXXXXXXGXXXXXXXXXXXXXXXXXXXGXXXXXXXXXXXXXXXXXXXGXXXXXXXXXXXXXXXXXXXGXXXXXXXXXXXXXXXXXXX,0,300,0

28665,13,0,13,47,240,0,0,251,177,74,GXXXXXXXXXXXXXXXXXXXGXXXXXXXXXXXXXXXXXXXGXXXXXXXXXXXXXXXXXXXGXXXXXXXXXXXXXXXXXXXGXXXXXXXXXXXXXXXXXXXGXXXXXXXXXXXXXXXXXXXGXXXXXXXXXXXXXXXXXXXGXXXXXXXXXXXXXXXXXXXGXXXXXXXXXXXXXXXXXXXGXXXXXXXXXXXXXXXXXXXGXXXXXXXXXXXXXXXXXXXGXXXXXXXXXXXXXXXXXXXGXXXXXXXXXXXXXXXXXXX,0,300,0
28686,14,1,13,46,240,0,0,251,179,72,GXXXXXXXXXXXXXXXXXXXGXXXXXXXXXXXXXXXXXXXGAXXXXXXXXXXXXXXXXXXGXXXXXXXXXXXXXXXXXXXGXXXXXXXXXXXXXXXXXXXGXXXXXXXXXXXXXXXXXXXGXXXXXXXXXXXXXXXXXXXGXXXXXXXXXXXXXXXXXXXGXXXXXXXXXXXXXXXXXXXGXXXXXXXXXXXXXXXXXXXGXXXXXXXXXXXXXXXXXXXGXXXXXXXXXXXXXXXXXXXGXXXXXXXXXXXXXXXXXXX,0,300,0
28707,14,1,13,46,240,0,0,252,177,75,GXXXXXXXXXXXXXXXXXXXGXXXXXXXXXXXXXXXXXXXGAXXXXXXXXXXXXXXXXXXGXXXXXXXXXXXXXXXXXXXGXXXXXXXXXXXXXXXXXXXGXXXXXXXXXXXXXXXXXXXGXXXXXXXXXXXXXXXXXXXGXXXXXXXXXXXXXXXXXXXGXXXXXXXXXXXXXXXXXXXGXXXXXXXXXXXXXXXXXXXGXXXXXXXXXXXXXXXXXXXGXXXXXXXXXXXXXXXXXXXGXXXXXXXXXXXXXXXXXXX,0,300,0
28728,14,1,13,51,235,0,0,247,178,69,GXXXXXXXXXXXXXXXXXXXGXXXXXXXXXXXXXXXXXXXGAXXXXXXXXXXXXXXXXXXGXXXXXXXXXXXXXXXXXXXGXXXXXXXXXXXXXXXXXXXGXXXXXXXXXXXXXXXXXXXGXXXXXXXXXXXXXXXXXXXGXXXXXXXXXXXXXXXXXXXGXXXXXXXXXXXXXXXXXXXGXXXXXXXXXXXXXXXXXXXGXXXXXXXXXXXXXXXXXXXGXXXXXXXXXXXXXXXXXXXGXXXXXXXXXXXXXXXXXXX,0,300,0
28749,14,1,13,49,237,0,0,249,176,73,GXXXXXXXXXXXXXXXXXXXGXXXXXXXXXXXXXXXXXXXGAXXXXXXXXXXXXXXXXXXGXXXXXXXXXXXXXXXXXXXGXXXXXXXXXXXXXXXXXXXGXXXXXXXXXXXXXXXXXXXGXXXXXXXXXXXXXXXXXXXGXXXXXXXXXXXXXXXXXXXGXXXXXXXXXXXXXXXXXXXGXXXXXXXXXXXXXXXXXXXGXXXXXXXXXXXXXXXXXXXGXXXXXXXXXXXXXXXXXXXGXXXXXXXXXXXXXXXXXXX,0,300,0

28770,13,0,13,49,238,0,0,248,179,69,GXXXXXXXXXXXXXXXXXXXGXXXXXXXXXXXXXXXXXXXGXXXXXXXXXXXXXXXXXXXGXXXXXXXXXXXXXXXXXXXGXXXXXXXXXXXXXXXXXXXGXXXXXXXXXXXXXXXXXXXGXXXXXXXXXXXXXXXXXXXGXXXXXXXXXXXXXXXXXXXGXXXXXXXXXXXXXXXXXXXGXXXXXXXXXXXXXXXXXXXGXXXXXXXXXXXXXXXXXXXGXXXXXXXXXXXXXXXXXXXGXXXXXXXXXXXXXXXXXXX,0,300,0
28791,13,0,13,52,235,0,0,247,174,73,GXXXXXXXXXXXXXXXXXXXGXXXXXXXXXXXXXXXXXXXGXXXXXXXXXXXXXXXXXXXGXXXXXXXXXXXXXXXXXXXGXXXXXXXXXXXXXXXXXXXGXXXXXXXXXXXXXXXXXXXGXXXXXXXXXXXXXXXXXXXGXXXXXXXXXXXXXXXXXXXGXXXXXXXXXXXXXXXXXXXGXXXXXXXXXXXXXXXXXXXGXXXXXXXXXXXXXXXXXXXGXXXXXXXXXXXXXXXXXXXGXXXXXXXXXXXXXXXXXXX,0,300,0
28812,13,0,13,50,237,0,0,249,175,74,GXXXXXXXXXXXXXXXXXXXGXXXXXXXXXXXXXXXXXXXGXXXXXXXXXXXXXXXXXXXGXXXXXXXXXXXXXXXXXXXGXXXXXXXXXXXXXXXXXXXGXXXXXXXXXXXXXXXXXXXGXXXXXXXXXXXXXXXXXXXGXXXXXXXXXXXXXXXXXXXGXXXXXXXXXXXXXXXXXXXGXXXXXXXXXXXXXXXXXXXGXXXXXXXXXXXXXXXXXXXGXXXXXXXXXXXXXXXXXXXGXXXXXXXXXXXXXXXXXXX,0,300,0
28833,13,0,13,48,239,0,0,251,175,76,GXXXXXXXXXXXXXXXXXXXGXXXXXXXXXXXXXXXXXXXGXXXXXXXXXXXXXXXXXXXGXXXXXXXXXXXXXXXXXXXGXXXXXXXXXXXXXXXXXXXGXXXXXXXXXXXXXXXXXXXGXXXXXXXXXXXXXXXXXXXGXXXXXXXXXXXXXXXXXXXGXXXXXXXXXXXXXXXXXXXGXXXXXXXXXXXXXXXXXXXGXXXXXXXXXXXXXXXXXXXGXXXXXXXXXXXXXXXXXXXGXXXXXXXXXXXXXXXXXXX,0,300,0
28854,13,0,13,39,248,0,0,259,178,81,GXXXXXXXXXXXXXXXXXXXGXXXXXXXXXXXXXXXXXXXGXXXXXXXXXXXXXXXXXXXGXXXXXXXXXXXXXXXXXXXGXXXXXXXXXXXXXXXXXXXGXXXXXXXXXXXXXXXXXXXGXXXXXXXXXXXXXXXXXXXGXXXXXXXXXXXXXXXXXXXGXXXXXXXXXXXXXXXXXXXGXXXXXXXXXXXXXXXXXXXGXXXXXXXXXXXXXXXXXXXGXXXXXXXXXXXXXXXXXXXGXXXXXXXXXXXXXXXXXXX,0,300,0

28875,13,0,13,41,246,0,0,258,175,83,GXXXXXXXXXXXXXXXXXXXGXXXXXXXXXXXXXXXXXXXGXXXXXXXXXXXXXXXXXXXGXXXXXXXXXXXXXXXXXXXGXXXXXXXXXXXXXXXXXXXGXXXXXXXXXXXXXXXXXXXGXXXXXXXXXXXXXXXXXXXGXXXXXXXXXXXXXXXXXXXGXXXXXXXXXXXXXXXXXXXGXXXXXXXXXXXXXXXXXXXGXXXXXXXXXXXXXXXXXXXGXXXXXXXXXXXXXXXXXXXGXXXXXXXXXXXXXXXXXXX,0,300,0
28896,13,0,13,40,247,0,0,258,177,81,GXXXXXXXXXXXXXXXXXXXGXXXXXXXXXXXXXXXXXXXGXXXXXXXXXXXXXXXXXXXGXXXXXXXXXXXXXXXXXXXGXXXXXXXXXXXXXXXXXXXGXXXXXXXXXXXXXXXXXXXGXXXXXXXXXXXXXXXXXXXGXXXXXXXXXXXXXXXXXXXGXXXXXXXXXXXXXXXXXXXGXXXXXXXXXXXXXXXXXXXGXXXXXXXXXXXXXXXXXXXGXXXXXXXXXXXXXXXXXXXGXXXXXXXXXXXXXXXXXXX,0,300,0
28917,13,0,13,40,247,0,0,259,179,80,GXXXXXXXXXXXXXXXXXXXGXXXXXXXXXXXXXXXXXXXGXXXXXXXXXXXXXXXXXXXGXXXXXXXXXXXXXXXXXXXGXXXXXXXXXXXXXXXXXXXGXXXXXXXXXXXXXXXXXXXGXXXXXXXXXXXXXXXXXXXGXXXXXXXXXXXXXXXXXXXGXXXXXXXXXXXXXXXXXXXGXXXXXXXXXXXXXXXXXXXGXXXXXXXXXXXXXXXXXXXGXXXXXXXXXXXXXXXXXXXGXXXXXXXXXXXXXXXXXXX,0,300,0
28938,13,0,13,40,247,0,0,259,175,84,GXXXXXXXXXXXXXXXXXXXGXXXXXXXXXXXXXXXXXXXGXXXXXXXXXXXXXXXXXXXGXXXXXXXXXXXXXXXXXXXGXXXXXXXXXXXXXXXXXXXGXXXXXXXXXXXXXXXXXXXGXXXXXXXXXXXXXXXXXXXGXXXXXXXXXXXXXXXXXXXGXXXXXXXXXXXXXXXXXXXGXXXXXXXXXXXXXXXXXXXGXXXXXXXXXXXXXXXXXXXGXXXXXXXXXXXXXXXXXXXGXXXXXXXXXXXXXXXXXXX,0,300,0
28959,13,0,13,40,247,0,0,259,175,84,GXXXXXXXXXXXXXXXXXXXGXXXXXXXXXXXXXXXXXXXGXXXXXXXXXXXXXXXXXXXGXXXXXXXXXXXXXXXXXXXGXXXXXXXXXXXXXXXXXXXGXXXXXXXXXXXXXXXXXXXGXXXXXXXXXXXXXXXXXXXGXXXXXXXXXXXXXXXXXXXGXXXXXXXXXXXXXXXXXXXGXXXXXXXXXXXXXXXXXXXGXXXXXXXXXXXXXXXXXXXGXXXXXXXXXXXXXXXXXXXGXXXXXXXXXXXXXXXXXXX,0,300,0

28980,13,0,13,42,245,0,0,257,182,75,GXXXXXXXXXXXXXXXXXXXGXXXXXXXXXXXXXXXXXXXGXXXXXXXXXXXXXXXXXXXGXXXXXXXXXXXXXXXXXXXGXXXXXXXXXXXXXXXXXXXGXXXXXXXXXXXXXXXXXXXGXXXXXXXXXXXXXXXXXXXGXXXXXXXXXXXXXXXXXXXGXXXXXXXXXXXXXXXXXXXGXXXXXXXXXXXXXXXXXXXGXXXXXXXXXXXXXXXXXXXGXXXXXXXXXXXXXXXXXXXGXXXXXXXXXXXXXXXXXXX,0,300,0
29001,13,0,13,41,246,0,0,258,180,78,GXXXXXXXXXXXXXXXXXXXGXXXXXXXXXXXXXXXXXXXGXXXXXXXXXXXXXXXXXXXGXXXXXXXXXXXXXXXXXXXGXXXXXXXXXXXXXXXXXXXGXXXXXXXXXXXXXXXXXXXGXXXXXXXXXXXXXXXXXXXGXXXXXXXXXXXXXXXXXXXGXXXXXXXXXXXXXXXXXXXGXXXXXXXXXXXXXXXXXXXGXXXXXXXXXXXXXXXXXXXGXXXXXXXXXXXXXXXXXXXGXXXXXXXXXXXXXXXXXXX,0,300,0
29022,13,0,13,42,245,0,0,257,178,79,GXXXXXXXXXXXXXXXXXXXGXXXXXXXXXXXXXXXXXXXGXXXXXXXXXXXXXXXXXXXGXXXXXXXXXXXXXXXXXXXGXXXXXXXXXXXXXXXXXXXGXXXXXXXXXXXXXXXXXXXGXXXXXXXXXXXXXXXXXXXGXXXXXXXXXXXXXXXXXXXGXXXXXXXXXXXXXXXXXXXGXXXXXXXXXXXXXXXXXXXGXXXXXXXXXXXXXXXXXXXGXXXXXXXXXXXXXXXXXXXGXXXXXXXXXXXXXXXXXXX,0,300,0
29043,13,0,13,45,242,0,0,254,179,75,GXXXXXXXXXXXXXXXXXXXGXXXXXXXXXXXXXXXXXXXGXXXXXXXXXXXXXXXXXXXGXXXXXXXXXXXXXXXXXXXGXXXXXXXXXXXXXXXXXXXGXXXXXXXXXXXXXXXXXXXGXXXXXXXXXXXXXXXXXXXGXXXXXXXXXXXXXXXXXXXGXXXXXXXXXXXXXXXXXXXGXXXXXXXXXXXXXXXXXXXGXXXXXXXXXXXXXXXXXXXGXXXXXXXXXXXXXXXXXXXGXXXXXXXXXXXXXXXXXXX,0,300,0
29064,13,0,13,44,243,0,0,254,178,76,GXXXXXXXXXXXXXXXXXXXGXXXXXXXXXXXXXXXXXXXGXXXXXXXXXXXXXXXXXXXGXXXXXXXXXXXXXXXXXXXGXXXXXXXXXXXXXXXXXXXGXXXXXXXXXXXXXXXXXXXGXXXXXXXXXXXXXXXXXXXGXXXXXXXXXXXXXXXXXXXGXXXXXXXXXXXXXXXXXXXGXXXXXXXXXXXXXXXXXXXGXXXXXXXXXXXXXXXXXXXGXXXXXXXXXXXXXXXXXXXGXXXXXXXXXXXXXXXXXXX,0,300,0

29085,13,0,13,48,239,0,0,251,178,73,GXXXXXXXXXXXXXXXXXXXGXXXXXXXXXXXXXXXXXXXGXXXXXXXXXXXXXXXXXXXGXXXXXXXXXXXXXXXXXXXGXXXXXXXXXXXXXXXXXXXGXXXXXXXXXXXXXXXXXXXGXXXXXXXXXXXXXXXXXXXGXXXXXXXXXXXXXXXXXXXGXXXXXXXXXXXXXXXXXXXGXXXXXXXXXXXXXXXXXXXGXXXXXXXXXXXXXXXXXXXGXXXXXXXXXXXXXXXXXXXGXXXXXXXXXXXXXXXXXXX,0,300,0
29106,13,0,13,43,244,0,0,255,182,73,GXXXXXXXXXXXXXXXXXXXGXXXXXXXXXXXXXXXXXXXGXXXXXXXXXXXXXXXXXXXGXXXXXXXXXXXXXXXXXXXGXXXXXXXXXXXXXXXXXXXGXXXXXXXXXXXXXXXXXXXGXXXXXXXXXXXXXXXXXXXGXXXXXXXXXXXXXXXXXXXGXXXXXXXXXXXXXXXXXXXGXXXXXXXXXXXXXXXXXXXGXXXXXXXXXXXXXXXXXXXGXXXXXXXXXXXXXXXXXXXGXXXXXXXXXXXXXXXXXXX,0,300,0
29127,13,0,13,44,243,0,0,254,180,74,GXXXXXXXXXXXXXXXXXXXGXXXXXXXXXXXXXXXXXXXGXXXXXXXXXXXXXXXXXXXGXXXXXXXXXXXXXXXXXXXGXXXXXXXXXXXXXXXXXXXGXXXXXXXXXXXXXXXXXXXGXXXXXXXXXXXXXXXXXXXGXXXXXXXXXXXXXXXXXXXGXXXXXXXXXXXXXXXXXXXGXXXXXXXXXXXXXXXXXXXGXXXXXXXXXXXXXXXXXXXGXXXXXXXXXXXXXXXXXXXGXXXXXXXXXXXXXXXXXXX,0,300,0
29148,13,0,13,44,243,0,0,255,176,79,GXXXXXXXXXXXXXXXXXXXGXXXXXXXXXXXXXXXXXXXGXXXXXXXXXXXXXXXXXXXGXXXXXXXXXXXXXXXXXXXGXXXXXXXXXXXXXXXXXXXGXXXXXXXXXXXXXXXXXXXGXXXXXXXXXXXXXXXXXXXGXXXXXXXXXXXXXXXXXXXGXXXXXXXXXXXXXXXXXXXGXXXXXXXXXXXXXXXXXXXGXXXXXXXXXXXXXXXXXXXGXXXXXXXXXXXXXXXXXXXGXXXXXXXXXXXXXXXXXXX,0,300,0
29169,13,0,13,41,246,0,0,258,177,81,GXXXXXXXXXXXXXXXXXXXGXXXXXXXXXXXXXXXXXXXGXXXXXXXXXXXXXXXXXXXGXXXXXXXXXXXXXXXXXXXGXXXXXXXXXXXXXXXXXXXGXXXXXXXXXXXXXXXXXXXGXXXXXXXXXXXXXXXXXXXGXXXXXXXXXXXXXXXXXXXGXXXXXXXXXXXXXXXXXXXGXXXXXXXXXXXXXXXXXXXGXXXXXXXXXXXXXXXXXXXGXXXXXXXXXXXXXXXXXXXGXXXXXXXXXXXXXXXXXXX,0,300,0

29190,13,0,13,40,247,0,0,258,176,82,GXXXXXXXXXXXXXXXXXXXGXXXXXXXXXXXXXXXXXXXGXXXXXXXXXXXXXXXXXXXGXXXXXXXXXXXXXXXXXXXGXXXXXXXXXXXXXXXXXXXGXXXXXXXXXXXXXXXXXXXGXXXXXXXXXXXXXXXXXXXGXXXXXXXXXXXXXXXXXXXGXXXXXXXXXXXXXXXXXXXGXXXXXXXXXXXXXXXXXXXGXXXXXXXXXXXXXXXXXXXGXXXXXXXXXXXXXXXXXXXGXXXXXXXXXXXXXXXXXXX,0,300,0
29211,13,0,13,38,249,0,0,260,176,84,GXXXXXXXXXXXXXXXXXXXGXXXXXXXXXXXXXXXXXXXGXXXXXXXXXXXXXXXXXXXGXXXXXXXXXXXXXXXXXXXGXXXXXXXXXXXXXXXXXXXGXXXXXXXXXXXXXXXXXXXGXXXXXXXXXXXXXXXXXXXGXXXXXXXXXXXXXXXXXXXGXXXXXXXXXXXXXXXXXXXGXXXXXXXXXXXXXXXXXXXGXXXXXXXXXXXXXXXXXXXGXXXXXXXXXXXXXXXXXXXGXXXXXXXXXXXXXXXXXXX,0,300,0
29232,13,0,13,38,249,0,0,261,180,81,GXXXXXXXXXXXXXXXXXXXGXXXXXXXXXXXXXXXXXXXGXXXXXXXXXXXXXXXXXXXGXXXXXXXXXXXXXXXXXXXGXXXXXXXXXXXXXXXXXXXGXXXXXXXXXXXXXXXXXXXGXXXXXXXXXXXXXXXXXXXGXXXXXXXXXXXXXXXXXXXGXXXXXXXXXXXXXXXXXXXGXXXXXXXXXXXXXXXXXXXGXXXXXXXXXXXXXXXXXXXGXXXXXXXXXXXXXXXXXXXGXXXXXXXXXXXXXXXXXXX,0,300,0
29253,13,0,13,39,248,0,0,260,181,79,GXXXXXXXXXXXXXXXXXXXGXXXXXXXXXXXXXXXXXXXGXXXXXXXXXXXXXXXXXXXGXXXXXXXXXXXXXXXXXXXGXXXXXXXXXXXXXXXXXXXGXXXXXXXXXXXXXXXXXXXGXXXXXXXXXXXXXXXXXXXGXXXXXXXXXXXXXXXXXXXGXXXXXXXXXXXXXXXXXXXGXXXXXXXXXXXXXXXXXXXGXXXXXXXXXXXXXXXXXXXGXXXXXXXXXXXXXXXXXXXGXXXXXXXXXXXXXXXXXXX,0,300,0
29274,13,0,13,39,248,0,0,260,179,81,GXXXXXXXXXXXXXXXXXXXGXXXXXXXXXXXXXXXXXXXGXXXXXXXXXXXXXXXXXXXGXXXXXXXXXXXXXXXXXXXGXXXXXXXXXXXXXXXXXXXGXXXXXXXXXXXXXXXXXXXGXXXXXXXXXXXXXXXXXXXGXXXXXXXXXXXXXXXXXXXGXXXXXXXXXXXXXXXXXXXGXXXXXXXXXXXXXXXXXXXGXXXXXXXXXXXXXXXXXXXGXXXXXXXXXXXXXXXXXXXGXXXXXXXXXXXXXXXXXXX,0,300,0

29295,13,0,13,41,246,0,0,257,178,79,GXXXXXXXXXXXXXXXXXXXGXXXXXXXXXXXXXXXXXXXGXXXXXXXXXXXXXXXXXXXGXXXXXXXXXXXXXXXXXXXGXXXXXXXXXXXXXXXXXXXGXXXXXXXXXXXXXXXXXXXGXXXXXXXXXXXXXXXXXXXGXXXXXXXXXXXXXXXXXXXGXXXXXXXXXXXXXXXXXXXGXXXXXXXXXXXXXXXXXXXGXXXXXXXXXXXXXXXXXXXGXXXXXXXXXXXXXXXXXXXGXXXXXXXXXXXXXXXXXXX,0,300,0
29316,13,0,13,45,242,0,0,254,179,75,GXXXXXXXXXXXXXXXXXXXGXXXXXXXXXXXXXXXXXXXGXXXXXXXXXXXXXXXXXXXGXXXXXXXXXXXXXXXXXXXGXXXXXXXXXXXXXXXXXXXGXXXXXXXXXXXXXXXXXXXGXXXXXXXXXXXXXXXXXXXGXXXXXXXXXXXXXXXXXXXGXXXXXXXXXXXXXXXXXXXGXXXXXXXXXXXXXXXXXXXGXXXXXXXXXXXXXXXXXXXGXXXXXXXXXXXXXXXXXXXGXXXXXXXXXXXXXXXXXXX,0,300,0
29337,13,0,13,48,239,0,0,251,178,73,GXXXXXXXXXXXXXXXXXXXGXXXXXXXXXXXXXXXXXXXGXXXXXXXXXXXXXXXXXXXGXXXXXXXXXXXXXXXXXXXGXXXXXXXXXXXXXXXXXXXGXXXXXXXXXXXXXXXXXXXGXXXXXXXXXXXXXXXXXXXGXXXXXXXXXXXXXXXXXXXGXXXXXXXXXXXXXXXXXXXGXXXXXXXXXXXXXXXXXXXGXXXXXXXXXXXXXXXXXXXGXXXXXXXXXXXXXXXXXXXGXXXXXXXXXXXXXXXXXXX,0,300,0
29358,13,0,13,51,236,0,0,248,177,71,GXXXXXXXXXXXXXXXXXXXGXXXXXXXXXXXXXXXXXXXGXXXXXXXXXXXXXXXXXXXGXXXXXXXXXXXXXXXXXXXGXXXXXXXXXXXXXXXXXXXGXXXXXXXXXXXXXXXXXXXGXXXXXXXXXXXXXXXXXXXGXXXXXXXXXXXXXXXXXXXGXXXXXXXXXXXXXXXXXXXGXXXXXXXXXXXXXXXXXXXGXXXXXXXXXXXXXXXXXXXGXXXXXXXXXXXXXXXXXXXGXXXXXXXXXXXXXXXXXXX,0,300,0
29379,13,0,13,48,239,0,0,250,179,71,GXXXXXXXXXXXXXXXXXXXGXXXXXXXXXXXXXXXXXXXGXXXXXXXXXXXXXXXXXXXGXXXXXXXXXXXXXXXXXXXGXXXXXXXXXXXXXXXXXXXGXXXXXXXXXXXXXXXXXXXGXXXXXXXXXXXXXXXXXXXGXXXXXXXXXXXXXXXXXXXGXXXXXXXXXXXXXXXXXXXGXXXXXXXXXXXXXXXXXXXGXXXXXXXXXXXXXXXXXXXGXXXXXXXXXXXXXXXXXXXGXXXXXXXXXXXXXXXXXXX,0,300,0

29400,13,0,13,49,238,0,0,250,177,73,GXXXXXXXXXXXXXXXXXXXGXXXXXXXXXXXXXXXXXXXGXXXXXXXXXXXXXXXXXXXGXXXXXXXXXXXXXXXXXXXGXXXXXXXXXXXXXXXXXXXGXXXXXXXXXXXXXXXXXXXGXXXXXXXXXXXXXXXXXXXGXXXXXXXXXXXXXXXXXXXGXXXXXXXXXXXXXXXXXXXGXXXXXXXXXXXXXXXXXXXGXXXXXXXXXXXXXXXXXXXGXXXXXXXXXXXXXXXXXXXGXXXXXXXXXXXXXXXXXXX,0,300,0
29421,13,0,13,50,237,0,0,248,178,70,GXXXXXXXXXXXXXXXXXXXGXXXXXXXXXXXXXXXXXXXGXXXXXXXXXXXXXXXXXXXGXXXXXXXXXXXXXXXXXXXGXXXXXXXXXXXXXXXXXXXGXXXXXXXXXXXXXXXXXXXGXXXXXXXXXXXXXXXXXXXGXXXXXXXXXXXXXXXXXXXGXXXXXXXXXXXXXXXXXXXGXXXXXXXXXXXXXXXXXXXGXXXXXXXXXXXXXXXXXXXGXXXXXXXXXXXXXXXXXXXGXXXXXXXXXXXXXXXXXXX,0,300,0
29442,13,0,13,49,238,0,0,249,181,68,GXXXXXXXXXXXXXXXXXXXGXXXXXXXXXXXXXXXXXXXGXXXXXXXXXXXXXXXXXXXGXXXXXXXXXXXXXXXXXXXGXXXXXXXXXXXXXXXXXXXGXXXXXXXXXXXXXXXXXXXGXXXXXXXXXXXXXXXXXXXGXXXXXXXXXXXXXXXXXXXGXXXXXXXXXXXXXXXXXXXGXXXXXXXXXXXXXXXXXXXGXXXXXXXXXXXXXXXXXXXGXXXXXXXXXXXXXXXXXXXGXXXXXXXXXXXXXXXXXXX,0,300,0
29463,13,0,13,45,242,0,0,254,181,73,GXXXXXXXXXXXXXXXXXXXGXXXXXXXXXXXXXXXXXXXGXXXXXXXXXXXXXXXXXXXGXXXXXXXXXXXXXXXXXXXGXXXXXXXXXXXXXXXXXXXGXXXXXXXXXXXXXXXXXXXGXXXXXXXXXXXXXXXXXXXGXXXXXXXXXXXXXXXXXXXGXXXXXXXXXXXXXXXXXXXGXXXXXXXXXXXXXXXXXXXGXXXXXXXXXXXXXXXXXXXGXXXXXXXXXXXXXXXXXXXGXXXXXXXXXXXXXXXXXXX,0,300,0
29484,13,0,13,47,240,0,0,252,178,74,GXXXXXXXXXXXXXXXXXXXGXXXXXXXXXXXXXXXXXXXGXXXXXXXXXXXXXXXXXXXGXXXXXXXXXXXXXXXXXXXGXXXXXXXXXXXXXXXXXXXGXXXXXXXXXXXXXXXXXXXGXXXXXXXXXXXXXXXXXXXGXXXXXXXXXXXXXXXXXXXGXXXXXXXXXXXXXXXXXXXGXXXXXXXXXXXXXXXXXXXGXXXXXXXXXXXXXXXXXXXGXXXXXXXXXXXXXXXXXXXGXXXXXXXXXXXXXXXXXXX,0,300,0

29505,13,0,13,46,241,0,0,253,178,75,GXXXXXXXXXXXXXXXXXXXGXXXXXXXXXXXXXXXXXXXGXXXXXXXXXXXXXXXXXXXGXXXXXXXXXXXXXXXXXXXGXXXXXXXXXXXXXXXXXXXGXXXXXXXXXXXXXXXXXXXGXXXXXXXXXXXXXXXXXXXGXXXXXXXXXXXXXXXXXXXGXXXXXXXXXXXXXXXXXXXGXXXXXXXXXXXXXXXXXXXGXXXXXXXXXXXXXXXXXXXGXXXXXXXXXXXXXXXXXXXGXXXXXXXXXXXXXXXXXXX,0,300,0
29526,13,0,13,40,247,0,0,258,183,75,GXXXXXXXXXXXXXXXXXXXGXXXXXXXXXXXXXXXXXXXGXXXXXXXXXXXXXXXXXXXGXXXXXXXXXXXXXXXXXXXGXXXXXXXXXXXXXXXXXXXGXXXXXXXXXXXXXXXXXXXGXXXXXXXXXXXXXXXXXXXGXXXXXXXXXXXXXXXXXXXGXXXXXXXXXXXXXXXXXXXGXXXXXXXXXXXXXXXXXXXGXXXXXXXXXXXXXXXXXXXGXXXXXXXXXXXXXXXXXXXGXXXXXXXXXXXXXXXXXXX,0,300,0
29547,13,0,13,39,248,0,0,259,183,76,GXXXXXXXXXXXXXXXXXXXGXXXXXXXXXXXXXXXXXXXGXXXXXXXXXXXXXXXXXXXGXXXXXXXXXXXXXXXXXXXGXXXXXXXXXXXXXXXXXXXGXXXXXXXXXXXXXXXXXXXGXXXXXXXXXXXXXXXXXXXGXXXXXXXXXXXXXXXXXXXGXXXXXXXXXXXXXXXXXXXGXXXXXXXXXXXXXXXXXXXGXXXXXXXXXXXXXXXXXXXGXXXXXXXXXXXXXXXXXXXGXXXXXXXXXXXXXXXXXXX,0,300,0
29568,13,0,13,40,247,0,0,258,183,75,GXXXXXXXXXXXXXXXXXXXGXXXXXXXXXXXXXXXXXXXGXXXXXXXXXXXXXXXXXXXGXXXXXXXXXXXXXXXXXXXGXXXXXXXXXXXXXXXXXXXGXXXXXXXXXXXXXXXXXXXGXXXXXXXXXXXXXXXXXXXGXXXXXXXXXXXXXXXXXXXGXXXXXXXXXXXXXXXXXXXGXXXXXXXXXXXXXXXXXXXGXXXXXXXXXXXXXXXXXXXGXXXXXXXXXXXXXXXXXXXGXXXXXXXXXXXXXXXXXXX,0,300,0
29589,13,0,13,39,248,0,0,260,180,80,GXXXXXXXXXXXXXXXXXXXGXXXXXXXXXXXXXXXXXXXGXXXXXXXXXXXXXXXXXXXGXXXXXXXXXXXXXXXXXXXGXXXXXXXXXXXXXXXXXXXGXXXXXXXXXXXXXXXXXXXGXXXXXXXXXXXXXXXXXXXGXXXXXXXXXXXXXXXXXXXGXXXXXXXXXXXXXXXXXXXGXXXXXXXXXXXXXXXXXXXGXXXXXXXXXXXXXXXXXXXGXXXXXXXXXXXXXXXXXXXGXXXXXXXXXXXXXXXXXXX,0,300,0

29610,13,0,13,41,246,0,0,258,177,81,GXXXXXXXXXXXXXXXXXXXGXXXXXXXXXXXXXXXXXXXGXXXXXXXXXXXXXXXXXXXGXXXXXXXXXXXXXXXXXXXGXXXXXXXXXXXXXXXXXXXGXXXXXXXXXXXXXXXXXXXGXXXXXXXXXXXXXXXXXXXGXXXXXXXXXXXXXXXXXXXGXXXXXXXXXXXXXXXXXXXGXXXXXXXXXXXXXXXXXXXGXXXXXXXXXXXXXXXXXXXGXXXXXXXXXXXXXXXXXXXGXXXXXXXXXXXXXXXXXXX,0,300,0
29631,13,0,13,46,241,0,0,253,173,80,GXXXXXXXXXXXXXXXXXXXGXXXXXXXXXXXXXXXXXXXGXXXXXXXXXXXXXXXXXXXGXXXXXXXXXXXXXXXXXXXGXXXXXXXXXXXXXXXXXXXGXXXXXXXXXXXXXXXXXXXGXXXXXXXXXXXXXXXXXXXGXXXXXXXXXXXXXXXXXXXGXXXXXXXXXXXXXXXXXXXGXXXXXXXXXXXXXXXXXXXGXXXXXXXXXXXXXXXXXXXGXXXXXXXXXXXXXXXXXXXGXXXXXXXXXXXXXXXXXXX,0,300,0
29652,13,0,13,44,243,0,0,255,177,78,GXXXXXXXXXXXXXXXXXXXGXXXXXXXXXXXXXXXXXXXGXXXXXXXXXXXXXXXXXXXGXXXXXXXXXXXXXXXXXXXGXXXXXXXXXXXXXXXXXXXGXXXXXXXXXXXXXXXXXXXGXXXXXXXXXXXXXXXXXXXGXXXXXXXXXXXXXXXXXXXGXXXXXXXXXXXXXXXXXXXGXXXXXXXXXXXXXXXXXXXGXXXXXXXXXXXXXXXXXXXGXXXXXXXXXXXXXXXXXXXGXXXXXXXXXXXXXXXXXXX,0,300,0
29673,13,0,13,40,247,0,0,259,178,81,GXXXXXXXXXXXXXXXXXXXGXXXXXXXXXXXXXXXXXXXGXXXXXXXXXXXXXXXXXXXGXXXXXXXXXXXXXXXXXXXGXXXXXXXXXXXXXXXXXXXGXXXXXXXXXXXXXXXXXXXGXXXXXXXXXXXXXXXXXXXGXXXXXXXXXXXXXXXXXXXGXXXXXXXXXXXXXXXXXXXGXXXXXXXXXXXXXXXXXXXGXXXXXXXXXXXXXXXXXXXGXXXXXXXXXXXXXXXXXXXGXXXXXXXXXXXXXXXXXXX,0,300,0
29694,13,0,13,40,247,0,0,259,179,80,GXXXXXXXXXXXXXXXXXXXGXXXXXXXXXXXXXXXXXXXGXXXXXXXXXXXXXXXXXXXGXXXXXXXXXXXXXXXXXXXGXXXXXXXXXXXXXXXXXXXGXXXXXXXXXXXXXXXXXXXGXXXXXXXXXXXXXXXXXXXGXXXXXXXXXXXXXXXXXXXGXXXXXXXXXXXXXXXXXXXGXXXXXXXXXXXXXXXXXXXGXXXXXXXXXXXXXXXXXXXGXXXXXXXXXXXXXXXXXXXGXXXXXXXXXXXXXXXXXXX,0,300,0

29715,13,0,13,41,246,0,0,258,179,79,GXXXXXXXXXXXXXXXXXXXGXXXXXXXXXXXXXXXXXXXGXXXXXXXXXXXXXXXXXXXGXXXXXXXXXXXXXXXXXXXGXXXXXXXXXXXXXXXXXXXGXXXXXXXXXXXXXXXXXXXGXXXXXXXXXXXXXXXXXXXGXXXXXXXXXXXXXXXXXXXGXXXXXXXXXXXXXXXXXXXGXXXXXXXXXXXXXXXXXXXGXXXXXXXXXXXXXXXXXXXGXXXXXXXXXXXXXXXXXXXGXXXXXXXXXXXXXXXXXXX,0,300,0
29736,13,0,13,41,246,0,0,258,181,77,GXXXXXXXXXXXXXXXXXXXGXXXXXXXXXXXXXXXXXXXGXXXXXXXXXXXXXXXXXXXGXXXXXXXXXXXXXXXXXXXGXXXXXXXXXXXXXXXXXXXGXXXXXXXXXXXXXXXXXXXGXXXXXXXXXXXXXXXXXXXGXXXXXXXXXXXXXXXXXXXGXXXXXXXXXXXXXXXXXXXGXXXXXXXXXXXXXXXXXXXGXXXXXXXXXXXXXXXXXXXGXXXXXXXXXXXXXXXXXXXGXXXXXXXXXXXXXXXXXXX,0,300,0
29757,13,0,13,37,250,0,0,261,181,80,GXXXXXXXXXXXXXXXXXXXGXXXXXXXXXXXXXXXXXXXGXXXXXXXXXXXXXXXXXXXGXXXXXXXXXXXXXXXXXXXGXXXXXXXXXXXXXXXXXXXGXXXXXXXXXXXXXXXXXXXGXXXXXXXXXXXXXXXXXXXGXXXXXXXXXXXXXXXXXXXGXXXXXXXXXXXXXXXXXXXGXXXXXXXXXXXXXXXXXXXGXXXXXXXXXXXXXXXXXXXGXXXXXXXXXXXXXXXXXXXGXXXXXXXXXXXXXXXXXXX,0,300,0
29778,13,0,13,38,249,0,0,261,180,81,GXXXXXXXXXXXXXXXXXXXGXXXXXXXXXXXXXXXXXXXGXXXXXXXXXXXXXXXXXXXGXXXXXXXXXXXXXXXXXXXGXXXXXXXXXXXXXXXXXXXGXXXXXXXXXXXXXXXXXXXGXXXXXXXXXXXXXXXXXXXGXXXXXXXXXXXXXXXXXXXGXXXXXXXXXXXXXXXXXXXGXXXXXXXXXXXXXXXXXXXGXXXXXXXXXXXXXXXXXXXGXXXXXXXXXXXXXXXXXXXGXXXXXXXXXXXXXXXXXXX,0,300,0
29799,13,0,13,33,254,0,0,266,183,83,GXXXXXXXXXXXXXXXXXXXGXXXXXXXXXXXXXXXXXXXGXXXXXXXXXXXXXXXXXXXGXXXXXXXXXXXXXXXXXXXGXXXXXXXXXXXXXXXXXXXGXXXXXXXXXXXXXXXXXXXGXXXXXXXXXXXXXXXXXXXGXXXXXXXXXXXXXXXXXXXGXXXXXXXXXXXXXXXXXXXGXXXXXXXXXXXXXXXXXXXGXXXXXXXXXXXXXXXXXXXGXXXXXXXXXXXXXXXXXXXGXXXXXXXXXXXXXXXXXXX,0,300,0

29820,13,0,13,36,251,0,0,263,182,81,GXXXXXXXXXXXXXXXXXXXGXXXXXXXXXXXXXXXXXXXGXXXXXXXXXXXXXXXXXXXGXXXXXXXXXXXXXXXXXXXGXXXXXXXXXXXXXXXXXXXGXXXXXXXXXXXXXXXXXXXGXXXXXXXXXXXXXXXXXXXGXXXXXXXXXXXXXXXXXXXGXXXXXXXXXXXXXXXXXXXGXXXXXXXXXXXXXXXXXXXGXXXXXXXXXXXXXXXXXXXGXXXXXXXXXXXXXXXXXXXGXXXXXXXXXXXXXXXXXXX,0,300,0
29841,13,0,13,39,248,0,0,260,184,76,GXXXXXXXXXXXXXXXXXXXGXXXXXXXXXXXXXXXXXXXGXXXXXXXXXXXXXXXXXXXGXXXXXXXXXXXXXXXXXXXGXXXXXXXXXXXXXXXXXXXGXXXXXXXXXXXXXXXXXXXGXXXXXXXXXXXXXXXXXXXGXXXXXXXXXXXXXXXXXXXGXXXXXXXXXXXXXXXXXXXGXXXXXXXXXXXXXXXXXXXGXXXXXXXXXXXXXXXXXXXGXXXXXXXXXXXXXXXXXXXGXXXXXXXXXXXXXXXXXXX,0,300,0
29862,13,0,13,41,246,0,0,258,181,77,GXXXXXXXXXXXXXXXXXXXGXXXXXXXXXXXXXXXXXXXGXXXXXXXXXXXXXXXXXXXGXXXXXXXXXXXXXXXXXXXGXXXXXXXXXXXXXXXXXXXGXXXXXXXXXXXXXXXXXXXGXXXXXXXXXXXXXXXXXXXGXXXXXXXXXXXXXXXXXXXGXXXXXXXXXXXXXXXXXXXGXXXXXXXXXXXXXXXXXXXGXXXXXXXXXXXXXXXXXXXGXXXXXXXXXXXXXXXXXXXGXXXXXXXXXXXXXXXXXXX,0,300,0
29883,13,0,13,41,246,0,0,258,180,78,GXXXXXXXXXXXXXXXXXXXGXXXXXXXXXXXXXXXXXXXGXXXXXXXXXXXXXXXXXXXGXXXXXXXXXXXXXXXXXXXGXXXXXXXXXXXXXXXXXXXGXXXXXXXXXXXXXXXXXXXGXXXXXXXXXXXXXXXXXXXGXXXXXXXXXXXXXXXXXXXGXXXXXXXXXXXXXXXXXXXGXXXXXXXXXXXXXXXXXXXGXXXXXXXXXXXXXXXXXXXGXXXXXXXXXXXXXXXXXXXGXXXXXXXXXXXXXXXXXXX,0,300,0
29904,13,0,13,43,244,0,0,255,178,77,GXXXXXXXXXXXXXXXXXXXGXXXXXXXXXXXXXXXXXXXGXXXXXXXXXXXXXXXXXXXGXXXXXXXXXXXXXXXXXXXGXXXXXXXXXXXXXXXXXXXGXXXXXXXXXXXXXXXXXXXGXXXXXXXXXXXXXXXXXXXGXXXXXXXXXXXXXXXXXXXGXXXXXXXXXXXXXXXXXXXGXXXXXXXXXXXXXXXXXXXGXXXXXXXXXXXXXXXXXXXGXXXXXXXXXXXXXXXXXXXGXXXXXXXXXXXXXXXXXXX,0,300,0

29925,13,0,13,43,244,0,0,256,177,79,GXXXXXXXXXXXXXXXXXXXGXXXXXXXXXXXXXXXXXXXGXXXXXXXXXXXXXXXXXXXGXXXXXXXXXXXXXXXXXXXGXXXXXXXXXXXXXXXXXXXGXXXXXXXXXXXXXXXXXXXGXXXXXXXXXXXXXXXXXXXGXXXXXXXXXXXXXXXXXXXGXXXXXXXXXXXXXXXXXXXGXXXXXXXXXXXXXXXXXXXGXXXXXXXXXXXXXXXXXXXGXXXXXXXXXXXXXXXXXXXGXXXXXXXXXXXXXXXXXXX,0,300,0
29946,13,0,13,45,242,0,0,254,177,77,GXXXXXXXXXXXXXXXXXXXGXXXXXXXXXXXXXXXXXXXGXXXXXXXXXXXXXXXXXXXGXXXXXXXXXXXXXXXXXXXGXXXXXXXXXXXXXXXXXXXGXXXXXXXXXXXXXXXXXXXGXXXXXXXXXXXXXXXXXXXGXXXXXXXXXXXXXXXXXXXGXXXXXXXXXXXXXXXXXXXGXXXXXXXXXXXXXXXXXXXGXXXXXXXXXXXXXXXXXXXGXXXXXXXXXXXXXXXXXXXGXXXXXXXXXXXXXXXXXXX,0,300,0
29967,13,0,13,40,247,0,0,259,181,78,GXXXXXXXXXXXXXXXXXXXGXXXXXXXXXXXXXXXXXXXGXXXXXXXXXXXXXXXXXXXGXXXXXXXXXXXXXXXXXXXGXXXXXXXXXXXXXXXXXXXGXXXXXXXXXXXXXXXXXXXGXXXXXXXXXXXXXXXXXXXGXXXXXXXXXXXXXXXXXXXGXXXXXXXXXXXXXXXXXXXGXXXXXXXXXXXXXXXXXXXGXXXXXXXXXXXXXXXXXXXGXXXXXXXXXXXXXXXXXXXGXXXXXXXXXXXXXXXXXXX,0,300,0
29988,13,0,13,44,243,0,0,255,180,75,GXXXXXXXXXXXXXXXXXXXGXXXXXXXXXXXXXXXXXXXGXXXXXXXXXXXXXXXXXXXGXXXXXXXXXXXXXXXXXXXGXXXXXXXXXXXXXXXXXXXGXXXXXXXXXXXXXXXXXXXGXXXXXXXXXXXXXXXXXXXGXXXXXXXXXXXXXXXXXXXGXXXXXXXXXXXXXXXXXXXGXXXXXXXXXXXXXXXXXXXGXXXXXXXXXXXXXXXXXXXGXXXXXXXXXXXXXXXXXXXGXXXXXXXXXXXXXXXXXXX,0,300,0
30009,13,0,13,45,242,0,0,254,184,70,GXXXXXXXXXXXXXXXXXXXGXXXXXXXXXXXXXXXXXXXGXXXXXXXXXXXXXXXXXXXGXXXXXXXXXXXXXXXXXXXGXXXXXXXXXXXXXXXXXXXGXXXXXXXXXXXXXXXXXXXGXXXXXXXXXXXXXXXXXXXGXXXXXXXXXXXXXXXXXXXGXXXXXXXXXXXXXXXXXXXGXXXXXXXXXXXXXXXXXXXGXXXXXXXXXXXXXXXXXXXGXXXXXXXXXXXXXXXXXXXGXXXXXXXXXXXXXXXXXXX,0,300,0

30030,14,1,13,41,245,0,0,256,186,70,GXXXXXXXXXXXXXXXXXXXGXXXXXXXXXXXXXXXXXXXGAXXXXXXXXXXXXXXXXXXGXXXXXXXXXXXXXXXXXXXGXXXXXXXXXXXXXXXXXXXGXXXXXXXXXXXXXXXXXXXGXXXXXXXXXXXXXXXXXXXGXXXXXXXXXXXXXXXXXXXGXXXXXXXXXXXXXXXXXXXGXXXXXXXXXXXXXXXXXXXGXXXXXXXXXXXXXXXXXXXGXXXXXXXXXXXXXXXXXXXGXXXXXXXXXXXXXXXXXXX,0,300,0
30051,13,0,13,45,242,0,0,254,181,73,GXXXXXXXXXXXXXXXXXXXGXXXXXXXXXXXXXXXXXXXGXXXXXXXXXXXXXXXXXXXGXXXXXXXXXXXXXXXXXXXGXXXXXXXXXXXXXXXXXXXGXXXXXXXXXXXXXXXXXXXGXXXXXXXXXXXXXXXXXXXGXXXXXXXXXXXXXXXXXXXGXXXXXXXXXXXXXXXXXXXGXXXXXXXXXXXXXXXXXXXGXXXXXXXXXXXXXXXXXXXGXXXXXXXXXXXXXXXXXXXGXXXXXXXXXXXXXXXXXXX,0,300,0
30072,13,0,13,43,244,0,0,256,180,76,GXXXXXXXXXXXXXXXXXXXGXXXXXXXXXXXXXXXXXXXGXXXXXXXXXXXXXXXXXXXGXXXXXXXXXXXXXXXXXXXGXXXXXXXXXXXXXXXXXXXGXXXXXXXXXXXXXXXXXXXGXXXXXXXXXXXXXXXXXXXGXXXXXXXXXXXXXXXXXXXGXXXXXXXXXXXXXXXXXXXGXXXXXXXXXXXXXXXXXXXGXXXXXXXXXXXXXXXXXXXGXXXXXXXXXXXXXXXXXXXGXXXXXXXXXXXXXXXXXXX,0,300,0
30093,13,0,13,39,248,0,0,259,179,80,GXXXXXXXXXXXXXXXXXXXGXXXXXXXXXXXXXXXXXXXGXXXXXXXXXXXXXXXXXXXGXXXXXXXXXXXXXXXXXXXGXXXXXXXXXXXXXXXXXXXGXXXXXXXXXXXXXXXXXXXGXXXXXXXXXXXXXXXXXXXGXXXXXXXXXXXXXXXXXXXGXXXXXXXXXXXXXXXXXXXGXXXXXXXXXXXXXXXXXXXGXXXXXXXXXXXXXXXXXXXGXXXXXXXXXXXXXXXXXXXGXXXXXXXXXXXXXXXXXXX,0,300,0
30114,13,0,13,41,246,0,0,258,182,76,GXXXXXXXXXXXXXXXXXXXGXXXXXXXXXXXXXXXXXXXGXXXXXXXXXXXXXXXXXXXGXXXXXXXXXXXXXXXXXXXGXXXXXXXXXXXXXXXXXXXGXXXXXXXXXXXXXXXXXXXGXXXXXXXXXXXXXXXXXXXGXXXXXXXXXXXXXXXXXXXGXXXXXXXXXXXXXXXXXXXGXXXXXXXXXXXXXXXXXXXGXXXXXXXXXXXXXXXXXXXGXXXXXXXXXXXXXXXXXXXGXXXXXXXXXXXXXXXXXXX,0,300,0

30135,13,0,13,39,248,0,0,258,181,77,GXXXXXXXXXXXXXXXXXXXGXXXXXXXXXXXXXXXXXXXGXXXXXXXXXXXXXXXXXXXGXXXXXXXXXXXXXXXXXXXGXXXXXXXXXXXXXXXXXXXGXXXXXXXXXXXXXXXXXXXGXXXXXXXXXXXXXXXXXXXGXXXXXXXXXXXXXXXXXXXGXXXXXXXXXXXXXXXXXXXGXXXXXXXXXXXXXXXXXXXGXXXXXXXXXXXXXXXXXXXGXXXXXXXXXXXXXXXXXXXGXXXXXXXXXXXXXXXXXXX,0,300,0
30156,13,0,13,41,246,0,0,259,184,75,GXXXXXXXXXXXXXXXXXXXGXXXXXXXXXXXXXXXXXXXGXXXXXXXXXXXXXXXXXXXGXXXXXXXXXXXXXXXXXXXGXXXXXXXXXXXXXXXXXXXGXXXXXXXXXXXXXXXXXXXGXXXXXXXXXXXXXXXXXXXGXXXXXXXXXXXXXXXXXXXGXXXXXXXXXXXXXXXXXXXGXXXXXXXXXXXXXXXXXXXGXXXXXXXXXXXXXXXXXXXGXXXXXXXXXXXXXXXXXXXGXXXXXXXXXXXXXXXXXXX,0,300,0
30177,13,0,13,49,238,0,0,251,176,75,GXXXXXXXXXXXXXXXXXXXGXXXXXXXXXXXXXXXXXXXGXXXXXXXXXXXXXXXXXXXGXXXXXXXXXXXXXXXXXXXGXXXXXXXXXXXXXXXXXXXGXXXXXXXXXXXXXXXXXXXGXXXXXXXXXXXXXXXXXXXGXXXXXXXXXXXXXXXXXXXGXXXXXXXXXXXXXXXXXXXGXXXXXXXXXXXXXXXXXXXGXXXXXXXXXXXXXXXXXXXGXXXXXXXXXXXXXXXXXXXGXXXXXXXXXXXXXXXXXXX,0,300,0
30198,13,0,13,46,241,0,0,253,179,74,GXXXXXXXXXXXXXXXXXXXGXXXXXXXXXXXXXXXXXXXGXXXXXXXXXXXXXXXXXXXGXXXXXXXXXXXXXXXXXXXGXXXXXXXXXXXXXXXXXXXGXXXXXXXXXXXXXXXXXXXGXXXXXXXXXXXXXXXXXXXGXXXXXXXXXXXXXXXXXXXGXXXXXXXXXXXXXXXXXXXGXXXXXXXXXXXXXXXXXXXGXXXXXXXXXXXXXXXXXXXGXXXXXXXXXXXXXXXXXXXGXXXXXXXXXXXXXXXXXXX,0,300,0
30219,13,0,13,46,241,0,0,254,176,78,GXXXXXXXXXXXXXXXXXXXGXXXXXXXXXXXXXXXXXXXGXXXXXXXXXXXXXXXXXXXGXXXXXXXXXXXXXXXXXXXGXXXXXXXXXXXXXXXXXXXGXXXXXXXXXXXXXXXXXXXGXXXXXXXXXXXXXXXXXXXGXXXXXXXXXXXXXXXXXXXGXXXXXXXXXXXXXXXXXXXGXXXXXXXXXXXXXXXXXXXGXXXXXXXXXXXXXXXXXXXGXXXXXXXXXXXXXXXXXXXGXXXXXXXXXXXXXXXXXXX,0,300,0

30240,13,0,13,41,246,0,0,258,178,80,GXXXXXXXXXXXXXXXXXXXGXXXXXXXXXXXXXXXXXXXGXXXXXXXXXXXXXXXXXXXGXXXXXXXXXXXXXXXXXXXGXXXXXXXXXXXXXXXXXXXGXXXXXXXXXXXXXXXXXXXGXXXXXXXXXXXXXXXXXXXGXXXXXXXXXXXXXXXXXXXGXXXXXXXXXXXXXXXXXXXGXXXXXXXXXXXXXXXXXXXGXXXXXXXXXXXXXXXXXXXGXXXXXXXXXXXXXXXXXXXGXXXXXXXXXXXXXXXXXXX,0,300,0
30261,13,0,13,36,251,0,0,263,179,84,GXXXXXXXXXXXXXXXXXXXGXXXXXXXXXXXXXXXXXXXGXXXXXXXXXXXXXXXXXXXGXXXXXXXXXXXXXXXXXXXGXXXXXXXXXXXXXXXXXXXGXXXXXXXXXXXXXXXXXXXGXXXXXXXXXXXXXXXXXXXGXXXXXXXXXXXXXXXXXXXGXXXXXXXXXXXXXXXXXXXGXXXXXXXXXXXXXXXXXXXGXXXXXXXXXXXXXXXXXXXGXXXXXXXXXXXXXXXXXXXGXXXXXXXXXXXXXXXXXXX,0,300,0
30282,13,0,13,39,248,0,0,260,181,79,GXXXXXXXXXXXXXXXXXXXGXXXXXXXXXXXXXXXXXXXGXXXXXXXXXXXXXXXXXXXGXXXXXXXXXXXXXXXXXXXGXXXXXXXXXXXXXXXXXXXGXXXXXXXXXXXXXXXXXXXGXXXXXXXXXXXXXXXXXXXGXXXXXXXXXXXXXXXXXXXGXXXXXXXXXXXXXXXXXXXGXXXXXXXXXXXXXXXXXXXGXXXXXXXXXXXXXXXXXXXGXXXXXXXXXXXXXXXXXXXGXXXXXXXXXXXXXXXXXXX,0,300,0
30303,13,0,13,35,252,0,0,264,185,79,GXXXXXXXXXXXXXXXXXXXGXXXXXXXXXXXXXXXXXXXGXXXXXXXXXXXXXXXXXXXGXXXXXXXXXXXXXXXXXXXGXXXXXXXXXXXXXXXXXXXGXXXXXXXXXXXXXXXXXXXGXXXXXXXXXXXXXXXXXXXGXXXXXXXXXXXXXXXXXXXGXXXXXXXXXXXXXXXXXXXGXXXXXXXXXXXXXXXXXXXGXXXXXXXXXXXXXXXXXXXGXXXXXXXXXXXXXXXXXXXGXXXXXXXXXXXXXXXXXXX,0,300,0
30324,13,0,13,39,248,0,0,260,182,78,GXXXXXXXXXXXXXXXXXXXGXXXXXXXXXXXXXXXXXXXGXXXXXXXXXXXXXXXXXXXGXXXXXXXXXXXXXXXXXXXGXXXXXXXXXXXXXXXXXXXGXXXXXXXXXXXXXXXXXXXGXXXXXXXXXXXXXXXXXXXGXXXXXXXXXXXXXXXXXXXGXXXXXXXXXXXXXXXXXXXGXXXXXXXXXXXXXXXXXXXGXXXXXXXXXXXXXXXXXXXGXXXXXXXXXXXXXXXXXXXGXXXXXXXXXXXXXXXXXXX,0,300,0

30345,13,0,13,40,247,0,0,259,180,79,GXXXXXXXXXXXXXXXXXXXGXXXXXXXXXXXXXXXXXXXGXXXXXXXXXXXXXXXXXXXGXXXXXXXXXXXXXXXXXXXGXXXXXXXXXXXXXXXXXXXGXXXXXXXXXXXXXXXXXXXGXXXXXXXXXXXXXXXXXXXGXXXXXXXXXXXXXXXXXXXGXXXXXXXXXXXXXXXXXXXGXXXXXXXXXXXXXXXXXXXGXXXXXXXXXXXXXXXXXXXGXXXXXXXXXXXXXXXXXXXGXXXXXXXXXXXXXXXXXXX,0,300,0
30366,13,0,13,41,246,0,0,259,180,79,GXXXXXXXXXXXXXXXXXXXGXXXXXXXXXXXXXXXXXXXGXXXXXXXXXXXXXXXXXXXGXXXXXXXXXXXXXXXXXXXGXXXXXXXXXXXXXXXXXXXGXXXXXXXXXXXXXXXXXXXGXXXXXXXXXXXXXXXXXXXGXXXXXXXXXXXXXXXXXXXGXXXXXXXXXXXXXXXXXXXGXXXXXXXXXXXXXXXXXXXGXXXXXXXXXXXXXXXXXXXGXXXXXXXXXXXXXXXXXXXGXXXXXXXXXXXXXXXXXXX,0,300,0
30387,13,0,13,45,242,0,0,254,178,76,GXXXXXXXXXXXXXXXXXXXGXXXXXXXXXXXXXXXXXXXGXXXXXXXXXXXXXXXXXXXGXXXXXXXXXXXXXXXXXXXGXXXXXXXXXXXXXXXXXXXGXXXXXXXXXXXXXXXXXXXGXXXXXXXXXXXXXXXXXXXGXXXXXXXXXXXXXXXXXXXGXXXXXXXXXXXXXXXXXXXGXXXXXXXXXXXXXXXXXXXGXXXXXXXXXXXXXXXXXXXGXXXXXXXXXXXXXXXXXXXGXXXXXXXXXXXXXXXXXXX,0,300,0
30408,14,1,13,45,241,0,0,254,175,79,GXXXXXXXXXXXXXXXXXXXGXXXXXXXXXXXXXXXXXXXGXXXXXXXXXXXXXXXXXXXGAXXXXXXXXXXXXXXXXXXGXXXXXXXXXXXXXXXXXXXGXXXXXXXXXXXXXXXXXXXGXXXXXXXXXXXXXXXXXXXGXXXXXXXXXXXXXXXXXXXGXXXXXXXXXXXXXXXXXXXGXXXXXXXXXXXXXXXXXXXGXXXXXXXXXXXXXXXXXXXGXXXXXXXXXXXXXXXXXXXGXXXXXXXXXXXXXXXXXXX,0,300,0
30429,14,1,13,43,243,0,0,257,178,79,GXXXXXXXXXXXXXXXXXXXGXXXXXXXXXXXXXXXXXXXGXXXXXXXXXXXXXXXXXXXGAXXXXXXXXXXXXXXXXXXGXXXXXXXXXXXXXXXXXXXGXXXXXXXXXXXXXXXXXXXGXXXXXXXXXXXXXXXXXXXGXXXXXXXXXXXXXXXXXXXGXXXXXXXXXXXXXXXXXXXGXXXXXXXXXXXXXXXXXXXGXXXXXXXXXXXXXXXXXXXGXXXXXXXXXXXXXXXXXXXGXXXXXXXXXXXXXXXXXXX,0,300,0

30450,14,1,13,44,242,0,0,256,178,78,GXXXXXXXXXXXXXXXXXXXGXXXXXXXXXXXXXXXXXXXGXXXXXXXXXXXXXXXXXXXGAXXXXXXXXXXXXXXXXXXGXXXXXXXXXXXXXXXXXXXGXXXXXXXXXXXXXXXXXXXGXXXXXXXXXXXXXXXXXXXGXXXXXXXXXXXXXXXXXXXGXXXXXXXXXXXXXXXXXXXGXXXXXXXXXXXXXXXXXXXGXXXXXXXXXXXXXXXXXXXGXXXXXXXXXXXXXXXXXXXGXXXXXXXXXXXXXXXXXXX,0,300,0
30471,14,1,13,42,244,0,0,257,183,74,GXXXXXXXXXXXXXXXXXXXGXXXXXXXXXXXXXXXXXXXGXXXXXXXXXXXXXXXXXXXGAXXXXXXXXXXXXXXXXXXGXXXXXXXXXXXXXXXXXXXGXXXXXXXXXXXXXXXXXXXGXXXXXXXXXXXXXXXXXXXGXXXXXXXXXXXXXXXXXXXGXXXXXXXXXXXXXXXXXXXGXXXXXXXXXXXXXXXXXXXGXXXXXXXXXXXXXXXXXXXGXXXXXXXXXXXXXXXXXXXGXXXXXXXXXXXXXXXXXXX,0,300,0
30492,14,1,13,43,243,0,0,257,179,78,GXXXXXXXXXXXXXXXXXXXGXXXXXXXXXXXXXXXXXXXGXXXXXXXXXXXXXXXXXXXGAXXXXXXXXXXXXXXXXXXGXXXXXXXXXXXXXXXXXXXGXXXXXXXXXXXXXXXXXXXGXXXXXXXXXXXXXXXXXXXGXXXXXXXXXXXXXXXXXXXGXXXXXXXXXXXXXXXXXXXGXXXXXXXXXXXXXXXXXXXGXXXXXXXXXXXXXXXXXXXGXXXXXXXXXXXXXXXXXXXGXXXXXXXXXXXXXXXXXXX,0,300,0
30513,14,1,13,39,247,0,0,260,179,81,GXXXXXXXXXXXXXXXXXXXGXXXXXXXXXXXXXXXXXXXGXXXXXXXXXXXXXXXXXXXGAXXXXXXXXXXXXXXXXXXGXXXXXXXXXXXXXXXXXXXGXXXXXXXXXXXXXXXXXXXGXXXXXXXXXXXXXXXXXXXGXXXXXXXXXXXXXXXXXXXGXXXXXXXXXXXXXXXXXXXGXXXXXXXXXXXXXXXXXXXGXXXXXXXXXXXXXXXXXXXGXXXXXXXXXXXXXXXXXXXGXXXXXXXXXXXXXXXXXXX,0,300,0
30534,14,1,13,35,251,0,0,264,180,84,GXXXXXXXXXXXXXXXXXXXGXXXXXXXXXXXXXXXXXXXGXXXXXXXXXXXXXXXXXXXGAXXXXXXXXXXXXXXXXXXGXXXXXXXXXXXXXXXXXXXGXXXXXXXXXXXXXXXXXXXGXXXXXXXXXXXXXXXXXXXGXXXXXXXXXXXXXXXXXXXGXXXXXXXXXXXXXXXXXXXGXXXXXXXXXXXXXXXXXXXGXXXXXXXXXXXXXXXXXXXGXXXXXXXXXXXXXXXXXXXGXXXXXXXXXXXXXXXXXXX,0,300,0

30555,14,1,13,36,250,0,0,262,184,78,GXXXXXXXXXXXXXXXXXXXGXXXXXXXXXXXXXXXXXXXGXXXXXXXXXXXXXXXXXXXGAXXXXXXXXXXXXXXXXXXGXXXXXXXXXXXXXXXXXXXGXXXXXXXXXXXXXXXXXXXGXXXXXXXXXXXXXXXXXXXGXXXXXXXXXXXXXXXXXXXGXXXXXXXXXXXXXXXXXXXGXXXXXXXXXXXXXXXXXXXGXXXXXXXXXXXXXXXXXXXGXXXXXXXXXXXXXXXXXXXGXXXXXXXXXXXXXXXXXXX,0,300,0
30576,13,0,13,40,247,0,0,259,185,74,GXXXXXXXXXXXXXXXXXXXGXXXXXXXXXXXXXXXXXXXGXXXXXXXXXXXXXXXXXXXGXXXXXXXXXXXXXXXXXXXGXXXXXXXXXXXXXXXXXXXGXXXXXXXXXXXXXXXXXXXGXXXXXXXXXXXXXXXXXXXGXXXXXXXXXXXXXXXXXXXGXXXXXXXXXXXXXXXXXXXGXXXXXXXXXXXXXXXXXXXGXXXXXXXXXXXXXXXXXXXGXXXXXXXXXXXXXXXXXXXGXXXXXXXXXXXXXXXXXXX,0,300,0
30597,13,0,13,37,250,0,0,262,187,75,GXXXXXXXXXXXXXXXXXXXGXXXXXXXXXXXXXXXXXXXGXXXXXXXXXXXXXXXXXXXGXXXXXXXXXXXXXXXXXXXGXXXXXXXXXXXXXXXXXXXGXXXXXXXXXXXXXXXXXXXGXXXXXXXXXXXXXXXXXXXGXXXXXXXXXXXXXXXXXXXGXXXXXXXXXXXXXXXXXXXGXXXXXXXXXXXXXXXXXXXGXXXXXXXXXXXXXXXXXXXGXXXXXXXXXXXXXXXXXXXGXXXXXXXXXXXXXXXXXXX,0,300,0
30618,13,0,13,42,245,0,0,257,183,74,GXXXXXXXXXXXXXXXXXXXGXXXXXXXXXXXXXXXXXXXGXXXXXXXXXXXXXXXXXXXGXXXXXXXXXXXXXXXXXXXGXXXXXXXXXXXXXXXXXXXGXXXXXXXXXXXXXXXXXXXGXXXXXXXXXXXXXXXXXXXGXXXXXXXXXXXXXXXXXXXGXXXXXXXXXXXXXXXXXXXGXXXXXXXXXXXXXXXXXXXGXXXXXXXXXXXXXXXXXXXGXXXXXXXXXXXXXXXXXXXGXXXXXXXXXXXXXXXXXXX,0,300,0
30639,13,0,13,42,245,0,0,257,182,75,GXXXXXXXXXXXXXXXXXXXGXXXXXXXXXXXXXXXXXXXGXXXXXXXXXXXXXXXXXXXGXXXXXXXXXXXXXXXXXXXGXXXXXXXXXXXXXXXXXXXGXXXXXXXXXXXXXXXXXXXGXXXXXXXXXXXXXXXXXXXGXXXXXXXXXXXXXXXXXXXGXXXXXXXXXXXXXXXXXXXGXXXXXXXXXXXXXXXXXXXGXXXXXXXXXXXXXXXXXXXGXXXXXXXXXXXXXXXXXXXGXXXXXXXXXXXXXXXXXXX,0,300,0

30660,13,0,13,43,244,0,0,256,184,72,GXXXXXXXXXXXXXXXXXXXGXXXXXXXXXXXXXXXXXXXGXXXXXXXXXXXXXXXXXXXGXXXXXXXXXXXXXXXXXXXGXXXXXXXXXXXXXXXXXXXGXXXXXXXXXXXXXXXXXXXGXXXXXXXXXXXXXXXXXXXGXXXXXXXXXXXXXXXXXXXGXXXXXXXXXXXXXXXXXXXGXXXXXXXXXXXXXXXXXXXGXXXXXXXXXXXXXXXXXXXGXXXXXXXXXXXXXXXXXXXGXXXXXXXXXXXXXXXXXXX,0,300,0
30681,13,0,13,41,246,0,0,258,184,74,GXXXXXXXXXXXXXXXXXXXGXXXXXXXXXXXXXXXXXXXGXXXXXXXXXXXXXXXXXXXGXXXXXXXXXXXXXXXXXXXGXXXXXXXXXXXXXXXXXXXGXXXXXXXXXXXXXXXXXXXGXXXXXXXXXXXXXXXXXXXGXXXXXXXXXXXXXXXXXXXGXXXXXXXXXXXXXXXXXXXGXXXXXXXXXXXXXXXXXXXGXXXXXXXXXXXXXXXXXXXGXXXXXXXXXXXXXXXXXXXGXXXXXXXXXXXXXXXXXXX,0,300,0
30702,13,0,13,42,245,0,0,256,183,73,GXXXXXXXXXXXXXXXXXXXGXXXXXXXXXXXXXXXXXXXGXXXXXXXXXXXXXXXXXXXGXXXXXXXXXXXXXXXXXXXGXXXXXXXXXXXXXXXXXXXGXXXXXXXXXXXXXXXXXXXGXXXXXXXXXXXXXXXXXXXGXXXXXXXXXXXXXXXXXXXGXXXXXXXXXXXXXXXXXXXGXXXXXXXXXXXXXXXXXXXGXXXXXXXXXXXXXXXXXXXGXXXXXXXXXXXXXXXXXXXGXXXXXXXXXXXXXXXXXXX,0,300,0
30723,13,0,13,43,244,0,0,256,179,77,GXXXXXXXXXXXXXXXXXXXGXXXXXXXXXXXXXXXXXXXGXXXXXXXXXXXXXXXXXXXGXXXXXXXXXXXXXXXXXXXGXXXXXXXXXXXXXXXXXXXGXXXXXXXXXXXXXXXXXXXGXXXXXXXXXXXXXXXXXXXGXXXXXXXXXXXXXXXXXXXGXXXXXXXXXXXXXXXXXXXGXXXXXXXXXXXXXXXXXXXGXXXXXXXXXXXXXXXXXXXGXXXXXXXXXXXXXXXXXXXGXXXXXXXXXXXXXXXXXXX,0,300,0
30744,13,0,13,42,245,0,0,257,181,76,GXXXXXXXXXXXXXXXXXXXGXXXXXXXXXXXXXXXXXXXGXXXXXXXXXXXXXXXXXXXGXXXXXXXXXXXXXXXXXXXGXXXXXXXXXXXXXXXXXXXGXXXXXXXXXXXXXXXXXXXGXXXXXXXXXXXXXXXXXXXGXXXXXXXXXXXXXXXXXXXGXXXXXXXXXXXXXXXXXXXGXXXXXXXXXXXXXXXXXXXGXXXXXXXXXXXXXXXXXXXGXXXXXXXXXXXXXXXXXXXGXXXXXXXXXXXXXXXXXXX,0,300,0

30765,13,0,13,44,243,0,0,255,182,73,GXXXXXXXXXXXXXXXXXXXGXXXXXXXXXXXXXXXXXXXGXXXXXXXXXXXXXXXXXXXGXXXXXXXXXXXXXXXXXXXGXXXXXXXXXXXXXXXXXXXGXXXXXXXXXXXXXXXXXXXGXXXXXXXXXXXXXXXXXXXGXXXXXXXXXXXXXXXXXXXGXXXXXXXXXXXXXXXXXXXGXXXXXXXXXXXXXXXXXXXGXXXXXXXXXXXXXXXXXXXGXXXXXXXXXXXXXXXXXXXGXXXXXXXXXXXXXXXXXXX,0,300,0
30786,13,0,13,46,241,0,0,252,179,73,GXXXXXXXXXXXXXXXXXXXGXXXXXXXXXXXXXXXXXXXGXXXXXXXXXXXXXXXXXXXGXXXXXXXXXXXXXXXXXXXGXXXXXXXXXXXXXXXXXXXGXXXXXXXXXXXXXXXXXXXGXXXXXXXXXXXXXXXXXXXGXXXXXXXXXXXXXXXXXXXGXXXXXXXXXXXXXXXXXXXGXXXXXXXXXXXXXXXXXXXGXXXXXXXXXXXXXXXXXXXGXXXXXXXXXXXXXXXXXXXGXXXXXXXXXXXXXXXXXXX,0,300,0
30807,13,0,13,44,243,0,0,254,183,71,GXXXXXXXXXXXXXXXXXXXGXXXXXXXXXXXXXXXXXXXGXXXXXXXXXXXXXXXXXXXGXXXXXXXXXXXXXXXXXXXGXXXXXXXXXXXXXXXXXXXGXXXXXXXXXXXXXXXXXXXGXXXXXXXXXXXXXXXXXXXGXXXXXXXXXXXXXXXXXXXGXXXXXXXXXXXXXXXXXXXGXXXXXXXXXXXXXXXXXXXGXXXXXXXXXXXXXXXXXXXGXXXXXXXXXXXXXXXXXXXGXXXXXXXXXXXXXXXXXXX,0,300,0
30828,13,0,13,45,242,0,0,255,185,70,GXXXXXXXXXXXXXXXXXXXGXXXXXXXXXXXXXXXXXXXGXXXXXXXXXXXXXXXXXXXGXXXXXXXXXXXXXXXXXXXGXXXXXXXXXXXXXXXXXXXGXXXXXXXXXXXXXXXXXXXGXXXXXXXXXXXXXXXXXXXGXXXXXXXXXXXXXXXXXXXGXXXXXXXXXXXXXXXXXXXGXXXXXXXXXXXXXXXXXXXGXXXXXXXXXXXXXXXXXXXGXXXXXXXXXXXXXXXXXXXGXXXXXXXXXXXXXXXXXXX,0,300,0
30849,13,0,13,47,240,0,0,253,183,70,GXXXXXXXXXXXXXXXXXXXGXXXXXXXXXXXXXXXXXXXGXXXXXXXXXXXXXXXXXXXGXXXXXXXXXXXXXXXXXXXGXXXXXXXXXXXXXXXXXXXGXXXXXXXXXXXXXXXXXXXGXXXXXXXXXXXXXXXXXXXGXXXXXXXXXXXXXXXXXXXGXXXXXXXXXXXXXXXXXXXGXXXXXXXXXXXXXXXXXXXGXXXXXXXXXXXXXXXXXXXGXXXXXXXXXXXXXXXXXXXGXXXXXXXXXXXXXXXXXXX,0,300,0

30870,13,0,13,47,240,0,0,253,184,69,GXXXXXXXXXXXXXXXXXXXGXXXXXXXXXXXXXXXXXXXGXXXXXXXXXXXXXXXXXXXGXXXXXXXXXXXXXXXXXXXGXXXXXXXXXXXXXXXXXXXGXXXXXXXXXXXXXXXXXXXGXXXXXXXXXXXXXXXXXXXGXXXXXXXXXXXXXXXXXXXGXXXXXXXXXXXXXXXXXXXGXXXXXXXXXXXXXXXXXXXGXXXXXXXXXXXXXXXXXXXGXXXXXXXXXXXXXXXXXXXGXXXXXXXXXXXXXXXXXXX,0,300,0
30891,13,0,13,50,237,0,0,249,179,70,GXXXXXXXXXXXXXXXXXXXGXXXXXXXXXXXXXXXXXXXGXXXXXXXXXXXXXXXXXXXGXXXXXXXXXXXXXXXXXXXGXXXXXXXXXXXXXXXXXXXGXXXXXXXXXXXXXXXXXXXGXXXXXXXXXXXXXXXXXXXGXXXXXXXXXXXXXXXXXXXGXXXXXXXXXXXXXXXXXXXGXXXXXXXXXXXXXXXXXXXGXXXXXXXXXXXXXXXXXXXGXXXXXXXXXXXXXXXXXXXGXXXXXXXXXXXXXXXXXXX,0,300,0
30912,13,0,13,48,239,0,0,251,178,73,GXXXXXXXXXXXXXXXXXXXGXXXXXXXXXXXXXXXXXXXGXXXXXXXXXXXXXXXXXXXGXXXXXXXXXXXXXXXXXXXGXXXXXXXXXXXXXXXXXXXGXXXXXXXXXXXXXXXXXXXGXXXXXXXXXXXXXXXXXXXGXXXXXXXXXXXXXXXXXXXGXXXXXXXXXXXXXXXXXXXGXXXXXXXXXXXXXXXXXXXGXXXXXXXXXXXXXXXXXXXGXXXXXXXXXXXXXXXXXXXGXXXXXXXXXXXXXXXXXXX,0,300,0
30933,13,0,13,50,237,0,0,249,180,69,GXXXXXXXXXXXXXXXXXXXGXXXXXXXXXXXXXXXXXXXGXXXXXXXXXXXXXXXXXXXGXXXXXXXXXXXXXXXXXXXGXXXXXXXXXXXXXXXXXXXGXXXXXXXXXXXXXXXXXXXGXXXXXXXXXXXXXXXXXXXGXXXXXXXXXXXXXXXXXXXGXXXXXXXXXXXXXXXXXXXGXXXXXXXXXXXXXXXXXXXGXXXXXXXXXXXXXXXXXXXGXXXXXXXXXXXXXXXXXXXGXXXXXXXXXXXXXXXXXXX,0,300,0
30954,13,0,13,50,237,0,0,249,182,67,GXXXXXXXXXXXXXXXXXXXGXXXXXXXXXXXXXXXXXXXGXXXXXXXXXXXXXXXXXXXGXXXXXXXXXXXXXXXXXXXGXXXXXXXXXXXXXXXXXXXGXXXXXXXXXXXXXXXXXXXGXXXXXXXXXXXXXXXXXXXGXXXXXXXXXXXXXXXXXXXGXXXXXXXXXXXXXXXXXXXGXXXXXXXXXXXXXXXXXXXGXXXXXXXXXXXXXXXXXXXGXXXXXXXXXXXXXXXXXXXGXXXXXXXXXXXXXXXXXXX,0,300,0

30975,13,0,13,52,235,0,0,248,183,65,GXXXXXXXXXXXXXXXXXXXGXXXXXXXXXXXXXXXXXXXGXXXXXXXXXXXXXXXXXXXGXXXXXXXXXXXXXXXXXXXGXXXXXXXXXXXXXXXXXXXGXXXXXXXXXXXXXXXXXXXGXXXXXXXXXXXXXXXXXXXGXXXXXXXXXXXXXXXXXXXGXXXXXXXXXXXXXXXXXXXGXXXXXXXXXXXXXXXXXXXGXXXXXXXXXXXXXXXXXXXGXXXXXXXXXXXXXXXXXXXGXXXXXXXXXXXXXXXXXXX,0,300,0
30996,13,0,13,51,236,0,0,249,181,68,GXXXXXXXXXXXXXXXXXXXGXXXXXXXXXXXXXXXXXXXGXXXXXXXXXXXXXXXXXXXGXXXXXXXXXXXXXXXXXXXGXXXXXXXXXXXXXXXXXXXGXXXXXXXXXXXXXXXXXXXGXXXXXXXXXXXXXXXXXXXGXXXXXXXXXXXXXXXXXXXGXXXXXXXXXXXXXXXXXXXGXXXXXXXXXXXXXXXXXXXGXXXXXXXXXXXXXXXXXXXGXXXXXXXXXXXXXXXXXXXGXXXXXXXXXXXXXXXXXXX,0,300,0
31017,13,0,13,47,240,0,0,253,183,70,GXXXXXXXXXXXXXXXXXXXGXXXXXXXXXXXXXXXXXXXGXXXXXXXXXXXXXXXXXXXGXXXXXXXXXXXXXXXXXXXGXXXXXXXXXXXXXXXXXXXGXXXXXXXXXXXXXXXXXXXGXXXXXXXXXXXXXXXXXXXGXXXXXXXXXXXXXXXXXXXGXXXXXXXXXXXXXXXXXXXGXXXXXXXXXXXXXXXXXXXGXXXXXXXXXXXXXXXXXXXGXXXXXXXXXXXXXXXXXXXGXXXXXXXXXXXXXXXXXXX,0,300,0
31038,13,0,13,47,240,0,0,253,179,74,GXXXXXXXXXXXXXXXXXXXGXXXXXXXXXXXXXXXXXXXGXXXXXXXXXXXXXXXXXXXGXXXXXXXXXXXXXXXXXXXGXXXXXXXXXXXXXXXXXXXGXXXXXXXXXXXXXXXXXXXGXXXXXXXXXXXXXXXXXXXGXXXXXXXXXXXXXXXXXXXGXXXXXXXXXXXXXXXXXXXGXXXXXXXXXXXXXXXXXXXGXXXXXXXXXXXXXXXXXXXGXXXXXXXXXXXXXXXXXXXGXXXXXXXXXXXXXXXXXXX,0,300,0
31059,13,0,13,44,243,0,0,255,180,75,GXXXXXXXXXXXXXXXXXXXGXXXXXXXXXXXXXXXXXXXGXXXXXXXXXXXXXXXXXXXGXXXXXXXXXXXXXXXXXXXGXXXXXXXXXXXXXXXXXXXGXXXXXXXXXXXXXXXXXXXGXXXXXXXXXXXXXXXXXXXGXXXXXXXXXXXXXXXXXXXGXXXXXXXXXXXXXXXXXXXGXXXXXXXXXXXXXXXXXXXGXXXXXXXXXXXXXXXXXXXGXXXXXXXXXXXXXXXXXXXGXXXXXXXXXXXXXXXXXXX,0,300,0

31080,13,0,13,39,248,0,0,261,180,81,GXXXXXXXXXXXXXXXXXXXGXXXXXXXXXXXXXXXXXXXGXXXXXXXXXXXXXXXXXXXGXXXXXXXXXXXXXXXXXXXGXXXXXXXXXXXXXXXXXXXGXXXXXXXXXXXXXXXXXXXGXXXXXXXXXXXXXXXXXXXGXXXXXXXXXXXXXXXXXXXGXXXXXXXXXXXXXXXXXXXGXXXXXXXXXXXXXXXXXXXGXXXXXXXXXXXXXXXXXXXGXXXXXXXXXXXXXXXXXXXGXXXXXXXXXXXXXXXXXXX,0,300,0
31101,13,0,13,35,252,0,0,265,181,84,GXXXXXXXXXXXXXXXXXXXGXXXXXXXXXXXXXXXXXXXGXXXXXXXXXXXXXXXXXXXGXXXXXXXXXXXXXXXXXXXGXXXXXXXXXXXXXXXXXXXGXXXXXXXXXXXXXXXXXXXGXXXXXXXXXXXXXXXXXXXGXXXXXXXXXXXXXXXXXXXGXXXXXXXXXXXXXXXXXXXGXXXXXXXXXXXXXXXXXXXGXXXXXXXXXXXXXXXXXXXGXXXXXXXXXXXXXXXXXXXGXXXXXXXXXXXXXXXXXXX,0,300,0
31122,13,0,13,37,250,0,0,263,181,82,GXXXXXXXXXXXXXXXXXXXGXXXXXXXXXXXXXXXXXXXGXXXXXXXXXXXXXXXXXXXGXXXXXXXXXXXXXXXXXXXGXXXXXXXXXXXXXXXXXXXGXXXXXXXXXXXXXXXXXXXGXXXXXXXXXXXXXXXXXXXGXXXXXXXXXXXXXXXXXXXGXXXXXXXXXXXXXXXXXXXGXXXXXXXXXXXXXXXXXXXGXXXXXXXXXXXXXXXXXXXGXXXXXXXXXXXXXXXXXXXGXXXXXXXXXXXXXXXXXXX,0,300,0
31143,13,0,13,37,250,0,0,262,183,79,GXXXXXXXXXXXXXXXXXXXGXXXXXXXXXXXXXXXXXXXGXXXXXXXXXXXXXXXXXXXGXXXXXXXXXXXXXXXXXXXGXXXXXXXXXXXXXXXXXXXGXXXXXXXXXXXXXXXXXXXGXXXXXXXXXXXXXXXXXXXGXXXXXXXXXXXXXXXXXXXGXXXXXXXXXXXXXXXXXXXGXXXXXXXXXXXXXXXXXXXGXXXXXXXXXXXXXXXXXXXGXXXXXXXXXXXXXXXXXXXGXXXXXXXXXXXXXXXXXXX,0,300,0
31164,13,0,13,40,247,0,0,259,181,78,GXXXXXXXXXXXXXXXXXXXGXXXXXXXXXXXXXXXXXXXGXXXXXXXXXXXXXXXXXXXGXXXXXXXXXXXXXXXXXXXGXXXXXXXXXXXXXXXXXXXGXXXXXXXXXXXXXXXXXXXGXXXXXXXXXXXXXXXXXXXGXXXXXXXXXXXXXXXXXXXGXXXXXXXXXXXXXXXXXXXGXXXXXXXXXXXXXXXXXXXGXXXXXXXXXXXXXXXXXXXGXXXXXXXXXXXXXXXXXXXGXXXXXXXXXXXXXXXXXXX,0,300,0

31185,13,0,13,38,249,0,0,261,183,78,GXXXXXXXXXXXXXXXXXXXGXXXXXXXXXXXXXXXXXXXGXXXXXXXXXXXXXXXXXXXGXXXXXXXXXXXXXXXXXXXGXXXXXXXXXXXXXXXXXXXGXXXXXXXXXXXXXXXXXXXGXXXXXXXXXXXXXXXXXXXGXXXXXXXXXXXXXXXXXXXGXXXXXXXXXXXXXXXXXXXGXXXXXXXXXXXXXXXXXXXGXXXXXXXXXXXXXXXXXXXGXXXXXXXXXXXXXXXXXXXGXXXXXXXXXXXXXXXXXXX,0,300,0
31206,13,0,13,37,250,0,0,261,184,77,GXXXXXXXXXXXXXXXXXXXGXXXXXXXXXXXXXXXXXXXGXXXXXXXXXXXXXXXXXXXGXXXXXXXXXXXXXXXXXXXGXXXXXXXXXXXXXXXXXXXGXXXXXXXXXXXXXXXXXXXGXXXXXXXXXXXXXXXXXXXGXXXXXXXXXXXXXXXXXXXGXXXXXXXXXXXXXXXXXXXGXXXXXXXXXXXXXXXXXXXGXXXXXXXXXXXXXXXXXXXGXXXXXXXXXXXXXXXXXXXGXXXXXXXXXXXXXXXXXXX,0,300,0
31227,13,0,13,37,250,0,0,262,183,79,GXXXXXXXXXXXXXXXXXXXGXXXXXXXXXXXXXXXXXXXGXXXXXXXXXXXXXXXXXXXGXXXXXXXXXXXXXXXXXXXGXXXXXXXXXXXXXXXXXXXGXXXXXXXXXXXXXXXXXXXGXXXXXXXXXXXXXXXXXXXGXXXXXXXXXXXXXXXXXXXGXXXXXXXXXXXXXXXXXXXGXXXXXXXXXXXXXXXXXXXGXXXXXXXXXXXXXXXXXXXGXXXXXXXXXXXXXXXXXXXGXXXXXXXXXXXXXXXXXXX,0,300,0
31248,13,0,13,35,252,0,0,263,179,84,GXXXXXXXXXXXXXXXXXXXGXXXXXXXXXXXXXXXXXXXGXXXXXXXXXXXXXXXXXXXGXXXXXXXXXXXXXXXXXXXGXXXXXXXXXXXXXXXXXXXGXXXXXXXXXXXXXXXXXXXGXXXXXXXXXXXXXXXXXXXGXXXXXXXXXXXXXXXXXXXGXXXXXXXXXXXXXXXXXXXGXXXXXXXXXXXXXXXXXXXGXXXXXXXXXXXXXXXXXXXGXXXXXXXXXXXXXXXXXXXGXXXXXXXXXXXXXXXXXXX,0,300,0
31269,13,0,13,37,250,0,0,261,180,81,GXXXXXXXXXXXXXXXXXXXGXXXXXXXXXXXXXXXXXXXGXXXXXXXXXXXXXXXXXXXGXXXXXXXXXXXXXXXXXXXGXXXXXXXXXXXXXXXXXXXGXXXXXXXXXXXXXXXXXXXGXXXXXXXXXXXXXXXXXXXGXXXXXXXXXXXXXXXXXXXGXXXXXXXXXXXXXXXXXXXGXXXXXXXXXXXXXXXXXXXGXXXXXXXXXXXXXXXXXXXGXXXXXXXXXXXXXXXXXXXGXXXXXXXXXXXXXXXXXXX,0,300,0

31290,13,0,13,34,253,0,0,265,181,84,GXXXXXXXXXXXXXXXXXXXGXXXXXXXXXXXXXXXXXXXGXXXXXXXXXXXXXXXXXXXGXXXXXXXXXXXXXXXXXXXGXXXXXXXXXXXXXXXXXXXGXXXXXXXXXXXXXXXXXXXGXXXXXXXXXXXXXXXXXXXGXXXXXXXXXXXXXXXXXXXGXXXXXXXXXXXXXXXXXXXGXXXXXXXXXXXXXXXXXXXGXXXXXXXXXXXXXXXXXXXGXXXXXXXXXXXXXXXXXXXGXXXXXXXXXXXXXXXXXXX,0,300,0
31311,13,0,13,32,255,0,0,267,183,84,GXXXXXXXXXXXXXXXXXXXGXXXXXXXXXXXXXXXXXXXGXXXXXXXXXXXXXXXXXXXGXXXXXXXXXXXXXXXXXXXGXXXXXXXXXXXXXXXXXXXGXXXXXXXXXXXXXXXXXXXGXXXXXXXXXXXXXXXXXXXGXXXXXXXXXXXXXXXXXXXGXXXXXXXXXXXXXXXXXXXGXXXXXXXXXXXXXXXXXXXGXXXXXXXXXXXXXXXXXXXGXXXXXXXXXXXXXXXXXXXGXXXXXXXXXXXXXXXXXXX,0,300,0
31332,13,0,13,34,253,0,0,265,182,83,GXXXXXXXXXXXXXXXXXXXGXXXXXXXXXXXXXXXXXXXGXXXXXXXXXXXXXXXXXXXGXXXXXXXXXXXXXXXXXXXGXXXXXXXXXXXXXXXXXXXGXXXXXXXXXXXXXXXXXXXGXXXXXXXXXXXXXXXXXXXGXXXXXXXXXXXXXXXXXXXGXXXXXXXXXXXXXXXXXXXGXXXXXXXXXXXXXXXXXXXGXXXXXXXXXXXXXXXXXXXGXXXXXXXXXXXXXXXXXXXGXXXXXXXXXXXXXXXXXXX,0,300,0
31353,13,0,13,33,254,0,0,266,185,81,GXXXXXXXXXXXXXXXXXXXGXXXXXXXXXXXXXXXXXXXGXXXXXXXXXXXXXXXXXXXGXXXXXXXXXXXXXXXXXXXGXXXXXXXXXXXXXXXXXXXGXXXXXXXXXXXXXXXXXXXGXXXXXXXXXXXXXXXXXXXGXXXXXXXXXXXXXXXXXXXGXXXXXXXXXXXXXXXXXXXGXXXXXXXXXXXXXXXXXXXGXXXXXXXXXXXXXXXXXXXGXXXXXXXXXXXXXXXXXXXGXXXXXXXXXXXXXXXXXXX,0,300,0
31374,13,0,13,32,255,0,0,267,186,81,GXXXXXXXXXXXXXXXXXXXGXXXXXXXXXXXXXXXXXXXGXXXXXXXXXXXXXXXXXXXGXXXXXXXXXXXXXXXXXXXGXXXXXXXXXXXXXXXXXXXGXXXXXXXXXXXXXXXXXXXGXXXXXXXXXXXXXXXXXXXGXXXXXXXXXXXXXXXXXXXGXXXXXXXXXXXXXXXXXXXGXXXXXXXXXXXXXXXXXXXGXXXXXXXXXXXXXXXXXXXGXXXXXXXXXXXXXXXXXXXGXXXXXXXXXXXXXXXXXXX,0,300,0

31395,13,0,13,31,256,0,0,268,188,80,GXXXXXXXXXXXXXXXXXXXGXXXXXXXXXXXXXXXXXXXGXXXXXXXXXXXXXXXXXXXGXXXXXXXXXXXXXXXXXXXGXXXXXXXXXXXXXXXXXXXGXXXXXXXXXXXXXXXXXXXGXXXXXXXXXXXXXXXXXXXGXXXXXXXXXXXXXXXXXXXGXXXXXXXXXXXXXXXXXXXGXXXXXXXXXXXXXXXXXXXGXXXXXXXXXXXXXXXXXXXGXXXXXXXXXXXXXXXXXXXGXXXXXXXXXXXXXXXXXXX,0,300,0
31416,13,0,13,34,253,0,0,264,184,80,GXXXXXXXXXXXXXXXXXXXGXXXXXXXXXXXXXXXXXXXGXXXXXXXXXXXXXXXXXXXGXXXXXXXXXXXXXXXXXXXGXXXXXXXXXXXXXXXXXXXGXXXXXXXXXXXXXXXXXXXGXXXXXXXXXXXXXXXXXXXGXXXXXXXXXXXXXXXXXXXGXXXXXXXXXXXXXXXXXXXGXXXXXXXXXXXXXXXXXXXGXXXXXXXXXXXXXXXXXXXGXXXXXXXXXXXXXXXXXXXGXXXXXXXXXXXXXXXXXXX,0,300,0
31437,13,0,13,35,252,0,0,264,182,82,GXXXXXXXXXXXXXXXXXXXGXXXXXXXXXXXXXXXXXXXGXXXXXXXXXXXXXXXXXXXGXXXXXXXXXXXXXXXXXXXGXXXXXXXXXXXXXXXXXXXGXXXXXXXXXXXXXXXXXXXGXXXXXXXXXXXXXXXXXXXGXXXXXXXXXXXXXXXXXXXGXXXXXXXXXXXXXXXXXXXGXXXXXXXXXXXXXXXXXXXGXXXXXXXXXXXXXXXXXXXGXXXXXXXXXXXXXXXXXXXGXXXXXXXXXXXXXXXXXXX,0,300,0
31458,13,0,13,36,251,0,0,263,183,80,GXXXXXXXXXXXXXXXXXXXGXXXXXXXXXXXXXXXXXXXGXXXXXXXXXXXXXXXXXXXGXXXXXXXXXXXXXXXXXXXGXXXXXXXXXXXXXXXXXXXGXXXXXXXXXXXXXXXXXXXGXXXXXXXXXXXXXXXXXXXGXXXXXXXXXXXXXXXXXXXGXXXXXXXXXXXXXXXXXXXGXXXXXXXXXXXXXXXXXXXGXXXXXXXXXXXXXXXXXXXGXXXXXXXXXXXXXXXXXXXGXXXXXXXXXXXXXXXXXXX,0,300,0
31479,13,0,13,38,249,0,0,261,183,78,GXXXXXXXXXXXXXXXXXXXGXXXXXXXXXXXXXXXXXXXGXXXXXXXXXXXXXXXXXXXGXXXXXXXXXXXXXXXXXXXGXXXXXXXXXXXXXXXXXXXGXXXXXXXXXXXXXXXXXXXGXXXXXXXXXXXXXXXXXXXGXXXXXXXXXXXXXXXXXXXGXXXXXXXXXXXXXXXXXXXGXXXXXXXXXXXXXXXXXXXGXXXXXXXXXXXXXXXXXXXGXXXXXXXXXXXXXXXXXXXGXXXXXXXXXXXXXXXXXXX,0,300,0

31500,13,0,13,40,247,0,0,259,184,75,GXXXXXXXXXXXXXXXXXXXGXXXXXXXXXXXXXXXXXXXGXXXXXXXXXXXXXXXXXXXGXXXXXXXXXXXXXXXXXXXGXXXXXXXXXXXXXXXXXXXGXXXXXXXXXXXXXXXXXXXGXXXXXXXXXXXXXXXXXXXGXXXXXXXXXXXXXXXXXXXGXXXXXXXXXXXXXXXXXXXGXXXXXXXXXXXXXXXXXXXGXXXXXXXXXXXXXXXXXXXGXXXXXXXXXXXXXXXXXXXGXXXXXXXXXXXXXXXXXXX,0,300,0
31521,13,0,13,42,245,0,0,256,185,71,GXXXXXXXXXXXXXXXXXXXGXXXXXXXXXXXXXXXXXXXGXXXXXXXXXXXXXXXXXXXGXXXXXXXXXXXXXXXXXXXGXXXXXXXXXXXXXXXXXXXGXXXXXXXXXXXXXXXXXXXGXXXXXXXXXXXXXXXXXXXGXXXXXXXXXXXXXXXXXXXGXXXXXXXXXXXXXXXXXXXGXXXXXXXXXXXXXXXXXXXGXXXXXXXXXXXXXXXXXXXGXXXXXXXXXXXXXXXXXXXGXXXXXXXXXXXXXXXXXXX,0,300,0
31542,13,0,13,44,243,0,0,255,182,73,GXXXXXXXXXXXXXXXXXXXGXXXXXXXXXXXXXXXXXXXGXXXXXXXXXXXXXXXXXXXGXXXXXXXXXXXXXXXXXXXGXXXXXXXXXXXXXXXXXXXGXXXXXXXXXXXXXXXXXXXGXXXXXXXXXXXXXXXXXXXGXXXXXXXXXXXXXXXXXXXGXXXXXXXXXXXXXXXXXXXGXXXXXXXXXXXXXXXXXXXGXXXXXXXXXXXXXXXXXXXGXXXXXXXXXXXXXXXXXXXGXXXXXXXXXXXXXXXXXXX,0,300,0
31563,13,0,13,41,246,0,0,258,188,70,GXXXXXXXXXXXXXXXXXXXGXXXXXXXXXXXXXXXXXXXGXXXXXXXXXXXXXXXXXXXGXXXXXXXXXXXXXXXXXXXGXXXXXXXXXXXXXXXXXXXGXXXXXXXXXXXXXXXXXXXGXXXXXXXXXXXXXXXXXXXGXXXXXXXXXXXXXXXXXXXGXXXXXXXXXXXXXXXXXXXGXXXXXXXXXXXXXXXXXXXGXXXXXXXXXXXXXXXXXXXGXXXXXXXXXXXXXXXXXXXGXXXXXXXXXXXXXXXXXXX,0,300,0
31584,13,0,13,40,247,0,0,259,189,70,GXXXXXXXXXXXXXXXXXXXGXXXXXXXXXXXXXXXXXXXGXXXXXXXXXXXXXXXXXXXGXXXXXXXXXXXXXXXXXXXGXXXXXXXXXXXXXXXXXXXGXXXXXXXXXXXXXXXXXXXGXXXXXXXXXXXXXXXXXXXGXXXXXXXXXXXXXXXXXXXGXXXXXXXXXXXXXXXXXXXGXXXXXXXXXXXXXXXXXXXGXXXXXXXXXXXXXXXXXXXGXXXXXXXXXXXXXXXXXXXGXXXXXXXXXXXXXXXXXXX,0,300,0

31605,13,0,13,44,243,0,0,255,185,70,GXXXXXXXXXXXXXXXXXXXGXXXXXXXXXXXXXXXXXXXGXXXXXXXXXXXXXXXXXXXGXXXXXXXXXXXXXXXXXXXGXXXXXXXXXXXXXXXXXXXGXXXXXXXXXXXXXXXXXXXGXXXXXXXXXXXXXXXXXXXGXXXXXXXXXXXXXXXXXXXGXXXXXXXXXXXXXXXXXXXGXXXXXXXXXXXXXXXXXXXGXXXXXXXXXXXXXXXXXXXGXXXXXXXXXXXXXXXXXXXGXXXXXXXXXXXXXXXXXXX,0,300,0
31626,13,0,13,44,243,0,0,254,186,68,GXXXXXXXXXXXXXXXXXXXGXXXXXXXXXXXXXXXXXXXGXXXXXXXXXXXXXXXXXXXGXXXXXXXXXXXXXXXXXXXGXXXXXXXXXXXXXXXXXXXGXXXXXXXXXXXXXXXXXXXGXXXXXXXXXXXXXXXXXXXGXXXXXXXXXXXXXXXXXXXGXXXXXXXXXXXXXXXXXXXGXXXXXXXXXXXXXXXXXXXGXXXXXXXXXXXXXXXXXXXGXXXXXXXXXXXXXXXXXXXGXXXXXXXXXXXXXXXXXXX,0,300,0
31647,13,0,13,46,241,0,0,253,184,69,GXXXXXXXXXXXXXXXXXXXGXXXXXXXXXXXXXXXXXXXGXXXXXXXXXXXXXXXXXXXGXXXXXXXXXXXXXXXXXXXGXXXXXXXXXXXXXXXXXXXGXXXXXXXXXXXXXXXXXXXGXXXXXXXXXXXXXXXXXXXGXXXXXXXXXXXXXXXXXXXGXXXXXXXXXXXXXXXXXXXGXXXXXXXXXXXXXXXXXXXGXXXXXXXXXXXXXXXXXXXGXXXXXXXXXXXXXXXXXXXGXXXXXXXXXXXXXXXXXXX,0,300,0
31668,13,0,13,49,238,0,0,250,185,65,GXXXXXXXXXXXXXXXXXXXGXXXXXXXXXXXXXXXXXXXGXXXXXXXXXXXXXXXXXXXGXXXXXXXXXXXXXXXXXXXGXXXXXXXXXXXXXXXXXXXGXXXXXXXXXXXXXXXXXXXGXXXXXXXXXXXXXXXXXXXGXXXXXXXXXXXXXXXXXXXGXXXXXXXXXXXXXXXXXXXGXXXXXXXXXXXXXXXXXXXGXXXXXXXXXXXXXXXXXXXGXXXXXXXXXXXXXXXXXXXGXXXXXXXXXXXXXXXXXXX,0,300,0
31689,13,0,13,52,235,0,0,246,182,64,GXXXXXXXXXXXXXXXXXXXGXXXXXXXXXXXXXXXXXXXGXXXXXXXXXXXXXXXXXXXGXXXXXXXXXXXXXXXXXXXGXXXXXXXXXXXXXXXXXXXGXXXXXXXXXXXXXXXXXXXGXXXXXXXXXXXXXXXXXXXGXXXXXXXXXXXXXXXXXXXGXXXXXXXXXXXXXXXXXXXGXXXXXXXXXXXXXXXXXXXGXXXXXXXXXXXXXXXXXXXGXXXXXXXXXXXXXXXXXXXGXXXXXXXXXXXXXXXXXXX,0,300,0

31710,13,0,13,50,237,0,0,249,182,67,GXXXXXXXXXXXXXXXXXXXGXXXXXXXXXXXXXXXXXXXGXXXXXXXXXXXXXXXXXXXGXXXXXXXXXXXXXXXXXXXGXXXXXXXXXXXXXXXXXXXGXXXXXXXXXXXXXXXXXXXGXXXXXXXXXXXXXXXXXXXGXXXXXXXXXXXXXXXXXXXGXXXXXXXXXXXXXXXXXXXGXXXXXXXXXXXXXXXXXXXGXXXXXXXXXXXXXXXXXXXGXXXXXXXXXXXXXXXXXXXGXXXXXXXXXXXXXXXXXXX,0,300,0
31731,13,0,13,49,238,0,0,249,181,68,GXXXXXXXXXXXXXXXXXXXGXXXXXXXXXXXXXXXXXXXGXXXXXXXXXXXXXXXXXXXGXXXXXXXXXXXXXXXXXXXGXXXXXXXXXXXXXXXXXXXGXXXXXXXXXXXXXXXXXXXGXXXXXXXXXXXXXXXXXXXGXXXXXXXXXXXXXXXXXXXGXXXXXXXXXXXXXXXXXXXGXXXXXXXXXXXXXXXXXXXGXXXXXXXXXXXXXXXXXXXGXXXXXXXXXXXXXXXXXXXGXXXXXXXXXXXXXXXXXXX,0,300,0
31752,13,0,13,49,238,0,0,249,182,67,GXXXXXXXXXXXXXXXXXXXGXXXXXXXXXXXXXXXXXXXGXXXXXXXXXXXXXXXXXXXGXXXXXXXXXXXXXXXXXXXGXXXXXXXXXXXXXXXXXXXGXXXXXXXXXXXXXXXXXXXGXXXXXXXXXXXXXXXXXXXGXXXXXXXXXXXXXXXXXXXGXXXXXXXXXXXXXXXXXXXGXXXXXXXXXXXXXXXXXXXGXXXXXXXXXXXXXXXXXXXGXXXXXXXXXXXXXXXXXXXGXXXXXXXXXXXXXXXXXXX,0,300,0
31773,13,0,13,47,240,0,0,250,180,70,GXXXXXXXXXXXXXXXXXXXGXXXXXXXXXXXXXXXXXXXGXXXXXXXXXXXXXXXXXXXGXXXXXXXXXXXXXXXXXXXGXXXXXXXXXXXXXXXXXXXGXXXXXXXXXXXXXXXXXXXGXXXXXXXXXXXXXXXXXXXGXXXXXXXXXXXXXXXXXXXGXXXXXXXXXXXXXXXXXXXGXXXXXXXXXXXXXXXXXXXGXXXXXXXXXXXXXXXXXXXGXXXXXXXXXXXXXXXXXXXGXXXXXXXXXXXXXXXXXXX,0,300,0
31794,13,0,13,45,242,0,0,254,185,69,GXXXXXXXXXXXXXXXXXXXGXXXXXXXXXXXXXXXXXXXGXXXXXXXXXXXXXXXXXXXGXXXXXXXXXXXXXXXXXXXGXXXXXXXXXXXXXXXXXXXGXXXXXXXXXXXXXXXXXXXGXXXXXXXXXXXXXXXXXXXGXXXXXXXXXXXXXXXXXXXGXXXXXXXXXXXXXXXXXXXGXXXXXXXXXXXXXXXXXXXGXXXXXXXXXXXXXXXXXXXGXXXXXXXXXXXXXXXXXXXGXXXXXXXXXXXXXXXXXXX,0,300,0

31815,14,1,13,48,238,0,0,250,182,68,GXXXXXXXXXXXXXXXXXXXGXXXXXXXXXXXXXXXXXXXGXXXXXXXXXXXXXXXXXXXGXXXXXXXXXXXXXXXXXXXGXXXXXXXXXXXXXXXXXXXGXXXXXXXXXXXXXXXXXXXGXXXXXXXXXXXXXXXXXXXGAXXXXXXXXXXXXXXXXXXGXXXXXXXXXXXXXXXXXXXGXXXXXXXXXXXXXXXXXXXGXXXXXXXXXXXXXXXXXXXGXXXXXXXXXXXXXXXXXXXGXXXXXXXXXXXXXXXXXXX,0,300,0
31836,13,0,13,48,239,0,0,251,182,69,GXXXXXXXXXXXXXXXXXXXGXXXXXXXXXXXXXXXXXXXGXXXXXXXXXXXXXXXXXXXGXXXXXXXXXXXXXXXXXXXGXXXXXXXXXXXXXXXXXXXGXXXXXXXXXXXXXXXXXXXGXXXXXXXXXXXXXXXXXXXGXXXXXXXXXXXXXXXXXXXGXXXXXXXXXXXXXXXXXXXGXXXXXXXXXXXXXXXXXXXGXXXXXXXXXXXXXXXXXXXGXXXXXXXXXXXXXXXXXXXGXXXXXXXXXXXXXXXXXXX,0,300,0
31857,13,0,13,49,238,0,0,250,182,68,GXXXXXXXXXXXXXXXXXXXGXXXXXXXXXXXXXXXXXXXGXXXXXXXXXXXXXXXXXXXGXXXXXXXXXXXXXXXXXXXGXXXXXXXXXXXXXXXXXXXGXXXXXXXXXXXXXXXXXXXGXXXXXXXXXXXXXXXXXXXGXXXXXXXXXXXXXXXXXXXGXXXXXXXXXXXXXXXXXXXGXXXXXXXXXXXXXXXXXXXGXXXXXXXXXXXXXXXXXXXGXXXXXXXXXXXXXXXXXXXGXXXXXXXXXXXXXXXXXXX,0,300,0
31878,13,0,13,51,236,0,0,248,182,66,GXXXXXXXXXXXXXXXXXXXGXXXXXXXXXXXXXXXXXXXGXXXXXXXXXXXXXXXXXXXGXXXXXXXXXXXXXXXXXXXGXXXXXXXXXXXXXXXXXXXGXXXXXXXXXXXXXXXXXXXGXXXXXXXXXXXXXXXXXXXGXXXXXXXXXXXXXXXXXXXGXXXXXXXXXXXXXXXXXXXGXXXXXXXXXXXXXXXXXXXGXXXXXXXXXXXXXXXXXXXGXXXXXXXXXXXXXXXXXXXGXXXXXXXXXXXXXXXXXXX,0,300,0
31899,13,0,13,49,238,0,0,250,182,68,GXXXXXXXXXXXXXXXXXXXGXXXXXXXXXXXXXXXXXXXGXXXXXXXXXXXXXXXXXXXGXXXXXXXXXXXXXXXXXXXGXXXXXXXXXXXXXXXXXXXGXXXXXXXXXXXXXXXXXXXGXXXXXXXXXXXXXXXXXXXGXXXXXXXXXXXXXXXXXXXGXXXXXXXXXXXXXXXXXXXGXXXXXXXXXXXXXXXXXXXGXXXXXXXXXXXXXXXXXXXGXXXXXXXXXXXXXXXXXXXGXXXXXXXXXXXXXXXXXXX,0,300,0

31920,13,0,13,45,242,0,0,254,187,67,GXXXXXXXXXXXXXXXXXXXGXXXXXXXXXXXXXXXXXXXGXXXXXXXXXXXXXXXXXXXGXXXXXXXXXXXXXXXXXXXGXXXXXXXXXXXXXXXXXXXGXXXXXXXXXXXXXXXXXXXGXXXXXXXXXXXXXXXXXXXGXXXXXXXXXXXXXXXXXXXGXXXXXXXXXXXXXXXXXXXGXXXXXXXXXXXXXXXXXXXGXXXXXXXXXXXXXXXXXXXGXXXXXXXXXXXXXXXXXXXGXXXXXXXXXXXXXXXXXXX,0,300,0
31941,13,0,13,44,243,0,0,255,184,71,GXXXXXXXXXXXXXXXXXXXGXXXXXXXXXXXXXXXXXXXGXXXXXXXXXXXXXXXXXXXGXXXXXXXXXXXXXXXXXXXGXXXXXXXXXXXXXXXXXXXGXXXXXXXXXXXXXXXXXXXGXXXXXXXXXXXXXXXXXXXGXXXXXXXXXXXXXXXXXXXGXXXXXXXXXXXXXXXXXXXGXXXXXXXXXXXXXXXXXXXGXXXXXXXXXXXXXXXXXXXGXXXXXXXXXXXXXXXXXXXGXXXXXXXXXXXXXXXXXXX,0,300,0
31962,13,0,13,42,245,0,0,256,185,71,GXXXXXXXXXXXXXXXXXXXGXXXXXXXXXXXXXXXXXXXGXXXXXXXXXXXXXXXXXXXGXXXXXXXXXXXXXXXXXXXGXXXXXXXXXXXXXXXXXXXGXXXXXXXXXXXXXXXXXXXGXXXXXXXXXXXXXXXXXXXGXXXXXXXXXXXXXXXXXXXGXXXXXXXXXXXXXXXXXXXGXXXXXXXXXXXXXXXXXXXGXXXXXXXXXXXXXXXXXXXGXXXXXXXXXXXXXXXXXXXGXXXXXXXXXXXXXXXXXXX,0,300,0
31983,13,0,13,40,247,0,0,259,187,72,GXXXXXXXXXXXXXXXXXXXGXXXXXXXXXXXXXXXXXXXGXXXXXXXXXXXXXXXXXXXGXXXXXXXXXXXXXXXXXXXGXXXXXXXXXXXXXXXXXXXGXXXXXXXXXXXXXXXXXXXGXXXXXXXXXXXXXXXXXXXGXXXXXXXXXXXXXXXXXXXGXXXXXXXXXXXXXXXXXXXGXXXXXXXXXXXXXXXXXXXGXXXXXXXXXXXXXXXXXXXGXXXXXXXXXXXXXXXXXXXGXXXXXXXXXXXXXXXXXXX,0,300,0
32004,13,0,13,38,249,0,0,261,185,76,GXXXXXXXXXXXXXXXXXXXGXXXXXXXXXXXXXXXXXXXGXXXXXXXXXXXXXXXXXXXGXXXXXXXXXXXXXXXXXXXGXXXXXXXXXXXXXXXXXXXGXXXXXXXXXXXXXXXXXXXGXXXXXXXXXXXXXXXXXXXGXXXXXXXXXXXXXXXXXXXGXXXXXXXXXXXXXXXXXXXGXXXXXXXXXXXXXXXXXXXGXXXXXXXXXXXXXXXXXXXGXXXXXXXXXXXXXXXXXXXGXXXXXXXXXXXXXXXXXXX,0,300,0

32025,13,0,13,39,248,0,0,260,184,76,GXXXXXXXXXXXXXXXXXXXGXXXXXXXXXXXXXXXXXXXGXXXXXXXXXXXXXXXXXXXGXXXXXXXXXXXXXXXXXXXGXXXXXXXXXXXXXXXXXXXGXXXXXXXXXXXXXXXXXXXGXXXXXXXXXXXXXXXXXXXGXXXXXXXXXXXXXXXXXXXGXXXXXXXXXXXXXXXXXXXGXXXXXXXXXXXXXXXXXXXGXXXXXXXXXXXXXXXXXXXGXXXXXXXXXXXXXXXXXXXGXXXXXXXXXXXXXXXXXXX,0,300,0
32046,13,0,13,39,248,0,0,260,181,79,GXXXXXXXXXXXXXXXXXXXGXXXXXXXXXXXXXXXXXXXGXXXXXXXXXXXXXXXXXXXGXXXXXXXXXXXXXXXXXXXGXXXXXXXXXXXXXXXXXXXGXXXXXXXXXXXXXXXXXXXGXXXXXXXXXXXXXXXXXXXGXXXXXXXXXXXXXXXXXXXGXXXXXXXXXXXXXXXXXXXGXXXXXXXXXXXXXXXXXXXGXXXXXXXXXXXXXXXXXXXGXXXXXXXXXXXXXXXXXXXGXXXXXXXXXXXXXXXXXXX,0,300,0
32067,13,0,13,40,247,0,0,259,182,77,GXXXXXXXXXXXXXXXXXXXGXXXXXXXXXXXXXXXXXXXGXXXXXXXXXXXXXXXXXXXGXXXXXXXXXXXXXXXXXXXGXXXXXXXXXXXXXXXXXXXGXXXXXXXXXXXXXXXXXXXGXXXXXXXXXXXXXXXXXXXGXXXXXXXXXXXXXXXXXXXGXXXXXXXXXXXXXXXXXXXGXXXXXXXXXXXXXXXXXXXGXXXXXXXXXXXXXXXXXXXGXXXXXXXXXXXXXXXXXXXGXXXXXXXXXXXXXXXXXXX,0,300,0
32088,14,1,13,39,247,0,0,259,180,79,GXXXXXXXXXXXXXXXXXXXGXXXXXXXXXXXXXXXXXXXGXXXXXXXXXXXXXXXXXXXGXXXXXXXXXXXXXXXXXXXGXXXXXXXXXXXXXXXXXXXGXXXXXXXXXXXXXXXXXXXGXXXXXXXXXXXXXXXXXXXGXXXXXXXXXXXXXXXXXXXGXXXXXXXXXXXXXXXXXXXGAXXXXXXXXXXXXXXXXXXGXXXXXXXXXXXXXXXXXXXGXXXXXXXXXXXXXXXXXXXGXXXXXXXXXXXXXXXXXXX,0,300,0
32109,14,1,13,36,250,0,0,263,181,82,GXXXXXXXXXXXXXXXXXXXGXXXXXXXXXXXXXXXXXXXGXXXXXXXXXXXXXXXXXXXGXXXXXXXXXXXXXXXXXXXGXXXXXXXXXXXXXXXXXXXGXXXXXXXXXXXXXXXXXXXGXXXXXXXXXXXXXXXXXXXGXXXXXXXXXXXXXXXXXXXGXXXXXXXXXXXXXXXXXXXGAXXXXXXXXXXXXXXXXXXGXXXXXXXXXXXXXXXXXXXGXXXXXXXXXXXXXXXXXXXGXXXXXXXXXXXXXXXXXXX,0,300,0

32130,14,1,13,34,252,0,0,265,186,79,GXXXXXXXXXXXXXXXXXXXGXXXXXXXXXXXXXXXXXXXGXXXXXXXXXXXXXXXXXXXGXXXXXXXXXXXXXXXXXXXGXXXXXXXXXXXXXXXXXXXGXXXXXXXXXXXXXXXXXXXGXXXXXXXXXXXXXXXXXXXGXXXXXXXXXXXXXXXXXXXGXXXXXXXXXXXXXXXXXXXGAXXXXXXXXXXXXXXXXXXGXXXXXXXXXXXXXXXXXXXGXXXXXXXXXXXXXXXXXXXGXXXXXXXXXXXXXXXXXXX,0,300,0
32151,14,1,13,38,248,0,0,261,186,75,GXXXXXXXXXXXXXXXXXXXGXXXXXXXXXXXXXXXXXXXGXXXXXXXXXXXXXXXXXXXGXXXXXXXXXXXXXXXXXXXGXXXXXXXXXXXXXXXXXXXGXXXXXXXXXXXXXXXXXXXGXXXXXXXXXXXXXXXXXXXGXXXXXXXXXXXXXXXXXXXGXXXXXXXXXXXXXXXXXXXGAXXXXXXXXXXXXXXXXXXGXXXXXXXXXXXXXXXXXXXGXXXXXXXXXXXXXXXXXXXGXXXXXXXXXXXXXXXXXXX,0,300,0
32172,14,1,13,36,250,0,0,264,189,75,GXXXXXXXXXXXXXXXXXXXGXXXXXXXXXXXXXXXXXXXGXXXXXXXXXXXXXXXXXXXGXXXXXXXXXXXXXXXXXXXGXXXXXXXXXXXXXXXXXXXGXXXXXXXXXXXXXXXXXXXGXXXXXXXXXXXXXXXXXXXGXXXXXXXXXXXXXXXXXXXGXXXXXXXXXXXXXXXXXXXGAXXXXXXXXXXXXXXXXXXGXXXXXXXXXXXXXXXXXXXGXXXXXXXXXXXXXXXXXXXGXXXXXXXXXXXXXXXXXXX,0,300,0
32193,14,1,13,43,243,0,0,257,188,69,GXXXXXXXXXXXXXXXXXXXGXXXXXXXXXXXXXXXXXXXGXXXXXXXXXXXXXXXXXXXGXXXXXXXXXXXXXXXXXXXGXXXXXXXXXXXXXXXXXXXGXXXXXXXXXXXXXXXXXXXGXXXXXXXXXXXXXXXXXXXGXXXXXXXXXXXXXXXXXXXGXXXXXXXXXXXXXXXXXXXGAXXXXXXXXXXXXXXXXXXGXXXXXXXXXXXXXXXXXXXGXXXXXXXXXXXXXXXXXXXGXXXXXXXXXXXXXXXXXXX,0,300,0
32214,14,1,13,41,245,0,0,259,192,67,GXXXXXXXXXXXXXXXXXXXGXXXXXXXXXXXXXXXXXXXGXXXXXXXXXXXXXXXXXXXGXXXXXXXXXXXXXXXXXXXGXXXXXXXXXXXXXXXXXXXGXXXXXXXXXXXXXXXXXXXGXXXXXXXXXXXXXXXXXXXGXXXXXXXXXXXXXXXXXXXGXXXXXXXXXXXXXXXXXXXGAXXXXXXXXXXXXXXXXXXGXXXXXXXXXXXXXXXXXXXGXXXXXXXXXXXXXXXXXXXGXXXXXXXXXXXXXXXXXXX,0,300,0

32235,14,1,13,49,237,0,0,251,186,65,GXXXXXXXXXXXXXXXXXXXGXXXXXXXXXXXXXXXXXXXGXXXXXXXXXXXXXXXXXXXGXXXXXXXXXXXXXXXXXXXGXXXXXXXXXXXXXXXXXXXGXXXXXXXXXXXXXXXXXXXGXXXXXXXXXXXXXXXXXXXGXXXXXXXXXXXXXXXXXXXGXXXXXXXXXXXXXXXXXXXGAXXXXXXXXXXXXXXXXXXGXXXXXXXXXXXXXXXXXXXGXXXXXXXXXXXXXXXXXXXGXXXXXXXXXXXXXXXXXXX,0,300,0
32256,14,1,13,44,242,0,0,256,189,67,GXXXXXXXXXXXXXXXXXXXGXXXXXXXXXXXXXXXXXXXGXXXXXXXXXXXXXXXXXXXGXXXXXXXXXXXXXXXXXXXGXXXXXXXXXXXXXXXXXXXGXXXXXXXXXXXXXXXXXXXGXXXXXXXXXXXXXXXXXXXGXXXXXXXXXXXXXXXXXXXGXXXXXXXXXXXXXXXXXXXGAXXXXXXXXXXXXXXXXXXGXXXXXXXXXXXXXXXXXXXGXXXXXXXXXXXXXXXXXXXGXXXXXXXXXXXXXXXXXXX,0,300,0
32277,14,1,13,44,242,0,0,256,188,68,GXXXXXXXXXXXXXXXXXXXGXXXXXXXXXXXXXXXXXXXGXXXXXXXXXXXXXXXXXXXGXXXXXXXXXXXXXXXXXXXGXXXXXXXXXXXXXXXXXXXGXXXXXXXXXXXXXXXXXXXGXXXXXXXXXXXXXXXXXXXGXXXXXXXXXXXXXXXXXXXGXXXXXXXXXXXXXXXXXXXGAXXXXXXXXXXXXXXXXXXGXXXXXXXXXXXXXXXXXXXGXXXXXXXXXXXXXXXXXXXGXXXXXXXXXXXXXXXXXXX,0,300,0
32298,15,2,13,45,240,0,0,254,189,65,GXXXXXXXXXXXXXXXXXXXGXXXXXXXXXXXXXXXXXXXGAXXXXXXXXXXXXXXXXXXGXXXXXXXXXXXXXXXXXXXGXXXXXXXXXXXXXXXXXXXGXXXXXXXXXXXXXXXXXXXGXXXXXXXXXXXXXXXXXXXGXXXXXXXXXXXXXXXXXXXGXXXXXXXXXXXXXXXXXXXGAXXXXXXXXXXXXXXXXXXGXXXXXXXXXXXXXXXXXXXGXXXXXXXXXXXXXXXXXXXGXXXXXXXXXXXXXXXXXXX,0,300,0
32319,15,1,14,48,237,0,0,251,191,60,GXXXXXXXXXXXXXXXXXXXGXXXXXXXXXXXXXXXXXXXGOXXXXXXXXXXXXXXXXXXGXXXXXXXXXXXXXXXXXXXGXXXXXXXXXXXXXXXXXXXGXXXXXXXXXXXXXXXXXXXGXXXXXXXXXXXXXXXXXXXGXXXXXXXXXXXXXXXXXXXGXXXXXXXXXXXXXXXXXXXGAXXXXXXXXXXXXXXXXXXGXXXXXXXXXXXXXXXXXXXGXXXXXXXXXXXXXXXXXXXGXXXXXXXXXXXXXXXXXXX,0,300,0

32340,15,1,14,50,235,0,0,248,191,57,GXXXXXXXXXXXXXXXXXXXGXXXXXXXXXXXXXXXXXXXGOXXXXXXXXXXXXXXXXXXGXXXXXXXXXXXXXXXXXXXGXXXXXXXXXXXXXXXXXXXGXXXXXXXXXXXXXXXXXXXGXXXXXXXXXXXXXXXXXXXGXXXXXXXXXXXXXXXXXXXGXXXXXXXXXXXXXXXXXXXGAXXXXXXXXXXXXXXXXXXGXXXXXXXXXXXXXXXXXXXGXXXXXXXXXXXXXXXXXXXGXXXXXXXXXXXXXXXXXXX,0,300,0
32361,13,0,13,48,239,0,0,253,192,61,GXXXXXXXXXXXXXXXXXXXGXXXXXXXXXXXXXXXXXXXGXXXXXXXXXXXXXXXXXXXGXXXXXXXXXXXXXXXXXXXGXXXXXXXXXXXXXXXXXXXGXXXXXXXXXXXXXXXXXXXGXXXXXXXXXXXXXXXXXXXGXXXXXXXXXXXXXXXXXXXGXXXXXXXXXXXXXXXXXXXGXXXXXXXXXXXXXXXXXXXGXXXXXXXXXXXXXXXXXXXGXXXXXXXXXXXXXXXXXXXGXXXXXXXXXXXXXXXXXXX,0,300,0
32382,13,0,13,45,242,0,0,256,191,65,GXXXXXXXXXXXXXXXXXXXGXXXXXXXXXXXXXXXXXXXGXXXXXXXXXXXXXXXXXXXGXXXXXXXXXXXXXXXXXXXGXXXXXXXXXXXXXXXXXXXGXXXXXXXXXXXXXXXXXXXGXXXXXXXXXXXXXXXXXXXGXXXXXXXXXXXXXXXXXXXGXXXXXXXXXXXXXXXXXXXGXXXXXXXXXXXXXXXXXXXGXXXXXXXXXXXXXXXXXXXGXXXXXXXXXXXXXXXXXXXGXXXXXXXXXXXXXXXXXXX,0,300,0
32403,13,0,13,45,242,0,0,256,192,64,GXXXXXXXXXXXXXXXXXXXGXXXXXXXXXXXXXXXXXXXGXXXXXXXXXXXXXXXXXXXGXXXXXXXXXXXXXXXXXXXGXXXXXXXXXXXXXXXXXXXGXXXXXXXXXXXXXXXXXXXGXXXXXXXXXXXXXXXXXXXGXXXXXXXXXXXXXXXXXXXGXXXXXXXXXXXXXXXXXXXGXXXXXXXXXXXXXXXXXXXGXXXXXXXXXXXXXXXXXXXGXXXXXXXXXXXXXXXXXXXGXXXXXXXXXXXXXXXXXXX,0,300,0
32424,13,0,13,47,240,0,0,254,193,61,GXXXXXXXXXXXXXXXXXXXGXXXXXXXXXXXXXXXXXXXGXXXXXXXXXXXXXXXXXXXGXXXXXXXXXXXXXXXXXXXGXXXXXXXXXXXXXXXXXXXGXXXXXXXXXXXXXXXXXXXGXXXXXXXXXXXXXXXXXXXGXXXXXXXXXXXXXXXXXXXGXXXXXXXXXXXXXXXXXXXGXXXXXXXXXXXXXXXXXXXGXXXXXXXXXXXXXXXXXXXGXXXXXXXXXXXXXXXXXXXGXXXXXXXXXXXXXXXXXXX,0,300,0

32445,13,0,13,45,242,0,0,255,192,63,GXXXXXXXXXXXXXXXXXXXGXXXXXXXXXXXXXXXXXXXGXXXXXXXXXXXXXXXXXXXGXXXXXXXXXXXXXXXXXXXGXXXXXXXXXXXXXXXXXXXGXXXXXXXXXXXXXXXXXXXGXXXXXXXXXXXXXXXXXXXGXXXXXXXXXXXXXXXXXXXGXXXXXXXXXXXXXXXXXXXGXXXXXXXXXXXXXXXXXXXGXXXXXXXXXXXXXXXXXXXGXXXXXXXXXXXXXXXXXXXGXXXXXXXXXXXXXXXXXXX,0,300,0
32466,13,0,13,41,246,0,0,259,190,69,GXXXXXXXXXXXXXXXXXXXGXXXXXXXXXXXXXXXXXXXGXXXXXXXXXXXXXXXXXXXGXXXXXXXXXXXXXXXXXXXGXXXXXXXXXXXXXXXXXXXGXXXXXXXXXXXXXXXXXXXGXXXXXXXXXXXXXXXXXXXGXXXXXXXXXXXXXXXXXXXGXXXXXXXXXXXXXXXXXXXGXXXXXXXXXXXXXXXXXXXGXXXXXXXXXXXXXXXXXXXGXXXXXXXXXXXXXXXXXXXGXXXXXXXXXXXXXXXXXXX,0,300,0
32487,13,0,13,39,248,0,0,261,190,71,GXXXXXXXXXXXXXXXXXXXGXXXXXXXXXXXXXXXXXXXGXXXXXXXXXXXXXXXXXXXGXXXXXXXXXXXXXXXXXXXGXXXXXXXXXXXXXXXXXXXGXXXXXXXXXXXXXXXXXXXGXXXXXXXXXXXXXXXXXXXGXXXXXXXXXXXXXXXXXXXGXXXXXXXXXXXXXXXXXXXGXXXXXXXXXXXXXXXXXXXGXXXXXXXXXXXXXXXXXXXGXXXXXXXXXXXXXXXXXXXGXXXXXXXXXXXXXXXXXXX,0,300,0
32508,13,0,13,41,246,0,0,259,189,70,GXXXXXXXXXXXXXXXXXXXGXXXXXXXXXXXXXXXXXXXGXXXXXXXXXXXXXXXXXXXGXXXXXXXXXXXXXXXXXXXGXXXXXXXXXXXXXXXXXXXGXXXXXXXXXXXXXXXXXXXGXXXXXXXXXXXXXXXXXXXGXXXXXXXXXXXXXXXXXXXGXXXXXXXXXXXXXXXXXXXGXXXXXXXXXXXXXXXXXXXGXXXXXXXXXXXXXXXXXXXGXXXXXXXXXXXXXXXXXXXGXXXXXXXXXXXXXXXXXXX,0,300,0
32529,13,0,13,43,244,0,0,256,190,66,GXXXXXXXXXXXXXXXXXXXGXXXXXXXXXXXXXXXXXXXGXXXXXXXXXXXXXXXXXXXGXXXXXXXXXXXXXXXXXXXGXXXXXXXXXXXXXXXXXXXGXXXXXXXXXXXXXXXXXXXGXXXXXXXXXXXXXXXXXXXGXXXXXXXXXXXXXXXXXXXGXXXXXXXXXXXXXXXXXXXGXXXXXXXXXXXXXXXXXXXGXXXXXXXXXXXXXXXXXXXGXXXXXXXXXXXXXXXXXXXGXXXXXXXXXXXXXXXXXXX,0,300,0

32550,13,0,13,42,245,0,0,258,192,66,GXXXXXXXXXXXXXXXXXXXGXXXXXXXXXXXXXXXXXXXGXXXXXXXXXXXXXXXXXXXGXXXXXXXXXXXXXXXXXXXGXXXXXXXXXXXXXXXXXXXGXXXXXXXXXXXXXXXXXXXGXXXXXXXXXXXXXXXXXXXGXXXXXXXXXXXXXXXXXXXGXXXXXXXXXXXXXXXXXXXGXXXXXXXXXXXXXXXXXXXGXXXXXXXXXXXXXXXXXXXGXXXXXXXXXXXXXXXXXXXGXXXXXXXXXXXXXXXXXXX,0,300,0
32571,13,0,13,40,247,0,0,260,191,69,GXXXXXXXXXXXXXXXXXXXGXXXXXXXXXXXXXXXXXXXGXXXXXXXXXXXXXXXXXXXGXXXXXXXXXXXXXXXXXXXGXXXXXXXXXXXXXXXXXXXGXXXXXXXXXXXXXXXXXXXGXXXXXXXXXXXXXXXXXXXGXXXXXXXXXXXXXXXXXXXGXXXXXXXXXXXXXXXXXXXGXXXXXXXXXXXXXXXXXXXGXXXXXXXXXXXXXXXXXXXGXXXXXXXXXXXXXXXXXXXGXXXXXXXXXXXXXXXXXXX,0,300,0
32592,13,0,13,38,249,0,0,262,190,72,GXXXXXXXXXXXXXXXXXXXGXXXXXXXXXXXXXXXXXXXGXXXXXXXXXXXXXXXXXXXGXXXXXXXXXXXXXXXXXXXGXXXXXXXXXXXXXXXXXXXGXXXXXXXXXXXXXXXXXXXGXXXXXXXXXXXXXXXXXXXGXXXXXXXXXXXXXXXXXXXGXXXXXXXXXXXXXXXXXXXGXXXXXXXXXXXXXXXXXXXGXXXXXXXXXXXXXXXXXXXGXXXXXXXXXXXXXXXXXXXGXXXXXXXXXXXXXXXXXXX,0,300,0
32613,13,0,13,40,247,0,0,262,187,75,GXXXXXXXXXXXXXXXXXXXGXXXXXXXXXXXXXXXXXXXGXXXXXXXXXXXXXXXXXXXGXXXXXXXXXXXXXXXXXXXGXXXXXXXXXXXXXXXXXXXGXXXXXXXXXXXXXXXXXXXGXXXXXXXXXXXXXXXXXXXGXXXXXXXXXXXXXXXXXXXGXXXXXXXXXXXXXXXXXXXGXXXXXXXXXXXXXXXXXXXGXXXXXXXXXXXXXXXXXXXGXXXXXXXXXXXXXXXXXXXGXXXXXXXXXXXXXXXXXXX,0,300,0
32634,13,0,13,33,254,0,0,268,191,77,GXXXXXXXXXXXXXXXXXXXGXXXXXXXXXXXXXXXXXXXGXXXXXXXXXXXXXXXXXXXGXXXXXXXXXXXXXXXXXXXGXXXXXXXXXXXXXXXXXXXGXXXXXXXXXXXXXXXXXXXGXXXXXXXXXXXXXXXXXXXGXXXXXXXXXXXXXXXXXXXGXXXXXXXXXXXXXXXXXXXGXXXXXXXXXXXXXXXXXXXGXXXXXXXXXXXXXXXXXXXGXXXXXXXXXXXXXXXXXXXGXXXXXXXXXXXXXXXXXXX,0,300,0

32655,13,0,13,30,257,0,0,271,195,76,GXXXXXXXXXXXXXXXXXXXGXXXXXXXXXXXXXXXXXXXGXXXXXXXXXXXXXXXXXXXGXXXXXXXXXXXXXXXXXXXGXXXXXXXXXXXXXXXXXXXGXXXXXXXXXXXXXXXXXXXGXXXXXXXXXXXXXXXXXXXGXXXXXXXXXXXXXXXXXXXGXXXXXXXXXXXXXXXXXXXGXXXXXXXXXXXXXXXXXXXGXXXXXXXXXXXXXXXXXXXGXXXXXXXXXXXXXXXXXXXGXXXXXXXXXXXXXXXXXXX,0,300,0
32676,13,0,13,39,248,0,0,262,192,70,GXXXXXXXXXXXXXXXXXXXGXXXXXXXXXXXXXXXXXXXGXXXXXXXXXXXXXXXXXXXGXXXXXXXXXXXXXXXXXXXGXXXXXXXXXXXXXXXXXXXGXXXXXXXXXXXXXXXXXXXGXXXXXXXXXXXXXXXXXXXGXXXXXXXXXXXXXXXXXXXGXXXXXXXXXXXXXXXXXXXGXXXXXXXXXXXXXXXXXXXGXXXXXXXXXXXXXXXXXXXGXXXXXXXXXXXXXXXXXXXGXXXXXXXXXXXXXXXXXXX,0,300,0
32697,13,0,13,38,249,0,0,263,190,73,GXXXXXXXXXXXXXXXXXXXGXXXXXXXXXXXXXXXXXXXGXXXXXXXXXXXXXXXXXXXGXXXXXXXXXXXXXXXXXXXGXXXXXXXXXXXXXXXXXXXGXXXXXXXXXXXXXXXXXXXGXXXXXXXXXXXXXXXXXXXGXXXXXXXXXXXXXXXXXXXGXXXXXXXXXXXXXXXXXXXGXXXXXXXXXXXXXXXXXXXGXXXXXXXXXXXXXXXXXXXGXXXXXXXXXXXXXXXXXXXGXXXXXXXXXXXXXXXXXXX,0,300,0
32718,13,0,13,40,247,0,0,261,188,73,GXXXXXXXXXXXXXXXXXXXGXXXXXXXXXXXXXXXXXXXGXXXXXXXXXXXXXXXXXXXGXXXXXXXXXXXXXXXXXXXGXXXXXXXXXXXXXXXXXXXGXXXXXXXXXXXXXXXXXXXGXXXXXXXXXXXXXXXXXXXGXXXXXXXXXXXXXXXXXXXGXXXXXXXXXXXXXXXXXXXGXXXXXXXXXXXXXXXXXXXGXXXXXXXXXXXXXXXXXXXGXXXXXXXXXXXXXXXXXXXGXXXXXXXXXXXXXXXXXXX,0,300,0
32739,13,0,13,40,247,0,0,260,190,70,GXXXXXXXXXXXXXXXXXXXGXXXXXXXXXXXXXXXXXXXGXXXXXXXXXXXXXXXXXXXGXXXXXXXXXXXXXXXXXXXGXXXXXXXXXXXXXXXXXXXGXXXXXXXXXXXXXXXXXXXGXXXXXXXXXXXXXXXXXXXGXXXXXXXXXXXXXXXXXXXGXXXXXXXXXXXXXXXXXXXGXXXXXXXXXXXXXXXXXXXGXXXXXXXXXXXXXXXXXXXGXXXXXXXXXXXXXXXXXXXGXXXXXXXXXXXXXXXXXXX,0,300,0

32760,13,0,13,41,246,0,0,259,194,65,GXXXXXXXXXXXXXXXXXXXGXXXXXXXXXXXXXXXXXXXGXXXXXXXXXXXXXXXXXXXGXXXXXXXXXXXXXXXXXXXGXXXXXXXXXXXXXXXXXXXGXXXXXXXXXXXXXXXXXXXGXXXXXXXXXXXXXXXXXXXGXXXXXXXXXXXXXXXXXXXGXXXXXXXXXXXXXXXXXXXGXXXXXXXXXXXXXXXXXXXGXXXXXXXXXXXXXXXXXXXGXXXXXXXXXXXXXXXXXXXGXXXXXXXXXXXXXXXXXXX,0,300,0
32781,13,0,13,40,247,0,0,260,195,65,GXXXXXXXXXXXXXXXXXXXGXXXXXXXXXXXXXXXXXXXGXXXXXXXXXXXXXXXXXXXGXXXXXXXXXXXXXXXXXXXGXXXXXXXXXXXXXXXXXXXGXXXXXXXXXXXXXXXXXXXGXXXXXXXXXXXXXXXXXXXGXXXXXXXXXXXXXXXXXXXGXXXXXXXXXXXXXXXXXXXGXXXXXXXXXXXXXXXXXXXGXXXXXXXXXXXXXXXXXXXGXXXXXXXXXXXXXXXXXXXGXXXXXXXXXXXXXXXXXXX,0,300,0
32802,13,0,13,40,247,0,0,260,193,67,GXXXXXXXXXXXXXXXXXXXGXXXXXXXXXXXXXXXXXXXGXXXXXXXXXXXXXXXXXXXGXXXXXXXXXXXXXXXXXXXGXXXXXXXXXXXXXXXXXXXGXXXXXXXXXXXXXXXXXXXGXXXXXXXXXXXXXXXXXXXGXXXXXXXXXXXXXXXXXXXGXXXXXXXXXXXXXXXXXXXGXXXXXXXXXXXXXXXXXXXGXXXXXXXXXXXXXXXXXXXGXXXXXXXXXXXXXXXXXXXGXXXXXXXXXXXXXXXXXXX,0,300,0
32823,13,0,13,41,246,0,0,258,193,65,GXXXXXXXXXXXXXXXXXXXGXXXXXXXXXXXXXXXXXXXGXXXXXXXXXXXXXXXXXXXGXXXXXXXXXXXXXXXXXXXGXXXXXXXXXXXXXXXXXXXGXXXXXXXXXXXXXXXXXXXGXXXXXXXXXXXXXXXXXXXGXXXXXXXXXXXXXXXXXXXGXXXXXXXXXXXXXXXXXXXGXXXXXXXXXXXXXXXXXXXGXXXXXXXXXXXXXXXXXXXGXXXXXXXXXXXXXXXXXXXGXXXXXXXXXXXXXXXXXXX,0,300,0
32844,13,0,13,45,242,0,0,254,189,65,GXXXXXXXXXXXXXXXXXXXGXXXXXXXXXXXXXXXXXXXGXXXXXXXXXXXXXXXXXXXGXXXXXXXXXXXXXXXXXXXGXXXXXXXXXXXXXXXXXXXGXXXXXXXXXXXXXXXXXXXGXXXXXXXXXXXXXXXXXXXGXXXXXXXXXXXXXXXXXXXGXXXXXXXXXXXXXXXXXXXGXXXXXXXXXXXXXXXXXXXGXXXXXXXXXXXXXXXXXXXGXXXXXXXXXXXXXXXXXXXGXXXXXXXXXXXXXXXXXXX,0,300,0

32865,13,0,13,44,243,0,0,254,191,63,GXXXXXXXXXXXXXXXXXXXGXXXXXXXXXXXXXXXXXXXGXXXXXXXXXXXXXXXXXXXGXXXXXXXXXXXXXXXXXXXGXXXXXXXXXXXXXXXXXXXGXXXXXXXXXXXXXXXXXXXGXXXXXXXXXXXXXXXXXXXGXXXXXXXXXXXXXXXXXXXGXXXXXXXXXXXXXXXXXXXGXXXXXXXXXXXXXXXXXXXGXXXXXXXXXXXXXXXXXXXGXXXXXXXXXXXXXXXXXXXGXXXXXXXXXXXXXXXXXXX,0,300,0
32886,13,0,13,43,244,0,0,256,193,63,GXXXXXXXXXXXXXXXXXXXGXXXXXXXXXXXXXXXXXXXGXXXXXXXXXXXXXXXXXXXGXXXXXXXXXXXXXXXXXXXGXXXXXXXXXXXXXXXXXXXGXXXXXXXXXXXXXXXXXXXGXXXXXXXXXXXXXXXXXXXGXXXXXXXXXXXXXXXXXXXGXXXXXXXXXXXXXXXXXXXGXXXXXXXXXXXXXXXXXXXGXXXXXXXXXXXXXXXXXXXGXXXXXXXXXXXXXXXXXXXGXXXXXXXXXXXXXXXXXXX,0,300,0
32907,13,0,13,43,244,0,0,256,190,66,GXXXXXXXXXXXXXXXXXXXGXXXXXXXXXXXXXXXXXXXGXXXXXXXXXXXXXXXXXXXGXXXXXXXXXXXXXXXXXXXGXXXXXXXXXXXXXXXXXXXGXXXXXXXXXXXXXXXXXXXGXXXXXXXXXXXXXXXXXXXGXXXXXXXXXXXXXXXXXXXGXXXXXXXXXXXXXXXXXXXGXXXXXXXXXXXXXXXXXXXGXXXXXXXXXXXXXXXXXXXGXXXXXXXXXXXXXXXXXXXGXXXXXXXXXXXXXXXXXXX,0,300,0
32928,13,0,13,45,242,0,0,254,189,65,GXXXXXXXXXXXXXXXXXXXGXXXXXXXXXXXXXXXXXXXGXXXXXXXXXXXXXXXXXXXGXXXXXXXXXXXXXXXXXXXGXXXXXXXXXXXXXXXXXXXGXXXXXXXXXXXXXXXXXXXGXXXXXXXXXXXXXXXXXXXGXXXXXXXXXXXXXXXXXXXGXXXXXXXXXXXXXXXXXXXGXXXXXXXXXXXXXXXXXXXGXXXXXXXXXXXXXXXXXXXGXXXXXXXXXXXXXXXXXXXGXXXXXXXXXXXXXXXXXXX,0,300,0
32949,13,0,13,41,246,0,0,258,190,68,GXXXXXXXXXXXXXXXXXXXGXXXXXXXXXXXXXXXXXXXGXXXXXXXXXXXXXXXXXXXGXXXXXXXXXXXXXXXXXXXGXXXXXXXXXXXXXXXXXXXGXXXXXXXXXXXXXXXXXXXGXXXXXXXXXXXXXXXXXXXGXXXXXXXXXXXXXXXXXXXGXXXXXXXXXXXXXXXXXXXGXXXXXXXXXXXXXXXXXXXGXXXXXXXXXXXXXXXXXXXGXXXXXXXXXXXXXXXXXXXGXXXXXXXXXXXXXXXXXXX,0,300,0

32970,13,0,13,39,248,0,0,260,188,72,GXXXXXXXXXXXXXXXXXXXGXXXXXXXXXXXXXXXXXXXGXXXXXXXXXXXXXXXXXXXGXXXXXXXXXXXXXXXXXXXGXXXXXXXXXXXXXXXXXXXGXXXXXXXXXXXXXXXXXXXGXXXXXXXXXXXXXXXXXXXGXXXXXXXXXXXXXXXXXXXGXXXXXXXXXXXXXXXXXXXGXXXXXXXXXXXXXXXXXXXGXXXXXXXXXXXXXXXXXXXGXXXXXXXXXXXXXXXXXXXGXXXXXXXXXXXXXXXXXXX,0,300,0
32991,13,0,13,39,248,0,0,260,186,74,GXXXXXXXXXXXXXXXXXXXGXXXXXXXXXXXXXXXXXXXGXXXXXXXXXXXXXXXXXXXGXXXXXXXXXXXXXXXXXXXGXXXXXXXXXXXXXXXXXXXGXXXXXXXXXXXXXXXXXXXGXXXXXXXXXXXXXXXXXXXGXXXXXXXXXXXXXXXXXXXGXXXXXXXXXXXXXXXXXXXGXXXXXXXXXXXXXXXXXXXGXXXXXXXXXXXXXXXXXXXGXXXXXXXXXXXXXXXXXXXGXXXXXXXXXXXXXXXXXXX,0,300,0
33012,13,0,13,39,248,0,0,260,186,74,GXXXXXXXXXXXXXXXXXXXGXXXXXXXXXXXXXXXXXXXGXXXXXXXXXXXXXXXXXXXGXXXXXXXXXXXXXXXXXXXGXXXXXXXXXXXXXXXXXXXGXXXXXXXXXXXXXXXXXXXGXXXXXXXXXXXXXXXXXXXGXXXXXXXXXXXXXXXXXXXGXXXXXXXXXXXXXXXXXXXGXXXXXXXXXXXXXXXXXXXGXXXXXXXXXXXXXXXXXXXGXXXXXXXXXXXXXXXXXXXGXXXXXXXXXXXXXXXXXXX,0,300,0
33033,13,0,13,37,250,0,0,262,190,72,GXXXXXXXXXXXXXXXXXXXGXXXXXXXXXXXXXXXXXXXGXXXXXXXXXXXXXXXXXXXGXXXXXXXXXXXXXXXXXXXGXXXXXXXXXXXXXXXXXXXGXXXXXXXXXXXXXXXXXXXGXXXXXXXXXXXXXXXXXXXGXXXXXXXXXXXXXXXXXXXGXXXXXXXXXXXXXXXXXXXGXXXXXXXXXXXXXXXXXXXGXXXXXXXXXXXXXXXXXXXGXXXXXXXXXXXXXXXXXXXGXXXXXXXXXXXXXXXXXXX,0,300,0
33054,14,1,13,34,252,0,0,264,190,74,GXXXXXXXXXXXXXXXXXXXGXXXXXXXXXXXXXXXXXXXGXXXXXXXXXXXXXXXXXXXGXXXXXXXXXXXXXXXXXXXGXXXXXXXXXXXXXXXXXXXGXXXXXXXXXXXXXXXXXXXGXXXXXXXXXXXXXXXXXXXGXXXXXXXXXXXXXXXXXXXGXXXXXXXXXXXXXXXXXXXGXXXXXXXXXXXXXXXXXXXGAXXXXXXXXXXXXXXXXXXGXXXXXXXXXXXXXXXXXXXGXXXXXXXXXXXXXXXXXXX,0,300,0

33075,14,0,14,32,254,0,0,266,192,74,GXXXXXXXXXXXXXXXXXXXGXXXXXXXXXXXXXXXXXXXGXXXXXXXXXXXXXXXXXXXGXXXXXXXXXXXXXXXXXXXGXXXXXXXXXXXXXXXXXXXGXXXXXXXXXXXXXXXXXXXGXXXXXXXXXXXXXXXXXXXGXXXXXXXXXXXXXXXXXXXGXXXXXXXXXXXXXXXXXXXGXXXXXXXXXXXXXXXXXXXGOXXXXXXXXXXXXXXXXXXGXXXXXXXXXXXXXXXXXXXGXXXXXXXXXXXXXXXXXXX,0,300,0
33096,14,0,14,37,249,0,0,262,189,73,GXXXXXXXXXXXXXXXXXXXGXXXXXXXXXXXXXXXXXXXGXXXXXXXXXXXXXXXXXXXGXXXXXXXXXXXXXXXXXXXGXXXXXXXXXXXXXXXXXXXGXXXXXXXXXXXXXXXXXXXGXXXXXXXXXXXXXXXXXXXGXXXXXXXXXXXXXXXXXXXGXXXXXXXXXXXXXXXXXXXGXXXXXXXXXXXXXXXXXXXGOXXXXXXXXXXXXXXXXXXGXXXXXXXXXXXXXXXXXXXGXXXXXXXXXXXXXXXXXXX,0,300,0
33117,13,0,13,39,248,0,0,261,187,74,GXXXXXXXXXXXXXXXXXXXGXXXXXXXXXXXXXXXXXXXGXXXXXXXXXXXXXXXXXXXGXXXXXXXXXXXXXXXXXXXGXXXXXXXXXXXXXXXXXXXGXXXXXXXXXXXXXXXXXXXGXXXXXXXXXXXXXXXXXXXGXXXXXXXXXXXXXXXXXXXGXXXXXXXXXXXXXXXXXXXGXXXXXXXXXXXXXXXXXXXGXXXXXXXXXXXXXXXXXXXGXXXXXXXXXXXXXXXXXXXGXXXXXXXXXXXXXXXXXXX,0,300,0
33138,13,0,13,39,248,0,0,261,187,74,GXXXXXXXXXXXXXXXXXXXGXXXXXXXXXXXXXXXXXXXGXXXXXXXXXXXXXXXXXXXGXXXXXXXXXXXXXXXXXXXGXXXXXXXXXXXXXXXXXXXGXXXXXXXXXXXXXXXXXXXGXXXXXXXXXXXXXXXXXXXGXXXXXXXXXXXXXXXXXXXGXXXXXXXXXXXXXXXXXXXGXXXXXXXXXXXXXXXXXXXGXXXXXXXXXXXXXXXXXXXGXXXXXXXXXXXXXXXXXXXGXXXXXXXXXXXXXXXXXXX,0,300,0
33159,13,0,13,38,249,0,0,263,186,77,GXXXXXXXXXXXXXXXXXXXGXXXXXXXXXXXXXXXXXXXGXXXXXXXXXXXXXXXXXXXGXXXXXXXXXXXXXXXXXXXGXXXXXXXXXXXXXXXXXXXGXXXXXXXXXXXXXXXXXXXGXXXXXXXXXXXXXXXXXXXGXXXXXXXXXXXXXXXXXXXGXXXXXXXXXXXXXXXXXXXGXXXXXXXXXXXXXXXXXXXGXXXXXXXXXXXXXXXXXXXGXXXXXXXXXXXXXXXXXXXGXXXXXXXXXXXXXXXXXXX,0,300,0

33180,13,0,13,34,253,0,0,265,191,74,GXXXXXXXXXXXXXXXXXXXGXXXXXXXXXXXXXXXXXXXGXXXXXXXXXXXXXXXXXXXGXXXXXXXXXXXXXXXXXXXGXXXXXXXXXXXXXXXXXXXGXXXXXXXXXXXXXXXXXXXGXXXXXXXXXXXXXXXXXXXGXXXXXXXXXXXXXXXXXXXGXXXXXXXXXXXXXXXXXXXGXXXXXXXXXXXXXXXXXXXGXXXXXXXXXXXXXXXXXXXGXXXXXXXXXXXXXXXXXXXGXXXXXXXXXXXXXXXXXXX,0,300,0
33201,14,1,13,35,251,0,0,263,188,75,GXXXXXXXXXXXXXXXXXXXGXXXXXXXXXXXXXXXXXXXGXXXXXXXXXXXXXXXXXXXGXXXXXXXXXXXXXXXXXXXGXXXXXXXXXXXXXXXXXXXGXXXXXXXXXXXXXXXXXXXGXXXXXXXXXXXXXXXXXXXGXXXXXXXXXXXXXXXXXXXGXXXXXXXXXXXXXXXXXXXGXXXXXXXXXXXXXXXXXXXGAXXXXXXXXXXXXXXXXXXGXXXXXXXXXXXXXXXXXXXGXXXXXXXXXXXXXXXXXXX,0,300,0
33222,14,1,13,35,251,0,0,263,192,71,GXXXXXXXXXXXXXXXXXXXGXXXXXXXXXXXXXXXXXXXGXXXXXXXXXXXXXXXXXXXGXXXXXXXXXXXXXXXXXXXGXXXXXXXXXXXXXXXXXXXGXXXXXXXXXXXXXXXXXXXGXXXXXXXXXXXXXXXXXXXGXXXXXXXXXXXXXXXXXXXGXXXXXXXXXXXXXXXXXXXGXXXXXXXXXXXXXXXXXXXGAXXXXXXXXXXXXXXXXXXGXXXXXXXXXXXXXXXXXXXGXXXXXXXXXXXXXXXXXXX,0,300,0
33243,14,1,13,34,252,0,0,264,190,74,GXXXXXXXXXXXXXXXXXXXGXXXXXXXXXXXXXXXXXXXGXXXXXXXXXXXXXXXXXXXGXXXXXXXXXXXXXXXXXXXGXXXXXXXXXXXXXXXXXXXGXXXXXXXXXXXXXXXXXXXGXXXXXXXXXXXXXXXXXXXGXXXXXXXXXXXXXXXXXXXGXXXXXXXXXXXXXXXXXXXGXXXXXXXXXXXXXXXXXXXGAXXXXXXXXXXXXXXXXXXGXXXXXXXXXXXXXXXXXXXGXXXXXXXXXXXXXXXXXXX,0,300,0
33264,14,1,13,30,256,0,0,267,191,76,GXXXXXXXXXXXXXXXXXXXGXXXXXXXXXXXXXXXXXXXGXXXXXXXXXXXXXXXXXXXGXXXXXXXXXXXXXXXXXXXGXXXXXXXXXXXXXXXXXXXGXXXXXXXXXXXXXXXXXXXGXXXXXXXXXXXXXXXXXXXGXXXXXXXXXXXXXXXXXXXGXXXXXXXXXXXXXXXXXXXGXXXXXXXXXXXXXXXXXXXGAXXXXXXXXXXXXXXXXXXGXXXXXXXXXXXXXXXXXXXGXXXXXXXXXXXXXXXXXXX,0,300,0

33285,14,1,13,35,251,0,0,262,192,70,GXXXXXXXXXXXXXXXXXXXGXXXXXXXXXXXXXXXXXXXGXXXXXXXXXXXXXXXXXXXGXXXXXXXXXXXXXXXXXXXGXXXXXXXXXXXXXXXXXXXGXXXXXXXXXXXXXXXXXXXGXXXXXXXXXXXXXXXXXXXGXXXXXXXXXXXXXXXXXXXGXXXXXXXXXXXXXXXXXXXGXXXXXXXXXXXXXXXXXXXGAXXXXXXXXXXXXXXXXXXGXXXXXXXXXXXXXXXXXXXGXXXXXXXXXXXXXXXXXXX,0,300,0
33306,14,1,13,38,248,0,0,260,189,71,GXXXXXXXXXXXXXXXXXXXGXXXXXXXXXXXXXXXXXXXGXXXXXXXXXXXXXXXXXXXGXXXXXXXXXXXXXXXXXXXGXXXXXXXXXXXXXXXXXXXGXXXXXXXXXXXXXXXXXXXGXXXXXXXXXXXXXXXXXXXGXXXXXXXXXXXXXXXXXXXGXXXXXXXXXXXXXXXXXXXGXXXXXXXXXXXXXXXXXXXGAXXXXXXXXXXXXXXXXXXGXXXXXXXXXXXXXXXXXXXGXXXXXXXXXXXXXXXXXXX,0,300,0
33327,14,1,13,34,252,0,0,264,194,70,GXXXXXXXXXXXXXXXXXXXGXXXXXXXXXXXXXXXXXXXGXXXXXXXXXXXXXXXXXXXGXXXXXXXXXXXXXXXXXXXGXXXXXXXXXXXXXXXXXXXGXXXXXXXXXXXXXXXXXXXGXXXXXXXXXXXXXXXXXXXGXXXXXXXXXXXXXXXXXXXGXXXXXXXXXXXXXXXXXXXGXXXXXXXXXXXXXXXXXXXGAXXXXXXXXXXXXXXXXXXGXXXXXXXXXXXXXXXXXXXGXXXXXXXXXXXXXXXXXXX,0,300,0
33348,14,1,13,36,250,0,0,263,197,66,GXXXXXXXXXXXXXXXXXXXGXXXXXXXXXXXXXXXXXXXGXXXXXXXXXXXXXXXXXXXGXXXXXXXXXXXXXXXXXXXGXXXXXXXXXXXXXXXXXXXGXXXXXXXXXXXXXXXXXXXGXXXXXXXXXXXXXXXXXXXGXXXXXXXXXXXXXXXXXXXGXXXXXXXXXXXXXXXXXXXGXXXXXXXXXXXXXXXXXXXGAXXXXXXXXXXXXXXXXXXGXXXXXXXXXXXXXXXXXXXGXXXXXXXXXXXXXXXXXXX,0,300,0
33369,14,1,13,36,250,0,0,262,196,66,GXXXXXXXXXXXXXXXXXXXGXXXXXXXXXXXXXXXXXXXGXXXXXXXXXXXXXXXXXXXGXXXXXXXXXXXXXXXXXXXGXXXXXXXXXXXXXXXXXXXGXXXXXXXXXXXXXXXXXXXGXXXXXXXXXXXXXXXXXXXGXXXXXXXXXXXXXXXXXXXGXXXXXXXXXXXXXXXXXXXGXXXXXXXXXXXXXXXXXXXGAXXXXXXXXXXXXXXXXXXGXXXXXXXXXXXXXXXXXXXGXXXXXXXXXXXXXXXXXXX,0,300,0

33390,14,1,13,41,245,0,0,257,194,63,GXXXXXXXXXXXXXXXXXXXGXXXXXXXXXXXXXXXXXXXGXXXXXXXXXXXXXXXXXXXGXXXXXXXXXXXXXXXXXXXGXXXXXXXXXXXXXXXXXXXGXXXXXXXXXXXXXXXXXXXGXXXXXXXXXXXXXXXXXXXGXXXXXXXXXXXXXXXXXXXGXXXXXXXXXXXXXXXXXXXGXXXXXXXXXXXXXXXXXXXGAXXXXXXXXXXXXXXXXXXGXXXXXXXXXXXXXXXXXXXGXXXXXXXXXXXXXXXXXXX,0,300,0
33411,14,1,13,43,243,0,0,254,192,62,GXXXXXXXXXXXXXXXXXXXGXXXXXXXXXXXXXXXXXXXGXXXXXXXXXXXXXXXXXXXGXXXXXXXXXXXXXXXXXXXGXXXXXXXXXXXXXXXXXXXGXXXXXXXXXXXXXXXXXXXGXXXXXXXXXXXXXXXXXXXGXXXXXXXXXXXXXXXXXXXGXXXXXXXXXXXXXXXXXXXGXXXXXXXXXXXXXXXXXXXGAXXXXXXXXXXXXXXXXXXGXXXXXXXXXXXXXXXXXXXGXXXXXXXXXXXXXXXXXXX,0,300,0
33432,14,1,13,47,239,0,0,251,187,64,GXXXXXXXXXXXXXXXXXXXGXXXXXXXXXXXXXXXXXXXGXXXXXXXXXXXXXXXXXXXGXXXXXXXXXXXXXXXXXXXGXXXXXXXXXXXXXXXXXXXGXXXXXXXXXXXXXXXXXXXGXXXXXXXXXXXXXXXXXXXGXXXXXXXXXXXXXXXXXXXGXXXXXXXXXXXXXXXXXXXGXXXXXXXXXXXXXXXXXXXGAXXXXXXXXXXXXXXXXXXGXXXXXXXXXXXXXXXXXXXGXXXXXXXXXXXXXXXXXXX,0,300,0
33453,14,1,13,41,245,0,0,257,188,69,GXXXXXXXXXXXXXXXXXXXGXXXXXXXXXXXXXXXXXXXGXXXXXXXXXXXXXXXXXXXGXXXXXXXXXXXXXXXXXXXGXXXXXXXXXXXXXXXXXXXGXXXXXXXXXXXXXXXXXXXGXXXXXXXXXXXXXXXXXXXGXXXXXXXXXXXXXXXXXXXGXXXXXXXXXXXXXXXXXXXGXXXXXXXXXXXXXXXXXXXGAXXXXXXXXXXXXXXXXXXGXXXXXXXXXXXXXXXXXXXGXXXXXXXXXXXXXXXXXXX,0,300,0
33474,14,1,13,36,250,0,0,263,188,75,GXXXXXXXXXXXXXXXXXXXGXXXXXXXXXXXXXXXXXXXGXXXXXXXXXXXXXXXXXXXGXXXXXXXXXXXXXXXXXXXGXXXXXXXXXXXXXXXXXXXGXXXXXXXXXXXXXXXXXXXGXXXXXXXXXXXXXXXXXXXGXXXXXXXXXXXXXXXXXXXGXXXXXXXXXXXXXXXXXXXGXXXXXXXXXXXXXXXXXXXGAXXXXXXXXXXXXXXXXXXGXXXXXXXXXXXXXXXXXXXGXXXXXXXXXXXXXXXXXXX,0,300,0

33495,14,1,13,37,249,0,0,262,187,75,GXXXXXXXXXXXXXXXXXXXGXXXXXXXXXXXXXXXXXXXGXXXXXXXXXXXXXXXXXXXGXXXXXXXXXXXXXXXXXXXGXXXXXXXXXXXXXXXXXXXGXXXXXXXXXXXXXXXXXXXGXXXXXXXXXXXXXXXXXXXGXXXXXXXXXXXXXXXXXXXGXXXXXXXXXXXXXXXXXXXGXXXXXXXXXXXXXXXXXXXGAXXXXXXXXXXXXXXXXXXGXXXXXXXXXXXXXXXXXXXGXXXXXXXXXXXXXXXXXXX,0,300,0
33516,13,0,13,37,250,0,0,262,186,76,GXXXXXXXXXXXXXXXXXXXGXXXXXXXXXXXXXXXXXXXGXXXXXXXXXXXXXXXXXXXGXXXXXXXXXXXXXXXXXXXGXXXXXXXXXXXXXXXXXXXGXXXXXXXXXXXXXXXXXXXGXXXXXXXXXXXXXXXXXXXGXXXXXXXXXXXXXXXXXXXGXXXXXXXXXXXXXXXXXXXGXXXXXXXXXXXXXXXXXXXGXXXXXXXXXXXXXXXXXXXGXXXXXXXXXXXXXXXXXXXGXXXXXXXXXXXXXXXXXXX,0,300,0
33537,13,0,13,37,250,0,0,263,185,78,GXXXXXXXXXXXXXXXXXXXGXXXXXXXXXXXXXXXXXXXGXXXXXXXXXXXXXXXXXXXGXXXXXXXXXXXXXXXXXXXGXXXXXXXXXXXXXXXXXXXGXXXXXXXXXXXXXXXXXXXGXXXXXXXXXXXXXXXXXXXGXXXXXXXXXXXXXXXXXXXGXXXXXXXXXXXXXXXXXXXGXXXXXXXXXXXXXXXXXXXGXXXXXXXXXXXXXXXXXXXGXXXXXXXXXXXXXXXXXXXGXXXXXXXXXXXXXXXXXXX,0,300,0
33558,14,1,13,35,251,0,0,264,185,79,GXXXXXXXXXXXXXXXXXXXGXXXXXXXXXXXXXXXXXXXGXXXXXXXXXXXXXXXXXXXGXXXXXXXXXXXXXXXXXXXGXXXXXXXXXXXXXXXXXXXGXXXXXXXXXXXXXXXXXXXGXXXXXXXXXXXXXXXXXXXGXXXXXXXXXXXXXXXXXXXGXXXXXXXXXXXXXXXXXXXGAXXXXXXXXXXXXXXXXXXGXXXXXXXXXXXXXXXXXXXGXXXXXXXXXXXXXXXXXXXGXXXXXXXXXXXXXXXXXXX,0,300,0
33579,14,1,13,35,251,0,0,264,188,76,GXXXXXXXXXXXXXXXXXXXGXXXXXXXXXXXXXXXXXXXGXXXXXXXXXXXXXXXXXXXGXXXXXXXXXXXXXXXXXXXGXXXXXXXXXXXXXXXXXXXGXXXXXXXXXXXXXXXXXXXGXXXXXXXXXXXXXXXXXXXGXXXXXXXXXXXXXXXXXXXGXXXXXXXXXXXXXXXXXXXGAXXXXXXXXXXXXXXXXXXGXXXXXXXXXXXXXXXXXXXGXXXXXXXXXXXXXXXXXXXGXXXXXXXXXXXXXXXXXXX,0,300,0

33600,14,1,13,31,255,0,0,268,190,78,GXXXXXXXXXXXXXXXXXXXGXXXXXXXXXXXXXXXXXXXGXXXXXXXXXXXXXXXXXXXGXXXXXXXXXXXXXXXXXXXGXXXXXXXXXXXXXXXXXXXGXXXXXXXXXXXXXXXXXXXGXXXXXXXXXXXXXXXXXXXGXXXXXXXXXXXXXXXXXXXGXXXXXXXXXXXXXXXXXXXGAXXXXXXXXXXXXXXXXXXGXXXXXXXXXXXXXXXXXXXGXXXXXXXXXXXXXXXXXXXGXXXXXXXXXXXXXXXXXXX,0,300,0
33621,14,0,14,32,254,0,0,267,198,69,GXXXXXXXXXXXXXXXXXXXGXXXXXXXXXXXXXXXXXXXGXXXXXXXXXXXXXXXXXXXGXXXXXXXXXXXXXXXXXXXGXXXXXXXXXXXXXXXXXXXGXXXXXXXXXXXXXXXXXXXGXXXXXXXXXXXXXXXXXXXGXXXXXXXXXXXXXXXXXXXGXXXXXXXXXXXXXXXXXXXGOXXXXXXXXXXXXXXXXXXGXXXXXXXXXXXXXXXXXXXGXXXXXXXXXXXXXXXXXXXGXXXXXXXXXXXXXXXXXXX,0,300,0
33642,14,0,14,38,248,0,0,261,196,65,GXXXXXXXXXXXXXXXXXXXGXXXXXXXXXXXXXXXXXXXGXXXXXXXXXXXXXXXXXXXGXXXXXXXXXXXXXXXXXXXGXXXXXXXXXXXXXXXXXXXGXXXXXXXXXXXXXXXXXXXGXXXXXXXXXXXXXXXXXXXGXXXXXXXXXXXXXXXXXXXGXXXXXXXXXXXXXXXXXXXGOXXXXXXXXXXXXXXXXXXGXXXXXXXXXXXXXXXXXXXGXXXXXXXXXXXXXXXXXXXGXXXXXXXXXXXXXXXXXXX,0,300,0
33663,13,0,13,44,243,0,0,255,190,65,GXXXXXXXXXXXXXXXXXXXGXXXXXXXXXXXXXXXXXXXGXXXXXXXXXXXXXXXXXXXGXXXXXXXXXXXXXXXXXXXGXXXXXXXXXXXXXXXXXXXGXXXXXXXXXXXXXXXXXXXGXXXXXXXXXXXXXXXXXXXGXXXXXXXXXXXXXXXXXXXGXXXXXXXXXXXXXXXXXXXGXXXXXXXXXXXXXXXXXXXGXXXXXXXXXXXXXXXXXXXGXXXXXXXXXXXXXXXXXXXGXXXXXXXXXXXXXXXXXXX,0,300,0
33684,13,0,13,44,243,0,0,254,189,65,GXXXXXXXXXXXXXXXXXXXGXXXXXXXXXXXXXXXXXXXGXXXXXXXXXXXXXXXXXXXGXXXXXXXXXXXXXXXXXXXGXXXXXXXXXXXXXXXXXXXGXXXXXXXXXXXXXXXXXXXGXXXXXXXXXXXXXXXXXXXGXXXXXXXXXXXXXXXXXXXGXXXXXXXXXXXXXXXXXXXGXXXXXXXXXXXXXXXXXXXGXXXXXXXXXXXXXXXXXXXGXXXXXXXXXXXXXXXXXXXGXXXXXXXXXXXXXXXXXXX,0,300,0

33705,13,0,13,41,246,0,0,258,187,71,GXXXXXXXXXXXXXXXXXXXGXXXXXXXXXXXXXXXXXXXGXXXXXXXXXXXXXXXXXXXGXXXXXXXXXXXXXXXXXXXGXXXXXXXXXXXXXXXXXXXGXXXXXXXXXXXXXXXXXXXGXXXXXXXXXXXXXXXXXXXGXXXXXXXXXXXXXXXXXXXGXXXXXXXXXXXXXXXXXXXGXXXXXXXXXXXXXXXXXXXGXXXXXXXXXXXXXXXXXXXGXXXXXXXXXXXXXXXXXXXGXXXXXXXXXXXXXXXXXXX,0,300,0
33726,13,0,13,40,247,0,0,258,189,69,GXXXXXXXXXXXXXXXXXXXGXXXXXXXXXXXXXXXXXXXGXXXXXXXXXXXXXXXXXXXGXXXXXXXXXXXXXXXXXXXGXXXXXXXXXXXXXXXXXXXGXXXXXXXXXXXXXXXXXXXGXXXXXXXXXXXXXXXXXXXGXXXXXXXXXXXXXXXXXXXGXXXXXXXXXXXXXXXXXXXGXXXXXXXXXXXXXXXXXXXGXXXXXXXXXXXXXXXXXXXGXXXXXXXXXXXXXXXXXXXGXXXXXXXXXXXXXXXXXXX,0,300,0
33747,13,0,13,35,252,0,0,264,188,76,GXXXXXXXXXXXXXXXXXXXGXXXXXXXXXXXXXXXXXXXGXXXXXXXXXXXXXXXXXXXGXXXXXXXXXXXXXXXXXXXGXXXXXXXXXXXXXXXXXXXGXXXXXXXXXXXXXXXXXXXGXXXXXXXXXXXXXXXXXXXGXXXXXXXXXXXXXXXXXXXGXXXXXXXXXXXXXXXXXXXGXXXXXXXXXXXXXXXXXXXGXXXXXXXXXXXXXXXXXXXGXXXXXXXXXXXXXXXXXXXGXXXXXXXXXXXXXXXXXXX,0,300,0
33768,13,0,13,34,253,0,0,265,191,74,GXXXXXXXXXXXXXXXXXXXGXXXXXXXXXXXXXXXXXXXGXXXXXXXXXXXXXXXXXXXGXXXXXXXXXXXXXXXXXXXGXXXXXXXXXXXXXXXXXXXGXXXXXXXXXXXXXXXXXXXGXXXXXXXXXXXXXXXXXXXGXXXXXXXXXXXXXXXXXXXGXXXXXXXXXXXXXXXXXXXGXXXXXXXXXXXXXXXXXXXGXXXXXXXXXXXXXXXXXXXGXXXXXXXXXXXXXXXXXXXGXXXXXXXXXXXXXXXXXXX,0,300,0
33789,13,0,13,32,255,0,0,267,191,76,GXXXXXXXXXXXXXXXXXXXGXXXXXXXXXXXXXXXXXXXGXXXXXXXXXXXXXXXXXXXGXXXXXXXXXXXXXXXXXXXGXXXXXXXXXXXXXXXXXXXGXXXXXXXXXXXXXXXXXXXGXXXXXXXXXXXXXXXXXXXGXXXXXXXXXXXXXXXXXXXGXXXXXXXXXXXXXXXXXXXGXXXXXXXXXXXXXXXXXXXGXXXXXXXXXXXXXXXXXXXGXXXXXXXXXXXXXXXXXXXGXXXXXXXXXXXXXXXXXXX,0,300,0

33810,13,0,13,32,255,0,0,267,194,73,GXXXXXXXXXXXXXXXXXXXGXXXXXXXXXXXXXXXXXXXGXXXXXXXXXXXXXXXXXXXGXXXXXXXXXXXXXXXXXXXGXXXXXXXXXXXXXXXXXXXGXXXXXXXXXXXXXXXXXXXGXXXXXXXXXXXXXXXXXXXGXXXXXXXXXXXXXXXXXXXGXXXXXXXXXXXXXXXXXXXGXXXXXXXXXXXXXXXXXXXGXXXXXXXXXXXXXXXXXXXGXXXXXXXXXXXXXXXXXXXGXXXXXXXXXXXXXXXXXXX,0,300,0
33831,13,0,13,32,255,0,0,266,191,75,GXXXXXXXXXXXXXXXXXXXGXXXXXXXXXXXXXXXXXXXGXXXXXXXXXXXXXXXXXXXGXXXXXXXXXXXXXXXXXXXGXXXXXXXXXXXXXXXXXXXGXXXXXXXXXXXXXXXXXXXGXXXXXXXXXXXXXXXXXXXGXXXXXXXXXXXXXXXXXXXGXXXXXXXXXXXXXXXXXXXGXXXXXXXXXXXXXXXXXXXGXXXXXXXXXXXXXXXXXXXGXXXXXXXXXXXXXXXXXXXGXXXXXXXXXXXXXXXXXXX,0,300,0
33852,13,0,13,38,249,0,0,261,190,71,GXXXXXXXXXXXXXXXXXXXGXXXXXXXXXXXXXXXXXXXGXXXXXXXXXXXXXXXXXXXGXXXXXXXXXXXXXXXXXXXGXXXXXXXXXXXXXXXXXXXGXXXXXXXXXXXXXXXXXXXGXXXXXXXXXXXXXXXXXXXGXXXXXXXXXXXXXXXXXXXGXXXXXXXXXXXXXXXXXXXGXXXXXXXXXXXXXXXXXXXGXXXXXXXXXXXXXXXXXXXGXXXXXXXXXXXXXXXXXXXGXXXXXXXXXXXXXXXXXXX,0,300,0
33873,13,0,13,38,249,0,0,261,189,72,GXXXXXXXXXXXXXXXXXXXGXXXXXXXXXXXXXXXXXXXGXXXXXXXXXXXXXXXXXXXGXXXXXXXXXXXXXXXXXXXGXXXXXXXXXXXXXXXXXXXGXXXXXXXXXXXXXXXXXXXGXXXXXXXXXXXXXXXXXXXGXXXXXXXXXXXXXXXXXXXGXXXXXXXXXXXXXXXXXXXGXXXXXXXXXXXXXXXXXXXGXXXXXXXXXXXXXXXXXXXGXXXXXXXXXXXXXXXXXXXGXXXXXXXXXXXXXXXXXXX,0,300,0
33894,13,0,13,39,248,0,0,260,188,72,GXXXXXXXXXXXXXXXXXXXGXXXXXXXXXXXXXXXXXXXGXXXXXXXXXXXXXXXXXXXGXXXXXXXXXXXXXXXXXXXGXXXXXXXXXXXXXXXXXXXGXXXXXXXXXXXXXXXXXXXGXXXXXXXXXXXXXXXXXXXGXXXXXXXXXXXXXXXXXXXGXXXXXXXXXXXXXXXXXXXGXXXXXXXXXXXXXXXXXXXGXXXXXXXXXXXXXXXXXXXGXXXXXXXXXXXXXXXXXXXGXXXXXXXXXXXXXXXXXXX,0,300,0

33915,13,0,13,41,246,0,0,258,190,68,GXXXXXXXXXXXXXXXXXXXGXXXXXXXXXXXXXXXXXXXGXXXXXXXXXXXXXXXXXXXGXXXXXXXXXXXXXXXXXXXGXXXXXXXXXXXXXXXXXXXGXXXXXXXXXXXXXXXXXXXGXXXXXXXXXXXXXXXXXXXGXXXXXXXXXXXXXXXXXXXGXXXXXXXXXXXXXXXXXXXGXXXXXXXXXXXXXXXXXXXGXXXXXXXXXXXXXXXXXXXGXXXXXXXXXXXXXXXXXXXGXXXXXXXXXXXXXXXXXXX,0,300,0
33936,13,0,13,44,243,0,0,256,191,65,GXXXXXXXXXXXXXXXXXXXGXXXXXXXXXXXXXXXXXXXGXXXXXXXXXXXXXXXXXXXGXXXXXXXXXXXXXXXXXXXGXXXXXXXXXXXXXXXXXXXGXXXXXXXXXXXXXXXXXXXGXXXXXXXXXXXXXXXXXXXGXXXXXXXXXXXXXXXXXXXGXXXXXXXXXXXXXXXXXXXGXXXXXXXXXXXXXXXXXXXGXXXXXXXXXXXXXXXXXXXGXXXXXXXXXXXXXXXXXXXGXXXXXXXXXXXXXXXXXXX,0,300,0
33957,13,0,13,48,239,0,0,252,190,62,GXXXXXXXXXXXXXXXXXXXGXXXXXXXXXXXXXXXXXXXGXXXXXXXXXXXXXXXXXXXGXXXXXXXXXXXXXXXXXXXGXXXXXXXXXXXXXXXXXXXGXXXXXXXXXXXXXXXXXXXGXXXXXXXXXXXXXXXXXXXGXXXXXXXXXXXXXXXXXXXGXXXXXXXXXXXXXXXXXXXGXXXXXXXXXXXXXXXXXXXGXXXXXXXXXXXXXXXXXXXGXXXXXXXXXXXXXXXXXXXGXXXXXXXXXXXXXXXXXXX,0,300,0
33978,13,0,13,44,243,0,0,255,193,62,GXXXXXXXXXXXXXXXXXXXGXXXXXXXXXXXXXXXXXXXGXXXXXXXXXXXXXXXXXXXGXXXXXXXXXXXXXXXXXXXGXXXXXXXXXXXXXXXXXXXGXXXXXXXXXXXXXXXXXXXGXXXXXXXXXXXXXXXXXXXGXXXXXXXXXXXXXXXXXXXGXXXXXXXXXXXXXXXXXXXGXXXXXXXXXXXXXXXXXXXGXXXXXXXXXXXXXXXXXXXGXXXXXXXXXXXXXXXXXXXGXXXXXXXXXXXXXXXXXXX,0,300,0
33999,13,0,13,45,242,0,0,255,194,61,GXXXXXXXXXXXXXXXXXXXGXXXXXXXXXXXXXXXXXXXGXXXXXXXXXXXXXXXXXXXGXXXXXXXXXXXXXXXXXXXGXXXXXXXXXXXXXXXXXXXGXXXXXXXXXXXXXXXXXXXGXXXXXXXXXXXXXXXXXXXGXXXXXXXXXXXXXXXXXXXGXXXXXXXXXXXXXXXXXXXGXXXXXXXXXXXXXXXXXXXGXXXXXXXXXXXXXXXXXXXGXXXXXXXXXXXXXXXXXXXGXXXXXXXXXXXXXXXXXXX,0,300,0

34020,13,0,13,45,242,0,0,254,193,61,GXXXXXXXXXXXXXXXXXXXGXXXXXXXXXXXXXXXXXXXGXXXXXXXXXXXXXXXXXXXGXXXXXXXXXXXXXXXXXXXGXXXXXXXXXXXXXXXXXXXGXXXXXXXXXXXXXXXXXXXGXXXXXXXXXXXXXXXXXXXGXXXXXXXXXXXXXXXXXXXGXXXXXXXXXXXXXXXXXXXGXXXXXXXXXXXXXXXXXXXGXXXXXXXXXXXXXXXXXXXGXXXXXXXXXXXXXXXXXXXGXXXXXXXXXXXXXXXXXXX,0,300,0
34041,14,1,13,45,241,0,0,254,198,56,GXXXXXXXXXXXXXXXXXXXGXXXXXXXXXXXXXXXXXXXGXXXXXXXXXXXXXXXXXXXGXXXXXXXXXXXXXXXXXXXGXXXXXXXXXXXXXXXXXXXGXXXXXXXXXXXXXXXXXXXGAXXXXXXXXXXXXXXXXXXGXXXXXXXXXXXXXXXXXXXGXXXXXXXXXXXXXXXXXXXGXXXXXXXXXXXXXXXXXXXGXXXXXXXXXXXXXXXXXXXGXXXXXXXXXXXXXXXXXXXGXXXXXXXXXXXXXXXXXXX,0,300,0
34062,14,1,13,47,239,0,0,252,196,56,GXXXXXXXXXXXXXXXXXXXGXXXXXXXXXXXXXXXXXXXGXXXXXXXXXXXXXXXXXXXGXXXXXXXXXXXXXXXXXXXGXXXXXXXXXXXXXXXXXXXGXXXXXXXXXXXXXXXXXXXGAXXXXXXXXXXXXXXXXXXGXXXXXXXXXXXXXXXXXXXGXXXXXXXXXXXXXXXXXXXGXXXXXXXXXXXXXXXXXXXGXXXXXXXXXXXXXXXXXXXGXXXXXXXXXXXXXXXXXXXGXXXXXXXXXXXXXXXXXXX,0,300,0
34083,14,1,13,47,239,0,0,252,192,60,GXXXXXXXXXXXXXXXXXXXGXXXXXXXXXXXXXXXXXXXGXXXXXXXXXXXXXXXXXXXGXXXXXXXXXXXXXXXXXXXGXXXXXXXXXXXXXXXXXXXGXXXXXXXXXXXXXXXXXXXGAXXXXXXXXXXXXXXXXXXGXXXXXXXXXXXXXXXXXXXGXXXXXXXXXXXXXXXXXXXGXXXXXXXXXXXXXXXXXXXGXXXXXXXXXXXXXXXXXXXGXXXXXXXXXXXXXXXXXXXGXXXXXXXXXXXXXXXXXXX,0,300,0
34104,14,1,13,48,238,0,0,251,189,62,GXXXXXXXXXXXXXXXXXXXGXXXXXXXXXXXXXXXXXXXGXXXXXXXXXXXXXXXXXXXGXXXXXXXXXXXXXXXXXXXGXXXXXXXXXXXXXXXXXXXGXXXXXXXXXXXXXXXXXXXGAXXXXXXXXXXXXXXXXXXGXXXXXXXXXXXXXXXXXXXGXXXXXXXXXXXXXXXXXXXGXXXXXXXXXXXXXXXXXXXGXXXXXXXXXXXXXXXXXXXGXXXXXXXXXXXXXXXXXXXGXXXXXXXXXXXXXXXXXXX,0,300,0

34125,14,1,13,46,240,0,0,253,188,65,GXXXXXXXXXXXXXXXXXXXGXXXXXXXXXXXXXXXXXXXGXXXXXXXXXXXXXXXXXXXGXXXXXXXXXXXXXXXXXXXGXXXXXXXXXXXXXXXXXXXGXXXXXXXXXXXXXXXXXXXGAXXXXXXXXXXXXXXXXXXGXXXXXXXXXXXXXXXXXXXGXXXXXXXXXXXXXXXXXXXGXXXXXXXXXXXXXXXXXXXGXXXXXXXXXXXXXXXXXXXGXXXXXXXXXXXXXXXXXXXGXXXXXXXXXXXXXXXXXXX,0,300,0
34146,14,1,13,43,243,0,0,255,190,65,GXXXXXXXXXXXXXXXXXXXGXXXXXXXXXXXXXXXXXXXGXXXXXXXXXXXXXXXXXXXGXXXXXXXXXXXXXXXXXXXGXXXXXXXXXXXXXXXXXXXGXXXXXXXXXXXXXXXXXXXGAXXXXXXXXXXXXXXXXXXGXXXXXXXXXXXXXXXXXXXGXXXXXXXXXXXXXXXXXXXGXXXXXXXXXXXXXXXXXXXGXXXXXXXXXXXXXXXXXXXGXXXXXXXXXXXXXXXXXXXGXXXXXXXXXXXXXXXXXXX,0,300,0
34167,14,1,13,43,243,0,0,255,191,64,GXXXXXXXXXXXXXXXXXXXGXXXXXXXXXXXXXXXXXXXGXXXXXXXXXXXXXXXXXXXGXXXXXXXXXXXXXXXXXXXGXXXXXXXXXXXXXXXXXXXGXXXXXXXXXXXXXXXXXXXGAXXXXXXXXXXXXXXXXXXGXXXXXXXXXXXXXXXXXXXGXXXXXXXXXXXXXXXXXXXGXXXXXXXXXXXXXXXXXXXGXXXXXXXXXXXXXXXXXXXGXXXXXXXXXXXXXXXXXXXGXXXXXXXXXXXXXXXXXXX,0,300,0
34188,14,1,13,44,242,0,0,253,189,64,GXXXXXXXXXXXXXXXXXXXGXXXXXXXXXXXXXXXXXXXGXXXXXXXXXXXXXXXXXXXGXXXXXXXXXXXXXXXXXXXGXXXXXXXXXXXXXXXXXXXGXXXXXXXXXXXXXXXXXXXGAXXXXXXXXXXXXXXXXXXGXXXXXXXXXXXXXXXXXXXGXXXXXXXXXXXXXXXXXXXGXXXXXXXXXXXXXXXXXXXGXXXXXXXXXXXXXXXXXXXGXXXXXXXXXXXXXXXXXXXGXXXXXXXXXXXXXXXXXXX,0,300,0
34209,14,1,13,42,244,0,0,256,191,65,GXXXXXXXXXXXXXXXXXXXGXXXXXXXXXXXXXXXXXXXGXXXXXXXXXXXXXXXXXXXGXXXXXXXXXXXXXXXXXXXGXXXXXXXXXXXXXXXXXXXGXXXXXXXXXXXXXXXXXXXGAXXXXXXXXXXXXXXXXXXGXXXXXXXXXXXXXXXXXXXGXXXXXXXXXXXXXXXXXXXGXXXXXXXXXXXXXXXXXXXGXXXXXXXXXXXXXXXXXXXGXXXXXXXXXXXXXXXXXXXGXXXXXXXXXXXXXXXXXXX,0,300,0

34230,15,2,13,40,245,0,0,257,189,68,GXXXXXXXXXXXXXXXXXXXGXXXXXXXXXXXXXXXXXXXGXXXXXXXXXXXXXXXXXXXGAXXXXXXXXXXXXXXXXXXGXXXXXXXXXXXXXXXXXXXGXXXXXXXXXXXXXXXXXXXGAXXXXXXXXXXXXXXXXXXGXXXXXXXXXXXXXXXXXXXGXXXXXXXXXXXXXXXXXXXGXXXXXXXXXXXXXXXXXXXGXXXXXXXXXXXXXXXXXXXGXXXXXXXXXXXXXXXXXXXGXXXXXXXXXXXXXXXXXXX,0,300,0
34251,14,1,13,41,245,0,0,256,190,66,GXXXXXXXXXXXXXXXXXXXGXXXXXXXXXXXXXXXXXXXGXXXXXXXXXXXXXXXXXXXGAXXXXXXXXXXXXXXXXXXGXXXXXXXXXXXXXXXXXXXGXXXXXXXXXXXXXXXXXXXGXXXXXXXXXXXXXXXXXXXGXXXXXXXXXXXXXXXXXXXGXXXXXXXXXXXXXXXXXXXGXXXXXXXXXXXXXXXXXXXGXXXXXXXXXXXXXXXXXXXGXXXXXXXXXXXXXXXXXXXGXXXXXXXXXXXXXXXXXXX,0,300,0
34272,14,1,13,41,245,0,0,258,189,69,GXXXXXXXXXXXXXXXXXXXGXXXXXXXXXXXXXXXXXXXGXXXXXXXXXXXXXXXXXXXGAXXXXXXXXXXXXXXXXXXGXXXXXXXXXXXXXXXXXXXGXXXXXXXXXXXXXXXXXXXGXXXXXXXXXXXXXXXXXXXGXXXXXXXXXXXXXXXXXXXGXXXXXXXXXXXXXXXXXXXGXXXXXXXXXXXXXXXXXXXGXXXXXXXXXXXXXXXXXXXGXXXXXXXXXXXXXXXXXXXGXXXXXXXXXXXXXXXXXXX,0,300,0
34293,14,1,13,39,247,0,0,260,192,68,GXXXXXXXXXXXXXXXXXXXGXXXXXXXXXXXXXXXXXXXGXXXXXXXXXXXXXXXXXXXGAXXXXXXXXXXXXXXXXXXGXXXXXXXXXXXXXXXXXXXGXXXXXXXXXXXXXXXXXXXGXXXXXXXXXXXXXXXXXXXGXXXXXXXXXXXXXXXXXXXGXXXXXXXXXXXXXXXXXXXGXXXXXXXXXXXXXXXXXXXGXXXXXXXXXXXXXXXXXXXGXXXXXXXXXXXXXXXXXXXGXXXXXXXXXXXXXXXXXXX,0,300,0
34314,14,1,13,36,250,0,0,262,193,69,GXXXXXXXXXXXXXXXXXXXGXXXXXXXXXXXXXXXXXXXGXXXXXXXXXXXXXXXXXXXGAXXXXXXXXXXXXXXXXXXGXXXXXXXXXXXXXXXXXXXGXXXXXXXXXXXXXXXXXXXGXXXXXXXXXXXXXXXXXXXGXXXXXXXXXXXXXXXXXXXGXXXXXXXXXXXXXXXXXXXGXXXXXXXXXXXXXXXXXXXGXXXXXXXXXXXXXXXXXXXGXXXXXXXXXXXXXXXXXXXGXXXXXXXXXXXXXXXXXXX,0,300,0

34335,14,1,13,36,250,0,0,263,190,73,GXXXXXXXXXXXXXXXXXXXGXXXXXXXXXXXXXXXXXXXGXXXXXXXXXXXXXXXXXXXGAXXXXXXXXXXXXXXXXXXGXXXXXXXXXXXXXXXXXXXGXXXXXXXXXXXXXXXXXXXGXXXXXXXXXXXXXXXXXXXGXXXXXXXXXXXXXXXXXXXGXXXXXXXXXXXXXXXXXXXGXXXXXXXXXXXXXXXXXXXGXXXXXXXXXXXXXXXXXXXGXXXXXXXXXXXXXXXXXXXGXXXXXXXXXXXXXXXXXXX,0,300,0
34356,14,1,13,32,254,0,0,267,193,74,GXXXXXXXXXXXXXXXXXXXGXXXXXXXXXXXXXXXXXXXGXXXXXXXXXXXXXXXXXXXGAXXXXXXXXXXXXXXXXXXGXXXXXXXXXXXXXXXXXXXGXXXXXXXXXXXXXXXXXXXGXXXXXXXXXXXXXXXXXXXGXXXXXXXXXXXXXXXXXXXGXXXXXXXXXXXXXXXXXXXGXXXXXXXXXXXXXXXXXXXGXXXXXXXXXXXXXXXXXXXGXXXXXXXXXXXXXXXXXXXGXXXXXXXXXXXXXXXXXXX,0,300,0
34377,14,1,13,33,253,0,0,266,190,76,GXXXXXXXXXXXXXXXXXXXGXXXXXXXXXXXXXXXXXXXGXXXXXXXXXXXXXXXXXXXGAXXXXXXXXXXXXXXXXXXGXXXXXXXXXXXXXXXXXXXGXXXXXXXXXXXXXXXXXXXGXXXXXXXXXXXXXXXXXXXGXXXXXXXXXXXXXXXXXXXGXXXXXXXXXXXXXXXXXXXGXXXXXXXXXXXXXXXXXXXGXXXXXXXXXXXXXXXXXXXGXXXXXXXXXXXXXXXXXXXGXXXXXXXXXXXXXXXXXXX,0,300,0
34398,14,1,13,34,252,0,0,265,192,73,GXXXXXXXXXXXXXXXXXXXGXXXXXXXXXXXXXXXXXXXGXXXXXXXXXXXXXXXXXXXGAXXXXXXXXXXXXXXXXXXGXXXXXXXXXXXXXXXXXXXGXXXXXXXXXXXXXXXXXXXGXXXXXXXXXXXXXXXXXXXGXXXXXXXXXXXXXXXXXXXGXXXXXXXXXXXXXXXXXXXGXXXXXXXXXXXXXXXXXXXGXXXXXXXXXXXXXXXXXXXGXXXXXXXXXXXXXXXXXXXGXXXXXXXXXXXXXXXXXXX,0,300,0
34419,14,1,13,36,250,0,0,263,192,71,GXXXXXXXXXXXXXXXXXXXGXXXXXXXXXXXXXXXXXXXGXXXXXXXXXXXXXXXXXXXGAXXXXXXXXXXXXXXXXXXGXXXXXXXXXXXXXXXXXXXGXXXXXXXXXXXXXXXXXXXGXXXXXXXXXXXXXXXXXXXGXXXXXXXXXXXXXXXXXXXGXXXXXXXXXXXXXXXXXXXGXXXXXXXXXXXXXXXXXXXGXXXXXXXXXXXXXXXXXXXGXXXXXXXXXXXXXXXXXXXGXXXXXXXXXXXXXXXXXXX,0,300,0

34440,14,1,13,33,253,0,0,265,193,72,GXXXXXXXXXXXXXXXXXXXGXXXXXXXXXXXXXXXXXXXGXXXXXXXXXXXXXXXXXXXGAXXXXXXXXXXXXXXXXXXGXXXXXXXXXXXXXXXXXXXGXXXXXXXXXXXXXXXXXXXGXXXXXXXXXXXXXXXXXXXGXXXXXXXXXXXXXXXXXXXGXXXXXXXXXXXXXXXXXXXGXXXXXXXXXXXXXXXXXXXGXXXXXXXXXXXXXXXXXXXGXXXXXXXXXXXXXXXXXXXGXXXXXXXXXXXXXXXXXXX,0,300,0
34461,14,1,13,34,252,0,0,264,196,68,GXXXXXXXXXXXXXXXXXXXGXXXXXXXXXXXXXXXXXXXGXXXXXXXXXXXXXXXXXXXGAXXXXXXXXXXXXXXXXXXGXXXXXXXXXXXXXXXXXXXGXXXXXXXXXXXXXXXXXXXGXXXXXXXXXXXXXXXXXXXGXXXXXXXXXXXXXXXXXXXGXXXXXXXXXXXXXXXXXXXGXXXXXXXXXXXXXXXXXXXGXXXXXXXXXXXXXXXXXXXGXXXXXXXXXXXXXXXXXXXGXXXXXXXXXXXXXXXXXXX,0,300,0
34482,14,0,14,38,248,0,0,261,195,66,GXXXXXXXXXXXXXXXXXXXGXXXXXXXXXXXXXXXXXXXGXXXXXXXXXXXXXXXXXXXGOXXXXXXXXXXXXXXXXXXGXXXXXXXXXXXXXXXXXXXGXXXXXXXXXXXXXXXXXXXGXXXXXXXXXXXXXXXXXXXGXXXXXXXXXXXXXXXXXXXGXXXXXXXXXXXXXXXXXXXGXXXXXXXXXXXXXXXXXXXGXXXXXXXXXXXXXXXXXXXGXXXXXXXXXXXXXXXXXXXGXXXXXXXXXXXXXXXXXXX,0,300,0
34503,13,0,13,41,246,0,0,258,197,61,GXXXXXXXXXXXXXXXXXXXGXXXXXXXXXXXXXXXXXXXGXXXXXXXXXXXXXXXXXXXGXXXXXXXXXXXXXXXXXXXGXXXXXXXXXXXXXXXXXXXGXXXXXXXXXXXXXXXXXXXGXXXXXXXXXXXXXXXXXXXGXXXXXXXXXXXXXXXXXXXGXXXXXXXXXXXXXXXXXXXGXXXXXXXXXXXXXXXXXXXGXXXXXXXXXXXXXXXXXXXGXXXXXXXXXXXXXXXXXXXGXXXXXXXXXXXXXXXXXXX,0,300,0
34524,13,0,13,39,248,0,0,259,194,65,GXXXXXXXXXXXXXXXXXXXGXXXXXXXXXXXXXXXXXXXGXXXXXXXXXXXXXXXXXXXGXXXXXXXXXXXXXXXXXXXGXXXXXXXXXXXXXXXXXXXGXXXXXXXXXXXXXXXXXXXGXXXXXXXXXXXXXXXXXXXGXXXXXXXXXXXXXXXXXXXGXXXXXXXXXXXXXXXXXXXGXXXXXXXXXXXXXXXXXXXGXXXXXXXXXXXXXXXXXXXGXXXXXXXXXXXXXXXXXXXGXXXXXXXXXXXXXXXXXXX,0,300,0

34545,13,0,13,42,245,0,0,257,199,58,GXXXXXXXXXXXXXXXXXXXGXXXXXXXXXXXXXXXXXXXGXXXXXXXXXXXXXXXXXXXGXXXXXXXXXXXXXXXXXXXGXXXXXXXXXXXXXXXXXXXGXXXXXXXXXXXXXXXXXXXGXXXXXXXXXXXXXXXXXXXGXXXXXXXXXXXXXXXXXXXGXXXXXXXXXXXXXXXXXXXGXXXXXXXXXXXXXXXXXXXGXXXXXXXXXXXXXXXXXXXGXXXXXXXXXXXXXXXXXXXGXXXXXXXXXXXXXXXXXXX,0,300,0
34566,13,0,13,48,239,0,0,251,194,57,GXXXXXXXXXXXXXXXXXXXGXXXXXXXXXXXXXXXXXXXGXXXXXXXXXXXXXXXXXXXGXXXXXXXXXXXXXXXXXXXGXXXXXXXXXXXXXXXXXXXGXXXXXXXXXXXXXXXXXXXGXXXXXXXXXXXXXXXXXXXGXXXXXXXXXXXXXXXXXXXGXXXXXXXXXXXXXXXXXXXGXXXXXXXXXXXXXXXXXXXGXXXXXXXXXXXXXXXXXXXGXXXXXXXXXXXXXXXXXXXGXXXXXXXXXXXXXXXXXXX,0,300,0
34587,13,0,13,47,240,0,0,252,196,56,GXXXXXXXXXXXXXXXXXXXGXXXXXXXXXXXXXXXXXXXGXXXXXXXXXXXXXXXXXXXGXXXXXXXXXXXXXXXXXXXGXXXXXXXXXXXXXXXXXXXGXXXXXXXXXXXXXXXXXXXGXXXXXXXXXXXXXXXXXXXGXXXXXXXXXXXXXXXXXXXGXXXXXXXXXXXXXXXXXXXGXXXXXXXXXXXXXXXXXXXGXXXXXXXXXXXXXXXXXXXGXXXXXXXXXXXXXXXXXXXGXXXXXXXXXXXXXXXXXXX,0,300,0
34608,13,0,13,45,242,0,0,254,196,58,GXXXXXXXXXXXXXXXXXXXGXXXXXXXXXXXXXXXXXXXGXXXXXXXXXXXXXXXXXXXGXXXXXXXXXXXXXXXXXXXGXXXXXXXXXXXXXXXXXXXGXXXXXXXXXXXXXXXXXXXGXXXXXXXXXXXXXXXXXXXGXXXXXXXXXXXXXXXXXXXGXXXXXXXXXXXXXXXXXXXGXXXXXXXXXXXXXXXXXXXGXXXXXXXXXXXXXXXXXXXGXXXXXXXXXXXXXXXXXXXGXXXXXXXXXXXXXXXXXXX,0,300,0
34629,13,0,13,42,245,0,0,257,192,65,GXXXXXXXXXXXXXXXXXXXGXXXXXXXXXXXXXXXXXXXGXXXXXXXXXXXXXXXXXXXGXXXXXXXXXXXXXXXXXXXGXXXXXXXXXXXXXXXXXXXGXXXXXXXXXXXXXXXXXXXGXXXXXXXXXXXXXXXXXXXGXXXXXXXXXXXXXXXXXXXGXXXXXXXXXXXXXXXXXXXGXXXXXXXXXXXXXXXXXXXGXXXXXXXXXXXXXXXXXXXGXXXXXXXXXXXXXXXXXXXGXXXXXXXXXXXXXXXXXXX,0,300,0

34650,13,0,13,42,245,0,0,256,190,66,GXXXXXXXXXXXXXXXXXXXGXXXXXXXXXXXXXXXXXXXGXXXXXXXXXXXXXXXXXXXGXXXXXXXXXXXXXXXXXXXGXXXXXXXXXXXXXXXXXXXGXXXXXXXXXXXXXXXXXXXGXXXXXXXXXXXXXXXXXXXGXXXXXXXXXXXXXXXXXXXGXXXXXXXXXXXXXXXXXXXGXXXXXXXXXXXXXXXXXXXGXXXXXXXXXXXXXXXXXXXGXXXXXXXXXXXXXXXXXXXGXXXXXXXXXXXXXXXXXXX,0,300,0
34671,14,1,13,39,247,0,0,259,193,66,GXXXXXXXXXXXXXXXXXXXGXXXXXXXXXXXXXXXXXXXGXXXXXXXXXXXXXXXXXXXGXXXXXXXXXXXXXXXXXXXGXXXXXXXXXXXXXXXXXXXGAXXXXXXXXXXXXXXXXXXGXXXXXXXXXXXXXXXXXXXGXXXXXXXXXXXXXXXXXXXGXXXXXXXXXXXXXXXXXXXGXXXXXXXXXXXXXXXXXXXGXXXXXXXXXXXXXXXXXXXGXXXXXXXXXXXXXXXXXXXGXXXXXXXXXXXXXXXXXXX,0,300,0
34692,14,1,13,37,249,0,0,261,192,69,GXXXXXXXXXXXXXXXXXXXGXXXXXXXXXXXXXXXXXXXGXXXXXXXXXXXXXXXXXXXGXXXXXXXXXXXXXXXXXXXGXXXXXXXXXXXXXXXXXXXGAXXXXXXXXXXXXXXXXXXGXXXXXXXXXXXXXXXXXXXGXXXXXXXXXXXXXXXXXXXGXXXXXXXXXXXXXXXXXXXGXXXXXXXXXXXXXXXXXXXGXXXXXXXXXXXXXXXXXXXGXXXXXXXXXXXXXXXXXXXGXXXXXXXXXXXXXXXXXXX,0,300,0
34713,14,1,13,39,247,0,0,259,192,67,GXXXXXXXXXXXXXXXXXXXGXXXXXXXXXXXXXXXXXXXGXXXXXXXXXXXXXXXXXXXGXXXXXXXXXXXXXXXXXXXGXXXXXXXXXXXXXXXXXXXGAXXXXXXXXXXXXXXXXXXGXXXXXXXXXXXXXXXXXXXGXXXXXXXXXXXXXXXXXXXGXXXXXXXXXXXXXXXXXXXGXXXXXXXXXXXXXXXXXXXGXXXXXXXXXXXXXXXXXXXGXXXXXXXXXXXXXXXXXXXGXXXXXXXXXXXXXXXXXXX,0,300,0
34734,14,1,13,39,247,0,0,259,192,67,GXXXXXXXXXXXXXXXXXXXGXXXXXXXXXXXXXXXXXXXGXXXXXXXXXXXXXXXXXXXGXXXXXXXXXXXXXXXXXXXGXXXXXXXXXXXXXXXXXXXGAXXXXXXXXXXXXXXXXXXGXXXXXXXXXXXXXXXXXXXGXXXXXXXXXXXXXXXXXXXGXXXXXXXXXXXXXXXXXXXGXXXXXXXXXXXXXXXXXXXGXXXXXXXXXXXXXXXXXXXGXXXXXXXXXXXXXXXXXXXGXXXXXXXXXXXXXXXXXXX,0,300,0

34755,14,1,13,41,245,0,0,257,189,68,GXXXXXXXXXXXXXXXXXXXGXXXXXXXXXXXXXXXXXXXGXXXXXXXXXXXXXXXXXXXGXXXXXXXXXXXXXXXXXXXGXXXXXXXXXXXXXXXXXXXGAXXXXXXXXXXXXXXXXXXGXXXXXXXXXXXXXXXXXXXGXXXXXXXXXXXXXXXXXXXGXXXXXXXXXXXXXXXXXXXGXXXXXXXXXXXXXXXXXXXGXXXXXXXXXXXXXXXXXXXGXXXXXXXXXXXXXXXXXXXGXXXXXXXXXXXXXXXXXXX,0,300,0
34776,14,0,14,42,244,0,0,256,190,66,GXXXXXXXXXXXXXXXXXXXGXXXXXXXXXXXXXXXXXXXGXXXXXXXXXXXXXXXXXXXGXXXXXXXXXXXXXXXXXXXGXXXXXXXXXXXXXXXXXXXGOXXXXXXXXXXXXXXXXXXGXXXXXXXXXXXXXXXXXXXGXXXXXXXXXXXXXXXXXXXGXXXXXXXXXXXXXXXXXXXGXXXXXXXXXXXXXXXXXXXGXXXXXXXXXXXXXXXXXXXGXXXXXXXXXXXXXXXXXXXGXXXXXXXXXXXXXXXXXXX,0,300,0
34797,14,0,14,41,245,0,0,258,192,66,GXXXXXXXXXXXXXXXXXXXGXXXXXXXXXXXXXXXXXXXGXXXXXXXXXXXXXXXXXXXGXXXXXXXXXXXXXXXXXXXGXXXXXXXXXXXXXXXXXXXGOXXXXXXXXXXXXXXXXXXGXXXXXXXXXXXXXXXXXXXGXXXXXXXXXXXXXXXXXXXGXXXXXXXXXXXXXXXXXXXGXXXXXXXXXXXXXXXXXXXGXXXXXXXXXXXXXXXXXXXGXXXXXXXXXXXXXXXXXXXGXXXXXXXXXXXXXXXXXXX,0,300,0
34818,13,0,13,40,247,0,0,260,190,70,GXXXXXXXXXXXXXXXXXXXGXXXXXXXXXXXXXXXXXXXGXXXXXXXXXXXXXXXXXXXGXXXXXXXXXXXXXXXXXXXGXXXXXXXXXXXXXXXXXXXGXXXXXXXXXXXXXXXXXXXGXXXXXXXXXXXXXXXXXXXGXXXXXXXXXXXXXXXXXXXGXXXXXXXXXXXXXXXXXXXGXXXXXXXXXXXXXXXXXXXGXXXXXXXXXXXXXXXXXXXGXXXXXXXXXXXXXXXXXXXGXXXXXXXXXXXXXXXXXXX,0,300,0
34839,13,0,13,36,251,0,0,264,191,73,GXXXXXXXXXXXXXXXXXXXGXXXXXXXXXXXXXXXXXXXGXXXXXXXXXXXXXXXXXXXGXXXXXXXXXXXXXXXXXXXGXXXXXXXXXXXXXXXXXXXGXXXXXXXXXXXXXXXXXXXGXXXXXXXXXXXXXXXXXXXGXXXXXXXXXXXXXXXXXXXGXXXXXXXXXXXXXXXXXXXGXXXXXXXXXXXXXXXXXXXGXXXXXXXXXXXXXXXXXXXGXXXXXXXXXXXXXXXXXXXGXXXXXXXXXXXXXXXXXXX,0,300,0

34860,13,0,13,36,251,0,0,265,192,73,GXXXXXXXXXXXXXXXXXXXGXXXXXXXXXXXXXXXXXXXGXXXXXXXXXXXXXXXXXXXGXXXXXXXXXXXXXXXXXXXGXXXXXXXXXXXXXXXXXXXGXXXXXXXXXXXXXXXXXXXGXXXXXXXXXXXXXXXXXXXGXXXXXXXXXXXXXXXXXXXGXXXXXXXXXXXXXXXXXXXGXXXXXXXXXXXXXXXXXXXGXXXXXXXXXXXXXXXXXXXGXXXXXXXXXXXXXXXXXXXGXXXXXXXXXXXXXXXXXXX,0,300,0
34881,13,0,13,32,255,0,0,266,193,73,GXXXXXXXXXXXXXXXXXXXGXXXXXXXXXXXXXXXXXXXGXXXXXXXXXXXXXXXXXXXGXXXXXXXXXXXXXXXXXXXGXXXXXXXXXXXXXXXXXXXGXXXXXXXXXXXXXXXXXXXGXXXXXXXXXXXXXXXXXXXGXXXXXXXXXXXXXXXXXXXGXXXXXXXXXXXXXXXXXXXGXXXXXXXXXXXXXXXXXXXGXXXXXXXXXXXXXXXXXXXGXXXXXXXXXXXXXXXXXXXGXXXXXXXXXXXXXXXXXXX,0,300,0
34902,13,0,13,31,256,0,0,269,195,74,GXXXXXXXXXXXXXXXXXXXGXXXXXXXXXXXXXXXXXXXGXXXXXXXXXXXXXXXXXXXGXXXXXXXXXXXXXXXXXXXGXXXXXXXXXXXXXXXXXXXGXXXXXXXXXXXXXXXXXXXGXXXXXXXXXXXXXXXXXXXGXXXXXXXXXXXXXXXXXXXGXXXXXXXXXXXXXXXXXXXGXXXXXXXXXXXXXXXXXXXGXXXXXXXXXXXXXXXXXXXGXXXXXXXXXXXXXXXXXXXGXXXXXXXXXXXXXXXXXXX,0,300,0
34923,13,0,13,32,255,0,0,268,200,68,GXXXXXXXXXXXXXXXXXXXGXXXXXXXXXXXXXXXXXXXGXXXXXXXXXXXXXXXXXXXGXXXXXXXXXXXXXXXXXXXGXXXXXXXXXXXXXXXXXXXGXXXXXXXXXXXXXXXXXXXGXXXXXXXXXXXXXXXXXXXGXXXXXXXXXXXXXXXXXXXGXXXXXXXXXXXXXXXXXXXGXXXXXXXXXXXXXXXXXXXGXXXXXXXXXXXXXXXXXXXGXXXXXXXXXXXXXXXXXXXGXXXXXXXXXXXXXXXXXXX,0,300,0
34944,13,0,13,32,255,0,0,267,201,66,GXXXXXXXXXXXXXXXXXXXGXXXXXXXXXXXXXXXXXXXGXXXXXXXXXXXXXXXXXXXGXXXXXXXXXXXXXXXXXXXGXXXXXXXXXXXXXXXXXXXGXXXXXXXXXXXXXXXXXXXGXXXXXXXXXXXXXXXXXXXGXXXXXXXXXXXXXXXXXXXGXXXXXXXXXXXXXXXXXXXGXXXXXXXXXXXXXXXXXXXGXXXXXXXXXXXXXXXXXXXGXXXXXXXXXXXXXXXXXXXGXXXXXXXXXXXXXXXXXXX,0,300,0

34965,13,0,13,35,252,0,0,265,201,64,GXXXXXXXXXXXXXXXXXXXGXXXXXXXXXXXXXXXXXXXGXXXXXXXXXXXXXXXXXXXGXXXXXXXXXXXXXXXXXXXGXXXXXXXXXXXXXXXXXXXGXXXXXXXXXXXXXXXXXXXGXXXXXXXXXXXXXXXXXXXGXXXXXXXXXXXXXXXXXXXGXXXXXXXXXXXXXXXXXXXGXXXXXXXXXXXXXXXXXXXGXXXXXXXXXXXXXXXXXXXGXXXXXXXXXXXXXXXXXXXGXXXXXXXXXXXXXXXXXXX,0,300,0
34986,13,0,13,38,249,0,0,263,199,64,GXXXXXXXXXXXXXXXXXXXGXXXXXXXXXXXXXXXXXXXGXXXXXXXXXXXXXXXXXXXGXXXXXXXXXXXXXXXXXXXGXXXXXXXXXXXXXXXXXXXGXXXXXXXXXXXXXXXXXXXGXXXXXXXXXXXXXXXXXXXGXXXXXXXXXXXXXXXXXXXGXXXXXXXXXXXXXXXXXXXGXXXXXXXXXXXXXXXXXXXGXXXXXXXXXXXXXXXXXXXGXXXXXXXXXXXXXXXXXXXGXXXXXXXXXXXXXXXXXXX,0,300,0
35007,13,0,13,32,255,0,0,269,201,68,GXXXXXXXXXXXXXXXXXXXGXXXXXXXXXXXXXXXXXXXGXXXXXXXXXXXXXXXXXXXGXXXXXXXXXXXXXXXXXXXGXXXXXXXXXXXXXXXXXXXGXXXXXXXXXXXXXXXXXXXGXXXXXXXXXXXXXXXXXXXGXXXXXXXXXXXXXXXXXXXGXXXXXXXXXXXXXXXXXXXGXXXXXXXXXXXXXXXXXXXGXXXXXXXXXXXXXXXXXXXGXXXXXXXXXXXXXXXXXXXGXXXXXXXXXXXXXXXXXXX,0,300,0
35028,13,0,13,32,255,0,0,268,197,71,GXXXXXXXXXXXXXXXXXXXGXXXXXXXXXXXXXXXXXXXGXXXXXXXXXXXXXXXXXXXGXXXXXXXXXXXXXXXXXXXGXXXXXXXXXXXXXXXXXXXGXXXXXXXXXXXXXXXXXXXGXXXXXXXXXXXXXXXXXXXGXXXXXXXXXXXXXXXXXXXGXXXXXXXXXXXXXXXXXXXGXXXXXXXXXXXXXXXXXXXGXXXXXXXXXXXXXXXXXXXGXXXXXXXXXXXXXXXXXXXGXXXXXXXXXXXXXXXXXXX,0,300,0
35049,13,0,13,34,253,0,0,267,198,69,GXXXXXXXXXXXXXXXXXXXGXXXXXXXXXXXXXXXXXXXGXXXXXXXXXXXXXXXXXXXGXXXXXXXXXXXXXXXXXXXGXXXXXXXXXXXXXXXXXXXGXXXXXXXXXXXXXXXXXXXGXXXXXXXXXXXXXXXXXXXGXXXXXXXXXXXXXXXXXXXGXXXXXXXXXXXXXXXXXXXGXXXXXXXXXXXXXXXXXXXGXXXXXXXXXXXXXXXXXXXGXXXXXXXXXXXXXXXXXXXGXXXXXXXXXXXXXXXXXXX,0,300,0

35070,13,0,13,42,245,0,0,259,194,65,GXXXXXXXXXXXXXXXXXXXGXXXXXXXXXXXXXXXXXXXGXXXXXXXXXXXXXXXXXXXGXXXXXXXXXXXXXXXXXXXGXXXXXXXXXXXXXXXXXXXGXXXXXXXXXXXXXXXXXXXGXXXXXXXXXXXXXXXXXXXGXXXXXXXXXXXXXXXXXXXGXXXXXXXXXXXXXXXXXXXGXXXXXXXXXXXXXXXXXXXGXXXXXXXXXXXXXXXXXXXGXXXXXXXXXXXXXXXXXXXGXXXXXXXXXXXXXXXXXXX,0,300,0
35091,13,0,13,40,247,0,0,261,197,64,GXXXXXXXXXXXXXXXXXXXGXXXXXXXXXXXXXXXXXXXGXXXXXXXXXXXXXXXXXXXGXXXXXXXXXXXXXXXXXXXGXXXXXXXXXXXXXXXXXXXGXXXXXXXXXXXXXXXXXXXGXXXXXXXXXXXXXXXXXXXGXXXXXXXXXXXXXXXXXXXGXXXXXXXXXXXXXXXXXXXGXXXXXXXXXXXXXXXXXXXGXXXXXXXXXXXXXXXXXXXGXXXXXXXXXXXXXXXXXXXGXXXXXXXXXXXXXXXXXXX,0,300,0
35112,13,0,13,39,248,0,0,261,198,63,GXXXXXXXXXXXXXXXXXXXGXXXXXXXXXXXXXXXXXXXGXXXXXXXXXXXXXXXXXXXGXXXXXXXXXXXXXXXXXXXGXXXXXXXXXXXXXXXXXXXGXXXXXXXXXXXXXXXXXXXGXXXXXXXXXXXXXXXXXXXGXXXXXXXXXXXXXXXXXXXGXXXXXXXXXXXXXXXXXXXGXXXXXXXXXXXXXXXXXXXGXXXXXXXXXXXXXXXXXXXGXXXXXXXXXXXXXXXXXXXGXXXXXXXXXXXXXXXXXXX,0,300,0
35133,13,0,13,42,245,0,0,258,198,60,GXXXXXXXXXXXXXXXXXXXGXXXXXXXXXXXXXXXXXXXGXXXXXXXXXXXXXXXXXXXGXXXXXXXXXXXXXXXXXXXGXXXXXXXXXXXXXXXXXXXGXXXXXXXXXXXXXXXXXXXGXXXXXXXXXXXXXXXXXXXGXXXXXXXXXXXXXXXXXXXGXXXXXXXXXXXXXXXXXXXGXXXXXXXXXXXXXXXXXXXGXXXXXXXXXXXXXXXXXXXGXXXXXXXXXXXXXXXXXXXGXXXXXXXXXXXXXXXXXXX,0,300,0
35154,13,0,13,45,242,0,0,256,197,59,GXXXXXXXXXXXXXXXXXXXGXXXXXXXXXXXXXXXXXXXGXXXXXXXXXXXXXXXXXXXGXXXXXXXXXXXXXXXXXXXGXXXXXXXXXXXXXXXXXXXGXXXXXXXXXXXXXXXXXXXGXXXXXXXXXXXXXXXXXXXGXXXXXXXXXXXXXXXXXXXGXXXXXXXXXXXXXXXXXXXGXXXXXXXXXXXXXXXXXXXGXXXXXXXXXXXXXXXXXXXGXXXXXXXXXXXXXXXXXXXGXXXXXXXXXXXXXXXXXXX,0,300,0

35175,13,0,13,44,243,0,0,257,196,61,GXXXXXXXXXXXXXXXXXXXGXXXXXXXXXXXXXXXXXXXGXXXXXXXXXXXXXXXXXXXGXXXXXXXXXXXXXXXXXXXGXXXXXXXXXXXXXXXXXXXGXXXXXXXXXXXXXXXXXXXGXXXXXXXXXXXXXXXXXXXGXXXXXXXXXXXXXXXXXXXGXXXXXXXXXXXXXXXXXXXGXXXXXXXXXXXXXXXXXXXGXXXXXXXXXXXXXXXXXXXGXXXXXXXXXXXXXXXXXXXGXXXXXXXXXXXXXXXXXXX,0,300,0
35196,13,0,13,42,245,0,0,259,196,63,GXXXXXXXXXXXXXXXXXXXGXXXXXXXXXXXXXXXXXXXGXXXXXXXXXXXXXXXXXXXGXXXXXXXXXXXXXXXXXXXGXXXXXXXXXXXXXXXXXXXGXXXXXXXXXXXXXXXXXXXGXXXXXXXXXXXXXXXXXXXGXXXXXXXXXXXXXXXXXXXGXXXXXXXXXXXXXXXXXXXGXXXXXXXXXXXXXXXXXXXGXXXXXXXXXXXXXXXXXXXGXXXXXXXXXXXXXXXXXXXGXXXXXXXXXXXXXXXXXXX,0,300,0
35217,13,0,13,43,244,0,0,257,196,61,GXXXXXXXXXXXXXXXXXXXGXXXXXXXXXXXXXXXXXXXGXXXXXXXXXXXXXXXXXXXGXXXXXXXXXXXXXXXXXXXGXXXXXXXXXXXXXXXXXXXGXXXXXXXXXXXXXXXXXXXGXXXXXXXXXXXXXXXXXXXGXXXXXXXXXXXXXXXXXXXGXXXXXXXXXXXXXXXXXXXGXXXXXXXXXXXXXXXXXXXGXXXXXXXXXXXXXXXXXXXGXXXXXXXXXXXXXXXXXXXGXXXXXXXXXXXXXXXXXXX,0,300,0
35238,13,0,13,42,245,0,0,258,195,63,GXXXXXXXXXXXXXXXXXXXGXXXXXXXXXXXXXXXXXXXGXXXXXXXXXXXXXXXXXXXGXXXXXXXXXXXXXXXXXXXGXXXXXXXXXXXXXXXXXXXGXXXXXXXXXXXXXXXXXXXGXXXXXXXXXXXXXXXXXXXGXXXXXXXXXXXXXXXXXXXGXXXXXXXXXXXXXXXXXXXGXXXXXXXXXXXXXXXXXXXGXXXXXXXXXXXXXXXXXXXGXXXXXXXXXXXXXXXXXXXGXXXXXXXXXXXXXXXXXXX,0,300,0
35259,13,0,13,40,247,0,0,260,195,65,GXXXXXXXXXXXXXXXXXXXGXXXXXXXXXXXXXXXXXXXGXXXXXXXXXXXXXXXXXXXGXXXXXXXXXXXXXXXXXXXGXXXXXXXXXXXXXXXXXXXGXXXXXXXXXXXXXXXXXXXGXXXXXXXXXXXXXXXXXXXGXXXXXXXXXXXXXXXXXXXGXXXXXXXXXXXXXXXXXXXGXXXXXXXXXXXXXXXXXXXGXXXXXXXXXXXXXXXXXXXGXXXXXXXXXXXXXXXXXXXGXXXXXXXXXXXXXXXXXXX,0,300,0

35280,13,0,13,40,247,0,0,260,197,63,GXXXXXXXXXXXXXXXXXXXGXXXXXXXXXXXXXXXXXXXGXXXXXXXXXXXXXXXXXXXGXXXXXXXXXXXXXXXXXXXGXXXXXXXXXXXXXXXXXXXGXXXXXXXXXXXXXXXXXXXGXXXXXXXXXXXXXXXXXXXGXXXXXXXXXXXXXXXXXXXGXXXXXXXXXXXXXXXXXXXGXXXXXXXXXXXXXXXXXXXGXXXXXXXXXXXXXXXXXXXGXXXXXXXXXXXXXXXXXXXGXXXXXXXXXXXXXXXXXXX,0,300,0
35301,13,0,13,38,249,0,0,261,199,62,GXXXXXXXXXXXXXXXXXXXGXXXXXXXXXXXXXXXXXXXGXXXXXXXXXXXXXXXXXXXGXXXXXXXXXXXXXXXXXXXGXXXXXXXXXXXXXXXXXXXGXXXXXXXXXXXXXXXXXXXGXXXXXXXXXXXXXXXXXXXGXXXXXXXXXXXXXXXXXXXGXXXXXXXXXXXXXXXXXXXGXXXXXXXXXXXXXXXXXXXGXXXXXXXXXXXXXXXXXXXGXXXXXXXXXXXXXXXXXXXGXXXXXXXXXXXXXXXXXXX,0,300,0
35322,13,0,13,42,245,0,0,257,197,60,GXXXXXXXXXXXXXXXXXXXGXXXXXXXXXXXXXXXXXXXGXXXXXXXXXXXXXXXXXXXGXXXXXXXXXXXXXXXXXXXGXXXXXXXXXXXXXXXXXXXGXXXXXXXXXXXXXXXXXXXGXXXXXXXXXXXXXXXXXXXGXXXXXXXXXXXXXXXXXXXGXXXXXXXXXXXXXXXXXXXGXXXXXXXXXXXXXXXXXXXGXXXXXXXXXXXXXXXXXXXGXXXXXXXXXXXXXXXXXXXGXXXXXXXXXXXXXXXXXXX,0,300,0
35343,13,0,13,44,243,0,0,255,194,61,GXXXXXXXXXXXXXXXXXXXGXXXXXXXXXXXXXXXXXXXGXXXXXXXXXXXXXXXXXXXGXXXXXXXXXXXXXXXXXXXGXXXXXXXXXXXXXXXXXXXGXXXXXXXXXXXXXXXXXXXGXXXXXXXXXXXXXXXXXXXGXXXXXXXXXXXXXXXXXXXGXXXXXXXXXXXXXXXXXXXGXXXXXXXXXXXXXXXXXXXGXXXXXXXXXXXXXXXXXXXGXXXXXXXXXXXXXXXXXXXGXXXXXXXXXXXXXXXXXXX,0,300,0
35364,13,0,13,42,245,0,0,257,192,65,GXXXXXXXXXXXXXXXXXXXGXXXXXXXXXXXXXXXXXXXGXXXXXXXXXXXXXXXXXXXGXXXXXXXXXXXXXXXXXXXGXXXXXXXXXXXXXXXXXXXGXXXXXXXXXXXXXXXXXXXGXXXXXXXXXXXXXXXXXXXGXXXXXXXXXXXXXXXXXXXGXXXXXXXXXXXXXXXXXXXGXXXXXXXXXXXXXXXXXXXGXXXXXXXXXXXXXXXXXXXGXXXXXXXXXXXXXXXXXXXGXXXXXXXXXXXXXXXXXXX,0,300,0

35385,13,0,13,39,248,0,0,260,195,65,GXXXXXXXXXXXXXXXXXXXGXXXXXXXXXXXXXXXXXXXGXXXXXXXXXXXXXXXXXXXGXXXXXXXXXXXXXXXXXXXGXXXXXXXXXXXXXXXXXXXGXXXXXXXXXXXXXXXXXXXGXXXXXXXXXXXXXXXXXXXGXXXXXXXXXXXXXXXXXXXGXXXXXXXXXXXXXXXXXXXGXXXXXXXXXXXXXXXXXXXGXXXXXXXXXXXXXXXXXXXGXXXXXXXXXXXXXXXXXXXGXXXXXXXXXXXXXXXXXXX,0,300,0
35406,13,0,13,39,248,0,0,259,194,65,GXXXXXXXXXXXXXXXXXXXGXXXXXXXXXXXXXXXXXXXGXXXXXXXXXXXXXXXXXXXGXXXXXXXXXXXXXXXXXXXGXXXXXXXXXXXXXXXXXXXGXXXXXXXXXXXXXXXXXXXGXXXXXXXXXXXXXXXXXXXGXXXXXXXXXXXXXXXXXXXGXXXXXXXXXXXXXXXXXXXGXXXXXXXXXXXXXXXXXXXGXXXXXXXXXXXXXXXXXXXGXXXXXXXXXXXXXXXXXXXGXXXXXXXXXXXXXXXXXXX,0,300,0
35427,13,0,13,38,249,0,0,261,195,66,GXXXXXXXXXXXXXXXXXXXGXXXXXXXXXXXXXXXXXXXGXXXXXXXXXXXXXXXXXXXGXXXXXXXXXXXXXXXXXXXGXXXXXXXXXXXXXXXXXXXGXXXXXXXXXXXXXXXXXXXGXXXXXXXXXXXXXXXXXXXGXXXXXXXXXXXXXXXXXXXGXXXXXXXXXXXXXXXXXXXGXXXXXXXXXXXXXXXXXXXGXXXXXXXXXXXXXXXXXXXGXXXXXXXXXXXXXXXXXXXGXXXXXXXXXXXXXXXXXXX,0,300,0
35448,13,0,13,34,253,0,0,265,196,69,GXXXXXXXXXXXXXXXXXXXGXXXXXXXXXXXXXXXXXXXGXXXXXXXXXXXXXXXXXXXGXXXXXXXXXXXXXXXXXXXGXXXXXXXXXXXXXXXXXXXGXXXXXXXXXXXXXXXXXXXGXXXXXXXXXXXXXXXXXXXGXXXXXXXXXXXXXXXXXXXGXXXXXXXXXXXXXXXXXXXGXXXXXXXXXXXXXXXXXXXGXXXXXXXXXXXXXXXXXXXGXXXXXXXXXXXXXXXXXXXGXXXXXXXXXXXXXXXXXXX,0,300,0
35469,13,0,13,31,256,0,0,268,199,69,GXXXXXXXXXXXXXXXXXXXGXXXXXXXXXXXXXXXXXXXGXXXXXXXXXXXXXXXXXXXGXXXXXXXXXXXXXXXXXXXGXXXXXXXXXXXXXXXXXXXGXXXXXXXXXXXXXXXXXXXGXXXXXXXXXXXXXXXXXXXGXXXXXXXXXXXXXXXXXXXGXXXXXXXXXXXXXXXXXXXGXXXXXXXXXXXXXXXXXXXGXXXXXXXXXXXXXXXXXXXGXXXXXXXXXXXXXXXXXXXGXXXXXXXXXXXXXXXXXXX,0,300,0

35490,13,0,13,34,253,0,0,264,199,65,GXXXXXXXXXXXXXXXXXXXGXXXXXXXXXXXXXXXXXXXGXXXXXXXXXXXXXXXXXXXGXXXXXXXXXXXXXXXXXXXGXXXXXXXXXXXXXXXXXXXGXXXXXXXXXXXXXXXXXXXGXXXXXXXXXXXXXXXXXXXGXXXXXXXXXXXXXXXXXXXGXXXXXXXXXXXXXXXXXXXGXXXXXXXXXXXXXXXXXXXGXXXXXXXXXXXXXXXXXXXGXXXXXXXXXXXXXXXXXXXGXXXXXXXXXXXXXXXXXXX,0,300,0
35511,13,0,13,35,252,0,0,263,194,69,GXXXXXXXXXXXXXXXXXXXGXXXXXXXXXXXXXXXXXXXGXXXXXXXXXXXXXXXXXXXGXXXXXXXXXXXXXXXXXXXGXXXXXXXXXXXXXXXXXXXGXXXXXXXXXXXXXXXXXXXGXXXXXXXXXXXXXXXXXXXGXXXXXXXXXXXXXXXXXXXGXXXXXXXXXXXXXXXXXXXGXXXXXXXXXXXXXXXXXXXGXXXXXXXXXXXXXXXXXXXGXXXXXXXXXXXXXXXXXXXGXXXXXXXXXXXXXXXXXXX,0,300,0
35532,13,0,13,36,251,0,0,263,198,65,GXXXXXXXXXXXXXXXXXXXGXXXXXXXXXXXXXXXXXXXGXXXXXXXXXXXXXXXXXXXGXXXXXXXXXXXXXXXXXXXGXXXXXXXXXXXXXXXXXXXGXXXXXXXXXXXXXXXXXXXGXXXXXXXXXXXXXXXXXXXGXXXXXXXXXXXXXXXXXXXGXXXXXXXXXXXXXXXXXXXGXXXXXXXXXXXXXXXXXXXGXXXXXXXXXXXXXXXXXXXGXXXXXXXXXXXXXXXXXXXGXXXXXXXXXXXXXXXXXXX,0,300,0
35553,13,0,13,34,253,0,0,265,197,68,GXXXXXXXXXXXXXXXXXXXGXXXXXXXXXXXXXXXXXXXGXXXXXXXXXXXXXXXXXXXGXXXXXXXXXXXXXXXXXXXGXXXXXXXXXXXXXXXXXXXGXXXXXXXXXXXXXXXXXXXGXXXXXXXXXXXXXXXXXXXGXXXXXXXXXXXXXXXXXXXGXXXXXXXXXXXXXXXXXXXGXXXXXXXXXXXXXXXXXXXGXXXXXXXXXXXXXXXXXXXGXXXXXXXXXXXXXXXXXXXGXXXXXXXXXXXXXXXXXXX,0,300,0
35574,13,0,13,35,252,0,0,264,194,70,GXXXXXXXXXXXXXXXXXXXGXXXXXXXXXXXXXXXXXXXGXXXXXXXXXXXXXXXXXXXGXXXXXXXXXXXXXXXXXXXGXXXXXXXXXXXXXXXXXXXGXXXXXXXXXXXXXXXXXXXGXXXXXXXXXXXXXXXXXXXGXXXXXXXXXXXXXXXXXXXGXXXXXXXXXXXXXXXXXXXGXXXXXXXXXXXXXXXXXXXGXXXXXXXXXXXXXXXXXXXGXXXXXXXXXXXXXXXXXXXGXXXXXXXXXXXXXXXXXXX,0,300,0

35595,13,0,13,27,260,0,0,271,196,75,GXXXXXXXXXXXXXXXXXXXGXXXXXXXXXXXXXXXXXXXGXXXXXXXXXXXXXXXXXXXGXXXXXXXXXXXXXXXXXXXGXXXXXXXXXXXXXXXXXXXGXXXXXXXXXXXXXXXXXXXGXXXXXXXXXXXXXXXXXXXGXXXXXXXXXXXXXXXXXXXGXXXXXXXXXXXXXXXXXXXGXXXXXXXXXXXXXXXXXXXGXXXXXXXXXXXXXXXXXXXGXXXXXXXXXXXXXXXXXXXGXXXXXXXXXXXXXXXXXXX,0,300,0
35616,13,0,13,21,266,0,0,278,199,79,GXXXXXXXXXXXXXXXXXXXGXXXXXXXXXXXXXXXXXXXGXXXXXXXXXXXXXXXXXXXGXXXXXXXXXXXXXXXXXXXGXXXXXXXXXXXXXXXXXXXGXXXXXXXXXXXXXXXXXXXGXXXXXXXXXXXXXXXXXXXGXXXXXXXXXXXXXXXXXXXGXXXXXXXXXXXXXXXXXXXGXXXXXXXXXXXXXXXXXXXGXXXXXXXXXXXXXXXXXXXGXXXXXXXXXXXXXXXXXXXGXXXXXXXXXXXXXXXXXXX,0,300,0
35637,14,1,13,22,264,0,0,276,198,78,GXXXXXXXXXXXXXXXXXXXGXXXXXXXXXXXXXXXXXXXGXXXXXXXXXXXXXXXXXXXGXXXXXXXXXXXXXXXXXXXGXXXXXXXXXXXXXXXXXXXGAXXXXXXXXXXXXXXXXXXGXXXXXXXXXXXXXXXXXXXGXXXXXXXXXXXXXXXXXXXGXXXXXXXXXXXXXXXXXXXGXXXXXXXXXXXXXXXXXXXGXXXXXXXXXXXXXXXXXXXGXXXXXXXXXXXXXXXXXXXGXXXXXXXXXXXXXXXXXXX,0,300,0
35658,14,1,13,25,261,0,0,273,201,72,GXXXXXXXXXXXXXXXXXXXGXXXXXXXXXXXXXXXXXXXGXXXXXXXXXXXXXXXXXXXGXXXXXXXXXXXXXXXXXXXGXXXXXXXXXXXXXXXXXXXGAXXXXXXXXXXXXXXXXXXGXXXXXXXXXXXXXXXXXXXGXXXXXXXXXXXXXXXXXXXGXXXXXXXXXXXXXXXXXXXGXXXXXXXXXXXXXXXXXXXGXXXXXXXXXXXXXXXXXXXGXXXXXXXXXXXXXXXXXXXGXXXXXXXXXXXXXXXXXXX,0,300,0
35679,14,1,13,30,256,0,0,268,201,67,GXXXXXXXXXXXXXXXXXXXGXXXXXXXXXXXXXXXXXXXGXXXXXXXXXXXXXXXXXXXGXXXXXXXXXXXXXXXXXXXGXXXXXXXXXXXXXXXXXXXGAXXXXXXXXXXXXXXXXXXGXXXXXXXXXXXXXXXXXXXGXXXXXXXXXXXXXXXXXXXGXXXXXXXXXXXXXXXXXXXGXXXXXXXXXXXXXXXXXXXGXXXXXXXXXXXXXXXXXXXGXXXXXXXXXXXXXXXXXXXGXXXXXXXXXXXXXXXXXXX,0,300,0

35700,14,1,13,30,256,0,0,268,203,65,GXXXXXXXXXXXXXXXXXXXGXXXXXXXXXXXXXXXXXXXGXXXXXXXXXXXXXXXXXXXGXXXXXXXXXXXXXXXXXXXGXXXXXXXXXXXXXXXXXXXGAXXXXXXXXXXXXXXXXXXGXXXXXXXXXXXXXXXXXXXGXXXXXXXXXXXXXXXXXXXGXXXXXXXXXXXXXXXXXXXGXXXXXXXXXXXXXXXXXXXGXXXXXXXXXXXXXXXXXXXGXXXXXXXXXXXXXXXXXXXGXXXXXXXXXXXXXXXXXXX,0,300,0
35721,14,1,13,34,252,0,0,264,204,60,GXXXXXXXXXXXXXXXXXXXGXXXXXXXXXXXXXXXXXXXGXXXXXXXXXXXXXXXXXXXGXXXXXXXXXXXXXXXXXXXGXXXXXXXXXXXXXXXXXXXGAXXXXXXXXXXXXXXXXXXGXXXXXXXXXXXXXXXXXXXGXXXXXXXXXXXXXXXXXXXGXXXXXXXXXXXXXXXXXXXGXXXXXXXXXXXXXXXXXXXGXXXXXXXXXXXXXXXXXXXGXXXXXXXXXXXXXXXXXXXGXXXXXXXXXXXXXXXXXXX,0,300,0
35742,14,1,13,34,252,0,0,265,208,57,GXXXXXXXXXXXXXXXXXXXGXXXXXXXXXXXXXXXXXXXGXXXXXXXXXXXXXXXXXXXGXXXXXXXXXXXXXXXXXXXGXXXXXXXXXXXXXXXXXXXGAXXXXXXXXXXXXXXXXXXGXXXXXXXXXXXXXXXXXXXGXXXXXXXXXXXXXXXXXXXGXXXXXXXXXXXXXXXXXXXGXXXXXXXXXXXXXXXXXXXGXXXXXXXXXXXXXXXXXXXGXXXXXXXXXXXXXXXXXXXGXXXXXXXXXXXXXXXXXXX,0,300,0
35763,13,0,13,35,252,0,0,265,202,63,GXXXXXXXXXXXXXXXXXXXGXXXXXXXXXXXXXXXXXXXGXXXXXXXXXXXXXXXXXXXGXXXXXXXXXXXXXXXXXXXGXXXXXXXXXXXXXXXXXXXGXXXXXXXXXXXXXXXXXXXGXXXXXXXXXXXXXXXXXXXGXXXXXXXXXXXXXXXXXXXGXXXXXXXXXXXXXXXXXXXGXXXXXXXXXXXXXXXXXXXGXXXXXXXXXXXXXXXXXXXGXXXXXXXXXXXXXXXXXXXGXXXXXXXXXXXXXXXXXXX,0,300,0
35784,13,0,13,33,254,0,0,266,198,68,GXXXXXXXXXXXXXXXXXXXGXXXXXXXXXXXXXXXXXXXGXXXXXXXXXXXXXXXXXXXGXXXXXXXXXXXXXXXXXXXGXXXXXXXXXXXXXXXXXXXGXXXXXXXXXXXXXXXXXXXGXXXXXXXXXXXXXXXXXXXGXXXXXXXXXXXXXXXXXXXGXXXXXXXXXXXXXXXXXXXGXXXXXXXXXXXXXXXXXXXGXXXXXXXXXXXXXXXXXXXGXXXXXXXXXXXXXXXXXXXGXXXXXXXXXXXXXXXXXXX,0,300,0

35805,13,0,13,32,255,0,0,267,201,66,GXXXXXXXXXXXXXXXXXXXGXXXXXXXXXXXXXXXXXXXGXXXXXXXXXXXXXXXXXXXGXXXXXXXXXXXXXXXXXXXGXXXXXXXXXXXXXXXXXXXGXXXXXXXXXXXXXXXXXXXGXXXXXXXXXXXXXXXXXXXGXXXXXXXXXXXXXXXXXXXGXXXXXXXXXXXXXXXXXXXGXXXXXXXXXXXXXXXXXXXGXXXXXXXXXXXXXXXXXXXGXXXXXXXXXXXXXXXXXXXGXXXXXXXXXXXXXXXXXXX,0,300,0
35826,13,0,13,34,253,0,0,265,201,64,GXXXXXXXXXXXXXXXXXXXGXXXXXXXXXXXXXXXXXXXGXXXXXXXXXXXXXXXXXXXGXXXXXXXXXXXXXXXXXXXGXXXXXXXXXXXXXXXXXXXGXXXXXXXXXXXXXXXXXXXGXXXXXXXXXXXXXXXXXXXGXXXXXXXXXXXXXXXXXXXGXXXXXXXXXXXXXXXXXXXGXXXXXXXXXXXXXXXXXXXGXXXXXXXXXXXXXXXXXXXGXXXXXXXXXXXXXXXXXXXGXXXXXXXXXXXXXXXXXXX,0,300,0
35847,13,0,13,35,252,0,0,264,197,67,GXXXXXXXXXXXXXXXXXXXGXXXXXXXXXXXXXXXXXXXGXXXXXXXXXXXXXXXXXXXGXXXXXXXXXXXXXXXXXXXGXXXXXXXXXXXXXXXXXXXGXXXXXXXXXXXXXXXXXXXGXXXXXXXXXXXXXXXXXXXGXXXXXXXXXXXXXXXXXXXGXXXXXXXXXXXXXXXXXXXGXXXXXXXXXXXXXXXXXXXGXXXXXXXXXXXXXXXXXXXGXXXXXXXXXXXXXXXXXXXGXXXXXXXXXXXXXXXXXXX,0,300,0
35868,13,0,13,38,249,0,0,261,198,63,GXXXXXXXXXXXXXXXXXXXGXXXXXXXXXXXXXXXXXXXGXXXXXXXXXXXXXXXXXXXGXXXXXXXXXXXXXXXXXXXGXXXXXXXXXXXXXXXXXXXGXXXXXXXXXXXXXXXXXXXGXXXXXXXXXXXXXXXXXXXGXXXXXXXXXXXXXXXXXXXGXXXXXXXXXXXXXXXXXXXGXXXXXXXXXXXXXXXXXXXGXXXXXXXXXXXXXXXXXXXGXXXXXXXXXXXXXXXXXXXGXXXXXXXXXXXXXXXXXXX,0,300,0
35889,13,0,13,39,248,0,0,260,198,62,GXXXXXXXXXXXXXXXXXXXGXXXXXXXXXXXXXXXXXXXGXXXXXXXXXXXXXXXXXXXGXXXXXXXXXXXXXXXXXXXGXXXXXXXXXXXXXXXXXXXGXXXXXXXXXXXXXXXXXXXGXXXXXXXXXXXXXXXXXXXGXXXXXXXXXXXXXXXXXXXGXXXXXXXXXXXXXXXXXXXGXXXXXXXXXXXXXXXXXXXGXXXXXXXXXXXXXXXXXXXGXXXXXXXXXXXXXXXXXXXGXXXXXXXXXXXXXXXXXXX,0,300,0

35910,13,0,13,37,250,0,0,261,198,63,GXXXXXXXXXXXXXXXXXXXGXXXXXXXXXXXXXXXXXXXGXXXXXXXXXXXXXXXXXXXGXXXXXXXXXXXXXXXXXXXGXXXXXXXXXXXXXXXXXXXGXXXXXXXXXXXXXXXXXXXGXXXXXXXXXXXXXXXXXXXGXXXXXXXXXXXXXXXXXXXGXXXXXXXXXXXXXXXXXXXGXXXXXXXXXXXXXXXXXXXGXXXXXXXXXXXXXXXXXXXGXXXXXXXXXXXXXXXXXXXGXXXXXXXXXXXXXXXXXXX,0,300,0
35931,13,0,13,38,249,0,0,260,201,59,GXXXXXXXXXXXXXXXXXXXGXXXXXXXXXXXXXXXXXXXGXXXXXXXXXXXXXXXXXXXGXXXXXXXXXXXXXXXXXXXGXXXXXXXXXXXXXXXXXXXGXXXXXXXXXXXXXXXXXXXGXXXXXXXXXXXXXXXXXXXGXXXXXXXXXXXXXXXXXXXGXXXXXXXXXXXXXXXXXXXGXXXXXXXXXXXXXXXXXXXGXXXXXXXXXXXXXXXXXXXGXXXXXXXXXXXXXXXXXXXGXXXXXXXXXXXXXXXXXXX,0,300,0
35952,13,0,13,40,247,0,0,259,203,56,GXXXXXXXXXXXXXXXXXXXGXXXXXXXXXXXXXXXXXXXGXXXXXXXXXXXXXXXXXXXGXXXXXXXXXXXXXXXXXXXGXXXXXXXXXXXXXXXXXXXGXXXXXXXXXXXXXXXXXXXGXXXXXXXXXXXXXXXXXXXGXXXXXXXXXXXXXXXXXXXGXXXXXXXXXXXXXXXXXXXGXXXXXXXXXXXXXXXXXXXGXXXXXXXXXXXXXXXXXXXGXXXXXXXXXXXXXXXXXXXGXXXXXXXXXXXXXXXXXXX,0,300,0
35973,13,0,13,46,241,0,0,254,199,55,GXXXXXXXXXXXXXXXXXXXGXXXXXXXXXXXXXXXXXXXGXXXXXXXXXXXXXXXXXXXGXXXXXXXXXXXXXXXXXXXGXXXXXXXXXXXXXXXXXXXGXXXXXXXXXXXXXXXXXXXGXXXXXXXXXXXXXXXXXXXGXXXXXXXXXXXXXXXXXXXGXXXXXXXXXXXXXXXXXXXGXXXXXXXXXXXXXXXXXXXGXXXXXXXXXXXXXXXXXXXGXXXXXXXXXXXXXXXXXXXGXXXXXXXXXXXXXXXXXXX,0,300,0
35994,13,0,13,46,241,0,0,255,197,58,GXXXXXXXXXXXXXXXXXXXGXXXXXXXXXXXXXXXXXXXGXXXXXXXXXXXXXXXXXXXGXXXXXXXXXXXXXXXXXXXGXXXXXXXXXXXXXXXXXXXGXXXXXXXXXXXXXXXXXXXGXXXXXXXXXXXXXXXXXXXGXXXXXXXXXXXXXXXXXXXGXXXXXXXXXXXXXXXXXXXGXXXXXXXXXXXXXXXXXXXGXXXXXXXXXXXXXXXXXXXGXXXXXXXXXXXXXXXXXXXGXXXXXXXXXXXXXXXXXXX,0,300,0

36015,13,0,13,40,247,0,0,260,197,63,GXXXXXXXXXXXXXXXXXXXGXXXXXXXXXXXXXXXXXXXGXXXXXXXXXXXXXXXXXXXGXXXXXXXXXXXXXXXXXXXGXXXXXXXXXXXXXXXXXXXGXXXXXXXXXXXXXXXXXXXGXXXXXXXXXXXXXXXXXXXGXXXXXXXXXXXXXXXXXXXGXXXXXXXXXXXXXXXXXXXGXXXXXXXXXXXXXXXXXXXGXXXXXXXXXXXXXXXXXXXGXXXXXXXXXXXXXXXXXXXGXXXXXXXXXXXXXXXXXXX,0,300,0
36036,13,0,13,40,247,0,0,261,195,66,GXXXXXXXXXXXXXXXXXXXGXXXXXXXXXXXXXXXXXXXGXXXXXXXXXXXXXXXXXXXGXXXXXXXXXXXXXXXXXXXGXXXXXXXXXXXXXXXXXXXGXXXXXXXXXXXXXXXXXXXGXXXXXXXXXXXXXXXXXXXGXXXXXXXXXXXXXXXXXXXGXXXXXXXXXXXXXXXXXXXGXXXXXXXXXXXXXXXXXXXGXXXXXXXXXXXXXXXXXXXGXXXXXXXXXXXXXXXXXXXGXXXXXXXXXXXXXXXXXXX,0,300,0
36057,13,0,13,39,248,0,0,260,196,64,GXXXXXXXXXXXXXXXXXXXGXXXXXXXXXXXXXXXXXXXGXXXXXXXXXXXXXXXXXXXGXXXXXXXXXXXXXXXXXXXGXXXXXXXXXXXXXXXXXXXGXXXXXXXXXXXXXXXXXXXGXXXXXXXXXXXXXXXXXXXGXXXXXXXXXXXXXXXXXXXGXXXXXXXXXXXXXXXXXXXGXXXXXXXXXXXXXXXXXXXGXXXXXXXXXXXXXXXXXXXGXXXXXXXXXXXXXXXXXXXGXXXXXXXXXXXXXXXXXXX,0,300,0
36078,13,0,13,38,249,0,0,262,197,65,GXXXXXXXXXXXXXXXXXXXGXXXXXXXXXXXXXXXXXXXGXXXXXXXXXXXXXXXXXXXGXXXXXXXXXXXXXXXXXXXGXXXXXXXXXXXXXXXXXXXGXXXXXXXXXXXXXXXXXXXGXXXXXXXXXXXXXXXXXXXGXXXXXXXXXXXXXXXXXXXGXXXXXXXXXXXXXXXXXXXGXXXXXXXXXXXXXXXXXXXGXXXXXXXXXXXXXXXXXXXGXXXXXXXXXXXXXXXXXXXGXXXXXXXXXXXXXXXXXXX,0,300,0
36099,13,0,13,34,253,0,0,265,197,68,GXXXXXXXXXXXXXXXXXXXGXXXXXXXXXXXXXXXXXXXGXXXXXXXXXXXXXXXXXXXGXXXXXXXXXXXXXXXXXXXGXXXXXXXXXXXXXXXXXXXGXXXXXXXXXXXXXXXXXXXGXXXXXXXXXXXXXXXXXXXGXXXXXXXXXXXXXXXXXXXGXXXXXXXXXXXXXXXXXXXGXXXXXXXXXXXXXXXXXXXGXXXXXXXXXXXXXXXXXXXGXXXXXXXXXXXXXXXXXXXGXXXXXXXXXXXXXXXXXXX,0,300,0

36120,13,0,13,33,254,0,0,267,198,69,GXXXXXXXXXXXXXXXXXXXGXXXXXXXXXXXXXXXXXXXGXXXXXXXXXXXXXXXXXXXGXXXXXXXXXXXXXXXXXXXGXXXXXXXXXXXXXXXXXXXGXXXXXXXXXXXXXXXXXXXGXXXXXXXXXXXXXXXXXXXGXXXXXXXXXXXXXXXXXXXGXXXXXXXXXXXXXXXXXXXGXXXXXXXXXXXXXXXXXXXGXXXXXXXXXXXXXXXXXXXGXXXXXXXXXXXXXXXXXXXGXXXXXXXXXXXXXXXXXXX,0,300,0
36141,13,0,13,35,252,0,0,265,197,68,GXXXXXXXXXXXXXXXXXXXGXXXXXXXXXXXXXXXXXXXGXXXXXXXXXXXXXXXXXXXGXXXXXXXXXXXXXXXXXXXGXXXXXXXXXXXXXXXXXXXGXXXXXXXXXXXXXXXXXXXGXXXXXXXXXXXXXXXXXXXGXXXXXXXXXXXXXXXXXXXGXXXXXXXXXXXXXXXXXXXGXXXXXXXXXXXXXXXXXXXGXXXXXXXXXXXXXXXXXXXGXXXXXXXXXXXXXXXXXXXGXXXXXXXXXXXXXXXXXXX,0,300,0
36162,13,0,13,34,253,0,0,266,196,70,GXXXXXXXXXXXXXXXXXXXGXXXXXXXXXXXXXXXXXXXGXXXXXXXXXXXXXXXXXXXGXXXXXXXXXXXXXXXXXXXGXXXXXXXXXXXXXXXXXXXGXXXXXXXXXXXXXXXXXXXGXXXXXXXXXXXXXXXXXXXGXXXXXXXXXXXXXXXXXXXGXXXXXXXXXXXXXXXXXXXGXXXXXXXXXXXXXXXXXXXGXXXXXXXXXXXXXXXXXXXGXXXXXXXXXXXXXXXXXXXGXXXXXXXXXXXXXXXXXXX,0,300,0
36183,13,0,13,32,255,0,0,268,199,69,GXXXXXXXXXXXXXXXXXXXGXXXXXXXXXXXXXXXXXXXGXXXXXXXXXXXXXXXXXXXGXXXXXXXXXXXXXXXXXXXGXXXXXXXXXXXXXXXXXXXGXXXXXXXXXXXXXXXXXXXGXXXXXXXXXXXXXXXXXXXGXXXXXXXXXXXXXXXXXXXGXXXXXXXXXXXXXXXXXXXGXXXXXXXXXXXXXXXXXXXGXXXXXXXXXXXXXXXXXXXGXXXXXXXXXXXXXXXXXXXGXXXXXXXXXXXXXXXXXXX,0,300,0
36204,14,1,13,27,259,0,0,271,200,71,GXXXXXXXXXXXXXXXXXXXGXXXXXXXXXXXXXXXXXXXGXXXXXXXXXXXXXXXXXXXGXXXXXXXXXXXXXXXXXXXGXXXXXXXXXXXXXXXXXXXGXXXXXXXXXXXXXXXXXXXGXXXXXXXXXXXXXXXXXXXGXXXXXXXXXXXXXXXXXXXGAXXXXXXXXXXXXXXXXXXGXXXXXXXXXXXXXXXXXXXGXXXXXXXXXXXXXXXXXXXGXXXXXXXXXXXXXXXXXXXGXXXXXXXXXXXXXXXXXXX,0,300,0

36225,14,1,13,31,255,0,0,267,195,72,GXXXXXXXXXXXXXXXXXXXGXXXXXXXXXXXXXXXXXXXGXXXXXXXXXXXXXXXXXXXGXXXXXXXXXXXXXXXXXXXGXXXXXXXXXXXXXXXXXXXGXXXXXXXXXXXXXXXXXXXGXXXXXXXXXXXXXXXXXXXGXXXXXXXXXXXXXXXXXXXGAXXXXXXXXXXXXXXXXXXGXXXXXXXXXXXXXXXXXXXGXXXXXXXXXXXXXXXXXXXGXXXXXXXXXXXXXXXXXXXGXXXXXXXXXXXXXXXXXXX,0,300,0
36246,14,1,13,28,258,0,0,270,196,74,GXXXXXXXXXXXXXXXXXXXGXXXXXXXXXXXXXXXXXXXGXXXXXXXXXXXXXXXXXXXGXXXXXXXXXXXXXXXXXXXGXXXXXXXXXXXXXXXXXXXGXXXXXXXXXXXXXXXXXXXGXXXXXXXXXXXXXXXXXXXGXXXXXXXXXXXXXXXXXXXGAXXXXXXXXXXXXXXXXXXGXXXXXXXXXXXXXXXXXXXGXXXXXXXXXXXXXXXXXXXGXXXXXXXXXXXXXXXXXXXGXXXXXXXXXXXXXXXXXXX,0,300,0
36267,14,1,13,26,260,0,0,272,196,76,GXXXXXXXXXXXXXXXXXXXGXXXXXXXXXXXXXXXXXXXGXXXXXXXXXXXXXXXXXXXGXXXXXXXXXXXXXXXXXXXGXXXXXXXXXXXXXXXXXXXGXXXXXXXXXXXXXXXXXXXGXXXXXXXXXXXXXXXXXXXGXXXXXXXXXXXXXXXXXXXGAXXXXXXXXXXXXXXXXXXGXXXXXXXXXXXXXXXXXXXGXXXXXXXXXXXXXXXXXXXGXXXXXXXXXXXXXXXXXXXGXXXXXXXXXXXXXXXXXXX,0,300,0
36288,14,0,14,24,262,0,0,274,198,76,GXXXXXXXXXXXXXXXXXXXGXXXXXXXXXXXXXXXXXXXGXXXXXXXXXXXXXXXXXXXGXXXXXXXXXXXXXXXXXXXGXXXXXXXXXXXXXXXXXXXGXXXXXXXXXXXXXXXXXXXGXXXXXXXXXXXXXXXXXXXGXXXXXXXXXXXXXXXXXXXGOXXXXXXXXXXXXXXXXXXGXXXXXXXXXXXXXXXXXXXGXXXXXXXXXXXXXXXXXXXGXXXXXXXXXXXXXXXXXXXGXXXXXXXXXXXXXXXXXXX,0,300,0
36309,14,0,14,23,263,0,0,275,200,75,GXXXXXXXXXXXXXXXXXXXGXXXXXXXXXXXXXXXXXXXGXXXXXXXXXXXXXXXXXXXGXXXXXXXXXXXXXXXXXXXGXXXXXXXXXXXXXXXXXXXGXXXXXXXXXXXXXXXXXXXGXXXXXXXXXXXXXXXXXXXGXXXXXXXXXXXXXXXXXXXGOXXXXXXXXXXXXXXXXXXGXXXXXXXXXXXXXXXXXXXGXXXXXXXXXXXXXXXXXXXGXXXXXXXXXXXXXXXXXXXGXXXXXXXXXXXXXXXXXXX,0,300,0

36330,14,0,14,23,263,0,0,275,203,72,GXXXXXXXXXXXXXXXXXXXGXXXXXXXXXXXXXXXXXXXGXXXXXXXXXXXXXXXXXXXGXXXXXXXXXXXXXXXXXXXGXXXXXXXXXXXXXXXXXXXGXXXXXXXXXXXXXXXXXXXGXXXXXXXXXXXXXXXXXXXGXXXXXXXXXXXXXXXXXXXGOXXXXXXXXXXXXXXXXXXGXXXXXXXXXXXXXXXXXXXGXXXXXXXXXXXXXXXXXXXGXXXXXXXXXXXXXXXXXXXGXXXXXXXXXXXXXXXXXXX,0,300,0
36351,13,0,13,26,261,0,0,272,203,69,GXXXXXXXXXXXXXXXXXXXGXXXXXXXXXXXXXXXXXXXGXXXXXXXXXXXXXXXXXXXGXXXXXXXXXXXXXXXXXXXGXXXXXXXXXXXXXXXXXXXGXXXXXXXXXXXXXXXXXXXGXXXXXXXXXXXXXXXXXXXGXXXXXXXXXXXXXXXXXXXGXXXXXXXXXXXXXXXXXXXGXXXXXXXXXXXXXXXXXXXGXXXXXXXXXXXXXXXXXXXGXXXXXXXXXXXXXXXXXXXGXXXXXXXXXXXXXXXXXXX,0,300,0
36372,13,0,13,31,256,0,0,268,201,67,GXXXXXXXXXXXXXXXXXXXGXXXXXXXXXXXXXXXXXXXGXXXXXXXXXXXXXXXXXXXGXXXXXXXXXXXXXXXXXXXGXXXXXXXXXXXXXXXXXXXGXXXXXXXXXXXXXXXXXXXGXXXXXXXXXXXXXXXXXXXGXXXXXXXXXXXXXXXXXXXGXXXXXXXXXXXXXXXXXXXGXXXXXXXXXXXXXXXXXXXGXXXXXXXXXXXXXXXXXXXGXXXXXXXXXXXXXXXXXXXGXXXXXXXXXXXXXXXXXXX,0,300,0
36393,13,0,13,34,253,0,0,265,199,66,GXXXXXXXXXXXXXXXXXXXGXXXXXXXXXXXXXXXXXXXGXXXXXXXXXXXXXXXXXXXGXXXXXXXXXXXXXXXXXXXGXXXXXXXXXXXXXXXXXXXGXXXXXXXXXXXXXXXXXXXGXXXXXXXXXXXXXXXXXXXGXXXXXXXXXXXXXXXXXXXGXXXXXXXXXXXXXXXXXXXGXXXXXXXXXXXXXXXXXXXGXXXXXXXXXXXXXXXXXXXGXXXXXXXXXXXXXXXXXXXGXXXXXXXXXXXXXXXXXXX,0,300,0
36414,13,0,13,34,253,0,0,264,199,65,GXXXXXXXXXXXXXXXXXXXGXXXXXXXXXXXXXXXXXXXGXXXXXXXXXXXXXXXXXXXGXXXXXXXXXXXXXXXXXXXGXXXXXXXXXXXXXXXXXXXGXXXXXXXXXXXXXXXXXXXGXXXXXXXXXXXXXXXXXXXGXXXXXXXXXXXXXXXXXXXGXXXXXXXXXXXXXXXXXXXGXXXXXXXXXXXXXXXXXXXGXXXXXXXXXXXXXXXXXXXGXXXXXXXXXXXXXXXXXXXGXXXXXXXXXXXXXXXXXXX,0,300,0

36435,13,0,13,31,256,0,0,267,198,69,GXXXXXXXXXXXXXXXXXXXGXXXXXXXXXXXXXXXXXXXGXXXXXXXXXXXXXXXXXXXGXXXXXXXXXXXXXXXXXXXGXXXXXXXXXXXXXXXXXXXGXXXXXXXXXXXXXXXXXXXGXXXXXXXXXXXXXXXXXXXGXXXXXXXXXXXXXXXXXXXGXXXXXXXXXXXXXXXXXXXGXXXXXXXXXXXXXXXXXXXGXXXXXXXXXXXXXXXXXXXGXXXXXXXXXXXXXXXXXXXGXXXXXXXXXXXXXXXXXXX,0,300,0
36456,13,0,13,30,257,0,0,269,198,71,GXXXXXXXXXXXXXXXXXXXGXXXXXXXXXXXXXXXXXXXGXXXXXXXXXXXXXXXXXXXGXXXXXXXXXXXXXXXXXXXGXXXXXXXXXXXXXXXXXXXGXXXXXXXXXXXXXXXXXXXGXXXXXXXXXXXXXXXXXXXGXXXXXXXXXXXXXXXXXXXGXXXXXXXXXXXXXXXXXXXGXXXXXXXXXXXXXXXXXXXGXXXXXXXXXXXXXXXXXXXGXXXXXXXXXXXXXXXXXXXGXXXXXXXXXXXXXXXXXXX,0,300,0
36477,13,0,13,27,260,0,0,272,202,70,GXXXXXXXXXXXXXXXXXXXGXXXXXXXXXXXXXXXXXXXGXXXXXXXXXXXXXXXXXXXGXXXXXXXXXXXXXXXXXXXGXXXXXXXXXXXXXXXXXXXGXXXXXXXXXXXXXXXXXXXGXXXXXXXXXXXXXXXXXXXGXXXXXXXXXXXXXXXXXXXGXXXXXXXXXXXXXXXXXXXGXXXXXXXXXXXXXXXXXXXGXXXXXXXXXXXXXXXXXXXGXXXXXXXXXXXXXXXXXXXGXXXXXXXXXXXXXXXXXXX,0,300,0
36498,13,0,13,30,257,0,0,269,200,69,GXXXXXXXXXXXXXXXXXXXGXXXXXXXXXXXXXXXXXXXGXXXXXXXXXXXXXXXXXXXGXXXXXXXXXXXXXXXXXXXGXXXXXXXXXXXXXXXXXXXGXXXXXXXXXXXXXXXXXXXGXXXXXXXXXXXXXXXXXXXGXXXXXXXXXXXXXXXXXXXGXXXXXXXXXXXXXXXXXXXGXXXXXXXXXXXXXXXXXXXGXXXXXXXXXXXXXXXXXXXGXXXXXXXXXXXXXXXXXXXGXXXXXXXXXXXXXXXXXXX,0,300,0
36519,13,0,13,31,256,0,0,268,201,67,GXXXXXXXXXXXXXXXXXXXGXXXXXXXXXXXXXXXXXXXGXXXXXXXXXXXXXXXXXXXGXXXXXXXXXXXXXXXXXXXGXXXXXXXXXXXXXXXXXXXGXXXXXXXXXXXXXXXXXXXGXXXXXXXXXXXXXXXXXXXGXXXXXXXXXXXXXXXXXXXGXXXXXXXXXXXXXXXXXXXGXXXXXXXXXXXXXXXXXXXGXXXXXXXXXXXXXXXXXXXGXXXXXXXXXXXXXXXXXXXGXXXXXXXXXXXXXXXXXXX,0,300,0

36540,13,0,13,32,255,0,0,266,205,61,GXXXXXXXXXXXXXXXXXXXGXXXXXXXXXXXXXXXXXXXGXXXXXXXXXXXXXXXXXXXGXXXXXXXXXXXXXXXXXXXGXXXXXXXXXXXXXXXXXXXGXXXXXXXXXXXXXXXXXXXGXXXXXXXXXXXXXXXXXXXGXXXXXXXXXXXXXXXXXXXGXXXXXXXXXXXXXXXXXXXGXXXXXXXXXXXXXXXXXXXGXXXXXXXXXXXXXXXXXXXGXXXXXXXXXXXXXXXXXXXGXXXXXXXXXXXXXXXXXXX,0,300,0
36561,13,0,13,35,252,0,0,264,203,61,GXXXXXXXXXXXXXXXXXXXGXXXXXXXXXXXXXXXXXXXGXXXXXXXXXXXXXXXXXXXGXXXXXXXXXXXXXXXXXXXGXXXXXXXXXXXXXXXXXXXGXXXXXXXXXXXXXXXXXXXGXXXXXXXXXXXXXXXXXXXGXXXXXXXXXXXXXXXXXXXGXXXXXXXXXXXXXXXXXXXGXXXXXXXXXXXXXXXXXXXGXXXXXXXXXXXXXXXXXXXGXXXXXXXXXXXXXXXXXXXGXXXXXXXXXXXXXXXXXXX,0,300,0
36582,13,0,13,42,245,0,0,257,199,58,GXXXXXXXXXXXXXXXXXXXGXXXXXXXXXXXXXXXXXXXGXXXXXXXXXXXXXXXXXXXGXXXXXXXXXXXXXXXXXXXGXXXXXXXXXXXXXXXXXXXGXXXXXXXXXXXXXXXXXXXGXXXXXXXXXXXXXXXXXXXGXXXXXXXXXXXXXXXXXXXGXXXXXXXXXXXXXXXXXXXGXXXXXXXXXXXXXXXXXXXGXXXXXXXXXXXXXXXXXXXGXXXXXXXXXXXXXXXXXXXGXXXXXXXXXXXXXXXXXXX,0,300,0
36603,13,0,13,39,248,0,0,259,199,60,GXXXXXXXXXXXXXXXXXXXGXXXXXXXXXXXXXXXXXXXGXXXXXXXXXXXXXXXXXXXGXXXXXXXXXXXXXXXXXXXGXXXXXXXXXXXXXXXXXXXGXXXXXXXXXXXXXXXXXXXGXXXXXXXXXXXXXXXXXXXGXXXXXXXXXXXXXXXXXXXGXXXXXXXXXXXXXXXXXXXGXXXXXXXXXXXXXXXXXXXGXXXXXXXXXXXXXXXXXXXGXXXXXXXXXXXXXXXXXXXGXXXXXXXXXXXXXXXXXXX,0,300,0
36624,13,0,13,34,253,0,0,265,196,69,GXXXXXXXXXXXXXXXXXXXGXXXXXXXXXXXXXXXXXXXGXXXXXXXXXXXXXXXXXXXGXXXXXXXXXXXXXXXXXXXGXXXXXXXXXXXXXXXXXXXGXXXXXXXXXXXXXXXXXXXGXXXXXXXXXXXXXXXXXXXGXXXXXXXXXXXXXXXXXXXGXXXXXXXXXXXXXXXXXXXGXXXXXXXXXXXXXXXXXXXGXXXXXXXXXXXXXXXXXXXGXXXXXXXXXXXXXXXXXXXGXXXXXXXXXXXXXXXXXXX,0,300,0

36645,13,0,13,34,253,0,0,265,202,63,GXXXXXXXXXXXXXXXXXXXGXXXXXXXXXXXXXXXXXXXGXXXXXXXXXXXXXXXXXXXGXXXXXXXXXXXXXXXXXXXGXXXXXXXXXXXXXXXXXXXGXXXXXXXXXXXXXXXXXXXGXXXXXXXXXXXXXXXXXXXGXXXXXXXXXXXXXXXXXXXGXXXXXXXXXXXXXXXXXXXGXXXXXXXXXXXXXXXXXXXGXXXXXXXXXXXXXXXXXXXGXXXXXXXXXXXXXXXXXXXGXXXXXXXXXXXXXXXXXXX,0,300,0
36666,13,0,13,35,252,0,0,264,201,63,GXXXXXXXXXXXXXXXXXXXGXXXXXXXXXXXXXXXXXXXGXXXXXXXXXXXXXXXXXXXGXXXXXXXXXXXXXXXXXXXGXXXXXXXXXXXXXXXXXXXGXXXXXXXXXXXXXXXXXXXGXXXXXXXXXXXXXXXXXXXGXXXXXXXXXXXXXXXXXXXGXXXXXXXXXXXXXXXXXXXGXXXXXXXXXXXXXXXXXXXGXXXXXXXXXXXXXXXXXXXGXXXXXXXXXXXXXXXXXXXGXXXXXXXXXXXXXXXXXXX,0,300,0
36687,13,0,13,33,254,0,0,266,204,62,GXXXXXXXXXXXXXXXXXXXGXXXXXXXXXXXXXXXXXXXGXXXXXXXXXXXXXXXXXXXGXXXXXXXXXXXXXXXXXXXGXXXXXXXXXXXXXXXXXXXGXXXXXXXXXXXXXXXXXXXGXXXXXXXXXXXXXXXXXXXGXXXXXXXXXXXXXXXXXXXGXXXXXXXXXXXXXXXXXXXGXXXXXXXXXXXXXXXXXXXGXXXXXXXXXXXXXXXXXXXGXXXXXXXXXXXXXXXXXXXGXXXXXXXXXXXXXXXXXXX,0,300,0
36708,13,0,13,37,250,0,0,262,201,61,GXXXXXXXXXXXXXXXXXXXGXXXXXXXXXXXXXXXXXXXGXXXXXXXXXXXXXXXXXXXGXXXXXXXXXXXXXXXXXXXGXXXXXXXXXXXXXXXXXXXGXXXXXXXXXXXXXXXXXXXGXXXXXXXXXXXXXXXXXXXGXXXXXXXXXXXXXXXXXXXGXXXXXXXXXXXXXXXXXXXGXXXXXXXXXXXXXXXXXXXGXXXXXXXXXXXXXXXXXXXGXXXXXXXXXXXXXXXXXXXGXXXXXXXXXXXXXXXXXXX,0,300,0
36729,13,0,13,37,250,0,0,262,200,62,GXXXXXXXXXXXXXXXXXXXGXXXXXXXXXXXXXXXXXXXGXXXXXXXXXXXXXXXXXXXGXXXXXXXXXXXXXXXXXXXGXXXXXXXXXXXXXXXXXXXGXXXXXXXXXXXXXXXXXXXGXXXXXXXXXXXXXXXXXXXGXXXXXXXXXXXXXXXXXXXGXXXXXXXXXXXXXXXXXXXGXXXXXXXXXXXXXXXXXXXGXXXXXXXXXXXXXXXXXXXGXXXXXXXXXXXXXXXXXXXGXXXXXXXXXXXXXXXXXXX,0,300,0

36750,13,0,13,35,252,0,0,264,200,64,GXXXXXXXXXXXXXXXXXXXGXXXXXXXXXXXXXXXXXXXGXXXXXXXXXXXXXXXXXXXGXXXXXXXXXXXXXXXXXXXGXXXXXXXXXXXXXXXXXXXGXXXXXXXXXXXXXXXXXXXGXXXXXXXXXXXXXXXXXXXGXXXXXXXXXXXXXXXXXXXGXXXXXXXXXXXXXXXXXXXGXXXXXXXXXXXXXXXXXXXGXXXXXXXXXXXXXXXXXXXGXXXXXXXXXXXXXXXXXXXGXXXXXXXXXXXXXXXXXXX,0,300,0
36771,14,1,13,34,252,0,0,264,199,65,GXXXXXXXXXXXXXXXXXXXGXXXXXXXXXXXXXXXXXXXGXXXXXXXXXXXXXXXXXXXGXXXXXXXXXXXXXXXXXXXGXXXXXXXXXXXXXXXXXXXGAXXXXXXXXXXXXXXXXXXGXXXXXXXXXXXXXXXXXXXGXXXXXXXXXXXXXXXXXXXGXXXXXXXXXXXXXXXXXXXGXXXXXXXXXXXXXXXXXXXGXXXXXXXXXXXXXXXXXXXGXXXXXXXXXXXXXXXXXXXGXXXXXXXXXXXXXXXXXXX,0,300,0
36792,14,1,13,35,251,0,0,263,200,63,GXXXXXXXXXXXXXXXXXXXGXXXXXXXXXXXXXXXXXXXGXXXXXXXXXXXXXXXXXXXGXXXXXXXXXXXXXXXXXXXGXXXXXXXXXXXXXXXXXXXGAXXXXXXXXXXXXXXXXXXGXXXXXXXXXXXXXXXXXXXGXXXXXXXXXXXXXXXXXXXGXXXXXXXXXXXXXXXXXXXGXXXXXXXXXXXXXXXXXXXGXXXXXXXXXXXXXXXXXXXGXXXXXXXXXXXXXXXXXXXGXXXXXXXXXXXXXXXXXXX,0,300,0
36813,14,1,13,32,254,0,0,266,202,64,GXXXXXXXXXXXXXXXXXXXGXXXXXXXXXXXXXXXXXXXGXXXXXXXXXXXXXXXXXXXGXXXXXXXXXXXXXXXXXXXGXXXXXXXXXXXXXXXXXXXGAXXXXXXXXXXXXXXXXXXGXXXXXXXXXXXXXXXXXXXGXXXXXXXXXXXXXXXXXXXGXXXXXXXXXXXXXXXXXXXGXXXXXXXXXXXXXXXXXXXGXXXXXXXXXXXXXXXXXXXGXXXXXXXXXXXXXXXXXXXGXXXXXXXXXXXXXXXXXXX,0,300,0
36834,14,1,13,32,254,0,0,266,201,65,GXXXXXXXXXXXXXXXXXXXGXXXXXXXXXXXXXXXXXXXGXXXXXXXXXXXXXXXXXXXGXXXXXXXXXXXXXXXXXXXGXXXXXXXXXXXXXXXXXXXGAXXXXXXXXXXXXXXXXXXGXXXXXXXXXXXXXXXXXXXGXXXXXXXXXXXXXXXXXXXGXXXXXXXXXXXXXXXXXXXGXXXXXXXXXXXXXXXXXXXGXXXXXXXXXXXXXXXXXXXGXXXXXXXXXXXXXXXXXXXGXXXXXXXXXXXXXXXXXXX,0,300,0

36855,14,1,13,35,251,0,0,262,200,62,GXXXXXXXXXXXXXXXXXXXGXXXXXXXXXXXXXXXXXXXGXXXXXXXXXXXXXXXXXXXGXXXXXXXXXXXXXXXXXXXGXXXXXXXXXXXXXXXXXXXGAXXXXXXXXXXXXXXXXXXGXXXXXXXXXXXXXXXXXXXGXXXXXXXXXXXXXXXXXXXGXXXXXXXXXXXXXXXXXXXGXXXXXXXXXXXXXXXXXXXGXXXXXXXXXXXXXXXXXXXGXXXXXXXXXXXXXXXXXXXGXXXXXXXXXXXXXXXXXXX,0,300,0
36876,14,1,13,36,250,0,0,262,206,56,GXXXXXXXXXXXXXXXXXXXGXXXXXXXXXXXXXXXXXXXGXXXXXXXXXXXXXXXXXXXGXXXXXXXXXXXXXXXXXXXGXXXXXXXXXXXXXXXXXXXGAXXXXXXXXXXXXXXXXXXGXXXXXXXXXXXXXXXXXXXGXXXXXXXXXXXXXXXXXXXGXXXXXXXXXXXXXXXXXXXGXXXXXXXXXXXXXXXXXXXGXXXXXXXXXXXXXXXXXXXGXXXXXXXXXXXXXXXXXXXGXXXXXXXXXXXXXXXXXXX,0,300,0
36897,14,1,13,41,245,0,0,258,201,57,GXXXXXXXXXXXXXXXXXXXGXXXXXXXXXXXXXXXXXXXGXXXXXXXXXXXXXXXXXXXGXXXXXXXXXXXXXXXXXXXGXXXXXXXXXXXXXXXXXXXGAXXXXXXXXXXXXXXXXXXGXXXXXXXXXXXXXXXXXXXGXXXXXXXXXXXXXXXXXXXGXXXXXXXXXXXXXXXXXXXGXXXXXXXXXXXXXXXXXXXGXXXXXXXXXXXXXXXXXXXGXXXXXXXXXXXXXXXXXXXGXXXXXXXXXXXXXXXXXXX,0,300,0
36918,14,1,13,38,248,0,0,260,202,58,GXXXXXXXXXXXXXXXXXXXGXXXXXXXXXXXXXXXXXXXGXXXXXXXXXXXXXXXXXXXGXXXXXXXXXXXXXXXXXXXGXXXXXXXXXXXXXXXXXXXGAXXXXXXXXXXXXXXXXXXGXXXXXXXXXXXXXXXXXXXGXXXXXXXXXXXXXXXXXXXGXXXXXXXXXXXXXXXXXXXGXXXXXXXXXXXXXXXXXXXGXXXXXXXXXXXXXXXXXXXGXXXXXXXXXXXXXXXXXXXGXXXXXXXXXXXXXXXXXXX,0,300,0
36939,14,1,13,36,250,0,0,263,203,60,GXXXXXXXXXXXXXXXXXXXGXXXXXXXXXXXXXXXXXXXGXXXXXXXXXXXXXXXXXXXGXXXXXXXXXXXXXXXXXXXGXXXXXXXXXXXXXXXXXXXGAXXXXXXXXXXXXXXXXXXGXXXXXXXXXXXXXXXXXXXGXXXXXXXXXXXXXXXXXXXGXXXXXXXXXXXXXXXXXXXGXXXXXXXXXXXXXXXXXXXGXXXXXXXXXXXXXXXXXXXGXXXXXXXXXXXXXXXXXXXGXXXXXXXXXXXXXXXXXXX,0,300,0

36960,14,1,13,37,249,0,0,262,199,63,GXXXXXXXXXXXXXXXXXXXGXXXXXXXXXXXXXXXXXXXGXXXXXXXXXXXXXXXXXXXGXXXXXXXXXXXXXXXXXXXGXXXXXXXXXXXXXXXXXXXGAXXXXXXXXXXXXXXXXXXGXXXXXXXXXXXXXXXXXXXGXXXXXXXXXXXXXXXXXXXGXXXXXXXXXXXXXXXXXXXGXXXXXXXXXXXXXXXXXXXGXXXXXXXXXXXXXXXXXXXGXXXXXXXXXXXXXXXXXXXGXXXXXXXXXXXXXXXXXXX,0,300,0
36981,14,1,13,31,255,0,0,268,201,67,GXXXXXXXXXXXXXXXXXXXGXXXXXXXXXXXXXXXXXXXGXXXXXXXXXXXXXXXXXXXGXXXXXXXXXXXXXXXXXXXGXXXXXXXXXXXXXXXXXXXGAXXXXXXXXXXXXXXXXXXGXXXXXXXXXXXXXXXXXXXGXXXXXXXXXXXXXXXXXXXGXXXXXXXXXXXXXXXXXXXGXXXXXXXXXXXXXXXXXXXGXXXXXXXXXXXXXXXXXXXGXXXXXXXXXXXXXXXXXXXGXXXXXXXXXXXXXXXXXXX,0,300,0
37002,14,1,13,35,251,0,0,264,200,64,GXXXXXXXXXXXXXXXXXXXGXXXXXXXXXXXXXXXXXXXGXXXXXXXXXXXXXXXXXXXGXXXXXXXXXXXXXXXXXXXGXXXXXXXXXXXXXXXXXXXGAXXXXXXXXXXXXXXXXXXGXXXXXXXXXXXXXXXXXXXGXXXXXXXXXXXXXXXXXXXGXXXXXXXXXXXXXXXXXXXGXXXXXXXXXXXXXXXXXXXGXXXXXXXXXXXXXXXXXXXGXXXXXXXXXXXXXXXXXXXGXXXXXXXXXXXXXXXXXXX,0,300,0
37023,14,0,14,35,251,0,0,264,200,64,GXXXXXXXXXXXXXXXXXXXGXXXXXXXXXXXXXXXXXXXGXXXXXXXXXXXXXXXXXXXGXXXXXXXXXXXXXXXXXXXGXXXXXXXXXXXXXXXXXXXGOXXXXXXXXXXXXXXXXXXGXXXXXXXXXXXXXXXXXXXGXXXXXXXXXXXXXXXXXXXGXXXXXXXXXXXXXXXXXXXGXXXXXXXXXXXXXXXXXXXGXXXXXXXXXXXXXXXXXXXGXXXXXXXXXXXXXXXXXXXGXXXXXXXXXXXXXXXXXXX,0,300,0
37044,14,0,14,35,251,0,0,263,196,67,GXXXXXXXXXXXXXXXXXXXGXXXXXXXXXXXXXXXXXXXGXXXXXXXXXXXXXXXXXXXGXXXXXXXXXXXXXXXXXXXGXXXXXXXXXXXXXXXXXXXGOXXXXXXXXXXXXXXXXXXGXXXXXXXXXXXXXXXXXXXGXXXXXXXXXXXXXXXXXXXGXXXXXXXXXXXXXXXXXXXGXXXXXXXXXXXXXXXXXXXGXXXXXXXXXXXXXXXXXXXGXXXXXXXXXXXXXXXXXXXGXXXXXXXXXXXXXXXXXXX,0,300,0

37065,13,0,13,30,257,0,0,269,197,72,GXXXXXXXXXXXXXXXXXXXGXXXXXXXXXXXXXXXXXXXGXXXXXXXXXXXXXXXXXXXGXXXXXXXXXXXXXXXXXXXGXXXXXXXXXXXXXXXXXXXGXXXXXXXXXXXXXXXXXXXGXXXXXXXXXXXXXXXXXXXGXXXXXXXXXXXXXXXXXXXGXXXXXXXXXXXXXXXXXXXGXXXXXXXXXXXXXXXXXXXGXXXXXXXXXXXXXXXXXXXGXXXXXXXXXXXXXXXXXXXGXXXXXXXXXXXXXXXXXXX,0,300,0
37086,13,0,13,28,259,0,0,271,197,74,GXXXXXXXXXXXXXXXXXXXGXXXXXXXXXXXXXXXXXXXGXXXXXXXXXXXXXXXXXXXGXXXXXXXXXXXXXXXXXXXGXXXXXXXXXXXXXXXXXXXGXXXXXXXXXXXXXXXXXXXGXXXXXXXXXXXXXXXXXXXGXXXXXXXXXXXXXXXXXXXGXXXXXXXXXXXXXXXXXXXGXXXXXXXXXXXXXXXXXXXGXXXXXXXXXXXXXXXXXXXGXXXXXXXXXXXXXXXXXXXGXXXXXXXXXXXXXXXXXXX,0,300,0
37107,13,0,13,31,256,0,0,268,197,71,GXXXXXXXXXXXXXXXXXXXGXXXXXXXXXXXXXXXXXXXGXXXXXXXXXXXXXXXXXXXGXXXXXXXXXXXXXXXXXXXGXXXXXXXXXXXXXXXXXXXGXXXXXXXXXXXXXXXXXXXGXXXXXXXXXXXXXXXXXXXGXXXXXXXXXXXXXXXXXXXGXXXXXXXXXXXXXXXXXXXGXXXXXXXXXXXXXXXXXXXGXXXXXXXXXXXXXXXXXXXGXXXXXXXXXXXXXXXXXXXGXXXXXXXXXXXXXXXXXXX,0,300,0
37128,13,0,13,31,256,0,0,268,202,66,GXXXXXXXXXXXXXXXXXXXGXXXXXXXXXXXXXXXXXXXGXXXXXXXXXXXXXXXXXXXGXXXXXXXXXXXXXXXXXXXGXXXXXXXXXXXXXXXXXXXGXXXXXXXXXXXXXXXXXXXGXXXXXXXXXXXXXXXXXXXGXXXXXXXXXXXXXXXXXXXGXXXXXXXXXXXXXXXXXXXGXXXXXXXXXXXXXXXXXXXGXXXXXXXXXXXXXXXXXXXGXXXXXXXXXXXXXXXXXXXGXXXXXXXXXXXXXXXXXXX,0,300,0
37149,13,0,13,31,256,0,0,268,203,65,GXXXXXXXXXXXXXXXXXXXGXXXXXXXXXXXXXXXXXXXGXXXXXXXXXXXXXXXXXXXGXXXXXXXXXXXXXXXXXXXGXXXXXXXXXXXXXXXXXXXGXXXXXXXXXXXXXXXXXXXGXXXXXXXXXXXXXXXXXXXGXXXXXXXXXXXXXXXXXXXGXXXXXXXXXXXXXXXXXXXGXXXXXXXXXXXXXXXXXXXGXXXXXXXXXXXXXXXXXXXGXXXXXXXXXXXXXXXXXXXGXXXXXXXXXXXXXXXXXXX,0,300,0

37170,13,0,13,34,253,0,0,265,201,64,GXXXXXXXXXXXXXXXXXXXGXXXXXXXXXXXXXXXXXXXGXXXXXXXXXXXXXXXXXXXGXXXXXXXXXXXXXXXXXXXGXXXXXXXXXXXXXXXXXXXGXXXXXXXXXXXXXXXXXXXGXXXXXXXXXXXXXXXXXXXGXXXXXXXXXXXXXXXXXXXGXXXXXXXXXXXXXXXXXXXGXXXXXXXXXXXXXXXXXXXGXXXXXXXXXXXXXXXXXXXGXXXXXXXXXXXXXXXXXXXGXXXXXXXXXXXXXXXXXXX,0,300,0
37191,13,0,13,36,251,0,0,263,202,61,GXXXXXXXXXXXXXXXXXXXGXXXXXXXXXXXXXXXXXXXGXXXXXXXXXXXXXXXXXXXGXXXXXXXXXXXXXXXXXXXGXXXXXXXXXXXXXXXXXXXGXXXXXXXXXXXXXXXXXXXGXXXXXXXXXXXXXXXXXXXGXXXXXXXXXXXXXXXXXXXGXXXXXXXXXXXXXXXXXXXGXXXXXXXXXXXXXXXXXXXGXXXXXXXXXXXXXXXXXXXGXXXXXXXXXXXXXXXXXXXGXXXXXXXXXXXXXXXXXXX,0,300,0
37212,13,0,13,40,247,0,0,259,201,58,GXXXXXXXXXXXXXXXXXXXGXXXXXXXXXXXXXXXXXXXGXXXXXXXXXXXXXXXXXXXGXXXXXXXXXXXXXXXXXXXGXXXXXXXXXXXXXXXXXXXGXXXXXXXXXXXXXXXXXXXGXXXXXXXXXXXXXXXXXXXGXXXXXXXXXXXXXXXXXXXGXXXXXXXXXXXXXXXXXXXGXXXXXXXXXXXXXXXXXXXGXXXXXXXXXXXXXXXXXXXGXXXXXXXXXXXXXXXXXXXGXXXXXXXXXXXXXXXXXXX,0,300,0
37233,13,0,13,38,249,0,0,261,201,60,GXXXXXXXXXXXXXXXXXXXGXXXXXXXXXXXXXXXXXXXGXXXXXXXXXXXXXXXXXXXGXXXXXXXXXXXXXXXXXXXGXXXXXXXXXXXXXXXXXXXGXXXXXXXXXXXXXXXXXXXGXXXXXXXXXXXXXXXXXXXGXXXXXXXXXXXXXXXXXXXGXXXXXXXXXXXXXXXXXXXGXXXXXXXXXXXXXXXXXXXGXXXXXXXXXXXXXXXXXXXGXXXXXXXXXXXXXXXXXXXGXXXXXXXXXXXXXXXXXXX,0,300,0
37254,13,0,13,41,246,0,0,258,200,58,GXXXXXXXXXXXXXXXXXXXGXXXXXXXXXXXXXXXXXXXGXXXXXXXXXXXXXXXXXXXGXXXXXXXXXXXXXXXXXXXGXXXXXXXXXXXXXXXXXXXGXXXXXXXXXXXXXXXXXXXGXXXXXXXXXXXXXXXXXXXGXXXXXXXXXXXXXXXXXXXGXXXXXXXXXXXXXXXXXXXGXXXXXXXXXXXXXXXXXXXGXXXXXXXXXXXXXXXXXXXGXXXXXXXXXXXXXXXXXXXGXXXXXXXXXXXXXXXXXXX,0,300,0

37275,13,0,13,43,244,0,0,256,202,54,GXXXXXXXXXXXXXXXXXXXGXXXXXXXXXXXXXXXXXXXGXXXXXXXXXXXXXXXXXXXGXXXXXXXXXXXXXXXXXXXGXXXXXXXXXXXXXXXXXXXGXXXXXXXXXXXXXXXXXXXGXXXXXXXXXXXXXXXXXXXGXXXXXXXXXXXXXXXXXXXGXXXXXXXXXXXXXXXXXXXGXXXXXXXXXXXXXXXXXXXGXXXXXXXXXXXXXXXXXXXGXXXXXXXXXXXXXXXXXXXGXXXXXXXXXXXXXXXXXXX,0,300,0
37296,13,0,13,43,244,0,0,256,202,54,GXXXXXXXXXXXXXXXXXXXGXXXXXXXXXXXXXXXXXXXGXXXXXXXXXXXXXXXXXXXGXXXXXXXXXXXXXXXXXXXGXXXXXXXXXXXXXXXXXXXGXXXXXXXXXXXXXXXXXXXGXXXXXXXXXXXXXXXXXXXGXXXXXXXXXXXXXXXXXXXGXXXXXXXXXXXXXXXXXXXGXXXXXXXXXXXXXXXXXXXGXXXXXXXXXXXXXXXXXXXGXXXXXXXXXXXXXXXXXXXGXXXXXXXXXXXXXXXXXXX,0,300,0
37317,13,0,13,45,242,0,0,254,199,55,GXXXXXXXXXXXXXXXXXXXGXXXXXXXXXXXXXXXXXXXGXXXXXXXXXXXXXXXXXXXGXXXXXXXXXXXXXXXXXXXGXXXXXXXXXXXXXXXXXXXGXXXXXXXXXXXXXXXXXXXGXXXXXXXXXXXXXXXXXXXGXXXXXXXXXXXXXXXXXXXGXXXXXXXXXXXXXXXXXXXGXXXXXXXXXXXXXXXXXXXGXXXXXXXXXXXXXXXXXXXGXXXXXXXXXXXXXXXXXXXGXXXXXXXXXXXXXXXXXXX,0,300,0
37338,13,0,13,42,245,0,0,256,198,58,GXXXXXXXXXXXXXXXXXXXGXXXXXXXXXXXXXXXXXXXGXXXXXXXXXXXXXXXXXXXGXXXXXXXXXXXXXXXXXXXGXXXXXXXXXXXXXXXXXXXGXXXXXXXXXXXXXXXXXXXGXXXXXXXXXXXXXXXXXXXGXXXXXXXXXXXXXXXXXXXGXXXXXXXXXXXXXXXXXXXGXXXXXXXXXXXXXXXXXXXGXXXXXXXXXXXXXXXXXXXGXXXXXXXXXXXXXXXXXXXGXXXXXXXXXXXXXXXXXXX,0,300,0
37359,13,0,13,43,244,0,0,257,199,58,GXXXXXXXXXXXXXXXXXXXGXXXXXXXXXXXXXXXXXXXGXXXXXXXXXXXXXXXXXXXGXXXXXXXXXXXXXXXXXXXGXXXXXXXXXXXXXXXXXXXGXXXXXXXXXXXXXXXXXXXGXXXXXXXXXXXXXXXXXXXGXXXXXXXXXXXXXXXXXXXGXXXXXXXXXXXXXXXXXXXGXXXXXXXXXXXXXXXXXXXGXXXXXXXXXXXXXXXXXXXGXXXXXXXXXXXXXXXXXXXGXXXXXXXXXXXXXXXXXXX,0,300,0

37380,13,0,13,41,246,0,0,258,197,61,GXXXXXXXXXXXXXXXXXXXGXXXXXXXXXXXXXXXXXXXGXXXXXXXXXXXXXXXXXXXGXXXXXXXXXXXXXXXXXXXGXXXXXXXXXXXXXXXXXXXGXXXXXXXXXXXXXXXXXXXGXXXXXXXXXXXXXXXXXXXGXXXXXXXXXXXXXXXXXXXGXXXXXXXXXXXXXXXXXXXGXXXXXXXXXXXXXXXXXXXGXXXXXXXXXXXXXXXXXXXGXXXXXXXXXXXXXXXXXXXGXXXXXXXXXXXXXXXXXXX,0,300,0
37401,13,0,13,36,251,0,0,264,199,65,GXXXXXXXXXXXXXXXXXXXGXXXXXXXXXXXXXXXXXXXGXXXXXXXXXXXXXXXXXXXGXXXXXXXXXXXXXXXXXXXGXXXXXXXXXXXXXXXXXXXGXXXXXXXXXXXXXXXXXXXGXXXXXXXXXXXXXXXXXXXGXXXXXXXXXXXXXXXXXXXGXXXXXXXXXXXXXXXXXXXGXXXXXXXXXXXXXXXXXXXGXXXXXXXXXXXXXXXXXXXGXXXXXXXXXXXXXXXXXXXGXXXXXXXXXXXXXXXXXXX,0,300,0
37422,14,1,13,33,253,0,0,265,201,64,GXXXXXXXXXXXXXXXXXXXGXXXXXXXXXXXXXXXXXXXGXXXXXXXXXXXXXXXXXXXGXXXXXXXXXXXXXXXXXXXGXXXXXXXXXXXXXXXXXXXGXXXXXXXXXXXXXXXXXXXGXXXXXXXXXXXXXXXXXXXGXXXXXXXXXXXXXXXXXXXGXXXXXXXXXXXXXXXXXXXGXXXXXXXXXXXXXXXXXXXGXXXXXXXXXXXXXXXXXXXGXXXXXXXXXXXXXXXXXXXGAXXXXXXXXXXXXXXXXXX,0,300,0
37443,14,1,13,31,255,0,0,268,200,68,GXXXXXXXXXXXXXXXXXXXGXXXXXXXXXXXXXXXXXXXGXXXXXXXXXXXXXXXXXXXGXXXXXXXXXXXXXXXXXXXGXXXXXXXXXXXXXXXXXXXGXXXXXXXXXXXXXXXXXXXGXXXXXXXXXXXXXXXXXXXGXXXXXXXXXXXXXXXXXXXGXXXXXXXXXXXXXXXXXXXGXXXXXXXXXXXXXXXXXXXGXXXXXXXXXXXXXXXXXXXGXXXXXXXXXXXXXXXXXXXGAXXXXXXXXXXXXXXXXXX,0,300,0
37464,14,1,13,28,258,0,0,271,199,72,GXXXXXXXXXXXXXXXXXXXGXXXXXXXXXXXXXXXXXXXGXXXXXXXXXXXXXXXXXXXGXXXXXXXXXXXXXXXXXXXGXXXXXXXXXXXXXXXXXXXGXXXXXXXXXXXXXXXXXXXGXXXXXXXXXXXXXXXXXXXGXXXXXXXXXXXXXXXXXXXGXXXXXXXXXXXXXXXXXXXGXXXXXXXXXXXXXXXXXXXGXXXXXXXXXXXXXXXXXXXGXXXXXXXXXXXXXXXXXXXGAXXXXXXXXXXXXXXXXXX,0,300,0

37485,14,1,13,26,260,0,0,273,200,73,GXXXXXXXXXXXXXXXXXXXGXXXXXXXXXXXXXXXXXXXGXXXXXXXXXXXXXXXXXXXGXXXXXXXXXXXXXXXXXXXGXXXXXXXXXXXXXXXXXXXGXXXXXXXXXXXXXXXXXXXGXXXXXXXXXXXXXXXXXXXGXXXXXXXXXXXXXXXXXXXGXXXXXXXXXXXXXXXXXXXGXXXXXXXXXXXXXXXXXXXGXXXXXXXXXXXXXXXXXXXGXXXXXXXXXXXXXXXXXXXGAXXXXXXXXXXXXXXXXXX,0,300,0
37506,14,1,13,25,261,0,0,274,202,72,GXXXXXXXXXXXXXXXXXXXGXXXXXXXXXXXXXXXXXXXGXXXXXXXXXXXXXXXXXXXGXXXXXXXXXXXXXXXXXXXGXXXXXXXXXXXXXXXXXXXGXXXXXXXXXXXXXXXXXXXGXXXXXXXXXXXXXXXXXXXGXXXXXXXXXXXXXXXXXXXGXXXXXXXXXXXXXXXXXXXGXXXXXXXXXXXXXXXXXXXGXXXXXXXXXXXXXXXXXXXGXXXXXXXXXXXXXXXXXXXGAXXXXXXXXXXXXXXXXXX,0,300,0
37527,14,1,13,28,258,0,0,271,199,72,GXXXXXXXXXXXXXXXXXXXGXXXXXXXXXXXXXXXXXXXGXXXXXXXXXXXXXXXXXXXGXXXXXXXXXXXXXXXXXXXGXXXXXXXXXXXXXXXXXXXGXXXXXXXXXXXXXXXXXXXGXXXXXXXXXXXXXXXXXXXGXXXXXXXXXXXXXXXXXXXGXXXXXXXXXXXXXXXXXXXGXXXXXXXXXXXXXXXXXXXGXXXXXXXXXXXXXXXXXXXGXXXXXXXXXXXXXXXXXXXGAXXXXXXXXXXXXXXXXXX,0,300,0
37548,15,2,13,28,257,0,0,270,198,72,GXXXXXXXXXXXXXXXXXXXGXXXXXXXXXXXXXXXXXXXGXXXXXXXXXXXXXXXXXXXGXXXXXXXXXXXXXXXXXXXGAXXXXXXXXXXXXXXXXXXGXXXXXXXXXXXXXXXXXXXGXXXXXXXXXXXXXXXXXXXGXXXXXXXXXXXXXXXXXXXGXXXXXXXXXXXXXXXXXXXGXXXXXXXXXXXXXXXXXXXGXXXXXXXXXXXXXXXXXXXGXXXXXXXXXXXXXXXXXXXGAXXXXXXXXXXXXXXXXXX,0,300,0
37569,15,2,13,26,259,0,0,272,199,73,GXXXXXXXXXXXXXXXXXXXGXXXXXXXXXXXXXXXXXXXGXXXXXXXXXXXXXXXXXXXGXXXXXXXXXXXXXXXXXXXGAXXXXXXXXXXXXXXXXXXGXXXXXXXXXXXXXXXXXXXGXXXXXXXXXXXXXXXXXXXGXXXXXXXXXXXXXXXXXXXGXXXXXXXXXXXXXXXXXXXGXXXXXXXXXXXXXXXXXXXGXXXXXXXXXXXXXXXXXXXGXXXXXXXXXXXXXXXXXXXGAXXXXXXXXXXXXXXXXXX,0,300,0

37590,15,2,13,30,255,0,0,268,197,71,GXXXXXXXXXXXXXXXXXXXGXXXXXXXXXXXXXXXXXXXGXXXXXXXXXXXXXXXXXXXGXXXXXXXXXXXXXXXXXXXGAXXXXXXXXXXXXXXXXXXGXXXXXXXXXXXXXXXXXXXGXXXXXXXXXXXXXXXXXXXGXXXXXXXXXXXXXXXXXXXGXXXXXXXXXXXXXXXXXXXGXXXXXXXXXXXXXXXXXXXGXXXXXXXXXXXXXXXXXXXGXXXXXXXXXXXXXXXXXXXGAXXXXXXXXXXXXXXXXXX,0,300,0
37611,15,2,13,27,258,0,0,271,203,68,GXXXXXXXXXXXXXXXXXXXGXXXXXXXXXXXXXXXXXXXGXXXXXXXXXXXXXXXXXXXGXXXXXXXXXXXXXXXXXXXGAXXXXXXXXXXXXXXXXXXGXXXXXXXXXXXXXXXXXXXGXXXXXXXXXXXXXXXXXXXGXXXXXXXXXXXXXXXXXXXGXXXXXXXXXXXXXXXXXXXGXXXXXXXXXXXXXXXXXXXGXXXXXXXXXXXXXXXXXXXGXXXXXXXXXXXXXXXXXXXGAXXXXXXXXXXXXXXXXXX,0,300,0
37632,15,2,13,29,256,0,0,268,202,66,GXXXXXXXXXXXXXXXXXXXGXXXXXXXXXXXXXXXXXXXGXXXXXXXXXXXXXXXXXXXGXXXXXXXXXXXXXXXXXXXGAXXXXXXXXXXXXXXXXXXGXXXXXXXXXXXXXXXXXXXGXXXXXXXXXXXXXXXXXXXGXXXXXXXXXXXXXXXXXXXGXXXXXXXXXXXXXXXXXXXGXXXXXXXXXXXXXXXXXXXGXXXXXXXXXXXXXXXXXXXGXXXXXXXXXXXXXXXXXXXGAXXXXXXXXXXXXXXXXXX,0,300,0
37653,15,2,13,29,256,0,0,269,203,66,GXXXXXXXXXXXXXXXXXXXGXXXXXXXXXXXXXXXXXXXGXXXXXXXXXXXXXXXXXXXGXXXXXXXXXXXXXXXXXXXGAXXXXXXXXXXXXXXXXXXGXXXXXXXXXXXXXXXXXXXGXXXXXXXXXXXXXXXXXXXGXXXXXXXXXXXXXXXXXXXGXXXXXXXXXXXXXXXXXXXGXXXXXXXXXXXXXXXXXXXGXXXXXXXXXXXXXXXXXXXGXXXXXXXXXXXXXXXXXXXGAXXXXXXXXXXXXXXXXXX,0,300,0
37674,15,0,15,28,257,0,0,270,205,65,GXXXXXXXXXXXXXXXXXXXGXXXXXXXXXXXXXXXXXXXGXXXXXXXXXXXXXXXXXXXGXXXXXXXXXXXXXXXXXXXGOXXXXXXXXXXXXXXXXXXGXXXXXXXXXXXXXXXXXXXGXXXXXXXXXXXXXXXXXXXGXXXXXXXXXXXXXXXXXXXGXXXXXXXXXXXXXXXXXXXGXXXXXXXXXXXXXXXXXXXGXXXXXXXXXXXXXXXXXXXGXXXXXXXXXXXXXXXXXXXGOXXXXXXXXXXXXXXXXXX,0,300,0

37695,15,0,15,31,254,0,0,266,204,62,GXXXXXXXXXXXXXXXXXXXGXXXXXXXXXXXXXXXXXXXGXXXXXXXXXXXXXXXXXXXGXXXXXXXXXXXXXXXXXXXGOXXXXXXXXXXXXXXXXXXGXXXXXXXXXXXXXXXXXXXGXXXXXXXXXXXXXXXXXXXGXXXXXXXXXXXXXXXXXXXGXXXXXXXXXXXXXXXXXXXGXXXXXXXXXXXXXXXXXXXGXXXXXXXXXXXXXXXXXXXGXXXXXXXXXXXXXXXXXXXGOXXXXXXXXXXXXXXXXXX,0,300,0
37716,13,0,13,33,254,0,0,266,204,62,GXXXXXXXXXXXXXXXXXXXGXXXXXXXXXXXXXXXXXXXGXXXXXXXXXXXXXXXXXXXGXXXXXXXXXXXXXXXXXXXGXXXXXXXXXXXXXXXXXXXGXXXXXXXXXXXXXXXXXXXGXXXXXXXXXXXXXXXXXXXGXXXXXXXXXXXXXXXXXXXGXXXXXXXXXXXXXXXXXXXGXXXXXXXXXXXXXXXXXXXGXXXXXXXXXXXXXXXXXXXGXXXXXXXXXXXXXXXXXXXGXXXXXXXXXXXXXXXXXXX,0,300,0
37737,13,0,13,37,250,0,0,262,204,58,GXXXXXXXXXXXXXXXXXXXGXXXXXXXXXXXXXXXXXXXGXXXXXXXXXXXXXXXXXXXGXXXXXXXXXXXXXXXXXXXGXXXXXXXXXXXXXXXXXXXGXXXXXXXXXXXXXXXXXXXGXXXXXXXXXXXXXXXXXXXGXXXXXXXXXXXXXXXXXXXGXXXXXXXXXXXXXXXXXXXGXXXXXXXXXXXXXXXXXXXGXXXXXXXXXXXXXXXXXXXGXXXXXXXXXXXXXXXXXXXGXXXXXXXXXXXXXXXXXXX,0,300,0
37758,13,0,13,36,251,0,0,261,204,57,GXXXXXXXXXXXXXXXXXXXGXXXXXXXXXXXXXXXXXXXGXXXXXXXXXXXXXXXXXXXGXXXXXXXXXXXXXXXXXXXGXXXXXXXXXXXXXXXXXXXGXXXXXXXXXXXXXXXXXXXGXXXXXXXXXXXXXXXXXXXGXXXXXXXXXXXXXXXXXXXGXXXXXXXXXXXXXXXXXXXGXXXXXXXXXXXXXXXXXXXGXXXXXXXXXXXXXXXXXXXGXXXXXXXXXXXXXXXXXXXGXXXXXXXXXXXXXXXXXXX,0,300,0
37779,13,0,13,33,254,0,0,266,206,60,GXXXXXXXXXXXXXXXXXXXGXXXXXXXXXXXXXXXXXXXGXXXXXXXXXXXXXXXXXXXGXXXXXXXXXXXXXXXXXXXGXXXXXXXXXXXXXXXXXXXGXXXXXXXXXXXXXXXXXXXGXXXXXXXXXXXXXXXXXXXGXXXXXXXXXXXXXXXXXXXGXXXXXXXXXXXXXXXXXXXGXXXXXXXXXXXXXXXXXXXGXXXXXXXXXXXXXXXXXXXGXXXXXXXXXXXXXXXXXXXGXXXXXXXXXXXXXXXXXXX,0,300,0

37800,13,0,13,36,251,0,0,263,204,59,GXXXXXXXXXXXXXXXXXXXGXXXXXXXXXXXXXXXXXXXGXXXXXXXXXXXXXXXXXXXGXXXXXXXXXXXXXXXXXXXGXXXXXXXXXXXXXXXXXXXGXXXXXXXXXXXXXXXXXXXGXXXXXXXXXXXXXXXXXXXGXXXXXXXXXXXXXXXXXXXGXXXXXXXXXXXXXXXXXXXGXXXXXXXXXXXXXXXXXXXGXXXXXXXXXXXXXXXXXXXGXXXXXXXXXXXXXXXXXXXGXXXXXXXXXXXXXXXXXXX,0,300,0
37821,13,0,13,37,250,0,0,263,203,60,GXXXXXXXXXXXXXXXXXXXGXXXXXXXXXXXXXXXXXXXGXXXXXXXXXXXXXXXXXXXGXXXXXXXXXXXXXXXXXXXGXXXXXXXXXXXXXXXXXXXGXXXXXXXXXXXXXXXXXXXGXXXXXXXXXXXXXXXXXXXGXXXXXXXXXXXXXXXXXXXGXXXXXXXXXXXXXXXXXXXGXXXXXXXXXXXXXXXXXXXGXXXXXXXXXXXXXXXXXXXGXXXXXXXXXXXXXXXXXXXGXXXXXXXXXXXXXXXXXXX,0,300,0
37842,13,0,13,37,250,0,0,263,204,59,GXXXXXXXXXXXXXXXXXXXGXXXXXXXXXXXXXXXXXXXGXXXXXXXXXXXXXXXXXXXGXXXXXXXXXXXXXXXXXXXGXXXXXXXXXXXXXXXXXXXGXXXXXXXXXXXXXXXXXXXGXXXXXXXXXXXXXXXXXXXGXXXXXXXXXXXXXXXXXXXGXXXXXXXXXXXXXXXXXXXGXXXXXXXXXXXXXXXXXXXGXXXXXXXXXXXXXXXXXXXGXXXXXXXXXXXXXXXXXXXGXXXXXXXXXXXXXXXXXXX,0,300,0
37863,13,0,13,45,242,0,0,255,201,54,GXXXXXXXXXXXXXXXXXXXGXXXXXXXXXXXXXXXXXXXGXXXXXXXXXXXXXXXXXXXGXXXXXXXXXXXXXXXXXXXGXXXXXXXXXXXXXXXXXXXGXXXXXXXXXXXXXXXXXXXGXXXXXXXXXXXXXXXXXXXGXXXXXXXXXXXXXXXXXXXGXXXXXXXXXXXXXXXXXXXGXXXXXXXXXXXXXXXXXXXGXXXXXXXXXXXXXXXXXXXGXXXXXXXXXXXXXXXXXXXGXXXXXXXXXXXXXXXXXXX,0,300,0
37884,13,0,13,39,248,0,0,260,203,57,GXXXXXXXXXXXXXXXXXXXGXXXXXXXXXXXXXXXXXXXGXXXXXXXXXXXXXXXXXXXGXXXXXXXXXXXXXXXXXXXGXXXXXXXXXXXXXXXXXXXGXXXXXXXXXXXXXXXXXXXGXXXXXXXXXXXXXXXXXXXGXXXXXXXXXXXXXXXXXXXGXXXXXXXXXXXXXXXXXXXGXXXXXXXXXXXXXXXXXXXGXXXXXXXXXXXXXXXXXXXGXXXXXXXXXXXXXXXXXXXGXXXXXXXXXXXXXXXXXXX,0,300,0

37905,13,0,13,38,249,0,0,261,203,58,GXXXXXXXXXXXXXXXXXXXGXXXXXXXXXXXXXXXXXXXGXXXXXXXXXXXXXXXXXXXGXXXXXXXXXXXXXXXXXXXGXXXXXXXXXXXXXXXXXXXGXXXXXXXXXXXXXXXXXXXGXXXXXXXXXXXXXXXXXXXGXXXXXXXXXXXXXXXXXXXGXXXXXXXXXXXXXXXXXXXGXXXXXXXXXXXXXXXXXXXGXXXXXXXXXXXXXXXXXXXGXXXXXXXXXXXXXXXXXXXGXXXXXXXXXXXXXXXXXXX,0,300,0
37926,13,0,13,38,249,0,0,261,201,60,GXXXXXXXXXXXXXXXXXXXGXXXXXXXXXXXXXXXXXXXGXXXXXXXXXXXXXXXXXXXGXXXXXXXXXXXXXXXXXXXGXXXXXXXXXXXXXXXXXXXGXXXXXXXXXXXXXXXXXXXGXXXXXXXXXXXXXXXXXXXGXXXXXXXXXXXXXXXXXXXGXXXXXXXXXXXXXXXXXXXGXXXXXXXXXXXXXXXXXXXGXXXXXXXXXXXXXXXXXXXGXXXXXXXXXXXXXXXXXXXGXXXXXXXXXXXXXXXXXXX,0,300,0
37947,13,0,13,39,248,0,0,260,199,61,GXXXXXXXXXXXXXXXXXXXGXXXXXXXXXXXXXXXXXXXGXXXXXXXXXXXXXXXXXXXGXXXXXXXXXXXXXXXXXXXGXXXXXXXXXXXXXXXXXXXGXXXXXXXXXXXXXXXXXXXGXXXXXXXXXXXXXXXXXXXGXXXXXXXXXXXXXXXXXXXGXXXXXXXXXXXXXXXXXXXGXXXXXXXXXXXXXXXXXXXGXXXXXXXXXXXXXXXXXXXGXXXXXXXXXXXXXXXXXXXGXXXXXXXXXXXXXXXXXXX,0,300,0
37968,13,0,13,38,249,0,0,261,199,62,GXXXXXXXXXXXXXXXXXXXGXXXXXXXXXXXXXXXXXXXGXXXXXXXXXXXXXXXXXXXGXXXXXXXXXXXXXXXXXXXGXXXXXXXXXXXXXXXXXXXGXXXXXXXXXXXXXXXXXXXGXXXXXXXXXXXXXXXXXXXGXXXXXXXXXXXXXXXXXXXGXXXXXXXXXXXXXXXXXXXGXXXXXXXXXXXXXXXXXXXGXXXXXXXXXXXXXXXXXXXGXXXXXXXXXXXXXXXXXXXGXXXXXXXXXXXXXXXXXXX,0,300,0
37989,13,0,13,34,253,0,0,264,199,65,GXXXXXXXXXXXXXXXXXXXGXXXXXXXXXXXXXXXXXXXGXXXXXXXXXXXXXXXXXXXGXXXXXXXXXXXXXXXXXXXGXXXXXXXXXXXXXXXXXXXGXXXXXXXXXXXXXXXXXXXGXXXXXXXXXXXXXXXXXXXGXXXXXXXXXXXXXXXXXXXGXXXXXXXXXXXXXXXXXXXGXXXXXXXXXXXXXXXXXXXGXXXXXXXXXXXXXXXXXXXGXXXXXXXXXXXXXXXXXXXGXXXXXXXXXXXXXXXXXXX,0,300,0

38010,13,0,13,34,253,0,0,265,197,68,GXXXXXXXXXXXXXXXXXXXGXXXXXXXXXXXXXXXXXXXGXXXXXXXXXXXXXXXXXXXGXXXXXXXXXXXXXXXXXXXGXXXXXXXXXXXXXXXXXXXGXXXXXXXXXXXXXXXXXXXGXXXXXXXXXXXXXXXXXXXGXXXXXXXXXXXXXXXXXXXGXXXXXXXXXXXXXXXXXXXGXXXXXXXXXXXXXXXXXXXGXXXXXXXXXXXXXXXXXXXGXXXXXXXXXXXXXXXXXXXGXXXXXXXXXXXXXXXXXXX,0,300,0
38031,13,0,13,31,256,0,0,268,198,70,GXXXXXXXXXXXXXXXXXXXGXXXXXXXXXXXXXXXXXXXGXXXXXXXXXXXXXXXXXXXGXXXXXXXXXXXXXXXXXXXGXXXXXXXXXXXXXXXXXXXGXXXXXXXXXXXXXXXXXXXGXXXXXXXXXXXXXXXXXXXGXXXXXXXXXXXXXXXXXXXGXXXXXXXXXXXXXXXXXXXGXXXXXXXXXXXXXXXXXXXGXXXXXXXXXXXXXXXXXXXGXXXXXXXXXXXXXXXXXXXGXXXXXXXXXXXXXXXXXXX,0,300,0
38052,13,0,13,27,260,0,0,272,204,68,GXXXXXXXXXXXXXXXXXXXGXXXXXXXXXXXXXXXXXXXGXXXXXXXXXXXXXXXXXXXGXXXXXXXXXXXXXXXXXXXGXXXXXXXXXXXXXXXXXXXGXXXXXXXXXXXXXXXXXXXGXXXXXXXXXXXXXXXXXXXGXXXXXXXXXXXXXXXXXXXGXXXXXXXXXXXXXXXXXXXGXXXXXXXXXXXXXXXXXXXGXXXXXXXXXXXXXXXXXXXGXXXXXXXXXXXXXXXXXXXGXXXXXXXXXXXXXXXXXXX,0,300,0
38073,13,0,13,25,262,0,0,274,204,70,GXXXXXXXXXXXXXXXXXXXGXXXXXXXXXXXXXXXXXXXGXXXXXXXXXXXXXXXXXXXGXXXXXXXXXXXXXXXXXXXGXXXXXXXXXXXXXXXXXXXGXXXXXXXXXXXXXXXXXXXGXXXXXXXXXXXXXXXXXXXGXXXXXXXXXXXXXXXXXXXGXXXXXXXXXXXXXXXXXXXGXXXXXXXXXXXXXXXXXXXGXXXXXXXXXXXXXXXXXXXGXXXXXXXXXXXXXXXXXXXGXXXXXXXXXXXXXXXXXXX,0,300,0
38094,13,0,13,26,261,0,0,273,204,69,GXXXXXXXXXXXXXXXXXXXGXXXXXXXXXXXXXXXXXXXGXXXXXXXXXXXXXXXXXXXGXXXXXXXXXXXXXXXXXXXGXXXXXXXXXXXXXXXXXXXGXXXXXXXXXXXXXXXXXXXGXXXXXXXXXXXXXXXXXXXGXXXXXXXXXXXXXXXXXXXGXXXXXXXXXXXXXXXXXXXGXXXXXXXXXXXXXXXXXXXGXXXXXXXXXXXXXXXXXXXGXXXXXXXXXXXXXXXXXXXGXXXXXXXXXXXXXXXXXXX,0,300,0

38115,13,0,13,24,263,0,0,274,204,70,GXXXXXXXXXXXXXXXXXXXGXXXXXXXXXXXXXXXXXXXGXXXXXXXXXXXXXXXXXXXGXXXXXXXXXXXXXXXXXXXGXXXXXXXXXXXXXXXXXXXGXXXXXXXXXXXXXXXXXXXGXXXXXXXXXXXXXXXXXXXGXXXXXXXXXXXXXXXXXXXGXXXXXXXXXXXXXXXXXXXGXXXXXXXXXXXXXXXXXXXGXXXXXXXXXXXXXXXXXXXGXXXXXXXXXXXXXXXXXXXGXXXXXXXXXXXXXXXXXXX,0,300,0
38136,13,0,13,27,260,0,0,272,201,71,GXXXXXXXXXXXXXXXXXXXGXXXXXXXXXXXXXXXXXXXGXXXXXXXXXXXXXXXXXXXGXXXXXXXXXXXXXXXXXXXGXXXXXXXXXXXXXXXXXXXGXXXXXXXXXXXXXXXXXXXGXXXXXXXXXXXXXXXXXXXGXXXXXXXXXXXXXXXXXXXGXXXXXXXXXXXXXXXXXXXGXXXXXXXXXXXXXXXXXXXGXXXXXXXXXXXXXXXXXXXGXXXXXXXXXXXXXXXXXXXGXXXXXXXXXXXXXXXXXXX,0,300,0
38157,13,0,13,27,260,0,0,272,204,68,GXXXXXXXXXXXXXXXXXXXGXXXXXXXXXXXXXXXXXXXGXXXXXXXXXXXXXXXXXXXGXXXXXXXXXXXXXXXXXXXGXXXXXXXXXXXXXXXXXXXGXXXXXXXXXXXXXXXXXXXGXXXXXXXXXXXXXXXXXXXGXXXXXXXXXXXXXXXXXXXGXXXXXXXXXXXXXXXXXXXGXXXXXXXXXXXXXXXXXXXGXXXXXXXXXXXXXXXXXXXGXXXXXXXXXXXXXXXXXXXGXXXXXXXXXXXXXXXXXXX,0,300,0
38178,13,0,13,23,264,0,0,276,202,74,GXXXXXXXXXXXXXXXXXXXGXXXXXXXXXXXXXXXXXXXGXXXXXXXXXXXXXXXXXXXGXXXXXXXXXXXXXXXXXXXGXXXXXXXXXXXXXXXXXXXGXXXXXXXXXXXXXXXXXXXGXXXXXXXXXXXXXXXXXXXGXXXXXXXXXXXXXXXXXXXGXXXXXXXXXXXXXXXXXXXGXXXXXXXXXXXXXXXXXXXGXXXXXXXXXXXXXXXXXXXGXXXXXXXXXXXXXXXXXXXGXXXXXXXXXXXXXXXXXXX,0,300,0
38199,13,0,13,27,260,0,0,273,202,71,GXXXXXXXXXXXXXXXXXXXGXXXXXXXXXXXXXXXXXXXGXXXXXXXXXXXXXXXXXXXGXXXXXXXXXXXXXXXXXXXGXXXXXXXXXXXXXXXXXXXGXXXXXXXXXXXXXXXXXXXGXXXXXXXXXXXXXXXXXXXGXXXXXXXXXXXXXXXXXXXGXXXXXXXXXXXXXXXXXXXGXXXXXXXXXXXXXXXXXXXGXXXXXXXXXXXXXXXXXXXGXXXXXXXXXXXXXXXXXXXGXXXXXXXXXXXXXXXXXXX,0,300,0

38220,13,0,13,28,259,0,0,272,202,70,GXXXXXXXXXXXXXXXXXXXGXXXXXXXXXXXXXXXXXXXGXXXXXXXXXXXXXXXXXXXGXXXXXXXXXXXXXXXXXXXGXXXXXXXXXXXXXXXXXXXGXXXXXXXXXXXXXXXXXXXGXXXXXXXXXXXXXXXXXXXGXXXXXXXXXXXXXXXXXXXGXXXXXXXXXXXXXXXXXXXGXXXXXXXXXXXXXXXXXXXGXXXXXXXXXXXXXXXXXXXGXXXXXXXXXXXXXXXXXXXGXXXXXXXXXXXXXXXXXXX,0,300,0
38241,13,0,13,31,256,0,0,269,206,63,GXXXXXXXXXXXXXXXXXXXGXXXXXXXXXXXXXXXXXXXGXXXXXXXXXXXXXXXXXXXGXXXXXXXXXXXXXXXXXXXGXXXXXXXXXXXXXXXXXXXGXXXXXXXXXXXXXXXXXXXGXXXXXXXXXXXXXXXXXXXGXXXXXXXXXXXXXXXXXXXGXXXXXXXXXXXXXXXXXXXGXXXXXXXXXXXXXXXXXXXGXXXXXXXXXXXXXXXXXXXGXXXXXXXXXXXXXXXXXXXGXXXXXXXXXXXXXXXXXXX,0,300,0
38262,13,0,13,31,256,0,0,269,205,64,GXXXXXXXXXXXXXXXXXXXGXXXXXXXXXXXXXXXXXXXGXXXXXXXXXXXXXXXXXXXGXXXXXXXXXXXXXXXXXXXGXXXXXXXXXXXXXXXXXXXGXXXXXXXXXXXXXXXXXXXGXXXXXXXXXXXXXXXXXXXGXXXXXXXXXXXXXXXXXXXGXXXXXXXXXXXXXXXXXXXGXXXXXXXXXXXXXXXXXXXGXXXXXXXXXXXXXXXXXXXGXXXXXXXXXXXXXXXXXXXGXXXXXXXXXXXXXXXXXXX,0,300,0
38283,13,0,13,37,250,0,0,262,205,57,GXXXXXXXXXXXXXXXXXXXGXXXXXXXXXXXXXXXXXXXGXXXXXXXXXXXXXXXXXXXGXXXXXXXXXXXXXXXXXXXGXXXXXXXXXXXXXXXXXXXGXXXXXXXXXXXXXXXXXXXGXXXXXXXXXXXXXXXXXXXGXXXXXXXXXXXXXXXXXXXGXXXXXXXXXXXXXXXXXXXGXXXXXXXXXXXXXXXXXXXGXXXXXXXXXXXXXXXXXXXGXXXXXXXXXXXXXXXXXXXGXXXXXXXXXXXXXXXXXXX,0,300,0
38304,13,0,13,41,246,0,0,259,200,59,GXXXXXXXXXXXXXXXXXXXGXXXXXXXXXXXXXXXXXXXGXXXXXXXXXXXXXXXXXXXGXXXXXXXXXXXXXXXXXXXGXXXXXXXXXXXXXXXXXXXGXXXXXXXXXXXXXXXXXXXGXXXXXXXXXXXXXXXXXXXGXXXXXXXXXXXXXXXXXXXGXXXXXXXXXXXXXXXXXXXGXXXXXXXXXXXXXXXXXXXGXXXXXXXXXXXXXXXXXXXGXXXXXXXXXXXXXXXXXXXGXXXXXXXXXXXXXXXXXXX,0,300,0

38325,13,0,13,39,248,0,0,261,201,60,GXXXXXXXXXXXXXXXXXXXGXXXXXXXXXXXXXXXXXXXGXXXXXXXXXXXXXXXXXXXGXXXXXXXXXXXXXXXXXXXGXXXXXXXXXXXXXXXXXXXGXXXXXXXXXXXXXXXXXXXGXXXXXXXXXXXXXXXXXXXGXXXXXXXXXXXXXXXXXXXGXXXXXXXXXXXXXXXXXXXGXXXXXXXXXXXXXXXXXXXGXXXXXXXXXXXXXXXXXXXGXXXXXXXXXXXXXXXXXXXGXXXXXXXXXXXXXXXXXXX,0,300,0
38346,13,0,13,40,247,0,0,260,201,59,GXXXXXXXXXXXXXXXXXXXGXXXXXXXXXXXXXXXXXXXGXXXXXXXXXXXXXXXXXXXGXXXXXXXXXXXXXXXXXXXGXXXXXXXXXXXXXXXXXXXGXXXXXXXXXXXXXXXXXXXGXXXXXXXXXXXXXXXXXXXGXXXXXXXXXXXXXXXXXXXGXXXXXXXXXXXXXXXXXXXGXXXXXXXXXXXXXXXXXXXGXXXXXXXXXXXXXXXXXXXGXXXXXXXXXXXXXXXXXXXGXXXXXXXXXXXXXXXXXXX,0,300,0
38367,13,0,13,36,251,0,0,264,206,58,GXXXXXXXXXXXXXXXXXXXGXXXXXXXXXXXXXXXXXXXGXXXXXXXXXXXXXXXXXXXGXXXXXXXXXXXXXXXXXXXGXXXXXXXXXXXXXXXXXXXGXXXXXXXXXXXXXXXXXXXGXXXXXXXXXXXXXXXXXXXGXXXXXXXXXXXXXXXXXXXGXXXXXXXXXXXXXXXXXXXGXXXXXXXXXXXXXXXXXXXGXXXXXXXXXXXXXXXXXXXGXXXXXXXXXXXXXXXXXXXGXXXXXXXXXXXXXXXXXXX,0,300,0
38388,13,0,13,41,246,0,0,259,206,53,GXXXXXXXXXXXXXXXXXXXGXXXXXXXXXXXXXXXXXXXGXXXXXXXXXXXXXXXXXXXGXXXXXXXXXXXXXXXXXXXGXXXXXXXXXXXXXXXXXXXGXXXXXXXXXXXXXXXXXXXGXXXXXXXXXXXXXXXXXXXGXXXXXXXXXXXXXXXXXXXGXXXXXXXXXXXXXXXXXXXGXXXXXXXXXXXXXXXXXXXGXXXXXXXXXXXXXXXXXXXGXXXXXXXXXXXXXXXXXXXGXXXXXXXXXXXXXXXXXXX,0,300,0
38409,13,0,13,39,248,0,0,261,206,55,GXXXXXXXXXXXXXXXXXXXGXXXXXXXXXXXXXXXXXXXGXXXXXXXXXXXXXXXXXXXGXXXXXXXXXXXXXXXXXXXGXXXXXXXXXXXXXXXXXXXGXXXXXXXXXXXXXXXXXXXGXXXXXXXXXXXXXXXXXXXGXXXXXXXXXXXXXXXXXXXGXXXXXXXXXXXXXXXXXXXGXXXXXXXXXXXXXXXXXXXGXXXXXXXXXXXXXXXXXXXGXXXXXXXXXXXXXXXXXXXGXXXXXXXXXXXXXXXXXXX,0,300,0

38430,13,0,13,34,253,0,0,265,210,55,GXXXXXXXXXXXXXXXXXXXGXXXXXXXXXXXXXXXXXXXGXXXXXXXXXXXXXXXXXXXGXXXXXXXXXXXXXXXXXXXGXXXXXXXXXXXXXXXXXXXGXXXXXXXXXXXXXXXXXXXGXXXXXXXXXXXXXXXXXXXGXXXXXXXXXXXXXXXXXXXGXXXXXXXXXXXXXXXXXXXGXXXXXXXXXXXXXXXXXXXGXXXXXXXXXXXXXXXXXXXGXXXXXXXXXXXXXXXXXXXGXXXXXXXXXXXXXXXXXXX,0,300,0
38451,13,0,13,34,253,0,0,265,209,56,GXXXXXXXXXXXXXXXXXXXGXXXXXXXXXXXXXXXXXXXGXXXXXXXXXXXXXXXXXXXGXXXXXXXXXXXXXXXXXXXGXXXXXXXXXXXXXXXXXXXGXXXXXXXXXXXXXXXXXXXGXXXXXXXXXXXXXXXXXXXGXXXXXXXXXXXXXXXXXXXGXXXXXXXXXXXXXXXXXXXGXXXXXXXXXXXXXXXXXXXGXXXXXXXXXXXXXXXXXXXGXXXXXXXXXXXXXXXXXXXGXXXXXXXXXXXXXXXXXXX,0,300,0
38472,13,0,13,38,249,0,0,261,209,52,GXXXXXXXXXXXXXXXXXXXGXXXXXXXXXXXXXXXXXXXGXXXXXXXXXXXXXXXXXXXGXXXXXXXXXXXXXXXXXXXGXXXXXXXXXXXXXXXXXXXGXXXXXXXXXXXXXXXXXXXGXXXXXXXXXXXXXXXXXXXGXXXXXXXXXXXXXXXXXXXGXXXXXXXXXXXXXXXXXXXGXXXXXXXXXXXXXXXXXXXGXXXXXXXXXXXXXXXXXXXGXXXXXXXXXXXXXXXXXXXGXXXXXXXXXXXXXXXXXXX,0,300,0
38493,13,0,13,38,249,0,0,261,207,54,GXXXXXXXXXXXXXXXXXXXGXXXXXXXXXXXXXXXXXXXGXXXXXXXXXXXXXXXXXXXGXXXXXXXXXXXXXXXXXXXGXXXXXXXXXXXXXXXXXXXGXXXXXXXXXXXXXXXXXXXGXXXXXXXXXXXXXXXXXXXGXXXXXXXXXXXXXXXXXXXGXXXXXXXXXXXXXXXXXXXGXXXXXXXXXXXXXXXXXXXGXXXXXXXXXXXXXXXXXXXGXXXXXXXXXXXXXXXXXXXGXXXXXXXXXXXXXXXXXXX,0,300,0
38514,13,0,13,37,250,0,0,262,203,59,GXXXXXXXXXXXXXXXXXXXGXXXXXXXXXXXXXXXXXXXGXXXXXXXXXXXXXXXXXXXGXXXXXXXXXXXXXXXXXXXGXXXXXXXXXXXXXXXXXXXGXXXXXXXXXXXXXXXXXXXGXXXXXXXXXXXXXXXXXXXGXXXXXXXXXXXXXXXXXXXGXXXXXXXXXXXXXXXXXXXGXXXXXXXXXXXXXXXXXXXGXXXXXXXXXXXXXXXXXXXGXXXXXXXXXXXXXXXXXXXGXXXXXXXXXXXXXXXXXXX,0,300,0

38535,13,0,13,37,250,0,0,262,203,59,GXXXXXXXXXXXXXXXXXXXGXXXXXXXXXXXXXXXXXXXGXXXXXXXXXXXXXXXXXXXGXXXXXXXXXXXXXXXXXXXGXXXXXXXXXXXXXXXXXXXGXXXXXXXXXXXXXXXXXXXGXXXXXXXXXXXXXXXXXXXGXXXXXXXXXXXXXXXXXXXGXXXXXXXXXXXXXXXXXXXGXXXXXXXXXXXXXXXXXXXGXXXXXXXXXXXXXXXXXXXGXXXXXXXXXXXXXXXXXXXGXXXXXXXXXXXXXXXXXXX,0,300,0
38556,13,0,13,36,251,0,0,262,202,60,GXXXXXXXXXXXXXXXXXXXGXXXXXXXXXXXXXXXXXXXGXXXXXXXXXXXXXXXXXXXGXXXXXXXXXXXXXXXXXXXGXXXXXXXXXXXXXXXXXXXGXXXXXXXXXXXXXXXXXXXGXXXXXXXXXXXXXXXXXXXGXXXXXXXXXXXXXXXXXXXGXXXXXXXXXXXXXXXXXXXGXXXXXXXXXXXXXXXXXXXGXXXXXXXXXXXXXXXXXXXGXXXXXXXXXXXXXXXXXXXGXXXXXXXXXXXXXXXXXXX,0,300,0
38577,13,0,13,34,253,0,0,266,202,64,GXXXXXXXXXXXXXXXXXXXGXXXXXXXXXXXXXXXXXXXGXXXXXXXXXXXXXXXXXXXGXXXXXXXXXXXXXXXXXXXGXXXXXXXXXXXXXXXXXXXGXXXXXXXXXXXXXXXXXXXGXXXXXXXXXXXXXXXXXXXGXXXXXXXXXXXXXXXXXXXGXXXXXXXXXXXXXXXXXXXGXXXXXXXXXXXXXXXXXXXGXXXXXXXXXXXXXXXXXXXGXXXXXXXXXXXXXXXXXXXGXXXXXXXXXXXXXXXXXXX,0,300,0
38598,13,0,13,34,253,0,0,265,205,60,GXXXXXXXXXXXXXXXXXXXGXXXXXXXXXXXXXXXXXXXGXXXXXXXXXXXXXXXXXXXGXXXXXXXXXXXXXXXXXXXGXXXXXXXXXXXXXXXXXXXGXXXXXXXXXXXXXXXXXXXGXXXXXXXXXXXXXXXXXXXGXXXXXXXXXXXXXXXXXXXGXXXXXXXXXXXXXXXXXXXGXXXXXXXXXXXXXXXXXXXGXXXXXXXXXXXXXXXXXXXGXXXXXXXXXXXXXXXXXXXGXXXXXXXXXXXXXXXXXXX,0,300,0
38619,13,0,13,36,251,0,0,263,202,61,GXXXXXXXXXXXXXXXXXXXGXXXXXXXXXXXXXXXXXXXGXXXXXXXXXXXXXXXXXXXGXXXXXXXXXXXXXXXXXXXGXXXXXXXXXXXXXXXXXXXGXXXXXXXXXXXXXXXXXXXGXXXXXXXXXXXXXXXXXXXGXXXXXXXXXXXXXXXXXXXGXXXXXXXXXXXXXXXXXXXGXXXXXXXXXXXXXXXXXXXGXXXXXXXXXXXXXXXXXXXGXXXXXXXXXXXXXXXXXXXGXXXXXXXXXXXXXXXXXXX,0,300,0

38640,13,0,13,36,251,0,0,263,204,59,GXXXXXXXXXXXXXXXXXXXGXXXXXXXXXXXXXXXXXXXGXXXXXXXXXXXXXXXXXXXGXXXXXXXXXXXXXXXXXXXGXXXXXXXXXXXXXXXXXXXGXXXXXXXXXXXXXXXXXXXGXXXXXXXXXXXXXXXXXXXGXXXXXXXXXXXXXXXXXXXGXXXXXXXXXXXXXXXXXXXGXXXXXXXXXXXXXXXXXXXGXXXXXXXXXXXXXXXXXXXGXXXXXXXXXXXXXXXXXXXGXXXXXXXXXXXXXXXXXXX,0,300,0
38661,13,0,13,34,253,0,0,265,204,61,GXXXXXXXXXXXXXXXXXXXGXXXXXXXXXXXXXXXXXXXGXXXXXXXXXXXXXXXXXXXGXXXXXXXXXXXXXXXXXXXGXXXXXXXXXXXXXXXXXXXGXXXXXXXXXXXXXXXXXXXGXXXXXXXXXXXXXXXXXXXGXXXXXXXXXXXXXXXXXXXGXXXXXXXXXXXXXXXXXXXGXXXXXXXXXXXXXXXXXXXGXXXXXXXXXXXXXXXXXXXGXXXXXXXXXXXXXXXXXXXGXXXXXXXXXXXXXXXXXXX,0,300,0
38682,13,0,13,31,256,0,0,268,204,64,GXXXXXXXXXXXXXXXXXXXGXXXXXXXXXXXXXXXXXXXGXXXXXXXXXXXXXXXXXXXGXXXXXXXXXXXXXXXXXXXGXXXXXXXXXXXXXXXXXXXGXXXXXXXXXXXXXXXXXXXGXXXXXXXXXXXXXXXXXXXGXXXXXXXXXXXXXXXXXXXGXXXXXXXXXXXXXXXXXXXGXXXXXXXXXXXXXXXXXXXGXXXXXXXXXXXXXXXXXXXGXXXXXXXXXXXXXXXXXXXGXXXXXXXXXXXXXXXXXXX,0,300,0
38703,13,0,13,32,255,0,0,267,202,65,GXXXXXXXXXXXXXXXXXXXGXXXXXXXXXXXXXXXXXXXGXXXXXXXXXXXXXXXXXXXGXXXXXXXXXXXXXXXXXXXGXXXXXXXXXXXXXXXXXXXGXXXXXXXXXXXXXXXXXXXGXXXXXXXXXXXXXXXXXXXGXXXXXXXXXXXXXXXXXXXGXXXXXXXXXXXXXXXXXXXGXXXXXXXXXXXXXXXXXXXGXXXXXXXXXXXXXXXXXXXGXXXXXXXXXXXXXXXXXXXGXXXXXXXXXXXXXXXXXXX,0,300,0
38724,13,0,13,32,255,0,0,267,201,66,GXXXXXXXXXXXXXXXXXXXGXXXXXXXXXXXXXXXXXXXGXXXXXXXXXXXXXXXXXXXGXXXXXXXXXXXXXXXXXXXGXXXXXXXXXXXXXXXXXXXGXXXXXXXXXXXXXXXXXXXGXXXXXXXXXXXXXXXXXXXGXXXXXXXXXXXXXXXXXXXGXXXXXXXXXXXXXXXXXXXGXXXXXXXXXXXXXXXXXXXGXXXXXXXXXXXXXXXXXXXGXXXXXXXXXXXXXXXXXXXGXXXXXXXXXXXXXXXXXXX,0,300,0

38745,13,0,13,33,254,0,0,266,204,62,GXXXXXXXXXXXXXXXXXXXGXXXXXXXXXXXXXXXXXXXGXXXXXXXXXXXXXXXXXXXGXXXXXXXXXXXXXXXXXXXGXXXXXXXXXXXXXXXXXXXGXXXXXXXXXXXXXXXXXXXGXXXXXXXXXXXXXXXXXXXGXXXXXXXXXXXXXXXXXXXGXXXXXXXXXXXXXXXXXXXGXXXXXXXXXXXXXXXXXXXGXXXXXXXXXXXXXXXXXXXGXXXXXXXXXXXXXXXXXXXGXXXXXXXXXXXXXXXXXXX,0,300,0
38766,13,0,13,30,257,0,0,269,204,65,GXXXXXXXXXXXXXXXXXXXGXXXXXXXXXXXXXXXXXXXGXXXXXXXXXXXXXXXXXXXGXXXXXXXXXXXXXXXXXXXGXXXXXXXXXXXXXXXXXXXGXXXXXXXXXXXXXXXXXXXGXXXXXXXXXXXXXXXXXXXGXXXXXXXXXXXXXXXXXXXGXXXXXXXXXXXXXXXXXXXGXXXXXXXXXXXXXXXXXXXGXXXXXXXXXXXXXXXXXXXGXXXXXXXXXXXXXXXXXXXGXXXXXXXXXXXXXXXXXXX,0,300,0
38787,13,0,13,26,261,0,0,272,205,67,GXXXXXXXXXXXXXXXXXXXGXXXXXXXXXXXXXXXXXXXGXXXXXXXXXXXXXXXXXXXGXXXXXXXXXXXXXXXXXXXGXXXXXXXXXXXXXXXXXXXGXXXXXXXXXXXXXXXXXXXGXXXXXXXXXXXXXXXXXXXGXXXXXXXXXXXXXXXXXXXGXXXXXXXXXXXXXXXXXXXGXXXXXXXXXXXXXXXXXXXGXXXXXXXXXXXXXXXXXXXGXXXXXXXXXXXXXXXXXXXGXXXXXXXXXXXXXXXXXXX,0,300,0
38808,13,0,13,28,259,0,0,271,209,62,GXXXXXXXXXXXXXXXXXXXGXXXXXXXXXXXXXXXXXXXGXXXXXXXXXXXXXXXXXXXGXXXXXXXXXXXXXXXXXXXGXXXXXXXXXXXXXXXXXXXGXXXXXXXXXXXXXXXXXXXGXXXXXXXXXXXXXXXXXXXGXXXXXXXXXXXXXXXXXXXGXXXXXXXXXXXXXXXXXXXGXXXXXXXXXXXXXXXXXXXGXXXXXXXXXXXXXXXXXXXGXXXXXXXXXXXXXXXXXXXGXXXXXXXXXXXXXXXXXXX,0,300,0
38829,13,0,13,33,254,0,0,266,204,62,GXXXXXXXXXXXXXXXXXXXGXXXXXXXXXXXXXXXXXXXGXXXXXXXXXXXXXXXXXXXGXXXXXXXXXXXXXXXXXXXGXXXXXXXXXXXXXXXXXXXGXXXXXXXXXXXXXXXXXXXGXXXXXXXXXXXXXXXXXXXGXXXXXXXXXXXXXXXXXXXGXXXXXXXXXXXXXXXXXXXGXXXXXXXXXXXXXXXXXXXGXXXXXXXXXXXXXXXXXXXGXXXXXXXXXXXXXXXXXXXGXXXXXXXXXXXXXXXXXXX,0,300,0

38850,13,0,13,31,256,0,0,268,207,61,GXXXXXXXXXXXXXXXXXXXGXXXXXXXXXXXXXXXXXXXGXXXXXXXXXXXXXXXXXXXGXXXXXXXXXXXXXXXXXXXGXXXXXXXXXXXXXXXXXXXGXXXXXXXXXXXXXXXXXXXGXXXXXXXXXXXXXXXXXXXGXXXXXXXXXXXXXXXXXXXGXXXXXXXXXXXXXXXXXXXGXXXXXXXXXXXXXXXXXXXGXXXXXXXXXXXXXXXXXXXGXXXXXXXXXXXXXXXXXXXGXXXXXXXXXXXXXXXXXXX,0,300,0
38871,13,0,13,29,258,0,0,270,206,64,GXXXXXXXXXXXXXXXXXXXGXXXXXXXXXXXXXXXXXXXGXXXXXXXXXXXXXXXXXXXGXXXXXXXXXXXXXXXXXXXGXXXXXXXXXXXXXXXXXXXGXXXXXXXXXXXXXXXXXXXGXXXXXXXXXXXXXXXXXXXGXXXXXXXXXXXXXXXXXXXGXXXXXXXXXXXXXXXXXXXGXXXXXXXXXXXXXXXXXXXGXXXXXXXXXXXXXXXXXXXGXXXXXXXXXXXXXXXXXXXGXXXXXXXXXXXXXXXXXXX,0,300,0
38892,13,0,13,34,253,0,0,265,207,58,GXXXXXXXXXXXXXXXXXXXGXXXXXXXXXXXXXXXXXXXGXXXXXXXXXXXXXXXXXXXGXXXXXXXXXXXXXXXXXXXGXXXXXXXXXXXXXXXXXXXGXXXXXXXXXXXXXXXXXXXGXXXXXXXXXXXXXXXXXXXGXXXXXXXXXXXXXXXXXXXGXXXXXXXXXXXXXXXXXXXGXXXXXXXXXXXXXXXXXXXGXXXXXXXXXXXXXXXXXXXGXXXXXXXXXXXXXXXXXXXGXXXXXXXXXXXXXXXXXXX,0,300,0
38913,13,0,13,35,252,0,0,264,206,58,GXXXXXXXXXXXXXXXXXXXGXXXXXXXXXXXXXXXXXXXGXXXXXXXXXXXXXXXXXXXGXXXXXXXXXXXXXXXXXXXGXXXXXXXXXXXXXXXXXXXGXXXXXXXXXXXXXXXXXXXGXXXXXXXXXXXXXXXXXXXGXXXXXXXXXXXXXXXXXXXGXXXXXXXXXXXXXXXXXXXGXXXXXXXXXXXXXXXXXXXGXXXXXXXXXXXXXXXXXXXGXXXXXXXXXXXXXXXXXXXGXXXXXXXXXXXXXXXXXXX,0,300,0
38934,13,0,13,34,253,0,0,265,206,59,GXXXXXXXXXXXXXXXXXXXGXXXXXXXXXXXXXXXXXXXGXXXXXXXXXXXXXXXXXXXGXXXXXXXXXXXXXXXXXXXGXXXXXXXXXXXXXXXXXXXGXXXXXXXXXXXXXXXXXXXGXXXXXXXXXXXXXXXXXXXGXXXXXXXXXXXXXXXXXXXGXXXXXXXXXXXXXXXXXXXGXXXXXXXXXXXXXXXXXXXGXXXXXXXXXXXXXXXXXXXGXXXXXXXXXXXXXXXXXXXGXXXXXXXXXXXXXXXXXXX,0,300,0

38955,13,0,13,31,256,0,0,268,205,63,GXXXXXXXXXXXXXXXXXXXGXXXXXXXXXXXXXXXXXXXGXXXXXXXXXXXXXXXXXXXGXXXXXXXXXXXXXXXXXXXGXXXXXXXXXXXXXXXXXXXGXXXXXXXXXXXXXXXXXXXGXXXXXXXXXXXXXXXXXXXGXXXXXXXXXXXXXXXXXXXGXXXXXXXXXXXXXXXXXXXGXXXXXXXXXXXXXXXXXXXGXXXXXXXXXXXXXXXXXXXGXXXXXXXXXXXXXXXXXXXGXXXXXXXXXXXXXXXXXXX,0,300,0
38976,13,0,13,30,257,0,0,268,209,59,GXXXXXXXXXXXXXXXXXXXGXXXXXXXXXXXXXXXXXXXGXXXXXXXXXXXXXXXXXXXGXXXXXXXXXXXXXXXXXXXGXXXXXXXXXXXXXXXXXXXGXXXXXXXXXXXXXXXXXXXGXXXXXXXXXXXXXXXXXXXGXXXXXXXXXXXXXXXXXXXGXXXXXXXXXXXXXXXXXXXGXXXXXXXXXXXXXXXXXXXGXXXXXXXXXXXXXXXXXXXGXXXXXXXXXXXXXXXXXXXGXXXXXXXXXXXXXXXXXXX,0,300,0
38997,13,0,13,37,250,0,0,262,204,58,GXXXXXXXXXXXXXXXXXXXGXXXXXXXXXXXXXXXXXXXGXXXXXXXXXXXXXXXXXXXGXXXXXXXXXXXXXXXXXXXGXXXXXXXXXXXXXXXXXXXGXXXXXXXXXXXXXXXXXXXGXXXXXXXXXXXXXXXXXXXGXXXXXXXXXXXXXXXXXXXGXXXXXXXXXXXXXXXXXXXGXXXXXXXXXXXXXXXXXXXGXXXXXXXXXXXXXXXXXXXGXXXXXXXXXXXXXXXXXXXGXXXXXXXXXXXXXXXXXXX,0,300,0
39018,13,0,13,36,251,0,0,263,207,56,GXXXXXXXXXXXXXXXXXXXGXXXXXXXXXXXXXXXXXXXGXXXXXXXXXXXXXXXXXXXGXXXXXXXXXXXXXXXXXXXGXXXXXXXXXXXXXXXXXXXGXXXXXXXXXXXXXXXXXXXGXXXXXXXXXXXXXXXXXXXGXXXXXXXXXXXXXXXXXXXGXXXXXXXXXXXXXXXXXXXGXXXXXXXXXXXXXXXXXXXGXXXXXXXXXXXXXXXXXXXGXXXXXXXXXXXXXXXXXXXGXXXXXXXXXXXXXXXXXXX,0,300,0
39039,13,0,13,36,251,0,0,263,205,58,GXXXXXXXXXXXXXXXXXXXGXXXXXXXXXXXXXXXXXXXGXXXXXXXXXXXXXXXXXXXGXXXXXXXXXXXXXXXXXXXGXXXXXXXXXXXXXXXXXXXGXXXXXXXXXXXXXXXXXXXGXXXXXXXXXXXXXXXXXXXGXXXXXXXXXXXXXXXXXXXGXXXXXXXXXXXXXXXXXXXGXXXXXXXXXXXXXXXXXXXGXXXXXXXXXXXXXXXXXXXGXXXXXXXXXXXXXXXXXXXGXXXXXXXXXXXXXXXXXXX,0,300,0

39060,13,0,13,38,249,0,0,261,204,57,GXXXXXXXXXXXXXXXXXXXGXXXXXXXXXXXXXXXXXXXGXXXXXXXXXXXXXXXXXXXGXXXXXXXXXXXXXXXXXXXGXXXXXXXXXXXXXXXXXXXGXXXXXXXXXXXXXXXXXXXGXXXXXXXXXXXXXXXXXXXGXXXXXXXXXXXXXXXXXXXGXXXXXXXXXXXXXXXXXXXGXXXXXXXXXXXXXXXXXXXGXXXXXXXXXXXXXXXXXXXGXXXXXXXXXXXXXXXXXXXGXXXXXXXXXXXXXXXXXXX,0,300,0
39081,13,0,13,34,253,0,0,265,206,59,GXXXXXXXXXXXXXXXXXXXGXXXXXXXXXXXXXXXXXXXGXXXXXXXXXXXXXXXXXXXGXXXXXXXXXXXXXXXXXXXGXXXXXXXXXXXXXXXXXXXGXXXXXXXXXXXXXXXXXXXGXXXXXXXXXXXXXXXXXXXGXXXXXXXXXXXXXXXXXXXGXXXXXXXXXXXXXXXXXXXGXXXXXXXXXXXXXXXXXXXGXXXXXXXXXXXXXXXXXXXGXXXXXXXXXXXXXXXXXXXGXXXXXXXXXXXXXXXXXXX,0,300,0
39102,13,0,13,36,251,0,0,263,205,58,GXXXXXXXXXXXXXXXXXXXGXXXXXXXXXXXXXXXXXXXGXXXXXXXXXXXXXXXXXXXGXXXXXXXXXXXXXXXXXXXGXXXXXXXXXXXXXXXXXXXGXXXXXXXXXXXXXXXXXXXGXXXXXXXXXXXXXXXXXXXGXXXXXXXXXXXXXXXXXXXGXXXXXXXXXXXXXXXXXXXGXXXXXXXXXXXXXXXXXXXGXXXXXXXXXXXXXXXXXXXGXXXXXXXXXXXXXXXXXXXGXXXXXXXXXXXXXXXXXXX,0,300,0
39123,13,0,13,38,249,0,0,261,203,58,GXXXXXXXXXXXXXXXXXXXGXXXXXXXXXXXXXXXXXXXGXXXXXXXXXXXXXXXXXXXGXXXXXXXXXXXXXXXXXXXGXXXXXXXXXXXXXXXXXXXGXXXXXXXXXXXXXXXXXXXGXXXXXXXXXXXXXXXXXXXGXXXXXXXXXXXXXXXXXXXGXXXXXXXXXXXXXXXXXXXGXXXXXXXXXXXXXXXXXXXGXXXXXXXXXXXXXXXXXXXGXXXXXXXXXXXXXXXXXXXGXXXXXXXXXXXXXXXXXXX,0,300,0
39144,13,0,13,35,252,0,0,264,206,58,GXXXXXXXXXXXXXXXXXXXGXXXXXXXXXXXXXXXXXXXGXXXXXXXXXXXXXXXXXXXGXXXXXXXXXXXXXXXXXXXGXXXXXXXXXXXXXXXXXXXGXXXXXXXXXXXXXXXXXXXGXXXXXXXXXXXXXXXXXXXGXXXXXXXXXXXXXXXXXXXGXXXXXXXXXXXXXXXXXXXGXXXXXXXXXXXXXXXXXXXGXXXXXXXXXXXXXXXXXXXGXXXXXXXXXXXXXXXXXXXGXXXXXXXXXXXXXXXXXXX,0,300,0

39165,13,0,13,31,256,0,0,267,210,57,GXXXXXXXXXXXXXXXXXXXGXXXXXXXXXXXXXXXXXXXGXXXXXXXXXXXXXXXXXXXGXXXXXXXXXXXXXXXXXXXGXXXXXXXXXXXXXXXXXXXGXXXXXXXXXXXXXXXXXXXGXXXXXXXXXXXXXXXXXXXGXXXXXXXXXXXXXXXXXXXGXXXXXXXXXXXXXXXXXXXGXXXXXXXXXXXXXXXXXXXGXXXXXXXXXXXXXXXXXXXGXXXXXXXXXXXXXXXXXXXGXXXXXXXXXXXXXXXXXXX,0,300,0
39186,13,0,13,33,254,0,0,266,207,59,GXXXXXXXXXXXXXXXXXXXGXXXXXXXXXXXXXXXXXXXGXXXXXXXXXXXXXXXXXXXGXXXXXXXXXXXXXXXXXXXGXXXXXXXXXXXXXXXXXXXGXXXXXXXXXXXXXXXXXXXGXXXXXXXXXXXXXXXXXXXGXXXXXXXXXXXXXXXXXXXGXXXXXXXXXXXXXXXXXXXGXXXXXXXXXXXXXXXXXXXGXXXXXXXXXXXXXXXXXXXGXXXXXXXXXXXXXXXXXXXGXXXXXXXXXXXXXXXXXXX,0,300,0
39207,13,0,13,31,256,0,0,268,209,59,GXXXXXXXXXXXXXXXXXXXGXXXXXXXXXXXXXXXXXXXGXXXXXXXXXXXXXXXXXXXGXXXXXXXXXXXXXXXXXXXGXXXXXXXXXXXXXXXXXXXGXXXXXXXXXXXXXXXXXXXGXXXXXXXXXXXXXXXXXXXGXXXXXXXXXXXXXXXXXXXGXXXXXXXXXXXXXXXXXXXGXXXXXXXXXXXXXXXXXXXGXXXXXXXXXXXXXXXXXXXGXXXXXXXXXXXXXXXXXXXGXXXXXXXXXXXXXXXXXXX,0,300,0
39228,13,0,13,33,254,0,0,266,207,59,GXXXXXXXXXXXXXXXXXXXGXXXXXXXXXXXXXXXXXXXGXXXXXXXXXXXXXXXXXXXGXXXXXXXXXXXXXXXXXXXGXXXXXXXXXXXXXXXXXXXGXXXXXXXXXXXXXXXXXXXGXXXXXXXXXXXXXXXXXXXGXXXXXXXXXXXXXXXXXXXGXXXXXXXXXXXXXXXXXXXGXXXXXXXXXXXXXXXXXXXGXXXXXXXXXXXXXXXXXXXGXXXXXXXXXXXXXXXXXXXGXXXXXXXXXXXXXXXXXXX,0,300,0
39249,13,0,13,34,253,0,0,265,209,56,GXXXXXXXXXXXXXXXXXXXGXXXXXXXXXXXXXXXXXXXGXXXXXXXXXXXXXXXXXXXGXXXXXXXXXXXXXXXXXXXGXXXXXXXXXXXXXXXXXXXGXXXXXXXXXXXXXXXXXXXGXXXXXXXXXXXXXXXXXXXGXXXXXXXXXXXXXXXXXXXGXXXXXXXXXXXXXXXXXXXGXXXXXXXXXXXXXXXXXXXGXXXXXXXXXXXXXXXXXXXGXXXXXXXXXXXXXXXXXXXGXXXXXXXXXXXXXXXXXXX,0,300,0

39270,13,0,13,38,249,0,0,261,202,59,GXXXXXXXXXXXXXXXXXXXGXXXXXXXXXXXXXXXXXXXGXXXXXXXXXXXXXXXXXXXGXXXXXXXXXXXXXXXXXXXGXXXXXXXXXXXXXXXXXXXGXXXXXXXXXXXXXXXXXXXGXXXXXXXXXXXXXXXXXXXGXXXXXXXXXXXXXXXXXXXGXXXXXXXXXXXXXXXXXXXGXXXXXXXXXXXXXXXXXXXGXXXXXXXXXXXXXXXXXXXGXXXXXXXXXXXXXXXXXXXGXXXXXXXXXXXXXXXXXXX,0,300,0
39291,13,0,13,38,249,0,0,261,205,56,GXXXXXXXXXXXXXXXXXXXGXXXXXXXXXXXXXXXXXXXGXXXXXXXXXXXXXXXXXXXGXXXXXXXXXXXXXXXXXXXGXXXXXXXXXXXXXXXXXXXGXXXXXXXXXXXXXXXXXXXGXXXXXXXXXXXXXXXXXXXGXXXXXXXXXXXXXXXXXXXGXXXXXXXXXXXXXXXXXXXGXXXXXXXXXXXXXXXXXXXGXXXXXXXXXXXXXXXXXXXGXXXXXXXXXXXXXXXXXXXGXXXXXXXXXXXXXXXXXXX,0,300,0
39312,14,1,13,36,250,0,0,262,204,58,GAXXXXXXXXXXXXXXXXXXGXXXXXXXXXXXXXXXXXXXGXXXXXXXXXXXXXXXXXXXGXXXXXXXXXXXXXXXXXXXGXXXXXXXXXXXXXXXXXXXGXXXXXXXXXXXXXXXXXXXGXXXXXXXXXXXXXXXXXXXGXXXXXXXXXXXXXXXXXXXGXXXXXXXXXXXXXXXXXXXGXXXXXXXXXXXXXXXXXXXGXXXXXXXXXXXXXXXXXXXGXXXXXXXXXXXXXXXXXXXGXXXXXXXXXXXXXXXXXXX,0,300,0
39333,14,1,13,37,249,0,0,261,205,56,GAXXXXXXXXXXXXXXXXXXGXXXXXXXXXXXXXXXXXXXGXXXXXXXXXXXXXXXXXXXGXXXXXXXXXXXXXXXXXXXGXXXXXXXXXXXXXXXXXXXGXXXXXXXXXXXXXXXXXXXGXXXXXXXXXXXXXXXXXXXGXXXXXXXXXXXXXXXXXXXGXXXXXXXXXXXXXXXXXXXGXXXXXXXXXXXXXXXXXXXGXXXXXXXXXXXXXXXXXXXGXXXXXXXXXXXXXXXXXXXGXXXXXXXXXXXXXXXXXXX,0,300,0
39354,14,1,13,35,251,0,0,263,209,54,GAXXXXXXXXXXXXXXXXXXGXXXXXXXXXXXXXXXXXXXGXXXXXXXXXXXXXXXXXXXGXXXXXXXXXXXXXXXXXXXGXXXXXXXXXXXXXXXXXXXGXXXXXXXXXXXXXXXXXXXGXXXXXXXXXXXXXXXXXXXGXXXXXXXXXXXXXXXXXXXGXXXXXXXXXXXXXXXXXXXGXXXXXXXXXXXXXXXXXXXGXXXXXXXXXXXXXXXXXXXGXXXXXXXXXXXXXXXXXXXGXXXXXXXXXXXXXXXXXXX,0,300,0

39375,14,1,13,35,251,0,0,263,209,54,GAXXXXXXXXXXXXXXXXXXGXXXXXXXXXXXXXXXXXXXGXXXXXXXXXXXXXXXXXXXGXXXXXXXXXXXXXXXXXXXGXXXXXXXXXXXXXXXXXXXGXXXXXXXXXXXXXXXXXXXGXXXXXXXXXXXXXXXXXXXGXXXXXXXXXXXXXXXXXXXGXXXXXXXXXXXXXXXXXXXGXXXXXXXXXXXXXXXXXXXGXXXXXXXXXXXXXXXXXXXGXXXXXXXXXXXXXXXXXXXGXXXXXXXXXXXXXXXXXXX,0,300,0
39396,14,1,13,37,249,0,0,261,207,54,GAXXXXXXXXXXXXXXXXXXGXXXXXXXXXXXXXXXXXXXGXXXXXXXXXXXXXXXXXXXGXXXXXXXXXXXXXXXXXXXGXXXXXXXXXXXXXXXXXXXGXXXXXXXXXXXXXXXXXXXGXXXXXXXXXXXXXXXXXXXGXXXXXXXXXXXXXXXXXXXGXXXXXXXXXXXXXXXXXXXGXXXXXXXXXXXXXXXXXXXGXXXXXXXXXXXXXXXXXXXGXXXXXXXXXXXXXXXXXXXGXXXXXXXXXXXXXXXXXXX,0,300,0
39417,14,1,13,35,251,0,0,263,205,58,GAXXXXXXXXXXXXXXXXXXGXXXXXXXXXXXXXXXXXXXGXXXXXXXXXXXXXXXXXXXGXXXXXXXXXXXXXXXXXXXGXXXXXXXXXXXXXXXXXXXGXXXXXXXXXXXXXXXXXXXGXXXXXXXXXXXXXXXXXXXGXXXXXXXXXXXXXXXXXXXGXXXXXXXXXXXXXXXXXXXGXXXXXXXXXXXXXXXXXXXGXXXXXXXXXXXXXXXXXXXGXXXXXXXXXXXXXXXXXXXGXXXXXXXXXXXXXXXXXXX,0,300,0
39438,14,1,13,32,254,0,0,266,206,60,GAXXXXXXXXXXXXXXXXXXGXXXXXXXXXXXXXXXXXXXGXXXXXXXXXXXXXXXXXXXGXXXXXXXXXXXXXXXXXXXGXXXXXXXXXXXXXXXXXXXGXXXXXXXXXXXXXXXXXXXGXXXXXXXXXXXXXXXXXXXGXXXXXXXXXXXXXXXXXXXGXXXXXXXXXXXXXXXXXXXGXXXXXXXXXXXXXXXXXXXGXXXXXXXXXXXXXXXXXXXGXXXXXXXXXXXXXXXXXXXGXXXXXXXXXXXXXXXXXXX,0,300,0
39459,14,1,13,35,251,0,0,263,204,59,GAXXXXXXXXXXXXXXXXXXGXXXXXXXXXXXXXXXXXXXGXXXXXXXXXXXXXXXXXXXGXXXXXXXXXXXXXXXXXXXGXXXXXXXXXXXXXXXXXXXGXXXXXXXXXXXXXXXXXXXGXXXXXXXXXXXXXXXXXXXGXXXXXXXXXXXXXXXXXXXGXXXXXXXXXXXXXXXXXXXGXXXXXXXXXXXXXXXXXXXGXXXXXXXXXXXXXXXXXXXGXXXXXXXXXXXXXXXXXXXGXXXXXXXXXXXXXXXXXXX,0,300,0

39480,14,1,13,34,252,0,0,264,204,60,GAXXXXXXXXXXXXXXXXXXGXXXXXXXXXXXXXXXXXXXGXXXXXXXXXXXXXXXXXXXGXXXXXXXXXXXXXXXXXXXGXXXXXXXXXXXXXXXXXXXGXXXXXXXXXXXXXXXXXXXGXXXXXXXXXXXXXXXXXXXGXXXXXXXXXXXXXXXXXXXGXXXXXXXXXXXXXXXXXXXGXXXXXXXXXXXXXXXXXXXGXXXXXXXXXXXXXXXXXXXGXXXXXXXXXXXXXXXXXXXGXXXXXXXXXXXXXXXXXXX,0,300,0
39501,14,1,13,34,252,0,0,264,202,62,GAXXXXXXXXXXXXXXXXXXGXXXXXXXXXXXXXXXXXXXGXXXXXXXXXXXXXXXXXXXGXXXXXXXXXXXXXXXXXXXGXXXXXXXXXXXXXXXXXXXGXXXXXXXXXXXXXXXXXXXGXXXXXXXXXXXXXXXXXXXGXXXXXXXXXXXXXXXXXXXGXXXXXXXXXXXXXXXXXXXGXXXXXXXXXXXXXXXXXXXGXXXXXXXXXXXXXXXXXXXGXXXXXXXXXXXXXXXXXXXGXXXXXXXXXXXXXXXXXXX,0,300,0
39522,14,1,13,33,253,0,0,265,204,61,GAXXXXXXXXXXXXXXXXXXGXXXXXXXXXXXXXXXXXXXGXXXXXXXXXXXXXXXXXXXGXXXXXXXXXXXXXXXXXXXGXXXXXXXXXXXXXXXXXXXGXXXXXXXXXXXXXXXXXXXGXXXXXXXXXXXXXXXXXXXGXXXXXXXXXXXXXXXXXXXGXXXXXXXXXXXXXXXXXXXGXXXXXXXXXXXXXXXXXXXGXXXXXXXXXXXXXXXXXXXGXXXXXXXXXXXXXXXXXXXGXXXXXXXXXXXXXXXXXXX,0,300,0
39543,14,1,13,32,254,0,0,265,205,60,GAXXXXXXXXXXXXXXXXXXGXXXXXXXXXXXXXXXXXXXGXXXXXXXXXXXXXXXXXXXGXXXXXXXXXXXXXXXXXXXGXXXXXXXXXXXXXXXXXXXGXXXXXXXXXXXXXXXXXXXGXXXXXXXXXXXXXXXXXXXGXXXXXXXXXXXXXXXXXXXGXXXXXXXXXXXXXXXXXXXGXXXXXXXXXXXXXXXXXXXGXXXXXXXXXXXXXXXXXXXGXXXXXXXXXXXXXXXXXXXGXXXXXXXXXXXXXXXXXXX,0,300,0
39564,15,2,13,29,256,0,0,268,205,63,GAXXXXXXXXXXXXXXXXXXGXXXXXXXXXXXXXXXXXXXGXXXXXXXXXXXXXXXXXXXGXXXXXXXXXXXXXXXXXXXGXXXXXXXXXXXXXXXXXXXGAXXXXXXXXXXXXXXXXXXGXXXXXXXXXXXXXXXXXXXGXXXXXXXXXXXXXXXXXXXGXXXXXXXXXXXXXXXXXXXGXXXXXXXXXXXXXXXXXXXGXXXXXXXXXXXXXXXXXXXGXXXXXXXXXXXXXXXXXXXGXXXXXXXXXXXXXXXXXXX,0,300,0

39585,15,2,13,29,256,0,0,268,204,64,GAXXXXXXXXXXXXXXXXXXGXXXXXXXXXXXXXXXXXXXGXXXXXXXXXXXXXXXXXXXGXXXXXXXXXXXXXXXXXXXGXXXXXXXXXXXXXXXXXXXGAXXXXXXXXXXXXXXXXXXGXXXXXXXXXXXXXXXXXXXGXXXXXXXXXXXXXXXXXXXGXXXXXXXXXXXXXXXXXXXGXXXXXXXXXXXXXXXXXXXGXXXXXXXXXXXXXXXXXXXGXXXXXXXXXXXXXXXXXXXGXXXXXXXXXXXXXXXXXXX,0,300,0
39606,14,1,13,30,256,0,0,268,206,62,GXXXXXXXXXXXXXXXXXXXGXXXXXXXXXXXXXXXXXXXGXXXXXXXXXXXXXXXXXXXGXXXXXXXXXXXXXXXXXXXGXXXXXXXXXXXXXXXXXXXGAXXXXXXXXXXXXXXXXXXGXXXXXXXXXXXXXXXXXXXGXXXXXXXXXXXXXXXXXXXGXXXXXXXXXXXXXXXXXXXGXXXXXXXXXXXXXXXXXXXGXXXXXXXXXXXXXXXXXXXGXXXXXXXXXXXXXXXXXXXGXXXXXXXXXXXXXXXXXXX,0,300,0
39627,14,1,13,29,257,0,0,269,208,61,GXXXXXXXXXXXXXXXXXXXGXXXXXXXXXXXXXXXXXXXGXXXXXXXXXXXXXXXXXXXGXXXXXXXXXXXXXXXXXXXGXXXXXXXXXXXXXXXXXXXGAXXXXXXXXXXXXXXXXXXGXXXXXXXXXXXXXXXXXXXGXXXXXXXXXXXXXXXXXXXGXXXXXXXXXXXXXXXXXXXGXXXXXXXXXXXXXXXXXXXGXXXXXXXXXXXXXXXXXXXGXXXXXXXXXXXXXXXXXXXGXXXXXXXXXXXXXXXXXXX,0,300,0
39648,14,1,13,33,253,0,0,265,208,57,GXXXXXXXXXXXXXXXXXXXGXXXXXXXXXXXXXXXXXXXGXXXXXXXXXXXXXXXXXXXGXXXXXXXXXXXXXXXXXXXGXXXXXXXXXXXXXXXXXXXGAXXXXXXXXXXXXXXXXXXGXXXXXXXXXXXXXXXXXXXGXXXXXXXXXXXXXXXXXXXGXXXXXXXXXXXXXXXXXXXGXXXXXXXXXXXXXXXXXXXGXXXXXXXXXXXXXXXXXXXGXXXXXXXXXXXXXXXXXXXGXXXXXXXXXXXXXXXXXXX,0,300,0
39669,15,2,13,36,249,0,0,261,205,56,GXXXXXXXXXXXXXXXXXXXGXXXXXXXXXXXXXXXXXXXGXXXXXXXXXXXXXXXXXXXGXXXXXXXXXXXXXXXXXXXGXXXXXXXXXXXXXXXXXXXGAXXXXXXXXXXXXXXXXXXGXXXXXXXXXXXXXXXXXXXGXXXXXXXXXXXXXXXXXXXGXXXXXXXXXXXXXXXXXXXGXXXXXXXXXXXXXXXXXXXGAXXXXXXXXXXXXXXXXXXGXXXXXXXXXXXXXXXXXXXGXXXXXXXXXXXXXXXXXXX,0,300,0

39690,15,1,14,31,254,0,0,266,210,56,GXXXXXXXXXXXXXXXXXXXGXXXXXXXXXXXXXXXXXXXGXXXXXXXXXXXXXXXXXXXGXXXXXXXXXXXXXXXXXXXGXXXXXXXXXXXXXXXXXXXGOXXXXXXXXXXXXXXXXXXGXXXXXXXXXXXXXXXXXXXGXXXXXXXXXXXXXXXXXXXGXXXXXXXXXXXXXXXXXXXGXXXXXXXXXXXXXXXXXXXGAXXXXXXXXXXXXXXXXXXGXXXXXXXXXXXXXXXXXXXGXXXXXXXXXXXXXXXXXXX,0,300,0
39711,14,1,13,36,250,0,0,262,203,59,GXXXXXXXXXXXXXXXXXXXGXXXXXXXXXXXXXXXXXXXGXXXXXXXXXXXXXXXXXXXGXXXXXXXXXXXXXXXXXXXGXXXXXXXXXXXXXXXXXXXGXXXXXXXXXXXXXXXXXXXGXXXXXXXXXXXXXXXXXXXGXXXXXXXXXXXXXXXXXXXGXXXXXXXXXXXXXXXXXXXGXXXXXXXXXXXXXXXXXXXGAXXXXXXXXXXXXXXXXXXGXXXXXXXXXXXXXXXXXXXGXXXXXXXXXXXXXXXXXXX,0,300,0
39732,14,1,13,34,252,0,0,264,207,57,GXXXXXXXXXXXXXXXXXXXGXXXXXXXXXXXXXXXXXXXGXXXXXXXXXXXXXXXXXXXGXXXXXXXXXXXXXXXXXXXGXXXXXXXXXXXXXXXXXXXGXXXXXXXXXXXXXXXXXXXGXXXXXXXXXXXXXXXXXXXGXXXXXXXXXXXXXXXXXXXGXXXXXXXXXXXXXXXXXXXGXXXXXXXXXXXXXXXXXXXGAXXXXXXXXXXXXXXXXXXGXXXXXXXXXXXXXXXXXXXGXXXXXXXXXXXXXXXXXXX,0,300,0
39753,14,1,13,29,257,0,0,269,207,62,GXXXXXXXXXXXXXXXXXXXGXXXXXXXXXXXXXXXXXXXGXXXXXXXXXXXXXXXXXXXGXXXXXXXXXXXXXXXXXXXGXXXXXXXXXXXXXXXXXXXGXXXXXXXXXXXXXXXXXXXGXXXXXXXXXXXXXXXXXXXGXXXXXXXXXXXXXXXXXXXGXXXXXXXXXXXXXXXXXXXGXXXXXXXXXXXXXXXXXXXGAXXXXXXXXXXXXXXXXXXGXXXXXXXXXXXXXXXXXXXGXXXXXXXXXXXXXXXXXXX,0,300,0
39774,14,1,13,28,258,0,0,270,207,63,GXXXXXXXXXXXXXXXXXXXGXXXXXXXXXXXXXXXXXXXGXXXXXXXXXXXXXXXXXXXGXXXXXXXXXXXXXXXXXXXGXXXXXXXXXXXXXXXXXXXGXXXXXXXXXXXXXXXXXXXGXXXXXXXXXXXXXXXXXXXGXXXXXXXXXXXXXXXXXXXGXXXXXXXXXXXXXXXXXXXGXXXXXXXXXXXXXXXXXXXGAXXXXXXXXXXXXXXXXXXGXXXXXXXXXXXXXXXXXXXGXXXXXXXXXXXXXXXXXXX,0,300,0

39795,14,1,13,28,258,0,0,270,205,65,GXXXXXXXXXXXXXXXXXXXGXXXXXXXXXXXXXXXXXXXGXXXXXXXXXXXXXXXXXXXGXXXXXXXXXXXXXXXXXXXGXXXXXXXXXXXXXXXXXXXGXXXXXXXXXXXXXXXXXXXGXXXXXXXXXXXXXXXXXXXGXXXXXXXXXXXXXXXXXXXGXXXXXXXXXXXXXXXXXXXGXXXXXXXXXXXXXXXXXXXGAXXXXXXXXXXXXXXXXXXGXXXXXXXXXXXXXXXXXXXGXXXXXXXXXXXXXXXXXXX,0,300,0
39816,14,1,13,25,261,0,0,273,206,67,GXXXXXXXXXXXXXXXXXXXGXXXXXXXXXXXXXXXXXXXGXXXXXXXXXXXXXXXXXXXGXXXXXXXXXXXXXXXXXXXGXXXXXXXXXXXXXXXXXXXGXXXXXXXXXXXXXXXXXXXGXXXXXXXXXXXXXXXXXXXGXXXXXXXXXXXXXXXXXXXGXXXXXXXXXXXXXXXXXXXGXXXXXXXXXXXXXXXXXXXGAXXXXXXXXXXXXXXXXXXGXXXXXXXXXXXXXXXXXXXGXXXXXXXXXXXXXXXXXXX,0,300,0
39837,15,2,13,25,260,0,0,271,206,65,GXXXXXXXXXXXXXXXXXXXGXXXXXXXXXXXXXXXXXXXGXXXXXXXXXXXXXXXXXXXGXXXXXXXXXXXXXXXXXXXGXXXXXXXXXXXXXXXXXXXGXXXXXXXXXXXXXXXXXXXGXXXXXXXXXXXXXXXXXXXGXXXXXXXXXXXXXXXXXXXGXXXXXXXXXXXXXXXXXXXGXXXXXXXXXXXXXXXXXXXGAXXXXXXXXXXXXXXXXXXGAXXXXXXXXXXXXXXXXXXGXXXXXXXXXXXXXXXXXXX,0,300,0
39858,15,2,13,27,258,0,0,270,205,65,GXXXXXXXXXXXXXXXXXXXGXXXXXXXXXXXXXXXXXXXGXXXXXXXXXXXXXXXXXXXGXXXXXXXXXXXXXXXXXXXGXXXXXXXXXXXXXXXXXXXGXXXXXXXXXXXXXXXXXXXGXXXXXXXXXXXXXXXXXXXGXXXXXXXXXXXXXXXXXXXGXXXXXXXXXXXXXXXXXXXGXXXXXXXXXXXXXXXXXXXGAXXXXXXXXXXXXXXXXXXGAXXXXXXXXXXXXXXXXXXGXXXXXXXXXXXXXXXXXXX,0,300,0
39879,15,2,13,30,255,0,0,267,204,63,GXXXXXXXXXXXXXXXXXXXGXXXXXXXXXXXXXXXXXXXGXXXXXXXXXXXXXXXXXXXGXXXXXXXXXXXXXXXXXXXGXXXXXXXXXXXXXXXXXXXGXXXXXXXXXXXXXXXXXXXGXXXXXXXXXXXXXXXXXXXGXXXXXXXXXXXXXXXXXXXGXXXXXXXXXXXXXXXXXXXGXXXXXXXXXXXXXXXXXXXGAXXXXXXXXXXXXXXXXXXGAXXXXXXXXXXXXXXXXXXGXXXXXXXXXXXXXXXXXXX,0,300,0

39900,15,2,13,28,257,0,0,269,205,64,GXXXXXXXXXXXXXXXXXXXGXXXXXXXXXXXXXXXXXXXGXXXXXXXXXXXXXXXXXXXGXXXXXXXXXXXXXXXXXXXGXXXXXXXXXXXXXXXXXXXGXXXXXXXXXXXXXXXXXXXGXXXXXXXXXXXXXXXXXXXGXXXXXXXXXXXXXXXXXXXGXXXXXXXXXXXXXXXXXXXGXXXXXXXXXXXXXXXXXXXGAXXXXXXXXXXXXXXXXXXGAXXXXXXXXXXXXXXXXXXGXXXXXXXXXXXXXXXXXXX,0,300,0
39921,15,2,13,30,255,0,0,267,206,61,GXXXXXXXXXXXXXXXXXXXGXXXXXXXXXXXXXXXXXXXGXXXXXXXXXXXXXXXXXXXGXXXXXXXXXXXXXXXXXXXGXXXXXXXXXXXXXXXXXXXGXXXXXXXXXXXXXXXXXXXGXXXXXXXXXXXXXXXXXXXGXXXXXXXXXXXXXXXXXXXGXXXXXXXXXXXXXXXXXXXGXXXXXXXXXXXXXXXXXXXGAXXXXXXXXXXXXXXXXXXGAXXXXXXXXXXXXXXXXXXGXXXXXXXXXXXXXXXXXXX,0,300,0
39942,15,2,13,28,257,0,0,269,204,65,GXXXXXXXXXXXXXXXXXXXGXXXXXXXXXXXXXXXXXXXGXXXXXXXXXXXXXXXXXXXGXXXXXXXXXXXXXXXXXXXGXXXXXXXXXXXXXXXXXXXGXXXXXXXXXXXXXXXXXXXGXXXXXXXXXXXXXXXXXXXGXXXXXXXXXXXXXXXXXXXGXXXXXXXXXXXXXXXXXXXGXXXXXXXXXXXXXXXXXXXGAXXXXXXXXXXXXXXXXXXGAXXXXXXXXXXXXXXXXXXGXXXXXXXXXXXXXXXXXXX,0,300,0
39963,14,1,13,31,255,0,0,267,205,62,GXXXXXXXXXXXXXXXXXXXGXXXXXXXXXXXXXXXXXXXGXXXXXXXXXXXXXXXXXXXGXXXXXXXXXXXXXXXXXXXGXXXXXXXXXXXXXXXXXXXGXXXXXXXXXXXXXXXXXXXGXXXXXXXXXXXXXXXXXXXGXXXXXXXXXXXXXXXXXXXGXXXXXXXXXXXXXXXXXXXGXXXXXXXXXXXXXXXXXXXGXXXXXXXXXXXXXXXXXXXGAXXXXXXXXXXXXXXXXXXGXXXXXXXXXXXXXXXXXXX,0,300,0
39984,14,1,13,30,256,0,0,268,207,61,GXXXXXXXXXXXXXXXXXXXGXXXXXXXXXXXXXXXXXXXGXXXXXXXXXXXXXXXXXXXGXXXXXXXXXXXXXXXXXXXGXXXXXXXXXXXXXXXXXXXGXXXXXXXXXXXXXXXXXXXGXXXXXXXXXXXXXXXXXXXGXXXXXXXXXXXXXXXXXXXGXXXXXXXXXXXXXXXXXXXGXXXXXXXXXXXXXXXXXXXGXXXXXXXXXXXXXXXXXXXGAXXXXXXXXXXXXXXXXXXGXXXXXXXXXXXXXXXXXXX,0,300,0

40005,14,1,13,33,253,0,0,265,209,56,GXXXXXXXXXXXXXXXXXXXGXXXXXXXXXXXXXXXXXXXGXXXXXXXXXXXXXXXXXXXGXXXXXXXXXXXXXXXXXXXGXXXXXXXXXXXXXXXXXXXGXXXXXXXXXXXXXXXXXXXGXXXXXXXXXXXXXXXXXXXGXXXXXXXXXXXXXXXXXXXGXXXXXXXXXXXXXXXXXXXGXXXXXXXXXXXXXXXXXXXGXXXXXXXXXXXXXXXXXXXGAXXXXXXXXXXXXXXXXXXGXXXXXXXXXXXXXXXXXXX,0,300,0
40026,14,1,13,34,252,0,0,264,207,57,GXXXXXXXXXXXXXXXXXXXGXXXXXXXXXXXXXXXXXXXGXXXXXXXXXXXXXXXXXXXGXXXXXXXXXXXXXXXXXXXGXXXXXXXXXXXXXXXXXXXGXXXXXXXXXXXXXXXXXXXGXXXXXXXXXXXXXXXXXXXGXXXXXXXXXXXXXXXXXXXGXXXXXXXXXXXXXXXXXXXGXXXXXXXXXXXXXXXXXXXGXXXXXXXXXXXXXXXXXXXGAXXXXXXXXXXXXXXXXXXGXXXXXXXXXXXXXXXXXXX,0,300,0
40047,14,1,13,34,252,0,0,263,208,55,GXXXXXXXXXXXXXXXXXXXGXXXXXXXXXXXXXXXXXXXGXXXXXXXXXXXXXXXXXXXGXXXXXXXXXXXXXXXXXXXGXXXXXXXXXXXXXXXXXXXGXXXXXXXXXXXXXXXXXXXGXXXXXXXXXXXXXXXXXXXGXXXXXXXXXXXXXXXXXXXGXXXXXXXXXXXXXXXXXXXGXXXXXXXXXXXXXXXXXXXGXXXXXXXXXXXXXXXXXXXGAXXXXXXXXXXXXXXXXXXGXXXXXXXXXXXXXXXXXXX,0,300,0
40068,14,0,14,34,252,0,0,263,210,53,GXXXXXXXXXXXXXXXXXXXGXXXXXXXXXXXXXXXXXXXGXXXXXXXXXXXXXXXXXXXGXXXXXXXXXXXXXXXXXXXGXXXXXXXXXXXXXXXXXXXGXXXXXXXXXXXXXXXXXXXGXXXXXXXXXXXXXXXXXXXGXXXXXXXXXXXXXXXXXXXGXXXXXXXXXXXXXXXXXXXGXXXXXXXXXXXXXXXXXXXGXXXXXXXXXXXXXXXXXXXGOXXXXXXXXXXXXXXXXXXGXXXXXXXXXXXXXXXXXXX,0,300,0
40089,14,0,14,34,252,0,0,264,210,54,GXXXXXXXXXXXXXXXXXXXGXXXXXXXXXXXXXXXXXXXGXXXXXXXXXXXXXXXXXXXGXXXXXXXXXXXXXXXXXXXGXXXXXXXXXXXXXXXXXXXGXXXXXXXXXXXXXXXXXXXGXXXXXXXXXXXXXXXXXXXGXXXXXXXXXXXXXXXXXXXGXXXXXXXXXXXXXXXXXXXGXXXXXXXXXXXXXXXXXXXGXXXXXXXXXXXXXXXXXXXGOXXXXXXXXXXXXXXXXXXGXXXXXXXXXXXXXXXXXXX,0,300,0

40110,13,0,13,38,249,0,0,261,208,53,GXXXXXXXXXXXXXXXXXXXGXXXXXXXXXXXXXXXXXXXGXXXXXXXXXXXXXXXXXXXGXXXXXXXXXXXXXXXXXXXGXXXXXXXXXXXXXXXXXXXGXXXXXXXXXXXXXXXXXXXGXXXXXXXXXXXXXXXXXXXGXXXXXXXXXXXXXXXXXXXGXXXXXXXXXXXXXXXXXXXGXXXXXXXXXXXXXXXXXXXGXXXXXXXXXXXXXXXXXXXGXXXXXXXXXXXXXXXXXXXGXXXXXXXXXXXXXXXXXXX,0,300,0
40131,13,0,13,34,253,0,0,263,204,59,GXXXXXXXXXXXXXXXXXXXGXXXXXXXXXXXXXXXXXXXGXXXXXXXXXXXXXXXXXXXGXXXXXXXXXXXXXXXXXXXGXXXXXXXXXXXXXXXXXXXGXXXXXXXXXXXXXXXXXXXGXXXXXXXXXXXXXXXXXXXGXXXXXXXXXXXXXXXXXXXGXXXXXXXXXXXXXXXXXXXGXXXXXXXXXXXXXXXXXXXGXXXXXXXXXXXXXXXXXXXGXXXXXXXXXXXXXXXXXXXGXXXXXXXXXXXXXXXXXXX,0,300,0
40152,13,0,13,34,253,0,0,264,207,57,GXXXXXXXXXXXXXXXXXXXGXXXXXXXXXXXXXXXXXXXGXXXXXXXXXXXXXXXXXXXGXXXXXXXXXXXXXXXXXXXGXXXXXXXXXXXXXXXXXXXGXXXXXXXXXXXXXXXXXXXGXXXXXXXXXXXXXXXXXXXGXXXXXXXXXXXXXXXXXXXGXXXXXXXXXXXXXXXXXXXGXXXXXXXXXXXXXXXXXXXGXXXXXXXXXXXXXXXXXXXGXXXXXXXXXXXXXXXXXXXGXXXXXXXXXXXXXXXXXXX,0,300,0
40173,13,0,13,34,253,0,0,265,205,60,GXXXXXXXXXXXXXXXXXXXGXXXXXXXXXXXXXXXXXXXGXXXXXXXXXXXXXXXXXXXGXXXXXXXXXXXXXXXXXXXGXXXXXXXXXXXXXXXXXXXGXXXXXXXXXXXXXXXXXXXGXXXXXXXXXXXXXXXXXXXGXXXXXXXXXXXXXXXXXXXGXXXXXXXXXXXXXXXXXXXGXXXXXXXXXXXXXXXXXXXGXXXXXXXXXXXXXXXXXXXGXXXXXXXXXXXXXXXXXXXGXXXXXXXXXXXXXXXXXXX,0,300,0
40194,13,0,13,34,253,0,0,265,205,60,GXXXXXXXXXXXXXXXXXXXGXXXXXXXXXXXXXXXXXXXGXXXXXXXXXXXXXXXXXXXGXXXXXXXXXXXXXXXXXXXGXXXXXXXXXXXXXXXXXXXGXXXXXXXXXXXXXXXXXXXGXXXXXXXXXXXXXXXXXXXGXXXXXXXXXXXXXXXXXXXGXXXXXXXXXXXXXXXXXXXGXXXXXXXXXXXXXXXXXXXGXXXXXXXXXXXXXXXXXXXGXXXXXXXXXXXXXXXXXXXGXXXXXXXXXXXXXXXXXXX,0,300,0

40215,13,0,13,34,253,0,0,264,204,60,GXXXXXXXXXXXXXXXXXXXGXXXXXXXXXXXXXXXXXXXGXXXXXXXXXXXXXXXXXXXGXXXXXXXXXXXXXXXXXXXGXXXXXXXXXXXXXXXXXXXGXXXXXXXXXXXXXXXXXXXGXXXXXXXXXXXXXXXXXXXGXXXXXXXXXXXXXXXXXXXGXXXXXXXXXXXXXXXXXXXGXXXXXXXXXXXXXXXXXXXGXXXXXXXXXXXXXXXXXXXGXXXXXXXXXXXXXXXXXXXGXXXXXXXXXXXXXXXXXXX,0,300,0
40236,13,0,13,36,251,0,0,263,206,57,GXXXXXXXXXXXXXXXXXXXGXXXXXXXXXXXXXXXXXXXGXXXXXXXXXXXXXXXXXXXGXXXXXXXXXXXXXXXXXXXGXXXXXXXXXXXXXXXXXXXGXXXXXXXXXXXXXXXXXXXGXXXXXXXXXXXXXXXXXXXGXXXXXXXXXXXXXXXXXXXGXXXXXXXXXXXXXXXXXXXGXXXXXXXXXXXXXXXXXXXGXXXXXXXXXXXXXXXXXXXGXXXXXXXXXXXXXXXXXXXGXXXXXXXXXXXXXXXXXXX,0,300,0
40257,13,0,13,34,253,0,0,265,207,58,GXXXXXXXXXXXXXXXXXXXGXXXXXXXXXXXXXXXXXXXGXXXXXXXXXXXXXXXXXXXGXXXXXXXXXXXXXXXXXXXGXXXXXXXXXXXXXXXXXXXGXXXXXXXXXXXXXXXXXXXGXXXXXXXXXXXXXXXXXXXGXXXXXXXXXXXXXXXXXXXGXXXXXXXXXXXXXXXXXXXGXXXXXXXXXXXXXXXXXXXGXXXXXXXXXXXXXXXXXXXGXXXXXXXXXXXXXXXXXXXGXXXXXXXXXXXXXXXXXXX,0,300,0
40278,13,0,13,31,256,0,0,267,209,58,GXXXXXXXXXXXXXXXXXXXGXXXXXXXXXXXXXXXXXXXGXXXXXXXXXXXXXXXXXXXGXXXXXXXXXXXXXXXXXXXGXXXXXXXXXXXXXXXXXXXGXXXXXXXXXXXXXXXXXXXGXXXXXXXXXXXXXXXXXXXGXXXXXXXXXXXXXXXXXXXGXXXXXXXXXXXXXXXXXXXGXXXXXXXXXXXXXXXXXXXGXXXXXXXXXXXXXXXXXXXGXXXXXXXXXXXXXXXXXXXGXXXXXXXXXXXXXXXXXXX,0,300,0
40299,13,0,13,30,257,0,0,269,207,62,GXXXXXXXXXXXXXXXXXXXGXXXXXXXXXXXXXXXXXXXGXXXXXXXXXXXXXXXXXXXGXXXXXXXXXXXXXXXXXXXGXXXXXXXXXXXXXXXXXXXGXXXXXXXXXXXXXXXXXXXGXXXXXXXXXXXXXXXXXXXGXXXXXXXXXXXXXXXXXXXGXXXXXXXXXXXXXXXXXXXGXXXXXXXXXXXXXXXXXXXGXXXXXXXXXXXXXXXXXXXGXXXXXXXXXXXXXXXXXXXGXXXXXXXXXXXXXXXXXXX,0,300,0

40320,13,0,13,30,257,0,0,269,209,60,GXXXXXXXXXXXXXXXXXXXGXXXXXXXXXXXXXXXXXXXGXXXXXXXXXXXXXXXXXXXGXXXXXXXXXXXXXXXXXXXGXXXXXXXXXXXXXXXXXXXGXXXXXXXXXXXXXXXXXXXGXXXXXXXXXXXXXXXXXXXGXXXXXXXXXXXXXXXXXXXGXXXXXXXXXXXXXXXXXXXGXXXXXXXXXXXXXXXXXXXGXXXXXXXXXXXXXXXXXXXGXXXXXXXXXXXXXXXXXXXGXXXXXXXXXXXXXXXXXXX,0,300,0
40341,13,0,13,31,256,0,0,268,207,61,GXXXXXXXXXXXXXXXXXXXGXXXXXXXXXXXXXXXXXXXGXXXXXXXXXXXXXXXXXXXGXXXXXXXXXXXXXXXXXXXGXXXXXXXXXXXXXXXXXXXGXXXXXXXXXXXXXXXXXXXGXXXXXXXXXXXXXXXXXXXGXXXXXXXXXXXXXXXXXXXGXXXXXXXXXXXXXXXXXXXGXXXXXXXXXXXXXXXXXXXGXXXXXXXXXXXXXXXXXXXGXXXXXXXXXXXXXXXXXXXGXXXXXXXXXXXXXXXXXXX,0,300,0
40362,14,1,13,29,257,0,0,269,207,62,GXXXXXXXXXXXXXXXXXXXGXXXXXXXXXXXXXXXXXXXGXXXXXXXXXXXXXXXXXXXGXXXXXXXXXXXXXXXXXXXGXXXXXXXXXXXXXXXXXXXGXXXXXXXXXXXXXXXXXXXGXXXXXXXXXXXXXXXXXXXGXXXXXXXXXXXXXXXXXXXGXXXXXXXXXXXXXXXXXXXGXXXXXXXXXXXXXXXXXXXGXXXXXXXXXXXXXXXXXXXGAXXXXXXXXXXXXXXXXXXGXXXXXXXXXXXXXXXXXXX,0,300,0
40383,14,1,13,32,254,0,0,266,204,62,GXXXXXXXXXXXXXXXXXXXGXXXXXXXXXXXXXXXXXXXGXXXXXXXXXXXXXXXXXXXGXXXXXXXXXXXXXXXXXXXGXXXXXXXXXXXXXXXXXXXGXXXXXXXXXXXXXXXXXXXGXXXXXXXXXXXXXXXXXXXGXXXXXXXXXXXXXXXXXXXGXXXXXXXXXXXXXXXXXXXGXXXXXXXXXXXXXXXXXXXGXXXXXXXXXXXXXXXXXXXGAXXXXXXXXXXXXXXXXXXGXXXXXXXXXXXXXXXXXXX,0,300,0
40404,14,1,13,31,255,0,0,267,204,63,GXXXXXXXXXXXXXXXXXXXGXXXXXXXXXXXXXXXXXXXGXXXXXXXXXXXXXXXXXXXGXXXXXXXXXXXXXXXXXXXGXXXXXXXXXXXXXXXXXXXGXXXXXXXXXXXXXXXXXXXGXXXXXXXXXXXXXXXXXXXGXXXXXXXXXXXXXXXXXXXGXXXXXXXXXXXXXXXXXXXGXXXXXXXXXXXXXXXXXXXGXXXXXXXXXXXXXXXXXXXGAXXXXXXXXXXXXXXXXXXGXXXXXXXXXXXXXXXXXXX,0,300,0

40425,14,1,13,27,259,0,0,271,208,63,GXXXXXXXXXXXXXXXXXXXGXXXXXXXXXXXXXXXXXXXGXXXXXXXXXXXXXXXXXXXGXXXXXXXXXXXXXXXXXXXGXXXXXXXXXXXXXXXXXXXGXXXXXXXXXXXXXXXXXXXGXXXXXXXXXXXXXXXXXXXGXXXXXXXXXXXXXXXXXXXGXXXXXXXXXXXXXXXXXXXGXXXXXXXXXXXXXXXXXXXGXXXXXXXXXXXXXXXXXXXGAXXXXXXXXXXXXXXXXXXGXXXXXXXXXXXXXXXXXXX,0,300,0
40446,14,1,13,29,257,0,0,269,206,63,GXXXXXXXXXXXXXXXXXXXGXXXXXXXXXXXXXXXXXXXGXXXXXXXXXXXXXXXXXXXGXXXXXXXXXXXXXXXXXXXGXXXXXXXXXXXXXXXXXXXGXXXXXXXXXXXXXXXXXXXGXXXXXXXXXXXXXXXXXXXGXXXXXXXXXXXXXXXXXXXGXXXXXXXXXXXXXXXXXXXGXXXXXXXXXXXXXXXXXXXGXXXXXXXXXXXXXXXXXXXGAXXXXXXXXXXXXXXXXXXGXXXXXXXXXXXXXXXXXXX,0,300,0
40467,14,1,13,29,257,0,0,268,208,60,GXXXXXXXXXXXXXXXXXXXGXXXXXXXXXXXXXXXXXXXGXXXXXXXXXXXXXXXXXXXGXXXXXXXXXXXXXXXXXXXGXXXXXXXXXXXXXXXXXXXGXXXXXXXXXXXXXXXXXXXGXXXXXXXXXXXXXXXXXXXGXXXXXXXXXXXXXXXXXXXGXXXXXXXXXXXXXXXXXXXGXXXXXXXXXXXXXXXXXXXGXXXXXXXXXXXXXXXXXXXGAXXXXXXXXXXXXXXXXXXGXXXXXXXXXXXXXXXXXXX,0,300,0
40488,14,1,13,21,265,0,0,276,210,66,GXXXXXXXXXXXXXXXXXXXGXXXXXXXXXXXXXXXXXXXGXXXXXXXXXXXXXXXXXXXGXXXXXXXXXXXXXXXXXXXGXXXXXXXXXXXXXXXXXXXGXXXXXXXXXXXXXXXXXXXGXXXXXXXXXXXXXXXXXXXGXXXXXXXXXXXXXXXXXXXGXXXXXXXXXXXXXXXXXXXGXXXXXXXXXXXXXXXXXXXGXXXXXXXXXXXXXXXXXXXGAXXXXXXXXXXXXXXXXXXGXXXXXXXXXXXXXXXXXXX,0,300,0
40509,14,1,13,20,266,0,0,278,210,68,GXXXXXXXXXXXXXXXXXXXGXXXXXXXXXXXXXXXXXXXGXXXXXXXXXXXXXXXXXXXGXXXXXXXXXXXXXXXXXXXGXXXXXXXXXXXXXXXXXXXGXXXXXXXXXXXXXXXXXXXGXXXXXXXXXXXXXXXXXXXGXXXXXXXXXXXXXXXXXXXGXXXXXXXXXXXXXXXXXXXGXXXXXXXXXXXXXXXXXXXGXXXXXXXXXXXXXXXXXXXGAXXXXXXXXXXXXXXXXXXGXXXXXXXXXXXXXXXXXXX,0,300,0

40530,14,1,13,25,261,0,0,273,212,61,GXXXXXXXXXXXXXXXXXXXGXXXXXXXXXXXXXXXXXXXGXXXXXXXXXXXXXXXXXXXGXXXXXXXXXXXXXXXXXXXGXXXXXXXXXXXXXXXXXXXGXXXXXXXXXXXXXXXXXXXGXXXXXXXXXXXXXXXXXXXGXXXXXXXXXXXXXXXXXXXGXXXXXXXXXXXXXXXXXXXGXXXXXXXXXXXXXXXXXXXGXXXXXXXXXXXXXXXXXXXGAXXXXXXXXXXXXXXXXXXGXXXXXXXXXXXXXXXXXXX,0,300,0
40551,14,1,13,25,261,0,0,273,212,61,GXXXXXXXXXXXXXXXXXXXGXXXXXXXXXXXXXXXXXXXGXXXXXXXXXXXXXXXXXXXGXXXXXXXXXXXXXXXXXXXGXXXXXXXXXXXXXXXXXXXGXXXXXXXXXXXXXXXXXXXGXXXXXXXXXXXXXXXXXXXGXXXXXXXXXXXXXXXXXXXGXXXXXXXXXXXXXXXXXXXGXXXXXXXXXXXXXXXXXXXGXXXXXXXXXXXXXXXXXXXGAXXXXXXXXXXXXXXXXXXGXXXXXXXXXXXXXXXXXXX,0,300,0
40572,14,1,13,29,257,0,0,269,212,57,GXXXXXXXXXXXXXXXXXXXGXXXXXXXXXXXXXXXXXXXGXXXXXXXXXXXXXXXXXXXGXXXXXXXXXXXXXXXXXXXGXXXXXXXXXXXXXXXXXXXGXXXXXXXXXXXXXXXXXXXGXXXXXXXXXXXXXXXXXXXGXXXXXXXXXXXXXXXXXXXGXXXXXXXXXXXXXXXXXXXGXXXXXXXXXXXXXXXXXXXGXXXXXXXXXXXXXXXXXXXGAXXXXXXXXXXXXXXXXXXGXXXXXXXXXXXXXXXXXXX,0,300,0
40593,14,1,13,28,258,0,0,270,211,59,GXXXXXXXXXXXXXXXXXXXGXXXXXXXXXXXXXXXXXXXGXXXXXXXXXXXXXXXXXXXGXXXXXXXXXXXXXXXXXXXGXXXXXXXXXXXXXXXXXXXGXXXXXXXXXXXXXXXXXXXGXXXXXXXXXXXXXXXXXXXGXXXXXXXXXXXXXXXXXXXGXXXXXXXXXXXXXXXXXXXGXXXXXXXXXXXXXXXXXXXGXXXXXXXXXXXXXXXXXXXGAXXXXXXXXXXXXXXXXXXGXXXXXXXXXXXXXXXXXXX,0,300,0
40614,14,1,13,28,258,0,0,270,213,57,GXXXXXXXXXXXXXXXXXXXGXXXXXXXXXXXXXXXXXXXGXXXXXXXXXXXXXXXXXXXGXXXXXXXXXXXXXXXXXXXGXXXXXXXXXXXXXXXXXXXGXXXXXXXXXXXXXXXXXXXGXXXXXXXXXXXXXXXXXXXGXXXXXXXXXXXXXXXXXXXGXXXXXXXXXXXXXXXXXXXGXXXXXXXXXXXXXXXXXXXGXXXXXXXXXXXXXXXXXXXGAXXXXXXXXXXXXXXXXXXGXXXXXXXXXXXXXXXXXXX,0,300,0

40635,14,1,13,29,257,0,0,269,210,59,GXXXXXXXXXXXXXXXXXXXGXXXXXXXXXXXXXXXXXXXGXXXXXXXXXXXXXXXXXXXGXXXXXXXXXXXXXXXXXXXGXXXXXXXXXXXXXXXXXXXGXXXXXXXXXXXXXXXXXXXGXXXXXXXXXXXXXXXXXXXGXXXXXXXXXXXXXXXXXXXGXXXXXXXXXXXXXXXXXXXGXXXXXXXXXXXXXXXXXXXGXXXXXXXXXXXXXXXXXXXGAXXXXXXXXXXXXXXXXXXGXXXXXXXXXXXXXXXXXXX,0,300,0
40656,14,1,13,31,255,0,0,267,209,58,GXXXXXXXXXXXXXXXXXXXGXXXXXXXXXXXXXXXXXXXGXXXXXXXXXXXXXXXXXXXGXXXXXXXXXXXXXXXXXXXGXXXXXXXXXXXXXXXXXXXGXXXXXXXXXXXXXXXXXXXGXXXXXXXXXXXXXXXXXXXGXXXXXXXXXXXXXXXXXXXGXXXXXXXXXXXXXXXXXXXGXXXXXXXXXXXXXXXXXXXGXXXXXXXXXXXXXXXXXXXGAXXXXXXXXXXXXXXXXXXGXXXXXXXXXXXXXXXXXXX,0,300,0
40677,14,1,13,35,251,0,0,263,210,53,GXXXXXXXXXXXXXXXXXXXGXXXXXXXXXXXXXXXXXXXGXXXXXXXXXXXXXXXXXXXGXXXXXXXXXXXXXXXXXXXGXXXXXXXXXXXXXXXXXXXGXXXXXXXXXXXXXXXXXXXGXXXXXXXXXXXXXXXXXXXGXXXXXXXXXXXXXXXXXXXGXXXXXXXXXXXXXXXXXXXGXXXXXXXXXXXXXXXXXXXGXXXXXXXXXXXXXXXXXXXGAXXXXXXXXXXXXXXXXXXGXXXXXXXXXXXXXXXXXXX,0,300,0
40698,14,1,13,31,255,0,0,267,209,58,GXXXXXXXXXXXXXXXXXXXGXXXXXXXXXXXXXXXXXXXGXXXXXXXXXXXXXXXXXXXGXXXXXXXXXXXXXXXXXXXGXXXXXXXXXXXXXXXXXXXGXXXXXXXXXXXXXXXXXXXGXXXXXXXXXXXXXXXXXXXGXXXXXXXXXXXXXXXXXXXGXXXXXXXXXXXXXXXXXXXGXXXXXXXXXXXXXXXXXXXGXXXXXXXXXXXXXXXXXXXGAXXXXXXXXXXXXXXXXXXGXXXXXXXXXXXXXXXXXXX,0,300,0
40719,14,1,13,30,256,0,0,268,208,60,GXXXXXXXXXXXXXXXXXXXGXXXXXXXXXXXXXXXXXXXGXXXXXXXXXXXXXXXXXXXGXXXXXXXXXXXXXXXXXXXGXXXXXXXXXXXXXXXXXXXGXXXXXXXXXXXXXXXXXXXGXXXXXXXXXXXXXXXXXXXGXXXXXXXXXXXXXXXXXXXGXXXXXXXXXXXXXXXXXXXGXXXXXXXXXXXXXXXXXXXGXXXXXXXXXXXXXXXXXXXGAXXXXXXXXXXXXXXXXXXGXXXXXXXXXXXXXXXXXXX,0,300,0

40740,14,0,14,35,251,0,0,263,208,55,GXXXXXXXXXXXXXXXXXXXGXXXXXXXXXXXXXXXXXXXGXXXXXXXXXXXXXXXXXXXGXXXXXXXXXXXXXXXXXXXGXXXXXXXXXXXXXXXXXXXGXXXXXXXXXXXXXXXXXXXGXXXXXXXXXXXXXXXXXXXGXXXXXXXXXXXXXXXXXXXGXXXXXXXXXXXXXXXXXXXGXXXXXXXXXXXXXXXXXXXGXXXXXXXXXXXXXXXXXXXGOXXXXXXXXXXXXXXXXXXGXXXXXXXXXXXXXXXXXXX,0,300,0
40761,13,0,13,39,248,0,0,260,209,51,GXXXXXXXXXXXXXXXXXXXGXXXXXXXXXXXXXXXXXXXGXXXXXXXXXXXXXXXXXXXGXXXXXXXXXXXXXXXXXXXGXXXXXXXXXXXXXXXXXXXGXXXXXXXXXXXXXXXXXXXGXXXXXXXXXXXXXXXXXXXGXXXXXXXXXXXXXXXXXXXGXXXXXXXXXXXXXXXXXXXGXXXXXXXXXXXXXXXXXXXGXXXXXXXXXXXXXXXXXXXGXXXXXXXXXXXXXXXXXXXGXXXXXXXXXXXXXXXXXXX,0,300,0
40782,14,1,13,41,245,0,0,257,207,50,GXXXXXXXXXXXXXXXXXXXGXXXXXXXXXXXXXXXXXXXGXXXXXXXXXXXXXXXXXXXGAXXXXXXXXXXXXXXXXXXGXXXXXXXXXXXXXXXXXXXGXXXXXXXXXXXXXXXXXXXGXXXXXXXXXXXXXXXXXXXGXXXXXXXXXXXXXXXXXXXGXXXXXXXXXXXXXXXXXXXGXXXXXXXXXXXXXXXXXXXGXXXXXXXXXXXXXXXXXXXGXXXXXXXXXXXXXXXXXXXGXXXXXXXXXXXXXXXXXXX,0,300,0
40803,14,1,13,37,249,0,0,260,207,53,GXXXXXXXXXXXXXXXXXXXGXXXXXXXXXXXXXXXXXXXGXXXXXXXXXXXXXXXXXXXGAXXXXXXXXXXXXXXXXXXGXXXXXXXXXXXXXXXXXXXGXXXXXXXXXXXXXXXXXXXGXXXXXXXXXXXXXXXXXXXGXXXXXXXXXXXXXXXXXXXGXXXXXXXXXXXXXXXXXXXGXXXXXXXXXXXXXXXXXXXGXXXXXXXXXXXXXXXXXXXGXXXXXXXXXXXXXXXXXXXGXXXXXXXXXXXXXXXXXXX,0,300,0
40824,14,1,13,33,253,0,0,263,208,55,GXXXXXXXXXXXXXXXXXXXGXXXXXXXXXXXXXXXXXXXGXXXXXXXXXXXXXXXXXXXGAXXXXXXXXXXXXXXXXXXGXXXXXXXXXXXXXXXXXXXGXXXXXXXXXXXXXXXXXXXGXXXXXXXXXXXXXXXXXXXGXXXXXXXXXXXXXXXXXXXGXXXXXXXXXXXXXXXXXXXGXXXXXXXXXXXXXXXXXXXGXXXXXXXXXXXXXXXXXXXGXXXXXXXXXXXXXXXXXXXGXXXXXXXXXXXXXXXXXXX,0,300,0

40845,15,2,13,27,258,0,0,270,208,62,GXXXXXXXXXXXXXXXXXXXGXXXXXXXXXXXXXXXXXXXGXXXXXXXXXXXXXXXXXXXGAAXXXXXXXXXXXXXXXXXGXXXXXXXXXXXXXXXXXXXGXXXXXXXXXXXXXXXXXXXGXXXXXXXXXXXXXXXXXXXGXXXXXXXXXXXXXXXXXXXGXXXXXXXXXXXXXXXXXXXGXXXXXXXXXXXXXXXXXXXGXXXXXXXXXXXXXXXXXXXGXXXXXXXXXXXXXXXXXXXGXXXXXXXXXXXXXXXXXXX,0,300,0
40866,15,2,13,28,257,0,0,268,209,59,GXXXXXXXXXXXXXXXXXXXGXXXXXXXXXXXXXXXXXXXGXXXXXXXXXXXXXXXXXXXGAAXXXXXXXXXXXXXXXXXGXXXXXXXXXXXXXXXXXXXGXXXXXXXXXXXXXXXXXXXGXXXXXXXXXXXXXXXXXXXGXXXXXXXXXXXXXXXXXXXGXXXXXXXXXXXXXXXXXXXGXXXXXXXXXXXXXXXXXXXGXXXXXXXXXXXXXXXXXXXGXXXXXXXXXXXXXXXXXXXGXXXXXXXXXXXXXXXXXXX,0,300,0
40887,14,1,13,27,259,0,0,271,211,60,GXXXXXXXXXXXXXXXXXXXGXXXXXXXXXXXXXXXXXXXGXXXXXXXXXXXXXXXXXXXGXAXXXXXXXXXXXXXXXXXGXXXXXXXXXXXXXXXXXXXGXXXXXXXXXXXXXXXXXXXGXXXXXXXXXXXXXXXXXXXGXXXXXXXXXXXXXXXXXXXGXXXXXXXXXXXXXXXXXXXGXXXXXXXXXXXXXXXXXXXGXXXXXXXXXXXXXXXXXXXGXXXXXXXXXXXXXXXXXXXGXXXXXXXXXXXXXXXXXXX,0,300,0
40908,14,1,13,29,257,0,0,269,211,58,GXXXXXXXXXXXXXXXXXXXGXXXXXXXXXXXXXXXXXXXGXXXXXXXXXXXXXXXXXXXGXAXXXXXXXXXXXXXXXXXGXXXXXXXXXXXXXXXXXXXGXXXXXXXXXXXXXXXXXXXGXXXXXXXXXXXXXXXXXXXGXXXXXXXXXXXXXXXXXXXGXXXXXXXXXXXXXXXXXXXGXXXXXXXXXXXXXXXXXXXGXXXXXXXXXXXXXXXXXXXGXXXXXXXXXXXXXXXXXXXGXXXXXXXXXXXXXXXXXXX,0,300,0
40929,13,0,13,27,260,0,0,272,213,59,GXXXXXXXXXXXXXXXXXXXGXXXXXXXXXXXXXXXXXXXGXXXXXXXXXXXXXXXXXXXGXXXXXXXXXXXXXXXXXXXGXXXXXXXXXXXXXXXXXXXGXXXXXXXXXXXXXXXXXXXGXXXXXXXXXXXXXXXXXXXGXXXXXXXXXXXXXXXXXXXGXXXXXXXXXXXXXXXXXXXGXXXXXXXXXXXXXXXXXXXGXXXXXXXXXXXXXXXXXXXGXXXXXXXXXXXXXXXXXXXGXXXXXXXXXXXXXXXXXXX,0,300,0

40950,14,1,13,22,264,0,0,276,217,59,GXXXXXXXXXXXXXXXXXXXGXXXXXXXXXXXXXXXXXXXGXXXXXXXXXXXXXXXXXXXGXXXXXXXXXXXXXXXXXXXGXXXXXXXXXXXXXXXXXXXGXXXXXXXXXXXXXXXXXXXGXXXXXXXXXXXXXXXXXXXGXXXXXXXXXXXXXXXXXXXGXXXXXXXXXXXXXXXXXXXGXXXXXXXXXXXXXXXXXXXGXXXXXXXXXXXXXXXXXXXGXXXXXXXXXXXXXXXXXXXGAXXXXXXXXXXXXXXXXXX,0,300,0
40971,14,1,13,28,258,0,0,270,215,55,GXXXXXXXXXXXXXXXXXXXGXXXXXXXXXXXXXXXXXXXGXXXXXXXXXXXXXXXXXXXGXXXXXXXXXXXXXXXXXXXGXXXXXXXXXXXXXXXXXXXGXXXXXXXXXXXXXXXXXXXGXXXXXXXXXXXXXXXXXXXGXXXXXXXXXXXXXXXXXXXGXXXXXXXXXXXXXXXXXXXGXXXXXXXXXXXXXXXXXXXGXXXXXXXXXXXXXXXXXXXGXXXXXXXXXXXXXXXXXXXGAXXXXXXXXXXXXXXXXXX,0,300,0
40992,14,1,13,31,255,0,0,266,212,54,GXXXXXXXXXXXXXXXXXXXGXXXXXXXXXXXXXXXXXXXGXXXXXXXXXXXXXXXXXXXGXXXXXXXXXXXXXXXXXXXGXXXXXXXXXXXXXXXXXXXGXXXXXXXXXXXXXXXXXXXGXXXXXXXXXXXXXXXXXXXGXXXXXXXXXXXXXXXXXXXGXXXXXXXXXXXXXXXXXXXGXXXXXXXXXXXXXXXXXXXGXXXXXXXXXXXXXXXXXXXGXXXXXXXXXXXXXXXXXXXGAXXXXXXXXXXXXXXXXXX,0,300,0
41013,14,1,13,27,259,0,0,271,212,59,GXXXXXXXXXXXXXXXXXXXGXXXXXXXXXXXXXXXXXXXGXXXXXXXXXXXXXXXXXXXGXXXXXXXXXXXXXXXXXXXGXXXXXXXXXXXXXXXXXXXGXXXXXXXXXXXXXXXXXXXGXXXXXXXXXXXXXXXXXXXGXXXXXXXXXXXXXXXXXXXGXXXXXXXXXXXXXXXXXXXGXXXXXXXXXXXXXXXXXXXGXXXXXXXXXXXXXXXXXXXGXXXXXXXXXXXXXXXXXXXGAXXXXXXXXXXXXXXXXXX,0,300,0
41034,14,0,14,31,255,0,0,267,208,59,GXXXXXXXXXXXXXXXXXXXGXXXXXXXXXXXXXXXXXXXGXXXXXXXXXXXXXXXXXXXGXXXXXXXXXXXXXXXXXXXGXXXXXXXXXXXXXXXXXXXGXXXXXXXXXXXXXXXXXXXGXXXXXXXXXXXXXXXXXXXGXXXXXXXXXXXXXXXXXXXGXXXXXXXXXXXXXXXXXXXGXXXXXXXXXXXXXXXXXXXGXXXXXXXXXXXXXXXXXXXGXXXXXXXXXXXXXXXXXXXGOXXXXXXXXXXXXXXXXXX,0,300,0

41055,13,0,13,30,257,0,0,269,209,60,GXXXXXXXXXXXXXXXXXXXGXXXXXXXXXXXXXXXXXXXGXXXXXXXXXXXXXXXXXXXGXXXXXXXXXXXXXXXXXXXGXXXXXXXXXXXXXXXXXXXGXXXXXXXXXXXXXXXXXXXGXXXXXXXXXXXXXXXXXXXGXXXXXXXXXXXXXXXXXXXGXXXXXXXXXXXXXXXXXXXGXXXXXXXXXXXXXXXXXXXGXXXXXXXXXXXXXXXXXXXGXXXXXXXXXXXXXXXXXXXGXXXXXXXXXXXXXXXXXXX,0,300,0
41076,13,0,13,27,260,0,0,272,211,61,GXXXXXXXXXXXXXXXXXXXGXXXXXXXXXXXXXXXXXXXGXXXXXXXXXXXXXXXXXXXGXXXXXXXXXXXXXXXXXXXGXXXXXXXXXXXXXXXXXXXGXXXXXXXXXXXXXXXXXXXGXXXXXXXXXXXXXXXXXXXGXXXXXXXXXXXXXXXXXXXGXXXXXXXXXXXXXXXXXXXGXXXXXXXXXXXXXXXXXXXGXXXXXXXXXXXXXXXXXXXGXXXXXXXXXXXXXXXXXXXGXXXXXXXXXXXXXXXXXXX,0,300,0
41097,13,0,13,29,258,0,0,269,210,59,GXXXXXXXXXXXXXXXXXXXGXXXXXXXXXXXXXXXXXXXGXXXXXXXXXXXXXXXXXXXGXXXXXXXXXXXXXXXXXXXGXXXXXXXXXXXXXXXXXXXGXXXXXXXXXXXXXXXXXXXGXXXXXXXXXXXXXXXXXXXGXXXXXXXXXXXXXXXXXXXGXXXXXXXXXXXXXXXXXXXGXXXXXXXXXXXXXXXXXXXGXXXXXXXXXXXXXXXXXXXGXXXXXXXXXXXXXXXXXXXGXXXXXXXXXXXXXXXXXXX,0,300,0
41118,13,0,13,32,255,0,0,267,209,58,GXXXXXXXXXXXXXXXXXXXGXXXXXXXXXXXXXXXXXXXGXXXXXXXXXXXXXXXXXXXGXXXXXXXXXXXXXXXXXXXGXXXXXXXXXXXXXXXXXXXGXXXXXXXXXXXXXXXXXXXGXXXXXXXXXXXXXXXXXXXGXXXXXXXXXXXXXXXXXXXGXXXXXXXXXXXXXXXXXXXGXXXXXXXXXXXXXXXXXXXGXXXXXXXXXXXXXXXXXXXGXXXXXXXXXXXXXXXXXXXGXXXXXXXXXXXXXXXXXXX,0,300,0
41139,13,0,13,26,261,0,0,272,213,59,GXXXXXXXXXXXXXXXXXXXGXXXXXXXXXXXXXXXXXXXGXXXXXXXXXXXXXXXXXXXGXXXXXXXXXXXXXXXXXXXGXXXXXXXXXXXXXXXXXXXGXXXXXXXXXXXXXXXXXXXGXXXXXXXXXXXXXXXXXXXGXXXXXXXXXXXXXXXXXXXGXXXXXXXXXXXXXXXXXXXGXXXXXXXXXXXXXXXXXXXGXXXXXXXXXXXXXXXXXXXGXXXXXXXXXXXXXXXXXXXGXXXXXXXXXXXXXXXXXXX,0,300,0

41160,13,0,13,29,258,0,0,270,210,60,GXXXXXXXXXXXXXXXXXXXGXXXXXXXXXXXXXXXXXXXGXXXXXXXXXXXXXXXXXXXGXXXXXXXXXXXXXXXXXXXGXXXXXXXXXXXXXXXXXXXGXXXXXXXXXXXXXXXXXXXGXXXXXXXXXXXXXXXXXXXGXXXXXXXXXXXXXXXXXXXGXXXXXXXXXXXXXXXXXXXGXXXXXXXXXXXXXXXXXXXGXXXXXXXXXXXXXXXXXXXGXXXXXXXXXXXXXXXXXXXGXXXXXXXXXXXXXXXXXXX,0,300,0
41181,13,0,13,32,255,0,0,268,209,59,GXXXXXXXXXXXXXXXXXXXGXXXXXXXXXXXXXXXXXXXGXXXXXXXXXXXXXXXXXXXGXXXXXXXXXXXXXXXXXXXGXXXXXXXXXXXXXXXXXXXGXXXXXXXXXXXXXXXXXXXGXXXXXXXXXXXXXXXXXXXGXXXXXXXXXXXXXXXXXXXGXXXXXXXXXXXXXXXXXXXGXXXXXXXXXXXXXXXXXXXGXXXXXXXXXXXXXXXXXXXGXXXXXXXXXXXXXXXXXXXGXXXXXXXXXXXXXXXXXXX,0,300,0
41202,13,0,13,32,255,0,0,268,211,57,GXXXXXXXXXXXXXXXXXXXGXXXXXXXXXXXXXXXXXXXGXXXXXXXXXXXXXXXXXXXGXXXXXXXXXXXXXXXXXXXGXXXXXXXXXXXXXXXXXXXGXXXXXXXXXXXXXXXXXXXGXXXXXXXXXXXXXXXXXXXGXXXXXXXXXXXXXXXXXXXGXXXXXXXXXXXXXXXXXXXGXXXXXXXXXXXXXXXXXXXGXXXXXXXXXXXXXXXXXXXGXXXXXXXXXXXXXXXXXXXGXXXXXXXXXXXXXXXXXXX,0,300,0
41223,13,0,13,31,256,0,0,269,207,62,GXXXXXXXXXXXXXXXXXXXGXXXXXXXXXXXXXXXXXXXGXXXXXXXXXXXXXXXXXXXGXXXXXXXXXXXXXXXXXXXGXXXXXXXXXXXXXXXXXXXGXXXXXXXXXXXXXXXXXXXGXXXXXXXXXXXXXXXXXXXGXXXXXXXXXXXXXXXXXXXGXXXXXXXXXXXXXXXXXXXGXXXXXXXXXXXXXXXXXXXGXXXXXXXXXXXXXXXXXXXGXXXXXXXXXXXXXXXXXXXGXXXXXXXXXXXXXXXXXXX,0,300,0
41244,13,0,13,26,261,0,0,274,212,62,GXXXXXXXXXXXXXXXXXXXGXXXXXXXXXXXXXXXXXXXGXXXXXXXXXXXXXXXXXXXGXXXXXXXXXXXXXXXXXXXGXXXXXXXXXXXXXXXXXXXGXXXXXXXXXXXXXXXXXXXGXXXXXXXXXXXXXXXXXXXGXXXXXXXXXXXXXXXXXXXGXXXXXXXXXXXXXXXXXXXGXXXXXXXXXXXXXXXXXXXGXXXXXXXXXXXXXXXXXXXGXXXXXXXXXXXXXXXXXXXGXXXXXXXXXXXXXXXXXXX,0,300,0

41265,13,0,13,27,260,0,0,272,211,61,GXXXXXXXXXXXXXXXXXXXGXXXXXXXXXXXXXXXXXXXGXXXXXXXXXXXXXXXXXXXGXXXXXXXXXXXXXXXXXXXGXXXXXXXXXXXXXXXXXXXGXXXXXXXXXXXXXXXXXXXGXXXXXXXXXXXXXXXXXXXGXXXXXXXXXXXXXXXXXXXGXXXXXXXXXXXXXXXXXXXGXXXXXXXXXXXXXXXXXXXGXXXXXXXXXXXXXXXXXXXGXXXXXXXXXXXXXXXXXXXGXXXXXXXXXXXXXXXXXXX,0,300,0
41286,13,0,13,33,254,0,0,267,204,63,GXXXXXXXXXXXXXXXXXXXGXXXXXXXXXXXXXXXXXXXGXXXXXXXXXXXXXXXXXXXGXXXXXXXXXXXXXXXXXXXGXXXXXXXXXXXXXXXXXXXGXXXXXXXXXXXXXXXXXXXGXXXXXXXXXXXXXXXXXXXGXXXXXXXXXXXXXXXXXXXGXXXXXXXXXXXXXXXXXXXGXXXXXXXXXXXXXXXXXXXGXXXXXXXXXXXXXXXXXXXGXXXXXXXXXXXXXXXXXXXGXXXXXXXXXXXXXXXXXXX,0,300,0
41307,13,0,13,30,257,0,0,268,208,60,GXXXXXXXXXXXXXXXXXXXGXXXXXXXXXXXXXXXXXXXGXXXXXXXXXXXXXXXXXXXGXXXXXXXXXXXXXXXXXXXGXXXXXXXXXXXXXXXXXXXGXXXXXXXXXXXXXXXXXXXGXXXXXXXXXXXXXXXXXXXGXXXXXXXXXXXXXXXXXXXGXXXXXXXXXXXXXXXXXXXGXXXXXXXXXXXXXXXXXXXGXXXXXXXXXXXXXXXXXXXGXXXXXXXXXXXXXXXXXXXGXXXXXXXXXXXXXXXXXXX,0,300,0
41328,14,1,13,30,256,0,0,269,208,61,GXXXXXXXXXXXXXXXXXXXGXXXXXXXXXXXXXXXXXXXGXXXXXXXXXXXXXXXXXXXGXXXXXXXXXXXXXXXXXXXGXXXXXXXXXXXXXXXXXXXGXXXXXXXXXXXXXXXXXXXGXXXXXXXXXXXXXXXXXXXGXXXXXXXXXXXXXXXXXXXGXXXXXXXXXXXXXXXXXXXGXXXXXXXXXXXXXXXXXXXGAXXXXXXXXXXXXXXXXXXGXXXXXXXXXXXXXXXXXXXGXXXXXXXXXXXXXXXXXXX,0,300,0
41349,14,1,13,30,256,0,0,268,208,60,GXXXXXXXXXXXXXXXXXXXGXXXXXXXXXXXXXXXXXXXGXXXXXXXXXXXXXXXXXXXGXXXXXXXXXXXXXXXXXXXGXXXXXXXXXXXXXXXXXXXGXXXXXXXXXXXXXXXXXXXGXXXXXXXXXXXXXXXXXXXGXXXXXXXXXXXXXXXXXXXGXXXXXXXXXXXXXXXXXXXGXXXXXXXXXXXXXXXXXXXGAXXXXXXXXXXXXXXXXXXGXXXXXXXXXXXXXXXXXXXGXXXXXXXXXXXXXXXXXXX,0,300,0

41370,14,1,13,30,256,0,0,269,209,60,GXXXXXXXXXXXXXXXXXXXGXXXXXXXXXXXXXXXXXXXGXXXXXXXXXXXXXXXXXXXGXXXXXXXXXXXXXXXXXXXGXXXXXXXXXXXXXXXXXXXGXXXXXXXXXXXXXXXXXXXGXXXXXXXXXXXXXXXXXXXGXXXXXXXXXXXXXXXXXXXGXXXXXXXXXXXXXXXXXXXGXXXXXXXXXXXXXXXXXXXGAXXXXXXXXXXXXXXXXXXGXXXXXXXXXXXXXXXXXXXGXXXXXXXXXXXXXXXXXXX,0,300,0
41391,14,1,13,33,253,0,0,266,206,60,GXXXXXXXXXXXXXXXXXXXGXXXXXXXXXXXXXXXXXXXGXXXXXXXXXXXXXXXXXXXGXXXXXXXXXXXXXXXXXXXGXXXXXXXXXXXXXXXXXXXGXXXXXXXXXXXXXXXXXXXGXXXXXXXXXXXXXXXXXXXGXXXXXXXXXXXXXXXXXXXGXXXXXXXXXXXXXXXXXXXGXXXXXXXXXXXXXXXXXXXGAXXXXXXXXXXXXXXXXXXGXXXXXXXXXXXXXXXXXXXGXXXXXXXXXXXXXXXXXXX,0,300,0
41412,14,1,13,31,255,0,0,268,209,59,GXXXXXXXXXXXXXXXXXXXGXXXXXXXXXXXXXXXXXXXGXXXXXXXXXXXXXXXXXXXGXXXXXXXXXXXXXXXXXXXGXXXXXXXXXXXXXXXXXXXGXXXXXXXXXXXXXXXXXXXGXXXXXXXXXXXXXXXXXXXGXXXXXXXXXXXXXXXXXXXGXXXXXXXXXXXXXXXXXXXGXXXXXXXXXXXXXXXXXXXGAXXXXXXXXXXXXXXXXXXGXXXXXXXXXXXXXXXXXXXGXXXXXXXXXXXXXXXXXXX,0,300,0
41433,14,1,13,34,252,0,0,265,210,55,GXXXXXXXXXXXXXXXXXXXGXXXXXXXXXXXXXXXXXXXGXXXXXXXXXXXXXXXXXXXGXXXXXXXXXXXXXXXXXXXGXXXXXXXXXXXXXXXXXXXGXXXXXXXXXXXXXXXXXXXGXXXXXXXXXXXXXXXXXXXGXXXXXXXXXXXXXXXXXXXGXXXXXXXXXXXXXXXXXXXGXXXXXXXXXXXXXXXXXXXGAXXXXXXXXXXXXXXXXXXGXXXXXXXXXXXXXXXXXXXGXXXXXXXXXXXXXXXXXXX,0,300,0
41454,14,1,13,32,254,0,0,266,210,56,GXXXXXXXXXXXXXXXXXXXGXXXXXXXXXXXXXXXXXXXGXXXXXXXXXXXXXXXXXXXGXXXXXXXXXXXXXXXXXXXGXXXXXXXXXXXXXXXXXXXGXXXXXXXXXXXXXXXXXXXGXXXXXXXXXXXXXXXXXXXGXXXXXXXXXXXXXXXXXXXGXXXXXXXXXXXXXXXXXXXGXXXXXXXXXXXXXXXXXXXGAXXXXXXXXXXXXXXXXXXGXXXXXXXXXXXXXXXXXXXGXXXXXXXXXXXXXXXXXXX,0,300,0

41475,14,1,13,32,254,0,0,266,213,53,GXXXXXXXXXXXXXXXXXXXGXXXXXXXXXXXXXXXXXXXGXXXXXXXXXXXXXXXXXXXGXXXXXXXXXXXXXXXXXXXGXXXXXXXXXXXXXXXXXXXGXXXXXXXXXXXXXXXXXXXGXXXXXXXXXXXXXXXXXXXGXXXXXXXXXXXXXXXXXXXGXXXXXXXXXXXXXXXXXXXGXXXXXXXXXXXXXXXXXXXGAXXXXXXXXXXXXXXXXXXGXXXXXXXXXXXXXXXXXXXGXXXXXXXXXXXXXXXXXXX,0,300,0
41496,14,1,13,33,253,0,0,265,211,54,GXXXXXXXXXXXXXXXXXXXGXXXXXXXXXXXXXXXXXXXGXXXXXXXXXXXXXXXXXXXGXXXXXXXXXXXXXXXXXXXGXXXXXXXXXXXXXXXXXXXGXXXXXXXXXXXXXXXXXXXGXXXXXXXXXXXXXXXXXXXGXXXXXXXXXXXXXXXXXXXGXXXXXXXXXXXXXXXXXXXGXXXXXXXXXXXXXXXXXXXGAXXXXXXXXXXXXXXXXXXGXXXXXXXXXXXXXXXXXXXGXXXXXXXXXXXXXXXXXXX,0,300,0
41517,14,0,14,34,252,0,0,264,212,52,GXXXXXXXXXXXXXXXXXXXGXXXXXXXXXXXXXXXXXXXGXXXXXXXXXXXXXXXXXXXGXXXXXXXXXXXXXXXXXXXGXXXXXXXXXXXXXXXXXXXGXXXXXXXXXXXXXXXXXXXGXXXXXXXXXXXXXXXXXXXGXXXXXXXXXXXXXXXXXXXGXXXXXXXXXXXXXXXXXXXGXXXXXXXXXXXXXXXXXXXGOXXXXXXXXXXXXXXXXXXGXXXXXXXXXXXXXXXXXXXGXXXXXXXXXXXXXXXXXXX,0,300,0
41538,14,0,14,32,254,0,0,266,213,53,GXXXXXXXXXXXXXXXXXXXGXXXXXXXXXXXXXXXXXXXGXXXXXXXXXXXXXXXXXXXGXXXXXXXXXXXXXXXXXXXGXXXXXXXXXXXXXXXXXXXGXXXXXXXXXXXXXXXXXXXGXXXXXXXXXXXXXXXXXXXGXXXXXXXXXXXXXXXXXXXGXXXXXXXXXXXXXXXXXXXGXXXXXXXXXXXXXXXXXXXGOXXXXXXXXXXXXXXXXXXGXXXXXXXXXXXXXXXXXXXGXXXXXXXXXXXXXXXXXXX,0,300,0
41559,13,0,13,34,253,0,0,265,212,53,GXXXXXXXXXXXXXXXXXXXGXXXXXXXXXXXXXXXXXXXGXXXXXXXXXXXXXXXXXXXGXXXXXXXXXXXXXXXXXXXGXXXXXXXXXXXXXXXXXXXGXXXXXXXXXXXXXXXXXXXGXXXXXXXXXXXXXXXXXXXGXXXXXXXXXXXXXXXXXXXGXXXXXXXXXXXXXXXXXXXGXXXXXXXXXXXXXXXXXXXGXXXXXXXXXXXXXXXXXXXGXXXXXXXXXXXXXXXXXXXGXXXXXXXXXXXXXXXXXXX,0,300,0

41580,13,0,13,33,254,0,0,266,213,53,GXXXXXXXXXXXXXXXXXXXGXXXXXXXXXXXXXXXXXXXGXXXXXXXXXXXXXXXXXXXGXXXXXXXXXXXXXXXXXXXGXXXXXXXXXXXXXXXXXXXGXXXXXXXXXXXXXXXXXXXGXXXXXXXXXXXXXXXXXXXGXXXXXXXXXXXXXXXXXXXGXXXXXXXXXXXXXXXXXXXGXXXXXXXXXXXXXXXXXXXGXXXXXXXXXXXXXXXXXXXGXXXXXXXXXXXXXXXXXXXGXXXXXXXXXXXXXXXXXXX,0,300,0
41601,14,1,13,33,253,0,0,265,211,54,GXXXXXXXXXXXXXXXXXXXGXXXXXXXXXXXXXXXXXXXGXXXXXXXXXXXXXXXXXXXGXXXXXXXXXXXXXXXXXXXGXXXXXXXXXXXXXXXXXXXGXXXXXXXXXXXXXXXXXXXGXXXXXXXXXXXXXXXXXXXGAXXXXXXXXXXXXXXXXXXGXXXXXXXXXXXXXXXXXXXGXXXXXXXXXXXXXXXXXXXGXXXXXXXXXXXXXXXXXXXGXXXXXXXXXXXXXXXXXXXGXXXXXXXXXXXXXXXXXXX,0,300,0
41622,14,1,13,30,256,0,0,268,209,59,GXXXXXXXXXXXXXXXXXXXGXXXXXXXXXXXXXXXXXXXGXXXXXXXXXXXXXXXXXXXGXXXXXXXXXXXXXXXXXXXGXXXXXXXXXXXXXXXXXXXGXXXXXXXXXXXXXXXXXXXGXXXXXXXXXXXXXXXXXXXGAXXXXXXXXXXXXXXXXXXGXXXXXXXXXXXXXXXXXXXGXXXXXXXXXXXXXXXXXXXGXXXXXXXXXXXXXXXXXXXGXXXXXXXXXXXXXXXXXXXGXXXXXXXXXXXXXXXXXXX,0,300,0
41643,14,1,13,29,257,0,0,269,212,57,GXXXXXXXXXXXXXXXXXXXGXXXXXXXXXXXXXXXXXXXGXXXXXXXXXXXXXXXXXXXGXXXXXXXXXXXXXXXXXXXGXXXXXXXXXXXXXXXXXXXGXXXXXXXXXXXXXXXXXXXGXXXXXXXXXXXXXXXXXXXGAXXXXXXXXXXXXXXXXXXGXXXXXXXXXXXXXXXXXXXGXXXXXXXXXXXXXXXXXXXGXXXXXXXXXXXXXXXXXXXGXXXXXXXXXXXXXXXXXXXGXXXXXXXXXXXXXXXXXXX,0,300,0
41664,14,1,13,30,256,0,0,268,214,54,GXXXXXXXXXXXXXXXXXXXGXXXXXXXXXXXXXXXXXXXGXXXXXXXXXXXXXXXXXXXGXXXXXXXXXXXXXXXXXXXGXXXXXXXXXXXXXXXXXXXGXXXXXXXXXXXXXXXXXXXGXXXXXXXXXXXXXXXXXXXGAXXXXXXXXXXXXXXXXXXGXXXXXXXXXXXXXXXXXXXGXXXXXXXXXXXXXXXXXXXGXXXXXXXXXXXXXXXXXXXGXXXXXXXXXXXXXXXXXXXGXXXXXXXXXXXXXXXXXXX,0,300,0

41685,14,1,13,27,259,0,0,270,210,60,GXXXXXXXXXXXXXXXXXXXGXXXXXXXXXXXXXXXXXXXGXXXXXXXXXXXXXXXXXXXGXXXXXXXXXXXXXXXXXXXGXXXXXXXXXXXXXXXXXXXGXXXXXXXXXXXXXXXXXXXGXXXXXXXXXXXXXXXXXXXGAXXXXXXXXXXXXXXXXXXGXXXXXXXXXXXXXXXXXXXGXXXXXXXXXXXXXXXXXXXGXXXXXXXXXXXXXXXXXXXGXXXXXXXXXXXXXXXXXXXGXXXXXXXXXXXXXXXXXXX,0,300,0
41706,14,1,13,28,258,0,0,270,211,59,GXXXXXXXXXXXXXXXXXXXGXXXXXXXXXXXXXXXXXXXGXXXXXXXXXXXXXXXXXXXGXXXXXXXXXXXXXXXXXXXGXXXXXXXXXXXXXXXXXXXGXXXXXXXXXXXXXXXXXXXGXXXXXXXXXXXXXXXXXXXGAXXXXXXXXXXXXXXXXXXGXXXXXXXXXXXXXXXXXXXGXXXXXXXXXXXXXXXXXXXGXXXXXXXXXXXXXXXXXXXGXXXXXXXXXXXXXXXXXXXGXXXXXXXXXXXXXXXXXXX,0,300,0
41727,14,1,13,24,262,0,0,274,209,65,GXXXXXXXXXXXXXXXXXXXGXXXXXXXXXXXXXXXXXXXGXXXXXXXXXXXXXXXXXXXGXXXXXXXXXXXXXXXXXXXGXXXXXXXXXXXXXXXXXXXGXXXXXXXXXXXXXXXXXXXGXXXXXXXXXXXXXXXXXXXGAXXXXXXXXXXXXXXXXXXGXXXXXXXXXXXXXXXXXXXGXXXXXXXXXXXXXXXXXXXGXXXXXXXXXXXXXXXXXXXGXXXXXXXXXXXXXXXXXXXGXXXXXXXXXXXXXXXXXXX,0,300,0
41748,14,1,13,24,262,0,0,274,209,65,GXXXXXXXXXXXXXXXXXXXGXXXXXXXXXXXXXXXXXXXGXXXXXXXXXXXXXXXXXXXGXXXXXXXXXXXXXXXXXXXGXXXXXXXXXXXXXXXXXXXGXXXXXXXXXXXXXXXXXXXGXXXXXXXXXXXXXXXXXXXGAXXXXXXXXXXXXXXXXXXGXXXXXXXXXXXXXXXXXXXGXXXXXXXXXXXXXXXXXXXGXXXXXXXXXXXXXXXXXXXGXXXXXXXXXXXXXXXXXXXGXXXXXXXXXXXXXXXXXXX,0,300,0
41769,14,1,13,26,260,0,0,272,211,61,GXXXXXXXXXXXXXXXXXXXGXXXXXXXXXXXXXXXXXXXGXXXXXXXXXXXXXXXXXXXGXXXXXXXXXXXXXXXXXXXGXXXXXXXXXXXXXXXXXXXGXXXXXXXXXXXXXXXXXXXGXXXXXXXXXXXXXXXXXXXGAXXXXXXXXXXXXXXXXXXGXXXXXXXXXXXXXXXXXXXGXXXXXXXXXXXXXXXXXXXGXXXXXXXXXXXXXXXXXXXGXXXXXXXXXXXXXXXXXXXGXXXXXXXXXXXXXXXXXXX,0,300,0

41790,14,1,13,27,259,0,0,271,211,60,GXXXXXXXXXXXXXXXXXXXGXXXXXXXXXXXXXXXXXXXGXXXXXXXXXXXXXXXXXXXGXXXXXXXXXXXXXXXXXXXGXXXXXXXXXXXXXXXXXXXGXXXXXXXXXXXXXXXXXXXGXXXXXXXXXXXXXXXXXXXGAXXXXXXXXXXXXXXXXXXGXXXXXXXXXXXXXXXXXXXGXXXXXXXXXXXXXXXXXXXGXXXXXXXXXXXXXXXXXXXGXXXXXXXXXXXXXXXXXXXGXXXXXXXXXXXXXXXXXXX,0,300,0
41811,14,1,13,28,258,0,0,270,213,57,GXXXXXXXXXXXXXXXXXXXGXXXXXXXXXXXXXXXXXXXGXXXXXXXXXXXXXXXXXXXGXXXXXXXXXXXXXXXXXXXGXXXXXXXXXXXXXXXXXXXGXXXXXXXXXXXXXXXXXXXGXXXXXXXXXXXXXXXXXXXGAXXXXXXXXXXXXXXXXXXGXXXXXXXXXXXXXXXXXXXGXXXXXXXXXXXXXXXXXXXGXXXXXXXXXXXXXXXXXXXGXXXXXXXXXXXXXXXXXXXGXXXXXXXXXXXXXXXXXXX,0,300,0
41832,14,1,13,33,253,0,0,265,211,54,GXXXXXXXXXXXXXXXXXXXGXXXXXXXXXXXXXXXXXXXGXXXXXXXXXXXXXXXXXXXGXXXXXXXXXXXXXXXXXXXGXXXXXXXXXXXXXXXXXXXGXXXXXXXXXXXXXXXXXXXGXXXXXXXXXXXXXXXXXXXGAXXXXXXXXXXXXXXXXXXGXXXXXXXXXXXXXXXXXXXGXXXXXXXXXXXXXXXXXXXGXXXXXXXXXXXXXXXXXXXGXXXXXXXXXXXXXXXXXXXGXXXXXXXXXXXXXXXXXXX,0,300,0
41853,14,1,13,34,252,0,0,264,210,54,GXXXXXXXXXXXXXXXXXXXGXXXXXXXXXXXXXXXXXXXGXXXXXXXXXXXXXXXXXXXGXXXXXXXXXXXXXXXXXXXGXXXXXXXXXXXXXXXXXXXGXXXXXXXXXXXXXXXXXXXGXXXXXXXXXXXXXXXXXXXGAXXXXXXXXXXXXXXXXXXGXXXXXXXXXXXXXXXXXXXGXXXXXXXXXXXXXXXXXXXGXXXXXXXXXXXXXXXXXXXGXXXXXXXXXXXXXXXXXXXGXXXXXXXXXXXXXXXXXXX,0,300,0
41874,14,1,13,34,252,0,0,264,209,55,GXXXXXXXXXXXXXXXXXXXGXXXXXXXXXXXXXXXXXXXGXXXXXXXXXXXXXXXXXXXGXXXXXXXXXXXXXXXXXXXGXXXXXXXXXXXXXXXXXXXGXXXXXXXXXXXXXXXXXXXGXXXXXXXXXXXXXXXXXXXGAXXXXXXXXXXXXXXXXXXGXXXXXXXXXXXXXXXXXXXGXXXXXXXXXXXXXXXXXXXGXXXXXXXXXXXXXXXXXXXGXXXXXXXXXXXXXXXXXXXGXXXXXXXXXXXXXXXXXXX,0,300,0

41895,14,1,13,30,256,0,0,268,211,57,GXXXXXXXXXXXXXXXXXXXGXXXXXXXXXXXXXXXXXXXGXXXXXXXXXXXXXXXXXXXGXXXXXXXXXXXXXXXXXXXGXXXXXXXXXXXXXXXXXXXGXXXXXXXXXXXXXXXXXXXGXXXXXXXXXXXXXXXXXXXGAXXXXXXXXXXXXXXXXXXGXXXXXXXXXXXXXXXXXXXGXXXXXXXXXXXXXXXXXXXGXXXXXXXXXXXXXXXXXXXGXXXXXXXXXXXXXXXXXXXGXXXXXXXXXXXXXXXXXXX,0,300,0
41916,14,1,13,29,257,0,0,269,210,59,GXXXXXXXXXXXXXXXXXXXGXXXXXXXXXXXXXXXXXXXGXXXXXXXXXXXXXXXXXXXGXXXXXXXXXXXXXXXXXXXGXXXXXXXXXXXXXXXXXXXGXXXXXXXXXXXXXXXXXXXGXXXXXXXXXXXXXXXXXXXGAXXXXXXXXXXXXXXXXXXGXXXXXXXXXXXXXXXXXXXGXXXXXXXXXXXXXXXXXXXGXXXXXXXXXXXXXXXXXXXGXXXXXXXXXXXXXXXXXXXGXXXXXXXXXXXXXXXXXXX,0,300,0
41937,14,0,14,26,260,0,0,272,215,57,GXXXXXXXXXXXXXXXXXXXGXXXXXXXXXXXXXXXXXXXGXXXXXXXXXXXXXXXXXXXGXXXXXXXXXXXXXXXXXXXGXXXXXXXXXXXXXXXXXXXGXXXXXXXXXXXXXXXXXXXGXXXXXXXXXXXXXXXXXXXGOXXXXXXXXXXXXXXXXXXGXXXXXXXXXXXXXXXXXXXGXXXXXXXXXXXXXXXXXXXGXXXXXXXXXXXXXXXXXXXGXXXXXXXXXXXXXXXXXXXGXXXXXXXXXXXXXXXXXXX,0,300,0
41958,13,0,13,26,261,0,0,273,218,55,GXXXXXXXXXXXXXXXXXXXGXXXXXXXXXXXXXXXXXXXGXXXXXXXXXXXXXXXXXXXGXXXXXXXXXXXXXXXXXXXGXXXXXXXXXXXXXXXXXXXGXXXXXXXXXXXXXXXXXXXGXXXXXXXXXXXXXXXXXXXGXXXXXXXXXXXXXXXXXXXGXXXXXXXXXXXXXXXXXXXGXXXXXXXXXXXXXXXXXXXGXXXXXXXXXXXXXXXXXXXGXXXXXXXXXXXXXXXXXXXGXXXXXXXXXXXXXXXXXXX,0,300,0
41979,13,0,13,28,259,0,0,272,218,54,GXXXXXXXXXXXXXXXXXXXGXXXXXXXXXXXXXXXXXXXGXXXXXXXXXXXXXXXXXXXGXXXXXXXXXXXXXXXXXXXGXXXXXXXXXXXXXXXXXXXGXXXXXXXXXXXXXXXXXXXGXXXXXXXXXXXXXXXXXXXGXXXXXXXXXXXXXXXXXXXGXXXXXXXXXXXXXXXXXXXGXXXXXXXXXXXXXXXXXXXGXXXXXXXXXXXXXXXXXXXGXXXXXXXXXXXXXXXXXXXGXXXXXXXXXXXXXXXXXXX,0,300,0

42000,13,0,13,35,252,0,0,264,211,53,GXXXXXXXXXXXXXXXXXXXGXXXXXXXXXXXXXXXXXXXGXXXXXXXXXXXXXXXXXXXGXXXXXXXXXXXXXXXXXXXGXXXXXXXXXXXXXXXXXXXGXXXXXXXXXXXXXXXXXXXGXXXXXXXXXXXXXXXXXXXGXXXXXXXXXXXXXXXXXXXGXXXXXXXXXXXXXXXXXXXGXXXXXXXXXXXXXXXXXXXGXXXXXXXXXXXXXXXXXXXGXXXXXXXXXXXXXXXXXXXGXXXXXXXXXXXXXXXXXXX,0,300,0
42021,14,1,13,36,250,0,0,263,210,53,GXXXXXXXXXXXXXXXXXXXGXXXXXXXXXXXXXXXXXXXGXXXXXXXXXXXXXXXXXXXGXXXXXXXXXXXXXXXXXXXGXXXXXXXXXXXXXXXXXXXGXXXXXXXXXXXXXXXXXXXGXXXXXXXXXXXXXXXXXXXGXXXXXXXXXXXXXXXXXXXGAXXXXXXXXXXXXXXXXXXGXXXXXXXXXXXXXXXXXXXGXXXXXXXXXXXXXXXXXXXGXXXXXXXXXXXXXXXXXXXGXXXXXXXXXXXXXXXXXXX,0,300,0
42042,14,1,13,30,256,0,0,269,210,59,GXXXXXXXXXXXXXXXXXXXGXXXXXXXXXXXXXXXXXXXGXXXXXXXXXXXXXXXXXXXGXXXXXXXXXXXXXXXXXXXGXXXXXXXXXXXXXXXXXXXGXXXXXXXXXXXXXXXXXXXGXXXXXXXXXXXXXXXXXXXGXXXXXXXXXXXXXXXXXXXGAXXXXXXXXXXXXXXXXXXGXXXXXXXXXXXXXXXXXXXGXXXXXXXXXXXXXXXXXXXGXXXXXXXXXXXXXXXXXXXGXXXXXXXXXXXXXXXXXXX,0,300,0
42063,14,1,13,29,257,0,0,270,210,60,GXXXXXXXXXXXXXXXXXXXGXXXXXXXXXXXXXXXXXXXGXXXXXXXXXXXXXXXXXXXGXXXXXXXXXXXXXXXXXXXGXXXXXXXXXXXXXXXXXXXGXXXXXXXXXXXXXXXXXXXGXXXXXXXXXXXXXXXXXXXGXXXXXXXXXXXXXXXXXXXGAXXXXXXXXXXXXXXXXXXGXXXXXXXXXXXXXXXXXXXGXXXXXXXXXXXXXXXXXXXGXXXXXXXXXXXXXXXXXXXGXXXXXXXXXXXXXXXXXXX,0,300,0
42084,14,1,13,34,252,0,0,265,210,55,GXXXXXXXXXXXXXXXXXXXGXXXXXXXXXXXXXXXXXXXGXXXXXXXXXXXXXXXXXXXGXXXXXXXXXXXXXXXXXXXGXXXXXXXXXXXXXXXXXXXGXXXXXXXXXXXXXXXXXXXGXXXXXXXXXXXXXXXXXXXGXXXXXXXXXXXXXXXXXXXGAXXXXXXXXXXXXXXXXXXGXXXXXXXXXXXXXXXXXXXGXXXXXXXXXXXXXXXXXXXGXXXXXXXXXXXXXXXXXXXGXXXXXXXXXXXXXXXXXXX,0,300,0

42105,14,1,13,32,254,0,0,267,211,56,GXXXXXXXXXXXXXXXXXXXGXXXXXXXXXXXXXXXXXXXGXXXXXXXXXXXXXXXXXXXGXXXXXXXXXXXXXXXXXXXGXXXXXXXXXXXXXXXXXXXGXXXXXXXXXXXXXXXXXXXGXXXXXXXXXXXXXXXXXXXGXXXXXXXXXXXXXXXXXXXGAXXXXXXXXXXXXXXXXXXGXXXXXXXXXXXXXXXXXXXGXXXXXXXXXXXXXXXXXXXGXXXXXXXXXXXXXXXXXXXGXXXXXXXXXXXXXXXXXXX,0,300,0
42126,14,1,13,32,254,0,0,266,210,56,GXXXXXXXXXXXXXXXXXXXGXXXXXXXXXXXXXXXXXXXGXXXXXXXXXXXXXXXXXXXGXXXXXXXXXXXXXXXXXXXGXXXXXXXXXXXXXXXXXXXGXXXXXXXXXXXXXXXXXXXGXXXXXXXXXXXXXXXXXXXGXXXXXXXXXXXXXXXXXXXGAXXXXXXXXXXXXXXXXXXGXXXXXXXXXXXXXXXXXXXGXXXXXXXXXXXXXXXXXXXGXXXXXXXXXXXXXXXXXXXGXXXXXXXXXXXXXXXXXXX,0,300,0
42147,14,0,14,32,254,0,0,266,212,54,GXXXXXXXXXXXXXXXXXXXGXXXXXXXXXXXXXXXXXXXGXXXXXXXXXXXXXXXXXXXGXXXXXXXXXXXXXXXXXXXGXXXXXXXXXXXXXXXXXXXGXXXXXXXXXXXXXXXXXXXGXXXXXXXXXXXXXXXXXXXGXXXXXXXXXXXXXXXXXXXGOXXXXXXXXXXXXXXXXXXGXXXXXXXXXXXXXXXXXXXGXXXXXXXXXXXXXXXXXXXGXXXXXXXXXXXXXXXXXXXGXXXXXXXXXXXXXXXXXXX,0,300,0
42168,13,0,13,32,255,0,0,267,210,57,GXXXXXXXXXXXXXXXXXXXGXXXXXXXXXXXXXXXXXXXGXXXXXXXXXXXXXXXXXXXGXXXXXXXXXXXXXXXXXXXGXXXXXXXXXXXXXXXXXXXGXXXXXXXXXXXXXXXXXXXGXXXXXXXXXXXXXXXXXXXGXXXXXXXXXXXXXXXXXXXGXXXXXXXXXXXXXXXXXXXGXXXXXXXXXXXXXXXXXXXGXXXXXXXXXXXXXXXXXXXGXXXXXXXXXXXXXXXXXXXGXXXXXXXXXXXXXXXXXXX,0,300,0
42189,13,0,13,34,253,0,0,265,209,56,GXXXXXXXXXXXXXXXXXXXGXXXXXXXXXXXXXXXXXXXGXXXXXXXXXXXXXXXXXXXGXXXXXXXXXXXXXXXXXXXGXXXXXXXXXXXXXXXXXXXGXXXXXXXXXXXXXXXXXXXGXXXXXXXXXXXXXXXXXXXGXXXXXXXXXXXXXXXXXXXGXXXXXXXXXXXXXXXXXXXGXXXXXXXXXXXXXXXXXXXGXXXXXXXXXXXXXXXXXXXGXXXXXXXXXXXXXXXXXXXGXXXXXXXXXXXXXXXXXXX,0,300,0

42210,13,0,13,34,253,0,0,265,209,56,GXXXXXXXXXXXXXXXXXXXGXXXXXXXXXXXXXXXXXXXGXXXXXXXXXXXXXXXXXXXGXXXXXXXXXXXXXXXXXXXGXXXXXXXXXXXXXXXXXXXGXXXXXXXXXXXXXXXXXXXGXXXXXXXXXXXXXXXXXXXGXXXXXXXXXXXXXXXXXXXGXXXXXXXXXXXXXXXXXXXGXXXXXXXXXXXXXXXXXXXGXXXXXXXXXXXXXXXXXXXGXXXXXXXXXXXXXXXXXXXGXXXXXXXXXXXXXXXXXXX,0,300,0
42231,13,0,13,32,255,0,0,267,208,59,GXXXXXXXXXXXXXXXXXXXGXXXXXXXXXXXXXXXXXXXGXXXXXXXXXXXXXXXXXXXGXXXXXXXXXXXXXXXXXXXGXXXXXXXXXXXXXXXXXXXGXXXXXXXXXXXXXXXXXXXGXXXXXXXXXXXXXXXXXXXGXXXXXXXXXXXXXXXXXXXGXXXXXXXXXXXXXXXXXXXGXXXXXXXXXXXXXXXXXXXGXXXXXXXXXXXXXXXXXXXGXXXXXXXXXXXXXXXXXXXGXXXXXXXXXXXXXXXXXXX,0,300,0
42252,13,0,13,29,258,0,0,270,211,59,GXXXXXXXXXXXXXXXXXXXGXXXXXXXXXXXXXXXXXXXGXXXXXXXXXXXXXXXXXXXGXXXXXXXXXXXXXXXXXXXGXXXXXXXXXXXXXXXXXXXGXXXXXXXXXXXXXXXXXXXGXXXXXXXXXXXXXXXXXXXGXXXXXXXXXXXXXXXXXXXGXXXXXXXXXXXXXXXXXXXGXXXXXXXXXXXXXXXXXXXGXXXXXXXXXXXXXXXXXXXGXXXXXXXXXXXXXXXXXXXGXXXXXXXXXXXXXXXXXXX,0,300,0
42273,13,0,13,29,258,0,0,269,208,61,GXXXXXXXXXXXXXXXXXXXGXXXXXXXXXXXXXXXXXXXGXXXXXXXXXXXXXXXXXXXGXXXXXXXXXXXXXXXXXXXGXXXXXXXXXXXXXXXXXXXGXXXXXXXXXXXXXXXXXXXGXXXXXXXXXXXXXXXXXXXGXXXXXXXXXXXXXXXXXXXGXXXXXXXXXXXXXXXXXXXGXXXXXXXXXXXXXXXXXXXGXXXXXXXXXXXXXXXXXXXGXXXXXXXXXXXXXXXXXXXGXXXXXXXXXXXXXXXXXXX,0,300,0
42294,13,0,13,28,259,0,0,271,210,61,GXXXXXXXXXXXXXXXXXXXGXXXXXXXXXXXXXXXXXXXGXXXXXXXXXXXXXXXXXXXGXXXXXXXXXXXXXXXXXXXGXXXXXXXXXXXXXXXXXXXGXXXXXXXXXXXXXXXXXXXGXXXXXXXXXXXXXXXXXXXGXXXXXXXXXXXXXXXXXXXGXXXXXXXXXXXXXXXXXXXGXXXXXXXXXXXXXXXXXXXGXXXXXXXXXXXXXXXXXXXGXXXXXXXXXXXXXXXXXXXGXXXXXXXXXXXXXXXXXXX,0,300,0

42315,13,0,13,28,259,0,0,271,212,59,GXXXXXXXXXXXXXXXXXXXGXXXXXXXXXXXXXXXXXXXGXXXXXXXXXXXXXXXXXXXGXXXXXXXXXXXXXXXXXXXGXXXXXXXXXXXXXXXXXXXGXXXXXXXXXXXXXXXXXXXGXXXXXXXXXXXXXXXXXXXGXXXXXXXXXXXXXXXXXXXGXXXXXXXXXXXXXXXXXXXGXXXXXXXXXXXXXXXXXXXGXXXXXXXXXXXXXXXXXXXGXXXXXXXXXXXXXXXXXXXGXXXXXXXXXXXXXXXXXXX,0,300,0
42336,13,0,13,26,261,0,0,273,211,62,GXXXXXXXXXXXXXXXXXXXGXXXXXXXXXXXXXXXXXXXGXXXXXXXXXXXXXXXXXXXGXXXXXXXXXXXXXXXXXXXGXXXXXXXXXXXXXXXXXXXGXXXXXXXXXXXXXXXXXXXGXXXXXXXXXXXXXXXXXXXGXXXXXXXXXXXXXXXXXXXGXXXXXXXXXXXXXXXXXXXGXXXXXXXXXXXXXXXXXXXGXXXXXXXXXXXXXXXXXXXGXXXXXXXXXXXXXXXXXXXGXXXXXXXXXXXXXXXXXXX,0,300,0
42357,13,0,13,27,260,0,0,272,210,62,GXXXXXXXXXXXXXXXXXXXGXXXXXXXXXXXXXXXXXXXGXXXXXXXXXXXXXXXXXXXGXXXXXXXXXXXXXXXXXXXGXXXXXXXXXXXXXXXXXXXGXXXXXXXXXXXXXXXXXXXGXXXXXXXXXXXXXXXXXXXGXXXXXXXXXXXXXXXXXXXGXXXXXXXXXXXXXXXXXXXGXXXXXXXXXXXXXXXXXXXGXXXXXXXXXXXXXXXXXXXGXXXXXXXXXXXXXXXXXXXGXXXXXXXXXXXXXXXXXXX,0,300,0
42378,13,0,13,27,260,0,0,272,214,58,GXXXXXXXXXXXXXXXXXXXGXXXXXXXXXXXXXXXXXXXGXXXXXXXXXXXXXXXXXXXGXXXXXXXXXXXXXXXXXXXGXXXXXXXXXXXXXXXXXXXGXXXXXXXXXXXXXXXXXXXGXXXXXXXXXXXXXXXXXXXGXXXXXXXXXXXXXXXXXXXGXXXXXXXXXXXXXXXXXXXGXXXXXXXXXXXXXXXXXXXGXXXXXXXXXXXXXXXXXXXGXXXXXXXXXXXXXXXXXXXGXXXXXXXXXXXXXXXXXXX,0,300,0
42399,13,0,13,27,260,0,0,271,216,55,GXXXXXXXXXXXXXXXXXXXGXXXXXXXXXXXXXXXXXXXGXXXXXXXXXXXXXXXXXXXGXXXXXXXXXXXXXXXXXXXGXXXXXXXXXXXXXXXXXXXGXXXXXXXXXXXXXXXXXXXGXXXXXXXXXXXXXXXXXXXGXXXXXXXXXXXXXXXXXXXGXXXXXXXXXXXXXXXXXXXGXXXXXXXXXXXXXXXXXXXGXXXXXXXXXXXXXXXXXXXGXXXXXXXXXXXXXXXXXXXGXXXXXXXXXXXXXXXXXXX,0,300,0

42420,13,0,13,27,260,0,0,272,212,60,GXXXXXXXXXXXXXXXXXXXGXXXXXXXXXXXXXXXXXXXGXXXXXXXXXXXXXXXXXXXGXXXXXXXXXXXXXXXXXXXGXXXXXXXXXXXXXXXXXXXGXXXXXXXXXXXXXXXXXXXGXXXXXXXXXXXXXXXXXXXGXXXXXXXXXXXXXXXXXXXGXXXXXXXXXXXXXXXXXXXGXXXXXXXXXXXXXXXXXXXGXXXXXXXXXXXXXXXXXXXGXXXXXXXXXXXXXXXXXXXGXXXXXXXXXXXXXXXXXXX,0,300,0
42441,13,0,13,28,259,0,0,271,215,56,GXXXXXXXXXXXXXXXXXXXGXXXXXXXXXXXXXXXXXXXGXXXXXXXXXXXXXXXXXXXGXXXXXXXXXXXXXXXXXXXGXXXXXXXXXXXXXXXXXXXGXXXXXXXXXXXXXXXXXXXGXXXXXXXXXXXXXXXXXXXGXXXXXXXXXXXXXXXXXXXGXXXXXXXXXXXXXXXXXXXGXXXXXXXXXXXXXXXXXXXGXXXXXXXXXXXXXXXXXXXGXXXXXXXXXXXXXXXXXXXGXXXXXXXXXXXXXXXXXXX,0,300,0
42462,13,0,13,31,256,0,0,268,212,56,GXXXXXXXXXXXXXXXXXXXGXXXXXXXXXXXXXXXXXXXGXXXXXXXXXXXXXXXXXXXGXXXXXXXXXXXXXXXXXXXGXXXXXXXXXXXXXXXXXXXGXXXXXXXXXXXXXXXXXXXGXXXXXXXXXXXXXXXXXXXGXXXXXXXXXXXXXXXXXXXGXXXXXXXXXXXXXXXXXXXGXXXXXXXXXXXXXXXXXXXGXXXXXXXXXXXXXXXXXXXGXXXXXXXXXXXXXXXXXXXGXXXXXXXXXXXXXXXXXXX,0,300,0
42483,13,0,13,30,257,0,0,269,212,57,GXXXXXXXXXXXXXXXXXXXGXXXXXXXXXXXXXXXXXXXGXXXXXXXXXXXXXXXXXXXGXXXXXXXXXXXXXXXXXXXGXXXXXXXXXXXXXXXXXXXGXXXXXXXXXXXXXXXXXXXGXXXXXXXXXXXXXXXXXXXGXXXXXXXXXXXXXXXXXXXGXXXXXXXXXXXXXXXXXXXGXXXXXXXXXXXXXXXXXXXGXXXXXXXXXXXXXXXXXXXGXXXXXXXXXXXXXXXXXXXGXXXXXXXXXXXXXXXXXXX,0,300,0
42504,13,0,13,27,260,0,0,272,214,58,GXXXXXXXXXXXXXXXXXXXGXXXXXXXXXXXXXXXXXXXGXXXXXXXXXXXXXXXXXXXGXXXXXXXXXXXXXXXXXXXGXXXXXXXXXXXXXXXXXXXGXXXXXXXXXXXXXXXXXXXGXXXXXXXXXXXXXXXXXXXGXXXXXXXXXXXXXXXXXXXGXXXXXXXXXXXXXXXXXXXGXXXXXXXXXXXXXXXXXXXGXXXXXXXXXXXXXXXXXXXGXXXXXXXXXXXXXXXXXXXGXXXXXXXXXXXXXXXXXXX,0,300,0

42525,13,0,13,28,259,0,0,271,217,54,GXXXXXXXXXXXXXXXXXXXGXXXXXXXXXXXXXXXXXXXGXXXXXXXXXXXXXXXXXXXGXXXXXXXXXXXXXXXXXXXGXXXXXXXXXXXXXXXXXXXGXXXXXXXXXXXXXXXXXXXGXXXXXXXXXXXXXXXXXXXGXXXXXXXXXXXXXXXXXXXGXXXXXXXXXXXXXXXXXXXGXXXXXXXXXXXXXXXXXXXGXXXXXXXXXXXXXXXXXXXGXXXXXXXXXXXXXXXXXXXGXXXXXXXXXXXXXXXXXXX,0,300,0
42546,13,0,13,30,257,0,0,269,215,54,GXXXXXXXXXXXXXXXXXXXGXXXXXXXXXXXXXXXXXXXGXXXXXXXXXXXXXXXXXXXGXXXXXXXXXXXXXXXXXXXGXXXXXXXXXXXXXXXXXXXGXXXXXXXXXXXXXXXXXXXGXXXXXXXXXXXXXXXXXXXGXXXXXXXXXXXXXXXXXXXGXXXXXXXXXXXXXXXXXXXGXXXXXXXXXXXXXXXXXXXGXXXXXXXXXXXXXXXXXXXGXXXXXXXXXXXXXXXXXXXGXXXXXXXXXXXXXXXXXXX,0,300,0
42567,13,0,13,34,253,0,0,265,213,52,GXXXXXXXXXXXXXXXXXXXGXXXXXXXXXXXXXXXXXXXGXXXXXXXXXXXXXXXXXXXGXXXXXXXXXXXXXXXXXXXGXXXXXXXXXXXXXXXXXXXGXXXXXXXXXXXXXXXXXXXGXXXXXXXXXXXXXXXXXXXGXXXXXXXXXXXXXXXXXXXGXXXXXXXXXXXXXXXXXXXGXXXXXXXXXXXXXXXXXXXGXXXXXXXXXXXXXXXXXXXGXXXXXXXXXXXXXXXXXXXGXXXXXXXXXXXXXXXXXXX,0,300,0
42588,13,0,13,36,251,0,0,263,210,53,GXXXXXXXXXXXXXXXXXXXGXXXXXXXXXXXXXXXXXXXGXXXXXXXXXXXXXXXXXXXGXXXXXXXXXXXXXXXXXXXGXXXXXXXXXXXXXXXXXXXGXXXXXXXXXXXXXXXXXXXGXXXXXXXXXXXXXXXXXXXGXXXXXXXXXXXXXXXXXXXGXXXXXXXXXXXXXXXXXXXGXXXXXXXXXXXXXXXXXXXGXXXXXXXXXXXXXXXXXXXGXXXXXXXXXXXXXXXXXXXGXXXXXXXXXXXXXXXXXXX,0,300,0
42609,13,0,13,35,252,0,0,264,212,52,GXXXXXXXXXXXXXXXXXXXGXXXXXXXXXXXXXXXXXXXGXXXXXXXXXXXXXXXXXXXGXXXXXXXXXXXXXXXXXXXGXXXXXXXXXXXXXXXXXXXGXXXXXXXXXXXXXXXXXXXGXXXXXXXXXXXXXXXXXXXGXXXXXXXXXXXXXXXXXXXGXXXXXXXXXXXXXXXXXXXGXXXXXXXXXXXXXXXXXXXGXXXXXXXXXXXXXXXXXXXGXXXXXXXXXXXXXXXXXXXGXXXXXXXXXXXXXXXXXXX,0,300,0

42630,13,0,13,38,249,0,0,261,210,51,GXXXXXXXXXXXXXXXXXXXGXXXXXXXXXXXXXXXXXXXGXXXXXXXXXXXXXXXXXXXGXXXXXXXXXXXXXXXXXXXGXXXXXXXXXXXXXXXXXXXGXXXXXXXXXXXXXXXXXXXGXXXXXXXXXXXXXXXXXXXGXXXXXXXXXXXXXXXXXXXGXXXXXXXXXXXXXXXXXXXGXXXXXXXXXXXXXXXXXXXGXXXXXXXXXXXXXXXXXXXGXXXXXXXXXXXXXXXXXXXGXXXXXXXXXXXXXXXXXXX,0,300,0
42651,13,0,13,40,247,0,0,259,209,50,GXXXXXXXXXXXXXXXXXXXGXXXXXXXXXXXXXXXXXXXGXXXXXXXXXXXXXXXXXXXGXXXXXXXXXXXXXXXXXXXGXXXXXXXXXXXXXXXXXXXGXXXXXXXXXXXXXXXXXXXGXXXXXXXXXXXXXXXXXXXGXXXXXXXXXXXXXXXXXXXGXXXXXXXXXXXXXXXXXXXGXXXXXXXXXXXXXXXXXXXGXXXXXXXXXXXXXXXXXXXGXXXXXXXXXXXXXXXXXXXGXXXXXXXXXXXXXXXXXXX,0,300,0
42672,13,0,13,35,252,0,0,264,212,52,GXXXXXXXXXXXXXXXXXXXGXXXXXXXXXXXXXXXXXXXGXXXXXXXXXXXXXXXXXXXGXXXXXXXXXXXXXXXXXXXGXXXXXXXXXXXXXXXXXXXGXXXXXXXXXXXXXXXXXXXGXXXXXXXXXXXXXXXXXXXGXXXXXXXXXXXXXXXXXXXGXXXXXXXXXXXXXXXXXXXGXXXXXXXXXXXXXXXXXXXGXXXXXXXXXXXXXXXXXXXGXXXXXXXXXXXXXXXXXXXGXXXXXXXXXXXXXXXXXXX,0,300,0
42693,13,0,13,35,252,0,0,264,212,52,GXXXXXXXXXXXXXXXXXXXGXXXXXXXXXXXXXXXXXXXGXXXXXXXXXXXXXXXXXXXGXXXXXXXXXXXXXXXXXXXGXXXXXXXXXXXXXXXXXXXGXXXXXXXXXXXXXXXXXXXGXXXXXXXXXXXXXXXXXXXGXXXXXXXXXXXXXXXXXXXGXXXXXXXXXXXXXXXXXXXGXXXXXXXXXXXXXXXXXXXGXXXXXXXXXXXXXXXXXXXGXXXXXXXXXXXXXXXXXXXGXXXXXXXXXXXXXXXXXXX,0,300,0
42714,13,0,13,32,255,0,0,267,214,53,GXXXXXXXXXXXXXXXXXXXGXXXXXXXXXXXXXXXXXXXGXXXXXXXXXXXXXXXXXXXGXXXXXXXXXXXXXXXXXXXGXXXXXXXXXXXXXXXXXXXGXXXXXXXXXXXXXXXXXXXGXXXXXXXXXXXXXXXXXXXGXXXXXXXXXXXXXXXXXXXGXXXXXXXXXXXXXXXXXXXGXXXXXXXXXXXXXXXXXXXGXXXXXXXXXXXXXXXXXXXGXXXXXXXXXXXXXXXXXXXGXXXXXXXXXXXXXXXXXXX,0,300,0

42735,13,0,13,33,254,0,0,266,213,53,GXXXXXXXXXXXXXXXXXXXGXXXXXXXXXXXXXXXXXXXGXXXXXXXXXXXXXXXXXXXGXXXXXXXXXXXXXXXXXXXGXXXXXXXXXXXXXXXXXXXGXXXXXXXXXXXXXXXXXXXGXXXXXXXXXXXXXXXXXXXGXXXXXXXXXXXXXXXXXXXGXXXXXXXXXXXXXXXXXXXGXXXXXXXXXXXXXXXXXXXGXXXXXXXXXXXXXXXXXXXGXXXXXXXXXXXXXXXXXXXGXXXXXXXXXXXXXXXXXXX,0,300,0
42756,13,0,13,34,253,0,0,265,214,51,GXXXXXXXXXXXXXXXXXXXGXXXXXXXXXXXXXXXXXXXGXXXXXXXXXXXXXXXXXXXGXXXXXXXXXXXXXXXXXXXGXXXXXXXXXXXXXXXXXXXGXXXXXXXXXXXXXXXXXXXGXXXXXXXXXXXXXXXXXXXGXXXXXXXXXXXXXXXXXXXGXXXXXXXXXXXXXXXXXXXGXXXXXXXXXXXXXXXXXXXGXXXXXXXXXXXXXXXXXXXGXXXXXXXXXXXXXXXXXXXGXXXXXXXXXXXXXXXXXXX,0,300,0
42777,13,0,13,34,253,0,0,264,214,50,GXXXXXXXXXXXXXXXXXXXGXXXXXXXXXXXXXXXXXXXGXXXXXXXXXXXXXXXXXXXGXXXXXXXXXXXXXXXXXXXGXXXXXXXXXXXXXXXXXXXGXXXXXXXXXXXXXXXXXXXGXXXXXXXXXXXXXXXXXXXGXXXXXXXXXXXXXXXXXXXGXXXXXXXXXXXXXXXXXXXGXXXXXXXXXXXXXXXXXXXGXXXXXXXXXXXXXXXXXXXGXXXXXXXXXXXXXXXXXXXGXXXXXXXXXXXXXXXXXXX,0,300,0
42798,13,0,13,38,249,0,0,261,212,49,GXXXXXXXXXXXXXXXXXXXGXXXXXXXXXXXXXXXXXXXGXXXXXXXXXXXXXXXXXXXGXXXXXXXXXXXXXXXXXXXGXXXXXXXXXXXXXXXXXXXGXXXXXXXXXXXXXXXXXXXGXXXXXXXXXXXXXXXXXXXGXXXXXXXXXXXXXXXXXXXGXXXXXXXXXXXXXXXXXXXGXXXXXXXXXXXXXXXXXXXGXXXXXXXXXXXXXXXXXXXGXXXXXXXXXXXXXXXXXXXGXXXXXXXXXXXXXXXXXXX,0,300,0
42819,13,0,13,40,247,0,0,259,212,47,GXXXXXXXXXXXXXXXXXXXGXXXXXXXXXXXXXXXXXXXGXXXXXXXXXXXXXXXXXXXGXXXXXXXXXXXXXXXXXXXGXXXXXXXXXXXXXXXXXXXGXXXXXXXXXXXXXXXXXXXGXXXXXXXXXXXXXXXXXXXGXXXXXXXXXXXXXXXXXXXGXXXXXXXXXXXXXXXXXXXGXXXXXXXXXXXXXXXXXXXGXXXXXXXXXXXXXXXXXXXGXXXXXXXXXXXXXXXXXXXGXXXXXXXXXXXXXXXXXXX,0,300,0

42840,13,0,13,39,248,0,0,260,212,48,GXXXXXXXXXXXXXXXXXXXGXXXXXXXXXXXXXXXXXXXGXXXXXXXXXXXXXXXXXXXGXXXXXXXXXXXXXXXXXXXGXXXXXXXXXXXXXXXXXXXGXXXXXXXXXXXXXXXXXXXGXXXXXXXXXXXXXXXXXXXGXXXXXXXXXXXXXXXXXXXGXXXXXXXXXXXXXXXXXXXGXXXXXXXXXXXXXXXXXXXGXXXXXXXXXXXXXXXXXXXGXXXXXXXXXXXXXXXXXXXGXXXXXXXXXXXXXXXXXXX,0,300,0
42861,13,0,13,36,251,0,0,264,212,52,GXXXXXXXXXXXXXXXXXXXGXXXXXXXXXXXXXXXXXXXGXXXXXXXXXXXXXXXXXXXGXXXXXXXXXXXXXXXXXXXGXXXXXXXXXXXXXXXXXXXGXXXXXXXXXXXXXXXXXXXGXXXXXXXXXXXXXXXXXXXGXXXXXXXXXXXXXXXXXXXGXXXXXXXXXXXXXXXXXXXGXXXXXXXXXXXXXXXXXXXGXXXXXXXXXXXXXXXXXXXGXXXXXXXXXXXXXXXXXXXGXXXXXXXXXXXXXXXXXXX,0,300,0
42882,14,1,13,31,255,0,0,267,212,55,GXXXXXXXXXXXXXXXXXXXGXXXXXXXXXXXXXXXXXXXGXXXXXXXXXXXXXXXXXXXGXXXXXXXXXXXXXXXXXXXGXXXXXXXXXXXXXXXXXXXGXXXXXXXXXXXXXXXXXXXGXXXXXXXXXXXXXXXXXXXGXXXXXXXXXXXXXXXXXXXGXXXXXXXXXXXXXXXXXXXGXXXXXXXXXXXXXXXXXXXGXXXXXXXXXXXXXXXXXXXGAXXXXXXXXXXXXXXXXXXGXXXXXXXXXXXXXXXXXXX,0,300,0
42903,14,1,13,31,255,0,0,267,209,58,GXXXXXXXXXXXXXXXXXXXGXXXXXXXXXXXXXXXXXXXGXXXXXXXXXXXXXXXXXXXGXXXXXXXXXXXXXXXXXXXGXXXXXXXXXXXXXXXXXXXGXXXXXXXXXXXXXXXXXXXGXXXXXXXXXXXXXXXXXXXGXXXXXXXXXXXXXXXXXXXGXXXXXXXXXXXXXXXXXXXGXXXXXXXXXXXXXXXXXXXGXXXXXXXXXXXXXXXXXXXGAXXXXXXXXXXXXXXXXXXGXXXXXXXXXXXXXXXXXXX,0,300,0
42924,14,1,13,30,256,0,0,268,208,60,GXXXXXXXXXXXXXXXXXXXGXXXXXXXXXXXXXXXXXXXGXXXXXXXXXXXXXXXXXXXGXXXXXXXXXXXXXXXXXXXGXXXXXXXXXXXXXXXXXXXGXXXXXXXXXXXXXXXXXXXGXXXXXXXXXXXXXXXXXXXGXXXXXXXXXXXXXXXXXXXGXXXXXXXXXXXXXXXXXXXGXXXXXXXXXXXXXXXXXXXGXXXXXXXXXXXXXXXXXXXGAXXXXXXXXXXXXXXXXXXGXXXXXXXXXXXXXXXXXXX,0,300,0

42945,14,1,13,31,255,0,0,267,210,57,GXXXXXXXXXXXXXXXXXXXGXXXXXXXXXXXXXXXXXXXGXXXXXXXXXXXXXXXXXXXGXXXXXXXXXXXXXXXXXXXGXXXXXXXXXXXXXXXXXXXGXXXXXXXXXXXXXXXXXXXGXXXXXXXXXXXXXXXXXXXGXXXXXXXXXXXXXXXXXXXGXXXXXXXXXXXXXXXXXXXGXXXXXXXXXXXXXXXXXXXGXXXXXXXXXXXXXXXXXXXGAXXXXXXXXXXXXXXXXXXGXXXXXXXXXXXXXXXXXXX,0,300,0
42966,14,1,13,33,253,0,0,264,209,55,GXXXXXXXXXXXXXXXXXXXGXXXXXXXXXXXXXXXXXXXGXXXXXXXXXXXXXXXXXXXGXXXXXXXXXXXXXXXXXXXGXXXXXXXXXXXXXXXXXXXGXXXXXXXXXXXXXXXXXXXGXXXXXXXXXXXXXXXXXXXGXXXXXXXXXXXXXXXXXXXGXXXXXXXXXXXXXXXXXXXGXXXXXXXXXXXXXXXXXXXGXXXXXXXXXXXXXXXXXXXGAXXXXXXXXXXXXXXXXXXGXXXXXXXXXXXXXXXXXXX,0,300,0
42987,15,1,14,31,254,0,0,266,212,54,GXXXXXXXXXXXXXXXXXXXGXXXXXXXXXXXXXXXXXXXGXXXXXXXXXXXXXXXXXXXGXXXXXXXXXXXXXXXXXXXGXXXXXXXXXXXXXXXXXXXGXXXXXXXXXXXXXXXXXXXGXXXXXXXXXXXXXXXXXXXGXXXXXXXXXXXXXXXXXXXGOXXXXXXXXXXXXXXXXXXGXXXXXXXXXXXXXXXXXXXGXXXXXXXXXXXXXXXXXXXGAXXXXXXXXXXXXXXXXXXGXXXXXXXXXXXXXXXXXXX,0,300,0
43008,14,1,13,31,255,0,0,266,210,56,GXXXXXXXXXXXXXXXXXXXGXXXXXXXXXXXXXXXXXXXGXXXXXXXXXXXXXXXXXXXGXXXXXXXXXXXXXXXXXXXGXXXXXXXXXXXXXXXXXXXGXXXXXXXXXXXXXXXXXXXGXXXXXXXXXXXXXXXXXXXGXXXXXXXXXXXXXXXXXXXGXXXXXXXXXXXXXXXXXXXGXXXXXXXXXXXXXXXXXXXGXXXXXXXXXXXXXXXXXXXGAXXXXXXXXXXXXXXXXXXGXXXXXXXXXXXXXXXXXXX,0,300,0
43029,13,0,13,32,255,0,0,267,212,55,GXXXXXXXXXXXXXXXXXXXGXXXXXXXXXXXXXXXXXXXGXXXXXXXXXXXXXXXXXXXGXXXXXXXXXXXXXXXXXXXGXXXXXXXXXXXXXXXXXXXGXXXXXXXXXXXXXXXXXXXGXXXXXXXXXXXXXXXXXXXGXXXXXXXXXXXXXXXXXXXGXXXXXXXXXXXXXXXXXXXGXXXXXXXXXXXXXXXXXXXGXXXXXXXXXXXXXXXXXXXGXXXXXXXXXXXXXXXXXXXGXXXXXXXXXXXXXXXXXXX,0,300,0

43050,13,0,13,27,260,0,0,272,212,60,GXXXXXXXXXXXXXXXXXXXGXXXXXXXXXXXXXXXXXXXGXXXXXXXXXXXXXXXXXXXGXXXXXXXXXXXXXXXXXXXGXXXXXXXXXXXXXXXXXXXGXXXXXXXXXXXXXXXXXXXGXXXXXXXXXXXXXXXXXXXGXXXXXXXXXXXXXXXXXXXGXXXXXXXXXXXXXXXXXXXGXXXXXXXXXXXXXXXXXXXGXXXXXXXXXXXXXXXXXXXGXXXXXXXXXXXXXXXXXXXGXXXXXXXXXXXXXXXXXXX,0,300,0
43071,13,0,13,27,260,0,0,272,211,61,GXXXXXXXXXXXXXXXXXXXGXXXXXXXXXXXXXXXXXXXGXXXXXXXXXXXXXXXXXXXGXXXXXXXXXXXXXXXXXXXGXXXXXXXXXXXXXXXXXXXGXXXXXXXXXXXXXXXXXXXGXXXXXXXXXXXXXXXXXXXGXXXXXXXXXXXXXXXXXXXGXXXXXXXXXXXXXXXXXXXGXXXXXXXXXXXXXXXXXXXGXXXXXXXXXXXXXXXXXXXGXXXXXXXXXXXXXXXXXXXGXXXXXXXXXXXXXXXXXXX,0,300,0
43092,13,0,13,24,263,0,0,275,215,60,GXXXXXXXXXXXXXXXXXXXGXXXXXXXXXXXXXXXXXXXGXXXXXXXXXXXXXXXXXXXGXXXXXXXXXXXXXXXXXXXGXXXXXXXXXXXXXXXXXXXGXXXXXXXXXXXXXXXXXXXGXXXXXXXXXXXXXXXXXXXGXXXXXXXXXXXXXXXXXXXGXXXXXXXXXXXXXXXXXXXGXXXXXXXXXXXXXXXXXXXGXXXXXXXXXXXXXXXXXXXGXXXXXXXXXXXXXXXXXXXGXXXXXXXXXXXXXXXXXXX,0,300,0
43113,13,0,13,26,261,0,0,273,211,62,GXXXXXXXXXXXXXXXXXXXGXXXXXXXXXXXXXXXXXXXGXXXXXXXXXXXXXXXXXXXGXXXXXXXXXXXXXXXXXXXGXXXXXXXXXXXXXXXXXXXGXXXXXXXXXXXXXXXXXXXGXXXXXXXXXXXXXXXXXXXGXXXXXXXXXXXXXXXXXXXGXXXXXXXXXXXXXXXXXXXGXXXXXXXXXXXXXXXXXXXGXXXXXXXXXXXXXXXXXXXGXXXXXXXXXXXXXXXXXXXGXXXXXXXXXXXXXXXXXXX,0,300,0
43134,13,0,13,25,262,0,0,274,211,63,GXXXXXXXXXXXXXXXXXXXGXXXXXXXXXXXXXXXXXXXGXXXXXXXXXXXXXXXXXXXGXXXXXXXXXXXXXXXXXXXGXXXXXXXXXXXXXXXXXXXGXXXXXXXXXXXXXXXXXXXGXXXXXXXXXXXXXXXXXXXGXXXXXXXXXXXXXXXXXXXGXXXXXXXXXXXXXXXXXXXGXXXXXXXXXXXXXXXXXXXGXXXXXXXXXXXXXXXXXXXGXXXXXXXXXXXXXXXXXXXGXXXXXXXXXXXXXXXXXXX,0,300,0

43155,13,0,13,25,262,0,0,274,213,61,GXXXXXXXXXXXXXXXXXXXGXXXXXXXXXXXXXXXXXXXGXXXXXXXXXXXXXXXXXXXGXXXXXXXXXXXXXXXXXXXGXXXXXXXXXXXXXXXXXXXGXXXXXXXXXXXXXXXXXXXGXXXXXXXXXXXXXXXXXXXGXXXXXXXXXXXXXXXXXXXGXXXXXXXXXXXXXXXXXXXGXXXXXXXXXXXXXXXXXXXGXXXXXXXXXXXXXXXXXXXGXXXXXXXXXXXXXXXXXXXGXXXXXXXXXXXXXXXXXXX,0,300,0
43176,13,0,13,25,262,0,0,274,212,62,GXXXXXXXXXXXXXXXXXXXGXXXXXXXXXXXXXXXXXXXGXXXXXXXXXXXXXXXXXXXGXXXXXXXXXXXXXXXXXXXGXXXXXXXXXXXXXXXXXXXGXXXXXXXXXXXXXXXXXXXGXXXXXXXXXXXXXXXXXXXGXXXXXXXXXXXXXXXXXXXGXXXXXXXXXXXXXXXXXXXGXXXXXXXXXXXXXXXXXXXGXXXXXXXXXXXXXXXXXXXGXXXXXXXXXXXXXXXXXXXGXXXXXXXXXXXXXXXXXXX,0,300,0
43197,13,0,13,25,262,0,0,274,213,61,GXXXXXXXXXXXXXXXXXXXGXXXXXXXXXXXXXXXXXXXGXXXXXXXXXXXXXXXXXXXGXXXXXXXXXXXXXXXXXXXGXXXXXXXXXXXXXXXXXXXGXXXXXXXXXXXXXXXXXXXGXXXXXXXXXXXXXXXXXXXGXXXXXXXXXXXXXXXXXXXGXXXXXXXXXXXXXXXXXXXGXXXXXXXXXXXXXXXXXXXGXXXXXXXXXXXXXXXXXXXGXXXXXXXXXXXXXXXXXXXGXXXXXXXXXXXXXXXXXXX,0,300,0
43218,13,0,13,25,262,0,0,274,213,61,GXXXXXXXXXXXXXXXXXXXGXXXXXXXXXXXXXXXXXXXGXXXXXXXXXXXXXXXXXXXGXXXXXXXXXXXXXXXXXXXGXXXXXXXXXXXXXXXXXXXGXXXXXXXXXXXXXXXXXXXGXXXXXXXXXXXXXXXXXXXGXXXXXXXXXXXXXXXXXXXGXXXXXXXXXXXXXXXXXXXGXXXXXXXXXXXXXXXXXXXGXXXXXXXXXXXXXXXXXXXGXXXXXXXXXXXXXXXXXXXGXXXXXXXXXXXXXXXXXXX,0,300,0
43239,13,0,13,25,262,0,0,274,214,60,GXXXXXXXXXXXXXXXXXXXGXXXXXXXXXXXXXXXXXXXGXXXXXXXXXXXXXXXXXXXGXXXXXXXXXXXXXXXXXXXGXXXXXXXXXXXXXXXXXXXGXXXXXXXXXXXXXXXXXXXGXXXXXXXXXXXXXXXXXXXGXXXXXXXXXXXXXXXXXXXGXXXXXXXXXXXXXXXXXXXGXXXXXXXXXXXXXXXXXXXGXXXXXXXXXXXXXXXXXXXGXXXXXXXXXXXXXXXXXXXGXXXXXXXXXXXXXXXXXXX,0,300,0

43260,13,0,13,24,263,0,0,275,213,62,GXXXXXXXXXXXXXXXXXXXGXXXXXXXXXXXXXXXXXXXGXXXXXXXXXXXXXXXXXXXGXXXXXXXXXXXXXXXXXXXGXXXXXXXXXXXXXXXXXXXGXXXXXXXXXXXXXXXXXXXGXXXXXXXXXXXXXXXXXXXGXXXXXXXXXXXXXXXXXXXGXXXXXXXXXXXXXXXXXXXGXXXXXXXXXXXXXXXXXXXGXXXXXXXXXXXXXXXXXXXGXXXXXXXXXXXXXXXXXXXGXXXXXXXXXXXXXXXXXXX,0,300,0
43281,13,0,13,25,262,0,0,273,212,61,GXXXXXXXXXXXXXXXXXXXGXXXXXXXXXXXXXXXXXXXGXXXXXXXXXXXXXXXXXXXGXXXXXXXXXXXXXXXXXXXGXXXXXXXXXXXXXXXXXXXGXXXXXXXXXXXXXXXXXXXGXXXXXXXXXXXXXXXXXXXGXXXXXXXXXXXXXXXXXXXGXXXXXXXXXXXXXXXXXXXGXXXXXXXXXXXXXXXXXXXGXXXXXXXXXXXXXXXXXXXGXXXXXXXXXXXXXXXXXXXGXXXXXXXXXXXXXXXXXXX,0,300,0
43302,13,0,13,25,262,0,0,273,212,61,GXXXXXXXXXXXXXXXXXXXGXXXXXXXXXXXXXXXXXXXGXXXXXXXXXXXXXXXXXXXGXXXXXXXXXXXXXXXXXXXGXXXXXXXXXXXXXXXXXXXGXXXXXXXXXXXXXXXXXXXGXXXXXXXXXXXXXXXXXXXGXXXXXXXXXXXXXXXXXXXGXXXXXXXXXXXXXXXXXXXGXXXXXXXXXXXXXXXXXXXGXXXXXXXXXXXXXXXXXXXGXXXXXXXXXXXXXXXXXXXGXXXXXXXXXXXXXXXXXXX,0,300,0
43323,13,0,13,30,257,0,0,269,211,58,GXXXXXXXXXXXXXXXXXXXGXXXXXXXXXXXXXXXXXXXGXXXXXXXXXXXXXXXXXXXGXXXXXXXXXXXXXXXXXXXGXXXXXXXXXXXXXXXXXXXGXXXXXXXXXXXXXXXXXXXGXXXXXXXXXXXXXXXXXXXGXXXXXXXXXXXXXXXXXXXGXXXXXXXXXXXXXXXXXXXGXXXXXXXXXXXXXXXXXXXGXXXXXXXXXXXXXXXXXXXGXXXXXXXXXXXXXXXXXXXGXXXXXXXXXXXXXXXXXXX,0,300,0
43344,13,0,13,27,260,0,0,272,214,58,GXXXXXXXXXXXXXXXXXXXGXXXXXXXXXXXXXXXXXXXGXXXXXXXXXXXXXXXXXXXGXXXXXXXXXXXXXXXXXXXGXXXXXXXXXXXXXXXXXXXGXXXXXXXXXXXXXXXXXXXGXXXXXXXXXXXXXXXXXXXGXXXXXXXXXXXXXXXXXXXGXXXXXXXXXXXXXXXXXXXGXXXXXXXXXXXXXXXXXXXGXXXXXXXXXXXXXXXXXXXGXXXXXXXXXXXXXXXXXXXGXXXXXXXXXXXXXXXXXXX,0,300,0

43365,13,0,13,26,261,0,0,272,217,55,GXXXXXXXXXXXXXXXXXXXGXXXXXXXXXXXXXXXXXXXGXXXXXXXXXXXXXXXXXXXGXXXXXXXXXXXXXXXXXXXGXXXXXXXXXXXXXXXXXXXGXXXXXXXXXXXXXXXXXXXGXXXXXXXXXXXXXXXXXXXGXXXXXXXXXXXXXXXXXXXGXXXXXXXXXXXXXXXXXXXGXXXXXXXXXXXXXXXXXXXGXXXXXXXXXXXXXXXXXXXGXXXXXXXXXXXXXXXXXXXGXXXXXXXXXXXXXXXXXXX,0,300,0
43386,13,0,13,26,261,0,0,273,216,57,GXXXXXXXXXXXXXXXXXXXGXXXXXXXXXXXXXXXXXXXGXXXXXXXXXXXXXXXXXXXGXXXXXXXXXXXXXXXXXXXGXXXXXXXXXXXXXXXXXXXGXXXXXXXXXXXXXXXXXXXGXXXXXXXXXXXXXXXXXXXGXXXXXXXXXXXXXXXXXXXGXXXXXXXXXXXXXXXXXXXGXXXXXXXXXXXXXXXXXXXGXXXXXXXXXXXXXXXXXXXGXXXXXXXXXXXXXXXXXXXGXXXXXXXXXXXXXXXXXXX,0,300,0
43407,13,0,13,25,262,0,0,274,217,57,GXXXXXXXXXXXXXXXXXXXGXXXXXXXXXXXXXXXXXXXGXXXXXXXXXXXXXXXXXXXGXXXXXXXXXXXXXXXXXXXGXXXXXXXXXXXXXXXXXXXGXXXXXXXXXXXXXXXXXXXGXXXXXXXXXXXXXXXXXXXGXXXXXXXXXXXXXXXXXXXGXXXXXXXXXXXXXXXXXXXGXXXXXXXXXXXXXXXXXXXGXXXXXXXXXXXXXXXXXXXGXXXXXXXXXXXXXXXXXXXGXXXXXXXXXXXXXXXXXXX,0,300,0
43428,13,0,13,30,257,0,0,269,214,55,GXXXXXXXXXXXXXXXXXXXGXXXXXXXXXXXXXXXXXXXGXXXXXXXXXXXXXXXXXXXGXXXXXXXXXXXXXXXXXXXGXXXXXXXXXXXXXXXXXXXGXXXXXXXXXXXXXXXXXXXGXXXXXXXXXXXXXXXXXXXGXXXXXXXXXXXXXXXXXXXGXXXXXXXXXXXXXXXXXXXGXXXXXXXXXXXXXXXXXXXGXXXXXXXXXXXXXXXXXXXGXXXXXXXXXXXXXXXXXXXGXXXXXXXXXXXXXXXXXXX,0,300,0
43449,13,0,13,29,258,0,0,270,212,58,GXXXXXXXXXXXXXXXXXXXGXXXXXXXXXXXXXXXXXXXGXXXXXXXXXXXXXXXXXXXGXXXXXXXXXXXXXXXXXXXGXXXXXXXXXXXXXXXXXXXGXXXXXXXXXXXXXXXXXXXGXXXXXXXXXXXXXXXXXXXGXXXXXXXXXXXXXXXXXXXGXXXXXXXXXXXXXXXXXXXGXXXXXXXXXXXXXXXXXXXGXXXXXXXXXXXXXXXXXXXGXXXXXXXXXXXXXXXXXXXGXXXXXXXXXXXXXXXXXXX,0,300,0

43470,13,0,13,28,259,0,0,271,214,57,GXXXXXXXXXXXXXXXXXXXGXXXXXXXXXXXXXXXXXXXGXXXXXXXXXXXXXXXXXXXGXXXXXXXXXXXXXXXXXXXGXXXXXXXXXXXXXXXXXXXGXXXXXXXXXXXXXXXXXXXGXXXXXXXXXXXXXXXXXXXGXXXXXXXXXXXXXXXXXXXGXXXXXXXXXXXXXXXXXXXGXXXXXXXXXXXXXXXXXXXGXXXXXXXXXXXXXXXXXXXGXXXXXXXXXXXXXXXXXXXGXXXXXXXXXXXXXXXXXXX,0,300,0
43491,13,0,13,28,259,0,0,271,215,56,GXXXXXXXXXXXXXXXXXXXGXXXXXXXXXXXXXXXXXXXGXXXXXXXXXXXXXXXXXXXGXXXXXXXXXXXXXXXXXXXGXXXXXXXXXXXXXXXXXXXGXXXXXXXXXXXXXXXXXXXGXXXXXXXXXXXXXXXXXXXGXXXXXXXXXXXXXXXXXXXGXXXXXXXXXXXXXXXXXXXGXXXXXXXXXXXXXXXXXXXGXXXXXXXXXXXXXXXXXXXGXXXXXXXXXXXXXXXXXXXGXXXXXXXXXXXXXXXXXXX,0,300,0
43512,13,0,13,33,254,0,0,266,211,55,GXXXXXXXXXXXXXXXXXXXGXXXXXXXXXXXXXXXXXXXGXXXXXXXXXXXXXXXXXXXGXXXXXXXXXXXXXXXXXXXGXXXXXXXXXXXXXXXXXXXGXXXXXXXXXXXXXXXXXXXGXXXXXXXXXXXXXXXXXXXGXXXXXXXXXXXXXXXXXXXGXXXXXXXXXXXXXXXXXXXGXXXXXXXXXXXXXXXXXXXGXXXXXXXXXXXXXXXXXXXGXXXXXXXXXXXXXXXXXXXGXXXXXXXXXXXXXXXXXXX,0,300,0
43533,13,0,13,34,253,0,0,265,210,55,GXXXXXXXXXXXXXXXXXXXGXXXXXXXXXXXXXXXXXXXGXXXXXXXXXXXXXXXXXXXGXXXXXXXXXXXXXXXXXXXGXXXXXXXXXXXXXXXXXXXGXXXXXXXXXXXXXXXXXXXGXXXXXXXXXXXXXXXXXXXGXXXXXXXXXXXXXXXXXXXGXXXXXXXXXXXXXXXXXXXGXXXXXXXXXXXXXXXXXXXGXXXXXXXXXXXXXXXXXXXGXXXXXXXXXXXXXXXXXXXGXXXXXXXXXXXXXXXXXXX,0,300,0
43554,13,0,13,34,253,0,0,265,212,53,GXXXXXXXXXXXXXXXXXXXGXXXXXXXXXXXXXXXXXXXGXXXXXXXXXXXXXXXXXXXGXXXXXXXXXXXXXXXXXXXGXXXXXXXXXXXXXXXXXXXGXXXXXXXXXXXXXXXXXXXGXXXXXXXXXXXXXXXXXXXGXXXXXXXXXXXXXXXXXXXGXXXXXXXXXXXXXXXXXXXGXXXXXXXXXXXXXXXXXXXGXXXXXXXXXXXXXXXXXXXGXXXXXXXXXXXXXXXXXXXGXXXXXXXXXXXXXXXXXXX,0,300,0

43575,13,0,13,32,255,0,0,267,211,56,GXXXXXXXXXXXXXXXXXXXGXXXXXXXXXXXXXXXXXXXGXXXXXXXXXXXXXXXXXXXGXXXXXXXXXXXXXXXXXXXGXXXXXXXXXXXXXXXXXXXGXXXXXXXXXXXXXXXXXXXGXXXXXXXXXXXXXXXXXXXGXXXXXXXXXXXXXXXXXXXGXXXXXXXXXXXXXXXXXXXGXXXXXXXXXXXXXXXXXXXGXXXXXXXXXXXXXXXXXXXGXXXXXXXXXXXXXXXXXXXGXXXXXXXXXXXXXXXXXXX,0,300,0
43596,13,0,13,31,256,0,0,268,212,56,GXXXXXXXXXXXXXXXXXXXGXXXXXXXXXXXXXXXXXXXGXXXXXXXXXXXXXXXXXXXGXXXXXXXXXXXXXXXXXXXGXXXXXXXXXXXXXXXXXXXGXXXXXXXXXXXXXXXXXXXGXXXXXXXXXXXXXXXXXXXGXXXXXXXXXXXXXXXXXXXGXXXXXXXXXXXXXXXXXXXGXXXXXXXXXXXXXXXXXXXGXXXXXXXXXXXXXXXXXXXGXXXXXXXXXXXXXXXXXXXGXXXXXXXXXXXXXXXXXXX,0,300,0
43617,13,0,13,29,258,0,0,270,214,56,GXXXXXXXXXXXXXXXXXXXGXXXXXXXXXXXXXXXXXXXGXXXXXXXXXXXXXXXXXXXGXXXXXXXXXXXXXXXXXXXGXXXXXXXXXXXXXXXXXXXGXXXXXXXXXXXXXXXXXXXGXXXXXXXXXXXXXXXXXXXGXXXXXXXXXXXXXXXXXXXGXXXXXXXXXXXXXXXXXXXGXXXXXXXXXXXXXXXXXXXGXXXXXXXXXXXXXXXXXXXGXXXXXXXXXXXXXXXXXXXGXXXXXXXXXXXXXXXXXXX,0,300,0
43638,13,0,13,28,259,0,0,271,214,57,GXXXXXXXXXXXXXXXXXXXGXXXXXXXXXXXXXXXXXXXGXXXXXXXXXXXXXXXXXXXGXXXXXXXXXXXXXXXXXXXGXXXXXXXXXXXXXXXXXXXGXXXXXXXXXXXXXXXXXXXGXXXXXXXXXXXXXXXXXXXGXXXXXXXXXXXXXXXXXXXGXXXXXXXXXXXXXXXXXXXGXXXXXXXXXXXXXXXXXXXGXXXXXXXXXXXXXXXXXXXGXXXXXXXXXXXXXXXXXXXGXXXXXXXXXXXXXXXXXXX,0,300,0
43659,13,0,13,29,258,0,0,269,217,52,GXXXXXXXXXXXXXXXXXXXGXXXXXXXXXXXXXXXXXXXGXXXXXXXXXXXXXXXXXXXGXXXXXXXXXXXXXXXXXXXGXXXXXXXXXXXXXXXXXXXGXXXXXXXXXXXXXXXXXXXGXXXXXXXXXXXXXXXXXXXGXXXXXXXXXXXXXXXXXXXGXXXXXXXXXXXXXXXXXXXGXXXXXXXXXXXXXXXXXXXGXXXXXXXXXXXXXXXXXXXGXXXXXXXXXXXXXXXXXXXGXXXXXXXXXXXXXXXXXXX,0,300,0

43680,13,0,13,32,255,0,0,267,214,53,GXXXXXXXXXXXXXXXXXXXGXXXXXXXXXXXXXXXXXXXGXXXXXXXXXXXXXXXXXXXGXXXXXXXXXXXXXXXXXXXGXXXXXXXXXXXXXXXXXXXGXXXXXXXXXXXXXXXXXXXGXXXXXXXXXXXXXXXXXXXGXXXXXXXXXXXXXXXXXXXGXXXXXXXXXXXXXXXXXXXGXXXXXXXXXXXXXXXXXXXGXXXXXXXXXXXXXXXXXXXGXXXXXXXXXXXXXXXXXXXGXXXXXXXXXXXXXXXXXXX,0,300,0
43701,13,0,13,32,255,0,0,267,212,55,GXXXXXXXXXXXXXXXXXXXGXXXXXXXXXXXXXXXXXXXGXXXXXXXXXXXXXXXXXXXGXXXXXXXXXXXXXXXXXXXGXXXXXXXXXXXXXXXXXXXGXXXXXXXXXXXXXXXXXXXGXXXXXXXXXXXXXXXXXXXGXXXXXXXXXXXXXXXXXXXGXXXXXXXXXXXXXXXXXXXGXXXXXXXXXXXXXXXXXXXGXXXXXXXXXXXXXXXXXXXGXXXXXXXXXXXXXXXXXXXGXXXXXXXXXXXXXXXXXXX,0,300,0
43722,13,0,13,31,256,0,0,268,212,56,GXXXXXXXXXXXXXXXXXXXGXXXXXXXXXXXXXXXXXXXGXXXXXXXXXXXXXXXXXXXGXXXXXXXXXXXXXXXXXXXGXXXXXXXXXXXXXXXXXXXGXXXXXXXXXXXXXXXXXXXGXXXXXXXXXXXXXXXXXXXGXXXXXXXXXXXXXXXXXXXGXXXXXXXXXXXXXXXXXXXGXXXXXXXXXXXXXXXXXXXGXXXXXXXXXXXXXXXXXXXGXXXXXXXXXXXXXXXXXXXGXXXXXXXXXXXXXXXXXXX,0,300,0
43743,13,0,13,31,256,0,0,268,211,57,GXXXXXXXXXXXXXXXXXXXGXXXXXXXXXXXXXXXXXXXGXXXXXXXXXXXXXXXXXXXGXXXXXXXXXXXXXXXXXXXGXXXXXXXXXXXXXXXXXXXGXXXXXXXXXXXXXXXXXXXGXXXXXXXXXXXXXXXXXXXGXXXXXXXXXXXXXXXXXXXGXXXXXXXXXXXXXXXXXXXGXXXXXXXXXXXXXXXXXXXGXXXXXXXXXXXXXXXXXXXGXXXXXXXXXXXXXXXXXXXGXXXXXXXXXXXXXXXXXXX,0,300,0
43764,13,0,13,31,256,0,0,269,214,55,GXXXXXXXXXXXXXXXXXXXGXXXXXXXXXXXXXXXXXXXGXXXXXXXXXXXXXXXXXXXGXXXXXXXXXXXXXXXXXXXGXXXXXXXXXXXXXXXXXXXGXXXXXXXXXXXXXXXXXXXGXXXXXXXXXXXXXXXXXXXGXXXXXXXXXXXXXXXXXXXGXXXXXXXXXXXXXXXXXXXGXXXXXXXXXXXXXXXXXXXGXXXXXXXXXXXXXXXXXXXGXXXXXXXXXXXXXXXXXXXGXXXXXXXXXXXXXXXXXXX,0,300,0

43785,13,0,13,34,253,0,0,266,212,54,GXXXXXXXXXXXXXXXXXXXGXXXXXXXXXXXXXXXXXXXGXXXXXXXXXXXXXXXXXXXGXXXXXXXXXXXXXXXXXXXGXXXXXXXXXXXXXXXXXXXGXXXXXXXXXXXXXXXXXXXGXXXXXXXXXXXXXXXXXXXGXXXXXXXXXXXXXXXXXXXGXXXXXXXXXXXXXXXXXXXGXXXXXXXXXXXXXXXXXXXGXXXXXXXXXXXXXXXXXXXGXXXXXXXXXXXXXXXXXXXGXXXXXXXXXXXXXXXXXXX,0,300,0
43806,13,0,13,30,257,0,0,269,216,53,GXXXXXXXXXXXXXXXXXXXGXXXXXXXXXXXXXXXXXXXGXXXXXXXXXXXXXXXXXXXGXXXXXXXXXXXXXXXXXXXGXXXXXXXXXXXXXXXXXXXGXXXXXXXXXXXXXXXXXXXGXXXXXXXXXXXXXXXXXXXGXXXXXXXXXXXXXXXXXXXGXXXXXXXXXXXXXXXXXXXGXXXXXXXXXXXXXXXXXXXGXXXXXXXXXXXXXXXXXXXGXXXXXXXXXXXXXXXXXXXGXXXXXXXXXXXXXXXXXXX,0,300,0
43827,13,0,13,29,258,0,0,271,216,55,GXXXXXXXXXXXXXXXXXXXGXXXXXXXXXXXXXXXXXXXGXXXXXXXXXXXXXXXXXXXGXXXXXXXXXXXXXXXXXXXGXXXXXXXXXXXXXXXXXXXGXXXXXXXXXXXXXXXXXXXGXXXXXXXXXXXXXXXXXXXGXXXXXXXXXXXXXXXXXXXGXXXXXXXXXXXXXXXXXXXGXXXXXXXXXXXXXXXXXXXGXXXXXXXXXXXXXXXXXXXGXXXXXXXXXXXXXXXXXXXGXXXXXXXXXXXXXXXXXXX,0,300,0
43848,13,0,13,32,255,0,0,268,214,54,GXXXXXXXXXXXXXXXXXXXGXXXXXXXXXXXXXXXXXXXGXXXXXXXXXXXXXXXXXXXGXXXXXXXXXXXXXXXXXXXGXXXXXXXXXXXXXXXXXXXGXXXXXXXXXXXXXXXXXXXGXXXXXXXXXXXXXXXXXXXGXXXXXXXXXXXXXXXXXXXGXXXXXXXXXXXXXXXXXXXGXXXXXXXXXXXXXXXXXXXGXXXXXXXXXXXXXXXXXXXGXXXXXXXXXXXXXXXXXXXGXXXXXXXXXXXXXXXXXXX,0,300,0
43869,13,0,13,28,259,0,0,271,212,59,GXXXXXXXXXXXXXXXXXXXGXXXXXXXXXXXXXXXXXXXGXXXXXXXXXXXXXXXXXXXGXXXXXXXXXXXXXXXXXXXGXXXXXXXXXXXXXXXXXXXGXXXXXXXXXXXXXXXXXXXGXXXXXXXXXXXXXXXXXXXGXXXXXXXXXXXXXXXXXXXGXXXXXXXXXXXXXXXXXXXGXXXXXXXXXXXXXXXXXXXGXXXXXXXXXXXXXXXXXXXGXXXXXXXXXXXXXXXXXXXGXXXXXXXXXXXXXXXXXXX,0,300,0

43890,13,0,13,30,257,0,0,270,212,58,GXXXXXXXXXXXXXXXXXXXGXXXXXXXXXXXXXXXXXXXGXXXXXXXXXXXXXXXXXXXGXXXXXXXXXXXXXXXXXXXGXXXXXXXXXXXXXXXXXXXGXXXXXXXXXXXXXXXXXXXGXXXXXXXXXXXXXXXXXXXGXXXXXXXXXXXXXXXXXXXGXXXXXXXXXXXXXXXXXXXGXXXXXXXXXXXXXXXXXXXGXXXXXXXXXXXXXXXXXXXGXXXXXXXXXXXXXXXXXXXGXXXXXXXXXXXXXXXXXXX,0,300,0
43911,13,0,13,30,257,0,0,270,211,59,GXXXXXXXXXXXXXXXXXXXGXXXXXXXXXXXXXXXXXXXGXXXXXXXXXXXXXXXXXXXGXXXXXXXXXXXXXXXXXXXGXXXXXXXXXXXXXXXXXXXGXXXXXXXXXXXXXXXXXXXGXXXXXXXXXXXXXXXXXXXGXXXXXXXXXXXXXXXXXXXGXXXXXXXXXXXXXXXXXXXGXXXXXXXXXXXXXXXXXXXGXXXXXXXXXXXXXXXXXXXGXXXXXXXXXXXXXXXXXXXGXXXXXXXXXXXXXXXXXXX,0,300,0
43932,13,0,13,31,256,0,0,269,211,58,GXXXXXXXXXXXXXXXXXXXGXXXXXXXXXXXXXXXXXXXGXXXXXXXXXXXXXXXXXXXGXXXXXXXXXXXXXXXXXXXGXXXXXXXXXXXXXXXXXXXGXXXXXXXXXXXXXXXXXXXGXXXXXXXXXXXXXXXXXXXGXXXXXXXXXXXXXXXXXXXGXXXXXXXXXXXXXXXXXXXGXXXXXXXXXXXXXXXXXXXGXXXXXXXXXXXXXXXXXXXGXXXXXXXXXXXXXXXXXXXGXXXXXXXXXXXXXXXXXXX,0,300,0
43953,13,0,13,28,259,0,0,273,214,59,GXXXXXXXXXXXXXXXXXXXGXXXXXXXXXXXXXXXXXXXGXXXXXXXXXXXXXXXXXXXGXXXXXXXXXXXXXXXXXXXGXXXXXXXXXXXXXXXXXXXGXXXXXXXXXXXXXXXXXXXGXXXXXXXXXXXXXXXXXXXGXXXXXXXXXXXXXXXXXXXGXXXXXXXXXXXXXXXXXXXGXXXXXXXXXXXXXXXXXXXGXXXXXXXXXXXXXXXXXXXGXXXXXXXXXXXXXXXXXXXGXXXXXXXXXXXXXXXXXXX,0,300,0
43974,13,0,13,26,261,0,0,275,218,57,GXXXXXXXXXXXXXXXXXXXGXXXXXXXXXXXXXXXXXXXGXXXXXXXXXXXXXXXXXXXGXXXXXXXXXXXXXXXXXXXGXXXXXXXXXXXXXXXXXXXGXXXXXXXXXXXXXXXXXXXGXXXXXXXXXXXXXXXXXXXGXXXXXXXXXXXXXXXXXXXGXXXXXXXXXXXXXXXXXXXGXXXXXXXXXXXXXXXXXXXGXXXXXXXXXXXXXXXXXXXGXXXXXXXXXXXXXXXXXXXGXXXXXXXXXXXXXXXXXXX,0,300,0

43995,13,0,13,29,258,0,0,272,215,57,GXXXXXXXXXXXXXXXXXXXGXXXXXXXXXXXXXXXXXXXGXXXXXXXXXXXXXXXXXXXGXXXXXXXXXXXXXXXXXXXGXXXXXXXXXXXXXXXXXXXGXXXXXXXXXXXXXXXXXXXGXXXXXXXXXXXXXXXXXXXGXXXXXXXXXXXXXXXXXXXGXXXXXXXXXXXXXXXXXXXGXXXXXXXXXXXXXXXXXXXGXXXXXXXXXXXXXXXXXXXGXXXXXXXXXXXXXXXXXXXGXXXXXXXXXXXXXXXXXXX,0,300,0
44016,13,0,13,22,265,0,0,278,217,61,GXXXXXXXXXXXXXXXXXXXGXXXXXXXXXXXXXXXXXXXGXXXXXXXXXXXXXXXXXXXGXXXXXXXXXXXXXXXXXXXGXXXXXXXXXXXXXXXXXXXGXXXXXXXXXXXXXXXXXXXGXXXXXXXXXXXXXXXXXXXGXXXXXXXXXXXXXXXXXXXGXXXXXXXXXXXXXXXXXXXGXXXXXXXXXXXXXXXXXXXGXXXXXXXXXXXXXXXXXXXGXXXXXXXXXXXXXXXXXXXGXXXXXXXXXXXXXXXXXXX,0,300,0
44037,13,0,13,22,265,0,0,278,215,63,GXXXXXXXXXXXXXXXXXXXGXXXXXXXXXXXXXXXXXXXGXXXXXXXXXXXXXXXXXXXGXXXXXXXXXXXXXXXXXXXGXXXXXXXXXXXXXXXXXXXGXXXXXXXXXXXXXXXXXXXGXXXXXXXXXXXXXXXXXXXGXXXXXXXXXXXXXXXXXXXGXXXXXXXXXXXXXXXXXXXGXXXXXXXXXXXXXXXXXXXGXXXXXXXXXXXXXXXXXXXGXXXXXXXXXXXXXXXXXXXGXXXXXXXXXXXXXXXXXXX,0,300,0
44058,13,0,13,21,266,0,0,278,216,62,GXXXXXXXXXXXXXXXXXXXGXXXXXXXXXXXXXXXXXXXGXXXXXXXXXXXXXXXXXXXGXXXXXXXXXXXXXXXXXXXGXXXXXXXXXXXXXXXXXXXGXXXXXXXXXXXXXXXXXXXGXXXXXXXXXXXXXXXXXXXGXXXXXXXXXXXXXXXXXXXGXXXXXXXXXXXXXXXXXXXGXXXXXXXXXXXXXXXXXXXGXXXXXXXXXXXXXXXXXXXGXXXXXXXXXXXXXXXXXXXGXXXXXXXXXXXXXXXXXXX,0,300,0
44079,13,0,13,23,264,0,0,275,215,60,GXXXXXXXXXXXXXXXXXXXGXXXXXXXXXXXXXXXXXXXGXXXXXXXXXXXXXXXXXXXGXXXXXXXXXXXXXXXXXXXGXXXXXXXXXXXXXXXXXXXGXXXXXXXXXXXXXXXXXXXGXXXXXXXXXXXXXXXXXXXGXXXXXXXXXXXXXXXXXXXGXXXXXXXXXXXXXXXXXXXGXXXXXXXXXXXXXXXXXXXGXXXXXXXXXXXXXXXXXXXGXXXXXXXXXXXXXXXXXXXGXXXXXXXXXXXXXXXXXXX,0,300,0

44100,13,0,13,25,262,0,0,274,216,58,GXXXXXXXXXXXXXXXXXXXGXXXXXXXXXXXXXXXXXXXGXXXXXXXXXXXXXXXXXXXGXXXXXXXXXXXXXXXXXXXGXXXXXXXXXXXXXXXXXXXGXXXXXXXXXXXXXXXXXXXGXXXXXXXXXXXXXXXXXXXGXXXXXXXXXXXXXXXXXXXGXXXXXXXXXXXXXXXXXXXGXXXXXXXXXXXXXXXXXXXGXXXXXXXXXXXXXXXXXXXGXXXXXXXXXXXXXXXXXXXGXXXXXXXXXXXXXXXXXXX,0,300,0
44121,13,0,13,23,264,0,0,276,218,58,GXXXXXXXXXXXXXXXXXXXGXXXXXXXXXXXXXXXXXXXGXXXXXXXXXXXXXXXXXXXGXXXXXXXXXXXXXXXXXXXGXXXXXXXXXXXXXXXXXXXGXXXXXXXXXXXXXXXXXXXGXXXXXXXXXXXXXXXXXXXGXXXXXXXXXXXXXXXXXXXGXXXXXXXXXXXXXXXXXXXGXXXXXXXXXXXXXXXXXXXGXXXXXXXXXXXXXXXXXXXGXXXXXXXXXXXXXXXXXXXGXXXXXXXXXXXXXXXXXXX,0,300,0
44142,13,0,13,23,264,0,0,276,219,57,GXXXXXXXXXXXXXXXXXXXGXXXXXXXXXXXXXXXXXXXGXXXXXXXXXXXXXXXXXXXGXXXXXXXXXXXXXXXXXXXGXXXXXXXXXXXXXXXXXXXGXXXXXXXXXXXXXXXXXXXGXXXXXXXXXXXXXXXXXXXGXXXXXXXXXXXXXXXXXXXGXXXXXXXXXXXXXXXXXXXGXXXXXXXXXXXXXXXXXXXGXXXXXXXXXXXXXXXXXXXGXXXXXXXXXXXXXXXXXXXGXXXXXXXXXXXXXXXXXXX,0,300,0
44163,13,0,13,26,261,0,0,273,216,57,GXXXXXXXXXXXXXXXXXXXGXXXXXXXXXXXXXXXXXXXGXXXXXXXXXXXXXXXXXXXGXXXXXXXXXXXXXXXXXXXGXXXXXXXXXXXXXXXXXXXGXXXXXXXXXXXXXXXXXXXGXXXXXXXXXXXXXXXXXXXGXXXXXXXXXXXXXXXXXXXGXXXXXXXXXXXXXXXXXXXGXXXXXXXXXXXXXXXXXXXGXXXXXXXXXXXXXXXXXXXGXXXXXXXXXXXXXXXXXXXGXXXXXXXXXXXXXXXXXXX,0,300,0
44184,13,0,13,28,259,0,0,271,215,56,GXXXXXXXXXXXXXXXXXXXGXXXXXXXXXXXXXXXXXXXGXXXXXXXXXXXXXXXXXXXGXXXXXXXXXXXXXXXXXXXGXXXXXXXXXXXXXXXXXXXGXXXXXXXXXXXXXXXXXXXGXXXXXXXXXXXXXXXXXXXGXXXXXXXXXXXXXXXXXXXGXXXXXXXXXXXXXXXXXXXGXXXXXXXXXXXXXXXXXXXGXXXXXXXXXXXXXXXXXXXGXXXXXXXXXXXXXXXXXXXGXXXXXXXXXXXXXXXXXXX,0,300,0

44205,13,0,13,32,255,0,0,267,218,49,GXXXXXXXXXXXXXXXXXXXGXXXXXXXXXXXXXXXXXXXGXXXXXXXXXXXXXXXXXXXGXXXXXXXXXXXXXXXXXXXGXXXXXXXXXXXXXXXXXXXGXXXXXXXXXXXXXXXXXXXGXXXXXXXXXXXXXXXXXXXGXXXXXXXXXXXXXXXXXXXGXXXXXXXXXXXXXXXXXXXGXXXXXXXXXXXXXXXXXXXGXXXXXXXXXXXXXXXXXXXGXXXXXXXXXXXXXXXXXXXGXXXXXXXXXXXXXXXXXXX,0,300,0
44226,13,0,13,32,255,0,0,267,218,49,GXXXXXXXXXXXXXXXXXXXGXXXXXXXXXXXXXXXXXXXGXXXXXXXXXXXXXXXXXXXGXXXXXXXXXXXXXXXXXXXGXXXXXXXXXXXXXXXXXXXGXXXXXXXXXXXXXXXXXXXGXXXXXXXXXXXXXXXXXXXGXXXXXXXXXXXXXXXXXXXGXXXXXXXXXXXXXXXXXXXGXXXXXXXXXXXXXXXXXXXGXXXXXXXXXXXXXXXXXXXGXXXXXXXXXXXXXXXXXXXGXXXXXXXXXXXXXXXXXXX,0,300,0
44247,13,0,13,37,250,0,0,262,217,45,GXXXXXXXXXXXXXXXXXXXGXXXXXXXXXXXXXXXXXXXGXXXXXXXXXXXXXXXXXXXGXXXXXXXXXXXXXXXXXXXGXXXXXXXXXXXXXXXXXXXGXXXXXXXXXXXXXXXXXXXGXXXXXXXXXXXXXXXXXXXGXXXXXXXXXXXXXXXXXXXGXXXXXXXXXXXXXXXXXXXGXXXXXXXXXXXXXXXXXXXGXXXXXXXXXXXXXXXXXXXGXXXXXXXXXXXXXXXXXXXGXXXXXXXXXXXXXXXXXXX,0,300,0
44268,13,0,13,33,254,0,0,266,217,49,GXXXXXXXXXXXXXXXXXXXGXXXXXXXXXXXXXXXXXXXGXXXXXXXXXXXXXXXXXXXGXXXXXXXXXXXXXXXXXXXGXXXXXXXXXXXXXXXXXXXGXXXXXXXXXXXXXXXXXXXGXXXXXXXXXXXXXXXXXXXGXXXXXXXXXXXXXXXXXXXGXXXXXXXXXXXXXXXXXXXGXXXXXXXXXXXXXXXXXXXGXXXXXXXXXXXXXXXXXXXGXXXXXXXXXXXXXXXXXXXGXXXXXXXXXXXXXXXXXXX,0,300,0
44289,13,0,13,34,253,0,0,265,217,48,GXXXXXXXXXXXXXXXXXXXGXXXXXXXXXXXXXXXXXXXGXXXXXXXXXXXXXXXXXXXGXXXXXXXXXXXXXXXXXXXGXXXXXXXXXXXXXXXXXXXGXXXXXXXXXXXXXXXXXXXGXXXXXXXXXXXXXXXXXXXGXXXXXXXXXXXXXXXXXXXGXXXXXXXXXXXXXXXXXXXGXXXXXXXXXXXXXXXXXXXGXXXXXXXXXXXXXXXXXXXGXXXXXXXXXXXXXXXXXXXGXXXXXXXXXXXXXXXXXXX,0,300,0

44310,13,0,13,33,254,0,0,266,215,51,GXXXXXXXXXXXXXXXXXXXGXXXXXXXXXXXXXXXXXXXGXXXXXXXXXXXXXXXXXXXGXXXXXXXXXXXXXXXXXXXGXXXXXXXXXXXXXXXXXXXGXXXXXXXXXXXXXXXXXXXGXXXXXXXXXXXXXXXXXXXGXXXXXXXXXXXXXXXXXXXGXXXXXXXXXXXXXXXXXXXGXXXXXXXXXXXXXXXXXXXGXXXXXXXXXXXXXXXXXXXGXXXXXXXXXXXXXXXXXXXGXXXXXXXXXXXXXXXXXXX,0,300,0
44331,13,0,13,31,256,0,0,268,216,52,GXXXXXXXXXXXXXXXXXXXGXXXXXXXXXXXXXXXXXXXGXXXXXXXXXXXXXXXXXXXGXXXXXXXXXXXXXXXXXXXGXXXXXXXXXXXXXXXXXXXGXXXXXXXXXXXXXXXXXXXGXXXXXXXXXXXXXXXXXXXGXXXXXXXXXXXXXXXXXXXGXXXXXXXXXXXXXXXXXXXGXXXXXXXXXXXXXXXXXXXGXXXXXXXXXXXXXXXXXXXGXXXXXXXXXXXXXXXXXXXGXXXXXXXXXXXXXXXXXXX,0,300,0
44352,13,0,13,32,255,0,0,267,216,51,GXXXXXXXXXXXXXXXXXXXGXXXXXXXXXXXXXXXXXXXGXXXXXXXXXXXXXXXXXXXGXXXXXXXXXXXXXXXXXXXGXXXXXXXXXXXXXXXXXXXGXXXXXXXXXXXXXXXXXXXGXXXXXXXXXXXXXXXXXXXGXXXXXXXXXXXXXXXXXXXGXXXXXXXXXXXXXXXXXXXGXXXXXXXXXXXXXXXXXXXGXXXXXXXXXXXXXXXXXXXGXXXXXXXXXXXXXXXXXXXGXXXXXXXXXXXXXXXXXXX,0,300,0
44373,13,0,13,30,257,0,0,269,215,54,GXXXXXXXXXXXXXXXXXXXGXXXXXXXXXXXXXXXXXXXGXXXXXXXXXXXXXXXXXXXGXXXXXXXXXXXXXXXXXXXGXXXXXXXXXXXXXXXXXXXGXXXXXXXXXXXXXXXXXXXGXXXXXXXXXXXXXXXXXXXGXXXXXXXXXXXXXXXXXXXGXXXXXXXXXXXXXXXXXXXGXXXXXXXXXXXXXXXXXXXGXXXXXXXXXXXXXXXXXXXGXXXXXXXXXXXXXXXXXXXGXXXXXXXXXXXXXXXXXXX,0,300,0
44394,13,0,13,30,257,0,0,269,214,55,GXXXXXXXXXXXXXXXXXXXGXXXXXXXXXXXXXXXXXXXGXXXXXXXXXXXXXXXXXXXGXXXXXXXXXXXXXXXXXXXGXXXXXXXXXXXXXXXXXXXGXXXXXXXXXXXXXXXXXXXGXXXXXXXXXXXXXXXXXXXGXXXXXXXXXXXXXXXXXXXGXXXXXXXXXXXXXXXXXXXGXXXXXXXXXXXXXXXXXXXGXXXXXXXXXXXXXXXXXXXGXXXXXXXXXXXXXXXXXXXGXXXXXXXXXXXXXXXXXXX,0,300,0

44415,13,0,13,31,256,0,0,267,215,52,GXXXXXXXXXXXXXXXXXXXGXXXXXXXXXXXXXXXXXXXGXXXXXXXXXXXXXXXXXXXGXXXXXXXXXXXXXXXXXXXGXXXXXXXXXXXXXXXXXXXGXXXXXXXXXXXXXXXXXXXGXXXXXXXXXXXXXXXXXXXGXXXXXXXXXXXXXXXXXXXGXXXXXXXXXXXXXXXXXXXGXXXXXXXXXXXXXXXXXXXGXXXXXXXXXXXXXXXXXXXGXXXXXXXXXXXXXXXXXXXGXXXXXXXXXXXXXXXXXXX,0,300,0
44436,13,0,13,33,254,0,0,266,215,51,GXXXXXXXXXXXXXXXXXXXGXXXXXXXXXXXXXXXXXXXGXXXXXXXXXXXXXXXXXXXGXXXXXXXXXXXXXXXXXXXGXXXXXXXXXXXXXXXXXXXGXXXXXXXXXXXXXXXXXXXGXXXXXXXXXXXXXXXXXXXGXXXXXXXXXXXXXXXXXXXGXXXXXXXXXXXXXXXXXXXGXXXXXXXXXXXXXXXXXXXGXXXXXXXXXXXXXXXXXXXGXXXXXXXXXXXXXXXXXXXGXXXXXXXXXXXXXXXXXXX,0,300,0
44457,13,0,13,33,254,0,0,267,216,51,GXXXXXXXXXXXXXXXXXXXGXXXXXXXXXXXXXXXXXXXGXXXXXXXXXXXXXXXXXXXGXXXXXXXXXXXXXXXXXXXGXXXXXXXXXXXXXXXXXXXGXXXXXXXXXXXXXXXXXXXGXXXXXXXXXXXXXXXXXXXGXXXXXXXXXXXXXXXXXXXGXXXXXXXXXXXXXXXXXXXGXXXXXXXXXXXXXXXXXXXGXXXXXXXXXXXXXXXXXXXGXXXXXXXXXXXXXXXXXXXGXXXXXXXXXXXXXXXXXXX,0,300,0
44478,13,0,13,32,255,0,0,267,218,49,GXXXXXXXXXXXXXXXXXXXGXXXXXXXXXXXXXXXXXXXGXXXXXXXXXXXXXXXXXXXGXXXXXXXXXXXXXXXXXXXGXXXXXXXXXXXXXXXXXXXGXXXXXXXXXXXXXXXXXXXGXXXXXXXXXXXXXXXXXXXGXXXXXXXXXXXXXXXXXXXGXXXXXXXXXXXXXXXXXXXGXXXXXXXXXXXXXXXXXXXGXXXXXXXXXXXXXXXXXXXGXXXXXXXXXXXXXXXXXXXGXXXXXXXXXXXXXXXXXXX,0,300,0
44499,13,0,13,32,255,0,0,268,222,46,GXXXXXXXXXXXXXXXXXXXGXXXXXXXXXXXXXXXXXXXGXXXXXXXXXXXXXXXXXXXGXXXXXXXXXXXXXXXXXXXGXXXXXXXXXXXXXXXXXXXGXXXXXXXXXXXXXXXXXXXGXXXXXXXXXXXXXXXXXXXGXXXXXXXXXXXXXXXXXXXGXXXXXXXXXXXXXXXXXXXGXXXXXXXXXXXXXXXXXXXGXXXXXXXXXXXXXXXXXXXGXXXXXXXXXXXXXXXXXXXGXXXXXXXXXXXXXXXXXXX,0,300,0

44520,13,0,13,34,253,0,0,266,218,48,GXXXXXXXXXXXXXXXXXXXGXXXXXXXXXXXXXXXXXXXGXXXXXXXXXXXXXXXXXXXGXXXXXXXXXXXXXXXXXXXGXXXXXXXXXXXXXXXXXXXGXXXXXXXXXXXXXXXXXXXGXXXXXXXXXXXXXXXXXXXGXXXXXXXXXXXXXXXXXXXGXXXXXXXXXXXXXXXXXXXGXXXXXXXXXXXXXXXXXXXGXXXXXXXXXXXXXXXXXXXGXXXXXXXXXXXXXXXXXXXGXXXXXXXXXXXXXXXXXXX,0,300,0
44541,13,0,13,35,252,0,0,265,217,48,GXXXXXXXXXXXXXXXXXXXGXXXXXXXXXXXXXXXXXXXGXXXXXXXXXXXXXXXXXXXGXXXXXXXXXXXXXXXXXXXGXXXXXXXXXXXXXXXXXXXGXXXXXXXXXXXXXXXXXXXGXXXXXXXXXXXXXXXXXXXGXXXXXXXXXXXXXXXXXXXGXXXXXXXXXXXXXXXXXXXGXXXXXXXXXXXXXXXXXXXGXXXXXXXXXXXXXXXXXXXGXXXXXXXXXXXXXXXXXXXGXXXXXXXXXXXXXXXXXXX,0,300,0
44562,14,1,13,34,252,0,0,265,218,47,GXXXXXXXXXXXXXXXXXXXGXXXXXXXXXXXXXXXXXXXGAXXXXXXXXXXXXXXXXXXGXXXXXXXXXXXXXXXXXXXGXXXXXXXXXXXXXXXXXXXGXXXXXXXXXXXXXXXXXXXGXXXXXXXXXXXXXXXXXXXGXXXXXXXXXXXXXXXXXXXGXXXXXXXXXXXXXXXXXXXGXXXXXXXXXXXXXXXXXXXGXXXXXXXXXXXXXXXXXXXGXXXXXXXXXXXXXXXXXXXGXXXXXXXXXXXXXXXXXXX,0,300,0
44583,14,1,13,31,255,0,0,268,218,50,GXXXXXXXXXXXXXXXXXXXGXXXXXXXXXXXXXXXXXXXGAXXXXXXXXXXXXXXXXXXGXXXXXXXXXXXXXXXXXXXGXXXXXXXXXXXXXXXXXXXGXXXXXXXXXXXXXXXXXXXGXXXXXXXXXXXXXXXXXXXGXXXXXXXXXXXXXXXXXXXGXXXXXXXXXXXXXXXXXXXGXXXXXXXXXXXXXXXXXXXGXXXXXXXXXXXXXXXXXXXGXXXXXXXXXXXXXXXXXXXGXXXXXXXXXXXXXXXXXXX,0,300,0
44604,14,1,13,33,253,0,0,266,217,49,GXXXXXXXXXXXXXXXXXXXGXXXXXXXXXXXXXXXXXXXGAXXXXXXXXXXXXXXXXXXGXXXXXXXXXXXXXXXXXXXGXXXXXXXXXXXXXXXXXXXGXXXXXXXXXXXXXXXXXXXGXXXXXXXXXXXXXXXXXXXGXXXXXXXXXXXXXXXXXXXGXXXXXXXXXXXXXXXXXXXGXXXXXXXXXXXXXXXXXXXGXXXXXXXXXXXXXXXXXXXGXXXXXXXXXXXXXXXXXXXGXXXXXXXXXXXXXXXXXXX,0,300,0

44625,14,0,14,36,250,0,0,263,216,47,GXXXXXXXXXXXXXXXXXXXGXXXXXXXXXXXXXXXXXXXGOXXXXXXXXXXXXXXXXXXGXXXXXXXXXXXXXXXXXXXGXXXXXXXXXXXXXXXXXXXGXXXXXXXXXXXXXXXXXXXGXXXXXXXXXXXXXXXXXXXGXXXXXXXXXXXXXXXXXXXGXXXXXXXXXXXXXXXXXXXGXXXXXXXXXXXXXXXXXXXGXXXXXXXXXXXXXXXXXXXGXXXXXXXXXXXXXXXXXXXGXXXXXXXXXXXXXXXXXXX,0,300,0
44646,14,0,14,33,253,0,0,266,217,49,GXXXXXXXXXXXXXXXXXXXGXXXXXXXXXXXXXXXXXXXGOXXXXXXXXXXXXXXXXXXGXXXXXXXXXXXXXXXXXXXGXXXXXXXXXXXXXXXXXXXGXXXXXXXXXXXXXXXXXXXGXXXXXXXXXXXXXXXXXXXGXXXXXXXXXXXXXXXXXXXGXXXXXXXXXXXXXXXXXXXGXXXXXXXXXXXXXXXXXXXGXXXXXXXXXXXXXXXXXXXGXXXXXXXXXXXXXXXXXXXGXXXXXXXXXXXXXXXXXXX,0,300,0
44667,13,0,13,35,252,0,0,265,217,48,GXXXXXXXXXXXXXXXXXXXGXXXXXXXXXXXXXXXXXXXGXXXXXXXXXXXXXXXXXXXGXXXXXXXXXXXXXXXXXXXGXXXXXXXXXXXXXXXXXXXGXXXXXXXXXXXXXXXXXXXGXXXXXXXXXXXXXXXXXXXGXXXXXXXXXXXXXXXXXXXGXXXXXXXXXXXXXXXXXXXGXXXXXXXXXXXXXXXXXXXGXXXXXXXXXXXXXXXXXXXGXXXXXXXXXXXXXXXXXXXGXXXXXXXXXXXXXXXXXXX,0,300,0
44688,13,0,13,31,256,0,0,269,215,54,GXXXXXXXXXXXXXXXXXXXGXXXXXXXXXXXXXXXXXXXGXXXXXXXXXXXXXXXXXXXGXXXXXXXXXXXXXXXXXXXGXXXXXXXXXXXXXXXXXXXGXXXXXXXXXXXXXXXXXXXGXXXXXXXXXXXXXXXXXXXGXXXXXXXXXXXXXXXXXXXGXXXXXXXXXXXXXXXXXXXGXXXXXXXXXXXXXXXXXXXGXXXXXXXXXXXXXXXXXXXGXXXXXXXXXXXXXXXXXXXGXXXXXXXXXXXXXXXXXXX,0,300,0
44709,13,0,13,30,257,0,0,270,217,53,GXXXXXXXXXXXXXXXXXXXGXXXXXXXXXXXXXXXXXXXGXXXXXXXXXXXXXXXXXXXGXXXXXXXXXXXXXXXXXXXGXXXXXXXXXXXXXXXXXXXGXXXXXXXXXXXXXXXXXXXGXXXXXXXXXXXXXXXXXXXGXXXXXXXXXXXXXXXXXXXGXXXXXXXXXXXXXXXXXXXGXXXXXXXXXXXXXXXXXXXGXXXXXXXXXXXXXXXXXXXGXXXXXXXXXXXXXXXXXXXGXXXXXXXXXXXXXXXXXXX,0,300,0

44730,13,0,13,32,255,0,0,267,217,50,GXXXXXXXXXXXXXXXXXXXGXXXXXXXXXXXXXXXXXXXGXXXXXXXXXXXXXXXXXXXGXXXXXXXXXXXXXXXXXXXGXXXXXXXXXXXXXXXXXXXGXXXXXXXXXXXXXXXXXXXGXXXXXXXXXXXXXXXXXXXGXXXXXXXXXXXXXXXXXXXGXXXXXXXXXXXXXXXXXXXGXXXXXXXXXXXXXXXXXXXGXXXXXXXXXXXXXXXXXXXGXXXXXXXXXXXXXXXXXXXGXXXXXXXXXXXXXXXXXXX,0,300,0
44751,13,0,13,30,257,0,0,269,216,53,GXXXXXXXXXXXXXXXXXXXGXXXXXXXXXXXXXXXXXXXGXXXXXXXXXXXXXXXXXXXGXXXXXXXXXXXXXXXXXXXGXXXXXXXXXXXXXXXXXXXGXXXXXXXXXXXXXXXXXXXGXXXXXXXXXXXXXXXXXXXGXXXXXXXXXXXXXXXXXXXGXXXXXXXXXXXXXXXXXXXGXXXXXXXXXXXXXXXXXXXGXXXXXXXXXXXXXXXXXXXGXXXXXXXXXXXXXXXXXXXGXXXXXXXXXXXXXXXXXXX,0,300,0
44772,13,0,13,30,257,0,0,269,217,52,GXXXXXXXXXXXXXXXXXXXGXXXXXXXXXXXXXXXXXXXGXXXXXXXXXXXXXXXXXXXGXXXXXXXXXXXXXXXXXXXGXXXXXXXXXXXXXXXXXXXGXXXXXXXXXXXXXXXXXXXGXXXXXXXXXXXXXXXXXXXGXXXXXXXXXXXXXXXXXXXGXXXXXXXXXXXXXXXXXXXGXXXXXXXXXXXXXXXXXXXGXXXXXXXXXXXXXXXXXXXGXXXXXXXXXXXXXXXXXXXGXXXXXXXXXXXXXXXXXXX,0,300,0
44793,13,0,13,31,256,0,0,268,219,49,GXXXXXXXXXXXXXXXXXXXGXXXXXXXXXXXXXXXXXXXGXXXXXXXXXXXXXXXXXXXGXXXXXXXXXXXXXXXXXXXGXXXXXXXXXXXXXXXXXXXGXXXXXXXXXXXXXXXXXXXGXXXXXXXXXXXXXXXXXXXGXXXXXXXXXXXXXXXXXXXGXXXXXXXXXXXXXXXXXXXGXXXXXXXXXXXXXXXXXXXGXXXXXXXXXXXXXXXXXXXGXXXXXXXXXXXXXXXXXXXGXXXXXXXXXXXXXXXXXXX,0,300,0
44814,13,0,13,33,254,0,0,266,216,50,GXXXXXXXXXXXXXXXXXXXGXXXXXXXXXXXXXXXXXXXGXXXXXXXXXXXXXXXXXXXGXXXXXXXXXXXXXXXXXXXGXXXXXXXXXXXXXXXXXXXGXXXXXXXXXXXXXXXXXXXGXXXXXXXXXXXXXXXXXXXGXXXXXXXXXXXXXXXXXXXGXXXXXXXXXXXXXXXXXXXGXXXXXXXXXXXXXXXXXXXGXXXXXXXXXXXXXXXXXXXGXXXXXXXXXXXXXXXXXXXGXXXXXXXXXXXXXXXXXXX,0,300,0

44835,13,0,13,31,256,0,0,269,215,54,GXXXXXXXXXXXXXXXXXXXGXXXXXXXXXXXXXXXXXXXGXXXXXXXXXXXXXXXXXXXGXXXXXXXXXXXXXXXXXXXGXXXXXXXXXXXXXXXXXXXGXXXXXXXXXXXXXXXXXXXGXXXXXXXXXXXXXXXXXXXGXXXXXXXXXXXXXXXXXXXGXXXXXXXXXXXXXXXXXXXGXXXXXXXXXXXXXXXXXXXGXXXXXXXXXXXXXXXXXXXGXXXXXXXXXXXXXXXXXXXGXXXXXXXXXXXXXXXXXXX,0,300,0
44856,13,0,13,31,256,0,0,269,215,54,GXXXXXXXXXXXXXXXXXXXGXXXXXXXXXXXXXXXXXXXGXXXXXXXXXXXXXXXXXXXGXXXXXXXXXXXXXXXXXXXGXXXXXXXXXXXXXXXXXXXGXXXXXXXXXXXXXXXXXXXGXXXXXXXXXXXXXXXXXXXGXXXXXXXXXXXXXXXXXXXGXXXXXXXXXXXXXXXXXXXGXXXXXXXXXXXXXXXXXXXGXXXXXXXXXXXXXXXXXXXGXXXXXXXXXXXXXXXXXXXGXXXXXXXXXXXXXXXXXXX,0,300,0
44877,13,0,13,32,255,0,0,268,215,53,GXXXXXXXXXXXXXXXXXXXGXXXXXXXXXXXXXXXXXXXGXXXXXXXXXXXXXXXXXXXGXXXXXXXXXXXXXXXXXXXGXXXXXXXXXXXXXXXXXXXGXXXXXXXXXXXXXXXXXXXGXXXXXXXXXXXXXXXXXXXGXXXXXXXXXXXXXXXXXXXGXXXXXXXXXXXXXXXXXXXGXXXXXXXXXXXXXXXXXXXGXXXXXXXXXXXXXXXXXXXGXXXXXXXXXXXXXXXXXXXGXXXXXXXXXXXXXXXXXXX,0,300,0
44898,13,0,13,29,258,0,0,271,215,56,GXXXXXXXXXXXXXXXXXXXGXXXXXXXXXXXXXXXXXXXGXXXXXXXXXXXXXXXXXXXGXXXXXXXXXXXXXXXXXXXGXXXXXXXXXXXXXXXXXXXGXXXXXXXXXXXXXXXXXXXGXXXXXXXXXXXXXXXXXXXGXXXXXXXXXXXXXXXXXXXGXXXXXXXXXXXXXXXXXXXGXXXXXXXXXXXXXXXXXXXGXXXXXXXXXXXXXXXXXXXGXXXXXXXXXXXXXXXXXXXGXXXXXXXXXXXXXXXXXXX,0,300,0
44919,13,0,13,27,260,0,0,272,215,57,GXXXXXXXXXXXXXXXXXXXGXXXXXXXXXXXXXXXXXXXGXXXXXXXXXXXXXXXXXXXGXXXXXXXXXXXXXXXXXXXGXXXXXXXXXXXXXXXXXXXGXXXXXXXXXXXXXXXXXXXGXXXXXXXXXXXXXXXXXXXGXXXXXXXXXXXXXXXXXXXGXXXXXXXXXXXXXXXXXXXGXXXXXXXXXXXXXXXXXXXGXXXXXXXXXXXXXXXXXXXGXXXXXXXXXXXXXXXXXXXGXXXXXXXXXXXXXXXXXXX,0,300,0

44940,13,0,13,27,260,0,0,273,217,56,GXXXXXXXXXXXXXXXXXXXGXXXXXXXXXXXXXXXXXXXGXXXXXXXXXXXXXXXXXXXGXXXXXXXXXXXXXXXXXXXGXXXXXXXXXXXXXXXXXXXGXXXXXXXXXXXXXXXXXXXGXXXXXXXXXXXXXXXXXXXGXXXXXXXXXXXXXXXXXXXGXXXXXXXXXXXXXXXXXXXGXXXXXXXXXXXXXXXXXXXGXXXXXXXXXXXXXXXXXXXGXXXXXXXXXXXXXXXXXXXGXXXXXXXXXXXXXXXXXXX,0,300,0
44961,13,0,13,27,260,0,0,273,219,54,GXXXXXXXXXXXXXXXXXXXGXXXXXXXXXXXXXXXXXXXGXXXXXXXXXXXXXXXXXXXGXXXXXXXXXXXXXXXXXXXGXXXXXXXXXXXXXXXXXXXGXXXXXXXXXXXXXXXXXXXGXXXXXXXXXXXXXXXXXXXGXXXXXXXXXXXXXXXXXXXGXXXXXXXXXXXXXXXXXXXGXXXXXXXXXXXXXXXXXXXGXXXXXXXXXXXXXXXXXXXGXXXXXXXXXXXXXXXXXXXGXXXXXXXXXXXXXXXXXXX,0,300,0
44982,13,0,13,27,260,0,0,273,217,56,GXXXXXXXXXXXXXXXXXXXGXXXXXXXXXXXXXXXXXXXGXXXXXXXXXXXXXXXXXXXGXXXXXXXXXXXXXXXXXXXGXXXXXXXXXXXXXXXXXXXGXXXXXXXXXXXXXXXXXXXGXXXXXXXXXXXXXXXXXXXGXXXXXXXXXXXXXXXXXXXGXXXXXXXXXXXXXXXXXXXGXXXXXXXXXXXXXXXXXXXGXXXXXXXXXXXXXXXXXXXGXXXXXXXXXXXXXXXXXXXGXXXXXXXXXXXXXXXXXXX,0,300,0
45003,13,0,13,31,256,0,0,269,218,51,GXXXXXXXXXXXXXXXXXXXGXXXXXXXXXXXXXXXXXXXGXXXXXXXXXXXXXXXXXXXGXXXXXXXXXXXXXXXXXXXGXXXXXXXXXXXXXXXXXXXGXXXXXXXXXXXXXXXXXXXGXXXXXXXXXXXXXXXXXXXGXXXXXXXXXXXXXXXXXXXGXXXXXXXXXXXXXXXXXXXGXXXXXXXXXXXXXXXXXXXGXXXXXXXXXXXXXXXXXXXGXXXXXXXXXXXXXXXXXXXGXXXXXXXXXXXXXXXXXXX,0,300,0
45024,13,0,13,31,256,0,0,269,219,50,GXXXXXXXXXXXXXXXXXXXGXXXXXXXXXXXXXXXXXXXGXXXXXXXXXXXXXXXXXXXGXXXXXXXXXXXXXXXXXXXGXXXXXXXXXXXXXXXXXXXGXXXXXXXXXXXXXXXXXXXGXXXXXXXXXXXXXXXXXXXGXXXXXXXXXXXXXXXXXXXGXXXXXXXXXXXXXXXXXXXGXXXXXXXXXXXXXXXXXXXGXXXXXXXXXXXXXXXXXXXGXXXXXXXXXXXXXXXXXXXGXXXXXXXXXXXXXXXXXXX,0,300,0

45045,13,0,13,31,256,0,0,269,219,50,GXXXXXXXXXXXXXXXXXXXGXXXXXXXXXXXXXXXXXXXGXXXXXXXXXXXXXXXXXXXGXXXXXXXXXXXXXXXXXXXGXXXXXXXXXXXXXXXXXXXGXXXXXXXXXXXXXXXXXXXGXXXXXXXXXXXXXXXXXXXGXXXXXXXXXXXXXXXXXXXGXXXXXXXXXXXXXXXXXXXGXXXXXXXXXXXXXXXXXXXGXXXXXXXXXXXXXXXXXXXGXXXXXXXXXXXXXXXXXXXGXXXXXXXXXXXXXXXXXXX,0,300,0
45066,13,0,13,32,255,0,0,267,218,49,GXXXXXXXXXXXXXXXXXXXGXXXXXXXXXXXXXXXXXXXGXXXXXXXXXXXXXXXXXXXGXXXXXXXXXXXXXXXXXXXGXXXXXXXXXXXXXXXXXXXGXXXXXXXXXXXXXXXXXXXGXXXXXXXXXXXXXXXXXXXGXXXXXXXXXXXXXXXXXXXGXXXXXXXXXXXXXXXXXXXGXXXXXXXXXXXXXXXXXXXGXXXXXXXXXXXXXXXXXXXGXXXXXXXXXXXXXXXXXXXGXXXXXXXXXXXXXXXXXXX,0,300,0
45087,13,0,13,31,256,0,0,269,217,52,GXXXXXXXXXXXXXXXXXXXGXXXXXXXXXXXXXXXXXXXGXXXXXXXXXXXXXXXXXXXGXXXXXXXXXXXXXXXXXXXGXXXXXXXXXXXXXXXXXXXGXXXXXXXXXXXXXXXXXXXGXXXXXXXXXXXXXXXXXXXGXXXXXXXXXXXXXXXXXXXGXXXXXXXXXXXXXXXXXXXGXXXXXXXXXXXXXXXXXXXGXXXXXXXXXXXXXXXXXXXGXXXXXXXXXXXXXXXXXXXGXXXXXXXXXXXXXXXXXXX,0,300,0
45108,13,0,13,28,259,0,0,272,218,54,GXXXXXXXXXXXXXXXXXXXGXXXXXXXXXXXXXXXXXXXGXXXXXXXXXXXXXXXXXXXGXXXXXXXXXXXXXXXXXXXGXXXXXXXXXXXXXXXXXXXGXXXXXXXXXXXXXXXXXXXGXXXXXXXXXXXXXXXXXXXGXXXXXXXXXXXXXXXXXXXGXXXXXXXXXXXXXXXXXXXGXXXXXXXXXXXXXXXXXXXGXXXXXXXXXXXXXXXXXXXGXXXXXXXXXXXXXXXXXXXGXXXXXXXXXXXXXXXXXXX,0,300,0
45129,13,0,13,27,260,0,0,273,215,58,GXXXXXXXXXXXXXXXXXXXGXXXXXXXXXXXXXXXXXXXGXXXXXXXXXXXXXXXXXXXGXXXXXXXXXXXXXXXXXXXGXXXXXXXXXXXXXXXXXXXGXXXXXXXXXXXXXXXXXXXGXXXXXXXXXXXXXXXXXXXGXXXXXXXXXXXXXXXXXXXGXXXXXXXXXXXXXXXXXXXGXXXXXXXXXXXXXXXXXXXGXXXXXXXXXXXXXXXXXXXGXXXXXXXXXXXXXXXXXXXGXXXXXXXXXXXXXXXXXXX,0,300,0

45150,13,0,13,30,257,0,0,270,214,56,GXXXXXXXXXXXXXXXXXXXGXXXXXXXXXXXXXXXXXXXGXXXXXXXXXXXXXXXXXXXGXXXXXXXXXXXXXXXXXXXGXXXXXXXXXXXXXXXXXXXGXXXXXXXXXXXXXXXXXXXGXXXXXXXXXXXXXXXXXXXGXXXXXXXXXXXXXXXXXXXGXXXXXXXXXXXXXXXXXXXGXXXXXXXXXXXXXXXXXXXGXXXXXXXXXXXXXXXXXXXGXXXXXXXXXXXXXXXXXXXGXXXXXXXXXXXXXXXXXXX,0,300,0
45171,14,1,13,26,260,0,0,272,216,56,GXXXXXXXXXXXXXXXXXXXGXXXXXXXXXXXXXXXXXXXGXXXXXXXXXXXXXXXXXXXGXXXXXXXXXXXXXXXXXXXGXXXXXXXXXXXXXXXXXXXGAXXXXXXXXXXXXXXXXXXGXXXXXXXXXXXXXXXXXXXGXXXXXXXXXXXXXXXXXXXGXXXXXXXXXXXXXXXXXXXGXXXXXXXXXXXXXXXXXXXGXXXXXXXXXXXXXXXXXXXGXXXXXXXXXXXXXXXXXXXGXXXXXXXXXXXXXXXXXXX,0,300,0
45192,14,1,13,28,258,0,0,270,214,56,GXXXXXXXXXXXXXXXXXXXGXXXXXXXXXXXXXXXXXXXGXXXXXXXXXXXXXXXXXXXGXXXXXXXXXXXXXXXXXXXGXXXXXXXXXXXXXXXXXXXGAXXXXXXXXXXXXXXXXXXGXXXXXXXXXXXXXXXXXXXGXXXXXXXXXXXXXXXXXXXGXXXXXXXXXXXXXXXXXXXGXXXXXXXXXXXXXXXXXXXGXXXXXXXXXXXXXXXXXXXGXXXXXXXXXXXXXXXXXXXGXXXXXXXXXXXXXXXXXXX,0,300,0
45213,14,1,13,27,259,0,0,272,219,53,GXXXXXXXXXXXXXXXXXXXGXXXXXXXXXXXXXXXXXXXGXXXXXXXXXXXXXXXXXXXGXXXXXXXXXXXXXXXXXXXGXXXXXXXXXXXXXXXXXXXGAXXXXXXXXXXXXXXXXXXGXXXXXXXXXXXXXXXXXXXGXXXXXXXXXXXXXXXXXXXGXXXXXXXXXXXXXXXXXXXGXXXXXXXXXXXXXXXXXXXGXXXXXXXXXXXXXXXXXXXGXXXXXXXXXXXXXXXXXXXGXXXXXXXXXXXXXXXXXXX,0,300,0
45234,14,1,13,28,258,0,0,270,217,53,GXXXXXXXXXXXXXXXXXXXGXXXXXXXXXXXXXXXXXXXGXXXXXXXXXXXXXXXXXXXGXXXXXXXXXXXXXXXXXXXGXXXXXXXXXXXXXXXXXXXGAXXXXXXXXXXXXXXXXXXGXXXXXXXXXXXXXXXXXXXGXXXXXXXXXXXXXXXXXXXGXXXXXXXXXXXXXXXXXXXGXXXXXXXXXXXXXXXXXXXGXXXXXXXXXXXXXXXXXXXGXXXXXXXXXXXXXXXXXXXGXXXXXXXXXXXXXXXXXXX,0,300,0

45255,13,0,13,28,259,0,0,272,218,54,GXXXXXXXXXXXXXXXXXXXGXXXXXXXXXXXXXXXXXXXGXXXXXXXXXXXXXXXXXXXGXXXXXXXXXXXXXXXXXXXGXXXXXXXXXXXXXXXXXXXGXXXXXXXXXXXXXXXXXXXGXXXXXXXXXXXXXXXXXXXGXXXXXXXXXXXXXXXXXXXGXXXXXXXXXXXXXXXXXXXGXXXXXXXXXXXXXXXXXXXGXXXXXXXXXXXXXXXXXXXGXXXXXXXXXXXXXXXXXXXGXXXXXXXXXXXXXXXXXXX,0,300,0
45276,13,0,13,28,259,0,0,272,217,55,GXXXXXXXXXXXXXXXXXXXGXXXXXXXXXXXXXXXXXXXGXXXXXXXXXXXXXXXXXXXGXXXXXXXXXXXXXXXXXXXGXXXXXXXXXXXXXXXXXXXGXXXXXXXXXXXXXXXXXXXGXXXXXXXXXXXXXXXXXXXGXXXXXXXXXXXXXXXXXXXGXXXXXXXXXXXXXXXXXXXGXXXXXXXXXXXXXXXXXXXGXXXXXXXXXXXXXXXXXXXGXXXXXXXXXXXXXXXXXXXGXXXXXXXXXXXXXXXXXXX,0,300,0
45297,13,0,13,28,259,0,0,272,221,51,GXXXXXXXXXXXXXXXXXXXGXXXXXXXXXXXXXXXXXXXGXXXXXXXXXXXXXXXXXXXGXXXXXXXXXXXXXXXXXXXGXXXXXXXXXXXXXXXXXXXGXXXXXXXXXXXXXXXXXXXGXXXXXXXXXXXXXXXXXXXGXXXXXXXXXXXXXXXXXXXGXXXXXXXXXXXXXXXXXXXGXXXXXXXXXXXXXXXXXXXGXXXXXXXXXXXXXXXXXXXGXXXXXXXXXXXXXXXXXXXGXXXXXXXXXXXXXXXXXXX,0,300,0
45318,13,0,13,33,254,0,0,267,215,52,GXXXXXXXXXXXXXXXXXXXGXXXXXXXXXXXXXXXXXXXGXXXXXXXXXXXXXXXXXXXGXXXXXXXXXXXXXXXXXXXGXXXXXXXXXXXXXXXXXXXGXXXXXXXXXXXXXXXXXXXGXXXXXXXXXXXXXXXXXXXGXXXXXXXXXXXXXXXXXXXGXXXXXXXXXXXXXXXXXXXGXXXXXXXXXXXXXXXXXXXGXXXXXXXXXXXXXXXXXXXGXXXXXXXXXXXXXXXXXXXGXXXXXXXXXXXXXXXXXXX,0,300,0
45339,13,0,13,30,257,0,0,270,219,51,GXXXXXXXXXXXXXXXXXXXGXXXXXXXXXXXXXXXXXXXGXXXXXXXXXXXXXXXXXXXGXXXXXXXXXXXXXXXXXXXGXXXXXXXXXXXXXXXXXXXGXXXXXXXXXXXXXXXXXXXGXXXXXXXXXXXXXXXXXXXGXXXXXXXXXXXXXXXXXXXGXXXXXXXXXXXXXXXXXXXGXXXXXXXXXXXXXXXXXXXGXXXXXXXXXXXXXXXXXXXGXXXXXXXXXXXXXXXXXXXGXXXXXXXXXXXXXXXXXXX,0,300,0

45360,13,0,13,33,254,0,0,267,218,49,GXXXXXXXXXXXXXXXXXXXGXXXXXXXXXXXXXXXXXXXGXXXXXXXXXXXXXXXXXXXGXXXXXXXXXXXXXXXXXXXGXXXXXXXXXXXXXXXXXXXGXXXXXXXXXXXXXXXXXXXGXXXXXXXXXXXXXXXXXXXGXXXXXXXXXXXXXXXXXXXGXXXXXXXXXXXXXXXXXXXGXXXXXXXXXXXXXXXXXXXGXXXXXXXXXXXXXXXXXXXGXXXXXXXXXXXXXXXXXXXGXXXXXXXXXXXXXXXXXXX,0,300,0
45381,13,0,13,32,255,0,0,268,219,49,GXXXXXXXXXXXXXXXXXXXGXXXXXXXXXXXXXXXXXXXGXXXXXXXXXXXXXXXXXXXGXXXXXXXXXXXXXXXXXXXGXXXXXXXXXXXXXXXXXXXGXXXXXXXXXXXXXXXXXXXGXXXXXXXXXXXXXXXXXXXGXXXXXXXXXXXXXXXXXXXGXXXXXXXXXXXXXXXXXXXGXXXXXXXXXXXXXXXXXXXGXXXXXXXXXXXXXXXXXXXGXXXXXXXXXXXXXXXXXXXGXXXXXXXXXXXXXXXXXXX,0,300,0
45402,13,0,13,31,256,0,0,270,220,50,GXXXXXXXXXXXXXXXXXXXGXXXXXXXXXXXXXXXXXXXGXXXXXXXXXXXXXXXXXXXGXXXXXXXXXXXXXXXXXXXGXXXXXXXXXXXXXXXXXXXGXXXXXXXXXXXXXXXXXXXGXXXXXXXXXXXXXXXXXXXGXXXXXXXXXXXXXXXXXXXGXXXXXXXXXXXXXXXXXXXGXXXXXXXXXXXXXXXXXXXGXXXXXXXXXXXXXXXXXXXGXXXXXXXXXXXXXXXXXXXGXXXXXXXXXXXXXXXXXXX,0,300,0
45423,13,0,13,30,257,0,0,270,221,49,GXXXXXXXXXXXXXXXXXXXGXXXXXXXXXXXXXXXXXXXGXXXXXXXXXXXXXXXXXXXGXXXXXXXXXXXXXXXXXXXGXXXXXXXXXXXXXXXXXXXGXXXXXXXXXXXXXXXXXXXGXXXXXXXXXXXXXXXXXXXGXXXXXXXXXXXXXXXXXXXGXXXXXXXXXXXXXXXXXXXGXXXXXXXXXXXXXXXXXXXGXXXXXXXXXXXXXXXXXXXGXXXXXXXXXXXXXXXXXXXGXXXXXXXXXXXXXXXXXXX,0,300,0
45444,13,0,13,34,253,0,0,266,218,48,GXXXXXXXXXXXXXXXXXXXGXXXXXXXXXXXXXXXXXXXGXXXXXXXXXXXXXXXXXXXGXXXXXXXXXXXXXXXXXXXGXXXXXXXXXXXXXXXXXXXGXXXXXXXXXXXXXXXXXXXGXXXXXXXXXXXXXXXXXXXGXXXXXXXXXXXXXXXXXXXGXXXXXXXXXXXXXXXXXXXGXXXXXXXXXXXXXXXXXXXGXXXXXXXXXXXXXXXXXXXGXXXXXXXXXXXXXXXXXXXGXXXXXXXXXXXXXXXXXXX,0,300,0

45465,13,0,13,31,256,0,0,269,221,48,GXXXXXXXXXXXXXXXXXXXGXXXXXXXXXXXXXXXXXXXGXXXXXXXXXXXXXXXXXXXGXXXXXXXXXXXXXXXXXXXGXXXXXXXXXXXXXXXXXXXGXXXXXXXXXXXXXXXXXXXGXXXXXXXXXXXXXXXXXXXGXXXXXXXXXXXXXXXXXXXGXXXXXXXXXXXXXXXXXXXGXXXXXXXXXXXXXXXXXXXGXXXXXXXXXXXXXXXXXXXGXXXXXXXXXXXXXXXXXXXGXXXXXXXXXXXXXXXXXXX,0,300,0
45486,13,0,13,29,258,0,0,270,220,50,GXXXXXXXXXXXXXXXXXXXGXXXXXXXXXXXXXXXXXXXGXXXXXXXXXXXXXXXXXXXGXXXXXXXXXXXXXXXXXXXGXXXXXXXXXXXXXXXXXXXGXXXXXXXXXXXXXXXXXXXGXXXXXXXXXXXXXXXXXXXGXXXXXXXXXXXXXXXXXXXGXXXXXXXXXXXXXXXXXXXGXXXXXXXXXXXXXXXXXXXGXXXXXXXXXXXXXXXXXXXGXXXXXXXXXXXXXXXXXXXGXXXXXXXXXXXXXXXXXXX,0,300,0
45507,13,0,13,30,257,0,0,270,219,51,GXXXXXXXXXXXXXXXXXXXGXXXXXXXXXXXXXXXXXXXGXXXXXXXXXXXXXXXXXXXGXXXXXXXXXXXXXXXXXXXGXXXXXXXXXXXXXXXXXXXGXXXXXXXXXXXXXXXXXXXGXXXXXXXXXXXXXXXXXXXGXXXXXXXXXXXXXXXXXXXGXXXXXXXXXXXXXXXXXXXGXXXXXXXXXXXXXXXXXXXGXXXXXXXXXXXXXXXXXXXGXXXXXXXXXXXXXXXXXXXGXXXXXXXXXXXXXXXXXXX,0,300,0
45528,13,0,13,28,259,0,0,271,221,50,GXXXXXXXXXXXXXXXXXXXGXXXXXXXXXXXXXXXXXXXGXXXXXXXXXXXXXXXXXXXGXXXXXXXXXXXXXXXXXXXGXXXXXXXXXXXXXXXXXXXGXXXXXXXXXXXXXXXXXXXGXXXXXXXXXXXXXXXXXXXGXXXXXXXXXXXXXXXXXXXGXXXXXXXXXXXXXXXXXXXGXXXXXXXXXXXXXXXXXXXGXXXXXXXXXXXXXXXXXXXGXXXXXXXXXXXXXXXXXXXGXXXXXXXXXXXXXXXXXXX,0,300,0
45549,14,1,13,31,255,0,0,267,214,53,GXXXXXXXXXXXXXXXXXXXGXXXXXXXXXXXXXXXXXXXGXXXXXXXXXXXXXXXXXXXGXXXXXXXXXXXXXXXXXXXGXXXXXXXXXXXXXXXXXXXGXXXXXXXXXXXXXXXXXXXGAXXXXXXXXXXXXXXXXXXGXXXXXXXXXXXXXXXXXXXGXXXXXXXXXXXXXXXXXXXGXXXXXXXXXXXXXXXXXXXGXXXXXXXXXXXXXXXXXXXGXXXXXXXXXXXXXXXXXXXGXXXXXXXXXXXXXXXXXXX,0,300,0

45570,14,0,14,31,255,0,0,267,217,50,GXXXXXXXXXXXXXXXXXXXGXXXXXXXXXXXXXXXXXXXGXXXXXXXXXXXXXXXXXXXGXXXXXXXXXXXXXXXXXXXGXXXXXXXXXXXXXXXXXXXGXXXXXXXXXXXXXXXXXXXGOXXXXXXXXXXXXXXXXXXGXXXXXXXXXXXXXXXXXXXGXXXXXXXXXXXXXXXXXXXGXXXXXXXXXXXXXXXXXXXGXXXXXXXXXXXXXXXXXXXGXXXXXXXXXXXXXXXXXXXGXXXXXXXXXXXXXXXXXXX,0,300,0
45591,14,0,14,29,257,0,0,269,216,53,GXXXXXXXXXXXXXXXXXXXGXXXXXXXXXXXXXXXXXXXGXXXXXXXXXXXXXXXXXXXGXXXXXXXXXXXXXXXXXXXGXXXXXXXXXXXXXXXXXXXGXXXXXXXXXXXXXXXXXXXGOXXXXXXXXXXXXXXXXXXGXXXXXXXXXXXXXXXXXXXGXXXXXXXXXXXXXXXXXXXGXXXXXXXXXXXXXXXXXXXGXXXXXXXXXXXXXXXXXXXGXXXXXXXXXXXXXXXXXXXGXXXXXXXXXXXXXXXXXXX,0,300,0
45612,13,0,13,29,258,0,0,270,217,53,GXXXXXXXXXXXXXXXXXXXGXXXXXXXXXXXXXXXXXXXGXXXXXXXXXXXXXXXXXXXGXXXXXXXXXXXXXXXXXXXGXXXXXXXXXXXXXXXXXXXGXXXXXXXXXXXXXXXXXXXGXXXXXXXXXXXXXXXXXXXGXXXXXXXXXXXXXXXXXXXGXXXXXXXXXXXXXXXXXXXGXXXXXXXXXXXXXXXXXXXGXXXXXXXXXXXXXXXXXXXGXXXXXXXXXXXXXXXXXXXGXXXXXXXXXXXXXXXXXXX,0,300,0
45633,13,0,13,29,258,0,0,270,217,53,GXXXXXXXXXXXXXXXXXXXGXXXXXXXXXXXXXXXXXXXGXXXXXXXXXXXXXXXXXXXGXXXXXXXXXXXXXXXXXXXGXXXXXXXXXXXXXXXXXXXGXXXXXXXXXXXXXXXXXXXGXXXXXXXXXXXXXXXXXXXGXXXXXXXXXXXXXXXXXXXGXXXXXXXXXXXXXXXXXXXGXXXXXXXXXXXXXXXXXXXGXXXXXXXXXXXXXXXXXXXGXXXXXXXXXXXXXXXXXXXGXXXXXXXXXXXXXXXXXXX,0,300,0
45654,13,0,13,28,259,0,0,271,218,53,GXXXXXXXXXXXXXXXXXXXGXXXXXXXXXXXXXXXXXXXGXXXXXXXXXXXXXXXXXXXGXXXXXXXXXXXXXXXXXXXGXXXXXXXXXXXXXXXXXXXGXXXXXXXXXXXXXXXXXXXGXXXXXXXXXXXXXXXXXXXGXXXXXXXXXXXXXXXXXXXGXXXXXXXXXXXXXXXXXXXGXXXXXXXXXXXXXXXXXXXGXXXXXXXXXXXXXXXXXXXGXXXXXXXXXXXXXXXXXXXGXXXXXXXXXXXXXXXXXXX,0,300,0

45675,13,0,13,25,262,0,0,274,216,58,GXXXXXXXXXXXXXXXXXXXGXXXXXXXXXXXXXXXXXXXGXXXXXXXXXXXXXXXXXXXGXXXXXXXXXXXXXXXXXXXGXXXXXXXXXXXXXXXXXXXGXXXXXXXXXXXXXXXXXXXGXXXXXXXXXXXXXXXXXXXGXXXXXXXXXXXXXXXXXXXGXXXXXXXXXXXXXXXXXXXGXXXXXXXXXXXXXXXXXXXGXXXXXXXXXXXXXXXXXXXGXXXXXXXXXXXXXXXXXXXGXXXXXXXXXXXXXXXXXXX,0,300,0
45696,13,0,13,25,262,0,0,274,217,57,GXXXXXXXXXXXXXXXXXXXGXXXXXXXXXXXXXXXXXXXGXXXXXXXXXXXXXXXXXXXGXXXXXXXXXXXXXXXXXXXGXXXXXXXXXXXXXXXXXXXGXXXXXXXXXXXXXXXXXXXGXXXXXXXXXXXXXXXXXXXGXXXXXXXXXXXXXXXXXXXGXXXXXXXXXXXXXXXXXXXGXXXXXXXXXXXXXXXXXXXGXXXXXXXXXXXXXXXXXXXGXXXXXXXXXXXXXXXXXXXGXXXXXXXXXXXXXXXXXXX,0,300,0
45717,13,0,13,28,259,0,0,271,219,52,GXXXXXXXXXXXXXXXXXXXGXXXXXXXXXXXXXXXXXXXGXXXXXXXXXXXXXXXXXXXGXXXXXXXXXXXXXXXXXXXGXXXXXXXXXXXXXXXXXXXGXXXXXXXXXXXXXXXXXXXGXXXXXXXXXXXXXXXXXXXGXXXXXXXXXXXXXXXXXXXGXXXXXXXXXXXXXXXXXXXGXXXXXXXXXXXXXXXXXXXGXXXXXXXXXXXXXXXXXXXGXXXXXXXXXXXXXXXXXXXGXXXXXXXXXXXXXXXXXXX,0,300,0
45738,13,0,13,28,259,0,0,271,219,52,GXXXXXXXXXXXXXXXXXXXGXXXXXXXXXXXXXXXXXXXGXXXXXXXXXXXXXXXXXXXGXXXXXXXXXXXXXXXXXXXGXXXXXXXXXXXXXXXXXXXGXXXXXXXXXXXXXXXXXXXGXXXXXXXXXXXXXXXXXXXGXXXXXXXXXXXXXXXXXXXGXXXXXXXXXXXXXXXXXXXGXXXXXXXXXXXXXXXXXXXGXXXXXXXXXXXXXXXXXXXGXXXXXXXXXXXXXXXXXXXGXXXXXXXXXXXXXXXXXXX,0,300,0
45759,13,0,13,28,259,0,0,271,221,50,GXXXXXXXXXXXXXXXXXXXGXXXXXXXXXXXXXXXXXXXGXXXXXXXXXXXXXXXXXXXGXXXXXXXXXXXXXXXXXXXGXXXXXXXXXXXXXXXXXXXGXXXXXXXXXXXXXXXXXXXGXXXXXXXXXXXXXXXXXXXGXXXXXXXXXXXXXXXXXXXGXXXXXXXXXXXXXXXXXXXGXXXXXXXXXXXXXXXXXXXGXXXXXXXXXXXXXXXXXXXGXXXXXXXXXXXXXXXXXXXGXXXXXXXXXXXXXXXXXXX,0,300,0

45780,13,0,13,31,256,0,0,268,218,50,GXXXXXXXXXXXXXXXXXXXGXXXXXXXXXXXXXXXXXXXGXXXXXXXXXXXXXXXXXXXGXXXXXXXXXXXXXXXXXXXGXXXXXXXXXXXXXXXXXXXGXXXXXXXXXXXXXXXXXXXGXXXXXXXXXXXXXXXXXXXGXXXXXXXXXXXXXXXXXXXGXXXXXXXXXXXXXXXXXXXGXXXXXXXXXXXXXXXXXXXGXXXXXXXXXXXXXXXXXXXGXXXXXXXXXXXXXXXXXXXGXXXXXXXXXXXXXXXXXXX,0,300,0
45801,13,0,13,31,256,0,0,268,218,50,GXXXXXXXXXXXXXXXXXXXGXXXXXXXXXXXXXXXXXXXGXXXXXXXXXXXXXXXXXXXGXXXXXXXXXXXXXXXXXXXGXXXXXXXXXXXXXXXXXXXGXXXXXXXXXXXXXXXXXXXGXXXXXXXXXXXXXXXXXXXGXXXXXXXXXXXXXXXXXXXGXXXXXXXXXXXXXXXXXXXGXXXXXXXXXXXXXXXXXXXGXXXXXXXXXXXXXXXXXXXGXXXXXXXXXXXXXXXXXXXGXXXXXXXXXXXXXXXXXXX,0,300,0
45822,13,0,13,31,256,0,0,268,215,53,GXXXXXXXXXXXXXXXXXXXGXXXXXXXXXXXXXXXXXXXGXXXXXXXXXXXXXXXXXXXGXXXXXXXXXXXXXXXXXXXGXXXXXXXXXXXXXXXXXXXGXXXXXXXXXXXXXXXXXXXGXXXXXXXXXXXXXXXXXXXGXXXXXXXXXXXXXXXXXXXGXXXXXXXXXXXXXXXXXXXGXXXXXXXXXXXXXXXXXXXGXXXXXXXXXXXXXXXXXXXGXXXXXXXXXXXXXXXXXXXGXXXXXXXXXXXXXXXXXXX,0,300,0
45843,13,0,13,29,258,0,0,270,215,55,GXXXXXXXXXXXXXXXXXXXGXXXXXXXXXXXXXXXXXXXGXXXXXXXXXXXXXXXXXXXGXXXXXXXXXXXXXXXXXXXGXXXXXXXXXXXXXXXXXXXGXXXXXXXXXXXXXXXXXXXGXXXXXXXXXXXXXXXXXXXGXXXXXXXXXXXXXXXXXXXGXXXXXXXXXXXXXXXXXXXGXXXXXXXXXXXXXXXXXXXGXXXXXXXXXXXXXXXXXXXGXXXXXXXXXXXXXXXXXXXGXXXXXXXXXXXXXXXXXXX,0,300,0
45864,13,0,13,28,259,0,0,270,221,49,GXXXXXXXXXXXXXXXXXXXGXXXXXXXXXXXXXXXXXXXGXXXXXXXXXXXXXXXXXXXGXXXXXXXXXXXXXXXXXXXGXXXXXXXXXXXXXXXXXXXGXXXXXXXXXXXXXXXXXXXGXXXXXXXXXXXXXXXXXXXGXXXXXXXXXXXXXXXXXXXGXXXXXXXXXXXXXXXXXXXGXXXXXXXXXXXXXXXXXXXGXXXXXXXXXXXXXXXXXXXGXXXXXXXXXXXXXXXXXXXGXXXXXXXXXXXXXXXXXXX,0,300,0

45885,13,0,13,28,259,0,0,270,220,50,GXXXXXXXXXXXXXXXXXXXGXXXXXXXXXXXXXXXXXXXGXXXXXXXXXXXXXXXXXXXGXXXXXXXXXXXXXXXXXXXGXXXXXXXXXXXXXXXXXXXGXXXXXXXXXXXXXXXXXXXGXXXXXXXXXXXXXXXXXXXGXXXXXXXXXXXXXXXXXXXGXXXXXXXXXXXXXXXXXXXGXXXXXXXXXXXXXXXXXXXGXXXXXXXXXXXXXXXXXXXGXXXXXXXXXXXXXXXXXXXGXXXXXXXXXXXXXXXXXXX,0,300,0
45906,13,0,13,29,258,0,0,269,217,52,GXXXXXXXXXXXXXXXXXXXGXXXXXXXXXXXXXXXXXXXGXXXXXXXXXXXXXXXXXXXGXXXXXXXXXXXXXXXXXXXGXXXXXXXXXXXXXXXXXXXGXXXXXXXXXXXXXXXXXXXGXXXXXXXXXXXXXXXXXXXGXXXXXXXXXXXXXXXXXXXGXXXXXXXXXXXXXXXXXXXGXXXXXXXXXXXXXXXXXXXGXXXXXXXXXXXXXXXXXXXGXXXXXXXXXXXXXXXXXXXGXXXXXXXXXXXXXXXXXXX,0,300,0
45927,13,0,13,32,255,0,0,267,215,52,GXXXXXXXXXXXXXXXXXXXGXXXXXXXXXXXXXXXXXXXGXXXXXXXXXXXXXXXXXXXGXXXXXXXXXXXXXXXXXXXGXXXXXXXXXXXXXXXXXXXGXXXXXXXXXXXXXXXXXXXGXXXXXXXXXXXXXXXXXXXGXXXXXXXXXXXXXXXXXXXGXXXXXXXXXXXXXXXXXXXGXXXXXXXXXXXXXXXXXXXGXXXXXXXXXXXXXXXXXXXGXXXXXXXXXXXXXXXXXXXGXXXXXXXXXXXXXXXXXXX,0,300,0
45948,13,0,13,26,261,0,0,273,216,57,GXXXXXXXXXXXXXXXXXXXGXXXXXXXXXXXXXXXXXXXGXXXXXXXXXXXXXXXXXXXGXXXXXXXXXXXXXXXXXXXGXXXXXXXXXXXXXXXXXXXGXXXXXXXXXXXXXXXXXXXGXXXXXXXXXXXXXXXXXXXGXXXXXXXXXXXXXXXXXXXGXXXXXXXXXXXXXXXXXXXGXXXXXXXXXXXXXXXXXXXGXXXXXXXXXXXXXXXXXXXGXXXXXXXXXXXXXXXXXXXGXXXXXXXXXXXXXXXXXXX,0,300,0
45969,13,0,13,25,262,0,0,274,219,55,GXXXXXXXXXXXXXXXXXXXGXXXXXXXXXXXXXXXXXXXGXXXXXXXXXXXXXXXXXXXGXXXXXXXXXXXXXXXXXXXGXXXXXXXXXXXXXXXXXXXGXXXXXXXXXXXXXXXXXXXGXXXXXXXXXXXXXXXXXXXGXXXXXXXXXXXXXXXXXXXGXXXXXXXXXXXXXXXXXXXGXXXXXXXXXXXXXXXXXXXGXXXXXXXXXXXXXXXXXXXGXXXXXXXXXXXXXXXXXXXGXXXXXXXXXXXXXXXXXXX,0,300,0

45990,13,0,13,25,262,0,0,274,222,52,GXXXXXXXXXXXXXXXXXXXGXXXXXXXXXXXXXXXXXXXGXXXXXXXXXXXXXXXXXXXGXXXXXXXXXXXXXXXXXXXGXXXXXXXXXXXXXXXXXXXGXXXXXXXXXXXXXXXXXXXGXXXXXXXXXXXXXXXXXXXGXXXXXXXXXXXXXXXXXXXGXXXXXXXXXXXXXXXXXXXGXXXXXXXXXXXXXXXXXXXGXXXXXXXXXXXXXXXXXXXGXXXXXXXXXXXXXXXXXXXGXXXXXXXXXXXXXXXXXXX,0,300,0
46011,13,0,13,25,262,0,0,273,219,54,GXXXXXXXXXXXXXXXXXXXGXXXXXXXXXXXXXXXXXXXGXXXXXXXXXXXXXXXXXXXGXXXXXXXXXXXXXXXXXXXGXXXXXXXXXXXXXXXXXXXGXXXXXXXXXXXXXXXXXXXGXXXXXXXXXXXXXXXXXXXGXXXXXXXXXXXXXXXXXXXGXXXXXXXXXXXXXXXXXXXGXXXXXXXXXXXXXXXXXXXGXXXXXXXXXXXXXXXXXXXGXXXXXXXXXXXXXXXXXXXGXXXXXXXXXXXXXXXXXXX,0,300,0
46032,13,0,13,23,264,0,0,276,219,57,GXXXXXXXXXXXXXXXXXXXGXXXXXXXXXXXXXXXXXXXGXXXXXXXXXXXXXXXXXXXGXXXXXXXXXXXXXXXXXXXGXXXXXXXXXXXXXXXXXXXGXXXXXXXXXXXXXXXXXXXGXXXXXXXXXXXXXXXXXXXGXXXXXXXXXXXXXXXXXXXGXXXXXXXXXXXXXXXXXXXGXXXXXXXXXXXXXXXXXXXGXXXXXXXXXXXXXXXXXXXGXXXXXXXXXXXXXXXXXXXGXXXXXXXXXXXXXXXXXXX,0,300,0
46053,13,0,13,23,264,0,0,275,218,57,GXXXXXXXXXXXXXXXXXXXGXXXXXXXXXXXXXXXXXXXGXXXXXXXXXXXXXXXXXXXGXXXXXXXXXXXXXXXXXXXGXXXXXXXXXXXXXXXXXXXGXXXXXXXXXXXXXXXXXXXGXXXXXXXXXXXXXXXXXXXGXXXXXXXXXXXXXXXXXXXGXXXXXXXXXXXXXXXXXXXGXXXXXXXXXXXXXXXXXXXGXXXXXXXXXXXXXXXXXXXGXXXXXXXXXXXXXXXXXXXGXXXXXXXXXXXXXXXXXXX,0,300,0
46074,13,0,13,21,266,0,0,277,217,60,GXXXXXXXXXXXXXXXXXXXGXXXXXXXXXXXXXXXXXXXGXXXXXXXXXXXXXXXXXXXGXXXXXXXXXXXXXXXXXXXGXXXXXXXXXXXXXXXXXXXGXXXXXXXXXXXXXXXXXXXGXXXXXXXXXXXXXXXXXXXGXXXXXXXXXXXXXXXXXXXGXXXXXXXXXXXXXXXXXXXGXXXXXXXXXXXXXXXXXXXGXXXXXXXXXXXXXXXXXXXGXXXXXXXXXXXXXXXXXXXGXXXXXXXXXXXXXXXXXXX,0,300,0

46095,13,0,13,21,266,0,0,278,223,55,GXXXXXXXXXXXXXXXXXXXGXXXXXXXXXXXXXXXXXXXGXXXXXXXXXXXXXXXXXXXGXXXXXXXXXXXXXXXXXXXGXXXXXXXXXXXXXXXXXXXGXXXXXXXXXXXXXXXXXXXGXXXXXXXXXXXXXXXXXXXGXXXXXXXXXXXXXXXXXXXGXXXXXXXXXXXXXXXXXXXGXXXXXXXXXXXXXXXXXXXGXXXXXXXXXXXXXXXXXXXGXXXXXXXXXXXXXXXXXXXGXXXXXXXXXXXXXXXXXXX,0,300,0
46116,13,0,13,26,261,0,0,273,223,50,GXXXXXXXXXXXXXXXXXXXGXXXXXXXXXXXXXXXXXXXGXXXXXXXXXXXXXXXXXXXGXXXXXXXXXXXXXXXXXXXGXXXXXXXXXXXXXXXXXXXGXXXXXXXXXXXXXXXXXXXGXXXXXXXXXXXXXXXXXXXGXXXXXXXXXXXXXXXXXXXGXXXXXXXXXXXXXXXXXXXGXXXXXXXXXXXXXXXXXXXGXXXXXXXXXXXXXXXXXXXGXXXXXXXXXXXXXXXXXXXGXXXXXXXXXXXXXXXXXXX,0,300,0
46137,13,0,13,28,259,0,0,271,219,52,GXXXXXXXXXXXXXXXXXXXGXXXXXXXXXXXXXXXXXXXGXXXXXXXXXXXXXXXXXXXGXXXXXXXXXXXXXXXXXXXGXXXXXXXXXXXXXXXXXXXGXXXXXXXXXXXXXXXXXXXGXXXXXXXXXXXXXXXXXXXGXXXXXXXXXXXXXXXXXXXGXXXXXXXXXXXXXXXXXXXGXXXXXXXXXXXXXXXXXXXGXXXXXXXXXXXXXXXXXXXGXXXXXXXXXXXXXXXXXXXGXXXXXXXXXXXXXXXXXXX,0,300,0
46158,13,0,13,27,260,0,0,272,218,54,GXXXXXXXXXXXXXXXXXXXGXXXXXXXXXXXXXXXXXXXGXXXXXXXXXXXXXXXXXXXGXXXXXXXXXXXXXXXXXXXGXXXXXXXXXXXXXXXXXXXGXXXXXXXXXXXXXXXXXXXGXXXXXXXXXXXXXXXXXXXGXXXXXXXXXXXXXXXXXXXGXXXXXXXXXXXXXXXXXXXGXXXXXXXXXXXXXXXXXXXGXXXXXXXXXXXXXXXXXXXGXXXXXXXXXXXXXXXXXXXGXXXXXXXXXXXXXXXXXXX,0,300,0
46179,13,0,13,27,260,0,0,272,220,52,GXXXXXXXXXXXXXXXXXXXGXXXXXXXXXXXXXXXXXXXGXXXXXXXXXXXXXXXXXXXGXXXXXXXXXXXXXXXXXXXGXXXXXXXXXXXXXXXXXXXGXXXXXXXXXXXXXXXXXXXGXXXXXXXXXXXXXXXXXXXGXXXXXXXXXXXXXXXXXXXGXXXXXXXXXXXXXXXXXXXGXXXXXXXXXXXXXXXXXXXGXXXXXXXXXXXXXXXXXXXGXXXXXXXXXXXXXXXXXXXGXXXXXXXXXXXXXXXXXXX,0,300,0

46200,13,0,13,28,259,0,0,271,220,51,GXXXXXXXXXXXXXXXXXXXGXXXXXXXXXXXXXXXXXXXGXXXXXXXXXXXXXXXXXXXGXXXXXXXXXXXXXXXXXXXGXXXXXXXXXXXXXXXXXXXGXXXXXXXXXXXXXXXXXXXGXXXXXXXXXXXXXXXXXXXGXXXXXXXXXXXXXXXXXXXGXXXXXXXXXXXXXXXXXXXGXXXXXXXXXXXXXXXXXXXGXXXXXXXXXXXXXXXXXXXGXXXXXXXXXXXXXXXXXXXGXXXXXXXXXXXXXXXXXXX,0,300,0
46221,13,0,13,31,256,0,0,268,220,48,GXXXXXXXXXXXXXXXXXXXGXXXXXXXXXXXXXXXXXXXGXXXXXXXXXXXXXXXXXXXGXXXXXXXXXXXXXXXXXXXGXXXXXXXXXXXXXXXXXXXGXXXXXXXXXXXXXXXXXXXGXXXXXXXXXXXXXXXXXXXGXXXXXXXXXXXXXXXXXXXGXXXXXXXXXXXXXXXXXXXGXXXXXXXXXXXXXXXXXXXGXXXXXXXXXXXXXXXXXXXGXXXXXXXXXXXXXXXXXXXGXXXXXXXXXXXXXXXXXXX,0,300,0
46242,13,0,13,31,256,0,0,268,219,49,GXXXXXXXXXXXXXXXXXXXGXXXXXXXXXXXXXXXXXXXGXXXXXXXXXXXXXXXXXXXGXXXXXXXXXXXXXXXXXXXGXXXXXXXXXXXXXXXXXXXGXXXXXXXXXXXXXXXXXXXGXXXXXXXXXXXXXXXXXXXGXXXXXXXXXXXXXXXXXXXGXXXXXXXXXXXXXXXXXXXGXXXXXXXXXXXXXXXXXXXGXXXXXXXXXXXXXXXXXXXGXXXXXXXXXXXXXXXXXXXGXXXXXXXXXXXXXXXXXXX,0,300,0
46263,13,0,13,34,253,0,0,265,216,49,GXXXXXXXXXXXXXXXXXXXGXXXXXXXXXXXXXXXXXXXGXXXXXXXXXXXXXXXXXXXGXXXXXXXXXXXXXXXXXXXGXXXXXXXXXXXXXXXXXXXGXXXXXXXXXXXXXXXXXXXGXXXXXXXXXXXXXXXXXXXGXXXXXXXXXXXXXXXXXXXGXXXXXXXXXXXXXXXXXXXGXXXXXXXXXXXXXXXXXXXGXXXXXXXXXXXXXXXXXXXGXXXXXXXXXXXXXXXXXXXGXXXXXXXXXXXXXXXXXXX,0,300,0
46284,13,0,13,33,254,0,0,266,219,47,GXXXXXXXXXXXXXXXXXXXGXXXXXXXXXXXXXXXXXXXGXXXXXXXXXXXXXXXXXXXGXXXXXXXXXXXXXXXXXXXGXXXXXXXXXXXXXXXXXXXGXXXXXXXXXXXXXXXXXXXGXXXXXXXXXXXXXXXXXXXGXXXXXXXXXXXXXXXXXXXGXXXXXXXXXXXXXXXXXXXGXXXXXXXXXXXXXXXXXXXGXXXXXXXXXXXXXXXXXXXGXXXXXXXXXXXXXXXXXXXGXXXXXXXXXXXXXXXXXXX,0,300,0

46305,13,0,13,32,255,0,0,267,221,46,GXXXXXXXXXXXXXXXXXXXGXXXXXXXXXXXXXXXXXXXGXXXXXXXXXXXXXXXXXXXGXXXXXXXXXXXXXXXXXXXGXXXXXXXXXXXXXXXXXXXGXXXXXXXXXXXXXXXXXXXGXXXXXXXXXXXXXXXXXXXGXXXXXXXXXXXXXXXXXXXGXXXXXXXXXXXXXXXXXXXGXXXXXXXXXXXXXXXXXXXGXXXXXXXXXXXXXXXXXXXGXXXXXXXXXXXXXXXXXXXGXXXXXXXXXXXXXXXXXXX,0,300,0
46326,13,0,13,30,257,0,0,269,221,48,GXXXXXXXXXXXXXXXXXXXGXXXXXXXXXXXXXXXXXXXGXXXXXXXXXXXXXXXXXXXGXXXXXXXXXXXXXXXXXXXGXXXXXXXXXXXXXXXXXXXGXXXXXXXXXXXXXXXXXXXGXXXXXXXXXXXXXXXXXXXGXXXXXXXXXXXXXXXXXXXGXXXXXXXXXXXXXXXXXXXGXXXXXXXXXXXXXXXXXXXGXXXXXXXXXXXXXXXXXXXGXXXXXXXXXXXXXXXXXXXGXXXXXXXXXXXXXXXXXXX,0,300,0
46347,13,0,13,36,251,0,0,263,220,43,GXXXXXXXXXXXXXXXXXXXGXXXXXXXXXXXXXXXXXXXGXXXXXXXXXXXXXXXXXXXGXXXXXXXXXXXXXXXXXXXGXXXXXXXXXXXXXXXXXXXGXXXXXXXXXXXXXXXXXXXGXXXXXXXXXXXXXXXXXXXGXXXXXXXXXXXXXXXXXXXGXXXXXXXXXXXXXXXXXXXGXXXXXXXXXXXXXXXXXXXGXXXXXXXXXXXXXXXXXXXGXXXXXXXXXXXXXXXXXXXGXXXXXXXXXXXXXXXXXXX,0,300,0
46368,13,0,13,36,251,0,0,263,220,43,GXXXXXXXXXXXXXXXXXXXGXXXXXXXXXXXXXXXXXXXGXXXXXXXXXXXXXXXXXXXGXXXXXXXXXXXXXXXXXXXGXXXXXXXXXXXXXXXXXXXGXXXXXXXXXXXXXXXXXXXGXXXXXXXXXXXXXXXXXXXGXXXXXXXXXXXXXXXXXXXGXXXXXXXXXXXXXXXXXXXGXXXXXXXXXXXXXXXXXXXGXXXXXXXXXXXXXXXXXXXGXXXXXXXXXXXXXXXXXXXGXXXXXXXXXXXXXXXXXXX,0,300,0
46389,13,0,13,37,250,0,0,262,218,44,GXXXXXXXXXXXXXXXXXXXGXXXXXXXXXXXXXXXXXXXGXXXXXXXXXXXXXXXXXXXGXXXXXXXXXXXXXXXXXXXGXXXXXXXXXXXXXXXXXXXGXXXXXXXXXXXXXXXXXXXGXXXXXXXXXXXXXXXXXXXGXXXXXXXXXXXXXXXXXXXGXXXXXXXXXXXXXXXXXXXGXXXXXXXXXXXXXXXXXXXGXXXXXXXXXXXXXXXXXXXGXXXXXXXXXXXXXXXXXXXGXXXXXXXXXXXXXXXXXXX,0,300,0

46410,13,0,13,36,251,0,0,263,219,44,GXXXXXXXXXXXXXXXXXXXGXXXXXXXXXXXXXXXXXXXGXXXXXXXXXXXXXXXXXXXGXXXXXXXXXXXXXXXXXXXGXXXXXXXXXXXXXXXXXXXGXXXXXXXXXXXXXXXXXXXGXXXXXXXXXXXXXXXXXXXGXXXXXXXXXXXXXXXXXXXGXXXXXXXXXXXXXXXXXXXGXXXXXXXXXXXXXXXXXXXGXXXXXXXXXXXXXXXXXXXGXXXXXXXXXXXXXXXXXXXGXXXXXXXXXXXXXXXXXXX,0,300,0
46431,13,0,13,34,253,0,0,264,220,44,GXXXXXXXXXXXXXXXXXXXGXXXXXXXXXXXXXXXXXXXGXXXXXXXXXXXXXXXXXXXGXXXXXXXXXXXXXXXXXXXGXXXXXXXXXXXXXXXXXXXGXXXXXXXXXXXXXXXXXXXGXXXXXXXXXXXXXXXXXXXGXXXXXXXXXXXXXXXXXXXGXXXXXXXXXXXXXXXXXXXGXXXXXXXXXXXXXXXXXXXGXXXXXXXXXXXXXXXXXXXGXXXXXXXXXXXXXXXXXXXGXXXXXXXXXXXXXXXXXXX,0,300,0
46452,13,0,13,37,250,0,0,262,219,43,GXXXXXXXXXXXXXXXXXXXGXXXXXXXXXXXXXXXXXXXGXXXXXXXXXXXXXXXXXXXGXXXXXXXXXXXXXXXXXXXGXXXXXXXXXXXXXXXXXXXGXXXXXXXXXXXXXXXXXXXGXXXXXXXXXXXXXXXXXXXGXXXXXXXXXXXXXXXXXXXGXXXXXXXXXXXXXXXXXXXGXXXXXXXXXXXXXXXXXXXGXXXXXXXXXXXXXXXXXXXGXXXXXXXXXXXXXXXXXXXGXXXXXXXXXXXXXXXXXXX,0,300,0
46473,13,0,13,35,252,0,0,264,221,43,GXXXXXXXXXXXXXXXXXXXGXXXXXXXXXXXXXXXXXXXGXXXXXXXXXXXXXXXXXXXGXXXXXXXXXXXXXXXXXXXGXXXXXXXXXXXXXXXXXXXGXXXXXXXXXXXXXXXXXXXGXXXXXXXXXXXXXXXXXXXGXXXXXXXXXXXXXXXXXXXGXXXXXXXXXXXXXXXXXXXGXXXXXXXXXXXXXXXXXXXGXXXXXXXXXXXXXXXXXXXGXXXXXXXXXXXXXXXXXXXGXXXXXXXXXXXXXXXXXXX,0,300,0
46494,13,0,13,34,253,0,0,265,222,43,GXXXXXXXXXXXXXXXXXXXGXXXXXXXXXXXXXXXXXXXGXXXXXXXXXXXXXXXXXXXGXXXXXXXXXXXXXXXXXXXGXXXXXXXXXXXXXXXXXXXGXXXXXXXXXXXXXXXXXXXGXXXXXXXXXXXXXXXXXXXGXXXXXXXXXXXXXXXXXXXGXXXXXXXXXXXXXXXXXXXGXXXXXXXXXXXXXXXXXXXGXXXXXXXXXXXXXXXXXXXGXXXXXXXXXXXXXXXXXXXGXXXXXXXXXXXXXXXXXXX,0,300,0

46515,13,0,13,33,254,0,0,265,220,45,GXXXXXXXXXXXXXXXXXXXGXXXXXXXXXXXXXXXXXXXGXXXXXXXXXXXXXXXXXXXGXXXXXXXXXXXXXXXXXXXGXXXXXXXXXXXXXXXXXXXGXXXXXXXXXXXXXXXXXXXGXXXXXXXXXXXXXXXXXXXGXXXXXXXXXXXXXXXXXXXGXXXXXXXXXXXXXXXXXXXGXXXXXXXXXXXXXXXXXXXGXXXXXXXXXXXXXXXXXXXGXXXXXXXXXXXXXXXXXXXGXXXXXXXXXXXXXXXXXXX,0,300,0
46536,13,0,13,32,255,0,0,267,218,49,GXXXXXXXXXXXXXXXXXXXGXXXXXXXXXXXXXXXXXXXGXXXXXXXXXXXXXXXXXXXGXXXXXXXXXXXXXXXXXXXGXXXXXXXXXXXXXXXXXXXGXXXXXXXXXXXXXXXXXXXGXXXXXXXXXXXXXXXXXXXGXXXXXXXXXXXXXXXXXXXGXXXXXXXXXXXXXXXXXXXGXXXXXXXXXXXXXXXXXXXGXXXXXXXXXXXXXXXXXXXGXXXXXXXXXXXXXXXXXXXGXXXXXXXXXXXXXXXXXXX,0,300,0
46557,13,0,13,33,254,0,0,266,219,47,GXXXXXXXXXXXXXXXXXXXGXXXXXXXXXXXXXXXXXXXGXXXXXXXXXXXXXXXXXXXGXXXXXXXXXXXXXXXXXXXGXXXXXXXXXXXXXXXXXXXGXXXXXXXXXXXXXXXXXXXGXXXXXXXXXXXXXXXXXXXGXXXXXXXXXXXXXXXXXXXGXXXXXXXXXXXXXXXXXXXGXXXXXXXXXXXXXXXXXXXGXXXXXXXXXXXXXXXXXXXGXXXXXXXXXXXXXXXXXXXGXXXXXXXXXXXXXXXXXXX,0,300,0
46578,13,0,13,30,257,0,0,268,221,47,GXXXXXXXXXXXXXXXXXXXGXXXXXXXXXXXXXXXXXXXGXXXXXXXXXXXXXXXXXXXGXXXXXXXXXXXXXXXXXXXGXXXXXXXXXXXXXXXXXXXGXXXXXXXXXXXXXXXXXXXGXXXXXXXXXXXXXXXXXXXGXXXXXXXXXXXXXXXXXXXGXXXXXXXXXXXXXXXXXXXGXXXXXXXXXXXXXXXXXXXGXXXXXXXXXXXXXXXXXXXGXXXXXXXXXXXXXXXXXXXGXXXXXXXXXXXXXXXXXXX,0,300,0
46599,13,0,13,27,260,0,0,272,220,52,GXXXXXXXXXXXXXXXXXXXGXXXXXXXXXXXXXXXXXXXGXXXXXXXXXXXXXXXXXXXGXXXXXXXXXXXXXXXXXXXGXXXXXXXXXXXXXXXXXXXGXXXXXXXXXXXXXXXXXXXGXXXXXXXXXXXXXXXXXXXGXXXXXXXXXXXXXXXXXXXGXXXXXXXXXXXXXXXXXXXGXXXXXXXXXXXXXXXXXXXGXXXXXXXXXXXXXXXXXXXGXXXXXXXXXXXXXXXXXXXGXXXXXXXXXXXXXXXXXXX,0,300,0

46620,13,0,13,26,261,0,0,273,220,53,GXXXXXXXXXXXXXXXXXXXGXXXXXXXXXXXXXXXXXXXGXXXXXXXXXXXXXXXXXXXGXXXXXXXXXXXXXXXXXXXGXXXXXXXXXXXXXXXXXXXGXXXXXXXXXXXXXXXXXXXGXXXXXXXXXXXXXXXXXXXGXXXXXXXXXXXXXXXXXXXGXXXXXXXXXXXXXXXXXXXGXXXXXXXXXXXXXXXXXXXGXXXXXXXXXXXXXXXXXXXGXXXXXXXXXXXXXXXXXXXGXXXXXXXXXXXXXXXXXXX,0,300,0
46641,13,0,13,26,261,0,0,274,220,54,GXXXXXXXXXXXXXXXXXXXGXXXXXXXXXXXXXXXXXXXGXXXXXXXXXXXXXXXXXXXGXXXXXXXXXXXXXXXXXXXGXXXXXXXXXXXXXXXXXXXGXXXXXXXXXXXXXXXXXXXGXXXXXXXXXXXXXXXXXXXGXXXXXXXXXXXXXXXXXXXGXXXXXXXXXXXXXXXXXXXGXXXXXXXXXXXXXXXXXXXGXXXXXXXXXXXXXXXXXXXGXXXXXXXXXXXXXXXXXXXGXXXXXXXXXXXXXXXXXXX,0,300,0
46662,13,0,13,28,259,0,0,271,218,53,GXXXXXXXXXXXXXXXXXXXGXXXXXXXXXXXXXXXXXXXGXXXXXXXXXXXXXXXXXXXGXXXXXXXXXXXXXXXXXXXGXXXXXXXXXXXXXXXXXXXGXXXXXXXXXXXXXXXXXXXGXXXXXXXXXXXXXXXXXXXGXXXXXXXXXXXXXXXXXXXGXXXXXXXXXXXXXXXXXXXGXXXXXXXXXXXXXXXXXXXGXXXXXXXXXXXXXXXXXXXGXXXXXXXXXXXXXXXXXXXGXXXXXXXXXXXXXXXXXXX,0,300,0
46683,13,0,13,26,261,0,0,273,218,55,GXXXXXXXXXXXXXXXXXXXGXXXXXXXXXXXXXXXXXXXGXXXXXXXXXXXXXXXXXXXGXXXXXXXXXXXXXXXXXXXGXXXXXXXXXXXXXXXXXXXGXXXXXXXXXXXXXXXXXXXGXXXXXXXXXXXXXXXXXXXGXXXXXXXXXXXXXXXXXXXGXXXXXXXXXXXXXXXXXXXGXXXXXXXXXXXXXXXXXXXGXXXXXXXXXXXXXXXXXXXGXXXXXXXXXXXXXXXXXXXGXXXXXXXXXXXXXXXXXXX,0,300,0
46704,13,0,13,27,260,0,0,272,220,52,GXXXXXXXXXXXXXXXXXXXGXXXXXXXXXXXXXXXXXXXGXXXXXXXXXXXXXXXXXXXGXXXXXXXXXXXXXXXXXXXGXXXXXXXXXXXXXXXXXXXGXXXXXXXXXXXXXXXXXXXGXXXXXXXXXXXXXXXXXXXGXXXXXXXXXXXXXXXXXXXGXXXXXXXXXXXXXXXXXXXGXXXXXXXXXXXXXXXXXXXGXXXXXXXXXXXXXXXXXXXGXXXXXXXXXXXXXXXXXXXGXXXXXXXXXXXXXXXXXXX,0,300,0

46725,13,0,13,28,259,0,0,270,219,51,GXXXXXXXXXXXXXXXXXXXGXXXXXXXXXXXXXXXXXXXGXXXXXXXXXXXXXXXXXXXGXXXXXXXXXXXXXXXXXXXGXXXXXXXXXXXXXXXXXXXGXXXXXXXXXXXXXXXXXXXGXXXXXXXXXXXXXXXXXXXGXXXXXXXXXXXXXXXXXXXGXXXXXXXXXXXXXXXXXXXGXXXXXXXXXXXXXXXXXXXGXXXXXXXXXXXXXXXXXXXGXXXXXXXXXXXXXXXXXXXGXXXXXXXXXXXXXXXXXXX,0,300,0
46746,13,0,13,28,259,0,0,271,219,52,GXXXXXXXXXXXXXXXXXXXGXXXXXXXXXXXXXXXXXXXGXXXXXXXXXXXXXXXXXXXGXXXXXXXXXXXXXXXXXXXGXXXXXXXXXXXXXXXXXXXGXXXXXXXXXXXXXXXXXXXGXXXXXXXXXXXXXXXXXXXGXXXXXXXXXXXXXXXXXXXGXXXXXXXXXXXXXXXXXXXGXXXXXXXXXXXXXXXXXXXGXXXXXXXXXXXXXXXXXXXGXXXXXXXXXXXXXXXXXXXGXXXXXXXXXXXXXXXXXXX,0,300,0
46767,13,0,13,28,259,0,0,270,217,53,GXXXXXXXXXXXXXXXXXXXGXXXXXXXXXXXXXXXXXXXGXXXXXXXXXXXXXXXXXXXGXXXXXXXXXXXXXXXXXXXGXXXXXXXXXXXXXXXXXXXGXXXXXXXXXXXXXXXXXXXGXXXXXXXXXXXXXXXXXXXGXXXXXXXXXXXXXXXXXXXGXXXXXXXXXXXXXXXXXXXGXXXXXXXXXXXXXXXXXXXGXXXXXXXXXXXXXXXXXXXGXXXXXXXXXXXXXXXXXXXGXXXXXXXXXXXXXXXXXXX,0,300,0
46788,13,0,13,29,258,0,0,270,218,52,GXXXXXXXXXXXXXXXXXXXGXXXXXXXXXXXXXXXXXXXGXXXXXXXXXXXXXXXXXXXGXXXXXXXXXXXXXXXXXXXGXXXXXXXXXXXXXXXXXXXGXXXXXXXXXXXXXXXXXXXGXXXXXXXXXXXXXXXXXXXGXXXXXXXXXXXXXXXXXXXGXXXXXXXXXXXXXXXXXXXGXXXXXXXXXXXXXXXXXXXGXXXXXXXXXXXXXXXXXXXGXXXXXXXXXXXXXXXXXXXGXXXXXXXXXXXXXXXXXXX,0,300,0
46809,13,0,13,27,260,0,0,271,218,53,GXXXXXXXXXXXXXXXXXXXGXXXXXXXXXXXXXXXXXXXGXXXXXXXXXXXXXXXXXXXGXXXXXXXXXXXXXXXXXXXGXXXXXXXXXXXXXXXXXXXGXXXXXXXXXXXXXXXXXXXGXXXXXXXXXXXXXXXXXXXGXXXXXXXXXXXXXXXXXXXGXXXXXXXXXXXXXXXXXXXGXXXXXXXXXXXXXXXXXXXGXXXXXXXXXXXXXXXXXXXGXXXXXXXXXXXXXXXXXXXGXXXXXXXXXXXXXXXXXXX,0,300,0

46830,13,0,13,25,262,0,0,274,223,51,GXXXXXXXXXXXXXXXXXXXGXXXXXXXXXXXXXXXXXXXGXXXXXXXXXXXXXXXXXXXGXXXXXXXXXXXXXXXXXXXGXXXXXXXXXXXXXXXXXXXGXXXXXXXXXXXXXXXXXXXGXXXXXXXXXXXXXXXXXXXGXXXXXXXXXXXXXXXXXXXGXXXXXXXXXXXXXXXXXXXGXXXXXXXXXXXXXXXXXXXGXXXXXXXXXXXXXXXXXXXGXXXXXXXXXXXXXXXXXXXGXXXXXXXXXXXXXXXXXXX,0,300,0
46851,13,0,13,24,263,0,0,275,222,53,GXXXXXXXXXXXXXXXXXXXGXXXXXXXXXXXXXXXXXXXGXXXXXXXXXXXXXXXXXXXGXXXXXXXXXXXXXXXXXXXGXXXXXXXXXXXXXXXXXXXGXXXXXXXXXXXXXXXXXXXGXXXXXXXXXXXXXXXXXXXGXXXXXXXXXXXXXXXXXXXGXXXXXXXXXXXXXXXXXXXGXXXXXXXXXXXXXXXXXXXGXXXXXXXXXXXXXXXXXXXGXXXXXXXXXXXXXXXXXXXGXXXXXXXXXXXXXXXXXXX,0,300,0
46872,13,0,13,25,262,0,0,274,222,52,GXXXXXXXXXXXXXXXXXXXGXXXXXXXXXXXXXXXXXXXGXXXXXXXXXXXXXXXXXXXGXXXXXXXXXXXXXXXXXXXGXXXXXXXXXXXXXXXXXXXGXXXXXXXXXXXXXXXXXXXGXXXXXXXXXXXXXXXXXXXGXXXXXXXXXXXXXXXXXXXGXXXXXXXXXXXXXXXXXXXGXXXXXXXXXXXXXXXXXXXGXXXXXXXXXXXXXXXXXXXGXXXXXXXXXXXXXXXXXXXGXXXXXXXXXXXXXXXXXXX,0,300,0
46893,13,0,13,24,263,0,0,275,228,47,GXXXXXXXXXXXXXXXXXXXGXXXXXXXXXXXXXXXXXXXGXXXXXXXXXXXXXXXXXXXGXXXXXXXXXXXXXXXXXXXGXXXXXXXXXXXXXXXXXXXGXXXXXXXXXXXXXXXXXXXGXXXXXXXXXXXXXXXXXXXGXXXXXXXXXXXXXXXXXXXGXXXXXXXXXXXXXXXXXXXGXXXXXXXXXXXXXXXXXXXGXXXXXXXXXXXXXXXXXXXGXXXXXXXXXXXXXXXXXXXGXXXXXXXXXXXXXXXXXXX,0,300,0
46914,13,0,13,30,257,0,0,269,223,46,GXXXXXXXXXXXXXXXXXXXGXXXXXXXXXXXXXXXXXXXGXXXXXXXXXXXXXXXXXXXGXXXXXXXXXXXXXXXXXXXGXXXXXXXXXXXXXXXXXXXGXXXXXXXXXXXXXXXXXXXGXXXXXXXXXXXXXXXXXXXGXXXXXXXXXXXXXXXXXXXGXXXXXXXXXXXXXXXXXXXGXXXXXXXXXXXXXXXXXXXGXXXXXXXXXXXXXXXXXXXGXXXXXXXXXXXXXXXXXXXGXXXXXXXXXXXXXXXXXXX,0,300,0

46935,13,0,13,33,254,0,0,266,222,44,GXXXXXXXXXXXXXXXXXXXGXXXXXXXXXXXXXXXXXXXGXXXXXXXXXXXXXXXXXXXGXXXXXXXXXXXXXXXXXXXGXXXXXXXXXXXXXXXXXXXGXXXXXXXXXXXXXXXXXXXGXXXXXXXXXXXXXXXXXXXGXXXXXXXXXXXXXXXXXXXGXXXXXXXXXXXXXXXXXXXGXXXXXXXXXXXXXXXXXXXGXXXXXXXXXXXXXXXXXXXGXXXXXXXXXXXXXXXXXXXGXXXXXXXXXXXXXXXXXXX,0,300,0
46956,13,0,13,37,250,0,0,262,218,44,GXXXXXXXXXXXXXXXXXXXGXXXXXXXXXXXXXXXXXXXGXXXXXXXXXXXXXXXXXXXGXXXXXXXXXXXXXXXXXXXGXXXXXXXXXXXXXXXXXXXGXXXXXXXXXXXXXXXXXXXGXXXXXXXXXXXXXXXXXXXGXXXXXXXXXXXXXXXXXXXGXXXXXXXXXXXXXXXXXXXGXXXXXXXXXXXXXXXXXXXGXXXXXXXXXXXXXXXXXXXGXXXXXXXXXXXXXXXXXXXGXXXXXXXXXXXXXXXXXXX,0,300,0
46977,13,0,13,35,252,0,0,264,222,42,GXXXXXXXXXXXXXXXXXXXGXXXXXXXXXXXXXXXXXXXGXXXXXXXXXXXXXXXXXXXGXXXXXXXXXXXXXXXXXXXGXXXXXXXXXXXXXXXXXXXGXXXXXXXXXXXXXXXXXXXGXXXXXXXXXXXXXXXXXXXGXXXXXXXXXXXXXXXXXXXGXXXXXXXXXXXXXXXXXXXGXXXXXXXXXXXXXXXXXXXGXXXXXXXXXXXXXXXXXXXGXXXXXXXXXXXXXXXXXXXGXXXXXXXXXXXXXXXXXXX,0,300,0
46998,13,0,13,34,253,0,0,264,222,42,GXXXXXXXXXXXXXXXXXXXGXXXXXXXXXXXXXXXXXXXGXXXXXXXXXXXXXXXXXXXGXXXXXXXXXXXXXXXXXXXGXXXXXXXXXXXXXXXXXXXGXXXXXXXXXXXXXXXXXXXGXXXXXXXXXXXXXXXXXXXGXXXXXXXXXXXXXXXXXXXGXXXXXXXXXXXXXXXXXXXGXXXXXXXXXXXXXXXXXXXGXXXXXXXXXXXXXXXXXXXGXXXXXXXXXXXXXXXXXXXGXXXXXXXXXXXXXXXXXXX,0,300,0
47019,13,0,13,36,251,0,0,263,221,42,GXXXXXXXXXXXXXXXXXXXGXXXXXXXXXXXXXXXXXXXGXXXXXXXXXXXXXXXXXXXGXXXXXXXXXXXXXXXXXXXGXXXXXXXXXXXXXXXXXXXGXXXXXXXXXXXXXXXXXXXGXXXXXXXXXXXXXXXXXXXGXXXXXXXXXXXXXXXXXXXGXXXXXXXXXXXXXXXXXXXGXXXXXXXXXXXXXXXXXXXGXXXXXXXXXXXXXXXXXXXGXXXXXXXXXXXXXXXXXXXGXXXXXXXXXXXXXXXXXXX,0,300,0

47040,13,0,13,33,254,0,0,266,219,47,GXXXXXXXXXXXXXXXXXXXGXXXXXXXXXXXXXXXXXXXGXXXXXXXXXXXXXXXXXXXGXXXXXXXXXXXXXXXXXXXGXXXXXXXXXXXXXXXXXXXGXXXXXXXXXXXXXXXXXXXGXXXXXXXXXXXXXXXXXXXGXXXXXXXXXXXXXXXXXXXGXXXXXXXXXXXXXXXXXXXGXXXXXXXXXXXXXXXXXXXGXXXXXXXXXXXXXXXXXXXGXXXXXXXXXXXXXXXXXXXGXXXXXXXXXXXXXXXXXXX,0,300,0
47061,13,0,13,27,260,0,0,273,218,55,GXXXXXXXXXXXXXXXXXXXGXXXXXXXXXXXXXXXXXXXGXXXXXXXXXXXXXXXXXXXGXXXXXXXXXXXXXXXXXXXGXXXXXXXXXXXXXXXXXXXGXXXXXXXXXXXXXXXXXXXGXXXXXXXXXXXXXXXXXXXGXXXXXXXXXXXXXXXXXXXGXXXXXXXXXXXXXXXXXXXGXXXXXXXXXXXXXXXXXXXGXXXXXXXXXXXXXXXXXXXGXXXXXXXXXXXXXXXXXXXGXXXXXXXXXXXXXXXXXXX,0,300,0
47082,13,0,13,26,261,0,0,273,219,54,GXXXXXXXXXXXXXXXXXXXGXXXXXXXXXXXXXXXXXXXGXXXXXXXXXXXXXXXXXXXGXXXXXXXXXXXXXXXXXXXGXXXXXXXXXXXXXXXXXXXGXXXXXXXXXXXXXXXXXXXGXXXXXXXXXXXXXXXXXXXGXXXXXXXXXXXXXXXXXXXGXXXXXXXXXXXXXXXXXXXGXXXXXXXXXXXXXXXXXXXGXXXXXXXXXXXXXXXXXXXGXXXXXXXXXXXXXXXXXXXGXXXXXXXXXXXXXXXXXXX,0,300,0
47103,13,0,13,24,263,0,0,275,219,56,GXXXXXXXXXXXXXXXXXXXGXXXXXXXXXXXXXXXXXXXGXXXXXXXXXXXXXXXXXXXGXXXXXXXXXXXXXXXXXXXGXXXXXXXXXXXXXXXXXXXGXXXXXXXXXXXXXXXXXXXGXXXXXXXXXXXXXXXXXXXGXXXXXXXXXXXXXXXXXXXGXXXXXXXXXXXXXXXXXXXGXXXXXXXXXXXXXXXXXXXGXXXXXXXXXXXXXXXXXXXGXXXXXXXXXXXXXXXXXXXGXXXXXXXXXXXXXXXXXXX,0,300,0
47124,13,0,13,24,263,0,0,276,220,56,GXXXXXXXXXXXXXXXXXXXGXXXXXXXXXXXXXXXXXXXGXXXXXXXXXXXXXXXXXXXGXXXXXXXXXXXXXXXXXXXGXXXXXXXXXXXXXXXXXXXGXXXXXXXXXXXXXXXXXXXGXXXXXXXXXXXXXXXXXXXGXXXXXXXXXXXXXXXXXXXGXXXXXXXXXXXXXXXXXXXGXXXXXXXXXXXXXXXXXXXGXXXXXXXXXXXXXXXXXXXGXXXXXXXXXXXXXXXXXXXGXXXXXXXXXXXXXXXXXXX,0,300,0

47145,14,1,13,25,261,0,0,274,219,55,GXXXXXXXXXXXXXXXXXXXGXXXXXXXXXXXXXXXXXXXGXXXXXXXXXXXXXXXXXXXGXXXXXXXXXXXXXXXXXXXGXXXXXXXXXXXXXXXXXXXGXXXXXXXXXXXXXXXXXXXGAXXXXXXXXXXXXXXXXXXGXXXXXXXXXXXXXXXXXXXGXXXXXXXXXXXXXXXXXXXGXXXXXXXXXXXXXXXXXXXGXXXXXXXXXXXXXXXXXXXGXXXXXXXXXXXXXXXXXXXGXXXXXXXXXXXXXXXXXXX,0,300,0
47166,14,1,13,24,262,0,0,274,220,54,GXXXXXXXXXXXXXXXXXXXGXXXXXXXXXXXXXXXXXXXGXXXXXXXXXXXXXXXXXXXGXXXXXXXXXXXXXXXXXXXGXXXXXXXXXXXXXXXXXXXGXXXXXXXXXXXXXXXXXXXGAXXXXXXXXXXXXXXXXXXGXXXXXXXXXXXXXXXXXXXGXXXXXXXXXXXXXXXXXXXGXXXXXXXXXXXXXXXXXXXGXXXXXXXXXXXXXXXXXXXGXXXXXXXXXXXXXXXXXXXGXXXXXXXXXXXXXXXXXXX,0,300,0
47187,14,0,14,24,262,0,0,275,218,57,GXXXXXXXXXXXXXXXXXXXGXXXXXXXXXXXXXXXXXXXGXXXXXXXXXXXXXXXXXXXGXXXXXXXXXXXXXXXXXXXGXXXXXXXXXXXXXXXXXXXGXXXXXXXXXXXXXXXXXXXGOXXXXXXXXXXXXXXXXXXGXXXXXXXXXXXXXXXXXXXGXXXXXXXXXXXXXXXXXXXGXXXXXXXXXXXXXXXXXXXGXXXXXXXXXXXXXXXXXXXGXXXXXXXXXXXXXXXXXXXGXXXXXXXXXXXXXXXXXXX,0,300,0
47208,13,0,13,24,263,0,0,276,219,57,GXXXXXXXXXXXXXXXXXXXGXXXXXXXXXXXXXXXXXXXGXXXXXXXXXXXXXXXXXXXGXXXXXXXXXXXXXXXXXXXGXXXXXXXXXXXXXXXXXXXGXXXXXXXXXXXXXXXXXXXGXXXXXXXXXXXXXXXXXXXGXXXXXXXXXXXXXXXXXXXGXXXXXXXXXXXXXXXXXXXGXXXXXXXXXXXXXXXXXXXGXXXXXXXXXXXXXXXXXXXGXXXXXXXXXXXXXXXXXXXGXXXXXXXXXXXXXXXXXXX,0,300,0
47229,13,0,13,24,263,0,0,275,221,54,GXXXXXXXXXXXXXXXXXXXGXXXXXXXXXXXXXXXXXXXGXXXXXXXXXXXXXXXXXXXGXXXXXXXXXXXXXXXXXXXGXXXXXXXXXXXXXXXXXXXGXXXXXXXXXXXXXXXXXXXGXXXXXXXXXXXXXXXXXXXGXXXXXXXXXXXXXXXXXXXGXXXXXXXXXXXXXXXXXXXGXXXXXXXXXXXXXXXXXXXGXXXXXXXXXXXXXXXXXXXGXXXXXXXXXXXXXXXXXXXGXXXXXXXXXXXXXXXXXXX,0,300,0

47250,13,0,13,25,262,0,0,275,221,54,GXXXXXXXXXXXXXXXXXXXGXXXXXXXXXXXXXXXXXXXGXXXXXXXXXXXXXXXXXXXGXXXXXXXXXXXXXXXXXXXGXXXXXXXXXXXXXXXXXXXGXXXXXXXXXXXXXXXXXXXGXXXXXXXXXXXXXXXXXXXGXXXXXXXXXXXXXXXXXXXGXXXXXXXXXXXXXXXXXXXGXXXXXXXXXXXXXXXXXXXGXXXXXXXXXXXXXXXXXXXGXXXXXXXXXXXXXXXXXXXGXXXXXXXXXXXXXXXXXXX,0,300,0
47271,13,0,13,24,263,0,0,276,223,53,GXXXXXXXXXXXXXXXXXXXGXXXXXXXXXXXXXXXXXXXGXXXXXXXXXXXXXXXXXXXGXXXXXXXXXXXXXXXXXXXGXXXXXXXXXXXXXXXXXXXGXXXXXXXXXXXXXXXXXXXGXXXXXXXXXXXXXXXXXXXGXXXXXXXXXXXXXXXXXXXGXXXXXXXXXXXXXXXXXXXGXXXXXXXXXXXXXXXXXXXGXXXXXXXXXXXXXXXXXXXGXXXXXXXXXXXXXXXXXXXGXXXXXXXXXXXXXXXXXXX,0,300,0
47292,13,0,13,22,265,0,0,277,222,55,GXXXXXXXXXXXXXXXXXXXGXXXXXXXXXXXXXXXXXXXGXXXXXXXXXXXXXXXXXXXGXXXXXXXXXXXXXXXXXXXGXXXXXXXXXXXXXXXXXXXGXXXXXXXXXXXXXXXXXXXGXXXXXXXXXXXXXXXXXXXGXXXXXXXXXXXXXXXXXXXGXXXXXXXXXXXXXXXXXXXGXXXXXXXXXXXXXXXXXXXGXXXXXXXXXXXXXXXXXXXGXXXXXXXXXXXXXXXXXXXGXXXXXXXXXXXXXXXXXXX,0,300,0
47313,13,0,13,22,265,0,0,278,223,55,GXXXXXXXXXXXXXXXXXXXGXXXXXXXXXXXXXXXXXXXGXXXXXXXXXXXXXXXXXXXGXXXXXXXXXXXXXXXXXXXGXXXXXXXXXXXXXXXXXXXGXXXXXXXXXXXXXXXXXXXGXXXXXXXXXXXXXXXXXXXGXXXXXXXXXXXXXXXXXXXGXXXXXXXXXXXXXXXXXXXGXXXXXXXXXXXXXXXXXXXGXXXXXXXXXXXXXXXXXXXGXXXXXXXXXXXXXXXXXXXGXXXXXXXXXXXXXXXXXXX,0,300,0
47334,13,0,13,22,265,0,0,278,228,50,GXXXXXXXXXXXXXXXXXXXGXXXXXXXXXXXXXXXXXXXGXXXXXXXXXXXXXXXXXXXGXXXXXXXXXXXXXXXXXXXGXXXXXXXXXXXXXXXXXXXGXXXXXXXXXXXXXXXXXXXGXXXXXXXXXXXXXXXXXXXGXXXXXXXXXXXXXXXXXXXGXXXXXXXXXXXXXXXXXXXGXXXXXXXXXXXXXXXXXXXGXXXXXXXXXXXXXXXXXXXGXXXXXXXXXXXXXXXXXXXGXXXXXXXXXXXXXXXXXXX,0,300,0

47355,13,0,13,27,260,0,0,273,223,50,GXXXXXXXXXXXXXXXXXXXGXXXXXXXXXXXXXXXXXXXGXXXXXXXXXXXXXXXXXXXGXXXXXXXXXXXXXXXXXXXGXXXXXXXXXXXXXXXXXXXGXXXXXXXXXXXXXXXXXXXGXXXXXXXXXXXXXXXXXXXGXXXXXXXXXXXXXXXXXXXGXXXXXXXXXXXXXXXXXXXGXXXXXXXXXXXXXXXXXXXGXXXXXXXXXXXXXXXXXXXGXXXXXXXXXXXXXXXXXXXGXXXXXXXXXXXXXXXXXXX,0,300,0
47376,14,1,13,26,260,0,0,272,220,52,GXXXXXXXXXXXXXXXXXXXGXXXXXXXXXXXXXXXXXXXGXXXXXXXXXXXXXXXXXXXGXXXXXXXXXXXXXXXXXXXGXXXXXXXXXXXXXXXXXXXGXXXXXXXXXXXXXXXXXXXGAXXXXXXXXXXXXXXXXXXGXXXXXXXXXXXXXXXXXXXGXXXXXXXXXXXXXXXXXXXGXXXXXXXXXXXXXXXXXXXGXXXXXXXXXXXXXXXXXXXGXXXXXXXXXXXXXXXXXXXGXXXXXXXXXXXXXXXXXXX,0,300,0
47397,14,1,13,24,262,0,0,275,221,54,GXXXXXXXXXXXXXXXXXXXGXXXXXXXXXXXXXXXXXXXGXXXXXXXXXXXXXXXXXXXGXXXXXXXXXXXXXXXXXXXGXXXXXXXXXXXXXXXXXXXGXXXXXXXXXXXXXXXXXXXGAXXXXXXXXXXXXXXXXXXGXXXXXXXXXXXXXXXXXXXGXXXXXXXXXXXXXXXXXXXGXXXXXXXXXXXXXXXXXXXGXXXXXXXXXXXXXXXXXXXGXXXXXXXXXXXXXXXXXXXGXXXXXXXXXXXXXXXXXXX,0,300,0
47418,14,1,13,25,261,0,0,274,222,52,GXXXXXXXXXXXXXXXXXXXGXXXXXXXXXXXXXXXXXXXGXXXXXXXXXXXXXXXXXXXGXXXXXXXXXXXXXXXXXXXGXXXXXXXXXXXXXXXXXXXGXXXXXXXXXXXXXXXXXXXGAXXXXXXXXXXXXXXXXXXGXXXXXXXXXXXXXXXXXXXGXXXXXXXXXXXXXXXXXXXGXXXXXXXXXXXXXXXXXXXGXXXXXXXXXXXXXXXXXXXGXXXXXXXXXXXXXXXXXXXGXXXXXXXXXXXXXXXXXXX,0,300,0
47439,14,1,13,27,259,0,0,272,222,50,GXXXXXXXXXXXXXXXXXXXGXXXXXXXXXXXXXXXXXXXGXXXXXXXXXXXXXXXXXXXGXXXXXXXXXXXXXXXXXXXGXXXXXXXXXXXXXXXXXXXGXXXXXXXXXXXXXXXXXXXGAXXXXXXXXXXXXXXXXXXGXXXXXXXXXXXXXXXXXXXGXXXXXXXXXXXXXXXXXXXGXXXXXXXXXXXXXXXXXXXGXXXXXXXXXXXXXXXXXXXGXXXXXXXXXXXXXXXXXXXGXXXXXXXXXXXXXXXXXXX,0,300,0

47460,14,1,13,25,261,0,0,273,220,53,GXXXXXXXXXXXXXXXXXXXGXXXXXXXXXXXXXXXXXXXGXXXXXXXXXXXXXXXXXXXGXXXXXXXXXXXXXXXXXXXGXXXXXXXXXXXXXXXXXXXGXXXXXXXXXXXXXXXXXXXGAXXXXXXXXXXXXXXXXXXGXXXXXXXXXXXXXXXXXXXGXXXXXXXXXXXXXXXXXXXGXXXXXXXXXXXXXXXXXXXGXXXXXXXXXXXXXXXXXXXGXXXXXXXXXXXXXXXXXXXGXXXXXXXXXXXXXXXXXXX,0,300,0
47481,14,1,13,24,262,0,0,274,221,53,GXXXXXXXXXXXXXXXXXXXGXXXXXXXXXXXXXXXXXXXGXXXXXXXXXXXXXXXXXXXGXXXXXXXXXXXXXXXXXXXGXXXXXXXXXXXXXXXXXXXGXXXXXXXXXXXXXXXXXXXGAXXXXXXXXXXXXXXXXXXGXXXXXXXXXXXXXXXXXXXGXXXXXXXXXXXXXXXXXXXGXXXXXXXXXXXXXXXXXXXGXXXXXXXXXXXXXXXXXXXGXXXXXXXXXXXXXXXXXXXGXXXXXXXXXXXXXXXXXXX,0,300,0
47502,14,1,13,27,259,0,0,270,222,48,GXXXXXXXXXXXXXXXXXXXGXXXXXXXXXXXXXXXXXXXGXXXXXXXXXXXXXXXXXXXGXXXXXXXXXXXXXXXXXXXGXXXXXXXXXXXXXXXXXXXGXXXXXXXXXXXXXXXXXXXGAXXXXXXXXXXXXXXXXXXGXXXXXXXXXXXXXXXXXXXGXXXXXXXXXXXXXXXXXXXGXXXXXXXXXXXXXXXXXXXGXXXXXXXXXXXXXXXXXXXGXXXXXXXXXXXXXXXXXXXGXXXXXXXXXXXXXXXXXXX,0,300,0
47523,13,0,13,27,260,0,0,272,222,50,GXXXXXXXXXXXXXXXXXXXGXXXXXXXXXXXXXXXXXXXGXXXXXXXXXXXXXXXXXXXGXXXXXXXXXXXXXXXXXXXGXXXXXXXXXXXXXXXXXXXGXXXXXXXXXXXXXXXXXXXGXXXXXXXXXXXXXXXXXXXGXXXXXXXXXXXXXXXXXXXGXXXXXXXXXXXXXXXXXXXGXXXXXXXXXXXXXXXXXXXGXXXXXXXXXXXXXXXXXXXGXXXXXXXXXXXXXXXXXXXGXXXXXXXXXXXXXXXXXXX,0,300,0
47544,13,0,13,27,260,0,0,272,222,50,GXXXXXXXXXXXXXXXXXXXGXXXXXXXXXXXXXXXXXXXGXXXXXXXXXXXXXXXXXXXGXXXXXXXXXXXXXXXXXXXGXXXXXXXXXXXXXXXXXXXGXXXXXXXXXXXXXXXXXXXGXXXXXXXXXXXXXXXXXXXGXXXXXXXXXXXXXXXXXXXGXXXXXXXXXXXXXXXXXXXGXXXXXXXXXXXXXXXXXXXGXXXXXXXXXXXXXXXXXXXGXXXXXXXXXXXXXXXXXXXGXXXXXXXXXXXXXXXXXXX,0,300,0

47565,13,0,13,25,262,0,0,274,223,51,GXXXXXXXXXXXXXXXXXXXGXXXXXXXXXXXXXXXXXXXGXXXXXXXXXXXXXXXXXXXGXXXXXXXXXXXXXXXXXXXGXXXXXXXXXXXXXXXXXXXGXXXXXXXXXXXXXXXXXXXGXXXXXXXXXXXXXXXXXXXGXXXXXXXXXXXXXXXXXXXGXXXXXXXXXXXXXXXXXXXGXXXXXXXXXXXXXXXXXXXGXXXXXXXXXXXXXXXXXXXGXXXXXXXXXXXXXXXXXXXGXXXXXXXXXXXXXXXXXXX,0,300,0
47586,13,0,13,25,262,0,0,274,224,50,GXXXXXXXXXXXXXXXXXXXGXXXXXXXXXXXXXXXXXXXGXXXXXXXXXXXXXXXXXXXGXXXXXXXXXXXXXXXXXXXGXXXXXXXXXXXXXXXXXXXGXXXXXXXXXXXXXXXXXXXGXXXXXXXXXXXXXXXXXXXGXXXXXXXXXXXXXXXXXXXGXXXXXXXXXXXXXXXXXXXGXXXXXXXXXXXXXXXXXXXGXXXXXXXXXXXXXXXXXXXGXXXXXXXXXXXXXXXXXXXGXXXXXXXXXXXXXXXXXXX,0,300,0
47607,13,0,13,25,262,0,0,274,223,51,GXXXXXXXXXXXXXXXXXXXGXXXXXXXXXXXXXXXXXXXGXXXXXXXXXXXXXXXXXXXGXXXXXXXXXXXXXXXXXXXGXXXXXXXXXXXXXXXXXXXGXXXXXXXXXXXXXXXXXXXGXXXXXXXXXXXXXXXXXXXGXXXXXXXXXXXXXXXXXXXGXXXXXXXXXXXXXXXXXXXGXXXXXXXXXXXXXXXXXXXGXXXXXXXXXXXXXXXXXXXGXXXXXXXXXXXXXXXXXXXGXXXXXXXXXXXXXXXXXXX,0,300,0
47628,13,0,13,27,260,0,0,272,222,50,GXXXXXXXXXXXXXXXXXXXGXXXXXXXXXXXXXXXXXXXGXXXXXXXXXXXXXXXXXXXGXXXXXXXXXXXXXXXXXXXGXXXXXXXXXXXXXXXXXXXGXXXXXXXXXXXXXXXXXXXGXXXXXXXXXXXXXXXXXXXGXXXXXXXXXXXXXXXXXXXGXXXXXXXXXXXXXXXXXXXGXXXXXXXXXXXXXXXXXXXGXXXXXXXXXXXXXXXXXXXGXXXXXXXXXXXXXXXXXXXGXXXXXXXXXXXXXXXXXXX,0,300,0
47649,13,0,13,29,258,0,0,271,226,45,GXXXXXXXXXXXXXXXXXXXGXXXXXXXXXXXXXXXXXXXGXXXXXXXXXXXXXXXXXXXGXXXXXXXXXXXXXXXXXXXGXXXXXXXXXXXXXXXXXXXGXXXXXXXXXXXXXXXXXXXGXXXXXXXXXXXXXXXXXXXGXXXXXXXXXXXXXXXXXXXGXXXXXXXXXXXXXXXXXXXGXXXXXXXXXXXXXXXXXXXGXXXXXXXXXXXXXXXXXXXGXXXXXXXXXXXXXXXXXXXGXXXXXXXXXXXXXXXXXXX,0,300,0

47670,13,0,13,30,257,0,0,270,226,44,GXXXXXXXXXXXXXXXXXXXGXXXXXXXXXXXXXXXXXXXGXXXXXXXXXXXXXXXXXXXGXXXXXXXXXXXXXXXXXXXGXXXXXXXXXXXXXXXXXXXGXXXXXXXXXXXXXXXXXXXGXXXXXXXXXXXXXXXXXXXGXXXXXXXXXXXXXXXXXXXGXXXXXXXXXXXXXXXXXXXGXXXXXXXXXXXXXXXXXXXGXXXXXXXXXXXXXXXXXXXGXXXXXXXXXXXXXXXXXXXGXXXXXXXXXXXXXXXXXXX,0,300,0
47691,13,0,13,30,257,0,0,270,224,46,GXXXXXXXXXXXXXXXXXXXGXXXXXXXXXXXXXXXXXXXGXXXXXXXXXXXXXXXXXXXGXXXXXXXXXXXXXXXXXXXGXXXXXXXXXXXXXXXXXXXGXXXXXXXXXXXXXXXXXXXGXXXXXXXXXXXXXXXXXXXGXXXXXXXXXXXXXXXXXXXGXXXXXXXXXXXXXXXXXXXGXXXXXXXXXXXXXXXXXXXGXXXXXXXXXXXXXXXXXXXGXXXXXXXXXXXXXXXXXXXGXXXXXXXXXXXXXXXXXXX,0,300,0
47712,13,0,13,32,255,0,0,268,224,44,GXXXXXXXXXXXXXXXXXXXGXXXXXXXXXXXXXXXXXXXGXXXXXXXXXXXXXXXXXXXGXXXXXXXXXXXXXXXXXXXGXXXXXXXXXXXXXXXXXXXGXXXXXXXXXXXXXXXXXXXGXXXXXXXXXXXXXXXXXXXGXXXXXXXXXXXXXXXXXXXGXXXXXXXXXXXXXXXXXXXGXXXXXXXXXXXXXXXXXXXGXXXXXXXXXXXXXXXXXXXGXXXXXXXXXXXXXXXXXXXGXXXXXXXXXXXXXXXXXXX,0,300,0
47733,13,0,13,33,254,0,0,266,222,44,GXXXXXXXXXXXXXXXXXXXGXXXXXXXXXXXXXXXXXXXGXXXXXXXXXXXXXXXXXXXGXXXXXXXXXXXXXXXXXXXGXXXXXXXXXXXXXXXXXXXGXXXXXXXXXXXXXXXXXXXGXXXXXXXXXXXXXXXXXXXGXXXXXXXXXXXXXXXXXXXGXXXXXXXXXXXXXXXXXXXGXXXXXXXXXXXXXXXXXXXGXXXXXXXXXXXXXXXXXXXGXXXXXXXXXXXXXXXXXXXGXXXXXXXXXXXXXXXXXXX,0,300,0
47754,13,0,13,35,252,0,0,264,219,45,GXXXXXXXXXXXXXXXXXXXGXXXXXXXXXXXXXXXXXXXGXXXXXXXXXXXXXXXXXXXGXXXXXXXXXXXXXXXXXXXGXXXXXXXXXXXXXXXXXXXGXXXXXXXXXXXXXXXXXXXGXXXXXXXXXXXXXXXXXXXGXXXXXXXXXXXXXXXXXXXGXXXXXXXXXXXXXXXXXXXGXXXXXXXXXXXXXXXXXXXGXXXXXXXXXXXXXXXXXXXGXXXXXXXXXXXXXXXXXXXGXXXXXXXXXXXXXXXXXXX,0,300,0

47775,13,0,13,32,255,0,0,267,220,47,GXXXXXXXXXXXXXXXXXXXGXXXXXXXXXXXXXXXXXXXGXXXXXXXXXXXXXXXXXXXGXXXXXXXXXXXXXXXXXXXGXXXXXXXXXXXXXXXXXXXGXXXXXXXXXXXXXXXXXXXGXXXXXXXXXXXXXXXXXXXGXXXXXXXXXXXXXXXXXXXGXXXXXXXXXXXXXXXXXXXGXXXXXXXXXXXXXXXXXXXGXXXXXXXXXXXXXXXXXXXGXXXXXXXXXXXXXXXXXXXGXXXXXXXXXXXXXXXXXXX,0,300,0
47796,13,0,13,32,255,0,0,267,220,47,GXXXXXXXXXXXXXXXXXXXGXXXXXXXXXXXXXXXXXXXGXXXXXXXXXXXXXXXXXXXGXXXXXXXXXXXXXXXXXXXGXXXXXXXXXXXXXXXXXXXGXXXXXXXXXXXXXXXXXXXGXXXXXXXXXXXXXXXXXXXGXXXXXXXXXXXXXXXXXXXGXXXXXXXXXXXXXXXXXXXGXXXXXXXXXXXXXXXXXXXGXXXXXXXXXXXXXXXXXXXGXXXXXXXXXXXXXXXXXXXGXXXXXXXXXXXXXXXXXXX,0,300,0
47817,13,0,13,28,259,0,0,271,220,51,GXXXXXXXXXXXXXXXXXXXGXXXXXXXXXXXXXXXXXXXGXXXXXXXXXXXXXXXXXXXGXXXXXXXXXXXXXXXXXXXGXXXXXXXXXXXXXXXXXXXGXXXXXXXXXXXXXXXXXXXGXXXXXXXXXXXXXXXXXXXGXXXXXXXXXXXXXXXXXXXGXXXXXXXXXXXXXXXXXXXGXXXXXXXXXXXXXXXXXXXGXXXXXXXXXXXXXXXXXXXGXXXXXXXXXXXXXXXXXXXGXXXXXXXXXXXXXXXXXXX,0,300,0
47838,13,0,13,28,259,0,0,271,222,49,GXXXXXXXXXXXXXXXXXXXGXXXXXXXXXXXXXXXXXXXGXXXXXXXXXXXXXXXXXXXGXXXXXXXXXXXXXXXXXXXGXXXXXXXXXXXXXXXXXXXGXXXXXXXXXXXXXXXXXXXGXXXXXXXXXXXXXXXXXXXGXXXXXXXXXXXXXXXXXXXGXXXXXXXXXXXXXXXXXXXGXXXXXXXXXXXXXXXXXXXGXXXXXXXXXXXXXXXXXXXGXXXXXXXXXXXXXXXXXXXGXXXXXXXXXXXXXXXXXXX,0,300,0
47859,13,0,13,30,257,0,0,268,223,45,GXXXXXXXXXXXXXXXXXXXGXXXXXXXXXXXXXXXXXXXGXXXXXXXXXXXXXXXXXXXGXXXXXXXXXXXXXXXXXXXGXXXXXXXXXXXXXXXXXXXGXXXXXXXXXXXXXXXXXXXGXXXXXXXXXXXXXXXXXXXGXXXXXXXXXXXXXXXXXXXGXXXXXXXXXXXXXXXXXXXGXXXXXXXXXXXXXXXXXXXGXXXXXXXXXXXXXXXXXXXGXXXXXXXXXXXXXXXXXXXGXXXXXXXXXXXXXXXXXXX,0,300,0

47880,13,0,13,31,256,0,0,268,219,49,GXXXXXXXXXXXXXXXXXXXGXXXXXXXXXXXXXXXXXXXGXXXXXXXXXXXXXXXXXXXGXXXXXXXXXXXXXXXXXXXGXXXXXXXXXXXXXXXXXXXGXXXXXXXXXXXXXXXXXXXGXXXXXXXXXXXXXXXXXXXGXXXXXXXXXXXXXXXXXXXGXXXXXXXXXXXXXXXXXXXGXXXXXXXXXXXXXXXXXXXGXXXXXXXXXXXXXXXXXXXGXXXXXXXXXXXXXXXXXXXGXXXXXXXXXXXXXXXXXXX,0,300,0
47901,13,0,13,31,256,0,0,269,218,51,GXXXXXXXXXXXXXXXXXXXGXXXXXXXXXXXXXXXXXXXGXXXXXXXXXXXXXXXXXXXGXXXXXXXXXXXXXXXXXXXGXXXXXXXXXXXXXXXXXXXGXXXXXXXXXXXXXXXXXXXGXXXXXXXXXXXXXXXXXXXGXXXXXXXXXXXXXXXXXXXGXXXXXXXXXXXXXXXXXXXGXXXXXXXXXXXXXXXXXXXGXXXXXXXXXXXXXXXXXXXGXXXXXXXXXXXXXXXXXXXGXXXXXXXXXXXXXXXXXXX,0,300,0
47922,13,0,13,32,255,0,0,268,221,47,GXXXXXXXXXXXXXXXXXXXGXXXXXXXXXXXXXXXXXXXGXXXXXXXXXXXXXXXXXXXGXXXXXXXXXXXXXXXXXXXGXXXXXXXXXXXXXXXXXXXGXXXXXXXXXXXXXXXXXXXGXXXXXXXXXXXXXXXXXXXGXXXXXXXXXXXXXXXXXXXGXXXXXXXXXXXXXXXXXXXGXXXXXXXXXXXXXXXXXXXGXXXXXXXXXXXXXXXXXXXGXXXXXXXXXXXXXXXXXXXGXXXXXXXXXXXXXXXXXXX,0,300,0
47943,13,0,13,25,262,0,0,273,220,53,GXXXXXXXXXXXXXXXXXXXGXXXXXXXXXXXXXXXXXXXGXXXXXXXXXXXXXXXXXXXGXXXXXXXXXXXXXXXXXXXGXXXXXXXXXXXXXXXXXXXGXXXXXXXXXXXXXXXXXXXGXXXXXXXXXXXXXXXXXXXGXXXXXXXXXXXXXXXXXXXGXXXXXXXXXXXXXXXXXXXGXXXXXXXXXXXXXXXXXXXGXXXXXXXXXXXXXXXXXXXGXXXXXXXXXXXXXXXXXXXGXXXXXXXXXXXXXXXXXXX,0,300,0
47964,13,0,13,26,261,0,0,273,220,53,GXXXXXXXXXXXXXXXXXXXGXXXXXXXXXXXXXXXXXXXGXXXXXXXXXXXXXXXXXXXGXXXXXXXXXXXXXXXXXXXGXXXXXXXXXXXXXXXXXXXGXXXXXXXXXXXXXXXXXXXGXXXXXXXXXXXXXXXXXXXGXXXXXXXXXXXXXXXXXXXGXXXXXXXXXXXXXXXXXXXGXXXXXXXXXXXXXXXXXXXGXXXXXXXXXXXXXXXXXXXGXXXXXXXXXXXXXXXXXXXGXXXXXXXXXXXXXXXXXXX,0,300,0

47985,13,0,13,28,259,0,0,271,220,51,GXXXXXXXXXXXXXXXXXXXGXXXXXXXXXXXXXXXXXXXGXXXXXXXXXXXXXXXXXXXGXXXXXXXXXXXXXXXXXXXGXXXXXXXXXXXXXXXXXXXGXXXXXXXXXXXXXXXXXXXGXXXXXXXXXXXXXXXXXXXGXXXXXXXXXXXXXXXXXXXGXXXXXXXXXXXXXXXXXXXGXXXXXXXXXXXXXXXXXXXGXXXXXXXXXXXXXXXXXXXGXXXXXXXXXXXXXXXXXXXGXXXXXXXXXXXXXXXXXXX,0,300,0
48006,13,0,13,28,259,0,0,270,219,51,GXXXXXXXXXXXXXXXXXXXGXXXXXXXXXXXXXXXXXXXGXXXXXXXXXXXXXXXXXXXGXXXXXXXXXXXXXXXXXXXGXXXXXXXXXXXXXXXXXXXGXXXXXXXXXXXXXXXXXXXGXXXXXXXXXXXXXXXXXXXGXXXXXXXXXXXXXXXXXXXGXXXXXXXXXXXXXXXXXXXGXXXXXXXXXXXXXXXXXXXGXXXXXXXXXXXXXXXXXXXGXXXXXXXXXXXXXXXXXXXGXXXXXXXXXXXXXXXXXXX,0,300,0
48027,13,0,13,22,265,0,0,276,222,54,GXXXXXXXXXXXXXXXXXXXGXXXXXXXXXXXXXXXXXXXGXXXXXXXXXXXXXXXXXXXGXXXXXXXXXXXXXXXXXXXGXXXXXXXXXXXXXXXXXXXGXXXXXXXXXXXXXXXXXXXGXXXXXXXXXXXXXXXXXXXGXXXXXXXXXXXXXXXXXXXGXXXXXXXXXXXXXXXXXXXGXXXXXXXXXXXXXXXXXXXGXXXXXXXXXXXXXXXXXXXGXXXXXXXXXXXXXXXXXXXGXXXXXXXXXXXXXXXXXXX,0,300,0
48048,13,0,13,24,263,0,0,275,220,55,GXXXXXXXXXXXXXXXXXXXGXXXXXXXXXXXXXXXXXXXGXXXXXXXXXXXXXXXXXXXGXXXXXXXXXXXXXXXXXXXGXXXXXXXXXXXXXXXXXXXGXXXXXXXXXXXXXXXXXXXGXXXXXXXXXXXXXXXXXXXGXXXXXXXXXXXXXXXXXXXGXXXXXXXXXXXXXXXXXXXGXXXXXXXXXXXXXXXXXXXGXXXXXXXXXXXXXXXXXXXGXXXXXXXXXXXXXXXXXXXGXXXXXXXXXXXXXXXXXXX,0,300,0
48069,13,0,13,25,262,0,0,274,219,55,GXXXXXXXXXXXXXXXXXXXGXXXXXXXXXXXXXXXXXXXGXXXXXXXXXXXXXXXXXXXGXXXXXXXXXXXXXXXXXXXGXXXXXXXXXXXXXXXXXXXGXXXXXXXXXXXXXXXXXXXGXXXXXXXXXXXXXXXXXXXGXXXXXXXXXXXXXXXXXXXGXXXXXXXXXXXXXXXXXXXGXXXXXXXXXXXXXXXXXXXGXXXXXXXXXXXXXXXXXXXGXXXXXXXXXXXXXXXXXXXGXXXXXXXXXXXXXXXXXXX,0,300,0

48090,13,0,13,26,261,0,0,273,220,53,GXXXXXXXXXXXXXXXXXXXGXXXXXXXXXXXXXXXXXXXGXXXXXXXXXXXXXXXXXXXGXXXXXXXXXXXXXXXXXXXGXXXXXXXXXXXXXXXXXXXGXXXXXXXXXXXXXXXXXXXGXXXXXXXXXXXXXXXXXXXGXXXXXXXXXXXXXXXXXXXGXXXXXXXXXXXXXXXXXXXGXXXXXXXXXXXXXXXXXXXGXXXXXXXXXXXXXXXXXXXGXXXXXXXXXXXXXXXXXXXGXXXXXXXXXXXXXXXXXXX,0,300,0
48111,13,0,13,30,257,0,0,269,220,49,GXXXXXXXXXXXXXXXXXXXGXXXXXXXXXXXXXXXXXXXGXXXXXXXXXXXXXXXXXXXGXXXXXXXXXXXXXXXXXXXGXXXXXXXXXXXXXXXXXXXGXXXXXXXXXXXXXXXXXXXGXXXXXXXXXXXXXXXXXXXGXXXXXXXXXXXXXXXXXXXGXXXXXXXXXXXXXXXXXXXGXXXXXXXXXXXXXXXXXXXGXXXXXXXXXXXXXXXXXXXGXXXXXXXXXXXXXXXXXXXGXXXXXXXXXXXXXXXXXXX,0,300,0
48132,13,0,13,31,256,0,0,267,223,44,GXXXXXXXXXXXXXXXXXXXGXXXXXXXXXXXXXXXXXXXGXXXXXXXXXXXXXXXXXXXGXXXXXXXXXXXXXXXXXXXGXXXXXXXXXXXXXXXXXXXGXXXXXXXXXXXXXXXXXXXGXXXXXXXXXXXXXXXXXXXGXXXXXXXXXXXXXXXXXXXGXXXXXXXXXXXXXXXXXXXGXXXXXXXXXXXXXXXXXXXGXXXXXXXXXXXXXXXXXXXGXXXXXXXXXXXXXXXXXXXGXXXXXXXXXXXXXXXXXXX,0,300,0
48153,13,0,13,31,256,0,0,268,220,48,GXXXXXXXXXXXXXXXXXXXGXXXXXXXXXXXXXXXXXXXGXXXXXXXXXXXXXXXXXXXGXXXXXXXXXXXXXXXXXXXGXXXXXXXXXXXXXXXXXXXGXXXXXXXXXXXXXXXXXXXGXXXXXXXXXXXXXXXXXXXGXXXXXXXXXXXXXXXXXXXGXXXXXXXXXXXXXXXXXXXGXXXXXXXXXXXXXXXXXXXGXXXXXXXXXXXXXXXXXXXGXXXXXXXXXXXXXXXXXXXGXXXXXXXXXXXXXXXXXXX,0,300,0
48174,14,1,13,29,257,0,0,269,218,51,GXXXXXXXXXXXXXXXXXXXGXXXXXXXXXXXXXXXXXXXGXXXXXXXXXXXXXXXXXXXGAXXXXXXXXXXXXXXXXXXGXXXXXXXXXXXXXXXXXXXGXXXXXXXXXXXXXXXXXXXGXXXXXXXXXXXXXXXXXXXGXXXXXXXXXXXXXXXXXXXGXXXXXXXXXXXXXXXXXXXGXXXXXXXXXXXXXXXXXXXGXXXXXXXXXXXXXXXXXXXGXXXXXXXXXXXXXXXXXXXGXXXXXXXXXXXXXXXXXXX,0,300,0

48195,14,1,13,26,260,0,0,272,219,53,GXXXXXXXXXXXXXXXXXXXGXXXXXXXXXXXXXXXXXXXGXXXXXXXXXXXXXXXXXXXGAXXXXXXXXXXXXXXXXXXGXXXXXXXXXXXXXXXXXXXGXXXXXXXXXXXXXXXXXXXGXXXXXXXXXXXXXXXXXXXGXXXXXXXXXXXXXXXXXXXGXXXXXXXXXXXXXXXXXXXGXXXXXXXXXXXXXXXXXXXGXXXXXXXXXXXXXXXXXXXGXXXXXXXXXXXXXXXXXXXGXXXXXXXXXXXXXXXXXXX,0,300,0
48216,14,1,13,25,261,0,0,273,218,55,GXXXXXXXXXXXXXXXXXXXGXXXXXXXXXXXXXXXXXXXGXXXXXXXXXXXXXXXXXXXGAXXXXXXXXXXXXXXXXXXGXXXXXXXXXXXXXXXXXXXGXXXXXXXXXXXXXXXXXXXGXXXXXXXXXXXXXXXXXXXGXXXXXXXXXXXXXXXXXXXGXXXXXXXXXXXXXXXXXXXGXXXXXXXXXXXXXXXXXXXGXXXXXXXXXXXXXXXXXXXGXXXXXXXXXXXXXXXXXXXGXXXXXXXXXXXXXXXXXXX,0,300,0
48237,14,1,13,24,262,0,0,274,219,55,GXXXXXXXXXXXXXXXXXXXGXXXXXXXXXXXXXXXXXXXGXXXXXXXXXXXXXXXXXXXGAXXXXXXXXXXXXXXXXXXGXXXXXXXXXXXXXXXXXXXGXXXXXXXXXXXXXXXXXXXGXXXXXXXXXXXXXXXXXXXGXXXXXXXXXXXXXXXXXXXGXXXXXXXXXXXXXXXXXXXGXXXXXXXXXXXXXXXXXXXGXXXXXXXXXXXXXXXXXXXGXXXXXXXXXXXXXXXXXXXGXXXXXXXXXXXXXXXXXXX,0,300,0
48258,13,0,13,23,264,0,0,274,221,53,GXXXXXXXXXXXXXXXXXXXGXXXXXXXXXXXXXXXXXXXGXXXXXXXXXXXXXXXXXXXGXXXXXXXXXXXXXXXXXXXGXXXXXXXXXXXXXXXXXXXGXXXXXXXXXXXXXXXXXXXGXXXXXXXXXXXXXXXXXXXGXXXXXXXXXXXXXXXXXXXGXXXXXXXXXXXXXXXXXXXGXXXXXXXXXXXXXXXXXXXGXXXXXXXXXXXXXXXXXXXGXXXXXXXXXXXXXXXXXXXGXXXXXXXXXXXXXXXXXXX,0,300,0
48279,13,0,13,26,261,0,0,273,223,50,GXXXXXXXXXXXXXXXXXXXGXXXXXXXXXXXXXXXXXXXGXXXXXXXXXXXXXXXXXXXGXXXXXXXXXXXXXXXXXXXGXXXXXXXXXXXXXXXXXXXGXXXXXXXXXXXXXXXXXXXGXXXXXXXXXXXXXXXXXXXGXXXXXXXXXXXXXXXXXXXGXXXXXXXXXXXXXXXXXXXGXXXXXXXXXXXXXXXXXXXGXXXXXXXXXXXXXXXXXXXGXXXXXXXXXXXXXXXXXXXGXXXXXXXXXXXXXXXXXXX,0,300,0

48300,13,0,13,25,262,0,0,274,224,50,GXXXXXXXXXXXXXXXXXXXGXXXXXXXXXXXXXXXXXXXGXXXXXXXXXXXXXXXXXXXGXXXXXXXXXXXXXXXXXXXGXXXXXXXXXXXXXXXXXXXGXXXXXXXXXXXXXXXXXXXGXXXXXXXXXXXXXXXXXXXGXXXXXXXXXXXXXXXXXXXGXXXXXXXXXXXXXXXXXXXGXXXXXXXXXXXXXXXXXXXGXXXXXXXXXXXXXXXXXXXGXXXXXXXXXXXXXXXXXXXGXXXXXXXXXXXXXXXXXXX,0,300,0
48321,13,0,13,26,261,0,0,273,223,50,GXXXXXXXXXXXXXXXXXXXGXXXXXXXXXXXXXXXXXXXGXXXXXXXXXXXXXXXXXXXGXXXXXXXXXXXXXXXXXXXGXXXXXXXXXXXXXXXXXXXGXXXXXXXXXXXXXXXXXXXGXXXXXXXXXXXXXXXXXXXGXXXXXXXXXXXXXXXXXXXGXXXXXXXXXXXXXXXXXXXGXXXXXXXXXXXXXXXXXXXGXXXXXXXXXXXXXXXXXXXGXXXXXXXXXXXXXXXXXXXGXXXXXXXXXXXXXXXXXXX,0,300,0
48342,13,0,13,24,263,0,0,275,223,52,GXXXXXXXXXXXXXXXXXXXGXXXXXXXXXXXXXXXXXXXGXXXXXXXXXXXXXXXXXXXGXXXXXXXXXXXXXXXXXXXGXXXXXXXXXXXXXXXXXXXGXXXXXXXXXXXXXXXXXXXGXXXXXXXXXXXXXXXXXXXGXXXXXXXXXXXXXXXXXXXGXXXXXXXXXXXXXXXXXXXGXXXXXXXXXXXXXXXXXXXGXXXXXXXXXXXXXXXXXXXGXXXXXXXXXXXXXXXXXXXGXXXXXXXXXXXXXXXXXXX,0,300,0
48363,13,0,13,24,263,0,0,275,224,51,GXXXXXXXXXXXXXXXXXXXGXXXXXXXXXXXXXXXXXXXGXXXXXXXXXXXXXXXXXXXGXXXXXXXXXXXXXXXXXXXGXXXXXXXXXXXXXXXXXXXGXXXXXXXXXXXXXXXXXXXGXXXXXXXXXXXXXXXXXXXGXXXXXXXXXXXXXXXXXXXGXXXXXXXXXXXXXXXXXXXGXXXXXXXXXXXXXXXXXXXGXXXXXXXXXXXXXXXXXXXGXXXXXXXXXXXXXXXXXXXGXXXXXXXXXXXXXXXXXXX,0,300,0
48384,13,0,13,22,265,0,0,277,228,49,GXXXXXXXXXXXXXXXXXXXGXXXXXXXXXXXXXXXXXXXGXXXXXXXXXXXXXXXXXXXGXXXXXXXXXXXXXXXXXXXGXXXXXXXXXXXXXXXXXXXGXXXXXXXXXXXXXXXXXXXGXXXXXXXXXXXXXXXXXXXGXXXXXXXXXXXXXXXXXXXGXXXXXXXXXXXXXXXXXXXGXXXXXXXXXXXXXXXXXXXGXXXXXXXXXXXXXXXXXXXGXXXXXXXXXXXXXXXXXXXGXXXXXXXXXXXXXXXXXXX,0,300,0

48405,13,0,13,27,260,0,0,272,226,46,GXXXXXXXXXXXXXXXXXXXGXXXXXXXXXXXXXXXXXXXGXXXXXXXXXXXXXXXXXXXGXXXXXXXXXXXXXXXXXXXGXXXXXXXXXXXXXXXXXXXGXXXXXXXXXXXXXXXXXXXGXXXXXXXXXXXXXXXXXXXGXXXXXXXXXXXXXXXXXXXGXXXXXXXXXXXXXXXXXXXGXXXXXXXXXXXXXXXXXXXGXXXXXXXXXXXXXXXXXXXGXXXXXXXXXXXXXXXXXXXGXXXXXXXXXXXXXXXXXXX,0,300,0
48426,13,0,13,27,260,0,0,272,225,47,GXXXXXXXXXXXXXXXXXXXGXXXXXXXXXXXXXXXXXXXGXXXXXXXXXXXXXXXXXXXGXXXXXXXXXXXXXXXXXXXGXXXXXXXXXXXXXXXXXXXGXXXXXXXXXXXXXXXXXXXGXXXXXXXXXXXXXXXXXXXGXXXXXXXXXXXXXXXXXXXGXXXXXXXXXXXXXXXXXXXGXXXXXXXXXXXXXXXXXXXGXXXXXXXXXXXXXXXXXXXGXXXXXXXXXXXXXXXXXXXGXXXXXXXXXXXXXXXXXXX,0,300,0
48447,13,0,13,30,257,0,0,269,224,45,GXXXXXXXXXXXXXXXXXXXGXXXXXXXXXXXXXXXXXXXGXXXXXXXXXXXXXXXXXXXGXXXXXXXXXXXXXXXXXXXGXXXXXXXXXXXXXXXXXXXGXXXXXXXXXXXXXXXXXXXGXXXXXXXXXXXXXXXXXXXGXXXXXXXXXXXXXXXXXXXGXXXXXXXXXXXXXXXXXXXGXXXXXXXXXXXXXXXXXXXGXXXXXXXXXXXXXXXXXXXGXXXXXXXXXXXXXXXXXXXGXXXXXXXXXXXXXXXXXXX,0,300,0
48468,13,0,13,32,255,0,0,267,223,44,GXXXXXXXXXXXXXXXXXXXGXXXXXXXXXXXXXXXXXXXGXXXXXXXXXXXXXXXXXXXGXXXXXXXXXXXXXXXXXXXGXXXXXXXXXXXXXXXXXXXGXXXXXXXXXXXXXXXXXXXGXXXXXXXXXXXXXXXXXXXGXXXXXXXXXXXXXXXXXXXGXXXXXXXXXXXXXXXXXXXGXXXXXXXXXXXXXXXXXXXGXXXXXXXXXXXXXXXXXXXGXXXXXXXXXXXXXXXXXXXGXXXXXXXXXXXXXXXXXXX,0,300,0
48489,13,0,13,30,257,0,0,269,225,44,GXXXXXXXXXXXXXXXXXXXGXXXXXXXXXXXXXXXXXXXGXXXXXXXXXXXXXXXXXXXGXXXXXXXXXXXXXXXXXXXGXXXXXXXXXXXXXXXXXXXGXXXXXXXXXXXXXXXXXXXGXXXXXXXXXXXXXXXXXXXGXXXXXXXXXXXXXXXXXXXGXXXXXXXXXXXXXXXXXXXGXXXXXXXXXXXXXXXXXXXGXXXXXXXXXXXXXXXXXXXGXXXXXXXXXXXXXXXXXXXGXXXXXXXXXXXXXXXXXXX,0,300,0

48510,13,0,13,30,257,0,0,269,226,43,GXXXXXXXXXXXXXXXXXXXGXXXXXXXXXXXXXXXXXXXGXXXXXXXXXXXXXXXXXXXGXXXXXXXXXXXXXXXXXXXGXXXXXXXXXXXXXXXXXXXGXXXXXXXXXXXXXXXXXXXGXXXXXXXXXXXXXXXXXXXGXXXXXXXXXXXXXXXXXXXGXXXXXXXXXXXXXXXXXXXGXXXXXXXXXXXXXXXXXXXGXXXXXXXXXXXXXXXXXXXGXXXXXXXXXXXXXXXXXXXGXXXXXXXXXXXXXXXXXXX,0,300,0
48531,13,0,13,28,259,0,0,270,221,49,GXXXXXXXXXXXXXXXXXXXGXXXXXXXXXXXXXXXXXXXGXXXXXXXXXXXXXXXXXXXGXXXXXXXXXXXXXXXXXXXGXXXXXXXXXXXXXXXXXXXGXXXXXXXXXXXXXXXXXXXGXXXXXXXXXXXXXXXXXXXGXXXXXXXXXXXXXXXXXXXGXXXXXXXXXXXXXXXXXXXGXXXXXXXXXXXXXXXXXXXGXXXXXXXXXXXXXXXXXXXGXXXXXXXXXXXXXXXXXXXGXXXXXXXXXXXXXXXXXXX,0,300,0
48552,13,0,13,28,259,0,0,271,220,51,GXXXXXXXXXXXXXXXXXXXGXXXXXXXXXXXXXXXXXXXGXXXXXXXXXXXXXXXXXXXGXXXXXXXXXXXXXXXXXXXGXXXXXXXXXXXXXXXXXXXGXXXXXXXXXXXXXXXXXXXGXXXXXXXXXXXXXXXXXXXGXXXXXXXXXXXXXXXXXXXGXXXXXXXXXXXXXXXXXXXGXXXXXXXXXXXXXXXXXXXGXXXXXXXXXXXXXXXXXXXGXXXXXXXXXXXXXXXXXXXGXXXXXXXXXXXXXXXXXXX,0,300,0
48573,13,0,13,26,261,0,0,273,219,54,GXXXXXXXXXXXXXXXXXXXGXXXXXXXXXXXXXXXXXXXGXXXXXXXXXXXXXXXXXXXGXXXXXXXXXXXXXXXXXXXGXXXXXXXXXXXXXXXXXXXGXXXXXXXXXXXXXXXXXXXGXXXXXXXXXXXXXXXXXXXGXXXXXXXXXXXXXXXXXXXGXXXXXXXXXXXXXXXXXXXGXXXXXXXXXXXXXXXXXXXGXXXXXXXXXXXXXXXXXXXGXXXXXXXXXXXXXXXXXXXGXXXXXXXXXXXXXXXXXXX,0,300,0
48594,13,0,13,22,265,0,0,276,221,55,GXXXXXXXXXXXXXXXXXXXGXXXXXXXXXXXXXXXXXXXGXXXXXXXXXXXXXXXXXXXGXXXXXXXXXXXXXXXXXXXGXXXXXXXXXXXXXXXXXXXGXXXXXXXXXXXXXXXXXXXGXXXXXXXXXXXXXXXXXXXGXXXXXXXXXXXXXXXXXXXGXXXXXXXXXXXXXXXXXXXGXXXXXXXXXXXXXXXXXXXGXXXXXXXXXXXXXXXXXXXGXXXXXXXXXXXXXXXXXXXGXXXXXXXXXXXXXXXXXXX,0,300,0

48615,13,0,13,20,267,0,0,279,223,56,GXXXXXXXXXXXXXXXXXXXGXXXXXXXXXXXXXXXXXXXGXXXXXXXXXXXXXXXXXXXGXXXXXXXXXXXXXXXXXXXGXXXXXXXXXXXXXXXXXXXGXXXXXXXXXXXXXXXXXXXGXXXXXXXXXXXXXXXXXXXGXXXXXXXXXXXXXXXXXXXGXXXXXXXXXXXXXXXXXXXGXXXXXXXXXXXXXXXXXXXGXXXXXXXXXXXXXXXXXXXGXXXXXXXXXXXXXXXXXXXGXXXXXXXXXXXXXXXXXXX,0,300,0
48636,13,0,13,18,269,0,0,281,223,58,GXXXXXXXXXXXXXXXXXXXGXXXXXXXXXXXXXXXXXXXGXXXXXXXXXXXXXXXXXXXGXXXXXXXXXXXXXXXXXXXGXXXXXXXXXXXXXXXXXXXGXXXXXXXXXXXXXXXXXXXGXXXXXXXXXXXXXXXXXXXGXXXXXXXXXXXXXXXXXXXGXXXXXXXXXXXXXXXXXXXGXXXXXXXXXXXXXXXXXXXGXXXXXXXXXXXXXXXXXXXGXXXXXXXXXXXXXXXXXXXGXXXXXXXXXXXXXXXXXXX,0,300,0
48657,13,0,13,16,271,0,0,283,223,60,GXXXXXXXXXXXXXXXXXXXGXXXXXXXXXXXXXXXXXXXGXXXXXXXXXXXXXXXXXXXGXXXXXXXXXXXXXXXXXXXGXXXXXXXXXXXXXXXXXXXGXXXXXXXXXXXXXXXXXXXGXXXXXXXXXXXXXXXXXXXGXXXXXXXXXXXXXXXXXXXGXXXXXXXXXXXXXXXXXXXGXXXXXXXXXXXXXXXXXXXGXXXXXXXXXXXXXXXXXXXGXXXXXXXXXXXXXXXXXXXGXXXXXXXXXXXXXXXXXXX,0,300,0
48678,13,0,13,15,272,0,0,284,221,63,GXXXXXXXXXXXXXXXXXXXGXXXXXXXXXXXXXXXXXXXGXXXXXXXXXXXXXXXXXXXGXXXXXXXXXXXXXXXXXXXGXXXXXXXXXXXXXXXXXXXGXXXXXXXXXXXXXXXXXXXGXXXXXXXXXXXXXXXXXXXGXXXXXXXXXXXXXXXXXXXGXXXXXXXXXXXXXXXXXXXGXXXXXXXXXXXXXXXXXXXGXXXXXXXXXXXXXXXXXXXGXXXXXXXXXXXXXXXXXXXGXXXXXXXXXXXXXXXXXXX,0,300,0
48699,13,0,13,15,272,0,0,284,221,63,GXXXXXXXXXXXXXXXXXXXGXXXXXXXXXXXXXXXXXXXGXXXXXXXXXXXXXXXXXXXGXXXXXXXXXXXXXXXXXXXGXXXXXXXXXXXXXXXXXXXGXXXXXXXXXXXXXXXXXXXGXXXXXXXXXXXXXXXXXXXGXXXXXXXXXXXXXXXXXXXGXXXXXXXXXXXXXXXXXXXGXXXXXXXXXXXXXXXXXXXGXXXXXXXXXXXXXXXXXXXGXXXXXXXXXXXXXXXXXXXGXXXXXXXXXXXXXXXXXXX,0,300,0

48720,13,0,13,15,272,0,0,284,224,60,GXXXXXXXXXXXXXXXXXXXGXXXXXXXXXXXXXXXXXXXGXXXXXXXXXXXXXXXXXXXGXXXXXXXXXXXXXXXXXXXGXXXXXXXXXXXXXXXXXXXGXXXXXXXXXXXXXXXXXXXGXXXXXXXXXXXXXXXXXXXGXXXXXXXXXXXXXXXXXXXGXXXXXXXXXXXXXXXXXXXGXXXXXXXXXXXXXXXXXXXGXXXXXXXXXXXXXXXXXXXGXXXXXXXXXXXXXXXXXXXGXXXXXXXXXXXXXXXXXXX,0,300,0
48741,13,0,13,18,269,0,0,281,225,56,GXXXXXXXXXXXXXXXXXXXGXXXXXXXXXXXXXXXXXXXGXXXXXXXXXXXXXXXXXXXGXXXXXXXXXXXXXXXXXXXGXXXXXXXXXXXXXXXXXXXGXXXXXXXXXXXXXXXXXXXGXXXXXXXXXXXXXXXXXXXGXXXXXXXXXXXXXXXXXXXGXXXXXXXXXXXXXXXXXXXGXXXXXXXXXXXXXXXXXXXGXXXXXXXXXXXXXXXXXXXGXXXXXXXXXXXXXXXXXXXGXXXXXXXXXXXXXXXXXXX,0,300,0
48762,13,0,13,24,263,0,0,275,222,53,GXXXXXXXXXXXXXXXXXXXGXXXXXXXXXXXXXXXXXXXGXXXXXXXXXXXXXXXXXXXGXXXXXXXXXXXXXXXXXXXGXXXXXXXXXXXXXXXXXXXGXXXXXXXXXXXXXXXXXXXGXXXXXXXXXXXXXXXXXXXGXXXXXXXXXXXXXXXXXXXGXXXXXXXXXXXXXXXXXXXGXXXXXXXXXXXXXXXXXXXGXXXXXXXXXXXXXXXXXXXGXXXXXXXXXXXXXXXXXXXGXXXXXXXXXXXXXXXXXXX,0,300,0
48783,13,0,13,25,262,0,0,273,222,51,GXXXXXXXXXXXXXXXXXXXGXXXXXXXXXXXXXXXXXXXGXXXXXXXXXXXXXXXXXXXGXXXXXXXXXXXXXXXXXXXGXXXXXXXXXXXXXXXXXXXGXXXXXXXXXXXXXXXXXXXGXXXXXXXXXXXXXXXXXXXGXXXXXXXXXXXXXXXXXXXGXXXXXXXXXXXXXXXXXXXGXXXXXXXXXXXXXXXXXXXGXXXXXXXXXXXXXXXXXXXGXXXXXXXXXXXXXXXXXXXGXXXXXXXXXXXXXXXXXXX,0,300,0
48804,13,0,13,27,260,0,0,272,223,49,GXXXXXXXXXXXXXXXXXXXGXXXXXXXXXXXXXXXXXXXGXXXXXXXXXXXXXXXXXXXGXXXXXXXXXXXXXXXXXXXGXXXXXXXXXXXXXXXXXXXGXXXXXXXXXXXXXXXXXXXGXXXXXXXXXXXXXXXXXXXGXXXXXXXXXXXXXXXXXXXGXXXXXXXXXXXXXXXXXXXGXXXXXXXXXXXXXXXXXXXGXXXXXXXXXXXXXXXXXXXGXXXXXXXXXXXXXXXXXXXGXXXXXXXXXXXXXXXXXXX,0,300,0

48825,13,0,13,24,263,0,0,275,225,50,GXXXXXXXXXXXXXXXXXXXGXXXXXXXXXXXXXXXXXXXGXXXXXXXXXXXXXXXXXXXGXXXXXXXXXXXXXXXXXXXGXXXXXXXXXXXXXXXXXXXGXXXXXXXXXXXXXXXXXXXGXXXXXXXXXXXXXXXXXXXGXXXXXXXXXXXXXXXXXXXGXXXXXXXXXXXXXXXXXXXGXXXXXXXXXXXXXXXXXXXGXXXXXXXXXXXXXXXXXXXGXXXXXXXXXXXXXXXXXXXGXXXXXXXXXXXXXXXXXXX,0,300,0
48846,13,0,13,28,259,0,0,271,221,50,GXXXXXXXXXXXXXXXXXXXGXXXXXXXXXXXXXXXXXXXGXXXXXXXXXXXXXXXXXXXGXXXXXXXXXXXXXXXXXXXGXXXXXXXXXXXXXXXXXXXGXXXXXXXXXXXXXXXXXXXGXXXXXXXXXXXXXXXXXXXGXXXXXXXXXXXXXXXXXXXGXXXXXXXXXXXXXXXXXXXGXXXXXXXXXXXXXXXXXXXGXXXXXXXXXXXXXXXXXXXGXXXXXXXXXXXXXXXXXXXGXXXXXXXXXXXXXXXXXXX,0,300,0
48867,13,0,13,27,260,0,0,272,221,51,GXXXXXXXXXXXXXXXXXXXGXXXXXXXXXXXXXXXXXXXGXXXXXXXXXXXXXXXXXXXGXXXXXXXXXXXXXXXXXXXGXXXXXXXXXXXXXXXXXXXGXXXXXXXXXXXXXXXXXXXGXXXXXXXXXXXXXXXXXXXGXXXXXXXXXXXXXXXXXXXGXXXXXXXXXXXXXXXXXXXGXXXXXXXXXXXXXXXXXXXGXXXXXXXXXXXXXXXXXXXGXXXXXXXXXXXXXXXXXXXGXXXXXXXXXXXXXXXXXXX,0,300,0
48888,13,0,13,25,262,0,0,274,224,50,GXXXXXXXXXXXXXXXXXXXGXXXXXXXXXXXXXXXXXXXGXXXXXXXXXXXXXXXXXXXGXXXXXXXXXXXXXXXXXXXGXXXXXXXXXXXXXXXXXXXGXXXXXXXXXXXXXXXXXXXGXXXXXXXXXXXXXXXXXXXGXXXXXXXXXXXXXXXXXXXGXXXXXXXXXXXXXXXXXXXGXXXXXXXXXXXXXXXXXXXGXXXXXXXXXXXXXXXXXXXGXXXXXXXXXXXXXXXXXXXGXXXXXXXXXXXXXXXXXXX,0,300,0
48909,13,0,13,29,258,0,0,270,223,47,GXXXXXXXXXXXXXXXXXXXGXXXXXXXXXXXXXXXXXXXGXXXXXXXXXXXXXXXXXXXGXXXXXXXXXXXXXXXXXXXGXXXXXXXXXXXXXXXXXXXGXXXXXXXXXXXXXXXXXXXGXXXXXXXXXXXXXXXXXXXGXXXXXXXXXXXXXXXXXXXGXXXXXXXXXXXXXXXXXXXGXXXXXXXXXXXXXXXXXXXGXXXXXXXXXXXXXXXXXXXGXXXXXXXXXXXXXXXXXXXGXXXXXXXXXXXXXXXXXXX,0,300,0

48930,13,0,13,27,260,0,0,272,223,49,GXXXXXXXXXXXXXXXXXXXGXXXXXXXXXXXXXXXXXXXGXXXXXXXXXXXXXXXXXXXGXXXXXXXXXXXXXXXXXXXGXXXXXXXXXXXXXXXXXXXGXXXXXXXXXXXXXXXXXXXGXXXXXXXXXXXXXXXXXXXGXXXXXXXXXXXXXXXXXXXGXXXXXXXXXXXXXXXXXXXGXXXXXXXXXXXXXXXXXXXGXXXXXXXXXXXXXXXXXXXGXXXXXXXXXXXXXXXXXXXGXXXXXXXXXXXXXXXXXXX,0,300,0
48951,13,0,13,27,260,0,0,272,226,46,GXXXXXXXXXXXXXXXXXXXGXXXXXXXXXXXXXXXXXXXGXXXXXXXXXXXXXXXXXXXGXXXXXXXXXXXXXXXXXXXGXXXXXXXXXXXXXXXXXXXGXXXXXXXXXXXXXXXXXXXGXXXXXXXXXXXXXXXXXXXGXXXXXXXXXXXXXXXXXXXGXXXXXXXXXXXXXXXXXXXGXXXXXXXXXXXXXXXXXXXGXXXXXXXXXXXXXXXXXXXGXXXXXXXXXXXXXXXXXXXGXXXXXXXXXXXXXXXXXXX,0,300,0
48972,13,0,13,29,258,0,0,270,224,46,GXXXXXXXXXXXXXXXXXXXGXXXXXXXXXXXXXXXXXXXGXXXXXXXXXXXXXXXXXXXGXXXXXXXXXXXXXXXXXXXGXXXXXXXXXXXXXXXXXXXGXXXXXXXXXXXXXXXXXXXGXXXXXXXXXXXXXXXXXXXGXXXXXXXXXXXXXXXXXXXGXXXXXXXXXXXXXXXXXXXGXXXXXXXXXXXXXXXXXXXGXXXXXXXXXXXXXXXXXXXGXXXXXXXXXXXXXXXXXXXGXXXXXXXXXXXXXXXXXXX,0,300,0
48993,13,0,13,31,256,0,0,268,225,43,GXXXXXXXXXXXXXXXXXXXGXXXXXXXXXXXXXXXXXXXGXXXXXXXXXXXXXXXXXXXGXXXXXXXXXXXXXXXXXXXGXXXXXXXXXXXXXXXXXXXGXXXXXXXXXXXXXXXXXXXGXXXXXXXXXXXXXXXXXXXGXXXXXXXXXXXXXXXXXXXGXXXXXXXXXXXXXXXXXXXGXXXXXXXXXXXXXXXXXXXGXXXXXXXXXXXXXXXXXXXGXXXXXXXXXXXXXXXXXXXGXXXXXXXXXXXXXXXXXXX,0,300,0
49014,13,0,13,31,256,0,0,268,225,43,GXXXXXXXXXXXXXXXXXXXGXXXXXXXXXXXXXXXXXXXGXXXXXXXXXXXXXXXXXXXGXXXXXXXXXXXXXXXXXXXGXXXXXXXXXXXXXXXXXXXGXXXXXXXXXXXXXXXXXXXGXXXXXXXXXXXXXXXXXXXGXXXXXXXXXXXXXXXXXXXGXXXXXXXXXXXXXXXXXXXGXXXXXXXXXXXXXXXXXXXGXXXXXXXXXXXXXXXXXXXGXXXXXXXXXXXXXXXXXXXGXXXXXXXXXXXXXXXXXXX,0,300,0

49035,13,0,13,33,254,0,0,266,223,43,GXXXXXXXXXXXXXXXXXXXGXXXXXXXXXXXXXXXXXXXGXXXXXXXXXXXXXXXXXXXGXXXXXXXXXXXXXXXXXXXGXXXXXXXXXXXXXXXXXXXGXXXXXXXXXXXXXXXXXXXGXXXXXXXXXXXXXXXXXXXGXXXXXXXXXXXXXXXXXXXGXXXXXXXXXXXXXXXXXXXGXXXXXXXXXXXXXXXXXXXGXXXXXXXXXXXXXXXXXXXGXXXXXXXXXXXXXXXXXXXGXXXXXXXXXXXXXXXXXXX,0,300,0
49056,13,0,13,34,253,0,0,265,221,44,GXXXXXXXXXXXXXXXXXXXGXXXXXXXXXXXXXXXXXXXGXXXXXXXXXXXXXXXXXXXGXXXXXXXXXXXXXXXXXXXGXXXXXXXXXXXXXXXXXXXGXXXXXXXXXXXXXXXXXXXGXXXXXXXXXXXXXXXXXXXGXXXXXXXXXXXXXXXXXXXGXXXXXXXXXXXXXXXXXXXGXXXXXXXXXXXXXXXXXXXGXXXXXXXXXXXXXXXXXXXGXXXXXXXXXXXXXXXXXXXGXXXXXXXXXXXXXXXXXXX,0,300,0
49077,13,0,13,29,258,0,0,269,221,48,GXXXXXXXXXXXXXXXXXXXGXXXXXXXXXXXXXXXXXXXGXXXXXXXXXXXXXXXXXXXGXXXXXXXXXXXXXXXXXXXGXXXXXXXXXXXXXXXXXXXGXXXXXXXXXXXXXXXXXXXGXXXXXXXXXXXXXXXXXXXGXXXXXXXXXXXXXXXXXXXGXXXXXXXXXXXXXXXXXXXGXXXXXXXXXXXXXXXXXXXGXXXXXXXXXXXXXXXXXXXGXXXXXXXXXXXXXXXXXXXGXXXXXXXXXXXXXXXXXXX,0,300,0
49098,13,0,13,26,261,0,0,273,223,50,GXXXXXXXXXXXXXXXXXXXGXXXXXXXXXXXXXXXXXXXGXXXXXXXXXXXXXXXXXXXGXXXXXXXXXXXXXXXXXXXGXXXXXXXXXXXXXXXXXXXGXXXXXXXXXXXXXXXXXXXGXXXXXXXXXXXXXXXXXXXGXXXXXXXXXXXXXXXXXXXGXXXXXXXXXXXXXXXXXXXGXXXXXXXXXXXXXXXXXXXGXXXXXXXXXXXXXXXXXXXGXXXXXXXXXXXXXXXXXXXGXXXXXXXXXXXXXXXXXXX,0,300,0
49119,13,0,13,27,260,0,0,272,221,51,GXXXXXXXXXXXXXXXXXXXGXXXXXXXXXXXXXXXXXXXGXXXXXXXXXXXXXXXXXXXGXXXXXXXXXXXXXXXXXXXGXXXXXXXXXXXXXXXXXXXGXXXXXXXXXXXXXXXXXXXGXXXXXXXXXXXXXXXXXXXGXXXXXXXXXXXXXXXXXXXGXXXXXXXXXXXXXXXXXXXGXXXXXXXXXXXXXXXXXXXGXXXXXXXXXXXXXXXXXXXGXXXXXXXXXXXXXXXXXXXGXXXXXXXXXXXXXXXXXXX,0,300,0

49140,13,0,13,27,260,0,0,272,221,51,GXXXXXXXXXXXXXXXXXXXGXXXXXXXXXXXXXXXXXXXGXXXXXXXXXXXXXXXXXXXGXXXXXXXXXXXXXXXXXXXGXXXXXXXXXXXXXXXXXXXGXXXXXXXXXXXXXXXXXXXGXXXXXXXXXXXXXXXXXXXGXXXXXXXXXXXXXXXXXXXGXXXXXXXXXXXXXXXXXXXGXXXXXXXXXXXXXXXXXXXGXXXXXXXXXXXXXXXXXXXGXXXXXXXXXXXXXXXXXXXGXXXXXXXXXXXXXXXXXXX,0,300,0
49161,13,0,13,25,262,0,0,274,222,52,GXXXXXXXXXXXXXXXXXXXGXXXXXXXXXXXXXXXXXXXGXXXXXXXXXXXXXXXXXXXGXXXXXXXXXXXXXXXXXXXGXXXXXXXXXXXXXXXXXXXGXXXXXXXXXXXXXXXXXXXGXXXXXXXXXXXXXXXXXXXGXXXXXXXXXXXXXXXXXXXGXXXXXXXXXXXXXXXXXXXGXXXXXXXXXXXXXXXXXXXGXXXXXXXXXXXXXXXXXXXGXXXXXXXXXXXXXXXXXXXGXXXXXXXXXXXXXXXXXXX,0,300,0
49182,13,0,13,21,266,0,0,277,224,53,GXXXXXXXXXXXXXXXXXXXGXXXXXXXXXXXXXXXXXXXGXXXXXXXXXXXXXXXXXXXGXXXXXXXXXXXXXXXXXXXGXXXXXXXXXXXXXXXXXXXGXXXXXXXXXXXXXXXXXXXGXXXXXXXXXXXXXXXXXXXGXXXXXXXXXXXXXXXXXXXGXXXXXXXXXXXXXXXXXXXGXXXXXXXXXXXXXXXXXXXGXXXXXXXXXXXXXXXXXXXGXXXXXXXXXXXXXXXXXXXGXXXXXXXXXXXXXXXXXXX,0,300,0
49203,13,0,13,21,266,0,0,278,223,55,GXXXXXXXXXXXXXXXXXXXGXXXXXXXXXXXXXXXXXXXGXXXXXXXXXXXXXXXXXXXGXXXXXXXXXXXXXXXXXXXGXXXXXXXXXXXXXXXXXXXGXXXXXXXXXXXXXXXXXXXGXXXXXXXXXXXXXXXXXXXGXXXXXXXXXXXXXXXXXXXGXXXXXXXXXXXXXXXXXXXGXXXXXXXXXXXXXXXXXXXGXXXXXXXXXXXXXXXXXXXGXXXXXXXXXXXXXXXXXXXGXXXXXXXXXXXXXXXXXXX,0,300,0
49224,13,0,13,23,264,0,0,277,225,52,GXXXXXXXXXXXXXXXXXXXGXXXXXXXXXXXXXXXXXXXGXXXXXXXXXXXXXXXXXXXGXXXXXXXXXXXXXXXXXXXGXXXXXXXXXXXXXXXXXXXGXXXXXXXXXXXXXXXXXXXGXXXXXXXXXXXXXXXXXXXGXXXXXXXXXXXXXXXXXXXGXXXXXXXXXXXXXXXXXXXGXXXXXXXXXXXXXXXXXXXGXXXXXXXXXXXXXXXXXXXGXXXXXXXXXXXXXXXXXXXGXXXXXXXXXXXXXXXXXXX,0,300,0

49245,13,0,13,25,262,0,0,274,226,48,GXXXXXXXXXXXXXXXXXXXGXXXXXXXXXXXXXXXXXXXGXXXXXXXXXXXXXXXXXXXGXXXXXXXXXXXXXXXXXXXGXXXXXXXXXXXXXXXXXXXGXXXXXXXXXXXXXXXXXXXGXXXXXXXXXXXXXXXXXXXGXXXXXXXXXXXXXXXXXXXGXXXXXXXXXXXXXXXXXXXGXXXXXXXXXXXXXXXXXXXGXXXXXXXXXXXXXXXXXXXGXXXXXXXXXXXXXXXXXXXGXXXXXXXXXXXXXXXXXXX,0,300,0
49266,13,0,13,24,263,0,0,277,227,50,GXXXXXXXXXXXXXXXXXXXGXXXXXXXXXXXXXXXXXXXGXXXXXXXXXXXXXXXXXXXGXXXXXXXXXXXXXXXXXXXGXXXXXXXXXXXXXXXXXXXGXXXXXXXXXXXXXXXXXXXGXXXXXXXXXXXXXXXXXXXGXXXXXXXXXXXXXXXXXXXGXXXXXXXXXXXXXXXXXXXGXXXXXXXXXXXXXXXXXXXGXXXXXXXXXXXXXXXXXXXGXXXXXXXXXXXXXXXXXXXGXXXXXXXXXXXXXXXXXXX,0,300,0
49287,13,0,13,26,261,0,0,276,225,51,GXXXXXXXXXXXXXXXXXXXGXXXXXXXXXXXXXXXXXXXGXXXXXXXXXXXXXXXXXXXGXXXXXXXXXXXXXXXXXXXGXXXXXXXXXXXXXXXXXXXGXXXXXXXXXXXXXXXXXXXGXXXXXXXXXXXXXXXXXXXGXXXXXXXXXXXXXXXXXXXGXXXXXXXXXXXXXXXXXXXGXXXXXXXXXXXXXXXXXXXGXXXXXXXXXXXXXXXXXXXGXXXXXXXXXXXXXXXXXXXGXXXXXXXXXXXXXXXXXXX,0,300,0
49308,13,0,13,29,258,0,0,273,225,48,GXXXXXXXXXXXXXXXXXXXGXXXXXXXXXXXXXXXXXXXGXXXXXXXXXXXXXXXXXXXGXXXXXXXXXXXXXXXXXXXGXXXXXXXXXXXXXXXXXXXGXXXXXXXXXXXXXXXXXXXGXXXXXXXXXXXXXXXXXXXGXXXXXXXXXXXXXXXXXXXGXXXXXXXXXXXXXXXXXXXGXXXXXXXXXXXXXXXXXXXGXXXXXXXXXXXXXXXXXXXGXXXXXXXXXXXXXXXXXXXGXXXXXXXXXXXXXXXXXXX,0,300,0
49329,13,0,13,28,259,0,0,274,226,48,GXXXXXXXXXXXXXXXXXXXGXXXXXXXXXXXXXXXXXXXGXXXXXXXXXXXXXXXXXXXGXXXXXXXXXXXXXXXXXXXGXXXXXXXXXXXXXXXXXXXGXXXXXXXXXXXXXXXXXXXGXXXXXXXXXXXXXXXXXXXGXXXXXXXXXXXXXXXXXXXGXXXXXXXXXXXXXXXXXXXGXXXXXXXXXXXXXXXXXXXGXXXXXXXXXXXXXXXXXXXGXXXXXXXXXXXXXXXXXXXGXXXXXXXXXXXXXXXXXXX,0,300,0

49350,13,0,13,30,257,0,0,272,224,48,GXXXXXXXXXXXXXXXXXXXGXXXXXXXXXXXXXXXXXXXGXXXXXXXXXXXXXXXXXXXGXXXXXXXXXXXXXXXXXXXGXXXXXXXXXXXXXXXXXXXGXXXXXXXXXXXXXXXXXXXGXXXXXXXXXXXXXXXXXXXGXXXXXXXXXXXXXXXXXXXGXXXXXXXXXXXXXXXXXXXGXXXXXXXXXXXXXXXXXXXGXXXXXXXXXXXXXXXXXXXGXXXXXXXXXXXXXXXXXXXGXXXXXXXXXXXXXXXXXXX,0,300,0
49371,13,0,13,30,257,0,0,271,222,49,GXXXXXXXXXXXXXXXXXXXGXXXXXXXXXXXXXXXXXXXGXXXXXXXXXXXXXXXXXXXGXXXXXXXXXXXXXXXXXXXGXXXXXXXXXXXXXXXXXXXGXXXXXXXXXXXXXXXXXXXGXXXXXXXXXXXXXXXXXXXGXXXXXXXXXXXXXXXXXXXGXXXXXXXXXXXXXXXXXXXGXXXXXXXXXXXXXXXXXXXGXXXXXXXXXXXXXXXXXXXGXXXXXXXXXXXXXXXXXXXGXXXXXXXXXXXXXXXXXXX,0,300,0
49392,13,0,13,31,256,0,0,269,221,48,GXXXXXXXXXXXXXXXXXXXGXXXXXXXXXXXXXXXXXXXGXXXXXXXXXXXXXXXXXXXGXXXXXXXXXXXXXXXXXXXGXXXXXXXXXXXXXXXXXXXGXXXXXXXXXXXXXXXXXXXGXXXXXXXXXXXXXXXXXXXGXXXXXXXXXXXXXXXXXXXGXXXXXXXXXXXXXXXXXXXGXXXXXXXXXXXXXXXXXXXGXXXXXXXXXXXXXXXXXXXGXXXXXXXXXXXXXXXXXXXGXXXXXXXXXXXXXXXXXXX,0,300,0
49413,13,0,13,28,259,0,0,272,222,50,GXXXXXXXXXXXXXXXXXXXGXXXXXXXXXXXXXXXXXXXGXXXXXXXXXXXXXXXXXXXGXXXXXXXXXXXXXXXXXXXGXXXXXXXXXXXXXXXXXXXGXXXXXXXXXXXXXXXXXXXGXXXXXXXXXXXXXXXXXXXGXXXXXXXXXXXXXXXXXXXGXXXXXXXXXXXXXXXXXXXGXXXXXXXXXXXXXXXXXXXGXXXXXXXXXXXXXXXXXXXGXXXXXXXXXXXXXXXXXXXGXXXXXXXXXXXXXXXXXXX,0,300,0
49434,13,0,13,29,258,0,0,271,224,47,GXXXXXXXXXXXXXXXXXXXGXXXXXXXXXXXXXXXXXXXGXXXXXXXXXXXXXXXXXXXGXXXXXXXXXXXXXXXXXXXGXXXXXXXXXXXXXXXXXXXGXXXXXXXXXXXXXXXXXXXGXXXXXXXXXXXXXXXXXXXGXXXXXXXXXXXXXXXXXXXGXXXXXXXXXXXXXXXXXXXGXXXXXXXXXXXXXXXXXXXGXXXXXXXXXXXXXXXXXXXGXXXXXXXXXXXXXXXXXXXGXXXXXXXXXXXXXXXXXXX,0,300,0

49455,13,0,13,30,257,0,0,270,226,44,GXXXXXXXXXXXXXXXXXXXGXXXXXXXXXXXXXXXXXXXGXXXXXXXXXXXXXXXXXXXGXXXXXXXXXXXXXXXXXXXGXXXXXXXXXXXXXXXXXXXGXXXXXXXXXXXXXXXXXXXGXXXXXXXXXXXXXXXXXXXGXXXXXXXXXXXXXXXXXXXGXXXXXXXXXXXXXXXXXXXGXXXXXXXXXXXXXXXXXXXGXXXXXXXXXXXXXXXXXXXGXXXXXXXXXXXXXXXXXXXGXXXXXXXXXXXXXXXXXXX,0,300,0
49476,13,0,13,28,259,0,0,272,224,48,GXXXXXXXXXXXXXXXXXXXGXXXXXXXXXXXXXXXXXXXGXXXXXXXXXXXXXXXXXXXGXXXXXXXXXXXXXXXXXXXGXXXXXXXXXXXXXXXXXXXGXXXXXXXXXXXXXXXXXXXGXXXXXXXXXXXXXXXXXXXGXXXXXXXXXXXXXXXXXXXGXXXXXXXXXXXXXXXXXXXGXXXXXXXXXXXXXXXXXXXGXXXXXXXXXXXXXXXXXXXGXXXXXXXXXXXXXXXXXXXGXXXXXXXXXXXXXXXXXXX,0,300,0
49497,13,0,13,27,260,0,0,274,224,50,GXXXXXXXXXXXXXXXXXXXGXXXXXXXXXXXXXXXXXXXGXXXXXXXXXXXXXXXXXXXGXXXXXXXXXXXXXXXXXXXGXXXXXXXXXXXXXXXXXXXGXXXXXXXXXXXXXXXXXXXGXXXXXXXXXXXXXXXXXXXGXXXXXXXXXXXXXXXXXXXGXXXXXXXXXXXXXXXXXXXGXXXXXXXXXXXXXXXXXXXGXXXXXXXXXXXXXXXXXXXGXXXXXXXXXXXXXXXXXXXGXXXXXXXXXXXXXXXXXXX,0,300,0
49518,13,0,13,29,258,0,0,272,224,48,GXXXXXXXXXXXXXXXXXXXGXXXXXXXXXXXXXXXXXXXGXXXXXXXXXXXXXXXXXXXGXXXXXXXXXXXXXXXXXXXGXXXXXXXXXXXXXXXXXXXGXXXXXXXXXXXXXXXXXXXGXXXXXXXXXXXXXXXXXXXGXXXXXXXXXXXXXXXXXXXGXXXXXXXXXXXXXXXXXXXGXXXXXXXXXXXXXXXXXXXGXXXXXXXXXXXXXXXXXXXGXXXXXXXXXXXXXXXXXXXGXXXXXXXXXXXXXXXXXXX,0,300,0
49539,13,0,13,24,263,0,0,276,229,47,GXXXXXXXXXXXXXXXXXXXGXXXXXXXXXXXXXXXXXXXGXXXXXXXXXXXXXXXXXXXGXXXXXXXXXXXXXXXXXXXGXXXXXXXXXXXXXXXXXXXGXXXXXXXXXXXXXXXXXXXGXXXXXXXXXXXXXXXXXXXGXXXXXXXXXXXXXXXXXXXGXXXXXXXXXXXXXXXXXXXGXXXXXXXXXXXXXXXXXXXGXXXXXXXXXXXXXXXXXXXGXXXXXXXXXXXXXXXXXXXGXXXXXXXXXXXXXXXXXXX,0,300,0

49560,13,0,13,26,261,0,0,274,229,45,GXXXXXXXXXXXXXXXXXXXGXXXXXXXXXXXXXXXXXXXGXXXXXXXXXXXXXXXXXXXGXXXXXXXXXXXXXXXXXXXGXXXXXXXXXXXXXXXXXXXGXXXXXXXXXXXXXXXXXXXGXXXXXXXXXXXXXXXXXXXGXXXXXXXXXXXXXXXXXXXGXXXXXXXXXXXXXXXXXXXGXXXXXXXXXXXXXXXXXXXGXXXXXXXXXXXXXXXXXXXGXXXXXXXXXXXXXXXXXXXGXXXXXXXXXXXXXXXXXXX,0,300,0
49581,13,0,13,26,261,0,0,274,228,46,GXXXXXXXXXXXXXXXXXXXGXXXXXXXXXXXXXXXXXXXGXXXXXXXXXXXXXXXXXXXGXXXXXXXXXXXXXXXXXXXGXXXXXXXXXXXXXXXXXXXGXXXXXXXXXXXXXXXXXXXGXXXXXXXXXXXXXXXXXXXGXXXXXXXXXXXXXXXXXXXGXXXXXXXXXXXXXXXXXXXGXXXXXXXXXXXXXXXXXXXGXXXXXXXXXXXXXXXXXXXGXXXXXXXXXXXXXXXXXXXGXXXXXXXXXXXXXXXXXXX,0,300,0
49602,13,0,13,29,258,0,0,270,225,45,GXXXXXXXXXXXXXXXXXXXGXXXXXXXXXXXXXXXXXXXGXXXXXXXXXXXXXXXXXXXGXXXXXXXXXXXXXXXXXXXGXXXXXXXXXXXXXXXXXXXGXXXXXXXXXXXXXXXXXXXGXXXXXXXXXXXXXXXXXXXGXXXXXXXXXXXXXXXXXXXGXXXXXXXXXXXXXXXXXXXGXXXXXXXXXXXXXXXXXXXGXXXXXXXXXXXXXXXXXXXGXXXXXXXXXXXXXXXXXXXGXXXXXXXXXXXXXXXXXXX,0,300,0
49623,13,0,13,29,258,0,0,270,222,48,GXXXXXXXXXXXXXXXXXXXGXXXXXXXXXXXXXXXXXXXGXXXXXXXXXXXXXXXXXXXGXXXXXXXXXXXXXXXXXXXGXXXXXXXXXXXXXXXXXXXGXXXXXXXXXXXXXXXXXXXGXXXXXXXXXXXXXXXXXXXGXXXXXXXXXXXXXXXXXXXGXXXXXXXXXXXXXXXXXXXGXXXXXXXXXXXXXXXXXXXGXXXXXXXXXXXXXXXXXXXGXXXXXXXXXXXXXXXXXXXGXXXXXXXXXXXXXXXXXXX,0,300,0
49644,13,0,13,28,259,0,0,271,223,48,GXXXXXXXXXXXXXXXXXXXGXXXXXXXXXXXXXXXXXXXGXXXXXXXXXXXXXXXXXXXGXXXXXXXXXXXXXXXXXXXGXXXXXXXXXXXXXXXXXXXGXXXXXXXXXXXXXXXXXXXGXXXXXXXXXXXXXXXXXXXGXXXXXXXXXXXXXXXXXXXGXXXXXXXXXXXXXXXXXXXGXXXXXXXXXXXXXXXXXXXGXXXXXXXXXXXXXXXXXXXGXXXXXXXXXXXXXXXXXXXGXXXXXXXXXXXXXXXXXXX,0,300,0

49665,14,1,13,26,260,0,0,272,223,49,GXXXXXXXXXXXXXXXXXXXGXXXXXXXXXXXXXXXXXXXGXXXXXXXXXXXXXXXXXXXGAXXXXXXXXXXXXXXXXXXGXXXXXXXXXXXXXXXXXXXGXXXXXXXXXXXXXXXXXXXGXXXXXXXXXXXXXXXXXXXGXXXXXXXXXXXXXXXXXXXGXXXXXXXXXXXXXXXXXXXGXXXXXXXXXXXXXXXXXXXGXXXXXXXXXXXXXXXXXXXGXXXXXXXXXXXXXXXXXXXGXXXXXXXXXXXXXXXXXXX,0,300,0
49686,14,1,13,24,262,0,0,274,227,47,GXXXXXXXXXXXXXXXXXXXGXXXXXXXXXXXXXXXXXXXGXXXXXXXXXXXXXXXXXXXGAXXXXXXXXXXXXXXXXXXGXXXXXXXXXXXXXXXXXXXGXXXXXXXXXXXXXXXXXXXGXXXXXXXXXXXXXXXXXXXGXXXXXXXXXXXXXXXXXXXGXXXXXXXXXXXXXXXXXXXGXXXXXXXXXXXXXXXXXXXGXXXXXXXXXXXXXXXXXXXGXXXXXXXXXXXXXXXXXXXGXXXXXXXXXXXXXXXXXXX,0,300,0
49707,14,1,13,24,262,0,0,274,225,49,GXXXXXXXXXXXXXXXXXXXGXXXXXXXXXXXXXXXXXXXGXXXXXXXXXXXXXXXXXXXGAXXXXXXXXXXXXXXXXXXGXXXXXXXXXXXXXXXXXXXGXXXXXXXXXXXXXXXXXXXGXXXXXXXXXXXXXXXXXXXGXXXXXXXXXXXXXXXXXXXGXXXXXXXXXXXXXXXXXXXGXXXXXXXXXXXXXXXXXXXGXXXXXXXXXXXXXXXXXXXGXXXXXXXXXXXXXXXXXXXGXXXXXXXXXXXXXXXXXXX,0,300,0
49728,14,0,14,23,263,0,0,275,223,52,GXXXXXXXXXXXXXXXXXXXGXXXXXXXXXXXXXXXXXXXGXXXXXXXXXXXXXXXXXXXGOXXXXXXXXXXXXXXXXXXGXXXXXXXXXXXXXXXXXXXGXXXXXXXXXXXXXXXXXXXGXXXXXXXXXXXXXXXXXXXGXXXXXXXXXXXXXXXXXXXGXXXXXXXXXXXXXXXXXXXGXXXXXXXXXXXXXXXXXXXGXXXXXXXXXXXXXXXXXXXGXXXXXXXXXXXXXXXXXXXGXXXXXXXXXXXXXXXXXXX,0,300,0
49749,14,0,14,26,260,0,0,272,226,46,GXXXXXXXXXXXXXXXXXXXGXXXXXXXXXXXXXXXXXXXGXXXXXXXXXXXXXXXXXXXGOXXXXXXXXXXXXXXXXXXGXXXXXXXXXXXXXXXXXXXGXXXXXXXXXXXXXXXXXXXGXXXXXXXXXXXXXXXXXXXGXXXXXXXXXXXXXXXXXXXGXXXXXXXXXXXXXXXXXXXGXXXXXXXXXXXXXXXXXXXGXXXXXXXXXXXXXXXXXXXGXXXXXXXXXXXXXXXXXXXGXXXXXXXXXXXXXXXXXXX,0,300,0

49770,13,0,13,24,263,0,0,275,227,48,GXXXXXXXXXXXXXXXXXXXGXXXXXXXXXXXXXXXXXXXGXXXXXXXXXXXXXXXXXXXGXXXXXXXXXXXXXXXXXXXGXXXXXXXXXXXXXXXXXXXGXXXXXXXXXXXXXXXXXXXGXXXXXXXXXXXXXXXXXXXGXXXXXXXXXXXXXXXXXXXGXXXXXXXXXXXXXXXXXXXGXXXXXXXXXXXXXXXXXXXGXXXXXXXXXXXXXXXXXXXGXXXXXXXXXXXXXXXXXXXGXXXXXXXXXXXXXXXXXXX,0,300,0
49791,13,0,13,28,259,0,0,271,221,50,GXXXXXXXXXXXXXXXXXXXGXXXXXXXXXXXXXXXXXXXGXXXXXXXXXXXXXXXXXXXGXXXXXXXXXXXXXXXXXXXGXXXXXXXXXXXXXXXXXXXGXXXXXXXXXXXXXXXXXXXGXXXXXXXXXXXXXXXXXXXGXXXXXXXXXXXXXXXXXXXGXXXXXXXXXXXXXXXXXXXGXXXXXXXXXXXXXXXXXXXGXXXXXXXXXXXXXXXXXXXGXXXXXXXXXXXXXXXXXXXGXXXXXXXXXXXXXXXXXXX,0,300,0
49812,13,0,13,26,261,0,0,274,221,53,GXXXXXXXXXXXXXXXXXXXGXXXXXXXXXXXXXXXXXXXGXXXXXXXXXXXXXXXXXXXGXXXXXXXXXXXXXXXXXXXGXXXXXXXXXXXXXXXXXXXGXXXXXXXXXXXXXXXXXXXGXXXXXXXXXXXXXXXXXXXGXXXXXXXXXXXXXXXXXXXGXXXXXXXXXXXXXXXXXXXGXXXXXXXXXXXXXXXXXXXGXXXXXXXXXXXXXXXXXXXGXXXXXXXXXXXXXXXXXXXGXXXXXXXXXXXXXXXXXXX,0,300,0
49833,13,0,13,25,262,0,0,275,221,54,GXXXXXXXXXXXXXXXXXXXGXXXXXXXXXXXXXXXXXXXGXXXXXXXXXXXXXXXXXXXGXXXXXXXXXXXXXXXXXXXGXXXXXXXXXXXXXXXXXXXGXXXXXXXXXXXXXXXXXXXGXXXXXXXXXXXXXXXXXXXGXXXXXXXXXXXXXXXXXXXGXXXXXXXXXXXXXXXXXXXGXXXXXXXXXXXXXXXXXXXGXXXXXXXXXXXXXXXXXXXGXXXXXXXXXXXXXXXXXXXGXXXXXXXXXXXXXXXXXXX,0,300,0
49854,13,0,13,23,264,0,0,276,221,55,GXXXXXXXXXXXXXXXXXXXGXXXXXXXXXXXXXXXXXXXGXXXXXXXXXXXXXXXXXXXGXXXXXXXXXXXXXXXXXXXGXXXXXXXXXXXXXXXXXXXGXXXXXXXXXXXXXXXXXXXGXXXXXXXXXXXXXXXXXXXGXXXXXXXXXXXXXXXXXXXGXXXXXXXXXXXXXXXXXXXGXXXXXXXXXXXXXXXXXXXGXXXXXXXXXXXXXXXXXXXGXXXXXXXXXXXXXXXXXXXGXXXXXXXXXXXXXXXXXXX,0,300,0

49875,13,0,13,22,265,0,0,278,223,55,GXXXXXXXXXXXXXXXXXXXGXXXXXXXXXXXXXXXXXXXGXXXXXXXXXXXXXXXXXXXGXXXXXXXXXXXXXXXXXXXGXXXXXXXXXXXXXXXXXXXGXXXXXXXXXXXXXXXXXXXGXXXXXXXXXXXXXXXXXXXGXXXXXXXXXXXXXXXXXXXGXXXXXXXXXXXXXXXXXXXGXXXXXXXXXXXXXXXXXXXGXXXXXXXXXXXXXXXXXXXGXXXXXXXXXXXXXXXXXXXGXXXXXXXXXXXXXXXXXXX,0,300,0
49896,13,0,13,24,263,0,0,276,224,52,GXXXXXXXXXXXXXXXXXXXGXXXXXXXXXXXXXXXXXXXGXXXXXXXXXXXXXXXXXXXGXXXXXXXXXXXXXXXXXXXGXXXXXXXXXXXXXXXXXXXGXXXXXXXXXXXXXXXXXXXGXXXXXXXXXXXXXXXXXXXGXXXXXXXXXXXXXXXXXXXGXXXXXXXXXXXXXXXXXXXGXXXXXXXXXXXXXXXXXXXGXXXXXXXXXXXXXXXXXXXGXXXXXXXXXXXXXXXXXXXGXXXXXXXXXXXXXXXXXXX,0,300,0
49917,13,0,13,27,260,0,0,273,225,48,GXXXXXXXXXXXXXXXXXXXGXXXXXXXXXXXXXXXXXXXGXXXXXXXXXXXXXXXXXXXGXXXXXXXXXXXXXXXXXXXGXXXXXXXXXXXXXXXXXXXGXXXXXXXXXXXXXXXXXXXGXXXXXXXXXXXXXXXXXXXGXXXXXXXXXXXXXXXXXXXGXXXXXXXXXXXXXXXXXXXGXXXXXXXXXXXXXXXXXXXGXXXXXXXXXXXXXXXXXXXGXXXXXXXXXXXXXXXXXXXGXXXXXXXXXXXXXXXXXXX,0,300,0
49938,13,0,13,26,261,0,0,274,223,51,GXXXXXXXXXXXXXXXXXXXGXXXXXXXXXXXXXXXXXXXGXXXXXXXXXXXXXXXXXXXGXXXXXXXXXXXXXXXXXXXGXXXXXXXXXXXXXXXXXXXGXXXXXXXXXXXXXXXXXXXGXXXXXXXXXXXXXXXXXXXGXXXXXXXXXXXXXXXXXXXGXXXXXXXXXXXXXXXXXXXGXXXXXXXXXXXXXXXXXXXGXXXXXXXXXXXXXXXXXXXGXXXXXXXXXXXXXXXXXXXGXXXXXXXXXXXXXXXXXXX,0,300,0
49959,13,0,13,28,259,0,0,273,224,49,GXXXXXXXXXXXXXXXXXXXGXXXXXXXXXXXXXXXXXXXGXXXXXXXXXXXXXXXXXXXGXXXXXXXXXXXXXXXXXXXGXXXXXXXXXXXXXXXXXXXGXXXXXXXXXXXXXXXXXXXGXXXXXXXXXXXXXXXXXXXGXXXXXXXXXXXXXXXXXXXGXXXXXXXXXXXXXXXXXXXGXXXXXXXXXXXXXXXXXXXGXXXXXXXXXXXXXXXXXXXGXXXXXXXXXXXXXXXXXXXGXXXXXXXXXXXXXXXXXXX,0,300,0

