iterCounter, dimersInMT, activeDimersInMT, inactiveDimersInMT, activeDimersFree,inactiveDimersFree, longestProtoFilament, lengthOfMT, totalGTPs, activeGTPs,inactiveGTPs, mtRepresentation, DeHydro Katanins, Hydro Katanins, Bonded Katanins

21,0,0,0,0,0,0,0,0,0,0,XXXXXXXXXXXXXXXXXXXXXXXXXXXXXXXXXXXXXXXXXXXXXXXXXXXXXXXXXXXXXXXXXXXXXXXXXXXXXXXXXXXXXXXXXXXXXXXXXXXXXXXXXXXXXXXXXXXXXXXXXXXXXXXXXXXXXXXXXXXXXXXXXXXXXXXXXXXXXXXXXXXXXXXXXXXXXXXXXXXXXXXXXXXXXXXXXXXXXXXXXXXXXXXXXXXXXXXXXXXXXXXXXXXXXXXXXXXXXXXXXXXXXXXXXXXXXXXXXXXX,0,0,0
42,0,0,0,0,0,0,0,0,0,0,XXXXXXXXXXXXXXXXXXXXXXXXXXXXXXXXXXXXXXXXXXXXXXXXXXXXXXXXXXXXXXXXXXXXXXXXXXXXXXXXXXXXXXXXXXXXXXXXXXXXXXXXXXXXXXXXXXXXXXXXXXXXXXXXXXXXXXXXXXXXXXXXXXXXXXXXXXXXXXXXXXXXXXXXXXXXXXXXXXXXXXXXXXXXXXXXXXXXXXXXXXXXXXXXXXXXXXXXXXXXXXXXXXXXXXXXXXXXXXXXXXXXXXXXXXXXXXXXXXXX,0,0,0
63,0,0,0,0,0,0,0,0,0,0,XXXXXXXXXXXXXXXXXXXXXXXXXXXXXXXXXXXXXXXXXXXXXXXXXXXXXXXXXXXXXXXXXXXXXXXXXXXXXXXXXXXXXXXXXXXXXXXXXXXXXXXXXXXXXXXXXXXXXXXXXXXXXXXXXXXXXXXXXXXXXXXXXXXXXXXXXXXXXXXXXXXXXXXXXXXXXXXXXXXXXXXXXXXXXXXXXXXXXXXXXXXXXXXXXXXXXXXXXXXXXXXXXXXXXXXXXXXXXXXXXXXXXXXXXXXXXXXXXXXX,0,0,0
84,0,0,0,0,0,0,0,0,0,0,XXXXXXXXXXXXXXXXXXXXXXXXXXXXXXXXXXXXXXXXXXXXXXXXXXXXXXXXXXXXXXXXXXXXXXXXXXXXXXXXXXXXXXXXXXXXXXXXXXXXXXXXXXXXXXXXXXXXXXXXXXXXXXXXXXXXXXXXXXXXXXXXXXXXXXXXXXXXXXXXXXXXXXXXXXXXXXXXXXXXXXXXXXXXXXXXXXXXXXXXXXXXXXXXXXXXXXXXXXXXXXXXXXXXXXXXXXXXXXXXXXXXXXXXXXXXXXXXXXXX,0,0,0

105,0,0,0,0,300,0,0,300,0,300,XXXXXXXXXXXXXXXXXXXXXXXXXXXXXXXXXXXXXXXXXXXXXXXXXXXXXXXXXXXXXXXXXXXXXXXXXXXXXXXXXXXXXXXXXXXXXXXXXXXXXXXXXXXXXXXXXXXXXXXXXXXXXXXXXXXXXXXXXXXXXXXXXXXXXXXXXXXXXXXXXXXXXXXXXXXXXXXXXXXXXXXXXXXXXXXXXXXXXXXXXXXXXXXXXXXXXXXXXXXXXXXXXXXXXXXXXXXXXXXXXXXXXXXXXXXXXXXXXXXX,0,0,0
126,0,0,0,0,300,0,0,300,0,300,XXXXXXXXXXXXXXXXXXXXXXXXXXXXXXXXXXXXXXXXXXXXXXXXXXXXXXXXXXXXXXXXXXXXXXXXXXXXXXXXXXXXXXXXXXXXXXXXXXXXXXXXXXXXXXXXXXXXXXXXXXXXXXXXXXXXXXXXXXXXXXXXXXXXXXXXXXXXXXXXXXXXXXXXXXXXXXXXXXXXXXXXXXXXXXXXXXXXXXXXXXXXXXXXXXXXXXXXXXXXXXXXXXXXXXXXXXXXXXXXXXXXXXXXXXXXXXXXXXXX,0,0,0
147,0,0,0,0,300,0,0,300,0,300,XXXXXXXXXXXXXXXXXXXXXXXXXXXXXXXXXXXXXXXXXXXXXXXXXXXXXXXXXXXXXXXXXXXXXXXXXXXXXXXXXXXXXXXXXXXXXXXXXXXXXXXXXXXXXXXXXXXXXXXXXXXXXXXXXXXXXXXXXXXXXXXXXXXXXXXXXXXXXXXXXXXXXXXXXXXXXXXXXXXXXXXXXXXXXXXXXXXXXXXXXXXXXXXXXXXXXXXXXXXXXXXXXXXXXXXXXXXXXXXXXXXXXXXXXXXXXXXXXXXX,0,0,0
168,0,0,0,0,300,0,0,300,0,300,XXXXXXXXXXXXXXXXXXXXXXXXXXXXXXXXXXXXXXXXXXXXXXXXXXXXXXXXXXXXXXXXXXXXXXXXXXXXXXXXXXXXXXXXXXXXXXXXXXXXXXXXXXXXXXXXXXXXXXXXXXXXXXXXXXXXXXXXXXXXXXXXXXXXXXXXXXXXXXXXXXXXXXXXXXXXXXXXXXXXXXXXXXXXXXXXXXXXXXXXXXXXXXXXXXXXXXXXXXXXXXXXXXXXXXXXXXXXXXXXXXXXXXXXXXXXXXXXXXXX,0,0,0
189,0,0,0,0,300,0,0,300,0,300,XXXXXXXXXXXXXXXXXXXXXXXXXXXXXXXXXXXXXXXXXXXXXXXXXXXXXXXXXXXXXXXXXXXXXXXXXXXXXXXXXXXXXXXXXXXXXXXXXXXXXXXXXXXXXXXXXXXXXXXXXXXXXXXXXXXXXXXXXXXXXXXXXXXXXXXXXXXXXXXXXXXXXXXXXXXXXXXXXXXXXXXXXXXXXXXXXXXXXXXXXXXXXXXXXXXXXXXXXXXXXXXXXXXXXXXXXXXXXXXXXXXXXXXXXXXXXXXXXXXX,0,0,0

210,0,0,0,0,300,0,0,300,0,300,XXXXXXXXXXXXXXXXXXXXXXXXXXXXXXXXXXXXXXXXXXXXXXXXXXXXXXXXXXXXXXXXXXXXXXXXXXXXXXXXXXXXXXXXXXXXXXXXXXXXXXXXXXXXXXXXXXXXXXXXXXXXXXXXXXXXXXXXXXXXXXXXXXXXXXXXXXXXXXXXXXXXXXXXXXXXXXXXXXXXXXXXXXXXXXXXXXXXXXXXXXXXXXXXXXXXXXXXXXXXXXXXXXXXXXXXXXXXXXXXXXXXXXXXXXXXXXXXXXXX,0,0,0
231,0,0,0,0,300,0,0,300,0,300,XXXXXXXXXXXXXXXXXXXXXXXXXXXXXXXXXXXXXXXXXXXXXXXXXXXXXXXXXXXXXXXXXXXXXXXXXXXXXXXXXXXXXXXXXXXXXXXXXXXXXXXXXXXXXXXXXXXXXXXXXXXXXXXXXXXXXXXXXXXXXXXXXXXXXXXXXXXXXXXXXXXXXXXXXXXXXXXXXXXXXXXXXXXXXXXXXXXXXXXXXXXXXXXXXXXXXXXXXXXXXXXXXXXXXXXXXXXXXXXXXXXXXXXXXXXXXXXXXXXX,0,0,0
252,0,0,0,0,300,0,0,300,0,300,XXXXXXXXXXXXXXXXXXXXXXXXXXXXXXXXXXXXXXXXXXXXXXXXXXXXXXXXXXXXXXXXXXXXXXXXXXXXXXXXXXXXXXXXXXXXXXXXXXXXXXXXXXXXXXXXXXXXXXXXXXXXXXXXXXXXXXXXXXXXXXXXXXXXXXXXXXXXXXXXXXXXXXXXXXXXXXXXXXXXXXXXXXXXXXXXXXXXXXXXXXXXXXXXXXXXXXXXXXXXXXXXXXXXXXXXXXXXXXXXXXXXXXXXXXXXXXXXXXXX,0,0,0
273,0,0,0,0,300,0,0,300,0,300,XXXXXXXXXXXXXXXXXXXXXXXXXXXXXXXXXXXXXXXXXXXXXXXXXXXXXXXXXXXXXXXXXXXXXXXXXXXXXXXXXXXXXXXXXXXXXXXXXXXXXXXXXXXXXXXXXXXXXXXXXXXXXXXXXXXXXXXXXXXXXXXXXXXXXXXXXXXXXXXXXXXXXXXXXXXXXXXXXXXXXXXXXXXXXXXXXXXXXXXXXXXXXXXXXXXXXXXXXXXXXXXXXXXXXXXXXXXXXXXXXXXXXXXXXXXXXXXXXXXX,0,0,0
294,0,0,0,0,300,0,0,300,0,300,XXXXXXXXXXXXXXXXXXXXXXXXXXXXXXXXXXXXXXXXXXXXXXXXXXXXXXXXXXXXXXXXXXXXXXXXXXXXXXXXXXXXXXXXXXXXXXXXXXXXXXXXXXXXXXXXXXXXXXXXXXXXXXXXXXXXXXXXXXXXXXXXXXXXXXXXXXXXXXXXXXXXXXXXXXXXXXXXXXXXXXXXXXXXXXXXXXXXXXXXXXXXXXXXXXXXXXXXXXXXXXXXXXXXXXXXXXXXXXXXXXXXXXXXXXXXXXXXXXXX,0,0,0

315,0,0,0,6,294,0,0,294,10,284,XXXXXXXXXXXXXXXXXXXXXXXXXXXXXXXXXXXXXXXXXXXXXXXXXXXXXXXXXXXXXXXXXXXXXXXXXXXXXXXXXXXXXXXXXXXXXXXXXXXXXXXXXXXXXXXXXXXXXXXXXXXXXXXXXXXXXXXXXXXXXXXXXXXXXXXXXXXXXXXXXXXXXXXXXXXXXXXXXXXXXXXXXXXXXXXXXXXXXXXXXXXXXXXXXXXXXXXXXXXXXXXXXXXXXXXXXXXXXXXXXXXXXXXXXXXXXXXXXXXX,0,0,0
336,0,0,0,22,278,0,0,278,11,267,XXXXXXXXXXXXXXXXXXXXXXXXXXXXXXXXXXXXXXXXXXXXXXXXXXXXXXXXXXXXXXXXXXXXXXXXXXXXXXXXXXXXXXXXXXXXXXXXXXXXXXXXXXXXXXXXXXXXXXXXXXXXXXXXXXXXXXXXXXXXXXXXXXXXXXXXXXXXXXXXXXXXXXXXXXXXXXXXXXXXXXXXXXXXXXXXXXXXXXXXXXXXXXXXXXXXXXXXXXXXXXXXXXXXXXXXXXXXXXXXXXXXXXXXXXXXXXXXXXXX,0,0,0
357,2,2,0,36,262,0,0,262,14,248,XXXXXXXXXXXXXXXXXXXXXXXXXXXXXXXXXXXXXXXXXXXXXXXXXXXXXXXXXXXXXXXXXXXXXXXXXXXXXXXXXXXXXXXXXXXXXXXXXXXXXXXXXXXXXXXXXXXXXXXXGXXXXXXXXXXXXXXXXXXXXXXXXXXXXXXXXXXXXXXXGXXXXXXXXXXXXXXXXXXXXXXXXXXXXXXXXXXXXXXXXXXXXXXXXXXXXXXXXXXXXXXXXXXXXXXXXXXXXXXXXXXXXXXXXXXXXXXXXXXX,0,0,0
378,3,3,0,54,243,0,0,243,21,222,XXXXXXXXXXXXXXXXXXXXXXXXXXXXXXXXXXXXXXXXXXXXXXXXXXXXXXXXXXXXXXXXXXXXXXXXXXXXXXXXXXXXXXXXXXXXXXXXXXXXXXXXXXXXXXXXXXXXXXXXGXXXXXXXXXXXXXXXXXXXXXXXXXXXXXXXXXXXXXXXGXXXXXXXXXXXXXXXXXXXXXXXXXXXXXXXXXXXXXXXXXXXXXXXXXXXXXXXXXXXXXXXXXXXXXXXXXXXXXXXGXXXXXXXXXXXXXXXXXXX,0,0,0
399,5,5,0,71,224,0,0,224,23,201,GXXXXXXXXXXXXXXXXXXXXXXXXXXXXXXXXXXXXXXXXXXXXXXXXXXXXXXXXXXXXXXXXXXXXXXXXXXXXXXXXXXXXXXXXXXXXXXXXXXXXXXXXXXXXXXXXXXXXXXXGXXXXXXXXXXXXXXXXXXXXXXXXXXXXXXXXXXXXXXXGXXXXXXXXXXXXXXXXXXXXXXXXXXXXXXXXXXXXXXXXXXXXXXXXXXXXXXXXXXXGXXXXXXXXXXXXXXXXXXXGXXXXXXXXXXXXXXXXXXX,0,0,0

420,5,5,0,87,208,0,0,208,18,190,GXXXXXXXXXXXXXXXXXXXXXXXXXXXXXXXXXXXXXXXXXXXXXXXXXXXXXXXXXXXXXXXXXXXXXXXXXXXXXXXXXXXXXXXXXXXXXXXXXXXXXXXXXXXXXXXXXXXXXXXGXXXXXXXXXXXXXXXXXXXXXXXXXXXXXXXXXXXXXXXGXXXXXXXXXXXXXXXXXXXXXXXXXXXXXXXXXXXXXXXXXXXXXXXXXXXXXXXXXXXGXXXXXXXXXXXXXXXXXXXGXXXXXXXXXXXXXXXXXXX,0,0,0
441,5,5,0,101,194,0,0,194,26,168,GXXXXXXXXXXXXXXXXXXXXXXXXXXXXXXXXXXXXXXXXXXXXXXXXXXXXXXXXXXXXXXXXXXXXXXXXXXXXXXXXXXXXXXXXXXXXXXXXXXXXXXXXXXXXXXXXXXXXXXXGXXXXXXXXXXXXXXXXXXXXXXXXXXXXXXXXXXXXXXXGXXXXXXXXXXXXXXXXXXXXXXXXXXXXXXXXXXXXXXXXXXXXXXXXXXXXXXXXXXXGXXXXXXXXXXXXXXXXXXXGXXXXXXXXXXXXXXXXXXX,0,0,0
462,6,6,0,126,168,0,0,168,27,141,GXXXXXXXXXXXXXXXXXXXXXXXXXXXXXXXXXXXXXXXXXXXXXXXXXXXXXXXXXXXXXXXXXXXXXXXXXXXXXXXXXXXXXXXXXXXXXXXXXXXGXXXXXXXXXXXXXXXXXXXGXXXXXXXXXXXXXXXXXXXXXXXXXXXXXXXXXXXXXXXGXXXXXXXXXXXXXXXXXXXXXXXXXXXXXXXXXXXXXXXXXXXXXXXXXXXXXXXXXXXGXXXXXXXXXXXXXXXXXXXGXXXXXXXXXXXXXXXXXXX,0,0,0
483,7,7,0,145,148,0,0,148,37,111,GXXXXXXXXXXXXXXXXXXXXXXXXXXXXXXXXXXXXXXXGXXXXXXXXXXXXXXXXXXXXXXXXXXXXXXXXXXXXXXXXXXXXXXXXXXXXXXXXXXXGXXXXXXXXXXXXXXXXXXXGXXXXXXXXXXXXXXXXXXXXXXXXXXXXXXXXXXXXXXXGXXXXXXXXXXXXXXXXXXXXXXXXXXXXXXXXXXXXXXXXXXXXXXXXXXXXXXXXXXXGXXXXXXXXXXXXXXXXXXXGXXXXXXXXXXXXXXXXXXX,0,0,0
504,9,9,0,163,128,0,0,128,38,90,GXXXXXXXXXXXXXXXXXXXXXXXXXXXXXXXXXXXXXXXGXXXXXXXXXXXXXXXXXXXGXXXXXXXXXXXXXXXXXXXXXXXXXXXXXXXXXXXXXXXGXXXXXXXXXXXXXXXXXXXGXXXXXXXXXXXXXXXXXXXXXXXXXXXXXXXXXXXXXXXGXXXXXXXXXXXXXXXXXXXXXXXXXXXXXXXXXXXXXXXGXXXXXXXXXXXXXXXXXXXGXXXXXXXXXXXXXXXXXXXGXXXXXXXXXXXXXXXXXXX,0,0,0

525,9,9,0,176,115,0,0,115,44,71,GXXXXXXXXXXXXXXXXXXXXXXXXXXXXXXXXXXXXXXXGXXXXXXXXXXXXXXXXXXXGXXXXXXXXXXXXXXXXXXXXXXXXXXXXXXXXXXXXXXXGXXXXXXXXXXXXXXXXXXXGXXXXXXXXXXXXXXXXXXXXXXXXXXXXXXXXXXXXXXXGXXXXXXXXXXXXXXXXXXXXXXXXXXXXXXXXXXXXXXXGXXXXXXXXXXXXXXXXXXXGXXXXXXXXXXXXXXXXXXXGXXXXXXXXXXXXXXXXXXX,0,0,0
546,9,8,1,194,97,0,0,97,45,52,GXXXXXXXXXXXXXXXXXXXXXXXXXXXXXXXXXXXXXXXGXXXXXXXXXXXXXXXXXXXGXXXXXXXXXXXXXXXXXXXXXXXXXXXXXXXXXXXXXXXGXXXXXXXXXXXXXXXXXXXGXXXXXXXXXXXXXXXXXXXXXXXXXXXXXXXXXXXXXXXGXXXXXXXXXXXXXXXXXXXXXXXXXXXXXXXXXXXXXXXGXXXXXXXXXXXXXXXXXXXGXXXXXXXXXXXXXXXXXXXGXXXXXXXXXXXXXXXXXXX,0,0,0
567,12,11,1,202,86,0,0,86,46,40,GXXXXXXXXXXXXXXXXXXXGXXXXXXXXXXXXXXXXXXXGXXXXXXXXXXXXXXXXXXXGXXXXXXXXXXXXXXXXXXXGXXXXXXXXXXXXXXXXXXXGXXXXXXXXXXXXXXXXXXXGXXXXXXXXXXXXXXXXXXXGXXXXXXXXXXXXXXXXXXXGXXXXXXXXXXXXXXXXXXXXXXXXXXXXXXXXXXXXXXXGXXXXXXXXXXXXXXXXXXXGXXXXXXXXXXXXXXXXXXXGXXXXXXXXXXXXXXXXXXX,0,0,0
588,12,10,2,208,80,0,0,80,55,25,GXXXXXXXXXXXXXXXXXXXGXXXXXXXXXXXXXXXXXXXGXXXXXXXXXXXXXXXXXXXGXXXXXXXXXXXXXXXXXXXGXXXXXXXXXXXXXXXXXXXGXXXXXXXXXXXXXXXXXXXGXXXXXXXXXXXXXXXXXXXGXXXXXXXXXXXXXXXXXXXGXXXXXXXXXXXXXXXXXXXXXXXXXXXXXXXXXXXXXXXGXXXXXXXXXXXXXXXXXXXGXXXXXXXXXXXXXXXXXXXGXXXXXXXXXXXXXXXXXXX,0,0,0
609,13,11,2,214,73,0,0,73,60,13,GXXXXXXXXXXXXXXXXXXXGXXXXXXXXXXXXXXXXXXXGAXXXXXXXXXXXXXXXXXXGXXXXXXXXXXXXXXXXXXXGXXXXXXXXXXXXXXXXXXXGXXXXXXXXXXXXXXXXXXXGXXXXXXXXXXXXXXXXXXXGXXXXXXXXXXXXXXXXXXXGXXXXXXXXXXXXXXXXXXXXXXXXXXXXXXXXXXXXXXXGXXXXXXXXXXXXXXXXXXXGXXXXXXXXXXXXXXXXXXXGXXXXXXXXXXXXXXXXXXX,0,0,0

630,14,11,3,221,65,0,0,65,49,16,GXXXXXXXXXXXXXXXXXXXGXXXXXXXXXXXXXXXXXXXGAXXXXXXXXXXXXXXXXXXGXXXXXXXXXXXXXXXXXXXGXXXXXXXXXXXXXXXXXXXGXXXXXXXXXXXXXXXXXXXGXXXXXXXXXXXXXXXXXXXGXXXXXXXXXXXXXXXXXXXGXXXXXXXXXXXXXXXXXXXXXXXXXXXXXXXXXXXXXXXGXXXXXXXXXXXXXXXXXXXGAXXXXXXXXXXXXXXXXXXGXXXXXXXXXXXXXXXXXXX,0,0,0
651,14,10,4,221,65,0,0,65,43,22,GXXXXXXXXXXXXXXXXXXXGXXXXXXXXXXXXXXXXXXXGAXXXXXXXXXXXXXXXXXXGXXXXXXXXXXXXXXXXXXXGXXXXXXXXXXXXXXXXXXXGXXXXXXXXXXXXXXXXXXXGXXXXXXXXXXXXXXXXXXXGXXXXXXXXXXXXXXXXXXXGXXXXXXXXXXXXXXXXXXXXXXXXXXXXXXXXXXXXXXXGXXXXXXXXXXXXXXXXXXXGAXXXXXXXXXXXXXXXXXXGXXXXXXXXXXXXXXXXXXX,0,0,0
672,15,10,5,219,66,0,0,65,36,29,GXXXXXXXXXXXXXXXXXXXGXXXXXXXXXXXXXXXXXXXGAXXXXXXXXXXXXXXXXXXGXXXXXXXXXXXXXXXXXXXGXXXXXXXXXXXXXXXXXXXGXXXXXXXXXXXXXXXXXXXGAXXXXXXXXXXXXXXXXXXGXXXXXXXXXXXXXXXXXXXGXXXXXXXXXXXXXXXXXXXXXXXXXXXXXXXXXXXXXXXGXXXXXXXXXXXXXXXXXXXGAXXXXXXXXXXXXXXXXXXGXXXXXXXXXXXXXXXXXXX,0,0,0
693,17,10,7,214,69,0,0,69,28,41,GXXXXXXXXXXXXXXXXXXXGAXXXXXXXXXXXXXXXXXXGAXXXXXXXXXXXXXXXXXXGXXXXXXXXXXXXXXXXXXXGXXXXXXXXXXXXXXXXXXXGXXXXXXXXXXXXXXXXXXXGAXXXXXXXXXXXXXXXXXXGXXXXXXXXXXXXXXXXXXXGXXXXXXXXXXXXXXXXXXXGXXXXXXXXXXXXXXXXXXXGXXXXXXXXXXXXXXXXXXXGAXXXXXXXXXXXXXXXXXXGXXXXXXXXXXXXXXXXXXX,0,0,0
714,17,9,8,201,82,0,0,80,25,55,GXXXXXXXXXXXXXXXXXXXGAXXXXXXXXXXXXXXXXXXGAXXXXXXXXXXXXXXXXXXGXXXXXXXXXXXXXXXXXXXGXXXXXXXXXXXXXXXXXXXGXXXXXXXXXXXXXXXXXXXGAXXXXXXXXXXXXXXXXXXGXXXXXXXXXXXXXXXXXXXGXXXXXXXXXXXXXXXXXXXGXXXXXXXXXXXXXXXXXXXGXXXXXXXXXXXXXXXXXXXGAXXXXXXXXXXXXXXXXXXGXXXXXXXXXXXXXXXXXXX,0,0,0

735,17,9,8,193,90,0,0,90,24,66,GXXXXXXXXXXXXXXXXXXXGAXXXXXXXXXXXXXXXXXXGAXXXXXXXXXXXXXXXXXXGXXXXXXXXXXXXXXXXXXXGXXXXXXXXXXXXXXXXXXXGXXXXXXXXXXXXXXXXXXXGAXXXXXXXXXXXXXXXXXXGXXXXXXXXXXXXXXXXXXXGXXXXXXXXXXXXXXXXXXXGXXXXXXXXXXXXXXXXXXXGXXXXXXXXXXXXXXXXXXXGAXXXXXXXXXXXXXXXXXXGXXXXXXXXXXXXXXXXXXX,0,0,0
756,18,10,8,180,102,0,0,101,22,79,GXXXXXXXXXXXXXXXXXXXGAXXXXXXXXXXXXXXXXXXGAAXXXXXXXXXXXXXXXXXGXXXXXXXXXXXXXXXXXXXGXXXXXXXXXXXXXXXXXXXGXXXXXXXXXXXXXXXXXXXGAXXXXXXXXXXXXXXXXXXGXXXXXXXXXXXXXXXXXXXGXXXXXXXXXXXXXXXXXXXGXXXXXXXXXXXXXXXXXXXGXXXXXXXXXXXXXXXXXXXGAXXXXXXXXXXXXXXXXXXGXXXXXXXXXXXXXXXXXXX,0,0,0
777,18,9,9,166,116,0,0,115,22,93,GXXXXXXXXXXXXXXXXXXXGAXXXXXXXXXXXXXXXXXXGAAXXXXXXXXXXXXXXXXXGXXXXXXXXXXXXXXXXXXXGXXXXXXXXXXXXXXXXXXXGXXXXXXXXXXXXXXXXXXXGAXXXXXXXXXXXXXXXXXXGXXXXXXXXXXXXXXXXXXXGXXXXXXXXXXXXXXXXXXXGXXXXXXXXXXXXXXXXXXXGXXXXXXXXXXXXXXXXXXXGAXXXXXXXXXXXXXXXXXXGXXXXXXXXXXXXXXXXXXX,0,0,0
798,18,7,11,152,130,0,0,130,19,111,GXXXXXXXXXXXXXXXXXXXGAXXXXXXXXXXXXXXXXXXGAAXXXXXXXXXXXXXXXXXGXXXXXXXXXXXXXXXXXXXGXXXXXXXXXXXXXXXXXXXGXXXXXXXXXXXXXXXXXXXGAXXXXXXXXXXXXXXXXXXGXXXXXXXXXXXXXXXXXXXGXXXXXXXXXXXXXXXXXXXGXXXXXXXXXXXXXXXXXXXGXXXXXXXXXXXXXXXXXXXGAXXXXXXXXXXXXXXXXXXGXXXXXXXXXXXXXXXXXXX,0,0,0
819,19,7,12,142,139,0,0,139,18,121,GXXXXXXXXXXXXXXXXXXXGAXXXXXXXXXXXXXXXXXXGAAXXXXXXXXXXXXXXXXXGXXXXXXXXXXXXXXXXXXXGXXXXXXXXXXXXXXXXXXXGXXXXXXXXXXXXXXXXXXXGAXXXXXXXXXXXXXXXXXXGXXXXXXXXXXXXXXXXXXXGXXXXXXXXXXXXXXXXXXXGXXXXXXXXXXXXXXXXXXXGXXXXXXXXXXXXXXXXXXXGAXXXXXXXXXXXXXXXXXXGAXXXXXXXXXXXXXXXXXX,0,0,0

840,19,5,14,130,151,0,0,150,18,132,GXXXXXXXXXXXXXXXXXXXGAXXXXXXXXXXXXXXXXXXGAOXXXXXXXXXXXXXXXXXGXXXXXXXXXXXXXXXXXXXGXXXXXXXXXXXXXXXXXXXGXXXXXXXXXXXXXXXXXXXGAXXXXXXXXXXXXXXXXXXGXXXXXXXXXXXXXXXXXXXGXXXXXXXXXXXXXXXXXXXGXXXXXXXXXXXXXXXXXXXGXXXXXXXXXXXXXXXXXXXGAXXXXXXXXXXXXXXXXXXGAXXXXXXXXXXXXXXXXXX,0,0,0
861,19,4,15,113,168,0,0,166,18,148,GXXXXXXXXXXXXXXXXXXXGAXXXXXXXXXXXXXXXXXXGAOXXXXXXXXXXXXXXXXXGXXXXXXXXXXXXXXXXXXXGXXXXXXXXXXXXXXXXXXXGXXXXXXXXXXXXXXXXXXXGAXXXXXXXXXXXXXXXXXXGXXXXXXXXXXXXXXXXXXXGXXXXXXXXXXXXXXXXXXXGXXXXXXXXXXXXXXXXXXXGXXXXXXXXXXXXXXXXXXXGOXXXXXXXXXXXXXXXXXXGAXXXXXXXXXXXXXXXXXX,0,0,0
882,19,2,17,98,183,0,0,182,18,164,GXXXXXXXXXXXXXXXXXXXGAXXXXXXXXXXXXXXXXXXGOOXXXXXXXXXXXXXXXXXGXXXXXXXXXXXXXXXXXXXGXXXXXXXXXXXXXXXXXXXGXXXXXXXXXXXXXXXXXXXGOXXXXXXXXXXXXXXXXXXGXXXXXXXXXXXXXXXXXXXGXXXXXXXXXXXXXXXXXXXGXXXXXXXXXXXXXXXXXXXGXXXXXXXXXXXXXXXXXXXGOXXXXXXXXXXXXXXXXXXGAXXXXXXXXXXXXXXXXXX,0,0,0
903,19,2,17,87,194,0,0,194,20,174,GXXXXXXXXXXXXXXXXXXXGAXXXXXXXXXXXXXXXXXXGOOXXXXXXXXXXXXXXXXXGXXXXXXXXXXXXXXXXXXXGXXXXXXXXXXXXXXXXXXXGXXXXXXXXXXXXXXXXXXXGOXXXXXXXXXXXXXXXXXXGXXXXXXXXXXXXXXXXXXXGXXXXXXXXXXXXXXXXXXXGXXXXXXXXXXXXXXXXXXXGXXXXXXXXXXXXXXXXXXXGOXXXXXXXXXXXXXXXXXXGAXXXXXXXXXXXXXXXXXX,0,0,0
924,19,1,18,72,209,0,0,206,20,186,GXXXXXXXXXXXXXXXXXXXGOXXXXXXXXXXXXXXXXXXGOOXXXXXXXXXXXXXXXXXGXXXXXXXXXXXXXXXXXXXGXXXXXXXXXXXXXXXXXXXGXXXXXXXXXXXXXXXXXXXGOXXXXXXXXXXXXXXXXXXGXXXXXXXXXXXXXXXXXXXGXXXXXXXXXXXXXXXXXXXGXXXXXXXXXXXXXXXXXXXGXXXXXXXXXXXXXXXXXXXGOXXXXXXXXXXXXXXXXXXGAXXXXXXXXXXXXXXXXXX,0,0,0

945,19,1,18,66,215,0,0,214,22,192,GXXXXXXXXXXXXXXXXXXXGOXXXXXXXXXXXXXXXXXXGOOXXXXXXXXXXXXXXXXXGXXXXXXXXXXXXXXXXXXXGXXXXXXXXXXXXXXXXXXXGXXXXXXXXXXXXXXXXXXXGOXXXXXXXXXXXXXXXXXXGXXXXXXXXXXXXXXXXXXXGXXXXXXXXXXXXXXXXXXXGXXXXXXXXXXXXXXXXXXXGXXXXXXXXXXXXXXXXXXXGOXXXXXXXXXXXXXXXXXXGAXXXXXXXXXXXXXXXXXX,0,0,0
966,19,1,18,65,216,0,0,216,26,190,GXXXXXXXXXXXXXXXXXXXGOXXXXXXXXXXXXXXXXXXGOOXXXXXXXXXXXXXXXXXGXXXXXXXXXXXXXXXXXXXGXXXXXXXXXXXXXXXXXXXGXXXXXXXXXXXXXXXXXXXGOXXXXXXXXXXXXXXXXXXGXXXXXXXXXXXXXXXXXXXGXXXXXXXXXXXXXXXXXXXGXXXXXXXXXXXXXXXXXXXGXXXXXXXXXXXXXXXXXXXGOXXXXXXXXXXXXXXXXXXGAXXXXXXXXXXXXXXXXXX,0,0,0
987,19,1,18,65,216,0,0,216,21,195,GXXXXXXXXXXXXXXXXXXXGOXXXXXXXXXXXXXXXXXXGOOXXXXXXXXXXXXXXXXXGXXXXXXXXXXXXXXXXXXXGXXXXXXXXXXXXXXXXXXXGXXXXXXXXXXXXXXXXXXXGOXXXXXXXXXXXXXXXXXXGXXXXXXXXXXXXXXXXXXXGXXXXXXXXXXXXXXXXXXXGXXXXXXXXXXXXXXXXXXXGXXXXXXXXXXXXXXXXXXXGOXXXXXXXXXXXXXXXXXXGAXXXXXXXXXXXXXXXXXX,0,0,0
1008,19,1,18,62,219,0,0,218,26,192,GXXXXXXXXXXXXXXXXXXXGOXXXXXXXXXXXXXXXXXXGOOXXXXXXXXXXXXXXXXXGXXXXXXXXXXXXXXXXXXXGXXXXXXXXXXXXXXXXXXXGXXXXXXXXXXXXXXXXXXXGOXXXXXXXXXXXXXXXXXXGXXXXXXXXXXXXXXXXXXXGXXXXXXXXXXXXXXXXXXXGXXXXXXXXXXXXXXXXXXXGXXXXXXXXXXXXXXXXXXXGOXXXXXXXXXXXXXXXXXXGAXXXXXXXXXXXXXXXXXX,0,0,0
1029,19,1,18,58,223,0,0,223,26,197,GXXXXXXXXXXXXXXXXXXXGOXXXXXXXXXXXXXXXXXXGOOXXXXXXXXXXXXXXXXXGXXXXXXXXXXXXXXXXXXXGXXXXXXXXXXXXXXXXXXXGXXXXXXXXXXXXXXXXXXXGOXXXXXXXXXXXXXXXXXXGXXXXXXXXXXXXXXXXXXXGXXXXXXXXXXXXXXXXXXXGXXXXXXXXXXXXXXXXXXXGXXXXXXXXXXXXXXXXXXXGOXXXXXXXXXXXXXXXXXXGAXXXXXXXXXXXXXXXXXX,0,0,0

1050,19,0,19,59,222,0,0,221,30,191,GXXXXXXXXXXXXXXXXXXXGOXXXXXXXXXXXXXXXXXXGOOXXXXXXXXXXXXXXXXXGXXXXXXXXXXXXXXXXXXXGXXXXXXXXXXXXXXXXXXXGXXXXXXXXXXXXXXXXXXXGOXXXXXXXXXXXXXXXXXXGXXXXXXXXXXXXXXXXXXXGXXXXXXXXXXXXXXXXXXXGXXXXXXXXXXXXXXXXXXXGXXXXXXXXXXXXXXXXXXXGOXXXXXXXXXXXXXXXXXXGOXXXXXXXXXXXXXXXXXX,0,0,0
1071,19,0,19,66,215,0,0,215,27,188,GXXXXXXXXXXXXXXXXXXXGOXXXXXXXXXXXXXXXXXXGOOXXXXXXXXXXXXXXXXXGXXXXXXXXXXXXXXXXXXXGXXXXXXXXXXXXXXXXXXXGXXXXXXXXXXXXXXXXXXXGOXXXXXXXXXXXXXXXXXXGXXXXXXXXXXXXXXXXXXXGXXXXXXXXXXXXXXXXXXXGXXXXXXXXXXXXXXXXXXXGXXXXXXXXXXXXXXXXXXXGOXXXXXXXXXXXXXXXXXXGOXXXXXXXXXXXXXXXXXX,0,0,0
1092,19,0,19,63,218,0,0,218,22,196,GXXXXXXXXXXXXXXXXXXXGOXXXXXXXXXXXXXXXXXXGOOXXXXXXXXXXXXXXXXXGXXXXXXXXXXXXXXXXXXXGXXXXXXXXXXXXXXXXXXXGXXXXXXXXXXXXXXXXXXXGOXXXXXXXXXXXXXXXXXXGXXXXXXXXXXXXXXXXXXXGXXXXXXXXXXXXXXXXXXXGXXXXXXXXXXXXXXXXXXXGXXXXXXXXXXXXXXXXXXXGOXXXXXXXXXXXXXXXXXXGOXXXXXXXXXXXXXXXXXX,0,0,0
1113,19,0,19,66,215,0,0,215,30,185,GXXXXXXXXXXXXXXXXXXXGOXXXXXXXXXXXXXXXXXXGOOXXXXXXXXXXXXXXXXXGXXXXXXXXXXXXXXXXXXXGXXXXXXXXXXXXXXXXXXXGXXXXXXXXXXXXXXXXXXXGOXXXXXXXXXXXXXXXXXXGXXXXXXXXXXXXXXXXXXXGXXXXXXXXXXXXXXXXXXXGXXXXXXXXXXXXXXXXXXXGXXXXXXXXXXXXXXXXXXXGOXXXXXXXXXXXXXXXXXXGOXXXXXXXXXXXXXXXXXX,0,0,0
1134,19,0,19,72,209,0,0,208,30,178,GXXXXXXXXXXXXXXXXXXXGOXXXXXXXXXXXXXXXXXXGOOXXXXXXXXXXXXXXXXXGXXXXXXXXXXXXXXXXXXXGXXXXXXXXXXXXXXXXXXXGXXXXXXXXXXXXXXXXXXXGOXXXXXXXXXXXXXXXXXXGXXXXXXXXXXXXXXXXXXXGXXXXXXXXXXXXXXXXXXXGXXXXXXXXXXXXXXXXXXXGXXXXXXXXXXXXXXXXXXXGOXXXXXXXXXXXXXXXXXXGOXXXXXXXXXXXXXXXXXX,0,0,0

1155,19,0,19,81,200,0,0,200,28,172,GXXXXXXXXXXXXXXXXXXXGOXXXXXXXXXXXXXXXXXXGOOXXXXXXXXXXXXXXXXXGXXXXXXXXXXXXXXXXXXXGXXXXXXXXXXXXXXXXXXXGXXXXXXXXXXXXXXXXXXXGOXXXXXXXXXXXXXXXXXXGXXXXXXXXXXXXXXXXXXXGXXXXXXXXXXXXXXXXXXXGXXXXXXXXXXXXXXXXXXXGXXXXXXXXXXXXXXXXXXXGOXXXXXXXXXXXXXXXXXXGOXXXXXXXXXXXXXXXXXX,0,0,0
1176,19,0,19,82,199,0,0,199,33,166,GXXXXXXXXXXXXXXXXXXXGOXXXXXXXXXXXXXXXXXXGOOXXXXXXXXXXXXXXXXXGXXXXXXXXXXXXXXXXXXXGXXXXXXXXXXXXXXXXXXXGXXXXXXXXXXXXXXXXXXXGOXXXXXXXXXXXXXXXXXXGXXXXXXXXXXXXXXXXXXXGXXXXXXXXXXXXXXXXXXXGXXXXXXXXXXXXXXXXXXXGXXXXXXXXXXXXXXXXXXXGOXXXXXXXXXXXXXXXXXXGOXXXXXXXXXXXXXXXXXX,0,0,0
1197,19,0,19,90,191,0,0,192,34,158,GXXXXXXXXXXXXXXXXXXXGOXXXXXXXXXXXXXXXXXXGOOXXXXXXXXXXXXXXXXXGXXXXXXXXXXXXXXXXXXXGXXXXXXXXXXXXXXXXXXXGXXXXXXXXXXXXXXXXXXXGOXXXXXXXXXXXXXXXXXXGXXXXXXXXXXXXXXXXXXXGXXXXXXXXXXXXXXXXXXXGXXXXXXXXXXXXXXXXXXXGXXXXXXXXXXXXXXXXXXXGOXXXXXXXXXXXXXXXXXXGOXXXXXXXXXXXXXXXXXX,0,0,0
1218,19,0,19,97,184,0,0,185,30,155,GXXXXXXXXXXXXXXXXXXXGOXXXXXXXXXXXXXXXXXXGOOXXXXXXXXXXXXXXXXXGXXXXXXXXXXXXXXXXXXXGXXXXXXXXXXXXXXXXXXXGXXXXXXXXXXXXXXXXXXXGOXXXXXXXXXXXXXXXXXXGXXXXXXXXXXXXXXXXXXXGXXXXXXXXXXXXXXXXXXXGXXXXXXXXXXXXXXXXXXXGXXXXXXXXXXXXXXXXXXXGOXXXXXXXXXXXXXXXXXXGOXXXXXXXXXXXXXXXXXX,0,0,0
1239,19,0,19,98,183,0,0,183,37,146,GXXXXXXXXXXXXXXXXXXXGOXXXXXXXXXXXXXXXXXXGOOXXXXXXXXXXXXXXXXXGXXXXXXXXXXXXXXXXXXXGXXXXXXXXXXXXXXXXXXXGXXXXXXXXXXXXXXXXXXXGOXXXXXXXXXXXXXXXXXXGXXXXXXXXXXXXXXXXXXXGXXXXXXXXXXXXXXXXXXXGXXXXXXXXXXXXXXXXXXXGXXXXXXXXXXXXXXXXXXXGOXXXXXXXXXXXXXXXXXXGOXXXXXXXXXXXXXXXXXX,0,0,0

1260,19,0,19,95,186,0,0,187,37,150,GXXXXXXXXXXXXXXXXXXXGOXXXXXXXXXXXXXXXXXXGOOXXXXXXXXXXXXXXXXXGXXXXXXXXXXXXXXXXXXXGXXXXXXXXXXXXXXXXXXXGXXXXXXXXXXXXXXXXXXXGOXXXXXXXXXXXXXXXXXXGXXXXXXXXXXXXXXXXXXXGXXXXXXXXXXXXXXXXXXXGXXXXXXXXXXXXXXXXXXXGXXXXXXXXXXXXXXXXXXXGOXXXXXXXXXXXXXXXXXXGOXXXXXXXXXXXXXXXXXX,0,0,0
1281,20,1,19,107,173,0,0,173,32,141,GXXXXXXXXXXXXXXXXXXXGOXXXXXXXXXXXXXXXXXXGOOXXXXXXXXXXXXXXXXXGXXXXXXXXXXXXXXXXXXXGAXXXXXXXXXXXXXXXXXXGXXXXXXXXXXXXXXXXXXXGOXXXXXXXXXXXXXXXXXXGXXXXXXXXXXXXXXXXXXXGXXXXXXXXXXXXXXXXXXXGXXXXXXXXXXXXXXXXXXXGXXXXXXXXXXXXXXXXXXXGOXXXXXXXXXXXXXXXXXXGOXXXXXXXXXXXXXXXXXX,0,0,0
1302,20,1,19,107,173,0,0,171,34,137,GXXXXXXXXXXXXXXXXXXXGOXXXXXXXXXXXXXXXXXXGOOXXXXXXXXXXXXXXXXXGXXXXXXXXXXXXXXXXXXXGAXXXXXXXXXXXXXXXXXXGXXXXXXXXXXXXXXXXXXXGOXXXXXXXXXXXXXXXXXXGXXXXXXXXXXXXXXXXXXXGXXXXXXXXXXXXXXXXXXXGXXXXXXXXXXXXXXXXXXXGXXXXXXXXXXXXXXXXXXXGOXXXXXXXXXXXXXXXXXXGOXXXXXXXXXXXXXXXXXX,0,0,0
1323,20,0,20,105,175,0,0,174,34,140,GXXXXXXXXXXXXXXXXXXXGOXXXXXXXXXXXXXXXXXXGOOXXXXXXXXXXXXXXXXXGXXXXXXXXXXXXXXXXXXXGOXXXXXXXXXXXXXXXXXXGXXXXXXXXXXXXXXXXXXXGOXXXXXXXXXXXXXXXXXXGXXXXXXXXXXXXXXXXXXXGXXXXXXXXXXXXXXXXXXXGXXXXXXXXXXXXXXXXXXXGXXXXXXXXXXXXXXXXXXXGOXXXXXXXXXXXXXXXXXXGOXXXXXXXXXXXXXXXXXX,0,0,0
1344,20,0,20,111,169,0,0,169,35,134,GXXXXXXXXXXXXXXXXXXXGOXXXXXXXXXXXXXXXXXXGOOXXXXXXXXXXXXXXXXXGXXXXXXXXXXXXXXXXXXXGOXXXXXXXXXXXXXXXXXXGXXXXXXXXXXXXXXXXXXXGOXXXXXXXXXXXXXXXXXXGXXXXXXXXXXXXXXXXXXXGXXXXXXXXXXXXXXXXXXXGXXXXXXXXXXXXXXXXXXXGXXXXXXXXXXXXXXXXXXXGOXXXXXXXXXXXXXXXXXXGOXXXXXXXXXXXXXXXXXX,0,0,0

1365,20,0,20,110,170,0,0,170,37,133,GXXXXXXXXXXXXXXXXXXXGOXXXXXXXXXXXXXXXXXXGOOXXXXXXXXXXXXXXXXXGXXXXXXXXXXXXXXXXXXXGOXXXXXXXXXXXXXXXXXXGXXXXXXXXXXXXXXXXXXXGOXXXXXXXXXXXXXXXXXXGXXXXXXXXXXXXXXXXXXXGXXXXXXXXXXXXXXXXXXXGXXXXXXXXXXXXXXXXXXXGXXXXXXXXXXXXXXXXXXXGOXXXXXXXXXXXXXXXXXXGOXXXXXXXXXXXXXXXXXX,0,0,0
1386,21,0,21,108,171,0,0,169,36,133,GXXXXXXXXXXXXXXXXXXXGOXXXXXXXXXXXXXXXXXXGOOXXXXXXXXXXXXXXXXXGXXXXXXXXXXXXXXXXXXXGOXXXXXXXXXXXXXXXXXXGXXXXXXXXXXXXXXXXXXXGOXXXXXXXXXXXXXXXXXXGXXXXXXXXXXXXXXXXXXXGXXXXXXXXXXXXXXXXXXXGXXXXXXXXXXXXXXXXXXXGOXXXXXXXXXXXXXXXXXXGOXXXXXXXXXXXXXXXXXXGOXXXXXXXXXXXXXXXXXX,0,0,0
1407,21,0,21,110,169,0,0,169,38,131,GXXXXXXXXXXXXXXXXXXXGOXXXXXXXXXXXXXXXXXXGOOXXXXXXXXXXXXXXXXXGXXXXXXXXXXXXXXXXXXXGOXXXXXXXXXXXXXXXXXXGXXXXXXXXXXXXXXXXXXXGOXXXXXXXXXXXXXXXXXXGXXXXXXXXXXXXXXXXXXXGXXXXXXXXXXXXXXXXXXXGXXXXXXXXXXXXXXXXXXXGOXXXXXXXXXXXXXXXXXXGOXXXXXXXXXXXXXXXXXXGOXXXXXXXXXXXXXXXXXX,0,0,0
1428,21,0,21,107,172,0,0,171,38,133,GXXXXXXXXXXXXXXXXXXXGOXXXXXXXXXXXXXXXXXXGOOXXXXXXXXXXXXXXXXXGXXXXXXXXXXXXXXXXXXXGOXXXXXXXXXXXXXXXXXXGXXXXXXXXXXXXXXXXXXXGOXXXXXXXXXXXXXXXXXXGXXXXXXXXXXXXXXXXXXXGXXXXXXXXXXXXXXXXXXXGXXXXXXXXXXXXXXXXXXXGOXXXXXXXXXXXXXXXXXXGOXXXXXXXXXXXXXXXXXXGOXXXXXXXXXXXXXXXXXX,0,0,0
1449,21,0,21,107,172,0,0,172,35,137,GXXXXXXXXXXXXXXXXXXXGOXXXXXXXXXXXXXXXXXXGOOXXXXXXXXXXXXXXXXXGXXXXXXXXXXXXXXXXXXXGOXXXXXXXXXXXXXXXXXXGXXXXXXXXXXXXXXXXXXXGOXXXXXXXXXXXXXXXXXXGXXXXXXXXXXXXXXXXXXXGXXXXXXXXXXXXXXXXXXXGXXXXXXXXXXXXXXXXXXXGOXXXXXXXXXXXXXXXXXXGOXXXXXXXXXXXXXXXXXXGOXXXXXXXXXXXXXXXXXX,0,0,0

1470,21,0,21,106,173,0,0,174,33,141,GXXXXXXXXXXXXXXXXXXXGOXXXXXXXXXXXXXXXXXXGOOXXXXXXXXXXXXXXXXXGXXXXXXXXXXXXXXXXXXXGOXXXXXXXXXXXXXXXXXXGXXXXXXXXXXXXXXXXXXXGOXXXXXXXXXXXXXXXXXXGXXXXXXXXXXXXXXXXXXXGXXXXXXXXXXXXXXXXXXXGXXXXXXXXXXXXXXXXXXXGOXXXXXXXXXXXXXXXXXXGOXXXXXXXXXXXXXXXXXXGOXXXXXXXXXXXXXXXXXX,0,0,0
1491,21,0,21,94,185,0,0,186,36,150,GXXXXXXXXXXXXXXXXXXXGOXXXXXXXXXXXXXXXXXXGOOXXXXXXXXXXXXXXXXXGXXXXXXXXXXXXXXXXXXXGOXXXXXXXXXXXXXXXXXXGXXXXXXXXXXXXXXXXXXXGOXXXXXXXXXXXXXXXXXXGXXXXXXXXXXXXXXXXXXXGXXXXXXXXXXXXXXXXXXXGXXXXXXXXXXXXXXXXXXXGOXXXXXXXXXXXXXXXXXXGOXXXXXXXXXXXXXXXXXXGOXXXXXXXXXXXXXXXXXX,0,0,0
1512,21,0,21,94,185,0,0,185,35,150,GXXXXXXXXXXXXXXXXXXXGOXXXXXXXXXXXXXXXXXXGOOXXXXXXXXXXXXXXXXXGXXXXXXXXXXXXXXXXXXXGOXXXXXXXXXXXXXXXXXXGXXXXXXXXXXXXXXXXXXXGOXXXXXXXXXXXXXXXXXXGXXXXXXXXXXXXXXXXXXXGXXXXXXXXXXXXXXXXXXXGXXXXXXXXXXXXXXXXXXXGOXXXXXXXXXXXXXXXXXXGOXXXXXXXXXXXXXXXXXXGOXXXXXXXXXXXXXXXXXX,0,0,0
1533,21,0,21,91,188,0,0,189,37,152,GXXXXXXXXXXXXXXXXXXXGOXXXXXXXXXXXXXXXXXXGOOXXXXXXXXXXXXXXXXXGXXXXXXXXXXXXXXXXXXXGOXXXXXXXXXXXXXXXXXXGXXXXXXXXXXXXXXXXXXXGOXXXXXXXXXXXXXXXXXXGXXXXXXXXXXXXXXXXXXXGXXXXXXXXXXXXXXXXXXXGXXXXXXXXXXXXXXXXXXXGOXXXXXXXXXXXXXXXXXXGOXXXXXXXXXXXXXXXXXXGOXXXXXXXXXXXXXXXXXX,0,0,0
1554,21,0,21,85,194,0,0,196,36,160,GXXXXXXXXXXXXXXXXXXXGOXXXXXXXXXXXXXXXXXXGOOXXXXXXXXXXXXXXXXXGXXXXXXXXXXXXXXXXXXXGOXXXXXXXXXXXXXXXXXXGXXXXXXXXXXXXXXXXXXXGOXXXXXXXXXXXXXXXXXXGXXXXXXXXXXXXXXXXXXXGXXXXXXXXXXXXXXXXXXXGXXXXXXXXXXXXXXXXXXXGOXXXXXXXXXXXXXXXXXXGOXXXXXXXXXXXXXXXXXXGOXXXXXXXXXXXXXXXXXX,0,0,0

1575,22,1,21,82,196,0,0,197,42,155,GAXXXXXXXXXXXXXXXXXXGOXXXXXXXXXXXXXXXXXXGOOXXXXXXXXXXXXXXXXXGXXXXXXXXXXXXXXXXXXXGOXXXXXXXXXXXXXXXXXXGXXXXXXXXXXXXXXXXXXXGOXXXXXXXXXXXXXXXXXXGXXXXXXXXXXXXXXXXXXXGXXXXXXXXXXXXXXXXXXXGXXXXXXXXXXXXXXXXXXXGOXXXXXXXXXXXXXXXXXXGOXXXXXXXXXXXXXXXXXXGOXXXXXXXXXXXXXXXXXX,0,0,0
1596,22,1,21,82,196,0,0,198,42,156,GAXXXXXXXXXXXXXXXXXXGOXXXXXXXXXXXXXXXXXXGOOXXXXXXXXXXXXXXXXXGXXXXXXXXXXXXXXXXXXXGOXXXXXXXXXXXXXXXXXXGXXXXXXXXXXXXXXXXXXXGOXXXXXXXXXXXXXXXXXXGXXXXXXXXXXXXXXXXXXXGXXXXXXXXXXXXXXXXXXXGXXXXXXXXXXXXXXXXXXXGOXXXXXXXXXXXXXXXXXXGOXXXXXXXXXXXXXXXXXXGOXXXXXXXXXXXXXXXXXX,0,0,0
1617,22,1,21,79,199,0,0,201,43,158,GAXXXXXXXXXXXXXXXXXXGOXXXXXXXXXXXXXXXXXXGOOXXXXXXXXXXXXXXXXXGXXXXXXXXXXXXXXXXXXXGOXXXXXXXXXXXXXXXXXXGXXXXXXXXXXXXXXXXXXXGOXXXXXXXXXXXXXXXXXXGXXXXXXXXXXXXXXXXXXXGXXXXXXXXXXXXXXXXXXXGXXXXXXXXXXXXXXXXXXXGOXXXXXXXXXXXXXXXXXXGOXXXXXXXXXXXXXXXXXXGOXXXXXXXXXXXXXXXXXX,0,0,0
1638,22,1,21,76,202,0,0,204,44,160,GAXXXXXXXXXXXXXXXXXXGOXXXXXXXXXXXXXXXXXXGOOXXXXXXXXXXXXXXXXXGXXXXXXXXXXXXXXXXXXXGOXXXXXXXXXXXXXXXXXXGXXXXXXXXXXXXXXXXXXXGOXXXXXXXXXXXXXXXXXXGXXXXXXXXXXXXXXXXXXXGXXXXXXXXXXXXXXXXXXXGXXXXXXXXXXXXXXXXXXXGOXXXXXXXXXXXXXXXXXXGOXXXXXXXXXXXXXXXXXXGOXXXXXXXXXXXXXXXXXX,0,0,0
1659,22,0,22,80,198,0,0,200,42,158,GOXXXXXXXXXXXXXXXXXXGOXXXXXXXXXXXXXXXXXXGOOXXXXXXXXXXXXXXXXXGXXXXXXXXXXXXXXXXXXXGOXXXXXXXXXXXXXXXXXXGXXXXXXXXXXXXXXXXXXXGOXXXXXXXXXXXXXXXXXXGXXXXXXXXXXXXXXXXXXXGXXXXXXXXXXXXXXXXXXXGXXXXXXXXXXXXXXXXXXXGOXXXXXXXXXXXXXXXXXXGOXXXXXXXXXXXXXXXXXXGOXXXXXXXXXXXXXXXXXX,0,0,0

1680,22,0,22,79,199,0,0,200,43,157,GOXXXXXXXXXXXXXXXXXXGOXXXXXXXXXXXXXXXXXXGOOXXXXXXXXXXXXXXXXXGXXXXXXXXXXXXXXXXXXXGOXXXXXXXXXXXXXXXXXXGXXXXXXXXXXXXXXXXXXXGOXXXXXXXXXXXXXXXXXXGXXXXXXXXXXXXXXXXXXXGXXXXXXXXXXXXXXXXXXXGXXXXXXXXXXXXXXXXXXXGOXXXXXXXXXXXXXXXXXXGOXXXXXXXXXXXXXXXXXXGOXXXXXXXXXXXXXXXXXX,0,0,0
1701,22,0,22,81,197,0,0,198,42,156,GOXXXXXXXXXXXXXXXXXXGOXXXXXXXXXXXXXXXXXXGOOXXXXXXXXXXXXXXXXXGXXXXXXXXXXXXXXXXXXXGOXXXXXXXXXXXXXXXXXXGXXXXXXXXXXXXXXXXXXXGOXXXXXXXXXXXXXXXXXXGXXXXXXXXXXXXXXXXXXXGXXXXXXXXXXXXXXXXXXXGXXXXXXXXXXXXXXXXXXXGOXXXXXXXXXXXXXXXXXXGOXXXXXXXXXXXXXXXXXXGOXXXXXXXXXXXXXXXXXX,0,0,0
1722,23,1,22,86,191,0,0,191,44,147,GOXXXXXXXXXXXXXXXXXXGOXXXXXXXXXXXXXXXXXXGOOXXXXXXXXXXXXXXXXXGXXXXXXXXXXXXXXXXXXXGOXXXXXXXXXXXXXXXXXXGXXXXXXXXXXXXXXXXXXXGOXXXXXXXXXXXXXXXXXXGXXXXXXXXXXXXXXXXXXXGXXXXXXXXXXXXXXXXXXXGAXXXXXXXXXXXXXXXXXXGOXXXXXXXXXXXXXXXXXXGOXXXXXXXXXXXXXXXXXXGOXXXXXXXXXXXXXXXXXX,0,0,0
1743,23,1,22,83,194,0,0,194,45,149,GOXXXXXXXXXXXXXXXXXXGOXXXXXXXXXXXXXXXXXXGOOXXXXXXXXXXXXXXXXXGXXXXXXXXXXXXXXXXXXXGOXXXXXXXXXXXXXXXXXXGXXXXXXXXXXXXXXXXXXXGOXXXXXXXXXXXXXXXXXXGXXXXXXXXXXXXXXXXXXXGXXXXXXXXXXXXXXXXXXXGAXXXXXXXXXXXXXXXXXXGOXXXXXXXXXXXXXXXXXXGOXXXXXXXXXXXXXXXXXXGOXXXXXXXXXXXXXXXXXX,0,0,0
1764,23,1,22,85,192,0,0,193,44,149,GOXXXXXXXXXXXXXXXXXXGOXXXXXXXXXXXXXXXXXXGOOXXXXXXXXXXXXXXXXXGXXXXXXXXXXXXXXXXXXXGOXXXXXXXXXXXXXXXXXXGXXXXXXXXXXXXXXXXXXXGOXXXXXXXXXXXXXXXXXXGXXXXXXXXXXXXXXXXXXXGXXXXXXXXXXXXXXXXXXXGAXXXXXXXXXXXXXXXXXXGOXXXXXXXXXXXXXXXXXXGOXXXXXXXXXXXXXXXXXXGOXXXXXXXXXXXXXXXXXX,0,0,0

1785,23,1,22,80,197,0,0,197,45,152,GOXXXXXXXXXXXXXXXXXXGOXXXXXXXXXXXXXXXXXXGOOXXXXXXXXXXXXXXXXXGXXXXXXXXXXXXXXXXXXXGOXXXXXXXXXXXXXXXXXXGXXXXXXXXXXXXXXXXXXXGOXXXXXXXXXXXXXXXXXXGXXXXXXXXXXXXXXXXXXXGXXXXXXXXXXXXXXXXXXXGAXXXXXXXXXXXXXXXXXXGOXXXXXXXXXXXXXXXXXXGOXXXXXXXXXXXXXXXXXXGOXXXXXXXXXXXXXXXXXX,0,0,0
1806,23,1,22,88,189,0,0,190,48,142,GOXXXXXXXXXXXXXXXXXXGOXXXXXXXXXXXXXXXXXXGOOXXXXXXXXXXXXXXXXXGXXXXXXXXXXXXXXXXXXXGOXXXXXXXXXXXXXXXXXXGXXXXXXXXXXXXXXXXXXXGOXXXXXXXXXXXXXXXXXXGXXXXXXXXXXXXXXXXXXXGXXXXXXXXXXXXXXXXXXXGAXXXXXXXXXXXXXXXXXXGOXXXXXXXXXXXXXXXXXXGOXXXXXXXXXXXXXXXXXXGOXXXXXXXXXXXXXXXXXX,0,0,0
1827,23,1,22,89,188,0,0,189,43,146,GOXXXXXXXXXXXXXXXXXXGOXXXXXXXXXXXXXXXXXXGOOXXXXXXXXXXXXXXXXXGXXXXXXXXXXXXXXXXXXXGOXXXXXXXXXXXXXXXXXXGXXXXXXXXXXXXXXXXXXXGOXXXXXXXXXXXXXXXXXXGXXXXXXXXXXXXXXXXXXXGXXXXXXXXXXXXXXXXXXXGAXXXXXXXXXXXXXXXXXXGOXXXXXXXXXXXXXXXXXXGOXXXXXXXXXXXXXXXXXXGOXXXXXXXXXXXXXXXXXX,0,0,0
1848,23,1,22,89,188,0,0,189,44,145,GOXXXXXXXXXXXXXXXXXXGOXXXXXXXXXXXXXXXXXXGOOXXXXXXXXXXXXXXXXXGXXXXXXXXXXXXXXXXXXXGOXXXXXXXXXXXXXXXXXXGXXXXXXXXXXXXXXXXXXXGOXXXXXXXXXXXXXXXXXXGXXXXXXXXXXXXXXXXXXXGXXXXXXXXXXXXXXXXXXXGAXXXXXXXXXXXXXXXXXXGOXXXXXXXXXXXXXXXXXXGOXXXXXXXXXXXXXXXXXXGOXXXXXXXXXXXXXXXXXX,0,0,0
1869,23,1,22,89,188,0,0,189,43,146,GOXXXXXXXXXXXXXXXXXXGOXXXXXXXXXXXXXXXXXXGOOXXXXXXXXXXXXXXXXXGXXXXXXXXXXXXXXXXXXXGOXXXXXXXXXXXXXXXXXXGXXXXXXXXXXXXXXXXXXXGOXXXXXXXXXXXXXXXXXXGXXXXXXXXXXXXXXXXXXXGXXXXXXXXXXXXXXXXXXXGAXXXXXXXXXXXXXXXXXXGOXXXXXXXXXXXXXXXXXXGOXXXXXXXXXXXXXXXXXXGOXXXXXXXXXXXXXXXXXX,0,0,0

1890,23,1,22,85,192,0,0,193,46,147,GOXXXXXXXXXXXXXXXXXXGOXXXXXXXXXXXXXXXXXXGOOXXXXXXXXXXXXXXXXXGXXXXXXXXXXXXXXXXXXXGOXXXXXXXXXXXXXXXXXXGXXXXXXXXXXXXXXXXXXXGOXXXXXXXXXXXXXXXXXXGXXXXXXXXXXXXXXXXXXXGXXXXXXXXXXXXXXXXXXXGAXXXXXXXXXXXXXXXXXXGOXXXXXXXXXXXXXXXXXXGOXXXXXXXXXXXXXXXXXXGOXXXXXXXXXXXXXXXXXX,0,0,0
1911,23,1,22,83,194,0,0,195,51,144,GOXXXXXXXXXXXXXXXXXXGOXXXXXXXXXXXXXXXXXXGOOXXXXXXXXXXXXXXXXXGXXXXXXXXXXXXXXXXXXXGOXXXXXXXXXXXXXXXXXXGXXXXXXXXXXXXXXXXXXXGOXXXXXXXXXXXXXXXXXXGXXXXXXXXXXXXXXXXXXXGXXXXXXXXXXXXXXXXXXXGAXXXXXXXXXXXXXXXXXXGOXXXXXXXXXXXXXXXXXXGOXXXXXXXXXXXXXXXXXXGOXXXXXXXXXXXXXXXXXX,0,0,0
1932,23,1,22,86,191,0,0,192,52,140,GOXXXXXXXXXXXXXXXXXXGOXXXXXXXXXXXXXXXXXXGOOXXXXXXXXXXXXXXXXXGXXXXXXXXXXXXXXXXXXXGOXXXXXXXXXXXXXXXXXXGXXXXXXXXXXXXXXXXXXXGOXXXXXXXXXXXXXXXXXXGXXXXXXXXXXXXXXXXXXXGXXXXXXXXXXXXXXXXXXXGAXXXXXXXXXXXXXXXXXXGOXXXXXXXXXXXXXXXXXXGOXXXXXXXXXXXXXXXXXXGOXXXXXXXXXXXXXXXXXX,0,0,0
1953,23,1,22,88,189,0,0,189,51,138,GOXXXXXXXXXXXXXXXXXXGOXXXXXXXXXXXXXXXXXXGOOXXXXXXXXXXXXXXXXXGXXXXXXXXXXXXXXXXXXXGOXXXXXXXXXXXXXXXXXXGXXXXXXXXXXXXXXXXXXXGOXXXXXXXXXXXXXXXXXXGXXXXXXXXXXXXXXXXXXXGXXXXXXXXXXXXXXXXXXXGAXXXXXXXXXXXXXXXXXXGOXXXXXXXXXXXXXXXXXXGOXXXXXXXXXXXXXXXXXXGOXXXXXXXXXXXXXXXXXX,0,0,0
1974,23,0,23,85,192,0,0,190,47,143,GOXXXXXXXXXXXXXXXXXXGOXXXXXXXXXXXXXXXXXXGOOXXXXXXXXXXXXXXXXXGXXXXXXXXXXXXXXXXXXXGOXXXXXXXXXXXXXXXXXXGXXXXXXXXXXXXXXXXXXXGOXXXXXXXXXXXXXXXXXXGXXXXXXXXXXXXXXXXXXXGXXXXXXXXXXXXXXXXXXXGOXXXXXXXXXXXXXXXXXXGOXXXXXXXXXXXXXXXXXXGOXXXXXXXXXXXXXXXXXXGOXXXXXXXXXXXXXXXXXX,0,0,0

1995,23,0,23,85,192,0,0,193,49,144,GOXXXXXXXXXXXXXXXXXXGOXXXXXXXXXXXXXXXXXXGOOXXXXXXXXXXXXXXXXXGXXXXXXXXXXXXXXXXXXXGOXXXXXXXXXXXXXXXXXXGXXXXXXXXXXXXXXXXXXXGOXXXXXXXXXXXXXXXXXXGXXXXXXXXXXXXXXXXXXXGXXXXXXXXXXXXXXXXXXXGOXXXXXXXXXXXXXXXXXXGOXXXXXXXXXXXXXXXXXXGOXXXXXXXXXXXXXXXXXXGOXXXXXXXXXXXXXXXXXX,0,0,0
2016,23,0,23,85,192,0,0,192,47,145,GOXXXXXXXXXXXXXXXXXXGOXXXXXXXXXXXXXXXXXXGOOXXXXXXXXXXXXXXXXXGXXXXXXXXXXXXXXXXXXXGOXXXXXXXXXXXXXXXXXXGXXXXXXXXXXXXXXXXXXXGOXXXXXXXXXXXXXXXXXXGXXXXXXXXXXXXXXXXXXXGXXXXXXXXXXXXXXXXXXXGOXXXXXXXXXXXXXXXXXXGOXXXXXXXXXXXXXXXXXXGOXXXXXXXXXXXXXXXXXXGOXXXXXXXXXXXXXXXXXX,0,0,0
2037,23,0,23,79,198,0,0,198,50,148,GOXXXXXXXXXXXXXXXXXXGOXXXXXXXXXXXXXXXXXXGOOXXXXXXXXXXXXXXXXXGXXXXXXXXXXXXXXXXXXXGOXXXXXXXXXXXXXXXXXXGXXXXXXXXXXXXXXXXXXXGOXXXXXXXXXXXXXXXXXXGXXXXXXXXXXXXXXXXXXXGXXXXXXXXXXXXXXXXXXXGOXXXXXXXXXXXXXXXXXXGOXXXXXXXXXXXXXXXXXXGOXXXXXXXXXXXXXXXXXXGOXXXXXXXXXXXXXXXXXX,0,0,0
2058,23,0,23,81,196,0,0,196,55,141,GOXXXXXXXXXXXXXXXXXXGOXXXXXXXXXXXXXXXXXXGOOXXXXXXXXXXXXXXXXXGXXXXXXXXXXXXXXXXXXXGOXXXXXXXXXXXXXXXXXXGXXXXXXXXXXXXXXXXXXXGOXXXXXXXXXXXXXXXXXXGXXXXXXXXXXXXXXXXXXXGXXXXXXXXXXXXXXXXXXXGOXXXXXXXXXXXXXXXXXXGOXXXXXXXXXXXXXXXXXXGOXXXXXXXXXXXXXXXXXXGOXXXXXXXXXXXXXXXXXX,0,0,0
2079,23,0,23,83,194,0,0,194,56,138,GOXXXXXXXXXXXXXXXXXXGOXXXXXXXXXXXXXXXXXXGOOXXXXXXXXXXXXXXXXXGXXXXXXXXXXXXXXXXXXXGOXXXXXXXXXXXXXXXXXXGXXXXXXXXXXXXXXXXXXXGOXXXXXXXXXXXXXXXXXXGXXXXXXXXXXXXXXXXXXXGXXXXXXXXXXXXXXXXXXXGOXXXXXXXXXXXXXXXXXXGOXXXXXXXXXXXXXXXXXXGOXXXXXXXXXXXXXXXXXXGOXXXXXXXXXXXXXXXXXX,0,0,0

2100,23,0,23,86,191,0,0,191,56,135,GOXXXXXXXXXXXXXXXXXXGOXXXXXXXXXXXXXXXXXXGOOXXXXXXXXXXXXXXXXXGXXXXXXXXXXXXXXXXXXXGOXXXXXXXXXXXXXXXXXXGXXXXXXXXXXXXXXXXXXXGOXXXXXXXXXXXXXXXXXXGXXXXXXXXXXXXXXXXXXXGXXXXXXXXXXXXXXXXXXXGOXXXXXXXXXXXXXXXXXXGOXXXXXXXXXXXXXXXXXXGOXXXXXXXXXXXXXXXXXXGOXXXXXXXXXXXXXXXXXX,0,0,0
2121,23,0,23,85,192,0,0,192,53,139,GOXXXXXXXXXXXXXXXXXXGOXXXXXXXXXXXXXXXXXXGOOXXXXXXXXXXXXXXXXXGXXXXXXXXXXXXXXXXXXXGOXXXXXXXXXXXXXXXXXXGXXXXXXXXXXXXXXXXXXXGOXXXXXXXXXXXXXXXXXXGXXXXXXXXXXXXXXXXXXXGXXXXXXXXXXXXXXXXXXXGOXXXXXXXXXXXXXXXXXXGOXXXXXXXXXXXXXXXXXXGOXXXXXXXXXXXXXXXXXXGOXXXXXXXXXXXXXXXXXX,0,0,0
2142,23,0,23,85,192,0,0,192,51,141,GOXXXXXXXXXXXXXXXXXXGOXXXXXXXXXXXXXXXXXXGOOXXXXXXXXXXXXXXXXXGXXXXXXXXXXXXXXXXXXXGOXXXXXXXXXXXXXXXXXXGXXXXXXXXXXXXXXXXXXXGOXXXXXXXXXXXXXXXXXXGXXXXXXXXXXXXXXXXXXXGXXXXXXXXXXXXXXXXXXXGOXXXXXXXXXXXXXXXXXXGOXXXXXXXXXXXXXXXXXXGOXXXXXXXXXXXXXXXXXXGOXXXXXXXXXXXXXXXXXX,0,0,0
2163,23,0,23,86,191,0,0,191,54,137,GOXXXXXXXXXXXXXXXXXXGOXXXXXXXXXXXXXXXXXXGOOXXXXXXXXXXXXXXXXXGXXXXXXXXXXXXXXXXXXXGOXXXXXXXXXXXXXXXXXXGXXXXXXXXXXXXXXXXXXXGOXXXXXXXXXXXXXXXXXXGXXXXXXXXXXXXXXXXXXXGXXXXXXXXXXXXXXXXXXXGOXXXXXXXXXXXXXXXXXXGOXXXXXXXXXXXXXXXXXXGOXXXXXXXXXXXXXXXXXXGOXXXXXXXXXXXXXXXXXX,0,0,0
2184,23,0,23,89,188,0,0,190,54,136,GOXXXXXXXXXXXXXXXXXXGOXXXXXXXXXXXXXXXXXXGOOXXXXXXXXXXXXXXXXXGXXXXXXXXXXXXXXXXXXXGOXXXXXXXXXXXXXXXXXXGXXXXXXXXXXXXXXXXXXXGOXXXXXXXXXXXXXXXXXXGXXXXXXXXXXXXXXXXXXXGXXXXXXXXXXXXXXXXXXXGOXXXXXXXXXXXXXXXXXXGOXXXXXXXXXXXXXXXXXXGOXXXXXXXXXXXXXXXXXXGOXXXXXXXXXXXXXXXXXX,0,0,0

2205,23,0,23,87,190,0,0,190,55,135,GOXXXXXXXXXXXXXXXXXXGOXXXXXXXXXXXXXXXXXXGOOXXXXXXXXXXXXXXXXXGXXXXXXXXXXXXXXXXXXXGOXXXXXXXXXXXXXXXXXXGXXXXXXXXXXXXXXXXXXXGOXXXXXXXXXXXXXXXXXXGXXXXXXXXXXXXXXXXXXXGXXXXXXXXXXXXXXXXXXXGOXXXXXXXXXXXXXXXXXXGOXXXXXXXXXXXXXXXXXXGOXXXXXXXXXXXXXXXXXXGOXXXXXXXXXXXXXXXXXX,0,0,0
2226,23,0,23,84,193,0,0,193,58,135,GOXXXXXXXXXXXXXXXXXXGOXXXXXXXXXXXXXXXXXXGOOXXXXXXXXXXXXXXXXXGXXXXXXXXXXXXXXXXXXXGOXXXXXXXXXXXXXXXXXXGXXXXXXXXXXXXXXXXXXXGOXXXXXXXXXXXXXXXXXXGXXXXXXXXXXXXXXXXXXXGXXXXXXXXXXXXXXXXXXXGOXXXXXXXXXXXXXXXXXXGOXXXXXXXXXXXXXXXXXXGOXXXXXXXXXXXXXXXXXXGOXXXXXXXXXXXXXXXXXX,0,0,0
2247,24,1,23,84,192,0,0,191,56,135,GOXXXXXXXXXXXXXXXXXXGOXXXXXXXXXXXXXXXXXXGOOXXXXXXXXXXXXXXXXXGXXXXXXXXXXXXXXXXXXXGOXXXXXXXXXXXXXXXXXXGXXXXXXXXXXXXXXXXXXXGOXXXXXXXXXXXXXXXXXXGXXXXXXXXXXXXXXXXXXXGXXXXXXXXXXXXXXXXXXXGOXXXXXXXXXXXXXXXXXXGOXXXXXXXXXXXXXXXXXXGOAXXXXXXXXXXXXXXXXXGOXXXXXXXXXXXXXXXXXX,0,0,0
2268,24,0,24,84,192,0,0,192,56,136,GOXXXXXXXXXXXXXXXXXXGOXXXXXXXXXXXXXXXXXXGOOXXXXXXXXXXXXXXXXXGXXXXXXXXXXXXXXXXXXXGOXXXXXXXXXXXXXXXXXXGXXXXXXXXXXXXXXXXXXXGOXXXXXXXXXXXXXXXXXXGXXXXXXXXXXXXXXXXXXXGXXXXXXXXXXXXXXXXXXXGOXXXXXXXXXXXXXXXXXXGOXXXXXXXXXXXXXXXXXXGOOXXXXXXXXXXXXXXXXXGOXXXXXXXXXXXXXXXXXX,0,0,0
2289,24,0,24,85,191,0,0,191,54,137,GOXXXXXXXXXXXXXXXXXXGOXXXXXXXXXXXXXXXXXXGOOXXXXXXXXXXXXXXXXXGXXXXXXXXXXXXXXXXXXXGOXXXXXXXXXXXXXXXXXXGXXXXXXXXXXXXXXXXXXXGOXXXXXXXXXXXXXXXXXXGXXXXXXXXXXXXXXXXXXXGXXXXXXXXXXXXXXXXXXXGOXXXXXXXXXXXXXXXXXXGOXXXXXXXXXXXXXXXXXXGOOXXXXXXXXXXXXXXXXXGOXXXXXXXXXXXXXXXXXX,0,0,0

2310,24,0,24,82,194,0,0,194,55,139,GOXXXXXXXXXXXXXXXXXXGOXXXXXXXXXXXXXXXXXXGOOXXXXXXXXXXXXXXXXXGXXXXXXXXXXXXXXXXXXXGOXXXXXXXXXXXXXXXXXXGXXXXXXXXXXXXXXXXXXXGOXXXXXXXXXXXXXXXXXXGXXXXXXXXXXXXXXXXXXXGXXXXXXXXXXXXXXXXXXXGOXXXXXXXXXXXXXXXXXXGOXXXXXXXXXXXXXXXXXXGOOXXXXXXXXXXXXXXXXXGOXXXXXXXXXXXXXXXXXX,0,0,0
2331,24,0,24,82,194,0,0,194,52,142,GOXXXXXXXXXXXXXXXXXXGOXXXXXXXXXXXXXXXXXXGOOXXXXXXXXXXXXXXXXXGXXXXXXXXXXXXXXXXXXXGOXXXXXXXXXXXXXXXXXXGXXXXXXXXXXXXXXXXXXXGOXXXXXXXXXXXXXXXXXXGXXXXXXXXXXXXXXXXXXXGXXXXXXXXXXXXXXXXXXXGOXXXXXXXXXXXXXXXXXXGOXXXXXXXXXXXXXXXXXXGOOXXXXXXXXXXXXXXXXXGOXXXXXXXXXXXXXXXXXX,0,0,0
2352,24,0,24,81,195,0,0,195,54,141,GOXXXXXXXXXXXXXXXXXXGOXXXXXXXXXXXXXXXXXXGOOXXXXXXXXXXXXXXXXXGXXXXXXXXXXXXXXXXXXXGOXXXXXXXXXXXXXXXXXXGXXXXXXXXXXXXXXXXXXXGOXXXXXXXXXXXXXXXXXXGXXXXXXXXXXXXXXXXXXXGXXXXXXXXXXXXXXXXXXXGOXXXXXXXXXXXXXXXXXXGOXXXXXXXXXXXXXXXXXXGOOXXXXXXXXXXXXXXXXXGOXXXXXXXXXXXXXXXXXX,0,0,0
2373,24,0,24,84,192,0,0,192,53,139,GOXXXXXXXXXXXXXXXXXXGOXXXXXXXXXXXXXXXXXXGOOXXXXXXXXXXXXXXXXXGXXXXXXXXXXXXXXXXXXXGOXXXXXXXXXXXXXXXXXXGXXXXXXXXXXXXXXXXXXXGOXXXXXXXXXXXXXXXXXXGXXXXXXXXXXXXXXXXXXXGXXXXXXXXXXXXXXXXXXXGOXXXXXXXXXXXXXXXXXXGOXXXXXXXXXXXXXXXXXXGOOXXXXXXXXXXXXXXXXXGOXXXXXXXXXXXXXXXXXX,0,0,0
2394,24,0,24,81,195,0,0,195,55,140,GOXXXXXXXXXXXXXXXXXXGOXXXXXXXXXXXXXXXXXXGOOXXXXXXXXXXXXXXXXXGXXXXXXXXXXXXXXXXXXXGOXXXXXXXXXXXXXXXXXXGXXXXXXXXXXXXXXXXXXXGOXXXXXXXXXXXXXXXXXXGXXXXXXXXXXXXXXXXXXXGXXXXXXXXXXXXXXXXXXXGOXXXXXXXXXXXXXXXXXXGOXXXXXXXXXXXXXXXXXXGOOXXXXXXXXXXXXXXXXXGOXXXXXXXXXXXXXXXXXX,0,0,0

2415,24,0,24,76,200,0,0,201,59,142,GOXXXXXXXXXXXXXXXXXXGOXXXXXXXXXXXXXXXXXXGOOXXXXXXXXXXXXXXXXXGXXXXXXXXXXXXXXXXXXXGOXXXXXXXXXXXXXXXXXXGXXXXXXXXXXXXXXXXXXXGOXXXXXXXXXXXXXXXXXXGXXXXXXXXXXXXXXXXXXXGXXXXXXXXXXXXXXXXXXXGOXXXXXXXXXXXXXXXXXXGOXXXXXXXXXXXXXXXXXXGOOXXXXXXXXXXXXXXXXXGOXXXXXXXXXXXXXXXXXX,0,0,0
2436,25,1,24,81,194,0,0,194,56,138,GOXXXXXXXXXXXXXXXXXXGOXXXXXXXXXXXXXXXXXXGOOXXXXXXXXXXXXXXXXXGAXXXXXXXXXXXXXXXXXXGOXXXXXXXXXXXXXXXXXXGXXXXXXXXXXXXXXXXXXXGOXXXXXXXXXXXXXXXXXXGXXXXXXXXXXXXXXXXXXXGXXXXXXXXXXXXXXXXXXXGOXXXXXXXXXXXXXXXXXXGOXXXXXXXXXXXXXXXXXXGOOXXXXXXXXXXXXXXXXXGOXXXXXXXXXXXXXXXXXX,0,0,0
2457,26,1,25,81,193,0,0,193,54,139,GOXXXXXXXXXXXXXXXXXXGOXXXXXXXXXXXXXXXXXXGOOXXXXXXXXXXXXXXXXXGAXXXXXXXXXXXXXXXXXXGOXXXXXXXXXXXXXXXXXXGXXXXXXXXXXXXXXXXXXXGOXXXXXXXXXXXXXXXXXXGOXXXXXXXXXXXXXXXXXXGXXXXXXXXXXXXXXXXXXXGOXXXXXXXXXXXXXXXXXXGOXXXXXXXXXXXXXXXXXXGOOXXXXXXXXXXXXXXXXXGOXXXXXXXXXXXXXXXXXX,0,0,0
2478,26,1,25,77,197,0,0,195,56,139,GOXXXXXXXXXXXXXXXXXXGOXXXXXXXXXXXXXXXXXXGOOXXXXXXXXXXXXXXXXXGAXXXXXXXXXXXXXXXXXXGOXXXXXXXXXXXXXXXXXXGXXXXXXXXXXXXXXXXXXXGOXXXXXXXXXXXXXXXXXXGOXXXXXXXXXXXXXXXXXXGXXXXXXXXXXXXXXXXXXXGOXXXXXXXXXXXXXXXXXXGOXXXXXXXXXXXXXXXXXXGOOXXXXXXXXXXXXXXXXXGOXXXXXXXXXXXXXXXXXX,0,0,0
2499,27,2,25,73,200,0,0,201,60,141,GOXXXXXXXXXXXXXXXXXXGOXXXXXXXXXXXXXXXXXXGOOXXXXXXXXXXXXXXXXXGAXXXXXXXXXXXXXXXXXXGOXXXXXXXXXXXXXXXXXXGXXXXXXXXXXXXXXXXXXXGOXXXXXXXXXXXXXXXXXXGOXXXXXXXXXXXXXXXXXXGXXXXXXXXXXXXXXXXXXXGOAXXXXXXXXXXXXXXXXXGOXXXXXXXXXXXXXXXXXXGOOXXXXXXXXXXXXXXXXXGOXXXXXXXXXXXXXXXXXX,0,0,0

2520,27,2,25,78,195,0,0,196,58,138,GOXXXXXXXXXXXXXXXXXXGOXXXXXXXXXXXXXXXXXXGOOXXXXXXXXXXXXXXXXXGAXXXXXXXXXXXXXXXXXXGOXXXXXXXXXXXXXXXXXXGXXXXXXXXXXXXXXXXXXXGOXXXXXXXXXXXXXXXXXXGOXXXXXXXXXXXXXXXXXXGXXXXXXXXXXXXXXXXXXXGOAXXXXXXXXXXXXXXXXXGOXXXXXXXXXXXXXXXXXXGOOXXXXXXXXXXXXXXXXXGOXXXXXXXXXXXXXXXXXX,0,0,0
2541,27,2,25,79,194,0,0,195,56,139,GOXXXXXXXXXXXXXXXXXXGOXXXXXXXXXXXXXXXXXXGOOXXXXXXXXXXXXXXXXXGAXXXXXXXXXXXXXXXXXXGOXXXXXXXXXXXXXXXXXXGXXXXXXXXXXXXXXXXXXXGOXXXXXXXXXXXXXXXXXXGOXXXXXXXXXXXXXXXXXXGXXXXXXXXXXXXXXXXXXXGOAXXXXXXXXXXXXXXXXXGOXXXXXXXXXXXXXXXXXXGOOXXXXXXXXXXXXXXXXXGOXXXXXXXXXXXXXXXXXX,0,0,0
2562,27,2,25,83,190,0,0,191,59,132,GOXXXXXXXXXXXXXXXXXXGOXXXXXXXXXXXXXXXXXXGOOXXXXXXXXXXXXXXXXXGAXXXXXXXXXXXXXXXXXXGOXXXXXXXXXXXXXXXXXXGXXXXXXXXXXXXXXXXXXXGOXXXXXXXXXXXXXXXXXXGOXXXXXXXXXXXXXXXXXXGXXXXXXXXXXXXXXXXXXXGOAXXXXXXXXXXXXXXXXXGOXXXXXXXXXXXXXXXXXXGOOXXXXXXXXXXXXXXXXXGOXXXXXXXXXXXXXXXXXX,0,0,0
2583,27,1,26,82,191,0,0,191,61,130,GOXXXXXXXXXXXXXXXXXXGOXXXXXXXXXXXXXXXXXXGOOXXXXXXXXXXXXXXXXXGOXXXXXXXXXXXXXXXXXXGOXXXXXXXXXXXXXXXXXXGXXXXXXXXXXXXXXXXXXXGOXXXXXXXXXXXXXXXXXXGOXXXXXXXXXXXXXXXXXXGXXXXXXXXXXXXXXXXXXXGOAXXXXXXXXXXXXXXXXXGOXXXXXXXXXXXXXXXXXXGOOXXXXXXXXXXXXXXXXXGOXXXXXXXXXXXXXXXXXX,0,0,0
2604,27,1,26,84,189,0,0,189,64,125,GOXXXXXXXXXXXXXXXXXXGOXXXXXXXXXXXXXXXXXXGOOXXXXXXXXXXXXXXXXXGOXXXXXXXXXXXXXXXXXXGOXXXXXXXXXXXXXXXXXXGXXXXXXXXXXXXXXXXXXXGOXXXXXXXXXXXXXXXXXXGOXXXXXXXXXXXXXXXXXXGXXXXXXXXXXXXXXXXXXXGOAXXXXXXXXXXXXXXXXXGOXXXXXXXXXXXXXXXXXXGOOXXXXXXXXXXXXXXXXXGOXXXXXXXXXXXXXXXXXX,0,0,0

2625,27,0,27,86,187,0,0,186,56,130,GOXXXXXXXXXXXXXXXXXXGOXXXXXXXXXXXXXXXXXXGOOXXXXXXXXXXXXXXXXXGOXXXXXXXXXXXXXXXXXXGOXXXXXXXXXXXXXXXXXXGXXXXXXXXXXXXXXXXXXXGOXXXXXXXXXXXXXXXXXXGOXXXXXXXXXXXXXXXXXXGXXXXXXXXXXXXXXXXXXXGOOXXXXXXXXXXXXXXXXXGOXXXXXXXXXXXXXXXXXXGOOXXXXXXXXXXXXXXXXXGOXXXXXXXXXXXXXXXXXX,0,0,0
2646,27,0,27,82,191,0,0,192,56,136,GOXXXXXXXXXXXXXXXXXXGOXXXXXXXXXXXXXXXXXXGOOXXXXXXXXXXXXXXXXXGOXXXXXXXXXXXXXXXXXXGOXXXXXXXXXXXXXXXXXXGXXXXXXXXXXXXXXXXXXXGOXXXXXXXXXXXXXXXXXXGOXXXXXXXXXXXXXXXXXXGXXXXXXXXXXXXXXXXXXXGOOXXXXXXXXXXXXXXXXXGOXXXXXXXXXXXXXXXXXXGOOXXXXXXXXXXXXXXXXXGOXXXXXXXXXXXXXXXXXX,0,0,0
2667,27,0,27,83,190,0,0,191,60,131,GOXXXXXXXXXXXXXXXXXXGOXXXXXXXXXXXXXXXXXXGOOXXXXXXXXXXXXXXXXXGOXXXXXXXXXXXXXXXXXXGOXXXXXXXXXXXXXXXXXXGXXXXXXXXXXXXXXXXXXXGOXXXXXXXXXXXXXXXXXXGOXXXXXXXXXXXXXXXXXXGXXXXXXXXXXXXXXXXXXXGOOXXXXXXXXXXXXXXXXXGOXXXXXXXXXXXXXXXXXXGOOXXXXXXXXXXXXXXXXXGOXXXXXXXXXXXXXXXXXX,0,0,0
2688,27,0,27,81,192,0,0,193,63,130,GOXXXXXXXXXXXXXXXXXXGOXXXXXXXXXXXXXXXXXXGOOXXXXXXXXXXXXXXXXXGOXXXXXXXXXXXXXXXXXXGOXXXXXXXXXXXXXXXXXXGXXXXXXXXXXXXXXXXXXXGOXXXXXXXXXXXXXXXXXXGOXXXXXXXXXXXXXXXXXXGXXXXXXXXXXXXXXXXXXXGOOXXXXXXXXXXXXXXXXXGOXXXXXXXXXXXXXXXXXXGOOXXXXXXXXXXXXXXXXXGOXXXXXXXXXXXXXXXXXX,0,0,0
2709,27,0,27,83,190,0,0,190,67,123,GOXXXXXXXXXXXXXXXXXXGOXXXXXXXXXXXXXXXXXXGOOXXXXXXXXXXXXXXXXXGOXXXXXXXXXXXXXXXXXXGOXXXXXXXXXXXXXXXXXXGXXXXXXXXXXXXXXXXXXXGOXXXXXXXXXXXXXXXXXXGOXXXXXXXXXXXXXXXXXXGXXXXXXXXXXXXXXXXXXXGOOXXXXXXXXXXXXXXXXXGOXXXXXXXXXXXXXXXXXXGOOXXXXXXXXXXXXXXXXXGOXXXXXXXXXXXXXXXXXX,0,0,0

2730,27,0,27,86,187,0,0,186,68,118,GOXXXXXXXXXXXXXXXXXXGOXXXXXXXXXXXXXXXXXXGOOXXXXXXXXXXXXXXXXXGOXXXXXXXXXXXXXXXXXXGOXXXXXXXXXXXXXXXXXXGXXXXXXXXXXXXXXXXXXXGOXXXXXXXXXXXXXXXXXXGOXXXXXXXXXXXXXXXXXXGXXXXXXXXXXXXXXXXXXXGOOXXXXXXXXXXXXXXXXXGOXXXXXXXXXXXXXXXXXXGOOXXXXXXXXXXXXXXXXXGOXXXXXXXXXXXXXXXXXX,0,0,0
2751,28,1,27,89,183,0,0,183,65,118,GOXXXXXXXXXXXXXXXXXXGOXXXXXXXXXXXXXXXXXXGOOXXXXXXXXXXXXXXXXXGOXXXXXXXXXXXXXXXXXXGOXXXXXXXXXXXXXXXXXXGXXXXXXXXXXXXXXXXXXXGOXXXXXXXXXXXXXXXXXXGOXXXXXXXXXXXXXXXXXXGXXXXXXXXXXXXXXXXXXXGOOXXXXXXXXXXXXXXXXXGOXXXXXXXXXXXXXXXXXXGOOXXXXXXXXXXXXXXXXXGOAXXXXXXXXXXXXXXXXX,0,0,0
2772,28,0,28,95,177,0,0,177,65,112,GOXXXXXXXXXXXXXXXXXXGOXXXXXXXXXXXXXXXXXXGOOXXXXXXXXXXXXXXXXXGOXXXXXXXXXXXXXXXXXXGOXXXXXXXXXXXXXXXXXXGXXXXXXXXXXXXXXXXXXXGOXXXXXXXXXXXXXXXXXXGOXXXXXXXXXXXXXXXXXXGXXXXXXXXXXXXXXXXXXXGOOXXXXXXXXXXXXXXXXXGOXXXXXXXXXXXXXXXXXXGOOXXXXXXXXXXXXXXXXXGOOXXXXXXXXXXXXXXXXX,0,0,0
2793,28,0,28,90,182,0,0,182,63,119,GOXXXXXXXXXXXXXXXXXXGOXXXXXXXXXXXXXXXXXXGOOXXXXXXXXXXXXXXXXXGOXXXXXXXXXXXXXXXXXXGOXXXXXXXXXXXXXXXXXXGXXXXXXXXXXXXXXXXXXXGOXXXXXXXXXXXXXXXXXXGOXXXXXXXXXXXXXXXXXXGXXXXXXXXXXXXXXXXXXXGOOXXXXXXXXXXXXXXXXXGOXXXXXXXXXXXXXXXXXXGOOXXXXXXXXXXXXXXXXXGOOXXXXXXXXXXXXXXXXX,0,0,0
2814,28,0,28,87,185,0,0,185,66,119,GOXXXXXXXXXXXXXXXXXXGOXXXXXXXXXXXXXXXXXXGOOXXXXXXXXXXXXXXXXXGOXXXXXXXXXXXXXXXXXXGOXXXXXXXXXXXXXXXXXXGXXXXXXXXXXXXXXXXXXXGOXXXXXXXXXXXXXXXXXXGOXXXXXXXXXXXXXXXXXXGXXXXXXXXXXXXXXXXXXXGOOXXXXXXXXXXXXXXXXXGOXXXXXXXXXXXXXXXXXXGOOXXXXXXXXXXXXXXXXXGOOXXXXXXXXXXXXXXXXX,0,0,0

2835,28,0,28,81,191,0,0,190,70,120,GOXXXXXXXXXXXXXXXXXXGOXXXXXXXXXXXXXXXXXXGOOXXXXXXXXXXXXXXXXXGOXXXXXXXXXXXXXXXXXXGOXXXXXXXXXXXXXXXXXXGXXXXXXXXXXXXXXXXXXXGOXXXXXXXXXXXXXXXXXXGOXXXXXXXXXXXXXXXXXXGXXXXXXXXXXXXXXXXXXXGOOXXXXXXXXXXXXXXXXXGOXXXXXXXXXXXXXXXXXXGOOXXXXXXXXXXXXXXXXXGOOXXXXXXXXXXXXXXXXX,0,0,0
2856,28,0,28,80,192,0,0,192,65,127,GOXXXXXXXXXXXXXXXXXXGOXXXXXXXXXXXXXXXXXXGOOXXXXXXXXXXXXXXXXXGOXXXXXXXXXXXXXXXXXXGOXXXXXXXXXXXXXXXXXXGXXXXXXXXXXXXXXXXXXXGOXXXXXXXXXXXXXXXXXXGOXXXXXXXXXXXXXXXXXXGXXXXXXXXXXXXXXXXXXXGOOXXXXXXXXXXXXXXXXXGOXXXXXXXXXXXXXXXXXXGOOXXXXXXXXXXXXXXXXXGOOXXXXXXXXXXXXXXXXX,0,0,0
2877,28,0,28,71,201,0,0,201,66,135,GOXXXXXXXXXXXXXXXXXXGOXXXXXXXXXXXXXXXXXXGOOXXXXXXXXXXXXXXXXXGOXXXXXXXXXXXXXXXXXXGOXXXXXXXXXXXXXXXXXXGXXXXXXXXXXXXXXXXXXXGOXXXXXXXXXXXXXXXXXXGOXXXXXXXXXXXXXXXXXXGXXXXXXXXXXXXXXXXXXXGOOXXXXXXXXXXXXXXXXXGOXXXXXXXXXXXXXXXXXXGOOXXXXXXXXXXXXXXXXXGOOXXXXXXXXXXXXXXXXX,0,0,0
2898,28,0,28,74,198,0,0,198,63,135,GOXXXXXXXXXXXXXXXXXXGOXXXXXXXXXXXXXXXXXXGOOXXXXXXXXXXXXXXXXXGOXXXXXXXXXXXXXXXXXXGOXXXXXXXXXXXXXXXXXXGXXXXXXXXXXXXXXXXXXXGOXXXXXXXXXXXXXXXXXXGOXXXXXXXXXXXXXXXXXXGXXXXXXXXXXXXXXXXXXXGOOXXXXXXXXXXXXXXXXXGOXXXXXXXXXXXXXXXXXXGOOXXXXXXXXXXXXXXXXXGOOXXXXXXXXXXXXXXXXX,0,0,0
2919,28,0,28,76,196,0,0,195,60,135,GOXXXXXXXXXXXXXXXXXXGOXXXXXXXXXXXXXXXXXXGOOXXXXXXXXXXXXXXXXXGOXXXXXXXXXXXXXXXXXXGOXXXXXXXXXXXXXXXXXXGXXXXXXXXXXXXXXXXXXXGOXXXXXXXXXXXXXXXXXXGOXXXXXXXXXXXXXXXXXXGXXXXXXXXXXXXXXXXXXXGOOXXXXXXXXXXXXXXXXXGOXXXXXXXXXXXXXXXXXXGOOXXXXXXXXXXXXXXXXXGOOXXXXXXXXXXXXXXXXX,0,0,0

2940,28,0,28,68,204,0,0,203,64,139,GOXXXXXXXXXXXXXXXXXXGOXXXXXXXXXXXXXXXXXXGOOXXXXXXXXXXXXXXXXXGOXXXXXXXXXXXXXXXXXXGOXXXXXXXXXXXXXXXXXXGXXXXXXXXXXXXXXXXXXXGOXXXXXXXXXXXXXXXXXXGOXXXXXXXXXXXXXXXXXXGXXXXXXXXXXXXXXXXXXXGOOXXXXXXXXXXXXXXXXXGOXXXXXXXXXXXXXXXXXXGOOXXXXXXXXXXXXXXXXXGOOXXXXXXXXXXXXXXXXX,0,0,0
2961,28,0,28,67,205,0,0,204,67,137,GOXXXXXXXXXXXXXXXXXXGOXXXXXXXXXXXXXXXXXXGOOXXXXXXXXXXXXXXXXXGOXXXXXXXXXXXXXXXXXXGOXXXXXXXXXXXXXXXXXXGXXXXXXXXXXXXXXXXXXXGOXXXXXXXXXXXXXXXXXXGOXXXXXXXXXXXXXXXXXXGXXXXXXXXXXXXXXXXXXXGOOXXXXXXXXXXXXXXXXXGOXXXXXXXXXXXXXXXXXXGOOXXXXXXXXXXXXXXXXXGOOXXXXXXXXXXXXXXXXX,0,0,0
2982,28,0,28,68,204,0,0,202,68,134,GOXXXXXXXXXXXXXXXXXXGOXXXXXXXXXXXXXXXXXXGOOXXXXXXXXXXXXXXXXXGOXXXXXXXXXXXXXXXXXXGOXXXXXXXXXXXXXXXXXXGXXXXXXXXXXXXXXXXXXXGOXXXXXXXXXXXXXXXXXXGOXXXXXXXXXXXXXXXXXXGXXXXXXXXXXXXXXXXXXXGOOXXXXXXXXXXXXXXXXXGOXXXXXXXXXXXXXXXXXXGOOXXXXXXXXXXXXXXXXXGOOXXXXXXXXXXXXXXXXX,0,0,0
3003,28,0,28,67,205,0,0,205,69,136,GOXXXXXXXXXXXXXXXXXXGOXXXXXXXXXXXXXXXXXXGOOXXXXXXXXXXXXXXXXXGOXXXXXXXXXXXXXXXXXXGOXXXXXXXXXXXXXXXXXXGXXXXXXXXXXXXXXXXXXXGOXXXXXXXXXXXXXXXXXXGOXXXXXXXXXXXXXXXXXXGXXXXXXXXXXXXXXXXXXXGOOXXXXXXXXXXXXXXXXXGOXXXXXXXXXXXXXXXXXXGOOXXXXXXXXXXXXXXXXXGOOXXXXXXXXXXXXXXXXX,0,0,0
3024,29,1,28,64,207,0,0,207,69,138,GOXXXXXXXXXXXXXXXXXXGOXXXXXXXXXXXXXXXXXXGOOXXXXXXXXXXXXXXXXXGOXXXXXXXXXXXXXXXXXXGOXXXXXXXXXXXXXXXXXXGXXXXXXXXXXXXXXXXXXXGOXXXXXXXXXXXXXXXXXXGOXXXXXXXXXXXXXXXXXXGXXXXXXXXXXXXXXXXXXXGOOXXXXXXXXXXXXXXXXXGOXXXXXXXXXXXXXXXXXXGOOAXXXXXXXXXXXXXXXXGOOXXXXXXXXXXXXXXXXX,0,0,0

3045,29,1,28,70,201,0,0,201,65,136,GOXXXXXXXXXXXXXXXXXXGOXXXXXXXXXXXXXXXXXXGOOXXXXXXXXXXXXXXXXXGOXXXXXXXXXXXXXXXXXXGOXXXXXXXXXXXXXXXXXXGXXXXXXXXXXXXXXXXXXXGOXXXXXXXXXXXXXXXXXXGOXXXXXXXXXXXXXXXXXXGXXXXXXXXXXXXXXXXXXXGOOXXXXXXXXXXXXXXXXXGOXXXXXXXXXXXXXXXXXXGOOAXXXXXXXXXXXXXXXXGOOXXXXXXXXXXXXXXXXX,0,0,0
3066,29,1,28,67,204,0,0,203,67,136,GOXXXXXXXXXXXXXXXXXXGOXXXXXXXXXXXXXXXXXXGOOXXXXXXXXXXXXXXXXXGOXXXXXXXXXXXXXXXXXXGOXXXXXXXXXXXXXXXXXXGXXXXXXXXXXXXXXXXXXXGOXXXXXXXXXXXXXXXXXXGOXXXXXXXXXXXXXXXXXXGXXXXXXXXXXXXXXXXXXXGOOXXXXXXXXXXXXXXXXXGOXXXXXXXXXXXXXXXXXXGOOAXXXXXXXXXXXXXXXXGOOXXXXXXXXXXXXXXXXX,0,0,0
3087,30,2,28,63,207,0,0,207,65,142,GOXXXXXXXXXXXXXXXXXXGOXXXXXXXXXXXXXXXXXXGOOAXXXXXXXXXXXXXXXXGOXXXXXXXXXXXXXXXXXXGOXXXXXXXXXXXXXXXXXXGXXXXXXXXXXXXXXXXXXXGOXXXXXXXXXXXXXXXXXXGOXXXXXXXXXXXXXXXXXXGXXXXXXXXXXXXXXXXXXXGOOXXXXXXXXXXXXXXXXXGOXXXXXXXXXXXXXXXXXXGOOAXXXXXXXXXXXXXXXXGOOXXXXXXXXXXXXXXXXX,0,0,0
3108,31,2,29,61,208,0,0,208,66,142,GOXXXXXXXXXXXXXXXXXXGOXXXXXXXXXXXXXXXXXXGOOAXXXXXXXXXXXXXXXXGOXXXXXXXXXXXXXXXXXXGOXXXXXXXXXXXXXXXXXXGXXXXXXXXXXXXXXXXXXXGOXXXXXXXXXXXXXXXXXXGOXXXXXXXXXXXXXXXXXXGXXXXXXXXXXXXXXXXXXXGOOAXXXXXXXXXXXXXXXXGOXXXXXXXXXXXXXXXXXXGOOOXXXXXXXXXXXXXXXXGOOXXXXXXXXXXXXXXXXX,0,0,0
3129,31,2,29,63,206,0,0,206,65,141,GOXXXXXXXXXXXXXXXXXXGOXXXXXXXXXXXXXXXXXXGOOAXXXXXXXXXXXXXXXXGOXXXXXXXXXXXXXXXXXXGOXXXXXXXXXXXXXXXXXXGXXXXXXXXXXXXXXXXXXXGOXXXXXXXXXXXXXXXXXXGOXXXXXXXXXXXXXXXXXXGXXXXXXXXXXXXXXXXXXXGOOAXXXXXXXXXXXXXXXXGOXXXXXXXXXXXXXXXXXXGOOOXXXXXXXXXXXXXXXXGOOXXXXXXXXXXXXXXXXX,0,0,0

3150,31,2,29,68,201,0,0,202,71,131,GOXXXXXXXXXXXXXXXXXXGOXXXXXXXXXXXXXXXXXXGOOAXXXXXXXXXXXXXXXXGOXXXXXXXXXXXXXXXXXXGOXXXXXXXXXXXXXXXXXXGXXXXXXXXXXXXXXXXXXXGOXXXXXXXXXXXXXXXXXXGOXXXXXXXXXXXXXXXXXXGXXXXXXXXXXXXXXXXXXXGOOAXXXXXXXXXXXXXXXXGOXXXXXXXXXXXXXXXXXXGOOOXXXXXXXXXXXXXXXXGOOXXXXXXXXXXXXXXXXX,0,0,0
3171,31,2,29,65,204,0,0,205,72,133,GOXXXXXXXXXXXXXXXXXXGOXXXXXXXXXXXXXXXXXXGOOAXXXXXXXXXXXXXXXXGOXXXXXXXXXXXXXXXXXXGOXXXXXXXXXXXXXXXXXXGXXXXXXXXXXXXXXXXXXXGOXXXXXXXXXXXXXXXXXXGOXXXXXXXXXXXXXXXXXXGXXXXXXXXXXXXXXXXXXXGOOAXXXXXXXXXXXXXXXXGOXXXXXXXXXXXXXXXXXXGOOOXXXXXXXXXXXXXXXXGOOXXXXXXXXXXXXXXXXX,0,0,0
3192,31,2,29,65,204,0,0,204,71,133,GOXXXXXXXXXXXXXXXXXXGOXXXXXXXXXXXXXXXXXXGOOAXXXXXXXXXXXXXXXXGOXXXXXXXXXXXXXXXXXXGOXXXXXXXXXXXXXXXXXXGXXXXXXXXXXXXXXXXXXXGOXXXXXXXXXXXXXXXXXXGOXXXXXXXXXXXXXXXXXXGXXXXXXXXXXXXXXXXXXXGOOAXXXXXXXXXXXXXXXXGOXXXXXXXXXXXXXXXXXXGOOOXXXXXXXXXXXXXXXXGOOXXXXXXXXXXXXXXXXX,0,0,0
3213,31,2,29,66,203,0,0,205,69,136,GOXXXXXXXXXXXXXXXXXXGOXXXXXXXXXXXXXXXXXXGOOAXXXXXXXXXXXXXXXXGOXXXXXXXXXXXXXXXXXXGOXXXXXXXXXXXXXXXXXXGXXXXXXXXXXXXXXXXXXXGOXXXXXXXXXXXXXXXXXXGOXXXXXXXXXXXXXXXXXXGXXXXXXXXXXXXXXXXXXXGOOAXXXXXXXXXXXXXXXXGOXXXXXXXXXXXXXXXXXXGOOOXXXXXXXXXXXXXXXXGOOXXXXXXXXXXXXXXXXX,0,0,0
3234,31,2,29,64,205,0,0,206,68,138,GOXXXXXXXXXXXXXXXXXXGOXXXXXXXXXXXXXXXXXXGOOAXXXXXXXXXXXXXXXXGOXXXXXXXXXXXXXXXXXXGOXXXXXXXXXXXXXXXXXXGXXXXXXXXXXXXXXXXXXXGOXXXXXXXXXXXXXXXXXXGOXXXXXXXXXXXXXXXXXXGXXXXXXXXXXXXXXXXXXXGOOAXXXXXXXXXXXXXXXXGOXXXXXXXXXXXXXXXXXXGOOOXXXXXXXXXXXXXXXXGOOXXXXXXXXXXXXXXXXX,0,0,0

3255,31,2,29,64,205,0,0,206,71,135,GOXXXXXXXXXXXXXXXXXXGOXXXXXXXXXXXXXXXXXXGOOAXXXXXXXXXXXXXXXXGOXXXXXXXXXXXXXXXXXXGOXXXXXXXXXXXXXXXXXXGXXXXXXXXXXXXXXXXXXXGOXXXXXXXXXXXXXXXXXXGOXXXXXXXXXXXXXXXXXXGXXXXXXXXXXXXXXXXXXXGOOAXXXXXXXXXXXXXXXXGOXXXXXXXXXXXXXXXXXXGOOOXXXXXXXXXXXXXXXXGOOXXXXXXXXXXXXXXXXX,0,0,0
3276,31,2,29,56,213,0,0,212,71,141,GOXXXXXXXXXXXXXXXXXXGOXXXXXXXXXXXXXXXXXXGOOAXXXXXXXXXXXXXXXXGOXXXXXXXXXXXXXXXXXXGOXXXXXXXXXXXXXXXXXXGXXXXXXXXXXXXXXXXXXXGOXXXXXXXXXXXXXXXXXXGOXXXXXXXXXXXXXXXXXXGXXXXXXXXXXXXXXXXXXXGOOAXXXXXXXXXXXXXXXXGOXXXXXXXXXXXXXXXXXXGOOOXXXXXXXXXXXXXXXXGOOXXXXXXXXXXXXXXXXX,0,0,0
3297,31,2,29,57,212,0,0,212,72,140,GOXXXXXXXXXXXXXXXXXXGOXXXXXXXXXXXXXXXXXXGOOAXXXXXXXXXXXXXXXXGOXXXXXXXXXXXXXXXXXXGOXXXXXXXXXXXXXXXXXXGXXXXXXXXXXXXXXXXXXXGOXXXXXXXXXXXXXXXXXXGOXXXXXXXXXXXXXXXXXXGXXXXXXXXXXXXXXXXXXXGOOAXXXXXXXXXXXXXXXXGOXXXXXXXXXXXXXXXXXXGOOOXXXXXXXXXXXXXXXXGOOXXXXXXXXXXXXXXXXX,0,0,0
3318,31,2,29,58,211,0,0,210,71,139,GOXXXXXXXXXXXXXXXXXXGOXXXXXXXXXXXXXXXXXXGOOAXXXXXXXXXXXXXXXXGOXXXXXXXXXXXXXXXXXXGOXXXXXXXXXXXXXXXXXXGXXXXXXXXXXXXXXXXXXXGOXXXXXXXXXXXXXXXXXXGOXXXXXXXXXXXXXXXXXXGXXXXXXXXXXXXXXXXXXXGOOAXXXXXXXXXXXXXXXXGOXXXXXXXXXXXXXXXXXXGOOOXXXXXXXXXXXXXXXXGOOXXXXXXXXXXXXXXXXX,0,0,0
3339,31,1,30,60,209,0,0,209,73,136,GOXXXXXXXXXXXXXXXXXXGOXXXXXXXXXXXXXXXXXXGOOOXXXXXXXXXXXXXXXXGOXXXXXXXXXXXXXXXXXXGOXXXXXXXXXXXXXXXXXXGXXXXXXXXXXXXXXXXXXXGOXXXXXXXXXXXXXXXXXXGOXXXXXXXXXXXXXXXXXXGXXXXXXXXXXXXXXXXXXXGOOAXXXXXXXXXXXXXXXXGOXXXXXXXXXXXXXXXXXXGOOOXXXXXXXXXXXXXXXXGOOXXXXXXXXXXXXXXXXX,0,0,0

3360,31,1,30,59,210,0,0,210,79,131,GOXXXXXXXXXXXXXXXXXXGOXXXXXXXXXXXXXXXXXXGOOOXXXXXXXXXXXXXXXXGOXXXXXXXXXXXXXXXXXXGOXXXXXXXXXXXXXXXXXXGXXXXXXXXXXXXXXXXXXXGOXXXXXXXXXXXXXXXXXXGOXXXXXXXXXXXXXXXXXXGXXXXXXXXXXXXXXXXXXXGOOAXXXXXXXXXXXXXXXXGOXXXXXXXXXXXXXXXXXXGOOOXXXXXXXXXXXXXXXXGOOXXXXXXXXXXXXXXXXX,0,0,0
3381,31,1,30,63,206,0,0,205,76,129,GOXXXXXXXXXXXXXXXXXXGOXXXXXXXXXXXXXXXXXXGOOOXXXXXXXXXXXXXXXXGOXXXXXXXXXXXXXXXXXXGOXXXXXXXXXXXXXXXXXXGXXXXXXXXXXXXXXXXXXXGOXXXXXXXXXXXXXXXXXXGOXXXXXXXXXXXXXXXXXXGXXXXXXXXXXXXXXXXXXXGOOAXXXXXXXXXXXXXXXXGOXXXXXXXXXXXXXXXXXXGOOOXXXXXXXXXXXXXXXXGOOXXXXXXXXXXXXXXXXX,0,0,0
3402,31,0,31,69,200,0,0,200,70,130,GOXXXXXXXXXXXXXXXXXXGOXXXXXXXXXXXXXXXXXXGOOOXXXXXXXXXXXXXXXXGOXXXXXXXXXXXXXXXXXXGOXXXXXXXXXXXXXXXXXXGXXXXXXXXXXXXXXXXXXXGOXXXXXXXXXXXXXXXXXXGOXXXXXXXXXXXXXXXXXXGXXXXXXXXXXXXXXXXXXXGOOOXXXXXXXXXXXXXXXXGOXXXXXXXXXXXXXXXXXXGOOOXXXXXXXXXXXXXXXXGOOXXXXXXXXXXXXXXXXX,0,0,0
3423,32,1,31,67,201,0,0,201,78,123,GOXXXXXXXXXXXXXXXXXXGOXXXXXXXXXXXXXXXXXXGOOOXXXXXXXXXXXXXXXXGOXXXXXXXXXXXXXXXXXXGOAXXXXXXXXXXXXXXXXXGXXXXXXXXXXXXXXXXXXXGOXXXXXXXXXXXXXXXXXXGOXXXXXXXXXXXXXXXXXXGXXXXXXXXXXXXXXXXXXXGOOOXXXXXXXXXXXXXXXXGOXXXXXXXXXXXXXXXXXXGOOOXXXXXXXXXXXXXXXXGOOXXXXXXXXXXXXXXXXX,0,0,0
3444,32,1,31,77,191,0,0,191,72,119,GOXXXXXXXXXXXXXXXXXXGOXXXXXXXXXXXXXXXXXXGOOOXXXXXXXXXXXXXXXXGOXXXXXXXXXXXXXXXXXXGOAXXXXXXXXXXXXXXXXXGXXXXXXXXXXXXXXXXXXXGOXXXXXXXXXXXXXXXXXXGOXXXXXXXXXXXXXXXXXXGXXXXXXXXXXXXXXXXXXXGOOOXXXXXXXXXXXXXXXXGOXXXXXXXXXXXXXXXXXXGOOOXXXXXXXXXXXXXXXXGOOXXXXXXXXXXXXXXXXX,0,0,0

3465,32,1,31,76,192,0,0,192,72,120,GOXXXXXXXXXXXXXXXXXXGOXXXXXXXXXXXXXXXXXXGOOOXXXXXXXXXXXXXXXXGOXXXXXXXXXXXXXXXXXXGOAXXXXXXXXXXXXXXXXXGXXXXXXXXXXXXXXXXXXXGOXXXXXXXXXXXXXXXXXXGOXXXXXXXXXXXXXXXXXXGXXXXXXXXXXXXXXXXXXXGOOOXXXXXXXXXXXXXXXXGOXXXXXXXXXXXXXXXXXXGOOOXXXXXXXXXXXXXXXXGOOXXXXXXXXXXXXXXXXX,0,0,0
3486,32,1,31,78,190,0,0,190,73,117,GOXXXXXXXXXXXXXXXXXXGOXXXXXXXXXXXXXXXXXXGOOOXXXXXXXXXXXXXXXXGOXXXXXXXXXXXXXXXXXXGOAXXXXXXXXXXXXXXXXXGXXXXXXXXXXXXXXXXXXXGOXXXXXXXXXXXXXXXXXXGOXXXXXXXXXXXXXXXXXXGXXXXXXXXXXXXXXXXXXXGOOOXXXXXXXXXXXXXXXXGOXXXXXXXXXXXXXXXXXXGOOOXXXXXXXXXXXXXXXXGOOXXXXXXXXXXXXXXXXX,0,0,0
3507,32,1,31,77,191,0,0,190,74,116,GOXXXXXXXXXXXXXXXXXXGOXXXXXXXXXXXXXXXXXXGOOOXXXXXXXXXXXXXXXXGOXXXXXXXXXXXXXXXXXXGOAXXXXXXXXXXXXXXXXXGXXXXXXXXXXXXXXXXXXXGOXXXXXXXXXXXXXXXXXXGOXXXXXXXXXXXXXXXXXXGXXXXXXXXXXXXXXXXXXXGOOOXXXXXXXXXXXXXXXXGOXXXXXXXXXXXXXXXXXXGOOOXXXXXXXXXXXXXXXXGOOXXXXXXXXXXXXXXXXX,0,0,0
3528,32,1,31,81,187,0,0,187,76,111,GOXXXXXXXXXXXXXXXXXXGOXXXXXXXXXXXXXXXXXXGOOOXXXXXXXXXXXXXXXXGOXXXXXXXXXXXXXXXXXXGOAXXXXXXXXXXXXXXXXXGXXXXXXXXXXXXXXXXXXXGOXXXXXXXXXXXXXXXXXXGOXXXXXXXXXXXXXXXXXXGXXXXXXXXXXXXXXXXXXXGOOOXXXXXXXXXXXXXXXXGOXXXXXXXXXXXXXXXXXXGOOOXXXXXXXXXXXXXXXXGOOXXXXXXXXXXXXXXXXX,0,0,0
3549,33,2,31,79,188,0,0,188,74,114,GOXXXXXXXXXXXXXXXXXXGOXXXXXXXXXXXXXXXXXXGOOOXXXXXXXXXXXXXXXXGOXXXXXXXXXXXXXXXXXXGOAXXXXXXXXXXXXXXXXXGXXXXXXXXXXXXXXXXXXXGOXXXXXXXXXXXXXXXXXXGOXXXXXXXXXXXXXXXXXXGAXXXXXXXXXXXXXXXXXXGOOOXXXXXXXXXXXXXXXXGOXXXXXXXXXXXXXXXXXXGOOOXXXXXXXXXXXXXXXXGOOXXXXXXXXXXXXXXXXX,0,0,0

3570,33,2,31,72,195,0,0,195,79,116,GOXXXXXXXXXXXXXXXXXXGOXXXXXXXXXXXXXXXXXXGOOOXXXXXXXXXXXXXXXXGOXXXXXXXXXXXXXXXXXXGOAXXXXXXXXXXXXXXXXXGXXXXXXXXXXXXXXXXXXXGOXXXXXXXXXXXXXXXXXXGOXXXXXXXXXXXXXXXXXXGAXXXXXXXXXXXXXXXXXXGOOOXXXXXXXXXXXXXXXXGOXXXXXXXXXXXXXXXXXXGOOOXXXXXXXXXXXXXXXXGOOXXXXXXXXXXXXXXXXX,0,0,0
3591,34,3,31,75,191,0,0,190,78,112,GOXXXXXXXXXXXXXXXXXXGOXXXXXXXXXXXXXXXXXXGOOOXXXXXXXXXXXXXXXXGOXXXXXXXXXXXXXXXXXXGOAXXXXXXXXXXXXXXXXXGXXXXXXXXXXXXXXXXXXXGOAXXXXXXXXXXXXXXXXXGOXXXXXXXXXXXXXXXXXXGAXXXXXXXXXXXXXXXXXXGOOOXXXXXXXXXXXXXXXXGOXXXXXXXXXXXXXXXXXXGOOOXXXXXXXXXXXXXXXXGOOXXXXXXXXXXXXXXXXX,0,0,0
3612,34,2,32,76,190,0,0,190,76,114,GOXXXXXXXXXXXXXXXXXXGOXXXXXXXXXXXXXXXXXXGOOOXXXXXXXXXXXXXXXXGOXXXXXXXXXXXXXXXXXXGOOXXXXXXXXXXXXXXXXXGXXXXXXXXXXXXXXXXXXXGOAXXXXXXXXXXXXXXXXXGOXXXXXXXXXXXXXXXXXXGAXXXXXXXXXXXXXXXXXXGOOOXXXXXXXXXXXXXXXXGOXXXXXXXXXXXXXXXXXXGOOOXXXXXXXXXXXXXXXXGOOXXXXXXXXXXXXXXXXX,0,0,0
3633,34,1,33,77,189,0,0,189,77,112,GOXXXXXXXXXXXXXXXXXXGOXXXXXXXXXXXXXXXXXXGOOOXXXXXXXXXXXXXXXXGOXXXXXXXXXXXXXXXXXXGOOXXXXXXXXXXXXXXXXXGXXXXXXXXXXXXXXXXXXXGOAXXXXXXXXXXXXXXXXXGOXXXXXXXXXXXXXXXXXXGOXXXXXXXXXXXXXXXXXXGOOOXXXXXXXXXXXXXXXXGOXXXXXXXXXXXXXXXXXXGOOOXXXXXXXXXXXXXXXXGOOXXXXXXXXXXXXXXXXX,0,0,0
3654,34,1,33,72,194,0,0,195,80,115,GOXXXXXXXXXXXXXXXXXXGOXXXXXXXXXXXXXXXXXXGOOOXXXXXXXXXXXXXXXXGOXXXXXXXXXXXXXXXXXXGOOXXXXXXXXXXXXXXXXXGXXXXXXXXXXXXXXXXXXXGOAXXXXXXXXXXXXXXXXXGOXXXXXXXXXXXXXXXXXXGOXXXXXXXXXXXXXXXXXXGOOOXXXXXXXXXXXXXXXXGOXXXXXXXXXXXXXXXXXXGOOOXXXXXXXXXXXXXXXXGOOXXXXXXXXXXXXXXXXX,0,0,0

3675,34,1,33,69,197,0,0,196,76,120,GOXXXXXXXXXXXXXXXXXXGOXXXXXXXXXXXXXXXXXXGOOOXXXXXXXXXXXXXXXXGOXXXXXXXXXXXXXXXXXXGOOXXXXXXXXXXXXXXXXXGXXXXXXXXXXXXXXXXXXXGOAXXXXXXXXXXXXXXXXXGOXXXXXXXXXXXXXXXXXXGOXXXXXXXXXXXXXXXXXXGOOOXXXXXXXXXXXXXXXXGOXXXXXXXXXXXXXXXXXXGOOOXXXXXXXXXXXXXXXXGOOXXXXXXXXXXXXXXXXX,0,0,0
3696,34,1,33,65,201,0,0,201,78,123,GOXXXXXXXXXXXXXXXXXXGOXXXXXXXXXXXXXXXXXXGOOOXXXXXXXXXXXXXXXXGOXXXXXXXXXXXXXXXXXXGOOXXXXXXXXXXXXXXXXXGXXXXXXXXXXXXXXXXXXXGOAXXXXXXXXXXXXXXXXXGOXXXXXXXXXXXXXXXXXXGOXXXXXXXXXXXXXXXXXXGOOOXXXXXXXXXXXXXXXXGOXXXXXXXXXXXXXXXXXXGOOOXXXXXXXXXXXXXXXXGOOXXXXXXXXXXXXXXXXX,0,0,0
3717,34,1,33,65,201,0,0,202,82,120,GOXXXXXXXXXXXXXXXXXXGOXXXXXXXXXXXXXXXXXXGOOOXXXXXXXXXXXXXXXXGOXXXXXXXXXXXXXXXXXXGOOXXXXXXXXXXXXXXXXXGXXXXXXXXXXXXXXXXXXXGOAXXXXXXXXXXXXXXXXXGOXXXXXXXXXXXXXXXXXXGOXXXXXXXXXXXXXXXXXXGOOOXXXXXXXXXXXXXXXXGOXXXXXXXXXXXXXXXXXXGOOOXXXXXXXXXXXXXXXXGOOXXXXXXXXXXXXXXXXX,0,0,0
3738,34,1,33,68,198,0,0,198,80,118,GOXXXXXXXXXXXXXXXXXXGOXXXXXXXXXXXXXXXXXXGOOOXXXXXXXXXXXXXXXXGOXXXXXXXXXXXXXXXXXXGOOXXXXXXXXXXXXXXXXXGXXXXXXXXXXXXXXXXXXXGOAXXXXXXXXXXXXXXXXXGOXXXXXXXXXXXXXXXXXXGOXXXXXXXXXXXXXXXXXXGOOOXXXXXXXXXXXXXXXXGOXXXXXXXXXXXXXXXXXXGOOOXXXXXXXXXXXXXXXXGOOXXXXXXXXXXXXXXXXX,0,0,0
3759,34,1,33,67,199,0,0,200,80,120,GOXXXXXXXXXXXXXXXXXXGOXXXXXXXXXXXXXXXXXXGOOOXXXXXXXXXXXXXXXXGOXXXXXXXXXXXXXXXXXXGOOXXXXXXXXXXXXXXXXXGXXXXXXXXXXXXXXXXXXXGOAXXXXXXXXXXXXXXXXXGOXXXXXXXXXXXXXXXXXXGOXXXXXXXXXXXXXXXXXXGOOOXXXXXXXXXXXXXXXXGOXXXXXXXXXXXXXXXXXXGOOOXXXXXXXXXXXXXXXXGOOXXXXXXXXXXXXXXXXX,0,0,0

3780,34,1,33,66,200,0,0,200,82,118,GOXXXXXXXXXXXXXXXXXXGOXXXXXXXXXXXXXXXXXXGOOOXXXXXXXXXXXXXXXXGOXXXXXXXXXXXXXXXXXXGOOXXXXXXXXXXXXXXXXXGXXXXXXXXXXXXXXXXXXXGOAXXXXXXXXXXXXXXXXXGOXXXXXXXXXXXXXXXXXXGOXXXXXXXXXXXXXXXXXXGOOOXXXXXXXXXXXXXXXXGOXXXXXXXXXXXXXXXXXXGOOOXXXXXXXXXXXXXXXXGOOXXXXXXXXXXXXXXXXX,0,0,0
3801,34,1,33,68,198,0,0,200,78,122,GOXXXXXXXXXXXXXXXXXXGOXXXXXXXXXXXXXXXXXXGOOOXXXXXXXXXXXXXXXXGOXXXXXXXXXXXXXXXXXXGOOXXXXXXXXXXXXXXXXXGXXXXXXXXXXXXXXXXXXXGOAXXXXXXXXXXXXXXXXXGOXXXXXXXXXXXXXXXXXXGOXXXXXXXXXXXXXXXXXXGOOOXXXXXXXXXXXXXXXXGOXXXXXXXXXXXXXXXXXXGOOOXXXXXXXXXXXXXXXXGOOXXXXXXXXXXXXXXXXX,0,0,0
3822,34,1,33,64,202,0,0,204,82,122,GOXXXXXXXXXXXXXXXXXXGOXXXXXXXXXXXXXXXXXXGOOOXXXXXXXXXXXXXXXXGOXXXXXXXXXXXXXXXXXXGOOXXXXXXXXXXXXXXXXXGXXXXXXXXXXXXXXXXXXXGOAXXXXXXXXXXXXXXXXXGOXXXXXXXXXXXXXXXXXXGOXXXXXXXXXXXXXXXXXXGOOOXXXXXXXXXXXXXXXXGOXXXXXXXXXXXXXXXXXXGOOOXXXXXXXXXXXXXXXXGOOXXXXXXXXXXXXXXXXX,0,0,0
3843,34,0,34,62,204,0,0,206,79,127,GOXXXXXXXXXXXXXXXXXXGOXXXXXXXXXXXXXXXXXXGOOOXXXXXXXXXXXXXXXXGOXXXXXXXXXXXXXXXXXXGOOXXXXXXXXXXXXXXXXXGXXXXXXXXXXXXXXXXXXXGOOXXXXXXXXXXXXXXXXXGOXXXXXXXXXXXXXXXXXXGOXXXXXXXXXXXXXXXXXXGOOOXXXXXXXXXXXXXXXXGOXXXXXXXXXXXXXXXXXXGOOOXXXXXXXXXXXXXXXXGOOXXXXXXXXXXXXXXXXX,0,0,0
3864,34,0,34,60,206,0,0,208,76,132,GOXXXXXXXXXXXXXXXXXXGOXXXXXXXXXXXXXXXXXXGOOOXXXXXXXXXXXXXXXXGOXXXXXXXXXXXXXXXXXXGOOXXXXXXXXXXXXXXXXXGXXXXXXXXXXXXXXXXXXXGOOXXXXXXXXXXXXXXXXXGOXXXXXXXXXXXXXXXXXXGOXXXXXXXXXXXXXXXXXXGOOOXXXXXXXXXXXXXXXXGOXXXXXXXXXXXXXXXXXXGOOOXXXXXXXXXXXXXXXXGOOXXXXXXXXXXXXXXXXX,0,0,0

3885,34,0,34,63,203,0,0,206,84,122,GOXXXXXXXXXXXXXXXXXXGOXXXXXXXXXXXXXXXXXXGOOOXXXXXXXXXXXXXXXXGOXXXXXXXXXXXXXXXXXXGOOXXXXXXXXXXXXXXXXXGXXXXXXXXXXXXXXXXXXXGOOXXXXXXXXXXXXXXXXXGOXXXXXXXXXXXXXXXXXXGOXXXXXXXXXXXXXXXXXXGOOOXXXXXXXXXXXXXXXXGOXXXXXXXXXXXXXXXXXXGOOOXXXXXXXXXXXXXXXXGOOXXXXXXXXXXXXXXXXX,0,0,0
3906,34,0,34,64,202,0,0,201,86,115,GOXXXXXXXXXXXXXXXXXXGOXXXXXXXXXXXXXXXXXXGOOOXXXXXXXXXXXXXXXXGOXXXXXXXXXXXXXXXXXXGOOXXXXXXXXXXXXXXXXXGXXXXXXXXXXXXXXXXXXXGOOXXXXXXXXXXXXXXXXXGOXXXXXXXXXXXXXXXXXXGOXXXXXXXXXXXXXXXXXXGOOOXXXXXXXXXXXXXXXXGOXXXXXXXXXXXXXXXXXXGOOOXXXXXXXXXXXXXXXXGOOXXXXXXXXXXXXXXXXX,0,0,0
3927,34,0,34,70,196,0,0,197,82,115,GOXXXXXXXXXXXXXXXXXXGOXXXXXXXXXXXXXXXXXXGOOOXXXXXXXXXXXXXXXXGOXXXXXXXXXXXXXXXXXXGOOXXXXXXXXXXXXXXXXXGXXXXXXXXXXXXXXXXXXXGOOXXXXXXXXXXXXXXXXXGOXXXXXXXXXXXXXXXXXXGOXXXXXXXXXXXXXXXXXXGOOOXXXXXXXXXXXXXXXXGOXXXXXXXXXXXXXXXXXXGOOOXXXXXXXXXXXXXXXXGOOXXXXXXXXXXXXXXXXX,0,0,0
3948,34,0,34,72,194,0,0,195,89,106,GOXXXXXXXXXXXXXXXXXXGOXXXXXXXXXXXXXXXXXXGOOOXXXXXXXXXXXXXXXXGOXXXXXXXXXXXXXXXXXXGOOXXXXXXXXXXXXXXXXXGXXXXXXXXXXXXXXXXXXXGOOXXXXXXXXXXXXXXXXXGOXXXXXXXXXXXXXXXXXXGOXXXXXXXXXXXXXXXXXXGOOOXXXXXXXXXXXXXXXXGOXXXXXXXXXXXXXXXXXXGOOOXXXXXXXXXXXXXXXXGOOXXXXXXXXXXXXXXXXX,0,0,0
3969,34,0,34,73,193,0,0,191,87,104,GOXXXXXXXXXXXXXXXXXXGOXXXXXXXXXXXXXXXXXXGOOOXXXXXXXXXXXXXXXXGOXXXXXXXXXXXXXXXXXXGOOXXXXXXXXXXXXXXXXXGXXXXXXXXXXXXXXXXXXXGOOXXXXXXXXXXXXXXXXXGOXXXXXXXXXXXXXXXXXXGOXXXXXXXXXXXXXXXXXXGOOOXXXXXXXXXXXXXXXXGOXXXXXXXXXXXXXXXXXXGOOOXXXXXXXXXXXXXXXXGOOXXXXXXXXXXXXXXXXX,0,0,0

3990,34,0,34,72,194,0,0,194,88,106,GOXXXXXXXXXXXXXXXXXXGOXXXXXXXXXXXXXXXXXXGOOOXXXXXXXXXXXXXXXXGOXXXXXXXXXXXXXXXXXXGOOXXXXXXXXXXXXXXXXXGXXXXXXXXXXXXXXXXXXXGOOXXXXXXXXXXXXXXXXXGOXXXXXXXXXXXXXXXXXXGOXXXXXXXXXXXXXXXXXXGOOOXXXXXXXXXXXXXXXXGOXXXXXXXXXXXXXXXXXXGOOOXXXXXXXXXXXXXXXXGOOXXXXXXXXXXXXXXXXX,0,0,0
4011,34,0,34,72,194,0,0,195,89,106,GOXXXXXXXXXXXXXXXXXXGOXXXXXXXXXXXXXXXXXXGOOOXXXXXXXXXXXXXXXXGOXXXXXXXXXXXXXXXXXXGOOXXXXXXXXXXXXXXXXXGXXXXXXXXXXXXXXXXXXXGOOXXXXXXXXXXXXXXXXXGOXXXXXXXXXXXXXXXXXXGOXXXXXXXXXXXXXXXXXXGOOOXXXXXXXXXXXXXXXXGOXXXXXXXXXXXXXXXXXXGOOOXXXXXXXXXXXXXXXXGOOXXXXXXXXXXXXXXXXX,0,0,0
4032,34,0,34,68,198,0,0,197,94,103,GOXXXXXXXXXXXXXXXXXXGOXXXXXXXXXXXXXXXXXXGOOOXXXXXXXXXXXXXXXXGOXXXXXXXXXXXXXXXXXXGOOXXXXXXXXXXXXXXXXXGXXXXXXXXXXXXXXXXXXXGOOXXXXXXXXXXXXXXXXXGOXXXXXXXXXXXXXXXXXXGOXXXXXXXXXXXXXXXXXXGOOOXXXXXXXXXXXXXXXXGOXXXXXXXXXXXXXXXXXXGOOOXXXXXXXXXXXXXXXXGOOXXXXXXXXXXXXXXXXX,0,0,0
4053,34,0,34,68,198,0,0,199,96,103,GOXXXXXXXXXXXXXXXXXXGOXXXXXXXXXXXXXXXXXXGOOOXXXXXXXXXXXXXXXXGOXXXXXXXXXXXXXXXXXXGOOXXXXXXXXXXXXXXXXXGXXXXXXXXXXXXXXXXXXXGOOXXXXXXXXXXXXXXXXXGOXXXXXXXXXXXXXXXXXXGOXXXXXXXXXXXXXXXXXXGOOOXXXXXXXXXXXXXXXXGOXXXXXXXXXXXXXXXXXXGOOOXXXXXXXXXXXXXXXXGOOXXXXXXXXXXXXXXXXX,0,0,0
4074,34,0,34,67,199,0,0,200,90,110,GOXXXXXXXXXXXXXXXXXXGOXXXXXXXXXXXXXXXXXXGOOOXXXXXXXXXXXXXXXXGOXXXXXXXXXXXXXXXXXXGOOXXXXXXXXXXXXXXXXXGXXXXXXXXXXXXXXXXXXXGOOXXXXXXXXXXXXXXXXXGOXXXXXXXXXXXXXXXXXXGOXXXXXXXXXXXXXXXXXXGOOOXXXXXXXXXXXXXXXXGOXXXXXXXXXXXXXXXXXXGOOOXXXXXXXXXXXXXXXXGOOXXXXXXXXXXXXXXXXX,0,0,0

4095,35,1,34,63,202,0,0,203,90,113,GOXXXXXXXXXXXXXXXXXXGOAXXXXXXXXXXXXXXXXXGOOOXXXXXXXXXXXXXXXXGOXXXXXXXXXXXXXXXXXXGOOXXXXXXXXXXXXXXXXXGXXXXXXXXXXXXXXXXXXXGOOXXXXXXXXXXXXXXXXXGOXXXXXXXXXXXXXXXXXXGOXXXXXXXXXXXXXXXXXXGOOOXXXXXXXXXXXXXXXXGOXXXXXXXXXXXXXXXXXXGOOOXXXXXXXXXXXXXXXXGOOXXXXXXXXXXXXXXXXX,0,0,0
4116,35,1,34,56,209,0,0,210,90,120,GOXXXXXXXXXXXXXXXXXXGOAXXXXXXXXXXXXXXXXXGOOOXXXXXXXXXXXXXXXXGOXXXXXXXXXXXXXXXXXXGOOXXXXXXXXXXXXXXXXXGXXXXXXXXXXXXXXXXXXXGOOXXXXXXXXXXXXXXXXXGOXXXXXXXXXXXXXXXXXXGOXXXXXXXXXXXXXXXXXXGOOOXXXXXXXXXXXXXXXXGOXXXXXXXXXXXXXXXXXXGOOOXXXXXXXXXXXXXXXXGOOXXXXXXXXXXXXXXXXX,0,0,0
4137,35,1,34,57,208,0,0,209,90,119,GOXXXXXXXXXXXXXXXXXXGOAXXXXXXXXXXXXXXXXXGOOOXXXXXXXXXXXXXXXXGOXXXXXXXXXXXXXXXXXXGOOXXXXXXXXXXXXXXXXXGXXXXXXXXXXXXXXXXXXXGOOXXXXXXXXXXXXXXXXXGOXXXXXXXXXXXXXXXXXXGOXXXXXXXXXXXXXXXXXXGOOOXXXXXXXXXXXXXXXXGOXXXXXXXXXXXXXXXXXXGOOOXXXXXXXXXXXXXXXXGOOXXXXXXXXXXXXXXXXX,0,0,0
4158,35,1,34,58,207,0,0,207,87,120,GOXXXXXXXXXXXXXXXXXXGOAXXXXXXXXXXXXXXXXXGOOOXXXXXXXXXXXXXXXXGOXXXXXXXXXXXXXXXXXXGOOXXXXXXXXXXXXXXXXXGXXXXXXXXXXXXXXXXXXXGOOXXXXXXXXXXXXXXXXXGOXXXXXXXXXXXXXXXXXXGOXXXXXXXXXXXXXXXXXXGOOOXXXXXXXXXXXXXXXXGOXXXXXXXXXXXXXXXXXXGOOOXXXXXXXXXXXXXXXXGOOXXXXXXXXXXXXXXXXX,0,0,0
4179,35,1,34,58,207,0,0,206,92,114,GOXXXXXXXXXXXXXXXXXXGOAXXXXXXXXXXXXXXXXXGOOOXXXXXXXXXXXXXXXXGOXXXXXXXXXXXXXXXXXXGOOXXXXXXXXXXXXXXXXXGXXXXXXXXXXXXXXXXXXXGOOXXXXXXXXXXXXXXXXXGOXXXXXXXXXXXXXXXXXXGOXXXXXXXXXXXXXXXXXXGOOOXXXXXXXXXXXXXXXXGOXXXXXXXXXXXXXXXXXXGOOOXXXXXXXXXXXXXXXXGOOXXXXXXXXXXXXXXXXX,0,0,0

4200,35,0,35,60,205,0,0,205,94,111,GOXXXXXXXXXXXXXXXXXXGOOXXXXXXXXXXXXXXXXXGOOOXXXXXXXXXXXXXXXXGOXXXXXXXXXXXXXXXXXXGOOXXXXXXXXXXXXXXXXXGXXXXXXXXXXXXXXXXXXXGOOXXXXXXXXXXXXXXXXXGOXXXXXXXXXXXXXXXXXXGOXXXXXXXXXXXXXXXXXXGOOOXXXXXXXXXXXXXXXXGOXXXXXXXXXXXXXXXXXXGOOOXXXXXXXXXXXXXXXXGOOXXXXXXXXXXXXXXXXX,0,0,0
4221,35,0,35,68,197,0,0,197,86,111,GOXXXXXXXXXXXXXXXXXXGOOXXXXXXXXXXXXXXXXXGOOOXXXXXXXXXXXXXXXXGOXXXXXXXXXXXXXXXXXXGOOXXXXXXXXXXXXXXXXXGXXXXXXXXXXXXXXXXXXXGOOXXXXXXXXXXXXXXXXXGOXXXXXXXXXXXXXXXXXXGOXXXXXXXXXXXXXXXXXXGOOOXXXXXXXXXXXXXXXXGOXXXXXXXXXXXXXXXXXXGOOOXXXXXXXXXXXXXXXXGOOXXXXXXXXXXXXXXXXX,0,0,0
4242,35,0,35,65,200,0,0,200,91,109,GOXXXXXXXXXXXXXXXXXXGOOXXXXXXXXXXXXXXXXXGOOOXXXXXXXXXXXXXXXXGOXXXXXXXXXXXXXXXXXXGOOXXXXXXXXXXXXXXXXXGXXXXXXXXXXXXXXXXXXXGOOXXXXXXXXXXXXXXXXXGOXXXXXXXXXXXXXXXXXXGOXXXXXXXXXXXXXXXXXXGOOOXXXXXXXXXXXXXXXXGOXXXXXXXXXXXXXXXXXXGOOOXXXXXXXXXXXXXXXXGOOXXXXXXXXXXXXXXXXX,0,0,0
4263,35,0,35,62,203,0,0,203,95,108,GOXXXXXXXXXXXXXXXXXXGOOXXXXXXXXXXXXXXXXXGOOOXXXXXXXXXXXXXXXXGOXXXXXXXXXXXXXXXXXXGOOXXXXXXXXXXXXXXXXXGXXXXXXXXXXXXXXXXXXXGOOXXXXXXXXXXXXXXXXXGOXXXXXXXXXXXXXXXXXXGOXXXXXXXXXXXXXXXXXXGOOOXXXXXXXXXXXXXXXXGOXXXXXXXXXXXXXXXXXXGOOOXXXXXXXXXXXXXXXXGOOXXXXXXXXXXXXXXXXX,0,0,0
4284,36,1,35,66,198,0,0,198,90,108,GOXXXXXXXXXXXXXXXXXXGOOXXXXXXXXXXXXXXXXXGOOOXXXXXXXXXXXXXXXXGOXXXXXXXXXXXXXXXXXXGOOXXXXXXXXXXXXXXXXXGXXXXXXXXXXXXXXXXXXXGOOXXXXXXXXXXXXXXXXXGOXXXXXXXXXXXXXXXXXXGOXXXXXXXXXXXXXXXXXXGOOOXXXXXXXXXXXXXXXXGOXXXXXXXXXXXXXXXXXXGOOOXXXXXXXXXXXXXXXXGOOAXXXXXXXXXXXXXXXX,0,0,0

4305,36,0,36,62,202,0,0,201,90,111,GOXXXXXXXXXXXXXXXXXXGOOXXXXXXXXXXXXXXXXXGOOOXXXXXXXXXXXXXXXXGOXXXXXXXXXXXXXXXXXXGOOXXXXXXXXXXXXXXXXXGXXXXXXXXXXXXXXXXXXXGOOXXXXXXXXXXXXXXXXXGOXXXXXXXXXXXXXXXXXXGOXXXXXXXXXXXXXXXXXXGOOOXXXXXXXXXXXXXXXXGOXXXXXXXXXXXXXXXXXXGOOOXXXXXXXXXXXXXXXXGOOOXXXXXXXXXXXXXXXX,0,0,0
4326,36,0,36,60,204,0,0,204,93,111,GOXXXXXXXXXXXXXXXXXXGOOXXXXXXXXXXXXXXXXXGOOOXXXXXXXXXXXXXXXXGOXXXXXXXXXXXXXXXXXXGOOXXXXXXXXXXXXXXXXXGXXXXXXXXXXXXXXXXXXXGOOXXXXXXXXXXXXXXXXXGOXXXXXXXXXXXXXXXXXXGOXXXXXXXXXXXXXXXXXXGOOOXXXXXXXXXXXXXXXXGOXXXXXXXXXXXXXXXXXXGOOOXXXXXXXXXXXXXXXXGOOOXXXXXXXXXXXXXXXX,0,0,0
4347,36,0,36,63,201,0,0,201,93,108,GOXXXXXXXXXXXXXXXXXXGOOXXXXXXXXXXXXXXXXXGOOOXXXXXXXXXXXXXXXXGOXXXXXXXXXXXXXXXXXXGOOXXXXXXXXXXXXXXXXXGXXXXXXXXXXXXXXXXXXXGOOXXXXXXXXXXXXXXXXXGOXXXXXXXXXXXXXXXXXXGOXXXXXXXXXXXXXXXXXXGOOOXXXXXXXXXXXXXXXXGOXXXXXXXXXXXXXXXXXXGOOOXXXXXXXXXXXXXXXXGOOOXXXXXXXXXXXXXXXX,0,0,0
4368,36,0,36,68,196,0,0,196,91,105,GOXXXXXXXXXXXXXXXXXXGOOXXXXXXXXXXXXXXXXXGOOOXXXXXXXXXXXXXXXXGOXXXXXXXXXXXXXXXXXXGOOXXXXXXXXXXXXXXXXXGXXXXXXXXXXXXXXXXXXXGOOXXXXXXXXXXXXXXXXXGOXXXXXXXXXXXXXXXXXXGOXXXXXXXXXXXXXXXXXXGOOOXXXXXXXXXXXXXXXXGOXXXXXXXXXXXXXXXXXXGOOOXXXXXXXXXXXXXXXXGOOOXXXXXXXXXXXXXXXX,0,0,0
4389,36,0,36,70,194,0,0,193,89,104,GOXXXXXXXXXXXXXXXXXXGOOXXXXXXXXXXXXXXXXXGOOOXXXXXXXXXXXXXXXXGOXXXXXXXXXXXXXXXXXXGOOXXXXXXXXXXXXXXXXXGXXXXXXXXXXXXXXXXXXXGOOXXXXXXXXXXXXXXXXXGOXXXXXXXXXXXXXXXXXXGOXXXXXXXXXXXXXXXXXXGOOOXXXXXXXXXXXXXXXXGOXXXXXXXXXXXXXXXXXXGOOOXXXXXXXXXXXXXXXXGOOOXXXXXXXXXXXXXXXX,0,0,0

4410,36,0,36,66,198,0,0,198,90,108,GOXXXXXXXXXXXXXXXXXXGOOXXXXXXXXXXXXXXXXXGOOOXXXXXXXXXXXXXXXXGOXXXXXXXXXXXXXXXXXXGOOXXXXXXXXXXXXXXXXXGXXXXXXXXXXXXXXXXXXXGOOXXXXXXXXXXXXXXXXXGOXXXXXXXXXXXXXXXXXXGOXXXXXXXXXXXXXXXXXXGOOOXXXXXXXXXXXXXXXXGOXXXXXXXXXXXXXXXXXXGOOOXXXXXXXXXXXXXXXXGOOOXXXXXXXXXXXXXXXX,0,0,0
4431,36,0,36,65,199,0,0,199,93,106,GOXXXXXXXXXXXXXXXXXXGOOXXXXXXXXXXXXXXXXXGOOOXXXXXXXXXXXXXXXXGOXXXXXXXXXXXXXXXXXXGOOXXXXXXXXXXXXXXXXXGXXXXXXXXXXXXXXXXXXXGOOXXXXXXXXXXXXXXXXXGOXXXXXXXXXXXXXXXXXXGOXXXXXXXXXXXXXXXXXXGOOOXXXXXXXXXXXXXXXXGOXXXXXXXXXXXXXXXXXXGOOOXXXXXXXXXXXXXXXXGOOOXXXXXXXXXXXXXXXX,0,0,0
4452,36,0,36,64,200,0,0,200,93,107,GOXXXXXXXXXXXXXXXXXXGOOXXXXXXXXXXXXXXXXXGOOOXXXXXXXXXXXXXXXXGOXXXXXXXXXXXXXXXXXXGOOXXXXXXXXXXXXXXXXXGXXXXXXXXXXXXXXXXXXXGOOXXXXXXXXXXXXXXXXXGOXXXXXXXXXXXXXXXXXXGOXXXXXXXXXXXXXXXXXXGOOOXXXXXXXXXXXXXXXXGOXXXXXXXXXXXXXXXXXXGOOOXXXXXXXXXXXXXXXXGOOOXXXXXXXXXXXXXXXX,0,0,0
4473,36,0,36,60,204,0,0,203,92,111,GOXXXXXXXXXXXXXXXXXXGOOXXXXXXXXXXXXXXXXXGOOOXXXXXXXXXXXXXXXXGOXXXXXXXXXXXXXXXXXXGOOXXXXXXXXXXXXXXXXXGXXXXXXXXXXXXXXXXXXXGOOXXXXXXXXXXXXXXXXXGOXXXXXXXXXXXXXXXXXXGOXXXXXXXXXXXXXXXXXXGOOOXXXXXXXXXXXXXXXXGOXXXXXXXXXXXXXXXXXXGOOOXXXXXXXXXXXXXXXXGOOOXXXXXXXXXXXXXXXX,0,0,0
4494,36,0,36,58,206,0,0,206,90,116,GOXXXXXXXXXXXXXXXXXXGOOXXXXXXXXXXXXXXXXXGOOOXXXXXXXXXXXXXXXXGOXXXXXXXXXXXXXXXXXXGOOXXXXXXXXXXXXXXXXXGXXXXXXXXXXXXXXXXXXXGOOXXXXXXXXXXXXXXXXXGOXXXXXXXXXXXXXXXXXXGOXXXXXXXXXXXXXXXXXXGOOOXXXXXXXXXXXXXXXXGOXXXXXXXXXXXXXXXXXXGOOOXXXXXXXXXXXXXXXXGOOOXXXXXXXXXXXXXXXX,0,0,0

4515,36,0,36,61,203,0,0,203,90,113,GOXXXXXXXXXXXXXXXXXXGOOXXXXXXXXXXXXXXXXXGOOOXXXXXXXXXXXXXXXXGOXXXXXXXXXXXXXXXXXXGOOXXXXXXXXXXXXXXXXXGXXXXXXXXXXXXXXXXXXXGOOXXXXXXXXXXXXXXXXXGOXXXXXXXXXXXXXXXXXXGOXXXXXXXXXXXXXXXXXXGOOOXXXXXXXXXXXXXXXXGOXXXXXXXXXXXXXXXXXXGOOOXXXXXXXXXXXXXXXXGOOOXXXXXXXXXXXXXXXX,0,0,0
4536,36,0,36,62,202,0,0,202,92,110,GOXXXXXXXXXXXXXXXXXXGOOXXXXXXXXXXXXXXXXXGOOOXXXXXXXXXXXXXXXXGOXXXXXXXXXXXXXXXXXXGOOXXXXXXXXXXXXXXXXXGXXXXXXXXXXXXXXXXXXXGOOXXXXXXXXXXXXXXXXXGOXXXXXXXXXXXXXXXXXXGOXXXXXXXXXXXXXXXXXXGOOOXXXXXXXXXXXXXXXXGOXXXXXXXXXXXXXXXXXXGOOOXXXXXXXXXXXXXXXXGOOOXXXXXXXXXXXXXXXX,0,0,0
4557,36,0,36,69,195,0,0,195,88,107,GOXXXXXXXXXXXXXXXXXXGOOXXXXXXXXXXXXXXXXXGOOOXXXXXXXXXXXXXXXXGOXXXXXXXXXXXXXXXXXXGOOXXXXXXXXXXXXXXXXXGXXXXXXXXXXXXXXXXXXXGOOXXXXXXXXXXXXXXXXXGOXXXXXXXXXXXXXXXXXXGOXXXXXXXXXXXXXXXXXXGOOOXXXXXXXXXXXXXXXXGOXXXXXXXXXXXXXXXXXXGOOOXXXXXXXXXXXXXXXXGOOOXXXXXXXXXXXXXXXX,0,0,0
4578,36,0,36,66,198,0,0,197,91,106,GOXXXXXXXXXXXXXXXXXXGOOXXXXXXXXXXXXXXXXXGOOOXXXXXXXXXXXXXXXXGOXXXXXXXXXXXXXXXXXXGOOXXXXXXXXXXXXXXXXXGXXXXXXXXXXXXXXXXXXXGOOXXXXXXXXXXXXXXXXXGOXXXXXXXXXXXXXXXXXXGOXXXXXXXXXXXXXXXXXXGOOOXXXXXXXXXXXXXXXXGOXXXXXXXXXXXXXXXXXXGOOOXXXXXXXXXXXXXXXXGOOOXXXXXXXXXXXXXXXX,0,0,0
4599,36,0,36,59,205,0,0,204,93,111,GOXXXXXXXXXXXXXXXXXXGOOXXXXXXXXXXXXXXXXXGOOOXXXXXXXXXXXXXXXXGOXXXXXXXXXXXXXXXXXXGOOXXXXXXXXXXXXXXXXXGXXXXXXXXXXXXXXXXXXXGOOXXXXXXXXXXXXXXXXXGOXXXXXXXXXXXXXXXXXXGOXXXXXXXXXXXXXXXXXXGOOOXXXXXXXXXXXXXXXXGOXXXXXXXXXXXXXXXXXXGOOOXXXXXXXXXXXXXXXXGOOOXXXXXXXXXXXXXXXX,0,0,0

4620,36,0,36,59,205,0,0,205,96,109,GOXXXXXXXXXXXXXXXXXXGOOXXXXXXXXXXXXXXXXXGOOOXXXXXXXXXXXXXXXXGOXXXXXXXXXXXXXXXXXXGOOXXXXXXXXXXXXXXXXXGXXXXXXXXXXXXXXXXXXXGOOXXXXXXXXXXXXXXXXXGOXXXXXXXXXXXXXXXXXXGOXXXXXXXXXXXXXXXXXXGOOOXXXXXXXXXXXXXXXXGOXXXXXXXXXXXXXXXXXXGOOOXXXXXXXXXXXXXXXXGOOOXXXXXXXXXXXXXXXX,0,0,0
4641,37,1,36,58,205,0,0,205,93,112,GOXXXXXXXXXXXXXXXXXXGOOXXXXXXXXXXXXXXXXXGOOOXXXXXXXXXXXXXXXXGOXXXXXXXXXXXXXXXXXXGOOXXXXXXXXXXXXXXXXXGXXXXXXXXXXXXXXXXXXXGOOXXXXXXXXXXXXXXXXXGOXXXXXXXXXXXXXXXXXXGOXXXXXXXXXXXXXXXXXXGOOOXXXXXXXXXXXXXXXXGOXXXXXXXXXXXXXXXXXXGOOOAXXXXXXXXXXXXXXXGOOOXXXXXXXXXXXXXXXX,0,0,0
4662,37,1,36,60,203,0,0,203,93,110,GOXXXXXXXXXXXXXXXXXXGOOXXXXXXXXXXXXXXXXXGOOOXXXXXXXXXXXXXXXXGOXXXXXXXXXXXXXXXXXXGOOXXXXXXXXXXXXXXXXXGXXXXXXXXXXXXXXXXXXXGOOXXXXXXXXXXXXXXXXXGOXXXXXXXXXXXXXXXXXXGOXXXXXXXXXXXXXXXXXXGOOOXXXXXXXXXXXXXXXXGOXXXXXXXXXXXXXXXXXXGOOOAXXXXXXXXXXXXXXXGOOOXXXXXXXXXXXXXXXX,0,0,0
4683,37,1,36,61,202,0,0,202,92,110,GOXXXXXXXXXXXXXXXXXXGOOXXXXXXXXXXXXXXXXXGOOOXXXXXXXXXXXXXXXXGOXXXXXXXXXXXXXXXXXXGOOXXXXXXXXXXXXXXXXXGXXXXXXXXXXXXXXXXXXXGOOXXXXXXXXXXXXXXXXXGOXXXXXXXXXXXXXXXXXXGOXXXXXXXXXXXXXXXXXXGOOOXXXXXXXXXXXXXXXXGOXXXXXXXXXXXXXXXXXXGOOOAXXXXXXXXXXXXXXXGOOOXXXXXXXXXXXXXXXX,0,0,0
4704,37,1,36,60,203,0,0,203,95,108,GOXXXXXXXXXXXXXXXXXXGOOXXXXXXXXXXXXXXXXXGOOOXXXXXXXXXXXXXXXXGOXXXXXXXXXXXXXXXXXXGOOXXXXXXXXXXXXXXXXXGXXXXXXXXXXXXXXXXXXXGOOXXXXXXXXXXXXXXXXXGOXXXXXXXXXXXXXXXXXXGOXXXXXXXXXXXXXXXXXXGOOOXXXXXXXXXXXXXXXXGOXXXXXXXXXXXXXXXXXXGOOOAXXXXXXXXXXXXXXXGOOOXXXXXXXXXXXXXXXX,0,0,0

4725,37,1,36,63,200,0,0,201,95,106,GOXXXXXXXXXXXXXXXXXXGOOXXXXXXXXXXXXXXXXXGOOOXXXXXXXXXXXXXXXXGOXXXXXXXXXXXXXXXXXXGOOXXXXXXXXXXXXXXXXXGXXXXXXXXXXXXXXXXXXXGOOXXXXXXXXXXXXXXXXXGOXXXXXXXXXXXXXXXXXXGOXXXXXXXXXXXXXXXXXXGOOOXXXXXXXXXXXXXXXXGOXXXXXXXXXXXXXXXXXXGOOOAXXXXXXXXXXXXXXXGOOOXXXXXXXXXXXXXXXX,0,0,0
4746,37,1,36,63,200,0,0,200,94,106,GOXXXXXXXXXXXXXXXXXXGOOXXXXXXXXXXXXXXXXXGOOOXXXXXXXXXXXXXXXXGOXXXXXXXXXXXXXXXXXXGOOXXXXXXXXXXXXXXXXXGXXXXXXXXXXXXXXXXXXXGOOXXXXXXXXXXXXXXXXXGOXXXXXXXXXXXXXXXXXXGOXXXXXXXXXXXXXXXXXXGOOOXXXXXXXXXXXXXXXXGOXXXXXXXXXXXXXXXXXXGOOOAXXXXXXXXXXXXXXXGOOOXXXXXXXXXXXXXXXX,0,0,0
4767,37,1,36,60,203,0,0,204,96,108,GOXXXXXXXXXXXXXXXXXXGOOXXXXXXXXXXXXXXXXXGOOOXXXXXXXXXXXXXXXXGOXXXXXXXXXXXXXXXXXXGOOXXXXXXXXXXXXXXXXXGXXXXXXXXXXXXXXXXXXXGOOXXXXXXXXXXXXXXXXXGOXXXXXXXXXXXXXXXXXXGOXXXXXXXXXXXXXXXXXXGOOOXXXXXXXXXXXXXXXXGOXXXXXXXXXXXXXXXXXXGOOOAXXXXXXXXXXXXXXXGOOOXXXXXXXXXXXXXXXX,0,0,0
4788,37,1,36,57,206,0,0,207,98,109,GOXXXXXXXXXXXXXXXXXXGOOXXXXXXXXXXXXXXXXXGOOOXXXXXXXXXXXXXXXXGOXXXXXXXXXXXXXXXXXXGOOXXXXXXXXXXXXXXXXXGXXXXXXXXXXXXXXXXXXXGOOXXXXXXXXXXXXXXXXXGOXXXXXXXXXXXXXXXXXXGOXXXXXXXXXXXXXXXXXXGOOOXXXXXXXXXXXXXXXXGOXXXXXXXXXXXXXXXXXXGOOOAXXXXXXXXXXXXXXXGOOOXXXXXXXXXXXXXXXX,0,0,0
4809,37,0,37,60,203,0,0,204,95,109,GOXXXXXXXXXXXXXXXXXXGOOXXXXXXXXXXXXXXXXXGOOOXXXXXXXXXXXXXXXXGOXXXXXXXXXXXXXXXXXXGOOXXXXXXXXXXXXXXXXXGXXXXXXXXXXXXXXXXXXXGOOXXXXXXXXXXXXXXXXXGOXXXXXXXXXXXXXXXXXXGOXXXXXXXXXXXXXXXXXXGOOOXXXXXXXXXXXXXXXXGOXXXXXXXXXXXXXXXXXXGOOOOXXXXXXXXXXXXXXXGOOOXXXXXXXXXXXXXXXX,0,0,0

4830,37,0,37,60,203,0,0,205,98,107,GOXXXXXXXXXXXXXXXXXXGOOXXXXXXXXXXXXXXXXXGOOOXXXXXXXXXXXXXXXXGOXXXXXXXXXXXXXXXXXXGOOXXXXXXXXXXXXXXXXXGXXXXXXXXXXXXXXXXXXXGOOXXXXXXXXXXXXXXXXXGOXXXXXXXXXXXXXXXXXXGOXXXXXXXXXXXXXXXXXXGOOOXXXXXXXXXXXXXXXXGOXXXXXXXXXXXXXXXXXXGOOOOXXXXXXXXXXXXXXXGOOOXXXXXXXXXXXXXXXX,0,0,0
4851,37,0,37,62,201,0,0,203,92,111,GOXXXXXXXXXXXXXXXXXXGOOXXXXXXXXXXXXXXXXXGOOOXXXXXXXXXXXXXXXXGOXXXXXXXXXXXXXXXXXXGOOXXXXXXXXXXXXXXXXXGXXXXXXXXXXXXXXXXXXXGOOXXXXXXXXXXXXXXXXXGOXXXXXXXXXXXXXXXXXXGOXXXXXXXXXXXXXXXXXXGOOOXXXXXXXXXXXXXXXXGOXXXXXXXXXXXXXXXXXXGOOOOXXXXXXXXXXXXXXXGOOOXXXXXXXXXXXXXXXX,0,0,0
4872,37,0,37,60,203,0,0,204,94,110,GOXXXXXXXXXXXXXXXXXXGOOXXXXXXXXXXXXXXXXXGOOOXXXXXXXXXXXXXXXXGOXXXXXXXXXXXXXXXXXXGOOXXXXXXXXXXXXXXXXXGXXXXXXXXXXXXXXXXXXXGOOXXXXXXXXXXXXXXXXXGOXXXXXXXXXXXXXXXXXXGOXXXXXXXXXXXXXXXXXXGOOOXXXXXXXXXXXXXXXXGOXXXXXXXXXXXXXXXXXXGOOOOXXXXXXXXXXXXXXXGOOOXXXXXXXXXXXXXXXX,0,0,0
4893,37,0,37,54,209,0,0,211,100,111,GOXXXXXXXXXXXXXXXXXXGOOXXXXXXXXXXXXXXXXXGOOOXXXXXXXXXXXXXXXXGOXXXXXXXXXXXXXXXXXXGOOXXXXXXXXXXXXXXXXXGXXXXXXXXXXXXXXXXXXXGOOXXXXXXXXXXXXXXXXXGOXXXXXXXXXXXXXXXXXXGOXXXXXXXXXXXXXXXXXXGOOOXXXXXXXXXXXXXXXXGOXXXXXXXXXXXXXXXXXXGOOOOXXXXXXXXXXXXXXXGOOOXXXXXXXXXXXXXXXX,0,0,0
4914,37,0,37,59,204,0,0,206,102,104,GOXXXXXXXXXXXXXXXXXXGOOXXXXXXXXXXXXXXXXXGOOOXXXXXXXXXXXXXXXXGOXXXXXXXXXXXXXXXXXXGOOXXXXXXXXXXXXXXXXXGXXXXXXXXXXXXXXXXXXXGOOXXXXXXXXXXXXXXXXXGOXXXXXXXXXXXXXXXXXXGOXXXXXXXXXXXXXXXXXXGOOOXXXXXXXXXXXXXXXXGOXXXXXXXXXXXXXXXXXXGOOOOXXXXXXXXXXXXXXXGOOOXXXXXXXXXXXXXXXX,0,0,0

4935,37,0,37,55,208,0,0,207,98,109,GOXXXXXXXXXXXXXXXXXXGOOXXXXXXXXXXXXXXXXXGOOOXXXXXXXXXXXXXXXXGOXXXXXXXXXXXXXXXXXXGOOXXXXXXXXXXXXXXXXXGXXXXXXXXXXXXXXXXXXXGOOXXXXXXXXXXXXXXXXXGOXXXXXXXXXXXXXXXXXXGOXXXXXXXXXXXXXXXXXXGOOOXXXXXXXXXXXXXXXXGOXXXXXXXXXXXXXXXXXXGOOOOXXXXXXXXXXXXXXXGOOOXXXXXXXXXXXXXXXX,0,0,0
4956,37,0,37,53,210,0,0,211,101,110,GOXXXXXXXXXXXXXXXXXXGOOXXXXXXXXXXXXXXXXXGOOOXXXXXXXXXXXXXXXXGOXXXXXXXXXXXXXXXXXXGOOXXXXXXXXXXXXXXXXXGXXXXXXXXXXXXXXXXXXXGOOXXXXXXXXXXXXXXXXXGOXXXXXXXXXXXXXXXXXXGOXXXXXXXXXXXXXXXXXXGOOOXXXXXXXXXXXXXXXXGOXXXXXXXXXXXXXXXXXXGOOOOXXXXXXXXXXXXXXXGOOOXXXXXXXXXXXXXXXX,0,0,0
4977,37,0,37,53,210,0,0,211,100,111,GOXXXXXXXXXXXXXXXXXXGOOXXXXXXXXXXXXXXXXXGOOOXXXXXXXXXXXXXXXXGOXXXXXXXXXXXXXXXXXXGOOXXXXXXXXXXXXXXXXXGXXXXXXXXXXXXXXXXXXXGOOXXXXXXXXXXXXXXXXXGOXXXXXXXXXXXXXXXXXXGOXXXXXXXXXXXXXXXXXXGOOOXXXXXXXXXXXXXXXXGOXXXXXXXXXXXXXXXXXXGOOOOXXXXXXXXXXXXXXXGOOOXXXXXXXXXXXXXXXX,0,0,0
4998,37,0,37,51,212,0,0,213,101,112,GOXXXXXXXXXXXXXXXXXXGOOXXXXXXXXXXXXXXXXXGOOOXXXXXXXXXXXXXXXXGOXXXXXXXXXXXXXXXXXXGOOXXXXXXXXXXXXXXXXXGXXXXXXXXXXXXXXXXXXXGOOXXXXXXXXXXXXXXXXXGOXXXXXXXXXXXXXXXXXXGOXXXXXXXXXXXXXXXXXXGOOOXXXXXXXXXXXXXXXXGOXXXXXXXXXXXXXXXXXXGOOOOXXXXXXXXXXXXXXXGOOOXXXXXXXXXXXXXXXX,0,0,0
5019,37,0,37,49,214,0,0,215,110,105,GOXXXXXXXXXXXXXXXXXXGOOXXXXXXXXXXXXXXXXXGOOOXXXXXXXXXXXXXXXXGOXXXXXXXXXXXXXXXXXXGOOXXXXXXXXXXXXXXXXXGXXXXXXXXXXXXXXXXXXXGOOXXXXXXXXXXXXXXXXXGOXXXXXXXXXXXXXXXXXXGOXXXXXXXXXXXXXXXXXXGOOOXXXXXXXXXXXXXXXXGOXXXXXXXXXXXXXXXXXXGOOOOXXXXXXXXXXXXXXXGOOOXXXXXXXXXXXXXXXX,0,0,0

5040,37,0,37,56,207,0,0,208,101,107,GOXXXXXXXXXXXXXXXXXXGOOXXXXXXXXXXXXXXXXXGOOOXXXXXXXXXXXXXXXXGOXXXXXXXXXXXXXXXXXXGOOXXXXXXXXXXXXXXXXXGXXXXXXXXXXXXXXXXXXXGOOXXXXXXXXXXXXXXXXXGOXXXXXXXXXXXXXXXXXXGOXXXXXXXXXXXXXXXXXXGOOOXXXXXXXXXXXXXXXXGOXXXXXXXXXXXXXXXXXXGOOOOXXXXXXXXXXXXXXXGOOOXXXXXXXXXXXXXXXX,0,0,0
5061,37,0,37,57,206,0,0,207,106,101,GOXXXXXXXXXXXXXXXXXXGOOXXXXXXXXXXXXXXXXXGOOOXXXXXXXXXXXXXXXXGOXXXXXXXXXXXXXXXXXXGOOXXXXXXXXXXXXXXXXXGXXXXXXXXXXXXXXXXXXXGOOXXXXXXXXXXXXXXXXXGOXXXXXXXXXXXXXXXXXXGOXXXXXXXXXXXXXXXXXXGOOOXXXXXXXXXXXXXXXXGOXXXXXXXXXXXXXXXXXXGOOOOXXXXXXXXXXXXXXXGOOOXXXXXXXXXXXXXXXX,0,0,0
5082,37,0,37,59,204,0,0,206,107,99,GOXXXXXXXXXXXXXXXXXXGOOXXXXXXXXXXXXXXXXXGOOOXXXXXXXXXXXXXXXXGOXXXXXXXXXXXXXXXXXXGOOXXXXXXXXXXXXXXXXXGXXXXXXXXXXXXXXXXXXXGOOXXXXXXXXXXXXXXXXXGOXXXXXXXXXXXXXXXXXXGOXXXXXXXXXXXXXXXXXXGOOOXXXXXXXXXXXXXXXXGOXXXXXXXXXXXXXXXXXXGOOOOXXXXXXXXXXXXXXXGOOOXXXXXXXXXXXXXXXX,0,0,0
5103,37,0,37,62,201,0,0,202,104,98,GOXXXXXXXXXXXXXXXXXXGOOXXXXXXXXXXXXXXXXXGOOOXXXXXXXXXXXXXXXXGOXXXXXXXXXXXXXXXXXXGOOXXXXXXXXXXXXXXXXXGXXXXXXXXXXXXXXXXXXXGOOXXXXXXXXXXXXXXXXXGOXXXXXXXXXXXXXXXXXXGOXXXXXXXXXXXXXXXXXXGOOOXXXXXXXXXXXXXXXXGOXXXXXXXXXXXXXXXXXXGOOOOXXXXXXXXXXXXXXXGOOOXXXXXXXXXXXXXXXX,0,0,0
5124,37,0,37,60,203,0,0,203,108,95,GOXXXXXXXXXXXXXXXXXXGOOXXXXXXXXXXXXXXXXXGOOOXXXXXXXXXXXXXXXXGOXXXXXXXXXXXXXXXXXXGOOXXXXXXXXXXXXXXXXXGXXXXXXXXXXXXXXXXXXXGOOXXXXXXXXXXXXXXXXXGOXXXXXXXXXXXXXXXXXXGOXXXXXXXXXXXXXXXXXXGOOOXXXXXXXXXXXXXXXXGOXXXXXXXXXXXXXXXXXXGOOOOXXXXXXXXXXXXXXXGOOOXXXXXXXXXXXXXXXX,0,0,0

5145,37,0,37,62,201,0,0,201,109,92,GOXXXXXXXXXXXXXXXXXXGOOXXXXXXXXXXXXXXXXXGOOOXXXXXXXXXXXXXXXXGOXXXXXXXXXXXXXXXXXXGOOXXXXXXXXXXXXXXXXXGXXXXXXXXXXXXXXXXXXXGOOXXXXXXXXXXXXXXXXXGOXXXXXXXXXXXXXXXXXXGOXXXXXXXXXXXXXXXXXXGOOOXXXXXXXXXXXXXXXXGOXXXXXXXXXXXXXXXXXXGOOOOXXXXXXXXXXXXXXXGOOOXXXXXXXXXXXXXXXX,0,0,0
5166,37,0,37,59,204,0,0,204,107,97,GOXXXXXXXXXXXXXXXXXXGOOXXXXXXXXXXXXXXXXXGOOOXXXXXXXXXXXXXXXXGOXXXXXXXXXXXXXXXXXXGOOXXXXXXXXXXXXXXXXXGXXXXXXXXXXXXXXXXXXXGOOXXXXXXXXXXXXXXXXXGOXXXXXXXXXXXXXXXXXXGOXXXXXXXXXXXXXXXXXXGOOOXXXXXXXXXXXXXXXXGOXXXXXXXXXXXXXXXXXXGOOOOXXXXXXXXXXXXXXXGOOOXXXXXXXXXXXXXXXX,0,0,0
5187,37,0,37,58,205,0,0,205,108,97,GOXXXXXXXXXXXXXXXXXXGOOXXXXXXXXXXXXXXXXXGOOOXXXXXXXXXXXXXXXXGOXXXXXXXXXXXXXXXXXXGOOXXXXXXXXXXXXXXXXXGXXXXXXXXXXXXXXXXXXXGOOXXXXXXXXXXXXXXXXXGOXXXXXXXXXXXXXXXXXXGOXXXXXXXXXXXXXXXXXXGOOOXXXXXXXXXXXXXXXXGOXXXXXXXXXXXXXXXXXXGOOOOXXXXXXXXXXXXXXXGOOOXXXXXXXXXXXXXXXX,0,0,0
5208,37,0,37,56,207,0,0,207,110,97,GOXXXXXXXXXXXXXXXXXXGOOXXXXXXXXXXXXXXXXXGOOOXXXXXXXXXXXXXXXXGOXXXXXXXXXXXXXXXXXXGOOXXXXXXXXXXXXXXXXXGXXXXXXXXXXXXXXXXXXXGOOXXXXXXXXXXXXXXXXXGOXXXXXXXXXXXXXXXXXXGOXXXXXXXXXXXXXXXXXXGOOOXXXXXXXXXXXXXXXXGOXXXXXXXXXXXXXXXXXXGOOOOXXXXXXXXXXXXXXXGOOOXXXXXXXXXXXXXXXX,0,0,0
5229,37,0,37,59,204,0,0,205,110,95,GOXXXXXXXXXXXXXXXXXXGOOXXXXXXXXXXXXXXXXXGOOOXXXXXXXXXXXXXXXXGOXXXXXXXXXXXXXXXXXXGOOXXXXXXXXXXXXXXXXXGXXXXXXXXXXXXXXXXXXXGOOXXXXXXXXXXXXXXXXXGOXXXXXXXXXXXXXXXXXXGOXXXXXXXXXXXXXXXXXXGOOOXXXXXXXXXXXXXXXXGOXXXXXXXXXXXXXXXXXXGOOOOXXXXXXXXXXXXXXXGOOOXXXXXXXXXXXXXXXX,0,0,0

5250,37,0,37,63,200,0,0,201,112,89,GOXXXXXXXXXXXXXXXXXXGOOXXXXXXXXXXXXXXXXXGOOOXXXXXXXXXXXXXXXXGOXXXXXXXXXXXXXXXXXXGOOXXXXXXXXXXXXXXXXXGXXXXXXXXXXXXXXXXXXXGOOXXXXXXXXXXXXXXXXXGOXXXXXXXXXXXXXXXXXXGOXXXXXXXXXXXXXXXXXXGOOOXXXXXXXXXXXXXXXXGOXXXXXXXXXXXXXXXXXXGOOOOXXXXXXXXXXXXXXXGOOOXXXXXXXXXXXXXXXX,0,0,0
5271,37,0,37,69,194,0,0,196,108,88,GOXXXXXXXXXXXXXXXXXXGOOXXXXXXXXXXXXXXXXXGOOOXXXXXXXXXXXXXXXXGOXXXXXXXXXXXXXXXXXXGOOXXXXXXXXXXXXXXXXXGXXXXXXXXXXXXXXXXXXXGOOXXXXXXXXXXXXXXXXXGOXXXXXXXXXXXXXXXXXXGOXXXXXXXXXXXXXXXXXXGOOOXXXXXXXXXXXXXXXXGOXXXXXXXXXXXXXXXXXXGOOOOXXXXXXXXXXXXXXXGOOOXXXXXXXXXXXXXXXX,0,0,0
5292,37,0,37,66,197,0,0,199,109,90,GOXXXXXXXXXXXXXXXXXXGOOXXXXXXXXXXXXXXXXXGOOOXXXXXXXXXXXXXXXXGOXXXXXXXXXXXXXXXXXXGOOXXXXXXXXXXXXXXXXXGXXXXXXXXXXXXXXXXXXXGOOXXXXXXXXXXXXXXXXXGOXXXXXXXXXXXXXXXXXXGOXXXXXXXXXXXXXXXXXXGOOOXXXXXXXXXXXXXXXXGOXXXXXXXXXXXXXXXXXXGOOOOXXXXXXXXXXXXXXXGOOOXXXXXXXXXXXXXXXX,0,0,0
5313,37,0,37,60,203,0,0,204,108,96,GOXXXXXXXXXXXXXXXXXXGOOXXXXXXXXXXXXXXXXXGOOOXXXXXXXXXXXXXXXXGOXXXXXXXXXXXXXXXXXXGOOXXXXXXXXXXXXXXXXXGXXXXXXXXXXXXXXXXXXXGOOXXXXXXXXXXXXXXXXXGOXXXXXXXXXXXXXXXXXXGOXXXXXXXXXXXXXXXXXXGOOOXXXXXXXXXXXXXXXXGOXXXXXXXXXXXXXXXXXXGOOOOXXXXXXXXXXXXXXXGOOOXXXXXXXXXXXXXXXX,0,0,0
5334,37,0,37,61,202,0,0,202,107,95,GOXXXXXXXXXXXXXXXXXXGOOXXXXXXXXXXXXXXXXXGOOOXXXXXXXXXXXXXXXXGOXXXXXXXXXXXXXXXXXXGOOXXXXXXXXXXXXXXXXXGXXXXXXXXXXXXXXXXXXXGOOXXXXXXXXXXXXXXXXXGOXXXXXXXXXXXXXXXXXXGOXXXXXXXXXXXXXXXXXXGOOOXXXXXXXXXXXXXXXXGOXXXXXXXXXXXXXXXXXXGOOOOXXXXXXXXXXXXXXXGOOOXXXXXXXXXXXXXXXX,0,0,0

5355,37,0,37,53,210,0,0,209,111,98,GOXXXXXXXXXXXXXXXXXXGOOXXXXXXXXXXXXXXXXXGOOOXXXXXXXXXXXXXXXXGOXXXXXXXXXXXXXXXXXXGOOXXXXXXXXXXXXXXXXXGXXXXXXXXXXXXXXXXXXXGOOXXXXXXXXXXXXXXXXXGOXXXXXXXXXXXXXXXXXXGOXXXXXXXXXXXXXXXXXXGOOOXXXXXXXXXXXXXXXXGOXXXXXXXXXXXXXXXXXXGOOOOXXXXXXXXXXXXXXXGOOOXXXXXXXXXXXXXXXX,0,0,0
5376,37,0,37,57,206,0,0,207,108,99,GOXXXXXXXXXXXXXXXXXXGOOXXXXXXXXXXXXXXXXXGOOOXXXXXXXXXXXXXXXXGOXXXXXXXXXXXXXXXXXXGOOXXXXXXXXXXXXXXXXXGXXXXXXXXXXXXXXXXXXXGOOXXXXXXXXXXXXXXXXXGOXXXXXXXXXXXXXXXXXXGOXXXXXXXXXXXXXXXXXXGOOOXXXXXXXXXXXXXXXXGOXXXXXXXXXXXXXXXXXXGOOOOXXXXXXXXXXXXXXXGOOOXXXXXXXXXXXXXXXX,0,0,0
5397,37,0,37,52,211,0,0,212,110,102,GOXXXXXXXXXXXXXXXXXXGOOXXXXXXXXXXXXXXXXXGOOOXXXXXXXXXXXXXXXXGOXXXXXXXXXXXXXXXXXXGOOXXXXXXXXXXXXXXXXXGXXXXXXXXXXXXXXXXXXXGOOXXXXXXXXXXXXXXXXXGOXXXXXXXXXXXXXXXXXXGOXXXXXXXXXXXXXXXXXXGOOOXXXXXXXXXXXXXXXXGOXXXXXXXXXXXXXXXXXXGOOOOXXXXXXXXXXXXXXXGOOOXXXXXXXXXXXXXXXX,0,0,0
5418,37,0,37,52,211,0,0,212,111,101,GOXXXXXXXXXXXXXXXXXXGOOXXXXXXXXXXXXXXXXXGOOOXXXXXXXXXXXXXXXXGOXXXXXXXXXXXXXXXXXXGOOXXXXXXXXXXXXXXXXXGXXXXXXXXXXXXXXXXXXXGOOXXXXXXXXXXXXXXXXXGOXXXXXXXXXXXXXXXXXXGOXXXXXXXXXXXXXXXXXXGOOOXXXXXXXXXXXXXXXXGOXXXXXXXXXXXXXXXXXXGOOOOXXXXXXXXXXXXXXXGOOOXXXXXXXXXXXXXXXX,0,0,0
5439,37,0,37,55,208,0,0,210,111,99,GOXXXXXXXXXXXXXXXXXXGOOXXXXXXXXXXXXXXXXXGOOOXXXXXXXXXXXXXXXXGOXXXXXXXXXXXXXXXXXXGOOXXXXXXXXXXXXXXXXXGXXXXXXXXXXXXXXXXXXXGOOXXXXXXXXXXXXXXXXXGOXXXXXXXXXXXXXXXXXXGOXXXXXXXXXXXXXXXXXXGOOOXXXXXXXXXXXXXXXXGOXXXXXXXXXXXXXXXXXXGOOOOXXXXXXXXXXXXXXXGOOOXXXXXXXXXXXXXXXX,0,0,0

5460,37,0,37,55,208,0,0,210,109,101,GOXXXXXXXXXXXXXXXXXXGOOXXXXXXXXXXXXXXXXXGOOOXXXXXXXXXXXXXXXXGOXXXXXXXXXXXXXXXXXXGOOXXXXXXXXXXXXXXXXXGXXXXXXXXXXXXXXXXXXXGOOXXXXXXXXXXXXXXXXXGOXXXXXXXXXXXXXXXXXXGOXXXXXXXXXXXXXXXXXXGOOOXXXXXXXXXXXXXXXXGOXXXXXXXXXXXXXXXXXXGOOOOXXXXXXXXXXXXXXXGOOOXXXXXXXXXXXXXXXX,0,0,0
5481,37,0,37,57,206,0,0,208,108,100,GOXXXXXXXXXXXXXXXXXXGOOXXXXXXXXXXXXXXXXXGOOOXXXXXXXXXXXXXXXXGOXXXXXXXXXXXXXXXXXXGOOXXXXXXXXXXXXXXXXXGXXXXXXXXXXXXXXXXXXXGOOXXXXXXXXXXXXXXXXXGOXXXXXXXXXXXXXXXXXXGOXXXXXXXXXXXXXXXXXXGOOOXXXXXXXXXXXXXXXXGOXXXXXXXXXXXXXXXXXXGOOOOXXXXXXXXXXXXXXXGOOOXXXXXXXXXXXXXXXX,0,0,0
5502,37,0,37,59,204,0,0,205,106,99,GOXXXXXXXXXXXXXXXXXXGOOXXXXXXXXXXXXXXXXXGOOOXXXXXXXXXXXXXXXXGOXXXXXXXXXXXXXXXXXXGOOXXXXXXXXXXXXXXXXXGXXXXXXXXXXXXXXXXXXXGOOXXXXXXXXXXXXXXXXXGOXXXXXXXXXXXXXXXXXXGOXXXXXXXXXXXXXXXXXXGOOOXXXXXXXXXXXXXXXXGOXXXXXXXXXXXXXXXXXXGOOOOXXXXXXXXXXXXXXXGOOOXXXXXXXXXXXXXXXX,0,0,0
5523,37,0,37,53,210,0,0,212,108,104,GOXXXXXXXXXXXXXXXXXXGOOXXXXXXXXXXXXXXXXXGOOOXXXXXXXXXXXXXXXXGOXXXXXXXXXXXXXXXXXXGOOXXXXXXXXXXXXXXXXXGXXXXXXXXXXXXXXXXXXXGOOXXXXXXXXXXXXXXXXXGOXXXXXXXXXXXXXXXXXXGOXXXXXXXXXXXXXXXXXXGOOOXXXXXXXXXXXXXXXXGOXXXXXXXXXXXXXXXXXXGOOOOXXXXXXXXXXXXXXXGOOOXXXXXXXXXXXXXXXX,0,0,0
5544,38,1,37,55,207,0,0,209,107,102,GOXXXXXXXXXXXXXXXXXXGOOXXXXXXXXXXXXXXXXXGOOOXXXXXXXXXXXXXXXXGOXXXXXXXXXXXXXXXXXXGOOXXXXXXXXXXXXXXXXXGXXXXXXXXXXXXXXXXXXXGOOXXXXXXXXXXXXXXXXXGOXXXXXXXXXXXXXXXXXXGOXXXXXXXXXXXXXXXXXXGOOOXXXXXXXXXXXXXXXXGOXXXXXXXXXXXXXXXXXXGOOOOXXXXXXXXXXXXXXXGOOOAXXXXXXXXXXXXXXX,0,0,0

5565,38,1,37,52,210,0,0,211,107,104,GOXXXXXXXXXXXXXXXXXXGOOXXXXXXXXXXXXXXXXXGOOOXXXXXXXXXXXXXXXXGOXXXXXXXXXXXXXXXXXXGOOXXXXXXXXXXXXXXXXXGXXXXXXXXXXXXXXXXXXXGOOXXXXXXXXXXXXXXXXXGOXXXXXXXXXXXXXXXXXXGOXXXXXXXXXXXXXXXXXXGOOOXXXXXXXXXXXXXXXXGOXXXXXXXXXXXXXXXXXXGOOOOXXXXXXXXXXXXXXXGOOOAXXXXXXXXXXXXXXX,0,0,0
5586,38,0,38,54,208,0,0,209,106,103,GOXXXXXXXXXXXXXXXXXXGOOXXXXXXXXXXXXXXXXXGOOOXXXXXXXXXXXXXXXXGOXXXXXXXXXXXXXXXXXXGOOXXXXXXXXXXXXXXXXXGXXXXXXXXXXXXXXXXXXXGOOXXXXXXXXXXXXXXXXXGOXXXXXXXXXXXXXXXXXXGOXXXXXXXXXXXXXXXXXXGOOOXXXXXXXXXXXXXXXXGOXXXXXXXXXXXXXXXXXXGOOOOXXXXXXXXXXXXXXXGOOOOXXXXXXXXXXXXXXX,0,0,0
5607,38,0,38,53,209,0,0,209,106,103,GOXXXXXXXXXXXXXXXXXXGOOXXXXXXXXXXXXXXXXXGOOOXXXXXXXXXXXXXXXXGOXXXXXXXXXXXXXXXXXXGOOXXXXXXXXXXXXXXXXXGXXXXXXXXXXXXXXXXXXXGOOXXXXXXXXXXXXXXXXXGOXXXXXXXXXXXXXXXXXXGOXXXXXXXXXXXXXXXXXXGOOOXXXXXXXXXXXXXXXXGOXXXXXXXXXXXXXXXXXXGOOOOXXXXXXXXXXXXXXXGOOOOXXXXXXXXXXXXXXX,0,0,0
5628,38,0,38,52,210,0,0,211,113,98,GOXXXXXXXXXXXXXXXXXXGOOXXXXXXXXXXXXXXXXXGOOOXXXXXXXXXXXXXXXXGOXXXXXXXXXXXXXXXXXXGOOXXXXXXXXXXXXXXXXXGXXXXXXXXXXXXXXXXXXXGOOXXXXXXXXXXXXXXXXXGOXXXXXXXXXXXXXXXXXXGOXXXXXXXXXXXXXXXXXXGOOOXXXXXXXXXXXXXXXXGOXXXXXXXXXXXXXXXXXXGOOOOXXXXXXXXXXXXXXXGOOOOXXXXXXXXXXXXXXX,0,0,0
5649,38,0,38,55,207,0,0,208,109,99,GOXXXXXXXXXXXXXXXXXXGOOXXXXXXXXXXXXXXXXXGOOOXXXXXXXXXXXXXXXXGOXXXXXXXXXXXXXXXXXXGOOXXXXXXXXXXXXXXXXXGXXXXXXXXXXXXXXXXXXXGOOXXXXXXXXXXXXXXXXXGOXXXXXXXXXXXXXXXXXXGOXXXXXXXXXXXXXXXXXXGOOOXXXXXXXXXXXXXXXXGOXXXXXXXXXXXXXXXXXXGOOOOXXXXXXXXXXXXXXXGOOOOXXXXXXXXXXXXXXX,0,0,0

5670,38,0,38,53,209,0,0,209,110,99,GOXXXXXXXXXXXXXXXXXXGOOXXXXXXXXXXXXXXXXXGOOOXXXXXXXXXXXXXXXXGOXXXXXXXXXXXXXXXXXXGOOXXXXXXXXXXXXXXXXXGXXXXXXXXXXXXXXXXXXXGOOXXXXXXXXXXXXXXXXXGOXXXXXXXXXXXXXXXXXXGOXXXXXXXXXXXXXXXXXXGOOOXXXXXXXXXXXXXXXXGOXXXXXXXXXXXXXXXXXXGOOOOXXXXXXXXXXXXXXXGOOOOXXXXXXXXXXXXXXX,0,0,0
5691,38,0,38,59,203,0,0,204,116,88,GOXXXXXXXXXXXXXXXXXXGOOXXXXXXXXXXXXXXXXXGOOOXXXXXXXXXXXXXXXXGOXXXXXXXXXXXXXXXXXXGOOXXXXXXXXXXXXXXXXXGXXXXXXXXXXXXXXXXXXXGOOXXXXXXXXXXXXXXXXXGOXXXXXXXXXXXXXXXXXXGOXXXXXXXXXXXXXXXXXXGOOOXXXXXXXXXXXXXXXXGOXXXXXXXXXXXXXXXXXXGOOOOXXXXXXXXXXXXXXXGOOOOXXXXXXXXXXXXXXX,0,0,0
5712,38,0,38,59,203,0,0,204,115,89,GOXXXXXXXXXXXXXXXXXXGOOXXXXXXXXXXXXXXXXXGOOOXXXXXXXXXXXXXXXXGOXXXXXXXXXXXXXXXXXXGOOXXXXXXXXXXXXXXXXXGXXXXXXXXXXXXXXXXXXXGOOXXXXXXXXXXXXXXXXXGOXXXXXXXXXXXXXXXXXXGOXXXXXXXXXXXXXXXXXXGOOOXXXXXXXXXXXXXXXXGOXXXXXXXXXXXXXXXXXXGOOOOXXXXXXXXXXXXXXXGOOOOXXXXXXXXXXXXXXX,0,0,0
5733,38,0,38,58,204,0,0,205,113,92,GOXXXXXXXXXXXXXXXXXXGOOXXXXXXXXXXXXXXXXXGOOOXXXXXXXXXXXXXXXXGOXXXXXXXXXXXXXXXXXXGOOXXXXXXXXXXXXXXXXXGXXXXXXXXXXXXXXXXXXXGOOXXXXXXXXXXXXXXXXXGOXXXXXXXXXXXXXXXXXXGOXXXXXXXXXXXXXXXXXXGOOOXXXXXXXXXXXXXXXXGOXXXXXXXXXXXXXXXXXXGOOOOXXXXXXXXXXXXXXXGOOOOXXXXXXXXXXXXXXX,0,0,0
5754,38,0,38,59,203,0,0,204,114,90,GOXXXXXXXXXXXXXXXXXXGOOXXXXXXXXXXXXXXXXXGOOOXXXXXXXXXXXXXXXXGOXXXXXXXXXXXXXXXXXXGOOXXXXXXXXXXXXXXXXXGXXXXXXXXXXXXXXXXXXXGOOXXXXXXXXXXXXXXXXXGOXXXXXXXXXXXXXXXXXXGOXXXXXXXXXXXXXXXXXXGOOOXXXXXXXXXXXXXXXXGOXXXXXXXXXXXXXXXXXXGOOOOXXXXXXXXXXXXXXXGOOOOXXXXXXXXXXXXXXX,0,0,0

5775,38,0,38,63,199,0,0,199,109,90,GOXXXXXXXXXXXXXXXXXXGOOXXXXXXXXXXXXXXXXXGOOOXXXXXXXXXXXXXXXXGOXXXXXXXXXXXXXXXXXXGOOXXXXXXXXXXXXXXXXXGXXXXXXXXXXXXXXXXXXXGOOXXXXXXXXXXXXXXXXXGOXXXXXXXXXXXXXXXXXXGOXXXXXXXXXXXXXXXXXXGOOOXXXXXXXXXXXXXXXXGOXXXXXXXXXXXXXXXXXXGOOOOXXXXXXXXXXXXXXXGOOOOXXXXXXXXXXXXXXX,0,0,0
5796,38,0,38,61,201,0,0,201,110,91,GOXXXXXXXXXXXXXXXXXXGOOXXXXXXXXXXXXXXXXXGOOOXXXXXXXXXXXXXXXXGOXXXXXXXXXXXXXXXXXXGOOXXXXXXXXXXXXXXXXXGXXXXXXXXXXXXXXXXXXXGOOXXXXXXXXXXXXXXXXXGOXXXXXXXXXXXXXXXXXXGOXXXXXXXXXXXXXXXXXXGOOOXXXXXXXXXXXXXXXXGOXXXXXXXXXXXXXXXXXXGOOOOXXXXXXXXXXXXXXXGOOOOXXXXXXXXXXXXXXX,0,0,0
5817,38,0,38,63,199,0,0,200,109,91,GOXXXXXXXXXXXXXXXXXXGOOXXXXXXXXXXXXXXXXXGOOOXXXXXXXXXXXXXXXXGOXXXXXXXXXXXXXXXXXXGOOXXXXXXXXXXXXXXXXXGXXXXXXXXXXXXXXXXXXXGOOXXXXXXXXXXXXXXXXXGOXXXXXXXXXXXXXXXXXXGOXXXXXXXXXXXXXXXXXXGOOOXXXXXXXXXXXXXXXXGOXXXXXXXXXXXXXXXXXXGOOOOXXXXXXXXXXXXXXXGOOOOXXXXXXXXXXXXXXX,0,0,0
5838,39,1,38,54,207,0,0,208,109,99,GOXXXXXXXXXXXXXXXXXXGOOXXXXXXXXXXXXXXXXXGOOOXXXXXXXXXXXXXXXXGOXXXXXXXXXXXXXXXXXXGOOXXXXXXXXXXXXXXXXXGXXXXXXXXXXXXXXXXXXXGOOAXXXXXXXXXXXXXXXXGOXXXXXXXXXXXXXXXXXXGOXXXXXXXXXXXXXXXXXXGOOOXXXXXXXXXXXXXXXXGOXXXXXXXXXXXXXXXXXXGOOOOXXXXXXXXXXXXXXXGOOOOXXXXXXXXXXXXXXX,0,0,0
5859,40,1,39,52,208,0,0,209,111,98,GOXXXXXXXXXXXXXXXXXXGOOXXXXXXXXXXXXXXXXXGOOOXXXXXXXXXXXXXXXXGOXXXXXXXXXXXXXXXXXXGOOXXXXXXXXXXXXXXXXXGXXXXXXXXXXXXXXXXXXXGOOOXXXXXXXXXXXXXXXXGOXXXXXXXXXXXXXXXXXXGOAXXXXXXXXXXXXXXXXXGOOOXXXXXXXXXXXXXXXXGOXXXXXXXXXXXXXXXXXXGOOOOXXXXXXXXXXXXXXXGOOOOXXXXXXXXXXXXXXX,0,0,0

5880,40,1,39,51,209,0,0,208,113,95,GOXXXXXXXXXXXXXXXXXXGOOXXXXXXXXXXXXXXXXXGOOOXXXXXXXXXXXXXXXXGOXXXXXXXXXXXXXXXXXXGOOXXXXXXXXXXXXXXXXXGXXXXXXXXXXXXXXXXXXXGOOOXXXXXXXXXXXXXXXXGOXXXXXXXXXXXXXXXXXXGOAXXXXXXXXXXXXXXXXXGOOOXXXXXXXXXXXXXXXXGOXXXXXXXXXXXXXXXXXXGOOOOXXXXXXXXXXXXXXXGOOOOXXXXXXXXXXXXXXX,0,0,0
5901,40,1,39,56,204,0,0,205,111,94,GOXXXXXXXXXXXXXXXXXXGOOXXXXXXXXXXXXXXXXXGOOOXXXXXXXXXXXXXXXXGOXXXXXXXXXXXXXXXXXXGOOXXXXXXXXXXXXXXXXXGXXXXXXXXXXXXXXXXXXXGOOOXXXXXXXXXXXXXXXXGOXXXXXXXXXXXXXXXXXXGOAXXXXXXXXXXXXXXXXXGOOOXXXXXXXXXXXXXXXXGOXXXXXXXXXXXXXXXXXXGOOOOXXXXXXXXXXXXXXXGOOOOXXXXXXXXXXXXXXX,0,0,0
5922,41,2,39,59,200,0,0,201,112,89,GOXXXXXXXXXXXXXXXXXXGOOXXXXXXXXXXXXXXXXXGOOOXXXXXXXXXXXXXXXXGOXXXXXXXXXXXXXXXXXXGOOAXXXXXXXXXXXXXXXXGXXXXXXXXXXXXXXXXXXXGOOOXXXXXXXXXXXXXXXXGOXXXXXXXXXXXXXXXXXXGOAXXXXXXXXXXXXXXXXXGOOOXXXXXXXXXXXXXXXXGOXXXXXXXXXXXXXXXXXXGOOOOXXXXXXXXXXXXXXXGOOOOXXXXXXXXXXXXXXX,0,0,0
5943,41,2,39,59,200,0,0,201,113,88,GOXXXXXXXXXXXXXXXXXXGOOXXXXXXXXXXXXXXXXXGOOOXXXXXXXXXXXXXXXXGOXXXXXXXXXXXXXXXXXXGOOAXXXXXXXXXXXXXXXXGXXXXXXXXXXXXXXXXXXXGOOOXXXXXXXXXXXXXXXXGOXXXXXXXXXXXXXXXXXXGOAXXXXXXXXXXXXXXXXXGOOOXXXXXXXXXXXXXXXXGOXXXXXXXXXXXXXXXXXXGOOOOXXXXXXXXXXXXXXXGOOOOXXXXXXXXXXXXXXX,0,0,0
5964,41,2,39,63,196,0,0,197,107,90,GOXXXXXXXXXXXXXXXXXXGOOXXXXXXXXXXXXXXXXXGOOOXXXXXXXXXXXXXXXXGOXXXXXXXXXXXXXXXXXXGOOAXXXXXXXXXXXXXXXXGXXXXXXXXXXXXXXXXXXXGOOOXXXXXXXXXXXXXXXXGOXXXXXXXXXXXXXXXXXXGOAXXXXXXXXXXXXXXXXXGOOOXXXXXXXXXXXXXXXXGOXXXXXXXXXXXXXXXXXXGOOOOXXXXXXXXXXXXXXXGOOOOXXXXXXXXXXXXXXX,0,0,0

5985,41,2,39,58,201,0,0,201,110,91,GOXXXXXXXXXXXXXXXXXXGOOXXXXXXXXXXXXXXXXXGOOOXXXXXXXXXXXXXXXXGOXXXXXXXXXXXXXXXXXXGOOAXXXXXXXXXXXXXXXXGXXXXXXXXXXXXXXXXXXXGOOOXXXXXXXXXXXXXXXXGOXXXXXXXXXXXXXXXXXXGOAXXXXXXXXXXXXXXXXXGOOOXXXXXXXXXXXXXXXXGOXXXXXXXXXXXXXXXXXXGOOOOXXXXXXXXXXXXXXXGOOOOXXXXXXXXXXXXXXX,0,0,0
6006,41,2,39,58,201,0,0,202,111,91,GOXXXXXXXXXXXXXXXXXXGOOXXXXXXXXXXXXXXXXXGOOOXXXXXXXXXXXXXXXXGOXXXXXXXXXXXXXXXXXXGOOAXXXXXXXXXXXXXXXXGXXXXXXXXXXXXXXXXXXXGOOOXXXXXXXXXXXXXXXXGOXXXXXXXXXXXXXXXXXXGOAXXXXXXXXXXXXXXXXXGOOOXXXXXXXXXXXXXXXXGOXXXXXXXXXXXXXXXXXXGOOOOXXXXXXXXXXXXXXXGOOOOXXXXXXXXXXXXXXX,0,0,0
6027,41,2,39,57,202,0,0,203,112,91,GOXXXXXXXXXXXXXXXXXXGOOXXXXXXXXXXXXXXXXXGOOOXXXXXXXXXXXXXXXXGOXXXXXXXXXXXXXXXXXXGOOAXXXXXXXXXXXXXXXXGXXXXXXXXXXXXXXXXXXXGOOOXXXXXXXXXXXXXXXXGOXXXXXXXXXXXXXXXXXXGOAXXXXXXXXXXXXXXXXXGOOOXXXXXXXXXXXXXXXXGOXXXXXXXXXXXXXXXXXXGOOOOXXXXXXXXXXXXXXXGOOOOXXXXXXXXXXXXXXX,0,0,0
6048,41,2,39,57,202,0,0,202,111,91,GOXXXXXXXXXXXXXXXXXXGOOXXXXXXXXXXXXXXXXXGOOOXXXXXXXXXXXXXXXXGOXXXXXXXXXXXXXXXXXXGOOAXXXXXXXXXXXXXXXXGXXXXXXXXXXXXXXXXXXXGOOOXXXXXXXXXXXXXXXXGOXXXXXXXXXXXXXXXXXXGOAXXXXXXXXXXXXXXXXXGOOOXXXXXXXXXXXXXXXXGOXXXXXXXXXXXXXXXXXXGOOOOXXXXXXXXXXXXXXXGOOOOXXXXXXXXXXXXXXX,0,0,0
6069,41,1,40,57,202,0,0,203,111,92,GOXXXXXXXXXXXXXXXXXXGOOXXXXXXXXXXXXXXXXXGOOOXXXXXXXXXXXXXXXXGOXXXXXXXXXXXXXXXXXXGOOAXXXXXXXXXXXXXXXXGXXXXXXXXXXXXXXXXXXXGOOOXXXXXXXXXXXXXXXXGOXXXXXXXXXXXXXXXXXXGOOXXXXXXXXXXXXXXXXXGOOOXXXXXXXXXXXXXXXXGOXXXXXXXXXXXXXXXXXXGOOOOXXXXXXXXXXXXXXXGOOOOXXXXXXXXXXXXXXX,0,0,0

6090,41,1,40,53,206,0,0,207,112,95,GOXXXXXXXXXXXXXXXXXXGOOXXXXXXXXXXXXXXXXXGOOOXXXXXXXXXXXXXXXXGOXXXXXXXXXXXXXXXXXXGOOAXXXXXXXXXXXXXXXXGXXXXXXXXXXXXXXXXXXXGOOOXXXXXXXXXXXXXXXXGOXXXXXXXXXXXXXXXXXXGOOXXXXXXXXXXXXXXXXXGOOOXXXXXXXXXXXXXXXXGOXXXXXXXXXXXXXXXXXXGOOOOXXXXXXXXXXXXXXXGOOOOXXXXXXXXXXXXXXX,0,0,0
6111,42,2,40,51,207,0,0,208,111,97,GOXXXXXXXXXXXXXXXXXXGOOXXXXXXXXXXXXXXXXXGOOOXXXXXXXXXXXXXXXXGOXXXXXXXXXXXXXXXXXXGOOAAXXXXXXXXXXXXXXXGXXXXXXXXXXXXXXXXXXXGOOOXXXXXXXXXXXXXXXXGOXXXXXXXXXXXXXXXXXXGOOXXXXXXXXXXXXXXXXXGOOOXXXXXXXXXXXXXXXXGOXXXXXXXXXXXXXXXXXXGOOOOXXXXXXXXXXXXXXXGOOOOXXXXXXXXXXXXXXX,0,0,0
6132,42,2,40,46,212,0,0,212,112,100,GOXXXXXXXXXXXXXXXXXXGOOXXXXXXXXXXXXXXXXXGOOOXXXXXXXXXXXXXXXXGOXXXXXXXXXXXXXXXXXXGOOAAXXXXXXXXXXXXXXXGXXXXXXXXXXXXXXXXXXXGOOOXXXXXXXXXXXXXXXXGOXXXXXXXXXXXXXXXXXXGOOXXXXXXXXXXXXXXXXXGOOOXXXXXXXXXXXXXXXXGOXXXXXXXXXXXXXXXXXXGOOOOXXXXXXXXXXXXXXXGOOOOXXXXXXXXXXXXXXX,0,0,0
6153,42,1,41,51,207,0,0,208,111,97,GOXXXXXXXXXXXXXXXXXXGOOXXXXXXXXXXXXXXXXXGOOOXXXXXXXXXXXXXXXXGOXXXXXXXXXXXXXXXXXXGOOOAXXXXXXXXXXXXXXXGXXXXXXXXXXXXXXXXXXXGOOOXXXXXXXXXXXXXXXXGOXXXXXXXXXXXXXXXXXXGOOXXXXXXXXXXXXXXXXXGOOOXXXXXXXXXXXXXXXXGOXXXXXXXXXXXXXXXXXXGOOOOXXXXXXXXXXXXXXXGOOOOXXXXXXXXXXXXXXX,0,0,0
6174,42,1,41,47,211,0,0,211,111,100,GOXXXXXXXXXXXXXXXXXXGOOXXXXXXXXXXXXXXXXXGOOOXXXXXXXXXXXXXXXXGOXXXXXXXXXXXXXXXXXXGOOOAXXXXXXXXXXXXXXXGXXXXXXXXXXXXXXXXXXXGOOOXXXXXXXXXXXXXXXXGOXXXXXXXXXXXXXXXXXXGOOXXXXXXXXXXXXXXXXXGOOOXXXXXXXXXXXXXXXXGOXXXXXXXXXXXXXXXXXXGOOOOXXXXXXXXXXXXXXXGOOOOXXXXXXXXXXXXXXX,0,0,0

6195,42,1,41,47,211,0,0,212,112,100,GOXXXXXXXXXXXXXXXXXXGOOXXXXXXXXXXXXXXXXXGOOOXXXXXXXXXXXXXXXXGOXXXXXXXXXXXXXXXXXXGOOOAXXXXXXXXXXXXXXXGXXXXXXXXXXXXXXXXXXXGOOOXXXXXXXXXXXXXXXXGOXXXXXXXXXXXXXXXXXXGOOXXXXXXXXXXXXXXXXXGOOOXXXXXXXXXXXXXXXXGOXXXXXXXXXXXXXXXXXXGOOOOXXXXXXXXXXXXXXXGOOOOXXXXXXXXXXXXXXX,0,0,0
6216,42,1,41,45,213,0,0,214,111,103,GOXXXXXXXXXXXXXXXXXXGOOXXXXXXXXXXXXXXXXXGOOOXXXXXXXXXXXXXXXXGOXXXXXXXXXXXXXXXXXXGOOOAXXXXXXXXXXXXXXXGXXXXXXXXXXXXXXXXXXXGOOOXXXXXXXXXXXXXXXXGOXXXXXXXXXXXXXXXXXXGOOXXXXXXXXXXXXXXXXXGOOOXXXXXXXXXXXXXXXXGOXXXXXXXXXXXXXXXXXXGOOOOXXXXXXXXXXXXXXXGOOOOXXXXXXXXXXXXXXX,0,0,0
6237,42,0,42,42,216,0,0,217,115,102,GOXXXXXXXXXXXXXXXXXXGOOXXXXXXXXXXXXXXXXXGOOOXXXXXXXXXXXXXXXXGOXXXXXXXXXXXXXXXXXXGOOOOXXXXXXXXXXXXXXXGXXXXXXXXXXXXXXXXXXXGOOOXXXXXXXXXXXXXXXXGOXXXXXXXXXXXXXXXXXXGOOXXXXXXXXXXXXXXXXXGOOOXXXXXXXXXXXXXXXXGOXXXXXXXXXXXXXXXXXXGOOOOXXXXXXXXXXXXXXXGOOOOXXXXXXXXXXXXXXX,0,0,0
6258,42,0,42,42,216,0,0,216,114,102,GOXXXXXXXXXXXXXXXXXXGOOXXXXXXXXXXXXXXXXXGOOOXXXXXXXXXXXXXXXXGOXXXXXXXXXXXXXXXXXXGOOOOXXXXXXXXXXXXXXXGXXXXXXXXXXXXXXXXXXXGOOOXXXXXXXXXXXXXXXXGOXXXXXXXXXXXXXXXXXXGOOXXXXXXXXXXXXXXXXXGOOOXXXXXXXXXXXXXXXXGOXXXXXXXXXXXXXXXXXXGOOOOXXXXXXXXXXXXXXXGOOOOXXXXXXXXXXXXXXX,0,0,0
6279,42,0,42,43,215,0,0,215,116,99,GOXXXXXXXXXXXXXXXXXXGOOXXXXXXXXXXXXXXXXXGOOOXXXXXXXXXXXXXXXXGOXXXXXXXXXXXXXXXXXXGOOOOXXXXXXXXXXXXXXXGXXXXXXXXXXXXXXXXXXXGOOOXXXXXXXXXXXXXXXXGOXXXXXXXXXXXXXXXXXXGOOXXXXXXXXXXXXXXXXXGOOOXXXXXXXXXXXXXXXXGOXXXXXXXXXXXXXXXXXXGOOOOXXXXXXXXXXXXXXXGOOOOXXXXXXXXXXXXXXX,0,0,0

6300,42,0,42,44,214,0,0,215,121,94,GOXXXXXXXXXXXXXXXXXXGOOXXXXXXXXXXXXXXXXXGOOOXXXXXXXXXXXXXXXXGOXXXXXXXXXXXXXXXXXXGOOOOXXXXXXXXXXXXXXXGXXXXXXXXXXXXXXXXXXXGOOOXXXXXXXXXXXXXXXXGOXXXXXXXXXXXXXXXXXXGOOXXXXXXXXXXXXXXXXXGOOOXXXXXXXXXXXXXXXXGOXXXXXXXXXXXXXXXXXXGOOOOXXXXXXXXXXXXXXXGOOOOXXXXXXXXXXXXXXX,0,0,0
6321,42,0,42,54,204,0,0,205,114,91,GOXXXXXXXXXXXXXXXXXXGOOXXXXXXXXXXXXXXXXXGOOOXXXXXXXXXXXXXXXXGOXXXXXXXXXXXXXXXXXXGOOOOXXXXXXXXXXXXXXXGXXXXXXXXXXXXXXXXXXXGOOOXXXXXXXXXXXXXXXXGOXXXXXXXXXXXXXXXXXXGOOXXXXXXXXXXXXXXXXXGOOOXXXXXXXXXXXXXXXXGOXXXXXXXXXXXXXXXXXXGOOOOXXXXXXXXXXXXXXXGOOOOXXXXXXXXXXXXXXX,0,0,0
6342,42,0,42,53,205,0,0,205,114,91,GOXXXXXXXXXXXXXXXXXXGOOXXXXXXXXXXXXXXXXXGOOOXXXXXXXXXXXXXXXXGOXXXXXXXXXXXXXXXXXXGOOOOXXXXXXXXXXXXXXXGXXXXXXXXXXXXXXXXXXXGOOOXXXXXXXXXXXXXXXXGOXXXXXXXXXXXXXXXXXXGOOXXXXXXXXXXXXXXXXXGOOOXXXXXXXXXXXXXXXXGOXXXXXXXXXXXXXXXXXXGOOOOXXXXXXXXXXXXXXXGOOOOXXXXXXXXXXXXXXX,0,0,0
6363,42,0,42,52,206,0,0,207,116,91,GOXXXXXXXXXXXXXXXXXXGOOXXXXXXXXXXXXXXXXXGOOOXXXXXXXXXXXXXXXXGOXXXXXXXXXXXXXXXXXXGOOOOXXXXXXXXXXXXXXXGXXXXXXXXXXXXXXXXXXXGOOOXXXXXXXXXXXXXXXXGOXXXXXXXXXXXXXXXXXXGOOXXXXXXXXXXXXXXXXXGOOOXXXXXXXXXXXXXXXXGOXXXXXXXXXXXXXXXXXXGOOOOXXXXXXXXXXXXXXXGOOOOXXXXXXXXXXXXXXX,0,0,0
6384,42,0,42,50,208,0,0,208,116,92,GOXXXXXXXXXXXXXXXXXXGOOXXXXXXXXXXXXXXXXXGOOOXXXXXXXXXXXXXXXXGOXXXXXXXXXXXXXXXXXXGOOOOXXXXXXXXXXXXXXXGXXXXXXXXXXXXXXXXXXXGOOOXXXXXXXXXXXXXXXXGOXXXXXXXXXXXXXXXXXXGOOXXXXXXXXXXXXXXXXXGOOOXXXXXXXXXXXXXXXXGOXXXXXXXXXXXXXXXXXXGOOOOXXXXXXXXXXXXXXXGOOOOXXXXXXXXXXXXXXX,0,0,0

6405,42,0,42,51,207,0,0,208,118,90,GOXXXXXXXXXXXXXXXXXXGOOXXXXXXXXXXXXXXXXXGOOOXXXXXXXXXXXXXXXXGOXXXXXXXXXXXXXXXXXXGOOOOXXXXXXXXXXXXXXXGXXXXXXXXXXXXXXXXXXXGOOOXXXXXXXXXXXXXXXXGOXXXXXXXXXXXXXXXXXXGOOXXXXXXXXXXXXXXXXXGOOOXXXXXXXXXXXXXXXXGOXXXXXXXXXXXXXXXXXXGOOOOXXXXXXXXXXXXXXXGOOOOXXXXXXXXXXXXXXX,0,0,0
6426,43,1,42,51,206,0,0,208,117,91,GOXXXXXXXXXXXXXXXXXXGOOAXXXXXXXXXXXXXXXXGOOOXXXXXXXXXXXXXXXXGOXXXXXXXXXXXXXXXXXXGOOOOXXXXXXXXXXXXXXXGXXXXXXXXXXXXXXXXXXXGOOOXXXXXXXXXXXXXXXXGOXXXXXXXXXXXXXXXXXXGOOXXXXXXXXXXXXXXXXXGOOOXXXXXXXXXXXXXXXXGOXXXXXXXXXXXXXXXXXXGOOOOXXXXXXXXXXXXXXXGOOOOXXXXXXXXXXXXXXX,0,0,0
6447,43,1,42,53,204,0,0,205,121,84,GOXXXXXXXXXXXXXXXXXXGOOAXXXXXXXXXXXXXXXXGOOOXXXXXXXXXXXXXXXXGOXXXXXXXXXXXXXXXXXXGOOOOXXXXXXXXXXXXXXXGXXXXXXXXXXXXXXXXXXXGOOOXXXXXXXXXXXXXXXXGOXXXXXXXXXXXXXXXXXXGOOXXXXXXXXXXXXXXXXXGOOOXXXXXXXXXXXXXXXXGOXXXXXXXXXXXXXXXXXXGOOOOXXXXXXXXXXXXXXXGOOOOXXXXXXXXXXXXXXX,0,0,0
6468,43,1,42,55,202,0,0,203,116,87,GOXXXXXXXXXXXXXXXXXXGOOAXXXXXXXXXXXXXXXXGOOOXXXXXXXXXXXXXXXXGOXXXXXXXXXXXXXXXXXXGOOOOXXXXXXXXXXXXXXXGXXXXXXXXXXXXXXXXXXXGOOOXXXXXXXXXXXXXXXXGOXXXXXXXXXXXXXXXXXXGOOXXXXXXXXXXXXXXXXXGOOOXXXXXXXXXXXXXXXXGOXXXXXXXXXXXXXXXXXXGOOOOXXXXXXXXXXXXXXXGOOOOXXXXXXXXXXXXXXX,0,0,0
6489,43,1,42,59,198,0,0,200,115,85,GOXXXXXXXXXXXXXXXXXXGOOAXXXXXXXXXXXXXXXXGOOOXXXXXXXXXXXXXXXXGOXXXXXXXXXXXXXXXXXXGOOOOXXXXXXXXXXXXXXXGXXXXXXXXXXXXXXXXXXXGOOOXXXXXXXXXXXXXXXXGOXXXXXXXXXXXXXXXXXXGOOXXXXXXXXXXXXXXXXXGOOOXXXXXXXXXXXXXXXXGOXXXXXXXXXXXXXXXXXXGOOOOXXXXXXXXXXXXXXXGOOOOXXXXXXXXXXXXXXX,0,0,0

6510,43,1,42,56,201,0,0,202,112,90,GOXXXXXXXXXXXXXXXXXXGOOAXXXXXXXXXXXXXXXXGOOOXXXXXXXXXXXXXXXXGOXXXXXXXXXXXXXXXXXXGOOOOXXXXXXXXXXXXXXXGXXXXXXXXXXXXXXXXXXXGOOOXXXXXXXXXXXXXXXXGOXXXXXXXXXXXXXXXXXXGOOXXXXXXXXXXXXXXXXXGOOOXXXXXXXXXXXXXXXXGOXXXXXXXXXXXXXXXXXXGOOOOXXXXXXXXXXXXXXXGOOOOXXXXXXXXXXXXXXX,0,0,0
6531,43,1,42,55,202,0,0,203,112,91,GOXXXXXXXXXXXXXXXXXXGOOAXXXXXXXXXXXXXXXXGOOOXXXXXXXXXXXXXXXXGOXXXXXXXXXXXXXXXXXXGOOOOXXXXXXXXXXXXXXXGXXXXXXXXXXXXXXXXXXXGOOOXXXXXXXXXXXXXXXXGOXXXXXXXXXXXXXXXXXXGOOXXXXXXXXXXXXXXXXXGOOOXXXXXXXXXXXXXXXXGOXXXXXXXXXXXXXXXXXXGOOOOXXXXXXXXXXXXXXXGOOOOXXXXXXXXXXXXXXX,0,0,0
6552,43,1,42,51,206,0,0,207,114,93,GOXXXXXXXXXXXXXXXXXXGOOAXXXXXXXXXXXXXXXXGOOOXXXXXXXXXXXXXXXXGOXXXXXXXXXXXXXXXXXXGOOOOXXXXXXXXXXXXXXXGXXXXXXXXXXXXXXXXXXXGOOOXXXXXXXXXXXXXXXXGOXXXXXXXXXXXXXXXXXXGOOXXXXXXXXXXXXXXXXXGOOOXXXXXXXXXXXXXXXXGOXXXXXXXXXXXXXXXXXXGOOOOXXXXXXXXXXXXXXXGOOOOXXXXXXXXXXXXXXX,0,0,0
6573,43,1,42,46,211,0,0,213,115,98,GOXXXXXXXXXXXXXXXXXXGOOAXXXXXXXXXXXXXXXXGOOOXXXXXXXXXXXXXXXXGOXXXXXXXXXXXXXXXXXXGOOOOXXXXXXXXXXXXXXXGXXXXXXXXXXXXXXXXXXXGOOOXXXXXXXXXXXXXXXXGOXXXXXXXXXXXXXXXXXXGOOXXXXXXXXXXXXXXXXXGOOOXXXXXXXXXXXXXXXXGOXXXXXXXXXXXXXXXXXXGOOOOXXXXXXXXXXXXXXXGOOOOXXXXXXXXXXXXXXX,0,0,0
6594,43,1,42,50,207,0,0,209,118,91,GOXXXXXXXXXXXXXXXXXXGOOAXXXXXXXXXXXXXXXXGOOOXXXXXXXXXXXXXXXXGOXXXXXXXXXXXXXXXXXXGOOOOXXXXXXXXXXXXXXXGXXXXXXXXXXXXXXXXXXXGOOOXXXXXXXXXXXXXXXXGOXXXXXXXXXXXXXXXXXXGOOXXXXXXXXXXXXXXXXXGOOOXXXXXXXXXXXXXXXXGOXXXXXXXXXXXXXXXXXXGOOOOXXXXXXXXXXXXXXXGOOOOXXXXXXXXXXXXXXX,0,0,0

6615,43,0,43,50,207,0,0,209,117,92,GOXXXXXXXXXXXXXXXXXXGOOOXXXXXXXXXXXXXXXXGOOOXXXXXXXXXXXXXXXXGOXXXXXXXXXXXXXXXXXXGOOOOXXXXXXXXXXXXXXXGXXXXXXXXXXXXXXXXXXXGOOOXXXXXXXXXXXXXXXXGOXXXXXXXXXXXXXXXXXXGOOXXXXXXXXXXXXXXXXXGOOOXXXXXXXXXXXXXXXXGOXXXXXXXXXXXXXXXXXXGOOOOXXXXXXXXXXXXXXXGOOOOXXXXXXXXXXXXXXX,0,0,0
6636,43,0,43,53,204,0,0,206,116,90,GOXXXXXXXXXXXXXXXXXXGOOOXXXXXXXXXXXXXXXXGOOOXXXXXXXXXXXXXXXXGOXXXXXXXXXXXXXXXXXXGOOOOXXXXXXXXXXXXXXXGXXXXXXXXXXXXXXXXXXXGOOOXXXXXXXXXXXXXXXXGOXXXXXXXXXXXXXXXXXXGOOXXXXXXXXXXXXXXXXXGOOOXXXXXXXXXXXXXXXXGOXXXXXXXXXXXXXXXXXXGOOOOXXXXXXXXXXXXXXXGOOOOXXXXXXXXXXXXXXX,0,0,0
6657,43,0,43,52,205,0,0,207,116,91,GOXXXXXXXXXXXXXXXXXXGOOOXXXXXXXXXXXXXXXXGOOOXXXXXXXXXXXXXXXXGOXXXXXXXXXXXXXXXXXXGOOOOXXXXXXXXXXXXXXXGXXXXXXXXXXXXXXXXXXXGOOOXXXXXXXXXXXXXXXXGOXXXXXXXXXXXXXXXXXXGOOXXXXXXXXXXXXXXXXXGOOOXXXXXXXXXXXXXXXXGOXXXXXXXXXXXXXXXXXXGOOOOXXXXXXXXXXXXXXXGOOOOXXXXXXXXXXXXXXX,0,0,0
6678,43,0,43,50,207,0,0,209,116,93,GOXXXXXXXXXXXXXXXXXXGOOOXXXXXXXXXXXXXXXXGOOOXXXXXXXXXXXXXXXXGOXXXXXXXXXXXXXXXXXXGOOOOXXXXXXXXXXXXXXXGXXXXXXXXXXXXXXXXXXXGOOOXXXXXXXXXXXXXXXXGOXXXXXXXXXXXXXXXXXXGOOXXXXXXXXXXXXXXXXXGOOOXXXXXXXXXXXXXXXXGOXXXXXXXXXXXXXXXXXXGOOOOXXXXXXXXXXXXXXXGOOOOXXXXXXXXXXXXXXX,0,0,0
6699,43,0,43,47,210,0,0,211,116,95,GOXXXXXXXXXXXXXXXXXXGOOOXXXXXXXXXXXXXXXXGOOOXXXXXXXXXXXXXXXXGOXXXXXXXXXXXXXXXXXXGOOOOXXXXXXXXXXXXXXXGXXXXXXXXXXXXXXXXXXXGOOOXXXXXXXXXXXXXXXXGOXXXXXXXXXXXXXXXXXXGOOXXXXXXXXXXXXXXXXXGOOOXXXXXXXXXXXXXXXXGOXXXXXXXXXXXXXXXXXXGOOOOXXXXXXXXXXXXXXXGOOOOXXXXXXXXXXXXXXX,0,0,0

6720,43,0,43,44,213,0,0,214,116,98,GOXXXXXXXXXXXXXXXXXXGOOOXXXXXXXXXXXXXXXXGOOOXXXXXXXXXXXXXXXXGOXXXXXXXXXXXXXXXXXXGOOOOXXXXXXXXXXXXXXXGXXXXXXXXXXXXXXXXXXXGOOOXXXXXXXXXXXXXXXXGOXXXXXXXXXXXXXXXXXXGOOXXXXXXXXXXXXXXXXXGOOOXXXXXXXXXXXXXXXXGOXXXXXXXXXXXXXXXXXXGOOOOXXXXXXXXXXXXXXXGOOOOXXXXXXXXXXXXXXX,0,0,0
6741,43,0,43,43,214,0,0,215,113,102,GOXXXXXXXXXXXXXXXXXXGOOOXXXXXXXXXXXXXXXXGOOOXXXXXXXXXXXXXXXXGOXXXXXXXXXXXXXXXXXXGOOOOXXXXXXXXXXXXXXXGXXXXXXXXXXXXXXXXXXXGOOOXXXXXXXXXXXXXXXXGOXXXXXXXXXXXXXXXXXXGOOXXXXXXXXXXXXXXXXXGOOOXXXXXXXXXXXXXXXXGOXXXXXXXXXXXXXXXXXXGOOOOXXXXXXXXXXXXXXXGOOOOXXXXXXXXXXXXXXX,0,0,0
6762,43,0,43,43,214,0,0,215,118,97,GOXXXXXXXXXXXXXXXXXXGOOOXXXXXXXXXXXXXXXXGOOOXXXXXXXXXXXXXXXXGOXXXXXXXXXXXXXXXXXXGOOOOXXXXXXXXXXXXXXXGXXXXXXXXXXXXXXXXXXXGOOOXXXXXXXXXXXXXXXXGOXXXXXXXXXXXXXXXXXXGOOXXXXXXXXXXXXXXXXXGOOOXXXXXXXXXXXXXXXXGOXXXXXXXXXXXXXXXXXXGOOOOXXXXXXXXXXXXXXXGOOOOXXXXXXXXXXXXXXX,0,0,0
6783,43,0,43,44,213,0,0,214,120,94,GOXXXXXXXXXXXXXXXXXXGOOOXXXXXXXXXXXXXXXXGOOOXXXXXXXXXXXXXXXXGOXXXXXXXXXXXXXXXXXXGOOOOXXXXXXXXXXXXXXXGXXXXXXXXXXXXXXXXXXXGOOOXXXXXXXXXXXXXXXXGOXXXXXXXXXXXXXXXXXXGOOXXXXXXXXXXXXXXXXXGOOOXXXXXXXXXXXXXXXXGOXXXXXXXXXXXXXXXXXXGOOOOXXXXXXXXXXXXXXXGOOOOXXXXXXXXXXXXXXX,0,0,0
6804,43,0,43,47,210,0,0,211,118,93,GOXXXXXXXXXXXXXXXXXXGOOOXXXXXXXXXXXXXXXXGOOOXXXXXXXXXXXXXXXXGOXXXXXXXXXXXXXXXXXXGOOOOXXXXXXXXXXXXXXXGXXXXXXXXXXXXXXXXXXXGOOOXXXXXXXXXXXXXXXXGOXXXXXXXXXXXXXXXXXXGOOXXXXXXXXXXXXXXXXXGOOOXXXXXXXXXXXXXXXXGOXXXXXXXXXXXXXXXXXXGOOOOXXXXXXXXXXXXXXXGOOOOXXXXXXXXXXXXXXX,0,0,0

6825,43,0,43,46,211,0,0,212,118,94,GOXXXXXXXXXXXXXXXXXXGOOOXXXXXXXXXXXXXXXXGOOOXXXXXXXXXXXXXXXXGOXXXXXXXXXXXXXXXXXXGOOOOXXXXXXXXXXXXXXXGXXXXXXXXXXXXXXXXXXXGOOOXXXXXXXXXXXXXXXXGOXXXXXXXXXXXXXXXXXXGOOXXXXXXXXXXXXXXXXXGOOOXXXXXXXXXXXXXXXXGOXXXXXXXXXXXXXXXXXXGOOOOXXXXXXXXXXXXXXXGOOOOXXXXXXXXXXXXXXX,0,0,0
6846,43,0,43,41,216,0,0,217,121,96,GOXXXXXXXXXXXXXXXXXXGOOOXXXXXXXXXXXXXXXXGOOOXXXXXXXXXXXXXXXXGOXXXXXXXXXXXXXXXXXXGOOOOXXXXXXXXXXXXXXXGXXXXXXXXXXXXXXXXXXXGOOOXXXXXXXXXXXXXXXXGOXXXXXXXXXXXXXXXXXXGOOXXXXXXXXXXXXXXXXXGOOOXXXXXXXXXXXXXXXXGOXXXXXXXXXXXXXXXXXXGOOOOXXXXXXXXXXXXXXXGOOOOXXXXXXXXXXXXXXX,0,0,0
6867,43,0,43,43,214,0,0,215,115,100,GOXXXXXXXXXXXXXXXXXXGOOOXXXXXXXXXXXXXXXXGOOOXXXXXXXXXXXXXXXXGOXXXXXXXXXXXXXXXXXXGOOOOXXXXXXXXXXXXXXXGXXXXXXXXXXXXXXXXXXXGOOOXXXXXXXXXXXXXXXXGOXXXXXXXXXXXXXXXXXXGOOXXXXXXXXXXXXXXXXXGOOOXXXXXXXXXXXXXXXXGOXXXXXXXXXXXXXXXXXXGOOOOXXXXXXXXXXXXXXXGOOOOXXXXXXXXXXXXXXX,0,0,0
6888,43,0,43,42,215,0,0,215,119,96,GOXXXXXXXXXXXXXXXXXXGOOOXXXXXXXXXXXXXXXXGOOOXXXXXXXXXXXXXXXXGOXXXXXXXXXXXXXXXXXXGOOOOXXXXXXXXXXXXXXXGXXXXXXXXXXXXXXXXXXXGOOOXXXXXXXXXXXXXXXXGOXXXXXXXXXXXXXXXXXXGOOXXXXXXXXXXXXXXXXXGOOOXXXXXXXXXXXXXXXXGOXXXXXXXXXXXXXXXXXXGOOOOXXXXXXXXXXXXXXXGOOOOXXXXXXXXXXXXXXX,0,0,0
6909,43,0,43,34,223,0,0,222,124,98,GOXXXXXXXXXXXXXXXXXXGOOOXXXXXXXXXXXXXXXXGOOOXXXXXXXXXXXXXXXXGOXXXXXXXXXXXXXXXXXXGOOOOXXXXXXXXXXXXXXXGXXXXXXXXXXXXXXXXXXXGOOOXXXXXXXXXXXXXXXXGOXXXXXXXXXXXXXXXXXXGOOXXXXXXXXXXXXXXXXXGOOOXXXXXXXXXXXXXXXXGOXXXXXXXXXXXXXXXXXXGOOOOXXXXXXXXXXXXXXXGOOOOXXXXXXXXXXXXXXX,0,0,0

6930,43,0,43,37,220,0,0,221,122,99,GOXXXXXXXXXXXXXXXXXXGOOOXXXXXXXXXXXXXXXXGOOOXXXXXXXXXXXXXXXXGOXXXXXXXXXXXXXXXXXXGOOOOXXXXXXXXXXXXXXXGXXXXXXXXXXXXXXXXXXXGOOOXXXXXXXXXXXXXXXXGOXXXXXXXXXXXXXXXXXXGOOXXXXXXXXXXXXXXXXXGOOOXXXXXXXXXXXXXXXXGOXXXXXXXXXXXXXXXXXXGOOOOXXXXXXXXXXXXXXXGOOOOXXXXXXXXXXXXXXX,0,0,0
6951,43,0,43,41,216,0,0,217,124,93,GOXXXXXXXXXXXXXXXXXXGOOOXXXXXXXXXXXXXXXXGOOOXXXXXXXXXXXXXXXXGOXXXXXXXXXXXXXXXXXXGOOOOXXXXXXXXXXXXXXXGXXXXXXXXXXXXXXXXXXXGOOOXXXXXXXXXXXXXXXXGOXXXXXXXXXXXXXXXXXXGOOXXXXXXXXXXXXXXXXXGOOOXXXXXXXXXXXXXXXXGOXXXXXXXXXXXXXXXXXXGOOOOXXXXXXXXXXXXXXXGOOOOXXXXXXXXXXXXXXX,0,0,0
6972,43,0,43,46,211,0,0,212,119,93,GOXXXXXXXXXXXXXXXXXXGOOOXXXXXXXXXXXXXXXXGOOOXXXXXXXXXXXXXXXXGOXXXXXXXXXXXXXXXXXXGOOOOXXXXXXXXXXXXXXXGXXXXXXXXXXXXXXXXXXXGOOOXXXXXXXXXXXXXXXXGOXXXXXXXXXXXXXXXXXXGOOXXXXXXXXXXXXXXXXXGOOOXXXXXXXXXXXXXXXXGOXXXXXXXXXXXXXXXXXXGOOOOXXXXXXXXXXXXXXXGOOOOXXXXXXXXXXXXXXX,0,0,0
6993,43,0,43,46,211,0,0,212,122,90,GOXXXXXXXXXXXXXXXXXXGOOOXXXXXXXXXXXXXXXXGOOOXXXXXXXXXXXXXXXXGOXXXXXXXXXXXXXXXXXXGOOOOXXXXXXXXXXXXXXXGXXXXXXXXXXXXXXXXXXXGOOOXXXXXXXXXXXXXXXXGOXXXXXXXXXXXXXXXXXXGOOXXXXXXXXXXXXXXXXXGOOOXXXXXXXXXXXXXXXXGOXXXXXXXXXXXXXXXXXXGOOOOXXXXXXXXXXXXXXXGOOOOXXXXXXXXXXXXXXX,0,0,0
7014,43,0,43,48,209,0,0,210,123,87,GOXXXXXXXXXXXXXXXXXXGOOOXXXXXXXXXXXXXXXXGOOOXXXXXXXXXXXXXXXXGOXXXXXXXXXXXXXXXXXXGOOOOXXXXXXXXXXXXXXXGXXXXXXXXXXXXXXXXXXXGOOOXXXXXXXXXXXXXXXXGOXXXXXXXXXXXXXXXXXXGOOXXXXXXXXXXXXXXXXXGOOOXXXXXXXXXXXXXXXXGOXXXXXXXXXXXXXXXXXXGOOOOXXXXXXXXXXXXXXXGOOOOXXXXXXXXXXXXXXX,0,0,0

7035,43,0,43,47,210,0,0,211,121,90,GOXXXXXXXXXXXXXXXXXXGOOOXXXXXXXXXXXXXXXXGOOOXXXXXXXXXXXXXXXXGOXXXXXXXXXXXXXXXXXXGOOOOXXXXXXXXXXXXXXXGXXXXXXXXXXXXXXXXXXXGOOOXXXXXXXXXXXXXXXXGOXXXXXXXXXXXXXXXXXXGOOXXXXXXXXXXXXXXXXXGOOOXXXXXXXXXXXXXXXXGOXXXXXXXXXXXXXXXXXXGOOOOXXXXXXXXXXXXXXXGOOOOXXXXXXXXXXXXXXX,0,0,0
7056,43,0,43,46,211,0,0,212,119,93,GOXXXXXXXXXXXXXXXXXXGOOOXXXXXXXXXXXXXXXXGOOOXXXXXXXXXXXXXXXXGOXXXXXXXXXXXXXXXXXXGOOOOXXXXXXXXXXXXXXXGXXXXXXXXXXXXXXXXXXXGOOOXXXXXXXXXXXXXXXXGOXXXXXXXXXXXXXXXXXXGOOXXXXXXXXXXXXXXXXXGOOOXXXXXXXXXXXXXXXXGOXXXXXXXXXXXXXXXXXXGOOOOXXXXXXXXXXXXXXXGOOOOXXXXXXXXXXXXXXX,0,0,0
7077,44,1,43,48,208,0,0,209,118,91,GOXXXXXXXXXXXXXXXXXXGOOOXXXXXXXXXXXXXXXXGOOOXXXXXXXXXXXXXXXXGOXXXXXXXXXXXXXXXXXXGOOOOAXXXXXXXXXXXXXXGXXXXXXXXXXXXXXXXXXXGOOOXXXXXXXXXXXXXXXXGOXXXXXXXXXXXXXXXXXXGOOXXXXXXXXXXXXXXXXXGOOOXXXXXXXXXXXXXXXXGOXXXXXXXXXXXXXXXXXXGOOOOXXXXXXXXXXXXXXXGOOOOXXXXXXXXXXXXXXX,0,0,0
7098,44,1,43,48,208,0,0,209,126,83,GOXXXXXXXXXXXXXXXXXXGOOOXXXXXXXXXXXXXXXXGOOOXXXXXXXXXXXXXXXXGOXXXXXXXXXXXXXXXXXXGOOOOAXXXXXXXXXXXXXXGXXXXXXXXXXXXXXXXXXXGOOOXXXXXXXXXXXXXXXXGOXXXXXXXXXXXXXXXXXXGOOXXXXXXXXXXXXXXXXXGOOOXXXXXXXXXXXXXXXXGOXXXXXXXXXXXXXXXXXXGOOOOXXXXXXXXXXXXXXXGOOOOXXXXXXXXXXXXXXX,0,0,0
7119,44,0,44,60,196,0,0,197,122,75,GOXXXXXXXXXXXXXXXXXXGOOOXXXXXXXXXXXXXXXXGOOOXXXXXXXXXXXXXXXXGOXXXXXXXXXXXXXXXXXXGOOOOOXXXXXXXXXXXXXXGXXXXXXXXXXXXXXXXXXXGOOOXXXXXXXXXXXXXXXXGOXXXXXXXXXXXXXXXXXXGOOXXXXXXXXXXXXXXXXXGOOOXXXXXXXXXXXXXXXXGOXXXXXXXXXXXXXXXXXXGOOOOXXXXXXXXXXXXXXXGOOOOXXXXXXXXXXXXXXX,0,0,0

7140,44,0,44,63,193,0,0,194,120,74,GOXXXXXXXXXXXXXXXXXXGOOOXXXXXXXXXXXXXXXXGOOOXXXXXXXXXXXXXXXXGOXXXXXXXXXXXXXXXXXXGOOOOOXXXXXXXXXXXXXXGXXXXXXXXXXXXXXXXXXXGOOOXXXXXXXXXXXXXXXXGOXXXXXXXXXXXXXXXXXXGOOXXXXXXXXXXXXXXXXXGOOOXXXXXXXXXXXXXXXXGOXXXXXXXXXXXXXXXXXXGOOOOXXXXXXXXXXXXXXXGOOOOXXXXXXXXXXXXXXX,0,0,0
7161,44,0,44,62,194,0,0,195,123,72,GOXXXXXXXXXXXXXXXXXXGOOOXXXXXXXXXXXXXXXXGOOOXXXXXXXXXXXXXXXXGOXXXXXXXXXXXXXXXXXXGOOOOOXXXXXXXXXXXXXXGXXXXXXXXXXXXXXXXXXXGOOOXXXXXXXXXXXXXXXXGOXXXXXXXXXXXXXXXXXXGOOXXXXXXXXXXXXXXXXXGOOOXXXXXXXXXXXXXXXXGOXXXXXXXXXXXXXXXXXXGOOOOXXXXXXXXXXXXXXXGOOOOXXXXXXXXXXXXXXX,0,0,0
7182,44,0,44,58,198,0,0,199,122,77,GOXXXXXXXXXXXXXXXXXXGOOOXXXXXXXXXXXXXXXXGOOOXXXXXXXXXXXXXXXXGOXXXXXXXXXXXXXXXXXXGOOOOOXXXXXXXXXXXXXXGXXXXXXXXXXXXXXXXXXXGOOOXXXXXXXXXXXXXXXXGOXXXXXXXXXXXXXXXXXXGOOXXXXXXXXXXXXXXXXXGOOOXXXXXXXXXXXXXXXXGOXXXXXXXXXXXXXXXXXXGOOOOXXXXXXXXXXXXXXXGOOOOXXXXXXXXXXXXXXX,0,0,0
7203,44,0,44,58,198,0,0,199,120,79,GOXXXXXXXXXXXXXXXXXXGOOOXXXXXXXXXXXXXXXXGOOOXXXXXXXXXXXXXXXXGOXXXXXXXXXXXXXXXXXXGOOOOOXXXXXXXXXXXXXXGXXXXXXXXXXXXXXXXXXXGOOOXXXXXXXXXXXXXXXXGOXXXXXXXXXXXXXXXXXXGOOXXXXXXXXXXXXXXXXXGOOOXXXXXXXXXXXXXXXXGOXXXXXXXXXXXXXXXXXXGOOOOXXXXXXXXXXXXXXXGOOOOXXXXXXXXXXXXXXX,0,0,0
7224,44,0,44,58,198,0,0,199,121,78,GOXXXXXXXXXXXXXXXXXXGOOOXXXXXXXXXXXXXXXXGOOOXXXXXXXXXXXXXXXXGOXXXXXXXXXXXXXXXXXXGOOOOOXXXXXXXXXXXXXXGXXXXXXXXXXXXXXXXXXXGOOOXXXXXXXXXXXXXXXXGOXXXXXXXXXXXXXXXXXXGOOXXXXXXXXXXXXXXXXXGOOOXXXXXXXXXXXXXXXXGOXXXXXXXXXXXXXXXXXXGOOOOXXXXXXXXXXXXXXXGOOOOXXXXXXXXXXXXXXX,0,0,0

7245,44,0,44,59,197,0,0,197,124,73,GOXXXXXXXXXXXXXXXXXXGOOOXXXXXXXXXXXXXXXXGOOOXXXXXXXXXXXXXXXXGOXXXXXXXXXXXXXXXXXXGOOOOOXXXXXXXXXXXXXXGXXXXXXXXXXXXXXXXXXXGOOOXXXXXXXXXXXXXXXXGOXXXXXXXXXXXXXXXXXXGOOXXXXXXXXXXXXXXXXXGOOOXXXXXXXXXXXXXXXXGOXXXXXXXXXXXXXXXXXXGOOOOXXXXXXXXXXXXXXXGOOOOXXXXXXXXXXXXXXX,0,0,0
7266,44,0,44,62,194,0,0,196,117,79,GOXXXXXXXXXXXXXXXXXXGOOOXXXXXXXXXXXXXXXXGOOOXXXXXXXXXXXXXXXXGOXXXXXXXXXXXXXXXXXXGOOOOOXXXXXXXXXXXXXXGXXXXXXXXXXXXXXXXXXXGOOOXXXXXXXXXXXXXXXXGOXXXXXXXXXXXXXXXXXXGOOXXXXXXXXXXXXXXXXXGOOOXXXXXXXXXXXXXXXXGOXXXXXXXXXXXXXXXXXXGOOOOXXXXXXXXXXXXXXXGOOOOXXXXXXXXXXXXXXX,0,0,0
7287,45,1,44,58,197,0,0,198,117,81,GOAXXXXXXXXXXXXXXXXXGOOOXXXXXXXXXXXXXXXXGOOOXXXXXXXXXXXXXXXXGOXXXXXXXXXXXXXXXXXXGOOOOOXXXXXXXXXXXXXXGXXXXXXXXXXXXXXXXXXXGOOOXXXXXXXXXXXXXXXXGOXXXXXXXXXXXXXXXXXXGOOXXXXXXXXXXXXXXXXXGOOOXXXXXXXXXXXXXXXXGOXXXXXXXXXXXXXXXXXXGOOOOXXXXXXXXXXXXXXXGOOOOXXXXXXXXXXXXXXX,0,0,0
7308,45,0,45,57,198,0,0,200,121,79,GOOXXXXXXXXXXXXXXXXXGOOOXXXXXXXXXXXXXXXXGOOOXXXXXXXXXXXXXXXXGOXXXXXXXXXXXXXXXXXXGOOOOOXXXXXXXXXXXXXXGXXXXXXXXXXXXXXXXXXXGOOOXXXXXXXXXXXXXXXXGOXXXXXXXXXXXXXXXXXXGOOXXXXXXXXXXXXXXXXXGOOOXXXXXXXXXXXXXXXXGOXXXXXXXXXXXXXXXXXXGOOOOXXXXXXXXXXXXXXXGOOOOXXXXXXXXXXXXXXX,0,0,0
7329,45,0,45,52,203,0,0,205,118,87,GOOXXXXXXXXXXXXXXXXXGOOOXXXXXXXXXXXXXXXXGOOOXXXXXXXXXXXXXXXXGOXXXXXXXXXXXXXXXXXXGOOOOOXXXXXXXXXXXXXXGXXXXXXXXXXXXXXXXXXXGOOOXXXXXXXXXXXXXXXXGOXXXXXXXXXXXXXXXXXXGOOXXXXXXXXXXXXXXXXXGOOOXXXXXXXXXXXXXXXXGOXXXXXXXXXXXXXXXXXXGOOOOXXXXXXXXXXXXXXXGOOOOXXXXXXXXXXXXXXX,0,0,0

7350,45,0,45,48,207,0,0,208,118,90,GOOXXXXXXXXXXXXXXXXXGOOOXXXXXXXXXXXXXXXXGOOOXXXXXXXXXXXXXXXXGOXXXXXXXXXXXXXXXXXXGOOOOOXXXXXXXXXXXXXXGXXXXXXXXXXXXXXXXXXXGOOOXXXXXXXXXXXXXXXXGOXXXXXXXXXXXXXXXXXXGOOXXXXXXXXXXXXXXXXXGOOOXXXXXXXXXXXXXXXXGOXXXXXXXXXXXXXXXXXXGOOOOXXXXXXXXXXXXXXXGOOOOXXXXXXXXXXXXXXX,0,0,0
7371,45,0,45,46,209,0,0,211,118,93,GOOXXXXXXXXXXXXXXXXXGOOOXXXXXXXXXXXXXXXXGOOOXXXXXXXXXXXXXXXXGOXXXXXXXXXXXXXXXXXXGOOOOOXXXXXXXXXXXXXXGXXXXXXXXXXXXXXXXXXXGOOOXXXXXXXXXXXXXXXXGOXXXXXXXXXXXXXXXXXXGOOXXXXXXXXXXXXXXXXXGOOOXXXXXXXXXXXXXXXXGOXXXXXXXXXXXXXXXXXXGOOOOXXXXXXXXXXXXXXXGOOOOXXXXXXXXXXXXXXX,0,0,0
7392,45,0,45,45,210,0,0,212,121,91,GOOXXXXXXXXXXXXXXXXXGOOOXXXXXXXXXXXXXXXXGOOOXXXXXXXXXXXXXXXXGOXXXXXXXXXXXXXXXXXXGOOOOOXXXXXXXXXXXXXXGXXXXXXXXXXXXXXXXXXXGOOOXXXXXXXXXXXXXXXXGOXXXXXXXXXXXXXXXXXXGOOXXXXXXXXXXXXXXXXXGOOOXXXXXXXXXXXXXXXXGOXXXXXXXXXXXXXXXXXXGOOOOXXXXXXXXXXXXXXXGOOOOXXXXXXXXXXXXXXX,0,0,0
7413,45,0,45,45,210,0,0,212,121,91,GOOXXXXXXXXXXXXXXXXXGOOOXXXXXXXXXXXXXXXXGOOOXXXXXXXXXXXXXXXXGOXXXXXXXXXXXXXXXXXXGOOOOOXXXXXXXXXXXXXXGXXXXXXXXXXXXXXXXXXXGOOOXXXXXXXXXXXXXXXXGOXXXXXXXXXXXXXXXXXXGOOXXXXXXXXXXXXXXXXXGOOOXXXXXXXXXXXXXXXXGOXXXXXXXXXXXXXXXXXXGOOOOXXXXXXXXXXXXXXXGOOOOXXXXXXXXXXXXXXX,0,0,0
7434,45,0,45,46,209,0,0,211,120,91,GOOXXXXXXXXXXXXXXXXXGOOOXXXXXXXXXXXXXXXXGOOOXXXXXXXXXXXXXXXXGOXXXXXXXXXXXXXXXXXXGOOOOOXXXXXXXXXXXXXXGXXXXXXXXXXXXXXXXXXXGOOOXXXXXXXXXXXXXXXXGOXXXXXXXXXXXXXXXXXXGOOXXXXXXXXXXXXXXXXXGOOOXXXXXXXXXXXXXXXXGOXXXXXXXXXXXXXXXXXXGOOOOXXXXXXXXXXXXXXXGOOOOXXXXXXXXXXXXXXX,0,0,0

7455,45,0,45,45,210,0,0,211,119,92,GOOXXXXXXXXXXXXXXXXXGOOOXXXXXXXXXXXXXXXXGOOOXXXXXXXXXXXXXXXXGOXXXXXXXXXXXXXXXXXXGOOOOOXXXXXXXXXXXXXXGXXXXXXXXXXXXXXXXXXXGOOOXXXXXXXXXXXXXXXXGOXXXXXXXXXXXXXXXXXXGOOXXXXXXXXXXXXXXXXXGOOOXXXXXXXXXXXXXXXXGOXXXXXXXXXXXXXXXXXXGOOOOXXXXXXXXXXXXXXXGOOOOXXXXXXXXXXXXXXX,0,0,0
7476,45,0,45,43,212,0,0,213,125,88,GOOXXXXXXXXXXXXXXXXXGOOOXXXXXXXXXXXXXXXXGOOOXXXXXXXXXXXXXXXXGOXXXXXXXXXXXXXXXXXXGOOOOOXXXXXXXXXXXXXXGXXXXXXXXXXXXXXXXXXXGOOOXXXXXXXXXXXXXXXXGOXXXXXXXXXXXXXXXXXXGOOXXXXXXXXXXXXXXXXXGOOOXXXXXXXXXXXXXXXXGOXXXXXXXXXXXXXXXXXXGOOOOXXXXXXXXXXXXXXXGOOOOXXXXXXXXXXXXXXX,0,0,0
7497,45,0,45,42,213,0,0,213,126,87,GOOXXXXXXXXXXXXXXXXXGOOOXXXXXXXXXXXXXXXXGOOOXXXXXXXXXXXXXXXXGOXXXXXXXXXXXXXXXXXXGOOOOOXXXXXXXXXXXXXXGXXXXXXXXXXXXXXXXXXXGOOOXXXXXXXXXXXXXXXXGOXXXXXXXXXXXXXXXXXXGOOXXXXXXXXXXXXXXXXXGOOOXXXXXXXXXXXXXXXXGOXXXXXXXXXXXXXXXXXXGOOOOXXXXXXXXXXXXXXXGOOOOXXXXXXXXXXXXXXX,0,0,0
7518,45,0,45,43,212,0,0,213,124,89,GOOXXXXXXXXXXXXXXXXXGOOOXXXXXXXXXXXXXXXXGOOOXXXXXXXXXXXXXXXXGOXXXXXXXXXXXXXXXXXXGOOOOOXXXXXXXXXXXXXXGXXXXXXXXXXXXXXXXXXXGOOOXXXXXXXXXXXXXXXXGOXXXXXXXXXXXXXXXXXXGOOXXXXXXXXXXXXXXXXXGOOOXXXXXXXXXXXXXXXXGOXXXXXXXXXXXXXXXXXXGOOOOXXXXXXXXXXXXXXXGOOOOXXXXXXXXXXXXXXX,0,0,0
7539,45,0,45,47,208,0,0,209,122,87,GOOXXXXXXXXXXXXXXXXXGOOOXXXXXXXXXXXXXXXXGOOOXXXXXXXXXXXXXXXXGOXXXXXXXXXXXXXXXXXXGOOOOOXXXXXXXXXXXXXXGXXXXXXXXXXXXXXXXXXXGOOOXXXXXXXXXXXXXXXXGOXXXXXXXXXXXXXXXXXXGOOXXXXXXXXXXXXXXXXXGOOOXXXXXXXXXXXXXXXXGOXXXXXXXXXXXXXXXXXXGOOOOXXXXXXXXXXXXXXXGOOOOXXXXXXXXXXXXXXX,0,0,0

7560,45,0,45,45,210,0,0,211,124,87,GOOXXXXXXXXXXXXXXXXXGOOOXXXXXXXXXXXXXXXXGOOOXXXXXXXXXXXXXXXXGOXXXXXXXXXXXXXXXXXXGOOOOOXXXXXXXXXXXXXXGXXXXXXXXXXXXXXXXXXXGOOOXXXXXXXXXXXXXXXXGOXXXXXXXXXXXXXXXXXXGOOXXXXXXXXXXXXXXXXXGOOOXXXXXXXXXXXXXXXXGOXXXXXXXXXXXXXXXXXXGOOOOXXXXXXXXXXXXXXXGOOOOXXXXXXXXXXXXXXX,0,0,0
7581,46,1,45,45,209,0,0,210,126,84,GOOXXXXXXXXXXXXXXXXXGOOOXXXXXXXXXXXXXXXXGOOOXXXXXXXXXXXXXXXXGOXXXXXXXXXXXXXXXXXXGOOOOOXXXXXXXXXXXXXXGXXXXXXXXXXXXXXXXXXXGOOOXXXXXXXXXXXXXXXXGOXXXXXXXXXXXXXXXXXXGOOXXXXXXXXXXXXXXXXXGOOOXXXXXXXXXXXXXXXXGOAXXXXXXXXXXXXXXXXXGOOOOXXXXXXXXXXXXXXXGOOOOXXXXXXXXXXXXXXX,0,0,0
7602,46,1,45,46,208,0,0,209,125,84,GOOXXXXXXXXXXXXXXXXXGOOOXXXXXXXXXXXXXXXXGOOOXXXXXXXXXXXXXXXXGOXXXXXXXXXXXXXXXXXXGOOOOOXXXXXXXXXXXXXXGXXXXXXXXXXXXXXXXXXXGOOOXXXXXXXXXXXXXXXXGOXXXXXXXXXXXXXXXXXXGOOXXXXXXXXXXXXXXXXXGOOOXXXXXXXXXXXXXXXXGOAXXXXXXXXXXXXXXXXXGOOOOXXXXXXXXXXXXXXXGOOOOXXXXXXXXXXXXXXX,0,0,0
7623,46,1,45,42,212,0,0,212,128,84,GOOXXXXXXXXXXXXXXXXXGOOOXXXXXXXXXXXXXXXXGOOOXXXXXXXXXXXXXXXXGOXXXXXXXXXXXXXXXXXXGOOOOOXXXXXXXXXXXXXXGXXXXXXXXXXXXXXXXXXXGOOOXXXXXXXXXXXXXXXXGOXXXXXXXXXXXXXXXXXXGOOXXXXXXXXXXXXXXXXXGOOOXXXXXXXXXXXXXXXXGOAXXXXXXXXXXXXXXXXXGOOOOXXXXXXXXXXXXXXXGOOOOXXXXXXXXXXXXXXX,0,0,0
7644,47,2,45,45,208,0,0,209,125,84,GOOXXXXXXXXXXXXXXXXXGOOOXXXXXXXXXXXXXXXXGOOOXXXXXXXXXXXXXXXXGOXXXXXXXXXXXXXXXXXXGOOOOOAXXXXXXXXXXXXXGXXXXXXXXXXXXXXXXXXXGOOOXXXXXXXXXXXXXXXXGOXXXXXXXXXXXXXXXXXXGOOXXXXXXXXXXXXXXXXXGOOOXXXXXXXXXXXXXXXXGOAXXXXXXXXXXXXXXXXXGOOOOXXXXXXXXXXXXXXXGOOOOXXXXXXXXXXXXXXX,0,0,0

7665,47,2,45,42,211,0,0,211,125,86,GOOXXXXXXXXXXXXXXXXXGOOOXXXXXXXXXXXXXXXXGOOOXXXXXXXXXXXXXXXXGOXXXXXXXXXXXXXXXXXXGOOOOOAXXXXXXXXXXXXXGXXXXXXXXXXXXXXXXXXXGOOOXXXXXXXXXXXXXXXXGOXXXXXXXXXXXXXXXXXXGOOXXXXXXXXXXXXXXXXXGOOOXXXXXXXXXXXXXXXXGOAXXXXXXXXXXXXXXXXXGOOOOXXXXXXXXXXXXXXXGOOOOXXXXXXXXXXXXXXX,0,0,0
7686,47,2,45,41,212,0,0,213,125,88,GOOXXXXXXXXXXXXXXXXXGOOOXXXXXXXXXXXXXXXXGOOOXXXXXXXXXXXXXXXXGOXXXXXXXXXXXXXXXXXXGOOOOOAXXXXXXXXXXXXXGXXXXXXXXXXXXXXXXXXXGOOOXXXXXXXXXXXXXXXXGOXXXXXXXXXXXXXXXXXXGOOXXXXXXXXXXXXXXXXXGOOOXXXXXXXXXXXXXXXXGOAXXXXXXXXXXXXXXXXXGOOOOXXXXXXXXXXXXXXXGOOOOXXXXXXXXXXXXXXX,0,0,0
7707,47,2,45,42,211,0,0,212,127,85,GOOXXXXXXXXXXXXXXXXXGOOOXXXXXXXXXXXXXXXXGOOOXXXXXXXXXXXXXXXXGOXXXXXXXXXXXXXXXXXXGOOOOOAXXXXXXXXXXXXXGXXXXXXXXXXXXXXXXXXXGOOOXXXXXXXXXXXXXXXXGOXXXXXXXXXXXXXXXXXXGOOXXXXXXXXXXXXXXXXXGOOOXXXXXXXXXXXXXXXXGOAXXXXXXXXXXXXXXXXXGOOOOXXXXXXXXXXXXXXXGOOOOXXXXXXXXXXXXXXX,0,0,0
7728,47,2,45,43,210,0,0,211,126,85,GOOXXXXXXXXXXXXXXXXXGOOOXXXXXXXXXXXXXXXXGOOOXXXXXXXXXXXXXXXXGOXXXXXXXXXXXXXXXXXXGOOOOOAXXXXXXXXXXXXXGXXXXXXXXXXXXXXXXXXXGOOOXXXXXXXXXXXXXXXXGOXXXXXXXXXXXXXXXXXXGOOXXXXXXXXXXXXXXXXXGOOOXXXXXXXXXXXXXXXXGOAXXXXXXXXXXXXXXXXXGOOOOXXXXXXXXXXXXXXXGOOOOXXXXXXXXXXXXXXX,0,0,0
7749,47,2,45,43,210,0,0,211,127,84,GOOXXXXXXXXXXXXXXXXXGOOOXXXXXXXXXXXXXXXXGOOOXXXXXXXXXXXXXXXXGOXXXXXXXXXXXXXXXXXXGOOOOOAXXXXXXXXXXXXXGXXXXXXXXXXXXXXXXXXXGOOOXXXXXXXXXXXXXXXXGOXXXXXXXXXXXXXXXXXXGOOXXXXXXXXXXXXXXXXXGOOOXXXXXXXXXXXXXXXXGOAXXXXXXXXXXXXXXXXXGOOOOXXXXXXXXXXXXXXXGOOOOXXXXXXXXXXXXXXX,0,0,0

7770,47,2,45,44,209,0,0,210,128,82,GOOXXXXXXXXXXXXXXXXXGOOOXXXXXXXXXXXXXXXXGOOOXXXXXXXXXXXXXXXXGOXXXXXXXXXXXXXXXXXXGOOOOOAXXXXXXXXXXXXXGXXXXXXXXXXXXXXXXXXXGOOOXXXXXXXXXXXXXXXXGOXXXXXXXXXXXXXXXXXXGOOXXXXXXXXXXXXXXXXXGOOOXXXXXXXXXXXXXXXXGOAXXXXXXXXXXXXXXXXXGOOOOXXXXXXXXXXXXXXXGOOOOXXXXXXXXXXXXXXX,0,0,0
7791,47,2,45,47,206,0,0,206,130,76,GOOXXXXXXXXXXXXXXXXXGOOOXXXXXXXXXXXXXXXXGOOOXXXXXXXXXXXXXXXXGOXXXXXXXXXXXXXXXXXXGOOOOOAXXXXXXXXXXXXXGXXXXXXXXXXXXXXXXXXXGOOOXXXXXXXXXXXXXXXXGOXXXXXXXXXXXXXXXXXXGOOXXXXXXXXXXXXXXXXXGOOOXXXXXXXXXXXXXXXXGOAXXXXXXXXXXXXXXXXXGOOOOXXXXXXXXXXXXXXXGOOOOXXXXXXXXXXXXXXX,0,0,0
7812,47,2,45,47,206,0,0,207,129,78,GOOXXXXXXXXXXXXXXXXXGOOOXXXXXXXXXXXXXXXXGOOOXXXXXXXXXXXXXXXXGOXXXXXXXXXXXXXXXXXXGOOOOOAXXXXXXXXXXXXXGXXXXXXXXXXXXXXXXXXXGOOOXXXXXXXXXXXXXXXXGOXXXXXXXXXXXXXXXXXXGOOXXXXXXXXXXXXXXXXXGOOOXXXXXXXXXXXXXXXXGOAXXXXXXXXXXXXXXXXXGOOOOXXXXXXXXXXXXXXXGOOOOXXXXXXXXXXXXXXX,0,0,0
7833,47,1,46,44,209,0,0,210,129,81,GOOXXXXXXXXXXXXXXXXXGOOOXXXXXXXXXXXXXXXXGOOOXXXXXXXXXXXXXXXXGOXXXXXXXXXXXXXXXXXXGOOOOOOXXXXXXXXXXXXXGXXXXXXXXXXXXXXXXXXXGOOOXXXXXXXXXXXXXXXXGOXXXXXXXXXXXXXXXXXXGOOXXXXXXXXXXXXXXXXXGOOOXXXXXXXXXXXXXXXXGOAXXXXXXXXXXXXXXXXXGOOOOXXXXXXXXXXXXXXXGOOOOXXXXXXXXXXXXXXX,0,0,0
7854,47,1,46,46,207,0,0,208,128,80,GOOXXXXXXXXXXXXXXXXXGOOOXXXXXXXXXXXXXXXXGOOOXXXXXXXXXXXXXXXXGOXXXXXXXXXXXXXXXXXXGOOOOOOXXXXXXXXXXXXXGXXXXXXXXXXXXXXXXXXXGOOOXXXXXXXXXXXXXXXXGOXXXXXXXXXXXXXXXXXXGOOXXXXXXXXXXXXXXXXXGOOOXXXXXXXXXXXXXXXXGOAXXXXXXXXXXXXXXXXXGOOOOXXXXXXXXXXXXXXXGOOOOXXXXXXXXXXXXXXX,0,0,0

7875,47,1,46,43,210,0,0,211,130,81,GOOXXXXXXXXXXXXXXXXXGOOOXXXXXXXXXXXXXXXXGOOOXXXXXXXXXXXXXXXXGOXXXXXXXXXXXXXXXXXXGOOOOOOXXXXXXXXXXXXXGXXXXXXXXXXXXXXXXXXXGOOOXXXXXXXXXXXXXXXXGOXXXXXXXXXXXXXXXXXXGOOXXXXXXXXXXXXXXXXXGOOOXXXXXXXXXXXXXXXXGOAXXXXXXXXXXXXXXXXXGOOOOXXXXXXXXXXXXXXXGOOOOXXXXXXXXXXXXXXX,0,0,0
7896,47,1,46,43,210,0,0,211,127,84,GOOXXXXXXXXXXXXXXXXXGOOOXXXXXXXXXXXXXXXXGOOOXXXXXXXXXXXXXXXXGOXXXXXXXXXXXXXXXXXXGOOOOOOXXXXXXXXXXXXXGXXXXXXXXXXXXXXXXXXXGOOOXXXXXXXXXXXXXXXXGOXXXXXXXXXXXXXXXXXXGOOXXXXXXXXXXXXXXXXXGOOOXXXXXXXXXXXXXXXXGOAXXXXXXXXXXXXXXXXXGOOOOXXXXXXXXXXXXXXXGOOOOXXXXXXXXXXXXXXX,0,0,0
7917,47,0,47,44,209,0,0,210,129,81,GOOXXXXXXXXXXXXXXXXXGOOOXXXXXXXXXXXXXXXXGOOOXXXXXXXXXXXXXXXXGOXXXXXXXXXXXXXXXXXXGOOOOOOXXXXXXXXXXXXXGXXXXXXXXXXXXXXXXXXXGOOOXXXXXXXXXXXXXXXXGOXXXXXXXXXXXXXXXXXXGOOXXXXXXXXXXXXXXXXXGOOOXXXXXXXXXXXXXXXXGOOXXXXXXXXXXXXXXXXXGOOOOXXXXXXXXXXXXXXXGOOOOXXXXXXXXXXXXXXX,0,0,0
7938,47,0,47,41,212,0,0,212,128,84,GOOXXXXXXXXXXXXXXXXXGOOOXXXXXXXXXXXXXXXXGOOOXXXXXXXXXXXXXXXXGOXXXXXXXXXXXXXXXXXXGOOOOOOXXXXXXXXXXXXXGXXXXXXXXXXXXXXXXXXXGOOOXXXXXXXXXXXXXXXXGOXXXXXXXXXXXXXXXXXXGOOXXXXXXXXXXXXXXXXXGOOOXXXXXXXXXXXXXXXXGOOXXXXXXXXXXXXXXXXXGOOOOXXXXXXXXXXXXXXXGOOOOXXXXXXXXXXXXXXX,0,0,0
7959,47,0,47,38,215,0,0,216,128,88,GOOXXXXXXXXXXXXXXXXXGOOOXXXXXXXXXXXXXXXXGOOOXXXXXXXXXXXXXXXXGOXXXXXXXXXXXXXXXXXXGOOOOOOXXXXXXXXXXXXXGXXXXXXXXXXXXXXXXXXXGOOOXXXXXXXXXXXXXXXXGOXXXXXXXXXXXXXXXXXXGOOXXXXXXXXXXXXXXXXXGOOOXXXXXXXXXXXXXXXXGOOXXXXXXXXXXXXXXXXXGOOOOXXXXXXXXXXXXXXXGOOOOXXXXXXXXXXXXXXX,0,0,0

7980,47,0,47,34,219,0,0,218,132,86,GOOXXXXXXXXXXXXXXXXXGOOOXXXXXXXXXXXXXXXXGOOOXXXXXXXXXXXXXXXXGOXXXXXXXXXXXXXXXXXXGOOOOOOXXXXXXXXXXXXXGXXXXXXXXXXXXXXXXXXXGOOOXXXXXXXXXXXXXXXXGOXXXXXXXXXXXXXXXXXXGOOXXXXXXXXXXXXXXXXXGOOOXXXXXXXXXXXXXXXXGOOXXXXXXXXXXXXXXXXXGOOOOXXXXXXXXXXXXXXXGOOOOXXXXXXXXXXXXXXX,0,0,0
8001,47,0,47,39,214,0,0,215,127,88,GOOXXXXXXXXXXXXXXXXXGOOOXXXXXXXXXXXXXXXXGOOOXXXXXXXXXXXXXXXXGOXXXXXXXXXXXXXXXXXXGOOOOOOXXXXXXXXXXXXXGXXXXXXXXXXXXXXXXXXXGOOOXXXXXXXXXXXXXXXXGOXXXXXXXXXXXXXXXXXXGOOXXXXXXXXXXXXXXXXXGOOOXXXXXXXXXXXXXXXXGOOXXXXXXXXXXXXXXXXXGOOOOXXXXXXXXXXXXXXXGOOOOXXXXXXXXXXXXXXX,0,0,0
8022,47,0,47,42,211,0,0,212,127,85,GOOXXXXXXXXXXXXXXXXXGOOOXXXXXXXXXXXXXXXXGOOOXXXXXXXXXXXXXXXXGOXXXXXXXXXXXXXXXXXXGOOOOOOXXXXXXXXXXXXXGXXXXXXXXXXXXXXXXXXXGOOOXXXXXXXXXXXXXXXXGOXXXXXXXXXXXXXXXXXXGOOXXXXXXXXXXXXXXXXXGOOOXXXXXXXXXXXXXXXXGOOXXXXXXXXXXXXXXXXXGOOOOXXXXXXXXXXXXXXXGOOOOXXXXXXXXXXXXXXX,0,0,0
8043,47,0,47,44,209,0,0,210,127,83,GOOXXXXXXXXXXXXXXXXXGOOOXXXXXXXXXXXXXXXXGOOOXXXXXXXXXXXXXXXXGOXXXXXXXXXXXXXXXXXXGOOOOOOXXXXXXXXXXXXXGXXXXXXXXXXXXXXXXXXXGOOOXXXXXXXXXXXXXXXXGOXXXXXXXXXXXXXXXXXXGOOXXXXXXXXXXXXXXXXXGOOOXXXXXXXXXXXXXXXXGOOXXXXXXXXXXXXXXXXXGOOOOXXXXXXXXXXXXXXXGOOOOXXXXXXXXXXXXXXX,0,0,0
8064,47,0,47,40,213,0,0,212,126,86,GOOXXXXXXXXXXXXXXXXXGOOOXXXXXXXXXXXXXXXXGOOOXXXXXXXXXXXXXXXXGOXXXXXXXXXXXXXXXXXXGOOOOOOXXXXXXXXXXXXXGXXXXXXXXXXXXXXXXXXXGOOOXXXXXXXXXXXXXXXXGOXXXXXXXXXXXXXXXXXXGOOXXXXXXXXXXXXXXXXXGOOOXXXXXXXXXXXXXXXXGOOXXXXXXXXXXXXXXXXXGOOOOXXXXXXXXXXXXXXXGOOOOXXXXXXXXXXXXXXX,0,0,0

8085,48,1,47,39,213,0,0,214,129,85,GOOXXXXXXXXXXXXXXXXXGOOOXXXXXXXXXXXXXXXXGOOOXXXXXXXXXXXXXXXXGOXXXXXXXXXXXXXXXXXXGOOOOOOXXXXXXXXXXXXXGXXXXXXXXXXXXXXXXXXXGOOOXXXXXXXXXXXXXXXXGOXXXXXXXXXXXXXXXXXXGOOXXXXXXXXXXXXXXXXXGOOOXXXXXXXXXXXXXXXXGOOXXXXXXXXXXXXXXXXXGOOOOAXXXXXXXXXXXXXXGOOOOXXXXXXXXXXXXXXX,0,0,0
8106,48,1,47,38,214,0,0,215,128,87,GOOXXXXXXXXXXXXXXXXXGOOOXXXXXXXXXXXXXXXXGOOOXXXXXXXXXXXXXXXXGOXXXXXXXXXXXXXXXXXXGOOOOOOXXXXXXXXXXXXXGXXXXXXXXXXXXXXXXXXXGOOOXXXXXXXXXXXXXXXXGOXXXXXXXXXXXXXXXXXXGOOXXXXXXXXXXXXXXXXXGOOOXXXXXXXXXXXXXXXXGOOXXXXXXXXXXXXXXXXXGOOOOAXXXXXXXXXXXXXXGOOOOXXXXXXXXXXXXXXX,0,0,0
8127,48,0,48,38,214,0,0,215,129,86,GOOXXXXXXXXXXXXXXXXXGOOOXXXXXXXXXXXXXXXXGOOOXXXXXXXXXXXXXXXXGOXXXXXXXXXXXXXXXXXXGOOOOOOXXXXXXXXXXXXXGXXXXXXXXXXXXXXXXXXXGOOOXXXXXXXXXXXXXXXXGOXXXXXXXXXXXXXXXXXXGOOXXXXXXXXXXXXXXXXXGOOOXXXXXXXXXXXXXXXXGOOXXXXXXXXXXXXXXXXXGOOOOOXXXXXXXXXXXXXXGOOOOXXXXXXXXXXXXXXX,0,0,0
8148,48,0,48,39,213,0,0,214,135,79,GOOXXXXXXXXXXXXXXXXXGOOOXXXXXXXXXXXXXXXXGOOOXXXXXXXXXXXXXXXXGOXXXXXXXXXXXXXXXXXXGOOOOOOXXXXXXXXXXXXXGXXXXXXXXXXXXXXXXXXXGOOOXXXXXXXXXXXXXXXXGOXXXXXXXXXXXXXXXXXXGOOXXXXXXXXXXXXXXXXXGOOOXXXXXXXXXXXXXXXXGOOXXXXXXXXXXXXXXXXXGOOOOOXXXXXXXXXXXXXXGOOOOXXXXXXXXXXXXXXX,0,0,0
8169,48,0,48,42,210,0,0,209,134,75,GOOXXXXXXXXXXXXXXXXXGOOOXXXXXXXXXXXXXXXXGOOOXXXXXXXXXXXXXXXXGOXXXXXXXXXXXXXXXXXXGOOOOOOXXXXXXXXXXXXXGXXXXXXXXXXXXXXXXXXXGOOOXXXXXXXXXXXXXXXXGOXXXXXXXXXXXXXXXXXXGOOXXXXXXXXXXXXXXXXXGOOOXXXXXXXXXXXXXXXXGOOXXXXXXXXXXXXXXXXXGOOOOOXXXXXXXXXXXXXXGOOOOXXXXXXXXXXXXXXX,0,0,0

8190,48,0,48,45,207,0,0,208,134,74,GOOXXXXXXXXXXXXXXXXXGOOOXXXXXXXXXXXXXXXXGOOOXXXXXXXXXXXXXXXXGOXXXXXXXXXXXXXXXXXXGOOOOOOXXXXXXXXXXXXXGXXXXXXXXXXXXXXXXXXXGOOOXXXXXXXXXXXXXXXXGOXXXXXXXXXXXXXXXXXXGOOXXXXXXXXXXXXXXXXXGOOOXXXXXXXXXXXXXXXXGOOXXXXXXXXXXXXXXXXXGOOOOOXXXXXXXXXXXXXXGOOOOXXXXXXXXXXXXXXX,0,0,0
8211,48,0,48,41,211,0,0,212,137,75,GOOXXXXXXXXXXXXXXXXXGOOOXXXXXXXXXXXXXXXXGOOOXXXXXXXXXXXXXXXXGOXXXXXXXXXXXXXXXXXXGOOOOOOXXXXXXXXXXXXXGXXXXXXXXXXXXXXXXXXXGOOOXXXXXXXXXXXXXXXXGOXXXXXXXXXXXXXXXXXXGOOXXXXXXXXXXXXXXXXXGOOOXXXXXXXXXXXXXXXXGOOXXXXXXXXXXXXXXXXXGOOOOOXXXXXXXXXXXXXXGOOOOXXXXXXXXXXXXXXX,0,0,0
8232,48,0,48,41,211,0,0,212,139,73,GOOXXXXXXXXXXXXXXXXXGOOOXXXXXXXXXXXXXXXXGOOOXXXXXXXXXXXXXXXXGOXXXXXXXXXXXXXXXXXXGOOOOOOXXXXXXXXXXXXXGXXXXXXXXXXXXXXXXXXXGOOOXXXXXXXXXXXXXXXXGOXXXXXXXXXXXXXXXXXXGOOXXXXXXXXXXXXXXXXXGOOOXXXXXXXXXXXXXXXXGOOXXXXXXXXXXXXXXXXXGOOOOOXXXXXXXXXXXXXXGOOOOXXXXXXXXXXXXXXX,0,0,0
8253,48,0,48,43,209,0,0,209,134,75,GOOXXXXXXXXXXXXXXXXXGOOOXXXXXXXXXXXXXXXXGOOOXXXXXXXXXXXXXXXXGOXXXXXXXXXXXXXXXXXXGOOOOOOXXXXXXXXXXXXXGXXXXXXXXXXXXXXXXXXXGOOOXXXXXXXXXXXXXXXXGOXXXXXXXXXXXXXXXXXXGOOXXXXXXXXXXXXXXXXXGOOOXXXXXXXXXXXXXXXXGOOXXXXXXXXXXXXXXXXXGOOOOOXXXXXXXXXXXXXXGOOOOXXXXXXXXXXXXXXX,0,0,0
8274,48,0,48,46,206,0,0,207,132,75,GOOXXXXXXXXXXXXXXXXXGOOOXXXXXXXXXXXXXXXXGOOOXXXXXXXXXXXXXXXXGOXXXXXXXXXXXXXXXXXXGOOOOOOXXXXXXXXXXXXXGXXXXXXXXXXXXXXXXXXXGOOOXXXXXXXXXXXXXXXXGOXXXXXXXXXXXXXXXXXXGOOXXXXXXXXXXXXXXXXXGOOOXXXXXXXXXXXXXXXXGOOXXXXXXXXXXXXXXXXXGOOOOOXXXXXXXXXXXXXXGOOOOXXXXXXXXXXXXXXX,0,0,0

8295,48,0,48,43,209,0,0,210,134,76,GOOXXXXXXXXXXXXXXXXXGOOOXXXXXXXXXXXXXXXXGOOOXXXXXXXXXXXXXXXXGOXXXXXXXXXXXXXXXXXXGOOOOOOXXXXXXXXXXXXXGXXXXXXXXXXXXXXXXXXXGOOOXXXXXXXXXXXXXXXXGOXXXXXXXXXXXXXXXXXXGOOXXXXXXXXXXXXXXXXXGOOOXXXXXXXXXXXXXXXXGOOXXXXXXXXXXXXXXXXXGOOOOOXXXXXXXXXXXXXXGOOOOXXXXXXXXXXXXXXX,0,0,0
8316,48,0,48,47,205,0,0,205,137,68,GOOXXXXXXXXXXXXXXXXXGOOOXXXXXXXXXXXXXXXXGOOOXXXXXXXXXXXXXXXXGOXXXXXXXXXXXXXXXXXXGOOOOOOXXXXXXXXXXXXXGXXXXXXXXXXXXXXXXXXXGOOOXXXXXXXXXXXXXXXXGOXXXXXXXXXXXXXXXXXXGOOXXXXXXXXXXXXXXXXXGOOOXXXXXXXXXXXXXXXXGOOXXXXXXXXXXXXXXXXXGOOOOOXXXXXXXXXXXXXXGOOOOXXXXXXXXXXXXXXX,0,0,0
8337,48,0,48,44,208,0,0,210,136,74,GOOXXXXXXXXXXXXXXXXXGOOOXXXXXXXXXXXXXXXXGOOOXXXXXXXXXXXXXXXXGOXXXXXXXXXXXXXXXXXXGOOOOOOXXXXXXXXXXXXXGXXXXXXXXXXXXXXXXXXXGOOOXXXXXXXXXXXXXXXXGOXXXXXXXXXXXXXXXXXXGOOXXXXXXXXXXXXXXXXXGOOOXXXXXXXXXXXXXXXXGOOXXXXXXXXXXXXXXXXXGOOOOOXXXXXXXXXXXXXXGOOOOXXXXXXXXXXXXXXX,0,0,0
8358,48,0,48,43,209,0,0,211,138,73,GOOXXXXXXXXXXXXXXXXXGOOOXXXXXXXXXXXXXXXXGOOOXXXXXXXXXXXXXXXXGOXXXXXXXXXXXXXXXXXXGOOOOOOXXXXXXXXXXXXXGXXXXXXXXXXXXXXXXXXXGOOOXXXXXXXXXXXXXXXXGOXXXXXXXXXXXXXXXXXXGOOXXXXXXXXXXXXXXXXXGOOOXXXXXXXXXXXXXXXXGOOXXXXXXXXXXXXXXXXXGOOOOOXXXXXXXXXXXXXXGOOOOXXXXXXXXXXXXXXX,0,0,0
8379,48,0,48,45,207,0,0,209,136,73,GOOXXXXXXXXXXXXXXXXXGOOOXXXXXXXXXXXXXXXXGOOOXXXXXXXXXXXXXXXXGOXXXXXXXXXXXXXXXXXXGOOOOOOXXXXXXXXXXXXXGXXXXXXXXXXXXXXXXXXXGOOOXXXXXXXXXXXXXXXXGOXXXXXXXXXXXXXXXXXXGOOXXXXXXXXXXXXXXXXXGOOOXXXXXXXXXXXXXXXXGOOXXXXXXXXXXXXXXXXXGOOOOOXXXXXXXXXXXXXXGOOOOXXXXXXXXXXXXXXX,0,0,0

8400,48,0,48,42,210,0,0,212,137,75,GOOXXXXXXXXXXXXXXXXXGOOOXXXXXXXXXXXXXXXXGOOOXXXXXXXXXXXXXXXXGOXXXXXXXXXXXXXXXXXXGOOOOOOXXXXXXXXXXXXXGXXXXXXXXXXXXXXXXXXXGOOOXXXXXXXXXXXXXXXXGOXXXXXXXXXXXXXXXXXXGOOXXXXXXXXXXXXXXXXXGOOOXXXXXXXXXXXXXXXXGOOXXXXXXXXXXXXXXXXXGOOOOOXXXXXXXXXXXXXXGOOOOXXXXXXXXXXXXXXX,0,0,0
8421,48,0,48,43,209,0,0,211,138,73,GOOXXXXXXXXXXXXXXXXXGOOOXXXXXXXXXXXXXXXXGOOOXXXXXXXXXXXXXXXXGOXXXXXXXXXXXXXXXXXXGOOOOOOXXXXXXXXXXXXXGXXXXXXXXXXXXXXXXXXXGOOOXXXXXXXXXXXXXXXXGOXXXXXXXXXXXXXXXXXXGOOXXXXXXXXXXXXXXXXXGOOOXXXXXXXXXXXXXXXXGOOXXXXXXXXXXXXXXXXXGOOOOOXXXXXXXXXXXXXXGOOOOXXXXXXXXXXXXXXX,0,0,0
8442,48,0,48,45,207,0,0,207,136,71,GOOXXXXXXXXXXXXXXXXXGOOOXXXXXXXXXXXXXXXXGOOOXXXXXXXXXXXXXXXXGOXXXXXXXXXXXXXXXXXXGOOOOOOXXXXXXXXXXXXXGXXXXXXXXXXXXXXXXXXXGOOOXXXXXXXXXXXXXXXXGOXXXXXXXXXXXXXXXXXXGOOXXXXXXXXXXXXXXXXXGOOOXXXXXXXXXXXXXXXXGOOXXXXXXXXXXXXXXXXXGOOOOOXXXXXXXXXXXXXXGOOOOXXXXXXXXXXXXXXX,0,0,0
8463,48,0,48,43,209,0,0,211,139,72,GOOXXXXXXXXXXXXXXXXXGOOOXXXXXXXXXXXXXXXXGOOOXXXXXXXXXXXXXXXXGOXXXXXXXXXXXXXXXXXXGOOOOOOXXXXXXXXXXXXXGXXXXXXXXXXXXXXXXXXXGOOOXXXXXXXXXXXXXXXXGOXXXXXXXXXXXXXXXXXXGOOXXXXXXXXXXXXXXXXXGOOOXXXXXXXXXXXXXXXXGOOXXXXXXXXXXXXXXXXXGOOOOOXXXXXXXXXXXXXXGOOOOXXXXXXXXXXXXXXX,0,0,0
8484,48,0,48,43,209,0,0,211,139,72,GOOXXXXXXXXXXXXXXXXXGOOOXXXXXXXXXXXXXXXXGOOOXXXXXXXXXXXXXXXXGOXXXXXXXXXXXXXXXXXXGOOOOOOXXXXXXXXXXXXXGXXXXXXXXXXXXXXXXXXXGOOOXXXXXXXXXXXXXXXXGOXXXXXXXXXXXXXXXXXXGOOXXXXXXXXXXXXXXXXXGOOOXXXXXXXXXXXXXXXXGOOXXXXXXXXXXXXXXXXXGOOOOOXXXXXXXXXXXXXXGOOOOXXXXXXXXXXXXXXX,0,0,0

8505,48,0,48,46,206,0,0,208,138,70,GOOXXXXXXXXXXXXXXXXXGOOOXXXXXXXXXXXXXXXXGOOOXXXXXXXXXXXXXXXXGOXXXXXXXXXXXXXXXXXXGOOOOOOXXXXXXXXXXXXXGXXXXXXXXXXXXXXXXXXXGOOOXXXXXXXXXXXXXXXXGOXXXXXXXXXXXXXXXXXXGOOXXXXXXXXXXXXXXXXXGOOOXXXXXXXXXXXXXXXXGOOXXXXXXXXXXXXXXXXXGOOOOOXXXXXXXXXXXXXXGOOOOXXXXXXXXXXXXXXX,0,0,0
8526,49,1,48,46,205,0,0,207,138,69,GOOXXXXXXXXXXXXXXXXXGOOOXXXXXXXXXXXXXXXXGOOOXXXXXXXXXXXXXXXXGOXXXXXXXXXXXXXXXXXXGOOOOOOXXXXXXXXXXXXXGXXXXXXXXXXXXXXXXXXXGOOOXXXXXXXXXXXXXXXXGOXXXXXXXXXXXXXXXXXXGOOXXXXXXXXXXXXXXXXXGOOOAXXXXXXXXXXXXXXXGOOXXXXXXXXXXXXXXXXXGOOOOOXXXXXXXXXXXXXXGOOOOXXXXXXXXXXXXXXX,0,0,0
8547,49,0,49,41,210,0,0,211,141,70,GOOXXXXXXXXXXXXXXXXXGOOOXXXXXXXXXXXXXXXXGOOOXXXXXXXXXXXXXXXXGOXXXXXXXXXXXXXXXXXXGOOOOOOXXXXXXXXXXXXXGXXXXXXXXXXXXXXXXXXXGOOOXXXXXXXXXXXXXXXXGOXXXXXXXXXXXXXXXXXXGOOXXXXXXXXXXXXXXXXXGOOOOXXXXXXXXXXXXXXXGOOXXXXXXXXXXXXXXXXXGOOOOOXXXXXXXXXXXXXXGOOOOXXXXXXXXXXXXXXX,0,0,0
8568,49,0,49,41,210,0,0,211,140,71,GOOXXXXXXXXXXXXXXXXXGOOOXXXXXXXXXXXXXXXXGOOOXXXXXXXXXXXXXXXXGOXXXXXXXXXXXXXXXXXXGOOOOOOXXXXXXXXXXXXXGXXXXXXXXXXXXXXXXXXXGOOOXXXXXXXXXXXXXXXXGOXXXXXXXXXXXXXXXXXXGOOXXXXXXXXXXXXXXXXXGOOOOXXXXXXXXXXXXXXXGOOXXXXXXXXXXXXXXXXXGOOOOOXXXXXXXXXXXXXXGOOOOXXXXXXXXXXXXXXX,0,0,0
8589,49,0,49,36,215,0,0,216,141,75,GOOXXXXXXXXXXXXXXXXXGOOOXXXXXXXXXXXXXXXXGOOOXXXXXXXXXXXXXXXXGOXXXXXXXXXXXXXXXXXXGOOOOOOXXXXXXXXXXXXXGXXXXXXXXXXXXXXXXXXXGOOOXXXXXXXXXXXXXXXXGOXXXXXXXXXXXXXXXXXXGOOXXXXXXXXXXXXXXXXXGOOOOXXXXXXXXXXXXXXXGOOXXXXXXXXXXXXXXXXXGOOOOOXXXXXXXXXXXXXXGOOOOXXXXXXXXXXXXXXX,0,0,0

8610,49,0,49,35,216,0,0,217,143,74,GOOXXXXXXXXXXXXXXXXXGOOOXXXXXXXXXXXXXXXXGOOOXXXXXXXXXXXXXXXXGOXXXXXXXXXXXXXXXXXXGOOOOOOXXXXXXXXXXXXXGXXXXXXXXXXXXXXXXXXXGOOOXXXXXXXXXXXXXXXXGOXXXXXXXXXXXXXXXXXXGOOXXXXXXXXXXXXXXXXXGOOOOXXXXXXXXXXXXXXXGOOXXXXXXXXXXXXXXXXXGOOOOOXXXXXXXXXXXXXXGOOOOXXXXXXXXXXXXXXX,0,0,0
8631,49,0,49,35,216,0,0,217,139,78,GOOXXXXXXXXXXXXXXXXXGOOOXXXXXXXXXXXXXXXXGOOOXXXXXXXXXXXXXXXXGOXXXXXXXXXXXXXXXXXXGOOOOOOXXXXXXXXXXXXXGXXXXXXXXXXXXXXXXXXXGOOOXXXXXXXXXXXXXXXXGOXXXXXXXXXXXXXXXXXXGOOXXXXXXXXXXXXXXXXXGOOOOXXXXXXXXXXXXXXXGOOXXXXXXXXXXXXXXXXXGOOOOOXXXXXXXXXXXXXXGOOOOXXXXXXXXXXXXXXX,0,0,0
8652,49,0,49,38,213,0,0,214,139,75,GOOXXXXXXXXXXXXXXXXXGOOOXXXXXXXXXXXXXXXXGOOOXXXXXXXXXXXXXXXXGOXXXXXXXXXXXXXXXXXXGOOOOOOXXXXXXXXXXXXXGXXXXXXXXXXXXXXXXXXXGOOOXXXXXXXXXXXXXXXXGOXXXXXXXXXXXXXXXXXXGOOXXXXXXXXXXXXXXXXXGOOOOXXXXXXXXXXXXXXXGOOXXXXXXXXXXXXXXXXXGOOOOOXXXXXXXXXXXXXXGOOOOXXXXXXXXXXXXXXX,0,0,0
8673,49,0,49,40,211,0,0,212,141,71,GOOXXXXXXXXXXXXXXXXXGOOOXXXXXXXXXXXXXXXXGOOOXXXXXXXXXXXXXXXXGOXXXXXXXXXXXXXXXXXXGOOOOOOXXXXXXXXXXXXXGXXXXXXXXXXXXXXXXXXXGOOOXXXXXXXXXXXXXXXXGOXXXXXXXXXXXXXXXXXXGOOXXXXXXXXXXXXXXXXXGOOOOXXXXXXXXXXXXXXXGOOXXXXXXXXXXXXXXXXXGOOOOOXXXXXXXXXXXXXXGOOOOXXXXXXXXXXXXXXX,0,0,0
8694,49,0,49,42,209,0,0,210,142,68,GOOXXXXXXXXXXXXXXXXXGOOOXXXXXXXXXXXXXXXXGOOOXXXXXXXXXXXXXXXXGOXXXXXXXXXXXXXXXXXXGOOOOOOXXXXXXXXXXXXXGXXXXXXXXXXXXXXXXXXXGOOOXXXXXXXXXXXXXXXXGOXXXXXXXXXXXXXXXXXXGOOXXXXXXXXXXXXXXXXXGOOOOXXXXXXXXXXXXXXXGOOXXXXXXXXXXXXXXXXXGOOOOOXXXXXXXXXXXXXXGOOOOXXXXXXXXXXXXXXX,0,0,0

8715,49,0,49,43,208,0,0,209,141,68,GOOXXXXXXXXXXXXXXXXXGOOOXXXXXXXXXXXXXXXXGOOOXXXXXXXXXXXXXXXXGOXXXXXXXXXXXXXXXXXXGOOOOOOXXXXXXXXXXXXXGXXXXXXXXXXXXXXXXXXXGOOOXXXXXXXXXXXXXXXXGOXXXXXXXXXXXXXXXXXXGOOXXXXXXXXXXXXXXXXXGOOOOXXXXXXXXXXXXXXXGOOXXXXXXXXXXXXXXXXXGOOOOOXXXXXXXXXXXXXXGOOOOXXXXXXXXXXXXXXX,0,0,0
8736,49,0,49,45,206,0,0,207,143,64,GOOXXXXXXXXXXXXXXXXXGOOOXXXXXXXXXXXXXXXXGOOOXXXXXXXXXXXXXXXXGOXXXXXXXXXXXXXXXXXXGOOOOOOXXXXXXXXXXXXXGXXXXXXXXXXXXXXXXXXXGOOOXXXXXXXXXXXXXXXXGOXXXXXXXXXXXXXXXXXXGOOXXXXXXXXXXXXXXXXXGOOOOXXXXXXXXXXXXXXXGOOXXXXXXXXXXXXXXXXXGOOOOOXXXXXXXXXXXXXXGOOOOXXXXXXXXXXXXXXX,0,0,0
8757,49,0,49,44,207,0,0,208,144,64,GOOXXXXXXXXXXXXXXXXXGOOOXXXXXXXXXXXXXXXXGOOOXXXXXXXXXXXXXXXXGOXXXXXXXXXXXXXXXXXXGOOOOOOXXXXXXXXXXXXXGXXXXXXXXXXXXXXXXXXXGOOOXXXXXXXXXXXXXXXXGOXXXXXXXXXXXXXXXXXXGOOXXXXXXXXXXXXXXXXXGOOOOXXXXXXXXXXXXXXXGOOXXXXXXXXXXXXXXXXXGOOOOOXXXXXXXXXXXXXXGOOOOXXXXXXXXXXXXXXX,0,0,0
8778,49,0,49,40,211,0,0,211,145,66,GOOXXXXXXXXXXXXXXXXXGOOOXXXXXXXXXXXXXXXXGOOOXXXXXXXXXXXXXXXXGOXXXXXXXXXXXXXXXXXXGOOOOOOXXXXXXXXXXXXXGXXXXXXXXXXXXXXXXXXXGOOOXXXXXXXXXXXXXXXXGOXXXXXXXXXXXXXXXXXXGOOXXXXXXXXXXXXXXXXXGOOOOXXXXXXXXXXXXXXXGOOXXXXXXXXXXXXXXXXXGOOOOOXXXXXXXXXXXXXXGOOOOXXXXXXXXXXXXXXX,0,0,0
8799,49,0,49,43,208,0,0,209,138,71,GOOXXXXXXXXXXXXXXXXXGOOOXXXXXXXXXXXXXXXXGOOOXXXXXXXXXXXXXXXXGOXXXXXXXXXXXXXXXXXXGOOOOOOXXXXXXXXXXXXXGXXXXXXXXXXXXXXXXXXXGOOOXXXXXXXXXXXXXXXXGOXXXXXXXXXXXXXXXXXXGOOXXXXXXXXXXXXXXXXXGOOOOXXXXXXXXXXXXXXXGOOXXXXXXXXXXXXXXXXXGOOOOOXXXXXXXXXXXXXXGOOOOXXXXXXXXXXXXXXX,0,0,0

8820,49,0,49,39,212,0,0,214,142,72,GOOXXXXXXXXXXXXXXXXXGOOOXXXXXXXXXXXXXXXXGOOOXXXXXXXXXXXXXXXXGOXXXXXXXXXXXXXXXXXXGOOOOOOXXXXXXXXXXXXXGXXXXXXXXXXXXXXXXXXXGOOOXXXXXXXXXXXXXXXXGOXXXXXXXXXXXXXXXXXXGOOXXXXXXXXXXXXXXXXXGOOOOXXXXXXXXXXXXXXXGOOXXXXXXXXXXXXXXXXXGOOOOOXXXXXXXXXXXXXXGOOOOXXXXXXXXXXXXXXX,0,0,0
8841,49,0,49,39,212,0,0,213,142,71,GOOXXXXXXXXXXXXXXXXXGOOOXXXXXXXXXXXXXXXXGOOOXXXXXXXXXXXXXXXXGOXXXXXXXXXXXXXXXXXXGOOOOOOXXXXXXXXXXXXXGXXXXXXXXXXXXXXXXXXXGOOOXXXXXXXXXXXXXXXXGOXXXXXXXXXXXXXXXXXXGOOXXXXXXXXXXXXXXXXXGOOOOXXXXXXXXXXXXXXXGOOXXXXXXXXXXXXXXXXXGOOOOOXXXXXXXXXXXXXXGOOOOXXXXXXXXXXXXXXX,0,0,0
8862,49,0,49,40,211,0,0,212,142,70,GOOXXXXXXXXXXXXXXXXXGOOOXXXXXXXXXXXXXXXXGOOOXXXXXXXXXXXXXXXXGOXXXXXXXXXXXXXXXXXXGOOOOOOXXXXXXXXXXXXXGXXXXXXXXXXXXXXXXXXXGOOOXXXXXXXXXXXXXXXXGOXXXXXXXXXXXXXXXXXXGOOXXXXXXXXXXXXXXXXXGOOOOXXXXXXXXXXXXXXXGOOXXXXXXXXXXXXXXXXXGOOOOOXXXXXXXXXXXXXXGOOOOXXXXXXXXXXXXXXX,0,0,0
8883,49,0,49,38,213,0,0,214,142,72,GOOXXXXXXXXXXXXXXXXXGOOOXXXXXXXXXXXXXXXXGOOOXXXXXXXXXXXXXXXXGOXXXXXXXXXXXXXXXXXXGOOOOOOXXXXXXXXXXXXXGXXXXXXXXXXXXXXXXXXXGOOOXXXXXXXXXXXXXXXXGOXXXXXXXXXXXXXXXXXXGOOXXXXXXXXXXXXXXXXXGOOOOXXXXXXXXXXXXXXXGOOXXXXXXXXXXXXXXXXXGOOOOOXXXXXXXXXXXXXXGOOOOXXXXXXXXXXXXXXX,0,0,0
8904,49,0,49,38,213,0,0,214,143,71,GOOXXXXXXXXXXXXXXXXXGOOOXXXXXXXXXXXXXXXXGOOOXXXXXXXXXXXXXXXXGOXXXXXXXXXXXXXXXXXXGOOOOOOXXXXXXXXXXXXXGXXXXXXXXXXXXXXXXXXXGOOOXXXXXXXXXXXXXXXXGOXXXXXXXXXXXXXXXXXXGOOXXXXXXXXXXXXXXXXXGOOOOXXXXXXXXXXXXXXXGOOXXXXXXXXXXXXXXXXXGOOOOOXXXXXXXXXXXXXXGOOOOXXXXXXXXXXXXXXX,0,0,0

8925,49,0,49,40,211,0,0,212,145,67,GOOXXXXXXXXXXXXXXXXXGOOOXXXXXXXXXXXXXXXXGOOOXXXXXXXXXXXXXXXXGOXXXXXXXXXXXXXXXXXXGOOOOOOXXXXXXXXXXXXXGXXXXXXXXXXXXXXXXXXXGOOOXXXXXXXXXXXXXXXXGOXXXXXXXXXXXXXXXXXXGOOXXXXXXXXXXXXXXXXXGOOOOXXXXXXXXXXXXXXXGOOXXXXXXXXXXXXXXXXXGOOOOOXXXXXXXXXXXXXXGOOOOXXXXXXXXXXXXXXX,0,0,0
8946,49,0,49,40,211,0,0,211,144,67,GOOXXXXXXXXXXXXXXXXXGOOOXXXXXXXXXXXXXXXXGOOOXXXXXXXXXXXXXXXXGOXXXXXXXXXXXXXXXXXXGOOOOOOXXXXXXXXXXXXXGXXXXXXXXXXXXXXXXXXXGOOOXXXXXXXXXXXXXXXXGOXXXXXXXXXXXXXXXXXXGOOXXXXXXXXXXXXXXXXXGOOOOXXXXXXXXXXXXXXXGOOXXXXXXXXXXXXXXXXXGOOOOOXXXXXXXXXXXXXXGOOOOXXXXXXXXXXXXXXX,0,0,0
8967,49,0,49,42,209,0,0,210,143,67,GOOXXXXXXXXXXXXXXXXXGOOOXXXXXXXXXXXXXXXXGOOOXXXXXXXXXXXXXXXXGOXXXXXXXXXXXXXXXXXXGOOOOOOXXXXXXXXXXXXXGXXXXXXXXXXXXXXXXXXXGOOOXXXXXXXXXXXXXXXXGOXXXXXXXXXXXXXXXXXXGOOXXXXXXXXXXXXXXXXXGOOOOXXXXXXXXXXXXXXXGOOXXXXXXXXXXXXXXXXXGOOOOOXXXXXXXXXXXXXXGOOOOXXXXXXXXXXXXXXX,0,0,0
8988,49,0,49,41,210,0,0,211,145,66,GOOXXXXXXXXXXXXXXXXXGOOOXXXXXXXXXXXXXXXXGOOOXXXXXXXXXXXXXXXXGOXXXXXXXXXXXXXXXXXXGOOOOOOXXXXXXXXXXXXXGXXXXXXXXXXXXXXXXXXXGOOOXXXXXXXXXXXXXXXXGOXXXXXXXXXXXXXXXXXXGOOXXXXXXXXXXXXXXXXXGOOOOXXXXXXXXXXXXXXXGOOXXXXXXXXXXXXXXXXXGOOOOOXXXXXXXXXXXXXXGOOOOXXXXXXXXXXXXXXX,0,0,0
9009,49,0,49,41,210,0,0,211,147,64,GOOXXXXXXXXXXXXXXXXXGOOOXXXXXXXXXXXXXXXXGOOOXXXXXXXXXXXXXXXXGOXXXXXXXXXXXXXXXXXXGOOOOOOXXXXXXXXXXXXXGXXXXXXXXXXXXXXXXXXXGOOOXXXXXXXXXXXXXXXXGOXXXXXXXXXXXXXXXXXXGOOXXXXXXXXXXXXXXXXXGOOOOXXXXXXXXXXXXXXXGOOXXXXXXXXXXXXXXXXXGOOOOOXXXXXXXXXXXXXXGOOOOXXXXXXXXXXXXXXX,0,0,0

9030,49,0,49,41,210,0,0,211,145,66,GOOXXXXXXXXXXXXXXXXXGOOOXXXXXXXXXXXXXXXXGOOOXXXXXXXXXXXXXXXXGOXXXXXXXXXXXXXXXXXXGOOOOOOXXXXXXXXXXXXXGXXXXXXXXXXXXXXXXXXXGOOOXXXXXXXXXXXXXXXXGOXXXXXXXXXXXXXXXXXXGOOXXXXXXXXXXXXXXXXXGOOOOXXXXXXXXXXXXXXXGOOXXXXXXXXXXXXXXXXXGOOOOOXXXXXXXXXXXXXXGOOOOXXXXXXXXXXXXXXX,0,0,0
9051,49,0,49,40,211,0,0,210,142,68,GOOXXXXXXXXXXXXXXXXXGOOOXXXXXXXXXXXXXXXXGOOOXXXXXXXXXXXXXXXXGOXXXXXXXXXXXXXXXXXXGOOOOOOXXXXXXXXXXXXXGXXXXXXXXXXXXXXXXXXXGOOOXXXXXXXXXXXXXXXXGOXXXXXXXXXXXXXXXXXXGOOXXXXXXXXXXXXXXXXXGOOOOXXXXXXXXXXXXXXXGOOXXXXXXXXXXXXXXXXXGOOOOOXXXXXXXXXXXXXXGOOOOXXXXXXXXXXXXXXX,0,0,0
9072,49,0,49,35,216,0,0,215,143,72,GOOXXXXXXXXXXXXXXXXXGOOOXXXXXXXXXXXXXXXXGOOOXXXXXXXXXXXXXXXXGOXXXXXXXXXXXXXXXXXXGOOOOOOXXXXXXXXXXXXXGXXXXXXXXXXXXXXXXXXXGOOOXXXXXXXXXXXXXXXXGOXXXXXXXXXXXXXXXXXXGOOXXXXXXXXXXXXXXXXXGOOOOXXXXXXXXXXXXXXXGOOXXXXXXXXXXXXXXXXXGOOOOOXXXXXXXXXXXXXXGOOOOXXXXXXXXXXXXXXX,0,0,0
9093,49,0,49,37,214,0,0,215,142,73,GOOXXXXXXXXXXXXXXXXXGOOOXXXXXXXXXXXXXXXXGOOOXXXXXXXXXXXXXXXXGOXXXXXXXXXXXXXXXXXXGOOOOOOXXXXXXXXXXXXXGXXXXXXXXXXXXXXXXXXXGOOOXXXXXXXXXXXXXXXXGOXXXXXXXXXXXXXXXXXXGOOXXXXXXXXXXXXXXXXXGOOOOXXXXXXXXXXXXXXXGOOXXXXXXXXXXXXXXXXXGOOOOOXXXXXXXXXXXXXXGOOOOXXXXXXXXXXXXXXX,0,0,0
9114,49,0,49,34,217,0,0,219,143,76,GOOXXXXXXXXXXXXXXXXXGOOOXXXXXXXXXXXXXXXXGOOOXXXXXXXXXXXXXXXXGOXXXXXXXXXXXXXXXXXXGOOOOOOXXXXXXXXXXXXXGXXXXXXXXXXXXXXXXXXXGOOOXXXXXXXXXXXXXXXXGOXXXXXXXXXXXXXXXXXXGOOXXXXXXXXXXXXXXXXXGOOOOXXXXXXXXXXXXXXXGOOXXXXXXXXXXXXXXXXXGOOOOOXXXXXXXXXXXXXXGOOOOXXXXXXXXXXXXXXX,0,0,0

9135,49,0,49,31,220,0,0,221,144,77,GOOXXXXXXXXXXXXXXXXXGOOOXXXXXXXXXXXXXXXXGOOOXXXXXXXXXXXXXXXXGOXXXXXXXXXXXXXXXXXXGOOOOOOXXXXXXXXXXXXXGXXXXXXXXXXXXXXXXXXXGOOOXXXXXXXXXXXXXXXXGOXXXXXXXXXXXXXXXXXXGOOXXXXXXXXXXXXXXXXXGOOOOXXXXXXXXXXXXXXXGOOXXXXXXXXXXXXXXXXXGOOOOOXXXXXXXXXXXXXXGOOOOXXXXXXXXXXXXXXX,0,0,0
9156,49,0,49,32,219,0,0,219,147,72,GOOXXXXXXXXXXXXXXXXXGOOOXXXXXXXXXXXXXXXXGOOOXXXXXXXXXXXXXXXXGOXXXXXXXXXXXXXXXXXXGOOOOOOXXXXXXXXXXXXXGXXXXXXXXXXXXXXXXXXXGOOOXXXXXXXXXXXXXXXXGOXXXXXXXXXXXXXXXXXXGOOXXXXXXXXXXXXXXXXXGOOOOXXXXXXXXXXXXXXXGOOXXXXXXXXXXXXXXXXXGOOOOOXXXXXXXXXXXXXXGOOOOXXXXXXXXXXXXXXX,0,0,0
9177,49,0,49,36,215,0,0,216,147,69,GOOXXXXXXXXXXXXXXXXXGOOOXXXXXXXXXXXXXXXXGOOOXXXXXXXXXXXXXXXXGOXXXXXXXXXXXXXXXXXXGOOOOOOXXXXXXXXXXXXXGXXXXXXXXXXXXXXXXXXXGOOOXXXXXXXXXXXXXXXXGOXXXXXXXXXXXXXXXXXXGOOXXXXXXXXXXXXXXXXXGOOOOXXXXXXXXXXXXXXXGOOXXXXXXXXXXXXXXXXXGOOOOOXXXXXXXXXXXXXXGOOOOXXXXXXXXXXXXXXX,0,0,0
9198,49,0,49,37,214,0,0,215,146,69,GOOXXXXXXXXXXXXXXXXXGOOOXXXXXXXXXXXXXXXXGOOOXXXXXXXXXXXXXXXXGOXXXXXXXXXXXXXXXXXXGOOOOOOXXXXXXXXXXXXXGXXXXXXXXXXXXXXXXXXXGOOOXXXXXXXXXXXXXXXXGOXXXXXXXXXXXXXXXXXXGOOXXXXXXXXXXXXXXXXXGOOOOXXXXXXXXXXXXXXXGOOXXXXXXXXXXXXXXXXXGOOOOOXXXXXXXXXXXXXXGOOOOXXXXXXXXXXXXXXX,0,0,0
9219,49,0,49,38,213,0,0,214,146,68,GOOXXXXXXXXXXXXXXXXXGOOOXXXXXXXXXXXXXXXXGOOOXXXXXXXXXXXXXXXXGOXXXXXXXXXXXXXXXXXXGOOOOOOXXXXXXXXXXXXXGXXXXXXXXXXXXXXXXXXXGOOOXXXXXXXXXXXXXXXXGOXXXXXXXXXXXXXXXXXXGOOXXXXXXXXXXXXXXXXXGOOOOXXXXXXXXXXXXXXXGOOXXXXXXXXXXXXXXXXXGOOOOOXXXXXXXXXXXXXXGOOOOXXXXXXXXXXXXXXX,0,0,0

9240,49,0,49,36,215,0,0,215,146,69,GOOXXXXXXXXXXXXXXXXXGOOOXXXXXXXXXXXXXXXXGOOOXXXXXXXXXXXXXXXXGOXXXXXXXXXXXXXXXXXXGOOOOOOXXXXXXXXXXXXXGXXXXXXXXXXXXXXXXXXXGOOOXXXXXXXXXXXXXXXXGOXXXXXXXXXXXXXXXXXXGOOXXXXXXXXXXXXXXXXXGOOOOXXXXXXXXXXXXXXXGOOXXXXXXXXXXXXXXXXXGOOOOOXXXXXXXXXXXXXXGOOOOXXXXXXXXXXXXXXX,0,0,0
9261,49,0,49,38,213,0,0,214,149,65,GOOXXXXXXXXXXXXXXXXXGOOOXXXXXXXXXXXXXXXXGOOOXXXXXXXXXXXXXXXXGOXXXXXXXXXXXXXXXXXXGOOOOOOXXXXXXXXXXXXXGXXXXXXXXXXXXXXXXXXXGOOOXXXXXXXXXXXXXXXXGOXXXXXXXXXXXXXXXXXXGOOXXXXXXXXXXXXXXXXXGOOOOXXXXXXXXXXXXXXXGOOXXXXXXXXXXXXXXXXXGOOOOOXXXXXXXXXXXXXXGOOOOXXXXXXXXXXXXXXX,0,0,0
9282,49,0,49,40,211,0,0,212,148,64,GOOXXXXXXXXXXXXXXXXXGOOOXXXXXXXXXXXXXXXXGOOOXXXXXXXXXXXXXXXXGOXXXXXXXXXXXXXXXXXXGOOOOOOXXXXXXXXXXXXXGXXXXXXXXXXXXXXXXXXXGOOOXXXXXXXXXXXXXXXXGOXXXXXXXXXXXXXXXXXXGOOXXXXXXXXXXXXXXXXXGOOOOXXXXXXXXXXXXXXXGOOXXXXXXXXXXXXXXXXXGOOOOOXXXXXXXXXXXXXXGOOOOXXXXXXXXXXXXXXX,0,0,0
9303,49,0,49,44,207,0,0,208,147,61,GOOXXXXXXXXXXXXXXXXXGOOOXXXXXXXXXXXXXXXXGOOOXXXXXXXXXXXXXXXXGOXXXXXXXXXXXXXXXXXXGOOOOOOXXXXXXXXXXXXXGXXXXXXXXXXXXXXXXXXXGOOOXXXXXXXXXXXXXXXXGOXXXXXXXXXXXXXXXXXXGOOXXXXXXXXXXXXXXXXXGOOOOXXXXXXXXXXXXXXXGOOXXXXXXXXXXXXXXXXXGOOOOOXXXXXXXXXXXXXXGOOOOXXXXXXXXXXXXXXX,0,0,0
9324,49,0,49,45,206,0,0,207,149,58,GOOXXXXXXXXXXXXXXXXXGOOOXXXXXXXXXXXXXXXXGOOOXXXXXXXXXXXXXXXXGOXXXXXXXXXXXXXXXXXXGOOOOOOXXXXXXXXXXXXXGXXXXXXXXXXXXXXXXXXXGOOOXXXXXXXXXXXXXXXXGOXXXXXXXXXXXXXXXXXXGOOXXXXXXXXXXXXXXXXXGOOOOXXXXXXXXXXXXXXXGOOXXXXXXXXXXXXXXXXXGOOOOOXXXXXXXXXXXXXXGOOOOXXXXXXXXXXXXXXX,0,0,0

9345,49,0,49,44,207,0,0,208,148,60,GOOXXXXXXXXXXXXXXXXXGOOOXXXXXXXXXXXXXXXXGOOOXXXXXXXXXXXXXXXXGOXXXXXXXXXXXXXXXXXXGOOOOOOXXXXXXXXXXXXXGXXXXXXXXXXXXXXXXXXXGOOOXXXXXXXXXXXXXXXXGOXXXXXXXXXXXXXXXXXXGOOXXXXXXXXXXXXXXXXXGOOOOXXXXXXXXXXXXXXXGOOXXXXXXXXXXXXXXXXXGOOOOOXXXXXXXXXXXXXXGOOOOXXXXXXXXXXXXXXX,0,0,0
9366,49,0,49,46,205,0,0,206,146,60,GOOXXXXXXXXXXXXXXXXXGOOOXXXXXXXXXXXXXXXXGOOOXXXXXXXXXXXXXXXXGOXXXXXXXXXXXXXXXXXXGOOOOOOXXXXXXXXXXXXXGXXXXXXXXXXXXXXXXXXXGOOOXXXXXXXXXXXXXXXXGOXXXXXXXXXXXXXXXXXXGOOXXXXXXXXXXXXXXXXXGOOOOXXXXXXXXXXXXXXXGOOXXXXXXXXXXXXXXXXXGOOOOOXXXXXXXXXXXXXXGOOOOXXXXXXXXXXXXXXX,0,0,0
9387,49,0,49,41,210,0,0,211,147,64,GOOXXXXXXXXXXXXXXXXXGOOOXXXXXXXXXXXXXXXXGOOOXXXXXXXXXXXXXXXXGOXXXXXXXXXXXXXXXXXXGOOOOOOXXXXXXXXXXXXXGXXXXXXXXXXXXXXXXXXXGOOOXXXXXXXXXXXXXXXXGOXXXXXXXXXXXXXXXXXXGOOXXXXXXXXXXXXXXXXXGOOOOXXXXXXXXXXXXXXXGOOXXXXXXXXXXXXXXXXXGOOOOOXXXXXXXXXXXXXXGOOOOXXXXXXXXXXXXXXX,0,0,0
9408,49,0,49,39,212,0,0,213,150,63,GOOXXXXXXXXXXXXXXXXXGOOOXXXXXXXXXXXXXXXXGOOOXXXXXXXXXXXXXXXXGOXXXXXXXXXXXXXXXXXXGOOOOOOXXXXXXXXXXXXXGXXXXXXXXXXXXXXXXXXXGOOOXXXXXXXXXXXXXXXXGOXXXXXXXXXXXXXXXXXXGOOXXXXXXXXXXXXXXXXXGOOOOXXXXXXXXXXXXXXXGOOXXXXXXXXXXXXXXXXXGOOOOOXXXXXXXXXXXXXXGOOOOXXXXXXXXXXXXXXX,0,0,0
9429,49,0,49,35,216,0,0,217,149,68,GOOXXXXXXXXXXXXXXXXXGOOOXXXXXXXXXXXXXXXXGOOOXXXXXXXXXXXXXXXXGOXXXXXXXXXXXXXXXXXXGOOOOOOXXXXXXXXXXXXXGXXXXXXXXXXXXXXXXXXXGOOOXXXXXXXXXXXXXXXXGOXXXXXXXXXXXXXXXXXXGOOXXXXXXXXXXXXXXXXXGOOOOXXXXXXXXXXXXXXXGOOXXXXXXXXXXXXXXXXXGOOOOOXXXXXXXXXXXXXXGOOOOXXXXXXXXXXXXXXX,0,0,0

9450,49,0,49,36,215,0,0,217,147,70,GOOXXXXXXXXXXXXXXXXXGOOOXXXXXXXXXXXXXXXXGOOOXXXXXXXXXXXXXXXXGOXXXXXXXXXXXXXXXXXXGOOOOOOXXXXXXXXXXXXXGXXXXXXXXXXXXXXXXXXXGOOOXXXXXXXXXXXXXXXXGOXXXXXXXXXXXXXXXXXXGOOXXXXXXXXXXXXXXXXXGOOOOXXXXXXXXXXXXXXXGOOXXXXXXXXXXXXXXXXXGOOOOOXXXXXXXXXXXXXXGOOOOXXXXXXXXXXXXXXX,0,0,0
9471,49,0,49,37,214,0,0,216,146,70,GOOXXXXXXXXXXXXXXXXXGOOOXXXXXXXXXXXXXXXXGOOOXXXXXXXXXXXXXXXXGOXXXXXXXXXXXXXXXXXXGOOOOOOXXXXXXXXXXXXXGXXXXXXXXXXXXXXXXXXXGOOOXXXXXXXXXXXXXXXXGOXXXXXXXXXXXXXXXXXXGOOXXXXXXXXXXXXXXXXXGOOOOXXXXXXXXXXXXXXXGOOXXXXXXXXXXXXXXXXXGOOOOOXXXXXXXXXXXXXXGOOOOXXXXXXXXXXXXXXX,0,0,0
9492,49,0,49,36,215,0,0,217,149,68,GOOXXXXXXXXXXXXXXXXXGOOOXXXXXXXXXXXXXXXXGOOOXXXXXXXXXXXXXXXXGOXXXXXXXXXXXXXXXXXXGOOOOOOXXXXXXXXXXXXXGXXXXXXXXXXXXXXXXXXXGOOOXXXXXXXXXXXXXXXXGOXXXXXXXXXXXXXXXXXXGOOXXXXXXXXXXXXXXXXXGOOOOXXXXXXXXXXXXXXXGOOXXXXXXXXXXXXXXXXXGOOOOOXXXXXXXXXXXXXXGOOOOXXXXXXXXXXXXXXX,0,0,0
9513,49,0,49,41,210,0,0,211,148,63,GOOXXXXXXXXXXXXXXXXXGOOOXXXXXXXXXXXXXXXXGOOOXXXXXXXXXXXXXXXXGOXXXXXXXXXXXXXXXXXXGOOOOOOXXXXXXXXXXXXXGXXXXXXXXXXXXXXXXXXXGOOOXXXXXXXXXXXXXXXXGOXXXXXXXXXXXXXXXXXXGOOXXXXXXXXXXXXXXXXXGOOOOXXXXXXXXXXXXXXXGOOXXXXXXXXXXXXXXXXXGOOOOOXXXXXXXXXXXXXXGOOOOXXXXXXXXXXXXXXX,0,0,0
9534,49,0,49,41,210,0,0,212,147,65,GOOXXXXXXXXXXXXXXXXXGOOOXXXXXXXXXXXXXXXXGOOOXXXXXXXXXXXXXXXXGOXXXXXXXXXXXXXXXXXXGOOOOOOXXXXXXXXXXXXXGXXXXXXXXXXXXXXXXXXXGOOOXXXXXXXXXXXXXXXXGOXXXXXXXXXXXXXXXXXXGOOXXXXXXXXXXXXXXXXXGOOOOXXXXXXXXXXXXXXXGOOXXXXXXXXXXXXXXXXXGOOOOOXXXXXXXXXXXXXXGOOOOXXXXXXXXXXXXXXX,0,0,0

9555,49,0,49,40,211,0,0,213,148,65,GOOXXXXXXXXXXXXXXXXXGOOOXXXXXXXXXXXXXXXXGOOOXXXXXXXXXXXXXXXXGOXXXXXXXXXXXXXXXXXXGOOOOOOXXXXXXXXXXXXXGXXXXXXXXXXXXXXXXXXXGOOOXXXXXXXXXXXXXXXXGOXXXXXXXXXXXXXXXXXXGOOXXXXXXXXXXXXXXXXXGOOOOXXXXXXXXXXXXXXXGOOXXXXXXXXXXXXXXXXXGOOOOOXXXXXXXXXXXXXXGOOOOXXXXXXXXXXXXXXX,0,0,0
9576,49,0,49,37,214,0,0,216,148,68,GOOXXXXXXXXXXXXXXXXXGOOOXXXXXXXXXXXXXXXXGOOOXXXXXXXXXXXXXXXXGOXXXXXXXXXXXXXXXXXXGOOOOOOXXXXXXXXXXXXXGXXXXXXXXXXXXXXXXXXXGOOOXXXXXXXXXXXXXXXXGOXXXXXXXXXXXXXXXXXXGOOXXXXXXXXXXXXXXXXXGOOOOXXXXXXXXXXXXXXXGOOXXXXXXXXXXXXXXXXXGOOOOOXXXXXXXXXXXXXXGOOOOXXXXXXXXXXXXXXX,0,0,0
9597,49,0,49,39,212,0,0,214,149,65,GOOXXXXXXXXXXXXXXXXXGOOOXXXXXXXXXXXXXXXXGOOOXXXXXXXXXXXXXXXXGOXXXXXXXXXXXXXXXXXXGOOOOOOXXXXXXXXXXXXXGXXXXXXXXXXXXXXXXXXXGOOOXXXXXXXXXXXXXXXXGOXXXXXXXXXXXXXXXXXXGOOXXXXXXXXXXXXXXXXXGOOOOXXXXXXXXXXXXXXXGOOXXXXXXXXXXXXXXXXXGOOOOOXXXXXXXXXXXXXXGOOOOXXXXXXXXXXXXXXX,0,0,0
9618,49,0,49,39,212,0,0,214,148,66,GOOXXXXXXXXXXXXXXXXXGOOOXXXXXXXXXXXXXXXXGOOOXXXXXXXXXXXXXXXXGOXXXXXXXXXXXXXXXXXXGOOOOOOXXXXXXXXXXXXXGXXXXXXXXXXXXXXXXXXXGOOOXXXXXXXXXXXXXXXXGOXXXXXXXXXXXXXXXXXXGOOXXXXXXXXXXXXXXXXXGOOOOXXXXXXXXXXXXXXXGOOXXXXXXXXXXXXXXXXXGOOOOOXXXXXXXXXXXXXXGOOOOXXXXXXXXXXXXXXX,0,0,0
9639,49,0,49,36,215,0,0,217,151,66,GOOXXXXXXXXXXXXXXXXXGOOOXXXXXXXXXXXXXXXXGOOOXXXXXXXXXXXXXXXXGOXXXXXXXXXXXXXXXXXXGOOOOOOXXXXXXXXXXXXXGXXXXXXXXXXXXXXXXXXXGOOOXXXXXXXXXXXXXXXXGOXXXXXXXXXXXXXXXXXXGOOXXXXXXXXXXXXXXXXXGOOOOXXXXXXXXXXXXXXXGOOXXXXXXXXXXXXXXXXXGOOOOOXXXXXXXXXXXXXXGOOOOXXXXXXXXXXXXXXX,0,0,0

9660,49,0,49,38,213,0,0,214,147,67,GOOXXXXXXXXXXXXXXXXXGOOOXXXXXXXXXXXXXXXXGOOOXXXXXXXXXXXXXXXXGOXXXXXXXXXXXXXXXXXXGOOOOOOXXXXXXXXXXXXXGXXXXXXXXXXXXXXXXXXXGOOOXXXXXXXXXXXXXXXXGOXXXXXXXXXXXXXXXXXXGOOXXXXXXXXXXXXXXXXXGOOOOXXXXXXXXXXXXXXXGOOXXXXXXXXXXXXXXXXXGOOOOOXXXXXXXXXXXXXXGOOOOXXXXXXXXXXXXXXX,0,0,0
9681,49,0,49,38,213,0,0,214,150,64,GOOXXXXXXXXXXXXXXXXXGOOOXXXXXXXXXXXXXXXXGOOOXXXXXXXXXXXXXXXXGOXXXXXXXXXXXXXXXXXXGOOOOOOXXXXXXXXXXXXXGXXXXXXXXXXXXXXXXXXXGOOOXXXXXXXXXXXXXXXXGOXXXXXXXXXXXXXXXXXXGOOXXXXXXXXXXXXXXXXXGOOOOXXXXXXXXXXXXXXXGOOXXXXXXXXXXXXXXXXXGOOOOOXXXXXXXXXXXXXXGOOOOXXXXXXXXXXXXXXX,0,0,0
9702,49,0,49,40,211,0,0,212,151,61,GOOXXXXXXXXXXXXXXXXXGOOOXXXXXXXXXXXXXXXXGOOOXXXXXXXXXXXXXXXXGOXXXXXXXXXXXXXXXXXXGOOOOOOXXXXXXXXXXXXXGXXXXXXXXXXXXXXXXXXXGOOOXXXXXXXXXXXXXXXXGOXXXXXXXXXXXXXXXXXXGOOXXXXXXXXXXXXXXXXXGOOOOXXXXXXXXXXXXXXXGOOXXXXXXXXXXXXXXXXXGOOOOOXXXXXXXXXXXXXXGOOOOXXXXXXXXXXXXXXX,0,0,0
9723,49,0,49,38,213,0,0,215,154,61,GOOXXXXXXXXXXXXXXXXXGOOOXXXXXXXXXXXXXXXXGOOOXXXXXXXXXXXXXXXXGOXXXXXXXXXXXXXXXXXXGOOOOOOXXXXXXXXXXXXXGXXXXXXXXXXXXXXXXXXXGOOOXXXXXXXXXXXXXXXXGOXXXXXXXXXXXXXXXXXXGOOXXXXXXXXXXXXXXXXXGOOOOXXXXXXXXXXXXXXXGOOXXXXXXXXXXXXXXXXXGOOOOOXXXXXXXXXXXXXXGOOOOXXXXXXXXXXXXXXX,0,0,0
9744,49,0,49,41,210,0,0,212,152,60,GOOXXXXXXXXXXXXXXXXXGOOOXXXXXXXXXXXXXXXXGOOOXXXXXXXXXXXXXXXXGOXXXXXXXXXXXXXXXXXXGOOOOOOXXXXXXXXXXXXXGXXXXXXXXXXXXXXXXXXXGOOOXXXXXXXXXXXXXXXXGOXXXXXXXXXXXXXXXXXXGOOXXXXXXXXXXXXXXXXXGOOOOXXXXXXXXXXXXXXXGOOXXXXXXXXXXXXXXXXXGOOOOOXXXXXXXXXXXXXXGOOOOXXXXXXXXXXXXXXX,0,0,0

9765,49,0,49,40,211,0,0,213,152,61,GOOXXXXXXXXXXXXXXXXXGOOOXXXXXXXXXXXXXXXXGOOOXXXXXXXXXXXXXXXXGOXXXXXXXXXXXXXXXXXXGOOOOOOXXXXXXXXXXXXXGXXXXXXXXXXXXXXXXXXXGOOOXXXXXXXXXXXXXXXXGOXXXXXXXXXXXXXXXXXXGOOXXXXXXXXXXXXXXXXXGOOOOXXXXXXXXXXXXXXXGOOXXXXXXXXXXXXXXXXXGOOOOOXXXXXXXXXXXXXXGOOOOXXXXXXXXXXXXXXX,0,0,0
9786,49,0,49,43,208,0,0,210,149,61,GOOXXXXXXXXXXXXXXXXXGOOOXXXXXXXXXXXXXXXXGOOOXXXXXXXXXXXXXXXXGOXXXXXXXXXXXXXXXXXXGOOOOOOXXXXXXXXXXXXXGXXXXXXXXXXXXXXXXXXXGOOOXXXXXXXXXXXXXXXXGOXXXXXXXXXXXXXXXXXXGOOXXXXXXXXXXXXXXXXXGOOOOXXXXXXXXXXXXXXXGOOXXXXXXXXXXXXXXXXXGOOOOOXXXXXXXXXXXXXXGOOOOXXXXXXXXXXXXXXX,0,0,0
9807,49,0,49,42,209,0,0,210,148,62,GOOXXXXXXXXXXXXXXXXXGOOOXXXXXXXXXXXXXXXXGOOOXXXXXXXXXXXXXXXXGOXXXXXXXXXXXXXXXXXXGOOOOOOXXXXXXXXXXXXXGXXXXXXXXXXXXXXXXXXXGOOOXXXXXXXXXXXXXXXXGOXXXXXXXXXXXXXXXXXXGOOXXXXXXXXXXXXXXXXXGOOOOXXXXXXXXXXXXXXXGOOXXXXXXXXXXXXXXXXXGOOOOOXXXXXXXXXXXXXXGOOOOXXXXXXXXXXXXXXX,0,0,0
9828,49,0,49,37,214,0,0,216,149,67,GOOXXXXXXXXXXXXXXXXXGOOOXXXXXXXXXXXXXXXXGOOOXXXXXXXXXXXXXXXXGOXXXXXXXXXXXXXXXXXXGOOOOOOXXXXXXXXXXXXXGXXXXXXXXXXXXXXXXXXXGOOOXXXXXXXXXXXXXXXXGOXXXXXXXXXXXXXXXXXXGOOXXXXXXXXXXXXXXXXXGOOOOXXXXXXXXXXXXXXXGOOXXXXXXXXXXXXXXXXXGOOOOOXXXXXXXXXXXXXXGOOOOXXXXXXXXXXXXXXX,0,0,0
9849,49,0,49,38,213,0,0,215,150,65,GOOXXXXXXXXXXXXXXXXXGOOOXXXXXXXXXXXXXXXXGOOOXXXXXXXXXXXXXXXXGOXXXXXXXXXXXXXXXXXXGOOOOOOXXXXXXXXXXXXXGXXXXXXXXXXXXXXXXXXXGOOOXXXXXXXXXXXXXXXXGOXXXXXXXXXXXXXXXXXXGOOXXXXXXXXXXXXXXXXXGOOOOXXXXXXXXXXXXXXXGOOXXXXXXXXXXXXXXXXXGOOOOOXXXXXXXXXXXXXXGOOOOXXXXXXXXXXXXXXX,0,0,0

9870,49,0,49,36,215,0,0,216,148,68,GOOXXXXXXXXXXXXXXXXXGOOOXXXXXXXXXXXXXXXXGOOOXXXXXXXXXXXXXXXXGOXXXXXXXXXXXXXXXXXXGOOOOOOXXXXXXXXXXXXXGXXXXXXXXXXXXXXXXXXXGOOOXXXXXXXXXXXXXXXXGOXXXXXXXXXXXXXXXXXXGOOXXXXXXXXXXXXXXXXXGOOOOXXXXXXXXXXXXXXXGOOXXXXXXXXXXXXXXXXXGOOOOOXXXXXXXXXXXXXXGOOOOXXXXXXXXXXXXXXX,0,0,0
9891,49,0,49,35,216,0,0,216,146,70,GOOXXXXXXXXXXXXXXXXXGOOOXXXXXXXXXXXXXXXXGOOOXXXXXXXXXXXXXXXXGOXXXXXXXXXXXXXXXXXXGOOOOOOXXXXXXXXXXXXXGXXXXXXXXXXXXXXXXXXXGOOOXXXXXXXXXXXXXXXXGOXXXXXXXXXXXXXXXXXXGOOXXXXXXXXXXXXXXXXXGOOOOXXXXXXXXXXXXXXXGOOXXXXXXXXXXXXXXXXXGOOOOOXXXXXXXXXXXXXXGOOOOXXXXXXXXXXXXXXX,0,0,0
9912,49,0,49,29,222,0,0,222,150,72,GOOXXXXXXXXXXXXXXXXXGOOOXXXXXXXXXXXXXXXXGOOOXXXXXXXXXXXXXXXXGOXXXXXXXXXXXXXXXXXXGOOOOOOXXXXXXXXXXXXXGXXXXXXXXXXXXXXXXXXXGOOOXXXXXXXXXXXXXXXXGOXXXXXXXXXXXXXXXXXXGOOXXXXXXXXXXXXXXXXXGOOOOXXXXXXXXXXXXXXXGOOXXXXXXXXXXXXXXXXXGOOOOOXXXXXXXXXXXXXXGOOOOXXXXXXXXXXXXXXX,0,0,0
9933,49,0,49,29,222,0,0,223,149,74,GOOXXXXXXXXXXXXXXXXXGOOOXXXXXXXXXXXXXXXXGOOOXXXXXXXXXXXXXXXXGOXXXXXXXXXXXXXXXXXXGOOOOOOXXXXXXXXXXXXXGXXXXXXXXXXXXXXXXXXXGOOOXXXXXXXXXXXXXXXXGOXXXXXXXXXXXXXXXXXXGOOXXXXXXXXXXXXXXXXXGOOOOXXXXXXXXXXXXXXXGOOXXXXXXXXXXXXXXXXXGOOOOOXXXXXXXXXXXXXXGOOOOXXXXXXXXXXXXXXX,0,0,0
9954,49,0,49,32,219,0,0,220,147,73,GOOXXXXXXXXXXXXXXXXXGOOOXXXXXXXXXXXXXXXXGOOOXXXXXXXXXXXXXXXXGOXXXXXXXXXXXXXXXXXXGOOOOOOXXXXXXXXXXXXXGXXXXXXXXXXXXXXXXXXXGOOOXXXXXXXXXXXXXXXXGOXXXXXXXXXXXXXXXXXXGOOXXXXXXXXXXXXXXXXXGOOOOXXXXXXXXXXXXXXXGOOXXXXXXXXXXXXXXXXXGOOOOOXXXXXXXXXXXXXXGOOOOXXXXXXXXXXXXXXX,0,0,0

9975,49,0,49,34,217,0,0,218,147,71,GOOXXXXXXXXXXXXXXXXXGOOOXXXXXXXXXXXXXXXXGOOOXXXXXXXXXXXXXXXXGOXXXXXXXXXXXXXXXXXXGOOOOOOXXXXXXXXXXXXXGXXXXXXXXXXXXXXXXXXXGOOOXXXXXXXXXXXXXXXXGOXXXXXXXXXXXXXXXXXXGOOXXXXXXXXXXXXXXXXXGOOOOXXXXXXXXXXXXXXXGOOXXXXXXXXXXXXXXXXXGOOOOOXXXXXXXXXXXXXXGOOOOXXXXXXXXXXXXXXX,0,0,0
9996,49,0,49,34,217,0,0,218,148,70,GOOXXXXXXXXXXXXXXXXXGOOOXXXXXXXXXXXXXXXXGOOOXXXXXXXXXXXXXXXXGOXXXXXXXXXXXXXXXXXXGOOOOOOXXXXXXXXXXXXXGXXXXXXXXXXXXXXXXXXXGOOOXXXXXXXXXXXXXXXXGOXXXXXXXXXXXXXXXXXXGOOXXXXXXXXXXXXXXXXXGOOOOXXXXXXXXXXXXXXXGOOXXXXXXXXXXXXXXXXXGOOOOOXXXXXXXXXXXXXXGOOOOXXXXXXXXXXXXXXX,0,0,0
10017,49,0,49,35,216,0,0,217,148,69,GOOXXXXXXXXXXXXXXXXXGOOOXXXXXXXXXXXXXXXXGOOOXXXXXXXXXXXXXXXXGOXXXXXXXXXXXXXXXXXXGOOOOOOXXXXXXXXXXXXXGXXXXXXXXXXXXXXXXXXXGOOOXXXXXXXXXXXXXXXXGOXXXXXXXXXXXXXXXXXXGOOXXXXXXXXXXXXXXXXXGOOOOXXXXXXXXXXXXXXXGOOXXXXXXXXXXXXXXXXXGOOOOOXXXXXXXXXXXXXXGOOOOXXXXXXXXXXXXXXX,300,0,0
10038,49,0,49,36,215,0,0,216,150,66,GOOXXXXXXXXXXXXXXXXXGOOOXXXXXXXXXXXXXXXXGOOOXXXXXXXXXXXXXXXXGOXXXXXXXXXXXXXXXXXXGOOOOOOXXXXXXXXXXXXXGXXXXXXXXXXXXXXXXXXXGOOOXXXXXXXXXXXXXXXXGOXXXXXXXXXXXXXXXXXXGOOXXXXXXXXXXXXXXXXXGOOOOXXXXXXXXXXXXXXXGOOXXXXXXXXXXXXXXXXXGOOOOOXXXXXXXXXXXXXXGOOOOXXXXXXXXXXXXXXX,300,0,0
10059,49,0,49,38,213,0,0,214,149,65,GOOXXXXXXXXXXXXXXXXXGOOOXXXXXXXXXXXXXXXXGOOOXXXXXXXXXXXXXXXXGOXXXXXXXXXXXXXXXXXXGOOOOOOXXXXXXXXXXXXXGXXXXXXXXXXXXXXXXXXXGOOOXXXXXXXXXXXXXXXXGOXXXXXXXXXXXXXXXXXXGOOXXXXXXXXXXXXXXXXXGOOOOXXXXXXXXXXXXXXXGOOXXXXXXXXXXXXXXXXXGOOOOOXXXXXXXXXXXXXXGOOOOXXXXXXXXXXXXXXX,300,0,0

10080,49,0,49,40,211,0,0,210,150,60,GOOXXXXXXXXXXXXXXXXXGOOOXXXXXXXXXXXXXXXXGOOOXXXXXXXXXXXXXXXXGOXXXXXXXXXXXXXXXXXXGOOOOOOXXXXXXXXXXXXXGXXXXXXXXXXXXXXXXXXXGOOOXXXXXXXXXXXXXXXXGOXXXXXXXXXXXXXXXXXXGOOXXXXXXXXXXXXXXXXXGOOOOXXXXXXXXXXXXXXXGOOXXXXXXXXXXXXXXXXXGOOOOOXXXXXXXXXXXXXXGOOOOXXXXXXXXXXXXXXX,300,0,0
10101,49,0,49,39,212,0,0,213,151,62,GOOXXXXXXXXXXXXXXXXXGOOOXXXXXXXXXXXXXXXXGOOOXXXXXXXXXXXXXXXXGOXXXXXXXXXXXXXXXXXXGOOOOOOXXXXXXXXXXXXXGXXXXXXXXXXXXXXXXXXXGOOOXXXXXXXXXXXXXXXXGOXXXXXXXXXXXXXXXXXXGOOXXXXXXXXXXXXXXXXXGOOOOXXXXXXXXXXXXXXXGOOXXXXXXXXXXXXXXXXXGOOOOOXXXXXXXXXXXXXXGOOOOXXXXXXXXXXXXXXX,300,0,0
10122,49,0,49,41,210,0,0,211,148,63,GOOXXXXXXXXXXXXXXXXXGOOOXXXXXXXXXXXXXXXXGOOOXXXXXXXXXXXXXXXXGOXXXXXXXXXXXXXXXXXXGOOOOOOXXXXXXXXXXXXXGXXXXXXXXXXXXXXXXXXXGOOOXXXXXXXXXXXXXXXXGOXXXXXXXXXXXXXXXXXXGOOXXXXXXXXXXXXXXXXXGOOOOXXXXXXXXXXXXXXXGOOXXXXXXXXXXXXXXXXXGOOOOOXXXXXXXXXXXXXXGOOOOXXXXXXXXXXXXXXX,300,0,0
10143,49,0,49,42,209,0,0,210,152,58,GOOXXXXXXXXXXXXXXXXXGOOOXXXXXXXXXXXXXXXXGOOOXXXXXXXXXXXXXXXXGOXXXXXXXXXXXXXXXXXXGOOOOOOXXXXXXXXXXXXXGXXXXXXXXXXXXXXXXXXXGOOOXXXXXXXXXXXXXXXXGOXXXXXXXXXXXXXXXXXXGOOXXXXXXXXXXXXXXXXXGOOOOXXXXXXXXXXXXXXXGOOXXXXXXXXXXXXXXXXXGOOOOOXXXXXXXXXXXXXXGOOOOXXXXXXXXXXXXXXX,300,0,0
10164,49,0,49,45,206,0,0,206,149,57,GOOXXXXXXXXXXXXXXXXXGOOOXXXXXXXXXXXXXXXXGOOOXXXXXXXXXXXXXXXXGOXXXXXXXXXXXXXXXXXXGOOOOOOXXXXXXXXXXXXXGXXXXXXXXXXXXXXXXXXXGOOOXXXXXXXXXXXXXXXXGOXXXXXXXXXXXXXXXXXXGOOXXXXXXXXXXXXXXXXXGOOOOXXXXXXXXXXXXXXXGOOXXXXXXXXXXXXXXXXXGOOOOOXXXXXXXXXXXXXXGOOOOXXXXXXXXXXXXXXX,300,0,0

10185,49,0,49,45,206,0,0,207,149,58,GOOXXXXXXXXXXXXXXXXXGOOOXXXXXXXXXXXXXXXXGOOOXXXXXXXXXXXXXXXXGOXXXXXXXXXXXXXXXXXXGOOOOOOXXXXXXXXXXXXXGXXXXXXXXXXXXXXXXXXXGOOOXXXXXXXXXXXXXXXXGOXXXXXXXXXXXXXXXXXXGOOXXXXXXXXXXXXXXXXXGOOOOXXXXXXXXXXXXXXXGOOXXXXXXXXXXXXXXXXXGOOOOOXXXXXXXXXXXXXXGOOOOXXXXXXXXXXXXXXX,300,0,0
10206,49,0,49,47,204,0,0,205,149,56,GOOXXXXXXXXXXXXXXXXXGOOOXXXXXXXXXXXXXXXXGOOOXXXXXXXXXXXXXXXXGOXXXXXXXXXXXXXXXXXXGOOOOOOXXXXXXXXXXXXXGXXXXXXXXXXXXXXXXXXXGOOOXXXXXXXXXXXXXXXXGOXXXXXXXXXXXXXXXXXXGOOXXXXXXXXXXXXXXXXXGOOOOXXXXXXXXXXXXXXXGOOXXXXXXXXXXXXXXXXXGOOOOOXXXXXXXXXXXXXXGOOOOXXXXXXXXXXXXXXX,300,0,0
10227,49,0,49,47,204,0,0,205,149,56,GOOXXXXXXXXXXXXXXXXXGOOOXXXXXXXXXXXXXXXXGOOOXXXXXXXXXXXXXXXXGOXXXXXXXXXXXXXXXXXXGOOOOOOXXXXXXXXXXXXXGXXXXXXXXXXXXXXXXXXXGOOOXXXXXXXXXXXXXXXXGOXXXXXXXXXXXXXXXXXXGOOXXXXXXXXXXXXXXXXXGOOOOXXXXXXXXXXXXXXXGOOXXXXXXXXXXXXXXXXXGOOOOOXXXXXXXXXXXXXXGOOOOXXXXXXXXXXXXXXX,300,0,0
10248,49,0,49,44,207,0,0,207,150,57,GOOXXXXXXXXXXXXXXXXXGOOOXXXXXXXXXXXXXXXXGOOOXXXXXXXXXXXXXXXXGOXXXXXXXXXXXXXXXXXXGOOOOOOXXXXXXXXXXXXXGXXXXXXXXXXXXXXXXXXXGOOOXXXXXXXXXXXXXXXXGOXXXXXXXXXXXXXXXXXXGOOXXXXXXXXXXXXXXXXXGOOOOXXXXXXXXXXXXXXXGOOXXXXXXXXXXXXXXXXXGOOOOOXXXXXXXXXXXXXXGOOOOXXXXXXXXXXXXXXX,300,0,0
10269,49,0,49,42,209,0,0,209,151,58,GOOXXXXXXXXXXXXXXXXXGOOOXXXXXXXXXXXXXXXXGOOOXXXXXXXXXXXXXXXXGOXXXXXXXXXXXXXXXXXXGOOOOOOXXXXXXXXXXXXXGXXXXXXXXXXXXXXXXXXXGOOOXXXXXXXXXXXXXXXXGOXXXXXXXXXXXXXXXXXXGOOXXXXXXXXXXXXXXXXXGOOOOXXXXXXXXXXXXXXXGOOXXXXXXXXXXXXXXXXXGOOOOOXXXXXXXXXXXXXXGOOOOXXXXXXXXXXXXXXX,300,0,0

10290,49,0,49,43,208,0,0,209,152,57,GOOXXXXXXXXXXXXXXXXXGOOOXXXXXXXXXXXXXXXXGOOOXXXXXXXXXXXXXXXXGOXXXXXXXXXXXXXXXXXXGOOOOOOXXXXXXXXXXXXXGXXXXXXXXXXXXXXXXXXXGOOOXXXXXXXXXXXXXXXXGOXXXXXXXXXXXXXXXXXXGOOXXXXXXXXXXXXXXXXXGOOOOXXXXXXXXXXXXXXXGOOXXXXXXXXXXXXXXXXXGOOOOOXXXXXXXXXXXXXXGOOOOXXXXXXXXXXXXXXX,300,0,0
10311,49,0,49,40,211,0,0,212,151,61,GOOXXXXXXXXXXXXXXXXXGOOOXXXXXXXXXXXXXXXXGOOOXXXXXXXXXXXXXXXXGOXXXXXXXXXXXXXXXXXXGOOOOOOXXXXXXXXXXXXXGXXXXXXXXXXXXXXXXXXXGOOOXXXXXXXXXXXXXXXXGOXXXXXXXXXXXXXXXXXXGOOXXXXXXXXXXXXXXXXXGOOOOXXXXXXXXXXXXXXXGOOXXXXXXXXXXXXXXXXXGOOOOOXXXXXXXXXXXXXXGOOOOXXXXXXXXXXXXXXX,300,0,0
10332,49,0,49,39,212,0,0,212,151,61,GOOXXXXXXXXXXXXXXXXXGOOOXXXXXXXXXXXXXXXXGOOOXXXXXXXXXXXXXXXXGOXXXXXXXXXXXXXXXXXXGOOOOOOXXXXXXXXXXXXXGXXXXXXXXXXXXXXXXXXXGOOOXXXXXXXXXXXXXXXXGOXXXXXXXXXXXXXXXXXXGOOXXXXXXXXXXXXXXXXXGOOOOXXXXXXXXXXXXXXXGOOXXXXXXXXXXXXXXXXXGOOOOOXXXXXXXXXXXXXXGOOOOXXXXXXXXXXXXXXX,300,0,0
10353,50,1,49,40,210,0,0,211,150,61,GOOXXXXXXXXXXXXXXXXXGOOOXXXXXXXXXXXXXXXXGOOOXXXXXXXXXXXXXXXXGOXXXXXXXXXXXXXXXXXXGOOOOOOXXXXXXXXXXXXXGXXXXXXXXXXXXXXXXXXXGOOOXXXXXXXXXXXXXXXXGOXXXXXXXXXXXXXXXXXXGOOXXXXXXXXXXXXXXXXXGOOOOXXXXXXXXXXXXXXXGOOXXXXXXXXXXXXXXXXXGOOOOOXXXXXXXXXXXXXXGOOOOAXXXXXXXXXXXXXX,300,0,0
10374,50,1,49,37,213,0,0,214,149,65,GOOXXXXXXXXXXXXXXXXXGOOOXXXXXXXXXXXXXXXXGOOOXXXXXXXXXXXXXXXXGOXXXXXXXXXXXXXXXXXXGOOOOOOXXXXXXXXXXXXXGXXXXXXXXXXXXXXXXXXXGOOOXXXXXXXXXXXXXXXXGOXXXXXXXXXXXXXXXXXXGOOXXXXXXXXXXXXXXXXXGOOOOXXXXXXXXXXXXXXXGOOXXXXXXXXXXXXXXXXXGOOOOOXXXXXXXXXXXXXXGOOOOAXXXXXXXXXXXXXX,300,0,0

10395,50,1,49,39,211,0,0,212,152,60,GOOXXXXXXXXXXXXXXXXXGOOOXXXXXXXXXXXXXXXXGOOOXXXXXXXXXXXXXXXXGOXXXXXXXXXXXXXXXXXXGOOOOOOXXXXXXXXXXXXXGXXXXXXXXXXXXXXXXXXXGOOOXXXXXXXXXXXXXXXXGOXXXXXXXXXXXXXXXXXXGOOXXXXXXXXXXXXXXXXXGOOOOXXXXXXXXXXXXXXXGOOXXXXXXXXXXXXXXXXXGOOOOOXXXXXXXXXXXXXXGOOOOAXXXXXXXXXXXXXX,300,0,0
10416,50,1,49,38,212,0,0,213,151,62,GOOXXXXXXXXXXXXXXXXXGOOOXXXXXXXXXXXXXXXXGOOOXXXXXXXXXXXXXXXXGOXXXXXXXXXXXXXXXXXXGOOOOOOXXXXXXXXXXXXXGXXXXXXXXXXXXXXXXXXXGOOOXXXXXXXXXXXXXXXXGOXXXXXXXXXXXXXXXXXXGOOXXXXXXXXXXXXXXXXXGOOOOXXXXXXXXXXXXXXXGOOXXXXXXXXXXXXXXXXXGOOOOOXXXXXXXXXXXXXXGOOOOAXXXXXXXXXXXXXX,300,0,0
10437,50,1,49,39,211,0,0,212,150,62,GOOXXXXXXXXXXXXXXXXXGOOOXXXXXXXXXXXXXXXXGOOOXXXXXXXXXXXXXXXXGOXXXXXXXXXXXXXXXXXXGOOOOOOXXXXXXXXXXXXXGXXXXXXXXXXXXXXXXXXXGOOOXXXXXXXXXXXXXXXXGOXXXXXXXXXXXXXXXXXXGOOXXXXXXXXXXXXXXXXXGOOOOXXXXXXXXXXXXXXXGOOXXXXXXXXXXXXXXXXXGOOOOOXXXXXXXXXXXXXXGOOOOAXXXXXXXXXXXXXX,300,0,0
10458,51,2,49,39,210,0,0,211,152,59,GOOXXXXXXXXXXXXXXXXXGOOOXXXXXXXXXXXXXXXXGOOOXXXXXXXXXXXXXXXXGOXXXXXXXXXXXXXXXXXXGOOOOOOXXXXXXXXXXXXXGXXXXXXXXXXXXXXXXXXXGOOOXXXXXXXXXXXXXXXXGOXXXXXXXXXXXXXXXXXXGOOXXXXXXXXXXXXXXXXXGOOOOAXXXXXXXXXXXXXXGOOXXXXXXXXXXXXXXXXXGOOOOOXXXXXXXXXXXXXXGOOOOAXXXXXXXXXXXXXX,300,0,0
10479,51,2,49,40,209,0,0,210,151,59,GOOXXXXXXXXXXXXXXXXXGOOOXXXXXXXXXXXXXXXXGOOOXXXXXXXXXXXXXXXXGOXXXXXXXXXXXXXXXXXXGOOOOOOXXXXXXXXXXXXXGXXXXXXXXXXXXXXXXXXXGOOOXXXXXXXXXXXXXXXXGOXXXXXXXXXXXXXXXXXXGOOXXXXXXXXXXXXXXXXXGOOOOAXXXXXXXXXXXXXXGOOXXXXXXXXXXXXXXXXXGOOOOOXXXXXXXXXXXXXXGOOOOAXXXXXXXXXXXXXX,300,0,0

10500,51,2,49,37,212,0,0,212,150,62,GOOXXXXXXXXXXXXXXXXXGOOOXXXXXXXXXXXXXXXXGOOOXXXXXXXXXXXXXXXXGOXXXXXXXXXXXXXXXXXXGOOOOOOXXXXXXXXXXXXXGXXXXXXXXXXXXXXXXXXXGOOOXXXXXXXXXXXXXXXXGOXXXXXXXXXXXXXXXXXXGOOXXXXXXXXXXXXXXXXXGOOOOAXXXXXXXXXXXXXXGOOXXXXXXXXXXXXXXXXXGOOOOOXXXXXXXXXXXXXXGOOOOAXXXXXXXXXXXXXX,300,0,0
10521,51,2,49,37,212,0,0,213,151,62,GOOXXXXXXXXXXXXXXXXXGOOOXXXXXXXXXXXXXXXXGOOOXXXXXXXXXXXXXXXXGOXXXXXXXXXXXXXXXXXXGOOOOOOXXXXXXXXXXXXXGXXXXXXXXXXXXXXXXXXXGOOOXXXXXXXXXXXXXXXXGOXXXXXXXXXXXXXXXXXXGOOXXXXXXXXXXXXXXXXXGOOOOAXXXXXXXXXXXXXXGOOXXXXXXXXXXXXXXXXXGOOOOOXXXXXXXXXXXXXXGOOOOAXXXXXXXXXXXXXX,281,19,0
10542,51,1,50,39,210,0,0,211,152,59,GOOXXXXXXXXXXXXXXXXXGOOOXXXXXXXXXXXXXXXXGOOOXXXXXXXXXXXXXXXXGOXXXXXXXXXXXXXXXXXXGOOOOOOXXXXXXXXXXXXXGXXXXXXXXXXXXXXXXXXXGOOOXXXXXXXXXXXXXXXXGOXXXXXXXXXXXXXXXXXXGOOXXXXXXXXXXXXXXXXXGOOOOAXXXXXXXXXXXXXXGOOXXXXXXXXXXXXXXXXXGOOOOOXXXXXXXXXXXXXXGOOOOOXXXXXXXXXXXXXX,265,35,0
10563,52,2,50,34,214,0,0,215,153,62,GOOXXXXXXXXXXXXXXXXXGOOOAXXXXXXXXXXXXXXXGOOOXXXXXXXXXXXXXXXXGOXXXXXXXXXXXXXXXXXXGOOOOOOXXXXXXXXXXXXXGXXXXXXXXXXXXXXXXXXXGOOOXXXXXXXXXXXXXXXXGOXXXXXXXXXXXXXXXXXXGOOXXXXXXXXXXXXXXXXXGOOOOAXXXXXXXXXXXXXXGOOXXXXXXXXXXXXXXXXXGOOOOOXXXXXXXXXXXXXXGOOOOOXXXXXXXXXXXXXX,257,43,0
10584,52,1,51,36,212,0,0,213,152,61,GOOXXXXXXXXXXXXXXXXXGOOOAXXXXXXXXXXXXXXXGOOOXXXXXXXXXXXXXXXXGOXXXXXXXXXXXXXXXXXXGOOOOOOXXXXXXXXXXXXXGXXXXXXXXXXXXXXXXXXXGOOOXXXXXXXXXXXXXXXXGOXXXXXXXXXXXXXXXXXXGOOXXXXXXXXXXXXXXXXXGOOOOOXXXXXXXXXXXXXXGOOXXXXXXXXXXXXXXXXXGOOOOOXXXXXXXXXXXXXXGOOOOOXXXXXXXXXXXXXX,242,58,0

10605,52,1,51,34,214,0,0,215,153,62,GOOXXXXXXXXXXXXXXXXXGOOOAXXXXXXXXXXXXXXXGOOOXXXXXXXXXXXXXXXXGOXXXXXXXXXXXXXXXXXXGOOOOOOXXXXXXXXXXXXXGXXXXXXXXXXXXXXXXXXXGOOOXXXXXXXXXXXXXXXXGOXXXXXXXXXXXXXXXXXXGOOXXXXXXXXXXXXXXXXXGOOOOOXXXXXXXXXXXXXXGOOXXXXXXXXXXXXXXXXXGOOOOOXXXXXXXXXXXXXXGOOOOOXXXXXXXXXXXXXX,228,72,0
10626,53,2,51,33,214,0,0,214,155,59,GOOXXXXXXXXXXXXXXXXXGOOOAXXXXXXXXXXXXXXXGOOOXXXXXXXXXXXXXXXXGOXXXXXXXXXXXXXXXXXXGOOOOOOXXXXXXXXXXXXXGXXXXXXXXXXXXXXXXXXXGOOOXXXXXXXXXXXXXXXXGOXXXXXXXXXXXXXXXXXXGOOXXXXXXXXXXXXXXXXXGOOOOOXXXXXXXXXXXXXXGOOXXXXXXXXXXXXXXXXXGOOOOOAXXXXXXXXXXXXXGOOOOOXXXXXXXXXXXXXX,214,86,0
10647,53,2,51,35,212,0,0,213,149,64,GOOXXXXXXXXXXXXXXXXXGOOOAXXXXXXXXXXXXXXXGOOOXXXXXXXXXXXXXXXXGOXXXXXXXXXXXXXXXXXXGOOOOOOXXXXXXXXXXXXXGXXXXXXXXXXXXXXXXXXXGOOOXXXXXXXXXXXXXXXXGOXXXXXXXXXXXXXXXXXXGOOXXXXXXXXXXXXXXXXXGOOOOOXXXXXXXXXXXXXXGOOXXXXXXXXXXXXXXXXXGOOOOOAXXXXXXXXXXXXXGOOOOOXXXXXXXXXXXXXX,207,93,0
10668,53,1,52,34,213,0,0,214,153,61,GOOXXXXXXXXXXXXXXXXXGOOOOXXXXXXXXXXXXXXXGOOOXXXXXXXXXXXXXXXXGOXXXXXXXXXXXXXXXXXXGOOOOOOXXXXXXXXXXXXXGXXXXXXXXXXXXXXXXXXXGOOOXXXXXXXXXXXXXXXXGOXXXXXXXXXXXXXXXXXXGOOXXXXXXXXXXXXXXXXXGOOOOOXXXXXXXXXXXXXXGOOXXXXXXXXXXXXXXXXXGOOOOOAXXXXXXXXXXXXXGOOOOOXXXXXXXXXXXXXX,195,105,0
10689,53,1,52,37,210,0,0,211,152,59,GOOXXXXXXXXXXXXXXXXXGOOOOXXXXXXXXXXXXXXXGOOOXXXXXXXXXXXXXXXXGOXXXXXXXXXXXXXXXXXXGOOOOOOXXXXXXXXXXXXXGXXXXXXXXXXXXXXXXXXXGOOOXXXXXXXXXXXXXXXXGOXXXXXXXXXXXXXXXXXXGOOXXXXXXXXXXXXXXXXXGOOOOOXXXXXXXXXXXXXXGOOXXXXXXXXXXXXXXXXXGOOOOOAXXXXXXXXXXXXXGOOOOOXXXXXXXXXXXXXX,187,113,0

10710,53,0,53,37,210,0,0,211,158,53,GOOXXXXXXXXXXXXXXXXXGOOOOXXXXXXXXXXXXXXXGOOOXXXXXXXXXXXXXXXXGOXXXXXXXXXXXXXXXXXXGOOOOOOXXXXXXXXXXXXXGXXXXXXXXXXXXXXXXXXXGOOOXXXXXXXXXXXXXXXXGOXXXXXXXXXXXXXXXXXXGOOXXXXXXXXXXXXXXXXXGOOOOOXXXXXXXXXXXXXXGOOXXXXXXXXXXXXXXXXXGOOOOOOXXXXXXXXXXXXXGOOOOOXXXXXXXXXXXXXX,174,126,0
10731,53,0,53,40,207,0,0,207,153,54,GOOXXXXXXXXXXXXXXXXXGOOOOXXXXXXXXXXXXXXXGOOOXXXXXXXXXXXXXXXXGOXXXXXXXXXXXXXXXXXXGOOOOOOXXXXXXXXXXXXXGXXXXXXXXXXXXXXXXXXXGOOOXXXXXXXXXXXXXXXXGOXXXXXXXXXXXXXXXXXXGOOXXXXXXXXXXXXXXXXXGOOOOOXXXXXXXXXXXXXXGOOXXXXXXXXXXXXXXXXXGOOOOOOXXXXXXXXXXXXXGOOOOOXXXXXXXXXXXXXX,161,139,0
10752,53,0,53,40,207,0,0,208,151,57,GOOXXXXXXXXXXXXXXXXXGOOOOXXXXXXXXXXXXXXXGOOOXXXXXXXXXXXXXXXXGOXXXXXXXXXXXXXXXXXXGOOOOOOXXXXXXXXXXXXXGXXXXXXXXXXXXXXXXXXXGOOOXXXXXXXXXXXXXXXXGOXXXXXXXXXXXXXXXXXXGOOXXXXXXXXXXXXXXXXXGOOOOOXXXXXXXXXXXXXXGOOXXXXXXXXXXXXXXXXXGOOOOOOXXXXXXXXXXXXXGOOOOOXXXXXXXXXXXXXX,144,156,0
10773,53,0,53,38,209,0,0,210,150,60,GOOXXXXXXXXXXXXXXXXXGOOOOXXXXXXXXXXXXXXXGOOOXXXXXXXXXXXXXXXXGOXXXXXXXXXXXXXXXXXXGOOOOOOXXXXXXXXXXXXXGXXXXXXXXXXXXXXXXXXXGOOOXXXXXXXXXXXXXXXXGOXXXXXXXXXXXXXXXXXXGOOXXXXXXXXXXXXXXXXXGOOOOOXXXXXXXXXXXXXXGOOXXXXXXXXXXXXXXXXXGOOOOOOXXXXXXXXXXXXXGOOOOOXXXXXXXXXXXXXX,132,168,0
10794,54,1,53,35,211,0,0,212,153,59,GOOXXXXXXXXXXXXXXXXXGOOOOAXXXXXXXXXXXXXXGOOOXXXXXXXXXXXXXXXXGOXXXXXXXXXXXXXXXXXXGOOOOOOXXXXXXXXXXXXXGXXXXXXXXXXXXXXXXXXXGOOOXXXXXXXXXXXXXXXXGOXXXXXXXXXXXXXXXXXXGOOXXXXXXXXXXXXXXXXXGOOOOOXXXXXXXXXXXXXXGOOXXXXXXXXXXXXXXXXXGOOOOOOXXXXXXXXXXXXXGOOOOOXXXXXXXXXXXXXX,123,177,0

10815,54,0,54,37,209,0,0,210,154,56,GOOXXXXXXXXXXXXXXXXXGOOOOOXXXXXXXXXXXXXXGOOOXXXXXXXXXXXXXXXXGOXXXXXXXXXXXXXXXXXXGOOOOOOXXXXXXXXXXXXXGXXXXXXXXXXXXXXXXXXXGOOOXXXXXXXXXXXXXXXXGOXXXXXXXXXXXXXXXXXXGOOXXXXXXXXXXXXXXXXXGOOOOOXXXXXXXXXXXXXXGOOXXXXXXXXXXXXXXXXXGOOOOOOXXXXXXXXXXXXXGOOOOOXXXXXXXXXXXXXX,107,193,0
10836,54,0,54,42,204,0,0,205,150,55,GOOXXXXXXXXXXXXXXXXXGOOOOOXXXXXXXXXXXXXXGOOOXXXXXXXXXXXXXXXXGOXXXXXXXXXXXXXXXXXXGOOOOOOXXXXXXXXXXXXXGXXXXXXXXXXXXXXXXXXXGOOOXXXXXXXXXXXXXXXXGOXXXXXXXXXXXXXXXXXXGOOXXXXXXXXXXXXXXXXXGOOOOOXXXXXXXXXXXXXXGOOXXXXXXXXXXXXXXXXXGOOOOOOXXXXXXXXXXXXXGOOOOOXXXXXXXXXXXXXX,98,202,0
10857,54,0,54,43,203,0,0,204,153,51,GOOXXXXXXXXXXXXXXXXXGOOOOOXXXXXXXXXXXXXXGOOOXXXXXXXXXXXXXXXXGOXXXXXXXXXXXXXXXXXXGOOOOOOXXXXXXXXXXXXXGXXXXXXXXXXXXXXXXXXXGOOOXXXXXXXXXXXXXXXXGOXXXXXXXXXXXXXXXXXXGOOXXXXXXXXXXXXXXXXXGOOOOOXXXXXXXXXXXXXXGOOXXXXXXXXXXXXXXXXXGOOOOOOXXXXXXXXXXXXXGOOOOOXXXXXXXXXXXXXX,89,211,0
10878,54,0,54,42,204,0,0,205,154,51,GOOXXXXXXXXXXXXXXXXXGOOOOOXXXXXXXXXXXXXXGOOOXXXXXXXXXXXXXXXXGOXXXXXXXXXXXXXXXXXXGOOOOOOXXXXXXXXXXXXXGXXXXXXXXXXXXXXXXXXXGOOOXXXXXXXXXXXXXXXXGOXXXXXXXXXXXXXXXXXXGOOXXXXXXXXXXXXXXXXXGOOOOOXXXXXXXXXXXXXXGOOXXXXXXXXXXXXXXXXXGOOOOOOXXXXXXXXXXXXXGOOOOOXXXXXXXXXXXXXX,81,219,0
10899,54,0,54,41,205,0,0,206,158,48,GOOXXXXXXXXXXXXXXXXXGOOOOOXXXXXXXXXXXXXXGOOOXXXXXXXXXXXXXXXXGOXXXXXXXXXXXXXXXXXXGOOOOOOXXXXXXXXXXXXXGXXXXXXXXXXXXXXXXXXXGOOOXXXXXXXXXXXXXXXXGOXXXXXXXXXXXXXXXXXXGOOXXXXXXXXXXXXXXXXXGOOOOOXXXXXXXXXXXXXXGOOXXXXXXXXXXXXXXXXXGOOOOOOXXXXXXXXXXXXXGOOOOOXXXXXXXXXXXXXX,63,237,0

10920,54,0,54,43,203,0,0,204,152,52,GOOXXXXXXXXXXXXXXXXXGOOOOOXXXXXXXXXXXXXXGOOOXXXXXXXXXXXXXXXXGOXXXXXXXXXXXXXXXXXXGOOOOOOXXXXXXXXXXXXXGXXXXXXXXXXXXXXXXXXXGOOOXXXXXXXXXXXXXXXXGOXXXXXXXXXXXXXXXXXXGOOXXXXXXXXXXXXXXXXXGOOOOOXXXXXXXXXXXXXXGOOXXXXXXXXXXXXXXXXXGOOOOOOXXXXXXXXXXXXXGOOOOOXXXXXXXXXXXXXX,51,249,0
10941,54,0,54,40,206,0,0,209,151,58,GOOXXXXXXXXXXXXXXXXXGOOOOOXXXXXXXXXXXXXXGOOOXXXXXXXXXXXXXXXXGOXXXXXXXXXXXXXXXXXXGOOOOOOXXXXXXXXXXXXXGXXXXXXXXXXXXXXXXXXXGOOOXXXXXXXXXXXXXXXXGOXXXXXXXXXXXXXXXXXXGOOXXXXXXXXXXXXXXXXXGOOOOOXXXXXXXXXXXXXXGOOXXXXXXXXXXXXXXXXXGOOOOOOXXXXXXXXXXXXXGOOOOOXXXXXXXXXXXXXX,44,256,0
10962,55,1,54,37,208,0,0,210,151,59,GOOXXXXXXXXXXXXXXXXXGOOOOOXXXXXXXXXXXXXXGOOOXXXXXXXXXXXXXXXXGOXXXXXXXXXXXXXXXXXXGOOOOOOXXXXXXXXXXXXXGXXXXXXXXXXXXXXXXXXXGOOOXXXXXXXXXXXXXXXXGOXXXXXXXXXXXXXXXXXXGOOAXXXXXXXXXXXXXXXXGOOOOOXXXXXXXXXXXXXXGOOXXXXXXXXXXXXXXXXXGOOOOOOXXXXXXXXXXXXXGOOOOOXXXXXXXXXXXXXX,30,270,0
10983,55,1,54,30,215,0,0,216,153,63,GOOXXXXXXXXXXXXXXXXXGOOOOOXXXXXXXXXXXXXXGOOOXXXXXXXXXXXXXXXXGOXXXXXXXXXXXXXXXXXXGOOOOOOXXXXXXXXXXXXXGXXXXXXXXXXXXXXXXXXXGOOOXXXXXXXXXXXXXXXXGOXXXXXXXXXXXXXXXXXXGOOAXXXXXXXXXXXXXXXXGOOOOOXXXXXXXXXXXXXXGOOXXXXXXXXXXXXXXXXXGOOOOOOXXXXXXXXXXXXXGOOOOOXXXXXXXXXXXXXX,11,289,0
11004,55,1,54,30,215,0,0,216,154,62,GOOXXXXXXXXXXXXXXXXXGOOOOOXXXXXXXXXXXXXXGOOOXXXXXXXXXXXXXXXXGOXXXXXXXXXXXXXXXXXXGOOOOOOXXXXXXXXXXXXXGXXXXXXXXXXXXXXXXXXXGOOOXXXXXXXXXXXXXXXXGOXXXXXXXXXXXXXXXXXXGOOAXXXXXXXXXXXXXXXXGOOOOOXXXXXXXXXXXXXXGOOXXXXXXXXXXXXXXXXXGOOOOOOXXXXXXXXXXXXXGOOOOOXXXXXXXXXXXXXX,0,300,0

11025,55,1,54,28,217,0,0,218,157,61,GOOXXXXXXXXXXXXXXXXXGOOOOOXXXXXXXXXXXXXXGOOOXXXXXXXXXXXXXXXXGOXXXXXXXXXXXXXXXXXXGOOOOOOXXXXXXXXXXXXXGXXXXXXXXXXXXXXXXXXXGOOOXXXXXXXXXXXXXXXXGOXXXXXXXXXXXXXXXXXXGOOAXXXXXXXXXXXXXXXXGOOOOOXXXXXXXXXXXXXXGOOXXXXXXXXXXXXXXXXXGOOOOOOXXXXXXXXXXXXXGOOOOOXXXXXXXXXXXXXX,0,300,0
11046,55,1,54,30,215,0,0,216,154,62,GOOXXXXXXXXXXXXXXXXXGOOOOOXXXXXXXXXXXXXXGOOOXXXXXXXXXXXXXXXXGOXXXXXXXXXXXXXXXXXXGOOOOOOXXXXXXXXXXXXXGXXXXXXXXXXXXXXXXXXXGOOOXXXXXXXXXXXXXXXXGOXXXXXXXXXXXXXXXXXXGOOAXXXXXXXXXXXXXXXXGOOOOOXXXXXXXXXXXXXXGOOXXXXXXXXXXXXXXXXXGOOOOOOXXXXXXXXXXXXXGOOOOOXXXXXXXXXXXXXX,0,300,0
11067,55,1,54,29,216,0,0,215,154,61,GOOXXXXXXXXXXXXXXXXXGOOOOOXXXXXXXXXXXXXXGOOOXXXXXXXXXXXXXXXXGOXXXXXXXXXXXXXXXXXXGOOOOOOXXXXXXXXXXXXXGXXXXXXXXXXXXXXXXXXXGOOOXXXXXXXXXXXXXXXXGOXXXXXXXXXXXXXXXXXXGOOAXXXXXXXXXXXXXXXXGOOOOOXXXXXXXXXXXXXXGOOXXXXXXXXXXXXXXXXXGOOOOOOXXXXXXXXXXXXXGOOOOOXXXXXXXXXXXXXX,0,300,0
11088,55,1,54,25,220,0,0,221,155,66,GOOXXXXXXXXXXXXXXXXXGOOOOOXXXXXXXXXXXXXXGOOOXXXXXXXXXXXXXXXXGOXXXXXXXXXXXXXXXXXXGOOOOOOXXXXXXXXXXXXXGXXXXXXXXXXXXXXXXXXXGOOOXXXXXXXXXXXXXXXXGOXXXXXXXXXXXXXXXXXXGOOAXXXXXXXXXXXXXXXXGOOOOOXXXXXXXXXXXXXXGOOXXXXXXXXXXXXXXXXXGOOOOOOXXXXXXXXXXXXXGOOOOOXXXXXXXXXXXXXX,0,300,0
11109,55,1,54,24,221,0,0,222,157,65,GOOXXXXXXXXXXXXXXXXXGOOOOOXXXXXXXXXXXXXXGOOOXXXXXXXXXXXXXXXXGOXXXXXXXXXXXXXXXXXXGOOOOOOXXXXXXXXXXXXXGXXXXXXXXXXXXXXXXXXXGOOOXXXXXXXXXXXXXXXXGOXXXXXXXXXXXXXXXXXXGOOAXXXXXXXXXXXXXXXXGOOOOOXXXXXXXXXXXXXXGOOXXXXXXXXXXXXXXXXXGOOOOOOXXXXXXXXXXXXXGOOOOOXXXXXXXXXXXXXX,0,300,0

11130,55,1,54,22,223,0,0,224,159,65,GOOXXXXXXXXXXXXXXXXXGOOOOOXXXXXXXXXXXXXXGOOOXXXXXXXXXXXXXXXXGOXXXXXXXXXXXXXXXXXXGOOOOOOXXXXXXXXXXXXXGXXXXXXXXXXXXXXXXXXXGOOOXXXXXXXXXXXXXXXXGOXXXXXXXXXXXXXXXXXXGOOAXXXXXXXXXXXXXXXXGOOOOOXXXXXXXXXXXXXXGOOXXXXXXXXXXXXXXXXXGOOOOOOXXXXXXXXXXXXXGOOOOOXXXXXXXXXXXXXX,0,300,0
11151,55,1,54,23,222,0,0,223,158,65,GOOXXXXXXXXXXXXXXXXXGOOOOOXXXXXXXXXXXXXXGOOOXXXXXXXXXXXXXXXXGOXXXXXXXXXXXXXXXXXXGOOOOOOXXXXXXXXXXXXXGXXXXXXXXXXXXXXXXXXXGOOOXXXXXXXXXXXXXXXXGOXXXXXXXXXXXXXXXXXXGOOAXXXXXXXXXXXXXXXXGOOOOOXXXXXXXXXXXXXXGOOXXXXXXXXXXXXXXXXXGOOOOOOXXXXXXXXXXXXXGOOOOOXXXXXXXXXXXXXX,0,300,0
11172,55,1,54,24,221,0,0,222,158,64,GOOXXXXXXXXXXXXXXXXXGOOOOOXXXXXXXXXXXXXXGOOOXXXXXXXXXXXXXXXXGOXXXXXXXXXXXXXXXXXXGOOOOOOXXXXXXXXXXXXXGXXXXXXXXXXXXXXXXXXXGOOOXXXXXXXXXXXXXXXXGOXXXXXXXXXXXXXXXXXXGOOAXXXXXXXXXXXXXXXXGOOOOOXXXXXXXXXXXXXXGOOXXXXXXXXXXXXXXXXXGOOOOOOXXXXXXXXXXXXXGOOOOOXXXXXXXXXXXXXX,0,300,0
11193,55,1,54,24,221,0,0,221,160,61,GOOXXXXXXXXXXXXXXXXXGOOOOOXXXXXXXXXXXXXXGOOOXXXXXXXXXXXXXXXXGOXXXXXXXXXXXXXXXXXXGOOOOOOXXXXXXXXXXXXXGXXXXXXXXXXXXXXXXXXXGOOOXXXXXXXXXXXXXXXXGOXXXXXXXXXXXXXXXXXXGOOAXXXXXXXXXXXXXXXXGOOOOOXXXXXXXXXXXXXXGOOXXXXXXXXXXXXXXXXXGOOOOOOXXXXXXXXXXXXXGOOOOOXXXXXXXXXXXXXX,0,300,0
11214,55,1,54,25,220,0,0,220,160,60,GOOXXXXXXXXXXXXXXXXXGOOOOOXXXXXXXXXXXXXXGOOOXXXXXXXXXXXXXXXXGOXXXXXXXXXXXXXXXXXXGOOOOOOXXXXXXXXXXXXXGXXXXXXXXXXXXXXXXXXXGOOOXXXXXXXXXXXXXXXXGOXXXXXXXXXXXXXXXXXXGOOAXXXXXXXXXXXXXXXXGOOOOOXXXXXXXXXXXXXXGOOXXXXXXXXXXXXXXXXXGOOOOOOXXXXXXXXXXXXXGOOOOOXXXXXXXXXXXXXX,0,300,0

11235,55,1,54,28,217,0,0,219,158,61,GOOXXXXXXXXXXXXXXXXXGOOOOOXXXXXXXXXXXXXXGOOOXXXXXXXXXXXXXXXXGOXXXXXXXXXXXXXXXXXXGOOOOOOXXXXXXXXXXXXXGXXXXXXXXXXXXXXXXXXXGOOOXXXXXXXXXXXXXXXXGOXXXXXXXXXXXXXXXXXXGOOAXXXXXXXXXXXXXXXXGOOOOOXXXXXXXXXXXXXXGOOXXXXXXXXXXXXXXXXXGOOOOOOXXXXXXXXXXXXXGOOOOOXXXXXXXXXXXXXX,0,300,0
11256,55,1,54,30,215,0,0,217,161,56,GOOXXXXXXXXXXXXXXXXXGOOOOOXXXXXXXXXXXXXXGOOOXXXXXXXXXXXXXXXXGOXXXXXXXXXXXXXXXXXXGOOOOOOXXXXXXXXXXXXXGXXXXXXXXXXXXXXXXXXXGOOOXXXXXXXXXXXXXXXXGOXXXXXXXXXXXXXXXXXXGOOAXXXXXXXXXXXXXXXXGOOOOOXXXXXXXXXXXXXXGOOXXXXXXXXXXXXXXXXXGOOOOOOXXXXXXXXXXXXXGOOOOOXXXXXXXXXXXXXX,0,300,0
11277,55,1,54,36,209,0,0,211,156,55,GOOXXXXXXXXXXXXXXXXXGOOOOOXXXXXXXXXXXXXXGOOOXXXXXXXXXXXXXXXXGOXXXXXXXXXXXXXXXXXXGOOOOOOXXXXXXXXXXXXXGXXXXXXXXXXXXXXXXXXXGOOOXXXXXXXXXXXXXXXXGOXXXXXXXXXXXXXXXXXXGOOAXXXXXXXXXXXXXXXXGOOOOOXXXXXXXXXXXXXXGOOXXXXXXXXXXXXXXXXXGOOOOOOXXXXXXXXXXXXXGOOOOOXXXXXXXXXXXXXX,0,300,0
11298,55,1,54,34,211,0,0,213,158,55,GOOXXXXXXXXXXXXXXXXXGOOOOOXXXXXXXXXXXXXXGOOOXXXXXXXXXXXXXXXXGOXXXXXXXXXXXXXXXXXXGOOOOOOXXXXXXXXXXXXXGXXXXXXXXXXXXXXXXXXXGOOOXXXXXXXXXXXXXXXXGOXXXXXXXXXXXXXXXXXXGOOAXXXXXXXXXXXXXXXXGOOOOOXXXXXXXXXXXXXXGOOXXXXXXXXXXXXXXXXXGOOOOOOXXXXXXXXXXXXXGOOOOOXXXXXXXXXXXXXX,0,300,0
11319,55,0,55,34,211,0,0,213,161,52,GOOXXXXXXXXXXXXXXXXXGOOOOOXXXXXXXXXXXXXXGOOOXXXXXXXXXXXXXXXXGOXXXXXXXXXXXXXXXXXXGOOOOOOXXXXXXXXXXXXXGXXXXXXXXXXXXXXXXXXXGOOOXXXXXXXXXXXXXXXXGOXXXXXXXXXXXXXXXXXXGOOOXXXXXXXXXXXXXXXXGOOOOOXXXXXXXXXXXXXXGOOXXXXXXXXXXXXXXXXXGOOOOOOXXXXXXXXXXXXXGOOOOOXXXXXXXXXXXXXX,0,300,0

11340,55,0,55,35,210,0,0,211,158,53,GOOXXXXXXXXXXXXXXXXXGOOOOOXXXXXXXXXXXXXXGOOOXXXXXXXXXXXXXXXXGOXXXXXXXXXXXXXXXXXXGOOOOOOXXXXXXXXXXXXXGXXXXXXXXXXXXXXXXXXXGOOOXXXXXXXXXXXXXXXXGOXXXXXXXXXXXXXXXXXXGOOOXXXXXXXXXXXXXXXXGOOOOOXXXXXXXXXXXXXXGOOXXXXXXXXXXXXXXXXXGOOOOOOXXXXXXXXXXXXXGOOOOOXXXXXXXXXXXXXX,0,300,0
11361,55,0,55,29,216,0,0,215,159,56,GOOXXXXXXXXXXXXXXXXXGOOOOOXXXXXXXXXXXXXXGOOOXXXXXXXXXXXXXXXXGOXXXXXXXXXXXXXXXXXXGOOOOOOXXXXXXXXXXXXXGXXXXXXXXXXXXXXXXXXXGOOOXXXXXXXXXXXXXXXXGOXXXXXXXXXXXXXXXXXXGOOOXXXXXXXXXXXXXXXXGOOOOOXXXXXXXXXXXXXXGOOXXXXXXXXXXXXXXXXXGOOOOOOXXXXXXXXXXXXXGOOOOOXXXXXXXXXXXXXX,0,300,0
11382,55,0,55,32,213,0,0,215,157,58,GOOXXXXXXXXXXXXXXXXXGOOOOOXXXXXXXXXXXXXXGOOOXXXXXXXXXXXXXXXXGOXXXXXXXXXXXXXXXXXXGOOOOOOXXXXXXXXXXXXXGXXXXXXXXXXXXXXXXXXXGOOOXXXXXXXXXXXXXXXXGOXXXXXXXXXXXXXXXXXXGOOOXXXXXXXXXXXXXXXXGOOOOOXXXXXXXXXXXXXXGOOXXXXXXXXXXXXXXXXXGOOOOOOXXXXXXXXXXXXXGOOOOOXXXXXXXXXXXXXX,0,300,0
11403,55,0,55,32,213,0,0,215,161,54,GOOXXXXXXXXXXXXXXXXXGOOOOOXXXXXXXXXXXXXXGOOOXXXXXXXXXXXXXXXXGOXXXXXXXXXXXXXXXXXXGOOOOOOXXXXXXXXXXXXXGXXXXXXXXXXXXXXXXXXXGOOOXXXXXXXXXXXXXXXXGOXXXXXXXXXXXXXXXXXXGOOOXXXXXXXXXXXXXXXXGOOOOOXXXXXXXXXXXXXXGOOXXXXXXXXXXXXXXXXXGOOOOOOXXXXXXXXXXXXXGOOOOOXXXXXXXXXXXXXX,0,300,0
11424,55,0,55,34,211,0,0,213,160,53,GOOXXXXXXXXXXXXXXXXXGOOOOOXXXXXXXXXXXXXXGOOOXXXXXXXXXXXXXXXXGOXXXXXXXXXXXXXXXXXXGOOOOOOXXXXXXXXXXXXXGXXXXXXXXXXXXXXXXXXXGOOOXXXXXXXXXXXXXXXXGOXXXXXXXXXXXXXXXXXXGOOOXXXXXXXXXXXXXXXXGOOOOOXXXXXXXXXXXXXXGOOXXXXXXXXXXXXXXXXXGOOOOOOXXXXXXXXXXXXXGOOOOOXXXXXXXXXXXXXX,0,300,0

11445,55,0,55,35,210,0,0,212,158,54,GOOXXXXXXXXXXXXXXXXXGOOOOOXXXXXXXXXXXXXXGOOOXXXXXXXXXXXXXXXXGOXXXXXXXXXXXXXXXXXXGOOOOOOXXXXXXXXXXXXXGXXXXXXXXXXXXXXXXXXXGOOOXXXXXXXXXXXXXXXXGOXXXXXXXXXXXXXXXXXXGOOOXXXXXXXXXXXXXXXXGOOOOOXXXXXXXXXXXXXXGOOXXXXXXXXXXXXXXXXXGOOOOOOXXXXXXXXXXXXXGOOOOOXXXXXXXXXXXXXX,0,300,0
11466,55,0,55,36,209,0,0,212,158,54,GOOXXXXXXXXXXXXXXXXXGOOOOOXXXXXXXXXXXXXXGOOOXXXXXXXXXXXXXXXXGOXXXXXXXXXXXXXXXXXXGOOOOOOXXXXXXXXXXXXXGXXXXXXXXXXXXXXXXXXXGOOOXXXXXXXXXXXXXXXXGOXXXXXXXXXXXXXXXXXXGOOOXXXXXXXXXXXXXXXXGOOOOOXXXXXXXXXXXXXXGOOXXXXXXXXXXXXXXXXXGOOOOOOXXXXXXXXXXXXXGOOOOOXXXXXXXXXXXXXX,0,300,0
11487,55,0,55,35,210,0,0,213,160,53,GOOXXXXXXXXXXXXXXXXXGOOOOOXXXXXXXXXXXXXXGOOOXXXXXXXXXXXXXXXXGOXXXXXXXXXXXXXXXXXXGOOOOOOXXXXXXXXXXXXXGXXXXXXXXXXXXXXXXXXXGOOOXXXXXXXXXXXXXXXXGOXXXXXXXXXXXXXXXXXXGOOOXXXXXXXXXXXXXXXXGOOOOOXXXXXXXXXXXXXXGOOXXXXXXXXXXXXXXXXXGOOOOOOXXXXXXXXXXXXXGOOOOOXXXXXXXXXXXXXX,0,300,0
11508,55,0,55,34,211,0,0,214,157,57,GOOXXXXXXXXXXXXXXXXXGOOOOOXXXXXXXXXXXXXXGOOOXXXXXXXXXXXXXXXXGOXXXXXXXXXXXXXXXXXXGOOOOOOXXXXXXXXXXXXXGXXXXXXXXXXXXXXXXXXXGOOOXXXXXXXXXXXXXXXXGOXXXXXXXXXXXXXXXXXXGOOOXXXXXXXXXXXXXXXXGOOOOOXXXXXXXXXXXXXXGOOXXXXXXXXXXXXXXXXXGOOOOOOXXXXXXXXXXXXXGOOOOOXXXXXXXXXXXXXX,0,300,0
11529,55,0,55,33,212,0,0,214,156,58,GOOXXXXXXXXXXXXXXXXXGOOOOOXXXXXXXXXXXXXXGOOOXXXXXXXXXXXXXXXXGOXXXXXXXXXXXXXXXXXXGOOOOOOXXXXXXXXXXXXXGXXXXXXXXXXXXXXXXXXXGOOOXXXXXXXXXXXXXXXXGOXXXXXXXXXXXXXXXXXXGOOOXXXXXXXXXXXXXXXXGOOOOOXXXXXXXXXXXXXXGOOXXXXXXXXXXXXXXXXXGOOOOOOXXXXXXXXXXXXXGOOOOOXXXXXXXXXXXXXX,0,300,0

11550,55,0,55,34,211,0,0,214,159,55,GOOXXXXXXXXXXXXXXXXXGOOOOOXXXXXXXXXXXXXXGOOOXXXXXXXXXXXXXXXXGOXXXXXXXXXXXXXXXXXXGOOOOOOXXXXXXXXXXXXXGXXXXXXXXXXXXXXXXXXXGOOOXXXXXXXXXXXXXXXXGOXXXXXXXXXXXXXXXXXXGOOOXXXXXXXXXXXXXXXXGOOOOOXXXXXXXXXXXXXXGOOXXXXXXXXXXXXXXXXXGOOOOOOXXXXXXXXXXXXXGOOOOOXXXXXXXXXXXXXX,0,300,0
11571,55,0,55,36,209,0,0,212,160,52,GOOXXXXXXXXXXXXXXXXXGOOOOOXXXXXXXXXXXXXXGOOOXXXXXXXXXXXXXXXXGOXXXXXXXXXXXXXXXXXXGOOOOOOXXXXXXXXXXXXXGXXXXXXXXXXXXXXXXXXXGOOOXXXXXXXXXXXXXXXXGOXXXXXXXXXXXXXXXXXXGOOOXXXXXXXXXXXXXXXXGOOOOOXXXXXXXXXXXXXXGOOXXXXXXXXXXXXXXXXXGOOOOOOXXXXXXXXXXXXXGOOOOOXXXXXXXXXXXXXX,0,300,0
11592,55,0,55,37,208,0,0,212,159,53,GOOXXXXXXXXXXXXXXXXXGOOOOOXXXXXXXXXXXXXXGOOOXXXXXXXXXXXXXXXXGOXXXXXXXXXXXXXXXXXXGOOOOOOXXXXXXXXXXXXXGXXXXXXXXXXXXXXXXXXXGOOOXXXXXXXXXXXXXXXXGOXXXXXXXXXXXXXXXXXXGOOOXXXXXXXXXXXXXXXXGOOOOOXXXXXXXXXXXXXXGOOXXXXXXXXXXXXXXXXXGOOOOOOXXXXXXXXXXXXXGOOOOOXXXXXXXXXXXXXX,0,300,0
11613,55,0,55,37,208,0,0,212,159,53,GOOXXXXXXXXXXXXXXXXXGOOOOOXXXXXXXXXXXXXXGOOOXXXXXXXXXXXXXXXXGOXXXXXXXXXXXXXXXXXXGOOOOOOXXXXXXXXXXXXXGXXXXXXXXXXXXXXXXXXXGOOOXXXXXXXXXXXXXXXXGOXXXXXXXXXXXXXXXXXXGOOOXXXXXXXXXXXXXXXXGOOOOOXXXXXXXXXXXXXXGOOXXXXXXXXXXXXXXXXXGOOOOOOXXXXXXXXXXXXXGOOOOOXXXXXXXXXXXXXX,0,300,0
11634,55,0,55,37,208,0,0,212,158,54,GOOXXXXXXXXXXXXXXXXXGOOOOOXXXXXXXXXXXXXXGOOOXXXXXXXXXXXXXXXXGOXXXXXXXXXXXXXXXXXXGOOOOOOXXXXXXXXXXXXXGXXXXXXXXXXXXXXXXXXXGOOOXXXXXXXXXXXXXXXXGOXXXXXXXXXXXXXXXXXXGOOOXXXXXXXXXXXXXXXXGOOOOOXXXXXXXXXXXXXXGOOXXXXXXXXXXXXXXXXXGOOOOOOXXXXXXXXXXXXXGOOOOOXXXXXXXXXXXXXX,0,300,0

11655,55,0,55,33,212,0,0,216,161,55,GOOXXXXXXXXXXXXXXXXXGOOOOOXXXXXXXXXXXXXXGOOOXXXXXXXXXXXXXXXXGOXXXXXXXXXXXXXXXXXXGOOOOOOXXXXXXXXXXXXXGXXXXXXXXXXXXXXXXXXXGOOOXXXXXXXXXXXXXXXXGOXXXXXXXXXXXXXXXXXXGOOOXXXXXXXXXXXXXXXXGOOOOOXXXXXXXXXXXXXXGOOXXXXXXXXXXXXXXXXXGOOOOOOXXXXXXXXXXXXXGOOOOOXXXXXXXXXXXXXX,0,300,0
11676,55,0,55,33,212,0,0,216,163,53,GOOXXXXXXXXXXXXXXXXXGOOOOOXXXXXXXXXXXXXXGOOOXXXXXXXXXXXXXXXXGOXXXXXXXXXXXXXXXXXXGOOOOOOXXXXXXXXXXXXXGXXXXXXXXXXXXXXXXXXXGOOOXXXXXXXXXXXXXXXXGOXXXXXXXXXXXXXXXXXXGOOOXXXXXXXXXXXXXXXXGOOOOOXXXXXXXXXXXXXXGOOXXXXXXXXXXXXXXXXXGOOOOOOXXXXXXXXXXXXXGOOOOOXXXXXXXXXXXXXX,0,300,0
11697,55,0,55,34,211,0,0,215,165,50,GOOXXXXXXXXXXXXXXXXXGOOOOOXXXXXXXXXXXXXXGOOOXXXXXXXXXXXXXXXXGOXXXXXXXXXXXXXXXXXXGOOOOOOXXXXXXXXXXXXXGXXXXXXXXXXXXXXXXXXXGOOOXXXXXXXXXXXXXXXXGOXXXXXXXXXXXXXXXXXXGOOOXXXXXXXXXXXXXXXXGOOOOOXXXXXXXXXXXXXXGOOXXXXXXXXXXXXXXXXXGOOOOOOXXXXXXXXXXXXXGOOOOOXXXXXXXXXXXXXX,0,300,0
11718,55,0,55,37,208,0,0,212,164,48,GOOXXXXXXXXXXXXXXXXXGOOOOOXXXXXXXXXXXXXXGOOOXXXXXXXXXXXXXXXXGOXXXXXXXXXXXXXXXXXXGOOOOOOXXXXXXXXXXXXXGXXXXXXXXXXXXXXXXXXXGOOOXXXXXXXXXXXXXXXXGOXXXXXXXXXXXXXXXXXXGOOOXXXXXXXXXXXXXXXXGOOOOOXXXXXXXXXXXXXXGOOXXXXXXXXXXXXXXXXXGOOOOOOXXXXXXXXXXXXXGOOOOOXXXXXXXXXXXXXX,0,300,0
11739,55,0,55,32,213,0,0,217,162,55,GOOXXXXXXXXXXXXXXXXXGOOOOOXXXXXXXXXXXXXXGOOOXXXXXXXXXXXXXXXXGOXXXXXXXXXXXXXXXXXXGOOOOOOXXXXXXXXXXXXXGXXXXXXXXXXXXXXXXXXXGOOOXXXXXXXXXXXXXXXXGOXXXXXXXXXXXXXXXXXXGOOOXXXXXXXXXXXXXXXXGOOOOOXXXXXXXXXXXXXXGOOXXXXXXXXXXXXXXXXXGOOOOOOXXXXXXXXXXXXXGOOOOOXXXXXXXXXXXXXX,0,300,0

11760,55,0,55,34,211,0,0,215,160,55,GOOXXXXXXXXXXXXXXXXXGOOOOOXXXXXXXXXXXXXXGOOOXXXXXXXXXXXXXXXXGOXXXXXXXXXXXXXXXXXXGOOOOOOXXXXXXXXXXXXXGXXXXXXXXXXXXXXXXXXXGOOOXXXXXXXXXXXXXXXXGOXXXXXXXXXXXXXXXXXXGOOOXXXXXXXXXXXXXXXXGOOOOOXXXXXXXXXXXXXXGOOXXXXXXXXXXXXXXXXXGOOOOOOXXXXXXXXXXXXXGOOOOOXXXXXXXXXXXXXX,0,300,0
11781,55,0,55,34,211,0,0,215,159,56,GOOXXXXXXXXXXXXXXXXXGOOOOOXXXXXXXXXXXXXXGOOOXXXXXXXXXXXXXXXXGOXXXXXXXXXXXXXXXXXXGOOOOOOXXXXXXXXXXXXXGXXXXXXXXXXXXXXXXXXXGOOOXXXXXXXXXXXXXXXXGOXXXXXXXXXXXXXXXXXXGOOOXXXXXXXXXXXXXXXXGOOOOOXXXXXXXXXXXXXXGOOXXXXXXXXXXXXXXXXXGOOOOOOXXXXXXXXXXXXXGOOOOOXXXXXXXXXXXXXX,0,300,0
11802,55,0,55,30,215,0,0,219,161,58,GOOXXXXXXXXXXXXXXXXXGOOOOOXXXXXXXXXXXXXXGOOOXXXXXXXXXXXXXXXXGOXXXXXXXXXXXXXXXXXXGOOOOOOXXXXXXXXXXXXXGXXXXXXXXXXXXXXXXXXXGOOOXXXXXXXXXXXXXXXXGOXXXXXXXXXXXXXXXXXXGOOOXXXXXXXXXXXXXXXXGOOOOOXXXXXXXXXXXXXXGOOXXXXXXXXXXXXXXXXXGOOOOOOXXXXXXXXXXXXXGOOOOOXXXXXXXXXXXXXX,0,300,0
11823,55,0,55,33,212,0,0,216,162,54,GOOXXXXXXXXXXXXXXXXXGOOOOOXXXXXXXXXXXXXXGOOOXXXXXXXXXXXXXXXXGOXXXXXXXXXXXXXXXXXXGOOOOOOXXXXXXXXXXXXXGXXXXXXXXXXXXXXXXXXXGOOOXXXXXXXXXXXXXXXXGOXXXXXXXXXXXXXXXXXXGOOOXXXXXXXXXXXXXXXXGOOOOOXXXXXXXXXXXXXXGOOXXXXXXXXXXXXXXXXXGOOOOOOXXXXXXXXXXXXXGOOOOOXXXXXXXXXXXXXX,0,300,0
11844,55,0,55,33,212,0,0,216,161,55,GOOXXXXXXXXXXXXXXXXXGOOOOOXXXXXXXXXXXXXXGOOOXXXXXXXXXXXXXXXXGOXXXXXXXXXXXXXXXXXXGOOOOOOXXXXXXXXXXXXXGXXXXXXXXXXXXXXXXXXXGOOOXXXXXXXXXXXXXXXXGOXXXXXXXXXXXXXXXXXXGOOOXXXXXXXXXXXXXXXXGOOOOOXXXXXXXXXXXXXXGOOXXXXXXXXXXXXXXXXXGOOOOOOXXXXXXXXXXXXXGOOOOOXXXXXXXXXXXXXX,0,300,0

11865,55,0,55,31,214,0,0,218,160,58,GOOXXXXXXXXXXXXXXXXXGOOOOOXXXXXXXXXXXXXXGOOOXXXXXXXXXXXXXXXXGOXXXXXXXXXXXXXXXXXXGOOOOOOXXXXXXXXXXXXXGXXXXXXXXXXXXXXXXXXXGOOOXXXXXXXXXXXXXXXXGOXXXXXXXXXXXXXXXXXXGOOOXXXXXXXXXXXXXXXXGOOOOOXXXXXXXXXXXXXXGOOXXXXXXXXXXXXXXXXXGOOOOOOXXXXXXXXXXXXXGOOOOOXXXXXXXXXXXXXX,0,300,0
11886,55,0,55,31,214,0,0,218,163,55,GOOXXXXXXXXXXXXXXXXXGOOOOOXXXXXXXXXXXXXXGOOOXXXXXXXXXXXXXXXXGOXXXXXXXXXXXXXXXXXXGOOOOOOXXXXXXXXXXXXXGXXXXXXXXXXXXXXXXXXXGOOOXXXXXXXXXXXXXXXXGOXXXXXXXXXXXXXXXXXXGOOOXXXXXXXXXXXXXXXXGOOOOOXXXXXXXXXXXXXXGOOXXXXXXXXXXXXXXXXXGOOOOOOXXXXXXXXXXXXXGOOOOOXXXXXXXXXXXXXX,0,300,0
11907,55,0,55,31,214,0,0,218,164,54,GOOXXXXXXXXXXXXXXXXXGOOOOOXXXXXXXXXXXXXXGOOOXXXXXXXXXXXXXXXXGOXXXXXXXXXXXXXXXXXXGOOOOOOXXXXXXXXXXXXXGXXXXXXXXXXXXXXXXXXXGOOOXXXXXXXXXXXXXXXXGOXXXXXXXXXXXXXXXXXXGOOOXXXXXXXXXXXXXXXXGOOOOOXXXXXXXXXXXXXXGOOXXXXXXXXXXXXXXXXXGOOOOOOXXXXXXXXXXXXXGOOOOOXXXXXXXXXXXXXX,0,300,0
11928,55,0,55,33,212,0,0,215,163,52,GOOXXXXXXXXXXXXXXXXXGOOOOOXXXXXXXXXXXXXXGOOOXXXXXXXXXXXXXXXXGOXXXXXXXXXXXXXXXXXXGOOOOOOXXXXXXXXXXXXXGXXXXXXXXXXXXXXXXXXXGOOOXXXXXXXXXXXXXXXXGOXXXXXXXXXXXXXXXXXXGOOOXXXXXXXXXXXXXXXXGOOOOOXXXXXXXXXXXXXXGOOXXXXXXXXXXXXXXXXXGOOOOOOXXXXXXXXXXXXXGOOOOOXXXXXXXXXXXXXX,0,300,0
11949,55,0,55,34,211,0,0,214,162,52,GOOXXXXXXXXXXXXXXXXXGOOOOOXXXXXXXXXXXXXXGOOOXXXXXXXXXXXXXXXXGOXXXXXXXXXXXXXXXXXXGOOOOOOXXXXXXXXXXXXXGXXXXXXXXXXXXXXXXXXXGOOOXXXXXXXXXXXXXXXXGOXXXXXXXXXXXXXXXXXXGOOOXXXXXXXXXXXXXXXXGOOOOOXXXXXXXXXXXXXXGOOXXXXXXXXXXXXXXXXXGOOOOOOXXXXXXXXXXXXXGOOOOOXXXXXXXXXXXXXX,0,300,0

11970,55,0,55,38,207,0,0,210,161,49,GOOXXXXXXXXXXXXXXXXXGOOOOOXXXXXXXXXXXXXXGOOOXXXXXXXXXXXXXXXXGOXXXXXXXXXXXXXXXXXXGOOOOOOXXXXXXXXXXXXXGXXXXXXXXXXXXXXXXXXXGOOOXXXXXXXXXXXXXXXXGOXXXXXXXXXXXXXXXXXXGOOOXXXXXXXXXXXXXXXXGOOOOOXXXXXXXXXXXXXXGOOXXXXXXXXXXXXXXXXXGOOOOOOXXXXXXXXXXXXXGOOOOOXXXXXXXXXXXXXX,0,300,0
11991,55,0,55,38,207,0,0,210,161,49,GOOXXXXXXXXXXXXXXXXXGOOOOOXXXXXXXXXXXXXXGOOOXXXXXXXXXXXXXXXXGOXXXXXXXXXXXXXXXXXXGOOOOOOXXXXXXXXXXXXXGXXXXXXXXXXXXXXXXXXXGOOOXXXXXXXXXXXXXXXXGOXXXXXXXXXXXXXXXXXXGOOOXXXXXXXXXXXXXXXXGOOOOOXXXXXXXXXXXXXXGOOXXXXXXXXXXXXXXXXXGOOOOOOXXXXXXXXXXXXXGOOOOOXXXXXXXXXXXXXX,0,300,0
12012,55,0,55,43,202,0,0,205,160,45,GOOXXXXXXXXXXXXXXXXXGOOOOOXXXXXXXXXXXXXXGOOOXXXXXXXXXXXXXXXXGOXXXXXXXXXXXXXXXXXXGOOOOOOXXXXXXXXXXXXXGXXXXXXXXXXXXXXXXXXXGOOOXXXXXXXXXXXXXXXXGOXXXXXXXXXXXXXXXXXXGOOOXXXXXXXXXXXXXXXXGOOOOOXXXXXXXXXXXXXXGOOXXXXXXXXXXXXXXXXXGOOOOOOXXXXXXXXXXXXXGOOOOOXXXXXXXXXXXXXX,0,300,0
12033,55,0,55,33,212,0,0,215,161,54,GOOXXXXXXXXXXXXXXXXXGOOOOOXXXXXXXXXXXXXXGOOOXXXXXXXXXXXXXXXXGOXXXXXXXXXXXXXXXXXXGOOOOOOXXXXXXXXXXXXXGXXXXXXXXXXXXXXXXXXXGOOOXXXXXXXXXXXXXXXXGOXXXXXXXXXXXXXXXXXXGOOOXXXXXXXXXXXXXXXXGOOOOOXXXXXXXXXXXXXXGOOXXXXXXXXXXXXXXXXXGOOOOOOXXXXXXXXXXXXXGOOOOOXXXXXXXXXXXXXX,0,300,0
12054,55,0,55,30,215,0,0,217,160,57,GOOXXXXXXXXXXXXXXXXXGOOOOOXXXXXXXXXXXXXXGOOOXXXXXXXXXXXXXXXXGOXXXXXXXXXXXXXXXXXXGOOOOOOXXXXXXXXXXXXXGXXXXXXXXXXXXXXXXXXXGOOOXXXXXXXXXXXXXXXXGOXXXXXXXXXXXXXXXXXXGOOOXXXXXXXXXXXXXXXXGOOOOOXXXXXXXXXXXXXXGOOXXXXXXXXXXXXXXXXXGOOOOOOXXXXXXXXXXXXXGOOOOOXXXXXXXXXXXXXX,0,300,0

12075,55,0,55,27,218,0,0,220,160,60,GOOXXXXXXXXXXXXXXXXXGOOOOOXXXXXXXXXXXXXXGOOOXXXXXXXXXXXXXXXXGOXXXXXXXXXXXXXXXXXXGOOOOOOXXXXXXXXXXXXXGXXXXXXXXXXXXXXXXXXXGOOOXXXXXXXXXXXXXXXXGOXXXXXXXXXXXXXXXXXXGOOOXXXXXXXXXXXXXXXXGOOOOOXXXXXXXXXXXXXXGOOXXXXXXXXXXXXXXXXXGOOOOOOXXXXXXXXXXXXXGOOOOOXXXXXXXXXXXXXX,0,300,0
12096,55,0,55,23,222,0,0,224,161,63,GOOXXXXXXXXXXXXXXXXXGOOOOOXXXXXXXXXXXXXXGOOOXXXXXXXXXXXXXXXXGOXXXXXXXXXXXXXXXXXXGOOOOOOXXXXXXXXXXXXXGXXXXXXXXXXXXXXXXXXXGOOOXXXXXXXXXXXXXXXXGOXXXXXXXXXXXXXXXXXXGOOOXXXXXXXXXXXXXXXXGOOOOOXXXXXXXXXXXXXXGOOXXXXXXXXXXXXXXXXXGOOOOOOXXXXXXXXXXXXXGOOOOOXXXXXXXXXXXXXX,0,300,0
12117,55,0,55,25,220,0,0,222,159,63,GOOXXXXXXXXXXXXXXXXXGOOOOOXXXXXXXXXXXXXXGOOOXXXXXXXXXXXXXXXXGOXXXXXXXXXXXXXXXXXXGOOOOOOXXXXXXXXXXXXXGXXXXXXXXXXXXXXXXXXXGOOOXXXXXXXXXXXXXXXXGOXXXXXXXXXXXXXXXXXXGOOOXXXXXXXXXXXXXXXXGOOOOOXXXXXXXXXXXXXXGOOXXXXXXXXXXXXXXXXXGOOOOOOXXXXXXXXXXXXXGOOOOOXXXXXXXXXXXXXX,0,300,0
12138,55,0,55,22,223,0,0,224,162,62,GOOXXXXXXXXXXXXXXXXXGOOOOOXXXXXXXXXXXXXXGOOOXXXXXXXXXXXXXXXXGOXXXXXXXXXXXXXXXXXXGOOOOOOXXXXXXXXXXXXXGXXXXXXXXXXXXXXXXXXXGOOOXXXXXXXXXXXXXXXXGOXXXXXXXXXXXXXXXXXXGOOOXXXXXXXXXXXXXXXXGOOOOOXXXXXXXXXXXXXXGOOXXXXXXXXXXXXXXXXXGOOOOOOXXXXXXXXXXXXXGOOOOOXXXXXXXXXXXXXX,0,300,0
12159,55,0,55,22,223,0,0,225,163,62,GOOXXXXXXXXXXXXXXXXXGOOOOOXXXXXXXXXXXXXXGOOOXXXXXXXXXXXXXXXXGOXXXXXXXXXXXXXXXXXXGOOOOOOXXXXXXXXXXXXXGXXXXXXXXXXXXXXXXXXXGOOOXXXXXXXXXXXXXXXXGOXXXXXXXXXXXXXXXXXXGOOOXXXXXXXXXXXXXXXXGOOOOOXXXXXXXXXXXXXXGOOXXXXXXXXXXXXXXXXXGOOOOOOXXXXXXXXXXXXXGOOOOOXXXXXXXXXXXXXX,0,300,0

12180,55,0,55,23,222,0,0,224,160,64,GOOXXXXXXXXXXXXXXXXXGOOOOOXXXXXXXXXXXXXXGOOOXXXXXXXXXXXXXXXXGOXXXXXXXXXXXXXXXXXXGOOOOOOXXXXXXXXXXXXXGXXXXXXXXXXXXXXXXXXXGOOOXXXXXXXXXXXXXXXXGOXXXXXXXXXXXXXXXXXXGOOOXXXXXXXXXXXXXXXXGOOOOOXXXXXXXXXXXXXXGOOXXXXXXXXXXXXXXXXXGOOOOOOXXXXXXXXXXXXXGOOOOOXXXXXXXXXXXXXX,0,300,0
12201,55,0,55,24,221,0,0,223,159,64,GOOXXXXXXXXXXXXXXXXXGOOOOOXXXXXXXXXXXXXXGOOOXXXXXXXXXXXXXXXXGOXXXXXXXXXXXXXXXXXXGOOOOOOXXXXXXXXXXXXXGXXXXXXXXXXXXXXXXXXXGOOOXXXXXXXXXXXXXXXXGOXXXXXXXXXXXXXXXXXXGOOOXXXXXXXXXXXXXXXXGOOOOOXXXXXXXXXXXXXXGOOXXXXXXXXXXXXXXXXXGOOOOOOXXXXXXXXXXXXXGOOOOOXXXXXXXXXXXXXX,0,300,0
12222,55,0,55,23,222,0,0,224,159,65,GOOXXXXXXXXXXXXXXXXXGOOOOOXXXXXXXXXXXXXXGOOOXXXXXXXXXXXXXXXXGOXXXXXXXXXXXXXXXXXXGOOOOOOXXXXXXXXXXXXXGXXXXXXXXXXXXXXXXXXXGOOOXXXXXXXXXXXXXXXXGOXXXXXXXXXXXXXXXXXXGOOOXXXXXXXXXXXXXXXXGOOOOOXXXXXXXXXXXXXXGOOXXXXXXXXXXXXXXXXXGOOOOOOXXXXXXXXXXXXXGOOOOOXXXXXXXXXXXXXX,0,300,0
12243,55,0,55,23,222,0,0,224,159,65,GOOXXXXXXXXXXXXXXXXXGOOOOOXXXXXXXXXXXXXXGOOOXXXXXXXXXXXXXXXXGOXXXXXXXXXXXXXXXXXXGOOOOOOXXXXXXXXXXXXXGXXXXXXXXXXXXXXXXXXXGOOOXXXXXXXXXXXXXXXXGOXXXXXXXXXXXXXXXXXXGOOOXXXXXXXXXXXXXXXXGOOOOOXXXXXXXXXXXXXXGOOXXXXXXXXXXXXXXXXXGOOOOOOXXXXXXXXXXXXXGOOOOOXXXXXXXXXXXXXX,0,300,0
12264,55,0,55,22,223,0,0,225,159,66,GOOXXXXXXXXXXXXXXXXXGOOOOOXXXXXXXXXXXXXXGOOOXXXXXXXXXXXXXXXXGOXXXXXXXXXXXXXXXXXXGOOOOOOXXXXXXXXXXXXXGXXXXXXXXXXXXXXXXXXXGOOOXXXXXXXXXXXXXXXXGOXXXXXXXXXXXXXXXXXXGOOOXXXXXXXXXXXXXXXXGOOOOOXXXXXXXXXXXXXXGOOXXXXXXXXXXXXXXXXXGOOOOOOXXXXXXXXXXXXXGOOOOOXXXXXXXXXXXXXX,0,300,0

12285,55,0,55,22,223,0,0,225,161,64,GOOXXXXXXXXXXXXXXXXXGOOOOOXXXXXXXXXXXXXXGOOOXXXXXXXXXXXXXXXXGOXXXXXXXXXXXXXXXXXXGOOOOOOXXXXXXXXXXXXXGXXXXXXXXXXXXXXXXXXXGOOOXXXXXXXXXXXXXXXXGOXXXXXXXXXXXXXXXXXXGOOOXXXXXXXXXXXXXXXXGOOOOOXXXXXXXXXXXXXXGOOXXXXXXXXXXXXXXXXXGOOOOOOXXXXXXXXXXXXXGOOOOOXXXXXXXXXXXXXX,0,300,0
12306,55,0,55,24,221,0,0,223,159,64,GOOXXXXXXXXXXXXXXXXXGOOOOOXXXXXXXXXXXXXXGOOOXXXXXXXXXXXXXXXXGOXXXXXXXXXXXXXXXXXXGOOOOOOXXXXXXXXXXXXXGXXXXXXXXXXXXXXXXXXXGOOOXXXXXXXXXXXXXXXXGOXXXXXXXXXXXXXXXXXXGOOOXXXXXXXXXXXXXXXXGOOOOOXXXXXXXXXXXXXXGOOXXXXXXXXXXXXXXXXXGOOOOOOXXXXXXXXXXXXXGOOOOOXXXXXXXXXXXXXX,0,300,0
12327,55,0,55,20,225,0,0,227,161,66,GOOXXXXXXXXXXXXXXXXXGOOOOOXXXXXXXXXXXXXXGOOOXXXXXXXXXXXXXXXXGOXXXXXXXXXXXXXXXXXXGOOOOOOXXXXXXXXXXXXXGXXXXXXXXXXXXXXXXXXXGOOOXXXXXXXXXXXXXXXXGOXXXXXXXXXXXXXXXXXXGOOOXXXXXXXXXXXXXXXXGOOOOOXXXXXXXXXXXXXXGOOXXXXXXXXXXXXXXXXXGOOOOOOXXXXXXXXXXXXXGOOOOOXXXXXXXXXXXXXX,0,300,0
12348,55,0,55,27,218,0,0,220,160,60,GOOXXXXXXXXXXXXXXXXXGOOOOOXXXXXXXXXXXXXXGOOOXXXXXXXXXXXXXXXXGOXXXXXXXXXXXXXXXXXXGOOOOOOXXXXXXXXXXXXXGXXXXXXXXXXXXXXXXXXXGOOOXXXXXXXXXXXXXXXXGOXXXXXXXXXXXXXXXXXXGOOOXXXXXXXXXXXXXXXXGOOOOOXXXXXXXXXXXXXXGOOXXXXXXXXXXXXXXXXXGOOOOOOXXXXXXXXXXXXXGOOOOOXXXXXXXXXXXXXX,0,300,0
12369,55,0,55,29,216,0,0,218,161,57,GOOXXXXXXXXXXXXXXXXXGOOOOOXXXXXXXXXXXXXXGOOOXXXXXXXXXXXXXXXXGOXXXXXXXXXXXXXXXXXXGOOOOOOXXXXXXXXXXXXXGXXXXXXXXXXXXXXXXXXXGOOOXXXXXXXXXXXXXXXXGOXXXXXXXXXXXXXXXXXXGOOOXXXXXXXXXXXXXXXXGOOOOOXXXXXXXXXXXXXXGOOXXXXXXXXXXXXXXXXXGOOOOOOXXXXXXXXXXXXXGOOOOOXXXXXXXXXXXXXX,0,300,0

12390,55,0,55,32,213,0,0,215,162,53,GOOXXXXXXXXXXXXXXXXXGOOOOOXXXXXXXXXXXXXXGOOOXXXXXXXXXXXXXXXXGOXXXXXXXXXXXXXXXXXXGOOOOOOXXXXXXXXXXXXXGXXXXXXXXXXXXXXXXXXXGOOOXXXXXXXXXXXXXXXXGOXXXXXXXXXXXXXXXXXXGOOOXXXXXXXXXXXXXXXXGOOOOOXXXXXXXXXXXXXXGOOXXXXXXXXXXXXXXXXXGOOOOOOXXXXXXXXXXXXXGOOOOOXXXXXXXXXXXXXX,0,300,0
12411,55,0,55,32,213,0,0,214,160,54,GOOXXXXXXXXXXXXXXXXXGOOOOOXXXXXXXXXXXXXXGOOOXXXXXXXXXXXXXXXXGOXXXXXXXXXXXXXXXXXXGOOOOOOXXXXXXXXXXXXXGXXXXXXXXXXXXXXXXXXXGOOOXXXXXXXXXXXXXXXXGOXXXXXXXXXXXXXXXXXXGOOOXXXXXXXXXXXXXXXXGOOOOOXXXXXXXXXXXXXXGOOXXXXXXXXXXXXXXXXXGOOOOOOXXXXXXXXXXXXXGOOOOOXXXXXXXXXXXXXX,0,300,0
12432,55,0,55,30,215,0,0,217,163,54,GOOXXXXXXXXXXXXXXXXXGOOOOOXXXXXXXXXXXXXXGOOOXXXXXXXXXXXXXXXXGOXXXXXXXXXXXXXXXXXXGOOOOOOXXXXXXXXXXXXXGXXXXXXXXXXXXXXXXXXXGOOOXXXXXXXXXXXXXXXXGOXXXXXXXXXXXXXXXXXXGOOOXXXXXXXXXXXXXXXXGOOOOOXXXXXXXXXXXXXXGOOXXXXXXXXXXXXXXXXXGOOOOOOXXXXXXXXXXXXXGOOOOOXXXXXXXXXXXXXX,0,300,0
12453,55,0,55,29,216,0,0,218,161,57,GOOXXXXXXXXXXXXXXXXXGOOOOOXXXXXXXXXXXXXXGOOOXXXXXXXXXXXXXXXXGOXXXXXXXXXXXXXXXXXXGOOOOOOXXXXXXXXXXXXXGXXXXXXXXXXXXXXXXXXXGOOOXXXXXXXXXXXXXXXXGOXXXXXXXXXXXXXXXXXXGOOOXXXXXXXXXXXXXXXXGOOOOOXXXXXXXXXXXXXXGOOXXXXXXXXXXXXXXXXXGOOOOOOXXXXXXXXXXXXXGOOOOOXXXXXXXXXXXXXX,0,300,0
12474,55,0,55,29,216,0,0,218,163,55,GOOXXXXXXXXXXXXXXXXXGOOOOOXXXXXXXXXXXXXXGOOOXXXXXXXXXXXXXXXXGOXXXXXXXXXXXXXXXXXXGOOOOOOXXXXXXXXXXXXXGXXXXXXXXXXXXXXXXXXXGOOOXXXXXXXXXXXXXXXXGOXXXXXXXXXXXXXXXXXXGOOOXXXXXXXXXXXXXXXXGOOOOOXXXXXXXXXXXXXXGOOXXXXXXXXXXXXXXXXXGOOOOOOXXXXXXXXXXXXXGOOOOOXXXXXXXXXXXXXX,0,300,0

12495,55,0,55,30,215,0,0,217,165,52,GOOXXXXXXXXXXXXXXXXXGOOOOOXXXXXXXXXXXXXXGOOOXXXXXXXXXXXXXXXXGOXXXXXXXXXXXXXXXXXXGOOOOOOXXXXXXXXXXXXXGXXXXXXXXXXXXXXXXXXXGOOOXXXXXXXXXXXXXXXXGOXXXXXXXXXXXXXXXXXXGOOOXXXXXXXXXXXXXXXXGOOOOOXXXXXXXXXXXXXXGOOXXXXXXXXXXXXXXXXXGOOOOOOXXXXXXXXXXXXXGOOOOOXXXXXXXXXXXXXX,0,300,0
12516,55,0,55,33,212,0,0,214,162,52,GOOXXXXXXXXXXXXXXXXXGOOOOOXXXXXXXXXXXXXXGOOOXXXXXXXXXXXXXXXXGOXXXXXXXXXXXXXXXXXXGOOOOOOXXXXXXXXXXXXXGXXXXXXXXXXXXXXXXXXXGOOOXXXXXXXXXXXXXXXXGOXXXXXXXXXXXXXXXXXXGOOOXXXXXXXXXXXXXXXXGOOOOOXXXXXXXXXXXXXXGOOXXXXXXXXXXXXXXXXXGOOOOOOXXXXXXXXXXXXXGOOOOOXXXXXXXXXXXXXX,0,300,0
12537,55,0,55,34,211,0,0,213,162,51,GOOXXXXXXXXXXXXXXXXXGOOOOOXXXXXXXXXXXXXXGOOOXXXXXXXXXXXXXXXXGOXXXXXXXXXXXXXXXXXXGOOOOOOXXXXXXXXXXXXXGXXXXXXXXXXXXXXXXXXXGOOOXXXXXXXXXXXXXXXXGOXXXXXXXXXXXXXXXXXXGOOOXXXXXXXXXXXXXXXXGOOOOOXXXXXXXXXXXXXXGOOXXXXXXXXXXXXXXXXXGOOOOOOXXXXXXXXXXXXXGOOOOOXXXXXXXXXXXXXX,0,300,0
12558,55,0,55,33,212,0,0,214,162,52,GOOXXXXXXXXXXXXXXXXXGOOOOOXXXXXXXXXXXXXXGOOOXXXXXXXXXXXXXXXXGOXXXXXXXXXXXXXXXXXXGOOOOOOXXXXXXXXXXXXXGXXXXXXXXXXXXXXXXXXXGOOOXXXXXXXXXXXXXXXXGOXXXXXXXXXXXXXXXXXXGOOOXXXXXXXXXXXXXXXXGOOOOOXXXXXXXXXXXXXXGOOXXXXXXXXXXXXXXXXXGOOOOOOXXXXXXXXXXXXXGOOOOOXXXXXXXXXXXXXX,0,300,0
12579,55,0,55,31,214,0,0,214,163,51,GOOXXXXXXXXXXXXXXXXXGOOOOOXXXXXXXXXXXXXXGOOOXXXXXXXXXXXXXXXXGOXXXXXXXXXXXXXXXXXXGOOOOOOXXXXXXXXXXXXXGXXXXXXXXXXXXXXXXXXXGOOOXXXXXXXXXXXXXXXXGOXXXXXXXXXXXXXXXXXXGOOOXXXXXXXXXXXXXXXXGOOOOOXXXXXXXXXXXXXXGOOXXXXXXXXXXXXXXXXXGOOOOOOXXXXXXXXXXXXXGOOOOOXXXXXXXXXXXXXX,0,300,0

12600,55,0,55,33,212,0,0,214,162,52,GOOXXXXXXXXXXXXXXXXXGOOOOOXXXXXXXXXXXXXXGOOOXXXXXXXXXXXXXXXXGOXXXXXXXXXXXXXXXXXXGOOOOOOXXXXXXXXXXXXXGXXXXXXXXXXXXXXXXXXXGOOOXXXXXXXXXXXXXXXXGOXXXXXXXXXXXXXXXXXXGOOOXXXXXXXXXXXXXXXXGOOOOOXXXXXXXXXXXXXXGOOXXXXXXXXXXXXXXXXXGOOOOOOXXXXXXXXXXXXXGOOOOOXXXXXXXXXXXXXX,0,300,0
12621,55,0,55,36,209,0,0,211,165,46,GOOXXXXXXXXXXXXXXXXXGOOOOOXXXXXXXXXXXXXXGOOOXXXXXXXXXXXXXXXXGOXXXXXXXXXXXXXXXXXXGOOOOOOXXXXXXXXXXXXXGXXXXXXXXXXXXXXXXXXXGOOOXXXXXXXXXXXXXXXXGOXXXXXXXXXXXXXXXXXXGOOOXXXXXXXXXXXXXXXXGOOOOOXXXXXXXXXXXXXXGOOXXXXXXXXXXXXXXXXXGOOOOOOXXXXXXXXXXXXXGOOOOOXXXXXXXXXXXXXX,0,300,0
12642,55,0,55,38,207,0,0,209,163,46,GOOXXXXXXXXXXXXXXXXXGOOOOOXXXXXXXXXXXXXXGOOOXXXXXXXXXXXXXXXXGOXXXXXXXXXXXXXXXXXXGOOOOOOXXXXXXXXXXXXXGXXXXXXXXXXXXXXXXXXXGOOOXXXXXXXXXXXXXXXXGOXXXXXXXXXXXXXXXXXXGOOOXXXXXXXXXXXXXXXXGOOOOOXXXXXXXXXXXXXXGOOXXXXXXXXXXXXXXXXXGOOOOOOXXXXXXXXXXXXXGOOOOOXXXXXXXXXXXXXX,0,300,0
12663,55,0,55,39,206,0,0,208,163,45,GOOXXXXXXXXXXXXXXXXXGOOOOOXXXXXXXXXXXXXXGOOOXXXXXXXXXXXXXXXXGOXXXXXXXXXXXXXXXXXXGOOOOOOXXXXXXXXXXXXXGXXXXXXXXXXXXXXXXXXXGOOOXXXXXXXXXXXXXXXXGOXXXXXXXXXXXXXXXXXXGOOOXXXXXXXXXXXXXXXXGOOOOOXXXXXXXXXXXXXXGOOXXXXXXXXXXXXXXXXXGOOOOOOXXXXXXXXXXXXXGOOOOOXXXXXXXXXXXXXX,0,300,0
12684,55,0,55,37,208,0,0,210,163,47,GOOXXXXXXXXXXXXXXXXXGOOOOOXXXXXXXXXXXXXXGOOOXXXXXXXXXXXXXXXXGOXXXXXXXXXXXXXXXXXXGOOOOOOXXXXXXXXXXXXXGXXXXXXXXXXXXXXXXXXXGOOOXXXXXXXXXXXXXXXXGOXXXXXXXXXXXXXXXXXXGOOOXXXXXXXXXXXXXXXXGOOOOOXXXXXXXXXXXXXXGOOXXXXXXXXXXXXXXXXXGOOOOOOXXXXXXXXXXXXXGOOOOOXXXXXXXXXXXXXX,0,300,0

12705,55,0,55,40,205,0,0,207,162,45,GOOXXXXXXXXXXXXXXXXXGOOOOOXXXXXXXXXXXXXXGOOOXXXXXXXXXXXXXXXXGOXXXXXXXXXXXXXXXXXXGOOOOOOXXXXXXXXXXXXXGXXXXXXXXXXXXXXXXXXXGOOOXXXXXXXXXXXXXXXXGOXXXXXXXXXXXXXXXXXXGOOOXXXXXXXXXXXXXXXXGOOOOOXXXXXXXXXXXXXXGOOXXXXXXXXXXXXXXXXXGOOOOOOXXXXXXXXXXXXXGOOOOOXXXXXXXXXXXXXX,0,300,0
12726,55,0,55,34,211,0,0,213,163,50,GOOXXXXXXXXXXXXXXXXXGOOOOOXXXXXXXXXXXXXXGOOOXXXXXXXXXXXXXXXXGOXXXXXXXXXXXXXXXXXXGOOOOOOXXXXXXXXXXXXXGXXXXXXXXXXXXXXXXXXXGOOOXXXXXXXXXXXXXXXXGOXXXXXXXXXXXXXXXXXXGOOOXXXXXXXXXXXXXXXXGOOOOOXXXXXXXXXXXXXXGOOXXXXXXXXXXXXXXXXXGOOOOOOXXXXXXXXXXXXXGOOOOOXXXXXXXXXXXXXX,0,300,0
12747,55,0,55,34,211,0,0,213,161,52,GOOXXXXXXXXXXXXXXXXXGOOOOOXXXXXXXXXXXXXXGOOOXXXXXXXXXXXXXXXXGOXXXXXXXXXXXXXXXXXXGOOOOOOXXXXXXXXXXXXXGXXXXXXXXXXXXXXXXXXXGOOOXXXXXXXXXXXXXXXXGOXXXXXXXXXXXXXXXXXXGOOOXXXXXXXXXXXXXXXXGOOOOOXXXXXXXXXXXXXXGOOXXXXXXXXXXXXXXXXXGOOOOOOXXXXXXXXXXXXXGOOOOOXXXXXXXXXXXXXX,0,300,0
12768,55,0,55,32,213,0,0,215,162,53,GOOXXXXXXXXXXXXXXXXXGOOOOOXXXXXXXXXXXXXXGOOOXXXXXXXXXXXXXXXXGOXXXXXXXXXXXXXXXXXXGOOOOOOXXXXXXXXXXXXXGXXXXXXXXXXXXXXXXXXXGOOOXXXXXXXXXXXXXXXXGOXXXXXXXXXXXXXXXXXXGOOOXXXXXXXXXXXXXXXXGOOOOOXXXXXXXXXXXXXXGOOXXXXXXXXXXXXXXXXXGOOOOOOXXXXXXXXXXXXXGOOOOOXXXXXXXXXXXXXX,0,300,0
12789,55,0,55,33,212,0,0,213,164,49,GOOXXXXXXXXXXXXXXXXXGOOOOOXXXXXXXXXXXXXXGOOOXXXXXXXXXXXXXXXXGOXXXXXXXXXXXXXXXXXXGOOOOOOXXXXXXXXXXXXXGXXXXXXXXXXXXXXXXXXXGOOOXXXXXXXXXXXXXXXXGOXXXXXXXXXXXXXXXXXXGOOOXXXXXXXXXXXXXXXXGOOOOOXXXXXXXXXXXXXXGOOXXXXXXXXXXXXXXXXXGOOOOOOXXXXXXXXXXXXXGOOOOOXXXXXXXXXXXXXX,0,300,0

12810,55,0,55,33,212,0,0,215,165,50,GOOXXXXXXXXXXXXXXXXXGOOOOOXXXXXXXXXXXXXXGOOOXXXXXXXXXXXXXXXXGOXXXXXXXXXXXXXXXXXXGOOOOOOXXXXXXXXXXXXXGXXXXXXXXXXXXXXXXXXXGOOOXXXXXXXXXXXXXXXXGOXXXXXXXXXXXXXXXXXXGOOOXXXXXXXXXXXXXXXXGOOOOOXXXXXXXXXXXXXXGOOXXXXXXXXXXXXXXXXXGOOOOOOXXXXXXXXXXXXXGOOOOOXXXXXXXXXXXXXX,0,300,0
12831,55,0,55,36,209,0,0,212,162,50,GOOXXXXXXXXXXXXXXXXXGOOOOOXXXXXXXXXXXXXXGOOOXXXXXXXXXXXXXXXXGOXXXXXXXXXXXXXXXXXXGOOOOOOXXXXXXXXXXXXXGXXXXXXXXXXXXXXXXXXXGOOOXXXXXXXXXXXXXXXXGOXXXXXXXXXXXXXXXXXXGOOOXXXXXXXXXXXXXXXXGOOOOOXXXXXXXXXXXXXXGOOXXXXXXXXXXXXXXXXXGOOOOOOXXXXXXXXXXXXXGOOOOOXXXXXXXXXXXXXX,0,300,0
12852,55,0,55,36,209,0,0,212,161,51,GOOXXXXXXXXXXXXXXXXXGOOOOOXXXXXXXXXXXXXXGOOOXXXXXXXXXXXXXXXXGOXXXXXXXXXXXXXXXXXXGOOOOOOXXXXXXXXXXXXXGXXXXXXXXXXXXXXXXXXXGOOOXXXXXXXXXXXXXXXXGOXXXXXXXXXXXXXXXXXXGOOOXXXXXXXXXXXXXXXXGOOOOOXXXXXXXXXXXXXXGOOXXXXXXXXXXXXXXXXXGOOOOOOXXXXXXXXXXXXXGOOOOOXXXXXXXXXXXXXX,0,300,0
12873,55,0,55,31,214,0,0,217,161,56,GOOXXXXXXXXXXXXXXXXXGOOOOOXXXXXXXXXXXXXXGOOOXXXXXXXXXXXXXXXXGOXXXXXXXXXXXXXXXXXXGOOOOOOXXXXXXXXXXXXXGXXXXXXXXXXXXXXXXXXXGOOOXXXXXXXXXXXXXXXXGOXXXXXXXXXXXXXXXXXXGOOOXXXXXXXXXXXXXXXXGOOOOOXXXXXXXXXXXXXXGOOXXXXXXXXXXXXXXXXXGOOOOOOXXXXXXXXXXXXXGOOOOOXXXXXXXXXXXXXX,0,300,0
12894,55,0,55,30,215,0,0,218,164,54,GOOXXXXXXXXXXXXXXXXXGOOOOOXXXXXXXXXXXXXXGOOOXXXXXXXXXXXXXXXXGOXXXXXXXXXXXXXXXXXXGOOOOOOXXXXXXXXXXXXXGXXXXXXXXXXXXXXXXXXXGOOOXXXXXXXXXXXXXXXXGOXXXXXXXXXXXXXXXXXXGOOOXXXXXXXXXXXXXXXXGOOOOOXXXXXXXXXXXXXXGOOXXXXXXXXXXXXXXXXXGOOOOOOXXXXXXXXXXXXXGOOOOOXXXXXXXXXXXXXX,0,300,0

12915,55,0,55,29,216,0,0,219,162,57,GOOXXXXXXXXXXXXXXXXXGOOOOOXXXXXXXXXXXXXXGOOOXXXXXXXXXXXXXXXXGOXXXXXXXXXXXXXXXXXXGOOOOOOXXXXXXXXXXXXXGXXXXXXXXXXXXXXXXXXXGOOOXXXXXXXXXXXXXXXXGOXXXXXXXXXXXXXXXXXXGOOOXXXXXXXXXXXXXXXXGOOOOOXXXXXXXXXXXXXXGOOXXXXXXXXXXXXXXXXXGOOOOOOXXXXXXXXXXXXXGOOOOOXXXXXXXXXXXXXX,0,300,0
12936,55,0,55,26,219,0,0,222,164,58,GOOXXXXXXXXXXXXXXXXXGOOOOOXXXXXXXXXXXXXXGOOOXXXXXXXXXXXXXXXXGOXXXXXXXXXXXXXXXXXXGOOOOOOXXXXXXXXXXXXXGXXXXXXXXXXXXXXXXXXXGOOOXXXXXXXXXXXXXXXXGOXXXXXXXXXXXXXXXXXXGOOOXXXXXXXXXXXXXXXXGOOOOOXXXXXXXXXXXXXXGOOXXXXXXXXXXXXXXXXXGOOOOOOXXXXXXXXXXXXXGOOOOOXXXXXXXXXXXXXX,0,300,0
12957,55,0,55,22,223,0,0,226,167,59,GOOXXXXXXXXXXXXXXXXXGOOOOOXXXXXXXXXXXXXXGOOOXXXXXXXXXXXXXXXXGOXXXXXXXXXXXXXXXXXXGOOOOOOXXXXXXXXXXXXXGXXXXXXXXXXXXXXXXXXXGOOOXXXXXXXXXXXXXXXXGOXXXXXXXXXXXXXXXXXXGOOOXXXXXXXXXXXXXXXXGOOOOOXXXXXXXXXXXXXXGOOXXXXXXXXXXXXXXXXXGOOOOOOXXXXXXXXXXXXXGOOOOOXXXXXXXXXXXXXX,0,300,0
12978,55,0,55,20,225,0,0,228,166,62,GOOXXXXXXXXXXXXXXXXXGOOOOOXXXXXXXXXXXXXXGOOOXXXXXXXXXXXXXXXXGOXXXXXXXXXXXXXXXXXXGOOOOOOXXXXXXXXXXXXXGXXXXXXXXXXXXXXXXXXXGOOOXXXXXXXXXXXXXXXXGOXXXXXXXXXXXXXXXXXXGOOOXXXXXXXXXXXXXXXXGOOOOOXXXXXXXXXXXXXXGOOXXXXXXXXXXXXXXXXXGOOOOOOXXXXXXXXXXXXXGOOOOOXXXXXXXXXXXXXX,0,300,0
12999,56,1,55,20,224,0,0,228,164,64,GOOAXXXXXXXXXXXXXXXXGOOOOOXXXXXXXXXXXXXXGOOOXXXXXXXXXXXXXXXXGOXXXXXXXXXXXXXXXXXXGOOOOOOXXXXXXXXXXXXXGXXXXXXXXXXXXXXXXXXXGOOOXXXXXXXXXXXXXXXXGOXXXXXXXXXXXXXXXXXXGOOOXXXXXXXXXXXXXXXXGOOOOOXXXXXXXXXXXXXXGOOXXXXXXXXXXXXXXXXXGOOOOOOXXXXXXXXXXXXXGOOOOOXXXXXXXXXXXXXX,0,300,0

13020,56,1,55,16,228,0,0,231,167,64,GOOAXXXXXXXXXXXXXXXXGOOOOOXXXXXXXXXXXXXXGOOOXXXXXXXXXXXXXXXXGOXXXXXXXXXXXXXXXXXXGOOOOOOXXXXXXXXXXXXXGXXXXXXXXXXXXXXXXXXXGOOOXXXXXXXXXXXXXXXXGOXXXXXXXXXXXXXXXXXXGOOOXXXXXXXXXXXXXXXXGOOOOOXXXXXXXXXXXXXXGOOXXXXXXXXXXXXXXXXXGOOOOOOXXXXXXXXXXXXXGOOOOOXXXXXXXXXXXXXX,0,300,0
13041,56,1,55,17,227,0,0,229,166,63,GOOAXXXXXXXXXXXXXXXXGOOOOOXXXXXXXXXXXXXXGOOOXXXXXXXXXXXXXXXXGOXXXXXXXXXXXXXXXXXXGOOOOOOXXXXXXXXXXXXXGXXXXXXXXXXXXXXXXXXXGOOOXXXXXXXXXXXXXXXXGOXXXXXXXXXXXXXXXXXXGOOOXXXXXXXXXXXXXXXXGOOOOOXXXXXXXXXXXXXXGOOXXXXXXXXXXXXXXXXXGOOOOOOXXXXXXXXXXXXXGOOOOOXXXXXXXXXXXXXX,0,300,0
13062,56,1,55,18,226,0,0,229,167,62,GOOAXXXXXXXXXXXXXXXXGOOOOOXXXXXXXXXXXXXXGOOOXXXXXXXXXXXXXXXXGOXXXXXXXXXXXXXXXXXXGOOOOOOXXXXXXXXXXXXXGXXXXXXXXXXXXXXXXXXXGOOOXXXXXXXXXXXXXXXXGOXXXXXXXXXXXXXXXXXXGOOOXXXXXXXXXXXXXXXXGOOOOOXXXXXXXXXXXXXXGOOXXXXXXXXXXXXXXXXXGOOOOOOXXXXXXXXXXXXXGOOOOOXXXXXXXXXXXXXX,0,300,0
13083,56,1,55,19,225,0,0,228,171,57,GOOAXXXXXXXXXXXXXXXXGOOOOOXXXXXXXXXXXXXXGOOOXXXXXXXXXXXXXXXXGOXXXXXXXXXXXXXXXXXXGOOOOOOXXXXXXXXXXXXXGXXXXXXXXXXXXXXXXXXXGOOOXXXXXXXXXXXXXXXXGOXXXXXXXXXXXXXXXXXXGOOOXXXXXXXXXXXXXXXXGOOOOOXXXXXXXXXXXXXXGOOXXXXXXXXXXXXXXXXXGOOOOOOXXXXXXXXXXXXXGOOOOOXXXXXXXXXXXXXX,0,300,0
13104,56,0,56,26,218,0,0,222,167,55,GOOOXXXXXXXXXXXXXXXXGOOOOOXXXXXXXXXXXXXXGOOOXXXXXXXXXXXXXXXXGOXXXXXXXXXXXXXXXXXXGOOOOOOXXXXXXXXXXXXXGXXXXXXXXXXXXXXXXXXXGOOOXXXXXXXXXXXXXXXXGOXXXXXXXXXXXXXXXXXXGOOOXXXXXXXXXXXXXXXXGOOOOOXXXXXXXXXXXXXXGOOXXXXXXXXXXXXXXXXXGOOOOOOXXXXXXXXXXXXXGOOOOOXXXXXXXXXXXXXX,0,300,0

13125,56,0,56,27,217,0,0,221,167,54,GOOOXXXXXXXXXXXXXXXXGOOOOOXXXXXXXXXXXXXXGOOOXXXXXXXXXXXXXXXXGOXXXXXXXXXXXXXXXXXXGOOOOOOXXXXXXXXXXXXXGXXXXXXXXXXXXXXXXXXXGOOOXXXXXXXXXXXXXXXXGOXXXXXXXXXXXXXXXXXXGOOOXXXXXXXXXXXXXXXXGOOOOOXXXXXXXXXXXXXXGOOXXXXXXXXXXXXXXXXXGOOOOOOXXXXXXXXXXXXXGOOOOOXXXXXXXXXXXXXX,0,300,0
13146,56,0,56,28,216,0,0,220,166,54,GOOOXXXXXXXXXXXXXXXXGOOOOOXXXXXXXXXXXXXXGOOOXXXXXXXXXXXXXXXXGOXXXXXXXXXXXXXXXXXXGOOOOOOXXXXXXXXXXXXXGXXXXXXXXXXXXXXXXXXXGOOOXXXXXXXXXXXXXXXXGOXXXXXXXXXXXXXXXXXXGOOOXXXXXXXXXXXXXXXXGOOOOOXXXXXXXXXXXXXXGOOXXXXXXXXXXXXXXXXXGOOOOOOXXXXXXXXXXXXXGOOOOOXXXXXXXXXXXXXX,0,300,0
13167,56,0,56,27,217,0,0,221,166,55,GOOOXXXXXXXXXXXXXXXXGOOOOOXXXXXXXXXXXXXXGOOOXXXXXXXXXXXXXXXXGOXXXXXXXXXXXXXXXXXXGOOOOOOXXXXXXXXXXXXXGXXXXXXXXXXXXXXXXXXXGOOOXXXXXXXXXXXXXXXXGOXXXXXXXXXXXXXXXXXXGOOOXXXXXXXXXXXXXXXXGOOOOOXXXXXXXXXXXXXXGOOXXXXXXXXXXXXXXXXXGOOOOOOXXXXXXXXXXXXXGOOOOOXXXXXXXXXXXXXX,0,300,0
13188,56,0,56,27,217,0,0,221,166,55,GOOOXXXXXXXXXXXXXXXXGOOOOOXXXXXXXXXXXXXXGOOOXXXXXXXXXXXXXXXXGOXXXXXXXXXXXXXXXXXXGOOOOOOXXXXXXXXXXXXXGXXXXXXXXXXXXXXXXXXXGOOOXXXXXXXXXXXXXXXXGOXXXXXXXXXXXXXXXXXXGOOOXXXXXXXXXXXXXXXXGOOOOOXXXXXXXXXXXXXXGOOXXXXXXXXXXXXXXXXXGOOOOOOXXXXXXXXXXXXXGOOOOOXXXXXXXXXXXXXX,0,300,0
13209,56,0,56,29,215,0,0,218,168,50,GOOOXXXXXXXXXXXXXXXXGOOOOOXXXXXXXXXXXXXXGOOOXXXXXXXXXXXXXXXXGOXXXXXXXXXXXXXXXXXXGOOOOOOXXXXXXXXXXXXXGXXXXXXXXXXXXXXXXXXXGOOOXXXXXXXXXXXXXXXXGOXXXXXXXXXXXXXXXXXXGOOOXXXXXXXXXXXXXXXXGOOOOOXXXXXXXXXXXXXXGOOXXXXXXXXXXXXXXXXXGOOOOOOXXXXXXXXXXXXXGOOOOOXXXXXXXXXXXXXX,0,300,0

13230,56,0,56,31,213,0,0,216,169,47,GOOOXXXXXXXXXXXXXXXXGOOOOOXXXXXXXXXXXXXXGOOOXXXXXXXXXXXXXXXXGOXXXXXXXXXXXXXXXXXXGOOOOOOXXXXXXXXXXXXXGXXXXXXXXXXXXXXXXXXXGOOOXXXXXXXXXXXXXXXXGOXXXXXXXXXXXXXXXXXXGOOOXXXXXXXXXXXXXXXXGOOOOOXXXXXXXXXXXXXXGOOXXXXXXXXXXXXXXXXXGOOOOOOXXXXXXXXXXXXXGOOOOOXXXXXXXXXXXXXX,0,300,0
13251,56,0,56,34,210,0,0,213,167,46,GOOOXXXXXXXXXXXXXXXXGOOOOOXXXXXXXXXXXXXXGOOOXXXXXXXXXXXXXXXXGOXXXXXXXXXXXXXXXXXXGOOOOOOXXXXXXXXXXXXXGXXXXXXXXXXXXXXXXXXXGOOOXXXXXXXXXXXXXXXXGOXXXXXXXXXXXXXXXXXXGOOOXXXXXXXXXXXXXXXXGOOOOOXXXXXXXXXXXXXXGOOXXXXXXXXXXXXXXXXXGOOOOOOXXXXXXXXXXXXXGOOOOOXXXXXXXXXXXXXX,0,300,0
13272,56,0,56,35,209,0,0,212,167,45,GOOOXXXXXXXXXXXXXXXXGOOOOOXXXXXXXXXXXXXXGOOOXXXXXXXXXXXXXXXXGOXXXXXXXXXXXXXXXXXXGOOOOOOXXXXXXXXXXXXXGXXXXXXXXXXXXXXXXXXXGOOOXXXXXXXXXXXXXXXXGOXXXXXXXXXXXXXXXXXXGOOOXXXXXXXXXXXXXXXXGOOOOOXXXXXXXXXXXXXXGOOXXXXXXXXXXXXXXXXXGOOOOOOXXXXXXXXXXXXXGOOOOOXXXXXXXXXXXXXX,0,300,0
13293,56,0,56,38,206,0,0,209,167,42,GOOOXXXXXXXXXXXXXXXXGOOOOOXXXXXXXXXXXXXXGOOOXXXXXXXXXXXXXXXXGOXXXXXXXXXXXXXXXXXXGOOOOOOXXXXXXXXXXXXXGXXXXXXXXXXXXXXXXXXXGOOOXXXXXXXXXXXXXXXXGOXXXXXXXXXXXXXXXXXXGOOOXXXXXXXXXXXXXXXXGOOOOOXXXXXXXXXXXXXXGOOXXXXXXXXXXXXXXXXXGOOOOOOXXXXXXXXXXXXXGOOOOOXXXXXXXXXXXXXX,0,300,0
13314,56,0,56,38,206,0,0,208,167,41,GOOOXXXXXXXXXXXXXXXXGOOOOOXXXXXXXXXXXXXXGOOOXXXXXXXXXXXXXXXXGOXXXXXXXXXXXXXXXXXXGOOOOOOXXXXXXXXXXXXXGXXXXXXXXXXXXXXXXXXXGOOOXXXXXXXXXXXXXXXXGOXXXXXXXXXXXXXXXXXXGOOOXXXXXXXXXXXXXXXXGOOOOOXXXXXXXXXXXXXXGOOXXXXXXXXXXXXXXXXXGOOOOOOXXXXXXXXXXXXXGOOOOOXXXXXXXXXXXXXX,0,300,0

13335,56,0,56,35,209,0,0,210,165,45,GOOOXXXXXXXXXXXXXXXXGOOOOOXXXXXXXXXXXXXXGOOOXXXXXXXXXXXXXXXXGOXXXXXXXXXXXXXXXXXXGOOOOOOXXXXXXXXXXXXXGXXXXXXXXXXXXXXXXXXXGOOOXXXXXXXXXXXXXXXXGOXXXXXXXXXXXXXXXXXXGOOOXXXXXXXXXXXXXXXXGOOOOOXXXXXXXXXXXXXXGOOXXXXXXXXXXXXXXXXXGOOOOOOXXXXXXXXXXXXXGOOOOOXXXXXXXXXXXXXX,0,300,0
13356,56,0,56,33,211,0,0,213,167,46,GOOOXXXXXXXXXXXXXXXXGOOOOOXXXXXXXXXXXXXXGOOOXXXXXXXXXXXXXXXXGOXXXXXXXXXXXXXXXXXXGOOOOOOXXXXXXXXXXXXXGXXXXXXXXXXXXXXXXXXXGOOOXXXXXXXXXXXXXXXXGOXXXXXXXXXXXXXXXXXXGOOOXXXXXXXXXXXXXXXXGOOOOOXXXXXXXXXXXXXXGOOXXXXXXXXXXXXXXXXXGOOOOOOXXXXXXXXXXXXXGOOOOOXXXXXXXXXXXXXX,0,300,0
13377,56,0,56,34,210,0,0,211,166,45,GOOOXXXXXXXXXXXXXXXXGOOOOOXXXXXXXXXXXXXXGOOOXXXXXXXXXXXXXXXXGOXXXXXXXXXXXXXXXXXXGOOOOOOXXXXXXXXXXXXXGXXXXXXXXXXXXXXXXXXXGOOOXXXXXXXXXXXXXXXXGOXXXXXXXXXXXXXXXXXXGOOOXXXXXXXXXXXXXXXXGOOOOOXXXXXXXXXXXXXXGOOXXXXXXXXXXXXXXXXXGOOOOOOXXXXXXXXXXXXXGOOOOOXXXXXXXXXXXXXX,0,300,0
13398,56,0,56,31,213,0,0,215,166,49,GOOOXXXXXXXXXXXXXXXXGOOOOOXXXXXXXXXXXXXXGOOOXXXXXXXXXXXXXXXXGOXXXXXXXXXXXXXXXXXXGOOOOOOXXXXXXXXXXXXXGXXXXXXXXXXXXXXXXXXXGOOOXXXXXXXXXXXXXXXXGOXXXXXXXXXXXXXXXXXXGOOOXXXXXXXXXXXXXXXXGOOOOOXXXXXXXXXXXXXXGOOXXXXXXXXXXXXXXXXXGOOOOOOXXXXXXXXXXXXXGOOOOOXXXXXXXXXXXXXX,0,300,0
13419,57,1,56,29,214,0,0,216,170,46,GOOOXXXXXXXXXXXXXXXXGOOOOOXXXXXXXXXXXXXXGOOOAXXXXXXXXXXXXXXXGOXXXXXXXXXXXXXXXXXXGOOOOOOXXXXXXXXXXXXXGXXXXXXXXXXXXXXXXXXXGOOOXXXXXXXXXXXXXXXXGOXXXXXXXXXXXXXXXXXXGOOOXXXXXXXXXXXXXXXXGOOOOOXXXXXXXXXXXXXXGOOXXXXXXXXXXXXXXXXXGOOOOOOXXXXXXXXXXXXXGOOOOOXXXXXXXXXXXXXX,0,300,0

13440,58,2,56,24,218,0,0,219,170,49,GOOOXXXXXXXXXXXXXXXXGOOOOOXXXXXXXXXXXXXXGOOOAAXXXXXXXXXXXXXXGOXXXXXXXXXXXXXXXXXXGOOOOOOXXXXXXXXXXXXXGXXXXXXXXXXXXXXXXXXXGOOOXXXXXXXXXXXXXXXXGOXXXXXXXXXXXXXXXXXXGOOOXXXXXXXXXXXXXXXXGOOOOOXXXXXXXXXXXXXXGOOXXXXXXXXXXXXXXXXXGOOOOOOXXXXXXXXXXXXXGOOOOOXXXXXXXXXXXXXX,0,300,0
13461,58,2,56,27,215,0,0,217,167,50,GOOOXXXXXXXXXXXXXXXXGOOOOOXXXXXXXXXXXXXXGOOOAAXXXXXXXXXXXXXXGOXXXXXXXXXXXXXXXXXXGOOOOOOXXXXXXXXXXXXXGXXXXXXXXXXXXXXXXXXXGOOOXXXXXXXXXXXXXXXXGOXXXXXXXXXXXXXXXXXXGOOOXXXXXXXXXXXXXXXXGOOOOOXXXXXXXXXXXXXXGOOXXXXXXXXXXXXXXXXXGOOOOOOXXXXXXXXXXXXXGOOOOOXXXXXXXXXXXXXX,0,300,0
13482,58,1,57,25,217,0,0,219,168,51,GOOOXXXXXXXXXXXXXXXXGOOOOOXXXXXXXXXXXXXXGOOOAOXXXXXXXXXXXXXXGOXXXXXXXXXXXXXXXXXXGOOOOOOXXXXXXXXXXXXXGXXXXXXXXXXXXXXXXXXXGOOOXXXXXXXXXXXXXXXXGOXXXXXXXXXXXXXXXXXXGOOOXXXXXXXXXXXXXXXXGOOOOOXXXXXXXXXXXXXXGOOXXXXXXXXXXXXXXXXXGOOOOOOXXXXXXXXXXXXXGOOOOOXXXXXXXXXXXXXX,0,300,0
13503,58,1,57,21,221,0,0,222,170,52,GOOOXXXXXXXXXXXXXXXXGOOOOOXXXXXXXXXXXXXXGOOOAOXXXXXXXXXXXXXXGOXXXXXXXXXXXXXXXXXXGOOOOOOXXXXXXXXXXXXXGXXXXXXXXXXXXXXXXXXXGOOOXXXXXXXXXXXXXXXXGOXXXXXXXXXXXXXXXXXXGOOOXXXXXXXXXXXXXXXXGOOOOOXXXXXXXXXXXXXXGOOXXXXXXXXXXXXXXXXXGOOOOOOXXXXXXXXXXXXXGOOOOOXXXXXXXXXXXXXX,0,300,0
13524,58,1,57,23,219,0,0,221,167,54,GOOOXXXXXXXXXXXXXXXXGOOOOOXXXXXXXXXXXXXXGOOOAOXXXXXXXXXXXXXXGOXXXXXXXXXXXXXXXXXXGOOOOOOXXXXXXXXXXXXXGXXXXXXXXXXXXXXXXXXXGOOOXXXXXXXXXXXXXXXXGOXXXXXXXXXXXXXXXXXXGOOOXXXXXXXXXXXXXXXXGOOOOOXXXXXXXXXXXXXXGOOXXXXXXXXXXXXXXXXXGOOOOOOXXXXXXXXXXXXXGOOOOOXXXXXXXXXXXXXX,0,300,0

13545,58,1,57,24,218,0,0,220,169,51,GOOOXXXXXXXXXXXXXXXXGOOOOOXXXXXXXXXXXXXXGOOOAOXXXXXXXXXXXXXXGOXXXXXXXXXXXXXXXXXXGOOOOOOXXXXXXXXXXXXXGXXXXXXXXXXXXXXXXXXXGOOOXXXXXXXXXXXXXXXXGOXXXXXXXXXXXXXXXXXXGOOOXXXXXXXXXXXXXXXXGOOOOOXXXXXXXXXXXXXXGOOXXXXXXXXXXXXXXXXXGOOOOOOXXXXXXXXXXXXXGOOOOOXXXXXXXXXXXXXX,0,300,0
13566,58,1,57,23,219,0,0,221,169,52,GOOOXXXXXXXXXXXXXXXXGOOOOOXXXXXXXXXXXXXXGOOOAOXXXXXXXXXXXXXXGOXXXXXXXXXXXXXXXXXXGOOOOOOXXXXXXXXXXXXXGXXXXXXXXXXXXXXXXXXXGOOOXXXXXXXXXXXXXXXXGOXXXXXXXXXXXXXXXXXXGOOOXXXXXXXXXXXXXXXXGOOOOOXXXXXXXXXXXXXXGOOXXXXXXXXXXXXXXXXXGOOOOOOXXXXXXXXXXXXXGOOOOOXXXXXXXXXXXXXX,0,300,0
13587,58,1,57,22,220,0,0,222,170,52,GOOOXXXXXXXXXXXXXXXXGOOOOOXXXXXXXXXXXXXXGOOOAOXXXXXXXXXXXXXXGOXXXXXXXXXXXXXXXXXXGOOOOOOXXXXXXXXXXXXXGXXXXXXXXXXXXXXXXXXXGOOOXXXXXXXXXXXXXXXXGOXXXXXXXXXXXXXXXXXXGOOOXXXXXXXXXXXXXXXXGOOOOOXXXXXXXXXXXXXXGOOXXXXXXXXXXXXXXXXXGOOOOOOXXXXXXXXXXXXXGOOOOOXXXXXXXXXXXXXX,0,300,0
13608,58,1,57,20,222,0,0,224,171,53,GOOOXXXXXXXXXXXXXXXXGOOOOOXXXXXXXXXXXXXXGOOOAOXXXXXXXXXXXXXXGOXXXXXXXXXXXXXXXXXXGOOOOOOXXXXXXXXXXXXXGXXXXXXXXXXXXXXXXXXXGOOOXXXXXXXXXXXXXXXXGOXXXXXXXXXXXXXXXXXXGOOOXXXXXXXXXXXXXXXXGOOOOOXXXXXXXXXXXXXXGOOXXXXXXXXXXXXXXXXXGOOOOOOXXXXXXXXXXXXXGOOOOOXXXXXXXXXXXXXX,0,300,0
13629,58,1,57,21,221,0,0,223,169,54,GOOOXXXXXXXXXXXXXXXXGOOOOOXXXXXXXXXXXXXXGOOOAOXXXXXXXXXXXXXXGOXXXXXXXXXXXXXXXXXXGOOOOOOXXXXXXXXXXXXXGXXXXXXXXXXXXXXXXXXXGOOOXXXXXXXXXXXXXXXXGOXXXXXXXXXXXXXXXXXXGOOOXXXXXXXXXXXXXXXXGOOOOOXXXXXXXXXXXXXXGOOXXXXXXXXXXXXXXXXXGOOOOOOXXXXXXXXXXXXXGOOOOOXXXXXXXXXXXXXX,0,300,0

13650,58,1,57,20,222,0,0,224,170,54,GOOOXXXXXXXXXXXXXXXXGOOOOOXXXXXXXXXXXXXXGOOOAOXXXXXXXXXXXXXXGOXXXXXXXXXXXXXXXXXXGOOOOOOXXXXXXXXXXXXXGXXXXXXXXXXXXXXXXXXXGOOOXXXXXXXXXXXXXXXXGOXXXXXXXXXXXXXXXXXXGOOOXXXXXXXXXXXXXXXXGOOOOOXXXXXXXXXXXXXXGOOXXXXXXXXXXXXXXXXXGOOOOOOXXXXXXXXXXXXXGOOOOOXXXXXXXXXXXXXX,0,300,0
13671,58,1,57,19,223,0,0,222,169,53,GOOOXXXXXXXXXXXXXXXXGOOOOOXXXXXXXXXXXXXXGOOOAOXXXXXXXXXXXXXXGOXXXXXXXXXXXXXXXXXXGOOOOOOXXXXXXXXXXXXXGXXXXXXXXXXXXXXXXXXXGOOOXXXXXXXXXXXXXXXXGOXXXXXXXXXXXXXXXXXXGOOOXXXXXXXXXXXXXXXXGOOOOOXXXXXXXXXXXXXXGOOXXXXXXXXXXXXXXXXXGOOOOOOXXXXXXXXXXXXXGOOOOOXXXXXXXXXXXXXX,0,300,0
13692,58,0,58,17,225,0,0,227,172,55,GOOOXXXXXXXXXXXXXXXXGOOOOOXXXXXXXXXXXXXXGOOOOOXXXXXXXXXXXXXXGOXXXXXXXXXXXXXXXXXXGOOOOOOXXXXXXXXXXXXXGXXXXXXXXXXXXXXXXXXXGOOOXXXXXXXXXXXXXXXXGOXXXXXXXXXXXXXXXXXXGOOOXXXXXXXXXXXXXXXXGOOOOOXXXXXXXXXXXXXXGOOXXXXXXXXXXXXXXXXXGOOOOOOXXXXXXXXXXXXXGOOOOOXXXXXXXXXXXXXX,0,300,0
13713,58,0,58,19,223,0,0,225,172,53,GOOOXXXXXXXXXXXXXXXXGOOOOOXXXXXXXXXXXXXXGOOOOOXXXXXXXXXXXXXXGOXXXXXXXXXXXXXXXXXXGOOOOOOXXXXXXXXXXXXXGXXXXXXXXXXXXXXXXXXXGOOOXXXXXXXXXXXXXXXXGOXXXXXXXXXXXXXXXXXXGOOOXXXXXXXXXXXXXXXXGOOOOOXXXXXXXXXXXXXXGOOXXXXXXXXXXXXXXXXXGOOOOOOXXXXXXXXXXXXXGOOOOOXXXXXXXXXXXXXX,0,300,0
13734,58,0,58,20,222,0,0,224,171,53,GOOOXXXXXXXXXXXXXXXXGOOOOOXXXXXXXXXXXXXXGOOOOOXXXXXXXXXXXXXXGOXXXXXXXXXXXXXXXXXXGOOOOOOXXXXXXXXXXXXXGXXXXXXXXXXXXXXXXXXXGOOOXXXXXXXXXXXXXXXXGOXXXXXXXXXXXXXXXXXXGOOOXXXXXXXXXXXXXXXXGOOOOOXXXXXXXXXXXXXXGOOXXXXXXXXXXXXXXXXXGOOOOOOXXXXXXXXXXXXXGOOOOOXXXXXXXXXXXXXX,0,300,0

13755,58,0,58,21,221,0,0,223,171,52,GOOOXXXXXXXXXXXXXXXXGOOOOOXXXXXXXXXXXXXXGOOOOOXXXXXXXXXXXXXXGOXXXXXXXXXXXXXXXXXXGOOOOOOXXXXXXXXXXXXXGXXXXXXXXXXXXXXXXXXXGOOOXXXXXXXXXXXXXXXXGOXXXXXXXXXXXXXXXXXXGOOOXXXXXXXXXXXXXXXXGOOOOOXXXXXXXXXXXXXXGOOXXXXXXXXXXXXXXXXXGOOOOOOXXXXXXXXXXXXXGOOOOOXXXXXXXXXXXXXX,0,300,0
13776,58,0,58,22,220,0,0,222,171,51,GOOOXXXXXXXXXXXXXXXXGOOOOOXXXXXXXXXXXXXXGOOOOOXXXXXXXXXXXXXXGOXXXXXXXXXXXXXXXXXXGOOOOOOXXXXXXXXXXXXXGXXXXXXXXXXXXXXXXXXXGOOOXXXXXXXXXXXXXXXXGOXXXXXXXXXXXXXXXXXXGOOOXXXXXXXXXXXXXXXXGOOOOOXXXXXXXXXXXXXXGOOXXXXXXXXXXXXXXXXXGOOOOOOXXXXXXXXXXXXXGOOOOOXXXXXXXXXXXXXX,0,300,0
13797,58,0,58,23,219,0,0,221,171,50,GOOOXXXXXXXXXXXXXXXXGOOOOOXXXXXXXXXXXXXXGOOOOOXXXXXXXXXXXXXXGOXXXXXXXXXXXXXXXXXXGOOOOOOXXXXXXXXXXXXXGXXXXXXXXXXXXXXXXXXXGOOOXXXXXXXXXXXXXXXXGOXXXXXXXXXXXXXXXXXXGOOOXXXXXXXXXXXXXXXXGOOOOOXXXXXXXXXXXXXXGOOXXXXXXXXXXXXXXXXXGOOOOOOXXXXXXXXXXXXXGOOOOOXXXXXXXXXXXXXX,0,300,0
13818,58,0,58,26,216,0,0,218,170,48,GOOOXXXXXXXXXXXXXXXXGOOOOOXXXXXXXXXXXXXXGOOOOOXXXXXXXXXXXXXXGOXXXXXXXXXXXXXXXXXXGOOOOOOXXXXXXXXXXXXXGXXXXXXXXXXXXXXXXXXXGOOOXXXXXXXXXXXXXXXXGOXXXXXXXXXXXXXXXXXXGOOOXXXXXXXXXXXXXXXXGOOOOOXXXXXXXXXXXXXXGOOXXXXXXXXXXXXXXXXXGOOOOOOXXXXXXXXXXXXXGOOOOOXXXXXXXXXXXXXX,0,300,0
13839,58,0,58,24,218,0,0,220,173,47,GOOOXXXXXXXXXXXXXXXXGOOOOOXXXXXXXXXXXXXXGOOOOOXXXXXXXXXXXXXXGOXXXXXXXXXXXXXXXXXXGOOOOOOXXXXXXXXXXXXXGXXXXXXXXXXXXXXXXXXXGOOOXXXXXXXXXXXXXXXXGOXXXXXXXXXXXXXXXXXXGOOOXXXXXXXXXXXXXXXXGOOOOOXXXXXXXXXXXXXXGOOXXXXXXXXXXXXXXXXXGOOOOOOXXXXXXXXXXXXXGOOOOOXXXXXXXXXXXXXX,0,300,0

13860,58,0,58,27,215,0,0,217,173,44,GOOOXXXXXXXXXXXXXXXXGOOOOOXXXXXXXXXXXXXXGOOOOOXXXXXXXXXXXXXXGOXXXXXXXXXXXXXXXXXXGOOOOOOXXXXXXXXXXXXXGXXXXXXXXXXXXXXXXXXXGOOOXXXXXXXXXXXXXXXXGOXXXXXXXXXXXXXXXXXXGOOOXXXXXXXXXXXXXXXXGOOOOOXXXXXXXXXXXXXXGOOXXXXXXXXXXXXXXXXXGOOOOOOXXXXXXXXXXXXXGOOOOOXXXXXXXXXXXXXX,0,300,0
13881,58,0,58,29,213,0,0,214,176,38,GOOOXXXXXXXXXXXXXXXXGOOOOOXXXXXXXXXXXXXXGOOOOOXXXXXXXXXXXXXXGOXXXXXXXXXXXXXXXXXXGOOOOOOXXXXXXXXXXXXXGXXXXXXXXXXXXXXXXXXXGOOOXXXXXXXXXXXXXXXXGOXXXXXXXXXXXXXXXXXXGOOOXXXXXXXXXXXXXXXXGOOOOOXXXXXXXXXXXXXXGOOXXXXXXXXXXXXXXXXXGOOOOOOXXXXXXXXXXXXXGOOOOOXXXXXXXXXXXXXX,0,300,0
13902,58,0,58,34,208,0,0,209,171,38,GOOOXXXXXXXXXXXXXXXXGOOOOOXXXXXXXXXXXXXXGOOOOOXXXXXXXXXXXXXXGOXXXXXXXXXXXXXXXXXXGOOOOOOXXXXXXXXXXXXXGXXXXXXXXXXXXXXXXXXXGOOOXXXXXXXXXXXXXXXXGOXXXXXXXXXXXXXXXXXXGOOOXXXXXXXXXXXXXXXXGOOOOOXXXXXXXXXXXXXXGOOXXXXXXXXXXXXXXXXXGOOOOOOXXXXXXXXXXXXXGOOOOOXXXXXXXXXXXXXX,0,300,0
13923,58,0,58,35,207,0,0,209,171,38,GOOOXXXXXXXXXXXXXXXXGOOOOOXXXXXXXXXXXXXXGOOOOOXXXXXXXXXXXXXXGOXXXXXXXXXXXXXXXXXXGOOOOOOXXXXXXXXXXXXXGXXXXXXXXXXXXXXXXXXXGOOOXXXXXXXXXXXXXXXXGOXXXXXXXXXXXXXXXXXXGOOOXXXXXXXXXXXXXXXXGOOOOOXXXXXXXXXXXXXXGOOXXXXXXXXXXXXXXXXXGOOOOOOXXXXXXXXXXXXXGOOOOOXXXXXXXXXXXXXX,0,300,0
13944,58,0,58,36,206,0,0,208,173,35,GOOOXXXXXXXXXXXXXXXXGOOOOOXXXXXXXXXXXXXXGOOOOOXXXXXXXXXXXXXXGOXXXXXXXXXXXXXXXXXXGOOOOOOXXXXXXXXXXXXXGXXXXXXXXXXXXXXXXXXXGOOOXXXXXXXXXXXXXXXXGOXXXXXXXXXXXXXXXXXXGOOOXXXXXXXXXXXXXXXXGOOOOOXXXXXXXXXXXXXXGOOXXXXXXXXXXXXXXXXXGOOOOOOXXXXXXXXXXXXXGOOOOOXXXXXXXXXXXXXX,0,300,0

13965,58,0,58,36,206,0,0,208,173,35,GOOOXXXXXXXXXXXXXXXXGOOOOOXXXXXXXXXXXXXXGOOOOOXXXXXXXXXXXXXXGOXXXXXXXXXXXXXXXXXXGOOOOOOXXXXXXXXXXXXXGXXXXXXXXXXXXXXXXXXXGOOOXXXXXXXXXXXXXXXXGOXXXXXXXXXXXXXXXXXXGOOOXXXXXXXXXXXXXXXXGOOOOOXXXXXXXXXXXXXXGOOXXXXXXXXXXXXXXXXXGOOOOOOXXXXXXXXXXXXXGOOOOOXXXXXXXXXXXXXX,0,300,0
13986,58,0,58,39,203,0,0,205,170,35,GOOOXXXXXXXXXXXXXXXXGOOOOOXXXXXXXXXXXXXXGOOOOOXXXXXXXXXXXXXXGOXXXXXXXXXXXXXXXXXXGOOOOOOXXXXXXXXXXXXXGXXXXXXXXXXXXXXXXXXXGOOOXXXXXXXXXXXXXXXXGOXXXXXXXXXXXXXXXXXXGOOOXXXXXXXXXXXXXXXXGOOOOOXXXXXXXXXXXXXXGOOXXXXXXXXXXXXXXXXXGOOOOOOXXXXXXXXXXXXXGOOOOOXXXXXXXXXXXXXX,0,300,0
14007,58,0,58,40,202,0,0,204,170,34,GOOOXXXXXXXXXXXXXXXXGOOOOOXXXXXXXXXXXXXXGOOOOOXXXXXXXXXXXXXXGOXXXXXXXXXXXXXXXXXXGOOOOOOXXXXXXXXXXXXXGXXXXXXXXXXXXXXXXXXXGOOOXXXXXXXXXXXXXXXXGOXXXXXXXXXXXXXXXXXXGOOOXXXXXXXXXXXXXXXXGOOOOOXXXXXXXXXXXXXXGOOXXXXXXXXXXXXXXXXXGOOOOOOXXXXXXXXXXXXXGOOOOOXXXXXXXXXXXXXX,0,300,0
14028,58,0,58,40,202,0,0,204,174,30,GOOOXXXXXXXXXXXXXXXXGOOOOOXXXXXXXXXXXXXXGOOOOOXXXXXXXXXXXXXXGOXXXXXXXXXXXXXXXXXXGOOOOOOXXXXXXXXXXXXXGXXXXXXXXXXXXXXXXXXXGOOOXXXXXXXXXXXXXXXXGOXXXXXXXXXXXXXXXXXXGOOOXXXXXXXXXXXXXXXXGOOOOOXXXXXXXXXXXXXXGOOXXXXXXXXXXXXXXXXXGOOOOOOXXXXXXXXXXXXXGOOOOOXXXXXXXXXXXXXX,0,300,0
14049,58,0,58,38,204,0,0,206,172,34,GOOOXXXXXXXXXXXXXXXXGOOOOOXXXXXXXXXXXXXXGOOOOOXXXXXXXXXXXXXXGOXXXXXXXXXXXXXXXXXXGOOOOOOXXXXXXXXXXXXXGXXXXXXXXXXXXXXXXXXXGOOOXXXXXXXXXXXXXXXXGOXXXXXXXXXXXXXXXXXXGOOOXXXXXXXXXXXXXXXXGOOOOOXXXXXXXXXXXXXXGOOXXXXXXXXXXXXXXXXXGOOOOOOXXXXXXXXXXXXXGOOOOOXXXXXXXXXXXXXX,0,300,0

14070,58,0,58,36,206,0,0,208,170,38,GOOOXXXXXXXXXXXXXXXXGOOOOOXXXXXXXXXXXXXXGOOOOOXXXXXXXXXXXXXXGOXXXXXXXXXXXXXXXXXXGOOOOOOXXXXXXXXXXXXXGXXXXXXXXXXXXXXXXXXXGOOOXXXXXXXXXXXXXXXXGOXXXXXXXXXXXXXXXXXXGOOOXXXXXXXXXXXXXXXXGOOOOOXXXXXXXXXXXXXXGOOXXXXXXXXXXXXXXXXXGOOOOOOXXXXXXXXXXXXXGOOOOOXXXXXXXXXXXXXX,0,300,0
14091,58,0,58,35,207,0,0,209,170,39,GOOOXXXXXXXXXXXXXXXXGOOOOOXXXXXXXXXXXXXXGOOOOOXXXXXXXXXXXXXXGOXXXXXXXXXXXXXXXXXXGOOOOOOXXXXXXXXXXXXXGXXXXXXXXXXXXXXXXXXXGOOOXXXXXXXXXXXXXXXXGOXXXXXXXXXXXXXXXXXXGOOOXXXXXXXXXXXXXXXXGOOOOOXXXXXXXXXXXXXXGOOXXXXXXXXXXXXXXXXXGOOOOOOXXXXXXXXXXXXXGOOOOOXXXXXXXXXXXXXX,0,300,0
14112,58,0,58,31,211,0,0,213,169,44,GOOOXXXXXXXXXXXXXXXXGOOOOOXXXXXXXXXXXXXXGOOOOOXXXXXXXXXXXXXXGOXXXXXXXXXXXXXXXXXXGOOOOOOXXXXXXXXXXXXXGXXXXXXXXXXXXXXXXXXXGOOOXXXXXXXXXXXXXXXXGOXXXXXXXXXXXXXXXXXXGOOOXXXXXXXXXXXXXXXXGOOOOOXXXXXXXXXXXXXXGOOXXXXXXXXXXXXXXXXXGOOOOOOXXXXXXXXXXXXXGOOOOOXXXXXXXXXXXXXX,0,300,0
14133,58,0,58,31,211,0,0,213,172,41,GOOOXXXXXXXXXXXXXXXXGOOOOOXXXXXXXXXXXXXXGOOOOOXXXXXXXXXXXXXXGOXXXXXXXXXXXXXXXXXXGOOOOOOXXXXXXXXXXXXXGXXXXXXXXXXXXXXXXXXXGOOOXXXXXXXXXXXXXXXXGOXXXXXXXXXXXXXXXXXXGOOOXXXXXXXXXXXXXXXXGOOOOOXXXXXXXXXXXXXXGOOXXXXXXXXXXXXXXXXXGOOOOOOXXXXXXXXXXXXXGOOOOOXXXXXXXXXXXXXX,0,300,0
14154,58,0,58,29,213,0,0,215,170,45,GOOOXXXXXXXXXXXXXXXXGOOOOOXXXXXXXXXXXXXXGOOOOOXXXXXXXXXXXXXXGOXXXXXXXXXXXXXXXXXXGOOOOOOXXXXXXXXXXXXXGXXXXXXXXXXXXXXXXXXXGOOOXXXXXXXXXXXXXXXXGOXXXXXXXXXXXXXXXXXXGOOOXXXXXXXXXXXXXXXXGOOOOOXXXXXXXXXXXXXXGOOXXXXXXXXXXXXXXXXXGOOOOOOXXXXXXXXXXXXXGOOOOOXXXXXXXXXXXXXX,0,300,0

14175,58,0,58,27,215,0,0,217,170,47,GOOOXXXXXXXXXXXXXXXXGOOOOOXXXXXXXXXXXXXXGOOOOOXXXXXXXXXXXXXXGOXXXXXXXXXXXXXXXXXXGOOOOOOXXXXXXXXXXXXXGXXXXXXXXXXXXXXXXXXXGOOOXXXXXXXXXXXXXXXXGOXXXXXXXXXXXXXXXXXXGOOOXXXXXXXXXXXXXXXXGOOOOOXXXXXXXXXXXXXXGOOXXXXXXXXXXXXXXXXXGOOOOOOXXXXXXXXXXXXXGOOOOOXXXXXXXXXXXXXX,0,300,0
14196,58,0,58,26,216,0,0,218,172,46,GOOOXXXXXXXXXXXXXXXXGOOOOOXXXXXXXXXXXXXXGOOOOOXXXXXXXXXXXXXXGOXXXXXXXXXXXXXXXXXXGOOOOOOXXXXXXXXXXXXXGXXXXXXXXXXXXXXXXXXXGOOOXXXXXXXXXXXXXXXXGOXXXXXXXXXXXXXXXXXXGOOOXXXXXXXXXXXXXXXXGOOOOOXXXXXXXXXXXXXXGOOXXXXXXXXXXXXXXXXXGOOOOOOXXXXXXXXXXXXXGOOOOOXXXXXXXXXXXXXX,0,300,0
14217,58,0,58,27,215,0,0,216,170,46,GOOOXXXXXXXXXXXXXXXXGOOOOOXXXXXXXXXXXXXXGOOOOOXXXXXXXXXXXXXXGOXXXXXXXXXXXXXXXXXXGOOOOOOXXXXXXXXXXXXXGXXXXXXXXXXXXXXXXXXXGOOOXXXXXXXXXXXXXXXXGOXXXXXXXXXXXXXXXXXXGOOOXXXXXXXXXXXXXXXXGOOOOOXXXXXXXXXXXXXXGOOXXXXXXXXXXXXXXXXXGOOOOOOXXXXXXXXXXXXXGOOOOOXXXXXXXXXXXXXX,0,300,0
14238,58,0,58,25,217,0,0,219,169,50,GOOOXXXXXXXXXXXXXXXXGOOOOOXXXXXXXXXXXXXXGOOOOOXXXXXXXXXXXXXXGOXXXXXXXXXXXXXXXXXXGOOOOOOXXXXXXXXXXXXXGXXXXXXXXXXXXXXXXXXXGOOOXXXXXXXXXXXXXXXXGOXXXXXXXXXXXXXXXXXXGOOOXXXXXXXXXXXXXXXXGOOOOOXXXXXXXXXXXXXXGOOXXXXXXXXXXXXXXXXXGOOOOOOXXXXXXXXXXXXXGOOOOOXXXXXXXXXXXXXX,0,300,0
14259,58,0,58,25,217,0,0,219,169,50,GOOOXXXXXXXXXXXXXXXXGOOOOOXXXXXXXXXXXXXXGOOOOOXXXXXXXXXXXXXXGOXXXXXXXXXXXXXXXXXXGOOOOOOXXXXXXXXXXXXXGXXXXXXXXXXXXXXXXXXXGOOOXXXXXXXXXXXXXXXXGOXXXXXXXXXXXXXXXXXXGOOOXXXXXXXXXXXXXXXXGOOOOOXXXXXXXXXXXXXXGOOXXXXXXXXXXXXXXXXXGOOOOOOXXXXXXXXXXXXXGOOOOOXXXXXXXXXXXXXX,0,300,0

14280,59,1,58,20,221,0,0,223,172,51,GOOOXXXXXXXXXXXXXXXXGOOOOOXXXXXXXXXXXXXXGOOOOOXXXXXXXXXXXXXXGOXXXXXXXXXXXXXXXXXXGOOOOOOAXXXXXXXXXXXXGXXXXXXXXXXXXXXXXXXXGOOOXXXXXXXXXXXXXXXXGOXXXXXXXXXXXXXXXXXXGOOOXXXXXXXXXXXXXXXXGOOOOOXXXXXXXXXXXXXXGOOXXXXXXXXXXXXXXXXXGOOOOOOXXXXXXXXXXXXXGOOOOOXXXXXXXXXXXXXX,0,300,0
14301,59,1,58,18,223,0,0,225,172,53,GOOOXXXXXXXXXXXXXXXXGOOOOOXXXXXXXXXXXXXXGOOOOOXXXXXXXXXXXXXXGOXXXXXXXXXXXXXXXXXXGOOOOOOAXXXXXXXXXXXXGXXXXXXXXXXXXXXXXXXXGOOOXXXXXXXXXXXXXXXXGOXXXXXXXXXXXXXXXXXXGOOOXXXXXXXXXXXXXXXXGOOOOOXXXXXXXXXXXXXXGOOXXXXXXXXXXXXXXXXXGOOOOOOXXXXXXXXXXXXXGOOOOOXXXXXXXXXXXXXX,0,300,0
14322,59,1,58,19,222,0,0,223,172,51,GOOOXXXXXXXXXXXXXXXXGOOOOOXXXXXXXXXXXXXXGOOOOOXXXXXXXXXXXXXXGOXXXXXXXXXXXXXXXXXXGOOOOOOAXXXXXXXXXXXXGXXXXXXXXXXXXXXXXXXXGOOOXXXXXXXXXXXXXXXXGOXXXXXXXXXXXXXXXXXXGOOOXXXXXXXXXXXXXXXXGOOOOOXXXXXXXXXXXXXXGOOXXXXXXXXXXXXXXXXXGOOOOOOXXXXXXXXXXXXXGOOOOOXXXXXXXXXXXXXX,0,300,0
14343,59,1,58,23,218,0,0,220,171,49,GOOOXXXXXXXXXXXXXXXXGOOOOOXXXXXXXXXXXXXXGOOOOOXXXXXXXXXXXXXXGOXXXXXXXXXXXXXXXXXXGOOOOOOAXXXXXXXXXXXXGXXXXXXXXXXXXXXXXXXXGOOOXXXXXXXXXXXXXXXXGOXXXXXXXXXXXXXXXXXXGOOOXXXXXXXXXXXXXXXXGOOOOOXXXXXXXXXXXXXXGOOXXXXXXXXXXXXXXXXXGOOOOOOXXXXXXXXXXXXXGOOOOOXXXXXXXXXXXXXX,0,300,0
14364,59,1,58,23,218,0,0,219,171,48,GOOOXXXXXXXXXXXXXXXXGOOOOOXXXXXXXXXXXXXXGOOOOOXXXXXXXXXXXXXXGOXXXXXXXXXXXXXXXXXXGOOOOOOAXXXXXXXXXXXXGXXXXXXXXXXXXXXXXXXXGOOOXXXXXXXXXXXXXXXXGOXXXXXXXXXXXXXXXXXXGOOOXXXXXXXXXXXXXXXXGOOOOOXXXXXXXXXXXXXXGOOXXXXXXXXXXXXXXXXXGOOOOOOXXXXXXXXXXXXXGOOOOOXXXXXXXXXXXXXX,0,300,0

14385,59,0,59,24,217,0,0,219,171,48,GOOOXXXXXXXXXXXXXXXXGOOOOOXXXXXXXXXXXXXXGOOOOOXXXXXXXXXXXXXXGOXXXXXXXXXXXXXXXXXXGOOOOOOOXXXXXXXXXXXXGXXXXXXXXXXXXXXXXXXXGOOOXXXXXXXXXXXXXXXXGOXXXXXXXXXXXXXXXXXXGOOOXXXXXXXXXXXXXXXXGOOOOOXXXXXXXXXXXXXXGOOXXXXXXXXXXXXXXXXXGOOOOOOXXXXXXXXXXXXXGOOOOOXXXXXXXXXXXXXX,0,300,0
14406,59,0,59,25,216,0,0,218,172,46,GOOOXXXXXXXXXXXXXXXXGOOOOOXXXXXXXXXXXXXXGOOOOOXXXXXXXXXXXXXXGOXXXXXXXXXXXXXXXXXXGOOOOOOOXXXXXXXXXXXXGXXXXXXXXXXXXXXXXXXXGOOOXXXXXXXXXXXXXXXXGOXXXXXXXXXXXXXXXXXXGOOOXXXXXXXXXXXXXXXXGOOOOOXXXXXXXXXXXXXXGOOXXXXXXXXXXXXXXXXXGOOOOOOXXXXXXXXXXXXXGOOOOOXXXXXXXXXXXXXX,0,300,0
14427,59,0,59,25,216,0,0,218,173,45,GOOOXXXXXXXXXXXXXXXXGOOOOOXXXXXXXXXXXXXXGOOOOOXXXXXXXXXXXXXXGOXXXXXXXXXXXXXXXXXXGOOOOOOOXXXXXXXXXXXXGXXXXXXXXXXXXXXXXXXXGOOOXXXXXXXXXXXXXXXXGOXXXXXXXXXXXXXXXXXXGOOOXXXXXXXXXXXXXXXXGOOOOOXXXXXXXXXXXXXXGOOXXXXXXXXXXXXXXXXXGOOOOOOXXXXXXXXXXXXXGOOOOOXXXXXXXXXXXXXX,0,300,0
14448,59,0,59,28,213,0,0,214,173,41,GOOOXXXXXXXXXXXXXXXXGOOOOOXXXXXXXXXXXXXXGOOOOOXXXXXXXXXXXXXXGOXXXXXXXXXXXXXXXXXXGOOOOOOOXXXXXXXXXXXXGXXXXXXXXXXXXXXXXXXXGOOOXXXXXXXXXXXXXXXXGOXXXXXXXXXXXXXXXXXXGOOOXXXXXXXXXXXXXXXXGOOOOOXXXXXXXXXXXXXXGOOXXXXXXXXXXXXXXXXXGOOOOOOXXXXXXXXXXXXXGOOOOOXXXXXXXXXXXXXX,0,300,0
14469,59,0,59,26,215,0,0,216,171,45,GOOOXXXXXXXXXXXXXXXXGOOOOOXXXXXXXXXXXXXXGOOOOOXXXXXXXXXXXXXXGOXXXXXXXXXXXXXXXXXXGOOOOOOOXXXXXXXXXXXXGXXXXXXXXXXXXXXXXXXXGOOOXXXXXXXXXXXXXXXXGOXXXXXXXXXXXXXXXXXXGOOOXXXXXXXXXXXXXXXXGOOOOOXXXXXXXXXXXXXXGOOXXXXXXXXXXXXXXXXXGOOOOOOXXXXXXXXXXXXXGOOOOOXXXXXXXXXXXXXX,0,300,0

14490,59,0,59,28,213,0,0,215,171,44,GOOOXXXXXXXXXXXXXXXXGOOOOOXXXXXXXXXXXXXXGOOOOOXXXXXXXXXXXXXXGOXXXXXXXXXXXXXXXXXXGOOOOOOOXXXXXXXXXXXXGXXXXXXXXXXXXXXXXXXXGOOOXXXXXXXXXXXXXXXXGOXXXXXXXXXXXXXXXXXXGOOOXXXXXXXXXXXXXXXXGOOOOOXXXXXXXXXXXXXXGOOXXXXXXXXXXXXXXXXXGOOOOOOXXXXXXXXXXXXXGOOOOOXXXXXXXXXXXXXX,0,300,0
14511,59,0,59,27,214,0,0,216,170,46,GOOOXXXXXXXXXXXXXXXXGOOOOOXXXXXXXXXXXXXXGOOOOOXXXXXXXXXXXXXXGOXXXXXXXXXXXXXXXXXXGOOOOOOOXXXXXXXXXXXXGXXXXXXXXXXXXXXXXXXXGOOOXXXXXXXXXXXXXXXXGOXXXXXXXXXXXXXXXXXXGOOOXXXXXXXXXXXXXXXXGOOOOOXXXXXXXXXXXXXXGOOXXXXXXXXXXXXXXXXXGOOOOOOXXXXXXXXXXXXXGOOOOOXXXXXXXXXXXXXX,0,300,0
14532,59,0,59,23,218,0,0,220,173,47,GOOOXXXXXXXXXXXXXXXXGOOOOOXXXXXXXXXXXXXXGOOOOOXXXXXXXXXXXXXXGOXXXXXXXXXXXXXXXXXXGOOOOOOOXXXXXXXXXXXXGXXXXXXXXXXXXXXXXXXXGOOOXXXXXXXXXXXXXXXXGOXXXXXXXXXXXXXXXXXXGOOOXXXXXXXXXXXXXXXXGOOOOOXXXXXXXXXXXXXXGOOXXXXXXXXXXXXXXXXXGOOOOOOXXXXXXXXXXXXXGOOOOOXXXXXXXXXXXXXX,0,300,0
14553,59,0,59,23,218,0,0,219,172,47,GOOOXXXXXXXXXXXXXXXXGOOOOOXXXXXXXXXXXXXXGOOOOOXXXXXXXXXXXXXXGOXXXXXXXXXXXXXXXXXXGOOOOOOOXXXXXXXXXXXXGXXXXXXXXXXXXXXXXXXXGOOOXXXXXXXXXXXXXXXXGOXXXXXXXXXXXXXXXXXXGOOOXXXXXXXXXXXXXXXXGOOOOOXXXXXXXXXXXXXXGOOXXXXXXXXXXXXXXXXXGOOOOOOXXXXXXXXXXXXXGOOOOOXXXXXXXXXXXXXX,0,300,0
14574,59,0,59,20,221,0,0,223,171,52,GOOOXXXXXXXXXXXXXXXXGOOOOOXXXXXXXXXXXXXXGOOOOOXXXXXXXXXXXXXXGOXXXXXXXXXXXXXXXXXXGOOOOOOOXXXXXXXXXXXXGXXXXXXXXXXXXXXXXXXXGOOOXXXXXXXXXXXXXXXXGOXXXXXXXXXXXXXXXXXXGOOOXXXXXXXXXXXXXXXXGOOOOOXXXXXXXXXXXXXXGOOXXXXXXXXXXXXXXXXXGOOOOOOXXXXXXXXXXXXXGOOOOOXXXXXXXXXXXXXX,0,300,0

14595,59,0,59,18,223,0,0,225,171,54,GOOOXXXXXXXXXXXXXXXXGOOOOOXXXXXXXXXXXXXXGOOOOOXXXXXXXXXXXXXXGOXXXXXXXXXXXXXXXXXXGOOOOOOOXXXXXXXXXXXXGXXXXXXXXXXXXXXXXXXXGOOOXXXXXXXXXXXXXXXXGOXXXXXXXXXXXXXXXXXXGOOOXXXXXXXXXXXXXXXXGOOOOOXXXXXXXXXXXXXXGOOXXXXXXXXXXXXXXXXXGOOOOOOXXXXXXXXXXXXXGOOOOOXXXXXXXXXXXXXX,0,300,0
14616,59,0,59,16,225,0,0,226,173,53,GOOOXXXXXXXXXXXXXXXXGOOOOOXXXXXXXXXXXXXXGOOOOOXXXXXXXXXXXXXXGOXXXXXXXXXXXXXXXXXXGOOOOOOOXXXXXXXXXXXXGXXXXXXXXXXXXXXXXXXXGOOOXXXXXXXXXXXXXXXXGOXXXXXXXXXXXXXXXXXXGOOOXXXXXXXXXXXXXXXXGOOOOOXXXXXXXXXXXXXXGOOXXXXXXXXXXXXXXXXXGOOOOOOXXXXXXXXXXXXXGOOOOOXXXXXXXXXXXXXX,0,300,0
14637,59,0,59,18,223,0,0,225,173,52,GOOOXXXXXXXXXXXXXXXXGOOOOOXXXXXXXXXXXXXXGOOOOOXXXXXXXXXXXXXXGOXXXXXXXXXXXXXXXXXXGOOOOOOOXXXXXXXXXXXXGXXXXXXXXXXXXXXXXXXXGOOOXXXXXXXXXXXXXXXXGOXXXXXXXXXXXXXXXXXXGOOOXXXXXXXXXXXXXXXXGOOOOOXXXXXXXXXXXXXXGOOXXXXXXXXXXXXXXXXXGOOOOOOXXXXXXXXXXXXXGOOOOOXXXXXXXXXXXXXX,0,300,0
14658,59,0,59,20,221,0,0,223,174,49,GOOOXXXXXXXXXXXXXXXXGOOOOOXXXXXXXXXXXXXXGOOOOOXXXXXXXXXXXXXXGOXXXXXXXXXXXXXXXXXXGOOOOOOOXXXXXXXXXXXXGXXXXXXXXXXXXXXXXXXXGOOOXXXXXXXXXXXXXXXXGOXXXXXXXXXXXXXXXXXXGOOOXXXXXXXXXXXXXXXXGOOOOOXXXXXXXXXXXXXXGOOXXXXXXXXXXXXXXXXXGOOOOOOXXXXXXXXXXXXXGOOOOOXXXXXXXXXXXXXX,0,300,0
14679,59,0,59,20,221,0,0,223,172,51,GOOOXXXXXXXXXXXXXXXXGOOOOOXXXXXXXXXXXXXXGOOOOOXXXXXXXXXXXXXXGOXXXXXXXXXXXXXXXXXXGOOOOOOOXXXXXXXXXXXXGXXXXXXXXXXXXXXXXXXXGOOOXXXXXXXXXXXXXXXXGOXXXXXXXXXXXXXXXXXXGOOOXXXXXXXXXXXXXXXXGOOOOOXXXXXXXXXXXXXXGOOXXXXXXXXXXXXXXXXXGOOOOOOXXXXXXXXXXXXXGOOOOOXXXXXXXXXXXXXX,0,300,0

14700,59,0,59,19,222,0,0,224,178,46,GOOOXXXXXXXXXXXXXXXXGOOOOOXXXXXXXXXXXXXXGOOOOOXXXXXXXXXXXXXXGOXXXXXXXXXXXXXXXXXXGOOOOOOOXXXXXXXXXXXXGXXXXXXXXXXXXXXXXXXXGOOOXXXXXXXXXXXXXXXXGOXXXXXXXXXXXXXXXXXXGOOOXXXXXXXXXXXXXXXXGOOOOOXXXXXXXXXXXXXXGOOXXXXXXXXXXXXXXXXXGOOOOOOXXXXXXXXXXXXXGOOOOOXXXXXXXXXXXXXX,0,300,0
14721,59,0,59,21,220,0,0,222,174,48,GOOOXXXXXXXXXXXXXXXXGOOOOOXXXXXXXXXXXXXXGOOOOOXXXXXXXXXXXXXXGOXXXXXXXXXXXXXXXXXXGOOOOOOOXXXXXXXXXXXXGXXXXXXXXXXXXXXXXXXXGOOOXXXXXXXXXXXXXXXXGOXXXXXXXXXXXXXXXXXXGOOOXXXXXXXXXXXXXXXXGOOOOOXXXXXXXXXXXXXXGOOXXXXXXXXXXXXXXXXXGOOOOOOXXXXXXXXXXXXXGOOOOOXXXXXXXXXXXXXX,0,300,0
14742,59,0,59,22,219,0,0,220,174,46,GOOOXXXXXXXXXXXXXXXXGOOOOOXXXXXXXXXXXXXXGOOOOOXXXXXXXXXXXXXXGOXXXXXXXXXXXXXXXXXXGOOOOOOOXXXXXXXXXXXXGXXXXXXXXXXXXXXXXXXXGOOOXXXXXXXXXXXXXXXXGOXXXXXXXXXXXXXXXXXXGOOOXXXXXXXXXXXXXXXXGOOOOOXXXXXXXXXXXXXXGOOXXXXXXXXXXXXXXXXXGOOOOOOXXXXXXXXXXXXXGOOOOOXXXXXXXXXXXXXX,0,300,0
14763,59,0,59,23,218,0,0,220,173,47,GOOOXXXXXXXXXXXXXXXXGOOOOOXXXXXXXXXXXXXXGOOOOOXXXXXXXXXXXXXXGOXXXXXXXXXXXXXXXXXXGOOOOOOOXXXXXXXXXXXXGXXXXXXXXXXXXXXXXXXXGOOOXXXXXXXXXXXXXXXXGOXXXXXXXXXXXXXXXXXXGOOOXXXXXXXXXXXXXXXXGOOOOOXXXXXXXXXXXXXXGOOXXXXXXXXXXXXXXXXXGOOOOOOXXXXXXXXXXXXXGOOOOOXXXXXXXXXXXXXX,0,300,0
14784,59,0,59,27,214,0,0,216,171,45,GOOOXXXXXXXXXXXXXXXXGOOOOOXXXXXXXXXXXXXXGOOOOOXXXXXXXXXXXXXXGOXXXXXXXXXXXXXXXXXXGOOOOOOOXXXXXXXXXXXXGXXXXXXXXXXXXXXXXXXXGOOOXXXXXXXXXXXXXXXXGOXXXXXXXXXXXXXXXXXXGOOOXXXXXXXXXXXXXXXXGOOOOOXXXXXXXXXXXXXXGOOXXXXXXXXXXXXXXXXXGOOOOOOXXXXXXXXXXXXXGOOOOOXXXXXXXXXXXXXX,0,300,0

14805,59,0,59,25,216,0,0,218,171,47,GOOOXXXXXXXXXXXXXXXXGOOOOOXXXXXXXXXXXXXXGOOOOOXXXXXXXXXXXXXXGOXXXXXXXXXXXXXXXXXXGOOOOOOOXXXXXXXXXXXXGXXXXXXXXXXXXXXXXXXXGOOOXXXXXXXXXXXXXXXXGOXXXXXXXXXXXXXXXXXXGOOOXXXXXXXXXXXXXXXXGOOOOOXXXXXXXXXXXXXXGOOXXXXXXXXXXXXXXXXXGOOOOOOXXXXXXXXXXXXXGOOOOOXXXXXXXXXXXXXX,0,300,0
14826,59,0,59,25,216,0,0,218,172,46,GOOOXXXXXXXXXXXXXXXXGOOOOOXXXXXXXXXXXXXXGOOOOOXXXXXXXXXXXXXXGOXXXXXXXXXXXXXXXXXXGOOOOOOOXXXXXXXXXXXXGXXXXXXXXXXXXXXXXXXXGOOOXXXXXXXXXXXXXXXXGOXXXXXXXXXXXXXXXXXXGOOOXXXXXXXXXXXXXXXXGOOOOOXXXXXXXXXXXXXXGOOXXXXXXXXXXXXXXXXXGOOOOOOXXXXXXXXXXXXXGOOOOOXXXXXXXXXXXXXX,0,300,0
14847,59,0,59,24,217,0,0,219,175,44,GOOOXXXXXXXXXXXXXXXXGOOOOOXXXXXXXXXXXXXXGOOOOOXXXXXXXXXXXXXXGOXXXXXXXXXXXXXXXXXXGOOOOOOOXXXXXXXXXXXXGXXXXXXXXXXXXXXXXXXXGOOOXXXXXXXXXXXXXXXXGOXXXXXXXXXXXXXXXXXXGOOOXXXXXXXXXXXXXXXXGOOOOOXXXXXXXXXXXXXXGOOXXXXXXXXXXXXXXXXXGOOOOOOXXXXXXXXXXXXXGOOOOOXXXXXXXXXXXXXX,0,300,0
14868,59,0,59,22,219,0,0,220,175,45,GOOOXXXXXXXXXXXXXXXXGOOOOOXXXXXXXXXXXXXXGOOOOOXXXXXXXXXXXXXXGOXXXXXXXXXXXXXXXXXXGOOOOOOOXXXXXXXXXXXXGXXXXXXXXXXXXXXXXXXXGOOOXXXXXXXXXXXXXXXXGOXXXXXXXXXXXXXXXXXXGOOOXXXXXXXXXXXXXXXXGOOOOOXXXXXXXXXXXXXXGOOXXXXXXXXXXXXXXXXXGOOOOOOXXXXXXXXXXXXXGOOOOOXXXXXXXXXXXXXX,0,300,0
14889,59,0,59,21,220,0,0,222,173,49,GOOOXXXXXXXXXXXXXXXXGOOOOOXXXXXXXXXXXXXXGOOOOOXXXXXXXXXXXXXXGOXXXXXXXXXXXXXXXXXXGOOOOOOOXXXXXXXXXXXXGXXXXXXXXXXXXXXXXXXXGOOOXXXXXXXXXXXXXXXXGOXXXXXXXXXXXXXXXXXXGOOOXXXXXXXXXXXXXXXXGOOOOOXXXXXXXXXXXXXXGOOXXXXXXXXXXXXXXXXXGOOOOOOXXXXXXXXXXXXXGOOOOOXXXXXXXXXXXXXX,0,300,0

14910,59,0,59,27,214,0,0,216,173,43,GOOOXXXXXXXXXXXXXXXXGOOOOOXXXXXXXXXXXXXXGOOOOOXXXXXXXXXXXXXXGOXXXXXXXXXXXXXXXXXXGOOOOOOOXXXXXXXXXXXXGXXXXXXXXXXXXXXXXXXXGOOOXXXXXXXXXXXXXXXXGOXXXXXXXXXXXXXXXXXXGOOOXXXXXXXXXXXXXXXXGOOOOOXXXXXXXXXXXXXXGOOXXXXXXXXXXXXXXXXXGOOOOOOXXXXXXXXXXXXXGOOOOOXXXXXXXXXXXXXX,0,300,0
14931,59,0,59,27,214,0,0,216,174,42,GOOOXXXXXXXXXXXXXXXXGOOOOOXXXXXXXXXXXXXXGOOOOOXXXXXXXXXXXXXXGOXXXXXXXXXXXXXXXXXXGOOOOOOOXXXXXXXXXXXXGXXXXXXXXXXXXXXXXXXXGOOOXXXXXXXXXXXXXXXXGOXXXXXXXXXXXXXXXXXXGOOOXXXXXXXXXXXXXXXXGOOOOOXXXXXXXXXXXXXXGOOXXXXXXXXXXXXXXXXXGOOOOOOXXXXXXXXXXXXXGOOOOOXXXXXXXXXXXXXX,0,300,0
14952,60,1,59,25,215,0,0,216,173,43,GOOOXXXXXXXXXXXXXXXXGOOOOOXXXXXXXXXXXXXXGOOOOOXXXXXXXXXXXXXXGOXXXXXXXXXXXXXXXXXXGOOOOOOOXXXXXXXXXXXXGXXXXXXXXXXXXXXXXXXXGOOOXXXXXXXXXXXXXXXXGOXXXXXXXXXXXXXXXXXXGOOOXXXXXXXXXXXXXXXXGOOOOOXXXXXXXXXXXXXXGOOXXXXXXXXXXXXXXXXXGOOOOOOXXXXXXXXXXXXXGOOOOOAXXXXXXXXXXXXX,0,300,0
14973,60,1,59,25,215,0,0,216,175,41,GOOOXXXXXXXXXXXXXXXXGOOOOOXXXXXXXXXXXXXXGOOOOOXXXXXXXXXXXXXXGOXXXXXXXXXXXXXXXXXXGOOOOOOOXXXXXXXXXXXXGXXXXXXXXXXXXXXXXXXXGOOOXXXXXXXXXXXXXXXXGOXXXXXXXXXXXXXXXXXXGOOOXXXXXXXXXXXXXXXXGOOOOOXXXXXXXXXXXXXXGOOXXXXXXXXXXXXXXXXXGOOOOOOXXXXXXXXXXXXXGOOOOOAXXXXXXXXXXXXX,0,300,0
14994,60,1,59,26,214,0,0,216,177,39,GOOOXXXXXXXXXXXXXXXXGOOOOOXXXXXXXXXXXXXXGOOOOOXXXXXXXXXXXXXXGOXXXXXXXXXXXXXXXXXXGOOOOOOOXXXXXXXXXXXXGXXXXXXXXXXXXXXXXXXXGOOOXXXXXXXXXXXXXXXXGOXXXXXXXXXXXXXXXXXXGOOOXXXXXXXXXXXXXXXXGOOOOOXXXXXXXXXXXXXXGOOXXXXXXXXXXXXXXXXXGOOOOOOXXXXXXXXXXXXXGOOOOOAXXXXXXXXXXXXX,0,300,0

15015,60,1,59,26,214,0,0,216,175,41,GOOOXXXXXXXXXXXXXXXXGOOOOOXXXXXXXXXXXXXXGOOOOOXXXXXXXXXXXXXXGOXXXXXXXXXXXXXXXXXXGOOOOOOOXXXXXXXXXXXXGXXXXXXXXXXXXXXXXXXXGOOOXXXXXXXXXXXXXXXXGOXXXXXXXXXXXXXXXXXXGOOOXXXXXXXXXXXXXXXXGOOOOOXXXXXXXXXXXXXXGOOXXXXXXXXXXXXXXXXXGOOOOOOXXXXXXXXXXXXXGOOOOOAXXXXXXXXXXXXX,0,300,0
15036,60,1,59,30,210,0,0,212,173,39,GOOOXXXXXXXXXXXXXXXXGOOOOOXXXXXXXXXXXXXXGOOOOOXXXXXXXXXXXXXXGOXXXXXXXXXXXXXXXXXXGOOOOOOOXXXXXXXXXXXXGXXXXXXXXXXXXXXXXXXXGOOOXXXXXXXXXXXXXXXXGOXXXXXXXXXXXXXXXXXXGOOOXXXXXXXXXXXXXXXXGOOOOOXXXXXXXXXXXXXXGOOXXXXXXXXXXXXXXXXXGOOOOOOXXXXXXXXXXXXXGOOOOOAXXXXXXXXXXXXX,0,300,0
15057,60,1,59,28,212,0,0,214,172,42,GOOOXXXXXXXXXXXXXXXXGOOOOOXXXXXXXXXXXXXXGOOOOOXXXXXXXXXXXXXXGOXXXXXXXXXXXXXXXXXXGOOOOOOOXXXXXXXXXXXXGXXXXXXXXXXXXXXXXXXXGOOOXXXXXXXXXXXXXXXXGOXXXXXXXXXXXXXXXXXXGOOOXXXXXXXXXXXXXXXXGOOOOOXXXXXXXXXXXXXXGOOXXXXXXXXXXXXXXXXXGOOOOOOXXXXXXXXXXXXXGOOOOOAXXXXXXXXXXXXX,0,300,0
15078,60,1,59,26,214,0,0,216,173,43,GOOOXXXXXXXXXXXXXXXXGOOOOOXXXXXXXXXXXXXXGOOOOOXXXXXXXXXXXXXXGOXXXXXXXXXXXXXXXXXXGOOOOOOOXXXXXXXXXXXXGXXXXXXXXXXXXXXXXXXXGOOOXXXXXXXXXXXXXXXXGOXXXXXXXXXXXXXXXXXXGOOOXXXXXXXXXXXXXXXXGOOOOOXXXXXXXXXXXXXXGOOXXXXXXXXXXXXXXXXXGOOOOOOXXXXXXXXXXXXXGOOOOOAXXXXXXXXXXXXX,0,300,0
15099,60,0,60,29,211,0,0,213,173,40,GOOOXXXXXXXXXXXXXXXXGOOOOOXXXXXXXXXXXXXXGOOOOOXXXXXXXXXXXXXXGOXXXXXXXXXXXXXXXXXXGOOOOOOOXXXXXXXXXXXXGXXXXXXXXXXXXXXXXXXXGOOOXXXXXXXXXXXXXXXXGOXXXXXXXXXXXXXXXXXXGOOOXXXXXXXXXXXXXXXXGOOOOOXXXXXXXXXXXXXXGOOXXXXXXXXXXXXXXXXXGOOOOOOXXXXXXXXXXXXXGOOOOOOXXXXXXXXXXXXX,0,300,0

15120,60,0,60,27,213,0,0,215,175,40,GOOOXXXXXXXXXXXXXXXXGOOOOOXXXXXXXXXXXXXXGOOOOOXXXXXXXXXXXXXXGOXXXXXXXXXXXXXXXXXXGOOOOOOOXXXXXXXXXXXXGXXXXXXXXXXXXXXXXXXXGOOOXXXXXXXXXXXXXXXXGOXXXXXXXXXXXXXXXXXXGOOOXXXXXXXXXXXXXXXXGOOOOOXXXXXXXXXXXXXXGOOXXXXXXXXXXXXXXXXXGOOOOOOXXXXXXXXXXXXXGOOOOOOXXXXXXXXXXXXX,0,300,0
15141,60,0,60,27,213,0,0,214,174,40,GOOOXXXXXXXXXXXXXXXXGOOOOOXXXXXXXXXXXXXXGOOOOOXXXXXXXXXXXXXXGOXXXXXXXXXXXXXXXXXXGOOOOOOOXXXXXXXXXXXXGXXXXXXXXXXXXXXXXXXXGOOOXXXXXXXXXXXXXXXXGOXXXXXXXXXXXXXXXXXXGOOOXXXXXXXXXXXXXXXXGOOOOOXXXXXXXXXXXXXXGOOXXXXXXXXXXXXXXXXXGOOOOOOXXXXXXXXXXXXXGOOOOOOXXXXXXXXXXXXX,0,300,0
15162,60,0,60,23,217,0,0,219,175,44,GOOOXXXXXXXXXXXXXXXXGOOOOOXXXXXXXXXXXXXXGOOOOOXXXXXXXXXXXXXXGOXXXXXXXXXXXXXXXXXXGOOOOOOOXXXXXXXXXXXXGXXXXXXXXXXXXXXXXXXXGOOOXXXXXXXXXXXXXXXXGOXXXXXXXXXXXXXXXXXXGOOOXXXXXXXXXXXXXXXXGOOOOOXXXXXXXXXXXXXXGOOXXXXXXXXXXXXXXXXXGOOOOOOXXXXXXXXXXXXXGOOOOOOXXXXXXXXXXXXX,0,300,0
15183,60,0,60,24,216,0,0,218,173,45,GOOOXXXXXXXXXXXXXXXXGOOOOOXXXXXXXXXXXXXXGOOOOOXXXXXXXXXXXXXXGOXXXXXXXXXXXXXXXXXXGOOOOOOOXXXXXXXXXXXXGXXXXXXXXXXXXXXXXXXXGOOOXXXXXXXXXXXXXXXXGOXXXXXXXXXXXXXXXXXXGOOOXXXXXXXXXXXXXXXXGOOOOOXXXXXXXXXXXXXXGOOXXXXXXXXXXXXXXXXXGOOOOOOXXXXXXXXXXXXXGOOOOOOXXXXXXXXXXXXX,0,300,0
15204,60,0,60,24,216,0,0,218,174,44,GOOOXXXXXXXXXXXXXXXXGOOOOOXXXXXXXXXXXXXXGOOOOOXXXXXXXXXXXXXXGOXXXXXXXXXXXXXXXXXXGOOOOOOOXXXXXXXXXXXXGXXXXXXXXXXXXXXXXXXXGOOOXXXXXXXXXXXXXXXXGOXXXXXXXXXXXXXXXXXXGOOOXXXXXXXXXXXXXXXXGOOOOOXXXXXXXXXXXXXXGOOXXXXXXXXXXXXXXXXXGOOOOOOXXXXXXXXXXXXXGOOOOOOXXXXXXXXXXXXX,0,300,0

15225,60,0,60,27,213,0,0,215,174,41,GOOOXXXXXXXXXXXXXXXXGOOOOOXXXXXXXXXXXXXXGOOOOOXXXXXXXXXXXXXXGOXXXXXXXXXXXXXXXXXXGOOOOOOOXXXXXXXXXXXXGXXXXXXXXXXXXXXXXXXXGOOOXXXXXXXXXXXXXXXXGOXXXXXXXXXXXXXXXXXXGOOOXXXXXXXXXXXXXXXXGOOOOOXXXXXXXXXXXXXXGOOXXXXXXXXXXXXXXXXXGOOOOOOXXXXXXXXXXXXXGOOOOOOXXXXXXXXXXXXX,0,300,0
15246,60,0,60,26,214,0,0,216,177,39,GOOOXXXXXXXXXXXXXXXXGOOOOOXXXXXXXXXXXXXXGOOOOOXXXXXXXXXXXXXXGOXXXXXXXXXXXXXXXXXXGOOOOOOOXXXXXXXXXXXXGXXXXXXXXXXXXXXXXXXXGOOOXXXXXXXXXXXXXXXXGOXXXXXXXXXXXXXXXXXXGOOOXXXXXXXXXXXXXXXXGOOOOOXXXXXXXXXXXXXXGOOXXXXXXXXXXXXXXXXXGOOOOOOXXXXXXXXXXXXXGOOOOOOXXXXXXXXXXXXX,0,300,0
15267,60,0,60,28,212,0,0,214,175,39,GOOOXXXXXXXXXXXXXXXXGOOOOOXXXXXXXXXXXXXXGOOOOOXXXXXXXXXXXXXXGOXXXXXXXXXXXXXXXXXXGOOOOOOOXXXXXXXXXXXXGXXXXXXXXXXXXXXXXXXXGOOOXXXXXXXXXXXXXXXXGOXXXXXXXXXXXXXXXXXXGOOOXXXXXXXXXXXXXXXXGOOOOOXXXXXXXXXXXXXXGOOXXXXXXXXXXXXXXXXXGOOOOOOXXXXXXXXXXXXXGOOOOOOXXXXXXXXXXXXX,0,300,0
15288,60,0,60,28,212,0,0,214,176,38,GOOOXXXXXXXXXXXXXXXXGOOOOOXXXXXXXXXXXXXXGOOOOOXXXXXXXXXXXXXXGOXXXXXXXXXXXXXXXXXXGOOOOOOOXXXXXXXXXXXXGXXXXXXXXXXXXXXXXXXXGOOOXXXXXXXXXXXXXXXXGOXXXXXXXXXXXXXXXXXXGOOOXXXXXXXXXXXXXXXXGOOOOOXXXXXXXXXXXXXXGOOXXXXXXXXXXXXXXXXXGOOOOOOXXXXXXXXXXXXXGOOOOOOXXXXXXXXXXXXX,0,300,0
15309,60,0,60,26,214,0,0,216,176,40,GOOOXXXXXXXXXXXXXXXXGOOOOOXXXXXXXXXXXXXXGOOOOOXXXXXXXXXXXXXXGOXXXXXXXXXXXXXXXXXXGOOOOOOOXXXXXXXXXXXXGXXXXXXXXXXXXXXXXXXXGOOOXXXXXXXXXXXXXXXXGOXXXXXXXXXXXXXXXXXXGOOOXXXXXXXXXXXXXXXXGOOOOOXXXXXXXXXXXXXXGOOXXXXXXXXXXXXXXXXXGOOOOOOXXXXXXXXXXXXXGOOOOOOXXXXXXXXXXXXX,0,300,0

15330,60,0,60,25,215,0,0,216,175,41,GOOOXXXXXXXXXXXXXXXXGOOOOOXXXXXXXXXXXXXXGOOOOOXXXXXXXXXXXXXXGOXXXXXXXXXXXXXXXXXXGOOOOOOOXXXXXXXXXXXXGXXXXXXXXXXXXXXXXXXXGOOOXXXXXXXXXXXXXXXXGOXXXXXXXXXXXXXXXXXXGOOOXXXXXXXXXXXXXXXXGOOOOOXXXXXXXXXXXXXXGOOXXXXXXXXXXXXXXXXXGOOOOOOXXXXXXXXXXXXXGOOOOOOXXXXXXXXXXXXX,0,300,0
15351,60,0,60,27,213,0,0,215,176,39,GOOOXXXXXXXXXXXXXXXXGOOOOOXXXXXXXXXXXXXXGOOOOOXXXXXXXXXXXXXXGOXXXXXXXXXXXXXXXXXXGOOOOOOOXXXXXXXXXXXXGXXXXXXXXXXXXXXXXXXXGOOOXXXXXXXXXXXXXXXXGOXXXXXXXXXXXXXXXXXXGOOOXXXXXXXXXXXXXXXXGOOOOOXXXXXXXXXXXXXXGOOXXXXXXXXXXXXXXXXXGOOOOOOXXXXXXXXXXXXXGOOOOOOXXXXXXXXXXXXX,0,300,0
15372,60,0,60,28,212,0,0,214,178,36,GOOOXXXXXXXXXXXXXXXXGOOOOOXXXXXXXXXXXXXXGOOOOOXXXXXXXXXXXXXXGOXXXXXXXXXXXXXXXXXXGOOOOOOOXXXXXXXXXXXXGXXXXXXXXXXXXXXXXXXXGOOOXXXXXXXXXXXXXXXXGOXXXXXXXXXXXXXXXXXXGOOOXXXXXXXXXXXXXXXXGOOOOOXXXXXXXXXXXXXXGOOXXXXXXXXXXXXXXXXXGOOOOOOXXXXXXXXXXXXXGOOOOOOXXXXXXXXXXXXX,0,300,0
15393,60,0,60,28,212,0,0,214,175,39,GOOOXXXXXXXXXXXXXXXXGOOOOOXXXXXXXXXXXXXXGOOOOOXXXXXXXXXXXXXXGOXXXXXXXXXXXXXXXXXXGOOOOOOOXXXXXXXXXXXXGXXXXXXXXXXXXXXXXXXXGOOOXXXXXXXXXXXXXXXXGOXXXXXXXXXXXXXXXXXXGOOOXXXXXXXXXXXXXXXXGOOOOOXXXXXXXXXXXXXXGOOXXXXXXXXXXXXXXXXXGOOOOOOXXXXXXXXXXXXXGOOOOOOXXXXXXXXXXXXX,0,300,0
15414,60,0,60,26,214,0,0,216,175,41,GOOOXXXXXXXXXXXXXXXXGOOOOOXXXXXXXXXXXXXXGOOOOOXXXXXXXXXXXXXXGOXXXXXXXXXXXXXXXXXXGOOOOOOOXXXXXXXXXXXXGXXXXXXXXXXXXXXXXXXXGOOOXXXXXXXXXXXXXXXXGOXXXXXXXXXXXXXXXXXXGOOOXXXXXXXXXXXXXXXXGOOOOOXXXXXXXXXXXXXXGOOXXXXXXXXXXXXXXXXXGOOOOOOXXXXXXXXXXXXXGOOOOOOXXXXXXXXXXXXX,0,300,0

15435,60,0,60,24,216,0,0,217,173,44,GOOOXXXXXXXXXXXXXXXXGOOOOOXXXXXXXXXXXXXXGOOOOOXXXXXXXXXXXXXXGOXXXXXXXXXXXXXXXXXXGOOOOOOOXXXXXXXXXXXXGXXXXXXXXXXXXXXXXXXXGOOOXXXXXXXXXXXXXXXXGOXXXXXXXXXXXXXXXXXXGOOOXXXXXXXXXXXXXXXXGOOOOOXXXXXXXXXXXXXXGOOXXXXXXXXXXXXXXXXXGOOOOOOXXXXXXXXXXXXXGOOOOOOXXXXXXXXXXXXX,0,300,0
15456,60,0,60,24,216,0,0,218,174,44,GOOOXXXXXXXXXXXXXXXXGOOOOOXXXXXXXXXXXXXXGOOOOOXXXXXXXXXXXXXXGOXXXXXXXXXXXXXXXXXXGOOOOOOOXXXXXXXXXXXXGXXXXXXXXXXXXXXXXXXXGOOOXXXXXXXXXXXXXXXXGOXXXXXXXXXXXXXXXXXXGOOOXXXXXXXXXXXXXXXXGOOOOOXXXXXXXXXXXXXXGOOXXXXXXXXXXXXXXXXXGOOOOOOXXXXXXXXXXXXXGOOOOOOXXXXXXXXXXXXX,0,300,0
15477,60,0,60,23,217,0,0,218,174,44,GOOOXXXXXXXXXXXXXXXXGOOOOOXXXXXXXXXXXXXXGOOOOOXXXXXXXXXXXXXXGOXXXXXXXXXXXXXXXXXXGOOOOOOOXXXXXXXXXXXXGXXXXXXXXXXXXXXXXXXXGOOOXXXXXXXXXXXXXXXXGOXXXXXXXXXXXXXXXXXXGOOOXXXXXXXXXXXXXXXXGOOOOOXXXXXXXXXXXXXXGOOXXXXXXXXXXXXXXXXXGOOOOOOXXXXXXXXXXXXXGOOOOOOXXXXXXXXXXXXX,0,300,0
15498,60,0,60,20,220,0,0,221,174,47,GOOOXXXXXXXXXXXXXXXXGOOOOOXXXXXXXXXXXXXXGOOOOOXXXXXXXXXXXXXXGOXXXXXXXXXXXXXXXXXXGOOOOOOOXXXXXXXXXXXXGXXXXXXXXXXXXXXXXXXXGOOOXXXXXXXXXXXXXXXXGOXXXXXXXXXXXXXXXXXXGOOOXXXXXXXXXXXXXXXXGOOOOOXXXXXXXXXXXXXXGOOXXXXXXXXXXXXXXXXXGOOOOOOXXXXXXXXXXXXXGOOOOOOXXXXXXXXXXXXX,0,300,0
15519,60,0,60,22,218,0,0,220,174,46,GOOOXXXXXXXXXXXXXXXXGOOOOOXXXXXXXXXXXXXXGOOOOOXXXXXXXXXXXXXXGOXXXXXXXXXXXXXXXXXXGOOOOOOOXXXXXXXXXXXXGXXXXXXXXXXXXXXXXXXXGOOOXXXXXXXXXXXXXXXXGOXXXXXXXXXXXXXXXXXXGOOOXXXXXXXXXXXXXXXXGOOOOOXXXXXXXXXXXXXXGOOXXXXXXXXXXXXXXXXXGOOOOOOXXXXXXXXXXXXXGOOOOOOXXXXXXXXXXXXX,0,300,0

15540,60,0,60,22,218,0,0,220,173,47,GOOOXXXXXXXXXXXXXXXXGOOOOOXXXXXXXXXXXXXXGOOOOOXXXXXXXXXXXXXXGOXXXXXXXXXXXXXXXXXXGOOOOOOOXXXXXXXXXXXXGXXXXXXXXXXXXXXXXXXXGOOOXXXXXXXXXXXXXXXXGOXXXXXXXXXXXXXXXXXXGOOOXXXXXXXXXXXXXXXXGOOOOOXXXXXXXXXXXXXXGOOXXXXXXXXXXXXXXXXXGOOOOOOXXXXXXXXXXXXXGOOOOOOXXXXXXXXXXXXX,0,300,0
15561,60,0,60,23,217,0,0,219,175,44,GOOOXXXXXXXXXXXXXXXXGOOOOOXXXXXXXXXXXXXXGOOOOOXXXXXXXXXXXXXXGOXXXXXXXXXXXXXXXXXXGOOOOOOOXXXXXXXXXXXXGXXXXXXXXXXXXXXXXXXXGOOOXXXXXXXXXXXXXXXXGOXXXXXXXXXXXXXXXXXXGOOOXXXXXXXXXXXXXXXXGOOOOOXXXXXXXXXXXXXXGOOXXXXXXXXXXXXXXXXXGOOOOOOXXXXXXXXXXXXXGOOOOOOXXXXXXXXXXXXX,0,300,0
15582,60,0,60,23,217,0,0,218,175,43,GOOOXXXXXXXXXXXXXXXXGOOOOOXXXXXXXXXXXXXXGOOOOOXXXXXXXXXXXXXXGOXXXXXXXXXXXXXXXXXXGOOOOOOOXXXXXXXXXXXXGXXXXXXXXXXXXXXXXXXXGOOOXXXXXXXXXXXXXXXXGOXXXXXXXXXXXXXXXXXXGOOOXXXXXXXXXXXXXXXXGOOOOOXXXXXXXXXXXXXXGOOXXXXXXXXXXXXXXXXXGOOOOOOXXXXXXXXXXXXXGOOOOOOXXXXXXXXXXXXX,0,300,0
15603,60,0,60,23,217,0,0,219,175,44,GOOOXXXXXXXXXXXXXXXXGOOOOOXXXXXXXXXXXXXXGOOOOOXXXXXXXXXXXXXXGOXXXXXXXXXXXXXXXXXXGOOOOOOOXXXXXXXXXXXXGXXXXXXXXXXXXXXXXXXXGOOOXXXXXXXXXXXXXXXXGOXXXXXXXXXXXXXXXXXXGOOOXXXXXXXXXXXXXXXXGOOOOOXXXXXXXXXXXXXXGOOXXXXXXXXXXXXXXXXXGOOOOOOXXXXXXXXXXXXXGOOOOOOXXXXXXXXXXXXX,0,300,0
15624,60,0,60,25,215,0,0,217,173,44,GOOOXXXXXXXXXXXXXXXXGOOOOOXXXXXXXXXXXXXXGOOOOOXXXXXXXXXXXXXXGOXXXXXXXXXXXXXXXXXXGOOOOOOOXXXXXXXXXXXXGXXXXXXXXXXXXXXXXXXXGOOOXXXXXXXXXXXXXXXXGOXXXXXXXXXXXXXXXXXXGOOOXXXXXXXXXXXXXXXXGOOOOOXXXXXXXXXXXXXXGOOXXXXXXXXXXXXXXXXXGOOOOOOXXXXXXXXXXXXXGOOOOOOXXXXXXXXXXXXX,0,300,0

15645,60,0,60,25,215,0,0,217,174,43,GOOOXXXXXXXXXXXXXXXXGOOOOOXXXXXXXXXXXXXXGOOOOOXXXXXXXXXXXXXXGOXXXXXXXXXXXXXXXXXXGOOOOOOOXXXXXXXXXXXXGXXXXXXXXXXXXXXXXXXXGOOOXXXXXXXXXXXXXXXXGOXXXXXXXXXXXXXXXXXXGOOOXXXXXXXXXXXXXXXXGOOOOOXXXXXXXXXXXXXXGOOXXXXXXXXXXXXXXXXXGOOOOOOXXXXXXXXXXXXXGOOOOOOXXXXXXXXXXXXX,0,300,0
15666,60,0,60,26,214,0,0,216,174,42,GOOOXXXXXXXXXXXXXXXXGOOOOOXXXXXXXXXXXXXXGOOOOOXXXXXXXXXXXXXXGOXXXXXXXXXXXXXXXXXXGOOOOOOOXXXXXXXXXXXXGXXXXXXXXXXXXXXXXXXXGOOOXXXXXXXXXXXXXXXXGOXXXXXXXXXXXXXXXXXXGOOOXXXXXXXXXXXXXXXXGOOOOOXXXXXXXXXXXXXXGOOXXXXXXXXXXXXXXXXXGOOOOOOXXXXXXXXXXXXXGOOOOOOXXXXXXXXXXXXX,0,300,0
15687,60,0,60,27,213,0,0,215,176,39,GOOOXXXXXXXXXXXXXXXXGOOOOOXXXXXXXXXXXXXXGOOOOOXXXXXXXXXXXXXXGOXXXXXXXXXXXXXXXXXXGOOOOOOOXXXXXXXXXXXXGXXXXXXXXXXXXXXXXXXXGOOOXXXXXXXXXXXXXXXXGOXXXXXXXXXXXXXXXXXXGOOOXXXXXXXXXXXXXXXXGOOOOOXXXXXXXXXXXXXXGOOXXXXXXXXXXXXXXXXXGOOOOOOXXXXXXXXXXXXXGOOOOOOXXXXXXXXXXXXX,0,300,0
15708,60,0,60,31,209,0,0,211,175,36,GOOOXXXXXXXXXXXXXXXXGOOOOOXXXXXXXXXXXXXXGOOOOOXXXXXXXXXXXXXXGOXXXXXXXXXXXXXXXXXXGOOOOOOOXXXXXXXXXXXXGXXXXXXXXXXXXXXXXXXXGOOOXXXXXXXXXXXXXXXXGOXXXXXXXXXXXXXXXXXXGOOOXXXXXXXXXXXXXXXXGOOOOOXXXXXXXXXXXXXXGOOXXXXXXXXXXXXXXXXXGOOOOOOXXXXXXXXXXXXXGOOOOOOXXXXXXXXXXXXX,0,300,0
15729,60,0,60,28,212,0,0,213,174,39,GOOOXXXXXXXXXXXXXXXXGOOOOOXXXXXXXXXXXXXXGOOOOOXXXXXXXXXXXXXXGOXXXXXXXXXXXXXXXXXXGOOOOOOOXXXXXXXXXXXXGXXXXXXXXXXXXXXXXXXXGOOOXXXXXXXXXXXXXXXXGOXXXXXXXXXXXXXXXXXXGOOOXXXXXXXXXXXXXXXXGOOOOOXXXXXXXXXXXXXXGOOXXXXXXXXXXXXXXXXXGOOOOOOXXXXXXXXXXXXXGOOOOOOXXXXXXXXXXXXX,0,300,0

15750,60,0,60,27,213,0,0,215,177,38,GOOOXXXXXXXXXXXXXXXXGOOOOOXXXXXXXXXXXXXXGOOOOOXXXXXXXXXXXXXXGOXXXXXXXXXXXXXXXXXXGOOOOOOOXXXXXXXXXXXXGXXXXXXXXXXXXXXXXXXXGOOOXXXXXXXXXXXXXXXXGOXXXXXXXXXXXXXXXXXXGOOOXXXXXXXXXXXXXXXXGOOOOOXXXXXXXXXXXXXXGOOXXXXXXXXXXXXXXXXXGOOOOOOXXXXXXXXXXXXXGOOOOOOXXXXXXXXXXXXX,0,300,0
15771,60,0,60,26,214,0,0,216,175,41,GOOOXXXXXXXXXXXXXXXXGOOOOOXXXXXXXXXXXXXXGOOOOOXXXXXXXXXXXXXXGOXXXXXXXXXXXXXXXXXXGOOOOOOOXXXXXXXXXXXXGXXXXXXXXXXXXXXXXXXXGOOOXXXXXXXXXXXXXXXXGOXXXXXXXXXXXXXXXXXXGOOOXXXXXXXXXXXXXXXXGOOOOOXXXXXXXXXXXXXXGOOXXXXXXXXXXXXXXXXXGOOOOOOXXXXXXXXXXXXXGOOOOOOXXXXXXXXXXXXX,0,300,0
15792,60,0,60,24,216,0,0,218,177,41,GOOOXXXXXXXXXXXXXXXXGOOOOOXXXXXXXXXXXXXXGOOOOOXXXXXXXXXXXXXXGOXXXXXXXXXXXXXXXXXXGOOOOOOOXXXXXXXXXXXXGXXXXXXXXXXXXXXXXXXXGOOOXXXXXXXXXXXXXXXXGOXXXXXXXXXXXXXXXXXXGOOOXXXXXXXXXXXXXXXXGOOOOOXXXXXXXXXXXXXXGOOXXXXXXXXXXXXXXXXXGOOOOOOXXXXXXXXXXXXXGOOOOOOXXXXXXXXXXXXX,0,300,0
15813,60,0,60,19,221,0,0,223,177,46,GOOOXXXXXXXXXXXXXXXXGOOOOOXXXXXXXXXXXXXXGOOOOOXXXXXXXXXXXXXXGOXXXXXXXXXXXXXXXXXXGOOOOOOOXXXXXXXXXXXXGXXXXXXXXXXXXXXXXXXXGOOOXXXXXXXXXXXXXXXXGOXXXXXXXXXXXXXXXXXXGOOOXXXXXXXXXXXXXXXXGOOOOOXXXXXXXXXXXXXXGOOXXXXXXXXXXXXXXXXXGOOOOOOXXXXXXXXXXXXXGOOOOOOXXXXXXXXXXXXX,0,300,0
15834,60,0,60,19,221,0,0,224,179,45,GOOOXXXXXXXXXXXXXXXXGOOOOOXXXXXXXXXXXXXXGOOOOOXXXXXXXXXXXXXXGOXXXXXXXXXXXXXXXXXXGOOOOOOOXXXXXXXXXXXXGXXXXXXXXXXXXXXXXXXXGOOOXXXXXXXXXXXXXXXXGOXXXXXXXXXXXXXXXXXXGOOOXXXXXXXXXXXXXXXXGOOOOOXXXXXXXXXXXXXXGOOXXXXXXXXXXXXXXXXXGOOOOOOXXXXXXXXXXXXXGOOOOOOXXXXXXXXXXXXX,0,300,0

15855,60,0,60,22,218,0,0,221,178,43,GOOOXXXXXXXXXXXXXXXXGOOOOOXXXXXXXXXXXXXXGOOOOOXXXXXXXXXXXXXXGOXXXXXXXXXXXXXXXXXXGOOOOOOOXXXXXXXXXXXXGXXXXXXXXXXXXXXXXXXXGOOOXXXXXXXXXXXXXXXXGOXXXXXXXXXXXXXXXXXXGOOOXXXXXXXXXXXXXXXXGOOOOOXXXXXXXXXXXXXXGOOXXXXXXXXXXXXXXXXXGOOOOOOXXXXXXXXXXXXXGOOOOOOXXXXXXXXXXXXX,0,300,0
15876,60,0,60,25,215,0,0,218,176,42,GOOOXXXXXXXXXXXXXXXXGOOOOOXXXXXXXXXXXXXXGOOOOOXXXXXXXXXXXXXXGOXXXXXXXXXXXXXXXXXXGOOOOOOOXXXXXXXXXXXXGXXXXXXXXXXXXXXXXXXXGOOOXXXXXXXXXXXXXXXXGOXXXXXXXXXXXXXXXXXXGOOOXXXXXXXXXXXXXXXXGOOOOOXXXXXXXXXXXXXXGOOXXXXXXXXXXXXXXXXXGOOOOOOXXXXXXXXXXXXXGOOOOOOXXXXXXXXXXXXX,0,300,0
15897,60,0,60,26,214,0,0,218,178,40,GOOOXXXXXXXXXXXXXXXXGOOOOOXXXXXXXXXXXXXXGOOOOOXXXXXXXXXXXXXXGOXXXXXXXXXXXXXXXXXXGOOOOOOOXXXXXXXXXXXXGXXXXXXXXXXXXXXXXXXXGOOOXXXXXXXXXXXXXXXXGOXXXXXXXXXXXXXXXXXXGOOOXXXXXXXXXXXXXXXXGOOOOOXXXXXXXXXXXXXXGOOXXXXXXXXXXXXXXXXXGOOOOOOXXXXXXXXXXXXXGOOOOOOXXXXXXXXXXXXX,0,300,0
15918,60,0,60,25,215,0,0,219,178,41,GOOOXXXXXXXXXXXXXXXXGOOOOOXXXXXXXXXXXXXXGOOOOOXXXXXXXXXXXXXXGOXXXXXXXXXXXXXXXXXXGOOOOOOOXXXXXXXXXXXXGXXXXXXXXXXXXXXXXXXXGOOOXXXXXXXXXXXXXXXXGOXXXXXXXXXXXXXXXXXXGOOOXXXXXXXXXXXXXXXXGOOOOOXXXXXXXXXXXXXXGOOXXXXXXXXXXXXXXXXXGOOOOOOXXXXXXXXXXXXXGOOOOOOXXXXXXXXXXXXX,0,300,0
15939,60,0,60,23,217,0,0,218,177,41,GOOOXXXXXXXXXXXXXXXXGOOOOOXXXXXXXXXXXXXXGOOOOOXXXXXXXXXXXXXXGOXXXXXXXXXXXXXXXXXXGOOOOOOOXXXXXXXXXXXXGXXXXXXXXXXXXXXXXXXXGOOOXXXXXXXXXXXXXXXXGOXXXXXXXXXXXXXXXXXXGOOOXXXXXXXXXXXXXXXXGOOOOOXXXXXXXXXXXXXXGOOXXXXXXXXXXXXXXXXXGOOOOOOXXXXXXXXXXXXXGOOOOOOXXXXXXXXXXXXX,0,300,0

15960,60,0,60,27,213,0,0,216,175,41,GOOOXXXXXXXXXXXXXXXXGOOOOOXXXXXXXXXXXXXXGOOOOOXXXXXXXXXXXXXXGOXXXXXXXXXXXXXXXXXXGOOOOOOOXXXXXXXXXXXXGXXXXXXXXXXXXXXXXXXXGOOOXXXXXXXXXXXXXXXXGOXXXXXXXXXXXXXXXXXXGOOOXXXXXXXXXXXXXXXXGOOOOOXXXXXXXXXXXXXXGOOXXXXXXXXXXXXXXXXXGOOOOOOXXXXXXXXXXXXXGOOOOOOXXXXXXXXXXXXX,0,300,0
15981,60,0,60,26,214,0,0,217,174,43,GOOOXXXXXXXXXXXXXXXXGOOOOOXXXXXXXXXXXXXXGOOOOOXXXXXXXXXXXXXXGOXXXXXXXXXXXXXXXXXXGOOOOOOOXXXXXXXXXXXXGXXXXXXXXXXXXXXXXXXXGOOOXXXXXXXXXXXXXXXXGOXXXXXXXXXXXXXXXXXXGOOOXXXXXXXXXXXXXXXXGOOOOOXXXXXXXXXXXXXXGOOXXXXXXXXXXXXXXXXXGOOOOOOXXXXXXXXXXXXXGOOOOOOXXXXXXXXXXXXX,0,300,0
16002,60,0,60,22,218,0,0,221,175,46,GOOOXXXXXXXXXXXXXXXXGOOOOOXXXXXXXXXXXXXXGOOOOOXXXXXXXXXXXXXXGOXXXXXXXXXXXXXXXXXXGOOOOOOOXXXXXXXXXXXXGXXXXXXXXXXXXXXXXXXXGOOOXXXXXXXXXXXXXXXXGOXXXXXXXXXXXXXXXXXXGOOOXXXXXXXXXXXXXXXXGOOOOOXXXXXXXXXXXXXXGOOXXXXXXXXXXXXXXXXXGOOOOOOXXXXXXXXXXXXXGOOOOOOXXXXXXXXXXXXX,0,300,0
16023,60,0,60,20,220,0,0,223,176,47,GOOOXXXXXXXXXXXXXXXXGOOOOOXXXXXXXXXXXXXXGOOOOOXXXXXXXXXXXXXXGOXXXXXXXXXXXXXXXXXXGOOOOOOOXXXXXXXXXXXXGXXXXXXXXXXXXXXXXXXXGOOOXXXXXXXXXXXXXXXXGOXXXXXXXXXXXXXXXXXXGOOOXXXXXXXXXXXXXXXXGOOOOOXXXXXXXXXXXXXXGOOXXXXXXXXXXXXXXXXXGOOOOOOXXXXXXXXXXXXXGOOOOOOXXXXXXXXXXXXX,0,300,0
16044,60,0,60,21,219,0,0,222,177,45,GOOOXXXXXXXXXXXXXXXXGOOOOOXXXXXXXXXXXXXXGOOOOOXXXXXXXXXXXXXXGOXXXXXXXXXXXXXXXXXXGOOOOOOOXXXXXXXXXXXXGXXXXXXXXXXXXXXXXXXXGOOOXXXXXXXXXXXXXXXXGOXXXXXXXXXXXXXXXXXXGOOOXXXXXXXXXXXXXXXXGOOOOOXXXXXXXXXXXXXXGOOXXXXXXXXXXXXXXXXXGOOOOOOXXXXXXXXXXXXXGOOOOOOXXXXXXXXXXXXX,0,300,0

16065,60,0,60,24,216,0,0,219,174,45,GOOOXXXXXXXXXXXXXXXXGOOOOOXXXXXXXXXXXXXXGOOOOOXXXXXXXXXXXXXXGOXXXXXXXXXXXXXXXXXXGOOOOOOOXXXXXXXXXXXXGXXXXXXXXXXXXXXXXXXXGOOOXXXXXXXXXXXXXXXXGOXXXXXXXXXXXXXXXXXXGOOOXXXXXXXXXXXXXXXXGOOOOOXXXXXXXXXXXXXXGOOXXXXXXXXXXXXXXXXXGOOOOOOXXXXXXXXXXXXXGOOOOOOXXXXXXXXXXXXX,0,300,0
16086,60,0,60,24,216,0,0,219,176,43,GOOOXXXXXXXXXXXXXXXXGOOOOOXXXXXXXXXXXXXXGOOOOOXXXXXXXXXXXXXXGOXXXXXXXXXXXXXXXXXXGOOOOOOOXXXXXXXXXXXXGXXXXXXXXXXXXXXXXXXXGOOOXXXXXXXXXXXXXXXXGOXXXXXXXXXXXXXXXXXXGOOOXXXXXXXXXXXXXXXXGOOOOOXXXXXXXXXXXXXXGOOXXXXXXXXXXXXXXXXXGOOOOOOXXXXXXXXXXXXXGOOOOOOXXXXXXXXXXXXX,0,300,0
16107,60,0,60,21,219,0,0,221,175,46,GOOOXXXXXXXXXXXXXXXXGOOOOOXXXXXXXXXXXXXXGOOOOOXXXXXXXXXXXXXXGOXXXXXXXXXXXXXXXXXXGOOOOOOOXXXXXXXXXXXXGXXXXXXXXXXXXXXXXXXXGOOOXXXXXXXXXXXXXXXXGOXXXXXXXXXXXXXXXXXXGOOOXXXXXXXXXXXXXXXXGOOOOOXXXXXXXXXXXXXXGOOXXXXXXXXXXXXXXXXXGOOOOOOXXXXXXXXXXXXXGOOOOOOXXXXXXXXXXXXX,0,300,0
16128,60,0,60,21,219,0,0,221,175,46,GOOOXXXXXXXXXXXXXXXXGOOOOOXXXXXXXXXXXXXXGOOOOOXXXXXXXXXXXXXXGOXXXXXXXXXXXXXXXXXXGOOOOOOOXXXXXXXXXXXXGXXXXXXXXXXXXXXXXXXXGOOOXXXXXXXXXXXXXXXXGOXXXXXXXXXXXXXXXXXXGOOOXXXXXXXXXXXXXXXXGOOOOOXXXXXXXXXXXXXXGOOXXXXXXXXXXXXXXXXXGOOOOOOXXXXXXXXXXXXXGOOOOOOXXXXXXXXXXXXX,0,300,0
16149,60,0,60,21,219,0,0,221,177,44,GOOOXXXXXXXXXXXXXXXXGOOOOOXXXXXXXXXXXXXXGOOOOOXXXXXXXXXXXXXXGOXXXXXXXXXXXXXXXXXXGOOOOOOOXXXXXXXXXXXXGXXXXXXXXXXXXXXXXXXXGOOOXXXXXXXXXXXXXXXXGOXXXXXXXXXXXXXXXXXXGOOOXXXXXXXXXXXXXXXXGOOOOOXXXXXXXXXXXXXXGOOXXXXXXXXXXXXXXXXXGOOOOOOXXXXXXXXXXXXXGOOOOOOXXXXXXXXXXXXX,0,300,0

16170,60,0,60,21,219,0,0,221,177,44,GOOOXXXXXXXXXXXXXXXXGOOOOOXXXXXXXXXXXXXXGOOOOOXXXXXXXXXXXXXXGOXXXXXXXXXXXXXXXXXXGOOOOOOOXXXXXXXXXXXXGXXXXXXXXXXXXXXXXXXXGOOOXXXXXXXXXXXXXXXXGOXXXXXXXXXXXXXXXXXXGOOOXXXXXXXXXXXXXXXXGOOOOOXXXXXXXXXXXXXXGOOXXXXXXXXXXXXXXXXXGOOOOOOXXXXXXXXXXXXXGOOOOOOXXXXXXXXXXXXX,0,300,0
16191,60,0,60,21,219,0,0,221,180,41,GOOOXXXXXXXXXXXXXXXXGOOOOOXXXXXXXXXXXXXXGOOOOOXXXXXXXXXXXXXXGOXXXXXXXXXXXXXXXXXXGOOOOOOOXXXXXXXXXXXXGXXXXXXXXXXXXXXXXXXXGOOOXXXXXXXXXXXXXXXXGOXXXXXXXXXXXXXXXXXXGOOOXXXXXXXXXXXXXXXXGOOOOOXXXXXXXXXXXXXXGOOXXXXXXXXXXXXXXXXXGOOOOOOXXXXXXXXXXXXXGOOOOOOXXXXXXXXXXXXX,0,300,0
16212,60,0,60,26,214,0,0,216,180,36,GOOOXXXXXXXXXXXXXXXXGOOOOOXXXXXXXXXXXXXXGOOOOOXXXXXXXXXXXXXXGOXXXXXXXXXXXXXXXXXXGOOOOOOOXXXXXXXXXXXXGXXXXXXXXXXXXXXXXXXXGOOOXXXXXXXXXXXXXXXXGOXXXXXXXXXXXXXXXXXXGOOOXXXXXXXXXXXXXXXXGOOOOOXXXXXXXXXXXXXXGOOXXXXXXXXXXXXXXXXXGOOOOOOXXXXXXXXXXXXXGOOOOOOXXXXXXXXXXXXX,0,300,0
16233,60,0,60,24,216,0,0,217,179,38,GOOOXXXXXXXXXXXXXXXXGOOOOOXXXXXXXXXXXXXXGOOOOOXXXXXXXXXXXXXXGOXXXXXXXXXXXXXXXXXXGOOOOOOOXXXXXXXXXXXXGXXXXXXXXXXXXXXXXXXXGOOOXXXXXXXXXXXXXXXXGOXXXXXXXXXXXXXXXXXXGOOOXXXXXXXXXXXXXXXXGOOOOOXXXXXXXXXXXXXXGOOXXXXXXXXXXXXXXXXXGOOOOOOXXXXXXXXXXXXXGOOOOOOXXXXXXXXXXXXX,0,300,0
16254,61,1,60,23,216,0,0,218,179,39,GOOOXXXXXXXXXXXXXXXXGOOOOOXXXXXXXXXXXXXXGOOOOOAXXXXXXXXXXXXXGOXXXXXXXXXXXXXXXXXXGOOOOOOOXXXXXXXXXXXXGXXXXXXXXXXXXXXXXXXXGOOOXXXXXXXXXXXXXXXXGOXXXXXXXXXXXXXXXXXXGOOOXXXXXXXXXXXXXXXXGOOOOOXXXXXXXXXXXXXXGOOXXXXXXXXXXXXXXXXXGOOOOOOXXXXXXXXXXXXXGOOOOOOXXXXXXXXXXXXX,0,300,0

16275,61,1,60,22,217,0,0,219,178,41,GOOOXXXXXXXXXXXXXXXXGOOOOOXXXXXXXXXXXXXXGOOOOOAXXXXXXXXXXXXXGOXXXXXXXXXXXXXXXXXXGOOOOOOOXXXXXXXXXXXXGXXXXXXXXXXXXXXXXXXXGOOOXXXXXXXXXXXXXXXXGOXXXXXXXXXXXXXXXXXXGOOOXXXXXXXXXXXXXXXXGOOOOOXXXXXXXXXXXXXXGOOXXXXXXXXXXXXXXXXXGOOOOOOXXXXXXXXXXXXXGOOOOOOXXXXXXXXXXXXX,0,300,0
16296,61,0,61,24,215,0,0,217,177,40,GOOOXXXXXXXXXXXXXXXXGOOOOOXXXXXXXXXXXXXXGOOOOOOXXXXXXXXXXXXXGOXXXXXXXXXXXXXXXXXXGOOOOOOOXXXXXXXXXXXXGXXXXXXXXXXXXXXXXXXXGOOOXXXXXXXXXXXXXXXXGOXXXXXXXXXXXXXXXXXXGOOOXXXXXXXXXXXXXXXXGOOOOOXXXXXXXXXXXXXXGOOXXXXXXXXXXXXXXXXXGOOOOOOXXXXXXXXXXXXXGOOOOOOXXXXXXXXXXXXX,0,300,0
16317,61,0,61,22,217,0,0,218,175,43,GOOOXXXXXXXXXXXXXXXXGOOOOOXXXXXXXXXXXXXXGOOOOOOXXXXXXXXXXXXXGOXXXXXXXXXXXXXXXXXXGOOOOOOOXXXXXXXXXXXXGXXXXXXXXXXXXXXXXXXXGOOOXXXXXXXXXXXXXXXXGOXXXXXXXXXXXXXXXXXXGOOOXXXXXXXXXXXXXXXXGOOOOOXXXXXXXXXXXXXXGOOXXXXXXXXXXXXXXXXXGOOOOOOXXXXXXXXXXXXXGOOOOOOXXXXXXXXXXXXX,0,300,0
16338,61,0,61,21,218,0,0,220,177,43,GOOOXXXXXXXXXXXXXXXXGOOOOOXXXXXXXXXXXXXXGOOOOOOXXXXXXXXXXXXXGOXXXXXXXXXXXXXXXXXXGOOOOOOOXXXXXXXXXXXXGXXXXXXXXXXXXXXXXXXXGOOOXXXXXXXXXXXXXXXXGOXXXXXXXXXXXXXXXXXXGOOOXXXXXXXXXXXXXXXXGOOOOOXXXXXXXXXXXXXXGOOXXXXXXXXXXXXXXXXXGOOOOOOXXXXXXXXXXXXXGOOOOOOXXXXXXXXXXXXX,0,300,0
16359,61,0,61,21,218,0,0,220,179,41,GOOOXXXXXXXXXXXXXXXXGOOOOOXXXXXXXXXXXXXXGOOOOOOXXXXXXXXXXXXXGOXXXXXXXXXXXXXXXXXXGOOOOOOOXXXXXXXXXXXXGXXXXXXXXXXXXXXXXXXXGOOOXXXXXXXXXXXXXXXXGOXXXXXXXXXXXXXXXXXXGOOOXXXXXXXXXXXXXXXXGOOOOOXXXXXXXXXXXXXXGOOXXXXXXXXXXXXXXXXXGOOOOOOXXXXXXXXXXXXXGOOOOOOXXXXXXXXXXXXX,0,300,0

16380,61,0,61,24,215,0,0,217,179,38,GOOOXXXXXXXXXXXXXXXXGOOOOOXXXXXXXXXXXXXXGOOOOOOXXXXXXXXXXXXXGOXXXXXXXXXXXXXXXXXXGOOOOOOOXXXXXXXXXXXXGXXXXXXXXXXXXXXXXXXXGOOOXXXXXXXXXXXXXXXXGOXXXXXXXXXXXXXXXXXXGOOOXXXXXXXXXXXXXXXXGOOOOOXXXXXXXXXXXXXXGOOXXXXXXXXXXXXXXXXXGOOOOOOXXXXXXXXXXXXXGOOOOOOXXXXXXXXXXXXX,0,300,0
16401,61,0,61,26,213,0,0,215,178,37,GOOOXXXXXXXXXXXXXXXXGOOOOOXXXXXXXXXXXXXXGOOOOOOXXXXXXXXXXXXXGOXXXXXXXXXXXXXXXXXXGOOOOOOOXXXXXXXXXXXXGXXXXXXXXXXXXXXXXXXXGOOOXXXXXXXXXXXXXXXXGOXXXXXXXXXXXXXXXXXXGOOOXXXXXXXXXXXXXXXXGOOOOOXXXXXXXXXXXXXXGOOXXXXXXXXXXXXXXXXXGOOOOOOXXXXXXXXXXXXXGOOOOOOXXXXXXXXXXXXX,0,300,0
16422,61,0,61,25,214,0,0,216,177,39,GOOOXXXXXXXXXXXXXXXXGOOOOOXXXXXXXXXXXXXXGOOOOOOXXXXXXXXXXXXXGOXXXXXXXXXXXXXXXXXXGOOOOOOOXXXXXXXXXXXXGXXXXXXXXXXXXXXXXXXXGOOOXXXXXXXXXXXXXXXXGOXXXXXXXXXXXXXXXXXXGOOOXXXXXXXXXXXXXXXXGOOOOOXXXXXXXXXXXXXXGOOXXXXXXXXXXXXXXXXXGOOOOOOXXXXXXXXXXXXXGOOOOOOXXXXXXXXXXXXX,0,300,0
16443,61,0,61,25,214,0,0,216,177,39,GOOOXXXXXXXXXXXXXXXXGOOOOOXXXXXXXXXXXXXXGOOOOOOXXXXXXXXXXXXXGOXXXXXXXXXXXXXXXXXXGOOOOOOOXXXXXXXXXXXXGXXXXXXXXXXXXXXXXXXXGOOOXXXXXXXXXXXXXXXXGOXXXXXXXXXXXXXXXXXXGOOOXXXXXXXXXXXXXXXXGOOOOOXXXXXXXXXXXXXXGOOXXXXXXXXXXXXXXXXXGOOOOOOXXXXXXXXXXXXXGOOOOOOXXXXXXXXXXXXX,0,300,0
16464,61,0,61,21,218,0,0,219,177,42,GOOOXXXXXXXXXXXXXXXXGOOOOOXXXXXXXXXXXXXXGOOOOOOXXXXXXXXXXXXXGOXXXXXXXXXXXXXXXXXXGOOOOOOOXXXXXXXXXXXXGXXXXXXXXXXXXXXXXXXXGOOOXXXXXXXXXXXXXXXXGOXXXXXXXXXXXXXXXXXXGOOOXXXXXXXXXXXXXXXXGOOOOOXXXXXXXXXXXXXXGOOXXXXXXXXXXXXXXXXXGOOOOOOXXXXXXXXXXXXXGOOOOOOXXXXXXXXXXXXX,0,300,0

16485,61,0,61,20,219,0,0,221,178,43,GOOOXXXXXXXXXXXXXXXXGOOOOOXXXXXXXXXXXXXXGOOOOOOXXXXXXXXXXXXXGOXXXXXXXXXXXXXXXXXXGOOOOOOOXXXXXXXXXXXXGXXXXXXXXXXXXXXXXXXXGOOOXXXXXXXXXXXXXXXXGOXXXXXXXXXXXXXXXXXXGOOOXXXXXXXXXXXXXXXXGOOOOOXXXXXXXXXXXXXXGOOXXXXXXXXXXXXXXXXXGOOOOOOXXXXXXXXXXXXXGOOOOOOXXXXXXXXXXXXX,0,300,0
16506,61,0,61,21,218,0,0,220,177,43,GOOOXXXXXXXXXXXXXXXXGOOOOOXXXXXXXXXXXXXXGOOOOOOXXXXXXXXXXXXXGOXXXXXXXXXXXXXXXXXXGOOOOOOOXXXXXXXXXXXXGXXXXXXXXXXXXXXXXXXXGOOOXXXXXXXXXXXXXXXXGOXXXXXXXXXXXXXXXXXXGOOOXXXXXXXXXXXXXXXXGOOOOOXXXXXXXXXXXXXXGOOXXXXXXXXXXXXXXXXXGOOOOOOXXXXXXXXXXXXXGOOOOOOXXXXXXXXXXXXX,0,300,0
16527,61,0,61,18,221,0,0,223,177,46,GOOOXXXXXXXXXXXXXXXXGOOOOOXXXXXXXXXXXXXXGOOOOOOXXXXXXXXXXXXXGOXXXXXXXXXXXXXXXXXXGOOOOOOOXXXXXXXXXXXXGXXXXXXXXXXXXXXXXXXXGOOOXXXXXXXXXXXXXXXXGOXXXXXXXXXXXXXXXXXXGOOOXXXXXXXXXXXXXXXXGOOOOOXXXXXXXXXXXXXXGOOXXXXXXXXXXXXXXXXXGOOOOOOXXXXXXXXXXXXXGOOOOOOXXXXXXXXXXXXX,0,300,0
16548,61,0,61,18,221,0,0,223,178,45,GOOOXXXXXXXXXXXXXXXXGOOOOOXXXXXXXXXXXXXXGOOOOOOXXXXXXXXXXXXXGOXXXXXXXXXXXXXXXXXXGOOOOOOOXXXXXXXXXXXXGXXXXXXXXXXXXXXXXXXXGOOOXXXXXXXXXXXXXXXXGOXXXXXXXXXXXXXXXXXXGOOOXXXXXXXXXXXXXXXXGOOOOOXXXXXXXXXXXXXXGOOXXXXXXXXXXXXXXXXXGOOOOOOXXXXXXXXXXXXXGOOOOOOXXXXXXXXXXXXX,0,300,0
16569,61,0,61,22,217,0,0,219,177,42,GOOOXXXXXXXXXXXXXXXXGOOOOOXXXXXXXXXXXXXXGOOOOOOXXXXXXXXXXXXXGOXXXXXXXXXXXXXXXXXXGOOOOOOOXXXXXXXXXXXXGXXXXXXXXXXXXXXXXXXXGOOOXXXXXXXXXXXXXXXXGOXXXXXXXXXXXXXXXXXXGOOOXXXXXXXXXXXXXXXXGOOOOOXXXXXXXXXXXXXXGOOXXXXXXXXXXXXXXXXXGOOOOOOXXXXXXXXXXXXXGOOOOOOXXXXXXXXXXXXX,0,300,0

16590,61,0,61,19,220,0,0,222,178,44,GOOOXXXXXXXXXXXXXXXXGOOOOOXXXXXXXXXXXXXXGOOOOOOXXXXXXXXXXXXXGOXXXXXXXXXXXXXXXXXXGOOOOOOOXXXXXXXXXXXXGXXXXXXXXXXXXXXXXXXXGOOOXXXXXXXXXXXXXXXXGOXXXXXXXXXXXXXXXXXXGOOOXXXXXXXXXXXXXXXXGOOOOOXXXXXXXXXXXXXXGOOXXXXXXXXXXXXXXXXXGOOOOOOXXXXXXXXXXXXXGOOOOOOXXXXXXXXXXXXX,0,300,0
16611,61,0,61,20,219,0,0,221,177,44,GOOOXXXXXXXXXXXXXXXXGOOOOOXXXXXXXXXXXXXXGOOOOOOXXXXXXXXXXXXXGOXXXXXXXXXXXXXXXXXXGOOOOOOOXXXXXXXXXXXXGXXXXXXXXXXXXXXXXXXXGOOOXXXXXXXXXXXXXXXXGOXXXXXXXXXXXXXXXXXXGOOOXXXXXXXXXXXXXXXXGOOOOOXXXXXXXXXXXXXXGOOXXXXXXXXXXXXXXXXXGOOOOOOXXXXXXXXXXXXXGOOOOOOXXXXXXXXXXXXX,0,300,0
16632,61,0,61,19,220,0,0,222,179,43,GOOOXXXXXXXXXXXXXXXXGOOOOOXXXXXXXXXXXXXXGOOOOOOXXXXXXXXXXXXXGOXXXXXXXXXXXXXXXXXXGOOOOOOOXXXXXXXXXXXXGXXXXXXXXXXXXXXXXXXXGOOOXXXXXXXXXXXXXXXXGOXXXXXXXXXXXXXXXXXXGOOOXXXXXXXXXXXXXXXXGOOOOOXXXXXXXXXXXXXXGOOXXXXXXXXXXXXXXXXXGOOOOOOXXXXXXXXXXXXXGOOOOOOXXXXXXXXXXXXX,0,300,0
16653,61,0,61,20,219,0,0,221,178,43,GOOOXXXXXXXXXXXXXXXXGOOOOOXXXXXXXXXXXXXXGOOOOOOXXXXXXXXXXXXXGOXXXXXXXXXXXXXXXXXXGOOOOOOOXXXXXXXXXXXXGXXXXXXXXXXXXXXXXXXXGOOOXXXXXXXXXXXXXXXXGOXXXXXXXXXXXXXXXXXXGOOOXXXXXXXXXXXXXXXXGOOOOOXXXXXXXXXXXXXXGOOXXXXXXXXXXXXXXXXXGOOOOOOXXXXXXXXXXXXXGOOOOOOXXXXXXXXXXXXX,0,300,0
16674,61,0,61,20,219,0,0,221,180,41,GOOOXXXXXXXXXXXXXXXXGOOOOOXXXXXXXXXXXXXXGOOOOOOXXXXXXXXXXXXXGOXXXXXXXXXXXXXXXXXXGOOOOOOOXXXXXXXXXXXXGXXXXXXXXXXXXXXXXXXXGOOOXXXXXXXXXXXXXXXXGOXXXXXXXXXXXXXXXXXXGOOOXXXXXXXXXXXXXXXXGOOOOOXXXXXXXXXXXXXXGOOXXXXXXXXXXXXXXXXXGOOOOOOXXXXXXXXXXXXXGOOOOOOXXXXXXXXXXXXX,0,300,0

16695,61,0,61,21,218,0,0,220,178,42,GOOOXXXXXXXXXXXXXXXXGOOOOOXXXXXXXXXXXXXXGOOOOOOXXXXXXXXXXXXXGOXXXXXXXXXXXXXXXXXXGOOOOOOOXXXXXXXXXXXXGXXXXXXXXXXXXXXXXXXXGOOOXXXXXXXXXXXXXXXXGOXXXXXXXXXXXXXXXXXXGOOOXXXXXXXXXXXXXXXXGOOOOOXXXXXXXXXXXXXXGOOXXXXXXXXXXXXXXXXXGOOOOOOXXXXXXXXXXXXXGOOOOOOXXXXXXXXXXXXX,0,300,0
16716,61,0,61,23,216,0,0,218,178,40,GOOOXXXXXXXXXXXXXXXXGOOOOOXXXXXXXXXXXXXXGOOOOOOXXXXXXXXXXXXXGOXXXXXXXXXXXXXXXXXXGOOOOOOOXXXXXXXXXXXXGXXXXXXXXXXXXXXXXXXXGOOOXXXXXXXXXXXXXXXXGOXXXXXXXXXXXXXXXXXXGOOOXXXXXXXXXXXXXXXXGOOOOOXXXXXXXXXXXXXXGOOXXXXXXXXXXXXXXXXXGOOOOOOXXXXXXXXXXXXXGOOOOOOXXXXXXXXXXXXX,0,300,0
16737,61,0,61,20,219,0,0,221,180,41,GOOOXXXXXXXXXXXXXXXXGOOOOOXXXXXXXXXXXXXXGOOOOOOXXXXXXXXXXXXXGOXXXXXXXXXXXXXXXXXXGOOOOOOOXXXXXXXXXXXXGXXXXXXXXXXXXXXXXXXXGOOOXXXXXXXXXXXXXXXXGOXXXXXXXXXXXXXXXXXXGOOOXXXXXXXXXXXXXXXXGOOOOOXXXXXXXXXXXXXXGOOXXXXXXXXXXXXXXXXXGOOOOOOXXXXXXXXXXXXXGOOOOOOXXXXXXXXXXXXX,0,300,0
16758,61,0,61,19,220,0,0,221,177,44,GOOOXXXXXXXXXXXXXXXXGOOOOOXXXXXXXXXXXXXXGOOOOOOXXXXXXXXXXXXXGOXXXXXXXXXXXXXXXXXXGOOOOOOOXXXXXXXXXXXXGXXXXXXXXXXXXXXXXXXXGOOOXXXXXXXXXXXXXXXXGOXXXXXXXXXXXXXXXXXXGOOOXXXXXXXXXXXXXXXXGOOOOOXXXXXXXXXXXXXXGOOXXXXXXXXXXXXXXXXXGOOOOOOXXXXXXXXXXXXXGOOOOOOXXXXXXXXXXXXX,0,300,0
16779,61,0,61,16,223,0,0,225,178,47,GOOOXXXXXXXXXXXXXXXXGOOOOOXXXXXXXXXXXXXXGOOOOOOXXXXXXXXXXXXXGOXXXXXXXXXXXXXXXXXXGOOOOOOOXXXXXXXXXXXXGXXXXXXXXXXXXXXXXXXXGOOOXXXXXXXXXXXXXXXXGOXXXXXXXXXXXXXXXXXXGOOOXXXXXXXXXXXXXXXXGOOOOOXXXXXXXXXXXXXXGOOXXXXXXXXXXXXXXXXXGOOOOOOXXXXXXXXXXXXXGOOOOOOXXXXXXXXXXXXX,0,300,0

16800,61,0,61,19,220,0,0,222,178,44,GOOOXXXXXXXXXXXXXXXXGOOOOOXXXXXXXXXXXXXXGOOOOOOXXXXXXXXXXXXXGOXXXXXXXXXXXXXXXXXXGOOOOOOOXXXXXXXXXXXXGXXXXXXXXXXXXXXXXXXXGOOOXXXXXXXXXXXXXXXXGOXXXXXXXXXXXXXXXXXXGOOOXXXXXXXXXXXXXXXXGOOOOOXXXXXXXXXXXXXXGOOXXXXXXXXXXXXXXXXXGOOOOOOXXXXXXXXXXXXXGOOOOOOXXXXXXXXXXXXX,0,300,0
16821,61,0,61,22,217,0,0,219,179,40,GOOOXXXXXXXXXXXXXXXXGOOOOOXXXXXXXXXXXXXXGOOOOOOXXXXXXXXXXXXXGOXXXXXXXXXXXXXXXXXXGOOOOOOOXXXXXXXXXXXXGXXXXXXXXXXXXXXXXXXXGOOOXXXXXXXXXXXXXXXXGOXXXXXXXXXXXXXXXXXXGOOOXXXXXXXXXXXXXXXXGOOOOOXXXXXXXXXXXXXXGOOXXXXXXXXXXXXXXXXXGOOOOOOXXXXXXXXXXXXXGOOOOOOXXXXXXXXXXXXX,0,300,0
16842,61,0,61,24,215,0,0,216,179,37,GOOOXXXXXXXXXXXXXXXXGOOOOOXXXXXXXXXXXXXXGOOOOOOXXXXXXXXXXXXXGOXXXXXXXXXXXXXXXXXXGOOOOOOOXXXXXXXXXXXXGXXXXXXXXXXXXXXXXXXXGOOOXXXXXXXXXXXXXXXXGOXXXXXXXXXXXXXXXXXXGOOOXXXXXXXXXXXXXXXXGOOOOOXXXXXXXXXXXXXXGOOXXXXXXXXXXXXXXXXXGOOOOOOXXXXXXXXXXXXXGOOOOOOXXXXXXXXXXXXX,0,300,0
16863,61,0,61,22,217,0,0,219,179,40,GOOOXXXXXXXXXXXXXXXXGOOOOOXXXXXXXXXXXXXXGOOOOOOXXXXXXXXXXXXXGOXXXXXXXXXXXXXXXXXXGOOOOOOOXXXXXXXXXXXXGXXXXXXXXXXXXXXXXXXXGOOOXXXXXXXXXXXXXXXXGOXXXXXXXXXXXXXXXXXXGOOOXXXXXXXXXXXXXXXXGOOOOOXXXXXXXXXXXXXXGOOXXXXXXXXXXXXXXXXXGOOOOOOXXXXXXXXXXXXXGOOOOOOXXXXXXXXXXXXX,0,300,0
16884,61,0,61,24,215,0,0,217,176,41,GOOOXXXXXXXXXXXXXXXXGOOOOOXXXXXXXXXXXXXXGOOOOOOXXXXXXXXXXXXXGOXXXXXXXXXXXXXXXXXXGOOOOOOOXXXXXXXXXXXXGXXXXXXXXXXXXXXXXXXXGOOOXXXXXXXXXXXXXXXXGOXXXXXXXXXXXXXXXXXXGOOOXXXXXXXXXXXXXXXXGOOOOOXXXXXXXXXXXXXXGOOXXXXXXXXXXXXXXXXXGOOOOOOXXXXXXXXXXXXXGOOOOOOXXXXXXXXXXXXX,0,300,0

16905,61,0,61,24,215,0,0,217,177,40,GOOOXXXXXXXXXXXXXXXXGOOOOOXXXXXXXXXXXXXXGOOOOOOXXXXXXXXXXXXXGOXXXXXXXXXXXXXXXXXXGOOOOOOOXXXXXXXXXXXXGXXXXXXXXXXXXXXXXXXXGOOOXXXXXXXXXXXXXXXXGOXXXXXXXXXXXXXXXXXXGOOOXXXXXXXXXXXXXXXXGOOOOOXXXXXXXXXXXXXXGOOXXXXXXXXXXXXXXXXXGOOOOOOXXXXXXXXXXXXXGOOOOOOXXXXXXXXXXXXX,0,300,0
16926,61,0,61,26,213,0,0,214,177,37,GOOOXXXXXXXXXXXXXXXXGOOOOOXXXXXXXXXXXXXXGOOOOOOXXXXXXXXXXXXXGOXXXXXXXXXXXXXXXXXXGOOOOOOOXXXXXXXXXXXXGXXXXXXXXXXXXXXXXXXXGOOOXXXXXXXXXXXXXXXXGOXXXXXXXXXXXXXXXXXXGOOOXXXXXXXXXXXXXXXXGOOOOOXXXXXXXXXXXXXXGOOXXXXXXXXXXXXXXXXXGOOOOOOXXXXXXXXXXXXXGOOOOOOXXXXXXXXXXXXX,0,300,0
16947,61,0,61,27,212,0,0,214,179,35,GOOOXXXXXXXXXXXXXXXXGOOOOOXXXXXXXXXXXXXXGOOOOOOXXXXXXXXXXXXXGOXXXXXXXXXXXXXXXXXXGOOOOOOOXXXXXXXXXXXXGXXXXXXXXXXXXXXXXXXXGOOOXXXXXXXXXXXXXXXXGOXXXXXXXXXXXXXXXXXXGOOOXXXXXXXXXXXXXXXXGOOOOOXXXXXXXXXXXXXXGOOXXXXXXXXXXXXXXXXXGOOOOOOXXXXXXXXXXXXXGOOOOOOXXXXXXXXXXXXX,0,300,0
16968,61,0,61,27,212,0,0,214,177,37,GOOOXXXXXXXXXXXXXXXXGOOOOOXXXXXXXXXXXXXXGOOOOOOXXXXXXXXXXXXXGOXXXXXXXXXXXXXXXXXXGOOOOOOOXXXXXXXXXXXXGXXXXXXXXXXXXXXXXXXXGOOOXXXXXXXXXXXXXXXXGOXXXXXXXXXXXXXXXXXXGOOOXXXXXXXXXXXXXXXXGOOOOOXXXXXXXXXXXXXXGOOXXXXXXXXXXXXXXXXXGOOOOOOXXXXXXXXXXXXXGOOOOOOXXXXXXXXXXXXX,0,300,0
16989,61,0,61,26,213,0,0,215,179,36,GOOOXXXXXXXXXXXXXXXXGOOOOOXXXXXXXXXXXXXXGOOOOOOXXXXXXXXXXXXXGOXXXXXXXXXXXXXXXXXXGOOOOOOOXXXXXXXXXXXXGXXXXXXXXXXXXXXXXXXXGOOOXXXXXXXXXXXXXXXXGOXXXXXXXXXXXXXXXXXXGOOOXXXXXXXXXXXXXXXXGOOOOOXXXXXXXXXXXXXXGOOXXXXXXXXXXXXXXXXXGOOOOOOXXXXXXXXXXXXXGOOOOOOXXXXXXXXXXXXX,0,300,0

17010,61,0,61,24,215,0,0,217,178,39,GOOOXXXXXXXXXXXXXXXXGOOOOOXXXXXXXXXXXXXXGOOOOOOXXXXXXXXXXXXXGOXXXXXXXXXXXXXXXXXXGOOOOOOOXXXXXXXXXXXXGXXXXXXXXXXXXXXXXXXXGOOOXXXXXXXXXXXXXXXXGOXXXXXXXXXXXXXXXXXXGOOOXXXXXXXXXXXXXXXXGOOOOOXXXXXXXXXXXXXXGOOXXXXXXXXXXXXXXXXXGOOOOOOXXXXXXXXXXXXXGOOOOOOXXXXXXXXXXXXX,0,300,0
17031,61,0,61,22,217,0,0,220,178,42,GOOOXXXXXXXXXXXXXXXXGOOOOOXXXXXXXXXXXXXXGOOOOOOXXXXXXXXXXXXXGOXXXXXXXXXXXXXXXXXXGOOOOOOOXXXXXXXXXXXXGXXXXXXXXXXXXXXXXXXXGOOOXXXXXXXXXXXXXXXXGOXXXXXXXXXXXXXXXXXXGOOOXXXXXXXXXXXXXXXXGOOOOOXXXXXXXXXXXXXXGOOXXXXXXXXXXXXXXXXXGOOOOOOXXXXXXXXXXXXXGOOOOOOXXXXXXXXXXXXX,0,300,0
17052,61,0,61,20,219,0,0,221,179,42,GOOOXXXXXXXXXXXXXXXXGOOOOOXXXXXXXXXXXXXXGOOOOOOXXXXXXXXXXXXXGOXXXXXXXXXXXXXXXXXXGOOOOOOOXXXXXXXXXXXXGXXXXXXXXXXXXXXXXXXXGOOOXXXXXXXXXXXXXXXXGOXXXXXXXXXXXXXXXXXXGOOOXXXXXXXXXXXXXXXXGOOOOOXXXXXXXXXXXXXXGOOXXXXXXXXXXXXXXXXXGOOOOOOXXXXXXXXXXXXXGOOOOOOXXXXXXXXXXXXX,0,300,0
17073,61,0,61,20,219,0,0,221,180,41,GOOOXXXXXXXXXXXXXXXXGOOOOOXXXXXXXXXXXXXXGOOOOOOXXXXXXXXXXXXXGOXXXXXXXXXXXXXXXXXXGOOOOOOOXXXXXXXXXXXXGXXXXXXXXXXXXXXXXXXXGOOOXXXXXXXXXXXXXXXXGOXXXXXXXXXXXXXXXXXXGOOOXXXXXXXXXXXXXXXXGOOOOOXXXXXXXXXXXXXXGOOXXXXXXXXXXXXXXXXXGOOOOOOXXXXXXXXXXXXXGOOOOOOXXXXXXXXXXXXX,0,300,0
17094,61,0,61,20,219,0,0,221,179,42,GOOOXXXXXXXXXXXXXXXXGOOOOOXXXXXXXXXXXXXXGOOOOOOXXXXXXXXXXXXXGOXXXXXXXXXXXXXXXXXXGOOOOOOOXXXXXXXXXXXXGXXXXXXXXXXXXXXXXXXXGOOOXXXXXXXXXXXXXXXXGOXXXXXXXXXXXXXXXXXXGOOOXXXXXXXXXXXXXXXXGOOOOOXXXXXXXXXXXXXXGOOXXXXXXXXXXXXXXXXXGOOOOOOXXXXXXXXXXXXXGOOOOOOXXXXXXXXXXXXX,0,300,0

17115,61,0,61,21,218,0,0,220,179,41,GOOOXXXXXXXXXXXXXXXXGOOOOOXXXXXXXXXXXXXXGOOOOOOXXXXXXXXXXXXXGOXXXXXXXXXXXXXXXXXXGOOOOOOOXXXXXXXXXXXXGXXXXXXXXXXXXXXXXXXXGOOOXXXXXXXXXXXXXXXXGOXXXXXXXXXXXXXXXXXXGOOOXXXXXXXXXXXXXXXXGOOOOOXXXXXXXXXXXXXXGOOXXXXXXXXXXXXXXXXXGOOOOOOXXXXXXXXXXXXXGOOOOOOXXXXXXXXXXXXX,0,300,0
17136,61,0,61,19,220,0,0,222,180,42,GOOOXXXXXXXXXXXXXXXXGOOOOOXXXXXXXXXXXXXXGOOOOOOXXXXXXXXXXXXXGOXXXXXXXXXXXXXXXXXXGOOOOOOOXXXXXXXXXXXXGXXXXXXXXXXXXXXXXXXXGOOOXXXXXXXXXXXXXXXXGOXXXXXXXXXXXXXXXXXXGOOOXXXXXXXXXXXXXXXXGOOOOOXXXXXXXXXXXXXXGOOXXXXXXXXXXXXXXXXXGOOOOOOXXXXXXXXXXXXXGOOOOOOXXXXXXXXXXXXX,0,300,0
17157,61,0,61,20,219,0,0,221,179,42,GOOOXXXXXXXXXXXXXXXXGOOOOOXXXXXXXXXXXXXXGOOOOOOXXXXXXXXXXXXXGOXXXXXXXXXXXXXXXXXXGOOOOOOOXXXXXXXXXXXXGXXXXXXXXXXXXXXXXXXXGOOOXXXXXXXXXXXXXXXXGOXXXXXXXXXXXXXXXXXXGOOOXXXXXXXXXXXXXXXXGOOOOOXXXXXXXXXXXXXXGOOXXXXXXXXXXXXXXXXXGOOOOOOXXXXXXXXXXXXXGOOOOOOXXXXXXXXXXXXX,0,300,0
17178,61,0,61,18,221,0,0,223,181,42,GOOOXXXXXXXXXXXXXXXXGOOOOOXXXXXXXXXXXXXXGOOOOOOXXXXXXXXXXXXXGOXXXXXXXXXXXXXXXXXXGOOOOOOOXXXXXXXXXXXXGXXXXXXXXXXXXXXXXXXXGOOOXXXXXXXXXXXXXXXXGOXXXXXXXXXXXXXXXXXXGOOOXXXXXXXXXXXXXXXXGOOOOOXXXXXXXXXXXXXXGOOXXXXXXXXXXXXXXXXXGOOOOOOXXXXXXXXXXXXXGOOOOOOXXXXXXXXXXXXX,0,300,0
17199,61,0,61,18,221,0,0,223,181,42,GOOOXXXXXXXXXXXXXXXXGOOOOOXXXXXXXXXXXXXXGOOOOOOXXXXXXXXXXXXXGOXXXXXXXXXXXXXXXXXXGOOOOOOOXXXXXXXXXXXXGXXXXXXXXXXXXXXXXXXXGOOOXXXXXXXXXXXXXXXXGOXXXXXXXXXXXXXXXXXXGOOOXXXXXXXXXXXXXXXXGOOOOOXXXXXXXXXXXXXXGOOXXXXXXXXXXXXXXXXXGOOOOOOXXXXXXXXXXXXXGOOOOOOXXXXXXXXXXXXX,0,300,0

17220,61,0,61,16,223,0,0,225,181,44,GOOOXXXXXXXXXXXXXXXXGOOOOOXXXXXXXXXXXXXXGOOOOOOXXXXXXXXXXXXXGOXXXXXXXXXXXXXXXXXXGOOOOOOOXXXXXXXXXXXXGXXXXXXXXXXXXXXXXXXXGOOOXXXXXXXXXXXXXXXXGOXXXXXXXXXXXXXXXXXXGOOOXXXXXXXXXXXXXXXXGOOOOOXXXXXXXXXXXXXXGOOXXXXXXXXXXXXXXXXXGOOOOOOXXXXXXXXXXXXXGOOOOOOXXXXXXXXXXXXX,0,300,0
17241,61,0,61,17,222,0,0,224,183,41,GOOOXXXXXXXXXXXXXXXXGOOOOOXXXXXXXXXXXXXXGOOOOOOXXXXXXXXXXXXXGOXXXXXXXXXXXXXXXXXXGOOOOOOOXXXXXXXXXXXXGXXXXXXXXXXXXXXXXXXXGOOOXXXXXXXXXXXXXXXXGOXXXXXXXXXXXXXXXXXXGOOOXXXXXXXXXXXXXXXXGOOOOOXXXXXXXXXXXXXXGOOXXXXXXXXXXXXXXXXXGOOOOOOXXXXXXXXXXXXXGOOOOOOXXXXXXXXXXXXX,0,300,0
17262,61,0,61,20,219,0,0,221,181,40,GOOOXXXXXXXXXXXXXXXXGOOOOOXXXXXXXXXXXXXXGOOOOOOXXXXXXXXXXXXXGOXXXXXXXXXXXXXXXXXXGOOOOOOOXXXXXXXXXXXXGXXXXXXXXXXXXXXXXXXXGOOOXXXXXXXXXXXXXXXXGOXXXXXXXXXXXXXXXXXXGOOOXXXXXXXXXXXXXXXXGOOOOOXXXXXXXXXXXXXXGOOXXXXXXXXXXXXXXXXXGOOOOOOXXXXXXXXXXXXXGOOOOOOXXXXXXXXXXXXX,0,300,0
17283,61,0,61,21,218,0,0,220,184,36,GOOOXXXXXXXXXXXXXXXXGOOOOOXXXXXXXXXXXXXXGOOOOOOXXXXXXXXXXXXXGOXXXXXXXXXXXXXXXXXXGOOOOOOOXXXXXXXXXXXXGXXXXXXXXXXXXXXXXXXXGOOOXXXXXXXXXXXXXXXXGOXXXXXXXXXXXXXXXXXXGOOOXXXXXXXXXXXXXXXXGOOOOOXXXXXXXXXXXXXXGOOXXXXXXXXXXXXXXXXXGOOOOOOXXXXXXXXXXXXXGOOOOOOXXXXXXXXXXXXX,0,300,0
17304,61,0,61,25,214,0,0,216,183,33,GOOOXXXXXXXXXXXXXXXXGOOOOOXXXXXXXXXXXXXXGOOOOOOXXXXXXXXXXXXXGOXXXXXXXXXXXXXXXXXXGOOOOOOOXXXXXXXXXXXXGXXXXXXXXXXXXXXXXXXXGOOOXXXXXXXXXXXXXXXXGOXXXXXXXXXXXXXXXXXXGOOOXXXXXXXXXXXXXXXXGOOOOOXXXXXXXXXXXXXXGOOXXXXXXXXXXXXXXXXXGOOOOOOXXXXXXXXXXXXXGOOOOOOXXXXXXXXXXXXX,0,300,0

17325,61,0,61,25,214,0,0,216,184,32,GOOOXXXXXXXXXXXXXXXXGOOOOOXXXXXXXXXXXXXXGOOOOOOXXXXXXXXXXXXXGOXXXXXXXXXXXXXXXXXXGOOOOOOOXXXXXXXXXXXXGXXXXXXXXXXXXXXXXXXXGOOOXXXXXXXXXXXXXXXXGOXXXXXXXXXXXXXXXXXXGOOOXXXXXXXXXXXXXXXXGOOOOOXXXXXXXXXXXXXXGOOXXXXXXXXXXXXXXXXXGOOOOOOXXXXXXXXXXXXXGOOOOOOXXXXXXXXXXXXX,0,300,0
17346,61,0,61,29,210,0,0,212,182,30,GOOOXXXXXXXXXXXXXXXXGOOOOOXXXXXXXXXXXXXXGOOOOOOXXXXXXXXXXXXXGOXXXXXXXXXXXXXXXXXXGOOOOOOOXXXXXXXXXXXXGXXXXXXXXXXXXXXXXXXXGOOOXXXXXXXXXXXXXXXXGOXXXXXXXXXXXXXXXXXXGOOOXXXXXXXXXXXXXXXXGOOOOOXXXXXXXXXXXXXXGOOXXXXXXXXXXXXXXXXXGOOOOOOXXXXXXXXXXXXXGOOOOOOXXXXXXXXXXXXX,0,300,0
17367,61,0,61,28,211,0,0,213,182,31,GOOOXXXXXXXXXXXXXXXXGOOOOOXXXXXXXXXXXXXXGOOOOOOXXXXXXXXXXXXXGOXXXXXXXXXXXXXXXXXXGOOOOOOOXXXXXXXXXXXXGXXXXXXXXXXXXXXXXXXXGOOOXXXXXXXXXXXXXXXXGOXXXXXXXXXXXXXXXXXXGOOOXXXXXXXXXXXXXXXXGOOOOOXXXXXXXXXXXXXXGOOXXXXXXXXXXXXXXXXXGOOOOOOXXXXXXXXXXXXXGOOOOOOXXXXXXXXXXXXX,0,300,0
17388,61,0,61,28,211,0,0,213,181,32,GOOOXXXXXXXXXXXXXXXXGOOOOOXXXXXXXXXXXXXXGOOOOOOXXXXXXXXXXXXXGOXXXXXXXXXXXXXXXXXXGOOOOOOOXXXXXXXXXXXXGXXXXXXXXXXXXXXXXXXXGOOOXXXXXXXXXXXXXXXXGOXXXXXXXXXXXXXXXXXXGOOOXXXXXXXXXXXXXXXXGOOOOOXXXXXXXXXXXXXXGOOXXXXXXXXXXXXXXXXXGOOOOOOXXXXXXXXXXXXXGOOOOOOXXXXXXXXXXXXX,0,300,0
17409,61,0,61,26,213,0,0,215,181,34,GOOOXXXXXXXXXXXXXXXXGOOOOOXXXXXXXXXXXXXXGOOOOOOXXXXXXXXXXXXXGOXXXXXXXXXXXXXXXXXXGOOOOOOOXXXXXXXXXXXXGXXXXXXXXXXXXXXXXXXXGOOOXXXXXXXXXXXXXXXXGOXXXXXXXXXXXXXXXXXXGOOOXXXXXXXXXXXXXXXXGOOOOOXXXXXXXXXXXXXXGOOXXXXXXXXXXXXXXXXXGOOOOOOXXXXXXXXXXXXXGOOOOOOXXXXXXXXXXXXX,0,300,0

17430,61,0,61,24,215,0,0,217,184,33,GOOOXXXXXXXXXXXXXXXXGOOOOOXXXXXXXXXXXXXXGOOOOOOXXXXXXXXXXXXXGOXXXXXXXXXXXXXXXXXXGOOOOOOOXXXXXXXXXXXXGXXXXXXXXXXXXXXXXXXXGOOOXXXXXXXXXXXXXXXXGOXXXXXXXXXXXXXXXXXXGOOOXXXXXXXXXXXXXXXXGOOOOOXXXXXXXXXXXXXXGOOXXXXXXXXXXXXXXXXXGOOOOOOXXXXXXXXXXXXXGOOOOOOXXXXXXXXXXXXX,0,300,0
17451,62,1,61,22,216,0,0,218,182,36,GOOOXXXXXXXXXXXXXXXXGOOOOOXXXXXXXXXXXXXXGOOOOOOAXXXXXXXXXXXXGOXXXXXXXXXXXXXXXXXXGOOOOOOOXXXXXXXXXXXXGXXXXXXXXXXXXXXXXXXXGOOOXXXXXXXXXXXXXXXXGOXXXXXXXXXXXXXXXXXXGOOOXXXXXXXXXXXXXXXXGOOOOOXXXXXXXXXXXXXXGOOXXXXXXXXXXXXXXXXXGOOOOOOXXXXXXXXXXXXXGOOOOOOXXXXXXXXXXXXX,0,300,0
17472,62,1,61,22,216,0,0,217,181,36,GOOOXXXXXXXXXXXXXXXXGOOOOOXXXXXXXXXXXXXXGOOOOOOAXXXXXXXXXXXXGOXXXXXXXXXXXXXXXXXXGOOOOOOOXXXXXXXXXXXXGXXXXXXXXXXXXXXXXXXXGOOOXXXXXXXXXXXXXXXXGOXXXXXXXXXXXXXXXXXXGOOOXXXXXXXXXXXXXXXXGOOOOOXXXXXXXXXXXXXXGOOXXXXXXXXXXXXXXXXXGOOOOOOXXXXXXXXXXXXXGOOOOOOXXXXXXXXXXXXX,0,300,0
17493,62,1,61,23,215,0,0,217,182,35,GOOOXXXXXXXXXXXXXXXXGOOOOOXXXXXXXXXXXXXXGOOOOOOAXXXXXXXXXXXXGOXXXXXXXXXXXXXXXXXXGOOOOOOOXXXXXXXXXXXXGXXXXXXXXXXXXXXXXXXXGOOOXXXXXXXXXXXXXXXXGOXXXXXXXXXXXXXXXXXXGOOOXXXXXXXXXXXXXXXXGOOOOOXXXXXXXXXXXXXXGOOXXXXXXXXXXXXXXXXXGOOOOOOXXXXXXXXXXXXXGOOOOOOXXXXXXXXXXXXX,0,300,0
17514,62,1,61,22,216,0,0,219,180,39,GOOOXXXXXXXXXXXXXXXXGOOOOOXXXXXXXXXXXXXXGOOOOOOAXXXXXXXXXXXXGOXXXXXXXXXXXXXXXXXXGOOOOOOOXXXXXXXXXXXXGXXXXXXXXXXXXXXXXXXXGOOOXXXXXXXXXXXXXXXXGOXXXXXXXXXXXXXXXXXXGOOOXXXXXXXXXXXXXXXXGOOOOOXXXXXXXXXXXXXXGOOXXXXXXXXXXXXXXXXXGOOOOOOXXXXXXXXXXXXXGOOOOOOXXXXXXXXXXXXX,0,300,0

17535,62,1,61,20,218,0,0,220,183,37,GOOOXXXXXXXXXXXXXXXXGOOOOOXXXXXXXXXXXXXXGOOOOOOAXXXXXXXXXXXXGOXXXXXXXXXXXXXXXXXXGOOOOOOOXXXXXXXXXXXXGXXXXXXXXXXXXXXXXXXXGOOOXXXXXXXXXXXXXXXXGOXXXXXXXXXXXXXXXXXXGOOOXXXXXXXXXXXXXXXXGOOOOOXXXXXXXXXXXXXXGOOXXXXXXXXXXXXXXXXXGOOOOOOXXXXXXXXXXXXXGOOOOOOXXXXXXXXXXXXX,0,300,0
17556,62,1,61,21,217,0,0,220,185,35,GOOOXXXXXXXXXXXXXXXXGOOOOOXXXXXXXXXXXXXXGOOOOOOAXXXXXXXXXXXXGOXXXXXXXXXXXXXXXXXXGOOOOOOOXXXXXXXXXXXXGXXXXXXXXXXXXXXXXXXXGOOOXXXXXXXXXXXXXXXXGOXXXXXXXXXXXXXXXXXXGOOOXXXXXXXXXXXXXXXXGOOOOOXXXXXXXXXXXXXXGOOXXXXXXXXXXXXXXXXXGOOOOOOXXXXXXXXXXXXXGOOOOOOXXXXXXXXXXXXX,0,300,0
17577,62,1,61,22,216,0,0,219,182,37,GOOOXXXXXXXXXXXXXXXXGOOOOOXXXXXXXXXXXXXXGOOOOOOAXXXXXXXXXXXXGOXXXXXXXXXXXXXXXXXXGOOOOOOOXXXXXXXXXXXXGXXXXXXXXXXXXXXXXXXXGOOOXXXXXXXXXXXXXXXXGOXXXXXXXXXXXXXXXXXXGOOOXXXXXXXXXXXXXXXXGOOOOOXXXXXXXXXXXXXXGOOXXXXXXXXXXXXXXXXXGOOOOOOXXXXXXXXXXXXXGOOOOOOXXXXXXXXXXXXX,0,300,0
17598,62,1,61,23,215,0,0,218,180,38,GOOOXXXXXXXXXXXXXXXXGOOOOOXXXXXXXXXXXXXXGOOOOOOAXXXXXXXXXXXXGOXXXXXXXXXXXXXXXXXXGOOOOOOOXXXXXXXXXXXXGXXXXXXXXXXXXXXXXXXXGOOOXXXXXXXXXXXXXXXXGOXXXXXXXXXXXXXXXXXXGOOOXXXXXXXXXXXXXXXXGOOOOOXXXXXXXXXXXXXXGOOXXXXXXXXXXXXXXXXXGOOOOOOXXXXXXXXXXXXXGOOOOOOXXXXXXXXXXXXX,0,300,0
17619,62,0,62,22,216,0,0,218,182,36,GOOOXXXXXXXXXXXXXXXXGOOOOOXXXXXXXXXXXXXXGOOOOOOOXXXXXXXXXXXXGOXXXXXXXXXXXXXXXXXXGOOOOOOOXXXXXXXXXXXXGXXXXXXXXXXXXXXXXXXXGOOOXXXXXXXXXXXXXXXXGOXXXXXXXXXXXXXXXXXXGOOOXXXXXXXXXXXXXXXXGOOOOOXXXXXXXXXXXXXXGOOXXXXXXXXXXXXXXXXXGOOOOOOXXXXXXXXXXXXXGOOOOOOXXXXXXXXXXXXX,0,300,0

17640,62,0,62,20,218,0,0,221,182,39,GOOOXXXXXXXXXXXXXXXXGOOOOOXXXXXXXXXXXXXXGOOOOOOOXXXXXXXXXXXXGOXXXXXXXXXXXXXXXXXXGOOOOOOOXXXXXXXXXXXXGXXXXXXXXXXXXXXXXXXXGOOOXXXXXXXXXXXXXXXXGOXXXXXXXXXXXXXXXXXXGOOOXXXXXXXXXXXXXXXXGOOOOOXXXXXXXXXXXXXXGOOXXXXXXXXXXXXXXXXXGOOOOOOXXXXXXXXXXXXXGOOOOOOXXXXXXXXXXXXX,0,300,0
17661,62,0,62,21,217,0,0,220,184,36,GOOOXXXXXXXXXXXXXXXXGOOOOOXXXXXXXXXXXXXXGOOOOOOOXXXXXXXXXXXXGOXXXXXXXXXXXXXXXXXXGOOOOOOOXXXXXXXXXXXXGXXXXXXXXXXXXXXXXXXXGOOOXXXXXXXXXXXXXXXXGOXXXXXXXXXXXXXXXXXXGOOOXXXXXXXXXXXXXXXXGOOOOOXXXXXXXXXXXXXXGOOXXXXXXXXXXXXXXXXXGOOOOOOXXXXXXXXXXXXXGOOOOOOXXXXXXXXXXXXX,0,300,0
17682,62,0,62,17,221,0,0,224,183,41,GOOOXXXXXXXXXXXXXXXXGOOOOOXXXXXXXXXXXXXXGOOOOOOOXXXXXXXXXXXXGOXXXXXXXXXXXXXXXXXXGOOOOOOOXXXXXXXXXXXXGXXXXXXXXXXXXXXXXXXXGOOOXXXXXXXXXXXXXXXXGOXXXXXXXXXXXXXXXXXXGOOOXXXXXXXXXXXXXXXXGOOOOOXXXXXXXXXXXXXXGOOXXXXXXXXXXXXXXXXXGOOOOOOXXXXXXXXXXXXXGOOOOOOXXXXXXXXXXXXX,0,300,0
17703,62,0,62,20,218,0,0,221,182,39,GOOOXXXXXXXXXXXXXXXXGOOOOOXXXXXXXXXXXXXXGOOOOOOOXXXXXXXXXXXXGOXXXXXXXXXXXXXXXXXXGOOOOOOOXXXXXXXXXXXXGXXXXXXXXXXXXXXXXXXXGOOOXXXXXXXXXXXXXXXXGOXXXXXXXXXXXXXXXXXXGOOOXXXXXXXXXXXXXXXXGOOOOOXXXXXXXXXXXXXXGOOXXXXXXXXXXXXXXXXXGOOOOOOXXXXXXXXXXXXXGOOOOOOXXXXXXXXXXXXX,0,300,0
17724,62,0,62,20,218,0,0,221,183,38,GOOOXXXXXXXXXXXXXXXXGOOOOOXXXXXXXXXXXXXXGOOOOOOOXXXXXXXXXXXXGOXXXXXXXXXXXXXXXXXXGOOOOOOOXXXXXXXXXXXXGXXXXXXXXXXXXXXXXXXXGOOOXXXXXXXXXXXXXXXXGOXXXXXXXXXXXXXXXXXXGOOOXXXXXXXXXXXXXXXXGOOOOOXXXXXXXXXXXXXXGOOXXXXXXXXXXXXXXXXXGOOOOOOXXXXXXXXXXXXXGOOOOOOXXXXXXXXXXXXX,0,300,0

17745,62,0,62,20,218,0,0,221,183,38,GOOOXXXXXXXXXXXXXXXXGOOOOOXXXXXXXXXXXXXXGOOOOOOOXXXXXXXXXXXXGOXXXXXXXXXXXXXXXXXXGOOOOOOOXXXXXXXXXXXXGXXXXXXXXXXXXXXXXXXXGOOOXXXXXXXXXXXXXXXXGOXXXXXXXXXXXXXXXXXXGOOOXXXXXXXXXXXXXXXXGOOOOOXXXXXXXXXXXXXXGOOXXXXXXXXXXXXXXXXXGOOOOOOXXXXXXXXXXXXXGOOOOOOXXXXXXXXXXXXX,0,300,0
17766,62,0,62,21,217,0,0,220,184,36,GOOOXXXXXXXXXXXXXXXXGOOOOOXXXXXXXXXXXXXXGOOOOOOOXXXXXXXXXXXXGOXXXXXXXXXXXXXXXXXXGOOOOOOOXXXXXXXXXXXXGXXXXXXXXXXXXXXXXXXXGOOOXXXXXXXXXXXXXXXXGOXXXXXXXXXXXXXXXXXXGOOOXXXXXXXXXXXXXXXXGOOOOOXXXXXXXXXXXXXXGOOXXXXXXXXXXXXXXXXXGOOOOOOXXXXXXXXXXXXXGOOOOOOXXXXXXXXXXXXX,0,300,0
17787,62,0,62,23,215,0,0,217,184,33,GOOOXXXXXXXXXXXXXXXXGOOOOOXXXXXXXXXXXXXXGOOOOOOOXXXXXXXXXXXXGOXXXXXXXXXXXXXXXXXXGOOOOOOOXXXXXXXXXXXXGXXXXXXXXXXXXXXXXXXXGOOOXXXXXXXXXXXXXXXXGOXXXXXXXXXXXXXXXXXXGOOOXXXXXXXXXXXXXXXXGOOOOOXXXXXXXXXXXXXXGOOXXXXXXXXXXXXXXXXXGOOOOOOXXXXXXXXXXXXXGOOOOOOXXXXXXXXXXXXX,0,300,0
17808,62,0,62,23,215,0,0,217,184,33,GOOOXXXXXXXXXXXXXXXXGOOOOOXXXXXXXXXXXXXXGOOOOOOOXXXXXXXXXXXXGOXXXXXXXXXXXXXXXXXXGOOOOOOOXXXXXXXXXXXXGXXXXXXXXXXXXXXXXXXXGOOOXXXXXXXXXXXXXXXXGOXXXXXXXXXXXXXXXXXXGOOOXXXXXXXXXXXXXXXXGOOOOOXXXXXXXXXXXXXXGOOXXXXXXXXXXXXXXXXXGOOOOOOXXXXXXXXXXXXXGOOOOOOXXXXXXXXXXXXX,0,300,0
17829,62,0,62,23,215,0,0,217,183,34,GOOOXXXXXXXXXXXXXXXXGOOOOOXXXXXXXXXXXXXXGOOOOOOOXXXXXXXXXXXXGOXXXXXXXXXXXXXXXXXXGOOOOOOOXXXXXXXXXXXXGXXXXXXXXXXXXXXXXXXXGOOOXXXXXXXXXXXXXXXXGOXXXXXXXXXXXXXXXXXXGOOOXXXXXXXXXXXXXXXXGOOOOOXXXXXXXXXXXXXXGOOXXXXXXXXXXXXXXXXXGOOOOOOXXXXXXXXXXXXXGOOOOOOXXXXXXXXXXXXX,0,300,0

17850,62,0,62,23,215,0,0,216,185,31,GOOOXXXXXXXXXXXXXXXXGOOOOOXXXXXXXXXXXXXXGOOOOOOOXXXXXXXXXXXXGOXXXXXXXXXXXXXXXXXXGOOOOOOOXXXXXXXXXXXXGXXXXXXXXXXXXXXXXXXXGOOOXXXXXXXXXXXXXXXXGOXXXXXXXXXXXXXXXXXXGOOOXXXXXXXXXXXXXXXXGOOOOOXXXXXXXXXXXXXXGOOXXXXXXXXXXXXXXXXXGOOOOOOXXXXXXXXXXXXXGOOOOOOXXXXXXXXXXXXX,0,300,0
17871,62,0,62,20,218,0,0,220,184,36,GOOOXXXXXXXXXXXXXXXXGOOOOOXXXXXXXXXXXXXXGOOOOOOOXXXXXXXXXXXXGOXXXXXXXXXXXXXXXXXXGOOOOOOOXXXXXXXXXXXXGXXXXXXXXXXXXXXXXXXXGOOOXXXXXXXXXXXXXXXXGOXXXXXXXXXXXXXXXXXXGOOOXXXXXXXXXXXXXXXXGOOOOOXXXXXXXXXXXXXXGOOXXXXXXXXXXXXXXXXXGOOOOOOXXXXXXXXXXXXXGOOOOOOXXXXXXXXXXXXX,0,300,0
17892,62,0,62,22,216,0,0,218,181,37,GOOOXXXXXXXXXXXXXXXXGOOOOOXXXXXXXXXXXXXXGOOOOOOOXXXXXXXXXXXXGOXXXXXXXXXXXXXXXXXXGOOOOOOOXXXXXXXXXXXXGXXXXXXXXXXXXXXXXXXXGOOOXXXXXXXXXXXXXXXXGOXXXXXXXXXXXXXXXXXXGOOOXXXXXXXXXXXXXXXXGOOOOOXXXXXXXXXXXXXXGOOXXXXXXXXXXXXXXXXXGOOOOOOXXXXXXXXXXXXXGOOOOOOXXXXXXXXXXXXX,0,300,0
17913,62,0,62,22,216,0,0,218,182,36,GOOOXXXXXXXXXXXXXXXXGOOOOOXXXXXXXXXXXXXXGOOOOOOOXXXXXXXXXXXXGOXXXXXXXXXXXXXXXXXXGOOOOOOOXXXXXXXXXXXXGXXXXXXXXXXXXXXXXXXXGOOOXXXXXXXXXXXXXXXXGOXXXXXXXXXXXXXXXXXXGOOOXXXXXXXXXXXXXXXXGOOOOOXXXXXXXXXXXXXXGOOXXXXXXXXXXXXXXXXXGOOOOOOXXXXXXXXXXXXXGOOOOOOXXXXXXXXXXXXX,0,300,0
17934,62,0,62,19,219,0,0,221,184,37,GOOOXXXXXXXXXXXXXXXXGOOOOOXXXXXXXXXXXXXXGOOOOOOOXXXXXXXXXXXXGOXXXXXXXXXXXXXXXXXXGOOOOOOOXXXXXXXXXXXXGXXXXXXXXXXXXXXXXXXXGOOOXXXXXXXXXXXXXXXXGOXXXXXXXXXXXXXXXXXXGOOOXXXXXXXXXXXXXXXXGOOOOOXXXXXXXXXXXXXXGOOXXXXXXXXXXXXXXXXXGOOOOOOXXXXXXXXXXXXXGOOOOOOXXXXXXXXXXXXX,0,300,0

17955,62,0,62,20,218,0,0,220,186,34,GOOOXXXXXXXXXXXXXXXXGOOOOOXXXXXXXXXXXXXXGOOOOOOOXXXXXXXXXXXXGOXXXXXXXXXXXXXXXXXXGOOOOOOOXXXXXXXXXXXXGXXXXXXXXXXXXXXXXXXXGOOOXXXXXXXXXXXXXXXXGOXXXXXXXXXXXXXXXXXXGOOOXXXXXXXXXXXXXXXXGOOOOOXXXXXXXXXXXXXXGOOXXXXXXXXXXXXXXXXXGOOOOOOXXXXXXXXXXXXXGOOOOOOXXXXXXXXXXXXX,0,300,0
17976,62,0,62,18,220,0,0,222,186,36,GOOOXXXXXXXXXXXXXXXXGOOOOOXXXXXXXXXXXXXXGOOOOOOOXXXXXXXXXXXXGOXXXXXXXXXXXXXXXXXXGOOOOOOOXXXXXXXXXXXXGXXXXXXXXXXXXXXXXXXXGOOOXXXXXXXXXXXXXXXXGOXXXXXXXXXXXXXXXXXXGOOOXXXXXXXXXXXXXXXXGOOOOOXXXXXXXXXXXXXXGOOXXXXXXXXXXXXXXXXXGOOOOOOXXXXXXXXXXXXXGOOOOOOXXXXXXXXXXXXX,0,300,0
17997,62,0,62,19,219,0,0,221,183,38,GOOOXXXXXXXXXXXXXXXXGOOOOOXXXXXXXXXXXXXXGOOOOOOOXXXXXXXXXXXXGOXXXXXXXXXXXXXXXXXXGOOOOOOOXXXXXXXXXXXXGXXXXXXXXXXXXXXXXXXXGOOOXXXXXXXXXXXXXXXXGOXXXXXXXXXXXXXXXXXXGOOOXXXXXXXXXXXXXXXXGOOOOOXXXXXXXXXXXXXXGOOXXXXXXXXXXXXXXXXXGOOOOOOXXXXXXXXXXXXXGOOOOOOXXXXXXXXXXXXX,0,300,0
18018,62,0,62,19,219,0,0,221,184,37,GOOOXXXXXXXXXXXXXXXXGOOOOOXXXXXXXXXXXXXXGOOOOOOOXXXXXXXXXXXXGOXXXXXXXXXXXXXXXXXXGOOOOOOOXXXXXXXXXXXXGXXXXXXXXXXXXXXXXXXXGOOOXXXXXXXXXXXXXXXXGOXXXXXXXXXXXXXXXXXXGOOOXXXXXXXXXXXXXXXXGOOOOOXXXXXXXXXXXXXXGOOXXXXXXXXXXXXXXXXXGOOOOOOXXXXXXXXXXXXXGOOOOOOXXXXXXXXXXXXX,0,300,0
18039,62,0,62,19,219,0,0,221,185,36,GOOOXXXXXXXXXXXXXXXXGOOOOOXXXXXXXXXXXXXXGOOOOOOOXXXXXXXXXXXXGOXXXXXXXXXXXXXXXXXXGOOOOOOOXXXXXXXXXXXXGXXXXXXXXXXXXXXXXXXXGOOOXXXXXXXXXXXXXXXXGOXXXXXXXXXXXXXXXXXXGOOOXXXXXXXXXXXXXXXXGOOOOOXXXXXXXXXXXXXXGOOXXXXXXXXXXXXXXXXXGOOOOOOXXXXXXXXXXXXXGOOOOOOXXXXXXXXXXXXX,0,300,0

18060,62,0,62,21,217,0,0,219,184,35,GOOOXXXXXXXXXXXXXXXXGOOOOOXXXXXXXXXXXXXXGOOOOOOOXXXXXXXXXXXXGOXXXXXXXXXXXXXXXXXXGOOOOOOOXXXXXXXXXXXXGXXXXXXXXXXXXXXXXXXXGOOOXXXXXXXXXXXXXXXXGOXXXXXXXXXXXXXXXXXXGOOOXXXXXXXXXXXXXXXXGOOOOOXXXXXXXXXXXXXXGOOXXXXXXXXXXXXXXXXXGOOOOOOXXXXXXXXXXXXXGOOOOOOXXXXXXXXXXXXX,0,300,0
18081,62,0,62,21,217,0,0,219,185,34,GOOOXXXXXXXXXXXXXXXXGOOOOOXXXXXXXXXXXXXXGOOOOOOOXXXXXXXXXXXXGOXXXXXXXXXXXXXXXXXXGOOOOOOOXXXXXXXXXXXXGXXXXXXXXXXXXXXXXXXXGOOOXXXXXXXXXXXXXXXXGOXXXXXXXXXXXXXXXXXXGOOOXXXXXXXXXXXXXXXXGOOOOOXXXXXXXXXXXXXXGOOXXXXXXXXXXXXXXXXXGOOOOOOXXXXXXXXXXXXXGOOOOOOXXXXXXXXXXXXX,0,300,0
18102,62,0,62,19,219,0,0,221,184,37,GOOOXXXXXXXXXXXXXXXXGOOOOOXXXXXXXXXXXXXXGOOOOOOOXXXXXXXXXXXXGOXXXXXXXXXXXXXXXXXXGOOOOOOOXXXXXXXXXXXXGXXXXXXXXXXXXXXXXXXXGOOOXXXXXXXXXXXXXXXXGOXXXXXXXXXXXXXXXXXXGOOOXXXXXXXXXXXXXXXXGOOOOOXXXXXXXXXXXXXXGOOXXXXXXXXXXXXXXXXXGOOOOOOXXXXXXXXXXXXXGOOOOOOXXXXXXXXXXXXX,0,300,0
18123,62,0,62,18,220,0,0,222,189,33,GOOOXXXXXXXXXXXXXXXXGOOOOOXXXXXXXXXXXXXXGOOOOOOOXXXXXXXXXXXXGOXXXXXXXXXXXXXXXXXXGOOOOOOOXXXXXXXXXXXXGXXXXXXXXXXXXXXXXXXXGOOOXXXXXXXXXXXXXXXXGOXXXXXXXXXXXXXXXXXXGOOOXXXXXXXXXXXXXXXXGOOOOOXXXXXXXXXXXXXXGOOXXXXXXXXXXXXXXXXXGOOOOOOXXXXXXXXXXXXXGOOOOOOXXXXXXXXXXXXX,0,300,0
18144,62,0,62,18,220,0,0,222,189,33,GOOOXXXXXXXXXXXXXXXXGOOOOOXXXXXXXXXXXXXXGOOOOOOOXXXXXXXXXXXXGOXXXXXXXXXXXXXXXXXXGOOOOOOOXXXXXXXXXXXXGXXXXXXXXXXXXXXXXXXXGOOOXXXXXXXXXXXXXXXXGOXXXXXXXXXXXXXXXXXXGOOOXXXXXXXXXXXXXXXXGOOOOOXXXXXXXXXXXXXXGOOXXXXXXXXXXXXXXXXXGOOOOOOXXXXXXXXXXXXXGOOOOOOXXXXXXXXXXXXX,0,300,0

18165,62,0,62,20,218,0,0,220,189,31,GOOOXXXXXXXXXXXXXXXXGOOOOOXXXXXXXXXXXXXXGOOOOOOOXXXXXXXXXXXXGOXXXXXXXXXXXXXXXXXXGOOOOOOOXXXXXXXXXXXXGXXXXXXXXXXXXXXXXXXXGOOOXXXXXXXXXXXXXXXXGOXXXXXXXXXXXXXXXXXXGOOOXXXXXXXXXXXXXXXXGOOOOOXXXXXXXXXXXXXXGOOXXXXXXXXXXXXXXXXXGOOOOOOXXXXXXXXXXXXXGOOOOOOXXXXXXXXXXXXX,0,300,0
18186,62,0,62,22,216,0,0,218,188,30,GOOOXXXXXXXXXXXXXXXXGOOOOOXXXXXXXXXXXXXXGOOOOOOOXXXXXXXXXXXXGOXXXXXXXXXXXXXXXXXXGOOOOOOOXXXXXXXXXXXXGXXXXXXXXXXXXXXXXXXXGOOOXXXXXXXXXXXXXXXXGOXXXXXXXXXXXXXXXXXXGOOOXXXXXXXXXXXXXXXXGOOOOOXXXXXXXXXXXXXXGOOXXXXXXXXXXXXXXXXXGOOOOOOXXXXXXXXXXXXXGOOOOOOXXXXXXXXXXXXX,0,300,0
18207,62,0,62,25,213,0,0,215,183,32,GOOOXXXXXXXXXXXXXXXXGOOOOOXXXXXXXXXXXXXXGOOOOOOOXXXXXXXXXXXXGOXXXXXXXXXXXXXXXXXXGOOOOOOOXXXXXXXXXXXXGXXXXXXXXXXXXXXXXXXXGOOOXXXXXXXXXXXXXXXXGOXXXXXXXXXXXXXXXXXXGOOOXXXXXXXXXXXXXXXXGOOOOOXXXXXXXXXXXXXXGOOXXXXXXXXXXXXXXXXXGOOOOOOXXXXXXXXXXXXXGOOOOOOXXXXXXXXXXXXX,0,300,0
18228,62,0,62,26,212,0,0,214,186,28,GOOOXXXXXXXXXXXXXXXXGOOOOOXXXXXXXXXXXXXXGOOOOOOOXXXXXXXXXXXXGOXXXXXXXXXXXXXXXXXXGOOOOOOOXXXXXXXXXXXXGXXXXXXXXXXXXXXXXXXXGOOOXXXXXXXXXXXXXXXXGOXXXXXXXXXXXXXXXXXXGOOOXXXXXXXXXXXXXXXXGOOOOOXXXXXXXXXXXXXXGOOXXXXXXXXXXXXXXXXXGOOOOOOXXXXXXXXXXXXXGOOOOOOXXXXXXXXXXXXX,0,300,0
18249,62,0,62,23,215,0,0,217,185,32,GOOOXXXXXXXXXXXXXXXXGOOOOOXXXXXXXXXXXXXXGOOOOOOOXXXXXXXXXXXXGOXXXXXXXXXXXXXXXXXXGOOOOOOOXXXXXXXXXXXXGXXXXXXXXXXXXXXXXXXXGOOOXXXXXXXXXXXXXXXXGOXXXXXXXXXXXXXXXXXXGOOOXXXXXXXXXXXXXXXXGOOOOOXXXXXXXXXXXXXXGOOXXXXXXXXXXXXXXXXXGOOOOOOXXXXXXXXXXXXXGOOOOOOXXXXXXXXXXXXX,0,300,0

18270,62,0,62,24,214,0,0,216,187,29,GOOOXXXXXXXXXXXXXXXXGOOOOOXXXXXXXXXXXXXXGOOOOOOOXXXXXXXXXXXXGOXXXXXXXXXXXXXXXXXXGOOOOOOOXXXXXXXXXXXXGXXXXXXXXXXXXXXXXXXXGOOOXXXXXXXXXXXXXXXXGOXXXXXXXXXXXXXXXXXXGOOOXXXXXXXXXXXXXXXXGOOOOOXXXXXXXXXXXXXXGOOXXXXXXXXXXXXXXXXXGOOOOOOXXXXXXXXXXXXXGOOOOOOXXXXXXXXXXXXX,0,300,0
18291,62,0,62,25,213,0,0,216,185,31,GOOOXXXXXXXXXXXXXXXXGOOOOOXXXXXXXXXXXXXXGOOOOOOOXXXXXXXXXXXXGOXXXXXXXXXXXXXXXXXXGOOOOOOOXXXXXXXXXXXXGXXXXXXXXXXXXXXXXXXXGOOOXXXXXXXXXXXXXXXXGOXXXXXXXXXXXXXXXXXXGOOOXXXXXXXXXXXXXXXXGOOOOOXXXXXXXXXXXXXXGOOXXXXXXXXXXXXXXXXXGOOOOOOXXXXXXXXXXXXXGOOOOOOXXXXXXXXXXXXX,0,300,0
18312,62,0,62,24,214,0,0,217,183,34,GOOOXXXXXXXXXXXXXXXXGOOOOOXXXXXXXXXXXXXXGOOOOOOOXXXXXXXXXXXXGOXXXXXXXXXXXXXXXXXXGOOOOOOOXXXXXXXXXXXXGXXXXXXXXXXXXXXXXXXXGOOOXXXXXXXXXXXXXXXXGOXXXXXXXXXXXXXXXXXXGOOOXXXXXXXXXXXXXXXXGOOOOOXXXXXXXXXXXXXXGOOXXXXXXXXXXXXXXXXXGOOOOOOXXXXXXXXXXXXXGOOOOOOXXXXXXXXXXXXX,0,300,0
18333,62,0,62,19,219,0,0,221,184,37,GOOOXXXXXXXXXXXXXXXXGOOOOOXXXXXXXXXXXXXXGOOOOOOOXXXXXXXXXXXXGOXXXXXXXXXXXXXXXXXXGOOOOOOOXXXXXXXXXXXXGXXXXXXXXXXXXXXXXXXXGOOOXXXXXXXXXXXXXXXXGOXXXXXXXXXXXXXXXXXXGOOOXXXXXXXXXXXXXXXXGOOOOOXXXXXXXXXXXXXXGOOXXXXXXXXXXXXXXXXXGOOOOOOXXXXXXXXXXXXXGOOOOOOXXXXXXXXXXXXX,0,300,0
18354,62,0,62,17,221,0,0,222,184,38,GOOOXXXXXXXXXXXXXXXXGOOOOOXXXXXXXXXXXXXXGOOOOOOOXXXXXXXXXXXXGOXXXXXXXXXXXXXXXXXXGOOOOOOOXXXXXXXXXXXXGXXXXXXXXXXXXXXXXXXXGOOOXXXXXXXXXXXXXXXXGOXXXXXXXXXXXXXXXXXXGOOOXXXXXXXXXXXXXXXXGOOOOOXXXXXXXXXXXXXXGOOXXXXXXXXXXXXXXXXXGOOOOOOXXXXXXXXXXXXXGOOOOOOXXXXXXXXXXXXX,0,300,0

18375,62,0,62,15,223,0,0,225,186,39,GOOOXXXXXXXXXXXXXXXXGOOOOOXXXXXXXXXXXXXXGOOOOOOOXXXXXXXXXXXXGOXXXXXXXXXXXXXXXXXXGOOOOOOOXXXXXXXXXXXXGXXXXXXXXXXXXXXXXXXXGOOOXXXXXXXXXXXXXXXXGOXXXXXXXXXXXXXXXXXXGOOOXXXXXXXXXXXXXXXXGOOOOOXXXXXXXXXXXXXXGOOXXXXXXXXXXXXXXXXXGOOOOOOXXXXXXXXXXXXXGOOOOOOXXXXXXXXXXXXX,0,300,0
18396,62,0,62,19,219,0,0,221,184,37,GOOOXXXXXXXXXXXXXXXXGOOOOOXXXXXXXXXXXXXXGOOOOOOOXXXXXXXXXXXXGOXXXXXXXXXXXXXXXXXXGOOOOOOOXXXXXXXXXXXXGXXXXXXXXXXXXXXXXXXXGOOOXXXXXXXXXXXXXXXXGOXXXXXXXXXXXXXXXXXXGOOOXXXXXXXXXXXXXXXXGOOOOOXXXXXXXXXXXXXXGOOXXXXXXXXXXXXXXXXXGOOOOOOXXXXXXXXXXXXXGOOOOOOXXXXXXXXXXXXX,0,300,0
18417,62,0,62,19,219,0,0,221,185,36,GOOOXXXXXXXXXXXXXXXXGOOOOOXXXXXXXXXXXXXXGOOOOOOOXXXXXXXXXXXXGOXXXXXXXXXXXXXXXXXXGOOOOOOOXXXXXXXXXXXXGXXXXXXXXXXXXXXXXXXXGOOOXXXXXXXXXXXXXXXXGOXXXXXXXXXXXXXXXXXXGOOOXXXXXXXXXXXXXXXXGOOOOOXXXXXXXXXXXXXXGOOXXXXXXXXXXXXXXXXXGOOOOOOXXXXXXXXXXXXXGOOOOOOXXXXXXXXXXXXX,0,300,0
18438,62,0,62,21,217,0,0,219,185,34,GOOOXXXXXXXXXXXXXXXXGOOOOOXXXXXXXXXXXXXXGOOOOOOOXXXXXXXXXXXXGOXXXXXXXXXXXXXXXXXXGOOOOOOOXXXXXXXXXXXXGXXXXXXXXXXXXXXXXXXXGOOOXXXXXXXXXXXXXXXXGOXXXXXXXXXXXXXXXXXXGOOOXXXXXXXXXXXXXXXXGOOOOOXXXXXXXXXXXXXXGOOXXXXXXXXXXXXXXXXXGOOOOOOXXXXXXXXXXXXXGOOOOOOXXXXXXXXXXXXX,0,300,0
18459,62,0,62,22,216,0,0,218,187,31,GOOOXXXXXXXXXXXXXXXXGOOOOOXXXXXXXXXXXXXXGOOOOOOOXXXXXXXXXXXXGOXXXXXXXXXXXXXXXXXXGOOOOOOOXXXXXXXXXXXXGXXXXXXXXXXXXXXXXXXXGOOOXXXXXXXXXXXXXXXXGOXXXXXXXXXXXXXXXXXXGOOOXXXXXXXXXXXXXXXXGOOOOOXXXXXXXXXXXXXXGOOXXXXXXXXXXXXXXXXXGOOOOOOXXXXXXXXXXXXXGOOOOOOXXXXXXXXXXXXX,0,300,0

18480,62,0,62,23,215,0,0,217,186,31,GOOOXXXXXXXXXXXXXXXXGOOOOOXXXXXXXXXXXXXXGOOOOOOOXXXXXXXXXXXXGOXXXXXXXXXXXXXXXXXXGOOOOOOOXXXXXXXXXXXXGXXXXXXXXXXXXXXXXXXXGOOOXXXXXXXXXXXXXXXXGOXXXXXXXXXXXXXXXXXXGOOOXXXXXXXXXXXXXXXXGOOOOOXXXXXXXXXXXXXXGOOXXXXXXXXXXXXXXXXXGOOOOOOXXXXXXXXXXXXXGOOOOOOXXXXXXXXXXXXX,0,300,0
18501,62,0,62,25,213,0,0,215,184,31,GOOOXXXXXXXXXXXXXXXXGOOOOOXXXXXXXXXXXXXXGOOOOOOOXXXXXXXXXXXXGOXXXXXXXXXXXXXXXXXXGOOOOOOOXXXXXXXXXXXXGXXXXXXXXXXXXXXXXXXXGOOOXXXXXXXXXXXXXXXXGOXXXXXXXXXXXXXXXXXXGOOOXXXXXXXXXXXXXXXXGOOOOOXXXXXXXXXXXXXXGOOXXXXXXXXXXXXXXXXXGOOOOOOXXXXXXXXXXXXXGOOOOOOXXXXXXXXXXXXX,0,300,0
18522,62,0,62,22,216,0,0,217,185,32,GOOOXXXXXXXXXXXXXXXXGOOOOOXXXXXXXXXXXXXXGOOOOOOOXXXXXXXXXXXXGOXXXXXXXXXXXXXXXXXXGOOOOOOOXXXXXXXXXXXXGXXXXXXXXXXXXXXXXXXXGOOOXXXXXXXXXXXXXXXXGOXXXXXXXXXXXXXXXXXXGOOOXXXXXXXXXXXXXXXXGOOOOOXXXXXXXXXXXXXXGOOXXXXXXXXXXXXXXXXXGOOOOOOXXXXXXXXXXXXXGOOOOOOXXXXXXXXXXXXX,0,300,0
18543,62,0,62,22,216,0,0,218,185,33,GOOOXXXXXXXXXXXXXXXXGOOOOOXXXXXXXXXXXXXXGOOOOOOOXXXXXXXXXXXXGOXXXXXXXXXXXXXXXXXXGOOOOOOOXXXXXXXXXXXXGXXXXXXXXXXXXXXXXXXXGOOOXXXXXXXXXXXXXXXXGOXXXXXXXXXXXXXXXXXXGOOOXXXXXXXXXXXXXXXXGOOOOOXXXXXXXXXXXXXXGOOXXXXXXXXXXXXXXXXXGOOOOOOXXXXXXXXXXXXXGOOOOOOXXXXXXXXXXXXX,0,300,0
18564,62,0,62,21,217,0,0,219,187,32,GOOOXXXXXXXXXXXXXXXXGOOOOOXXXXXXXXXXXXXXGOOOOOOOXXXXXXXXXXXXGOXXXXXXXXXXXXXXXXXXGOOOOOOOXXXXXXXXXXXXGXXXXXXXXXXXXXXXXXXXGOOOXXXXXXXXXXXXXXXXGOXXXXXXXXXXXXXXXXXXGOOOXXXXXXXXXXXXXXXXGOOOOOXXXXXXXXXXXXXXGOOXXXXXXXXXXXXXXXXXGOOOOOOXXXXXXXXXXXXXGOOOOOOXXXXXXXXXXXXX,0,300,0

18585,62,0,62,19,219,0,0,221,189,32,GOOOXXXXXXXXXXXXXXXXGOOOOOXXXXXXXXXXXXXXGOOOOOOOXXXXXXXXXXXXGOXXXXXXXXXXXXXXXXXXGOOOOOOOXXXXXXXXXXXXGXXXXXXXXXXXXXXXXXXXGOOOXXXXXXXXXXXXXXXXGOXXXXXXXXXXXXXXXXXXGOOOXXXXXXXXXXXXXXXXGOOOOOXXXXXXXXXXXXXXGOOXXXXXXXXXXXXXXXXXGOOOOOOXXXXXXXXXXXXXGOOOOOOXXXXXXXXXXXXX,0,300,0
18606,62,0,62,17,221,0,0,222,187,35,GOOOXXXXXXXXXXXXXXXXGOOOOOXXXXXXXXXXXXXXGOOOOOOOXXXXXXXXXXXXGOXXXXXXXXXXXXXXXXXXGOOOOOOOXXXXXXXXXXXXGXXXXXXXXXXXXXXXXXXXGOOOXXXXXXXXXXXXXXXXGOXXXXXXXXXXXXXXXXXXGOOOXXXXXXXXXXXXXXXXGOOOOOXXXXXXXXXXXXXXGOOXXXXXXXXXXXXXXXXXGOOOOOOXXXXXXXXXXXXXGOOOOOOXXXXXXXXXXXXX,0,300,0
18627,62,0,62,17,221,0,0,222,186,36,GOOOXXXXXXXXXXXXXXXXGOOOOOXXXXXXXXXXXXXXGOOOOOOOXXXXXXXXXXXXGOXXXXXXXXXXXXXXXXXXGOOOOOOOXXXXXXXXXXXXGXXXXXXXXXXXXXXXXXXXGOOOXXXXXXXXXXXXXXXXGOXXXXXXXXXXXXXXXXXXGOOOXXXXXXXXXXXXXXXXGOOOOOXXXXXXXXXXXXXXGOOXXXXXXXXXXXXXXXXXGOOOOOOXXXXXXXXXXXXXGOOOOOOXXXXXXXXXXXXX,0,300,0
18648,62,0,62,17,221,0,0,223,187,36,GOOOXXXXXXXXXXXXXXXXGOOOOOXXXXXXXXXXXXXXGOOOOOOOXXXXXXXXXXXXGOXXXXXXXXXXXXXXXXXXGOOOOOOOXXXXXXXXXXXXGXXXXXXXXXXXXXXXXXXXGOOOXXXXXXXXXXXXXXXXGOXXXXXXXXXXXXXXXXXXGOOOXXXXXXXXXXXXXXXXGOOOOOXXXXXXXXXXXXXXGOOXXXXXXXXXXXXXXXXXGOOOOOOXXXXXXXXXXXXXGOOOOOOXXXXXXXXXXXXX,0,300,0
18669,62,0,62,19,219,0,0,221,186,35,GOOOXXXXXXXXXXXXXXXXGOOOOOXXXXXXXXXXXXXXGOOOOOOOXXXXXXXXXXXXGOXXXXXXXXXXXXXXXXXXGOOOOOOOXXXXXXXXXXXXGXXXXXXXXXXXXXXXXXXXGOOOXXXXXXXXXXXXXXXXGOXXXXXXXXXXXXXXXXXXGOOOXXXXXXXXXXXXXXXXGOOOOOXXXXXXXXXXXXXXGOOXXXXXXXXXXXXXXXXXGOOOOOOXXXXXXXXXXXXXGOOOOOOXXXXXXXXXXXXX,0,300,0

18690,62,0,62,19,219,0,0,221,186,35,GOOOXXXXXXXXXXXXXXXXGOOOOOXXXXXXXXXXXXXXGOOOOOOOXXXXXXXXXXXXGOXXXXXXXXXXXXXXXXXXGOOOOOOOXXXXXXXXXXXXGXXXXXXXXXXXXXXXXXXXGOOOXXXXXXXXXXXXXXXXGOXXXXXXXXXXXXXXXXXXGOOOXXXXXXXXXXXXXXXXGOOOOOXXXXXXXXXXXXXXGOOXXXXXXXXXXXXXXXXXGOOOOOOXXXXXXXXXXXXXGOOOOOOXXXXXXXXXXXXX,0,300,0
18711,62,0,62,17,221,0,0,223,186,37,GOOOXXXXXXXXXXXXXXXXGOOOOOXXXXXXXXXXXXXXGOOOOOOOXXXXXXXXXXXXGOXXXXXXXXXXXXXXXXXXGOOOOOOOXXXXXXXXXXXXGXXXXXXXXXXXXXXXXXXXGOOOXXXXXXXXXXXXXXXXGOXXXXXXXXXXXXXXXXXXGOOOXXXXXXXXXXXXXXXXGOOOOOXXXXXXXXXXXXXXGOOXXXXXXXXXXXXXXXXXGOOOOOOXXXXXXXXXXXXXGOOOOOOXXXXXXXXXXXXX,0,300,0
18732,62,0,62,17,221,0,0,223,186,37,GOOOXXXXXXXXXXXXXXXXGOOOOOXXXXXXXXXXXXXXGOOOOOOOXXXXXXXXXXXXGOXXXXXXXXXXXXXXXXXXGOOOOOOOXXXXXXXXXXXXGXXXXXXXXXXXXXXXXXXXGOOOXXXXXXXXXXXXXXXXGOXXXXXXXXXXXXXXXXXXGOOOXXXXXXXXXXXXXXXXGOOOOOXXXXXXXXXXXXXXGOOXXXXXXXXXXXXXXXXXGOOOOOOXXXXXXXXXXXXXGOOOOOOXXXXXXXXXXXXX,0,300,0
18753,62,0,62,18,220,0,0,223,185,38,GOOOXXXXXXXXXXXXXXXXGOOOOOXXXXXXXXXXXXXXGOOOOOOOXXXXXXXXXXXXGOXXXXXXXXXXXXXXXXXXGOOOOOOOXXXXXXXXXXXXGXXXXXXXXXXXXXXXXXXXGOOOXXXXXXXXXXXXXXXXGOXXXXXXXXXXXXXXXXXXGOOOXXXXXXXXXXXXXXXXGOOOOOXXXXXXXXXXXXXXGOOXXXXXXXXXXXXXXXXXGOOOOOOXXXXXXXXXXXXXGOOOOOOXXXXXXXXXXXXX,0,300,0
18774,62,0,62,17,221,0,0,223,188,35,GOOOXXXXXXXXXXXXXXXXGOOOOOXXXXXXXXXXXXXXGOOOOOOOXXXXXXXXXXXXGOXXXXXXXXXXXXXXXXXXGOOOOOOOXXXXXXXXXXXXGXXXXXXXXXXXXXXXXXXXGOOOXXXXXXXXXXXXXXXXGOXXXXXXXXXXXXXXXXXXGOOOXXXXXXXXXXXXXXXXGOOOOOXXXXXXXXXXXXXXGOOXXXXXXXXXXXXXXXXXGOOOOOOXXXXXXXXXXXXXGOOOOOOXXXXXXXXXXXXX,0,300,0

18795,62,0,62,18,220,0,0,222,186,36,GOOOXXXXXXXXXXXXXXXXGOOOOOXXXXXXXXXXXXXXGOOOOOOOXXXXXXXXXXXXGOXXXXXXXXXXXXXXXXXXGOOOOOOOXXXXXXXXXXXXGXXXXXXXXXXXXXXXXXXXGOOOXXXXXXXXXXXXXXXXGOXXXXXXXXXXXXXXXXXXGOOOXXXXXXXXXXXXXXXXGOOOOOXXXXXXXXXXXXXXGOOXXXXXXXXXXXXXXXXXGOOOOOOXXXXXXXXXXXXXGOOOOOOXXXXXXXXXXXXX,0,300,0
18816,62,0,62,16,222,0,0,224,189,35,GOOOXXXXXXXXXXXXXXXXGOOOOOXXXXXXXXXXXXXXGOOOOOOOXXXXXXXXXXXXGOXXXXXXXXXXXXXXXXXXGOOOOOOOXXXXXXXXXXXXGXXXXXXXXXXXXXXXXXXXGOOOXXXXXXXXXXXXXXXXGOXXXXXXXXXXXXXXXXXXGOOOXXXXXXXXXXXXXXXXGOOOOOXXXXXXXXXXXXXXGOOXXXXXXXXXXXXXXXXXGOOOOOOXXXXXXXXXXXXXGOOOOOOXXXXXXXXXXXXX,0,300,0
18837,62,0,62,18,220,0,0,222,187,35,GOOOXXXXXXXXXXXXXXXXGOOOOOXXXXXXXXXXXXXXGOOOOOOOXXXXXXXXXXXXGOXXXXXXXXXXXXXXXXXXGOOOOOOOXXXXXXXXXXXXGXXXXXXXXXXXXXXXXXXXGOOOXXXXXXXXXXXXXXXXGOXXXXXXXXXXXXXXXXXXGOOOXXXXXXXXXXXXXXXXGOOOOOXXXXXXXXXXXXXXGOOXXXXXXXXXXXXXXXXXGOOOOOOXXXXXXXXXXXXXGOOOOOOXXXXXXXXXXXXX,0,300,0
18858,62,0,62,19,219,0,0,221,185,36,GOOOXXXXXXXXXXXXXXXXGOOOOOXXXXXXXXXXXXXXGOOOOOOOXXXXXXXXXXXXGOXXXXXXXXXXXXXXXXXXGOOOOOOOXXXXXXXXXXXXGXXXXXXXXXXXXXXXXXXXGOOOXXXXXXXXXXXXXXXXGOXXXXXXXXXXXXXXXXXXGOOOXXXXXXXXXXXXXXXXGOOOOOXXXXXXXXXXXXXXGOOXXXXXXXXXXXXXXXXXGOOOOOOXXXXXXXXXXXXXGOOOOOOXXXXXXXXXXXXX,0,300,0
18879,62,0,62,18,220,0,0,222,185,37,GOOOXXXXXXXXXXXXXXXXGOOOOOXXXXXXXXXXXXXXGOOOOOOOXXXXXXXXXXXXGOXXXXXXXXXXXXXXXXXXGOOOOOOOXXXXXXXXXXXXGXXXXXXXXXXXXXXXXXXXGOOOXXXXXXXXXXXXXXXXGOXXXXXXXXXXXXXXXXXXGOOOXXXXXXXXXXXXXXXXGOOOOOXXXXXXXXXXXXXXGOOXXXXXXXXXXXXXXXXXGOOOOOOXXXXXXXXXXXXXGOOOOOOXXXXXXXXXXXXX,0,300,0

18900,62,0,62,17,221,0,0,223,186,37,GOOOXXXXXXXXXXXXXXXXGOOOOOXXXXXXXXXXXXXXGOOOOOOOXXXXXXXXXXXXGOXXXXXXXXXXXXXXXXXXGOOOOOOOXXXXXXXXXXXXGXXXXXXXXXXXXXXXXXXXGOOOXXXXXXXXXXXXXXXXGOXXXXXXXXXXXXXXXXXXGOOOXXXXXXXXXXXXXXXXGOOOOOXXXXXXXXXXXXXXGOOXXXXXXXXXXXXXXXXXGOOOOOOXXXXXXXXXXXXXGOOOOOOXXXXXXXXXXXXX,0,300,0
18921,62,0,62,18,220,0,0,222,188,34,GOOOXXXXXXXXXXXXXXXXGOOOOOXXXXXXXXXXXXXXGOOOOOOOXXXXXXXXXXXXGOXXXXXXXXXXXXXXXXXXGOOOOOOOXXXXXXXXXXXXGXXXXXXXXXXXXXXXXXXXGOOOXXXXXXXXXXXXXXXXGOXXXXXXXXXXXXXXXXXXGOOOXXXXXXXXXXXXXXXXGOOOOOXXXXXXXXXXXXXXGOOXXXXXXXXXXXXXXXXXGOOOOOOXXXXXXXXXXXXXGOOOOOOXXXXXXXXXXXXX,0,300,0
18942,62,0,62,18,220,0,0,222,187,35,GOOOXXXXXXXXXXXXXXXXGOOOOOXXXXXXXXXXXXXXGOOOOOOOXXXXXXXXXXXXGOXXXXXXXXXXXXXXXXXXGOOOOOOOXXXXXXXXXXXXGXXXXXXXXXXXXXXXXXXXGOOOXXXXXXXXXXXXXXXXGOXXXXXXXXXXXXXXXXXXGOOOXXXXXXXXXXXXXXXXGOOOOOXXXXXXXXXXXXXXGOOXXXXXXXXXXXXXXXXXGOOOOOOXXXXXXXXXXXXXGOOOOOOXXXXXXXXXXXXX,0,300,0
18963,62,0,62,17,221,0,0,223,187,36,GOOOXXXXXXXXXXXXXXXXGOOOOOXXXXXXXXXXXXXXGOOOOOOOXXXXXXXXXXXXGOXXXXXXXXXXXXXXXXXXGOOOOOOOXXXXXXXXXXXXGXXXXXXXXXXXXXXXXXXXGOOOXXXXXXXXXXXXXXXXGOXXXXXXXXXXXXXXXXXXGOOOXXXXXXXXXXXXXXXXGOOOOOXXXXXXXXXXXXXXGOOXXXXXXXXXXXXXXXXXGOOOOOOXXXXXXXXXXXXXGOOOOOOXXXXXXXXXXXXX,0,300,0
18984,62,0,62,14,224,0,0,226,188,38,GOOOXXXXXXXXXXXXXXXXGOOOOOXXXXXXXXXXXXXXGOOOOOOOXXXXXXXXXXXXGOXXXXXXXXXXXXXXXXXXGOOOOOOOXXXXXXXXXXXXGXXXXXXXXXXXXXXXXXXXGOOOXXXXXXXXXXXXXXXXGOXXXXXXXXXXXXXXXXXXGOOOXXXXXXXXXXXXXXXXGOOOOOXXXXXXXXXXXXXXGOOXXXXXXXXXXXXXXXXXGOOOOOOXXXXXXXXXXXXXGOOOOOOXXXXXXXXXXXXX,0,300,0

19005,62,0,62,14,224,0,0,226,190,36,GOOOXXXXXXXXXXXXXXXXGOOOOOXXXXXXXXXXXXXXGOOOOOOOXXXXXXXXXXXXGOXXXXXXXXXXXXXXXXXXGOOOOOOOXXXXXXXXXXXXGXXXXXXXXXXXXXXXXXXXGOOOXXXXXXXXXXXXXXXXGOXXXXXXXXXXXXXXXXXXGOOOXXXXXXXXXXXXXXXXGOOOOOXXXXXXXXXXXXXXGOOXXXXXXXXXXXXXXXXXGOOOOOOXXXXXXXXXXXXXGOOOOOOXXXXXXXXXXXXX,0,300,0
19026,62,0,62,17,221,0,0,223,188,35,GOOOXXXXXXXXXXXXXXXXGOOOOOXXXXXXXXXXXXXXGOOOOOOOXXXXXXXXXXXXGOXXXXXXXXXXXXXXXXXXGOOOOOOOXXXXXXXXXXXXGXXXXXXXXXXXXXXXXXXXGOOOXXXXXXXXXXXXXXXXGOXXXXXXXXXXXXXXXXXXGOOOXXXXXXXXXXXXXXXXGOOOOOXXXXXXXXXXXXXXGOOXXXXXXXXXXXXXXXXXGOOOOOOXXXXXXXXXXXXXGOOOOOOXXXXXXXXXXXXX,0,300,0
19047,62,0,62,14,224,0,0,226,187,39,GOOOXXXXXXXXXXXXXXXXGOOOOOXXXXXXXXXXXXXXGOOOOOOOXXXXXXXXXXXXGOXXXXXXXXXXXXXXXXXXGOOOOOOOXXXXXXXXXXXXGXXXXXXXXXXXXXXXXXXXGOOOXXXXXXXXXXXXXXXXGOXXXXXXXXXXXXXXXXXXGOOOXXXXXXXXXXXXXXXXGOOOOOXXXXXXXXXXXXXXGOOXXXXXXXXXXXXXXXXXGOOOOOOXXXXXXXXXXXXXGOOOOOOXXXXXXXXXXXXX,0,300,0
19068,62,0,62,14,224,0,0,226,189,37,GOOOXXXXXXXXXXXXXXXXGOOOOOXXXXXXXXXXXXXXGOOOOOOOXXXXXXXXXXXXGOXXXXXXXXXXXXXXXXXXGOOOOOOOXXXXXXXXXXXXGXXXXXXXXXXXXXXXXXXXGOOOXXXXXXXXXXXXXXXXGOXXXXXXXXXXXXXXXXXXGOOOXXXXXXXXXXXXXXXXGOOOOOXXXXXXXXXXXXXXGOOXXXXXXXXXXXXXXXXXGOOOOOOXXXXXXXXXXXXXGOOOOOOXXXXXXXXXXXXX,0,300,0
19089,62,0,62,15,223,0,0,225,187,38,GOOOXXXXXXXXXXXXXXXXGOOOOOXXXXXXXXXXXXXXGOOOOOOOXXXXXXXXXXXXGOXXXXXXXXXXXXXXXXXXGOOOOOOOXXXXXXXXXXXXGXXXXXXXXXXXXXXXXXXXGOOOXXXXXXXXXXXXXXXXGOXXXXXXXXXXXXXXXXXXGOOOXXXXXXXXXXXXXXXXGOOOOOXXXXXXXXXXXXXXGOOXXXXXXXXXXXXXXXXXGOOOOOOXXXXXXXXXXXXXGOOOOOOXXXXXXXXXXXXX,0,300,0

19110,62,0,62,11,227,0,0,229,189,40,GOOOXXXXXXXXXXXXXXXXGOOOOOXXXXXXXXXXXXXXGOOOOOOOXXXXXXXXXXXXGOXXXXXXXXXXXXXXXXXXGOOOOOOOXXXXXXXXXXXXGXXXXXXXXXXXXXXXXXXXGOOOXXXXXXXXXXXXXXXXGOXXXXXXXXXXXXXXXXXXGOOOXXXXXXXXXXXXXXXXGOOOOOXXXXXXXXXXXXXXGOOXXXXXXXXXXXXXXXXXGOOOOOOXXXXXXXXXXXXXGOOOOOOXXXXXXXXXXXXX,0,300,0
19131,62,0,62,13,225,0,0,227,187,40,GOOOXXXXXXXXXXXXXXXXGOOOOOXXXXXXXXXXXXXXGOOOOOOOXXXXXXXXXXXXGOXXXXXXXXXXXXXXXXXXGOOOOOOOXXXXXXXXXXXXGXXXXXXXXXXXXXXXXXXXGOOOXXXXXXXXXXXXXXXXGOXXXXXXXXXXXXXXXXXXGOOOXXXXXXXXXXXXXXXXGOOOOOXXXXXXXXXXXXXXGOOXXXXXXXXXXXXXXXXXGOOOOOOXXXXXXXXXXXXXGOOOOOOXXXXXXXXXXXXX,0,300,0
19152,62,0,62,13,225,0,0,227,189,38,GOOOXXXXXXXXXXXXXXXXGOOOOOXXXXXXXXXXXXXXGOOOOOOOXXXXXXXXXXXXGOXXXXXXXXXXXXXXXXXXGOOOOOOOXXXXXXXXXXXXGXXXXXXXXXXXXXXXXXXXGOOOXXXXXXXXXXXXXXXXGOXXXXXXXXXXXXXXXXXXGOOOXXXXXXXXXXXXXXXXGOOOOOXXXXXXXXXXXXXXGOOXXXXXXXXXXXXXXXXXGOOOOOOXXXXXXXXXXXXXGOOOOOOXXXXXXXXXXXXX,0,300,0
19173,62,0,62,11,227,0,0,228,191,37,GOOOXXXXXXXXXXXXXXXXGOOOOOXXXXXXXXXXXXXXGOOOOOOOXXXXXXXXXXXXGOXXXXXXXXXXXXXXXXXXGOOOOOOOXXXXXXXXXXXXGXXXXXXXXXXXXXXXXXXXGOOOXXXXXXXXXXXXXXXXGOXXXXXXXXXXXXXXXXXXGOOOXXXXXXXXXXXXXXXXGOOOOOXXXXXXXXXXXXXXGOOXXXXXXXXXXXXXXXXXGOOOOOOXXXXXXXXXXXXXGOOOOOOXXXXXXXXXXXXX,0,300,0
19194,62,0,62,14,224,0,0,226,189,37,GOOOXXXXXXXXXXXXXXXXGOOOOOXXXXXXXXXXXXXXGOOOOOOOXXXXXXXXXXXXGOXXXXXXXXXXXXXXXXXXGOOOOOOOXXXXXXXXXXXXGXXXXXXXXXXXXXXXXXXXGOOOXXXXXXXXXXXXXXXXGOXXXXXXXXXXXXXXXXXXGOOOXXXXXXXXXXXXXXXXGOOOOOXXXXXXXXXXXXXXGOOXXXXXXXXXXXXXXXXXGOOOOOOXXXXXXXXXXXXXGOOOOOOXXXXXXXXXXXXX,0,300,0

19215,63,1,62,14,223,0,0,225,189,36,GOOOXXXXXXXXXXXXXXXXGOOOOOXXXXXXXXXXXXXXGOOOOOOOXXXXXXXXXXXXGOXXXXXXXXXXXXXXXXXXGOOOOOOOXXXXXXXXXXXXGXXXXXXXXXXXXXXXXXXXGOOOXXXXXXXXXXXXXXXXGOXXXXXXXXXXXXXXXXXXGOOOXXXXXXXXXXXXXXXXGOOOOOXXXXXXXXXXXXXXGOOXXXXXXXXXXXXXXXXXGOOOOOOXXXXXXXXXXXXXGOOOOOOAXXXXXXXXXXXX,0,300,0
19236,63,1,62,14,223,0,0,225,190,35,GOOOXXXXXXXXXXXXXXXXGOOOOOXXXXXXXXXXXXXXGOOOOOOOXXXXXXXXXXXXGOXXXXXXXXXXXXXXXXXXGOOOOOOOXXXXXXXXXXXXGXXXXXXXXXXXXXXXXXXXGOOOXXXXXXXXXXXXXXXXGOXXXXXXXXXXXXXXXXXXGOOOXXXXXXXXXXXXXXXXGOOOOOXXXXXXXXXXXXXXGOOXXXXXXXXXXXXXXXXXGOOOOOOXXXXXXXXXXXXXGOOOOOOAXXXXXXXXXXXX,0,300,0
19257,63,1,62,15,222,0,0,224,189,35,GOOOXXXXXXXXXXXXXXXXGOOOOOXXXXXXXXXXXXXXGOOOOOOOXXXXXXXXXXXXGOXXXXXXXXXXXXXXXXXXGOOOOOOOXXXXXXXXXXXXGXXXXXXXXXXXXXXXXXXXGOOOXXXXXXXXXXXXXXXXGOXXXXXXXXXXXXXXXXXXGOOOXXXXXXXXXXXXXXXXGOOOOOXXXXXXXXXXXXXXGOOXXXXXXXXXXXXXXXXXGOOOOOOXXXXXXXXXXXXXGOOOOOOAXXXXXXXXXXXX,0,300,0
19278,63,1,62,14,223,0,0,225,190,35,GOOOXXXXXXXXXXXXXXXXGOOOOOXXXXXXXXXXXXXXGOOOOOOOXXXXXXXXXXXXGOXXXXXXXXXXXXXXXXXXGOOOOOOOXXXXXXXXXXXXGXXXXXXXXXXXXXXXXXXXGOOOXXXXXXXXXXXXXXXXGOXXXXXXXXXXXXXXXXXXGOOOXXXXXXXXXXXXXXXXGOOOOOXXXXXXXXXXXXXXGOOXXXXXXXXXXXXXXXXXGOOOOOOXXXXXXXXXXXXXGOOOOOOAXXXXXXXXXXXX,0,300,0
19299,63,1,62,14,223,0,0,225,189,36,GOOOXXXXXXXXXXXXXXXXGOOOOOXXXXXXXXXXXXXXGOOOOOOOXXXXXXXXXXXXGOXXXXXXXXXXXXXXXXXXGOOOOOOOXXXXXXXXXXXXGXXXXXXXXXXXXXXXXXXXGOOOXXXXXXXXXXXXXXXXGOXXXXXXXXXXXXXXXXXXGOOOXXXXXXXXXXXXXXXXGOOOOOXXXXXXXXXXXXXXGOOXXXXXXXXXXXXXXXXXGOOOOOOXXXXXXXXXXXXXGOOOOOOAXXXXXXXXXXXX,0,300,0

19320,63,1,62,15,222,0,0,224,190,34,GOOOXXXXXXXXXXXXXXXXGOOOOOXXXXXXXXXXXXXXGOOOOOOOXXXXXXXXXXXXGOXXXXXXXXXXXXXXXXXXGOOOOOOOXXXXXXXXXXXXGXXXXXXXXXXXXXXXXXXXGOOOXXXXXXXXXXXXXXXXGOXXXXXXXXXXXXXXXXXXGOOOXXXXXXXXXXXXXXXXGOOOOOXXXXXXXXXXXXXXGOOXXXXXXXXXXXXXXXXXGOOOOOOXXXXXXXXXXXXXGOOOOOOAXXXXXXXXXXXX,0,300,0
19341,63,1,62,16,221,0,0,223,192,31,GOOOXXXXXXXXXXXXXXXXGOOOOOXXXXXXXXXXXXXXGOOOOOOOXXXXXXXXXXXXGOXXXXXXXXXXXXXXXXXXGOOOOOOOXXXXXXXXXXXXGXXXXXXXXXXXXXXXXXXXGOOOXXXXXXXXXXXXXXXXGOXXXXXXXXXXXXXXXXXXGOOOXXXXXXXXXXXXXXXXGOOOOOXXXXXXXXXXXXXXGOOXXXXXXXXXXXXXXXXXGOOOOOOXXXXXXXXXXXXXGOOOOOOAXXXXXXXXXXXX,0,300,0
19362,63,1,62,18,219,0,0,221,189,32,GOOOXXXXXXXXXXXXXXXXGOOOOOXXXXXXXXXXXXXXGOOOOOOOXXXXXXXXXXXXGOXXXXXXXXXXXXXXXXXXGOOOOOOOXXXXXXXXXXXXGXXXXXXXXXXXXXXXXXXXGOOOXXXXXXXXXXXXXXXXGOXXXXXXXXXXXXXXXXXXGOOOXXXXXXXXXXXXXXXXGOOOOOXXXXXXXXXXXXXXGOOXXXXXXXXXXXXXXXXXGOOOOOOXXXXXXXXXXXXXGOOOOOOAXXXXXXXXXXXX,0,300,0
19383,63,1,62,17,220,0,0,222,189,33,GOOOXXXXXXXXXXXXXXXXGOOOOOXXXXXXXXXXXXXXGOOOOOOOXXXXXXXXXXXXGOXXXXXXXXXXXXXXXXXXGOOOOOOOXXXXXXXXXXXXGXXXXXXXXXXXXXXXXXXXGOOOXXXXXXXXXXXXXXXXGOXXXXXXXXXXXXXXXXXXGOOOXXXXXXXXXXXXXXXXGOOOOOXXXXXXXXXXXXXXGOOXXXXXXXXXXXXXXXXXGOOOOOOXXXXXXXXXXXXXGOOOOOOAXXXXXXXXXXXX,0,300,0
19404,63,0,63,17,220,0,0,222,189,33,GOOOXXXXXXXXXXXXXXXXGOOOOOXXXXXXXXXXXXXXGOOOOOOOXXXXXXXXXXXXGOXXXXXXXXXXXXXXXXXXGOOOOOOOXXXXXXXXXXXXGXXXXXXXXXXXXXXXXXXXGOOOXXXXXXXXXXXXXXXXGOXXXXXXXXXXXXXXXXXXGOOOXXXXXXXXXXXXXXXXGOOOOOXXXXXXXXXXXXXXGOOXXXXXXXXXXXXXXXXXGOOOOOOXXXXXXXXXXXXXGOOOOOOOXXXXXXXXXXXX,0,300,0

19425,63,0,63,15,222,0,0,224,192,32,GOOOXXXXXXXXXXXXXXXXGOOOOOXXXXXXXXXXXXXXGOOOOOOOXXXXXXXXXXXXGOXXXXXXXXXXXXXXXXXXGOOOOOOOXXXXXXXXXXXXGXXXXXXXXXXXXXXXXXXXGOOOXXXXXXXXXXXXXXXXGOXXXXXXXXXXXXXXXXXXGOOOXXXXXXXXXXXXXXXXGOOOOOXXXXXXXXXXXXXXGOOXXXXXXXXXXXXXXXXXGOOOOOOXXXXXXXXXXXXXGOOOOOOOXXXXXXXXXXXX,0,300,0
19446,63,0,63,17,220,0,0,222,191,31,GOOOXXXXXXXXXXXXXXXXGOOOOOXXXXXXXXXXXXXXGOOOOOOOXXXXXXXXXXXXGOXXXXXXXXXXXXXXXXXXGOOOOOOOXXXXXXXXXXXXGXXXXXXXXXXXXXXXXXXXGOOOXXXXXXXXXXXXXXXXGOXXXXXXXXXXXXXXXXXXGOOOXXXXXXXXXXXXXXXXGOOOOOXXXXXXXXXXXXXXGOOXXXXXXXXXXXXXXXXXGOOOOOOXXXXXXXXXXXXXGOOOOOOOXXXXXXXXXXXX,0,300,0
19467,63,0,63,19,218,0,0,220,189,31,GOOOXXXXXXXXXXXXXXXXGOOOOOXXXXXXXXXXXXXXGOOOOOOOXXXXXXXXXXXXGOXXXXXXXXXXXXXXXXXXGOOOOOOOXXXXXXXXXXXXGXXXXXXXXXXXXXXXXXXXGOOOXXXXXXXXXXXXXXXXGOXXXXXXXXXXXXXXXXXXGOOOXXXXXXXXXXXXXXXXGOOOOOXXXXXXXXXXXXXXGOOXXXXXXXXXXXXXXXXXGOOOOOOXXXXXXXXXXXXXGOOOOOOOXXXXXXXXXXXX,0,300,0
19488,63,0,63,18,219,0,0,221,189,32,GOOOXXXXXXXXXXXXXXXXGOOOOOXXXXXXXXXXXXXXGOOOOOOOXXXXXXXXXXXXGOXXXXXXXXXXXXXXXXXXGOOOOOOOXXXXXXXXXXXXGXXXXXXXXXXXXXXXXXXXGOOOXXXXXXXXXXXXXXXXGOXXXXXXXXXXXXXXXXXXGOOOXXXXXXXXXXXXXXXXGOOOOOXXXXXXXXXXXXXXGOOXXXXXXXXXXXXXXXXXGOOOOOOXXXXXXXXXXXXXGOOOOOOOXXXXXXXXXXXX,0,300,0
19509,63,0,63,20,217,0,0,219,190,29,GOOOXXXXXXXXXXXXXXXXGOOOOOXXXXXXXXXXXXXXGOOOOOOOXXXXXXXXXXXXGOXXXXXXXXXXXXXXXXXXGOOOOOOOXXXXXXXXXXXXGXXXXXXXXXXXXXXXXXXXGOOOXXXXXXXXXXXXXXXXGOXXXXXXXXXXXXXXXXXXGOOOXXXXXXXXXXXXXXXXGOOOOOXXXXXXXXXXXXXXGOOXXXXXXXXXXXXXXXXXGOOOOOOXXXXXXXXXXXXXGOOOOOOOXXXXXXXXXXXX,0,300,0

19530,63,0,63,22,215,0,0,217,192,25,GOOOXXXXXXXXXXXXXXXXGOOOOOXXXXXXXXXXXXXXGOOOOOOOXXXXXXXXXXXXGOXXXXXXXXXXXXXXXXXXGOOOOOOOXXXXXXXXXXXXGXXXXXXXXXXXXXXXXXXXGOOOXXXXXXXXXXXXXXXXGOXXXXXXXXXXXXXXXXXXGOOOXXXXXXXXXXXXXXXXGOOOOOXXXXXXXXXXXXXXGOOXXXXXXXXXXXXXXXXXGOOOOOOXXXXXXXXXXXXXGOOOOOOOXXXXXXXXXXXX,0,300,0
19551,63,0,63,23,214,0,0,216,194,22,GOOOXXXXXXXXXXXXXXXXGOOOOOXXXXXXXXXXXXXXGOOOOOOOXXXXXXXXXXXXGOXXXXXXXXXXXXXXXXXXGOOOOOOOXXXXXXXXXXXXGXXXXXXXXXXXXXXXXXXXGOOOXXXXXXXXXXXXXXXXGOXXXXXXXXXXXXXXXXXXGOOOXXXXXXXXXXXXXXXXGOOOOOXXXXXXXXXXXXXXGOOXXXXXXXXXXXXXXXXXGOOOOOOXXXXXXXXXXXXXGOOOOOOOXXXXXXXXXXXX,0,300,0
19572,64,1,63,26,210,0,0,212,190,22,GOOOXXXXXXXXXXXXXXXXGOOOOOXXXXXXXXXXXXXXGOOOOOOOXXXXXXXXXXXXGOXXXXXXXXXXXXXXXXXXGOOOOOOOAXXXXXXXXXXXGXXXXXXXXXXXXXXXXXXXGOOOXXXXXXXXXXXXXXXXGOXXXXXXXXXXXXXXXXXXGOOOXXXXXXXXXXXXXXXXGOOOOOXXXXXXXXXXXXXXGOOXXXXXXXXXXXXXXXXXGOOOOOOXXXXXXXXXXXXXGOOOOOOOXXXXXXXXXXXX,0,300,0
19593,64,1,63,27,209,0,0,211,189,22,GOOOXXXXXXXXXXXXXXXXGOOOOOXXXXXXXXXXXXXXGOOOOOOOXXXXXXXXXXXXGOXXXXXXXXXXXXXXXXXXGOOOOOOOAXXXXXXXXXXXGXXXXXXXXXXXXXXXXXXXGOOOXXXXXXXXXXXXXXXXGOXXXXXXXXXXXXXXXXXXGOOOXXXXXXXXXXXXXXXXGOOOOOXXXXXXXXXXXXXXGOOXXXXXXXXXXXXXXXXXGOOOOOOXXXXXXXXXXXXXGOOOOOOOXXXXXXXXXXXX,0,300,0
19614,64,1,63,26,210,0,0,212,189,23,GOOOXXXXXXXXXXXXXXXXGOOOOOXXXXXXXXXXXXXXGOOOOOOOXXXXXXXXXXXXGOXXXXXXXXXXXXXXXXXXGOOOOOOOAXXXXXXXXXXXGXXXXXXXXXXXXXXXXXXXGOOOXXXXXXXXXXXXXXXXGOXXXXXXXXXXXXXXXXXXGOOOXXXXXXXXXXXXXXXXGOOOOOXXXXXXXXXXXXXXGOOXXXXXXXXXXXXXXXXXGOOOOOOXXXXXXXXXXXXXGOOOOOOOXXXXXXXXXXXX,0,300,0

19635,64,0,64,22,214,0,0,216,189,27,GOOOXXXXXXXXXXXXXXXXGOOOOOXXXXXXXXXXXXXXGOOOOOOOXXXXXXXXXXXXGOXXXXXXXXXXXXXXXXXXGOOOOOOOOXXXXXXXXXXXGXXXXXXXXXXXXXXXXXXXGOOOXXXXXXXXXXXXXXXXGOXXXXXXXXXXXXXXXXXXGOOOXXXXXXXXXXXXXXXXGOOOOOXXXXXXXXXXXXXXGOOXXXXXXXXXXXXXXXXXGOOOOOOXXXXXXXXXXXXXGOOOOOOOXXXXXXXXXXXX,0,300,0
19656,64,0,64,18,218,0,0,219,190,29,GOOOXXXXXXXXXXXXXXXXGOOOOOXXXXXXXXXXXXXXGOOOOOOOXXXXXXXXXXXXGOXXXXXXXXXXXXXXXXXXGOOOOOOOOXXXXXXXXXXXGXXXXXXXXXXXXXXXXXXXGOOOXXXXXXXXXXXXXXXXGOXXXXXXXXXXXXXXXXXXGOOOXXXXXXXXXXXXXXXXGOOOOOXXXXXXXXXXXXXXGOOXXXXXXXXXXXXXXXXXGOOOOOOXXXXXXXXXXXXXGOOOOOOOXXXXXXXXXXXX,0,300,0
19677,64,0,64,16,220,0,0,222,190,32,GOOOXXXXXXXXXXXXXXXXGOOOOOXXXXXXXXXXXXXXGOOOOOOOXXXXXXXXXXXXGOXXXXXXXXXXXXXXXXXXGOOOOOOOOXXXXXXXXXXXGXXXXXXXXXXXXXXXXXXXGOOOXXXXXXXXXXXXXXXXGOXXXXXXXXXXXXXXXXXXGOOOXXXXXXXXXXXXXXXXGOOOOOXXXXXXXXXXXXXXGOOXXXXXXXXXXXXXXXXXGOOOOOOXXXXXXXXXXXXXGOOOOOOOXXXXXXXXXXXX,0,300,0
19698,64,0,64,17,219,0,0,221,191,30,GOOOXXXXXXXXXXXXXXXXGOOOOOXXXXXXXXXXXXXXGOOOOOOOXXXXXXXXXXXXGOXXXXXXXXXXXXXXXXXXGOOOOOOOOXXXXXXXXXXXGXXXXXXXXXXXXXXXXXXXGOOOXXXXXXXXXXXXXXXXGOXXXXXXXXXXXXXXXXXXGOOOXXXXXXXXXXXXXXXXGOOOOOXXXXXXXXXXXXXXGOOXXXXXXXXXXXXXXXXXGOOOOOOXXXXXXXXXXXXXGOOOOOOOXXXXXXXXXXXX,0,300,0
19719,64,0,64,15,221,0,0,223,191,32,GOOOXXXXXXXXXXXXXXXXGOOOOOXXXXXXXXXXXXXXGOOOOOOOXXXXXXXXXXXXGOXXXXXXXXXXXXXXXXXXGOOOOOOOOXXXXXXXXXXXGXXXXXXXXXXXXXXXXXXXGOOOXXXXXXXXXXXXXXXXGOXXXXXXXXXXXXXXXXXXGOOOXXXXXXXXXXXXXXXXGOOOOOXXXXXXXXXXXXXXGOOXXXXXXXXXXXXXXXXXGOOOOOOXXXXXXXXXXXXXGOOOOOOOXXXXXXXXXXXX,0,300,0

19740,64,0,64,16,220,0,0,222,190,32,GOOOXXXXXXXXXXXXXXXXGOOOOOXXXXXXXXXXXXXXGOOOOOOOXXXXXXXXXXXXGOXXXXXXXXXXXXXXXXXXGOOOOOOOOXXXXXXXXXXXGXXXXXXXXXXXXXXXXXXXGOOOXXXXXXXXXXXXXXXXGOXXXXXXXXXXXXXXXXXXGOOOXXXXXXXXXXXXXXXXGOOOOOXXXXXXXXXXXXXXGOOXXXXXXXXXXXXXXXXXGOOOOOOXXXXXXXXXXXXXGOOOOOOOXXXXXXXXXXXX,0,300,0
19761,64,0,64,17,219,0,0,221,191,30,GOOOXXXXXXXXXXXXXXXXGOOOOOXXXXXXXXXXXXXXGOOOOOOOXXXXXXXXXXXXGOXXXXXXXXXXXXXXXXXXGOOOOOOOOXXXXXXXXXXXGXXXXXXXXXXXXXXXXXXXGOOOXXXXXXXXXXXXXXXXGOXXXXXXXXXXXXXXXXXXGOOOXXXXXXXXXXXXXXXXGOOOOOXXXXXXXXXXXXXXGOOXXXXXXXXXXXXXXXXXGOOOOOOXXXXXXXXXXXXXGOOOOOOOXXXXXXXXXXXX,0,300,0
19782,64,0,64,17,219,0,0,221,192,29,GOOOXXXXXXXXXXXXXXXXGOOOOOXXXXXXXXXXXXXXGOOOOOOOXXXXXXXXXXXXGOXXXXXXXXXXXXXXXXXXGOOOOOOOOXXXXXXXXXXXGXXXXXXXXXXXXXXXXXXXGOOOXXXXXXXXXXXXXXXXGOXXXXXXXXXXXXXXXXXXGOOOXXXXXXXXXXXXXXXXGOOOOOXXXXXXXXXXXXXXGOOXXXXXXXXXXXXXXXXXGOOOOOOXXXXXXXXXXXXXGOOOOOOOXXXXXXXXXXXX,0,300,0
19803,64,0,64,19,217,0,0,219,190,29,GOOOXXXXXXXXXXXXXXXXGOOOOOXXXXXXXXXXXXXXGOOOOOOOXXXXXXXXXXXXGOXXXXXXXXXXXXXXXXXXGOOOOOOOOXXXXXXXXXXXGXXXXXXXXXXXXXXXXXXXGOOOXXXXXXXXXXXXXXXXGOXXXXXXXXXXXXXXXXXXGOOOXXXXXXXXXXXXXXXXGOOOOOXXXXXXXXXXXXXXGOOXXXXXXXXXXXXXXXXXGOOOOOOXXXXXXXXXXXXXGOOOOOOOXXXXXXXXXXXX,0,300,0
19824,64,0,64,17,219,0,0,221,190,31,GOOOXXXXXXXXXXXXXXXXGOOOOOXXXXXXXXXXXXXXGOOOOOOOXXXXXXXXXXXXGOXXXXXXXXXXXXXXXXXXGOOOOOOOOXXXXXXXXXXXGXXXXXXXXXXXXXXXXXXXGOOOXXXXXXXXXXXXXXXXGOXXXXXXXXXXXXXXXXXXGOOOXXXXXXXXXXXXXXXXGOOOOOXXXXXXXXXXXXXXGOOXXXXXXXXXXXXXXXXXGOOOOOOXXXXXXXXXXXXXGOOOOOOOXXXXXXXXXXXX,0,300,0

19845,64,0,64,14,222,0,0,224,191,33,GOOOXXXXXXXXXXXXXXXXGOOOOOXXXXXXXXXXXXXXGOOOOOOOXXXXXXXXXXXXGOXXXXXXXXXXXXXXXXXXGOOOOOOOOXXXXXXXXXXXGXXXXXXXXXXXXXXXXXXXGOOOXXXXXXXXXXXXXXXXGOXXXXXXXXXXXXXXXXXXGOOOXXXXXXXXXXXXXXXXGOOOOOXXXXXXXXXXXXXXGOOXXXXXXXXXXXXXXXXXGOOOOOOXXXXXXXXXXXXXGOOOOOOOXXXXXXXXXXXX,0,300,0
19866,64,0,64,14,222,0,0,223,191,32,GOOOXXXXXXXXXXXXXXXXGOOOOOXXXXXXXXXXXXXXGOOOOOOOXXXXXXXXXXXXGOXXXXXXXXXXXXXXXXXXGOOOOOOOOXXXXXXXXXXXGXXXXXXXXXXXXXXXXXXXGOOOXXXXXXXXXXXXXXXXGOXXXXXXXXXXXXXXXXXXGOOOXXXXXXXXXXXXXXXXGOOOOOXXXXXXXXXXXXXXGOOXXXXXXXXXXXXXXXXXGOOOOOOXXXXXXXXXXXXXGOOOOOOOXXXXXXXXXXXX,0,300,0
19887,64,0,64,13,223,0,0,225,196,29,GOOOXXXXXXXXXXXXXXXXGOOOOOXXXXXXXXXXXXXXGOOOOOOOXXXXXXXXXXXXGOXXXXXXXXXXXXXXXXXXGOOOOOOOOXXXXXXXXXXXGXXXXXXXXXXXXXXXXXXXGOOOXXXXXXXXXXXXXXXXGOXXXXXXXXXXXXXXXXXXGOOOXXXXXXXXXXXXXXXXGOOOOOXXXXXXXXXXXXXXGOOXXXXXXXXXXXXXXXXXGOOOOOOXXXXXXXXXXXXXGOOOOOOOXXXXXXXXXXXX,0,300,0
19908,64,0,64,14,222,0,0,224,198,26,GOOOXXXXXXXXXXXXXXXXGOOOOOXXXXXXXXXXXXXXGOOOOOOOXXXXXXXXXXXXGOXXXXXXXXXXXXXXXXXXGOOOOOOOOXXXXXXXXXXXGXXXXXXXXXXXXXXXXXXXGOOOXXXXXXXXXXXXXXXXGOXXXXXXXXXXXXXXXXXXGOOOXXXXXXXXXXXXXXXXGOOOOOXXXXXXXXXXXXXXGOOXXXXXXXXXXXXXXXXXGOOOOOOXXXXXXXXXXXXXGOOOOOOOXXXXXXXXXXXX,0,300,0
19929,64,0,64,17,219,0,0,221,193,28,GOOOXXXXXXXXXXXXXXXXGOOOOOXXXXXXXXXXXXXXGOOOOOOOXXXXXXXXXXXXGOXXXXXXXXXXXXXXXXXXGOOOOOOOOXXXXXXXXXXXGXXXXXXXXXXXXXXXXXXXGOOOXXXXXXXXXXXXXXXXGOXXXXXXXXXXXXXXXXXXGOOOXXXXXXXXXXXXXXXXGOOOOOXXXXXXXXXXXXXXGOOXXXXXXXXXXXXXXXXXGOOOOOOXXXXXXXXXXXXXGOOOOOOOXXXXXXXXXXXX,0,300,0

19950,64,0,64,19,217,0,0,219,192,27,GOOOXXXXXXXXXXXXXXXXGOOOOOXXXXXXXXXXXXXXGOOOOOOOXXXXXXXXXXXXGOXXXXXXXXXXXXXXXXXXGOOOOOOOOXXXXXXXXXXXGXXXXXXXXXXXXXXXXXXXGOOOXXXXXXXXXXXXXXXXGOXXXXXXXXXXXXXXXXXXGOOOXXXXXXXXXXXXXXXXGOOOOOXXXXXXXXXXXXXXGOOXXXXXXXXXXXXXXXXXGOOOOOOXXXXXXXXXXXXXGOOOOOOOXXXXXXXXXXXX,0,300,0
19971,64,0,64,18,218,0,0,220,192,28,GOOOXXXXXXXXXXXXXXXXGOOOOOXXXXXXXXXXXXXXGOOOOOOOXXXXXXXXXXXXGOXXXXXXXXXXXXXXXXXXGOOOOOOOOXXXXXXXXXXXGXXXXXXXXXXXXXXXXXXXGOOOXXXXXXXXXXXXXXXXGOXXXXXXXXXXXXXXXXXXGOOOXXXXXXXXXXXXXXXXGOOOOOXXXXXXXXXXXXXXGOOXXXXXXXXXXXXXXXXXGOOOOOOXXXXXXXXXXXXXGOOOOOOOXXXXXXXXXXXX,0,300,0
19992,64,0,64,20,216,0,0,218,193,25,GOOOXXXXXXXXXXXXXXXXGOOOOOXXXXXXXXXXXXXXGOOOOOOOXXXXXXXXXXXXGOXXXXXXXXXXXXXXXXXXGOOOOOOOOXXXXXXXXXXXGXXXXXXXXXXXXXXXXXXXGOOOXXXXXXXXXXXXXXXXGOXXXXXXXXXXXXXXXXXXGOOOXXXXXXXXXXXXXXXXGOOOOOXXXXXXXXXXXXXXGOOXXXXXXXXXXXXXXXXXGOOOOOOXXXXXXXXXXXXXGOOOOOOOXXXXXXXXXXXX,0,300,0
20013,64,0,64,17,219,0,0,221,193,28,GOOOXXXXXXXXXXXXXXXXGOOOOOXXXXXXXXXXXXXXGOOOOOOOXXXXXXXXXXXXGOXXXXXXXXXXXXXXXXXXGOOOOOOOOXXXXXXXXXXXGXXXXXXXXXXXXXXXXXXXGOOOXXXXXXXXXXXXXXXXGOXXXXXXXXXXXXXXXXXXGOOOXXXXXXXXXXXXXXXXGOOOOOXXXXXXXXXXXXXXGOOXXXXXXXXXXXXXXXXXGOOOOOOXXXXXXXXXXXXXGOOOOOOOXXXXXXXXXXXX,0,300,0
20034,64,0,64,21,215,0,0,217,193,24,GOOOXXXXXXXXXXXXXXXXGOOOOOXXXXXXXXXXXXXXGOOOOOOOXXXXXXXXXXXXGOXXXXXXXXXXXXXXXXXXGOOOOOOOOXXXXXXXXXXXGXXXXXXXXXXXXXXXXXXXGOOOXXXXXXXXXXXXXXXXGOXXXXXXXXXXXXXXXXXXGOOOXXXXXXXXXXXXXXXXGOOOOOXXXXXXXXXXXXXXGOOXXXXXXXXXXXXXXXXXGOOOOOOXXXXXXXXXXXXXGOOOOOOOXXXXXXXXXXXX,0,300,0

20055,64,0,64,18,218,0,0,219,191,28,GOOOXXXXXXXXXXXXXXXXGOOOOOXXXXXXXXXXXXXXGOOOOOOOXXXXXXXXXXXXGOXXXXXXXXXXXXXXXXXXGOOOOOOOOXXXXXXXXXXXGXXXXXXXXXXXXXXXXXXXGOOOXXXXXXXXXXXXXXXXGOXXXXXXXXXXXXXXXXXXGOOOXXXXXXXXXXXXXXXXGOOOOOXXXXXXXXXXXXXXGOOXXXXXXXXXXXXXXXXXGOOOOOOXXXXXXXXXXXXXGOOOOOOOXXXXXXXXXXXX,0,300,0
20076,64,0,64,15,221,0,0,223,191,32,GOOOXXXXXXXXXXXXXXXXGOOOOOXXXXXXXXXXXXXXGOOOOOOOXXXXXXXXXXXXGOXXXXXXXXXXXXXXXXXXGOOOOOOOOXXXXXXXXXXXGXXXXXXXXXXXXXXXXXXXGOOOXXXXXXXXXXXXXXXXGOXXXXXXXXXXXXXXXXXXGOOOXXXXXXXXXXXXXXXXGOOOOOXXXXXXXXXXXXXXGOOXXXXXXXXXXXXXXXXXGOOOOOOXXXXXXXXXXXXXGOOOOOOOXXXXXXXXXXXX,0,300,0
20097,64,0,64,13,223,0,0,225,192,33,GOOOXXXXXXXXXXXXXXXXGOOOOOXXXXXXXXXXXXXXGOOOOOOOXXXXXXXXXXXXGOXXXXXXXXXXXXXXXXXXGOOOOOOOOXXXXXXXXXXXGXXXXXXXXXXXXXXXXXXXGOOOXXXXXXXXXXXXXXXXGOXXXXXXXXXXXXXXXXXXGOOOXXXXXXXXXXXXXXXXGOOOOOXXXXXXXXXXXXXXGOOXXXXXXXXXXXXXXXXXGOOOOOOXXXXXXXXXXXXXGOOOOOOOXXXXXXXXXXXX,0,300,0
20118,64,0,64,15,221,0,0,223,191,32,GOOOXXXXXXXXXXXXXXXXGOOOOOXXXXXXXXXXXXXXGOOOOOOOXXXXXXXXXXXXGOXXXXXXXXXXXXXXXXXXGOOOOOOOOXXXXXXXXXXXGXXXXXXXXXXXXXXXXXXXGOOOXXXXXXXXXXXXXXXXGOXXXXXXXXXXXXXXXXXXGOOOXXXXXXXXXXXXXXXXGOOOOOXXXXXXXXXXXXXXGOOXXXXXXXXXXXXXXXXXGOOOOOOXXXXXXXXXXXXXGOOOOOOOXXXXXXXXXXXX,0,300,0
20139,64,0,64,15,221,0,0,223,192,31,GOOOXXXXXXXXXXXXXXXXGOOOOOXXXXXXXXXXXXXXGOOOOOOOXXXXXXXXXXXXGOXXXXXXXXXXXXXXXXXXGOOOOOOOOXXXXXXXXXXXGXXXXXXXXXXXXXXXXXXXGOOOXXXXXXXXXXXXXXXXGOXXXXXXXXXXXXXXXXXXGOOOXXXXXXXXXXXXXXXXGOOOOOXXXXXXXXXXXXXXGOOXXXXXXXXXXXXXXXXXGOOOOOOXXXXXXXXXXXXXGOOOOOOOXXXXXXXXXXXX,0,300,0

20160,64,0,64,14,222,0,0,224,194,30,GOOOXXXXXXXXXXXXXXXXGOOOOOXXXXXXXXXXXXXXGOOOOOOOXXXXXXXXXXXXGOXXXXXXXXXXXXXXXXXXGOOOOOOOOXXXXXXXXXXXGXXXXXXXXXXXXXXXXXXXGOOOXXXXXXXXXXXXXXXXGOXXXXXXXXXXXXXXXXXXGOOOXXXXXXXXXXXXXXXXGOOOOOXXXXXXXXXXXXXXGOOXXXXXXXXXXXXXXXXXGOOOOOOXXXXXXXXXXXXXGOOOOOOOXXXXXXXXXXXX,0,300,0
20181,64,0,64,16,220,0,0,222,192,30,GOOOXXXXXXXXXXXXXXXXGOOOOOXXXXXXXXXXXXXXGOOOOOOOXXXXXXXXXXXXGOXXXXXXXXXXXXXXXXXXGOOOOOOOOXXXXXXXXXXXGXXXXXXXXXXXXXXXXXXXGOOOXXXXXXXXXXXXXXXXGOXXXXXXXXXXXXXXXXXXGOOOXXXXXXXXXXXXXXXXGOOOOOXXXXXXXXXXXXXXGOOXXXXXXXXXXXXXXXXXGOOOOOOXXXXXXXXXXXXXGOOOOOOOXXXXXXXXXXXX,0,300,0
20202,64,0,64,15,221,0,0,223,192,31,GOOOXXXXXXXXXXXXXXXXGOOOOOXXXXXXXXXXXXXXGOOOOOOOXXXXXXXXXXXXGOXXXXXXXXXXXXXXXXXXGOOOOOOOOXXXXXXXXXXXGXXXXXXXXXXXXXXXXXXXGOOOXXXXXXXXXXXXXXXXGOXXXXXXXXXXXXXXXXXXGOOOXXXXXXXXXXXXXXXXGOOOOOXXXXXXXXXXXXXXGOOXXXXXXXXXXXXXXXXXGOOOOOOXXXXXXXXXXXXXGOOOOOOOXXXXXXXXXXXX,0,300,0
20223,64,0,64,14,222,0,0,224,192,32,GOOOXXXXXXXXXXXXXXXXGOOOOOXXXXXXXXXXXXXXGOOOOOOOXXXXXXXXXXXXGOXXXXXXXXXXXXXXXXXXGOOOOOOOOXXXXXXXXXXXGXXXXXXXXXXXXXXXXXXXGOOOXXXXXXXXXXXXXXXXGOXXXXXXXXXXXXXXXXXXGOOOXXXXXXXXXXXXXXXXGOOOOOXXXXXXXXXXXXXXGOOXXXXXXXXXXXXXXXXXGOOOOOOXXXXXXXXXXXXXGOOOOOOOXXXXXXXXXXXX,0,300,0
20244,64,0,64,12,224,0,0,226,192,34,GOOOXXXXXXXXXXXXXXXXGOOOOOXXXXXXXXXXXXXXGOOOOOOOXXXXXXXXXXXXGOXXXXXXXXXXXXXXXXXXGOOOOOOOOXXXXXXXXXXXGXXXXXXXXXXXXXXXXXXXGOOOXXXXXXXXXXXXXXXXGOXXXXXXXXXXXXXXXXXXGOOOXXXXXXXXXXXXXXXXGOOOOOXXXXXXXXXXXXXXGOOXXXXXXXXXXXXXXXXXGOOOOOOXXXXXXXXXXXXXGOOOOOOOXXXXXXXXXXXX,0,300,0

20265,64,0,64,12,224,0,0,226,192,34,GOOOXXXXXXXXXXXXXXXXGOOOOOXXXXXXXXXXXXXXGOOOOOOOXXXXXXXXXXXXGOXXXXXXXXXXXXXXXXXXGOOOOOOOOXXXXXXXXXXXGXXXXXXXXXXXXXXXXXXXGOOOXXXXXXXXXXXXXXXXGOXXXXXXXXXXXXXXXXXXGOOOXXXXXXXXXXXXXXXXGOOOOOXXXXXXXXXXXXXXGOOXXXXXXXXXXXXXXXXXGOOOOOOXXXXXXXXXXXXXGOOOOOOOXXXXXXXXXXXX,0,300,0
20286,64,0,64,12,224,0,0,226,193,33,GOOOXXXXXXXXXXXXXXXXGOOOOOXXXXXXXXXXXXXXGOOOOOOOXXXXXXXXXXXXGOXXXXXXXXXXXXXXXXXXGOOOOOOOOXXXXXXXXXXXGXXXXXXXXXXXXXXXXXXXGOOOXXXXXXXXXXXXXXXXGOXXXXXXXXXXXXXXXXXXGOOOXXXXXXXXXXXXXXXXGOOOOOXXXXXXXXXXXXXXGOOXXXXXXXXXXXXXXXXXGOOOOOOXXXXXXXXXXXXXGOOOOOOOXXXXXXXXXXXX,0,300,0
20307,64,0,64,12,224,0,0,226,194,32,GOOOXXXXXXXXXXXXXXXXGOOOOOXXXXXXXXXXXXXXGOOOOOOOXXXXXXXXXXXXGOXXXXXXXXXXXXXXXXXXGOOOOOOOOXXXXXXXXXXXGXXXXXXXXXXXXXXXXXXXGOOOXXXXXXXXXXXXXXXXGOXXXXXXXXXXXXXXXXXXGOOOXXXXXXXXXXXXXXXXGOOOOOXXXXXXXXXXXXXXGOOXXXXXXXXXXXXXXXXXGOOOOOOXXXXXXXXXXXXXGOOOOOOOXXXXXXXXXXXX,0,300,0
20328,64,0,64,12,224,0,0,226,194,32,GOOOXXXXXXXXXXXXXXXXGOOOOOXXXXXXXXXXXXXXGOOOOOOOXXXXXXXXXXXXGOXXXXXXXXXXXXXXXXXXGOOOOOOOOXXXXXXXXXXXGXXXXXXXXXXXXXXXXXXXGOOOXXXXXXXXXXXXXXXXGOXXXXXXXXXXXXXXXXXXGOOOXXXXXXXXXXXXXXXXGOOOOOXXXXXXXXXXXXXXGOOXXXXXXXXXXXXXXXXXGOOOOOOXXXXXXXXXXXXXGOOOOOOOXXXXXXXXXXXX,0,300,0
20349,64,0,64,14,222,0,0,224,193,31,GOOOXXXXXXXXXXXXXXXXGOOOOOXXXXXXXXXXXXXXGOOOOOOOXXXXXXXXXXXXGOXXXXXXXXXXXXXXXXXXGOOOOOOOOXXXXXXXXXXXGXXXXXXXXXXXXXXXXXXXGOOOXXXXXXXXXXXXXXXXGOXXXXXXXXXXXXXXXXXXGOOOXXXXXXXXXXXXXXXXGOOOOOXXXXXXXXXXXXXXGOOXXXXXXXXXXXXXXXXXGOOOOOOXXXXXXXXXXXXXGOOOOOOOXXXXXXXXXXXX,0,300,0

20370,64,0,64,17,219,0,0,221,192,29,GOOOXXXXXXXXXXXXXXXXGOOOOOXXXXXXXXXXXXXXGOOOOOOOXXXXXXXXXXXXGOXXXXXXXXXXXXXXXXXXGOOOOOOOOXXXXXXXXXXXGXXXXXXXXXXXXXXXXXXXGOOOXXXXXXXXXXXXXXXXGOXXXXXXXXXXXXXXXXXXGOOOXXXXXXXXXXXXXXXXGOOOOOXXXXXXXXXXXXXXGOOXXXXXXXXXXXXXXXXXGOOOOOOXXXXXXXXXXXXXGOOOOOOOXXXXXXXXXXXX,0,300,0
20391,64,0,64,16,220,0,0,222,193,29,GOOOXXXXXXXXXXXXXXXXGOOOOOXXXXXXXXXXXXXXGOOOOOOOXXXXXXXXXXXXGOXXXXXXXXXXXXXXXXXXGOOOOOOOOXXXXXXXXXXXGXXXXXXXXXXXXXXXXXXXGOOOXXXXXXXXXXXXXXXXGOXXXXXXXXXXXXXXXXXXGOOOXXXXXXXXXXXXXXXXGOOOOOXXXXXXXXXXXXXXGOOXXXXXXXXXXXXXXXXXGOOOOOOXXXXXXXXXXXXXGOOOOOOOXXXXXXXXXXXX,0,300,0
20412,64,0,64,17,219,0,0,221,193,28,GOOOXXXXXXXXXXXXXXXXGOOOOOXXXXXXXXXXXXXXGOOOOOOOXXXXXXXXXXXXGOXXXXXXXXXXXXXXXXXXGOOOOOOOOXXXXXXXXXXXGXXXXXXXXXXXXXXXXXXXGOOOXXXXXXXXXXXXXXXXGOXXXXXXXXXXXXXXXXXXGOOOXXXXXXXXXXXXXXXXGOOOOOXXXXXXXXXXXXXXGOOXXXXXXXXXXXXXXXXXGOOOOOOXXXXXXXXXXXXXGOOOOOOOXXXXXXXXXXXX,0,300,0
20433,64,0,64,13,223,0,0,225,197,28,GOOOXXXXXXXXXXXXXXXXGOOOOOXXXXXXXXXXXXXXGOOOOOOOXXXXXXXXXXXXGOXXXXXXXXXXXXXXXXXXGOOOOOOOOXXXXXXXXXXXGXXXXXXXXXXXXXXXXXXXGOOOXXXXXXXXXXXXXXXXGOXXXXXXXXXXXXXXXXXXGOOOXXXXXXXXXXXXXXXXGOOOOOXXXXXXXXXXXXXXGOOXXXXXXXXXXXXXXXXXGOOOOOOXXXXXXXXXXXXXGOOOOOOOXXXXXXXXXXXX,0,300,0
20454,65,1,64,13,222,0,0,223,196,27,GOOOXXXXXXXXXXXXXXXXGOOOOOXXXXXXXXXXXXXXGOOOOOOOXXXXXXXXXXXXGOXXXXXXXXXXXXXXXXXXGOOOOOOOOXXXXXXXXXXXGXXXXXXXXXXXXXXXXXXXGOOOXXXXXXXXXXXXXXXXGOAXXXXXXXXXXXXXXXXXGOOOXXXXXXXXXXXXXXXXGOOOOOXXXXXXXXXXXXXXGOOXXXXXXXXXXXXXXXXXGOOOOOOXXXXXXXXXXXXXGOOOOOOOXXXXXXXXXXXX,0,300,0

20475,65,1,64,15,220,0,0,222,193,29,GOOOXXXXXXXXXXXXXXXXGOOOOOXXXXXXXXXXXXXXGOOOOOOOXXXXXXXXXXXXGOXXXXXXXXXXXXXXXXXXGOOOOOOOOXXXXXXXXXXXGXXXXXXXXXXXXXXXXXXXGOOOXXXXXXXXXXXXXXXXGOAXXXXXXXXXXXXXXXXXGOOOXXXXXXXXXXXXXXXXGOOOOOXXXXXXXXXXXXXXGOOXXXXXXXXXXXXXXXXXGOOOOOOXXXXXXXXXXXXXGOOOOOOOXXXXXXXXXXXX,0,300,0
20496,65,1,64,15,220,0,0,222,196,26,GOOOXXXXXXXXXXXXXXXXGOOOOOXXXXXXXXXXXXXXGOOOOOOOXXXXXXXXXXXXGOXXXXXXXXXXXXXXXXXXGOOOOOOOOXXXXXXXXXXXGXXXXXXXXXXXXXXXXXXXGOOOXXXXXXXXXXXXXXXXGOAXXXXXXXXXXXXXXXXXGOOOXXXXXXXXXXXXXXXXGOOOOOXXXXXXXXXXXXXXGOOXXXXXXXXXXXXXXXXXGOOOOOOXXXXXXXXXXXXXGOOOOOOOXXXXXXXXXXXX,0,300,0
20517,65,1,64,16,219,0,0,221,195,26,GOOOXXXXXXXXXXXXXXXXGOOOOOXXXXXXXXXXXXXXGOOOOOOOXXXXXXXXXXXXGOXXXXXXXXXXXXXXXXXXGOOOOOOOOXXXXXXXXXXXGXXXXXXXXXXXXXXXXXXXGOOOXXXXXXXXXXXXXXXXGOAXXXXXXXXXXXXXXXXXGOOOXXXXXXXXXXXXXXXXGOOOOOXXXXXXXXXXXXXXGOOXXXXXXXXXXXXXXXXXGOOOOOOXXXXXXXXXXXXXGOOOOOOOXXXXXXXXXXXX,0,300,0
20538,65,1,64,20,215,0,0,217,198,19,GOOOXXXXXXXXXXXXXXXXGOOOOOXXXXXXXXXXXXXXGOOOOOOOXXXXXXXXXXXXGOXXXXXXXXXXXXXXXXXXGOOOOOOOOXXXXXXXXXXXGXXXXXXXXXXXXXXXXXXXGOOOXXXXXXXXXXXXXXXXGOAXXXXXXXXXXXXXXXXXGOOOXXXXXXXXXXXXXXXXGOOOOOXXXXXXXXXXXXXXGOOXXXXXXXXXXXXXXXXXGOOOOOOXXXXXXXXXXXXXGOOOOOOOXXXXXXXXXXXX,0,300,0
20559,65,1,64,23,212,0,0,214,195,19,GOOOXXXXXXXXXXXXXXXXGOOOOOXXXXXXXXXXXXXXGOOOOOOOXXXXXXXXXXXXGOXXXXXXXXXXXXXXXXXXGOOOOOOOOXXXXXXXXXXXGXXXXXXXXXXXXXXXXXXXGOOOXXXXXXXXXXXXXXXXGOAXXXXXXXXXXXXXXXXXGOOOXXXXXXXXXXXXXXXXGOOOOOXXXXXXXXXXXXXXGOOXXXXXXXXXXXXXXXXXGOOOOOOXXXXXXXXXXXXXGOOOOOOOXXXXXXXXXXXX,0,300,0

20580,65,1,64,23,212,0,0,214,195,19,GOOOXXXXXXXXXXXXXXXXGOOOOOXXXXXXXXXXXXXXGOOOOOOOXXXXXXXXXXXXGOXXXXXXXXXXXXXXXXXXGOOOOOOOOXXXXXXXXXXXGXXXXXXXXXXXXXXXXXXXGOOOXXXXXXXXXXXXXXXXGOAXXXXXXXXXXXXXXXXXGOOOXXXXXXXXXXXXXXXXGOOOOOXXXXXXXXXXXXXXGOOXXXXXXXXXXXXXXXXXGOOOOOOXXXXXXXXXXXXXGOOOOOOOXXXXXXXXXXXX,0,300,0
20601,65,1,64,22,213,0,0,215,196,19,GOOOXXXXXXXXXXXXXXXXGOOOOOXXXXXXXXXXXXXXGOOOOOOOXXXXXXXXXXXXGOXXXXXXXXXXXXXXXXXXGOOOOOOOOXXXXXXXXXXXGXXXXXXXXXXXXXXXXXXXGOOOXXXXXXXXXXXXXXXXGOAXXXXXXXXXXXXXXXXXGOOOXXXXXXXXXXXXXXXXGOOOOOXXXXXXXXXXXXXXGOOXXXXXXXXXXXXXXXXXGOOOOOOXXXXXXXXXXXXXGOOOOOOOXXXXXXXXXXXX,0,300,0
20622,65,1,64,22,213,0,0,215,195,20,GOOOXXXXXXXXXXXXXXXXGOOOOOXXXXXXXXXXXXXXGOOOOOOOXXXXXXXXXXXXGOXXXXXXXXXXXXXXXXXXGOOOOOOOOXXXXXXXXXXXGXXXXXXXXXXXXXXXXXXXGOOOXXXXXXXXXXXXXXXXGOAXXXXXXXXXXXXXXXXXGOOOXXXXXXXXXXXXXXXXGOOOOOXXXXXXXXXXXXXXGOOXXXXXXXXXXXXXXXXXGOOOOOOXXXXXXXXXXXXXGOOOOOOOXXXXXXXXXXXX,0,300,0
20643,65,1,64,18,217,0,0,219,197,22,GOOOXXXXXXXXXXXXXXXXGOOOOOXXXXXXXXXXXXXXGOOOOOOOXXXXXXXXXXXXGOXXXXXXXXXXXXXXXXXXGOOOOOOOOXXXXXXXXXXXGXXXXXXXXXXXXXXXXXXXGOOOXXXXXXXXXXXXXXXXGOAXXXXXXXXXXXXXXXXXGOOOXXXXXXXXXXXXXXXXGOOOOOXXXXXXXXXXXXXXGOOXXXXXXXXXXXXXXXXXGOOOOOOXXXXXXXXXXXXXGOOOOOOOXXXXXXXXXXXX,0,300,0
20664,65,0,65,19,216,0,0,218,195,23,GOOOXXXXXXXXXXXXXXXXGOOOOOXXXXXXXXXXXXXXGOOOOOOOXXXXXXXXXXXXGOXXXXXXXXXXXXXXXXXXGOOOOOOOOXXXXXXXXXXXGXXXXXXXXXXXXXXXXXXXGOOOXXXXXXXXXXXXXXXXGOOXXXXXXXXXXXXXXXXXGOOOXXXXXXXXXXXXXXXXGOOOOOXXXXXXXXXXXXXXGOOXXXXXXXXXXXXXXXXXGOOOOOOXXXXXXXXXXXXXGOOOOOOOXXXXXXXXXXXX,0,300,0

20685,65,0,65,17,218,0,0,220,195,25,GOOOXXXXXXXXXXXXXXXXGOOOOOXXXXXXXXXXXXXXGOOOOOOOXXXXXXXXXXXXGOXXXXXXXXXXXXXXXXXXGOOOOOOOOXXXXXXXXXXXGXXXXXXXXXXXXXXXXXXXGOOOXXXXXXXXXXXXXXXXGOOXXXXXXXXXXXXXXXXXGOOOXXXXXXXXXXXXXXXXGOOOOOXXXXXXXXXXXXXXGOOXXXXXXXXXXXXXXXXXGOOOOOOXXXXXXXXXXXXXGOOOOOOOXXXXXXXXXXXX,0,300,0
20706,65,0,65,16,219,0,0,221,194,27,GOOOXXXXXXXXXXXXXXXXGOOOOOXXXXXXXXXXXXXXGOOOOOOOXXXXXXXXXXXXGOXXXXXXXXXXXXXXXXXXGOOOOOOOOXXXXXXXXXXXGXXXXXXXXXXXXXXXXXXXGOOOXXXXXXXXXXXXXXXXGOOXXXXXXXXXXXXXXXXXGOOOXXXXXXXXXXXXXXXXGOOOOOXXXXXXXXXXXXXXGOOXXXXXXXXXXXXXXXXXGOOOOOOXXXXXXXXXXXXXGOOOOOOOXXXXXXXXXXXX,0,300,0
20727,65,0,65,14,221,0,0,222,196,26,GOOOXXXXXXXXXXXXXXXXGOOOOOXXXXXXXXXXXXXXGOOOOOOOXXXXXXXXXXXXGOXXXXXXXXXXXXXXXXXXGOOOOOOOOXXXXXXXXXXXGXXXXXXXXXXXXXXXXXXXGOOOXXXXXXXXXXXXXXXXGOOXXXXXXXXXXXXXXXXXGOOOXXXXXXXXXXXXXXXXGOOOOOXXXXXXXXXXXXXXGOOXXXXXXXXXXXXXXXXXGOOOOOOXXXXXXXXXXXXXGOOOOOOOXXXXXXXXXXXX,0,300,0
20748,65,0,65,14,221,0,0,223,196,27,GOOOXXXXXXXXXXXXXXXXGOOOOOXXXXXXXXXXXXXXGOOOOOOOXXXXXXXXXXXXGOXXXXXXXXXXXXXXXXXXGOOOOOOOOXXXXXXXXXXXGXXXXXXXXXXXXXXXXXXXGOOOXXXXXXXXXXXXXXXXGOOXXXXXXXXXXXXXXXXXGOOOXXXXXXXXXXXXXXXXGOOOOOXXXXXXXXXXXXXXGOOXXXXXXXXXXXXXXXXXGOOOOOOXXXXXXXXXXXXXGOOOOOOOXXXXXXXXXXXX,0,300,0
20769,65,0,65,16,219,0,0,221,194,27,GOOOXXXXXXXXXXXXXXXXGOOOOOXXXXXXXXXXXXXXGOOOOOOOXXXXXXXXXXXXGOXXXXXXXXXXXXXXXXXXGOOOOOOOOXXXXXXXXXXXGXXXXXXXXXXXXXXXXXXXGOOOXXXXXXXXXXXXXXXXGOOXXXXXXXXXXXXXXXXXGOOOXXXXXXXXXXXXXXXXGOOOOOXXXXXXXXXXXXXXGOOXXXXXXXXXXXXXXXXXGOOOOOOXXXXXXXXXXXXXGOOOOOOOXXXXXXXXXXXX,0,300,0

20790,65,0,65,14,221,0,0,223,195,28,GOOOXXXXXXXXXXXXXXXXGOOOOOXXXXXXXXXXXXXXGOOOOOOOXXXXXXXXXXXXGOXXXXXXXXXXXXXXXXXXGOOOOOOOOXXXXXXXXXXXGXXXXXXXXXXXXXXXXXXXGOOOXXXXXXXXXXXXXXXXGOOXXXXXXXXXXXXXXXXXGOOOXXXXXXXXXXXXXXXXGOOOOOXXXXXXXXXXXXXXGOOXXXXXXXXXXXXXXXXXGOOOOOOXXXXXXXXXXXXXGOOOOOOOXXXXXXXXXXXX,0,300,0
20811,65,0,65,14,221,0,0,223,195,28,GOOOXXXXXXXXXXXXXXXXGOOOOOXXXXXXXXXXXXXXGOOOOOOOXXXXXXXXXXXXGOXXXXXXXXXXXXXXXXXXGOOOOOOOOXXXXXXXXXXXGXXXXXXXXXXXXXXXXXXXGOOOXXXXXXXXXXXXXXXXGOOXXXXXXXXXXXXXXXXXGOOOXXXXXXXXXXXXXXXXGOOOOOXXXXXXXXXXXXXXGOOXXXXXXXXXXXXXXXXXGOOOOOOXXXXXXXXXXXXXGOOOOOOOXXXXXXXXXXXX,0,300,0
20832,65,0,65,14,221,0,0,223,197,26,GOOOXXXXXXXXXXXXXXXXGOOOOOXXXXXXXXXXXXXXGOOOOOOOXXXXXXXXXXXXGOXXXXXXXXXXXXXXXXXXGOOOOOOOOXXXXXXXXXXXGXXXXXXXXXXXXXXXXXXXGOOOXXXXXXXXXXXXXXXXGOOXXXXXXXXXXXXXXXXXGOOOXXXXXXXXXXXXXXXXGOOOOOXXXXXXXXXXXXXXGOOXXXXXXXXXXXXXXXXXGOOOOOOXXXXXXXXXXXXXGOOOOOOOXXXXXXXXXXXX,0,300,0
20853,65,0,65,15,220,0,0,222,194,28,GOOOXXXXXXXXXXXXXXXXGOOOOOXXXXXXXXXXXXXXGOOOOOOOXXXXXXXXXXXXGOXXXXXXXXXXXXXXXXXXGOOOOOOOOXXXXXXXXXXXGXXXXXXXXXXXXXXXXXXXGOOOXXXXXXXXXXXXXXXXGOOXXXXXXXXXXXXXXXXXGOOOXXXXXXXXXXXXXXXXGOOOOOXXXXXXXXXXXXXXGOOXXXXXXXXXXXXXXXXXGOOOOOOXXXXXXXXXXXXXGOOOOOOOXXXXXXXXXXXX,0,300,0
20874,65,0,65,15,220,0,0,222,195,27,GOOOXXXXXXXXXXXXXXXXGOOOOOXXXXXXXXXXXXXXGOOOOOOOXXXXXXXXXXXXGOXXXXXXXXXXXXXXXXXXGOOOOOOOOXXXXXXXXXXXGXXXXXXXXXXXXXXXXXXXGOOOXXXXXXXXXXXXXXXXGOOXXXXXXXXXXXXXXXXXGOOOXXXXXXXXXXXXXXXXGOOOOOXXXXXXXXXXXXXXGOOXXXXXXXXXXXXXXXXXGOOOOOOXXXXXXXXXXXXXGOOOOOOOXXXXXXXXXXXX,0,300,0

20895,65,0,65,15,220,0,0,222,195,27,GOOOXXXXXXXXXXXXXXXXGOOOOOXXXXXXXXXXXXXXGOOOOOOOXXXXXXXXXXXXGOXXXXXXXXXXXXXXXXXXGOOOOOOOOXXXXXXXXXXXGXXXXXXXXXXXXXXXXXXXGOOOXXXXXXXXXXXXXXXXGOOXXXXXXXXXXXXXXXXXGOOOXXXXXXXXXXXXXXXXGOOOOOXXXXXXXXXXXXXXGOOXXXXXXXXXXXXXXXXXGOOOOOOXXXXXXXXXXXXXGOOOOOOOXXXXXXXXXXXX,0,300,0
20916,65,0,65,14,221,0,0,223,197,26,GOOOXXXXXXXXXXXXXXXXGOOOOOXXXXXXXXXXXXXXGOOOOOOOXXXXXXXXXXXXGOXXXXXXXXXXXXXXXXXXGOOOOOOOOXXXXXXXXXXXGXXXXXXXXXXXXXXXXXXXGOOOXXXXXXXXXXXXXXXXGOOXXXXXXXXXXXXXXXXXGOOOXXXXXXXXXXXXXXXXGOOOOOXXXXXXXXXXXXXXGOOXXXXXXXXXXXXXXXXXGOOOOOOXXXXXXXXXXXXXGOOOOOOOXXXXXXXXXXXX,0,300,0
20937,65,0,65,13,222,0,0,224,196,28,GOOOXXXXXXXXXXXXXXXXGOOOOOXXXXXXXXXXXXXXGOOOOOOOXXXXXXXXXXXXGOXXXXXXXXXXXXXXXXXXGOOOOOOOOXXXXXXXXXXXGXXXXXXXXXXXXXXXXXXXGOOOXXXXXXXXXXXXXXXXGOOXXXXXXXXXXXXXXXXXGOOOXXXXXXXXXXXXXXXXGOOOOOXXXXXXXXXXXXXXGOOXXXXXXXXXXXXXXXXXGOOOOOOXXXXXXXXXXXXXGOOOOOOOXXXXXXXXXXXX,0,300,0
20958,65,0,65,13,222,0,0,224,195,29,GOOOXXXXXXXXXXXXXXXXGOOOOOXXXXXXXXXXXXXXGOOOOOOOXXXXXXXXXXXXGOXXXXXXXXXXXXXXXXXXGOOOOOOOOXXXXXXXXXXXGXXXXXXXXXXXXXXXXXXXGOOOXXXXXXXXXXXXXXXXGOOXXXXXXXXXXXXXXXXXGOOOXXXXXXXXXXXXXXXXGOOOOOXXXXXXXXXXXXXXGOOXXXXXXXXXXXXXXXXXGOOOOOOXXXXXXXXXXXXXGOOOOOOOXXXXXXXXXXXX,0,300,0
20979,65,0,65,13,222,0,0,224,196,28,GOOOXXXXXXXXXXXXXXXXGOOOOOXXXXXXXXXXXXXXGOOOOOOOXXXXXXXXXXXXGOXXXXXXXXXXXXXXXXXXGOOOOOOOOXXXXXXXXXXXGXXXXXXXXXXXXXXXXXXXGOOOXXXXXXXXXXXXXXXXGOOXXXXXXXXXXXXXXXXXGOOOXXXXXXXXXXXXXXXXGOOOOOXXXXXXXXXXXXXXGOOXXXXXXXXXXXXXXXXXGOOOOOOXXXXXXXXXXXXXGOOOOOOOXXXXXXXXXXXX,0,300,0

21000,65,0,65,15,220,0,0,222,195,27,GOOOXXXXXXXXXXXXXXXXGOOOOOXXXXXXXXXXXXXXGOOOOOOOXXXXXXXXXXXXGOXXXXXXXXXXXXXXXXXXGOOOOOOOOXXXXXXXXXXXGXXXXXXXXXXXXXXXXXXXGOOOXXXXXXXXXXXXXXXXGOOXXXXXXXXXXXXXXXXXGOOOXXXXXXXXXXXXXXXXGOOOOOXXXXXXXXXXXXXXGOOXXXXXXXXXXXXXXXXXGOOOOOOXXXXXXXXXXXXXGOOOOOOOXXXXXXXXXXXX,0,300,0
21021,65,0,65,12,223,0,0,225,196,29,GOOOXXXXXXXXXXXXXXXXGOOOOOXXXXXXXXXXXXXXGOOOOOOOXXXXXXXXXXXXGOXXXXXXXXXXXXXXXXXXGOOOOOOOOXXXXXXXXXXXGXXXXXXXXXXXXXXXXXXXGOOOXXXXXXXXXXXXXXXXGOOXXXXXXXXXXXXXXXXXGOOOXXXXXXXXXXXXXXXXGOOOOOXXXXXXXXXXXXXXGOOXXXXXXXXXXXXXXXXXGOOOOOOXXXXXXXXXXXXXGOOOOOOOXXXXXXXXXXXX,0,300,0
21042,65,0,65,11,224,0,0,226,198,28,GOOOXXXXXXXXXXXXXXXXGOOOOOXXXXXXXXXXXXXXGOOOOOOOXXXXXXXXXXXXGOXXXXXXXXXXXXXXXXXXGOOOOOOOOXXXXXXXXXXXGXXXXXXXXXXXXXXXXXXXGOOOXXXXXXXXXXXXXXXXGOOXXXXXXXXXXXXXXXXXGOOOXXXXXXXXXXXXXXXXGOOOOOXXXXXXXXXXXXXXGOOXXXXXXXXXXXXXXXXXGOOOOOOXXXXXXXXXXXXXGOOOOOOOXXXXXXXXXXXX,0,300,0
21063,65,0,65,13,222,0,0,224,196,28,GOOOXXXXXXXXXXXXXXXXGOOOOOXXXXXXXXXXXXXXGOOOOOOOXXXXXXXXXXXXGOXXXXXXXXXXXXXXXXXXGOOOOOOOOXXXXXXXXXXXGXXXXXXXXXXXXXXXXXXXGOOOXXXXXXXXXXXXXXXXGOOXXXXXXXXXXXXXXXXXGOOOXXXXXXXXXXXXXXXXGOOOOOXXXXXXXXXXXXXXGOOXXXXXXXXXXXXXXXXXGOOOOOOXXXXXXXXXXXXXGOOOOOOOXXXXXXXXXXXX,0,300,0
21084,65,0,65,14,221,0,0,223,195,28,GOOOXXXXXXXXXXXXXXXXGOOOOOXXXXXXXXXXXXXXGOOOOOOOXXXXXXXXXXXXGOXXXXXXXXXXXXXXXXXXGOOOOOOOOXXXXXXXXXXXGXXXXXXXXXXXXXXXXXXXGOOOXXXXXXXXXXXXXXXXGOOXXXXXXXXXXXXXXXXXGOOOXXXXXXXXXXXXXXXXGOOOOOXXXXXXXXXXXXXXGOOXXXXXXXXXXXXXXXXXGOOOOOOXXXXXXXXXXXXXGOOOOOOOXXXXXXXXXXXX,0,300,0

21105,65,0,65,12,223,0,0,225,195,30,GOOOXXXXXXXXXXXXXXXXGOOOOOXXXXXXXXXXXXXXGOOOOOOOXXXXXXXXXXXXGOXXXXXXXXXXXXXXXXXXGOOOOOOOOXXXXXXXXXXXGXXXXXXXXXXXXXXXXXXXGOOOXXXXXXXXXXXXXXXXGOOXXXXXXXXXXXXXXXXXGOOOXXXXXXXXXXXXXXXXGOOOOOXXXXXXXXXXXXXXGOOXXXXXXXXXXXXXXXXXGOOOOOOXXXXXXXXXXXXXGOOOOOOOXXXXXXXXXXXX,0,300,0
21126,65,0,65,10,225,0,0,227,196,31,GOOOXXXXXXXXXXXXXXXXGOOOOOXXXXXXXXXXXXXXGOOOOOOOXXXXXXXXXXXXGOXXXXXXXXXXXXXXXXXXGOOOOOOOOXXXXXXXXXXXGXXXXXXXXXXXXXXXXXXXGOOOXXXXXXXXXXXXXXXXGOOXXXXXXXXXXXXXXXXXGOOOXXXXXXXXXXXXXXXXGOOOOOXXXXXXXXXXXXXXGOOXXXXXXXXXXXXXXXXXGOOOOOOXXXXXXXXXXXXXGOOOOOOOXXXXXXXXXXXX,0,300,0
21147,65,0,65,9,226,0,0,228,195,33,GOOOXXXXXXXXXXXXXXXXGOOOOOXXXXXXXXXXXXXXGOOOOOOOXXXXXXXXXXXXGOXXXXXXXXXXXXXXXXXXGOOOOOOOOXXXXXXXXXXXGXXXXXXXXXXXXXXXXXXXGOOOXXXXXXXXXXXXXXXXGOOXXXXXXXXXXXXXXXXXGOOOXXXXXXXXXXXXXXXXGOOOOOXXXXXXXXXXXXXXGOOXXXXXXXXXXXXXXXXXGOOOOOOXXXXXXXXXXXXXGOOOOOOOXXXXXXXXXXXX,0,300,0
21168,65,0,65,9,226,0,0,228,196,32,GOOOXXXXXXXXXXXXXXXXGOOOOOXXXXXXXXXXXXXXGOOOOOOOXXXXXXXXXXXXGOXXXXXXXXXXXXXXXXXXGOOOOOOOOXXXXXXXXXXXGXXXXXXXXXXXXXXXXXXXGOOOXXXXXXXXXXXXXXXXGOOXXXXXXXXXXXXXXXXXGOOOXXXXXXXXXXXXXXXXGOOOOOXXXXXXXXXXXXXXGOOXXXXXXXXXXXXXXXXXGOOOOOOXXXXXXXXXXXXXGOOOOOOOXXXXXXXXXXXX,0,300,0
21189,65,0,65,9,226,0,0,228,198,30,GOOOXXXXXXXXXXXXXXXXGOOOOOXXXXXXXXXXXXXXGOOOOOOOXXXXXXXXXXXXGOXXXXXXXXXXXXXXXXXXGOOOOOOOOXXXXXXXXXXXGXXXXXXXXXXXXXXXXXXXGOOOXXXXXXXXXXXXXXXXGOOXXXXXXXXXXXXXXXXXGOOOXXXXXXXXXXXXXXXXGOOOOOXXXXXXXXXXXXXXGOOXXXXXXXXXXXXXXXXXGOOOOOOXXXXXXXXXXXXXGOOOOOOOXXXXXXXXXXXX,0,300,0

21210,65,0,65,13,222,0,0,224,199,25,GOOOXXXXXXXXXXXXXXXXGOOOOOXXXXXXXXXXXXXXGOOOOOOOXXXXXXXXXXXXGOXXXXXXXXXXXXXXXXXXGOOOOOOOOXXXXXXXXXXXGXXXXXXXXXXXXXXXXXXXGOOOXXXXXXXXXXXXXXXXGOOXXXXXXXXXXXXXXXXXGOOOXXXXXXXXXXXXXXXXGOOOOOXXXXXXXXXXXXXXGOOXXXXXXXXXXXXXXXXXGOOOOOOXXXXXXXXXXXXXGOOOOOOOXXXXXXXXXXXX,0,300,0
21231,65,0,65,14,221,0,0,223,197,26,GOOOXXXXXXXXXXXXXXXXGOOOOOXXXXXXXXXXXXXXGOOOOOOOXXXXXXXXXXXXGOXXXXXXXXXXXXXXXXXXGOOOOOOOOXXXXXXXXXXXGXXXXXXXXXXXXXXXXXXXGOOOXXXXXXXXXXXXXXXXGOOXXXXXXXXXXXXXXXXXGOOOXXXXXXXXXXXXXXXXGOOOOOXXXXXXXXXXXXXXGOOXXXXXXXXXXXXXXXXXGOOOOOOXXXXXXXXXXXXXGOOOOOOOXXXXXXXXXXXX,0,300,0
21252,65,0,65,13,222,0,0,224,197,27,GOOOXXXXXXXXXXXXXXXXGOOOOOXXXXXXXXXXXXXXGOOOOOOOXXXXXXXXXXXXGOXXXXXXXXXXXXXXXXXXGOOOOOOOOXXXXXXXXXXXGXXXXXXXXXXXXXXXXXXXGOOOXXXXXXXXXXXXXXXXGOOXXXXXXXXXXXXXXXXXGOOOXXXXXXXXXXXXXXXXGOOOOOXXXXXXXXXXXXXXGOOXXXXXXXXXXXXXXXXXGOOOOOOXXXXXXXXXXXXXGOOOOOOOXXXXXXXXXXXX,0,300,0
21273,65,0,65,14,221,0,0,223,197,26,GOOOXXXXXXXXXXXXXXXXGOOOOOXXXXXXXXXXXXXXGOOOOOOOXXXXXXXXXXXXGOXXXXXXXXXXXXXXXXXXGOOOOOOOOXXXXXXXXXXXGXXXXXXXXXXXXXXXXXXXGOOOXXXXXXXXXXXXXXXXGOOXXXXXXXXXXXXXXXXXGOOOXXXXXXXXXXXXXXXXGOOOOOXXXXXXXXXXXXXXGOOXXXXXXXXXXXXXXXXXGOOOOOOXXXXXXXXXXXXXGOOOOOOOXXXXXXXXXXXX,0,300,0
21294,65,0,65,14,221,0,0,223,196,27,GOOOXXXXXXXXXXXXXXXXGOOOOOXXXXXXXXXXXXXXGOOOOOOOXXXXXXXXXXXXGOXXXXXXXXXXXXXXXXXXGOOOOOOOOXXXXXXXXXXXGXXXXXXXXXXXXXXXXXXXGOOOXXXXXXXXXXXXXXXXGOOXXXXXXXXXXXXXXXXXGOOOXXXXXXXXXXXXXXXXGOOOOOXXXXXXXXXXXXXXGOOXXXXXXXXXXXXXXXXXGOOOOOOXXXXXXXXXXXXXGOOOOOOOXXXXXXXXXXXX,0,300,0

21315,65,0,65,13,222,0,0,225,196,29,GOOOXXXXXXXXXXXXXXXXGOOOOOXXXXXXXXXXXXXXGOOOOOOOXXXXXXXXXXXXGOXXXXXXXXXXXXXXXXXXGOOOOOOOOXXXXXXXXXXXGXXXXXXXXXXXXXXXXXXXGOOOXXXXXXXXXXXXXXXXGOOXXXXXXXXXXXXXXXXXGOOOXXXXXXXXXXXXXXXXGOOOOOXXXXXXXXXXXXXXGOOXXXXXXXXXXXXXXXXXGOOOOOOXXXXXXXXXXXXXGOOOOOOOXXXXXXXXXXXX,0,300,0
21336,65,0,65,14,221,0,0,224,197,27,GOOOXXXXXXXXXXXXXXXXGOOOOOXXXXXXXXXXXXXXGOOOOOOOXXXXXXXXXXXXGOXXXXXXXXXXXXXXXXXXGOOOOOOOOXXXXXXXXXXXGXXXXXXXXXXXXXXXXXXXGOOOXXXXXXXXXXXXXXXXGOOXXXXXXXXXXXXXXXXXGOOOXXXXXXXXXXXXXXXXGOOOOOXXXXXXXXXXXXXXGOOXXXXXXXXXXXXXXXXXGOOOOOOXXXXXXXXXXXXXGOOOOOOOXXXXXXXXXXXX,0,300,0
21357,65,0,65,14,221,0,0,223,197,26,GOOOXXXXXXXXXXXXXXXXGOOOOOXXXXXXXXXXXXXXGOOOOOOOXXXXXXXXXXXXGOXXXXXXXXXXXXXXXXXXGOOOOOOOOXXXXXXXXXXXGXXXXXXXXXXXXXXXXXXXGOOOXXXXXXXXXXXXXXXXGOOXXXXXXXXXXXXXXXXXGOOOXXXXXXXXXXXXXXXXGOOOOOXXXXXXXXXXXXXXGOOXXXXXXXXXXXXXXXXXGOOOOOOXXXXXXXXXXXXXGOOOOOOOXXXXXXXXXXXX,0,300,0
21378,65,0,65,15,220,0,0,222,195,27,GOOOXXXXXXXXXXXXXXXXGOOOOOXXXXXXXXXXXXXXGOOOOOOOXXXXXXXXXXXXGOXXXXXXXXXXXXXXXXXXGOOOOOOOOXXXXXXXXXXXGXXXXXXXXXXXXXXXXXXXGOOOXXXXXXXXXXXXXXXXGOOXXXXXXXXXXXXXXXXXGOOOXXXXXXXXXXXXXXXXGOOOOOXXXXXXXXXXXXXXGOOXXXXXXXXXXXXXXXXXGOOOOOOXXXXXXXXXXXXXGOOOOOOOXXXXXXXXXXXX,0,300,0
21399,65,0,65,15,220,0,0,222,195,27,GOOOXXXXXXXXXXXXXXXXGOOOOOXXXXXXXXXXXXXXGOOOOOOOXXXXXXXXXXXXGOXXXXXXXXXXXXXXXXXXGOOOOOOOOXXXXXXXXXXXGXXXXXXXXXXXXXXXXXXXGOOOXXXXXXXXXXXXXXXXGOOXXXXXXXXXXXXXXXXXGOOOXXXXXXXXXXXXXXXXGOOOOOXXXXXXXXXXXXXXGOOXXXXXXXXXXXXXXXXXGOOOOOOXXXXXXXXXXXXXGOOOOOOOXXXXXXXXXXXX,0,300,0

21420,65,0,65,14,221,0,0,223,196,27,GOOOXXXXXXXXXXXXXXXXGOOOOOXXXXXXXXXXXXXXGOOOOOOOXXXXXXXXXXXXGOXXXXXXXXXXXXXXXXXXGOOOOOOOOXXXXXXXXXXXGXXXXXXXXXXXXXXXXXXXGOOOXXXXXXXXXXXXXXXXGOOXXXXXXXXXXXXXXXXXGOOOXXXXXXXXXXXXXXXXGOOOOOXXXXXXXXXXXXXXGOOXXXXXXXXXXXXXXXXXGOOOOOOXXXXXXXXXXXXXGOOOOOOOXXXXXXXXXXXX,0,300,0
21441,65,0,65,14,221,0,0,223,196,27,GOOOXXXXXXXXXXXXXXXXGOOOOOXXXXXXXXXXXXXXGOOOOOOOXXXXXXXXXXXXGOXXXXXXXXXXXXXXXXXXGOOOOOOOOXXXXXXXXXXXGXXXXXXXXXXXXXXXXXXXGOOOXXXXXXXXXXXXXXXXGOOXXXXXXXXXXXXXXXXXGOOOXXXXXXXXXXXXXXXXGOOOOOXXXXXXXXXXXXXXGOOXXXXXXXXXXXXXXXXXGOOOOOOXXXXXXXXXXXXXGOOOOOOOXXXXXXXXXXXX,0,300,0
21462,65,0,65,14,221,0,0,223,195,28,GOOOXXXXXXXXXXXXXXXXGOOOOOXXXXXXXXXXXXXXGOOOOOOOXXXXXXXXXXXXGOXXXXXXXXXXXXXXXXXXGOOOOOOOOXXXXXXXXXXXGXXXXXXXXXXXXXXXXXXXGOOOXXXXXXXXXXXXXXXXGOOXXXXXXXXXXXXXXXXXGOOOXXXXXXXXXXXXXXXXGOOOOOXXXXXXXXXXXXXXGOOXXXXXXXXXXXXXXXXXGOOOOOOXXXXXXXXXXXXXGOOOOOOOXXXXXXXXXXXX,0,300,0
21483,65,0,65,15,220,0,0,222,195,27,GOOOXXXXXXXXXXXXXXXXGOOOOOXXXXXXXXXXXXXXGOOOOOOOXXXXXXXXXXXXGOXXXXXXXXXXXXXXXXXXGOOOOOOOOXXXXXXXXXXXGXXXXXXXXXXXXXXXXXXXGOOOXXXXXXXXXXXXXXXXGOOXXXXXXXXXXXXXXXXXGOOOXXXXXXXXXXXXXXXXGOOOOOXXXXXXXXXXXXXXGOOXXXXXXXXXXXXXXXXXGOOOOOOXXXXXXXXXXXXXGOOOOOOOXXXXXXXXXXXX,0,300,0
21504,65,0,65,14,221,0,0,223,194,29,GOOOXXXXXXXXXXXXXXXXGOOOOOXXXXXXXXXXXXXXGOOOOOOOXXXXXXXXXXXXGOXXXXXXXXXXXXXXXXXXGOOOOOOOOXXXXXXXXXXXGXXXXXXXXXXXXXXXXXXXGOOOXXXXXXXXXXXXXXXXGOOXXXXXXXXXXXXXXXXXGOOOXXXXXXXXXXXXXXXXGOOOOOXXXXXXXXXXXXXXGOOXXXXXXXXXXXXXXXXXGOOOOOOXXXXXXXXXXXXXGOOOOOOOXXXXXXXXXXXX,0,300,0

21525,65,0,65,12,223,0,0,225,196,29,GOOOXXXXXXXXXXXXXXXXGOOOOOXXXXXXXXXXXXXXGOOOOOOOXXXXXXXXXXXXGOXXXXXXXXXXXXXXXXXXGOOOOOOOOXXXXXXXXXXXGXXXXXXXXXXXXXXXXXXXGOOOXXXXXXXXXXXXXXXXGOOXXXXXXXXXXXXXXXXXGOOOXXXXXXXXXXXXXXXXGOOOOOXXXXXXXXXXXXXXGOOXXXXXXXXXXXXXXXXXGOOOOOOXXXXXXXXXXXXXGOOOOOOOXXXXXXXXXXXX,0,300,0
21546,65,0,65,13,222,0,0,224,197,27,GOOOXXXXXXXXXXXXXXXXGOOOOOXXXXXXXXXXXXXXGOOOOOOOXXXXXXXXXXXXGOXXXXXXXXXXXXXXXXXXGOOOOOOOOXXXXXXXXXXXGXXXXXXXXXXXXXXXXXXXGOOOXXXXXXXXXXXXXXXXGOOXXXXXXXXXXXXXXXXXGOOOXXXXXXXXXXXXXXXXGOOOOOXXXXXXXXXXXXXXGOOXXXXXXXXXXXXXXXXXGOOOOOOXXXXXXXXXXXXXGOOOOOOOXXXXXXXXXXXX,0,300,0
21567,65,0,65,16,219,0,0,221,195,26,GOOOXXXXXXXXXXXXXXXXGOOOOOXXXXXXXXXXXXXXGOOOOOOOXXXXXXXXXXXXGOXXXXXXXXXXXXXXXXXXGOOOOOOOOXXXXXXXXXXXGXXXXXXXXXXXXXXXXXXXGOOOXXXXXXXXXXXXXXXXGOOXXXXXXXXXXXXXXXXXGOOOXXXXXXXXXXXXXXXXGOOOOOXXXXXXXXXXXXXXGOOXXXXXXXXXXXXXXXXXGOOOOOOXXXXXXXXXXXXXGOOOOOOOXXXXXXXXXXXX,0,300,0
21588,65,0,65,16,219,0,0,221,195,26,GOOOXXXXXXXXXXXXXXXXGOOOOOXXXXXXXXXXXXXXGOOOOOOOXXXXXXXXXXXXGOXXXXXXXXXXXXXXXXXXGOOOOOOOOXXXXXXXXXXXGXXXXXXXXXXXXXXXXXXXGOOOXXXXXXXXXXXXXXXXGOOXXXXXXXXXXXXXXXXXGOOOXXXXXXXXXXXXXXXXGOOOOOXXXXXXXXXXXXXXGOOXXXXXXXXXXXXXXXXXGOOOOOOXXXXXXXXXXXXXGOOOOOOOXXXXXXXXXXXX,0,300,0
21609,65,0,65,16,219,0,0,221,196,25,GOOOXXXXXXXXXXXXXXXXGOOOOOXXXXXXXXXXXXXXGOOOOOOOXXXXXXXXXXXXGOXXXXXXXXXXXXXXXXXXGOOOOOOOOXXXXXXXXXXXGXXXXXXXXXXXXXXXXXXXGOOOXXXXXXXXXXXXXXXXGOOXXXXXXXXXXXXXXXXXGOOOXXXXXXXXXXXXXXXXGOOOOOXXXXXXXXXXXXXXGOOXXXXXXXXXXXXXXXXXGOOOOOOXXXXXXXXXXXXXGOOOOOOOXXXXXXXXXXXX,0,300,0

21630,66,1,65,16,218,0,0,220,195,25,GOOOXXXXXXXXXXXXXXXXGOOOOOXXXXXXXXXXXXXXGOOOOOOOXXXXXXXXXXXXGOXXXXXXXXXXXXXXXXXXGOOOOOOOOXXXXXXXXXXXGAXXXXXXXXXXXXXXXXXXGOOOXXXXXXXXXXXXXXXXGOOXXXXXXXXXXXXXXXXXGOOOXXXXXXXXXXXXXXXXGOOOOOXXXXXXXXXXXXXXGOOXXXXXXXXXXXXXXXXXGOOOOOOXXXXXXXXXXXXXGOOOOOOOXXXXXXXXXXXX,0,300,0
21651,66,1,65,17,217,0,0,219,195,24,GOOOXXXXXXXXXXXXXXXXGOOOOOXXXXXXXXXXXXXXGOOOOOOOXXXXXXXXXXXXGOXXXXXXXXXXXXXXXXXXGOOOOOOOOXXXXXXXXXXXGAXXXXXXXXXXXXXXXXXXGOOOXXXXXXXXXXXXXXXXGOOXXXXXXXXXXXXXXXXXGOOOXXXXXXXXXXXXXXXXGOOOOOXXXXXXXXXXXXXXGOOXXXXXXXXXXXXXXXXXGOOOOOOXXXXXXXXXXXXXGOOOOOOOXXXXXXXXXXXX,0,300,0
21672,66,1,65,15,219,0,0,221,196,25,GOOOXXXXXXXXXXXXXXXXGOOOOOXXXXXXXXXXXXXXGOOOOOOOXXXXXXXXXXXXGOXXXXXXXXXXXXXXXXXXGOOOOOOOOXXXXXXXXXXXGAXXXXXXXXXXXXXXXXXXGOOOXXXXXXXXXXXXXXXXGOOXXXXXXXXXXXXXXXXXGOOOXXXXXXXXXXXXXXXXGOOOOOXXXXXXXXXXXXXXGOOXXXXXXXXXXXXXXXXXGOOOOOOXXXXXXXXXXXXXGOOOOOOOXXXXXXXXXXXX,0,300,0
21693,66,1,65,13,221,0,0,223,198,25,GOOOXXXXXXXXXXXXXXXXGOOOOOXXXXXXXXXXXXXXGOOOOOOOXXXXXXXXXXXXGOXXXXXXXXXXXXXXXXXXGOOOOOOOOXXXXXXXXXXXGAXXXXXXXXXXXXXXXXXXGOOOXXXXXXXXXXXXXXXXGOOXXXXXXXXXXXXXXXXXGOOOXXXXXXXXXXXXXXXXGOOOOOXXXXXXXXXXXXXXGOOXXXXXXXXXXXXXXXXXGOOOOOOXXXXXXXXXXXXXGOOOOOOOXXXXXXXXXXXX,0,300,0
21714,66,0,66,10,224,0,0,226,197,29,GOOOXXXXXXXXXXXXXXXXGOOOOOXXXXXXXXXXXXXXGOOOOOOOXXXXXXXXXXXXGOXXXXXXXXXXXXXXXXXXGOOOOOOOOXXXXXXXXXXXGOXXXXXXXXXXXXXXXXXXGOOOXXXXXXXXXXXXXXXXGOOXXXXXXXXXXXXXXXXXGOOOXXXXXXXXXXXXXXXXGOOOOOXXXXXXXXXXXXXXGOOXXXXXXXXXXXXXXXXXGOOOOOOXXXXXXXXXXXXXGOOOOOOOXXXXXXXXXXXX,0,300,0

21735,66,0,66,9,225,0,0,227,197,30,GOOOXXXXXXXXXXXXXXXXGOOOOOXXXXXXXXXXXXXXGOOOOOOOXXXXXXXXXXXXGOXXXXXXXXXXXXXXXXXXGOOOOOOOOXXXXXXXXXXXGOXXXXXXXXXXXXXXXXXXGOOOXXXXXXXXXXXXXXXXGOOXXXXXXXXXXXXXXXXXGOOOXXXXXXXXXXXXXXXXGOOOOOXXXXXXXXXXXXXXGOOXXXXXXXXXXXXXXXXXGOOOOOOXXXXXXXXXXXXXGOOOOOOOXXXXXXXXXXXX,0,300,0
21756,66,0,66,8,226,0,0,228,198,30,GOOOXXXXXXXXXXXXXXXXGOOOOOXXXXXXXXXXXXXXGOOOOOOOXXXXXXXXXXXXGOXXXXXXXXXXXXXXXXXXGOOOOOOOOXXXXXXXXXXXGOXXXXXXXXXXXXXXXXXXGOOOXXXXXXXXXXXXXXXXGOOXXXXXXXXXXXXXXXXXGOOOXXXXXXXXXXXXXXXXGOOOOOXXXXXXXXXXXXXXGOOXXXXXXXXXXXXXXXXXGOOOOOOXXXXXXXXXXXXXGOOOOOOOXXXXXXXXXXXX,0,300,0
21777,66,0,66,8,226,0,0,228,201,27,GOOOXXXXXXXXXXXXXXXXGOOOOOXXXXXXXXXXXXXXGOOOOOOOXXXXXXXXXXXXGOXXXXXXXXXXXXXXXXXXGOOOOOOOOXXXXXXXXXXXGOXXXXXXXXXXXXXXXXXXGOOOXXXXXXXXXXXXXXXXGOOXXXXXXXXXXXXXXXXXGOOOXXXXXXXXXXXXXXXXGOOOOOXXXXXXXXXXXXXXGOOXXXXXXXXXXXXXXXXXGOOOOOOXXXXXXXXXXXXXGOOOOOOOXXXXXXXXXXXX,0,300,0
21798,66,0,66,9,225,0,0,227,202,25,GOOOXXXXXXXXXXXXXXXXGOOOOOXXXXXXXXXXXXXXGOOOOOOOXXXXXXXXXXXXGOXXXXXXXXXXXXXXXXXXGOOOOOOOOXXXXXXXXXXXGOXXXXXXXXXXXXXXXXXXGOOOXXXXXXXXXXXXXXXXGOOXXXXXXXXXXXXXXXXXGOOOXXXXXXXXXXXXXXXXGOOOOOXXXXXXXXXXXXXXGOOXXXXXXXXXXXXXXXXXGOOOOOOXXXXXXXXXXXXXGOOOOOOOXXXXXXXXXXXX,0,300,0
21819,66,0,66,14,220,0,0,222,197,25,GOOOXXXXXXXXXXXXXXXXGOOOOOXXXXXXXXXXXXXXGOOOOOOOXXXXXXXXXXXXGOXXXXXXXXXXXXXXXXXXGOOOOOOOOXXXXXXXXXXXGOXXXXXXXXXXXXXXXXXXGOOOXXXXXXXXXXXXXXXXGOOXXXXXXXXXXXXXXXXXGOOOXXXXXXXXXXXXXXXXGOOOOOXXXXXXXXXXXXXXGOOXXXXXXXXXXXXXXXXXGOOOOOOXXXXXXXXXXXXXGOOOOOOOXXXXXXXXXXXX,0,300,0

21840,66,0,66,13,221,0,0,223,198,25,GOOOXXXXXXXXXXXXXXXXGOOOOOXXXXXXXXXXXXXXGOOOOOOOXXXXXXXXXXXXGOXXXXXXXXXXXXXXXXXXGOOOOOOOOXXXXXXXXXXXGOXXXXXXXXXXXXXXXXXXGOOOXXXXXXXXXXXXXXXXGOOXXXXXXXXXXXXXXXXXGOOOXXXXXXXXXXXXXXXXGOOOOOXXXXXXXXXXXXXXGOOXXXXXXXXXXXXXXXXXGOOOOOOXXXXXXXXXXXXXGOOOOOOOXXXXXXXXXXXX,0,300,0
21861,66,0,66,12,222,0,0,224,202,22,GOOOXXXXXXXXXXXXXXXXGOOOOOXXXXXXXXXXXXXXGOOOOOOOXXXXXXXXXXXXGOXXXXXXXXXXXXXXXXXXGOOOOOOOOXXXXXXXXXXXGOXXXXXXXXXXXXXXXXXXGOOOXXXXXXXXXXXXXXXXGOOXXXXXXXXXXXXXXXXXGOOOXXXXXXXXXXXXXXXXGOOOOOXXXXXXXXXXXXXXGOOXXXXXXXXXXXXXXXXXGOOOOOOXXXXXXXXXXXXXGOOOOOOOXXXXXXXXXXXX,0,300,0
21882,66,0,66,13,221,0,0,223,200,23,GOOOXXXXXXXXXXXXXXXXGOOOOOXXXXXXXXXXXXXXGOOOOOOOXXXXXXXXXXXXGOXXXXXXXXXXXXXXXXXXGOOOOOOOOXXXXXXXXXXXGOXXXXXXXXXXXXXXXXXXGOOOXXXXXXXXXXXXXXXXGOOXXXXXXXXXXXXXXXXXGOOOXXXXXXXXXXXXXXXXGOOOOOXXXXXXXXXXXXXXGOOXXXXXXXXXXXXXXXXXGOOOOOOXXXXXXXXXXXXXGOOOOOOOXXXXXXXXXXXX,0,300,0
21903,66,0,66,12,222,0,0,224,200,24,GOOOXXXXXXXXXXXXXXXXGOOOOOXXXXXXXXXXXXXXGOOOOOOOXXXXXXXXXXXXGOXXXXXXXXXXXXXXXXXXGOOOOOOOOXXXXXXXXXXXGOXXXXXXXXXXXXXXXXXXGOOOXXXXXXXXXXXXXXXXGOOXXXXXXXXXXXXXXXXXGOOOXXXXXXXXXXXXXXXXGOOOOOXXXXXXXXXXXXXXGOOXXXXXXXXXXXXXXXXXGOOOOOOXXXXXXXXXXXXXGOOOOOOOXXXXXXXXXXXX,0,300,0
21924,66,0,66,14,220,0,0,222,198,24,GOOOXXXXXXXXXXXXXXXXGOOOOOXXXXXXXXXXXXXXGOOOOOOOXXXXXXXXXXXXGOXXXXXXXXXXXXXXXXXXGOOOOOOOOXXXXXXXXXXXGOXXXXXXXXXXXXXXXXXXGOOOXXXXXXXXXXXXXXXXGOOXXXXXXXXXXXXXXXXXGOOOXXXXXXXXXXXXXXXXGOOOOOXXXXXXXXXXXXXXGOOXXXXXXXXXXXXXXXXXGOOOOOOXXXXXXXXXXXXXGOOOOOOOXXXXXXXXXXXX,0,300,0

21945,66,0,66,16,218,0,0,220,199,21,GOOOXXXXXXXXXXXXXXXXGOOOOOXXXXXXXXXXXXXXGOOOOOOOXXXXXXXXXXXXGOXXXXXXXXXXXXXXXXXXGOOOOOOOOXXXXXXXXXXXGOXXXXXXXXXXXXXXXXXXGOOOXXXXXXXXXXXXXXXXGOOXXXXXXXXXXXXXXXXXGOOOXXXXXXXXXXXXXXXXGOOOOOXXXXXXXXXXXXXXGOOXXXXXXXXXXXXXXXXXGOOOOOOXXXXXXXXXXXXXGOOOOOOOXXXXXXXXXXXX,0,300,0
21966,66,0,66,16,218,0,0,220,199,21,GOOOXXXXXXXXXXXXXXXXGOOOOOXXXXXXXXXXXXXXGOOOOOOOXXXXXXXXXXXXGOXXXXXXXXXXXXXXXXXXGOOOOOOOOXXXXXXXXXXXGOXXXXXXXXXXXXXXXXXXGOOOXXXXXXXXXXXXXXXXGOOXXXXXXXXXXXXXXXXXGOOOXXXXXXXXXXXXXXXXGOOOOOXXXXXXXXXXXXXXGOOXXXXXXXXXXXXXXXXXGOOOOOOXXXXXXXXXXXXXGOOOOOOOXXXXXXXXXXXX,0,300,0
21987,66,0,66,14,220,0,0,222,199,23,GOOOXXXXXXXXXXXXXXXXGOOOOOXXXXXXXXXXXXXXGOOOOOOOXXXXXXXXXXXXGOXXXXXXXXXXXXXXXXXXGOOOOOOOOXXXXXXXXXXXGOXXXXXXXXXXXXXXXXXXGOOOXXXXXXXXXXXXXXXXGOOXXXXXXXXXXXXXXXXXGOOOXXXXXXXXXXXXXXXXGOOOOOXXXXXXXXXXXXXXGOOXXXXXXXXXXXXXXXXXGOOOOOOXXXXXXXXXXXXXGOOOOOOOXXXXXXXXXXXX,0,300,0
22008,66,0,66,14,220,0,0,222,198,24,GOOOXXXXXXXXXXXXXXXXGOOOOOXXXXXXXXXXXXXXGOOOOOOOXXXXXXXXXXXXGOXXXXXXXXXXXXXXXXXXGOOOOOOOOXXXXXXXXXXXGOXXXXXXXXXXXXXXXXXXGOOOXXXXXXXXXXXXXXXXGOOXXXXXXXXXXXXXXXXXGOOOXXXXXXXXXXXXXXXXGOOOOOXXXXXXXXXXXXXXGOOXXXXXXXXXXXXXXXXXGOOOOOOXXXXXXXXXXXXXGOOOOOOOXXXXXXXXXXXX,0,300,0
22029,66,0,66,14,220,0,0,222,200,22,GOOOXXXXXXXXXXXXXXXXGOOOOOXXXXXXXXXXXXXXGOOOOOOOXXXXXXXXXXXXGOXXXXXXXXXXXXXXXXXXGOOOOOOOOXXXXXXXXXXXGOXXXXXXXXXXXXXXXXXXGOOOXXXXXXXXXXXXXXXXGOOXXXXXXXXXXXXXXXXXGOOOXXXXXXXXXXXXXXXXGOOOOOXXXXXXXXXXXXXXGOOXXXXXXXXXXXXXXXXXGOOOOOOXXXXXXXXXXXXXGOOOOOOOXXXXXXXXXXXX,0,300,0

22050,66,0,66,13,221,0,0,223,198,25,GOOOXXXXXXXXXXXXXXXXGOOOOOXXXXXXXXXXXXXXGOOOOOOOXXXXXXXXXXXXGOXXXXXXXXXXXXXXXXXXGOOOOOOOOXXXXXXXXXXXGOXXXXXXXXXXXXXXXXXXGOOOXXXXXXXXXXXXXXXXGOOXXXXXXXXXXXXXXXXXGOOOXXXXXXXXXXXXXXXXGOOOOOXXXXXXXXXXXXXXGOOXXXXXXXXXXXXXXXXXGOOOOOOXXXXXXXXXXXXXGOOOOOOOXXXXXXXXXXXX,0,300,0
22071,66,0,66,13,221,0,0,224,198,26,GOOOXXXXXXXXXXXXXXXXGOOOOOXXXXXXXXXXXXXXGOOOOOOOXXXXXXXXXXXXGOXXXXXXXXXXXXXXXXXXGOOOOOOOOXXXXXXXXXXXGOXXXXXXXXXXXXXXXXXXGOOOXXXXXXXXXXXXXXXXGOOXXXXXXXXXXXXXXXXXGOOOXXXXXXXXXXXXXXXXGOOOOOXXXXXXXXXXXXXXGOOXXXXXXXXXXXXXXXXXGOOOOOOXXXXXXXXXXXXXGOOOOOOOXXXXXXXXXXXX,0,300,0
22092,66,0,66,14,220,0,0,223,199,24,GOOOXXXXXXXXXXXXXXXXGOOOOOXXXXXXXXXXXXXXGOOOOOOOXXXXXXXXXXXXGOXXXXXXXXXXXXXXXXXXGOOOOOOOOXXXXXXXXXXXGOXXXXXXXXXXXXXXXXXXGOOOXXXXXXXXXXXXXXXXGOOXXXXXXXXXXXXXXXXXGOOOXXXXXXXXXXXXXXXXGOOOOOXXXXXXXXXXXXXXGOOXXXXXXXXXXXXXXXXXGOOOOOOXXXXXXXXXXXXXGOOOOOOOXXXXXXXXXXXX,0,300,0
22113,66,0,66,12,222,0,0,225,200,25,GOOOXXXXXXXXXXXXXXXXGOOOOOXXXXXXXXXXXXXXGOOOOOOOXXXXXXXXXXXXGOXXXXXXXXXXXXXXXXXXGOOOOOOOOXXXXXXXXXXXGOXXXXXXXXXXXXXXXXXXGOOOXXXXXXXXXXXXXXXXGOOXXXXXXXXXXXXXXXXXGOOOXXXXXXXXXXXXXXXXGOOOOOXXXXXXXXXXXXXXGOOXXXXXXXXXXXXXXXXXGOOOOOOXXXXXXXXXXXXXGOOOOOOOXXXXXXXXXXXX,0,300,0
22134,66,0,66,12,222,0,0,224,199,25,GOOOXXXXXXXXXXXXXXXXGOOOOOXXXXXXXXXXXXXXGOOOOOOOXXXXXXXXXXXXGOXXXXXXXXXXXXXXXXXXGOOOOOOOOXXXXXXXXXXXGOXXXXXXXXXXXXXXXXXXGOOOXXXXXXXXXXXXXXXXGOOXXXXXXXXXXXXXXXXXGOOOXXXXXXXXXXXXXXXXGOOOOOXXXXXXXXXXXXXXGOOXXXXXXXXXXXXXXXXXGOOOOOOXXXXXXXXXXXXXGOOOOOOOXXXXXXXXXXXX,0,300,0

22155,66,0,66,12,222,0,0,224,201,23,GOOOXXXXXXXXXXXXXXXXGOOOOOXXXXXXXXXXXXXXGOOOOOOOXXXXXXXXXXXXGOXXXXXXXXXXXXXXXXXXGOOOOOOOOXXXXXXXXXXXGOXXXXXXXXXXXXXXXXXXGOOOXXXXXXXXXXXXXXXXGOOXXXXXXXXXXXXXXXXXGOOOXXXXXXXXXXXXXXXXGOOOOOXXXXXXXXXXXXXXGOOXXXXXXXXXXXXXXXXXGOOOOOOXXXXXXXXXXXXXGOOOOOOOXXXXXXXXXXXX,0,300,0
22176,66,0,66,12,222,0,0,224,200,24,GOOOXXXXXXXXXXXXXXXXGOOOOOXXXXXXXXXXXXXXGOOOOOOOXXXXXXXXXXXXGOXXXXXXXXXXXXXXXXXXGOOOOOOOOXXXXXXXXXXXGOXXXXXXXXXXXXXXXXXXGOOOXXXXXXXXXXXXXXXXGOOXXXXXXXXXXXXXXXXXGOOOXXXXXXXXXXXXXXXXGOOOOOXXXXXXXXXXXXXXGOOXXXXXXXXXXXXXXXXXGOOOOOOXXXXXXXXXXXXXGOOOOOOOXXXXXXXXXXXX,0,300,0
22197,66,0,66,11,223,0,0,225,201,24,GOOOXXXXXXXXXXXXXXXXGOOOOOXXXXXXXXXXXXXXGOOOOOOOXXXXXXXXXXXXGOXXXXXXXXXXXXXXXXXXGOOOOOOOOXXXXXXXXXXXGOXXXXXXXXXXXXXXXXXXGOOOXXXXXXXXXXXXXXXXGOOXXXXXXXXXXXXXXXXXGOOOXXXXXXXXXXXXXXXXGOOOOOXXXXXXXXXXXXXXGOOXXXXXXXXXXXXXXXXXGOOOOOOXXXXXXXXXXXXXGOOOOOOOXXXXXXXXXXXX,0,300,0
22218,66,0,66,12,222,0,0,224,201,23,GOOOXXXXXXXXXXXXXXXXGOOOOOXXXXXXXXXXXXXXGOOOOOOOXXXXXXXXXXXXGOXXXXXXXXXXXXXXXXXXGOOOOOOOOXXXXXXXXXXXGOXXXXXXXXXXXXXXXXXXGOOOXXXXXXXXXXXXXXXXGOOXXXXXXXXXXXXXXXXXGOOOXXXXXXXXXXXXXXXXGOOOOOXXXXXXXXXXXXXXGOOXXXXXXXXXXXXXXXXXGOOOOOOXXXXXXXXXXXXXGOOOOOOOXXXXXXXXXXXX,0,300,0
22239,66,0,66,11,223,0,0,225,201,24,GOOOXXXXXXXXXXXXXXXXGOOOOOXXXXXXXXXXXXXXGOOOOOOOXXXXXXXXXXXXGOXXXXXXXXXXXXXXXXXXGOOOOOOOOXXXXXXXXXXXGOXXXXXXXXXXXXXXXXXXGOOOXXXXXXXXXXXXXXXXGOOXXXXXXXXXXXXXXXXXGOOOXXXXXXXXXXXXXXXXGOOOOOXXXXXXXXXXXXXXGOOXXXXXXXXXXXXXXXXXGOOOOOOXXXXXXXXXXXXXGOOOOOOOXXXXXXXXXXXX,0,300,0

22260,66,0,66,11,223,0,0,225,201,24,GOOOXXXXXXXXXXXXXXXXGOOOOOXXXXXXXXXXXXXXGOOOOOOOXXXXXXXXXXXXGOXXXXXXXXXXXXXXXXXXGOOOOOOOOXXXXXXXXXXXGOXXXXXXXXXXXXXXXXXXGOOOXXXXXXXXXXXXXXXXGOOXXXXXXXXXXXXXXXXXGOOOXXXXXXXXXXXXXXXXGOOOOOXXXXXXXXXXXXXXGOOXXXXXXXXXXXXXXXXXGOOOOOOXXXXXXXXXXXXXGOOOOOOOXXXXXXXXXXXX,0,300,0
22281,66,0,66,9,225,0,0,227,204,23,GOOOXXXXXXXXXXXXXXXXGOOOOOXXXXXXXXXXXXXXGOOOOOOOXXXXXXXXXXXXGOXXXXXXXXXXXXXXXXXXGOOOOOOOOXXXXXXXXXXXGOXXXXXXXXXXXXXXXXXXGOOOXXXXXXXXXXXXXXXXGOOXXXXXXXXXXXXXXXXXGOOOXXXXXXXXXXXXXXXXGOOOOOXXXXXXXXXXXXXXGOOXXXXXXXXXXXXXXXXXGOOOOOOXXXXXXXXXXXXXGOOOOOOOXXXXXXXXXXXX,0,300,0
22302,66,0,66,10,224,0,0,226,207,19,GOOOXXXXXXXXXXXXXXXXGOOOOOXXXXXXXXXXXXXXGOOOOOOOXXXXXXXXXXXXGOXXXXXXXXXXXXXXXXXXGOOOOOOOOXXXXXXXXXXXGOXXXXXXXXXXXXXXXXXXGOOOXXXXXXXXXXXXXXXXGOOXXXXXXXXXXXXXXXXXGOOOXXXXXXXXXXXXXXXXGOOOOOXXXXXXXXXXXXXXGOOXXXXXXXXXXXXXXXXXGOOOOOOXXXXXXXXXXXXXGOOOOOOOXXXXXXXXXXXX,0,300,0
22323,66,0,66,11,223,0,0,225,205,20,GOOOXXXXXXXXXXXXXXXXGOOOOOXXXXXXXXXXXXXXGOOOOOOOXXXXXXXXXXXXGOXXXXXXXXXXXXXXXXXXGOOOOOOOOXXXXXXXXXXXGOXXXXXXXXXXXXXXXXXXGOOOXXXXXXXXXXXXXXXXGOOXXXXXXXXXXXXXXXXXGOOOXXXXXXXXXXXXXXXXGOOOOOXXXXXXXXXXXXXXGOOXXXXXXXXXXXXXXXXXGOOOOOOXXXXXXXXXXXXXGOOOOOOOXXXXXXXXXXXX,0,300,0
22344,66,0,66,14,220,0,0,222,204,18,GOOOXXXXXXXXXXXXXXXXGOOOOOXXXXXXXXXXXXXXGOOOOOOOXXXXXXXXXXXXGOXXXXXXXXXXXXXXXXXXGOOOOOOOOXXXXXXXXXXXGOXXXXXXXXXXXXXXXXXXGOOOXXXXXXXXXXXXXXXXGOOXXXXXXXXXXXXXXXXXGOOOXXXXXXXXXXXXXXXXGOOOOOXXXXXXXXXXXXXXGOOXXXXXXXXXXXXXXXXXGOOOOOOXXXXXXXXXXXXXGOOOOOOOXXXXXXXXXXXX,0,300,0

22365,66,0,66,13,221,0,0,223,203,20,GOOOXXXXXXXXXXXXXXXXGOOOOOXXXXXXXXXXXXXXGOOOOOOOXXXXXXXXXXXXGOXXXXXXXXXXXXXXXXXXGOOOOOOOOXXXXXXXXXXXGOXXXXXXXXXXXXXXXXXXGOOOXXXXXXXXXXXXXXXXGOOXXXXXXXXXXXXXXXXXGOOOXXXXXXXXXXXXXXXXGOOOOOXXXXXXXXXXXXXXGOOXXXXXXXXXXXXXXXXXGOOOOOOXXXXXXXXXXXXXGOOOOOOOXXXXXXXXXXXX,0,300,0
22386,66,0,66,11,223,0,0,225,204,21,GOOOXXXXXXXXXXXXXXXXGOOOOOXXXXXXXXXXXXXXGOOOOOOOXXXXXXXXXXXXGOXXXXXXXXXXXXXXXXXXGOOOOOOOOXXXXXXXXXXXGOXXXXXXXXXXXXXXXXXXGOOOXXXXXXXXXXXXXXXXGOOXXXXXXXXXXXXXXXXXGOOOXXXXXXXXXXXXXXXXGOOOOOXXXXXXXXXXXXXXGOOXXXXXXXXXXXXXXXXXGOOOOOOXXXXXXXXXXXXXGOOOOOOOXXXXXXXXXXXX,0,300,0
22407,66,0,66,11,223,0,0,225,205,20,GOOOXXXXXXXXXXXXXXXXGOOOOOXXXXXXXXXXXXXXGOOOOOOOXXXXXXXXXXXXGOXXXXXXXXXXXXXXXXXXGOOOOOOOOXXXXXXXXXXXGOXXXXXXXXXXXXXXXXXXGOOOXXXXXXXXXXXXXXXXGOOXXXXXXXXXXXXXXXXXGOOOXXXXXXXXXXXXXXXXGOOOOOXXXXXXXXXXXXXXGOOXXXXXXXXXXXXXXXXXGOOOOOOXXXXXXXXXXXXXGOOOOOOOXXXXXXXXXXXX,0,300,0
22428,66,0,66,11,223,0,0,225,204,21,GOOOXXXXXXXXXXXXXXXXGOOOOOXXXXXXXXXXXXXXGOOOOOOOXXXXXXXXXXXXGOXXXXXXXXXXXXXXXXXXGOOOOOOOOXXXXXXXXXXXGOXXXXXXXXXXXXXXXXXXGOOOXXXXXXXXXXXXXXXXGOOXXXXXXXXXXXXXXXXXGOOOXXXXXXXXXXXXXXXXGOOOOOXXXXXXXXXXXXXXGOOXXXXXXXXXXXXXXXXXGOOOOOOXXXXXXXXXXXXXGOOOOOOOXXXXXXXXXXXX,0,300,0
22449,67,1,66,10,223,0,0,225,204,21,GOOOXXXXXXXXXXXXXXXXGOOOOOXXXXXXXXXXXXXXGOOOOOOOXXXXXXXXXXXXGOXXXXXXXXXXXXXXXXXXGOOOOOOOOAXXXXXXXXXXGOXXXXXXXXXXXXXXXXXXGOOOXXXXXXXXXXXXXXXXGOOXXXXXXXXXXXXXXXXXGOOOXXXXXXXXXXXXXXXXGOOOOOXXXXXXXXXXXXXXGOOXXXXXXXXXXXXXXXXXGOOOOOOXXXXXXXXXXXXXGOOOOOOOXXXXXXXXXXXX,0,300,0

22470,67,1,66,9,224,0,0,226,206,20,GOOOXXXXXXXXXXXXXXXXGOOOOOXXXXXXXXXXXXXXGOOOOOOOXXXXXXXXXXXXGOXXXXXXXXXXXXXXXXXXGOOOOOOOOAXXXXXXXXXXGOXXXXXXXXXXXXXXXXXXGOOOXXXXXXXXXXXXXXXXGOOXXXXXXXXXXXXXXXXXGOOOXXXXXXXXXXXXXXXXGOOOOOXXXXXXXXXXXXXXGOOXXXXXXXXXXXXXXXXXGOOOOOOXXXXXXXXXXXXXGOOOOOOOXXXXXXXXXXXX,0,300,0
22491,67,1,66,11,222,0,0,224,204,20,GOOOXXXXXXXXXXXXXXXXGOOOOOXXXXXXXXXXXXXXGOOOOOOOXXXXXXXXXXXXGOXXXXXXXXXXXXXXXXXXGOOOOOOOOAXXXXXXXXXXGOXXXXXXXXXXXXXXXXXXGOOOXXXXXXXXXXXXXXXXGOOXXXXXXXXXXXXXXXXXGOOOXXXXXXXXXXXXXXXXGOOOOOXXXXXXXXXXXXXXGOOXXXXXXXXXXXXXXXXXGOOOOOOXXXXXXXXXXXXXGOOOOOOOXXXXXXXXXXXX,0,300,0
22512,67,1,66,10,223,0,0,225,203,22,GOOOXXXXXXXXXXXXXXXXGOOOOOXXXXXXXXXXXXXXGOOOOOOOXXXXXXXXXXXXGOXXXXXXXXXXXXXXXXXXGOOOOOOOOAXXXXXXXXXXGOXXXXXXXXXXXXXXXXXXGOOOXXXXXXXXXXXXXXXXGOOXXXXXXXXXXXXXXXXXGOOOXXXXXXXXXXXXXXXXGOOOOOXXXXXXXXXXXXXXGOOXXXXXXXXXXXXXXXXXGOOOOOOXXXXXXXXXXXXXGOOOOOOOXXXXXXXXXXXX,0,300,0
22533,67,1,66,11,222,0,0,224,204,20,GOOOXXXXXXXXXXXXXXXXGOOOOOXXXXXXXXXXXXXXGOOOOOOOXXXXXXXXXXXXGOXXXXXXXXXXXXXXXXXXGOOOOOOOOAXXXXXXXXXXGOXXXXXXXXXXXXXXXXXXGOOOXXXXXXXXXXXXXXXXGOOXXXXXXXXXXXXXXXXXGOOOXXXXXXXXXXXXXXXXGOOOOOXXXXXXXXXXXXXXGOOXXXXXXXXXXXXXXXXXGOOOOOOXXXXXXXXXXXXXGOOOOOOOXXXXXXXXXXXX,0,300,0
22554,67,1,66,10,223,0,0,225,205,20,GOOOXXXXXXXXXXXXXXXXGOOOOOXXXXXXXXXXXXXXGOOOOOOOXXXXXXXXXXXXGOXXXXXXXXXXXXXXXXXXGOOOOOOOOAXXXXXXXXXXGOXXXXXXXXXXXXXXXXXXGOOOXXXXXXXXXXXXXXXXGOOXXXXXXXXXXXXXXXXXGOOOXXXXXXXXXXXXXXXXGOOOOOXXXXXXXXXXXXXXGOOXXXXXXXXXXXXXXXXXGOOOOOOXXXXXXXXXXXXXGOOOOOOOXXXXXXXXXXXX,0,300,0

22575,67,0,67,9,224,0,0,226,204,22,GOOOXXXXXXXXXXXXXXXXGOOOOOXXXXXXXXXXXXXXGOOOOOOOXXXXXXXXXXXXGOXXXXXXXXXXXXXXXXXXGOOOOOOOOOXXXXXXXXXXGOXXXXXXXXXXXXXXXXXXGOOOXXXXXXXXXXXXXXXXGOOXXXXXXXXXXXXXXXXXGOOOXXXXXXXXXXXXXXXXGOOOOOXXXXXXXXXXXXXXGOOXXXXXXXXXXXXXXXXXGOOOOOOXXXXXXXXXXXXXGOOOOOOOXXXXXXXXXXXX,0,300,0
22596,67,0,67,10,223,0,0,225,203,22,GOOOXXXXXXXXXXXXXXXXGOOOOOXXXXXXXXXXXXXXGOOOOOOOXXXXXXXXXXXXGOXXXXXXXXXXXXXXXXXXGOOOOOOOOOXXXXXXXXXXGOXXXXXXXXXXXXXXXXXXGOOOXXXXXXXXXXXXXXXXGOOXXXXXXXXXXXXXXXXXGOOOXXXXXXXXXXXXXXXXGOOOOOXXXXXXXXXXXXXXGOOXXXXXXXXXXXXXXXXXGOOOOOOXXXXXXXXXXXXXGOOOOOOOXXXXXXXXXXXX,0,300,0
22617,67,0,67,9,224,0,0,226,203,23,GOOOXXXXXXXXXXXXXXXXGOOOOOXXXXXXXXXXXXXXGOOOOOOOXXXXXXXXXXXXGOXXXXXXXXXXXXXXXXXXGOOOOOOOOOXXXXXXXXXXGOXXXXXXXXXXXXXXXXXXGOOOXXXXXXXXXXXXXXXXGOOXXXXXXXXXXXXXXXXXGOOOXXXXXXXXXXXXXXXXGOOOOOXXXXXXXXXXXXXXGOOXXXXXXXXXXXXXXXXXGOOOOOOXXXXXXXXXXXXXGOOOOOOOXXXXXXXXXXXX,0,300,0
22638,67,0,67,8,225,0,0,227,203,24,GOOOXXXXXXXXXXXXXXXXGOOOOOXXXXXXXXXXXXXXGOOOOOOOXXXXXXXXXXXXGOXXXXXXXXXXXXXXXXXXGOOOOOOOOOXXXXXXXXXXGOXXXXXXXXXXXXXXXXXXGOOOXXXXXXXXXXXXXXXXGOOXXXXXXXXXXXXXXXXXGOOOXXXXXXXXXXXXXXXXGOOOOOXXXXXXXXXXXXXXGOOXXXXXXXXXXXXXXXXXGOOOOOOXXXXXXXXXXXXXGOOOOOOOXXXXXXXXXXXX,0,300,0
22659,67,0,67,5,228,0,0,230,205,25,GOOOXXXXXXXXXXXXXXXXGOOOOOXXXXXXXXXXXXXXGOOOOOOOXXXXXXXXXXXXGOXXXXXXXXXXXXXXXXXXGOOOOOOOOOXXXXXXXXXXGOXXXXXXXXXXXXXXXXXXGOOOXXXXXXXXXXXXXXXXGOOXXXXXXXXXXXXXXXXXGOOOXXXXXXXXXXXXXXXXGOOOOOXXXXXXXXXXXXXXGOOXXXXXXXXXXXXXXXXXGOOOOOOXXXXXXXXXXXXXGOOOOOOOXXXXXXXXXXXX,0,300,0

22680,67,0,67,7,226,0,0,228,203,25,GOOOXXXXXXXXXXXXXXXXGOOOOOXXXXXXXXXXXXXXGOOOOOOOXXXXXXXXXXXXGOXXXXXXXXXXXXXXXXXXGOOOOOOOOOXXXXXXXXXXGOXXXXXXXXXXXXXXXXXXGOOOXXXXXXXXXXXXXXXXGOOXXXXXXXXXXXXXXXXXGOOOXXXXXXXXXXXXXXXXGOOOOOXXXXXXXXXXXXXXGOOXXXXXXXXXXXXXXXXXGOOOOOOXXXXXXXXXXXXXGOOOOOOOXXXXXXXXXXXX,0,300,0
22701,67,0,67,8,225,0,0,227,204,23,GOOOXXXXXXXXXXXXXXXXGOOOOOXXXXXXXXXXXXXXGOOOOOOOXXXXXXXXXXXXGOXXXXXXXXXXXXXXXXXXGOOOOOOOOOXXXXXXXXXXGOXXXXXXXXXXXXXXXXXXGOOOXXXXXXXXXXXXXXXXGOOXXXXXXXXXXXXXXXXXGOOOXXXXXXXXXXXXXXXXGOOOOOXXXXXXXXXXXXXXGOOXXXXXXXXXXXXXXXXXGOOOOOOXXXXXXXXXXXXXGOOOOOOOXXXXXXXXXXXX,0,300,0
22722,67,0,67,8,225,0,0,227,204,23,GOOOXXXXXXXXXXXXXXXXGOOOOOXXXXXXXXXXXXXXGOOOOOOOXXXXXXXXXXXXGOXXXXXXXXXXXXXXXXXXGOOOOOOOOOXXXXXXXXXXGOXXXXXXXXXXXXXXXXXXGOOOXXXXXXXXXXXXXXXXGOOXXXXXXXXXXXXXXXXXGOOOXXXXXXXXXXXXXXXXGOOOOOXXXXXXXXXXXXXXGOOXXXXXXXXXXXXXXXXXGOOOOOOXXXXXXXXXXXXXGOOOOOOOXXXXXXXXXXXX,0,300,0
22743,67,0,67,10,223,0,0,225,205,20,GOOOXXXXXXXXXXXXXXXXGOOOOOXXXXXXXXXXXXXXGOOOOOOOXXXXXXXXXXXXGOXXXXXXXXXXXXXXXXXXGOOOOOOOOOXXXXXXXXXXGOXXXXXXXXXXXXXXXXXXGOOOXXXXXXXXXXXXXXXXGOOXXXXXXXXXXXXXXXXXGOOOXXXXXXXXXXXXXXXXGOOOOOXXXXXXXXXXXXXXGOOXXXXXXXXXXXXXXXXXGOOOOOOXXXXXXXXXXXXXGOOOOOOOXXXXXXXXXXXX,0,300,0
22764,67,0,67,12,221,0,0,223,206,17,GOOOXXXXXXXXXXXXXXXXGOOOOOXXXXXXXXXXXXXXGOOOOOOOXXXXXXXXXXXXGOXXXXXXXXXXXXXXXXXXGOOOOOOOOOXXXXXXXXXXGOXXXXXXXXXXXXXXXXXXGOOOXXXXXXXXXXXXXXXXGOOXXXXXXXXXXXXXXXXXGOOOXXXXXXXXXXXXXXXXGOOOOOXXXXXXXXXXXXXXGOOXXXXXXXXXXXXXXXXXGOOOOOOXXXXXXXXXXXXXGOOOOOOOXXXXXXXXXXXX,0,300,0

22785,67,0,67,13,220,0,0,222,207,15,GOOOXXXXXXXXXXXXXXXXGOOOOOXXXXXXXXXXXXXXGOOOOOOOXXXXXXXXXXXXGOXXXXXXXXXXXXXXXXXXGOOOOOOOOOXXXXXXXXXXGOXXXXXXXXXXXXXXXXXXGOOOXXXXXXXXXXXXXXXXGOOXXXXXXXXXXXXXXXXXGOOOXXXXXXXXXXXXXXXXGOOOOOXXXXXXXXXXXXXXGOOXXXXXXXXXXXXXXXXXGOOOOOOXXXXXXXXXXXXXGOOOOOOOXXXXXXXXXXXX,0,300,0
22806,67,0,67,15,218,0,0,220,206,14,GOOOXXXXXXXXXXXXXXXXGOOOOOXXXXXXXXXXXXXXGOOOOOOOXXXXXXXXXXXXGOXXXXXXXXXXXXXXXXXXGOOOOOOOOOXXXXXXXXXXGOXXXXXXXXXXXXXXXXXXGOOOXXXXXXXXXXXXXXXXGOOXXXXXXXXXXXXXXXXXGOOOXXXXXXXXXXXXXXXXGOOOOOXXXXXXXXXXXXXXGOOXXXXXXXXXXXXXXXXXGOOOOOOXXXXXXXXXXXXXGOOOOOOOXXXXXXXXXXXX,0,300,0
22827,67,0,67,18,215,0,0,217,204,13,GOOOXXXXXXXXXXXXXXXXGOOOOOXXXXXXXXXXXXXXGOOOOOOOXXXXXXXXXXXXGOXXXXXXXXXXXXXXXXXXGOOOOOOOOOXXXXXXXXXXGOXXXXXXXXXXXXXXXXXXGOOOXXXXXXXXXXXXXXXXGOOXXXXXXXXXXXXXXXXXGOOOXXXXXXXXXXXXXXXXGOOOOOXXXXXXXXXXXXXXGOOXXXXXXXXXXXXXXXXXGOOOOOOXXXXXXXXXXXXXGOOOOOOOXXXXXXXXXXXX,0,300,0
22848,67,0,67,18,215,0,0,217,203,14,GOOOXXXXXXXXXXXXXXXXGOOOOOXXXXXXXXXXXXXXGOOOOOOOXXXXXXXXXXXXGOXXXXXXXXXXXXXXXXXXGOOOOOOOOOXXXXXXXXXXGOXXXXXXXXXXXXXXXXXXGOOOXXXXXXXXXXXXXXXXGOOXXXXXXXXXXXXXXXXXGOOOXXXXXXXXXXXXXXXXGOOOOOXXXXXXXXXXXXXXGOOXXXXXXXXXXXXXXXXXGOOOOOOXXXXXXXXXXXXXGOOOOOOOXXXXXXXXXXXX,0,300,0
22869,67,0,67,16,217,0,0,219,202,17,GOOOXXXXXXXXXXXXXXXXGOOOOOXXXXXXXXXXXXXXGOOOOOOOXXXXXXXXXXXXGOXXXXXXXXXXXXXXXXXXGOOOOOOOOOXXXXXXXXXXGOXXXXXXXXXXXXXXXXXXGOOOXXXXXXXXXXXXXXXXGOOXXXXXXXXXXXXXXXXXGOOOXXXXXXXXXXXXXXXXGOOOOOXXXXXXXXXXXXXXGOOXXXXXXXXXXXXXXXXXGOOOOOOXXXXXXXXXXXXXGOOOOOOOXXXXXXXXXXXX,0,300,0

22890,67,0,67,15,218,0,0,220,203,17,GOOOXXXXXXXXXXXXXXXXGOOOOOXXXXXXXXXXXXXXGOOOOOOOXXXXXXXXXXXXGOXXXXXXXXXXXXXXXXXXGOOOOOOOOOXXXXXXXXXXGOXXXXXXXXXXXXXXXXXXGOOOXXXXXXXXXXXXXXXXGOOXXXXXXXXXXXXXXXXXGOOOXXXXXXXXXXXXXXXXGOOOOOXXXXXXXXXXXXXXGOOXXXXXXXXXXXXXXXXXGOOOOOOXXXXXXXXXXXXXGOOOOOOOXXXXXXXXXXXX,0,300,0
22911,67,0,67,14,219,0,0,221,204,17,GOOOXXXXXXXXXXXXXXXXGOOOOOXXXXXXXXXXXXXXGOOOOOOOXXXXXXXXXXXXGOXXXXXXXXXXXXXXXXXXGOOOOOOOOOXXXXXXXXXXGOXXXXXXXXXXXXXXXXXXGOOOXXXXXXXXXXXXXXXXGOOXXXXXXXXXXXXXXXXXGOOOXXXXXXXXXXXXXXXXGOOOOOXXXXXXXXXXXXXXGOOXXXXXXXXXXXXXXXXXGOOOOOOXXXXXXXXXXXXXGOOOOOOOXXXXXXXXXXXX,0,300,0
22932,67,0,67,14,219,0,0,221,203,18,GOOOXXXXXXXXXXXXXXXXGOOOOOXXXXXXXXXXXXXXGOOOOOOOXXXXXXXXXXXXGOXXXXXXXXXXXXXXXXXXGOOOOOOOOOXXXXXXXXXXGOXXXXXXXXXXXXXXXXXXGOOOXXXXXXXXXXXXXXXXGOOXXXXXXXXXXXXXXXXXGOOOXXXXXXXXXXXXXXXXGOOOOOXXXXXXXXXXXXXXGOOXXXXXXXXXXXXXXXXXGOOOOOOXXXXXXXXXXXXXGOOOOOOOXXXXXXXXXXXX,0,300,0
22953,67,0,67,12,221,0,0,223,203,20,GOOOXXXXXXXXXXXXXXXXGOOOOOXXXXXXXXXXXXXXGOOOOOOOXXXXXXXXXXXXGOXXXXXXXXXXXXXXXXXXGOOOOOOOOOXXXXXXXXXXGOXXXXXXXXXXXXXXXXXXGOOOXXXXXXXXXXXXXXXXGOOXXXXXXXXXXXXXXXXXGOOOXXXXXXXXXXXXXXXXGOOOOOXXXXXXXXXXXXXXGOOXXXXXXXXXXXXXXXXXGOOOOOOXXXXXXXXXXXXXGOOOOOOOXXXXXXXXXXXX,0,300,0
22974,67,0,67,14,219,0,0,221,203,18,GOOOXXXXXXXXXXXXXXXXGOOOOOXXXXXXXXXXXXXXGOOOOOOOXXXXXXXXXXXXGOXXXXXXXXXXXXXXXXXXGOOOOOOOOOXXXXXXXXXXGOXXXXXXXXXXXXXXXXXXGOOOXXXXXXXXXXXXXXXXGOOXXXXXXXXXXXXXXXXXGOOOXXXXXXXXXXXXXXXXGOOOOOXXXXXXXXXXXXXXGOOXXXXXXXXXXXXXXXXXGOOOOOOXXXXXXXXXXXXXGOOOOOOOXXXXXXXXXXXX,0,300,0

22995,67,0,67,14,219,0,0,221,204,17,GOOOXXXXXXXXXXXXXXXXGOOOOOXXXXXXXXXXXXXXGOOOOOOOXXXXXXXXXXXXGOXXXXXXXXXXXXXXXXXXGOOOOOOOOOXXXXXXXXXXGOXXXXXXXXXXXXXXXXXXGOOOXXXXXXXXXXXXXXXXGOOXXXXXXXXXXXXXXXXXGOOOXXXXXXXXXXXXXXXXGOOOOOXXXXXXXXXXXXXXGOOXXXXXXXXXXXXXXXXXGOOOOOOXXXXXXXXXXXXXGOOOOOOOXXXXXXXXXXXX,0,300,0
23016,67,0,67,15,218,0,0,220,203,17,GOOOXXXXXXXXXXXXXXXXGOOOOOXXXXXXXXXXXXXXGOOOOOOOXXXXXXXXXXXXGOXXXXXXXXXXXXXXXXXXGOOOOOOOOOXXXXXXXXXXGOXXXXXXXXXXXXXXXXXXGOOOXXXXXXXXXXXXXXXXGOOXXXXXXXXXXXXXXXXXGOOOXXXXXXXXXXXXXXXXGOOOOOXXXXXXXXXXXXXXGOOXXXXXXXXXXXXXXXXXGOOOOOOXXXXXXXXXXXXXGOOOOOOOXXXXXXXXXXXX,0,300,0
23037,67,0,67,13,220,0,0,222,204,18,GOOOXXXXXXXXXXXXXXXXGOOOOOXXXXXXXXXXXXXXGOOOOOOOXXXXXXXXXXXXGOXXXXXXXXXXXXXXXXXXGOOOOOOOOOXXXXXXXXXXGOXXXXXXXXXXXXXXXXXXGOOOXXXXXXXXXXXXXXXXGOOXXXXXXXXXXXXXXXXXGOOOXXXXXXXXXXXXXXXXGOOOOOXXXXXXXXXXXXXXGOOXXXXXXXXXXXXXXXXXGOOOOOOXXXXXXXXXXXXXGOOOOOOOXXXXXXXXXXXX,0,300,0
23058,67,0,67,13,220,0,0,222,205,17,GOOOXXXXXXXXXXXXXXXXGOOOOOXXXXXXXXXXXXXXGOOOOOOOXXXXXXXXXXXXGOXXXXXXXXXXXXXXXXXXGOOOOOOOOOXXXXXXXXXXGOXXXXXXXXXXXXXXXXXXGOOOXXXXXXXXXXXXXXXXGOOXXXXXXXXXXXXXXXXXGOOOXXXXXXXXXXXXXXXXGOOOOOXXXXXXXXXXXXXXGOOXXXXXXXXXXXXXXXXXGOOOOOOXXXXXXXXXXXXXGOOOOOOOXXXXXXXXXXXX,0,300,0
23079,67,0,67,16,217,0,0,219,203,16,GOOOXXXXXXXXXXXXXXXXGOOOOOXXXXXXXXXXXXXXGOOOOOOOXXXXXXXXXXXXGOXXXXXXXXXXXXXXXXXXGOOOOOOOOOXXXXXXXXXXGOXXXXXXXXXXXXXXXXXXGOOOXXXXXXXXXXXXXXXXGOOXXXXXXXXXXXXXXXXXGOOOXXXXXXXXXXXXXXXXGOOOOOXXXXXXXXXXXXXXGOOXXXXXXXXXXXXXXXXXGOOOOOOXXXXXXXXXXXXXGOOOOOOOXXXXXXXXXXXX,0,300,0

23100,67,0,67,15,218,0,0,220,203,17,GOOOXXXXXXXXXXXXXXXXGOOOOOXXXXXXXXXXXXXXGOOOOOOOXXXXXXXXXXXXGOXXXXXXXXXXXXXXXXXXGOOOOOOOOOXXXXXXXXXXGOXXXXXXXXXXXXXXXXXXGOOOXXXXXXXXXXXXXXXXGOOXXXXXXXXXXXXXXXXXGOOOXXXXXXXXXXXXXXXXGOOOOOXXXXXXXXXXXXXXGOOXXXXXXXXXXXXXXXXXGOOOOOOXXXXXXXXXXXXXGOOOOOOOXXXXXXXXXXXX,0,300,0
23121,67,0,67,14,219,0,0,221,205,16,GOOOXXXXXXXXXXXXXXXXGOOOOOXXXXXXXXXXXXXXGOOOOOOOXXXXXXXXXXXXGOXXXXXXXXXXXXXXXXXXGOOOOOOOOOXXXXXXXXXXGOXXXXXXXXXXXXXXXXXXGOOOXXXXXXXXXXXXXXXXGOOXXXXXXXXXXXXXXXXXGOOOXXXXXXXXXXXXXXXXGOOOOOXXXXXXXXXXXXXXGOOXXXXXXXXXXXXXXXXXGOOOOOOXXXXXXXXXXXXXGOOOOOOOXXXXXXXXXXXX,0,300,0
23142,67,0,67,12,221,0,0,223,205,18,GOOOXXXXXXXXXXXXXXXXGOOOOOXXXXXXXXXXXXXXGOOOOOOOXXXXXXXXXXXXGOXXXXXXXXXXXXXXXXXXGOOOOOOOOOXXXXXXXXXXGOXXXXXXXXXXXXXXXXXXGOOOXXXXXXXXXXXXXXXXGOOXXXXXXXXXXXXXXXXXGOOOXXXXXXXXXXXXXXXXGOOOOOXXXXXXXXXXXXXXGOOXXXXXXXXXXXXXXXXXGOOOOOOXXXXXXXXXXXXXGOOOOOOOXXXXXXXXXXXX,0,300,0
23163,67,0,67,13,220,0,0,222,204,18,GOOOXXXXXXXXXXXXXXXXGOOOOOXXXXXXXXXXXXXXGOOOOOOOXXXXXXXXXXXXGOXXXXXXXXXXXXXXXXXXGOOOOOOOOOXXXXXXXXXXGOXXXXXXXXXXXXXXXXXXGOOOXXXXXXXXXXXXXXXXGOOXXXXXXXXXXXXXXXXXGOOOXXXXXXXXXXXXXXXXGOOOOOXXXXXXXXXXXXXXGOOXXXXXXXXXXXXXXXXXGOOOOOOXXXXXXXXXXXXXGOOOOOOOXXXXXXXXXXXX,0,300,0
23184,67,0,67,13,220,0,0,222,203,19,GOOOXXXXXXXXXXXXXXXXGOOOOOXXXXXXXXXXXXXXGOOOOOOOXXXXXXXXXXXXGOXXXXXXXXXXXXXXXXXXGOOOOOOOOOXXXXXXXXXXGOXXXXXXXXXXXXXXXXXXGOOOXXXXXXXXXXXXXXXXGOOXXXXXXXXXXXXXXXXXGOOOXXXXXXXXXXXXXXXXGOOOOOXXXXXXXXXXXXXXGOOXXXXXXXXXXXXXXXXXGOOOOOOXXXXXXXXXXXXXGOOOOOOOXXXXXXXXXXXX,0,300,0

23205,67,0,67,12,221,0,0,223,204,19,GOOOXXXXXXXXXXXXXXXXGOOOOOXXXXXXXXXXXXXXGOOOOOOOXXXXXXXXXXXXGOXXXXXXXXXXXXXXXXXXGOOOOOOOOOXXXXXXXXXXGOXXXXXXXXXXXXXXXXXXGOOOXXXXXXXXXXXXXXXXGOOXXXXXXXXXXXXXXXXXGOOOXXXXXXXXXXXXXXXXGOOOOOXXXXXXXXXXXXXXGOOXXXXXXXXXXXXXXXXXGOOOOOOXXXXXXXXXXXXXGOOOOOOOXXXXXXXXXXXX,0,300,0
23226,67,0,67,10,223,0,0,225,204,21,GOOOXXXXXXXXXXXXXXXXGOOOOOXXXXXXXXXXXXXXGOOOOOOOXXXXXXXXXXXXGOXXXXXXXXXXXXXXXXXXGOOOOOOOOOXXXXXXXXXXGOXXXXXXXXXXXXXXXXXXGOOOXXXXXXXXXXXXXXXXGOOXXXXXXXXXXXXXXXXXGOOOXXXXXXXXXXXXXXXXGOOOOOXXXXXXXXXXXXXXGOOXXXXXXXXXXXXXXXXXGOOOOOOXXXXXXXXXXXXXGOOOOOOOXXXXXXXXXXXX,0,300,0
23247,67,0,67,9,224,0,0,226,204,22,GOOOXXXXXXXXXXXXXXXXGOOOOOXXXXXXXXXXXXXXGOOOOOOOXXXXXXXXXXXXGOXXXXXXXXXXXXXXXXXXGOOOOOOOOOXXXXXXXXXXGOXXXXXXXXXXXXXXXXXXGOOOXXXXXXXXXXXXXXXXGOOXXXXXXXXXXXXXXXXXGOOOXXXXXXXXXXXXXXXXGOOOOOXXXXXXXXXXXXXXGOOXXXXXXXXXXXXXXXXXGOOOOOOXXXXXXXXXXXXXGOOOOOOOXXXXXXXXXXXX,0,300,0
23268,67,0,67,9,224,0,0,226,205,21,GOOOXXXXXXXXXXXXXXXXGOOOOOXXXXXXXXXXXXXXGOOOOOOOXXXXXXXXXXXXGOXXXXXXXXXXXXXXXXXXGOOOOOOOOOXXXXXXXXXXGOXXXXXXXXXXXXXXXXXXGOOOXXXXXXXXXXXXXXXXGOOXXXXXXXXXXXXXXXXXGOOOXXXXXXXXXXXXXXXXGOOOOOXXXXXXXXXXXXXXGOOXXXXXXXXXXXXXXXXXGOOOOOOXXXXXXXXXXXXXGOOOOOOOXXXXXXXXXXXX,0,300,0
23289,67,0,67,9,224,0,0,226,204,22,GOOOXXXXXXXXXXXXXXXXGOOOOOXXXXXXXXXXXXXXGOOOOOOOXXXXXXXXXXXXGOXXXXXXXXXXXXXXXXXXGOOOOOOOOOXXXXXXXXXXGOXXXXXXXXXXXXXXXXXXGOOOXXXXXXXXXXXXXXXXGOOXXXXXXXXXXXXXXXXXGOOOXXXXXXXXXXXXXXXXGOOOOOXXXXXXXXXXXXXXGOOXXXXXXXXXXXXXXXXXGOOOOOOXXXXXXXXXXXXXGOOOOOOOXXXXXXXXXXXX,0,300,0

23310,67,0,67,9,224,0,0,226,204,22,GOOOXXXXXXXXXXXXXXXXGOOOOOXXXXXXXXXXXXXXGOOOOOOOXXXXXXXXXXXXGOXXXXXXXXXXXXXXXXXXGOOOOOOOOOXXXXXXXXXXGOXXXXXXXXXXXXXXXXXXGOOOXXXXXXXXXXXXXXXXGOOXXXXXXXXXXXXXXXXXGOOOXXXXXXXXXXXXXXXXGOOOOOXXXXXXXXXXXXXXGOOXXXXXXXXXXXXXXXXXGOOOOOOXXXXXXXXXXXXXGOOOOOOOXXXXXXXXXXXX,0,300,0
23331,67,0,67,8,225,0,0,227,205,22,GOOOXXXXXXXXXXXXXXXXGOOOOOXXXXXXXXXXXXXXGOOOOOOOXXXXXXXXXXXXGOXXXXXXXXXXXXXXXXXXGOOOOOOOOOXXXXXXXXXXGOXXXXXXXXXXXXXXXXXXGOOOXXXXXXXXXXXXXXXXGOOXXXXXXXXXXXXXXXXXGOOOXXXXXXXXXXXXXXXXGOOOOOXXXXXXXXXXXXXXGOOXXXXXXXXXXXXXXXXXGOOOOOOXXXXXXXXXXXXXGOOOOOOOXXXXXXXXXXXX,0,300,0
23352,67,0,67,8,225,0,0,227,205,22,GOOOXXXXXXXXXXXXXXXXGOOOOOXXXXXXXXXXXXXXGOOOOOOOXXXXXXXXXXXXGOXXXXXXXXXXXXXXXXXXGOOOOOOOOOXXXXXXXXXXGOXXXXXXXXXXXXXXXXXXGOOOXXXXXXXXXXXXXXXXGOOXXXXXXXXXXXXXXXXXGOOOXXXXXXXXXXXXXXXXGOOOOOXXXXXXXXXXXXXXGOOXXXXXXXXXXXXXXXXXGOOOOOOXXXXXXXXXXXXXGOOOOOOOXXXXXXXXXXXX,0,300,0
23373,67,0,67,9,224,0,0,226,206,20,GOOOXXXXXXXXXXXXXXXXGOOOOOXXXXXXXXXXXXXXGOOOOOOOXXXXXXXXXXXXGOXXXXXXXXXXXXXXXXXXGOOOOOOOOOXXXXXXXXXXGOXXXXXXXXXXXXXXXXXXGOOOXXXXXXXXXXXXXXXXGOOXXXXXXXXXXXXXXXXXGOOOXXXXXXXXXXXXXXXXGOOOOOXXXXXXXXXXXXXXGOOXXXXXXXXXXXXXXXXXGOOOOOOXXXXXXXXXXXXXGOOOOOOOXXXXXXXXXXXX,0,300,0
23394,67,0,67,12,221,0,0,223,206,17,GOOOXXXXXXXXXXXXXXXXGOOOOOXXXXXXXXXXXXXXGOOOOOOOXXXXXXXXXXXXGOXXXXXXXXXXXXXXXXXXGOOOOOOOOOXXXXXXXXXXGOXXXXXXXXXXXXXXXXXXGOOOXXXXXXXXXXXXXXXXGOOXXXXXXXXXXXXXXXXXGOOOXXXXXXXXXXXXXXXXGOOOOOXXXXXXXXXXXXXXGOOXXXXXXXXXXXXXXXXXGOOOOOOXXXXXXXXXXXXXGOOOOOOOXXXXXXXXXXXX,0,300,0

23415,67,0,67,12,221,0,0,223,204,19,GOOOXXXXXXXXXXXXXXXXGOOOOOXXXXXXXXXXXXXXGOOOOOOOXXXXXXXXXXXXGOXXXXXXXXXXXXXXXXXXGOOOOOOOOOXXXXXXXXXXGOXXXXXXXXXXXXXXXXXXGOOOXXXXXXXXXXXXXXXXGOOXXXXXXXXXXXXXXXXXGOOOXXXXXXXXXXXXXXXXGOOOOOXXXXXXXXXXXXXXGOOXXXXXXXXXXXXXXXXXGOOOOOOXXXXXXXXXXXXXGOOOOOOOXXXXXXXXXXXX,0,300,0
23436,67,0,67,12,221,0,0,223,206,17,GOOOXXXXXXXXXXXXXXXXGOOOOOXXXXXXXXXXXXXXGOOOOOOOXXXXXXXXXXXXGOXXXXXXXXXXXXXXXXXXGOOOOOOOOOXXXXXXXXXXGOXXXXXXXXXXXXXXXXXXGOOOXXXXXXXXXXXXXXXXGOOXXXXXXXXXXXXXXXXXGOOOXXXXXXXXXXXXXXXXGOOOOOXXXXXXXXXXXXXXGOOXXXXXXXXXXXXXXXXXGOOOOOOXXXXXXXXXXXXXGOOOOOOOXXXXXXXXXXXX,0,300,0
23457,67,0,67,13,220,0,0,222,204,18,GOOOXXXXXXXXXXXXXXXXGOOOOOXXXXXXXXXXXXXXGOOOOOOOXXXXXXXXXXXXGOXXXXXXXXXXXXXXXXXXGOOOOOOOOOXXXXXXXXXXGOXXXXXXXXXXXXXXXXXXGOOOXXXXXXXXXXXXXXXXGOOXXXXXXXXXXXXXXXXXGOOOXXXXXXXXXXXXXXXXGOOOOOXXXXXXXXXXXXXXGOOXXXXXXXXXXXXXXXXXGOOOOOOXXXXXXXXXXXXXGOOOOOOOXXXXXXXXXXXX,0,300,0
23478,67,0,67,10,223,0,0,225,204,21,GOOOXXXXXXXXXXXXXXXXGOOOOOXXXXXXXXXXXXXXGOOOOOOOXXXXXXXXXXXXGOXXXXXXXXXXXXXXXXXXGOOOOOOOOOXXXXXXXXXXGOXXXXXXXXXXXXXXXXXXGOOOXXXXXXXXXXXXXXXXGOOXXXXXXXXXXXXXXXXXGOOOXXXXXXXXXXXXXXXXGOOOOOXXXXXXXXXXXXXXGOOXXXXXXXXXXXXXXXXXGOOOOOOXXXXXXXXXXXXXGOOOOOOOXXXXXXXXXXXX,0,300,0
23499,67,0,67,10,223,0,0,225,205,20,GOOOXXXXXXXXXXXXXXXXGOOOOOXXXXXXXXXXXXXXGOOOOOOOXXXXXXXXXXXXGOXXXXXXXXXXXXXXXXXXGOOOOOOOOOXXXXXXXXXXGOXXXXXXXXXXXXXXXXXXGOOOXXXXXXXXXXXXXXXXGOOXXXXXXXXXXXXXXXXXGOOOXXXXXXXXXXXXXXXXGOOOOOXXXXXXXXXXXXXXGOOXXXXXXXXXXXXXXXXXGOOOOOOXXXXXXXXXXXXXGOOOOOOOXXXXXXXXXXXX,0,300,0

23520,67,0,67,11,222,0,0,224,206,18,GOOOXXXXXXXXXXXXXXXXGOOOOOXXXXXXXXXXXXXXGOOOOOOOXXXXXXXXXXXXGOXXXXXXXXXXXXXXXXXXGOOOOOOOOOXXXXXXXXXXGOXXXXXXXXXXXXXXXXXXGOOOXXXXXXXXXXXXXXXXGOOXXXXXXXXXXXXXXXXXGOOOXXXXXXXXXXXXXXXXGOOOOOXXXXXXXXXXXXXXGOOXXXXXXXXXXXXXXXXXGOOOOOOXXXXXXXXXXXXXGOOOOOOOXXXXXXXXXXXX,0,300,0
23541,67,0,67,11,222,0,0,224,206,18,GOOOXXXXXXXXXXXXXXXXGOOOOOXXXXXXXXXXXXXXGOOOOOOOXXXXXXXXXXXXGOXXXXXXXXXXXXXXXXXXGOOOOOOOOOXXXXXXXXXXGOXXXXXXXXXXXXXXXXXXGOOOXXXXXXXXXXXXXXXXGOOXXXXXXXXXXXXXXXXXGOOOXXXXXXXXXXXXXXXXGOOOOOXXXXXXXXXXXXXXGOOXXXXXXXXXXXXXXXXXGOOOOOOXXXXXXXXXXXXXGOOOOOOOXXXXXXXXXXXX,0,300,0
23562,67,0,67,9,224,0,0,226,206,20,GOOOXXXXXXXXXXXXXXXXGOOOOOXXXXXXXXXXXXXXGOOOOOOOXXXXXXXXXXXXGOXXXXXXXXXXXXXXXXXXGOOOOOOOOOXXXXXXXXXXGOXXXXXXXXXXXXXXXXXXGOOOXXXXXXXXXXXXXXXXGOOXXXXXXXXXXXXXXXXXGOOOXXXXXXXXXXXXXXXXGOOOOOXXXXXXXXXXXXXXGOOXXXXXXXXXXXXXXXXXGOOOOOOXXXXXXXXXXXXXGOOOOOOOXXXXXXXXXXXX,0,300,0
23583,67,0,67,11,222,0,0,224,207,17,GOOOXXXXXXXXXXXXXXXXGOOOOOXXXXXXXXXXXXXXGOOOOOOOXXXXXXXXXXXXGOXXXXXXXXXXXXXXXXXXGOOOOOOOOOXXXXXXXXXXGOXXXXXXXXXXXXXXXXXXGOOOXXXXXXXXXXXXXXXXGOOXXXXXXXXXXXXXXXXXGOOOXXXXXXXXXXXXXXXXGOOOOOXXXXXXXXXXXXXXGOOXXXXXXXXXXXXXXXXXGOOOOOOXXXXXXXXXXXXXGOOOOOOOXXXXXXXXXXXX,0,300,0
23604,67,0,67,12,221,0,0,223,206,17,GOOOXXXXXXXXXXXXXXXXGOOOOOXXXXXXXXXXXXXXGOOOOOOOXXXXXXXXXXXXGOXXXXXXXXXXXXXXXXXXGOOOOOOOOOXXXXXXXXXXGOXXXXXXXXXXXXXXXXXXGOOOXXXXXXXXXXXXXXXXGOOXXXXXXXXXXXXXXXXXGOOOXXXXXXXXXXXXXXXXGOOOOOXXXXXXXXXXXXXXGOOXXXXXXXXXXXXXXXXXGOOOOOOXXXXXXXXXXXXXGOOOOOOOXXXXXXXXXXXX,0,300,0

23625,67,0,67,11,222,0,0,224,206,18,GOOOXXXXXXXXXXXXXXXXGOOOOOXXXXXXXXXXXXXXGOOOOOOOXXXXXXXXXXXXGOXXXXXXXXXXXXXXXXXXGOOOOOOOOOXXXXXXXXXXGOXXXXXXXXXXXXXXXXXXGOOOXXXXXXXXXXXXXXXXGOOXXXXXXXXXXXXXXXXXGOOOXXXXXXXXXXXXXXXXGOOOOOXXXXXXXXXXXXXXGOOXXXXXXXXXXXXXXXXXGOOOOOOXXXXXXXXXXXXXGOOOOOOOXXXXXXXXXXXX,0,300,0
23646,67,0,67,10,223,0,0,225,205,20,GOOOXXXXXXXXXXXXXXXXGOOOOOXXXXXXXXXXXXXXGOOOOOOOXXXXXXXXXXXXGOXXXXXXXXXXXXXXXXXXGOOOOOOOOOXXXXXXXXXXGOXXXXXXXXXXXXXXXXXXGOOOXXXXXXXXXXXXXXXXGOOXXXXXXXXXXXXXXXXXGOOOXXXXXXXXXXXXXXXXGOOOOOXXXXXXXXXXXXXXGOOXXXXXXXXXXXXXXXXXGOOOOOOXXXXXXXXXXXXXGOOOOOOOXXXXXXXXXXXX,0,300,0
23667,67,0,67,8,225,0,0,227,207,20,GOOOXXXXXXXXXXXXXXXXGOOOOOXXXXXXXXXXXXXXGOOOOOOOXXXXXXXXXXXXGOXXXXXXXXXXXXXXXXXXGOOOOOOOOOXXXXXXXXXXGOXXXXXXXXXXXXXXXXXXGOOOXXXXXXXXXXXXXXXXGOOXXXXXXXXXXXXXXXXXGOOOXXXXXXXXXXXXXXXXGOOOOOXXXXXXXXXXXXXXGOOXXXXXXXXXXXXXXXXXGOOOOOOXXXXXXXXXXXXXGOOOOOOOXXXXXXXXXXXX,0,300,0
23688,67,0,67,9,224,0,0,226,208,18,GOOOXXXXXXXXXXXXXXXXGOOOOOXXXXXXXXXXXXXXGOOOOOOOXXXXXXXXXXXXGOXXXXXXXXXXXXXXXXXXGOOOOOOOOOXXXXXXXXXXGOXXXXXXXXXXXXXXXXXXGOOOXXXXXXXXXXXXXXXXGOOXXXXXXXXXXXXXXXXXGOOOXXXXXXXXXXXXXXXXGOOOOOXXXXXXXXXXXXXXGOOXXXXXXXXXXXXXXXXXGOOOOOOXXXXXXXXXXXXXGOOOOOOOXXXXXXXXXXXX,0,300,0
23709,67,0,67,8,225,0,0,226,209,17,GOOOXXXXXXXXXXXXXXXXGOOOOOXXXXXXXXXXXXXXGOOOOOOOXXXXXXXXXXXXGOXXXXXXXXXXXXXXXXXXGOOOOOOOOOXXXXXXXXXXGOXXXXXXXXXXXXXXXXXXGOOOXXXXXXXXXXXXXXXXGOOXXXXXXXXXXXXXXXXXGOOOXXXXXXXXXXXXXXXXGOOOOOXXXXXXXXXXXXXXGOOXXXXXXXXXXXXXXXXXGOOOOOOXXXXXXXXXXXXXGOOOOOOOXXXXXXXXXXXX,0,300,0

23730,67,0,67,11,222,0,0,224,207,17,GOOOXXXXXXXXXXXXXXXXGOOOOOXXXXXXXXXXXXXXGOOOOOOOXXXXXXXXXXXXGOXXXXXXXXXXXXXXXXXXGOOOOOOOOOXXXXXXXXXXGOXXXXXXXXXXXXXXXXXXGOOOXXXXXXXXXXXXXXXXGOOXXXXXXXXXXXXXXXXXGOOOXXXXXXXXXXXXXXXXGOOOOOXXXXXXXXXXXXXXGOOXXXXXXXXXXXXXXXXXGOOOOOOXXXXXXXXXXXXXGOOOOOOOXXXXXXXXXXXX,0,300,0
23751,67,0,67,10,223,0,0,225,206,19,GOOOXXXXXXXXXXXXXXXXGOOOOOXXXXXXXXXXXXXXGOOOOOOOXXXXXXXXXXXXGOXXXXXXXXXXXXXXXXXXGOOOOOOOOOXXXXXXXXXXGOXXXXXXXXXXXXXXXXXXGOOOXXXXXXXXXXXXXXXXGOOXXXXXXXXXXXXXXXXXGOOOXXXXXXXXXXXXXXXXGOOOOOXXXXXXXXXXXXXXGOOXXXXXXXXXXXXXXXXXGOOOOOOXXXXXXXXXXXXXGOOOOOOOXXXXXXXXXXXX,0,300,0
23772,67,0,67,10,223,0,0,225,207,18,GOOOXXXXXXXXXXXXXXXXGOOOOOXXXXXXXXXXXXXXGOOOOOOOXXXXXXXXXXXXGOXXXXXXXXXXXXXXXXXXGOOOOOOOOOXXXXXXXXXXGOXXXXXXXXXXXXXXXXXXGOOOXXXXXXXXXXXXXXXXGOOXXXXXXXXXXXXXXXXXGOOOXXXXXXXXXXXXXXXXGOOOOOXXXXXXXXXXXXXXGOOXXXXXXXXXXXXXXXXXGOOOOOOXXXXXXXXXXXXXGOOOOOOOXXXXXXXXXXXX,0,300,0
23793,67,0,67,9,224,0,0,226,207,19,GOOOXXXXXXXXXXXXXXXXGOOOOOXXXXXXXXXXXXXXGOOOOOOOXXXXXXXXXXXXGOXXXXXXXXXXXXXXXXXXGOOOOOOOOOXXXXXXXXXXGOXXXXXXXXXXXXXXXXXXGOOOXXXXXXXXXXXXXXXXGOOXXXXXXXXXXXXXXXXXGOOOXXXXXXXXXXXXXXXXGOOOOOXXXXXXXXXXXXXXGOOXXXXXXXXXXXXXXXXXGOOOOOOXXXXXXXXXXXXXGOOOOOOOXXXXXXXXXXXX,0,300,0
23814,67,0,67,7,226,0,0,227,208,19,GOOOXXXXXXXXXXXXXXXXGOOOOOXXXXXXXXXXXXXXGOOOOOOOXXXXXXXXXXXXGOXXXXXXXXXXXXXXXXXXGOOOOOOOOOXXXXXXXXXXGOXXXXXXXXXXXXXXXXXXGOOOXXXXXXXXXXXXXXXXGOOXXXXXXXXXXXXXXXXXGOOOXXXXXXXXXXXXXXXXGOOOOOXXXXXXXXXXXXXXGOOXXXXXXXXXXXXXXXXXGOOOOOOXXXXXXXXXXXXXGOOOOOOOXXXXXXXXXXXX,0,300,0

23835,67,0,67,8,225,0,0,227,206,21,GOOOXXXXXXXXXXXXXXXXGOOOOOXXXXXXXXXXXXXXGOOOOOOOXXXXXXXXXXXXGOXXXXXXXXXXXXXXXXXXGOOOOOOOOOXXXXXXXXXXGOXXXXXXXXXXXXXXXXXXGOOOXXXXXXXXXXXXXXXXGOOXXXXXXXXXXXXXXXXXGOOOXXXXXXXXXXXXXXXXGOOOOOXXXXXXXXXXXXXXGOOXXXXXXXXXXXXXXXXXGOOOOOOXXXXXXXXXXXXXGOOOOOOOXXXXXXXXXXXX,0,300,0
23856,67,0,67,8,225,0,0,227,207,20,GOOOXXXXXXXXXXXXXXXXGOOOOOXXXXXXXXXXXXXXGOOOOOOOXXXXXXXXXXXXGOXXXXXXXXXXXXXXXXXXGOOOOOOOOOXXXXXXXXXXGOXXXXXXXXXXXXXXXXXXGOOOXXXXXXXXXXXXXXXXGOOXXXXXXXXXXXXXXXXXGOOOXXXXXXXXXXXXXXXXGOOOOOXXXXXXXXXXXXXXGOOXXXXXXXXXXXXXXXXXGOOOOOOXXXXXXXXXXXXXGOOOOOOOXXXXXXXXXXXX,0,300,0
23877,67,0,67,10,223,0,0,225,208,17,GOOOXXXXXXXXXXXXXXXXGOOOOOXXXXXXXXXXXXXXGOOOOOOOXXXXXXXXXXXXGOXXXXXXXXXXXXXXXXXXGOOOOOOOOOXXXXXXXXXXGOXXXXXXXXXXXXXXXXXXGOOOXXXXXXXXXXXXXXXXGOOXXXXXXXXXXXXXXXXXGOOOXXXXXXXXXXXXXXXXGOOOOOXXXXXXXXXXXXXXGOOXXXXXXXXXXXXXXXXXGOOOOOOXXXXXXXXXXXXXGOOOOOOOXXXXXXXXXXXX,0,300,0
23898,67,0,67,11,222,0,0,224,208,16,GOOOXXXXXXXXXXXXXXXXGOOOOOXXXXXXXXXXXXXXGOOOOOOOXXXXXXXXXXXXGOXXXXXXXXXXXXXXXXXXGOOOOOOOOOXXXXXXXXXXGOXXXXXXXXXXXXXXXXXXGOOOXXXXXXXXXXXXXXXXGOOXXXXXXXXXXXXXXXXXGOOOXXXXXXXXXXXXXXXXGOOOOOXXXXXXXXXXXXXXGOOXXXXXXXXXXXXXXXXXGOOOOOOXXXXXXXXXXXXXGOOOOOOOXXXXXXXXXXXX,0,300,0
23919,67,0,67,12,221,0,0,223,207,16,GOOOXXXXXXXXXXXXXXXXGOOOOOXXXXXXXXXXXXXXGOOOOOOOXXXXXXXXXXXXGOXXXXXXXXXXXXXXXXXXGOOOOOOOOOXXXXXXXXXXGOXXXXXXXXXXXXXXXXXXGOOOXXXXXXXXXXXXXXXXGOOXXXXXXXXXXXXXXXXXGOOOXXXXXXXXXXXXXXXXGOOOOOXXXXXXXXXXXXXXGOOXXXXXXXXXXXXXXXXXGOOOOOOXXXXXXXXXXXXXGOOOOOOOXXXXXXXXXXXX,0,300,0

23940,67,0,67,13,220,0,0,222,206,16,GOOOXXXXXXXXXXXXXXXXGOOOOOXXXXXXXXXXXXXXGOOOOOOOXXXXXXXXXXXXGOXXXXXXXXXXXXXXXXXXGOOOOOOOOOXXXXXXXXXXGOXXXXXXXXXXXXXXXXXXGOOOXXXXXXXXXXXXXXXXGOOXXXXXXXXXXXXXXXXXGOOOXXXXXXXXXXXXXXXXGOOOOOXXXXXXXXXXXXXXGOOXXXXXXXXXXXXXXXXXGOOOOOOXXXXXXXXXXXXXGOOOOOOOXXXXXXXXXXXX,0,300,0
23961,67,0,67,12,221,0,0,223,209,14,GOOOXXXXXXXXXXXXXXXXGOOOOOXXXXXXXXXXXXXXGOOOOOOOXXXXXXXXXXXXGOXXXXXXXXXXXXXXXXXXGOOOOOOOOOXXXXXXXXXXGOXXXXXXXXXXXXXXXXXXGOOOXXXXXXXXXXXXXXXXGOOXXXXXXXXXXXXXXXXXGOOOXXXXXXXXXXXXXXXXGOOOOOXXXXXXXXXXXXXXGOOXXXXXXXXXXXXXXXXXGOOOOOOXXXXXXXXXXXXXGOOOOOOOXXXXXXXXXXXX,0,300,0
23982,67,0,67,11,222,0,0,224,207,17,GOOOXXXXXXXXXXXXXXXXGOOOOOXXXXXXXXXXXXXXGOOOOOOOXXXXXXXXXXXXGOXXXXXXXXXXXXXXXXXXGOOOOOOOOOXXXXXXXXXXGOXXXXXXXXXXXXXXXXXXGOOOXXXXXXXXXXXXXXXXGOOXXXXXXXXXXXXXXXXXGOOOXXXXXXXXXXXXXXXXGOOOOOXXXXXXXXXXXXXXGOOXXXXXXXXXXXXXXXXXGOOOOOOXXXXXXXXXXXXXGOOOOOOOXXXXXXXXXXXX,0,300,0
24003,67,0,67,10,223,0,0,225,207,18,GOOOXXXXXXXXXXXXXXXXGOOOOOXXXXXXXXXXXXXXGOOOOOOOXXXXXXXXXXXXGOXXXXXXXXXXXXXXXXXXGOOOOOOOOOXXXXXXXXXXGOXXXXXXXXXXXXXXXXXXGOOOXXXXXXXXXXXXXXXXGOOXXXXXXXXXXXXXXXXXGOOOXXXXXXXXXXXXXXXXGOOOOOXXXXXXXXXXXXXXGOOXXXXXXXXXXXXXXXXXGOOOOOOXXXXXXXXXXXXXGOOOOOOOXXXXXXXXXXXX,0,300,0
24024,67,0,67,9,224,0,0,226,207,19,GOOOXXXXXXXXXXXXXXXXGOOOOOXXXXXXXXXXXXXXGOOOOOOOXXXXXXXXXXXXGOXXXXXXXXXXXXXXXXXXGOOOOOOOOOXXXXXXXXXXGOXXXXXXXXXXXXXXXXXXGOOOXXXXXXXXXXXXXXXXGOOXXXXXXXXXXXXXXXXXGOOOXXXXXXXXXXXXXXXXGOOOOOXXXXXXXXXXXXXXGOOXXXXXXXXXXXXXXXXXGOOOOOOXXXXXXXXXXXXXGOOOOOOOXXXXXXXXXXXX,0,300,0

24045,67,0,67,9,224,0,0,225,207,18,GOOOXXXXXXXXXXXXXXXXGOOOOOXXXXXXXXXXXXXXGOOOOOOOXXXXXXXXXXXXGOXXXXXXXXXXXXXXXXXXGOOOOOOOOOXXXXXXXXXXGOXXXXXXXXXXXXXXXXXXGOOOXXXXXXXXXXXXXXXXGOOXXXXXXXXXXXXXXXXXGOOOXXXXXXXXXXXXXXXXGOOOOOXXXXXXXXXXXXXXGOOXXXXXXXXXXXXXXXXXGOOOOOOXXXXXXXXXXXXXGOOOOOOOXXXXXXXXXXXX,0,300,0
24066,67,0,67,10,223,0,0,225,206,19,GOOOXXXXXXXXXXXXXXXXGOOOOOXXXXXXXXXXXXXXGOOOOOOOXXXXXXXXXXXXGOXXXXXXXXXXXXXXXXXXGOOOOOOOOOXXXXXXXXXXGOXXXXXXXXXXXXXXXXXXGOOOXXXXXXXXXXXXXXXXGOOXXXXXXXXXXXXXXXXXGOOOXXXXXXXXXXXXXXXXGOOOOOXXXXXXXXXXXXXXGOOXXXXXXXXXXXXXXXXXGOOOOOOXXXXXXXXXXXXXGOOOOOOOXXXXXXXXXXXX,0,300,0
24087,67,0,67,10,223,0,0,225,206,19,GOOOXXXXXXXXXXXXXXXXGOOOOOXXXXXXXXXXXXXXGOOOOOOOXXXXXXXXXXXXGOXXXXXXXXXXXXXXXXXXGOOOOOOOOOXXXXXXXXXXGOXXXXXXXXXXXXXXXXXXGOOOXXXXXXXXXXXXXXXXGOOXXXXXXXXXXXXXXXXXGOOOXXXXXXXXXXXXXXXXGOOOOOXXXXXXXXXXXXXXGOOXXXXXXXXXXXXXXXXXGOOOOOOXXXXXXXXXXXXXGOOOOOOOXXXXXXXXXXXX,0,300,0
24108,67,0,67,9,224,0,0,226,206,20,GOOOXXXXXXXXXXXXXXXXGOOOOOXXXXXXXXXXXXXXGOOOOOOOXXXXXXXXXXXXGOXXXXXXXXXXXXXXXXXXGOOOOOOOOOXXXXXXXXXXGOXXXXXXXXXXXXXXXXXXGOOOXXXXXXXXXXXXXXXXGOOXXXXXXXXXXXXXXXXXGOOOXXXXXXXXXXXXXXXXGOOOOOXXXXXXXXXXXXXXGOOXXXXXXXXXXXXXXXXXGOOOOOOXXXXXXXXXXXXXGOOOOOOOXXXXXXXXXXXX,0,300,0
24129,67,0,67,9,224,0,0,226,206,20,GOOOXXXXXXXXXXXXXXXXGOOOOOXXXXXXXXXXXXXXGOOOOOOOXXXXXXXXXXXXGOXXXXXXXXXXXXXXXXXXGOOOOOOOOOXXXXXXXXXXGOXXXXXXXXXXXXXXXXXXGOOOXXXXXXXXXXXXXXXXGOOXXXXXXXXXXXXXXXXXGOOOXXXXXXXXXXXXXXXXGOOOOOXXXXXXXXXXXXXXGOOXXXXXXXXXXXXXXXXXGOOOOOOXXXXXXXXXXXXXGOOOOOOOXXXXXXXXXXXX,0,300,0

24150,67,0,67,9,224,0,0,226,207,19,GOOOXXXXXXXXXXXXXXXXGOOOOOXXXXXXXXXXXXXXGOOOOOOOXXXXXXXXXXXXGOXXXXXXXXXXXXXXXXXXGOOOOOOOOOXXXXXXXXXXGOXXXXXXXXXXXXXXXXXXGOOOXXXXXXXXXXXXXXXXGOOXXXXXXXXXXXXXXXXXGOOOXXXXXXXXXXXXXXXXGOOOOOXXXXXXXXXXXXXXGOOXXXXXXXXXXXXXXXXXGOOOOOOXXXXXXXXXXXXXGOOOOOOOXXXXXXXXXXXX,0,300,0
24171,67,0,67,9,224,0,0,226,207,19,GOOOXXXXXXXXXXXXXXXXGOOOOOXXXXXXXXXXXXXXGOOOOOOOXXXXXXXXXXXXGOXXXXXXXXXXXXXXXXXXGOOOOOOOOOXXXXXXXXXXGOXXXXXXXXXXXXXXXXXXGOOOXXXXXXXXXXXXXXXXGOOXXXXXXXXXXXXXXXXXGOOOXXXXXXXXXXXXXXXXGOOOOOXXXXXXXXXXXXXXGOOXXXXXXXXXXXXXXXXXGOOOOOOXXXXXXXXXXXXXGOOOOOOOXXXXXXXXXXXX,0,300,0
24192,67,0,67,8,225,0,0,227,207,20,GOOOXXXXXXXXXXXXXXXXGOOOOOXXXXXXXXXXXXXXGOOOOOOOXXXXXXXXXXXXGOXXXXXXXXXXXXXXXXXXGOOOOOOOOOXXXXXXXXXXGOXXXXXXXXXXXXXXXXXXGOOOXXXXXXXXXXXXXXXXGOOXXXXXXXXXXXXXXXXXGOOOXXXXXXXXXXXXXXXXGOOOOOXXXXXXXXXXXXXXGOOXXXXXXXXXXXXXXXXXGOOOOOOXXXXXXXXXXXXXGOOOOOOOXXXXXXXXXXXX,0,300,0
24213,67,0,67,7,226,0,0,228,208,20,GOOOXXXXXXXXXXXXXXXXGOOOOOXXXXXXXXXXXXXXGOOOOOOOXXXXXXXXXXXXGOXXXXXXXXXXXXXXXXXXGOOOOOOOOOXXXXXXXXXXGOXXXXXXXXXXXXXXXXXXGOOOXXXXXXXXXXXXXXXXGOOXXXXXXXXXXXXXXXXXGOOOXXXXXXXXXXXXXXXXGOOOOOXXXXXXXXXXXXXXGOOXXXXXXXXXXXXXXXXXGOOOOOOXXXXXXXXXXXXXGOOOOOOOXXXXXXXXXXXX,0,300,0
24234,67,0,67,8,225,0,0,226,207,19,GOOOXXXXXXXXXXXXXXXXGOOOOOXXXXXXXXXXXXXXGOOOOOOOXXXXXXXXXXXXGOXXXXXXXXXXXXXXXXXXGOOOOOOOOOXXXXXXXXXXGOXXXXXXXXXXXXXXXXXXGOOOXXXXXXXXXXXXXXXXGOOXXXXXXXXXXXXXXXXXGOOOXXXXXXXXXXXXXXXXGOOOOOXXXXXXXXXXXXXXGOOXXXXXXXXXXXXXXXXXGOOOOOOXXXXXXXXXXXXXGOOOOOOOXXXXXXXXXXXX,0,300,0

24255,67,0,67,6,227,0,0,228,208,20,GOOOXXXXXXXXXXXXXXXXGOOOOOXXXXXXXXXXXXXXGOOOOOOOXXXXXXXXXXXXGOXXXXXXXXXXXXXXXXXXGOOOOOOOOOXXXXXXXXXXGOXXXXXXXXXXXXXXXXXXGOOOXXXXXXXXXXXXXXXXGOOXXXXXXXXXXXXXXXXXGOOOXXXXXXXXXXXXXXXXGOOOOOXXXXXXXXXXXXXXGOOXXXXXXXXXXXXXXXXXGOOOOOOXXXXXXXXXXXXXGOOOOOOOXXXXXXXXXXXX,0,300,0
24276,67,0,67,6,227,0,0,229,207,22,GOOOXXXXXXXXXXXXXXXXGOOOOOXXXXXXXXXXXXXXGOOOOOOOXXXXXXXXXXXXGOXXXXXXXXXXXXXXXXXXGOOOOOOOOOXXXXXXXXXXGOXXXXXXXXXXXXXXXXXXGOOOXXXXXXXXXXXXXXXXGOOXXXXXXXXXXXXXXXXXGOOOXXXXXXXXXXXXXXXXGOOOOOXXXXXXXXXXXXXXGOOXXXXXXXXXXXXXXXXXGOOOOOOXXXXXXXXXXXXXGOOOOOOOXXXXXXXXXXXX,0,300,0
24297,67,0,67,7,226,0,0,228,207,21,GOOOXXXXXXXXXXXXXXXXGOOOOOXXXXXXXXXXXXXXGOOOOOOOXXXXXXXXXXXXGOXXXXXXXXXXXXXXXXXXGOOOOOOOOOXXXXXXXXXXGOXXXXXXXXXXXXXXXXXXGOOOXXXXXXXXXXXXXXXXGOOXXXXXXXXXXXXXXXXXGOOOXXXXXXXXXXXXXXXXGOOOOOXXXXXXXXXXXXXXGOOXXXXXXXXXXXXXXXXXGOOOOOOXXXXXXXXXXXXXGOOOOOOOXXXXXXXXXXXX,0,300,0
24318,67,0,67,9,224,0,0,226,206,20,GOOOXXXXXXXXXXXXXXXXGOOOOOXXXXXXXXXXXXXXGOOOOOOOXXXXXXXXXXXXGOXXXXXXXXXXXXXXXXXXGOOOOOOOOOXXXXXXXXXXGOXXXXXXXXXXXXXXXXXXGOOOXXXXXXXXXXXXXXXXGOOXXXXXXXXXXXXXXXXXGOOOXXXXXXXXXXXXXXXXGOOOOOXXXXXXXXXXXXXXGOOXXXXXXXXXXXXXXXXXGOOOOOOXXXXXXXXXXXXXGOOOOOOOXXXXXXXXXXXX,0,300,0
24339,67,0,67,8,225,0,0,227,207,20,GOOOXXXXXXXXXXXXXXXXGOOOOOXXXXXXXXXXXXXXGOOOOOOOXXXXXXXXXXXXGOXXXXXXXXXXXXXXXXXXGOOOOOOOOOXXXXXXXXXXGOXXXXXXXXXXXXXXXXXXGOOOXXXXXXXXXXXXXXXXGOOXXXXXXXXXXXXXXXXXGOOOXXXXXXXXXXXXXXXXGOOOOOXXXXXXXXXXXXXXGOOXXXXXXXXXXXXXXXXXGOOOOOOXXXXXXXXXXXXXGOOOOOOOXXXXXXXXXXXX,0,300,0

24360,67,0,67,10,223,0,0,225,206,19,GOOOXXXXXXXXXXXXXXXXGOOOOOXXXXXXXXXXXXXXGOOOOOOOXXXXXXXXXXXXGOXXXXXXXXXXXXXXXXXXGOOOOOOOOOXXXXXXXXXXGOXXXXXXXXXXXXXXXXXXGOOOXXXXXXXXXXXXXXXXGOOXXXXXXXXXXXXXXXXXGOOOXXXXXXXXXXXXXXXXGOOOOOXXXXXXXXXXXXXXGOOXXXXXXXXXXXXXXXXXGOOOOOOXXXXXXXXXXXXXGOOOOOOOXXXXXXXXXXXX,0,300,0
24381,67,0,67,10,223,0,0,225,207,18,GOOOXXXXXXXXXXXXXXXXGOOOOOXXXXXXXXXXXXXXGOOOOOOOXXXXXXXXXXXXGOXXXXXXXXXXXXXXXXXXGOOOOOOOOOXXXXXXXXXXGOXXXXXXXXXXXXXXXXXXGOOOXXXXXXXXXXXXXXXXGOOXXXXXXXXXXXXXXXXXGOOOXXXXXXXXXXXXXXXXGOOOOOXXXXXXXXXXXXXXGOOXXXXXXXXXXXXXXXXXGOOOOOOXXXXXXXXXXXXXGOOOOOOOXXXXXXXXXXXX,0,300,0
24402,67,0,67,10,223,0,0,225,206,19,GOOOXXXXXXXXXXXXXXXXGOOOOOXXXXXXXXXXXXXXGOOOOOOOXXXXXXXXXXXXGOXXXXXXXXXXXXXXXXXXGOOOOOOOOOXXXXXXXXXXGOXXXXXXXXXXXXXXXXXXGOOOXXXXXXXXXXXXXXXXGOOXXXXXXXXXXXXXXXXXGOOOXXXXXXXXXXXXXXXXGOOOOOXXXXXXXXXXXXXXGOOXXXXXXXXXXXXXXXXXGOOOOOOXXXXXXXXXXXXXGOOOOOOOXXXXXXXXXXXX,0,300,0
24423,67,0,67,10,223,0,0,225,207,18,GOOOXXXXXXXXXXXXXXXXGOOOOOXXXXXXXXXXXXXXGOOOOOOOXXXXXXXXXXXXGOXXXXXXXXXXXXXXXXXXGOOOOOOOOOXXXXXXXXXXGOXXXXXXXXXXXXXXXXXXGOOOXXXXXXXXXXXXXXXXGOOXXXXXXXXXXXXXXXXXGOOOXXXXXXXXXXXXXXXXGOOOOOXXXXXXXXXXXXXXGOOXXXXXXXXXXXXXXXXXGOOOOOOXXXXXXXXXXXXXGOOOOOOOXXXXXXXXXXXX,0,300,0
24444,67,0,67,11,222,0,0,224,208,16,GOOOXXXXXXXXXXXXXXXXGOOOOOXXXXXXXXXXXXXXGOOOOOOOXXXXXXXXXXXXGOXXXXXXXXXXXXXXXXXXGOOOOOOOOOXXXXXXXXXXGOXXXXXXXXXXXXXXXXXXGOOOXXXXXXXXXXXXXXXXGOOXXXXXXXXXXXXXXXXXGOOOXXXXXXXXXXXXXXXXGOOOOOXXXXXXXXXXXXXXGOOXXXXXXXXXXXXXXXXXGOOOOOOXXXXXXXXXXXXXGOOOOOOOXXXXXXXXXXXX,0,300,0

24465,67,0,67,14,219,0,0,221,207,14,GOOOXXXXXXXXXXXXXXXXGOOOOOXXXXXXXXXXXXXXGOOOOOOOXXXXXXXXXXXXGOXXXXXXXXXXXXXXXXXXGOOOOOOOOOXXXXXXXXXXGOXXXXXXXXXXXXXXXXXXGOOOXXXXXXXXXXXXXXXXGOOXXXXXXXXXXXXXXXXXGOOOXXXXXXXXXXXXXXXXGOOOOOXXXXXXXXXXXXXXGOOXXXXXXXXXXXXXXXXXGOOOOOOXXXXXXXXXXXXXGOOOOOOOXXXXXXXXXXXX,0,300,0
24486,67,0,67,15,218,0,0,220,206,14,GOOOXXXXXXXXXXXXXXXXGOOOOOXXXXXXXXXXXXXXGOOOOOOOXXXXXXXXXXXXGOXXXXXXXXXXXXXXXXXXGOOOOOOOOOXXXXXXXXXXGOXXXXXXXXXXXXXXXXXXGOOOXXXXXXXXXXXXXXXXGOOXXXXXXXXXXXXXXXXXGOOOXXXXXXXXXXXXXXXXGOOOOOXXXXXXXXXXXXXXGOOXXXXXXXXXXXXXXXXXGOOOOOOXXXXXXXXXXXXXGOOOOOOOXXXXXXXXXXXX,0,300,0
24507,67,0,67,12,221,0,0,223,208,15,GOOOXXXXXXXXXXXXXXXXGOOOOOXXXXXXXXXXXXXXGOOOOOOOXXXXXXXXXXXXGOXXXXXXXXXXXXXXXXXXGOOOOOOOOOXXXXXXXXXXGOXXXXXXXXXXXXXXXXXXGOOOXXXXXXXXXXXXXXXXGOOXXXXXXXXXXXXXXXXXGOOOXXXXXXXXXXXXXXXXGOOOOOXXXXXXXXXXXXXXGOOXXXXXXXXXXXXXXXXXGOOOOOOXXXXXXXXXXXXXGOOOOOOOXXXXXXXXXXXX,0,300,0
24528,67,0,67,11,222,0,0,224,208,16,GOOOXXXXXXXXXXXXXXXXGOOOOOXXXXXXXXXXXXXXGOOOOOOOXXXXXXXXXXXXGOXXXXXXXXXXXXXXXXXXGOOOOOOOOOXXXXXXXXXXGOXXXXXXXXXXXXXXXXXXGOOOXXXXXXXXXXXXXXXXGOOXXXXXXXXXXXXXXXXXGOOOXXXXXXXXXXXXXXXXGOOOOOXXXXXXXXXXXXXXGOOXXXXXXXXXXXXXXXXXGOOOOOOXXXXXXXXXXXXXGOOOOOOOXXXXXXXXXXXX,0,300,0
24549,67,0,67,13,220,0,0,222,207,15,GOOOXXXXXXXXXXXXXXXXGOOOOOXXXXXXXXXXXXXXGOOOOOOOXXXXXXXXXXXXGOXXXXXXXXXXXXXXXXXXGOOOOOOOOOXXXXXXXXXXGOXXXXXXXXXXXXXXXXXXGOOOXXXXXXXXXXXXXXXXGOOXXXXXXXXXXXXXXXXXGOOOXXXXXXXXXXXXXXXXGOOOOOXXXXXXXXXXXXXXGOOXXXXXXXXXXXXXXXXXGOOOOOOXXXXXXXXXXXXXGOOOOOOOXXXXXXXXXXXX,0,300,0

24570,67,0,67,13,220,0,0,222,207,15,GOOOXXXXXXXXXXXXXXXXGOOOOOXXXXXXXXXXXXXXGOOOOOOOXXXXXXXXXXXXGOXXXXXXXXXXXXXXXXXXGOOOOOOOOOXXXXXXXXXXGOXXXXXXXXXXXXXXXXXXGOOOXXXXXXXXXXXXXXXXGOOXXXXXXXXXXXXXXXXXGOOOXXXXXXXXXXXXXXXXGOOOOOXXXXXXXXXXXXXXGOOXXXXXXXXXXXXXXXXXGOOOOOOXXXXXXXXXXXXXGOOOOOOOXXXXXXXXXXXX,0,300,0
24591,67,0,67,12,221,0,0,223,207,16,GOOOXXXXXXXXXXXXXXXXGOOOOOXXXXXXXXXXXXXXGOOOOOOOXXXXXXXXXXXXGOXXXXXXXXXXXXXXXXXXGOOOOOOOOOXXXXXXXXXXGOXXXXXXXXXXXXXXXXXXGOOOXXXXXXXXXXXXXXXXGOOXXXXXXXXXXXXXXXXXGOOOXXXXXXXXXXXXXXXXGOOOOOXXXXXXXXXXXXXXGOOXXXXXXXXXXXXXXXXXGOOOOOOXXXXXXXXXXXXXGOOOOOOOXXXXXXXXXXXX,0,300,0
24612,67,0,67,9,224,0,0,226,208,18,GOOOXXXXXXXXXXXXXXXXGOOOOOXXXXXXXXXXXXXXGOOOOOOOXXXXXXXXXXXXGOXXXXXXXXXXXXXXXXXXGOOOOOOOOOXXXXXXXXXXGOXXXXXXXXXXXXXXXXXXGOOOXXXXXXXXXXXXXXXXGOOXXXXXXXXXXXXXXXXXGOOOXXXXXXXXXXXXXXXXGOOOOOXXXXXXXXXXXXXXGOOXXXXXXXXXXXXXXXXXGOOOOOOXXXXXXXXXXXXXGOOOOOOOXXXXXXXXXXXX,0,300,0
24633,67,0,67,8,225,0,0,227,208,19,GOOOXXXXXXXXXXXXXXXXGOOOOOXXXXXXXXXXXXXXGOOOOOOOXXXXXXXXXXXXGOXXXXXXXXXXXXXXXXXXGOOOOOOOOOXXXXXXXXXXGOXXXXXXXXXXXXXXXXXXGOOOXXXXXXXXXXXXXXXXGOOXXXXXXXXXXXXXXXXXGOOOXXXXXXXXXXXXXXXXGOOOOOXXXXXXXXXXXXXXGOOXXXXXXXXXXXXXXXXXGOOOOOOXXXXXXXXXXXXXGOOOOOOOXXXXXXXXXXXX,0,300,0
24654,67,0,67,9,224,0,0,226,206,20,GOOOXXXXXXXXXXXXXXXXGOOOOOXXXXXXXXXXXXXXGOOOOOOOXXXXXXXXXXXXGOXXXXXXXXXXXXXXXXXXGOOOOOOOOOXXXXXXXXXXGOXXXXXXXXXXXXXXXXXXGOOOXXXXXXXXXXXXXXXXGOOXXXXXXXXXXXXXXXXXGOOOXXXXXXXXXXXXXXXXGOOOOOXXXXXXXXXXXXXXGOOXXXXXXXXXXXXXXXXXGOOOOOOXXXXXXXXXXXXXGOOOOOOOXXXXXXXXXXXX,0,300,0

24675,67,0,67,10,223,0,0,225,207,18,GOOOXXXXXXXXXXXXXXXXGOOOOOXXXXXXXXXXXXXXGOOOOOOOXXXXXXXXXXXXGOXXXXXXXXXXXXXXXXXXGOOOOOOOOOXXXXXXXXXXGOXXXXXXXXXXXXXXXXXXGOOOXXXXXXXXXXXXXXXXGOOXXXXXXXXXXXXXXXXXGOOOXXXXXXXXXXXXXXXXGOOOOOXXXXXXXXXXXXXXGOOXXXXXXXXXXXXXXXXXGOOOOOOXXXXXXXXXXXXXGOOOOOOOXXXXXXXXXXXX,0,300,0
24696,67,0,67,10,223,0,0,225,206,19,GOOOXXXXXXXXXXXXXXXXGOOOOOXXXXXXXXXXXXXXGOOOOOOOXXXXXXXXXXXXGOXXXXXXXXXXXXXXXXXXGOOOOOOOOOXXXXXXXXXXGOXXXXXXXXXXXXXXXXXXGOOOXXXXXXXXXXXXXXXXGOOXXXXXXXXXXXXXXXXXGOOOXXXXXXXXXXXXXXXXGOOOOOXXXXXXXXXXXXXXGOOXXXXXXXXXXXXXXXXXGOOOOOOXXXXXXXXXXXXXGOOOOOOOXXXXXXXXXXXX,0,300,0
24717,67,0,67,10,223,0,0,225,206,19,GOOOXXXXXXXXXXXXXXXXGOOOOOXXXXXXXXXXXXXXGOOOOOOOXXXXXXXXXXXXGOXXXXXXXXXXXXXXXXXXGOOOOOOOOOXXXXXXXXXXGOXXXXXXXXXXXXXXXXXXGOOOXXXXXXXXXXXXXXXXGOOXXXXXXXXXXXXXXXXXGOOOXXXXXXXXXXXXXXXXGOOOOOXXXXXXXXXXXXXXGOOXXXXXXXXXXXXXXXXXGOOOOOOXXXXXXXXXXXXXGOOOOOOOXXXXXXXXXXXX,0,300,0
24738,67,0,67,11,222,0,0,224,206,18,GOOOXXXXXXXXXXXXXXXXGOOOOOXXXXXXXXXXXXXXGOOOOOOOXXXXXXXXXXXXGOXXXXXXXXXXXXXXXXXXGOOOOOOOOOXXXXXXXXXXGOXXXXXXXXXXXXXXXXXXGOOOXXXXXXXXXXXXXXXXGOOXXXXXXXXXXXXXXXXXGOOOXXXXXXXXXXXXXXXXGOOOOOXXXXXXXXXXXXXXGOOXXXXXXXXXXXXXXXXXGOOOOOOXXXXXXXXXXXXXGOOOOOOOXXXXXXXXXXXX,0,300,0
24759,67,0,67,11,222,0,0,224,206,18,GOOOXXXXXXXXXXXXXXXXGOOOOOXXXXXXXXXXXXXXGOOOOOOOXXXXXXXXXXXXGOXXXXXXXXXXXXXXXXXXGOOOOOOOOOXXXXXXXXXXGOXXXXXXXXXXXXXXXXXXGOOOXXXXXXXXXXXXXXXXGOOXXXXXXXXXXXXXXXXXGOOOXXXXXXXXXXXXXXXXGOOOOOXXXXXXXXXXXXXXGOOXXXXXXXXXXXXXXXXXGOOOOOOXXXXXXXXXXXXXGOOOOOOOXXXXXXXXXXXX,0,300,0

24780,67,0,67,10,223,0,0,225,205,20,GOOOXXXXXXXXXXXXXXXXGOOOOOXXXXXXXXXXXXXXGOOOOOOOXXXXXXXXXXXXGOXXXXXXXXXXXXXXXXXXGOOOOOOOOOXXXXXXXXXXGOXXXXXXXXXXXXXXXXXXGOOOXXXXXXXXXXXXXXXXGOOXXXXXXXXXXXXXXXXXGOOOXXXXXXXXXXXXXXXXGOOOOOXXXXXXXXXXXXXXGOOXXXXXXXXXXXXXXXXXGOOOOOOXXXXXXXXXXXXXGOOOOOOOXXXXXXXXXXXX,0,300,0
24801,67,0,67,10,223,0,0,225,206,19,GOOOXXXXXXXXXXXXXXXXGOOOOOXXXXXXXXXXXXXXGOOOOOOOXXXXXXXXXXXXGOXXXXXXXXXXXXXXXXXXGOOOOOOOOOXXXXXXXXXXGOXXXXXXXXXXXXXXXXXXGOOOXXXXXXXXXXXXXXXXGOOXXXXXXXXXXXXXXXXXGOOOXXXXXXXXXXXXXXXXGOOOOOXXXXXXXXXXXXXXGOOXXXXXXXXXXXXXXXXXGOOOOOOXXXXXXXXXXXXXGOOOOOOOXXXXXXXXXXXX,0,300,0
24822,67,0,67,11,222,0,0,224,205,19,GOOOXXXXXXXXXXXXXXXXGOOOOOXXXXXXXXXXXXXXGOOOOOOOXXXXXXXXXXXXGOXXXXXXXXXXXXXXXXXXGOOOOOOOOOXXXXXXXXXXGOXXXXXXXXXXXXXXXXXXGOOOXXXXXXXXXXXXXXXXGOOXXXXXXXXXXXXXXXXXGOOOXXXXXXXXXXXXXXXXGOOOOOXXXXXXXXXXXXXXGOOXXXXXXXXXXXXXXXXXGOOOOOOXXXXXXXXXXXXXGOOOOOOOXXXXXXXXXXXX,0,300,0
24843,67,0,67,11,222,0,0,224,205,19,GOOOXXXXXXXXXXXXXXXXGOOOOOXXXXXXXXXXXXXXGOOOOOOOXXXXXXXXXXXXGOXXXXXXXXXXXXXXXXXXGOOOOOOOOOXXXXXXXXXXGOXXXXXXXXXXXXXXXXXXGOOOXXXXXXXXXXXXXXXXGOOXXXXXXXXXXXXXXXXXGOOOXXXXXXXXXXXXXXXXGOOOOOXXXXXXXXXXXXXXGOOXXXXXXXXXXXXXXXXXGOOOOOOXXXXXXXXXXXXXGOOOOOOOXXXXXXXXXXXX,0,300,0
24864,67,0,67,12,221,0,0,223,205,18,GOOOXXXXXXXXXXXXXXXXGOOOOOXXXXXXXXXXXXXXGOOOOOOOXXXXXXXXXXXXGOXXXXXXXXXXXXXXXXXXGOOOOOOOOOXXXXXXXXXXGOXXXXXXXXXXXXXXXXXXGOOOXXXXXXXXXXXXXXXXGOOXXXXXXXXXXXXXXXXXGOOOXXXXXXXXXXXXXXXXGOOOOOXXXXXXXXXXXXXXGOOXXXXXXXXXXXXXXXXXGOOOOOOXXXXXXXXXXXXXGOOOOOOOXXXXXXXXXXXX,0,300,0

24885,67,0,67,13,220,0,0,222,205,17,GOOOXXXXXXXXXXXXXXXXGOOOOOXXXXXXXXXXXXXXGOOOOOOOXXXXXXXXXXXXGOXXXXXXXXXXXXXXXXXXGOOOOOOOOOXXXXXXXXXXGOXXXXXXXXXXXXXXXXXXGOOOXXXXXXXXXXXXXXXXGOOXXXXXXXXXXXXXXXXXGOOOXXXXXXXXXXXXXXXXGOOOOOXXXXXXXXXXXXXXGOOXXXXXXXXXXXXXXXXXGOOOOOOXXXXXXXXXXXXXGOOOOOOOXXXXXXXXXXXX,0,300,0
24906,67,0,67,13,220,0,0,222,206,16,GOOOXXXXXXXXXXXXXXXXGOOOOOXXXXXXXXXXXXXXGOOOOOOOXXXXXXXXXXXXGOXXXXXXXXXXXXXXXXXXGOOOOOOOOOXXXXXXXXXXGOXXXXXXXXXXXXXXXXXXGOOOXXXXXXXXXXXXXXXXGOOXXXXXXXXXXXXXXXXXGOOOXXXXXXXXXXXXXXXXGOOOOOXXXXXXXXXXXXXXGOOXXXXXXXXXXXXXXXXXGOOOOOOXXXXXXXXXXXXXGOOOOOOOXXXXXXXXXXXX,0,300,0
24927,67,0,67,14,219,0,0,221,206,15,GOOOXXXXXXXXXXXXXXXXGOOOOOXXXXXXXXXXXXXXGOOOOOOOXXXXXXXXXXXXGOXXXXXXXXXXXXXXXXXXGOOOOOOOOOXXXXXXXXXXGOXXXXXXXXXXXXXXXXXXGOOOXXXXXXXXXXXXXXXXGOOXXXXXXXXXXXXXXXXXGOOOXXXXXXXXXXXXXXXXGOOOOOXXXXXXXXXXXXXXGOOXXXXXXXXXXXXXXXXXGOOOOOOXXXXXXXXXXXXXGOOOOOOOXXXXXXXXXXXX,0,300,0
24948,67,0,67,14,219,0,0,221,207,14,GOOOXXXXXXXXXXXXXXXXGOOOOOXXXXXXXXXXXXXXGOOOOOOOXXXXXXXXXXXXGOXXXXXXXXXXXXXXXXXXGOOOOOOOOOXXXXXXXXXXGOXXXXXXXXXXXXXXXXXXGOOOXXXXXXXXXXXXXXXXGOOXXXXXXXXXXXXXXXXXGOOOXXXXXXXXXXXXXXXXGOOOOOXXXXXXXXXXXXXXGOOXXXXXXXXXXXXXXXXXGOOOOOOXXXXXXXXXXXXXGOOOOOOOXXXXXXXXXXXX,0,300,0
24969,67,0,67,12,221,0,0,223,205,18,GOOOXXXXXXXXXXXXXXXXGOOOOOXXXXXXXXXXXXXXGOOOOOOOXXXXXXXXXXXXGOXXXXXXXXXXXXXXXXXXGOOOOOOOOOXXXXXXXXXXGOXXXXXXXXXXXXXXXXXXGOOOXXXXXXXXXXXXXXXXGOOXXXXXXXXXXXXXXXXXGOOOXXXXXXXXXXXXXXXXGOOOOOXXXXXXXXXXXXXXGOOXXXXXXXXXXXXXXXXXGOOOOOOXXXXXXXXXXXXXGOOOOOOOXXXXXXXXXXXX,0,300,0

24990,67,0,67,12,221,0,0,223,205,18,GOOOXXXXXXXXXXXXXXXXGOOOOOXXXXXXXXXXXXXXGOOOOOOOXXXXXXXXXXXXGOXXXXXXXXXXXXXXXXXXGOOOOOOOOOXXXXXXXXXXGOXXXXXXXXXXXXXXXXXXGOOOXXXXXXXXXXXXXXXXGOOXXXXXXXXXXXXXXXXXGOOOXXXXXXXXXXXXXXXXGOOOOOXXXXXXXXXXXXXXGOOXXXXXXXXXXXXXXXXXGOOOOOOXXXXXXXXXXXXXGOOOOOOOXXXXXXXXXXXX,0,300,0
25011,67,0,67,11,222,0,0,224,207,17,GOOOXXXXXXXXXXXXXXXXGOOOOOXXXXXXXXXXXXXXGOOOOOOOXXXXXXXXXXXXGOXXXXXXXXXXXXXXXXXXGOOOOOOOOOXXXXXXXXXXGOXXXXXXXXXXXXXXXXXXGOOOXXXXXXXXXXXXXXXXGOOXXXXXXXXXXXXXXXXXGOOOXXXXXXXXXXXXXXXXGOOOOOXXXXXXXXXXXXXXGOOXXXXXXXXXXXXXXXXXGOOOOOOXXXXXXXXXXXXXGOOOOOOOXXXXXXXXXXXX,0,300,0
25032,67,0,67,11,222,0,0,224,206,18,GOOOXXXXXXXXXXXXXXXXGOOOOOXXXXXXXXXXXXXXGOOOOOOOXXXXXXXXXXXXGOXXXXXXXXXXXXXXXXXXGOOOOOOOOOXXXXXXXXXXGOXXXXXXXXXXXXXXXXXXGOOOXXXXXXXXXXXXXXXXGOOXXXXXXXXXXXXXXXXXGOOOXXXXXXXXXXXXXXXXGOOOOOXXXXXXXXXXXXXXGOOXXXXXXXXXXXXXXXXXGOOOOOOXXXXXXXXXXXXXGOOOOOOOXXXXXXXXXXXX,0,300,0
25053,67,0,67,8,225,0,0,226,208,18,GOOOXXXXXXXXXXXXXXXXGOOOOOXXXXXXXXXXXXXXGOOOOOOOXXXXXXXXXXXXGOXXXXXXXXXXXXXXXXXXGOOOOOOOOOXXXXXXXXXXGOXXXXXXXXXXXXXXXXXXGOOOXXXXXXXXXXXXXXXXGOOXXXXXXXXXXXXXXXXXGOOOXXXXXXXXXXXXXXXXGOOOOOXXXXXXXXXXXXXXGOOXXXXXXXXXXXXXXXXXGOOOOOOXXXXXXXXXXXXXGOOOOOOOXXXXXXXXXXXX,0,300,0
25074,67,0,67,8,225,0,0,227,206,21,GOOOXXXXXXXXXXXXXXXXGOOOOOXXXXXXXXXXXXXXGOOOOOOOXXXXXXXXXXXXGOXXXXXXXXXXXXXXXXXXGOOOOOOOOOXXXXXXXXXXGOXXXXXXXXXXXXXXXXXXGOOOXXXXXXXXXXXXXXXXGOOXXXXXXXXXXXXXXXXXGOOOXXXXXXXXXXXXXXXXGOOOOOXXXXXXXXXXXXXXGOOXXXXXXXXXXXXXXXXXGOOOOOOXXXXXXXXXXXXXGOOOOOOOXXXXXXXXXXXX,0,300,0

25095,67,0,67,10,223,0,0,225,206,19,GOOOXXXXXXXXXXXXXXXXGOOOOOXXXXXXXXXXXXXXGOOOOOOOXXXXXXXXXXXXGOXXXXXXXXXXXXXXXXXXGOOOOOOOOOXXXXXXXXXXGOXXXXXXXXXXXXXXXXXXGOOOXXXXXXXXXXXXXXXXGOOXXXXXXXXXXXXXXXXXGOOOXXXXXXXXXXXXXXXXGOOOOOXXXXXXXXXXXXXXGOOXXXXXXXXXXXXXXXXXGOOOOOOXXXXXXXXXXXXXGOOOOOOOXXXXXXXXXXXX,0,300,0
25116,67,0,67,8,225,0,0,227,206,21,GOOOXXXXXXXXXXXXXXXXGOOOOOXXXXXXXXXXXXXXGOOOOOOOXXXXXXXXXXXXGOXXXXXXXXXXXXXXXXXXGOOOOOOOOOXXXXXXXXXXGOXXXXXXXXXXXXXXXXXXGOOOXXXXXXXXXXXXXXXXGOOXXXXXXXXXXXXXXXXXGOOOXXXXXXXXXXXXXXXXGOOOOOXXXXXXXXXXXXXXGOOXXXXXXXXXXXXXXXXXGOOOOOOXXXXXXXXXXXXXGOOOOOOOXXXXXXXXXXXX,0,300,0
25137,67,0,67,6,227,0,0,229,207,22,GOOOXXXXXXXXXXXXXXXXGOOOOOXXXXXXXXXXXXXXGOOOOOOOXXXXXXXXXXXXGOXXXXXXXXXXXXXXXXXXGOOOOOOOOOXXXXXXXXXXGOXXXXXXXXXXXXXXXXXXGOOOXXXXXXXXXXXXXXXXGOOXXXXXXXXXXXXXXXXXGOOOXXXXXXXXXXXXXXXXGOOOOOXXXXXXXXXXXXXXGOOXXXXXXXXXXXXXXXXXGOOOOOOXXXXXXXXXXXXXGOOOOOOOXXXXXXXXXXXX,0,300,0
25158,67,0,67,5,228,0,0,230,208,22,GOOOXXXXXXXXXXXXXXXXGOOOOOXXXXXXXXXXXXXXGOOOOOOOXXXXXXXXXXXXGOXXXXXXXXXXXXXXXXXXGOOOOOOOOOXXXXXXXXXXGOXXXXXXXXXXXXXXXXXXGOOOXXXXXXXXXXXXXXXXGOOXXXXXXXXXXXXXXXXXGOOOXXXXXXXXXXXXXXXXGOOOOOXXXXXXXXXXXXXXGOOXXXXXXXXXXXXXXXXXGOOOOOOXXXXXXXXXXXXXGOOOOOOOXXXXXXXXXXXX,0,300,0
25179,67,0,67,5,228,0,0,230,207,23,GOOOXXXXXXXXXXXXXXXXGOOOOOXXXXXXXXXXXXXXGOOOOOOOXXXXXXXXXXXXGOXXXXXXXXXXXXXXXXXXGOOOOOOOOOXXXXXXXXXXGOXXXXXXXXXXXXXXXXXXGOOOXXXXXXXXXXXXXXXXGOOXXXXXXXXXXXXXXXXXGOOOXXXXXXXXXXXXXXXXGOOOOOXXXXXXXXXXXXXXGOOXXXXXXXXXXXXXXXXXGOOOOOOXXXXXXXXXXXXXGOOOOOOOXXXXXXXXXXXX,0,300,0

25200,67,0,67,6,227,0,0,229,206,23,GOOOXXXXXXXXXXXXXXXXGOOOOOXXXXXXXXXXXXXXGOOOOOOOXXXXXXXXXXXXGOXXXXXXXXXXXXXXXXXXGOOOOOOOOOXXXXXXXXXXGOXXXXXXXXXXXXXXXXXXGOOOXXXXXXXXXXXXXXXXGOOXXXXXXXXXXXXXXXXXGOOOXXXXXXXXXXXXXXXXGOOOOOXXXXXXXXXXXXXXGOOXXXXXXXXXXXXXXXXXGOOOOOOXXXXXXXXXXXXXGOOOOOOOXXXXXXXXXXXX,0,300,0
25221,67,0,67,4,229,0,0,231,208,23,GOOOXXXXXXXXXXXXXXXXGOOOOOXXXXXXXXXXXXXXGOOOOOOOXXXXXXXXXXXXGOXXXXXXXXXXXXXXXXXXGOOOOOOOOOXXXXXXXXXXGOXXXXXXXXXXXXXXXXXXGOOOXXXXXXXXXXXXXXXXGOOXXXXXXXXXXXXXXXXXGOOOXXXXXXXXXXXXXXXXGOOOOOXXXXXXXXXXXXXXGOOXXXXXXXXXXXXXXXXXGOOOOOOXXXXXXXXXXXXXGOOOOOOOXXXXXXXXXXXX,0,300,0
25242,67,0,67,5,228,0,0,230,206,24,GOOOXXXXXXXXXXXXXXXXGOOOOOXXXXXXXXXXXXXXGOOOOOOOXXXXXXXXXXXXGOXXXXXXXXXXXXXXXXXXGOOOOOOOOOXXXXXXXXXXGOXXXXXXXXXXXXXXXXXXGOOOXXXXXXXXXXXXXXXXGOOXXXXXXXXXXXXXXXXXGOOOXXXXXXXXXXXXXXXXGOOOOOXXXXXXXXXXXXXXGOOXXXXXXXXXXXXXXXXXGOOOOOOXXXXXXXXXXXXXGOOOOOOOXXXXXXXXXXXX,0,300,0
25263,67,0,67,5,228,0,0,230,208,22,GOOOXXXXXXXXXXXXXXXXGOOOOOXXXXXXXXXXXXXXGOOOOOOOXXXXXXXXXXXXGOXXXXXXXXXXXXXXXXXXGOOOOOOOOOXXXXXXXXXXGOXXXXXXXXXXXXXXXXXXGOOOXXXXXXXXXXXXXXXXGOOXXXXXXXXXXXXXXXXXGOOOXXXXXXXXXXXXXXXXGOOOOOXXXXXXXXXXXXXXGOOXXXXXXXXXXXXXXXXXGOOOOOOXXXXXXXXXXXXXGOOOOOOOXXXXXXXXXXXX,0,300,0
25284,67,0,67,8,225,0,0,227,207,20,GOOOXXXXXXXXXXXXXXXXGOOOOOXXXXXXXXXXXXXXGOOOOOOOXXXXXXXXXXXXGOXXXXXXXXXXXXXXXXXXGOOOOOOOOOXXXXXXXXXXGOXXXXXXXXXXXXXXXXXXGOOOXXXXXXXXXXXXXXXXGOOXXXXXXXXXXXXXXXXXGOOOXXXXXXXXXXXXXXXXGOOOOOXXXXXXXXXXXXXXGOOXXXXXXXXXXXXXXXXXGOOOOOOXXXXXXXXXXXXXGOOOOOOOXXXXXXXXXXXX,0,300,0

25305,67,0,67,8,225,0,0,227,207,20,GOOOXXXXXXXXXXXXXXXXGOOOOOXXXXXXXXXXXXXXGOOOOOOOXXXXXXXXXXXXGOXXXXXXXXXXXXXXXXXXGOOOOOOOOOXXXXXXXXXXGOXXXXXXXXXXXXXXXXXXGOOOXXXXXXXXXXXXXXXXGOOXXXXXXXXXXXXXXXXXGOOOXXXXXXXXXXXXXXXXGOOOOOXXXXXXXXXXXXXXGOOXXXXXXXXXXXXXXXXXGOOOOOOXXXXXXXXXXXXXGOOOOOOOXXXXXXXXXXXX,0,300,0
25326,67,0,67,9,224,0,0,226,206,20,GOOOXXXXXXXXXXXXXXXXGOOOOOXXXXXXXXXXXXXXGOOOOOOOXXXXXXXXXXXXGOXXXXXXXXXXXXXXXXXXGOOOOOOOOOXXXXXXXXXXGOXXXXXXXXXXXXXXXXXXGOOOXXXXXXXXXXXXXXXXGOOXXXXXXXXXXXXXXXXXGOOOXXXXXXXXXXXXXXXXGOOOOOXXXXXXXXXXXXXXGOOXXXXXXXXXXXXXXXXXGOOOOOOXXXXXXXXXXXXXGOOOOOOOXXXXXXXXXXXX,0,300,0
25347,67,0,67,9,224,0,0,226,206,20,GOOOXXXXXXXXXXXXXXXXGOOOOOXXXXXXXXXXXXXXGOOOOOOOXXXXXXXXXXXXGOXXXXXXXXXXXXXXXXXXGOOOOOOOOOXXXXXXXXXXGOXXXXXXXXXXXXXXXXXXGOOOXXXXXXXXXXXXXXXXGOOXXXXXXXXXXXXXXXXXGOOOXXXXXXXXXXXXXXXXGOOOOOXXXXXXXXXXXXXXGOOXXXXXXXXXXXXXXXXXGOOOOOOXXXXXXXXXXXXXGOOOOOOOXXXXXXXXXXXX,0,300,0
25368,67,0,67,10,223,0,0,225,207,18,GOOOXXXXXXXXXXXXXXXXGOOOOOXXXXXXXXXXXXXXGOOOOOOOXXXXXXXXXXXXGOXXXXXXXXXXXXXXXXXXGOOOOOOOOOXXXXXXXXXXGOXXXXXXXXXXXXXXXXXXGOOOXXXXXXXXXXXXXXXXGOOXXXXXXXXXXXXXXXXXGOOOXXXXXXXXXXXXXXXXGOOOOOXXXXXXXXXXXXXXGOOXXXXXXXXXXXXXXXXXGOOOOOOXXXXXXXXXXXXXGOOOOOOOXXXXXXXXXXXX,0,300,0
25389,67,0,67,10,223,0,0,225,208,17,GOOOXXXXXXXXXXXXXXXXGOOOOOXXXXXXXXXXXXXXGOOOOOOOXXXXXXXXXXXXGOXXXXXXXXXXXXXXXXXXGOOOOOOOOOXXXXXXXXXXGOXXXXXXXXXXXXXXXXXXGOOOXXXXXXXXXXXXXXXXGOOXXXXXXXXXXXXXXXXXGOOOXXXXXXXXXXXXXXXXGOOOOOXXXXXXXXXXXXXXGOOXXXXXXXXXXXXXXXXXGOOOOOOXXXXXXXXXXXXXGOOOOOOOXXXXXXXXXXXX,0,300,0

25410,67,0,67,10,223,0,0,225,209,16,GOOOXXXXXXXXXXXXXXXXGOOOOOXXXXXXXXXXXXXXGOOOOOOOXXXXXXXXXXXXGOXXXXXXXXXXXXXXXXXXGOOOOOOOOOXXXXXXXXXXGOXXXXXXXXXXXXXXXXXXGOOOXXXXXXXXXXXXXXXXGOOXXXXXXXXXXXXXXXXXGOOOXXXXXXXXXXXXXXXXGOOOOOXXXXXXXXXXXXXXGOOXXXXXXXXXXXXXXXXXGOOOOOOXXXXXXXXXXXXXGOOOOOOOXXXXXXXXXXXX,0,300,0
25431,67,0,67,11,222,0,0,224,208,16,GOOOXXXXXXXXXXXXXXXXGOOOOOXXXXXXXXXXXXXXGOOOOOOOXXXXXXXXXXXXGOXXXXXXXXXXXXXXXXXXGOOOOOOOOOXXXXXXXXXXGOXXXXXXXXXXXXXXXXXXGOOOXXXXXXXXXXXXXXXXGOOXXXXXXXXXXXXXXXXXGOOOXXXXXXXXXXXXXXXXGOOOOOXXXXXXXXXXXXXXGOOXXXXXXXXXXXXXXXXXGOOOOOOXXXXXXXXXXXXXGOOOOOOOXXXXXXXXXXXX,0,300,0
25452,67,0,67,12,221,0,0,223,210,13,GOOOXXXXXXXXXXXXXXXXGOOOOOXXXXXXXXXXXXXXGOOOOOOOXXXXXXXXXXXXGOXXXXXXXXXXXXXXXXXXGOOOOOOOOOXXXXXXXXXXGOXXXXXXXXXXXXXXXXXXGOOOXXXXXXXXXXXXXXXXGOOXXXXXXXXXXXXXXXXXGOOOXXXXXXXXXXXXXXXXGOOOOOXXXXXXXXXXXXXXGOOXXXXXXXXXXXXXXXXXGOOOOOOXXXXXXXXXXXXXGOOOOOOOXXXXXXXXXXXX,0,300,0
25473,67,0,67,12,221,0,0,223,209,14,GOOOXXXXXXXXXXXXXXXXGOOOOOXXXXXXXXXXXXXXGOOOOOOOXXXXXXXXXXXXGOXXXXXXXXXXXXXXXXXXGOOOOOOOOOXXXXXXXXXXGOXXXXXXXXXXXXXXXXXXGOOOXXXXXXXXXXXXXXXXGOOXXXXXXXXXXXXXXXXXGOOOXXXXXXXXXXXXXXXXGOOOOOXXXXXXXXXXXXXXGOOXXXXXXXXXXXXXXXXXGOOOOOOXXXXXXXXXXXXXGOOOOOOOXXXXXXXXXXXX,0,300,0
25494,67,0,67,13,220,0,0,222,208,14,GOOOXXXXXXXXXXXXXXXXGOOOOOXXXXXXXXXXXXXXGOOOOOOOXXXXXXXXXXXXGOXXXXXXXXXXXXXXXXXXGOOOOOOOOOXXXXXXXXXXGOXXXXXXXXXXXXXXXXXXGOOOXXXXXXXXXXXXXXXXGOOXXXXXXXXXXXXXXXXXGOOOXXXXXXXXXXXXXXXXGOOOOOXXXXXXXXXXXXXXGOOXXXXXXXXXXXXXXXXXGOOOOOOXXXXXXXXXXXXXGOOOOOOOXXXXXXXXXXXX,0,300,0

25515,67,0,67,12,221,0,0,223,208,15,GOOOXXXXXXXXXXXXXXXXGOOOOOXXXXXXXXXXXXXXGOOOOOOOXXXXXXXXXXXXGOXXXXXXXXXXXXXXXXXXGOOOOOOOOOXXXXXXXXXXGOXXXXXXXXXXXXXXXXXXGOOOXXXXXXXXXXXXXXXXGOOXXXXXXXXXXXXXXXXXGOOOXXXXXXXXXXXXXXXXGOOOOOXXXXXXXXXXXXXXGOOXXXXXXXXXXXXXXXXXGOOOOOOXXXXXXXXXXXXXGOOOOOOOXXXXXXXXXXXX,0,300,0
25536,67,0,67,10,223,0,0,225,209,16,GOOOXXXXXXXXXXXXXXXXGOOOOOXXXXXXXXXXXXXXGOOOOOOOXXXXXXXXXXXXGOXXXXXXXXXXXXXXXXXXGOOOOOOOOOXXXXXXXXXXGOXXXXXXXXXXXXXXXXXXGOOOXXXXXXXXXXXXXXXXGOOXXXXXXXXXXXXXXXXXGOOOXXXXXXXXXXXXXXXXGOOOOOXXXXXXXXXXXXXXGOOXXXXXXXXXXXXXXXXXGOOOOOOXXXXXXXXXXXXXGOOOOOOOXXXXXXXXXXXX,0,300,0
25557,67,0,67,11,222,0,0,224,211,13,GOOOXXXXXXXXXXXXXXXXGOOOOOXXXXXXXXXXXXXXGOOOOOOOXXXXXXXXXXXXGOXXXXXXXXXXXXXXXXXXGOOOOOOOOOXXXXXXXXXXGOXXXXXXXXXXXXXXXXXXGOOOXXXXXXXXXXXXXXXXGOOXXXXXXXXXXXXXXXXXGOOOXXXXXXXXXXXXXXXXGOOOOOXXXXXXXXXXXXXXGOOXXXXXXXXXXXXXXXXXGOOOOOOXXXXXXXXXXXXXGOOOOOOOXXXXXXXXXXXX,0,300,0
25578,67,0,67,9,224,0,0,226,208,18,GOOOXXXXXXXXXXXXXXXXGOOOOOXXXXXXXXXXXXXXGOOOOOOOXXXXXXXXXXXXGOXXXXXXXXXXXXXXXXXXGOOOOOOOOOXXXXXXXXXXGOXXXXXXXXXXXXXXXXXXGOOOXXXXXXXXXXXXXXXXGOOXXXXXXXXXXXXXXXXXGOOOXXXXXXXXXXXXXXXXGOOOOOXXXXXXXXXXXXXXGOOXXXXXXXXXXXXXXXXXGOOOOOOXXXXXXXXXXXXXGOOOOOOOXXXXXXXXXXXX,0,300,0
25599,67,0,67,8,225,0,0,227,207,20,GOOOXXXXXXXXXXXXXXXXGOOOOOXXXXXXXXXXXXXXGOOOOOOOXXXXXXXXXXXXGOXXXXXXXXXXXXXXXXXXGOOOOOOOOOXXXXXXXXXXGOXXXXXXXXXXXXXXXXXXGOOOXXXXXXXXXXXXXXXXGOOXXXXXXXXXXXXXXXXXGOOOXXXXXXXXXXXXXXXXGOOOOOXXXXXXXXXXXXXXGOOXXXXXXXXXXXXXXXXXGOOOOOOXXXXXXXXXXXXXGOOOOOOOXXXXXXXXXXXX,0,300,0

25620,67,0,67,9,224,0,0,226,207,19,GOOOXXXXXXXXXXXXXXXXGOOOOOXXXXXXXXXXXXXXGOOOOOOOXXXXXXXXXXXXGOXXXXXXXXXXXXXXXXXXGOOOOOOOOOXXXXXXXXXXGOXXXXXXXXXXXXXXXXXXGOOOXXXXXXXXXXXXXXXXGOOXXXXXXXXXXXXXXXXXGOOOXXXXXXXXXXXXXXXXGOOOOOXXXXXXXXXXXXXXGOOXXXXXXXXXXXXXXXXXGOOOOOOXXXXXXXXXXXXXGOOOOOOOXXXXXXXXXXXX,0,300,0
25641,67,0,67,9,224,0,0,226,207,19,GOOOXXXXXXXXXXXXXXXXGOOOOOXXXXXXXXXXXXXXGOOOOOOOXXXXXXXXXXXXGOXXXXXXXXXXXXXXXXXXGOOOOOOOOOXXXXXXXXXXGOXXXXXXXXXXXXXXXXXXGOOOXXXXXXXXXXXXXXXXGOOXXXXXXXXXXXXXXXXXGOOOXXXXXXXXXXXXXXXXGOOOOOXXXXXXXXXXXXXXGOOXXXXXXXXXXXXXXXXXGOOOOOOXXXXXXXXXXXXXGOOOOOOOXXXXXXXXXXXX,0,300,0
25662,67,0,67,6,227,0,0,229,208,21,GOOOXXXXXXXXXXXXXXXXGOOOOOXXXXXXXXXXXXXXGOOOOOOOXXXXXXXXXXXXGOXXXXXXXXXXXXXXXXXXGOOOOOOOOOXXXXXXXXXXGOXXXXXXXXXXXXXXXXXXGOOOXXXXXXXXXXXXXXXXGOOXXXXXXXXXXXXXXXXXGOOOXXXXXXXXXXXXXXXXGOOOOOXXXXXXXXXXXXXXGOOXXXXXXXXXXXXXXXXXGOOOOOOXXXXXXXXXXXXXGOOOOOOOXXXXXXXXXXXX,0,300,0
25683,67,0,67,6,227,0,0,229,208,21,GOOOXXXXXXXXXXXXXXXXGOOOOOXXXXXXXXXXXXXXGOOOOOOOXXXXXXXXXXXXGOXXXXXXXXXXXXXXXXXXGOOOOOOOOOXXXXXXXXXXGOXXXXXXXXXXXXXXXXXXGOOOXXXXXXXXXXXXXXXXGOOXXXXXXXXXXXXXXXXXGOOOXXXXXXXXXXXXXXXXGOOOOOXXXXXXXXXXXXXXGOOXXXXXXXXXXXXXXXXXGOOOOOOXXXXXXXXXXXXXGOOOOOOOXXXXXXXXXXXX,0,300,0
25704,67,0,67,7,226,0,0,228,207,21,GOOOXXXXXXXXXXXXXXXXGOOOOOXXXXXXXXXXXXXXGOOOOOOOXXXXXXXXXXXXGOXXXXXXXXXXXXXXXXXXGOOOOOOOOOXXXXXXXXXXGOXXXXXXXXXXXXXXXXXXGOOOXXXXXXXXXXXXXXXXGOOXXXXXXXXXXXXXXXXXGOOOXXXXXXXXXXXXXXXXGOOOOOXXXXXXXXXXXXXXGOOXXXXXXXXXXXXXXXXXGOOOOOOXXXXXXXXXXXXXGOOOOOOOXXXXXXXXXXXX,0,300,0

25725,67,0,67,7,226,0,0,228,209,19,GOOOXXXXXXXXXXXXXXXXGOOOOOXXXXXXXXXXXXXXGOOOOOOOXXXXXXXXXXXXGOXXXXXXXXXXXXXXXXXXGOOOOOOOOOXXXXXXXXXXGOXXXXXXXXXXXXXXXXXXGOOOXXXXXXXXXXXXXXXXGOOXXXXXXXXXXXXXXXXXGOOOXXXXXXXXXXXXXXXXGOOOOOXXXXXXXXXXXXXXGOOXXXXXXXXXXXXXXXXXGOOOOOOXXXXXXXXXXXXXGOOOOOOOXXXXXXXXXXXX,0,300,0
25746,67,0,67,8,225,0,0,227,208,19,GOOOXXXXXXXXXXXXXXXXGOOOOOXXXXXXXXXXXXXXGOOOOOOOXXXXXXXXXXXXGOXXXXXXXXXXXXXXXXXXGOOOOOOOOOXXXXXXXXXXGOXXXXXXXXXXXXXXXXXXGOOOXXXXXXXXXXXXXXXXGOOXXXXXXXXXXXXXXXXXGOOOXXXXXXXXXXXXXXXXGOOOOOXXXXXXXXXXXXXXGOOXXXXXXXXXXXXXXXXXGOOOOOOXXXXXXXXXXXXXGOOOOOOOXXXXXXXXXXXX,0,300,0
25767,67,0,67,7,226,0,0,228,209,19,GOOOXXXXXXXXXXXXXXXXGOOOOOXXXXXXXXXXXXXXGOOOOOOOXXXXXXXXXXXXGOXXXXXXXXXXXXXXXXXXGOOOOOOOOOXXXXXXXXXXGOXXXXXXXXXXXXXXXXXXGOOOXXXXXXXXXXXXXXXXGOOXXXXXXXXXXXXXXXXXGOOOXXXXXXXXXXXXXXXXGOOOOOXXXXXXXXXXXXXXGOOXXXXXXXXXXXXXXXXXGOOOOOOXXXXXXXXXXXXXGOOOOOOOXXXXXXXXXXXX,0,300,0
25788,67,0,67,8,225,0,0,227,208,19,GOOOXXXXXXXXXXXXXXXXGOOOOOXXXXXXXXXXXXXXGOOOOOOOXXXXXXXXXXXXGOXXXXXXXXXXXXXXXXXXGOOOOOOOOOXXXXXXXXXXGOXXXXXXXXXXXXXXXXXXGOOOXXXXXXXXXXXXXXXXGOOXXXXXXXXXXXXXXXXXGOOOXXXXXXXXXXXXXXXXGOOOOOXXXXXXXXXXXXXXGOOXXXXXXXXXXXXXXXXXGOOOOOOXXXXXXXXXXXXXGOOOOOOOXXXXXXXXXXXX,0,300,0
25809,67,0,67,9,224,0,0,226,209,17,GOOOXXXXXXXXXXXXXXXXGOOOOOXXXXXXXXXXXXXXGOOOOOOOXXXXXXXXXXXXGOXXXXXXXXXXXXXXXXXXGOOOOOOOOOXXXXXXXXXXGOXXXXXXXXXXXXXXXXXXGOOOXXXXXXXXXXXXXXXXGOOXXXXXXXXXXXXXXXXXGOOOXXXXXXXXXXXXXXXXGOOOOOXXXXXXXXXXXXXXGOOXXXXXXXXXXXXXXXXXGOOOOOOXXXXXXXXXXXXXGOOOOOOOXXXXXXXXXXXX,0,300,0

25830,67,0,67,10,223,0,0,225,207,18,GOOOXXXXXXXXXXXXXXXXGOOOOOXXXXXXXXXXXXXXGOOOOOOOXXXXXXXXXXXXGOXXXXXXXXXXXXXXXXXXGOOOOOOOOOXXXXXXXXXXGOXXXXXXXXXXXXXXXXXXGOOOXXXXXXXXXXXXXXXXGOOXXXXXXXXXXXXXXXXXGOOOXXXXXXXXXXXXXXXXGOOOOOXXXXXXXXXXXXXXGOOXXXXXXXXXXXXXXXXXGOOOOOOXXXXXXXXXXXXXGOOOOOOOXXXXXXXXXXXX,0,300,0
25851,67,0,67,10,223,0,0,225,207,18,GOOOXXXXXXXXXXXXXXXXGOOOOOXXXXXXXXXXXXXXGOOOOOOOXXXXXXXXXXXXGOXXXXXXXXXXXXXXXXXXGOOOOOOOOOXXXXXXXXXXGOXXXXXXXXXXXXXXXXXXGOOOXXXXXXXXXXXXXXXXGOOXXXXXXXXXXXXXXXXXGOOOXXXXXXXXXXXXXXXXGOOOOOXXXXXXXXXXXXXXGOOXXXXXXXXXXXXXXXXXGOOOOOOXXXXXXXXXXXXXGOOOOOOOXXXXXXXXXXXX,0,300,0
25872,67,0,67,7,226,0,0,228,208,20,GOOOXXXXXXXXXXXXXXXXGOOOOOXXXXXXXXXXXXXXGOOOOOOOXXXXXXXXXXXXGOXXXXXXXXXXXXXXXXXXGOOOOOOOOOXXXXXXXXXXGOXXXXXXXXXXXXXXXXXXGOOOXXXXXXXXXXXXXXXXGOOXXXXXXXXXXXXXXXXXGOOOXXXXXXXXXXXXXXXXGOOOOOXXXXXXXXXXXXXXGOOXXXXXXXXXXXXXXXXXGOOOOOOXXXXXXXXXXXXXGOOOOOOOXXXXXXXXXXXX,0,300,0
25893,67,0,67,9,224,0,0,226,210,16,GOOOXXXXXXXXXXXXXXXXGOOOOOXXXXXXXXXXXXXXGOOOOOOOXXXXXXXXXXXXGOXXXXXXXXXXXXXXXXXXGOOOOOOOOOXXXXXXXXXXGOXXXXXXXXXXXXXXXXXXGOOOXXXXXXXXXXXXXXXXGOOXXXXXXXXXXXXXXXXXGOOOXXXXXXXXXXXXXXXXGOOOOOXXXXXXXXXXXXXXGOOXXXXXXXXXXXXXXXXXGOOOOOOXXXXXXXXXXXXXGOOOOOOOXXXXXXXXXXXX,0,300,0
25914,67,0,67,11,222,0,0,224,209,15,GOOOXXXXXXXXXXXXXXXXGOOOOOXXXXXXXXXXXXXXGOOOOOOOXXXXXXXXXXXXGOXXXXXXXXXXXXXXXXXXGOOOOOOOOOXXXXXXXXXXGOXXXXXXXXXXXXXXXXXXGOOOXXXXXXXXXXXXXXXXGOOXXXXXXXXXXXXXXXXXGOOOXXXXXXXXXXXXXXXXGOOOOOXXXXXXXXXXXXXXGOOXXXXXXXXXXXXXXXXXGOOOOOOXXXXXXXXXXXXXGOOOOOOOXXXXXXXXXXXX,0,300,0

25935,67,0,67,11,222,0,0,224,209,15,GOOOXXXXXXXXXXXXXXXXGOOOOOXXXXXXXXXXXXXXGOOOOOOOXXXXXXXXXXXXGOXXXXXXXXXXXXXXXXXXGOOOOOOOOOXXXXXXXXXXGOXXXXXXXXXXXXXXXXXXGOOOXXXXXXXXXXXXXXXXGOOXXXXXXXXXXXXXXXXXGOOOXXXXXXXXXXXXXXXXGOOOOOXXXXXXXXXXXXXXGOOXXXXXXXXXXXXXXXXXGOOOOOOXXXXXXXXXXXXXGOOOOOOOXXXXXXXXXXXX,0,300,0
25956,67,0,67,10,223,0,0,225,210,15,GOOOXXXXXXXXXXXXXXXXGOOOOOXXXXXXXXXXXXXXGOOOOOOOXXXXXXXXXXXXGOXXXXXXXXXXXXXXXXXXGOOOOOOOOOXXXXXXXXXXGOXXXXXXXXXXXXXXXXXXGOOOXXXXXXXXXXXXXXXXGOOXXXXXXXXXXXXXXXXXGOOOXXXXXXXXXXXXXXXXGOOOOOXXXXXXXXXXXXXXGOOXXXXXXXXXXXXXXXXXGOOOOOOXXXXXXXXXXXXXGOOOOOOOXXXXXXXXXXXX,0,300,0
25977,67,0,67,9,224,0,0,225,209,16,GOOOXXXXXXXXXXXXXXXXGOOOOOXXXXXXXXXXXXXXGOOOOOOOXXXXXXXXXXXXGOXXXXXXXXXXXXXXXXXXGOOOOOOOOOXXXXXXXXXXGOXXXXXXXXXXXXXXXXXXGOOOXXXXXXXXXXXXXXXXGOOXXXXXXXXXXXXXXXXXGOOOXXXXXXXXXXXXXXXXGOOOOOXXXXXXXXXXXXXXGOOXXXXXXXXXXXXXXXXXGOOOOOOXXXXXXXXXXXXXGOOOOOOOXXXXXXXXXXXX,0,300,0
25998,67,0,67,10,223,0,0,225,208,17,GOOOXXXXXXXXXXXXXXXXGOOOOOXXXXXXXXXXXXXXGOOOOOOOXXXXXXXXXXXXGOXXXXXXXXXXXXXXXXXXGOOOOOOOOOXXXXXXXXXXGOXXXXXXXXXXXXXXXXXXGOOOXXXXXXXXXXXXXXXXGOOXXXXXXXXXXXXXXXXXGOOOXXXXXXXXXXXXXXXXGOOOOOXXXXXXXXXXXXXXGOOXXXXXXXXXXXXXXXXXGOOOOOOXXXXXXXXXXXXXGOOOOOOOXXXXXXXXXXXX,0,300,0
26019,67,0,67,9,224,0,0,225,208,17,GOOOXXXXXXXXXXXXXXXXGOOOOOXXXXXXXXXXXXXXGOOOOOOOXXXXXXXXXXXXGOXXXXXXXXXXXXXXXXXXGOOOOOOOOOXXXXXXXXXXGOXXXXXXXXXXXXXXXXXXGOOOXXXXXXXXXXXXXXXXGOOXXXXXXXXXXXXXXXXXGOOOXXXXXXXXXXXXXXXXGOOOOOXXXXXXXXXXXXXXGOOXXXXXXXXXXXXXXXXXGOOOOOOXXXXXXXXXXXXXGOOOOOOOXXXXXXXXXXXX,0,300,0

26040,67,0,67,9,224,0,0,226,208,18,GOOOXXXXXXXXXXXXXXXXGOOOOOXXXXXXXXXXXXXXGOOOOOOOXXXXXXXXXXXXGOXXXXXXXXXXXXXXXXXXGOOOOOOOOOXXXXXXXXXXGOXXXXXXXXXXXXXXXXXXGOOOXXXXXXXXXXXXXXXXGOOXXXXXXXXXXXXXXXXXGOOOXXXXXXXXXXXXXXXXGOOOOOXXXXXXXXXXXXXXGOOXXXXXXXXXXXXXXXXXGOOOOOOXXXXXXXXXXXXXGOOOOOOOXXXXXXXXXXXX,0,300,0
26061,67,0,67,7,226,0,0,228,209,19,GOOOXXXXXXXXXXXXXXXXGOOOOOXXXXXXXXXXXXXXGOOOOOOOXXXXXXXXXXXXGOXXXXXXXXXXXXXXXXXXGOOOOOOOOOXXXXXXXXXXGOXXXXXXXXXXXXXXXXXXGOOOXXXXXXXXXXXXXXXXGOOXXXXXXXXXXXXXXXXXGOOOXXXXXXXXXXXXXXXXGOOOOOXXXXXXXXXXXXXXGOOXXXXXXXXXXXXXXXXXGOOOOOOXXXXXXXXXXXXXGOOOOOOOXXXXXXXXXXXX,0,300,0
26082,67,0,67,7,226,0,0,228,209,19,GOOOXXXXXXXXXXXXXXXXGOOOOOXXXXXXXXXXXXXXGOOOOOOOXXXXXXXXXXXXGOXXXXXXXXXXXXXXXXXXGOOOOOOOOOXXXXXXXXXXGOXXXXXXXXXXXXXXXXXXGOOOXXXXXXXXXXXXXXXXGOOXXXXXXXXXXXXXXXXXGOOOXXXXXXXXXXXXXXXXGOOOOOXXXXXXXXXXXXXXGOOXXXXXXXXXXXXXXXXXGOOOOOOXXXXXXXXXXXXXGOOOOOOOXXXXXXXXXXXX,0,300,0
26103,67,0,67,9,224,0,0,226,208,18,GOOOXXXXXXXXXXXXXXXXGOOOOOXXXXXXXXXXXXXXGOOOOOOOXXXXXXXXXXXXGOXXXXXXXXXXXXXXXXXXGOOOOOOOOOXXXXXXXXXXGOXXXXXXXXXXXXXXXXXXGOOOXXXXXXXXXXXXXXXXGOOXXXXXXXXXXXXXXXXXGOOOXXXXXXXXXXXXXXXXGOOOOOXXXXXXXXXXXXXXGOOXXXXXXXXXXXXXXXXXGOOOOOOXXXXXXXXXXXXXGOOOOOOOXXXXXXXXXXXX,0,300,0
26124,67,0,67,8,225,0,0,227,208,19,GOOOXXXXXXXXXXXXXXXXGOOOOOXXXXXXXXXXXXXXGOOOOOOOXXXXXXXXXXXXGOXXXXXXXXXXXXXXXXXXGOOOOOOOOOXXXXXXXXXXGOXXXXXXXXXXXXXXXXXXGOOOXXXXXXXXXXXXXXXXGOOXXXXXXXXXXXXXXXXXGOOOXXXXXXXXXXXXXXXXGOOOOOXXXXXXXXXXXXXXGOOXXXXXXXXXXXXXXXXXGOOOOOOXXXXXXXXXXXXXGOOOOOOOXXXXXXXXXXXX,0,300,0

26145,67,0,67,6,227,0,0,229,209,20,GOOOXXXXXXXXXXXXXXXXGOOOOOXXXXXXXXXXXXXXGOOOOOOOXXXXXXXXXXXXGOXXXXXXXXXXXXXXXXXXGOOOOOOOOOXXXXXXXXXXGOXXXXXXXXXXXXXXXXXXGOOOXXXXXXXXXXXXXXXXGOOXXXXXXXXXXXXXXXXXGOOOXXXXXXXXXXXXXXXXGOOOOOXXXXXXXXXXXXXXGOOXXXXXXXXXXXXXXXXXGOOOOOOXXXXXXXXXXXXXGOOOOOOOXXXXXXXXXXXX,0,300,0
26166,67,0,67,6,227,0,0,229,208,21,GOOOXXXXXXXXXXXXXXXXGOOOOOXXXXXXXXXXXXXXGOOOOOOOXXXXXXXXXXXXGOXXXXXXXXXXXXXXXXXXGOOOOOOOOOXXXXXXXXXXGOXXXXXXXXXXXXXXXXXXGOOOXXXXXXXXXXXXXXXXGOOXXXXXXXXXXXXXXXXXGOOOXXXXXXXXXXXXXXXXGOOOOOXXXXXXXXXXXXXXGOOXXXXXXXXXXXXXXXXXGOOOOOOXXXXXXXXXXXXXGOOOOOOOXXXXXXXXXXXX,0,300,0
26187,67,0,67,5,228,0,0,230,208,22,GOOOXXXXXXXXXXXXXXXXGOOOOOXXXXXXXXXXXXXXGOOOOOOOXXXXXXXXXXXXGOXXXXXXXXXXXXXXXXXXGOOOOOOOOOXXXXXXXXXXGOXXXXXXXXXXXXXXXXXXGOOOXXXXXXXXXXXXXXXXGOOXXXXXXXXXXXXXXXXXGOOOXXXXXXXXXXXXXXXXGOOOOOXXXXXXXXXXXXXXGOOXXXXXXXXXXXXXXXXXGOOOOOOXXXXXXXXXXXXXGOOOOOOOXXXXXXXXXXXX,0,300,0
26208,67,0,67,5,228,0,0,230,208,22,GOOOXXXXXXXXXXXXXXXXGOOOOOXXXXXXXXXXXXXXGOOOOOOOXXXXXXXXXXXXGOXXXXXXXXXXXXXXXXXXGOOOOOOOOOXXXXXXXXXXGOXXXXXXXXXXXXXXXXXXGOOOXXXXXXXXXXXXXXXXGOOXXXXXXXXXXXXXXXXXGOOOXXXXXXXXXXXXXXXXGOOOOOXXXXXXXXXXXXXXGOOXXXXXXXXXXXXXXXXXGOOOOOOXXXXXXXXXXXXXGOOOOOOOXXXXXXXXXXXX,0,300,0
26229,67,0,67,7,226,0,0,228,210,18,GOOOXXXXXXXXXXXXXXXXGOOOOOXXXXXXXXXXXXXXGOOOOOOOXXXXXXXXXXXXGOXXXXXXXXXXXXXXXXXXGOOOOOOOOOXXXXXXXXXXGOXXXXXXXXXXXXXXXXXXGOOOXXXXXXXXXXXXXXXXGOOXXXXXXXXXXXXXXXXXGOOOXXXXXXXXXXXXXXXXGOOOOOXXXXXXXXXXXXXXGOOXXXXXXXXXXXXXXXXXGOOOOOOXXXXXXXXXXXXXGOOOOOOOXXXXXXXXXXXX,0,300,0

26250,67,0,67,9,224,0,0,226,209,17,GOOOXXXXXXXXXXXXXXXXGOOOOOXXXXXXXXXXXXXXGOOOOOOOXXXXXXXXXXXXGOXXXXXXXXXXXXXXXXXXGOOOOOOOOOXXXXXXXXXXGOXXXXXXXXXXXXXXXXXXGOOOXXXXXXXXXXXXXXXXGOOXXXXXXXXXXXXXXXXXGOOOXXXXXXXXXXXXXXXXGOOOOOXXXXXXXXXXXXXXGOOXXXXXXXXXXXXXXXXXGOOOOOOXXXXXXXXXXXXXGOOOOOOOXXXXXXXXXXXX,0,300,0
26271,67,0,67,9,224,0,0,226,209,17,GOOOXXXXXXXXXXXXXXXXGOOOOOXXXXXXXXXXXXXXGOOOOOOOXXXXXXXXXXXXGOXXXXXXXXXXXXXXXXXXGOOOOOOOOOXXXXXXXXXXGOXXXXXXXXXXXXXXXXXXGOOOXXXXXXXXXXXXXXXXGOOXXXXXXXXXXXXXXXXXGOOOXXXXXXXXXXXXXXXXGOOOOOXXXXXXXXXXXXXXGOOXXXXXXXXXXXXXXXXXGOOOOOOXXXXXXXXXXXXXGOOOOOOOXXXXXXXXXXXX,0,300,0
26292,67,0,67,9,224,0,0,226,209,17,GOOOXXXXXXXXXXXXXXXXGOOOOOXXXXXXXXXXXXXXGOOOOOOOXXXXXXXXXXXXGOXXXXXXXXXXXXXXXXXXGOOOOOOOOOXXXXXXXXXXGOXXXXXXXXXXXXXXXXXXGOOOXXXXXXXXXXXXXXXXGOOXXXXXXXXXXXXXXXXXGOOOXXXXXXXXXXXXXXXXGOOOOOXXXXXXXXXXXXXXGOOXXXXXXXXXXXXXXXXXGOOOOOOXXXXXXXXXXXXXGOOOOOOOXXXXXXXXXXXX,0,300,0
26313,67,0,67,7,226,0,0,227,209,18,GOOOXXXXXXXXXXXXXXXXGOOOOOXXXXXXXXXXXXXXGOOOOOOOXXXXXXXXXXXXGOXXXXXXXXXXXXXXXXXXGOOOOOOOOOXXXXXXXXXXGOXXXXXXXXXXXXXXXXXXGOOOXXXXXXXXXXXXXXXXGOOXXXXXXXXXXXXXXXXXGOOOXXXXXXXXXXXXXXXXGOOOOOXXXXXXXXXXXXXXGOOXXXXXXXXXXXXXXXXXGOOOOOOXXXXXXXXXXXXXGOOOOOOOXXXXXXXXXXXX,0,300,0
26334,67,0,67,8,225,0,0,227,209,18,GOOOXXXXXXXXXXXXXXXXGOOOOOXXXXXXXXXXXXXXGOOOOOOOXXXXXXXXXXXXGOXXXXXXXXXXXXXXXXXXGOOOOOOOOOXXXXXXXXXXGOXXXXXXXXXXXXXXXXXXGOOOXXXXXXXXXXXXXXXXGOOXXXXXXXXXXXXXXXXXGOOOXXXXXXXXXXXXXXXXGOOOOOXXXXXXXXXXXXXXGOOXXXXXXXXXXXXXXXXXGOOOOOOXXXXXXXXXXXXXGOOOOOOOXXXXXXXXXXXX,0,300,0

26355,67,0,67,7,226,0,0,228,209,19,GOOOXXXXXXXXXXXXXXXXGOOOOOXXXXXXXXXXXXXXGOOOOOOOXXXXXXXXXXXXGOXXXXXXXXXXXXXXXXXXGOOOOOOOOOXXXXXXXXXXGOXXXXXXXXXXXXXXXXXXGOOOXXXXXXXXXXXXXXXXGOOXXXXXXXXXXXXXXXXXGOOOXXXXXXXXXXXXXXXXGOOOOOXXXXXXXXXXXXXXGOOXXXXXXXXXXXXXXXXXGOOOOOOXXXXXXXXXXXXXGOOOOOOOXXXXXXXXXXXX,0,300,0
26376,67,0,67,5,228,0,0,230,210,20,GOOOXXXXXXXXXXXXXXXXGOOOOOXXXXXXXXXXXXXXGOOOOOOOXXXXXXXXXXXXGOXXXXXXXXXXXXXXXXXXGOOOOOOOOOXXXXXXXXXXGOXXXXXXXXXXXXXXXXXXGOOOXXXXXXXXXXXXXXXXGOOXXXXXXXXXXXXXXXXXGOOOXXXXXXXXXXXXXXXXGOOOOOXXXXXXXXXXXXXXGOOXXXXXXXXXXXXXXXXXGOOOOOOXXXXXXXXXXXXXGOOOOOOOXXXXXXXXXXXX,0,300,0
26397,67,0,67,6,227,0,0,229,209,20,GOOOXXXXXXXXXXXXXXXXGOOOOOXXXXXXXXXXXXXXGOOOOOOOXXXXXXXXXXXXGOXXXXXXXXXXXXXXXXXXGOOOOOOOOOXXXXXXXXXXGOXXXXXXXXXXXXXXXXXXGOOOXXXXXXXXXXXXXXXXGOOXXXXXXXXXXXXXXXXXGOOOXXXXXXXXXXXXXXXXGOOOOOXXXXXXXXXXXXXXGOOXXXXXXXXXXXXXXXXXGOOOOOOXXXXXXXXXXXXXGOOOOOOOXXXXXXXXXXXX,0,300,0
26418,68,1,67,6,226,0,0,228,209,19,GOOOXXXXXXXXXXXXXXXXGOOOOOXXXXXXXXXXXXXXGOOOOOOOXXXXXXXXXXXXGOXXXXXXXXXXXXXXXXXXGOOOOOOOOOAXXXXXXXXXGOXXXXXXXXXXXXXXXXXXGOOOXXXXXXXXXXXXXXXXGOOXXXXXXXXXXXXXXXXXGOOOXXXXXXXXXXXXXXXXGOOOOOXXXXXXXXXXXXXXGOOXXXXXXXXXXXXXXXXXGOOOOOOXXXXXXXXXXXXXGOOOOOOOXXXXXXXXXXXX,0,300,0
26439,68,1,67,8,224,0,0,226,213,13,GOOOXXXXXXXXXXXXXXXXGOOOOOXXXXXXXXXXXXXXGOOOOOOOXXXXXXXXXXXXGOXXXXXXXXXXXXXXXXXXGOOOOOOOOOAXXXXXXXXXGOXXXXXXXXXXXXXXXXXXGOOOXXXXXXXXXXXXXXXXGOOXXXXXXXXXXXXXXXXXGOOOXXXXXXXXXXXXXXXXGOOOOOXXXXXXXXXXXXXXGOOXXXXXXXXXXXXXXXXXGOOOOOOXXXXXXXXXXXXXGOOOOOOOXXXXXXXXXXXX,0,300,0

26460,68,1,67,11,221,0,0,223,213,10,GOOOXXXXXXXXXXXXXXXXGOOOOOXXXXXXXXXXXXXXGOOOOOOOXXXXXXXXXXXXGOXXXXXXXXXXXXXXXXXXGOOOOOOOOOAXXXXXXXXXGOXXXXXXXXXXXXXXXXXXGOOOXXXXXXXXXXXXXXXXGOOXXXXXXXXXXXXXXXXXGOOOXXXXXXXXXXXXXXXXGOOOOOXXXXXXXXXXXXXXGOOXXXXXXXXXXXXXXXXXGOOOOOOXXXXXXXXXXXXXGOOOOOOOXXXXXXXXXXXX,0,300,0
26481,68,1,67,13,219,0,0,221,211,10,GOOOXXXXXXXXXXXXXXXXGOOOOOXXXXXXXXXXXXXXGOOOOOOOXXXXXXXXXXXXGOXXXXXXXXXXXXXXXXXXGOOOOOOOOOAXXXXXXXXXGOXXXXXXXXXXXXXXXXXXGOOOXXXXXXXXXXXXXXXXGOOXXXXXXXXXXXXXXXXXGOOOXXXXXXXXXXXXXXXXGOOOOOXXXXXXXXXXXXXXGOOXXXXXXXXXXXXXXXXXGOOOOOOXXXXXXXXXXXXXGOOOOOOOXXXXXXXXXXXX,0,300,0
26502,68,1,67,13,219,0,0,221,212,9,GOOOXXXXXXXXXXXXXXXXGOOOOOXXXXXXXXXXXXXXGOOOOOOOXXXXXXXXXXXXGOXXXXXXXXXXXXXXXXXXGOOOOOOOOOAXXXXXXXXXGOXXXXXXXXXXXXXXXXXXGOOOXXXXXXXXXXXXXXXXGOOXXXXXXXXXXXXXXXXXGOOOXXXXXXXXXXXXXXXXGOOOOOXXXXXXXXXXXXXXGOOXXXXXXXXXXXXXXXXXGOOOOOOXXXXXXXXXXXXXGOOOOOOOXXXXXXXXXXXX,0,300,0
26523,68,0,68,13,219,0,0,221,211,10,GOOOXXXXXXXXXXXXXXXXGOOOOOXXXXXXXXXXXXXXGOOOOOOOXXXXXXXXXXXXGOXXXXXXXXXXXXXXXXXXGOOOOOOOOOOXXXXXXXXXGOXXXXXXXXXXXXXXXXXXGOOOXXXXXXXXXXXXXXXXGOOXXXXXXXXXXXXXXXXXGOOOXXXXXXXXXXXXXXXXGOOOOOXXXXXXXXXXXXXXGOOXXXXXXXXXXXXXXXXXGOOOOOOXXXXXXXXXXXXXGOOOOOOOXXXXXXXXXXXX,0,300,0
26544,68,0,68,13,219,0,0,221,210,11,GOOOXXXXXXXXXXXXXXXXGOOOOOXXXXXXXXXXXXXXGOOOOOOOXXXXXXXXXXXXGOXXXXXXXXXXXXXXXXXXGOOOOOOOOOOXXXXXXXXXGOXXXXXXXXXXXXXXXXXXGOOOXXXXXXXXXXXXXXXXGOOXXXXXXXXXXXXXXXXXGOOOXXXXXXXXXXXXXXXXGOOOOOXXXXXXXXXXXXXXGOOXXXXXXXXXXXXXXXXXGOOOOOOXXXXXXXXXXXXXGOOOOOOOXXXXXXXXXXXX,0,300,0

26565,68,0,68,13,219,0,0,221,210,11,GOOOXXXXXXXXXXXXXXXXGOOOOOXXXXXXXXXXXXXXGOOOOOOOXXXXXXXXXXXXGOXXXXXXXXXXXXXXXXXXGOOOOOOOOOOXXXXXXXXXGOXXXXXXXXXXXXXXXXXXGOOOXXXXXXXXXXXXXXXXGOOXXXXXXXXXXXXXXXXXGOOOXXXXXXXXXXXXXXXXGOOOOOXXXXXXXXXXXXXXGOOXXXXXXXXXXXXXXXXXGOOOOOOXXXXXXXXXXXXXGOOOOOOOXXXXXXXXXXXX,0,300,0
26586,68,0,68,12,220,0,0,222,211,11,GOOOXXXXXXXXXXXXXXXXGOOOOOXXXXXXXXXXXXXXGOOOOOOOXXXXXXXXXXXXGOXXXXXXXXXXXXXXXXXXGOOOOOOOOOOXXXXXXXXXGOXXXXXXXXXXXXXXXXXXGOOOXXXXXXXXXXXXXXXXGOOXXXXXXXXXXXXXXXXXGOOOXXXXXXXXXXXXXXXXGOOOOOXXXXXXXXXXXXXXGOOXXXXXXXXXXXXXXXXXGOOOOOOXXXXXXXXXXXXXGOOOOOOOXXXXXXXXXXXX,0,300,0
26607,68,0,68,10,222,0,0,224,211,13,GOOOXXXXXXXXXXXXXXXXGOOOOOXXXXXXXXXXXXXXGOOOOOOOXXXXXXXXXXXXGOXXXXXXXXXXXXXXXXXXGOOOOOOOOOOXXXXXXXXXGOXXXXXXXXXXXXXXXXXXGOOOXXXXXXXXXXXXXXXXGOOXXXXXXXXXXXXXXXXXGOOOXXXXXXXXXXXXXXXXGOOOOOXXXXXXXXXXXXXXGOOXXXXXXXXXXXXXXXXXGOOOOOOXXXXXXXXXXXXXGOOOOOOOXXXXXXXXXXXX,0,300,0
26628,68,0,68,11,221,0,0,223,210,13,GOOOXXXXXXXXXXXXXXXXGOOOOOXXXXXXXXXXXXXXGOOOOOOOXXXXXXXXXXXXGOXXXXXXXXXXXXXXXXXXGOOOOOOOOOOXXXXXXXXXGOXXXXXXXXXXXXXXXXXXGOOOXXXXXXXXXXXXXXXXGOOXXXXXXXXXXXXXXXXXGOOOXXXXXXXXXXXXXXXXGOOOOOXXXXXXXXXXXXXXGOOXXXXXXXXXXXXXXXXXGOOOOOOXXXXXXXXXXXXXGOOOOOOOXXXXXXXXXXXX,0,300,0
26649,68,0,68,10,222,0,0,224,210,14,GOOOXXXXXXXXXXXXXXXXGOOOOOXXXXXXXXXXXXXXGOOOOOOOXXXXXXXXXXXXGOXXXXXXXXXXXXXXXXXXGOOOOOOOOOOXXXXXXXXXGOXXXXXXXXXXXXXXXXXXGOOOXXXXXXXXXXXXXXXXGOOXXXXXXXXXXXXXXXXXGOOOXXXXXXXXXXXXXXXXGOOOOOXXXXXXXXXXXXXXGOOXXXXXXXXXXXXXXXXXGOOOOOOXXXXXXXXXXXXXGOOOOOOOXXXXXXXXXXXX,0,300,0

26670,68,0,68,9,223,0,0,225,210,15,GOOOXXXXXXXXXXXXXXXXGOOOOOXXXXXXXXXXXXXXGOOOOOOOXXXXXXXXXXXXGOXXXXXXXXXXXXXXXXXXGOOOOOOOOOOXXXXXXXXXGOXXXXXXXXXXXXXXXXXXGOOOXXXXXXXXXXXXXXXXGOOXXXXXXXXXXXXXXXXXGOOOXXXXXXXXXXXXXXXXGOOOOOXXXXXXXXXXXXXXGOOXXXXXXXXXXXXXXXXXGOOOOOOXXXXXXXXXXXXXGOOOOOOOXXXXXXXXXXXX,0,300,0
26691,68,0,68,9,223,0,0,225,210,15,GOOOXXXXXXXXXXXXXXXXGOOOOOXXXXXXXXXXXXXXGOOOOOOOXXXXXXXXXXXXGOXXXXXXXXXXXXXXXXXXGOOOOOOOOOOXXXXXXXXXGOXXXXXXXXXXXXXXXXXXGOOOXXXXXXXXXXXXXXXXGOOXXXXXXXXXXXXXXXXXGOOOXXXXXXXXXXXXXXXXGOOOOOXXXXXXXXXXXXXXGOOXXXXXXXXXXXXXXXXXGOOOOOOXXXXXXXXXXXXXGOOOOOOOXXXXXXXXXXXX,0,300,0
26712,68,0,68,7,225,0,0,227,211,16,GOOOXXXXXXXXXXXXXXXXGOOOOOXXXXXXXXXXXXXXGOOOOOOOXXXXXXXXXXXXGOXXXXXXXXXXXXXXXXXXGOOOOOOOOOOXXXXXXXXXGOXXXXXXXXXXXXXXXXXXGOOOXXXXXXXXXXXXXXXXGOOXXXXXXXXXXXXXXXXXGOOOXXXXXXXXXXXXXXXXGOOOOOXXXXXXXXXXXXXXGOOXXXXXXXXXXXXXXXXXGOOOOOOXXXXXXXXXXXXXGOOOOOOOXXXXXXXXXXXX,0,300,0
26733,68,0,68,7,225,0,0,227,210,17,GOOOXXXXXXXXXXXXXXXXGOOOOOXXXXXXXXXXXXXXGOOOOOOOXXXXXXXXXXXXGOXXXXXXXXXXXXXXXXXXGOOOOOOOOOOXXXXXXXXXGOXXXXXXXXXXXXXXXXXXGOOOXXXXXXXXXXXXXXXXGOOXXXXXXXXXXXXXXXXXGOOOXXXXXXXXXXXXXXXXGOOOOOXXXXXXXXXXXXXXGOOXXXXXXXXXXXXXXXXXGOOOOOOXXXXXXXXXXXXXGOOOOOOOXXXXXXXXXXXX,0,300,0
26754,68,0,68,6,226,0,0,228,210,18,GOOOXXXXXXXXXXXXXXXXGOOOOOXXXXXXXXXXXXXXGOOOOOOOXXXXXXXXXXXXGOXXXXXXXXXXXXXXXXXXGOOOOOOOOOOXXXXXXXXXGOXXXXXXXXXXXXXXXXXXGOOOXXXXXXXXXXXXXXXXGOOXXXXXXXXXXXXXXXXXGOOOXXXXXXXXXXXXXXXXGOOOOOXXXXXXXXXXXXXXGOOXXXXXXXXXXXXXXXXXGOOOOOOXXXXXXXXXXXXXGOOOOOOOXXXXXXXXXXXX,0,300,0

26775,68,0,68,6,226,0,0,228,211,17,GOOOXXXXXXXXXXXXXXXXGOOOOOXXXXXXXXXXXXXXGOOOOOOOXXXXXXXXXXXXGOXXXXXXXXXXXXXXXXXXGOOOOOOOOOOXXXXXXXXXGOXXXXXXXXXXXXXXXXXXGOOOXXXXXXXXXXXXXXXXGOOXXXXXXXXXXXXXXXXXGOOOXXXXXXXXXXXXXXXXGOOOOOXXXXXXXXXXXXXXGOOXXXXXXXXXXXXXXXXXGOOOOOOXXXXXXXXXXXXXGOOOOOOOXXXXXXXXXXXX,0,300,0
26796,68,0,68,6,226,0,0,228,211,17,GOOOXXXXXXXXXXXXXXXXGOOOOOXXXXXXXXXXXXXXGOOOOOOOXXXXXXXXXXXXGOXXXXXXXXXXXXXXXXXXGOOOOOOOOOOXXXXXXXXXGOXXXXXXXXXXXXXXXXXXGOOOXXXXXXXXXXXXXXXXGOOXXXXXXXXXXXXXXXXXGOOOXXXXXXXXXXXXXXXXGOOOOOXXXXXXXXXXXXXXGOOXXXXXXXXXXXXXXXXXGOOOOOOXXXXXXXXXXXXXGOOOOOOOXXXXXXXXXXXX,0,300,0
26817,68,0,68,7,225,0,0,227,210,17,GOOOXXXXXXXXXXXXXXXXGOOOOOXXXXXXXXXXXXXXGOOOOOOOXXXXXXXXXXXXGOXXXXXXXXXXXXXXXXXXGOOOOOOOOOOXXXXXXXXXGOXXXXXXXXXXXXXXXXXXGOOOXXXXXXXXXXXXXXXXGOOXXXXXXXXXXXXXXXXXGOOOXXXXXXXXXXXXXXXXGOOOOOXXXXXXXXXXXXXXGOOXXXXXXXXXXXXXXXXXGOOOOOOXXXXXXXXXXXXXGOOOOOOOXXXXXXXXXXXX,0,300,0
26838,68,0,68,5,227,0,0,229,211,18,GOOOXXXXXXXXXXXXXXXXGOOOOOXXXXXXXXXXXXXXGOOOOOOOXXXXXXXXXXXXGOXXXXXXXXXXXXXXXXXXGOOOOOOOOOOXXXXXXXXXGOXXXXXXXXXXXXXXXXXXGOOOXXXXXXXXXXXXXXXXGOOXXXXXXXXXXXXXXXXXGOOOXXXXXXXXXXXXXXXXGOOOOOXXXXXXXXXXXXXXGOOXXXXXXXXXXXXXXXXXGOOOOOOXXXXXXXXXXXXXGOOOOOOOXXXXXXXXXXXX,0,300,0
26859,68,0,68,7,225,0,0,227,210,17,GOOOXXXXXXXXXXXXXXXXGOOOOOXXXXXXXXXXXXXXGOOOOOOOXXXXXXXXXXXXGOXXXXXXXXXXXXXXXXXXGOOOOOOOOOOXXXXXXXXXGOXXXXXXXXXXXXXXXXXXGOOOXXXXXXXXXXXXXXXXGOOXXXXXXXXXXXXXXXXXGOOOXXXXXXXXXXXXXXXXGOOOOOXXXXXXXXXXXXXXGOOXXXXXXXXXXXXXXXXXGOOOOOOXXXXXXXXXXXXXGOOOOOOOXXXXXXXXXXXX,0,300,0

26880,68,0,68,7,225,0,0,227,210,17,GOOOXXXXXXXXXXXXXXXXGOOOOOXXXXXXXXXXXXXXGOOOOOOOXXXXXXXXXXXXGOXXXXXXXXXXXXXXXXXXGOOOOOOOOOOXXXXXXXXXGOXXXXXXXXXXXXXXXXXXGOOOXXXXXXXXXXXXXXXXGOOXXXXXXXXXXXXXXXXXGOOOXXXXXXXXXXXXXXXXGOOOOOXXXXXXXXXXXXXXGOOXXXXXXXXXXXXXXXXXGOOOOOOXXXXXXXXXXXXXGOOOOOOOXXXXXXXXXXXX,0,300,0
26901,68,0,68,7,225,0,0,227,211,16,GOOOXXXXXXXXXXXXXXXXGOOOOOXXXXXXXXXXXXXXGOOOOOOOXXXXXXXXXXXXGOXXXXXXXXXXXXXXXXXXGOOOOOOOOOOXXXXXXXXXGOXXXXXXXXXXXXXXXXXXGOOOXXXXXXXXXXXXXXXXGOOXXXXXXXXXXXXXXXXXGOOOXXXXXXXXXXXXXXXXGOOOOOXXXXXXXXXXXXXXGOOXXXXXXXXXXXXXXXXXGOOOOOOXXXXXXXXXXXXXGOOOOOOOXXXXXXXXXXXX,0,300,0
26922,68,0,68,8,224,0,0,226,210,16,GOOOXXXXXXXXXXXXXXXXGOOOOOXXXXXXXXXXXXXXGOOOOOOOXXXXXXXXXXXXGOXXXXXXXXXXXXXXXXXXGOOOOOOOOOOXXXXXXXXXGOXXXXXXXXXXXXXXXXXXGOOOXXXXXXXXXXXXXXXXGOOXXXXXXXXXXXXXXXXXGOOOXXXXXXXXXXXXXXXXGOOOOOXXXXXXXXXXXXXXGOOXXXXXXXXXXXXXXXXXGOOOOOOXXXXXXXXXXXXXGOOOOOOOXXXXXXXXXXXX,0,300,0
26943,68,0,68,8,224,0,0,226,210,16,GOOOXXXXXXXXXXXXXXXXGOOOOOXXXXXXXXXXXXXXGOOOOOOOXXXXXXXXXXXXGOXXXXXXXXXXXXXXXXXXGOOOOOOOOOOXXXXXXXXXGOXXXXXXXXXXXXXXXXXXGOOOXXXXXXXXXXXXXXXXGOOXXXXXXXXXXXXXXXXXGOOOXXXXXXXXXXXXXXXXGOOOOOXXXXXXXXXXXXXXGOOXXXXXXXXXXXXXXXXXGOOOOOOXXXXXXXXXXXXXGOOOOOOOXXXXXXXXXXXX,0,300,0
26964,68,0,68,9,223,0,0,225,211,14,GOOOXXXXXXXXXXXXXXXXGOOOOOXXXXXXXXXXXXXXGOOOOOOOXXXXXXXXXXXXGOXXXXXXXXXXXXXXXXXXGOOOOOOOOOOXXXXXXXXXGOXXXXXXXXXXXXXXXXXXGOOOXXXXXXXXXXXXXXXXGOOXXXXXXXXXXXXXXXXXGOOOXXXXXXXXXXXXXXXXGOOOOOXXXXXXXXXXXXXXGOOXXXXXXXXXXXXXXXXXGOOOOOOXXXXXXXXXXXXXGOOOOOOOXXXXXXXXXXXX,0,300,0

26985,68,0,68,8,224,0,0,226,210,16,GOOOXXXXXXXXXXXXXXXXGOOOOOXXXXXXXXXXXXXXGOOOOOOOXXXXXXXXXXXXGOXXXXXXXXXXXXXXXXXXGOOOOOOOOOOXXXXXXXXXGOXXXXXXXXXXXXXXXXXXGOOOXXXXXXXXXXXXXXXXGOOXXXXXXXXXXXXXXXXXGOOOXXXXXXXXXXXXXXXXGOOOOOXXXXXXXXXXXXXXGOOXXXXXXXXXXXXXXXXXGOOOOOOXXXXXXXXXXXXXGOOOOOOOXXXXXXXXXXXX,0,300,0
27006,68,0,68,7,225,0,0,227,210,17,GOOOXXXXXXXXXXXXXXXXGOOOOOXXXXXXXXXXXXXXGOOOOOOOXXXXXXXXXXXXGOXXXXXXXXXXXXXXXXXXGOOOOOOOOOOXXXXXXXXXGOXXXXXXXXXXXXXXXXXXGOOOXXXXXXXXXXXXXXXXGOOXXXXXXXXXXXXXXXXXGOOOXXXXXXXXXXXXXXXXGOOOOOXXXXXXXXXXXXXXGOOXXXXXXXXXXXXXXXXXGOOOOOOXXXXXXXXXXXXXGOOOOOOOXXXXXXXXXXXX,0,300,0
27027,68,0,68,6,226,0,0,228,210,18,GOOOXXXXXXXXXXXXXXXXGOOOOOXXXXXXXXXXXXXXGOOOOOOOXXXXXXXXXXXXGOXXXXXXXXXXXXXXXXXXGOOOOOOOOOOXXXXXXXXXGOXXXXXXXXXXXXXXXXXXGOOOXXXXXXXXXXXXXXXXGOOXXXXXXXXXXXXXXXXXGOOOXXXXXXXXXXXXXXXXGOOOOOXXXXXXXXXXXXXXGOOXXXXXXXXXXXXXXXXXGOOOOOOXXXXXXXXXXXXXGOOOOOOOXXXXXXXXXXXX,0,300,0
27048,68,0,68,6,226,0,0,228,210,18,GOOOXXXXXXXXXXXXXXXXGOOOOOXXXXXXXXXXXXXXGOOOOOOOXXXXXXXXXXXXGOXXXXXXXXXXXXXXXXXXGOOOOOOOOOOXXXXXXXXXGOXXXXXXXXXXXXXXXXXXGOOOXXXXXXXXXXXXXXXXGOOXXXXXXXXXXXXXXXXXGOOOXXXXXXXXXXXXXXXXGOOOOOXXXXXXXXXXXXXXGOOXXXXXXXXXXXXXXXXXGOOOOOOXXXXXXXXXXXXXGOOOOOOOXXXXXXXXXXXX,0,300,0
27069,68,0,68,7,225,0,0,227,210,17,GOOOXXXXXXXXXXXXXXXXGOOOOOXXXXXXXXXXXXXXGOOOOOOOXXXXXXXXXXXXGOXXXXXXXXXXXXXXXXXXGOOOOOOOOOOXXXXXXXXXGOXXXXXXXXXXXXXXXXXXGOOOXXXXXXXXXXXXXXXXGOOXXXXXXXXXXXXXXXXXGOOOXXXXXXXXXXXXXXXXGOOOOOXXXXXXXXXXXXXXGOOXXXXXXXXXXXXXXXXXGOOOOOOXXXXXXXXXXXXXGOOOOOOOXXXXXXXXXXXX,0,300,0

27090,68,0,68,7,225,0,0,227,211,16,GOOOXXXXXXXXXXXXXXXXGOOOOOXXXXXXXXXXXXXXGOOOOOOOXXXXXXXXXXXXGOXXXXXXXXXXXXXXXXXXGOOOOOOOOOOXXXXXXXXXGOXXXXXXXXXXXXXXXXXXGOOOXXXXXXXXXXXXXXXXGOOXXXXXXXXXXXXXXXXXGOOOXXXXXXXXXXXXXXXXGOOOOOXXXXXXXXXXXXXXGOOXXXXXXXXXXXXXXXXXGOOOOOOXXXXXXXXXXXXXGOOOOOOOXXXXXXXXXXXX,0,300,0
27111,68,0,68,7,225,0,0,227,214,13,GOOOXXXXXXXXXXXXXXXXGOOOOOXXXXXXXXXXXXXXGOOOOOOOXXXXXXXXXXXXGOXXXXXXXXXXXXXXXXXXGOOOOOOOOOOXXXXXXXXXGOXXXXXXXXXXXXXXXXXXGOOOXXXXXXXXXXXXXXXXGOOXXXXXXXXXXXXXXXXXGOOOXXXXXXXXXXXXXXXXGOOOOOXXXXXXXXXXXXXXGOOXXXXXXXXXXXXXXXXXGOOOOOOXXXXXXXXXXXXXGOOOOOOOXXXXXXXXXXXX,0,300,0
27132,68,0,68,9,223,0,0,225,211,14,GOOOXXXXXXXXXXXXXXXXGOOOOOXXXXXXXXXXXXXXGOOOOOOOXXXXXXXXXXXXGOXXXXXXXXXXXXXXXXXXGOOOOOOOOOOXXXXXXXXXGOXXXXXXXXXXXXXXXXXXGOOOXXXXXXXXXXXXXXXXGOOXXXXXXXXXXXXXXXXXGOOOXXXXXXXXXXXXXXXXGOOOOOXXXXXXXXXXXXXXGOOXXXXXXXXXXXXXXXXXGOOOOOOXXXXXXXXXXXXXGOOOOOOOXXXXXXXXXXXX,0,300,0
27153,68,0,68,7,225,0,0,227,210,17,GOOOXXXXXXXXXXXXXXXXGOOOOOXXXXXXXXXXXXXXGOOOOOOOXXXXXXXXXXXXGOXXXXXXXXXXXXXXXXXXGOOOOOOOOOOXXXXXXXXXGOXXXXXXXXXXXXXXXXXXGOOOXXXXXXXXXXXXXXXXGOOXXXXXXXXXXXXXXXXXGOOOXXXXXXXXXXXXXXXXGOOOOOXXXXXXXXXXXXXXGOOXXXXXXXXXXXXXXXXXGOOOOOOXXXXXXXXXXXXXGOOOOOOOXXXXXXXXXXXX,0,300,0
27174,68,0,68,7,225,0,0,227,210,17,GOOOXXXXXXXXXXXXXXXXGOOOOOXXXXXXXXXXXXXXGOOOOOOOXXXXXXXXXXXXGOXXXXXXXXXXXXXXXXXXGOOOOOOOOOOXXXXXXXXXGOXXXXXXXXXXXXXXXXXXGOOOXXXXXXXXXXXXXXXXGOOXXXXXXXXXXXXXXXXXGOOOXXXXXXXXXXXXXXXXGOOOOOXXXXXXXXXXXXXXGOOXXXXXXXXXXXXXXXXXGOOOOOOXXXXXXXXXXXXXGOOOOOOOXXXXXXXXXXXX,0,300,0

27195,68,0,68,8,224,0,0,226,210,16,GOOOXXXXXXXXXXXXXXXXGOOOOOXXXXXXXXXXXXXXGOOOOOOOXXXXXXXXXXXXGOXXXXXXXXXXXXXXXXXXGOOOOOOOOOOXXXXXXXXXGOXXXXXXXXXXXXXXXXXXGOOOXXXXXXXXXXXXXXXXGOOXXXXXXXXXXXXXXXXXGOOOXXXXXXXXXXXXXXXXGOOOOOXXXXXXXXXXXXXXGOOXXXXXXXXXXXXXXXXXGOOOOOOXXXXXXXXXXXXXGOOOOOOOXXXXXXXXXXXX,0,300,0
27216,68,0,68,7,225,0,0,227,211,16,GOOOXXXXXXXXXXXXXXXXGOOOOOXXXXXXXXXXXXXXGOOOOOOOXXXXXXXXXXXXGOXXXXXXXXXXXXXXXXXXGOOOOOOOOOOXXXXXXXXXGOXXXXXXXXXXXXXXXXXXGOOOXXXXXXXXXXXXXXXXGOOXXXXXXXXXXXXXXXXXGOOOXXXXXXXXXXXXXXXXGOOOOOXXXXXXXXXXXXXXGOOXXXXXXXXXXXXXXXXXGOOOOOOXXXXXXXXXXXXXGOOOOOOOXXXXXXXXXXXX,0,300,0
27237,68,0,68,7,225,0,0,227,211,16,GOOOXXXXXXXXXXXXXXXXGOOOOOXXXXXXXXXXXXXXGOOOOOOOXXXXXXXXXXXXGOXXXXXXXXXXXXXXXXXXGOOOOOOOOOOXXXXXXXXXGOXXXXXXXXXXXXXXXXXXGOOOXXXXXXXXXXXXXXXXGOOXXXXXXXXXXXXXXXXXGOOOXXXXXXXXXXXXXXXXGOOOOOXXXXXXXXXXXXXXGOOXXXXXXXXXXXXXXXXXGOOOOOOXXXXXXXXXXXXXGOOOOOOOXXXXXXXXXXXX,0,300,0
27258,68,0,68,7,225,0,0,227,215,12,GOOOXXXXXXXXXXXXXXXXGOOOOOXXXXXXXXXXXXXXGOOOOOOOXXXXXXXXXXXXGOXXXXXXXXXXXXXXXXXXGOOOOOOOOOOXXXXXXXXXGOXXXXXXXXXXXXXXXXXXGOOOXXXXXXXXXXXXXXXXGOOXXXXXXXXXXXXXXXXXGOOOXXXXXXXXXXXXXXXXGOOOOOXXXXXXXXXXXXXXGOOXXXXXXXXXXXXXXXXXGOOOOOOXXXXXXXXXXXXXGOOOOOOOXXXXXXXXXXXX,0,300,0
27279,68,0,68,8,224,0,0,226,212,14,GOOOXXXXXXXXXXXXXXXXGOOOOOXXXXXXXXXXXXXXGOOOOOOOXXXXXXXXXXXXGOXXXXXXXXXXXXXXXXXXGOOOOOOOOOOXXXXXXXXXGOXXXXXXXXXXXXXXXXXXGOOOXXXXXXXXXXXXXXXXGOOXXXXXXXXXXXXXXXXXGOOOXXXXXXXXXXXXXXXXGOOOOOXXXXXXXXXXXXXXGOOXXXXXXXXXXXXXXXXXGOOOOOOXXXXXXXXXXXXXGOOOOOOOXXXXXXXXXXXX,0,300,0

27300,68,0,68,7,225,0,0,227,212,15,GOOOXXXXXXXXXXXXXXXXGOOOOOXXXXXXXXXXXXXXGOOOOOOOXXXXXXXXXXXXGOXXXXXXXXXXXXXXXXXXGOOOOOOOOOOXXXXXXXXXGOXXXXXXXXXXXXXXXXXXGOOOXXXXXXXXXXXXXXXXGOOXXXXXXXXXXXXXXXXXGOOOXXXXXXXXXXXXXXXXGOOOOOXXXXXXXXXXXXXXGOOXXXXXXXXXXXXXXXXXGOOOOOOXXXXXXXXXXXXXGOOOOOOOXXXXXXXXXXXX,0,300,0
27321,68,0,68,5,227,0,0,229,212,17,GOOOXXXXXXXXXXXXXXXXGOOOOOXXXXXXXXXXXXXXGOOOOOOOXXXXXXXXXXXXGOXXXXXXXXXXXXXXXXXXGOOOOOOOOOOXXXXXXXXXGOXXXXXXXXXXXXXXXXXXGOOOXXXXXXXXXXXXXXXXGOOXXXXXXXXXXXXXXXXXGOOOXXXXXXXXXXXXXXXXGOOOOOXXXXXXXXXXXXXXGOOXXXXXXXXXXXXXXXXXGOOOOOOXXXXXXXXXXXXXGOOOOOOOXXXXXXXXXXXX,0,300,0
27342,68,0,68,4,228,0,0,230,212,18,GOOOXXXXXXXXXXXXXXXXGOOOOOXXXXXXXXXXXXXXGOOOOOOOXXXXXXXXXXXXGOXXXXXXXXXXXXXXXXXXGOOOOOOOOOOXXXXXXXXXGOXXXXXXXXXXXXXXXXXXGOOOXXXXXXXXXXXXXXXXGOOXXXXXXXXXXXXXXXXXGOOOXXXXXXXXXXXXXXXXGOOOOOXXXXXXXXXXXXXXGOOXXXXXXXXXXXXXXXXXGOOOOOOXXXXXXXXXXXXXGOOOOOOOXXXXXXXXXXXX,0,300,0
27363,68,0,68,3,229,0,0,231,213,18,GOOOXXXXXXXXXXXXXXXXGOOOOOXXXXXXXXXXXXXXGOOOOOOOXXXXXXXXXXXXGOXXXXXXXXXXXXXXXXXXGOOOOOOOOOOXXXXXXXXXGOXXXXXXXXXXXXXXXXXXGOOOXXXXXXXXXXXXXXXXGOOXXXXXXXXXXXXXXXXXGOOOXXXXXXXXXXXXXXXXGOOOOOXXXXXXXXXXXXXXGOOXXXXXXXXXXXXXXXXXGOOOOOOXXXXXXXXXXXXXGOOOOOOOXXXXXXXXXXXX,0,300,0
27384,68,0,68,2,230,0,0,232,213,19,GOOOXXXXXXXXXXXXXXXXGOOOOOXXXXXXXXXXXXXXGOOOOOOOXXXXXXXXXXXXGOXXXXXXXXXXXXXXXXXXGOOOOOOOOOOXXXXXXXXXGOXXXXXXXXXXXXXXXXXXGOOOXXXXXXXXXXXXXXXXGOOXXXXXXXXXXXXXXXXXGOOOXXXXXXXXXXXXXXXXGOOOOOXXXXXXXXXXXXXXGOOXXXXXXXXXXXXXXXXXGOOOOOOXXXXXXXXXXXXXGOOOOOOOXXXXXXXXXXXX,0,300,0

27405,68,0,68,2,230,0,0,232,215,17,GOOOXXXXXXXXXXXXXXXXGOOOOOXXXXXXXXXXXXXXGOOOOOOOXXXXXXXXXXXXGOXXXXXXXXXXXXXXXXXXGOOOOOOOOOOXXXXXXXXXGOXXXXXXXXXXXXXXXXXXGOOOXXXXXXXXXXXXXXXXGOOXXXXXXXXXXXXXXXXXGOOOXXXXXXXXXXXXXXXXGOOOOOXXXXXXXXXXXXXXGOOXXXXXXXXXXXXXXXXXGOOOOOOXXXXXXXXXXXXXGOOOOOOOXXXXXXXXXXXX,0,300,0
27426,68,0,68,3,229,0,0,231,214,17,GOOOXXXXXXXXXXXXXXXXGOOOOOXXXXXXXXXXXXXXGOOOOOOOXXXXXXXXXXXXGOXXXXXXXXXXXXXXXXXXGOOOOOOOOOOXXXXXXXXXGOXXXXXXXXXXXXXXXXXXGOOOXXXXXXXXXXXXXXXXGOOXXXXXXXXXXXXXXXXXGOOOXXXXXXXXXXXXXXXXGOOOOOXXXXXXXXXXXXXXGOOXXXXXXXXXXXXXXXXXGOOOOOOXXXXXXXXXXXXXGOOOOOOOXXXXXXXXXXXX,0,300,0
27447,68,0,68,4,228,0,0,230,214,16,GOOOXXXXXXXXXXXXXXXXGOOOOOXXXXXXXXXXXXXXGOOOOOOOXXXXXXXXXXXXGOXXXXXXXXXXXXXXXXXXGOOOOOOOOOOXXXXXXXXXGOXXXXXXXXXXXXXXXXXXGOOOXXXXXXXXXXXXXXXXGOOXXXXXXXXXXXXXXXXXGOOOXXXXXXXXXXXXXXXXGOOOOOXXXXXXXXXXXXXXGOOXXXXXXXXXXXXXXXXXGOOOOOOXXXXXXXXXXXXXGOOOOOOOXXXXXXXXXXXX,0,300,0
27468,68,0,68,6,226,0,0,228,214,14,GOOOXXXXXXXXXXXXXXXXGOOOOOXXXXXXXXXXXXXXGOOOOOOOXXXXXXXXXXXXGOXXXXXXXXXXXXXXXXXXGOOOOOOOOOOXXXXXXXXXGOXXXXXXXXXXXXXXXXXXGOOOXXXXXXXXXXXXXXXXGOOXXXXXXXXXXXXXXXXXGOOOXXXXXXXXXXXXXXXXGOOOOOXXXXXXXXXXXXXXGOOXXXXXXXXXXXXXXXXXGOOOOOOXXXXXXXXXXXXXGOOOOOOOXXXXXXXXXXXX,0,300,0
27489,68,0,68,5,227,0,0,229,215,14,GOOOXXXXXXXXXXXXXXXXGOOOOOXXXXXXXXXXXXXXGOOOOOOOXXXXXXXXXXXXGOXXXXXXXXXXXXXXXXXXGOOOOOOOOOOXXXXXXXXXGOXXXXXXXXXXXXXXXXXXGOOOXXXXXXXXXXXXXXXXGOOXXXXXXXXXXXXXXXXXGOOOXXXXXXXXXXXXXXXXGOOOOOXXXXXXXXXXXXXXGOOXXXXXXXXXXXXXXXXXGOOOOOOXXXXXXXXXXXXXGOOOOOOOXXXXXXXXXXXX,0,300,0

27510,68,0,68,5,227,0,0,229,214,15,GOOOXXXXXXXXXXXXXXXXGOOOOOXXXXXXXXXXXXXXGOOOOOOOXXXXXXXXXXXXGOXXXXXXXXXXXXXXXXXXGOOOOOOOOOOXXXXXXXXXGOXXXXXXXXXXXXXXXXXXGOOOXXXXXXXXXXXXXXXXGOOXXXXXXXXXXXXXXXXXGOOOXXXXXXXXXXXXXXXXGOOOOOXXXXXXXXXXXXXXGOOXXXXXXXXXXXXXXXXXGOOOOOOXXXXXXXXXXXXXGOOOOOOOXXXXXXXXXXXX,0,300,0
27531,68,0,68,6,226,0,0,228,213,15,GOOOXXXXXXXXXXXXXXXXGOOOOOXXXXXXXXXXXXXXGOOOOOOOXXXXXXXXXXXXGOXXXXXXXXXXXXXXXXXXGOOOOOOOOOOXXXXXXXXXGOXXXXXXXXXXXXXXXXXXGOOOXXXXXXXXXXXXXXXXGOOXXXXXXXXXXXXXXXXXGOOOXXXXXXXXXXXXXXXXGOOOOOXXXXXXXXXXXXXXGOOXXXXXXXXXXXXXXXXXGOOOOOOXXXXXXXXXXXXXGOOOOOOOXXXXXXXXXXXX,0,300,0
27552,68,0,68,5,227,0,0,229,213,16,GOOOXXXXXXXXXXXXXXXXGOOOOOXXXXXXXXXXXXXXGOOOOOOOXXXXXXXXXXXXGOXXXXXXXXXXXXXXXXXXGOOOOOOOOOOXXXXXXXXXGOXXXXXXXXXXXXXXXXXXGOOOXXXXXXXXXXXXXXXXGOOXXXXXXXXXXXXXXXXXGOOOXXXXXXXXXXXXXXXXGOOOOOXXXXXXXXXXXXXXGOOXXXXXXXXXXXXXXXXXGOOOOOOXXXXXXXXXXXXXGOOOOOOOXXXXXXXXXXXX,0,300,0
27573,68,0,68,5,227,0,0,229,215,14,GOOOXXXXXXXXXXXXXXXXGOOOOOXXXXXXXXXXXXXXGOOOOOOOXXXXXXXXXXXXGOXXXXXXXXXXXXXXXXXXGOOOOOOOOOOXXXXXXXXXGOXXXXXXXXXXXXXXXXXXGOOOXXXXXXXXXXXXXXXXGOOXXXXXXXXXXXXXXXXXGOOOXXXXXXXXXXXXXXXXGOOOOOXXXXXXXXXXXXXXGOOXXXXXXXXXXXXXXXXXGOOOOOOXXXXXXXXXXXXXGOOOOOOOXXXXXXXXXXXX,0,300,0
27594,68,0,68,7,225,0,0,227,213,14,GOOOXXXXXXXXXXXXXXXXGOOOOOXXXXXXXXXXXXXXGOOOOOOOXXXXXXXXXXXXGOXXXXXXXXXXXXXXXXXXGOOOOOOOOOOXXXXXXXXXGOXXXXXXXXXXXXXXXXXXGOOOXXXXXXXXXXXXXXXXGOOXXXXXXXXXXXXXXXXXGOOOXXXXXXXXXXXXXXXXGOOOOOXXXXXXXXXXXXXXGOOXXXXXXXXXXXXXXXXXGOOOOOOXXXXXXXXXXXXXGOOOOOOOXXXXXXXXXXXX,0,300,0

27615,68,0,68,5,227,0,0,229,215,14,GOOOXXXXXXXXXXXXXXXXGOOOOOXXXXXXXXXXXXXXGOOOOOOOXXXXXXXXXXXXGOXXXXXXXXXXXXXXXXXXGOOOOOOOOOOXXXXXXXXXGOXXXXXXXXXXXXXXXXXXGOOOXXXXXXXXXXXXXXXXGOOXXXXXXXXXXXXXXXXXGOOOXXXXXXXXXXXXXXXXGOOOOOXXXXXXXXXXXXXXGOOXXXXXXXXXXXXXXXXXGOOOOOOXXXXXXXXXXXXXGOOOOOOOXXXXXXXXXXXX,0,300,0
27636,68,0,68,8,224,0,0,226,213,13,GOOOXXXXXXXXXXXXXXXXGOOOOOXXXXXXXXXXXXXXGOOOOOOOXXXXXXXXXXXXGOXXXXXXXXXXXXXXXXXXGOOOOOOOOOOXXXXXXXXXGOXXXXXXXXXXXXXXXXXXGOOOXXXXXXXXXXXXXXXXGOOXXXXXXXXXXXXXXXXXGOOOXXXXXXXXXXXXXXXXGOOOOOXXXXXXXXXXXXXXGOOXXXXXXXXXXXXXXXXXGOOOOOOXXXXXXXXXXXXXGOOOOOOOXXXXXXXXXXXX,0,300,0
27657,68,0,68,9,223,0,0,225,213,12,GOOOXXXXXXXXXXXXXXXXGOOOOOXXXXXXXXXXXXXXGOOOOOOOXXXXXXXXXXXXGOXXXXXXXXXXXXXXXXXXGOOOOOOOOOOXXXXXXXXXGOXXXXXXXXXXXXXXXXXXGOOOXXXXXXXXXXXXXXXXGOOXXXXXXXXXXXXXXXXXGOOOXXXXXXXXXXXXXXXXGOOOOOXXXXXXXXXXXXXXGOOXXXXXXXXXXXXXXXXXGOOOOOOXXXXXXXXXXXXXGOOOOOOOXXXXXXXXXXXX,0,300,0
27678,68,0,68,9,223,0,0,225,214,11,GOOOXXXXXXXXXXXXXXXXGOOOOOXXXXXXXXXXXXXXGOOOOOOOXXXXXXXXXXXXGOXXXXXXXXXXXXXXXXXXGOOOOOOOOOOXXXXXXXXXGOXXXXXXXXXXXXXXXXXXGOOOXXXXXXXXXXXXXXXXGOOXXXXXXXXXXXXXXXXXGOOOXXXXXXXXXXXXXXXXGOOOOOXXXXXXXXXXXXXXGOOXXXXXXXXXXXXXXXXXGOOOOOOXXXXXXXXXXXXXGOOOOOOOXXXXXXXXXXXX,0,300,0
27699,68,0,68,11,221,0,0,223,215,8,GOOOXXXXXXXXXXXXXXXXGOOOOOXXXXXXXXXXXXXXGOOOOOOOXXXXXXXXXXXXGOXXXXXXXXXXXXXXXXXXGOOOOOOOOOOXXXXXXXXXGOXXXXXXXXXXXXXXXXXXGOOOXXXXXXXXXXXXXXXXGOOXXXXXXXXXXXXXXXXXGOOOXXXXXXXXXXXXXXXXGOOOOOXXXXXXXXXXXXXXGOOXXXXXXXXXXXXXXXXXGOOOOOOXXXXXXXXXXXXXGOOOOOOOXXXXXXXXXXXX,0,300,0

27720,68,0,68,11,221,0,0,223,214,9,GOOOXXXXXXXXXXXXXXXXGOOOOOXXXXXXXXXXXXXXGOOOOOOOXXXXXXXXXXXXGOXXXXXXXXXXXXXXXXXXGOOOOOOOOOOXXXXXXXXXGOXXXXXXXXXXXXXXXXXXGOOOXXXXXXXXXXXXXXXXGOOXXXXXXXXXXXXXXXXXGOOOXXXXXXXXXXXXXXXXGOOOOOXXXXXXXXXXXXXXGOOXXXXXXXXXXXXXXXXXGOOOOOOXXXXXXXXXXXXXGOOOOOOOXXXXXXXXXXXX,0,300,0
27741,68,0,68,12,220,0,0,222,214,8,GOOOXXXXXXXXXXXXXXXXGOOOOOXXXXXXXXXXXXXXGOOOOOOOXXXXXXXXXXXXGOXXXXXXXXXXXXXXXXXXGOOOOOOOOOOXXXXXXXXXGOXXXXXXXXXXXXXXXXXXGOOOXXXXXXXXXXXXXXXXGOOXXXXXXXXXXXXXXXXXGOOOXXXXXXXXXXXXXXXXGOOOOOXXXXXXXXXXXXXXGOOXXXXXXXXXXXXXXXXXGOOOOOOXXXXXXXXXXXXXGOOOOOOOXXXXXXXXXXXX,0,300,0
27762,68,0,68,10,222,0,0,224,215,9,GOOOXXXXXXXXXXXXXXXXGOOOOOXXXXXXXXXXXXXXGOOOOOOOXXXXXXXXXXXXGOXXXXXXXXXXXXXXXXXXGOOOOOOOOOOXXXXXXXXXGOXXXXXXXXXXXXXXXXXXGOOOXXXXXXXXXXXXXXXXGOOXXXXXXXXXXXXXXXXXGOOOXXXXXXXXXXXXXXXXGOOOOOXXXXXXXXXXXXXXGOOXXXXXXXXXXXXXXXXXGOOOOOOXXXXXXXXXXXXXGOOOOOOOXXXXXXXXXXXX,0,300,0
27783,68,0,68,12,220,0,0,222,213,9,GOOOXXXXXXXXXXXXXXXXGOOOOOXXXXXXXXXXXXXXGOOOOOOOXXXXXXXXXXXXGOXXXXXXXXXXXXXXXXXXGOOOOOOOOOOXXXXXXXXXGOXXXXXXXXXXXXXXXXXXGOOOXXXXXXXXXXXXXXXXGOOXXXXXXXXXXXXXXXXXGOOOXXXXXXXXXXXXXXXXGOOOOOXXXXXXXXXXXXXXGOOXXXXXXXXXXXXXXXXXGOOOOOOXXXXXXXXXXXXXGOOOOOOOXXXXXXXXXXXX,0,300,0
27804,68,0,68,10,222,0,0,224,213,11,GOOOXXXXXXXXXXXXXXXXGOOOOOXXXXXXXXXXXXXXGOOOOOOOXXXXXXXXXXXXGOXXXXXXXXXXXXXXXXXXGOOOOOOOOOOXXXXXXXXXGOXXXXXXXXXXXXXXXXXXGOOOXXXXXXXXXXXXXXXXGOOXXXXXXXXXXXXXXXXXGOOOXXXXXXXXXXXXXXXXGOOOOOXXXXXXXXXXXXXXGOOXXXXXXXXXXXXXXXXXGOOOOOOXXXXXXXXXXXXXGOOOOOOOXXXXXXXXXXXX,0,300,0

27825,68,0,68,9,223,0,0,225,213,12,GOOOXXXXXXXXXXXXXXXXGOOOOOXXXXXXXXXXXXXXGOOOOOOOXXXXXXXXXXXXGOXXXXXXXXXXXXXXXXXXGOOOOOOOOOOXXXXXXXXXGOXXXXXXXXXXXXXXXXXXGOOOXXXXXXXXXXXXXXXXGOOXXXXXXXXXXXXXXXXXGOOOXXXXXXXXXXXXXXXXGOOOOOXXXXXXXXXXXXXXGOOXXXXXXXXXXXXXXXXXGOOOOOOXXXXXXXXXXXXXGOOOOOOOXXXXXXXXXXXX,0,300,0
27846,68,0,68,8,224,0,0,226,213,13,GOOOXXXXXXXXXXXXXXXXGOOOOOXXXXXXXXXXXXXXGOOOOOOOXXXXXXXXXXXXGOXXXXXXXXXXXXXXXXXXGOOOOOOOOOOXXXXXXXXXGOXXXXXXXXXXXXXXXXXXGOOOXXXXXXXXXXXXXXXXGOOXXXXXXXXXXXXXXXXXGOOOXXXXXXXXXXXXXXXXGOOOOOXXXXXXXXXXXXXXGOOXXXXXXXXXXXXXXXXXGOOOOOOXXXXXXXXXXXXXGOOOOOOOXXXXXXXXXXXX,0,300,0
27867,68,0,68,6,226,0,0,228,213,15,GOOOXXXXXXXXXXXXXXXXGOOOOOXXXXXXXXXXXXXXGOOOOOOOXXXXXXXXXXXXGOXXXXXXXXXXXXXXXXXXGOOOOOOOOOOXXXXXXXXXGOXXXXXXXXXXXXXXXXXXGOOOXXXXXXXXXXXXXXXXGOOXXXXXXXXXXXXXXXXXGOOOXXXXXXXXXXXXXXXXGOOOOOXXXXXXXXXXXXXXGOOXXXXXXXXXXXXXXXXXGOOOOOOXXXXXXXXXXXXXGOOOOOOOXXXXXXXXXXXX,0,300,0
27888,68,0,68,5,227,0,0,229,214,15,GOOOXXXXXXXXXXXXXXXXGOOOOOXXXXXXXXXXXXXXGOOOOOOOXXXXXXXXXXXXGOXXXXXXXXXXXXXXXXXXGOOOOOOOOOOXXXXXXXXXGOXXXXXXXXXXXXXXXXXXGOOOXXXXXXXXXXXXXXXXGOOXXXXXXXXXXXXXXXXXGOOOXXXXXXXXXXXXXXXXGOOOOOXXXXXXXXXXXXXXGOOXXXXXXXXXXXXXXXXXGOOOOOOXXXXXXXXXXXXXGOOOOOOOXXXXXXXXXXXX,0,300,0
27909,68,0,68,4,228,0,0,230,213,17,GOOOXXXXXXXXXXXXXXXXGOOOOOXXXXXXXXXXXXXXGOOOOOOOXXXXXXXXXXXXGOXXXXXXXXXXXXXXXXXXGOOOOOOOOOOXXXXXXXXXGOXXXXXXXXXXXXXXXXXXGOOOXXXXXXXXXXXXXXXXGOOXXXXXXXXXXXXXXXXXGOOOXXXXXXXXXXXXXXXXGOOOOOXXXXXXXXXXXXXXGOOXXXXXXXXXXXXXXXXXGOOOOOOXXXXXXXXXXXXXGOOOOOOOXXXXXXXXXXXX,0,300,0

27930,68,0,68,4,228,0,0,230,213,17,GOOOXXXXXXXXXXXXXXXXGOOOOOXXXXXXXXXXXXXXGOOOOOOOXXXXXXXXXXXXGOXXXXXXXXXXXXXXXXXXGOOOOOOOOOOXXXXXXXXXGOXXXXXXXXXXXXXXXXXXGOOOXXXXXXXXXXXXXXXXGOOXXXXXXXXXXXXXXXXXGOOOXXXXXXXXXXXXXXXXGOOOOOXXXXXXXXXXXXXXGOOXXXXXXXXXXXXXXXXXGOOOOOOXXXXXXXXXXXXXGOOOOOOOXXXXXXXXXXXX,0,300,0
27951,68,0,68,5,227,0,0,229,214,15,GOOOXXXXXXXXXXXXXXXXGOOOOOXXXXXXXXXXXXXXGOOOOOOOXXXXXXXXXXXXGOXXXXXXXXXXXXXXXXXXGOOOOOOOOOOXXXXXXXXXGOXXXXXXXXXXXXXXXXXXGOOOXXXXXXXXXXXXXXXXGOOXXXXXXXXXXXXXXXXXGOOOXXXXXXXXXXXXXXXXGOOOOOXXXXXXXXXXXXXXGOOXXXXXXXXXXXXXXXXXGOOOOOOXXXXXXXXXXXXXGOOOOOOOXXXXXXXXXXXX,0,300,0
27972,68,0,68,3,229,0,0,231,214,17,GOOOXXXXXXXXXXXXXXXXGOOOOOXXXXXXXXXXXXXXGOOOOOOOXXXXXXXXXXXXGOXXXXXXXXXXXXXXXXXXGOOOOOOOOOOXXXXXXXXXGOXXXXXXXXXXXXXXXXXXGOOOXXXXXXXXXXXXXXXXGOOXXXXXXXXXXXXXXXXXGOOOXXXXXXXXXXXXXXXXGOOOOOXXXXXXXXXXXXXXGOOXXXXXXXXXXXXXXXXXGOOOOOOXXXXXXXXXXXXXGOOOOOOOXXXXXXXXXXXX,0,300,0
27993,68,0,68,4,228,0,0,230,213,17,GOOOXXXXXXXXXXXXXXXXGOOOOOXXXXXXXXXXXXXXGOOOOOOOXXXXXXXXXXXXGOXXXXXXXXXXXXXXXXXXGOOOOOOOOOOXXXXXXXXXGOXXXXXXXXXXXXXXXXXXGOOOXXXXXXXXXXXXXXXXGOOXXXXXXXXXXXXXXXXXGOOOXXXXXXXXXXXXXXXXGOOOOOXXXXXXXXXXXXXXGOOXXXXXXXXXXXXXXXXXGOOOOOOXXXXXXXXXXXXXGOOOOOOOXXXXXXXXXXXX,0,300,0
28014,68,0,68,4,228,0,0,230,213,17,GOOOXXXXXXXXXXXXXXXXGOOOOOXXXXXXXXXXXXXXGOOOOOOOXXXXXXXXXXXXGOXXXXXXXXXXXXXXXXXXGOOOOOOOOOOXXXXXXXXXGOXXXXXXXXXXXXXXXXXXGOOOXXXXXXXXXXXXXXXXGOOXXXXXXXXXXXXXXXXXGOOOXXXXXXXXXXXXXXXXGOOOOOXXXXXXXXXXXXXXGOOXXXXXXXXXXXXXXXXXGOOOOOOXXXXXXXXXXXXXGOOOOOOOXXXXXXXXXXXX,0,300,0

28035,68,0,68,6,226,0,0,228,213,15,GOOOXXXXXXXXXXXXXXXXGOOOOOXXXXXXXXXXXXXXGOOOOOOOXXXXXXXXXXXXGOXXXXXXXXXXXXXXXXXXGOOOOOOOOOOXXXXXXXXXGOXXXXXXXXXXXXXXXXXXGOOOXXXXXXXXXXXXXXXXGOOXXXXXXXXXXXXXXXXXGOOOXXXXXXXXXXXXXXXXGOOOOOXXXXXXXXXXXXXXGOOXXXXXXXXXXXXXXXXXGOOOOOOXXXXXXXXXXXXXGOOOOOOOXXXXXXXXXXXX,0,300,0
28056,68,0,68,5,227,0,0,229,214,15,GOOOXXXXXXXXXXXXXXXXGOOOOOXXXXXXXXXXXXXXGOOOOOOOXXXXXXXXXXXXGOXXXXXXXXXXXXXXXXXXGOOOOOOOOOOXXXXXXXXXGOXXXXXXXXXXXXXXXXXXGOOOXXXXXXXXXXXXXXXXGOOXXXXXXXXXXXXXXXXXGOOOXXXXXXXXXXXXXXXXGOOOOOXXXXXXXXXXXXXXGOOXXXXXXXXXXXXXXXXXGOOOOOOXXXXXXXXXXXXXGOOOOOOOXXXXXXXXXXXX,0,300,0
28077,68,0,68,5,227,0,0,229,214,15,GOOOXXXXXXXXXXXXXXXXGOOOOOXXXXXXXXXXXXXXGOOOOOOOXXXXXXXXXXXXGOXXXXXXXXXXXXXXXXXXGOOOOOOOOOOXXXXXXXXXGOXXXXXXXXXXXXXXXXXXGOOOXXXXXXXXXXXXXXXXGOOXXXXXXXXXXXXXXXXXGOOOXXXXXXXXXXXXXXXXGOOOOOXXXXXXXXXXXXXXGOOXXXXXXXXXXXXXXXXXGOOOOOOXXXXXXXXXXXXXGOOOOOOOXXXXXXXXXXXX,0,300,0
28098,68,0,68,6,226,0,0,228,214,14,GOOOXXXXXXXXXXXXXXXXGOOOOOXXXXXXXXXXXXXXGOOOOOOOXXXXXXXXXXXXGOXXXXXXXXXXXXXXXXXXGOOOOOOOOOOXXXXXXXXXGOXXXXXXXXXXXXXXXXXXGOOOXXXXXXXXXXXXXXXXGOOXXXXXXXXXXXXXXXXXGOOOXXXXXXXXXXXXXXXXGOOOOOXXXXXXXXXXXXXXGOOXXXXXXXXXXXXXXXXXGOOOOOOXXXXXXXXXXXXXGOOOOOOOXXXXXXXXXXXX,0,300,0
28119,68,0,68,6,226,0,0,228,215,13,GOOOXXXXXXXXXXXXXXXXGOOOOOXXXXXXXXXXXXXXGOOOOOOOXXXXXXXXXXXXGOXXXXXXXXXXXXXXXXXXGOOOOOOOOOOXXXXXXXXXGOXXXXXXXXXXXXXXXXXXGOOOXXXXXXXXXXXXXXXXGOOXXXXXXXXXXXXXXXXXGOOOXXXXXXXXXXXXXXXXGOOOOOXXXXXXXXXXXXXXGOOXXXXXXXXXXXXXXXXXGOOOOOOXXXXXXXXXXXXXGOOOOOOOXXXXXXXXXXXX,0,300,0

28140,68,0,68,8,224,0,0,226,214,12,GOOOXXXXXXXXXXXXXXXXGOOOOOXXXXXXXXXXXXXXGOOOOOOOXXXXXXXXXXXXGOXXXXXXXXXXXXXXXXXXGOOOOOOOOOOXXXXXXXXXGOXXXXXXXXXXXXXXXXXXGOOOXXXXXXXXXXXXXXXXGOOXXXXXXXXXXXXXXXXXGOOOXXXXXXXXXXXXXXXXGOOOOOXXXXXXXXXXXXXXGOOXXXXXXXXXXXXXXXXXGOOOOOOXXXXXXXXXXXXXGOOOOOOOXXXXXXXXXXXX,0,300,0
28161,68,0,68,9,223,0,0,225,214,11,GOOOXXXXXXXXXXXXXXXXGOOOOOXXXXXXXXXXXXXXGOOOOOOOXXXXXXXXXXXXGOXXXXXXXXXXXXXXXXXXGOOOOOOOOOOXXXXXXXXXGOXXXXXXXXXXXXXXXXXXGOOOXXXXXXXXXXXXXXXXGOOXXXXXXXXXXXXXXXXXGOOOXXXXXXXXXXXXXXXXGOOOOOXXXXXXXXXXXXXXGOOXXXXXXXXXXXXXXXXXGOOOOOOXXXXXXXXXXXXXGOOOOOOOXXXXXXXXXXXX,0,300,0
28182,68,0,68,11,221,0,0,223,213,10,GOOOXXXXXXXXXXXXXXXXGOOOOOXXXXXXXXXXXXXXGOOOOOOOXXXXXXXXXXXXGOXXXXXXXXXXXXXXXXXXGOOOOOOOOOOXXXXXXXXXGOXXXXXXXXXXXXXXXXXXGOOOXXXXXXXXXXXXXXXXGOOXXXXXXXXXXXXXXXXXGOOOXXXXXXXXXXXXXXXXGOOOOOXXXXXXXXXXXXXXGOOXXXXXXXXXXXXXXXXXGOOOOOOXXXXXXXXXXXXXGOOOOOOOXXXXXXXXXXXX,0,300,0
28203,68,0,68,11,221,0,0,223,213,10,GOOOXXXXXXXXXXXXXXXXGOOOOOXXXXXXXXXXXXXXGOOOOOOOXXXXXXXXXXXXGOXXXXXXXXXXXXXXXXXXGOOOOOOOOOOXXXXXXXXXGOXXXXXXXXXXXXXXXXXXGOOOXXXXXXXXXXXXXXXXGOOXXXXXXXXXXXXXXXXXGOOOXXXXXXXXXXXXXXXXGOOOOOXXXXXXXXXXXXXXGOOXXXXXXXXXXXXXXXXXGOOOOOOXXXXXXXXXXXXXGOOOOOOOXXXXXXXXXXXX,0,300,0
28224,68,0,68,11,221,0,0,223,215,8,GOOOXXXXXXXXXXXXXXXXGOOOOOXXXXXXXXXXXXXXGOOOOOOOXXXXXXXXXXXXGOXXXXXXXXXXXXXXXXXXGOOOOOOOOOOXXXXXXXXXGOXXXXXXXXXXXXXXXXXXGOOOXXXXXXXXXXXXXXXXGOOXXXXXXXXXXXXXXXXXGOOOXXXXXXXXXXXXXXXXGOOOOOXXXXXXXXXXXXXXGOOXXXXXXXXXXXXXXXXXGOOOOOOXXXXXXXXXXXXXGOOOOOOOXXXXXXXXXXXX,0,300,0

28245,68,0,68,14,218,0,0,220,214,6,GOOOXXXXXXXXXXXXXXXXGOOOOOXXXXXXXXXXXXXXGOOOOOOOXXXXXXXXXXXXGOXXXXXXXXXXXXXXXXXXGOOOOOOOOOOXXXXXXXXXGOXXXXXXXXXXXXXXXXXXGOOOXXXXXXXXXXXXXXXXGOOXXXXXXXXXXXXXXXXXGOOOXXXXXXXXXXXXXXXXGOOOOOXXXXXXXXXXXXXXGOOXXXXXXXXXXXXXXXXXGOOOOOOXXXXXXXXXXXXXGOOOOOOOXXXXXXXXXXXX,0,300,0
28266,68,0,68,14,218,0,0,220,213,7,GOOOXXXXXXXXXXXXXXXXGOOOOOXXXXXXXXXXXXXXGOOOOOOOXXXXXXXXXXXXGOXXXXXXXXXXXXXXXXXXGOOOOOOOOOOXXXXXXXXXGOXXXXXXXXXXXXXXXXXXGOOOXXXXXXXXXXXXXXXXGOOXXXXXXXXXXXXXXXXXGOOOXXXXXXXXXXXXXXXXGOOOOOXXXXXXXXXXXXXXGOOXXXXXXXXXXXXXXXXXGOOOOOOXXXXXXXXXXXXXGOOOOOOOXXXXXXXXXXXX,0,300,0
28287,68,0,68,13,219,0,0,221,213,8,GOOOXXXXXXXXXXXXXXXXGOOOOOXXXXXXXXXXXXXXGOOOOOOOXXXXXXXXXXXXGOXXXXXXXXXXXXXXXXXXGOOOOOOOOOOXXXXXXXXXGOXXXXXXXXXXXXXXXXXXGOOOXXXXXXXXXXXXXXXXGOOXXXXXXXXXXXXXXXXXGOOOXXXXXXXXXXXXXXXXGOOOOOXXXXXXXXXXXXXXGOOXXXXXXXXXXXXXXXXXGOOOOOOXXXXXXXXXXXXXGOOOOOOOXXXXXXXXXXXX,0,300,0
28308,68,0,68,11,221,0,0,223,213,10,GOOOXXXXXXXXXXXXXXXXGOOOOOXXXXXXXXXXXXXXGOOOOOOOXXXXXXXXXXXXGOXXXXXXXXXXXXXXXXXXGOOOOOOOOOOXXXXXXXXXGOXXXXXXXXXXXXXXXXXXGOOOXXXXXXXXXXXXXXXXGOOXXXXXXXXXXXXXXXXXGOOOXXXXXXXXXXXXXXXXGOOOOOXXXXXXXXXXXXXXGOOXXXXXXXXXXXXXXXXXGOOOOOOXXXXXXXXXXXXXGOOOOOOOXXXXXXXXXXXX,0,300,0
28329,68,0,68,10,222,0,0,224,213,11,GOOOXXXXXXXXXXXXXXXXGOOOOOXXXXXXXXXXXXXXGOOOOOOOXXXXXXXXXXXXGOXXXXXXXXXXXXXXXXXXGOOOOOOOOOOXXXXXXXXXGOXXXXXXXXXXXXXXXXXXGOOOXXXXXXXXXXXXXXXXGOOXXXXXXXXXXXXXXXXXGOOOXXXXXXXXXXXXXXXXGOOOOOXXXXXXXXXXXXXXGOOXXXXXXXXXXXXXXXXXGOOOOOOXXXXXXXXXXXXXGOOOOOOOXXXXXXXXXXXX,0,300,0

28350,68,0,68,10,222,0,0,224,214,10,GOOOXXXXXXXXXXXXXXXXGOOOOOXXXXXXXXXXXXXXGOOOOOOOXXXXXXXXXXXXGOXXXXXXXXXXXXXXXXXXGOOOOOOOOOOXXXXXXXXXGOXXXXXXXXXXXXXXXXXXGOOOXXXXXXXXXXXXXXXXGOOXXXXXXXXXXXXXXXXXGOOOXXXXXXXXXXXXXXXXGOOOOOXXXXXXXXXXXXXXGOOXXXXXXXXXXXXXXXXXGOOOOOOXXXXXXXXXXXXXGOOOOOOOXXXXXXXXXXXX,0,300,0
28371,68,0,68,7,225,0,0,227,214,13,GOOOXXXXXXXXXXXXXXXXGOOOOOXXXXXXXXXXXXXXGOOOOOOOXXXXXXXXXXXXGOXXXXXXXXXXXXXXXXXXGOOOOOOOOOOXXXXXXXXXGOXXXXXXXXXXXXXXXXXXGOOOXXXXXXXXXXXXXXXXGOOXXXXXXXXXXXXXXXXXGOOOXXXXXXXXXXXXXXXXGOOOOOXXXXXXXXXXXXXXGOOXXXXXXXXXXXXXXXXXGOOOOOOXXXXXXXXXXXXXGOOOOOOOXXXXXXXXXXXX,0,300,0
28392,68,0,68,5,227,0,0,229,215,14,GOOOXXXXXXXXXXXXXXXXGOOOOOXXXXXXXXXXXXXXGOOOOOOOXXXXXXXXXXXXGOXXXXXXXXXXXXXXXXXXGOOOOOOOOOOXXXXXXXXXGOXXXXXXXXXXXXXXXXXXGOOOXXXXXXXXXXXXXXXXGOOXXXXXXXXXXXXXXXXXGOOOXXXXXXXXXXXXXXXXGOOOOOXXXXXXXXXXXXXXGOOXXXXXXXXXXXXXXXXXGOOOOOOXXXXXXXXXXXXXGOOOOOOOXXXXXXXXXXXX,0,300,0
28413,68,0,68,6,226,0,0,228,214,14,GOOOXXXXXXXXXXXXXXXXGOOOOOXXXXXXXXXXXXXXGOOOOOOOXXXXXXXXXXXXGOXXXXXXXXXXXXXXXXXXGOOOOOOOOOOXXXXXXXXXGOXXXXXXXXXXXXXXXXXXGOOOXXXXXXXXXXXXXXXXGOOXXXXXXXXXXXXXXXXXGOOOXXXXXXXXXXXXXXXXGOOOOOXXXXXXXXXXXXXXGOOXXXXXXXXXXXXXXXXXGOOOOOOXXXXXXXXXXXXXGOOOOOOOXXXXXXXXXXXX,0,300,0
28434,68,0,68,5,227,0,0,229,214,15,GOOOXXXXXXXXXXXXXXXXGOOOOOXXXXXXXXXXXXXXGOOOOOOOXXXXXXXXXXXXGOXXXXXXXXXXXXXXXXXXGOOOOOOOOOOXXXXXXXXXGOXXXXXXXXXXXXXXXXXXGOOOXXXXXXXXXXXXXXXXGOOXXXXXXXXXXXXXXXXXGOOOXXXXXXXXXXXXXXXXGOOOOOXXXXXXXXXXXXXXGOOXXXXXXXXXXXXXXXXXGOOOOOOXXXXXXXXXXXXXGOOOOOOOXXXXXXXXXXXX,0,300,0

28455,68,0,68,5,227,0,0,229,214,15,GOOOXXXXXXXXXXXXXXXXGOOOOOXXXXXXXXXXXXXXGOOOOOOOXXXXXXXXXXXXGOXXXXXXXXXXXXXXXXXXGOOOOOOOOOOXXXXXXXXXGOXXXXXXXXXXXXXXXXXXGOOOXXXXXXXXXXXXXXXXGOOXXXXXXXXXXXXXXXXXGOOOXXXXXXXXXXXXXXXXGOOOOOXXXXXXXXXXXXXXGOOXXXXXXXXXXXXXXXXXGOOOOOOXXXXXXXXXXXXXGOOOOOOOXXXXXXXXXXXX,0,300,0
28476,68,0,68,4,228,0,0,229,214,15,GOOOXXXXXXXXXXXXXXXXGOOOOOXXXXXXXXXXXXXXGOOOOOOOXXXXXXXXXXXXGOXXXXXXXXXXXXXXXXXXGOOOOOOOOOOXXXXXXXXXGOXXXXXXXXXXXXXXXXXXGOOOXXXXXXXXXXXXXXXXGOOXXXXXXXXXXXXXXXXXGOOOXXXXXXXXXXXXXXXXGOOOOOXXXXXXXXXXXXXXGOOXXXXXXXXXXXXXXXXXGOOOOOOXXXXXXXXXXXXXGOOOOOOOXXXXXXXXXXXX,0,300,0
28497,68,0,68,4,228,0,0,230,215,15,GOOOXXXXXXXXXXXXXXXXGOOOOOXXXXXXXXXXXXXXGOOOOOOOXXXXXXXXXXXXGOXXXXXXXXXXXXXXXXXXGOOOOOOOOOOXXXXXXXXXGOXXXXXXXXXXXXXXXXXXGOOOXXXXXXXXXXXXXXXXGOOXXXXXXXXXXXXXXXXXGOOOXXXXXXXXXXXXXXXXGOOOOOXXXXXXXXXXXXXXGOOXXXXXXXXXXXXXXXXXGOOOOOOXXXXXXXXXXXXXGOOOOOOOXXXXXXXXXXXX,0,300,0
28518,68,0,68,3,229,0,0,231,216,15,GOOOXXXXXXXXXXXXXXXXGOOOOOXXXXXXXXXXXXXXGOOOOOOOXXXXXXXXXXXXGOXXXXXXXXXXXXXXXXXXGOOOOOOOOOOXXXXXXXXXGOXXXXXXXXXXXXXXXXXXGOOOXXXXXXXXXXXXXXXXGOOXXXXXXXXXXXXXXXXXGOOOXXXXXXXXXXXXXXXXGOOOOOXXXXXXXXXXXXXXGOOXXXXXXXXXXXXXXXXXGOOOOOOXXXXXXXXXXXXXGOOOOOOOXXXXXXXXXXXX,0,300,0
28539,68,0,68,5,227,0,0,229,215,14,GOOOXXXXXXXXXXXXXXXXGOOOOOXXXXXXXXXXXXXXGOOOOOOOXXXXXXXXXXXXGOXXXXXXXXXXXXXXXXXXGOOOOOOOOOOXXXXXXXXXGOXXXXXXXXXXXXXXXXXXGOOOXXXXXXXXXXXXXXXXGOOXXXXXXXXXXXXXXXXXGOOOXXXXXXXXXXXXXXXXGOOOOOXXXXXXXXXXXXXXGOOXXXXXXXXXXXXXXXXXGOOOOOOXXXXXXXXXXXXXGOOOOOOOXXXXXXXXXXXX,0,300,0

28560,68,0,68,5,227,0,0,229,215,14,GOOOXXXXXXXXXXXXXXXXGOOOOOXXXXXXXXXXXXXXGOOOOOOOXXXXXXXXXXXXGOXXXXXXXXXXXXXXXXXXGOOOOOOOOOOXXXXXXXXXGOXXXXXXXXXXXXXXXXXXGOOOXXXXXXXXXXXXXXXXGOOXXXXXXXXXXXXXXXXXGOOOXXXXXXXXXXXXXXXXGOOOOOXXXXXXXXXXXXXXGOOXXXXXXXXXXXXXXXXXGOOOOOOXXXXXXXXXXXXXGOOOOOOOXXXXXXXXXXXX,0,300,0
28581,68,0,68,4,228,0,0,230,215,15,GOOOXXXXXXXXXXXXXXXXGOOOOOXXXXXXXXXXXXXXGOOOOOOOXXXXXXXXXXXXGOXXXXXXXXXXXXXXXXXXGOOOOOOOOOOXXXXXXXXXGOXXXXXXXXXXXXXXXXXXGOOOXXXXXXXXXXXXXXXXGOOXXXXXXXXXXXXXXXXXGOOOXXXXXXXXXXXXXXXXGOOOOOXXXXXXXXXXXXXXGOOXXXXXXXXXXXXXXXXXGOOOOOOXXXXXXXXXXXXXGOOOOOOOXXXXXXXXXXXX,0,300,0
28602,68,0,68,1,231,0,0,233,215,18,GOOOXXXXXXXXXXXXXXXXGOOOOOXXXXXXXXXXXXXXGOOOOOOOXXXXXXXXXXXXGOXXXXXXXXXXXXXXXXXXGOOOOOOOOOOXXXXXXXXXGOXXXXXXXXXXXXXXXXXXGOOOXXXXXXXXXXXXXXXXGOOXXXXXXXXXXXXXXXXXGOOOXXXXXXXXXXXXXXXXGOOOOOXXXXXXXXXXXXXXGOOXXXXXXXXXXXXXXXXXGOOOOOOXXXXXXXXXXXXXGOOOOOOOXXXXXXXXXXXX,0,300,0
28623,68,0,68,1,231,0,0,233,216,17,GOOOXXXXXXXXXXXXXXXXGOOOOOXXXXXXXXXXXXXXGOOOOOOOXXXXXXXXXXXXGOXXXXXXXXXXXXXXXXXXGOOOOOOOOOOXXXXXXXXXGOXXXXXXXXXXXXXXXXXXGOOOXXXXXXXXXXXXXXXXGOOXXXXXXXXXXXXXXXXXGOOOXXXXXXXXXXXXXXXXGOOOOOXXXXXXXXXXXXXXGOOXXXXXXXXXXXXXXXXXGOOOOOOXXXXXXXXXXXXXGOOOOOOOXXXXXXXXXXXX,0,300,0
28644,68,0,68,1,231,0,0,233,216,17,GOOOXXXXXXXXXXXXXXXXGOOOOOXXXXXXXXXXXXXXGOOOOOOOXXXXXXXXXXXXGOXXXXXXXXXXXXXXXXXXGOOOOOOOOOOXXXXXXXXXGOXXXXXXXXXXXXXXXXXXGOOOXXXXXXXXXXXXXXXXGOOXXXXXXXXXXXXXXXXXGOOOXXXXXXXXXXXXXXXXGOOOOOXXXXXXXXXXXXXXGOOXXXXXXXXXXXXXXXXXGOOOOOOXXXXXXXXXXXXXGOOOOOOOXXXXXXXXXXXX,0,300,0

28665,68,0,68,2,230,0,0,232,215,17,GOOOXXXXXXXXXXXXXXXXGOOOOOXXXXXXXXXXXXXXGOOOOOOOXXXXXXXXXXXXGOXXXXXXXXXXXXXXXXXXGOOOOOOOOOOXXXXXXXXXGOXXXXXXXXXXXXXXXXXXGOOOXXXXXXXXXXXXXXXXGOOXXXXXXXXXXXXXXXXXGOOOXXXXXXXXXXXXXXXXGOOOOOXXXXXXXXXXXXXXGOOXXXXXXXXXXXXXXXXXGOOOOOOXXXXXXXXXXXXXGOOOOOOOXXXXXXXXXXXX,0,300,0
28686,68,0,68,4,228,0,0,230,217,13,GOOOXXXXXXXXXXXXXXXXGOOOOOXXXXXXXXXXXXXXGOOOOOOOXXXXXXXXXXXXGOXXXXXXXXXXXXXXXXXXGOOOOOOOOOOXXXXXXXXXGOXXXXXXXXXXXXXXXXXXGOOOXXXXXXXXXXXXXXXXGOOXXXXXXXXXXXXXXXXXGOOOXXXXXXXXXXXXXXXXGOOOOOXXXXXXXXXXXXXXGOOXXXXXXXXXXXXXXXXXGOOOOOOXXXXXXXXXXXXXGOOOOOOOXXXXXXXXXXXX,0,300,0
28707,68,0,68,5,227,0,0,229,217,12,GOOOXXXXXXXXXXXXXXXXGOOOOOXXXXXXXXXXXXXXGOOOOOOOXXXXXXXXXXXXGOXXXXXXXXXXXXXXXXXXGOOOOOOOOOOXXXXXXXXXGOXXXXXXXXXXXXXXXXXXGOOOXXXXXXXXXXXXXXXXGOOXXXXXXXXXXXXXXXXXGOOOXXXXXXXXXXXXXXXXGOOOOOXXXXXXXXXXXXXXGOOXXXXXXXXXXXXXXXXXGOOOOOOXXXXXXXXXXXXXGOOOOOOOXXXXXXXXXXXX,0,300,0
28728,68,0,68,8,224,0,0,226,216,10,GOOOXXXXXXXXXXXXXXXXGOOOOOXXXXXXXXXXXXXXGOOOOOOOXXXXXXXXXXXXGOXXXXXXXXXXXXXXXXXXGOOOOOOOOOOXXXXXXXXXGOXXXXXXXXXXXXXXXXXXGOOOXXXXXXXXXXXXXXXXGOOXXXXXXXXXXXXXXXXXGOOOXXXXXXXXXXXXXXXXGOOOOOXXXXXXXXXXXXXXGOOXXXXXXXXXXXXXXXXXGOOOOOOXXXXXXXXXXXXXGOOOOOOOXXXXXXXXXXXX,0,300,0
28749,68,0,68,10,222,0,0,224,215,9,GOOOXXXXXXXXXXXXXXXXGOOOOOXXXXXXXXXXXXXXGOOOOOOOXXXXXXXXXXXXGOXXXXXXXXXXXXXXXXXXGOOOOOOOOOOXXXXXXXXXGOXXXXXXXXXXXXXXXXXXGOOOXXXXXXXXXXXXXXXXGOOXXXXXXXXXXXXXXXXXGOOOXXXXXXXXXXXXXXXXGOOOOOXXXXXXXXXXXXXXGOOXXXXXXXXXXXXXXXXXGOOOOOOXXXXXXXXXXXXXGOOOOOOOXXXXXXXXXXXX,0,300,0

28770,68,0,68,11,221,0,0,223,214,9,GOOOXXXXXXXXXXXXXXXXGOOOOOXXXXXXXXXXXXXXGOOOOOOOXXXXXXXXXXXXGOXXXXXXXXXXXXXXXXXXGOOOOOOOOOOXXXXXXXXXGOXXXXXXXXXXXXXXXXXXGOOOXXXXXXXXXXXXXXXXGOOXXXXXXXXXXXXXXXXXGOOOXXXXXXXXXXXXXXXXGOOOOOXXXXXXXXXXXXXXGOOXXXXXXXXXXXXXXXXXGOOOOOOXXXXXXXXXXXXXGOOOOOOOXXXXXXXXXXXX,0,300,0
28791,68,0,68,11,221,0,0,223,214,9,GOOOXXXXXXXXXXXXXXXXGOOOOOXXXXXXXXXXXXXXGOOOOOOOXXXXXXXXXXXXGOXXXXXXXXXXXXXXXXXXGOOOOOOOOOOXXXXXXXXXGOXXXXXXXXXXXXXXXXXXGOOOXXXXXXXXXXXXXXXXGOOXXXXXXXXXXXXXXXXXGOOOXXXXXXXXXXXXXXXXGOOOOOXXXXXXXXXXXXXXGOOXXXXXXXXXXXXXXXXXGOOOOOOXXXXXXXXXXXXXGOOOOOOOXXXXXXXXXXXX,0,300,0
28812,68,0,68,11,221,0,0,223,214,9,GOOOXXXXXXXXXXXXXXXXGOOOOOXXXXXXXXXXXXXXGOOOOOOOXXXXXXXXXXXXGOXXXXXXXXXXXXXXXXXXGOOOOOOOOOOXXXXXXXXXGOXXXXXXXXXXXXXXXXXXGOOOXXXXXXXXXXXXXXXXGOOXXXXXXXXXXXXXXXXXGOOOXXXXXXXXXXXXXXXXGOOOOOXXXXXXXXXXXXXXGOOXXXXXXXXXXXXXXXXXGOOOOOOXXXXXXXXXXXXXGOOOOOOOXXXXXXXXXXXX,0,300,0
28833,68,0,68,9,223,0,0,225,215,10,GOOOXXXXXXXXXXXXXXXXGOOOOOXXXXXXXXXXXXXXGOOOOOOOXXXXXXXXXXXXGOXXXXXXXXXXXXXXXXXXGOOOOOOOOOOXXXXXXXXXGOXXXXXXXXXXXXXXXXXXGOOOXXXXXXXXXXXXXXXXGOOXXXXXXXXXXXXXXXXXGOOOXXXXXXXXXXXXXXXXGOOOOOXXXXXXXXXXXXXXGOOXXXXXXXXXXXXXXXXXGOOOOOOXXXXXXXXXXXXXGOOOOOOOXXXXXXXXXXXX,0,300,0
28854,68,0,68,7,225,0,0,226,214,12,GOOOXXXXXXXXXXXXXXXXGOOOOOXXXXXXXXXXXXXXGOOOOOOOXXXXXXXXXXXXGOXXXXXXXXXXXXXXXXXXGOOOOOOOOOOXXXXXXXXXGOXXXXXXXXXXXXXXXXXXGOOOXXXXXXXXXXXXXXXXGOOXXXXXXXXXXXXXXXXXGOOOXXXXXXXXXXXXXXXXGOOOOOXXXXXXXXXXXXXXGOOXXXXXXXXXXXXXXXXXGOOOOOOXXXXXXXXXXXXXGOOOOOOOXXXXXXXXXXXX,0,300,0

28875,68,0,68,7,225,0,0,227,214,13,GOOOXXXXXXXXXXXXXXXXGOOOOOXXXXXXXXXXXXXXGOOOOOOOXXXXXXXXXXXXGOXXXXXXXXXXXXXXXXXXGOOOOOOOOOOXXXXXXXXXGOXXXXXXXXXXXXXXXXXXGOOOXXXXXXXXXXXXXXXXGOOXXXXXXXXXXXXXXXXXGOOOXXXXXXXXXXXXXXXXGOOOOOXXXXXXXXXXXXXXGOOXXXXXXXXXXXXXXXXXGOOOOOOXXXXXXXXXXXXXGOOOOOOOXXXXXXXXXXXX,0,300,0
28896,68,0,68,8,224,0,0,226,214,12,GOOOXXXXXXXXXXXXXXXXGOOOOOXXXXXXXXXXXXXXGOOOOOOOXXXXXXXXXXXXGOXXXXXXXXXXXXXXXXXXGOOOOOOOOOOXXXXXXXXXGOXXXXXXXXXXXXXXXXXXGOOOXXXXXXXXXXXXXXXXGOOXXXXXXXXXXXXXXXXXGOOOXXXXXXXXXXXXXXXXGOOOOOXXXXXXXXXXXXXXGOOXXXXXXXXXXXXXXXXXGOOOOOOXXXXXXXXXXXXXGOOOOOOOXXXXXXXXXXXX,0,300,0
28917,68,0,68,8,224,0,0,226,214,12,GOOOXXXXXXXXXXXXXXXXGOOOOOXXXXXXXXXXXXXXGOOOOOOOXXXXXXXXXXXXGOXXXXXXXXXXXXXXXXXXGOOOOOOOOOOXXXXXXXXXGOXXXXXXXXXXXXXXXXXXGOOOXXXXXXXXXXXXXXXXGOOXXXXXXXXXXXXXXXXXGOOOXXXXXXXXXXXXXXXXGOOOOOXXXXXXXXXXXXXXGOOXXXXXXXXXXXXXXXXXGOOOOOOXXXXXXXXXXXXXGOOOOOOOXXXXXXXXXXXX,0,300,0
28938,68,0,68,6,226,0,0,228,214,14,GOOOXXXXXXXXXXXXXXXXGOOOOOXXXXXXXXXXXXXXGOOOOOOOXXXXXXXXXXXXGOXXXXXXXXXXXXXXXXXXGOOOOOOOOOOXXXXXXXXXGOXXXXXXXXXXXXXXXXXXGOOOXXXXXXXXXXXXXXXXGOOXXXXXXXXXXXXXXXXXGOOOXXXXXXXXXXXXXXXXGOOOOOXXXXXXXXXXXXXXGOOXXXXXXXXXXXXXXXXXGOOOOOOXXXXXXXXXXXXXGOOOOOOOXXXXXXXXXXXX,0,300,0
28959,68,0,68,5,227,0,0,229,215,14,GOOOXXXXXXXXXXXXXXXXGOOOOOXXXXXXXXXXXXXXGOOOOOOOXXXXXXXXXXXXGOXXXXXXXXXXXXXXXXXXGOOOOOOOOOOXXXXXXXXXGOXXXXXXXXXXXXXXXXXXGOOOXXXXXXXXXXXXXXXXGOOXXXXXXXXXXXXXXXXXGOOOXXXXXXXXXXXXXXXXGOOOOOXXXXXXXXXXXXXXGOOXXXXXXXXXXXXXXXXXGOOOOOOXXXXXXXXXXXXXGOOOOOOOXXXXXXXXXXXX,0,300,0

28980,68,0,68,5,227,0,0,229,215,14,GOOOXXXXXXXXXXXXXXXXGOOOOOXXXXXXXXXXXXXXGOOOOOOOXXXXXXXXXXXXGOXXXXXXXXXXXXXXXXXXGOOOOOOOOOOXXXXXXXXXGOXXXXXXXXXXXXXXXXXXGOOOXXXXXXXXXXXXXXXXGOOXXXXXXXXXXXXXXXXXGOOOXXXXXXXXXXXXXXXXGOOOOOXXXXXXXXXXXXXXGOOXXXXXXXXXXXXXXXXXGOOOOOOXXXXXXXXXXXXXGOOOOOOOXXXXXXXXXXXX,0,300,0
29001,68,0,68,5,227,0,0,229,215,14,GOOOXXXXXXXXXXXXXXXXGOOOOOXXXXXXXXXXXXXXGOOOOOOOXXXXXXXXXXXXGOXXXXXXXXXXXXXXXXXXGOOOOOOOOOOXXXXXXXXXGOXXXXXXXXXXXXXXXXXXGOOOXXXXXXXXXXXXXXXXGOOXXXXXXXXXXXXXXXXXGOOOXXXXXXXXXXXXXXXXGOOOOOXXXXXXXXXXXXXXGOOXXXXXXXXXXXXXXXXXGOOOOOOXXXXXXXXXXXXXGOOOOOOOXXXXXXXXXXXX,0,300,0
29022,68,0,68,5,227,0,0,229,214,15,GOOOXXXXXXXXXXXXXXXXGOOOOOXXXXXXXXXXXXXXGOOOOOOOXXXXXXXXXXXXGOXXXXXXXXXXXXXXXXXXGOOOOOOOOOOXXXXXXXXXGOXXXXXXXXXXXXXXXXXXGOOOXXXXXXXXXXXXXXXXGOOXXXXXXXXXXXXXXXXXGOOOXXXXXXXXXXXXXXXXGOOOOOXXXXXXXXXXXXXXGOOXXXXXXXXXXXXXXXXXGOOOOOOXXXXXXXXXXXXXGOOOOOOOXXXXXXXXXXXX,0,300,0
29043,68,0,68,6,226,0,0,228,214,14,GOOOXXXXXXXXXXXXXXXXGOOOOOXXXXXXXXXXXXXXGOOOOOOOXXXXXXXXXXXXGOXXXXXXXXXXXXXXXXXXGOOOOOOOOOOXXXXXXXXXGOXXXXXXXXXXXXXXXXXXGOOOXXXXXXXXXXXXXXXXGOOXXXXXXXXXXXXXXXXXGOOOXXXXXXXXXXXXXXXXGOOOOOXXXXXXXXXXXXXXGOOXXXXXXXXXXXXXXXXXGOOOOOOXXXXXXXXXXXXXGOOOOOOOXXXXXXXXXXXX,0,300,0
29064,68,0,68,5,227,0,0,229,214,15,GOOOXXXXXXXXXXXXXXXXGOOOOOXXXXXXXXXXXXXXGOOOOOOOXXXXXXXXXXXXGOXXXXXXXXXXXXXXXXXXGOOOOOOOOOOXXXXXXXXXGOXXXXXXXXXXXXXXXXXXGOOOXXXXXXXXXXXXXXXXGOOXXXXXXXXXXXXXXXXXGOOOXXXXXXXXXXXXXXXXGOOOOOXXXXXXXXXXXXXXGOOXXXXXXXXXXXXXXXXXGOOOOOOXXXXXXXXXXXXXGOOOOOOOXXXXXXXXXXXX,0,300,0

29085,68,0,68,5,227,0,0,229,214,15,GOOOXXXXXXXXXXXXXXXXGOOOOOXXXXXXXXXXXXXXGOOOOOOOXXXXXXXXXXXXGOXXXXXXXXXXXXXXXXXXGOOOOOOOOOOXXXXXXXXXGOXXXXXXXXXXXXXXXXXXGOOOXXXXXXXXXXXXXXXXGOOXXXXXXXXXXXXXXXXXGOOOXXXXXXXXXXXXXXXXGOOOOOXXXXXXXXXXXXXXGOOXXXXXXXXXXXXXXXXXGOOOOOOXXXXXXXXXXXXXGOOOOOOOXXXXXXXXXXXX,0,300,0
29106,68,0,68,5,227,0,0,229,214,15,GOOOXXXXXXXXXXXXXXXXGOOOOOXXXXXXXXXXXXXXGOOOOOOOXXXXXXXXXXXXGOXXXXXXXXXXXXXXXXXXGOOOOOOOOOOXXXXXXXXXGOXXXXXXXXXXXXXXXXXXGOOOXXXXXXXXXXXXXXXXGOOXXXXXXXXXXXXXXXXXGOOOXXXXXXXXXXXXXXXXGOOOOOXXXXXXXXXXXXXXGOOXXXXXXXXXXXXXXXXXGOOOOOOXXXXXXXXXXXXXGOOOOOOOXXXXXXXXXXXX,0,300,0
29127,68,0,68,6,226,0,0,228,214,14,GOOOXXXXXXXXXXXXXXXXGOOOOOXXXXXXXXXXXXXXGOOOOOOOXXXXXXXXXXXXGOXXXXXXXXXXXXXXXXXXGOOOOOOOOOOXXXXXXXXXGOXXXXXXXXXXXXXXXXXXGOOOXXXXXXXXXXXXXXXXGOOXXXXXXXXXXXXXXXXXGOOOXXXXXXXXXXXXXXXXGOOOOOXXXXXXXXXXXXXXGOOXXXXXXXXXXXXXXXXXGOOOOOOXXXXXXXXXXXXXGOOOOOOOXXXXXXXXXXXX,0,300,0
29148,68,0,68,5,227,0,0,229,214,15,GOOOXXXXXXXXXXXXXXXXGOOOOOXXXXXXXXXXXXXXGOOOOOOOXXXXXXXXXXXXGOXXXXXXXXXXXXXXXXXXGOOOOOOOOOOXXXXXXXXXGOXXXXXXXXXXXXXXXXXXGOOOXXXXXXXXXXXXXXXXGOOXXXXXXXXXXXXXXXXXGOOOXXXXXXXXXXXXXXXXGOOOOOXXXXXXXXXXXXXXGOOXXXXXXXXXXXXXXXXXGOOOOOOXXXXXXXXXXXXXGOOOOOOOXXXXXXXXXXXX,0,300,0
29169,68,0,68,5,227,0,0,229,214,15,GOOOXXXXXXXXXXXXXXXXGOOOOOXXXXXXXXXXXXXXGOOOOOOOXXXXXXXXXXXXGOXXXXXXXXXXXXXXXXXXGOOOOOOOOOOXXXXXXXXXGOXXXXXXXXXXXXXXXXXXGOOOXXXXXXXXXXXXXXXXGOOXXXXXXXXXXXXXXXXXGOOOXXXXXXXXXXXXXXXXGOOOOOXXXXXXXXXXXXXXGOOXXXXXXXXXXXXXXXXXGOOOOOOXXXXXXXXXXXXXGOOOOOOOXXXXXXXXXXXX,0,300,0

29190,68,0,68,4,228,0,0,230,214,16,GOOOXXXXXXXXXXXXXXXXGOOOOOXXXXXXXXXXXXXXGOOOOOOOXXXXXXXXXXXXGOXXXXXXXXXXXXXXXXXXGOOOOOOOOOOXXXXXXXXXGOXXXXXXXXXXXXXXXXXXGOOOXXXXXXXXXXXXXXXXGOOXXXXXXXXXXXXXXXXXGOOOXXXXXXXXXXXXXXXXGOOOOOXXXXXXXXXXXXXXGOOXXXXXXXXXXXXXXXXXGOOOOOOXXXXXXXXXXXXXGOOOOOOOXXXXXXXXXXXX,0,300,0
29211,68,0,68,6,226,0,0,228,215,13,GOOOXXXXXXXXXXXXXXXXGOOOOOXXXXXXXXXXXXXXGOOOOOOOXXXXXXXXXXXXGOXXXXXXXXXXXXXXXXXXGOOOOOOOOOOXXXXXXXXXGOXXXXXXXXXXXXXXXXXXGOOOXXXXXXXXXXXXXXXXGOOXXXXXXXXXXXXXXXXXGOOOXXXXXXXXXXXXXXXXGOOOOOXXXXXXXXXXXXXXGOOXXXXXXXXXXXXXXXXXGOOOOOOXXXXXXXXXXXXXGOOOOOOOXXXXXXXXXXXX,0,300,0
29232,68,0,68,7,225,0,0,227,218,9,GOOOXXXXXXXXXXXXXXXXGOOOOOXXXXXXXXXXXXXXGOOOOOOOXXXXXXXXXXXXGOXXXXXXXXXXXXXXXXXXGOOOOOOOOOOXXXXXXXXXGOXXXXXXXXXXXXXXXXXXGOOOXXXXXXXXXXXXXXXXGOOXXXXXXXXXXXXXXXXXGOOOXXXXXXXXXXXXXXXXGOOOOOXXXXXXXXXXXXXXGOOXXXXXXXXXXXXXXXXXGOOOOOOXXXXXXXXXXXXXGOOOOOOOXXXXXXXXXXXX,0,300,0
29253,68,0,68,8,224,0,0,226,217,9,GOOOXXXXXXXXXXXXXXXXGOOOOOXXXXXXXXXXXXXXGOOOOOOOXXXXXXXXXXXXGOXXXXXXXXXXXXXXXXXXGOOOOOOOOOOXXXXXXXXXGOXXXXXXXXXXXXXXXXXXGOOOXXXXXXXXXXXXXXXXGOOXXXXXXXXXXXXXXXXXGOOOXXXXXXXXXXXXXXXXGOOOOOXXXXXXXXXXXXXXGOOXXXXXXXXXXXXXXXXXGOOOOOOXXXXXXXXXXXXXGOOOOOOOXXXXXXXXXXXX,0,300,0
29274,68,0,68,10,222,0,0,224,215,9,GOOOXXXXXXXXXXXXXXXXGOOOOOXXXXXXXXXXXXXXGOOOOOOOXXXXXXXXXXXXGOXXXXXXXXXXXXXXXXXXGOOOOOOOOOOXXXXXXXXXGOXXXXXXXXXXXXXXXXXXGOOOXXXXXXXXXXXXXXXXGOOXXXXXXXXXXXXXXXXXGOOOXXXXXXXXXXXXXXXXGOOOOOXXXXXXXXXXXXXXGOOXXXXXXXXXXXXXXXXXGOOOOOOXXXXXXXXXXXXXGOOOOOOOXXXXXXXXXXXX,0,300,0

29295,68,0,68,7,225,0,0,227,215,12,GOOOXXXXXXXXXXXXXXXXGOOOOOXXXXXXXXXXXXXXGOOOOOOOXXXXXXXXXXXXGOXXXXXXXXXXXXXXXXXXGOOOOOOOOOOXXXXXXXXXGOXXXXXXXXXXXXXXXXXXGOOOXXXXXXXXXXXXXXXXGOOXXXXXXXXXXXXXXXXXGOOOXXXXXXXXXXXXXXXXGOOOOOXXXXXXXXXXXXXXGOOXXXXXXXXXXXXXXXXXGOOOOOOXXXXXXXXXXXXXGOOOOOOOXXXXXXXXXXXX,0,300,0
29316,68,0,68,8,224,0,0,226,215,11,GOOOXXXXXXXXXXXXXXXXGOOOOOXXXXXXXXXXXXXXGOOOOOOOXXXXXXXXXXXXGOXXXXXXXXXXXXXXXXXXGOOOOOOOOOOXXXXXXXXXGOXXXXXXXXXXXXXXXXXXGOOOXXXXXXXXXXXXXXXXGOOXXXXXXXXXXXXXXXXXGOOOXXXXXXXXXXXXXXXXGOOOOOXXXXXXXXXXXXXXGOOXXXXXXXXXXXXXXXXXGOOOOOOXXXXXXXXXXXXXGOOOOOOOXXXXXXXXXXXX,0,300,0
29337,68,0,68,8,224,0,0,226,216,10,GOOOXXXXXXXXXXXXXXXXGOOOOOXXXXXXXXXXXXXXGOOOOOOOXXXXXXXXXXXXGOXXXXXXXXXXXXXXXXXXGOOOOOOOOOOXXXXXXXXXGOXXXXXXXXXXXXXXXXXXGOOOXXXXXXXXXXXXXXXXGOOXXXXXXXXXXXXXXXXXGOOOXXXXXXXXXXXXXXXXGOOOOOXXXXXXXXXXXXXXGOOXXXXXXXXXXXXXXXXXGOOOOOOXXXXXXXXXXXXXGOOOOOOOXXXXXXXXXXXX,0,300,0
29358,68,0,68,7,225,0,0,227,215,12,GOOOXXXXXXXXXXXXXXXXGOOOOOXXXXXXXXXXXXXXGOOOOOOOXXXXXXXXXXXXGOXXXXXXXXXXXXXXXXXXGOOOOOOOOOOXXXXXXXXXGOXXXXXXXXXXXXXXXXXXGOOOXXXXXXXXXXXXXXXXGOOXXXXXXXXXXXXXXXXXGOOOXXXXXXXXXXXXXXXXGOOOOOXXXXXXXXXXXXXXGOOXXXXXXXXXXXXXXXXXGOOOOOOXXXXXXXXXXXXXGOOOOOOOXXXXXXXXXXXX,0,300,0
29379,68,0,68,5,227,0,0,228,215,13,GOOOXXXXXXXXXXXXXXXXGOOOOOXXXXXXXXXXXXXXGOOOOOOOXXXXXXXXXXXXGOXXXXXXXXXXXXXXXXXXGOOOOOOOOOOXXXXXXXXXGOXXXXXXXXXXXXXXXXXXGOOOXXXXXXXXXXXXXXXXGOOXXXXXXXXXXXXXXXXXGOOOXXXXXXXXXXXXXXXXGOOOOOXXXXXXXXXXXXXXGOOXXXXXXXXXXXXXXXXXGOOOOOOXXXXXXXXXXXXXGOOOOOOOXXXXXXXXXXXX,0,300,0

29400,68,0,68,4,228,0,0,230,216,14,GOOOXXXXXXXXXXXXXXXXGOOOOOXXXXXXXXXXXXXXGOOOOOOOXXXXXXXXXXXXGOXXXXXXXXXXXXXXXXXXGOOOOOOOOOOXXXXXXXXXGOXXXXXXXXXXXXXXXXXXGOOOXXXXXXXXXXXXXXXXGOOXXXXXXXXXXXXXXXXXGOOOXXXXXXXXXXXXXXXXGOOOOOXXXXXXXXXXXXXXGOOXXXXXXXXXXXXXXXXXGOOOOOOXXXXXXXXXXXXXGOOOOOOOXXXXXXXXXXXX,0,300,0
29421,68,0,68,4,228,0,0,230,215,15,GOOOXXXXXXXXXXXXXXXXGOOOOOXXXXXXXXXXXXXXGOOOOOOOXXXXXXXXXXXXGOXXXXXXXXXXXXXXXXXXGOOOOOOOOOOXXXXXXXXXGOXXXXXXXXXXXXXXXXXXGOOOXXXXXXXXXXXXXXXXGOOXXXXXXXXXXXXXXXXXGOOOXXXXXXXXXXXXXXXXGOOOOOXXXXXXXXXXXXXXGOOXXXXXXXXXXXXXXXXXGOOOOOOXXXXXXXXXXXXXGOOOOOOOXXXXXXXXXXXX,0,300,0
29442,68,0,68,4,228,0,0,230,215,15,GOOOXXXXXXXXXXXXXXXXGOOOOOXXXXXXXXXXXXXXGOOOOOOOXXXXXXXXXXXXGOXXXXXXXXXXXXXXXXXXGOOOOOOOOOOXXXXXXXXXGOXXXXXXXXXXXXXXXXXXGOOOXXXXXXXXXXXXXXXXGOOXXXXXXXXXXXXXXXXXGOOOXXXXXXXXXXXXXXXXGOOOOOXXXXXXXXXXXXXXGOOXXXXXXXXXXXXXXXXXGOOOOOOXXXXXXXXXXXXXGOOOOOOOXXXXXXXXXXXX,0,300,0
29463,68,0,68,4,228,0,0,230,216,14,GOOOXXXXXXXXXXXXXXXXGOOOOOXXXXXXXXXXXXXXGOOOOOOOXXXXXXXXXXXXGOXXXXXXXXXXXXXXXXXXGOOOOOOOOOOXXXXXXXXXGOXXXXXXXXXXXXXXXXXXGOOOXXXXXXXXXXXXXXXXGOOXXXXXXXXXXXXXXXXXGOOOXXXXXXXXXXXXXXXXGOOOOOXXXXXXXXXXXXXXGOOXXXXXXXXXXXXXXXXXGOOOOOOXXXXXXXXXXXXXGOOOOOOOXXXXXXXXXXXX,0,300,0
29484,68,0,68,4,228,0,0,230,216,14,GOOOXXXXXXXXXXXXXXXXGOOOOOXXXXXXXXXXXXXXGOOOOOOOXXXXXXXXXXXXGOXXXXXXXXXXXXXXXXXXGOOOOOOOOOOXXXXXXXXXGOXXXXXXXXXXXXXXXXXXGOOOXXXXXXXXXXXXXXXXGOOXXXXXXXXXXXXXXXXXGOOOXXXXXXXXXXXXXXXXGOOOOOXXXXXXXXXXXXXXGOOXXXXXXXXXXXXXXXXXGOOOOOOXXXXXXXXXXXXXGOOOOOOOXXXXXXXXXXXX,0,300,0

29505,68,0,68,5,227,0,0,229,215,14,GOOOXXXXXXXXXXXXXXXXGOOOOOXXXXXXXXXXXXXXGOOOOOOOXXXXXXXXXXXXGOXXXXXXXXXXXXXXXXXXGOOOOOOOOOOXXXXXXXXXGOXXXXXXXXXXXXXXXXXXGOOOXXXXXXXXXXXXXXXXGOOXXXXXXXXXXXXXXXXXGOOOXXXXXXXXXXXXXXXXGOOOOOXXXXXXXXXXXXXXGOOXXXXXXXXXXXXXXXXXGOOOOOOXXXXXXXXXXXXXGOOOOOOOXXXXXXXXXXXX,0,300,0
29526,68,0,68,4,228,0,0,230,215,15,GOOOXXXXXXXXXXXXXXXXGOOOOOXXXXXXXXXXXXXXGOOOOOOOXXXXXXXXXXXXGOXXXXXXXXXXXXXXXXXXGOOOOOOOOOOXXXXXXXXXGOXXXXXXXXXXXXXXXXXXGOOOXXXXXXXXXXXXXXXXGOOXXXXXXXXXXXXXXXXXGOOOXXXXXXXXXXXXXXXXGOOOOOXXXXXXXXXXXXXXGOOXXXXXXXXXXXXXXXXXGOOOOOOXXXXXXXXXXXXXGOOOOOOOXXXXXXXXXXXX,0,300,0
29547,68,0,68,5,227,0,0,229,215,14,GOOOXXXXXXXXXXXXXXXXGOOOOOXXXXXXXXXXXXXXGOOOOOOOXXXXXXXXXXXXGOXXXXXXXXXXXXXXXXXXGOOOOOOOOOOXXXXXXXXXGOXXXXXXXXXXXXXXXXXXGOOOXXXXXXXXXXXXXXXXGOOXXXXXXXXXXXXXXXXXGOOOXXXXXXXXXXXXXXXXGOOOOOXXXXXXXXXXXXXXGOOXXXXXXXXXXXXXXXXXGOOOOOOXXXXXXXXXXXXXGOOOOOOOXXXXXXXXXXXX,0,300,0
29568,68,0,68,5,227,0,0,228,215,13,GOOOXXXXXXXXXXXXXXXXGOOOOOXXXXXXXXXXXXXXGOOOOOOOXXXXXXXXXXXXGOXXXXXXXXXXXXXXXXXXGOOOOOOOOOOXXXXXXXXXGOXXXXXXXXXXXXXXXXXXGOOOXXXXXXXXXXXXXXXXGOOXXXXXXXXXXXXXXXXXGOOOXXXXXXXXXXXXXXXXGOOOOOXXXXXXXXXXXXXXGOOXXXXXXXXXXXXXXXXXGOOOOOOXXXXXXXXXXXXXGOOOOOOOXXXXXXXXXXXX,0,300,0
29589,68,0,68,6,226,0,0,228,215,13,GOOOXXXXXXXXXXXXXXXXGOOOOOXXXXXXXXXXXXXXGOOOOOOOXXXXXXXXXXXXGOXXXXXXXXXXXXXXXXXXGOOOOOOOOOOXXXXXXXXXGOXXXXXXXXXXXXXXXXXXGOOOXXXXXXXXXXXXXXXXGOOXXXXXXXXXXXXXXXXXGOOOXXXXXXXXXXXXXXXXGOOOOOXXXXXXXXXXXXXXGOOXXXXXXXXXXXXXXXXXGOOOOOOXXXXXXXXXXXXXGOOOOOOOXXXXXXXXXXXX,0,300,0

29610,68,0,68,4,228,0,0,230,215,15,GOOOXXXXXXXXXXXXXXXXGOOOOOXXXXXXXXXXXXXXGOOOOOOOXXXXXXXXXXXXGOXXXXXXXXXXXXXXXXXXGOOOOOOOOOOXXXXXXXXXGOXXXXXXXXXXXXXXXXXXGOOOXXXXXXXXXXXXXXXXGOOXXXXXXXXXXXXXXXXXGOOOXXXXXXXXXXXXXXXXGOOOOOXXXXXXXXXXXXXXGOOXXXXXXXXXXXXXXXXXGOOOOOOXXXXXXXXXXXXXGOOOOOOOXXXXXXXXXXXX,0,300,0
29631,68,0,68,4,228,0,0,230,215,15,GOOOXXXXXXXXXXXXXXXXGOOOOOXXXXXXXXXXXXXXGOOOOOOOXXXXXXXXXXXXGOXXXXXXXXXXXXXXXXXXGOOOOOOOOOOXXXXXXXXXGOXXXXXXXXXXXXXXXXXXGOOOXXXXXXXXXXXXXXXXGOOXXXXXXXXXXXXXXXXXGOOOXXXXXXXXXXXXXXXXGOOOOOXXXXXXXXXXXXXXGOOXXXXXXXXXXXXXXXXXGOOOOOOXXXXXXXXXXXXXGOOOOOOOXXXXXXXXXXXX,0,300,0
29652,68,0,68,3,229,0,0,231,216,15,GOOOXXXXXXXXXXXXXXXXGOOOOOXXXXXXXXXXXXXXGOOOOOOOXXXXXXXXXXXXGOXXXXXXXXXXXXXXXXXXGOOOOOOOOOOXXXXXXXXXGOXXXXXXXXXXXXXXXXXXGOOOXXXXXXXXXXXXXXXXGOOXXXXXXXXXXXXXXXXXGOOOXXXXXXXXXXXXXXXXGOOOOOXXXXXXXXXXXXXXGOOXXXXXXXXXXXXXXXXXGOOOOOOXXXXXXXXXXXXXGOOOOOOOXXXXXXXXXXXX,0,300,0
29673,68,0,68,5,227,0,0,229,216,13,GOOOXXXXXXXXXXXXXXXXGOOOOOXXXXXXXXXXXXXXGOOOOOOOXXXXXXXXXXXXGOXXXXXXXXXXXXXXXXXXGOOOOOOOOOOXXXXXXXXXGOXXXXXXXXXXXXXXXXXXGOOOXXXXXXXXXXXXXXXXGOOXXXXXXXXXXXXXXXXXGOOOXXXXXXXXXXXXXXXXGOOOOOXXXXXXXXXXXXXXGOOXXXXXXXXXXXXXXXXXGOOOOOOXXXXXXXXXXXXXGOOOOOOOXXXXXXXXXXXX,0,300,0
29694,68,0,68,5,227,0,0,229,216,13,GOOOXXXXXXXXXXXXXXXXGOOOOOXXXXXXXXXXXXXXGOOOOOOOXXXXXXXXXXXXGOXXXXXXXXXXXXXXXXXXGOOOOOOOOOOXXXXXXXXXGOXXXXXXXXXXXXXXXXXXGOOOXXXXXXXXXXXXXXXXGOOXXXXXXXXXXXXXXXXXGOOOXXXXXXXXXXXXXXXXGOOOOOXXXXXXXXXXXXXXGOOXXXXXXXXXXXXXXXXXGOOOOOOXXXXXXXXXXXXXGOOOOOOOXXXXXXXXXXXX,0,300,0

29715,68,0,68,5,227,0,0,229,216,13,GOOOXXXXXXXXXXXXXXXXGOOOOOXXXXXXXXXXXXXXGOOOOOOOXXXXXXXXXXXXGOXXXXXXXXXXXXXXXXXXGOOOOOOOOOOXXXXXXXXXGOXXXXXXXXXXXXXXXXXXGOOOXXXXXXXXXXXXXXXXGOOXXXXXXXXXXXXXXXXXGOOOXXXXXXXXXXXXXXXXGOOOOOXXXXXXXXXXXXXXGOOXXXXXXXXXXXXXXXXXGOOOOOOXXXXXXXXXXXXXGOOOOOOOXXXXXXXXXXXX,0,300,0
29736,68,0,68,7,225,0,0,227,216,11,GOOOXXXXXXXXXXXXXXXXGOOOOOXXXXXXXXXXXXXXGOOOOOOOXXXXXXXXXXXXGOXXXXXXXXXXXXXXXXXXGOOOOOOOOOOXXXXXXXXXGOXXXXXXXXXXXXXXXXXXGOOOXXXXXXXXXXXXXXXXGOOXXXXXXXXXXXXXXXXXGOOOXXXXXXXXXXXXXXXXGOOOOOXXXXXXXXXXXXXXGOOXXXXXXXXXXXXXXXXXGOOOOOOXXXXXXXXXXXXXGOOOOOOOXXXXXXXXXXXX,0,300,0
29757,68,0,68,8,224,0,0,226,216,10,GOOOXXXXXXXXXXXXXXXXGOOOOOXXXXXXXXXXXXXXGOOOOOOOXXXXXXXXXXXXGOXXXXXXXXXXXXXXXXXXGOOOOOOOOOOXXXXXXXXXGOXXXXXXXXXXXXXXXXXXGOOOXXXXXXXXXXXXXXXXGOOXXXXXXXXXXXXXXXXXGOOOXXXXXXXXXXXXXXXXGOOOOOXXXXXXXXXXXXXXGOOXXXXXXXXXXXXXXXXXGOOOOOOXXXXXXXXXXXXXGOOOOOOOXXXXXXXXXXXX,0,300,0
29778,68,0,68,8,224,0,0,226,216,10,GOOOXXXXXXXXXXXXXXXXGOOOOOXXXXXXXXXXXXXXGOOOOOOOXXXXXXXXXXXXGOXXXXXXXXXXXXXXXXXXGOOOOOOOOOOXXXXXXXXXGOXXXXXXXXXXXXXXXXXXGOOOXXXXXXXXXXXXXXXXGOOXXXXXXXXXXXXXXXXXGOOOXXXXXXXXXXXXXXXXGOOOOOXXXXXXXXXXXXXXGOOXXXXXXXXXXXXXXXXXGOOOOOOXXXXXXXXXXXXXGOOOOOOOXXXXXXXXXXXX,0,300,0
29799,68,0,68,9,223,0,0,225,216,9,GOOOXXXXXXXXXXXXXXXXGOOOOOXXXXXXXXXXXXXXGOOOOOOOXXXXXXXXXXXXGOXXXXXXXXXXXXXXXXXXGOOOOOOOOOOXXXXXXXXXGOXXXXXXXXXXXXXXXXXXGOOOXXXXXXXXXXXXXXXXGOOXXXXXXXXXXXXXXXXXGOOOXXXXXXXXXXXXXXXXGOOOOOXXXXXXXXXXXXXXGOOXXXXXXXXXXXXXXXXXGOOOOOOXXXXXXXXXXXXXGOOOOOOOXXXXXXXXXXXX,0,300,0

29820,68,0,68,10,222,0,0,224,217,7,GOOOXXXXXXXXXXXXXXXXGOOOOOXXXXXXXXXXXXXXGOOOOOOOXXXXXXXXXXXXGOXXXXXXXXXXXXXXXXXXGOOOOOOOOOOXXXXXXXXXGOXXXXXXXXXXXXXXXXXXGOOOXXXXXXXXXXXXXXXXGOOXXXXXXXXXXXXXXXXXGOOOXXXXXXXXXXXXXXXXGOOOOOXXXXXXXXXXXXXXGOOXXXXXXXXXXXXXXXXXGOOOOOOXXXXXXXXXXXXXGOOOOOOOXXXXXXXXXXXX,0,300,0
29841,68,0,68,10,222,0,0,224,216,8,GOOOXXXXXXXXXXXXXXXXGOOOOOXXXXXXXXXXXXXXGOOOOOOOXXXXXXXXXXXXGOXXXXXXXXXXXXXXXXXXGOOOOOOOOOOXXXXXXXXXGOXXXXXXXXXXXXXXXXXXGOOOXXXXXXXXXXXXXXXXGOOXXXXXXXXXXXXXXXXXGOOOXXXXXXXXXXXXXXXXGOOOOOXXXXXXXXXXXXXXGOOXXXXXXXXXXXXXXXXXGOOOOOOXXXXXXXXXXXXXGOOOOOOOXXXXXXXXXXXX,0,300,0
29862,68,0,68,9,223,0,0,225,216,9,GOOOXXXXXXXXXXXXXXXXGOOOOOXXXXXXXXXXXXXXGOOOOOOOXXXXXXXXXXXXGOXXXXXXXXXXXXXXXXXXGOOOOOOOOOOXXXXXXXXXGOXXXXXXXXXXXXXXXXXXGOOOXXXXXXXXXXXXXXXXGOOXXXXXXXXXXXXXXXXXGOOOXXXXXXXXXXXXXXXXGOOOOOXXXXXXXXXXXXXXGOOXXXXXXXXXXXXXXXXXGOOOOOOXXXXXXXXXXXXXGOOOOOOOXXXXXXXXXXXX,0,300,0
29883,68,0,68,7,225,0,0,227,217,10,GOOOXXXXXXXXXXXXXXXXGOOOOOXXXXXXXXXXXXXXGOOOOOOOXXXXXXXXXXXXGOXXXXXXXXXXXXXXXXXXGOOOOOOOOOOXXXXXXXXXGOXXXXXXXXXXXXXXXXXXGOOOXXXXXXXXXXXXXXXXGOOXXXXXXXXXXXXXXXXXGOOOXXXXXXXXXXXXXXXXGOOOOOXXXXXXXXXXXXXXGOOXXXXXXXXXXXXXXXXXGOOOOOOXXXXXXXXXXXXXGOOOOOOOXXXXXXXXXXXX,0,300,0
29904,68,0,68,8,224,0,0,226,215,11,GOOOXXXXXXXXXXXXXXXXGOOOOOXXXXXXXXXXXXXXGOOOOOOOXXXXXXXXXXXXGOXXXXXXXXXXXXXXXXXXGOOOOOOOOOOXXXXXXXXXGOXXXXXXXXXXXXXXXXXXGOOOXXXXXXXXXXXXXXXXGOOXXXXXXXXXXXXXXXXXGOOOXXXXXXXXXXXXXXXXGOOOOOXXXXXXXXXXXXXXGOOXXXXXXXXXXXXXXXXXGOOOOOOXXXXXXXXXXXXXGOOOOOOOXXXXXXXXXXXX,0,300,0

29925,68,0,68,6,226,0,0,228,215,13,GOOOXXXXXXXXXXXXXXXXGOOOOOXXXXXXXXXXXXXXGOOOOOOOXXXXXXXXXXXXGOXXXXXXXXXXXXXXXXXXGOOOOOOOOOOXXXXXXXXXGOXXXXXXXXXXXXXXXXXXGOOOXXXXXXXXXXXXXXXXGOOXXXXXXXXXXXXXXXXXGOOOXXXXXXXXXXXXXXXXGOOOOOXXXXXXXXXXXXXXGOOXXXXXXXXXXXXXXXXXGOOOOOOXXXXXXXXXXXXXGOOOOOOOXXXXXXXXXXXX,0,300,0
29946,68,0,68,6,226,0,0,228,215,13,GOOOXXXXXXXXXXXXXXXXGOOOOOXXXXXXXXXXXXXXGOOOOOOOXXXXXXXXXXXXGOXXXXXXXXXXXXXXXXXXGOOOOOOOOOOXXXXXXXXXGOXXXXXXXXXXXXXXXXXXGOOOXXXXXXXXXXXXXXXXGOOXXXXXXXXXXXXXXXXXGOOOXXXXXXXXXXXXXXXXGOOOOOXXXXXXXXXXXXXXGOOXXXXXXXXXXXXXXXXXGOOOOOOXXXXXXXXXXXXXGOOOOOOOXXXXXXXXXXXX,0,300,0
29967,68,0,68,6,226,0,0,228,215,13,GOOOXXXXXXXXXXXXXXXXGOOOOOXXXXXXXXXXXXXXGOOOOOOOXXXXXXXXXXXXGOXXXXXXXXXXXXXXXXXXGOOOOOOOOOOXXXXXXXXXGOXXXXXXXXXXXXXXXXXXGOOOXXXXXXXXXXXXXXXXGOOXXXXXXXXXXXXXXXXXGOOOXXXXXXXXXXXXXXXXGOOOOOXXXXXXXXXXXXXXGOOXXXXXXXXXXXXXXXXXGOOOOOOXXXXXXXXXXXXXGOOOOOOOXXXXXXXXXXXX,0,300,0
29988,68,0,68,6,226,0,0,228,215,13,GOOOXXXXXXXXXXXXXXXXGOOOOOXXXXXXXXXXXXXXGOOOOOOOXXXXXXXXXXXXGOXXXXXXXXXXXXXXXXXXGOOOOOOOOOOXXXXXXXXXGOXXXXXXXXXXXXXXXXXXGOOOXXXXXXXXXXXXXXXXGOOXXXXXXXXXXXXXXXXXGOOOXXXXXXXXXXXXXXXXGOOOOOXXXXXXXXXXXXXXGOOXXXXXXXXXXXXXXXXXGOOOOOOXXXXXXXXXXXXXGOOOOOOOXXXXXXXXXXXX,0,300,0
30009,68,0,68,6,226,0,0,228,215,13,GOOOXXXXXXXXXXXXXXXXGOOOOOXXXXXXXXXXXXXXGOOOOOOOXXXXXXXXXXXXGOXXXXXXXXXXXXXXXXXXGOOOOOOOOOOXXXXXXXXXGOXXXXXXXXXXXXXXXXXXGOOOXXXXXXXXXXXXXXXXGOOXXXXXXXXXXXXXXXXXGOOOXXXXXXXXXXXXXXXXGOOOOOXXXXXXXXXXXXXXGOOXXXXXXXXXXXXXXXXXGOOOOOOXXXXXXXXXXXXXGOOOOOOOXXXXXXXXXXXX,0,300,0

30030,68,0,68,6,226,0,0,228,215,13,GOOOXXXXXXXXXXXXXXXXGOOOOOXXXXXXXXXXXXXXGOOOOOOOXXXXXXXXXXXXGOXXXXXXXXXXXXXXXXXXGOOOOOOOOOOXXXXXXXXXGOXXXXXXXXXXXXXXXXXXGOOOXXXXXXXXXXXXXXXXGOOXXXXXXXXXXXXXXXXXGOOOXXXXXXXXXXXXXXXXGOOOOOXXXXXXXXXXXXXXGOOXXXXXXXXXXXXXXXXXGOOOOOOXXXXXXXXXXXXXGOOOOOOOXXXXXXXXXXXX,0,300,0
30051,68,0,68,4,228,0,0,230,216,14,GOOOXXXXXXXXXXXXXXXXGOOOOOXXXXXXXXXXXXXXGOOOOOOOXXXXXXXXXXXXGOXXXXXXXXXXXXXXXXXXGOOOOOOOOOOXXXXXXXXXGOXXXXXXXXXXXXXXXXXXGOOOXXXXXXXXXXXXXXXXGOOXXXXXXXXXXXXXXXXXGOOOXXXXXXXXXXXXXXXXGOOOOOXXXXXXXXXXXXXXGOOXXXXXXXXXXXXXXXXXGOOOOOOXXXXXXXXXXXXXGOOOOOOOXXXXXXXXXXXX,0,300,0
30072,68,0,68,3,229,0,0,231,217,14,GOOOXXXXXXXXXXXXXXXXGOOOOOXXXXXXXXXXXXXXGOOOOOOOXXXXXXXXXXXXGOXXXXXXXXXXXXXXXXXXGOOOOOOOOOOXXXXXXXXXGOXXXXXXXXXXXXXXXXXXGOOOXXXXXXXXXXXXXXXXGOOXXXXXXXXXXXXXXXXXGOOOXXXXXXXXXXXXXXXXGOOOOOXXXXXXXXXXXXXXGOOXXXXXXXXXXXXXXXXXGOOOOOOXXXXXXXXXXXXXGOOOOOOOXXXXXXXXXXXX,0,300,0
30093,68,0,68,6,226,0,0,228,215,13,GOOOXXXXXXXXXXXXXXXXGOOOOOXXXXXXXXXXXXXXGOOOOOOOXXXXXXXXXXXXGOXXXXXXXXXXXXXXXXXXGOOOOOOOOOOXXXXXXXXXGOXXXXXXXXXXXXXXXXXXGOOOXXXXXXXXXXXXXXXXGOOXXXXXXXXXXXXXXXXXGOOOXXXXXXXXXXXXXXXXGOOOOOXXXXXXXXXXXXXXGOOXXXXXXXXXXXXXXXXXGOOOOOOXXXXXXXXXXXXXGOOOOOOOXXXXXXXXXXXX,0,300,0
30114,68,0,68,6,226,0,0,228,215,13,GOOOXXXXXXXXXXXXXXXXGOOOOOXXXXXXXXXXXXXXGOOOOOOOXXXXXXXXXXXXGOXXXXXXXXXXXXXXXXXXGOOOOOOOOOOXXXXXXXXXGOXXXXXXXXXXXXXXXXXXGOOOXXXXXXXXXXXXXXXXGOOXXXXXXXXXXXXXXXXXGOOOXXXXXXXXXXXXXXXXGOOOOOXXXXXXXXXXXXXXGOOXXXXXXXXXXXXXXXXXGOOOOOOXXXXXXXXXXXXXGOOOOOOOXXXXXXXXXXXX,0,300,0

30135,68,0,68,5,227,0,0,229,215,14,GOOOXXXXXXXXXXXXXXXXGOOOOOXXXXXXXXXXXXXXGOOOOOOOXXXXXXXXXXXXGOXXXXXXXXXXXXXXXXXXGOOOOOOOOOOXXXXXXXXXGOXXXXXXXXXXXXXXXXXXGOOOXXXXXXXXXXXXXXXXGOOXXXXXXXXXXXXXXXXXGOOOXXXXXXXXXXXXXXXXGOOOOOXXXXXXXXXXXXXXGOOXXXXXXXXXXXXXXXXXGOOOOOOXXXXXXXXXXXXXGOOOOOOOXXXXXXXXXXXX,0,300,0
30156,68,0,68,3,229,0,0,230,216,14,GOOOXXXXXXXXXXXXXXXXGOOOOOXXXXXXXXXXXXXXGOOOOOOOXXXXXXXXXXXXGOXXXXXXXXXXXXXXXXXXGOOOOOOOOOOXXXXXXXXXGOXXXXXXXXXXXXXXXXXXGOOOXXXXXXXXXXXXXXXXGOOXXXXXXXXXXXXXXXXXGOOOXXXXXXXXXXXXXXXXGOOOOOXXXXXXXXXXXXXXGOOXXXXXXXXXXXXXXXXXGOOOOOOXXXXXXXXXXXXXGOOOOOOOXXXXXXXXXXXX,0,300,0
30177,68,0,68,5,227,0,0,229,215,14,GOOOXXXXXXXXXXXXXXXXGOOOOOXXXXXXXXXXXXXXGOOOOOOOXXXXXXXXXXXXGOXXXXXXXXXXXXXXXXXXGOOOOOOOOOOXXXXXXXXXGOXXXXXXXXXXXXXXXXXXGOOOXXXXXXXXXXXXXXXXGOOXXXXXXXXXXXXXXXXXGOOOXXXXXXXXXXXXXXXXGOOOOOXXXXXXXXXXXXXXGOOXXXXXXXXXXXXXXXXXGOOOOOOXXXXXXXXXXXXXGOOOOOOOXXXXXXXXXXXX,0,300,0
30198,68,0,68,5,227,0,0,229,216,13,GOOOXXXXXXXXXXXXXXXXGOOOOOXXXXXXXXXXXXXXGOOOOOOOXXXXXXXXXXXXGOXXXXXXXXXXXXXXXXXXGOOOOOOOOOOXXXXXXXXXGOXXXXXXXXXXXXXXXXXXGOOOXXXXXXXXXXXXXXXXGOOXXXXXXXXXXXXXXXXXGOOOXXXXXXXXXXXXXXXXGOOOOOXXXXXXXXXXXXXXGOOXXXXXXXXXXXXXXXXXGOOOOOOXXXXXXXXXXXXXGOOOOOOOXXXXXXXXXXXX,0,300,0
30219,68,0,68,4,228,0,0,230,216,14,GOOOXXXXXXXXXXXXXXXXGOOOOOXXXXXXXXXXXXXXGOOOOOOOXXXXXXXXXXXXGOXXXXXXXXXXXXXXXXXXGOOOOOOOOOOXXXXXXXXXGOXXXXXXXXXXXXXXXXXXGOOOXXXXXXXXXXXXXXXXGOOXXXXXXXXXXXXXXXXXGOOOXXXXXXXXXXXXXXXXGOOOOOXXXXXXXXXXXXXXGOOXXXXXXXXXXXXXXXXXGOOOOOOXXXXXXXXXXXXXGOOOOOOOXXXXXXXXXXXX,0,300,0

30240,68,0,68,5,227,0,0,229,215,14,GOOOXXXXXXXXXXXXXXXXGOOOOOXXXXXXXXXXXXXXGOOOOOOOXXXXXXXXXXXXGOXXXXXXXXXXXXXXXXXXGOOOOOOOOOOXXXXXXXXXGOXXXXXXXXXXXXXXXXXXGOOOXXXXXXXXXXXXXXXXGOOXXXXXXXXXXXXXXXXXGOOOXXXXXXXXXXXXXXXXGOOOOOXXXXXXXXXXXXXXGOOXXXXXXXXXXXXXXXXXGOOOOOOXXXXXXXXXXXXXGOOOOOOOXXXXXXXXXXXX,0,300,0
30261,68,0,68,5,227,0,0,229,215,14,GOOOXXXXXXXXXXXXXXXXGOOOOOXXXXXXXXXXXXXXGOOOOOOOXXXXXXXXXXXXGOXXXXXXXXXXXXXXXXXXGOOOOOOOOOOXXXXXXXXXGOXXXXXXXXXXXXXXXXXXGOOOXXXXXXXXXXXXXXXXGOOXXXXXXXXXXXXXXXXXGOOOXXXXXXXXXXXXXXXXGOOOOOXXXXXXXXXXXXXXGOOXXXXXXXXXXXXXXXXXGOOOOOOXXXXXXXXXXXXXGOOOOOOOXXXXXXXXXXXX,0,300,0
30282,68,0,68,5,227,0,0,229,215,14,GOOOXXXXXXXXXXXXXXXXGOOOOOXXXXXXXXXXXXXXGOOOOOOOXXXXXXXXXXXXGOXXXXXXXXXXXXXXXXXXGOOOOOOOOOOXXXXXXXXXGOXXXXXXXXXXXXXXXXXXGOOOXXXXXXXXXXXXXXXXGOOXXXXXXXXXXXXXXXXXGOOOXXXXXXXXXXXXXXXXGOOOOOXXXXXXXXXXXXXXGOOXXXXXXXXXXXXXXXXXGOOOOOOXXXXXXXXXXXXXGOOOOOOOXXXXXXXXXXXX,0,300,0
30303,68,0,68,5,227,0,0,229,217,12,GOOOXXXXXXXXXXXXXXXXGOOOOOXXXXXXXXXXXXXXGOOOOOOOXXXXXXXXXXXXGOXXXXXXXXXXXXXXXXXXGOOOOOOOOOOXXXXXXXXXGOXXXXXXXXXXXXXXXXXXGOOOXXXXXXXXXXXXXXXXGOOXXXXXXXXXXXXXXXXXGOOOXXXXXXXXXXXXXXXXGOOOOOXXXXXXXXXXXXXXGOOXXXXXXXXXXXXXXXXXGOOOOOOXXXXXXXXXXXXXGOOOOOOOXXXXXXXXXXXX,0,300,0
30324,68,0,68,7,225,0,0,226,216,10,GOOOXXXXXXXXXXXXXXXXGOOOOOXXXXXXXXXXXXXXGOOOOOOOXXXXXXXXXXXXGOXXXXXXXXXXXXXXXXXXGOOOOOOOOOOXXXXXXXXXGOXXXXXXXXXXXXXXXXXXGOOOXXXXXXXXXXXXXXXXGOOXXXXXXXXXXXXXXXXXGOOOXXXXXXXXXXXXXXXXGOOOOOXXXXXXXXXXXXXXGOOXXXXXXXXXXXXXXXXXGOOOOOOXXXXXXXXXXXXXGOOOOOOOXXXXXXXXXXXX,0,300,0

30345,68,0,68,8,224,0,0,226,214,12,GOOOXXXXXXXXXXXXXXXXGOOOOOXXXXXXXXXXXXXXGOOOOOOOXXXXXXXXXXXXGOXXXXXXXXXXXXXXXXXXGOOOOOOOOOOXXXXXXXXXGOXXXXXXXXXXXXXXXXXXGOOOXXXXXXXXXXXXXXXXGOOXXXXXXXXXXXXXXXXXGOOOXXXXXXXXXXXXXXXXGOOOOOXXXXXXXXXXXXXXGOOXXXXXXXXXXXXXXXXXGOOOOOOXXXXXXXXXXXXXGOOOOOOOXXXXXXXXXXXX,0,300,0
30366,68,0,68,8,224,0,0,226,216,10,GOOOXXXXXXXXXXXXXXXXGOOOOOXXXXXXXXXXXXXXGOOOOOOOXXXXXXXXXXXXGOXXXXXXXXXXXXXXXXXXGOOOOOOOOOOXXXXXXXXXGOXXXXXXXXXXXXXXXXXXGOOOXXXXXXXXXXXXXXXXGOOXXXXXXXXXXXXXXXXXGOOOXXXXXXXXXXXXXXXXGOOOOOXXXXXXXXXXXXXXGOOXXXXXXXXXXXXXXXXXGOOOOOOXXXXXXXXXXXXXGOOOOOOOXXXXXXXXXXXX,0,300,0
30387,68,0,68,10,222,0,0,224,215,9,GOOOXXXXXXXXXXXXXXXXGOOOOOXXXXXXXXXXXXXXGOOOOOOOXXXXXXXXXXXXGOXXXXXXXXXXXXXXXXXXGOOOOOOOOOOXXXXXXXXXGOXXXXXXXXXXXXXXXXXXGOOOXXXXXXXXXXXXXXXXGOOXXXXXXXXXXXXXXXXXGOOOXXXXXXXXXXXXXXXXGOOOOOXXXXXXXXXXXXXXGOOXXXXXXXXXXXXXXXXXGOOOOOOXXXXXXXXXXXXXGOOOOOOOXXXXXXXXXXXX,0,300,0
30408,68,0,68,10,222,0,0,224,216,8,GOOOXXXXXXXXXXXXXXXXGOOOOOXXXXXXXXXXXXXXGOOOOOOOXXXXXXXXXXXXGOXXXXXXXXXXXXXXXXXXGOOOOOOOOOOXXXXXXXXXGOXXXXXXXXXXXXXXXXXXGOOOXXXXXXXXXXXXXXXXGOOXXXXXXXXXXXXXXXXXGOOOXXXXXXXXXXXXXXXXGOOOOOXXXXXXXXXXXXXXGOOXXXXXXXXXXXXXXXXXGOOOOOOXXXXXXXXXXXXXGOOOOOOOXXXXXXXXXXXX,0,300,0
30429,68,0,68,11,221,0,0,223,215,8,GOOOXXXXXXXXXXXXXXXXGOOOOOXXXXXXXXXXXXXXGOOOOOOOXXXXXXXXXXXXGOXXXXXXXXXXXXXXXXXXGOOOOOOOOOOXXXXXXXXXGOXXXXXXXXXXXXXXXXXXGOOOXXXXXXXXXXXXXXXXGOOXXXXXXXXXXXXXXXXXGOOOXXXXXXXXXXXXXXXXGOOOOOXXXXXXXXXXXXXXGOOXXXXXXXXXXXXXXXXXGOOOOOOXXXXXXXXXXXXXGOOOOOOOXXXXXXXXXXXX,0,300,0

30450,68,0,68,11,221,0,0,223,215,8,GOOOXXXXXXXXXXXXXXXXGOOOOOXXXXXXXXXXXXXXGOOOOOOOXXXXXXXXXXXXGOXXXXXXXXXXXXXXXXXXGOOOOOOOOOOXXXXXXXXXGOXXXXXXXXXXXXXXXXXXGOOOXXXXXXXXXXXXXXXXGOOXXXXXXXXXXXXXXXXXGOOOXXXXXXXXXXXXXXXXGOOOOOXXXXXXXXXXXXXXGOOXXXXXXXXXXXXXXXXXGOOOOOOXXXXXXXXXXXXXGOOOOOOOXXXXXXXXXXXX,0,300,0
30471,68,0,68,9,223,0,0,225,215,10,GOOOXXXXXXXXXXXXXXXXGOOOOOXXXXXXXXXXXXXXGOOOOOOOXXXXXXXXXXXXGOXXXXXXXXXXXXXXXXXXGOOOOOOOOOOXXXXXXXXXGOXXXXXXXXXXXXXXXXXXGOOOXXXXXXXXXXXXXXXXGOOXXXXXXXXXXXXXXXXXGOOOXXXXXXXXXXXXXXXXGOOOOOXXXXXXXXXXXXXXGOOXXXXXXXXXXXXXXXXXGOOOOOOXXXXXXXXXXXXXGOOOOOOOXXXXXXXXXXXX,0,300,0
30492,68,0,68,8,224,0,0,226,214,12,GOOOXXXXXXXXXXXXXXXXGOOOOOXXXXXXXXXXXXXXGOOOOOOOXXXXXXXXXXXXGOXXXXXXXXXXXXXXXXXXGOOOOOOOOOOXXXXXXXXXGOXXXXXXXXXXXXXXXXXXGOOOXXXXXXXXXXXXXXXXGOOXXXXXXXXXXXXXXXXXGOOOXXXXXXXXXXXXXXXXGOOOOOXXXXXXXXXXXXXXGOOXXXXXXXXXXXXXXXXXGOOOOOOXXXXXXXXXXXXXGOOOOOOOXXXXXXXXXXXX,0,300,0
30513,68,0,68,8,224,0,0,226,215,11,GOOOXXXXXXXXXXXXXXXXGOOOOOXXXXXXXXXXXXXXGOOOOOOOXXXXXXXXXXXXGOXXXXXXXXXXXXXXXXXXGOOOOOOOOOOXXXXXXXXXGOXXXXXXXXXXXXXXXXXXGOOOXXXXXXXXXXXXXXXXGOOXXXXXXXXXXXXXXXXXGOOOXXXXXXXXXXXXXXXXGOOOOOXXXXXXXXXXXXXXGOOXXXXXXXXXXXXXXXXXGOOOOOOXXXXXXXXXXXXXGOOOOOOOXXXXXXXXXXXX,0,300,0
30534,68,0,68,9,223,0,0,225,214,11,GOOOXXXXXXXXXXXXXXXXGOOOOOXXXXXXXXXXXXXXGOOOOOOOXXXXXXXXXXXXGOXXXXXXXXXXXXXXXXXXGOOOOOOOOOOXXXXXXXXXGOXXXXXXXXXXXXXXXXXXGOOOXXXXXXXXXXXXXXXXGOOXXXXXXXXXXXXXXXXXGOOOXXXXXXXXXXXXXXXXGOOOOOXXXXXXXXXXXXXXGOOXXXXXXXXXXXXXXXXXGOOOOOOXXXXXXXXXXXXXGOOOOOOOXXXXXXXXXXXX,0,300,0

30555,68,0,68,9,223,0,0,225,215,10,GOOOXXXXXXXXXXXXXXXXGOOOOOXXXXXXXXXXXXXXGOOOOOOOXXXXXXXXXXXXGOXXXXXXXXXXXXXXXXXXGOOOOOOOOOOXXXXXXXXXGOXXXXXXXXXXXXXXXXXXGOOOXXXXXXXXXXXXXXXXGOOXXXXXXXXXXXXXXXXXGOOOXXXXXXXXXXXXXXXXGOOOOOXXXXXXXXXXXXXXGOOXXXXXXXXXXXXXXXXXGOOOOOOXXXXXXXXXXXXXGOOOOOOOXXXXXXXXXXXX,0,300,0
30576,68,0,68,10,222,0,0,224,216,8,GOOOXXXXXXXXXXXXXXXXGOOOOOXXXXXXXXXXXXXXGOOOOOOOXXXXXXXXXXXXGOXXXXXXXXXXXXXXXXXXGOOOOOOOOOOXXXXXXXXXGOXXXXXXXXXXXXXXXXXXGOOOXXXXXXXXXXXXXXXXGOOXXXXXXXXXXXXXXXXXGOOOXXXXXXXXXXXXXXXXGOOOOOXXXXXXXXXXXXXXGOOXXXXXXXXXXXXXXXXXGOOOOOOXXXXXXXXXXXXXGOOOOOOOXXXXXXXXXXXX,0,300,0
30597,68,0,68,10,222,0,0,224,215,9,GOOOXXXXXXXXXXXXXXXXGOOOOOXXXXXXXXXXXXXXGOOOOOOOXXXXXXXXXXXXGOXXXXXXXXXXXXXXXXXXGOOOOOOOOOOXXXXXXXXXGOXXXXXXXXXXXXXXXXXXGOOOXXXXXXXXXXXXXXXXGOOXXXXXXXXXXXXXXXXXGOOOXXXXXXXXXXXXXXXXGOOOOOXXXXXXXXXXXXXXGOOXXXXXXXXXXXXXXXXXGOOOOOOXXXXXXXXXXXXXGOOOOOOOXXXXXXXXXXXX,0,300,0
30618,68,0,68,10,222,0,0,224,215,9,GOOOXXXXXXXXXXXXXXXXGOOOOOXXXXXXXXXXXXXXGOOOOOOOXXXXXXXXXXXXGOXXXXXXXXXXXXXXXXXXGOOOOOOOOOOXXXXXXXXXGOXXXXXXXXXXXXXXXXXXGOOOXXXXXXXXXXXXXXXXGOOXXXXXXXXXXXXXXXXXGOOOXXXXXXXXXXXXXXXXGOOOOOXXXXXXXXXXXXXXGOOXXXXXXXXXXXXXXXXXGOOOOOOXXXXXXXXXXXXXGOOOOOOOXXXXXXXXXXXX,0,300,0
30639,68,0,68,10,222,0,0,224,216,8,GOOOXXXXXXXXXXXXXXXXGOOOOOXXXXXXXXXXXXXXGOOOOOOOXXXXXXXXXXXXGOXXXXXXXXXXXXXXXXXXGOOOOOOOOOOXXXXXXXXXGOXXXXXXXXXXXXXXXXXXGOOOXXXXXXXXXXXXXXXXGOOXXXXXXXXXXXXXXXXXGOOOXXXXXXXXXXXXXXXXGOOOOOXXXXXXXXXXXXXXGOOXXXXXXXXXXXXXXXXXGOOOOOOXXXXXXXXXXXXXGOOOOOOOXXXXXXXXXXXX,0,300,0

30660,68,0,68,10,222,0,0,224,216,8,GOOOXXXXXXXXXXXXXXXXGOOOOOXXXXXXXXXXXXXXGOOOOOOOXXXXXXXXXXXXGOXXXXXXXXXXXXXXXXXXGOOOOOOOOOOXXXXXXXXXGOXXXXXXXXXXXXXXXXXXGOOOXXXXXXXXXXXXXXXXGOOXXXXXXXXXXXXXXXXXGOOOXXXXXXXXXXXXXXXXGOOOOOXXXXXXXXXXXXXXGOOXXXXXXXXXXXXXXXXXGOOOOOOXXXXXXXXXXXXXGOOOOOOOXXXXXXXXXXXX,0,300,0
30681,68,0,68,7,225,0,0,227,216,11,GOOOXXXXXXXXXXXXXXXXGOOOOOXXXXXXXXXXXXXXGOOOOOOOXXXXXXXXXXXXGOXXXXXXXXXXXXXXXXXXGOOOOOOOOOOXXXXXXXXXGOXXXXXXXXXXXXXXXXXXGOOOXXXXXXXXXXXXXXXXGOOXXXXXXXXXXXXXXXXXGOOOXXXXXXXXXXXXXXXXGOOOOOXXXXXXXXXXXXXXGOOXXXXXXXXXXXXXXXXXGOOOOOOXXXXXXXXXXXXXGOOOOOOOXXXXXXXXXXXX,0,300,0
30702,68,0,68,7,225,0,0,227,215,12,GOOOXXXXXXXXXXXXXXXXGOOOOOXXXXXXXXXXXXXXGOOOOOOOXXXXXXXXXXXXGOXXXXXXXXXXXXXXXXXXGOOOOOOOOOOXXXXXXXXXGOXXXXXXXXXXXXXXXXXXGOOOXXXXXXXXXXXXXXXXGOOXXXXXXXXXXXXXXXXXGOOOXXXXXXXXXXXXXXXXGOOOOOXXXXXXXXXXXXXXGOOXXXXXXXXXXXXXXXXXGOOOOOOXXXXXXXXXXXXXGOOOOOOOXXXXXXXXXXXX,0,300,0
30723,68,0,68,6,226,0,0,229,215,14,GOOOXXXXXXXXXXXXXXXXGOOOOOXXXXXXXXXXXXXXGOOOOOOOXXXXXXXXXXXXGOXXXXXXXXXXXXXXXXXXGOOOOOOOOOOXXXXXXXXXGOXXXXXXXXXXXXXXXXXXGOOOXXXXXXXXXXXXXXXXGOOXXXXXXXXXXXXXXXXXGOOOXXXXXXXXXXXXXXXXGOOOOOXXXXXXXXXXXXXXGOOXXXXXXXXXXXXXXXXXGOOOOOOXXXXXXXXXXXXXGOOOOOOOXXXXXXXXXXXX,0,300,0
30744,68,0,68,3,229,0,0,231,215,16,GOOOXXXXXXXXXXXXXXXXGOOOOOXXXXXXXXXXXXXXGOOOOOOOXXXXXXXXXXXXGOXXXXXXXXXXXXXXXXXXGOOOOOOOOOOXXXXXXXXXGOXXXXXXXXXXXXXXXXXXGOOOXXXXXXXXXXXXXXXXGOOXXXXXXXXXXXXXXXXXGOOOXXXXXXXXXXXXXXXXGOOOOOXXXXXXXXXXXXXXGOOXXXXXXXXXXXXXXXXXGOOOOOOXXXXXXXXXXXXXGOOOOOOOXXXXXXXXXXXX,0,300,0

30765,68,0,68,4,228,0,0,230,215,15,GOOOXXXXXXXXXXXXXXXXGOOOOOXXXXXXXXXXXXXXGOOOOOOOXXXXXXXXXXXXGOXXXXXXXXXXXXXXXXXXGOOOOOOOOOOXXXXXXXXXGOXXXXXXXXXXXXXXXXXXGOOOXXXXXXXXXXXXXXXXGOOXXXXXXXXXXXXXXXXXGOOOXXXXXXXXXXXXXXXXGOOOOOXXXXXXXXXXXXXXGOOXXXXXXXXXXXXXXXXXGOOOOOOXXXXXXXXXXXXXGOOOOOOOXXXXXXXXXXXX,0,300,0
30786,68,0,68,3,229,0,0,231,215,16,GOOOXXXXXXXXXXXXXXXXGOOOOOXXXXXXXXXXXXXXGOOOOOOOXXXXXXXXXXXXGOXXXXXXXXXXXXXXXXXXGOOOOOOOOOOXXXXXXXXXGOXXXXXXXXXXXXXXXXXXGOOOXXXXXXXXXXXXXXXXGOOXXXXXXXXXXXXXXXXXGOOOXXXXXXXXXXXXXXXXGOOOOOXXXXXXXXXXXXXXGOOXXXXXXXXXXXXXXXXXGOOOOOOXXXXXXXXXXXXXGOOOOOOOXXXXXXXXXXXX,0,300,0
30807,68,0,68,3,229,0,0,231,215,16,GOOOXXXXXXXXXXXXXXXXGOOOOOXXXXXXXXXXXXXXGOOOOOOOXXXXXXXXXXXXGOXXXXXXXXXXXXXXXXXXGOOOOOOOOOOXXXXXXXXXGOXXXXXXXXXXXXXXXXXXGOOOXXXXXXXXXXXXXXXXGOOXXXXXXXXXXXXXXXXXGOOOXXXXXXXXXXXXXXXXGOOOOOXXXXXXXXXXXXXXGOOXXXXXXXXXXXXXXXXXGOOOOOOXXXXXXXXXXXXXGOOOOOOOXXXXXXXXXXXX,0,300,0
30828,68,0,68,3,229,0,0,231,216,15,GOOOXXXXXXXXXXXXXXXXGOOOOOXXXXXXXXXXXXXXGOOOOOOOXXXXXXXXXXXXGOXXXXXXXXXXXXXXXXXXGOOOOOOOOOOXXXXXXXXXGOXXXXXXXXXXXXXXXXXXGOOOXXXXXXXXXXXXXXXXGOOXXXXXXXXXXXXXXXXXGOOOXXXXXXXXXXXXXXXXGOOOOOXXXXXXXXXXXXXXGOOXXXXXXXXXXXXXXXXXGOOOOOOXXXXXXXXXXXXXGOOOOOOOXXXXXXXXXXXX,0,300,0
30849,68,0,68,4,228,0,0,230,216,14,GOOOXXXXXXXXXXXXXXXXGOOOOOXXXXXXXXXXXXXXGOOOOOOOXXXXXXXXXXXXGOXXXXXXXXXXXXXXXXXXGOOOOOOOOOOXXXXXXXXXGOXXXXXXXXXXXXXXXXXXGOOOXXXXXXXXXXXXXXXXGOOXXXXXXXXXXXXXXXXXGOOOXXXXXXXXXXXXXXXXGOOOOOXXXXXXXXXXXXXXGOOXXXXXXXXXXXXXXXXXGOOOOOOXXXXXXXXXXXXXGOOOOOOOXXXXXXXXXXXX,0,300,0

30870,68,0,68,5,227,0,0,229,215,14,GOOOXXXXXXXXXXXXXXXXGOOOOOXXXXXXXXXXXXXXGOOOOOOOXXXXXXXXXXXXGOXXXXXXXXXXXXXXXXXXGOOOOOOOOOOXXXXXXXXXGOXXXXXXXXXXXXXXXXXXGOOOXXXXXXXXXXXXXXXXGOOXXXXXXXXXXXXXXXXXGOOOXXXXXXXXXXXXXXXXGOOOOOXXXXXXXXXXXXXXGOOXXXXXXXXXXXXXXXXXGOOOOOOXXXXXXXXXXXXXGOOOOOOOXXXXXXXXXXXX,0,300,0
30891,68,0,68,6,226,0,0,228,214,14,GOOOXXXXXXXXXXXXXXXXGOOOOOXXXXXXXXXXXXXXGOOOOOOOXXXXXXXXXXXXGOXXXXXXXXXXXXXXXXXXGOOOOOOOOOOXXXXXXXXXGOXXXXXXXXXXXXXXXXXXGOOOXXXXXXXXXXXXXXXXGOOXXXXXXXXXXXXXXXXXGOOOXXXXXXXXXXXXXXXXGOOOOOXXXXXXXXXXXXXXGOOXXXXXXXXXXXXXXXXXGOOOOOOXXXXXXXXXXXXXGOOOOOOOXXXXXXXXXXXX,0,300,0
30912,68,0,68,6,226,0,0,228,214,14,GOOOXXXXXXXXXXXXXXXXGOOOOOXXXXXXXXXXXXXXGOOOOOOOXXXXXXXXXXXXGOXXXXXXXXXXXXXXXXXXGOOOOOOOOOOXXXXXXXXXGOXXXXXXXXXXXXXXXXXXGOOOXXXXXXXXXXXXXXXXGOOXXXXXXXXXXXXXXXXXGOOOXXXXXXXXXXXXXXXXGOOOOOXXXXXXXXXXXXXXGOOXXXXXXXXXXXXXXXXXGOOOOOOXXXXXXXXXXXXXGOOOOOOOXXXXXXXXXXXX,0,300,0
30933,68,0,68,6,226,0,0,228,215,13,GOOOXXXXXXXXXXXXXXXXGOOOOOXXXXXXXXXXXXXXGOOOOOOOXXXXXXXXXXXXGOXXXXXXXXXXXXXXXXXXGOOOOOOOOOOXXXXXXXXXGOXXXXXXXXXXXXXXXXXXGOOOXXXXXXXXXXXXXXXXGOOXXXXXXXXXXXXXXXXXGOOOXXXXXXXXXXXXXXXXGOOOOOXXXXXXXXXXXXXXGOOXXXXXXXXXXXXXXXXXGOOOOOOXXXXXXXXXXXXXGOOOOOOOXXXXXXXXXXXX,0,300,0
30954,68,0,68,6,226,0,0,228,215,13,GOOOXXXXXXXXXXXXXXXXGOOOOOXXXXXXXXXXXXXXGOOOOOOOXXXXXXXXXXXXGOXXXXXXXXXXXXXXXXXXGOOOOOOOOOOXXXXXXXXXGOXXXXXXXXXXXXXXXXXXGOOOXXXXXXXXXXXXXXXXGOOXXXXXXXXXXXXXXXXXGOOOXXXXXXXXXXXXXXXXGOOOOOXXXXXXXXXXXXXXGOOXXXXXXXXXXXXXXXXXGOOOOOOXXXXXXXXXXXXXGOOOOOOOXXXXXXXXXXXX,0,300,0

30975,68,0,68,7,225,0,0,227,216,11,GOOOXXXXXXXXXXXXXXXXGOOOOOXXXXXXXXXXXXXXGOOOOOOOXXXXXXXXXXXXGOXXXXXXXXXXXXXXXXXXGOOOOOOOOOOXXXXXXXXXGOXXXXXXXXXXXXXXXXXXGOOOXXXXXXXXXXXXXXXXGOOXXXXXXXXXXXXXXXXXGOOOXXXXXXXXXXXXXXXXGOOOOOXXXXXXXXXXXXXXGOOXXXXXXXXXXXXXXXXXGOOOOOOXXXXXXXXXXXXXGOOOOOOOXXXXXXXXXXXX,0,300,0
30996,68,0,68,8,224,0,0,226,215,11,GOOOXXXXXXXXXXXXXXXXGOOOOOXXXXXXXXXXXXXXGOOOOOOOXXXXXXXXXXXXGOXXXXXXXXXXXXXXXXXXGOOOOOOOOOOXXXXXXXXXGOXXXXXXXXXXXXXXXXXXGOOOXXXXXXXXXXXXXXXXGOOXXXXXXXXXXXXXXXXXGOOOXXXXXXXXXXXXXXXXGOOOOOXXXXXXXXXXXXXXGOOXXXXXXXXXXXXXXXXXGOOOOOOXXXXXXXXXXXXXGOOOOOOOXXXXXXXXXXXX,0,300,0
31017,68,0,68,7,225,0,0,227,215,12,GOOOXXXXXXXXXXXXXXXXGOOOOOXXXXXXXXXXXXXXGOOOOOOOXXXXXXXXXXXXGOXXXXXXXXXXXXXXXXXXGOOOOOOOOOOXXXXXXXXXGOXXXXXXXXXXXXXXXXXXGOOOXXXXXXXXXXXXXXXXGOOXXXXXXXXXXXXXXXXXGOOOXXXXXXXXXXXXXXXXGOOOOOXXXXXXXXXXXXXXGOOXXXXXXXXXXXXXXXXXGOOOOOOXXXXXXXXXXXXXGOOOOOOOXXXXXXXXXXXX,0,300,0
31038,68,0,68,5,227,0,0,229,215,14,GOOOXXXXXXXXXXXXXXXXGOOOOOXXXXXXXXXXXXXXGOOOOOOOXXXXXXXXXXXXGOXXXXXXXXXXXXXXXXXXGOOOOOOOOOOXXXXXXXXXGOXXXXXXXXXXXXXXXXXXGOOOXXXXXXXXXXXXXXXXGOOXXXXXXXXXXXXXXXXXGOOOXXXXXXXXXXXXXXXXGOOOOOXXXXXXXXXXXXXXGOOXXXXXXXXXXXXXXXXXGOOOOOOXXXXXXXXXXXXXGOOOOOOOXXXXXXXXXXXX,0,300,0
31059,68,0,68,5,227,0,0,229,215,14,GOOOXXXXXXXXXXXXXXXXGOOOOOXXXXXXXXXXXXXXGOOOOOOOXXXXXXXXXXXXGOXXXXXXXXXXXXXXXXXXGOOOOOOOOOOXXXXXXXXXGOXXXXXXXXXXXXXXXXXXGOOOXXXXXXXXXXXXXXXXGOOXXXXXXXXXXXXXXXXXGOOOXXXXXXXXXXXXXXXXGOOOOOXXXXXXXXXXXXXXGOOXXXXXXXXXXXXXXXXXGOOOOOOXXXXXXXXXXXXXGOOOOOOOXXXXXXXXXXXX,0,300,0

31080,68,0,68,6,226,0,0,228,215,13,GOOOXXXXXXXXXXXXXXXXGOOOOOXXXXXXXXXXXXXXGOOOOOOOXXXXXXXXXXXXGOXXXXXXXXXXXXXXXXXXGOOOOOOOOOOXXXXXXXXXGOXXXXXXXXXXXXXXXXXXGOOOXXXXXXXXXXXXXXXXGOOXXXXXXXXXXXXXXXXXGOOOXXXXXXXXXXXXXXXXGOOOOOXXXXXXXXXXXXXXGOOXXXXXXXXXXXXXXXXXGOOOOOOXXXXXXXXXXXXXGOOOOOOOXXXXXXXXXXXX,0,300,0
31101,68,0,68,6,226,0,0,228,215,13,GOOOXXXXXXXXXXXXXXXXGOOOOOXXXXXXXXXXXXXXGOOOOOOOXXXXXXXXXXXXGOXXXXXXXXXXXXXXXXXXGOOOOOOOOOOXXXXXXXXXGOXXXXXXXXXXXXXXXXXXGOOOXXXXXXXXXXXXXXXXGOOXXXXXXXXXXXXXXXXXGOOOXXXXXXXXXXXXXXXXGOOOOOXXXXXXXXXXXXXXGOOXXXXXXXXXXXXXXXXXGOOOOOOXXXXXXXXXXXXXGOOOOOOOXXXXXXXXXXXX,0,300,0
31122,68,0,68,5,227,0,0,229,215,14,GOOOXXXXXXXXXXXXXXXXGOOOOOXXXXXXXXXXXXXXGOOOOOOOXXXXXXXXXXXXGOXXXXXXXXXXXXXXXXXXGOOOOOOOOOOXXXXXXXXXGOXXXXXXXXXXXXXXXXXXGOOOXXXXXXXXXXXXXXXXGOOXXXXXXXXXXXXXXXXXGOOOXXXXXXXXXXXXXXXXGOOOOOXXXXXXXXXXXXXXGOOXXXXXXXXXXXXXXXXXGOOOOOOXXXXXXXXXXXXXGOOOOOOOXXXXXXXXXXXX,0,300,0
31143,68,0,68,4,228,0,0,230,217,13,GOOOXXXXXXXXXXXXXXXXGOOOOOXXXXXXXXXXXXXXGOOOOOOOXXXXXXXXXXXXGOXXXXXXXXXXXXXXXXXXGOOOOOOOOOOXXXXXXXXXGOXXXXXXXXXXXXXXXXXXGOOOXXXXXXXXXXXXXXXXGOOXXXXXXXXXXXXXXXXXGOOOXXXXXXXXXXXXXXXXGOOOOOXXXXXXXXXXXXXXGOOXXXXXXXXXXXXXXXXXGOOOOOOXXXXXXXXXXXXXGOOOOOOOXXXXXXXXXXXX,0,300,0
31164,68,0,68,7,225,0,0,227,216,11,GOOOXXXXXXXXXXXXXXXXGOOOOOXXXXXXXXXXXXXXGOOOOOOOXXXXXXXXXXXXGOXXXXXXXXXXXXXXXXXXGOOOOOOOOOOXXXXXXXXXGOXXXXXXXXXXXXXXXXXXGOOOXXXXXXXXXXXXXXXXGOOXXXXXXXXXXXXXXXXXGOOOXXXXXXXXXXXXXXXXGOOOOOXXXXXXXXXXXXXXGOOXXXXXXXXXXXXXXXXXGOOOOOOXXXXXXXXXXXXXGOOOOOOOXXXXXXXXXXXX,0,300,0

31185,68,0,68,8,224,0,0,226,216,10,GOOOXXXXXXXXXXXXXXXXGOOOOOXXXXXXXXXXXXXXGOOOOOOOXXXXXXXXXXXXGOXXXXXXXXXXXXXXXXXXGOOOOOOOOOOXXXXXXXXXGOXXXXXXXXXXXXXXXXXXGOOOXXXXXXXXXXXXXXXXGOOXXXXXXXXXXXXXXXXXGOOOXXXXXXXXXXXXXXXXGOOOOOXXXXXXXXXXXXXXGOOXXXXXXXXXXXXXXXXXGOOOOOOXXXXXXXXXXXXXGOOOOOOOXXXXXXXXXXXX,0,300,0
31206,68,0,68,6,226,0,0,228,215,13,GOOOXXXXXXXXXXXXXXXXGOOOOOXXXXXXXXXXXXXXGOOOOOOOXXXXXXXXXXXXGOXXXXXXXXXXXXXXXXXXGOOOOOOOOOOXXXXXXXXXGOXXXXXXXXXXXXXXXXXXGOOOXXXXXXXXXXXXXXXXGOOXXXXXXXXXXXXXXXXXGOOOXXXXXXXXXXXXXXXXGOOOOOXXXXXXXXXXXXXXGOOXXXXXXXXXXXXXXXXXGOOOOOOXXXXXXXXXXXXXGOOOOOOOXXXXXXXXXXXX,0,300,0
31227,68,0,68,6,226,0,0,228,215,13,GOOOXXXXXXXXXXXXXXXXGOOOOOXXXXXXXXXXXXXXGOOOOOOOXXXXXXXXXXXXGOXXXXXXXXXXXXXXXXXXGOOOOOOOOOOXXXXXXXXXGOXXXXXXXXXXXXXXXXXXGOOOXXXXXXXXXXXXXXXXGOOXXXXXXXXXXXXXXXXXGOOOXXXXXXXXXXXXXXXXGOOOOOXXXXXXXXXXXXXXGOOXXXXXXXXXXXXXXXXXGOOOOOOXXXXXXXXXXXXXGOOOOOOOXXXXXXXXXXXX,0,300,0
31248,68,0,68,5,227,0,0,229,215,14,GOOOXXXXXXXXXXXXXXXXGOOOOOXXXXXXXXXXXXXXGOOOOOOOXXXXXXXXXXXXGOXXXXXXXXXXXXXXXXXXGOOOOOOOOOOXXXXXXXXXGOXXXXXXXXXXXXXXXXXXGOOOXXXXXXXXXXXXXXXXGOOXXXXXXXXXXXXXXXXXGOOOXXXXXXXXXXXXXXXXGOOOOOXXXXXXXXXXXXXXGOOXXXXXXXXXXXXXXXXXGOOOOOOXXXXXXXXXXXXXGOOOOOOOXXXXXXXXXXXX,0,300,0
31269,68,0,68,4,228,0,0,230,216,14,GOOOXXXXXXXXXXXXXXXXGOOOOOXXXXXXXXXXXXXXGOOOOOOOXXXXXXXXXXXXGOXXXXXXXXXXXXXXXXXXGOOOOOOOOOOXXXXXXXXXGOXXXXXXXXXXXXXXXXXXGOOOXXXXXXXXXXXXXXXXGOOXXXXXXXXXXXXXXXXXGOOOXXXXXXXXXXXXXXXXGOOOOOXXXXXXXXXXXXXXGOOXXXXXXXXXXXXXXXXXGOOOOOOXXXXXXXXXXXXXGOOOOOOOXXXXXXXXXXXX,0,300,0

31290,68,0,68,4,228,0,0,230,218,12,GOOOXXXXXXXXXXXXXXXXGOOOOOXXXXXXXXXXXXXXGOOOOOOOXXXXXXXXXXXXGOXXXXXXXXXXXXXXXXXXGOOOOOOOOOOXXXXXXXXXGOXXXXXXXXXXXXXXXXXXGOOOXXXXXXXXXXXXXXXXGOOXXXXXXXXXXXXXXXXXGOOOXXXXXXXXXXXXXXXXGOOOOOXXXXXXXXXXXXXXGOOXXXXXXXXXXXXXXXXXGOOOOOOXXXXXXXXXXXXXGOOOOOOOXXXXXXXXXXXX,0,300,0
31311,68,0,68,5,227,0,0,229,217,12,GOOOXXXXXXXXXXXXXXXXGOOOOOXXXXXXXXXXXXXXGOOOOOOOXXXXXXXXXXXXGOXXXXXXXXXXXXXXXXXXGOOOOOOOOOOXXXXXXXXXGOXXXXXXXXXXXXXXXXXXGOOOXXXXXXXXXXXXXXXXGOOXXXXXXXXXXXXXXXXXGOOOXXXXXXXXXXXXXXXXGOOOOOXXXXXXXXXXXXXXGOOXXXXXXXXXXXXXXXXXGOOOOOOXXXXXXXXXXXXXGOOOOOOOXXXXXXXXXXXX,0,300,0
31332,68,0,68,5,227,0,0,229,217,12,GOOOXXXXXXXXXXXXXXXXGOOOOOXXXXXXXXXXXXXXGOOOOOOOXXXXXXXXXXXXGOXXXXXXXXXXXXXXXXXXGOOOOOOOOOOXXXXXXXXXGOXXXXXXXXXXXXXXXXXXGOOOXXXXXXXXXXXXXXXXGOOXXXXXXXXXXXXXXXXXGOOOXXXXXXXXXXXXXXXXGOOOOOXXXXXXXXXXXXXXGOOXXXXXXXXXXXXXXXXXGOOOOOOXXXXXXXXXXXXXGOOOOOOOXXXXXXXXXXXX,0,300,0
31353,68,0,68,6,226,0,0,228,216,12,GOOOXXXXXXXXXXXXXXXXGOOOOOXXXXXXXXXXXXXXGOOOOOOOXXXXXXXXXXXXGOXXXXXXXXXXXXXXXXXXGOOOOOOOOOOXXXXXXXXXGOXXXXXXXXXXXXXXXXXXGOOOXXXXXXXXXXXXXXXXGOOXXXXXXXXXXXXXXXXXGOOOXXXXXXXXXXXXXXXXGOOOOOXXXXXXXXXXXXXXGOOXXXXXXXXXXXXXXXXXGOOOOOOXXXXXXXXXXXXXGOOOOOOOXXXXXXXXXXXX,0,300,0
31374,68,0,68,7,225,0,0,227,216,11,GOOOXXXXXXXXXXXXXXXXGOOOOOXXXXXXXXXXXXXXGOOOOOOOXXXXXXXXXXXXGOXXXXXXXXXXXXXXXXXXGOOOOOOOOOOXXXXXXXXXGOXXXXXXXXXXXXXXXXXXGOOOXXXXXXXXXXXXXXXXGOOXXXXXXXXXXXXXXXXXGOOOXXXXXXXXXXXXXXXXGOOOOOXXXXXXXXXXXXXXGOOXXXXXXXXXXXXXXXXXGOOOOOOXXXXXXXXXXXXXGOOOOOOOXXXXXXXXXXXX,0,300,0

31395,68,0,68,8,224,0,0,226,216,10,GOOOXXXXXXXXXXXXXXXXGOOOOOXXXXXXXXXXXXXXGOOOOOOOXXXXXXXXXXXXGOXXXXXXXXXXXXXXXXXXGOOOOOOOOOOXXXXXXXXXGOXXXXXXXXXXXXXXXXXXGOOOXXXXXXXXXXXXXXXXGOOXXXXXXXXXXXXXXXXXGOOOXXXXXXXXXXXXXXXXGOOOOOXXXXXXXXXXXXXXGOOXXXXXXXXXXXXXXXXXGOOOOOOXXXXXXXXXXXXXGOOOOOOOXXXXXXXXXXXX,0,300,0
31416,68,0,68,6,226,0,0,228,217,11,GOOOXXXXXXXXXXXXXXXXGOOOOOXXXXXXXXXXXXXXGOOOOOOOXXXXXXXXXXXXGOXXXXXXXXXXXXXXXXXXGOOOOOOOOOOXXXXXXXXXGOXXXXXXXXXXXXXXXXXXGOOOXXXXXXXXXXXXXXXXGOOXXXXXXXXXXXXXXXXXGOOOXXXXXXXXXXXXXXXXGOOOOOXXXXXXXXXXXXXXGOOXXXXXXXXXXXXXXXXXGOOOOOOXXXXXXXXXXXXXGOOOOOOOXXXXXXXXXXXX,0,300,0
31437,68,0,68,7,225,0,0,227,216,11,GOOOXXXXXXXXXXXXXXXXGOOOOOXXXXXXXXXXXXXXGOOOOOOOXXXXXXXXXXXXGOXXXXXXXXXXXXXXXXXXGOOOOOOOOOOXXXXXXXXXGOXXXXXXXXXXXXXXXXXXGOOOXXXXXXXXXXXXXXXXGOOXXXXXXXXXXXXXXXXXGOOOXXXXXXXXXXXXXXXXGOOOOOXXXXXXXXXXXXXXGOOXXXXXXXXXXXXXXXXXGOOOOOOXXXXXXXXXXXXXGOOOOOOOXXXXXXXXXXXX,0,300,0
31458,68,0,68,7,225,0,0,227,217,10,GOOOXXXXXXXXXXXXXXXXGOOOOOXXXXXXXXXXXXXXGOOOOOOOXXXXXXXXXXXXGOXXXXXXXXXXXXXXXXXXGOOOOOOOOOOXXXXXXXXXGOXXXXXXXXXXXXXXXXXXGOOOXXXXXXXXXXXXXXXXGOOXXXXXXXXXXXXXXXXXGOOOXXXXXXXXXXXXXXXXGOOOOOXXXXXXXXXXXXXXGOOXXXXXXXXXXXXXXXXXGOOOOOOXXXXXXXXXXXXXGOOOOOOOXXXXXXXXXXXX,0,300,0
31479,68,0,68,7,225,0,0,227,218,9,GOOOXXXXXXXXXXXXXXXXGOOOOOXXXXXXXXXXXXXXGOOOOOOOXXXXXXXXXXXXGOXXXXXXXXXXXXXXXXXXGOOOOOOOOOOXXXXXXXXXGOXXXXXXXXXXXXXXXXXXGOOOXXXXXXXXXXXXXXXXGOOXXXXXXXXXXXXXXXXXGOOOXXXXXXXXXXXXXXXXGOOOOOXXXXXXXXXXXXXXGOOXXXXXXXXXXXXXXXXXGOOOOOOXXXXXXXXXXXXXGOOOOOOOXXXXXXXXXXXX,0,300,0

31500,68,0,68,6,226,0,0,228,218,10,GOOOXXXXXXXXXXXXXXXXGOOOOOXXXXXXXXXXXXXXGOOOOOOOXXXXXXXXXXXXGOXXXXXXXXXXXXXXXXXXGOOOOOOOOOOXXXXXXXXXGOXXXXXXXXXXXXXXXXXXGOOOXXXXXXXXXXXXXXXXGOOXXXXXXXXXXXXXXXXXGOOOXXXXXXXXXXXXXXXXGOOOOOXXXXXXXXXXXXXXGOOXXXXXXXXXXXXXXXXXGOOOOOOXXXXXXXXXXXXXGOOOOOOOXXXXXXXXXXXX,0,300,0
31521,68,0,68,9,223,0,0,225,217,8,GOOOXXXXXXXXXXXXXXXXGOOOOOXXXXXXXXXXXXXXGOOOOOOOXXXXXXXXXXXXGOXXXXXXXXXXXXXXXXXXGOOOOOOOOOOXXXXXXXXXGOXXXXXXXXXXXXXXXXXXGOOOXXXXXXXXXXXXXXXXGOOXXXXXXXXXXXXXXXXXGOOOXXXXXXXXXXXXXXXXGOOOOOXXXXXXXXXXXXXXGOOXXXXXXXXXXXXXXXXXGOOOOOOXXXXXXXXXXXXXGOOOOOOOXXXXXXXXXXXX,0,300,0
31542,68,0,68,10,222,0,0,224,216,8,GOOOXXXXXXXXXXXXXXXXGOOOOOXXXXXXXXXXXXXXGOOOOOOOXXXXXXXXXXXXGOXXXXXXXXXXXXXXXXXXGOOOOOOOOOOXXXXXXXXXGOXXXXXXXXXXXXXXXXXXGOOOXXXXXXXXXXXXXXXXGOOXXXXXXXXXXXXXXXXXGOOOXXXXXXXXXXXXXXXXGOOOOOXXXXXXXXXXXXXXGOOXXXXXXXXXXXXXXXXXGOOOOOOXXXXXXXXXXXXXGOOOOOOOXXXXXXXXXXXX,0,300,0
31563,68,0,68,9,223,0,0,225,216,9,GOOOXXXXXXXXXXXXXXXXGOOOOOXXXXXXXXXXXXXXGOOOOOOOXXXXXXXXXXXXGOXXXXXXXXXXXXXXXXXXGOOOOOOOOOOXXXXXXXXXGOXXXXXXXXXXXXXXXXXXGOOOXXXXXXXXXXXXXXXXGOOXXXXXXXXXXXXXXXXXGOOOXXXXXXXXXXXXXXXXGOOOOOXXXXXXXXXXXXXXGOOXXXXXXXXXXXXXXXXXGOOOOOOXXXXXXXXXXXXXGOOOOOOOXXXXXXXXXXXX,0,300,0
31584,68,0,68,8,224,0,0,226,216,10,GOOOXXXXXXXXXXXXXXXXGOOOOOXXXXXXXXXXXXXXGOOOOOOOXXXXXXXXXXXXGOXXXXXXXXXXXXXXXXXXGOOOOOOOOOOXXXXXXXXXGOXXXXXXXXXXXXXXXXXXGOOOXXXXXXXXXXXXXXXXGOOXXXXXXXXXXXXXXXXXGOOOXXXXXXXXXXXXXXXXGOOOOOXXXXXXXXXXXXXXGOOXXXXXXXXXXXXXXXXXGOOOOOOXXXXXXXXXXXXXGOOOOOOOXXXXXXXXXXXX,0,300,0

31605,68,0,68,8,224,0,0,226,216,10,GOOOXXXXXXXXXXXXXXXXGOOOOOXXXXXXXXXXXXXXGOOOOOOOXXXXXXXXXXXXGOXXXXXXXXXXXXXXXXXXGOOOOOOOOOOXXXXXXXXXGOXXXXXXXXXXXXXXXXXXGOOOXXXXXXXXXXXXXXXXGOOXXXXXXXXXXXXXXXXXGOOOXXXXXXXXXXXXXXXXGOOOOOXXXXXXXXXXXXXXGOOXXXXXXXXXXXXXXXXXGOOOOOOXXXXXXXXXXXXXGOOOOOOOXXXXXXXXXXXX,0,300,0
31626,68,0,68,7,225,0,0,227,218,9,GOOOXXXXXXXXXXXXXXXXGOOOOOXXXXXXXXXXXXXXGOOOOOOOXXXXXXXXXXXXGOXXXXXXXXXXXXXXXXXXGOOOOOOOOOOXXXXXXXXXGOXXXXXXXXXXXXXXXXXXGOOOXXXXXXXXXXXXXXXXGOOXXXXXXXXXXXXXXXXXGOOOXXXXXXXXXXXXXXXXGOOOOOXXXXXXXXXXXXXXGOOXXXXXXXXXXXXXXXXXGOOOOOOXXXXXXXXXXXXXGOOOOOOOXXXXXXXXXXXX,0,300,0
31647,68,0,68,8,224,0,0,226,218,8,GOOOXXXXXXXXXXXXXXXXGOOOOOXXXXXXXXXXXXXXGOOOOOOOXXXXXXXXXXXXGOXXXXXXXXXXXXXXXXXXGOOOOOOOOOOXXXXXXXXXGOXXXXXXXXXXXXXXXXXXGOOOXXXXXXXXXXXXXXXXGOOXXXXXXXXXXXXXXXXXGOOOXXXXXXXXXXXXXXXXGOOOOOXXXXXXXXXXXXXXGOOXXXXXXXXXXXXXXXXXGOOOOOOXXXXXXXXXXXXXGOOOOOOOXXXXXXXXXXXX,0,300,0
31668,68,0,68,10,222,0,0,224,216,8,GOOOXXXXXXXXXXXXXXXXGOOOOOXXXXXXXXXXXXXXGOOOOOOOXXXXXXXXXXXXGOXXXXXXXXXXXXXXXXXXGOOOOOOOOOOXXXXXXXXXGOXXXXXXXXXXXXXXXXXXGOOOXXXXXXXXXXXXXXXXGOOXXXXXXXXXXXXXXXXXGOOOXXXXXXXXXXXXXXXXGOOOOOXXXXXXXXXXXXXXGOOXXXXXXXXXXXXXXXXXGOOOOOOXXXXXXXXXXXXXGOOOOOOOXXXXXXXXXXXX,0,300,0
31689,68,0,68,10,222,0,0,224,216,8,GOOOXXXXXXXXXXXXXXXXGOOOOOXXXXXXXXXXXXXXGOOOOOOOXXXXXXXXXXXXGOXXXXXXXXXXXXXXXXXXGOOOOOOOOOOXXXXXXXXXGOXXXXXXXXXXXXXXXXXXGOOOXXXXXXXXXXXXXXXXGOOXXXXXXXXXXXXXXXXXGOOOXXXXXXXXXXXXXXXXGOOOOOXXXXXXXXXXXXXXGOOXXXXXXXXXXXXXXXXXGOOOOOOXXXXXXXXXXXXXGOOOOOOOXXXXXXXXXXXX,0,300,0

31710,68,0,68,9,223,0,0,225,217,8,GOOOXXXXXXXXXXXXXXXXGOOOOOXXXXXXXXXXXXXXGOOOOOOOXXXXXXXXXXXXGOXXXXXXXXXXXXXXXXXXGOOOOOOOOOOXXXXXXXXXGOXXXXXXXXXXXXXXXXXXGOOOXXXXXXXXXXXXXXXXGOOXXXXXXXXXXXXXXXXXGOOOXXXXXXXXXXXXXXXXGOOOOOXXXXXXXXXXXXXXGOOXXXXXXXXXXXXXXXXXGOOOOOOXXXXXXXXXXXXXGOOOOOOOXXXXXXXXXXXX,0,300,0
31731,68,0,68,7,225,0,0,227,216,11,GOOOXXXXXXXXXXXXXXXXGOOOOOXXXXXXXXXXXXXXGOOOOOOOXXXXXXXXXXXXGOXXXXXXXXXXXXXXXXXXGOOOOOOOOOOXXXXXXXXXGOXXXXXXXXXXXXXXXXXXGOOOXXXXXXXXXXXXXXXXGOOXXXXXXXXXXXXXXXXXGOOOXXXXXXXXXXXXXXXXGOOOOOXXXXXXXXXXXXXXGOOXXXXXXXXXXXXXXXXXGOOOOOOXXXXXXXXXXXXXGOOOOOOOXXXXXXXXXXXX,0,300,0
31752,68,0,68,7,225,0,0,227,216,11,GOOOXXXXXXXXXXXXXXXXGOOOOOXXXXXXXXXXXXXXGOOOOOOOXXXXXXXXXXXXGOXXXXXXXXXXXXXXXXXXGOOOOOOOOOOXXXXXXXXXGOXXXXXXXXXXXXXXXXXXGOOOXXXXXXXXXXXXXXXXGOOXXXXXXXXXXXXXXXXXGOOOXXXXXXXXXXXXXXXXGOOOOOXXXXXXXXXXXXXXGOOXXXXXXXXXXXXXXXXXGOOOOOOXXXXXXXXXXXXXGOOOOOOOXXXXXXXXXXXX,0,300,0
31773,68,0,68,7,225,0,0,227,216,11,GOOOXXXXXXXXXXXXXXXXGOOOOOXXXXXXXXXXXXXXGOOOOOOOXXXXXXXXXXXXGOXXXXXXXXXXXXXXXXXXGOOOOOOOOOOXXXXXXXXXGOXXXXXXXXXXXXXXXXXXGOOOXXXXXXXXXXXXXXXXGOOXXXXXXXXXXXXXXXXXGOOOXXXXXXXXXXXXXXXXGOOOOOXXXXXXXXXXXXXXGOOXXXXXXXXXXXXXXXXXGOOOOOOXXXXXXXXXXXXXGOOOOOOOXXXXXXXXXXXX,0,300,0
31794,68,0,68,6,226,0,0,228,216,12,GOOOXXXXXXXXXXXXXXXXGOOOOOXXXXXXXXXXXXXXGOOOOOOOXXXXXXXXXXXXGOXXXXXXXXXXXXXXXXXXGOOOOOOOOOOXXXXXXXXXGOXXXXXXXXXXXXXXXXXXGOOOXXXXXXXXXXXXXXXXGOOXXXXXXXXXXXXXXXXXGOOOXXXXXXXXXXXXXXXXGOOOOOXXXXXXXXXXXXXXGOOXXXXXXXXXXXXXXXXXGOOOOOOXXXXXXXXXXXXXGOOOOOOOXXXXXXXXXXXX,0,300,0

31815,68,0,68,5,227,0,0,228,217,11,GOOOXXXXXXXXXXXXXXXXGOOOOOXXXXXXXXXXXXXXGOOOOOOOXXXXXXXXXXXXGOXXXXXXXXXXXXXXXXXXGOOOOOOOOOOXXXXXXXXXGOXXXXXXXXXXXXXXXXXXGOOOXXXXXXXXXXXXXXXXGOOXXXXXXXXXXXXXXXXXGOOOXXXXXXXXXXXXXXXXGOOOOOXXXXXXXXXXXXXXGOOXXXXXXXXXXXXXXXXXGOOOOOOXXXXXXXXXXXXXGOOOOOOOXXXXXXXXXXXX,0,300,0
31836,68,0,68,6,226,0,0,228,216,12,GOOOXXXXXXXXXXXXXXXXGOOOOOXXXXXXXXXXXXXXGOOOOOOOXXXXXXXXXXXXGOXXXXXXXXXXXXXXXXXXGOOOOOOOOOOXXXXXXXXXGOXXXXXXXXXXXXXXXXXXGOOOXXXXXXXXXXXXXXXXGOOXXXXXXXXXXXXXXXXXGOOOXXXXXXXXXXXXXXXXGOOOOOXXXXXXXXXXXXXXGOOXXXXXXXXXXXXXXXXXGOOOOOOXXXXXXXXXXXXXGOOOOOOOXXXXXXXXXXXX,0,300,0
31857,68,0,68,5,227,0,0,229,216,13,GOOOXXXXXXXXXXXXXXXXGOOOOOXXXXXXXXXXXXXXGOOOOOOOXXXXXXXXXXXXGOXXXXXXXXXXXXXXXXXXGOOOOOOOOOOXXXXXXXXXGOXXXXXXXXXXXXXXXXXXGOOOXXXXXXXXXXXXXXXXGOOXXXXXXXXXXXXXXXXXGOOOXXXXXXXXXXXXXXXXGOOOOOXXXXXXXXXXXXXXGOOXXXXXXXXXXXXXXXXXGOOOOOOXXXXXXXXXXXXXGOOOOOOOXXXXXXXXXXXX,0,300,0
31878,68,0,68,5,227,0,0,229,216,13,GOOOXXXXXXXXXXXXXXXXGOOOOOXXXXXXXXXXXXXXGOOOOOOOXXXXXXXXXXXXGOXXXXXXXXXXXXXXXXXXGOOOOOOOOOOXXXXXXXXXGOXXXXXXXXXXXXXXXXXXGOOOXXXXXXXXXXXXXXXXGOOXXXXXXXXXXXXXXXXXGOOOXXXXXXXXXXXXXXXXGOOOOOXXXXXXXXXXXXXXGOOXXXXXXXXXXXXXXXXXGOOOOOOXXXXXXXXXXXXXGOOOOOOOXXXXXXXXXXXX,0,300,0
31899,68,0,68,0,232,0,0,233,216,17,GOOOXXXXXXXXXXXXXXXXGOOOOOXXXXXXXXXXXXXXGOOOOOOOXXXXXXXXXXXXGOXXXXXXXXXXXXXXXXXXGOOOOOOOOOOXXXXXXXXXGOXXXXXXXXXXXXXXXXXXGOOOXXXXXXXXXXXXXXXXGOOXXXXXXXXXXXXXXXXXGOOOXXXXXXXXXXXXXXXXGOOOOOXXXXXXXXXXXXXXGOOXXXXXXXXXXXXXXXXXGOOOOOOXXXXXXXXXXXXXGOOOOOOOXXXXXXXXXXXX,0,300,0

31920,68,0,68,1,231,0,0,233,216,17,GOOOXXXXXXXXXXXXXXXXGOOOOOXXXXXXXXXXXXXXGOOOOOOOXXXXXXXXXXXXGOXXXXXXXXXXXXXXXXXXGOOOOOOOOOOXXXXXXXXXGOXXXXXXXXXXXXXXXXXXGOOOXXXXXXXXXXXXXXXXGOOXXXXXXXXXXXXXXXXXGOOOXXXXXXXXXXXXXXXXGOOOOOXXXXXXXXXXXXXXGOOXXXXXXXXXXXXXXXXXGOOOOOOXXXXXXXXXXXXXGOOOOOOOXXXXXXXXXXXX,0,300,0
31941,68,0,68,1,231,0,0,233,218,15,GOOOXXXXXXXXXXXXXXXXGOOOOOXXXXXXXXXXXXXXGOOOOOOOXXXXXXXXXXXXGOXXXXXXXXXXXXXXXXXXGOOOOOOOOOOXXXXXXXXXGOXXXXXXXXXXXXXXXXXXGOOOXXXXXXXXXXXXXXXXGOOXXXXXXXXXXXXXXXXXGOOOXXXXXXXXXXXXXXXXGOOOOOXXXXXXXXXXXXXXGOOXXXXXXXXXXXXXXXXXGOOOOOOXXXXXXXXXXXXXGOOOOOOOXXXXXXXXXXXX,0,300,0
31962,68,0,68,4,228,0,0,230,217,13,GOOOXXXXXXXXXXXXXXXXGOOOOOXXXXXXXXXXXXXXGOOOOOOOXXXXXXXXXXXXGOXXXXXXXXXXXXXXXXXXGOOOOOOOOOOXXXXXXXXXGOXXXXXXXXXXXXXXXXXXGOOOXXXXXXXXXXXXXXXXGOOXXXXXXXXXXXXXXXXXGOOOXXXXXXXXXXXXXXXXGOOOOOXXXXXXXXXXXXXXGOOXXXXXXXXXXXXXXXXXGOOOOOOXXXXXXXXXXXXXGOOOOOOOXXXXXXXXXXXX,0,300,0
31983,68,0,68,5,227,0,0,229,216,13,GOOOXXXXXXXXXXXXXXXXGOOOOOXXXXXXXXXXXXXXGOOOOOOOXXXXXXXXXXXXGOXXXXXXXXXXXXXXXXXXGOOOOOOOOOOXXXXXXXXXGOXXXXXXXXXXXXXXXXXXGOOOXXXXXXXXXXXXXXXXGOOXXXXXXXXXXXXXXXXXGOOOXXXXXXXXXXXXXXXXGOOOOOXXXXXXXXXXXXXXGOOXXXXXXXXXXXXXXXXXGOOOOOOXXXXXXXXXXXXXGOOOOOOOXXXXXXXXXXXX,0,300,0
32004,68,0,68,5,227,0,0,229,216,13,GOOOXXXXXXXXXXXXXXXXGOOOOOXXXXXXXXXXXXXXGOOOOOOOXXXXXXXXXXXXGOXXXXXXXXXXXXXXXXXXGOOOOOOOOOOXXXXXXXXXGOXXXXXXXXXXXXXXXXXXGOOOXXXXXXXXXXXXXXXXGOOXXXXXXXXXXXXXXXXXGOOOXXXXXXXXXXXXXXXXGOOOOOXXXXXXXXXXXXXXGOOXXXXXXXXXXXXXXXXXGOOOOOOXXXXXXXXXXXXXGOOOOOOOXXXXXXXXXXXX,0,300,0

32025,68,0,68,5,227,0,0,229,218,11,GOOOXXXXXXXXXXXXXXXXGOOOOOXXXXXXXXXXXXXXGOOOOOOOXXXXXXXXXXXXGOXXXXXXXXXXXXXXXXXXGOOOOOOOOOOXXXXXXXXXGOXXXXXXXXXXXXXXXXXXGOOOXXXXXXXXXXXXXXXXGOOXXXXXXXXXXXXXXXXXGOOOXXXXXXXXXXXXXXXXGOOOOOXXXXXXXXXXXXXXGOOXXXXXXXXXXXXXXXXXGOOOOOOXXXXXXXXXXXXXGOOOOOOOXXXXXXXXXXXX,0,300,0
32046,68,0,68,8,224,0,0,226,217,9,GOOOXXXXXXXXXXXXXXXXGOOOOOXXXXXXXXXXXXXXGOOOOOOOXXXXXXXXXXXXGOXXXXXXXXXXXXXXXXXXGOOOOOOOOOOXXXXXXXXXGOXXXXXXXXXXXXXXXXXXGOOOXXXXXXXXXXXXXXXXGOOXXXXXXXXXXXXXXXXXGOOOXXXXXXXXXXXXXXXXGOOOOOXXXXXXXXXXXXXXGOOXXXXXXXXXXXXXXXXXGOOOOOOXXXXXXXXXXXXXGOOOOOOOXXXXXXXXXXXX,0,300,0
32067,68,0,68,7,225,0,0,227,217,10,GOOOXXXXXXXXXXXXXXXXGOOOOOXXXXXXXXXXXXXXGOOOOOOOXXXXXXXXXXXXGOXXXXXXXXXXXXXXXXXXGOOOOOOOOOOXXXXXXXXXGOXXXXXXXXXXXXXXXXXXGOOOXXXXXXXXXXXXXXXXGOOXXXXXXXXXXXXXXXXXGOOOXXXXXXXXXXXXXXXXGOOOOOXXXXXXXXXXXXXXGOOXXXXXXXXXXXXXXXXXGOOOOOOXXXXXXXXXXXXXGOOOOOOOXXXXXXXXXXXX,0,300,0
32088,68,0,68,5,227,0,0,229,218,11,GOOOXXXXXXXXXXXXXXXXGOOOOOXXXXXXXXXXXXXXGOOOOOOOXXXXXXXXXXXXGOXXXXXXXXXXXXXXXXXXGOOOOOOOOOOXXXXXXXXXGOXXXXXXXXXXXXXXXXXXGOOOXXXXXXXXXXXXXXXXGOOXXXXXXXXXXXXXXXXXGOOOXXXXXXXXXXXXXXXXGOOOOOXXXXXXXXXXXXXXGOOXXXXXXXXXXXXXXXXXGOOOOOOXXXXXXXXXXXXXGOOOOOOOXXXXXXXXXXXX,0,300,0
32109,68,0,68,6,226,0,0,228,217,11,GOOOXXXXXXXXXXXXXXXXGOOOOOXXXXXXXXXXXXXXGOOOOOOOXXXXXXXXXXXXGOXXXXXXXXXXXXXXXXXXGOOOOOOOOOOXXXXXXXXXGOXXXXXXXXXXXXXXXXXXGOOOXXXXXXXXXXXXXXXXGOOXXXXXXXXXXXXXXXXXGOOOXXXXXXXXXXXXXXXXGOOOOOXXXXXXXXXXXXXXGOOXXXXXXXXXXXXXXXXXGOOOOOOXXXXXXXXXXXXXGOOOOOOOXXXXXXXXXXXX,0,300,0

32130,68,0,68,6,226,0,0,228,218,10,GOOOXXXXXXXXXXXXXXXXGOOOOOXXXXXXXXXXXXXXGOOOOOOOXXXXXXXXXXXXGOXXXXXXXXXXXXXXXXXXGOOOOOOOOOOXXXXXXXXXGOXXXXXXXXXXXXXXXXXXGOOOXXXXXXXXXXXXXXXXGOOXXXXXXXXXXXXXXXXXGOOOXXXXXXXXXXXXXXXXGOOOOOXXXXXXXXXXXXXXGOOXXXXXXXXXXXXXXXXXGOOOOOOXXXXXXXXXXXXXGOOOOOOOXXXXXXXXXXXX,0,300,0
32151,68,0,68,8,224,0,0,226,216,10,GOOOXXXXXXXXXXXXXXXXGOOOOOXXXXXXXXXXXXXXGOOOOOOOXXXXXXXXXXXXGOXXXXXXXXXXXXXXXXXXGOOOOOOOOOOXXXXXXXXXGOXXXXXXXXXXXXXXXXXXGOOOXXXXXXXXXXXXXXXXGOOXXXXXXXXXXXXXXXXXGOOOXXXXXXXXXXXXXXXXGOOOOOXXXXXXXXXXXXXXGOOXXXXXXXXXXXXXXXXXGOOOOOOXXXXXXXXXXXXXGOOOOOOOXXXXXXXXXXXX,0,300,0
32172,68,0,68,8,224,0,0,226,216,10,GOOOXXXXXXXXXXXXXXXXGOOOOOXXXXXXXXXXXXXXGOOOOOOOXXXXXXXXXXXXGOXXXXXXXXXXXXXXXXXXGOOOOOOOOOOXXXXXXXXXGOXXXXXXXXXXXXXXXXXXGOOOXXXXXXXXXXXXXXXXGOOXXXXXXXXXXXXXXXXXGOOOXXXXXXXXXXXXXXXXGOOOOOXXXXXXXXXXXXXXGOOXXXXXXXXXXXXXXXXXGOOOOOOXXXXXXXXXXXXXGOOOOOOOXXXXXXXXXXXX,0,300,0
32193,68,0,68,8,224,0,0,226,216,10,GOOOXXXXXXXXXXXXXXXXGOOOOOXXXXXXXXXXXXXXGOOOOOOOXXXXXXXXXXXXGOXXXXXXXXXXXXXXXXXXGOOOOOOOOOOXXXXXXXXXGOXXXXXXXXXXXXXXXXXXGOOOXXXXXXXXXXXXXXXXGOOXXXXXXXXXXXXXXXXXGOOOXXXXXXXXXXXXXXXXGOOOOOXXXXXXXXXXXXXXGOOXXXXXXXXXXXXXXXXXGOOOOOOXXXXXXXXXXXXXGOOOOOOOXXXXXXXXXXXX,0,300,0
32214,68,0,68,7,225,0,0,227,217,10,GOOOXXXXXXXXXXXXXXXXGOOOOOXXXXXXXXXXXXXXGOOOOOOOXXXXXXXXXXXXGOXXXXXXXXXXXXXXXXXXGOOOOOOOOOOXXXXXXXXXGOXXXXXXXXXXXXXXXXXXGOOOXXXXXXXXXXXXXXXXGOOXXXXXXXXXXXXXXXXXGOOOXXXXXXXXXXXXXXXXGOOOOOXXXXXXXXXXXXXXGOOXXXXXXXXXXXXXXXXXGOOOOOOXXXXXXXXXXXXXGOOOOOOOXXXXXXXXXXXX,0,300,0

32235,68,0,68,10,222,0,0,224,217,7,GOOOXXXXXXXXXXXXXXXXGOOOOOXXXXXXXXXXXXXXGOOOOOOOXXXXXXXXXXXXGOXXXXXXXXXXXXXXXXXXGOOOOOOOOOOXXXXXXXXXGOXXXXXXXXXXXXXXXXXXGOOOXXXXXXXXXXXXXXXXGOOXXXXXXXXXXXXXXXXXGOOOXXXXXXXXXXXXXXXXGOOOOOXXXXXXXXXXXXXXGOOXXXXXXXXXXXXXXXXXGOOOOOOXXXXXXXXXXXXXGOOOOOOOXXXXXXXXXXXX,0,300,0
32256,68,0,68,9,223,0,0,225,217,8,GOOOXXXXXXXXXXXXXXXXGOOOOOXXXXXXXXXXXXXXGOOOOOOOXXXXXXXXXXXXGOXXXXXXXXXXXXXXXXXXGOOOOOOOOOOXXXXXXXXXGOXXXXXXXXXXXXXXXXXXGOOOXXXXXXXXXXXXXXXXGOOXXXXXXXXXXXXXXXXXGOOOXXXXXXXXXXXXXXXXGOOOOOXXXXXXXXXXXXXXGOOXXXXXXXXXXXXXXXXXGOOOOOOXXXXXXXXXXXXXGOOOOOOOXXXXXXXXXXXX,0,300,0
32277,68,0,68,9,223,0,0,225,216,9,GOOOXXXXXXXXXXXXXXXXGOOOOOXXXXXXXXXXXXXXGOOOOOOOXXXXXXXXXXXXGOXXXXXXXXXXXXXXXXXXGOOOOOOOOOOXXXXXXXXXGOXXXXXXXXXXXXXXXXXXGOOOXXXXXXXXXXXXXXXXGOOXXXXXXXXXXXXXXXXXGOOOXXXXXXXXXXXXXXXXGOOOOOXXXXXXXXXXXXXXGOOXXXXXXXXXXXXXXXXXGOOOOOOXXXXXXXXXXXXXGOOOOOOOXXXXXXXXXXXX,0,300,0
32298,68,0,68,7,225,0,0,227,216,11,GOOOXXXXXXXXXXXXXXXXGOOOOOXXXXXXXXXXXXXXGOOOOOOOXXXXXXXXXXXXGOXXXXXXXXXXXXXXXXXXGOOOOOOOOOOXXXXXXXXXGOXXXXXXXXXXXXXXXXXXGOOOXXXXXXXXXXXXXXXXGOOXXXXXXXXXXXXXXXXXGOOOXXXXXXXXXXXXXXXXGOOOOOXXXXXXXXXXXXXXGOOXXXXXXXXXXXXXXXXXGOOOOOOXXXXXXXXXXXXXGOOOOOOOXXXXXXXXXXXX,0,300,0
32319,68,0,68,5,227,0,0,229,216,13,GOOOXXXXXXXXXXXXXXXXGOOOOOXXXXXXXXXXXXXXGOOOOOOOXXXXXXXXXXXXGOXXXXXXXXXXXXXXXXXXGOOOOOOOOOOXXXXXXXXXGOXXXXXXXXXXXXXXXXXXGOOOXXXXXXXXXXXXXXXXGOOXXXXXXXXXXXXXXXXXGOOOXXXXXXXXXXXXXXXXGOOOOOXXXXXXXXXXXXXXGOOXXXXXXXXXXXXXXXXXGOOOOOOXXXXXXXXXXXXXGOOOOOOOXXXXXXXXXXXX,0,300,0

32340,68,0,68,5,227,0,0,229,216,13,GOOOXXXXXXXXXXXXXXXXGOOOOOXXXXXXXXXXXXXXGOOOOOOOXXXXXXXXXXXXGOXXXXXXXXXXXXXXXXXXGOOOOOOOOOOXXXXXXXXXGOXXXXXXXXXXXXXXXXXXGOOOXXXXXXXXXXXXXXXXGOOXXXXXXXXXXXXXXXXXGOOOXXXXXXXXXXXXXXXXGOOOOOXXXXXXXXXXXXXXGOOXXXXXXXXXXXXXXXXXGOOOOOOXXXXXXXXXXXXXGOOOOOOOXXXXXXXXXXXX,0,300,0
32361,68,0,68,5,227,0,0,229,218,11,GOOOXXXXXXXXXXXXXXXXGOOOOOXXXXXXXXXXXXXXGOOOOOOOXXXXXXXXXXXXGOXXXXXXXXXXXXXXXXXXGOOOOOOOOOOXXXXXXXXXGOXXXXXXXXXXXXXXXXXXGOOOXXXXXXXXXXXXXXXXGOOXXXXXXXXXXXXXXXXXGOOOXXXXXXXXXXXXXXXXGOOOOOXXXXXXXXXXXXXXGOOXXXXXXXXXXXXXXXXXGOOOOOOXXXXXXXXXXXXXGOOOOOOOXXXXXXXXXXXX,0,300,0
32382,68,0,68,6,226,0,0,228,217,11,GOOOXXXXXXXXXXXXXXXXGOOOOOXXXXXXXXXXXXXXGOOOOOOOXXXXXXXXXXXXGOXXXXXXXXXXXXXXXXXXGOOOOOOOOOOXXXXXXXXXGOXXXXXXXXXXXXXXXXXXGOOOXXXXXXXXXXXXXXXXGOOXXXXXXXXXXXXXXXXXGOOOXXXXXXXXXXXXXXXXGOOOOOXXXXXXXXXXXXXXGOOXXXXXXXXXXXXXXXXXGOOOOOOXXXXXXXXXXXXXGOOOOOOOXXXXXXXXXXXX,0,300,0
32403,68,0,68,7,225,0,0,227,217,10,GOOOXXXXXXXXXXXXXXXXGOOOOOXXXXXXXXXXXXXXGOOOOOOOXXXXXXXXXXXXGOXXXXXXXXXXXXXXXXXXGOOOOOOOOOOXXXXXXXXXGOXXXXXXXXXXXXXXXXXXGOOOXXXXXXXXXXXXXXXXGOOXXXXXXXXXXXXXXXXXGOOOXXXXXXXXXXXXXXXXGOOOOOXXXXXXXXXXXXXXGOOXXXXXXXXXXXXXXXXXGOOOOOOXXXXXXXXXXXXXGOOOOOOOXXXXXXXXXXXX,0,300,0
32424,68,0,68,6,226,0,0,228,216,12,GOOOXXXXXXXXXXXXXXXXGOOOOOXXXXXXXXXXXXXXGOOOOOOOXXXXXXXXXXXXGOXXXXXXXXXXXXXXXXXXGOOOOOOOOOOXXXXXXXXXGOXXXXXXXXXXXXXXXXXXGOOOXXXXXXXXXXXXXXXXGOOXXXXXXXXXXXXXXXXXGOOOXXXXXXXXXXXXXXXXGOOOOOXXXXXXXXXXXXXXGOOXXXXXXXXXXXXXXXXXGOOOOOOXXXXXXXXXXXXXGOOOOOOOXXXXXXXXXXXX,0,300,0

32445,68,0,68,5,227,0,0,229,216,13,GOOOXXXXXXXXXXXXXXXXGOOOOOXXXXXXXXXXXXXXGOOOOOOOXXXXXXXXXXXXGOXXXXXXXXXXXXXXXXXXGOOOOOOOOOOXXXXXXXXXGOXXXXXXXXXXXXXXXXXXGOOOXXXXXXXXXXXXXXXXGOOXXXXXXXXXXXXXXXXXGOOOXXXXXXXXXXXXXXXXGOOOOOXXXXXXXXXXXXXXGOOXXXXXXXXXXXXXXXXXGOOOOOOXXXXXXXXXXXXXGOOOOOOOXXXXXXXXXXXX,0,300,0
32466,68,0,68,4,228,0,0,230,217,13,GOOOXXXXXXXXXXXXXXXXGOOOOOXXXXXXXXXXXXXXGOOOOOOOXXXXXXXXXXXXGOXXXXXXXXXXXXXXXXXXGOOOOOOOOOOXXXXXXXXXGOXXXXXXXXXXXXXXXXXXGOOOXXXXXXXXXXXXXXXXGOOXXXXXXXXXXXXXXXXXGOOOXXXXXXXXXXXXXXXXGOOOOOXXXXXXXXXXXXXXGOOXXXXXXXXXXXXXXXXXGOOOOOOXXXXXXXXXXXXXGOOOOOOOXXXXXXXXXXXX,0,300,0
32487,68,0,68,4,228,0,0,230,216,14,GOOOXXXXXXXXXXXXXXXXGOOOOOXXXXXXXXXXXXXXGOOOOOOOXXXXXXXXXXXXGOXXXXXXXXXXXXXXXXXXGOOOOOOOOOOXXXXXXXXXGOXXXXXXXXXXXXXXXXXXGOOOXXXXXXXXXXXXXXXXGOOXXXXXXXXXXXXXXXXXGOOOXXXXXXXXXXXXXXXXGOOOOOXXXXXXXXXXXXXXGOOXXXXXXXXXXXXXXXXXGOOOOOOXXXXXXXXXXXXXGOOOOOOOXXXXXXXXXXXX,0,300,0
32508,68,0,68,4,228,0,0,230,217,13,GOOOXXXXXXXXXXXXXXXXGOOOOOXXXXXXXXXXXXXXGOOOOOOOXXXXXXXXXXXXGOXXXXXXXXXXXXXXXXXXGOOOOOOOOOOXXXXXXXXXGOXXXXXXXXXXXXXXXXXXGOOOXXXXXXXXXXXXXXXXGOOXXXXXXXXXXXXXXXXXGOOOXXXXXXXXXXXXXXXXGOOOOOXXXXXXXXXXXXXXGOOXXXXXXXXXXXXXXXXXGOOOOOOXXXXXXXXXXXXXGOOOOOOOXXXXXXXXXXXX,0,300,0
32529,68,0,68,3,229,0,0,231,218,13,GOOOXXXXXXXXXXXXXXXXGOOOOOXXXXXXXXXXXXXXGOOOOOOOXXXXXXXXXXXXGOXXXXXXXXXXXXXXXXXXGOOOOOOOOOOXXXXXXXXXGOXXXXXXXXXXXXXXXXXXGOOOXXXXXXXXXXXXXXXXGOOXXXXXXXXXXXXXXXXXGOOOXXXXXXXXXXXXXXXXGOOOOOXXXXXXXXXXXXXXGOOXXXXXXXXXXXXXXXXXGOOOOOOXXXXXXXXXXXXXGOOOOOOOXXXXXXXXXXXX,0,300,0

32550,68,0,68,3,229,0,0,231,217,14,GOOOXXXXXXXXXXXXXXXXGOOOOOXXXXXXXXXXXXXXGOOOOOOOXXXXXXXXXXXXGOXXXXXXXXXXXXXXXXXXGOOOOOOOOOOXXXXXXXXXGOXXXXXXXXXXXXXXXXXXGOOOXXXXXXXXXXXXXXXXGOOXXXXXXXXXXXXXXXXXGOOOXXXXXXXXXXXXXXXXGOOOOOXXXXXXXXXXXXXXGOOXXXXXXXXXXXXXXXXXGOOOOOOXXXXXXXXXXXXXGOOOOOOOXXXXXXXXXXXX,0,300,0
32571,68,0,68,4,228,0,0,230,216,14,GOOOXXXXXXXXXXXXXXXXGOOOOOXXXXXXXXXXXXXXGOOOOOOOXXXXXXXXXXXXGOXXXXXXXXXXXXXXXXXXGOOOOOOOOOOXXXXXXXXXGOXXXXXXXXXXXXXXXXXXGOOOXXXXXXXXXXXXXXXXGOOXXXXXXXXXXXXXXXXXGOOOXXXXXXXXXXXXXXXXGOOOOOXXXXXXXXXXXXXXGOOXXXXXXXXXXXXXXXXXGOOOOOOXXXXXXXXXXXXXGOOOOOOOXXXXXXXXXXXX,0,300,0
32592,68,0,68,4,228,0,0,230,216,14,GOOOXXXXXXXXXXXXXXXXGOOOOOXXXXXXXXXXXXXXGOOOOOOOXXXXXXXXXXXXGOXXXXXXXXXXXXXXXXXXGOOOOOOOOOOXXXXXXXXXGOXXXXXXXXXXXXXXXXXXGOOOXXXXXXXXXXXXXXXXGOOXXXXXXXXXXXXXXXXXGOOOXXXXXXXXXXXXXXXXGOOOOOXXXXXXXXXXXXXXGOOXXXXXXXXXXXXXXXXXGOOOOOOXXXXXXXXXXXXXGOOOOOOOXXXXXXXXXXXX,0,300,0
32613,68,0,68,3,229,0,0,231,217,14,GOOOXXXXXXXXXXXXXXXXGOOOOOXXXXXXXXXXXXXXGOOOOOOOXXXXXXXXXXXXGOXXXXXXXXXXXXXXXXXXGOOOOOOOOOOXXXXXXXXXGOXXXXXXXXXXXXXXXXXXGOOOXXXXXXXXXXXXXXXXGOOXXXXXXXXXXXXXXXXXGOOOXXXXXXXXXXXXXXXXGOOOOOXXXXXXXXXXXXXXGOOXXXXXXXXXXXXXXXXXGOOOOOOXXXXXXXXXXXXXGOOOOOOOXXXXXXXXXXXX,0,300,0
32634,68,0,68,4,228,0,0,230,218,12,GOOOXXXXXXXXXXXXXXXXGOOOOOXXXXXXXXXXXXXXGOOOOOOOXXXXXXXXXXXXGOXXXXXXXXXXXXXXXXXXGOOOOOOOOOOXXXXXXXXXGOXXXXXXXXXXXXXXXXXXGOOOXXXXXXXXXXXXXXXXGOOXXXXXXXXXXXXXXXXXGOOOXXXXXXXXXXXXXXXXGOOOOOXXXXXXXXXXXXXXGOOXXXXXXXXXXXXXXXXXGOOOOOOXXXXXXXXXXXXXGOOOOOOOXXXXXXXXXXXX,0,300,0

32655,68,0,68,6,226,0,0,228,217,11,GOOOXXXXXXXXXXXXXXXXGOOOOOXXXXXXXXXXXXXXGOOOOOOOXXXXXXXXXXXXGOXXXXXXXXXXXXXXXXXXGOOOOOOOOOOXXXXXXXXXGOXXXXXXXXXXXXXXXXXXGOOOXXXXXXXXXXXXXXXXGOOXXXXXXXXXXXXXXXXXGOOOXXXXXXXXXXXXXXXXGOOOOOXXXXXXXXXXXXXXGOOXXXXXXXXXXXXXXXXXGOOOOOOXXXXXXXXXXXXXGOOOOOOOXXXXXXXXXXXX,0,300,0
32676,68,0,68,7,225,0,0,227,216,11,GOOOXXXXXXXXXXXXXXXXGOOOOOXXXXXXXXXXXXXXGOOOOOOOXXXXXXXXXXXXGOXXXXXXXXXXXXXXXXXXGOOOOOOOOOOXXXXXXXXXGOXXXXXXXXXXXXXXXXXXGOOOXXXXXXXXXXXXXXXXGOOXXXXXXXXXXXXXXXXXGOOOXXXXXXXXXXXXXXXXGOOOOOXXXXXXXXXXXXXXGOOXXXXXXXXXXXXXXXXXGOOOOOOXXXXXXXXXXXXXGOOOOOOOXXXXXXXXXXXX,0,300,0
32697,68,0,68,7,225,0,0,227,218,9,GOOOXXXXXXXXXXXXXXXXGOOOOOXXXXXXXXXXXXXXGOOOOOOOXXXXXXXXXXXXGOXXXXXXXXXXXXXXXXXXGOOOOOOOOOOXXXXXXXXXGOXXXXXXXXXXXXXXXXXXGOOOXXXXXXXXXXXXXXXXGOOXXXXXXXXXXXXXXXXXGOOOXXXXXXXXXXXXXXXXGOOOOOXXXXXXXXXXXXXXGOOXXXXXXXXXXXXXXXXXGOOOOOOXXXXXXXXXXXXXGOOOOOOOXXXXXXXXXXXX,0,300,0
32718,68,0,68,8,224,0,0,225,216,9,GOOOXXXXXXXXXXXXXXXXGOOOOOXXXXXXXXXXXXXXGOOOOOOOXXXXXXXXXXXXGOXXXXXXXXXXXXXXXXXXGOOOOOOOOOOXXXXXXXXXGOXXXXXXXXXXXXXXXXXXGOOOXXXXXXXXXXXXXXXXGOOXXXXXXXXXXXXXXXXXGOOOXXXXXXXXXXXXXXXXGOOOOOXXXXXXXXXXXXXXGOOXXXXXXXXXXXXXXXXXGOOOOOOXXXXXXXXXXXXXGOOOOOOOXXXXXXXXXXXX,0,300,0
32739,68,0,68,9,223,0,0,225,216,9,GOOOXXXXXXXXXXXXXXXXGOOOOOXXXXXXXXXXXXXXGOOOOOOOXXXXXXXXXXXXGOXXXXXXXXXXXXXXXXXXGOOOOOOOOOOXXXXXXXXXGOXXXXXXXXXXXXXXXXXXGOOOXXXXXXXXXXXXXXXXGOOXXXXXXXXXXXXXXXXXGOOOXXXXXXXXXXXXXXXXGOOOOOXXXXXXXXXXXXXXGOOXXXXXXXXXXXXXXXXXGOOOOOOXXXXXXXXXXXXXGOOOOOOOXXXXXXXXXXXX,0,300,0

32760,68,0,68,10,222,0,0,224,216,8,GOOOXXXXXXXXXXXXXXXXGOOOOOXXXXXXXXXXXXXXGOOOOOOOXXXXXXXXXXXXGOXXXXXXXXXXXXXXXXXXGOOOOOOOOOOXXXXXXXXXGOXXXXXXXXXXXXXXXXXXGOOOXXXXXXXXXXXXXXXXGOOXXXXXXXXXXXXXXXXXGOOOXXXXXXXXXXXXXXXXGOOOOOXXXXXXXXXXXXXXGOOXXXXXXXXXXXXXXXXXGOOOOOOXXXXXXXXXXXXXGOOOOOOOXXXXXXXXXXXX,0,300,0
32781,68,0,68,9,223,0,0,225,217,8,GOOOXXXXXXXXXXXXXXXXGOOOOOXXXXXXXXXXXXXXGOOOOOOOXXXXXXXXXXXXGOXXXXXXXXXXXXXXXXXXGOOOOOOOOOOXXXXXXXXXGOXXXXXXXXXXXXXXXXXXGOOOXXXXXXXXXXXXXXXXGOOXXXXXXXXXXXXXXXXXGOOOXXXXXXXXXXXXXXXXGOOOOOXXXXXXXXXXXXXXGOOXXXXXXXXXXXXXXXXXGOOOOOOXXXXXXXXXXXXXGOOOOOOOXXXXXXXXXXXX,0,300,0
32802,68,0,68,11,221,0,0,223,216,7,GOOOXXXXXXXXXXXXXXXXGOOOOOXXXXXXXXXXXXXXGOOOOOOOXXXXXXXXXXXXGOXXXXXXXXXXXXXXXXXXGOOOOOOOOOOXXXXXXXXXGOXXXXXXXXXXXXXXXXXXGOOOXXXXXXXXXXXXXXXXGOOXXXXXXXXXXXXXXXXXGOOOXXXXXXXXXXXXXXXXGOOOOOXXXXXXXXXXXXXXGOOXXXXXXXXXXXXXXXXXGOOOOOOXXXXXXXXXXXXXGOOOOOOOXXXXXXXXXXXX,0,300,0
32823,68,0,68,11,221,0,0,223,217,6,GOOOXXXXXXXXXXXXXXXXGOOOOOXXXXXXXXXXXXXXGOOOOOOOXXXXXXXXXXXXGOXXXXXXXXXXXXXXXXXXGOOOOOOOOOOXXXXXXXXXGOXXXXXXXXXXXXXXXXXXGOOOXXXXXXXXXXXXXXXXGOOXXXXXXXXXXXXXXXXXGOOOXXXXXXXXXXXXXXXXGOOOOOXXXXXXXXXXXXXXGOOXXXXXXXXXXXXXXXXXGOOOOOOXXXXXXXXXXXXXGOOOOOOOXXXXXXXXXXXX,0,300,0
32844,68,0,68,8,224,0,0,226,217,9,GOOOXXXXXXXXXXXXXXXXGOOOOOXXXXXXXXXXXXXXGOOOOOOOXXXXXXXXXXXXGOXXXXXXXXXXXXXXXXXXGOOOOOOOOOOXXXXXXXXXGOXXXXXXXXXXXXXXXXXXGOOOXXXXXXXXXXXXXXXXGOOXXXXXXXXXXXXXXXXXGOOOXXXXXXXXXXXXXXXXGOOOOOXXXXXXXXXXXXXXGOOXXXXXXXXXXXXXXXXXGOOOOOOXXXXXXXXXXXXXGOOOOOOOXXXXXXXXXXXX,0,300,0

32865,68,0,68,5,227,0,0,229,217,12,GOOOXXXXXXXXXXXXXXXXGOOOOOXXXXXXXXXXXXXXGOOOOOOOXXXXXXXXXXXXGOXXXXXXXXXXXXXXXXXXGOOOOOOOOOOXXXXXXXXXGOXXXXXXXXXXXXXXXXXXGOOOXXXXXXXXXXXXXXXXGOOXXXXXXXXXXXXXXXXXGOOOXXXXXXXXXXXXXXXXGOOOOOXXXXXXXXXXXXXXGOOXXXXXXXXXXXXXXXXXGOOOOOOXXXXXXXXXXXXXGOOOOOOOXXXXXXXXXXXX,0,300,0
32886,69,1,68,3,228,0,0,230,217,13,GOOOXXXXXXXXXXXXXXXXGOOOOOXXXXXXXXXXXXXXGOOOOOOOXXXXXXXXXXXXGOXXXXXXXXXXXXXXXXXXGOOOOOOOOOOXXXXXXXXXGOXXXXXXXXXXXXXXXXXXGOOOXXXXXXXXXXXXXXXXGOOXXXXXXXXXXXXXXXXXGOOOXXXXXXXXXXXXXXXXGOOOOOXXXXXXXXXXXXXXGOOXXXXXXXXXXXXXXXXXGOOOOOOXXXXXXXXXXXXXGOOOOOOOAXXXXXXXXXXX,0,300,0
32907,69,0,69,3,228,0,0,230,217,13,GOOOXXXXXXXXXXXXXXXXGOOOOOXXXXXXXXXXXXXXGOOOOOOOXXXXXXXXXXXXGOXXXXXXXXXXXXXXXXXXGOOOOOOOOOOXXXXXXXXXGOXXXXXXXXXXXXXXXXXXGOOOXXXXXXXXXXXXXXXXGOOXXXXXXXXXXXXXXXXXGOOOXXXXXXXXXXXXXXXXGOOOOOXXXXXXXXXXXXXXGOOXXXXXXXXXXXXXXXXXGOOOOOOXXXXXXXXXXXXXGOOOOOOOOXXXXXXXXXXX,0,300,0
32928,69,0,69,3,228,0,0,230,217,13,GOOOXXXXXXXXXXXXXXXXGOOOOOXXXXXXXXXXXXXXGOOOOOOOXXXXXXXXXXXXGOXXXXXXXXXXXXXXXXXXGOOOOOOOOOOXXXXXXXXXGOXXXXXXXXXXXXXXXXXXGOOOXXXXXXXXXXXXXXXXGOOXXXXXXXXXXXXXXXXXGOOOXXXXXXXXXXXXXXXXGOOOOOXXXXXXXXXXXXXXGOOXXXXXXXXXXXXXXXXXGOOOOOOXXXXXXXXXXXXXGOOOOOOOOXXXXXXXXXXX,0,300,0
32949,69,0,69,3,228,0,0,230,217,13,GOOOXXXXXXXXXXXXXXXXGOOOOOXXXXXXXXXXXXXXGOOOOOOOXXXXXXXXXXXXGOXXXXXXXXXXXXXXXXXXGOOOOOOOOOOXXXXXXXXXGOXXXXXXXXXXXXXXXXXXGOOOXXXXXXXXXXXXXXXXGOOXXXXXXXXXXXXXXXXXGOOOXXXXXXXXXXXXXXXXGOOOOOXXXXXXXXXXXXXXGOOXXXXXXXXXXXXXXXXXGOOOOOOXXXXXXXXXXXXXGOOOOOOOOXXXXXXXXXXX,0,300,0

32970,69,0,69,3,228,0,0,230,218,12,GOOOXXXXXXXXXXXXXXXXGOOOOOXXXXXXXXXXXXXXGOOOOOOOXXXXXXXXXXXXGOXXXXXXXXXXXXXXXXXXGOOOOOOOOOOXXXXXXXXXGOXXXXXXXXXXXXXXXXXXGOOOXXXXXXXXXXXXXXXXGOOXXXXXXXXXXXXXXXXXGOOOXXXXXXXXXXXXXXXXGOOOOOXXXXXXXXXXXXXXGOOXXXXXXXXXXXXXXXXXGOOOOOOXXXXXXXXXXXXXGOOOOOOOOXXXXXXXXXXX,0,300,0
32991,69,0,69,4,227,0,0,229,217,12,GOOOXXXXXXXXXXXXXXXXGOOOOOXXXXXXXXXXXXXXGOOOOOOOXXXXXXXXXXXXGOXXXXXXXXXXXXXXXXXXGOOOOOOOOOOXXXXXXXXXGOXXXXXXXXXXXXXXXXXXGOOOXXXXXXXXXXXXXXXXGOOXXXXXXXXXXXXXXXXXGOOOXXXXXXXXXXXXXXXXGOOOOOXXXXXXXXXXXXXXGOOXXXXXXXXXXXXXXXXXGOOOOOOXXXXXXXXXXXXXGOOOOOOOOXXXXXXXXXXX,0,300,0
33012,69,0,69,4,227,0,0,229,217,12,GOOOXXXXXXXXXXXXXXXXGOOOOOXXXXXXXXXXXXXXGOOOOOOOXXXXXXXXXXXXGOXXXXXXXXXXXXXXXXXXGOOOOOOOOOOXXXXXXXXXGOXXXXXXXXXXXXXXXXXXGOOOXXXXXXXXXXXXXXXXGOOXXXXXXXXXXXXXXXXXGOOOXXXXXXXXXXXXXXXXGOOOOOXXXXXXXXXXXXXXGOOXXXXXXXXXXXXXXXXXGOOOOOOXXXXXXXXXXXXXGOOOOOOOOXXXXXXXXXXX,0,300,0
33033,69,0,69,5,226,0,0,228,217,11,GOOOXXXXXXXXXXXXXXXXGOOOOOXXXXXXXXXXXXXXGOOOOOOOXXXXXXXXXXXXGOXXXXXXXXXXXXXXXXXXGOOOOOOOOOOXXXXXXXXXGOXXXXXXXXXXXXXXXXXXGOOOXXXXXXXXXXXXXXXXGOOXXXXXXXXXXXXXXXXXGOOOXXXXXXXXXXXXXXXXGOOOOOXXXXXXXXXXXXXXGOOXXXXXXXXXXXXXXXXXGOOOOOOXXXXXXXXXXXXXGOOOOOOOOXXXXXXXXXXX,0,300,0
33054,69,0,69,6,225,0,0,227,217,10,GOOOXXXXXXXXXXXXXXXXGOOOOOXXXXXXXXXXXXXXGOOOOOOOXXXXXXXXXXXXGOXXXXXXXXXXXXXXXXXXGOOOOOOOOOOXXXXXXXXXGOXXXXXXXXXXXXXXXXXXGOOOXXXXXXXXXXXXXXXXGOOXXXXXXXXXXXXXXXXXGOOOXXXXXXXXXXXXXXXXGOOOOOXXXXXXXXXXXXXXGOOXXXXXXXXXXXXXXXXXGOOOOOOXXXXXXXXXXXXXGOOOOOOOOXXXXXXXXXXX,0,300,0

33075,69,0,69,7,224,0,0,226,217,9,GOOOXXXXXXXXXXXXXXXXGOOOOOXXXXXXXXXXXXXXGOOOOOOOXXXXXXXXXXXXGOXXXXXXXXXXXXXXXXXXGOOOOOOOOOOXXXXXXXXXGOXXXXXXXXXXXXXXXXXXGOOOXXXXXXXXXXXXXXXXGOOXXXXXXXXXXXXXXXXXGOOOXXXXXXXXXXXXXXXXGOOOOOXXXXXXXXXXXXXXGOOXXXXXXXXXXXXXXXXXGOOOOOOXXXXXXXXXXXXXGOOOOOOOOXXXXXXXXXXX,0,300,0
33096,69,0,69,6,225,0,0,228,217,11,GOOOXXXXXXXXXXXXXXXXGOOOOOXXXXXXXXXXXXXXGOOOOOOOXXXXXXXXXXXXGOXXXXXXXXXXXXXXXXXXGOOOOOOOOOOXXXXXXXXXGOXXXXXXXXXXXXXXXXXXGOOOXXXXXXXXXXXXXXXXGOOXXXXXXXXXXXXXXXXXGOOOXXXXXXXXXXXXXXXXGOOOOOXXXXXXXXXXXXXXGOOXXXXXXXXXXXXXXXXXGOOOOOOXXXXXXXXXXXXXGOOOOOOOOXXXXXXXXXXX,0,300,0
33117,69,0,69,6,225,0,0,228,218,10,GOOOXXXXXXXXXXXXXXXXGOOOOOXXXXXXXXXXXXXXGOOOOOOOXXXXXXXXXXXXGOXXXXXXXXXXXXXXXXXXGOOOOOOOOOOXXXXXXXXXGOXXXXXXXXXXXXXXXXXXGOOOXXXXXXXXXXXXXXXXGOOXXXXXXXXXXXXXXXXXGOOOXXXXXXXXXXXXXXXXGOOOOOXXXXXXXXXXXXXXGOOXXXXXXXXXXXXXXXXXGOOOOOOXXXXXXXXXXXXXGOOOOOOOOXXXXXXXXXXX,0,300,0
33138,69,0,69,5,226,0,0,229,219,10,GOOOXXXXXXXXXXXXXXXXGOOOOOXXXXXXXXXXXXXXGOOOOOOOXXXXXXXXXXXXGOXXXXXXXXXXXXXXXXXXGOOOOOOOOOOXXXXXXXXXGOXXXXXXXXXXXXXXXXXXGOOOXXXXXXXXXXXXXXXXGOOXXXXXXXXXXXXXXXXXGOOOXXXXXXXXXXXXXXXXGOOOOOXXXXXXXXXXXXXXGOOXXXXXXXXXXXXXXXXXGOOOOOOXXXXXXXXXXXXXGOOOOOOOOXXXXXXXXXXX,0,300,0
33159,69,0,69,6,225,0,0,228,218,10,GOOOXXXXXXXXXXXXXXXXGOOOOOXXXXXXXXXXXXXXGOOOOOOOXXXXXXXXXXXXGOXXXXXXXXXXXXXXXXXXGOOOOOOOOOOXXXXXXXXXGOXXXXXXXXXXXXXXXXXXGOOOXXXXXXXXXXXXXXXXGOOXXXXXXXXXXXXXXXXXGOOOXXXXXXXXXXXXXXXXGOOOOOXXXXXXXXXXXXXXGOOXXXXXXXXXXXXXXXXXGOOOOOOXXXXXXXXXXXXXGOOOOOOOOXXXXXXXXXXX,0,300,0

33180,69,0,69,6,225,0,0,228,218,10,GOOOXXXXXXXXXXXXXXXXGOOOOOXXXXXXXXXXXXXXGOOOOOOOXXXXXXXXXXXXGOXXXXXXXXXXXXXXXXXXGOOOOOOOOOOXXXXXXXXXGOXXXXXXXXXXXXXXXXXXGOOOXXXXXXXXXXXXXXXXGOOXXXXXXXXXXXXXXXXXGOOOXXXXXXXXXXXXXXXXGOOOOOXXXXXXXXXXXXXXGOOXXXXXXXXXXXXXXXXXGOOOOOOXXXXXXXXXXXXXGOOOOOOOOXXXXXXXXXXX,0,300,0
33201,69,0,69,6,225,0,0,228,219,9,GOOOXXXXXXXXXXXXXXXXGOOOOOXXXXXXXXXXXXXXGOOOOOOOXXXXXXXXXXXXGOXXXXXXXXXXXXXXXXXXGOOOOOOOOOOXXXXXXXXXGOXXXXXXXXXXXXXXXXXXGOOOXXXXXXXXXXXXXXXXGOOXXXXXXXXXXXXXXXXXGOOOXXXXXXXXXXXXXXXXGOOOOOXXXXXXXXXXXXXXGOOXXXXXXXXXXXXXXXXXGOOOOOOXXXXXXXXXXXXXGOOOOOOOOXXXXXXXXXXX,0,300,0
33222,69,0,69,7,224,0,0,227,218,9,GOOOXXXXXXXXXXXXXXXXGOOOOOXXXXXXXXXXXXXXGOOOOOOOXXXXXXXXXXXXGOXXXXXXXXXXXXXXXXXXGOOOOOOOOOOXXXXXXXXXGOXXXXXXXXXXXXXXXXXXGOOOXXXXXXXXXXXXXXXXGOOXXXXXXXXXXXXXXXXXGOOOXXXXXXXXXXXXXXXXGOOOOOXXXXXXXXXXXXXXGOOXXXXXXXXXXXXXXXXXGOOOOOOXXXXXXXXXXXXXGOOOOOOOOXXXXXXXXXXX,0,300,0
33243,69,0,69,6,225,0,0,227,219,8,GOOOXXXXXXXXXXXXXXXXGOOOOOXXXXXXXXXXXXXXGOOOOOOOXXXXXXXXXXXXGOXXXXXXXXXXXXXXXXXXGOOOOOOOOOOXXXXXXXXXGOXXXXXXXXXXXXXXXXXXGOOOXXXXXXXXXXXXXXXXGOOXXXXXXXXXXXXXXXXXGOOOXXXXXXXXXXXXXXXXGOOOOOXXXXXXXXXXXXXXGOOXXXXXXXXXXXXXXXXXGOOOOOOXXXXXXXXXXXXXGOOOOOOOOXXXXXXXXXXX,0,300,0
33264,69,0,69,7,224,0,0,227,218,9,GOOOXXXXXXXXXXXXXXXXGOOOOOXXXXXXXXXXXXXXGOOOOOOOXXXXXXXXXXXXGOXXXXXXXXXXXXXXXXXXGOOOOOOOOOOXXXXXXXXXGOXXXXXXXXXXXXXXXXXXGOOOXXXXXXXXXXXXXXXXGOOXXXXXXXXXXXXXXXXXGOOOXXXXXXXXXXXXXXXXGOOOOOXXXXXXXXXXXXXXGOOXXXXXXXXXXXXXXXXXGOOOOOOXXXXXXXXXXXXXGOOOOOOOOXXXXXXXXXXX,0,300,0

33285,69,0,69,8,223,0,0,226,220,6,GOOOXXXXXXXXXXXXXXXXGOOOOOXXXXXXXXXXXXXXGOOOOOOOXXXXXXXXXXXXGOXXXXXXXXXXXXXXXXXXGOOOOOOOOOOXXXXXXXXXGOXXXXXXXXXXXXXXXXXXGOOOXXXXXXXXXXXXXXXXGOOXXXXXXXXXXXXXXXXXGOOOXXXXXXXXXXXXXXXXGOOOOOXXXXXXXXXXXXXXGOOXXXXXXXXXXXXXXXXXGOOOOOOXXXXXXXXXXXXXGOOOOOOOOXXXXXXXXXXX,0,300,0
33306,69,0,69,10,221,0,0,224,219,5,GOOOXXXXXXXXXXXXXXXXGOOOOOXXXXXXXXXXXXXXGOOOOOOOXXXXXXXXXXXXGOXXXXXXXXXXXXXXXXXXGOOOOOOOOOOXXXXXXXXXGOXXXXXXXXXXXXXXXXXXGOOOXXXXXXXXXXXXXXXXGOOXXXXXXXXXXXXXXXXXGOOOXXXXXXXXXXXXXXXXGOOOOOXXXXXXXXXXXXXXGOOXXXXXXXXXXXXXXXXXGOOOOOOXXXXXXXXXXXXXGOOOOOOOOXXXXXXXXXXX,0,300,0
33327,69,0,69,10,221,0,0,224,218,6,GOOOXXXXXXXXXXXXXXXXGOOOOOXXXXXXXXXXXXXXGOOOOOOOXXXXXXXXXXXXGOXXXXXXXXXXXXXXXXXXGOOOOOOOOOOXXXXXXXXXGOXXXXXXXXXXXXXXXXXXGOOOXXXXXXXXXXXXXXXXGOOXXXXXXXXXXXXXXXXXGOOOXXXXXXXXXXXXXXXXGOOOOOXXXXXXXXXXXXXXGOOXXXXXXXXXXXXXXXXXGOOOOOOXXXXXXXXXXXXXGOOOOOOOOXXXXXXXXXXX,0,300,0
33348,69,0,69,9,222,0,0,225,218,7,GOOOXXXXXXXXXXXXXXXXGOOOOOXXXXXXXXXXXXXXGOOOOOOOXXXXXXXXXXXXGOXXXXXXXXXXXXXXXXXXGOOOOOOOOOOXXXXXXXXXGOXXXXXXXXXXXXXXXXXXGOOOXXXXXXXXXXXXXXXXGOOXXXXXXXXXXXXXXXXXGOOOXXXXXXXXXXXXXXXXGOOOOOXXXXXXXXXXXXXXGOOXXXXXXXXXXXXXXXXXGOOOOOOXXXXXXXXXXXXXGOOOOOOOOXXXXXXXXXXX,0,300,0
33369,69,0,69,8,223,0,0,226,218,8,GOOOXXXXXXXXXXXXXXXXGOOOOOXXXXXXXXXXXXXXGOOOOOOOXXXXXXXXXXXXGOXXXXXXXXXXXXXXXXXXGOOOOOOOOOOXXXXXXXXXGOXXXXXXXXXXXXXXXXXXGOOOXXXXXXXXXXXXXXXXGOOXXXXXXXXXXXXXXXXXGOOOXXXXXXXXXXXXXXXXGOOOOOXXXXXXXXXXXXXXGOOXXXXXXXXXXXXXXXXXGOOOOOOXXXXXXXXXXXXXGOOOOOOOOXXXXXXXXXXX,0,300,0

33390,69,0,69,8,223,0,0,226,218,8,GOOOXXXXXXXXXXXXXXXXGOOOOOXXXXXXXXXXXXXXGOOOOOOOXXXXXXXXXXXXGOXXXXXXXXXXXXXXXXXXGOOOOOOOOOOXXXXXXXXXGOXXXXXXXXXXXXXXXXXXGOOOXXXXXXXXXXXXXXXXGOOXXXXXXXXXXXXXXXXXGOOOXXXXXXXXXXXXXXXXGOOOOOXXXXXXXXXXXXXXGOOXXXXXXXXXXXXXXXXXGOOOOOOXXXXXXXXXXXXXGOOOOOOOOXXXXXXXXXXX,0,300,0
33411,69,0,69,8,223,0,0,226,218,8,GOOOXXXXXXXXXXXXXXXXGOOOOOXXXXXXXXXXXXXXGOOOOOOOXXXXXXXXXXXXGOXXXXXXXXXXXXXXXXXXGOOOOOOOOOOXXXXXXXXXGOXXXXXXXXXXXXXXXXXXGOOOXXXXXXXXXXXXXXXXGOOXXXXXXXXXXXXXXXXXGOOOXXXXXXXXXXXXXXXXGOOOOOXXXXXXXXXXXXXXGOOXXXXXXXXXXXXXXXXXGOOOOOOXXXXXXXXXXXXXGOOOOOOOOXXXXXXXXXXX,0,300,0
33432,69,0,69,5,226,0,0,227,218,9,GOOOXXXXXXXXXXXXXXXXGOOOOOXXXXXXXXXXXXXXGOOOOOOOXXXXXXXXXXXXGOXXXXXXXXXXXXXXXXXXGOOOOOOOOOOXXXXXXXXXGOXXXXXXXXXXXXXXXXXXGOOOXXXXXXXXXXXXXXXXGOOXXXXXXXXXXXXXXXXXGOOOXXXXXXXXXXXXXXXXGOOOOOXXXXXXXXXXXXXXGOOXXXXXXXXXXXXXXXXXGOOOOOOXXXXXXXXXXXXXGOOOOOOOOXXXXXXXXXXX,0,300,0
33453,69,0,69,4,227,0,0,229,218,11,GOOOXXXXXXXXXXXXXXXXGOOOOOXXXXXXXXXXXXXXGOOOOOOOXXXXXXXXXXXXGOXXXXXXXXXXXXXXXXXXGOOOOOOOOOOXXXXXXXXXGOXXXXXXXXXXXXXXXXXXGOOOXXXXXXXXXXXXXXXXGOOXXXXXXXXXXXXXXXXXGOOOXXXXXXXXXXXXXXXXGOOOOOXXXXXXXXXXXXXXGOOXXXXXXXXXXXXXXXXXGOOOOOOXXXXXXXXXXXXXGOOOOOOOOXXXXXXXXXXX,0,300,0
33474,69,0,69,4,227,0,0,228,218,10,GOOOXXXXXXXXXXXXXXXXGOOOOOXXXXXXXXXXXXXXGOOOOOOOXXXXXXXXXXXXGOXXXXXXXXXXXXXXXXXXGOOOOOOOOOOXXXXXXXXXGOXXXXXXXXXXXXXXXXXXGOOOXXXXXXXXXXXXXXXXGOOXXXXXXXXXXXXXXXXXGOOOXXXXXXXXXXXXXXXXGOOOOOXXXXXXXXXXXXXXGOOXXXXXXXXXXXXXXXXXGOOOOOOXXXXXXXXXXXXXGOOOOOOOOXXXXXXXXXXX,0,300,0

33495,69,0,69,4,227,0,0,229,218,11,GOOOXXXXXXXXXXXXXXXXGOOOOOXXXXXXXXXXXXXXGOOOOOOOXXXXXXXXXXXXGOXXXXXXXXXXXXXXXXXXGOOOOOOOOOOXXXXXXXXXGOXXXXXXXXXXXXXXXXXXGOOOXXXXXXXXXXXXXXXXGOOXXXXXXXXXXXXXXXXXGOOOXXXXXXXXXXXXXXXXGOOOOOXXXXXXXXXXXXXXGOOXXXXXXXXXXXXXXXXXGOOOOOOXXXXXXXXXXXXXGOOOOOOOOXXXXXXXXXXX,0,300,0
33516,69,0,69,4,227,0,0,229,218,11,GOOOXXXXXXXXXXXXXXXXGOOOOOXXXXXXXXXXXXXXGOOOOOOOXXXXXXXXXXXXGOXXXXXXXXXXXXXXXXXXGOOOOOOOOOOXXXXXXXXXGOXXXXXXXXXXXXXXXXXXGOOOXXXXXXXXXXXXXXXXGOOXXXXXXXXXXXXXXXXXGOOOXXXXXXXXXXXXXXXXGOOOOOXXXXXXXXXXXXXXGOOXXXXXXXXXXXXXXXXXGOOOOOOXXXXXXXXXXXXXGOOOOOOOOXXXXXXXXXXX,0,300,0
33537,69,0,69,3,228,0,0,230,218,12,GOOOXXXXXXXXXXXXXXXXGOOOOOXXXXXXXXXXXXXXGOOOOOOOXXXXXXXXXXXXGOXXXXXXXXXXXXXXXXXXGOOOOOOOOOOXXXXXXXXXGOXXXXXXXXXXXXXXXXXXGOOOXXXXXXXXXXXXXXXXGOOXXXXXXXXXXXXXXXXXGOOOXXXXXXXXXXXXXXXXGOOOOOXXXXXXXXXXXXXXGOOXXXXXXXXXXXXXXXXXGOOOOOOXXXXXXXXXXXXXGOOOOOOOOXXXXXXXXXXX,0,300,0
33558,69,0,69,3,228,0,0,230,218,12,GOOOXXXXXXXXXXXXXXXXGOOOOOXXXXXXXXXXXXXXGOOOOOOOXXXXXXXXXXXXGOXXXXXXXXXXXXXXXXXXGOOOOOOOOOOXXXXXXXXXGOXXXXXXXXXXXXXXXXXXGOOOXXXXXXXXXXXXXXXXGOOXXXXXXXXXXXXXXXXXGOOOXXXXXXXXXXXXXXXXGOOOOOXXXXXXXXXXXXXXGOOXXXXXXXXXXXXXXXXXGOOOOOOXXXXXXXXXXXXXGOOOOOOOOXXXXXXXXXXX,0,300,0
33579,69,0,69,2,229,0,0,231,218,13,GOOOXXXXXXXXXXXXXXXXGOOOOOXXXXXXXXXXXXXXGOOOOOOOXXXXXXXXXXXXGOXXXXXXXXXXXXXXXXXXGOOOOOOOOOOXXXXXXXXXGOXXXXXXXXXXXXXXXXXXGOOOXXXXXXXXXXXXXXXXGOOXXXXXXXXXXXXXXXXXGOOOXXXXXXXXXXXXXXXXGOOOOOXXXXXXXXXXXXXXGOOXXXXXXXXXXXXXXXXXGOOOOOOXXXXXXXXXXXXXGOOOOOOOOXXXXXXXXXXX,0,300,0

33600,69,0,69,4,227,0,0,229,218,11,GOOOXXXXXXXXXXXXXXXXGOOOOOXXXXXXXXXXXXXXGOOOOOOOXXXXXXXXXXXXGOXXXXXXXXXXXXXXXXXXGOOOOOOOOOOXXXXXXXXXGOXXXXXXXXXXXXXXXXXXGOOOXXXXXXXXXXXXXXXXGOOXXXXXXXXXXXXXXXXXGOOOXXXXXXXXXXXXXXXXGOOOOOXXXXXXXXXXXXXXGOOXXXXXXXXXXXXXXXXXGOOOOOOXXXXXXXXXXXXXGOOOOOOOOXXXXXXXXXXX,0,300,0
33621,69,0,69,4,227,0,0,229,218,11,GOOOXXXXXXXXXXXXXXXXGOOOOOXXXXXXXXXXXXXXGOOOOOOOXXXXXXXXXXXXGOXXXXXXXXXXXXXXXXXXGOOOOOOOOOOXXXXXXXXXGOXXXXXXXXXXXXXXXXXXGOOOXXXXXXXXXXXXXXXXGOOXXXXXXXXXXXXXXXXXGOOOXXXXXXXXXXXXXXXXGOOOOOXXXXXXXXXXXXXXGOOXXXXXXXXXXXXXXXXXGOOOOOOXXXXXXXXXXXXXGOOOOOOOOXXXXXXXXXXX,0,300,0
33642,69,0,69,4,227,0,0,229,219,10,GOOOXXXXXXXXXXXXXXXXGOOOOOXXXXXXXXXXXXXXGOOOOOOOXXXXXXXXXXXXGOXXXXXXXXXXXXXXXXXXGOOOOOOOOOOXXXXXXXXXGOXXXXXXXXXXXXXXXXXXGOOOXXXXXXXXXXXXXXXXGOOXXXXXXXXXXXXXXXXXGOOOXXXXXXXXXXXXXXXXGOOOOOXXXXXXXXXXXXXXGOOXXXXXXXXXXXXXXXXXGOOOOOOXXXXXXXXXXXXXGOOOOOOOOXXXXXXXXXXX,0,300,0
33663,69,0,69,5,226,0,0,228,219,9,GOOOXXXXXXXXXXXXXXXXGOOOOOXXXXXXXXXXXXXXGOOOOOOOXXXXXXXXXXXXGOXXXXXXXXXXXXXXXXXXGOOOOOOOOOOXXXXXXXXXGOXXXXXXXXXXXXXXXXXXGOOOXXXXXXXXXXXXXXXXGOOXXXXXXXXXXXXXXXXXGOOOXXXXXXXXXXXXXXXXGOOOOOXXXXXXXXXXXXXXGOOXXXXXXXXXXXXXXXXXGOOOOOOXXXXXXXXXXXXXGOOOOOOOOXXXXXXXXXXX,0,300,0
33684,69,0,69,6,225,0,0,227,221,6,GOOOXXXXXXXXXXXXXXXXGOOOOOXXXXXXXXXXXXXXGOOOOOOOXXXXXXXXXXXXGOXXXXXXXXXXXXXXXXXXGOOOOOOOOOOXXXXXXXXXGOXXXXXXXXXXXXXXXXXXGOOOXXXXXXXXXXXXXXXXGOOXXXXXXXXXXXXXXXXXGOOOXXXXXXXXXXXXXXXXGOOOOOXXXXXXXXXXXXXXGOOXXXXXXXXXXXXXXXXXGOOOOOOXXXXXXXXXXXXXGOOOOOOOOXXXXXXXXXXX,0,300,0

33705,69,0,69,8,223,0,0,225,219,6,GOOOXXXXXXXXXXXXXXXXGOOOOOXXXXXXXXXXXXXXGOOOOOOOXXXXXXXXXXXXGOXXXXXXXXXXXXXXXXXXGOOOOOOOOOOXXXXXXXXXGOXXXXXXXXXXXXXXXXXXGOOOXXXXXXXXXXXXXXXXGOOXXXXXXXXXXXXXXXXXGOOOXXXXXXXXXXXXXXXXGOOOOOXXXXXXXXXXXXXXGOOXXXXXXXXXXXXXXXXXGOOOOOOXXXXXXXXXXXXXGOOOOOOOOXXXXXXXXXXX,0,300,0
33726,69,0,69,7,224,0,0,226,219,7,GOOOXXXXXXXXXXXXXXXXGOOOOOXXXXXXXXXXXXXXGOOOOOOOXXXXXXXXXXXXGOXXXXXXXXXXXXXXXXXXGOOOOOOOOOOXXXXXXXXXGOXXXXXXXXXXXXXXXXXXGOOOXXXXXXXXXXXXXXXXGOOXXXXXXXXXXXXXXXXXGOOOXXXXXXXXXXXXXXXXGOOOOOXXXXXXXXXXXXXXGOOXXXXXXXXXXXXXXXXXGOOOOOOXXXXXXXXXXXXXGOOOOOOOOXXXXXXXXXXX,0,300,0
33747,69,0,69,5,226,0,0,228,219,9,GOOOXXXXXXXXXXXXXXXXGOOOOOXXXXXXXXXXXXXXGOOOOOOOXXXXXXXXXXXXGOXXXXXXXXXXXXXXXXXXGOOOOOOOOOOXXXXXXXXXGOXXXXXXXXXXXXXXXXXXGOOOXXXXXXXXXXXXXXXXGOOXXXXXXXXXXXXXXXXXGOOOXXXXXXXXXXXXXXXXGOOOOOXXXXXXXXXXXXXXGOOXXXXXXXXXXXXXXXXXGOOOOOOXXXXXXXXXXXXXGOOOOOOOOXXXXXXXXXXX,0,300,0
33768,69,0,69,5,226,0,0,228,218,10,GOOOXXXXXXXXXXXXXXXXGOOOOOXXXXXXXXXXXXXXGOOOOOOOXXXXXXXXXXXXGOXXXXXXXXXXXXXXXXXXGOOOOOOOOOOXXXXXXXXXGOXXXXXXXXXXXXXXXXXXGOOOXXXXXXXXXXXXXXXXGOOXXXXXXXXXXXXXXXXXGOOOXXXXXXXXXXXXXXXXGOOOOOXXXXXXXXXXXXXXGOOXXXXXXXXXXXXXXXXXGOOOOOOXXXXXXXXXXXXXGOOOOOOOOXXXXXXXXXXX,0,300,0
33789,69,0,69,5,226,0,0,228,218,10,GOOOXXXXXXXXXXXXXXXXGOOOOOXXXXXXXXXXXXXXGOOOOOOOXXXXXXXXXXXXGOXXXXXXXXXXXXXXXXXXGOOOOOOOOOOXXXXXXXXXGOXXXXXXXXXXXXXXXXXXGOOOXXXXXXXXXXXXXXXXGOOXXXXXXXXXXXXXXXXXGOOOXXXXXXXXXXXXXXXXGOOOOOXXXXXXXXXXXXXXGOOXXXXXXXXXXXXXXXXXGOOOOOOXXXXXXXXXXXXXGOOOOOOOOXXXXXXXXXXX,0,300,0

33810,69,0,69,5,226,0,0,228,218,10,GOOOXXXXXXXXXXXXXXXXGOOOOOXXXXXXXXXXXXXXGOOOOOOOXXXXXXXXXXXXGOXXXXXXXXXXXXXXXXXXGOOOOOOOOOOXXXXXXXXXGOXXXXXXXXXXXXXXXXXXGOOOXXXXXXXXXXXXXXXXGOOXXXXXXXXXXXXXXXXXGOOOXXXXXXXXXXXXXXXXGOOOOOXXXXXXXXXXXXXXGOOXXXXXXXXXXXXXXXXXGOOOOOOXXXXXXXXXXXXXGOOOOOOOOXXXXXXXXXXX,0,300,0
33831,69,0,69,6,225,0,0,227,218,9,GOOOXXXXXXXXXXXXXXXXGOOOOOXXXXXXXXXXXXXXGOOOOOOOXXXXXXXXXXXXGOXXXXXXXXXXXXXXXXXXGOOOOOOOOOOXXXXXXXXXGOXXXXXXXXXXXXXXXXXXGOOOXXXXXXXXXXXXXXXXGOOXXXXXXXXXXXXXXXXXGOOOXXXXXXXXXXXXXXXXGOOOOOXXXXXXXXXXXXXXGOOXXXXXXXXXXXXXXXXXGOOOOOOXXXXXXXXXXXXXGOOOOOOOOXXXXXXXXXXX,0,300,0
33852,69,0,69,6,225,0,0,227,218,9,GOOOXXXXXXXXXXXXXXXXGOOOOOXXXXXXXXXXXXXXGOOOOOOOXXXXXXXXXXXXGOXXXXXXXXXXXXXXXXXXGOOOOOOOOOOXXXXXXXXXGOXXXXXXXXXXXXXXXXXXGOOOXXXXXXXXXXXXXXXXGOOXXXXXXXXXXXXXXXXXGOOOXXXXXXXXXXXXXXXXGOOOOOXXXXXXXXXXXXXXGOOXXXXXXXXXXXXXXXXXGOOOOOOXXXXXXXXXXXXXGOOOOOOOOXXXXXXXXXXX,0,300,0
33873,69,0,69,5,226,0,0,228,218,10,GOOOXXXXXXXXXXXXXXXXGOOOOOXXXXXXXXXXXXXXGOOOOOOOXXXXXXXXXXXXGOXXXXXXXXXXXXXXXXXXGOOOOOOOOOOXXXXXXXXXGOXXXXXXXXXXXXXXXXXXGOOOXXXXXXXXXXXXXXXXGOOXXXXXXXXXXXXXXXXXGOOOXXXXXXXXXXXXXXXXGOOOOOXXXXXXXXXXXXXXGOOXXXXXXXXXXXXXXXXXGOOOOOOXXXXXXXXXXXXXGOOOOOOOOXXXXXXXXXXX,0,300,0
33894,69,0,69,4,227,0,0,229,218,11,GOOOXXXXXXXXXXXXXXXXGOOOOOXXXXXXXXXXXXXXGOOOOOOOXXXXXXXXXXXXGOXXXXXXXXXXXXXXXXXXGOOOOOOOOOOXXXXXXXXXGOXXXXXXXXXXXXXXXXXXGOOOXXXXXXXXXXXXXXXXGOOXXXXXXXXXXXXXXXXXGOOOXXXXXXXXXXXXXXXXGOOOOOXXXXXXXXXXXXXXGOOXXXXXXXXXXXXXXXXXGOOOOOOXXXXXXXXXXXXXGOOOOOOOOXXXXXXXXXXX,0,300,0

33915,69,0,69,4,227,0,0,229,218,11,GOOOXXXXXXXXXXXXXXXXGOOOOOXXXXXXXXXXXXXXGOOOOOOOXXXXXXXXXXXXGOXXXXXXXXXXXXXXXXXXGOOOOOOOOOOXXXXXXXXXGOXXXXXXXXXXXXXXXXXXGOOOXXXXXXXXXXXXXXXXGOOXXXXXXXXXXXXXXXXXGOOOXXXXXXXXXXXXXXXXGOOOOOXXXXXXXXXXXXXXGOOXXXXXXXXXXXXXXXXXGOOOOOOXXXXXXXXXXXXXGOOOOOOOOXXXXXXXXXXX,0,300,0
33936,69,0,69,3,228,0,0,230,218,12,GOOOXXXXXXXXXXXXXXXXGOOOOOXXXXXXXXXXXXXXGOOOOOOOXXXXXXXXXXXXGOXXXXXXXXXXXXXXXXXXGOOOOOOOOOOXXXXXXXXXGOXXXXXXXXXXXXXXXXXXGOOOXXXXXXXXXXXXXXXXGOOXXXXXXXXXXXXXXXXXGOOOXXXXXXXXXXXXXXXXGOOOOOXXXXXXXXXXXXXXGOOXXXXXXXXXXXXXXXXXGOOOOOOXXXXXXXXXXXXXGOOOOOOOOXXXXXXXXXXX,0,300,0
33957,69,0,69,2,229,0,0,231,218,13,GOOOXXXXXXXXXXXXXXXXGOOOOOXXXXXXXXXXXXXXGOOOOOOOXXXXXXXXXXXXGOXXXXXXXXXXXXXXXXXXGOOOOOOOOOOXXXXXXXXXGOXXXXXXXXXXXXXXXXXXGOOOXXXXXXXXXXXXXXXXGOOXXXXXXXXXXXXXXXXXGOOOXXXXXXXXXXXXXXXXGOOOOOXXXXXXXXXXXXXXGOOXXXXXXXXXXXXXXXXXGOOOOOOXXXXXXXXXXXXXGOOOOOOOOXXXXXXXXXXX,0,300,0
33978,69,0,69,3,228,0,0,230,218,12,GOOOXXXXXXXXXXXXXXXXGOOOOOXXXXXXXXXXXXXXGOOOOOOOXXXXXXXXXXXXGOXXXXXXXXXXXXXXXXXXGOOOOOOOOOOXXXXXXXXXGOXXXXXXXXXXXXXXXXXXGOOOXXXXXXXXXXXXXXXXGOOXXXXXXXXXXXXXXXXXGOOOXXXXXXXXXXXXXXXXGOOOOOXXXXXXXXXXXXXXGOOXXXXXXXXXXXXXXXXXGOOOOOOXXXXXXXXXXXXXGOOOOOOOOXXXXXXXXXXX,0,300,0
33999,69,0,69,2,229,0,0,231,218,13,GOOOXXXXXXXXXXXXXXXXGOOOOOXXXXXXXXXXXXXXGOOOOOOOXXXXXXXXXXXXGOXXXXXXXXXXXXXXXXXXGOOOOOOOOOOXXXXXXXXXGOXXXXXXXXXXXXXXXXXXGOOOXXXXXXXXXXXXXXXXGOOXXXXXXXXXXXXXXXXXGOOOXXXXXXXXXXXXXXXXGOOOOOXXXXXXXXXXXXXXGOOXXXXXXXXXXXXXXXXXGOOOOOOXXXXXXXXXXXXXGOOOOOOOOXXXXXXXXXXX,0,300,0

34020,69,0,69,2,229,0,0,231,218,13,GOOOXXXXXXXXXXXXXXXXGOOOOOXXXXXXXXXXXXXXGOOOOOOOXXXXXXXXXXXXGOXXXXXXXXXXXXXXXXXXGOOOOOOOOOOXXXXXXXXXGOXXXXXXXXXXXXXXXXXXGOOOXXXXXXXXXXXXXXXXGOOXXXXXXXXXXXXXXXXXGOOOXXXXXXXXXXXXXXXXGOOOOOXXXXXXXXXXXXXXGOOXXXXXXXXXXXXXXXXXGOOOOOOXXXXXXXXXXXXXGOOOOOOOOXXXXXXXXXXX,0,300,0
34041,69,0,69,2,229,0,0,231,219,12,GOOOXXXXXXXXXXXXXXXXGOOOOOXXXXXXXXXXXXXXGOOOOOOOXXXXXXXXXXXXGOXXXXXXXXXXXXXXXXXXGOOOOOOOOOOXXXXXXXXXGOXXXXXXXXXXXXXXXXXXGOOOXXXXXXXXXXXXXXXXGOOXXXXXXXXXXXXXXXXXGOOOXXXXXXXXXXXXXXXXGOOOOOXXXXXXXXXXXXXXGOOXXXXXXXXXXXXXXXXXGOOOOOOXXXXXXXXXXXXXGOOOOOOOOXXXXXXXXXXX,0,300,0
34062,69,0,69,3,228,0,0,230,218,12,GOOOXXXXXXXXXXXXXXXXGOOOOOXXXXXXXXXXXXXXGOOOOOOOXXXXXXXXXXXXGOXXXXXXXXXXXXXXXXXXGOOOOOOOOOOXXXXXXXXXGOXXXXXXXXXXXXXXXXXXGOOOXXXXXXXXXXXXXXXXGOOXXXXXXXXXXXXXXXXXGOOOXXXXXXXXXXXXXXXXGOOOOOXXXXXXXXXXXXXXGOOXXXXXXXXXXXXXXXXXGOOOOOOXXXXXXXXXXXXXGOOOOOOOOXXXXXXXXXXX,0,300,0
34083,69,0,69,4,227,0,0,229,218,11,GOOOXXXXXXXXXXXXXXXXGOOOOOXXXXXXXXXXXXXXGOOOOOOOXXXXXXXXXXXXGOXXXXXXXXXXXXXXXXXXGOOOOOOOOOOXXXXXXXXXGOXXXXXXXXXXXXXXXXXXGOOOXXXXXXXXXXXXXXXXGOOXXXXXXXXXXXXXXXXXGOOOXXXXXXXXXXXXXXXXGOOOOOXXXXXXXXXXXXXXGOOXXXXXXXXXXXXXXXXXGOOOOOOXXXXXXXXXXXXXGOOOOOOOOXXXXXXXXXXX,0,300,0
34104,69,0,69,4,227,0,0,229,219,10,GOOOXXXXXXXXXXXXXXXXGOOOOOXXXXXXXXXXXXXXGOOOOOOOXXXXXXXXXXXXGOXXXXXXXXXXXXXXXXXXGOOOOOOOOOOXXXXXXXXXGOXXXXXXXXXXXXXXXXXXGOOOXXXXXXXXXXXXXXXXGOOXXXXXXXXXXXXXXXXXGOOOXXXXXXXXXXXXXXXXGOOOOOXXXXXXXXXXXXXXGOOXXXXXXXXXXXXXXXXXGOOOOOOXXXXXXXXXXXXXGOOOOOOOOXXXXXXXXXXX,0,300,0

34125,69,0,69,3,228,0,0,230,219,11,GOOOXXXXXXXXXXXXXXXXGOOOOOXXXXXXXXXXXXXXGOOOOOOOXXXXXXXXXXXXGOXXXXXXXXXXXXXXXXXXGOOOOOOOOOOXXXXXXXXXGOXXXXXXXXXXXXXXXXXXGOOOXXXXXXXXXXXXXXXXGOOXXXXXXXXXXXXXXXXXGOOOXXXXXXXXXXXXXXXXGOOOOOXXXXXXXXXXXXXXGOOXXXXXXXXXXXXXXXXXGOOOOOOXXXXXXXXXXXXXGOOOOOOOOXXXXXXXXXXX,0,300,0
34146,69,0,69,3,228,0,0,230,219,11,GOOOXXXXXXXXXXXXXXXXGOOOOOXXXXXXXXXXXXXXGOOOOOOOXXXXXXXXXXXXGOXXXXXXXXXXXXXXXXXXGOOOOOOOOOOXXXXXXXXXGOXXXXXXXXXXXXXXXXXXGOOOXXXXXXXXXXXXXXXXGOOXXXXXXXXXXXXXXXXXGOOOXXXXXXXXXXXXXXXXGOOOOOXXXXXXXXXXXXXXGOOXXXXXXXXXXXXXXXXXGOOOOOOXXXXXXXXXXXXXGOOOOOOOOXXXXXXXXXXX,0,300,0
34167,69,0,69,5,226,0,0,228,220,8,GOOOXXXXXXXXXXXXXXXXGOOOOOXXXXXXXXXXXXXXGOOOOOOOXXXXXXXXXXXXGOXXXXXXXXXXXXXXXXXXGOOOOOOOOOOXXXXXXXXXGOXXXXXXXXXXXXXXXXXXGOOOXXXXXXXXXXXXXXXXGOOXXXXXXXXXXXXXXXXXGOOOXXXXXXXXXXXXXXXXGOOOOOXXXXXXXXXXXXXXGOOXXXXXXXXXXXXXXXXXGOOOOOOXXXXXXXXXXXXXGOOOOOOOOXXXXXXXXXXX,0,300,0
34188,69,0,69,7,224,0,0,226,218,8,GOOOXXXXXXXXXXXXXXXXGOOOOOXXXXXXXXXXXXXXGOOOOOOOXXXXXXXXXXXXGOXXXXXXXXXXXXXXXXXXGOOOOOOOOOOXXXXXXXXXGOXXXXXXXXXXXXXXXXXXGOOOXXXXXXXXXXXXXXXXGOOXXXXXXXXXXXXXXXXXGOOOXXXXXXXXXXXXXXXXGOOOOOXXXXXXXXXXXXXXGOOXXXXXXXXXXXXXXXXXGOOOOOOXXXXXXXXXXXXXGOOOOOOOOXXXXXXXXXXX,0,300,0
34209,69,0,69,7,224,0,0,226,218,8,GOOOXXXXXXXXXXXXXXXXGOOOOOXXXXXXXXXXXXXXGOOOOOOOXXXXXXXXXXXXGOXXXXXXXXXXXXXXXXXXGOOOOOOOOOOXXXXXXXXXGOXXXXXXXXXXXXXXXXXXGOOOXXXXXXXXXXXXXXXXGOOXXXXXXXXXXXXXXXXXGOOOXXXXXXXXXXXXXXXXGOOOOOXXXXXXXXXXXXXXGOOXXXXXXXXXXXXXXXXXGOOOOOOXXXXXXXXXXXXXGOOOOOOOOXXXXXXXXXXX,0,300,0

34230,69,0,69,7,224,0,0,226,218,8,GOOOXXXXXXXXXXXXXXXXGOOOOOXXXXXXXXXXXXXXGOOOOOOOXXXXXXXXXXXXGOXXXXXXXXXXXXXXXXXXGOOOOOOOOOOXXXXXXXXXGOXXXXXXXXXXXXXXXXXXGOOOXXXXXXXXXXXXXXXXGOOXXXXXXXXXXXXXXXXXGOOOXXXXXXXXXXXXXXXXGOOOOOXXXXXXXXXXXXXXGOOXXXXXXXXXXXXXXXXXGOOOOOOXXXXXXXXXXXXXGOOOOOOOOXXXXXXXXXXX,0,300,0
34251,69,0,69,7,224,0,0,226,218,8,GOOOXXXXXXXXXXXXXXXXGOOOOOXXXXXXXXXXXXXXGOOOOOOOXXXXXXXXXXXXGOXXXXXXXXXXXXXXXXXXGOOOOOOOOOOXXXXXXXXXGOXXXXXXXXXXXXXXXXXXGOOOXXXXXXXXXXXXXXXXGOOXXXXXXXXXXXXXXXXXGOOOXXXXXXXXXXXXXXXXGOOOOOXXXXXXXXXXXXXXGOOXXXXXXXXXXXXXXXXXGOOOOOOXXXXXXXXXXXXXGOOOOOOOOXXXXXXXXXXX,0,300,0
34272,69,0,69,6,225,0,0,226,218,8,GOOOXXXXXXXXXXXXXXXXGOOOOOXXXXXXXXXXXXXXGOOOOOOOXXXXXXXXXXXXGOXXXXXXXXXXXXXXXXXXGOOOOOOOOOOXXXXXXXXXGOXXXXXXXXXXXXXXXXXXGOOOXXXXXXXXXXXXXXXXGOOXXXXXXXXXXXXXXXXXGOOOXXXXXXXXXXXXXXXXGOOOOOXXXXXXXXXXXXXXGOOXXXXXXXXXXXXXXXXXGOOOOOOXXXXXXXXXXXXXGOOOOOOOOXXXXXXXXXXX,0,300,0
34293,69,0,69,6,225,0,0,227,218,9,GOOOXXXXXXXXXXXXXXXXGOOOOOXXXXXXXXXXXXXXGOOOOOOOXXXXXXXXXXXXGOXXXXXXXXXXXXXXXXXXGOOOOOOOOOOXXXXXXXXXGOXXXXXXXXXXXXXXXXXXGOOOXXXXXXXXXXXXXXXXGOOXXXXXXXXXXXXXXXXXGOOOXXXXXXXXXXXXXXXXGOOOOOXXXXXXXXXXXXXXGOOXXXXXXXXXXXXXXXXXGOOOOOOXXXXXXXXXXXXXGOOOOOOOOXXXXXXXXXXX,0,300,0
34314,69,0,69,6,225,0,0,227,218,9,GOOOXXXXXXXXXXXXXXXXGOOOOOXXXXXXXXXXXXXXGOOOOOOOXXXXXXXXXXXXGOXXXXXXXXXXXXXXXXXXGOOOOOOOOOOXXXXXXXXXGOXXXXXXXXXXXXXXXXXXGOOOXXXXXXXXXXXXXXXXGOOXXXXXXXXXXXXXXXXXGOOOXXXXXXXXXXXXXXXXGOOOOOXXXXXXXXXXXXXXGOOXXXXXXXXXXXXXXXXXGOOOOOOXXXXXXXXXXXXXGOOOOOOOOXXXXXXXXXXX,0,300,0

34335,69,0,69,4,227,0,0,229,220,9,GOOOXXXXXXXXXXXXXXXXGOOOOOXXXXXXXXXXXXXXGOOOOOOOXXXXXXXXXXXXGOXXXXXXXXXXXXXXXXXXGOOOOOOOOOOXXXXXXXXXGOXXXXXXXXXXXXXXXXXXGOOOXXXXXXXXXXXXXXXXGOOXXXXXXXXXXXXXXXXXGOOOXXXXXXXXXXXXXXXXGOOOOOXXXXXXXXXXXXXXGOOXXXXXXXXXXXXXXXXXGOOOOOOXXXXXXXXXXXXXGOOOOOOOOXXXXXXXXXXX,0,300,0
34356,69,0,69,6,225,0,0,227,218,9,GOOOXXXXXXXXXXXXXXXXGOOOOOXXXXXXXXXXXXXXGOOOOOOOXXXXXXXXXXXXGOXXXXXXXXXXXXXXXXXXGOOOOOOOOOOXXXXXXXXXGOXXXXXXXXXXXXXXXXXXGOOOXXXXXXXXXXXXXXXXGOOXXXXXXXXXXXXXXXXXGOOOXXXXXXXXXXXXXXXXGOOOOOXXXXXXXXXXXXXXGOOXXXXXXXXXXXXXXXXXGOOOOOOXXXXXXXXXXXXXGOOOOOOOOXXXXXXXXXXX,0,300,0
34377,69,0,69,6,225,0,0,227,218,9,GOOOXXXXXXXXXXXXXXXXGOOOOOXXXXXXXXXXXXXXGOOOOOOOXXXXXXXXXXXXGOXXXXXXXXXXXXXXXXXXGOOOOOOOOOOXXXXXXXXXGOXXXXXXXXXXXXXXXXXXGOOOXXXXXXXXXXXXXXXXGOOXXXXXXXXXXXXXXXXXGOOOXXXXXXXXXXXXXXXXGOOOOOXXXXXXXXXXXXXXGOOXXXXXXXXXXXXXXXXXGOOOOOOXXXXXXXXXXXXXGOOOOOOOOXXXXXXXXXXX,0,300,0
34398,69,0,69,6,225,0,0,227,219,8,GOOOXXXXXXXXXXXXXXXXGOOOOOXXXXXXXXXXXXXXGOOOOOOOXXXXXXXXXXXXGOXXXXXXXXXXXXXXXXXXGOOOOOOOOOOXXXXXXXXXGOXXXXXXXXXXXXXXXXXXGOOOXXXXXXXXXXXXXXXXGOOXXXXXXXXXXXXXXXXXGOOOXXXXXXXXXXXXXXXXGOOOOOXXXXXXXXXXXXXXGOOXXXXXXXXXXXXXXXXXGOOOOOOXXXXXXXXXXXXXGOOOOOOOOXXXXXXXXXXX,0,300,0
34419,69,0,69,7,224,0,0,226,220,6,GOOOXXXXXXXXXXXXXXXXGOOOOOXXXXXXXXXXXXXXGOOOOOOOXXXXXXXXXXXXGOXXXXXXXXXXXXXXXXXXGOOOOOOOOOOXXXXXXXXXGOXXXXXXXXXXXXXXXXXXGOOOXXXXXXXXXXXXXXXXGOOXXXXXXXXXXXXXXXXXGOOOXXXXXXXXXXXXXXXXGOOOOOXXXXXXXXXXXXXXGOOXXXXXXXXXXXXXXXXXGOOOOOOXXXXXXXXXXXXXGOOOOOOOOXXXXXXXXXXX,0,300,0

34440,69,0,69,8,223,0,0,225,218,7,GOOOXXXXXXXXXXXXXXXXGOOOOOXXXXXXXXXXXXXXGOOOOOOOXXXXXXXXXXXXGOXXXXXXXXXXXXXXXXXXGOOOOOOOOOOXXXXXXXXXGOXXXXXXXXXXXXXXXXXXGOOOXXXXXXXXXXXXXXXXGOOXXXXXXXXXXXXXXXXXGOOOXXXXXXXXXXXXXXXXGOOOOOXXXXXXXXXXXXXXGOOXXXXXXXXXXXXXXXXXGOOOOOOXXXXXXXXXXXXXGOOOOOOOOXXXXXXXXXXX,0,300,0
34461,69,0,69,7,224,0,0,226,218,8,GOOOXXXXXXXXXXXXXXXXGOOOOOXXXXXXXXXXXXXXGOOOOOOOXXXXXXXXXXXXGOXXXXXXXXXXXXXXXXXXGOOOOOOOOOOXXXXXXXXXGOXXXXXXXXXXXXXXXXXXGOOOXXXXXXXXXXXXXXXXGOOXXXXXXXXXXXXXXXXXGOOOXXXXXXXXXXXXXXXXGOOOOOXXXXXXXXXXXXXXGOOXXXXXXXXXXXXXXXXXGOOOOOOXXXXXXXXXXXXXGOOOOOOOOXXXXXXXXXXX,0,300,0
34482,69,0,69,7,224,0,0,226,218,8,GOOOXXXXXXXXXXXXXXXXGOOOOOXXXXXXXXXXXXXXGOOOOOOOXXXXXXXXXXXXGOXXXXXXXXXXXXXXXXXXGOOOOOOOOOOXXXXXXXXXGOXXXXXXXXXXXXXXXXXXGOOOXXXXXXXXXXXXXXXXGOOXXXXXXXXXXXXXXXXXGOOOXXXXXXXXXXXXXXXXGOOOOOXXXXXXXXXXXXXXGOOXXXXXXXXXXXXXXXXXGOOOOOOXXXXXXXXXXXXXGOOOOOOOOXXXXXXXXXXX,0,300,0
34503,69,0,69,6,225,0,0,227,218,9,GOOOXXXXXXXXXXXXXXXXGOOOOOXXXXXXXXXXXXXXGOOOOOOOXXXXXXXXXXXXGOXXXXXXXXXXXXXXXXXXGOOOOOOOOOOXXXXXXXXXGOXXXXXXXXXXXXXXXXXXGOOOXXXXXXXXXXXXXXXXGOOXXXXXXXXXXXXXXXXXGOOOXXXXXXXXXXXXXXXXGOOOOOXXXXXXXXXXXXXXGOOXXXXXXXXXXXXXXXXXGOOOOOOXXXXXXXXXXXXXGOOOOOOOOXXXXXXXXXXX,0,300,0
34524,69,0,69,6,225,0,0,227,218,9,GOOOXXXXXXXXXXXXXXXXGOOOOOXXXXXXXXXXXXXXGOOOOOOOXXXXXXXXXXXXGOXXXXXXXXXXXXXXXXXXGOOOOOOOOOOXXXXXXXXXGOXXXXXXXXXXXXXXXXXXGOOOXXXXXXXXXXXXXXXXGOOXXXXXXXXXXXXXXXXXGOOOXXXXXXXXXXXXXXXXGOOOOOXXXXXXXXXXXXXXGOOXXXXXXXXXXXXXXXXXGOOOOOOXXXXXXXXXXXXXGOOOOOOOOXXXXXXXXXXX,0,300,0

34545,69,0,69,5,226,0,0,228,218,10,GOOOXXXXXXXXXXXXXXXXGOOOOOXXXXXXXXXXXXXXGOOOOOOOXXXXXXXXXXXXGOXXXXXXXXXXXXXXXXXXGOOOOOOOOOOXXXXXXXXXGOXXXXXXXXXXXXXXXXXXGOOOXXXXXXXXXXXXXXXXGOOXXXXXXXXXXXXXXXXXGOOOXXXXXXXXXXXXXXXXGOOOOOXXXXXXXXXXXXXXGOOXXXXXXXXXXXXXXXXXGOOOOOOXXXXXXXXXXXXXGOOOOOOOOXXXXXXXXXXX,0,300,0
34566,69,0,69,5,226,0,0,227,218,9,GOOOXXXXXXXXXXXXXXXXGOOOOOXXXXXXXXXXXXXXGOOOOOOOXXXXXXXXXXXXGOXXXXXXXXXXXXXXXXXXGOOOOOOOOOOXXXXXXXXXGOXXXXXXXXXXXXXXXXXXGOOOXXXXXXXXXXXXXXXXGOOXXXXXXXXXXXXXXXXXGOOOXXXXXXXXXXXXXXXXGOOOOOXXXXXXXXXXXXXXGOOXXXXXXXXXXXXXXXXXGOOOOOOXXXXXXXXXXXXXGOOOOOOOOXXXXXXXXXXX,0,300,0
34587,69,0,69,5,226,0,0,228,219,9,GOOOXXXXXXXXXXXXXXXXGOOOOOXXXXXXXXXXXXXXGOOOOOOOXXXXXXXXXXXXGOXXXXXXXXXXXXXXXXXXGOOOOOOOOOOXXXXXXXXXGOXXXXXXXXXXXXXXXXXXGOOOXXXXXXXXXXXXXXXXGOOXXXXXXXXXXXXXXXXXGOOOXXXXXXXXXXXXXXXXGOOOOOXXXXXXXXXXXXXXGOOXXXXXXXXXXXXXXXXXGOOOOOOXXXXXXXXXXXXXGOOOOOOOOXXXXXXXXXXX,0,300,0
34608,69,0,69,3,228,0,0,230,218,12,GOOOXXXXXXXXXXXXXXXXGOOOOOXXXXXXXXXXXXXXGOOOOOOOXXXXXXXXXXXXGOXXXXXXXXXXXXXXXXXXGOOOOOOOOOOXXXXXXXXXGOXXXXXXXXXXXXXXXXXXGOOOXXXXXXXXXXXXXXXXGOOXXXXXXXXXXXXXXXXXGOOOXXXXXXXXXXXXXXXXGOOOOOXXXXXXXXXXXXXXGOOXXXXXXXXXXXXXXXXXGOOOOOOXXXXXXXXXXXXXGOOOOOOOOXXXXXXXXXXX,0,300,0
34629,69,0,69,3,228,0,0,230,218,12,GOOOXXXXXXXXXXXXXXXXGOOOOOXXXXXXXXXXXXXXGOOOOOOOXXXXXXXXXXXXGOXXXXXXXXXXXXXXXXXXGOOOOOOOOOOXXXXXXXXXGOXXXXXXXXXXXXXXXXXXGOOOXXXXXXXXXXXXXXXXGOOXXXXXXXXXXXXXXXXXGOOOXXXXXXXXXXXXXXXXGOOOOOXXXXXXXXXXXXXXGOOXXXXXXXXXXXXXXXXXGOOOOOOXXXXXXXXXXXXXGOOOOOOOOXXXXXXXXXXX,0,300,0

34650,69,0,69,2,229,0,0,231,218,13,GOOOXXXXXXXXXXXXXXXXGOOOOOXXXXXXXXXXXXXXGOOOOOOOXXXXXXXXXXXXGOXXXXXXXXXXXXXXXXXXGOOOOOOOOOOXXXXXXXXXGOXXXXXXXXXXXXXXXXXXGOOOXXXXXXXXXXXXXXXXGOOXXXXXXXXXXXXXXXXXGOOOXXXXXXXXXXXXXXXXGOOOOOXXXXXXXXXXXXXXGOOXXXXXXXXXXXXXXXXXGOOOOOOXXXXXXXXXXXXXGOOOOOOOOXXXXXXXXXXX,0,300,0
34671,69,0,69,3,228,0,0,230,218,12,GOOOXXXXXXXXXXXXXXXXGOOOOOXXXXXXXXXXXXXXGOOOOOOOXXXXXXXXXXXXGOXXXXXXXXXXXXXXXXXXGOOOOOOOOOOXXXXXXXXXGOXXXXXXXXXXXXXXXXXXGOOOXXXXXXXXXXXXXXXXGOOXXXXXXXXXXXXXXXXXGOOOXXXXXXXXXXXXXXXXGOOOOOXXXXXXXXXXXXXXGOOXXXXXXXXXXXXXXXXXGOOOOOOXXXXXXXXXXXXXGOOOOOOOOXXXXXXXXXXX,0,300,0
34692,69,0,69,3,228,0,0,230,218,12,GOOOXXXXXXXXXXXXXXXXGOOOOOXXXXXXXXXXXXXXGOOOOOOOXXXXXXXXXXXXGOXXXXXXXXXXXXXXXXXXGOOOOOOOOOOXXXXXXXXXGOXXXXXXXXXXXXXXXXXXGOOOXXXXXXXXXXXXXXXXGOOXXXXXXXXXXXXXXXXXGOOOXXXXXXXXXXXXXXXXGOOOOOXXXXXXXXXXXXXXGOOXXXXXXXXXXXXXXXXXGOOOOOOXXXXXXXXXXXXXGOOOOOOOOXXXXXXXXXXX,0,300,0
34713,69,0,69,3,228,0,0,230,218,12,GOOOXXXXXXXXXXXXXXXXGOOOOOXXXXXXXXXXXXXXGOOOOOOOXXXXXXXXXXXXGOXXXXXXXXXXXXXXXXXXGOOOOOOOOOOXXXXXXXXXGOXXXXXXXXXXXXXXXXXXGOOOXXXXXXXXXXXXXXXXGOOXXXXXXXXXXXXXXXXXGOOOXXXXXXXXXXXXXXXXGOOOOOXXXXXXXXXXXXXXGOOXXXXXXXXXXXXXXXXXGOOOOOOXXXXXXXXXXXXXGOOOOOOOOXXXXXXXXXXX,0,300,0
34734,69,0,69,4,227,0,0,229,218,11,GOOOXXXXXXXXXXXXXXXXGOOOOOXXXXXXXXXXXXXXGOOOOOOOXXXXXXXXXXXXGOXXXXXXXXXXXXXXXXXXGOOOOOOOOOOXXXXXXXXXGOXXXXXXXXXXXXXXXXXXGOOOXXXXXXXXXXXXXXXXGOOXXXXXXXXXXXXXXXXXGOOOXXXXXXXXXXXXXXXXGOOOOOXXXXXXXXXXXXXXGOOXXXXXXXXXXXXXXXXXGOOOOOOXXXXXXXXXXXXXGOOOOOOOOXXXXXXXXXXX,0,300,0

34755,69,0,69,3,228,0,0,230,219,11,GOOOXXXXXXXXXXXXXXXXGOOOOOXXXXXXXXXXXXXXGOOOOOOOXXXXXXXXXXXXGOXXXXXXXXXXXXXXXXXXGOOOOOOOOOOXXXXXXXXXGOXXXXXXXXXXXXXXXXXXGOOOXXXXXXXXXXXXXXXXGOOXXXXXXXXXXXXXXXXXGOOOXXXXXXXXXXXXXXXXGOOOOOXXXXXXXXXXXXXXGOOXXXXXXXXXXXXXXXXXGOOOOOOXXXXXXXXXXXXXGOOOOOOOOXXXXXXXXXXX,0,300,0
34776,69,0,69,3,228,0,0,229,219,10,GOOOXXXXXXXXXXXXXXXXGOOOOOXXXXXXXXXXXXXXGOOOOOOOXXXXXXXXXXXXGOXXXXXXXXXXXXXXXXXXGOOOOOOOOOOXXXXXXXXXGOXXXXXXXXXXXXXXXXXXGOOOXXXXXXXXXXXXXXXXGOOXXXXXXXXXXXXXXXXXGOOOXXXXXXXXXXXXXXXXGOOOOOXXXXXXXXXXXXXXGOOXXXXXXXXXXXXXXXXXGOOOOOOXXXXXXXXXXXXXGOOOOOOOOXXXXXXXXXXX,0,300,0
34797,69,0,69,3,228,0,0,230,220,10,GOOOXXXXXXXXXXXXXXXXGOOOOOXXXXXXXXXXXXXXGOOOOOOOXXXXXXXXXXXXGOXXXXXXXXXXXXXXXXXXGOOOOOOOOOOXXXXXXXXXGOXXXXXXXXXXXXXXXXXXGOOOXXXXXXXXXXXXXXXXGOOXXXXXXXXXXXXXXXXXGOOOXXXXXXXXXXXXXXXXGOOOOOXXXXXXXXXXXXXXGOOXXXXXXXXXXXXXXXXXGOOOOOOXXXXXXXXXXXXXGOOOOOOOOXXXXXXXXXXX,0,300,0
34818,69,0,69,3,228,0,0,230,221,9,GOOOXXXXXXXXXXXXXXXXGOOOOOXXXXXXXXXXXXXXGOOOOOOOXXXXXXXXXXXXGOXXXXXXXXXXXXXXXXXXGOOOOOOOOOOXXXXXXXXXGOXXXXXXXXXXXXXXXXXXGOOOXXXXXXXXXXXXXXXXGOOXXXXXXXXXXXXXXXXXGOOOXXXXXXXXXXXXXXXXGOOOOOXXXXXXXXXXXXXXGOOXXXXXXXXXXXXXXXXXGOOOOOOXXXXXXXXXXXXXGOOOOOOOOXXXXXXXXXXX,0,300,0
34839,69,0,69,5,226,0,0,228,219,9,GOOOXXXXXXXXXXXXXXXXGOOOOOXXXXXXXXXXXXXXGOOOOOOOXXXXXXXXXXXXGOXXXXXXXXXXXXXXXXXXGOOOOOOOOOOXXXXXXXXXGOXXXXXXXXXXXXXXXXXXGOOOXXXXXXXXXXXXXXXXGOOXXXXXXXXXXXXXXXXXGOOOXXXXXXXXXXXXXXXXGOOOOOXXXXXXXXXXXXXXGOOXXXXXXXXXXXXXXXXXGOOOOOOXXXXXXXXXXXXXGOOOOOOOOXXXXXXXXXXX,0,300,0

34860,69,0,69,4,227,0,0,229,220,9,GOOOXXXXXXXXXXXXXXXXGOOOOOXXXXXXXXXXXXXXGOOOOOOOXXXXXXXXXXXXGOXXXXXXXXXXXXXXXXXXGOOOOOOOOOOXXXXXXXXXGOXXXXXXXXXXXXXXXXXXGOOOXXXXXXXXXXXXXXXXGOOXXXXXXXXXXXXXXXXXGOOOXXXXXXXXXXXXXXXXGOOOOOXXXXXXXXXXXXXXGOOXXXXXXXXXXXXXXXXXGOOOOOOXXXXXXXXXXXXXGOOOOOOOOXXXXXXXXXXX,0,300,0
34881,69,0,69,4,227,0,0,229,219,10,GOOOXXXXXXXXXXXXXXXXGOOOOOXXXXXXXXXXXXXXGOOOOOOOXXXXXXXXXXXXGOXXXXXXXXXXXXXXXXXXGOOOOOOOOOOXXXXXXXXXGOXXXXXXXXXXXXXXXXXXGOOOXXXXXXXXXXXXXXXXGOOXXXXXXXXXXXXXXXXXGOOOXXXXXXXXXXXXXXXXGOOOOOXXXXXXXXXXXXXXGOOXXXXXXXXXXXXXXXXXGOOOOOOXXXXXXXXXXXXXGOOOOOOOOXXXXXXXXXXX,0,300,0
34902,69,0,69,4,227,0,0,229,220,9,GOOOXXXXXXXXXXXXXXXXGOOOOOXXXXXXXXXXXXXXGOOOOOOOXXXXXXXXXXXXGOXXXXXXXXXXXXXXXXXXGOOOOOOOOOOXXXXXXXXXGOXXXXXXXXXXXXXXXXXXGOOOXXXXXXXXXXXXXXXXGOOXXXXXXXXXXXXXXXXXGOOOXXXXXXXXXXXXXXXXGOOOOOXXXXXXXXXXXXXXGOOXXXXXXXXXXXXXXXXXGOOOOOOXXXXXXXXXXXXXGOOOOOOOOXXXXXXXXXXX,0,300,0
34923,69,0,69,2,229,0,0,231,221,10,GOOOXXXXXXXXXXXXXXXXGOOOOOXXXXXXXXXXXXXXGOOOOOOOXXXXXXXXXXXXGOXXXXXXXXXXXXXXXXXXGOOOOOOOOOOXXXXXXXXXGOXXXXXXXXXXXXXXXXXXGOOOXXXXXXXXXXXXXXXXGOOXXXXXXXXXXXXXXXXXGOOOXXXXXXXXXXXXXXXXGOOOOOXXXXXXXXXXXXXXGOOXXXXXXXXXXXXXXXXXGOOOOOOXXXXXXXXXXXXXGOOOOOOOOXXXXXXXXXXX,0,300,0
34944,69,0,69,2,229,0,0,231,220,11,GOOOXXXXXXXXXXXXXXXXGOOOOOXXXXXXXXXXXXXXGOOOOOOOXXXXXXXXXXXXGOXXXXXXXXXXXXXXXXXXGOOOOOOOOOOXXXXXXXXXGOXXXXXXXXXXXXXXXXXXGOOOXXXXXXXXXXXXXXXXGOOXXXXXXXXXXXXXXXXXGOOOXXXXXXXXXXXXXXXXGOOOOOXXXXXXXXXXXXXXGOOXXXXXXXXXXXXXXXXXGOOOOOOXXXXXXXXXXXXXGOOOOOOOOXXXXXXXXXXX,0,300,0

34965,69,0,69,4,227,0,0,229,221,8,GOOOXXXXXXXXXXXXXXXXGOOOOOXXXXXXXXXXXXXXGOOOOOOOXXXXXXXXXXXXGOXXXXXXXXXXXXXXXXXXGOOOOOOOOOOXXXXXXXXXGOXXXXXXXXXXXXXXXXXXGOOOXXXXXXXXXXXXXXXXGOOXXXXXXXXXXXXXXXXXGOOOXXXXXXXXXXXXXXXXGOOOOOXXXXXXXXXXXXXXGOOXXXXXXXXXXXXXXXXXGOOOOOOXXXXXXXXXXXXXGOOOOOOOOXXXXXXXXXXX,0,300,0
34986,69,0,69,4,227,0,0,229,221,8,GOOOXXXXXXXXXXXXXXXXGOOOOOXXXXXXXXXXXXXXGOOOOOOOXXXXXXXXXXXXGOXXXXXXXXXXXXXXXXXXGOOOOOOOOOOXXXXXXXXXGOXXXXXXXXXXXXXXXXXXGOOOXXXXXXXXXXXXXXXXGOOXXXXXXXXXXXXXXXXXGOOOXXXXXXXXXXXXXXXXGOOOOOXXXXXXXXXXXXXXGOOXXXXXXXXXXXXXXXXXGOOOOOOXXXXXXXXXXXXXGOOOOOOOOXXXXXXXXXXX,0,300,0
35007,69,0,69,5,226,0,0,228,220,8,GOOOXXXXXXXXXXXXXXXXGOOOOOXXXXXXXXXXXXXXGOOOOOOOXXXXXXXXXXXXGOXXXXXXXXXXXXXXXXXXGOOOOOOOOOOXXXXXXXXXGOXXXXXXXXXXXXXXXXXXGOOOXXXXXXXXXXXXXXXXGOOXXXXXXXXXXXXXXXXXGOOOXXXXXXXXXXXXXXXXGOOOOOXXXXXXXXXXXXXXGOOXXXXXXXXXXXXXXXXXGOOOOOOXXXXXXXXXXXXXGOOOOOOOOXXXXXXXXXXX,0,300,0
35028,69,0,69,5,226,0,0,228,220,8,GOOOXXXXXXXXXXXXXXXXGOOOOOXXXXXXXXXXXXXXGOOOOOOOXXXXXXXXXXXXGOXXXXXXXXXXXXXXXXXXGOOOOOOOOOOXXXXXXXXXGOXXXXXXXXXXXXXXXXXXGOOOXXXXXXXXXXXXXXXXGOOXXXXXXXXXXXXXXXXXGOOOXXXXXXXXXXXXXXXXGOOOOOXXXXXXXXXXXXXXGOOXXXXXXXXXXXXXXXXXGOOOOOOXXXXXXXXXXXXXGOOOOOOOOXXXXXXXXXXX,0,300,0
35049,69,0,69,6,225,0,0,227,220,7,GOOOXXXXXXXXXXXXXXXXGOOOOOXXXXXXXXXXXXXXGOOOOOOOXXXXXXXXXXXXGOXXXXXXXXXXXXXXXXXXGOOOOOOOOOOXXXXXXXXXGOXXXXXXXXXXXXXXXXXXGOOOXXXXXXXXXXXXXXXXGOOXXXXXXXXXXXXXXXXXGOOOXXXXXXXXXXXXXXXXGOOOOOXXXXXXXXXXXXXXGOOXXXXXXXXXXXXXXXXXGOOOOOOXXXXXXXXXXXXXGOOOOOOOOXXXXXXXXXXX,0,300,0

35070,69,0,69,3,228,0,0,230,220,10,GOOOXXXXXXXXXXXXXXXXGOOOOOXXXXXXXXXXXXXXGOOOOOOOXXXXXXXXXXXXGOXXXXXXXXXXXXXXXXXXGOOOOOOOOOOXXXXXXXXXGOXXXXXXXXXXXXXXXXXXGOOOXXXXXXXXXXXXXXXXGOOXXXXXXXXXXXXXXXXXGOOOXXXXXXXXXXXXXXXXGOOOOOXXXXXXXXXXXXXXGOOXXXXXXXXXXXXXXXXXGOOOOOOXXXXXXXXXXXXXGOOOOOOOOXXXXXXXXXXX,0,300,0
35091,69,0,69,3,228,0,0,230,220,10,GOOOXXXXXXXXXXXXXXXXGOOOOOXXXXXXXXXXXXXXGOOOOOOOXXXXXXXXXXXXGOXXXXXXXXXXXXXXXXXXGOOOOOOOOOOXXXXXXXXXGOXXXXXXXXXXXXXXXXXXGOOOXXXXXXXXXXXXXXXXGOOXXXXXXXXXXXXXXXXXGOOOXXXXXXXXXXXXXXXXGOOOOOXXXXXXXXXXXXXXGOOXXXXXXXXXXXXXXXXXGOOOOOOXXXXXXXXXXXXXGOOOOOOOOXXXXXXXXXXX,0,300,0
35112,69,0,69,4,227,0,0,229,220,9,GOOOXXXXXXXXXXXXXXXXGOOOOOXXXXXXXXXXXXXXGOOOOOOOXXXXXXXXXXXXGOXXXXXXXXXXXXXXXXXXGOOOOOOOOOOXXXXXXXXXGOXXXXXXXXXXXXXXXXXXGOOOXXXXXXXXXXXXXXXXGOOXXXXXXXXXXXXXXXXXGOOOXXXXXXXXXXXXXXXXGOOOOOXXXXXXXXXXXXXXGOOXXXXXXXXXXXXXXXXXGOOOOOOXXXXXXXXXXXXXGOOOOOOOOXXXXXXXXXXX,0,300,0
35133,69,0,69,3,228,0,0,230,220,10,GOOOXXXXXXXXXXXXXXXXGOOOOOXXXXXXXXXXXXXXGOOOOOOOXXXXXXXXXXXXGOXXXXXXXXXXXXXXXXXXGOOOOOOOOOOXXXXXXXXXGOXXXXXXXXXXXXXXXXXXGOOOXXXXXXXXXXXXXXXXGOOXXXXXXXXXXXXXXXXXGOOOXXXXXXXXXXXXXXXXGOOOOOXXXXXXXXXXXXXXGOOXXXXXXXXXXXXXXXXXGOOOOOOXXXXXXXXXXXXXGOOOOOOOOXXXXXXXXXXX,0,300,0
35154,69,0,69,4,227,0,0,229,220,9,GOOOXXXXXXXXXXXXXXXXGOOOOOXXXXXXXXXXXXXXGOOOOOOOXXXXXXXXXXXXGOXXXXXXXXXXXXXXXXXXGOOOOOOOOOOXXXXXXXXXGOXXXXXXXXXXXXXXXXXXGOOOXXXXXXXXXXXXXXXXGOOXXXXXXXXXXXXXXXXXGOOOXXXXXXXXXXXXXXXXGOOOOOXXXXXXXXXXXXXXGOOXXXXXXXXXXXXXXXXXGOOOOOOXXXXXXXXXXXXXGOOOOOOOOXXXXXXXXXXX,0,300,0

35175,69,0,69,4,227,0,0,229,221,8,GOOOXXXXXXXXXXXXXXXXGOOOOOXXXXXXXXXXXXXXGOOOOOOOXXXXXXXXXXXXGOXXXXXXXXXXXXXXXXXXGOOOOOOOOOOXXXXXXXXXGOXXXXXXXXXXXXXXXXXXGOOOXXXXXXXXXXXXXXXXGOOXXXXXXXXXXXXXXXXXGOOOXXXXXXXXXXXXXXXXGOOOOOXXXXXXXXXXXXXXGOOXXXXXXXXXXXXXXXXXGOOOOOOXXXXXXXXXXXXXGOOOOOOOOXXXXXXXXXXX,0,300,0
35196,69,0,69,5,226,0,0,228,221,7,GOOOXXXXXXXXXXXXXXXXGOOOOOXXXXXXXXXXXXXXGOOOOOOOXXXXXXXXXXXXGOXXXXXXXXXXXXXXXXXXGOOOOOOOOOOXXXXXXXXXGOXXXXXXXXXXXXXXXXXXGOOOXXXXXXXXXXXXXXXXGOOXXXXXXXXXXXXXXXXXGOOOXXXXXXXXXXXXXXXXGOOOOOXXXXXXXXXXXXXXGOOXXXXXXXXXXXXXXXXXGOOOOOOXXXXXXXXXXXXXGOOOOOOOOXXXXXXXXXXX,0,300,0
35217,69,0,69,6,225,0,0,227,220,7,GOOOXXXXXXXXXXXXXXXXGOOOOOXXXXXXXXXXXXXXGOOOOOOOXXXXXXXXXXXXGOXXXXXXXXXXXXXXXXXXGOOOOOOOOOOXXXXXXXXXGOXXXXXXXXXXXXXXXXXXGOOOXXXXXXXXXXXXXXXXGOOXXXXXXXXXXXXXXXXXGOOOXXXXXXXXXXXXXXXXGOOOOOXXXXXXXXXXXXXXGOOXXXXXXXXXXXXXXXXXGOOOOOOXXXXXXXXXXXXXGOOOOOOOOXXXXXXXXXXX,0,300,0
35238,69,0,69,6,225,0,0,227,220,7,GOOOXXXXXXXXXXXXXXXXGOOOOOXXXXXXXXXXXXXXGOOOOOOOXXXXXXXXXXXXGOXXXXXXXXXXXXXXXXXXGOOOOOOOOOOXXXXXXXXXGOXXXXXXXXXXXXXXXXXXGOOOXXXXXXXXXXXXXXXXGOOXXXXXXXXXXXXXXXXXGOOOXXXXXXXXXXXXXXXXGOOOOOXXXXXXXXXXXXXXGOOXXXXXXXXXXXXXXXXXGOOOOOOXXXXXXXXXXXXXGOOOOOOOOXXXXXXXXXXX,0,300,0
35259,69,0,69,5,226,0,0,228,220,8,GOOOXXXXXXXXXXXXXXXXGOOOOOXXXXXXXXXXXXXXGOOOOOOOXXXXXXXXXXXXGOXXXXXXXXXXXXXXXXXXGOOOOOOOOOOXXXXXXXXXGOXXXXXXXXXXXXXXXXXXGOOOXXXXXXXXXXXXXXXXGOOXXXXXXXXXXXXXXXXXGOOOXXXXXXXXXXXXXXXXGOOOOOXXXXXXXXXXXXXXGOOXXXXXXXXXXXXXXXXXGOOOOOOXXXXXXXXXXXXXGOOOOOOOOXXXXXXXXXXX,0,300,0

35280,69,0,69,5,226,0,0,228,220,8,GOOOXXXXXXXXXXXXXXXXGOOOOOXXXXXXXXXXXXXXGOOOOOOOXXXXXXXXXXXXGOXXXXXXXXXXXXXXXXXXGOOOOOOOOOOXXXXXXXXXGOXXXXXXXXXXXXXXXXXXGOOOXXXXXXXXXXXXXXXXGOOXXXXXXXXXXXXXXXXXGOOOXXXXXXXXXXXXXXXXGOOOOOXXXXXXXXXXXXXXGOOXXXXXXXXXXXXXXXXXGOOOOOOXXXXXXXXXXXXXGOOOOOOOOXXXXXXXXXXX,0,300,0
35301,69,0,69,5,226,0,0,228,220,8,GOOOXXXXXXXXXXXXXXXXGOOOOOXXXXXXXXXXXXXXGOOOOOOOXXXXXXXXXXXXGOXXXXXXXXXXXXXXXXXXGOOOOOOOOOOXXXXXXXXXGOXXXXXXXXXXXXXXXXXXGOOOXXXXXXXXXXXXXXXXGOOXXXXXXXXXXXXXXXXXGOOOXXXXXXXXXXXXXXXXGOOOOOXXXXXXXXXXXXXXGOOXXXXXXXXXXXXXXXXXGOOOOOOXXXXXXXXXXXXXGOOOOOOOOXXXXXXXXXXX,0,300,0
35322,69,0,69,5,226,0,0,228,220,8,GOOOXXXXXXXXXXXXXXXXGOOOOOXXXXXXXXXXXXXXGOOOOOOOXXXXXXXXXXXXGOXXXXXXXXXXXXXXXXXXGOOOOOOOOOOXXXXXXXXXGOXXXXXXXXXXXXXXXXXXGOOOXXXXXXXXXXXXXXXXGOOXXXXXXXXXXXXXXXXXGOOOXXXXXXXXXXXXXXXXGOOOOOXXXXXXXXXXXXXXGOOXXXXXXXXXXXXXXXXXGOOOOOOXXXXXXXXXXXXXGOOOOOOOOXXXXXXXXXXX,0,300,0
35343,69,0,69,6,225,0,0,227,221,6,GOOOXXXXXXXXXXXXXXXXGOOOOOXXXXXXXXXXXXXXGOOOOOOOXXXXXXXXXXXXGOXXXXXXXXXXXXXXXXXXGOOOOOOOOOOXXXXXXXXXGOXXXXXXXXXXXXXXXXXXGOOOXXXXXXXXXXXXXXXXGOOXXXXXXXXXXXXXXXXXGOOOXXXXXXXXXXXXXXXXGOOOOOXXXXXXXXXXXXXXGOOXXXXXXXXXXXXXXXXXGOOOOOOXXXXXXXXXXXXXGOOOOOOOOXXXXXXXXXXX,0,300,0
35364,69,0,69,5,226,0,0,228,221,7,GOOOXXXXXXXXXXXXXXXXGOOOOOXXXXXXXXXXXXXXGOOOOOOOXXXXXXXXXXXXGOXXXXXXXXXXXXXXXXXXGOOOOOOOOOOXXXXXXXXXGOXXXXXXXXXXXXXXXXXXGOOOXXXXXXXXXXXXXXXXGOOXXXXXXXXXXXXXXXXXGOOOXXXXXXXXXXXXXXXXGOOOOOXXXXXXXXXXXXXXGOOXXXXXXXXXXXXXXXXXGOOOOOOXXXXXXXXXXXXXGOOOOOOOOXXXXXXXXXXX,0,300,0

35385,69,0,69,6,225,0,0,227,221,6,GOOOXXXXXXXXXXXXXXXXGOOOOOXXXXXXXXXXXXXXGOOOOOOOXXXXXXXXXXXXGOXXXXXXXXXXXXXXXXXXGOOOOOOOOOOXXXXXXXXXGOXXXXXXXXXXXXXXXXXXGOOOXXXXXXXXXXXXXXXXGOOXXXXXXXXXXXXXXXXXGOOOXXXXXXXXXXXXXXXXGOOOOOXXXXXXXXXXXXXXGOOXXXXXXXXXXXXXXXXXGOOOOOOXXXXXXXXXXXXXGOOOOOOOOXXXXXXXXXXX,0,300,0
35406,69,0,69,6,225,0,0,227,220,7,GOOOXXXXXXXXXXXXXXXXGOOOOOXXXXXXXXXXXXXXGOOOOOOOXXXXXXXXXXXXGOXXXXXXXXXXXXXXXXXXGOOOOOOOOOOXXXXXXXXXGOXXXXXXXXXXXXXXXXXXGOOOXXXXXXXXXXXXXXXXGOOXXXXXXXXXXXXXXXXXGOOOXXXXXXXXXXXXXXXXGOOOOOXXXXXXXXXXXXXXGOOXXXXXXXXXXXXXXXXXGOOOOOOXXXXXXXXXXXXXGOOOOOOOOXXXXXXXXXXX,0,300,0
35427,69,0,69,7,224,0,0,226,221,5,GOOOXXXXXXXXXXXXXXXXGOOOOOXXXXXXXXXXXXXXGOOOOOOOXXXXXXXXXXXXGOXXXXXXXXXXXXXXXXXXGOOOOOOOOOOXXXXXXXXXGOXXXXXXXXXXXXXXXXXXGOOOXXXXXXXXXXXXXXXXGOOXXXXXXXXXXXXXXXXXGOOOXXXXXXXXXXXXXXXXGOOOOOXXXXXXXXXXXXXXGOOXXXXXXXXXXXXXXXXXGOOOOOOXXXXXXXXXXXXXGOOOOOOOOXXXXXXXXXXX,0,300,0
35448,69,0,69,4,227,0,0,229,220,9,GOOOXXXXXXXXXXXXXXXXGOOOOOXXXXXXXXXXXXXXGOOOOOOOXXXXXXXXXXXXGOXXXXXXXXXXXXXXXXXXGOOOOOOOOOOXXXXXXXXXGOXXXXXXXXXXXXXXXXXXGOOOXXXXXXXXXXXXXXXXGOOXXXXXXXXXXXXXXXXXGOOOXXXXXXXXXXXXXXXXGOOOOOXXXXXXXXXXXXXXGOOXXXXXXXXXXXXXXXXXGOOOOOOXXXXXXXXXXXXXGOOOOOOOOXXXXXXXXXXX,0,300,0
35469,69,0,69,3,228,0,0,230,220,10,GOOOXXXXXXXXXXXXXXXXGOOOOOXXXXXXXXXXXXXXGOOOOOOOXXXXXXXXXXXXGOXXXXXXXXXXXXXXXXXXGOOOOOOOOOOXXXXXXXXXGOXXXXXXXXXXXXXXXXXXGOOOXXXXXXXXXXXXXXXXGOOXXXXXXXXXXXXXXXXXGOOOXXXXXXXXXXXXXXXXGOOOOOXXXXXXXXXXXXXXGOOXXXXXXXXXXXXXXXXXGOOOOOOXXXXXXXXXXXXXGOOOOOOOOXXXXXXXXXXX,0,300,0

35490,69,0,69,3,228,0,0,230,220,10,GOOOXXXXXXXXXXXXXXXXGOOOOOXXXXXXXXXXXXXXGOOOOOOOXXXXXXXXXXXXGOXXXXXXXXXXXXXXXXXXGOOOOOOOOOOXXXXXXXXXGOXXXXXXXXXXXXXXXXXXGOOOXXXXXXXXXXXXXXXXGOOXXXXXXXXXXXXXXXXXGOOOXXXXXXXXXXXXXXXXGOOOOOXXXXXXXXXXXXXXGOOXXXXXXXXXXXXXXXXXGOOOOOOXXXXXXXXXXXXXGOOOOOOOOXXXXXXXXXXX,0,300,0
35511,69,0,69,2,229,0,0,231,220,11,GOOOXXXXXXXXXXXXXXXXGOOOOOXXXXXXXXXXXXXXGOOOOOOOXXXXXXXXXXXXGOXXXXXXXXXXXXXXXXXXGOOOOOOOOOOXXXXXXXXXGOXXXXXXXXXXXXXXXXXXGOOOXXXXXXXXXXXXXXXXGOOXXXXXXXXXXXXXXXXXGOOOXXXXXXXXXXXXXXXXGOOOOOXXXXXXXXXXXXXXGOOXXXXXXXXXXXXXXXXXGOOOOOOXXXXXXXXXXXXXGOOOOOOOOXXXXXXXXXXX,0,300,0
35532,69,0,69,2,229,0,0,231,221,10,GOOOXXXXXXXXXXXXXXXXGOOOOOXXXXXXXXXXXXXXGOOOOOOOXXXXXXXXXXXXGOXXXXXXXXXXXXXXXXXXGOOOOOOOOOOXXXXXXXXXGOXXXXXXXXXXXXXXXXXXGOOOXXXXXXXXXXXXXXXXGOOXXXXXXXXXXXXXXXXXGOOOXXXXXXXXXXXXXXXXGOOOOOXXXXXXXXXXXXXXGOOXXXXXXXXXXXXXXXXXGOOOOOOXXXXXXXXXXXXXGOOOOOOOOXXXXXXXXXXX,0,300,0
35553,69,0,69,2,229,0,0,231,220,11,GOOOXXXXXXXXXXXXXXXXGOOOOOXXXXXXXXXXXXXXGOOOOOOOXXXXXXXXXXXXGOXXXXXXXXXXXXXXXXXXGOOOOOOOOOOXXXXXXXXXGOXXXXXXXXXXXXXXXXXXGOOOXXXXXXXXXXXXXXXXGOOXXXXXXXXXXXXXXXXXGOOOXXXXXXXXXXXXXXXXGOOOOOXXXXXXXXXXXXXXGOOXXXXXXXXXXXXXXXXXGOOOOOOXXXXXXXXXXXXXGOOOOOOOOXXXXXXXXXXX,0,300,0
35574,69,0,69,3,228,0,0,230,220,10,GOOOXXXXXXXXXXXXXXXXGOOOOOXXXXXXXXXXXXXXGOOOOOOOXXXXXXXXXXXXGOXXXXXXXXXXXXXXXXXXGOOOOOOOOOOXXXXXXXXXGOXXXXXXXXXXXXXXXXXXGOOOXXXXXXXXXXXXXXXXGOOXXXXXXXXXXXXXXXXXGOOOXXXXXXXXXXXXXXXXGOOOOOXXXXXXXXXXXXXXGOOXXXXXXXXXXXXXXXXXGOOOOOOXXXXXXXXXXXXXGOOOOOOOOXXXXXXXXXXX,0,300,0

35595,69,0,69,4,227,0,0,229,219,10,GOOOXXXXXXXXXXXXXXXXGOOOOOXXXXXXXXXXXXXXGOOOOOOOXXXXXXXXXXXXGOXXXXXXXXXXXXXXXXXXGOOOOOOOOOOXXXXXXXXXGOXXXXXXXXXXXXXXXXXXGOOOXXXXXXXXXXXXXXXXGOOXXXXXXXXXXXXXXXXXGOOOXXXXXXXXXXXXXXXXGOOOOOXXXXXXXXXXXXXXGOOXXXXXXXXXXXXXXXXXGOOOOOOXXXXXXXXXXXXXGOOOOOOOOXXXXXXXXXXX,0,300,0
35616,69,0,69,4,227,0,0,229,219,10,GOOOXXXXXXXXXXXXXXXXGOOOOOXXXXXXXXXXXXXXGOOOOOOOXXXXXXXXXXXXGOXXXXXXXXXXXXXXXXXXGOOOOOOOOOOXXXXXXXXXGOXXXXXXXXXXXXXXXXXXGOOOXXXXXXXXXXXXXXXXGOOXXXXXXXXXXXXXXXXXGOOOXXXXXXXXXXXXXXXXGOOOOOXXXXXXXXXXXXXXGOOXXXXXXXXXXXXXXXXXGOOOOOOXXXXXXXXXXXXXGOOOOOOOOXXXXXXXXXXX,0,300,0
35637,69,0,69,4,227,0,0,229,219,10,GOOOXXXXXXXXXXXXXXXXGOOOOOXXXXXXXXXXXXXXGOOOOOOOXXXXXXXXXXXXGOXXXXXXXXXXXXXXXXXXGOOOOOOOOOOXXXXXXXXXGOXXXXXXXXXXXXXXXXXXGOOOXXXXXXXXXXXXXXXXGOOXXXXXXXXXXXXXXXXXGOOOXXXXXXXXXXXXXXXXGOOOOOXXXXXXXXXXXXXXGOOXXXXXXXXXXXXXXXXXGOOOOOOXXXXXXXXXXXXXGOOOOOOOOXXXXXXXXXXX,0,300,0
35658,69,0,69,4,227,0,0,229,220,9,GOOOXXXXXXXXXXXXXXXXGOOOOOXXXXXXXXXXXXXXGOOOOOOOXXXXXXXXXXXXGOXXXXXXXXXXXXXXXXXXGOOOOOOOOOOXXXXXXXXXGOXXXXXXXXXXXXXXXXXXGOOOXXXXXXXXXXXXXXXXGOOXXXXXXXXXXXXXXXXXGOOOXXXXXXXXXXXXXXXXGOOOOOXXXXXXXXXXXXXXGOOXXXXXXXXXXXXXXXXXGOOOOOOXXXXXXXXXXXXXGOOOOOOOOXXXXXXXXXXX,0,300,0
35679,69,0,69,5,226,0,0,228,220,8,GOOOXXXXXXXXXXXXXXXXGOOOOOXXXXXXXXXXXXXXGOOOOOOOXXXXXXXXXXXXGOXXXXXXXXXXXXXXXXXXGOOOOOOOOOOXXXXXXXXXGOXXXXXXXXXXXXXXXXXXGOOOXXXXXXXXXXXXXXXXGOOXXXXXXXXXXXXXXXXXGOOOXXXXXXXXXXXXXXXXGOOOOOXXXXXXXXXXXXXXGOOXXXXXXXXXXXXXXXXXGOOOOOOXXXXXXXXXXXXXGOOOOOOOOXXXXXXXXXXX,0,300,0

35700,69,0,69,5,226,0,0,228,219,9,GOOOXXXXXXXXXXXXXXXXGOOOOOXXXXXXXXXXXXXXGOOOOOOOXXXXXXXXXXXXGOXXXXXXXXXXXXXXXXXXGOOOOOOOOOOXXXXXXXXXGOXXXXXXXXXXXXXXXXXXGOOOXXXXXXXXXXXXXXXXGOOXXXXXXXXXXXXXXXXXGOOOXXXXXXXXXXXXXXXXGOOOOOXXXXXXXXXXXXXXGOOXXXXXXXXXXXXXXXXXGOOOOOOXXXXXXXXXXXXXGOOOOOOOOXXXXXXXXXXX,0,300,0
35721,69,0,69,5,226,0,0,228,220,8,GOOOXXXXXXXXXXXXXXXXGOOOOOXXXXXXXXXXXXXXGOOOOOOOXXXXXXXXXXXXGOXXXXXXXXXXXXXXXXXXGOOOOOOOOOOXXXXXXXXXGOXXXXXXXXXXXXXXXXXXGOOOXXXXXXXXXXXXXXXXGOOXXXXXXXXXXXXXXXXXGOOOXXXXXXXXXXXXXXXXGOOOOOXXXXXXXXXXXXXXGOOXXXXXXXXXXXXXXXXXGOOOOOOXXXXXXXXXXXXXGOOOOOOOOXXXXXXXXXXX,0,300,0
35742,69,0,69,4,227,0,0,229,220,9,GOOOXXXXXXXXXXXXXXXXGOOOOOXXXXXXXXXXXXXXGOOOOOOOXXXXXXXXXXXXGOXXXXXXXXXXXXXXXXXXGOOOOOOOOOOXXXXXXXXXGOXXXXXXXXXXXXXXXXXXGOOOXXXXXXXXXXXXXXXXGOOXXXXXXXXXXXXXXXXXGOOOXXXXXXXXXXXXXXXXGOOOOOXXXXXXXXXXXXXXGOOXXXXXXXXXXXXXXXXXGOOOOOOXXXXXXXXXXXXXGOOOOOOOOXXXXXXXXXXX,0,300,0
35763,69,0,69,5,226,0,0,228,219,9,GOOOXXXXXXXXXXXXXXXXGOOOOOXXXXXXXXXXXXXXGOOOOOOOXXXXXXXXXXXXGOXXXXXXXXXXXXXXXXXXGOOOOOOOOOOXXXXXXXXXGOXXXXXXXXXXXXXXXXXXGOOOXXXXXXXXXXXXXXXXGOOXXXXXXXXXXXXXXXXXGOOOXXXXXXXXXXXXXXXXGOOOOOXXXXXXXXXXXXXXGOOXXXXXXXXXXXXXXXXXGOOOOOOXXXXXXXXXXXXXGOOOOOOOOXXXXXXXXXXX,0,300,0
35784,69,0,69,6,225,0,0,227,219,8,GOOOXXXXXXXXXXXXXXXXGOOOOOXXXXXXXXXXXXXXGOOOOOOOXXXXXXXXXXXXGOXXXXXXXXXXXXXXXXXXGOOOOOOOOOOXXXXXXXXXGOXXXXXXXXXXXXXXXXXXGOOOXXXXXXXXXXXXXXXXGOOXXXXXXXXXXXXXXXXXGOOOXXXXXXXXXXXXXXXXGOOOOOXXXXXXXXXXXXXXGOOXXXXXXXXXXXXXXXXXGOOOOOOXXXXXXXXXXXXXGOOOOOOOOXXXXXXXXXXX,0,300,0

35805,69,0,69,4,227,0,0,229,220,9,GOOOXXXXXXXXXXXXXXXXGOOOOOXXXXXXXXXXXXXXGOOOOOOOXXXXXXXXXXXXGOXXXXXXXXXXXXXXXXXXGOOOOOOOOOOXXXXXXXXXGOXXXXXXXXXXXXXXXXXXGOOOXXXXXXXXXXXXXXXXGOOXXXXXXXXXXXXXXXXXGOOOXXXXXXXXXXXXXXXXGOOOOOXXXXXXXXXXXXXXGOOXXXXXXXXXXXXXXXXXGOOOOOOXXXXXXXXXXXXXGOOOOOOOOXXXXXXXXXXX,0,300,0
35826,69,0,69,3,228,0,0,230,219,11,GOOOXXXXXXXXXXXXXXXXGOOOOOXXXXXXXXXXXXXXGOOOOOOOXXXXXXXXXXXXGOXXXXXXXXXXXXXXXXXXGOOOOOOOOOOXXXXXXXXXGOXXXXXXXXXXXXXXXXXXGOOOXXXXXXXXXXXXXXXXGOOXXXXXXXXXXXXXXXXXGOOOXXXXXXXXXXXXXXXXGOOOOOXXXXXXXXXXXXXXGOOXXXXXXXXXXXXXXXXXGOOOOOOXXXXXXXXXXXXXGOOOOOOOOXXXXXXXXXXX,0,300,0
35847,69,0,69,3,228,0,0,229,219,10,GOOOXXXXXXXXXXXXXXXXGOOOOOXXXXXXXXXXXXXXGOOOOOOOXXXXXXXXXXXXGOXXXXXXXXXXXXXXXXXXGOOOOOOOOOOXXXXXXXXXGOXXXXXXXXXXXXXXXXXXGOOOXXXXXXXXXXXXXXXXGOOXXXXXXXXXXXXXXXXXGOOOXXXXXXXXXXXXXXXXGOOOOOXXXXXXXXXXXXXXGOOXXXXXXXXXXXXXXXXXGOOOOOOXXXXXXXXXXXXXGOOOOOOOOXXXXXXXXXXX,0,300,0
35868,69,0,69,3,228,0,0,230,220,10,GOOOXXXXXXXXXXXXXXXXGOOOOOXXXXXXXXXXXXXXGOOOOOOOXXXXXXXXXXXXGOXXXXXXXXXXXXXXXXXXGOOOOOOOOOOXXXXXXXXXGOXXXXXXXXXXXXXXXXXXGOOOXXXXXXXXXXXXXXXXGOOXXXXXXXXXXXXXXXXXGOOOXXXXXXXXXXXXXXXXGOOOOOXXXXXXXXXXXXXXGOOXXXXXXXXXXXXXXXXXGOOOOOOXXXXXXXXXXXXXGOOOOOOOOXXXXXXXXXXX,0,300,0
35889,69,0,69,3,228,0,0,230,220,10,GOOOXXXXXXXXXXXXXXXXGOOOOOXXXXXXXXXXXXXXGOOOOOOOXXXXXXXXXXXXGOXXXXXXXXXXXXXXXXXXGOOOOOOOOOOXXXXXXXXXGOXXXXXXXXXXXXXXXXXXGOOOXXXXXXXXXXXXXXXXGOOXXXXXXXXXXXXXXXXXGOOOXXXXXXXXXXXXXXXXGOOOOOXXXXXXXXXXXXXXGOOXXXXXXXXXXXXXXXXXGOOOOOOXXXXXXXXXXXXXGOOOOOOOOXXXXXXXXXXX,0,300,0

35910,69,0,69,3,228,0,0,230,219,11,GOOOXXXXXXXXXXXXXXXXGOOOOOXXXXXXXXXXXXXXGOOOOOOOXXXXXXXXXXXXGOXXXXXXXXXXXXXXXXXXGOOOOOOOOOOXXXXXXXXXGOXXXXXXXXXXXXXXXXXXGOOOXXXXXXXXXXXXXXXXGOOXXXXXXXXXXXXXXXXXGOOOXXXXXXXXXXXXXXXXGOOOOOXXXXXXXXXXXXXXGOOXXXXXXXXXXXXXXXXXGOOOOOOXXXXXXXXXXXXXGOOOOOOOOXXXXXXXXXXX,0,300,0
35931,69,0,69,2,229,0,0,231,220,11,GOOOXXXXXXXXXXXXXXXXGOOOOOXXXXXXXXXXXXXXGOOOOOOOXXXXXXXXXXXXGOXXXXXXXXXXXXXXXXXXGOOOOOOOOOOXXXXXXXXXGOXXXXXXXXXXXXXXXXXXGOOOXXXXXXXXXXXXXXXXGOOXXXXXXXXXXXXXXXXXGOOOXXXXXXXXXXXXXXXXGOOOOOXXXXXXXXXXXXXXGOOXXXXXXXXXXXXXXXXXGOOOOOOXXXXXXXXXXXXXGOOOOOOOOXXXXXXXXXXX,0,300,0
35952,69,0,69,5,226,0,0,228,219,9,GOOOXXXXXXXXXXXXXXXXGOOOOOXXXXXXXXXXXXXXGOOOOOOOXXXXXXXXXXXXGOXXXXXXXXXXXXXXXXXXGOOOOOOOOOOXXXXXXXXXGOXXXXXXXXXXXXXXXXXXGOOOXXXXXXXXXXXXXXXXGOOXXXXXXXXXXXXXXXXXGOOOXXXXXXXXXXXXXXXXGOOOOOXXXXXXXXXXXXXXGOOXXXXXXXXXXXXXXXXXGOOOOOOXXXXXXXXXXXXXGOOOOOOOOXXXXXXXXXXX,0,300,0
35973,69,0,69,4,227,0,0,229,219,10,GOOOXXXXXXXXXXXXXXXXGOOOOOXXXXXXXXXXXXXXGOOOOOOOXXXXXXXXXXXXGOXXXXXXXXXXXXXXXXXXGOOOOOOOOOOXXXXXXXXXGOXXXXXXXXXXXXXXXXXXGOOOXXXXXXXXXXXXXXXXGOOXXXXXXXXXXXXXXXXXGOOOXXXXXXXXXXXXXXXXGOOOOOXXXXXXXXXXXXXXGOOXXXXXXXXXXXXXXXXXGOOOOOOXXXXXXXXXXXXXGOOOOOOOOXXXXXXXXXXX,0,300,0
35994,69,0,69,4,227,0,0,229,220,9,GOOOXXXXXXXXXXXXXXXXGOOOOOXXXXXXXXXXXXXXGOOOOOOOXXXXXXXXXXXXGOXXXXXXXXXXXXXXXXXXGOOOOOOOOOOXXXXXXXXXGOXXXXXXXXXXXXXXXXXXGOOOXXXXXXXXXXXXXXXXGOOXXXXXXXXXXXXXXXXXGOOOXXXXXXXXXXXXXXXXGOOOOOXXXXXXXXXXXXXXGOOXXXXXXXXXXXXXXXXXGOOOOOOXXXXXXXXXXXXXGOOOOOOOOXXXXXXXXXXX,0,300,0

36015,69,0,69,2,229,0,0,231,220,11,GOOOXXXXXXXXXXXXXXXXGOOOOOXXXXXXXXXXXXXXGOOOOOOOXXXXXXXXXXXXGOXXXXXXXXXXXXXXXXXXGOOOOOOOOOOXXXXXXXXXGOXXXXXXXXXXXXXXXXXXGOOOXXXXXXXXXXXXXXXXGOOXXXXXXXXXXXXXXXXXGOOOXXXXXXXXXXXXXXXXGOOOOOXXXXXXXXXXXXXXGOOXXXXXXXXXXXXXXXXXGOOOOOOXXXXXXXXXXXXXGOOOOOOOOXXXXXXXXXXX,0,300,0
36036,69,0,69,2,229,0,0,231,221,10,GOOOXXXXXXXXXXXXXXXXGOOOOOXXXXXXXXXXXXXXGOOOOOOOXXXXXXXXXXXXGOXXXXXXXXXXXXXXXXXXGOOOOOOOOOOXXXXXXXXXGOXXXXXXXXXXXXXXXXXXGOOOXXXXXXXXXXXXXXXXGOOXXXXXXXXXXXXXXXXXGOOOXXXXXXXXXXXXXXXXGOOOOOXXXXXXXXXXXXXXGOOXXXXXXXXXXXXXXXXXGOOOOOOXXXXXXXXXXXXXGOOOOOOOOXXXXXXXXXXX,0,300,0
36057,69,0,69,2,229,0,0,231,224,7,GOOOXXXXXXXXXXXXXXXXGOOOOOXXXXXXXXXXXXXXGOOOOOOOXXXXXXXXXXXXGOXXXXXXXXXXXXXXXXXXGOOOOOOOOOOXXXXXXXXXGOXXXXXXXXXXXXXXXXXXGOOOXXXXXXXXXXXXXXXXGOOXXXXXXXXXXXXXXXXXGOOOXXXXXXXXXXXXXXXXGOOOOOXXXXXXXXXXXXXXGOOXXXXXXXXXXXXXXXXXGOOOOOOXXXXXXXXXXXXXGOOOOOOOOXXXXXXXXXXX,0,300,0
36078,69,0,69,7,224,0,0,226,220,6,GOOOXXXXXXXXXXXXXXXXGOOOOOXXXXXXXXXXXXXXGOOOOOOOXXXXXXXXXXXXGOXXXXXXXXXXXXXXXXXXGOOOOOOOOOOXXXXXXXXXGOXXXXXXXXXXXXXXXXXXGOOOXXXXXXXXXXXXXXXXGOOXXXXXXXXXXXXXXXXXGOOOXXXXXXXXXXXXXXXXGOOOOOXXXXXXXXXXXXXXGOOXXXXXXXXXXXXXXXXXGOOOOOOXXXXXXXXXXXXXGOOOOOOOOXXXXXXXXXXX,0,300,0
36099,69,0,69,6,225,0,0,227,220,7,GOOOXXXXXXXXXXXXXXXXGOOOOOXXXXXXXXXXXXXXGOOOOOOOXXXXXXXXXXXXGOXXXXXXXXXXXXXXXXXXGOOOOOOOOOOXXXXXXXXXGOXXXXXXXXXXXXXXXXXXGOOOXXXXXXXXXXXXXXXXGOOXXXXXXXXXXXXXXXXXGOOOXXXXXXXXXXXXXXXXGOOOOOXXXXXXXXXXXXXXGOOXXXXXXXXXXXXXXXXXGOOOOOOXXXXXXXXXXXXXGOOOOOOOOXXXXXXXXXXX,0,300,0

36120,69,0,69,5,226,0,0,228,220,8,GOOOXXXXXXXXXXXXXXXXGOOOOOXXXXXXXXXXXXXXGOOOOOOOXXXXXXXXXXXXGOXXXXXXXXXXXXXXXXXXGOOOOOOOOOOXXXXXXXXXGOXXXXXXXXXXXXXXXXXXGOOOXXXXXXXXXXXXXXXXGOOXXXXXXXXXXXXXXXXXGOOOXXXXXXXXXXXXXXXXGOOOOOXXXXXXXXXXXXXXGOOXXXXXXXXXXXXXXXXXGOOOOOOXXXXXXXXXXXXXGOOOOOOOOXXXXXXXXXXX,0,300,0
36141,69,0,69,6,225,0,0,227,220,7,GOOOXXXXXXXXXXXXXXXXGOOOOOXXXXXXXXXXXXXXGOOOOOOOXXXXXXXXXXXXGOXXXXXXXXXXXXXXXXXXGOOOOOOOOOOXXXXXXXXXGOXXXXXXXXXXXXXXXXXXGOOOXXXXXXXXXXXXXXXXGOOXXXXXXXXXXXXXXXXXGOOOXXXXXXXXXXXXXXXXGOOOOOXXXXXXXXXXXXXXGOOXXXXXXXXXXXXXXXXXGOOOOOOXXXXXXXXXXXXXGOOOOOOOOXXXXXXXXXXX,0,300,0
36162,69,0,69,6,225,0,0,227,221,6,GOOOXXXXXXXXXXXXXXXXGOOOOOXXXXXXXXXXXXXXGOOOOOOOXXXXXXXXXXXXGOXXXXXXXXXXXXXXXXXXGOOOOOOOOOOXXXXXXXXXGOXXXXXXXXXXXXXXXXXXGOOOXXXXXXXXXXXXXXXXGOOXXXXXXXXXXXXXXXXXGOOOXXXXXXXXXXXXXXXXGOOOOOXXXXXXXXXXXXXXGOOXXXXXXXXXXXXXXXXXGOOOOOOXXXXXXXXXXXXXGOOOOOOOOXXXXXXXXXXX,0,300,0
36183,69,0,69,7,224,0,0,226,220,6,GOOOXXXXXXXXXXXXXXXXGOOOOOXXXXXXXXXXXXXXGOOOOOOOXXXXXXXXXXXXGOXXXXXXXXXXXXXXXXXXGOOOOOOOOOOXXXXXXXXXGOXXXXXXXXXXXXXXXXXXGOOOXXXXXXXXXXXXXXXXGOOXXXXXXXXXXXXXXXXXGOOOXXXXXXXXXXXXXXXXGOOOOOXXXXXXXXXXXXXXGOOXXXXXXXXXXXXXXXXXGOOOOOOXXXXXXXXXXXXXGOOOOOOOOXXXXXXXXXXX,0,300,0
36204,69,0,69,6,225,0,0,227,220,7,GOOOXXXXXXXXXXXXXXXXGOOOOOXXXXXXXXXXXXXXGOOOOOOOXXXXXXXXXXXXGOXXXXXXXXXXXXXXXXXXGOOOOOOOOOOXXXXXXXXXGOXXXXXXXXXXXXXXXXXXGOOOXXXXXXXXXXXXXXXXGOOXXXXXXXXXXXXXXXXXGOOOXXXXXXXXXXXXXXXXGOOOOOXXXXXXXXXXXXXXGOOXXXXXXXXXXXXXXXXXGOOOOOOXXXXXXXXXXXXXGOOOOOOOOXXXXXXXXXXX,0,300,0

36225,69,0,69,5,226,0,0,228,221,7,GOOOXXXXXXXXXXXXXXXXGOOOOOXXXXXXXXXXXXXXGOOOOOOOXXXXXXXXXXXXGOXXXXXXXXXXXXXXXXXXGOOOOOOOOOOXXXXXXXXXGOXXXXXXXXXXXXXXXXXXGOOOXXXXXXXXXXXXXXXXGOOXXXXXXXXXXXXXXXXXGOOOXXXXXXXXXXXXXXXXGOOOOOXXXXXXXXXXXXXXGOOXXXXXXXXXXXXXXXXXGOOOOOOXXXXXXXXXXXXXGOOOOOOOOXXXXXXXXXXX,0,300,0
36246,69,0,69,4,227,0,0,229,221,8,GOOOXXXXXXXXXXXXXXXXGOOOOOXXXXXXXXXXXXXXGOOOOOOOXXXXXXXXXXXXGOXXXXXXXXXXXXXXXXXXGOOOOOOOOOOXXXXXXXXXGOXXXXXXXXXXXXXXXXXXGOOOXXXXXXXXXXXXXXXXGOOXXXXXXXXXXXXXXXXXGOOOXXXXXXXXXXXXXXXXGOOOOOXXXXXXXXXXXXXXGOOXXXXXXXXXXXXXXXXXGOOOOOOXXXXXXXXXXXXXGOOOOOOOOXXXXXXXXXXX,0,300,0
36267,69,0,69,5,226,0,0,228,220,8,GOOOXXXXXXXXXXXXXXXXGOOOOOXXXXXXXXXXXXXXGOOOOOOOXXXXXXXXXXXXGOXXXXXXXXXXXXXXXXXXGOOOOOOOOOOXXXXXXXXXGOXXXXXXXXXXXXXXXXXXGOOOXXXXXXXXXXXXXXXXGOOXXXXXXXXXXXXXXXXXGOOOXXXXXXXXXXXXXXXXGOOOOOXXXXXXXXXXXXXXGOOXXXXXXXXXXXXXXXXXGOOOOOOXXXXXXXXXXXXXGOOOOOOOOXXXXXXXXXXX,0,300,0
36288,69,0,69,5,226,0,0,228,220,8,GOOOXXXXXXXXXXXXXXXXGOOOOOXXXXXXXXXXXXXXGOOOOOOOXXXXXXXXXXXXGOXXXXXXXXXXXXXXXXXXGOOOOOOOOOOXXXXXXXXXGOXXXXXXXXXXXXXXXXXXGOOOXXXXXXXXXXXXXXXXGOOXXXXXXXXXXXXXXXXXGOOOXXXXXXXXXXXXXXXXGOOOOOXXXXXXXXXXXXXXGOOXXXXXXXXXXXXXXXXXGOOOOOOXXXXXXXXXXXXXGOOOOOOOOXXXXXXXXXXX,0,300,0
36309,69,0,69,5,226,0,0,228,220,8,GOOOXXXXXXXXXXXXXXXXGOOOOOXXXXXXXXXXXXXXGOOOOOOOXXXXXXXXXXXXGOXXXXXXXXXXXXXXXXXXGOOOOOOOOOOXXXXXXXXXGOXXXXXXXXXXXXXXXXXXGOOOXXXXXXXXXXXXXXXXGOOXXXXXXXXXXXXXXXXXGOOOXXXXXXXXXXXXXXXXGOOOOOXXXXXXXXXXXXXXGOOXXXXXXXXXXXXXXXXXGOOOOOOXXXXXXXXXXXXXGOOOOOOOOXXXXXXXXXXX,0,300,0

36330,69,0,69,5,226,0,0,228,220,8,GOOOXXXXXXXXXXXXXXXXGOOOOOXXXXXXXXXXXXXXGOOOOOOOXXXXXXXXXXXXGOXXXXXXXXXXXXXXXXXXGOOOOOOOOOOXXXXXXXXXGOXXXXXXXXXXXXXXXXXXGOOOXXXXXXXXXXXXXXXXGOOXXXXXXXXXXXXXXXXXGOOOXXXXXXXXXXXXXXXXGOOOOOXXXXXXXXXXXXXXGOOXXXXXXXXXXXXXXXXXGOOOOOOXXXXXXXXXXXXXGOOOOOOOOXXXXXXXXXXX,0,300,0
36351,69,0,69,4,227,0,0,229,222,7,GOOOXXXXXXXXXXXXXXXXGOOOOOXXXXXXXXXXXXXXGOOOOOOOXXXXXXXXXXXXGOXXXXXXXXXXXXXXXXXXGOOOOOOOOOOXXXXXXXXXGOXXXXXXXXXXXXXXXXXXGOOOXXXXXXXXXXXXXXXXGOOXXXXXXXXXXXXXXXXXGOOOXXXXXXXXXXXXXXXXGOOOOOXXXXXXXXXXXXXXGOOXXXXXXXXXXXXXXXXXGOOOOOOXXXXXXXXXXXXXGOOOOOOOOXXXXXXXXXXX,0,300,0
36372,69,0,69,5,226,0,0,228,220,8,GOOOXXXXXXXXXXXXXXXXGOOOOOXXXXXXXXXXXXXXGOOOOOOOXXXXXXXXXXXXGOXXXXXXXXXXXXXXXXXXGOOOOOOOOOOXXXXXXXXXGOXXXXXXXXXXXXXXXXXXGOOOXXXXXXXXXXXXXXXXGOOXXXXXXXXXXXXXXXXXGOOOXXXXXXXXXXXXXXXXGOOOOOXXXXXXXXXXXXXXGOOXXXXXXXXXXXXXXXXXGOOOOOOXXXXXXXXXXXXXGOOOOOOOOXXXXXXXXXXX,0,300,0
36393,69,0,69,4,227,0,0,229,220,9,GOOOXXXXXXXXXXXXXXXXGOOOOOXXXXXXXXXXXXXXGOOOOOOOXXXXXXXXXXXXGOXXXXXXXXXXXXXXXXXXGOOOOOOOOOOXXXXXXXXXGOXXXXXXXXXXXXXXXXXXGOOOXXXXXXXXXXXXXXXXGOOXXXXXXXXXXXXXXXXXGOOOXXXXXXXXXXXXXXXXGOOOOOXXXXXXXXXXXXXXGOOXXXXXXXXXXXXXXXXXGOOOOOOXXXXXXXXXXXXXGOOOOOOOOXXXXXXXXXXX,0,300,0
36414,69,0,69,4,227,0,0,229,220,9,GOOOXXXXXXXXXXXXXXXXGOOOOOXXXXXXXXXXXXXXGOOOOOOOXXXXXXXXXXXXGOXXXXXXXXXXXXXXXXXXGOOOOOOOOOOXXXXXXXXXGOXXXXXXXXXXXXXXXXXXGOOOXXXXXXXXXXXXXXXXGOOXXXXXXXXXXXXXXXXXGOOOXXXXXXXXXXXXXXXXGOOOOOXXXXXXXXXXXXXXGOOXXXXXXXXXXXXXXXXXGOOOOOOXXXXXXXXXXXXXGOOOOOOOOXXXXXXXXXXX,0,300,0

36435,69,0,69,4,227,0,0,229,221,8,GOOOXXXXXXXXXXXXXXXXGOOOOOXXXXXXXXXXXXXXGOOOOOOOXXXXXXXXXXXXGOXXXXXXXXXXXXXXXXXXGOOOOOOOOOOXXXXXXXXXGOXXXXXXXXXXXXXXXXXXGOOOXXXXXXXXXXXXXXXXGOOXXXXXXXXXXXXXXXXXGOOOXXXXXXXXXXXXXXXXGOOOOOXXXXXXXXXXXXXXGOOXXXXXXXXXXXXXXXXXGOOOOOOXXXXXXXXXXXXXGOOOOOOOOXXXXXXXXXXX,0,300,0
36456,69,0,69,4,227,0,0,229,220,9,GOOOXXXXXXXXXXXXXXXXGOOOOOXXXXXXXXXXXXXXGOOOOOOOXXXXXXXXXXXXGOXXXXXXXXXXXXXXXXXXGOOOOOOOOOOXXXXXXXXXGOXXXXXXXXXXXXXXXXXXGOOOXXXXXXXXXXXXXXXXGOOXXXXXXXXXXXXXXXXXGOOOXXXXXXXXXXXXXXXXGOOOOOXXXXXXXXXXXXXXGOOXXXXXXXXXXXXXXXXXGOOOOOOXXXXXXXXXXXXXGOOOOOOOOXXXXXXXXXXX,0,300,0
36477,69,0,69,4,227,0,0,229,220,9,GOOOXXXXXXXXXXXXXXXXGOOOOOXXXXXXXXXXXXXXGOOOOOOOXXXXXXXXXXXXGOXXXXXXXXXXXXXXXXXXGOOOOOOOOOOXXXXXXXXXGOXXXXXXXXXXXXXXXXXXGOOOXXXXXXXXXXXXXXXXGOOXXXXXXXXXXXXXXXXXGOOOXXXXXXXXXXXXXXXXGOOOOOXXXXXXXXXXXXXXGOOXXXXXXXXXXXXXXXXXGOOOOOOXXXXXXXXXXXXXGOOOOOOOOXXXXXXXXXXX,0,300,0
36498,69,0,69,3,228,0,0,230,220,10,GOOOXXXXXXXXXXXXXXXXGOOOOOXXXXXXXXXXXXXXGOOOOOOOXXXXXXXXXXXXGOXXXXXXXXXXXXXXXXXXGOOOOOOOOOOXXXXXXXXXGOXXXXXXXXXXXXXXXXXXGOOOXXXXXXXXXXXXXXXXGOOXXXXXXXXXXXXXXXXXGOOOXXXXXXXXXXXXXXXXGOOOOOXXXXXXXXXXXXXXGOOXXXXXXXXXXXXXXXXXGOOOOOOXXXXXXXXXXXXXGOOOOOOOOXXXXXXXXXXX,0,300,0
36519,69,0,69,2,229,0,0,231,220,11,GOOOXXXXXXXXXXXXXXXXGOOOOOXXXXXXXXXXXXXXGOOOOOOOXXXXXXXXXXXXGOXXXXXXXXXXXXXXXXXXGOOOOOOOOOOXXXXXXXXXGOXXXXXXXXXXXXXXXXXXGOOOXXXXXXXXXXXXXXXXGOOXXXXXXXXXXXXXXXXXGOOOXXXXXXXXXXXXXXXXGOOOOOXXXXXXXXXXXXXXGOOXXXXXXXXXXXXXXXXXGOOOOOOXXXXXXXXXXXXXGOOOOOOOOXXXXXXXXXXX,0,300,0

36540,69,0,69,2,229,0,0,231,221,10,GOOOXXXXXXXXXXXXXXXXGOOOOOXXXXXXXXXXXXXXGOOOOOOOXXXXXXXXXXXXGOXXXXXXXXXXXXXXXXXXGOOOOOOOOOOXXXXXXXXXGOXXXXXXXXXXXXXXXXXXGOOOXXXXXXXXXXXXXXXXGOOXXXXXXXXXXXXXXXXXGOOOXXXXXXXXXXXXXXXXGOOOOOXXXXXXXXXXXXXXGOOXXXXXXXXXXXXXXXXXGOOOOOOXXXXXXXXXXXXXGOOOOOOOOXXXXXXXXXXX,0,300,0
36561,69,0,69,1,230,0,0,230,220,10,GOOOXXXXXXXXXXXXXXXXGOOOOOXXXXXXXXXXXXXXGOOOOOOOXXXXXXXXXXXXGOXXXXXXXXXXXXXXXXXXGOOOOOOOOOOXXXXXXXXXGOXXXXXXXXXXXXXXXXXXGOOOXXXXXXXXXXXXXXXXGOOXXXXXXXXXXXXXXXXXGOOOXXXXXXXXXXXXXXXXGOOOOOXXXXXXXXXXXXXXGOOXXXXXXXXXXXXXXXXXGOOOOOOXXXXXXXXXXXXXGOOOOOOOOXXXXXXXXXXX,0,300,0
36582,69,0,69,1,230,0,0,232,220,12,GOOOXXXXXXXXXXXXXXXXGOOOOOXXXXXXXXXXXXXXGOOOOOOOXXXXXXXXXXXXGOXXXXXXXXXXXXXXXXXXGOOOOOOOOOOXXXXXXXXXGOXXXXXXXXXXXXXXXXXXGOOOXXXXXXXXXXXXXXXXGOOXXXXXXXXXXXXXXXXXGOOOXXXXXXXXXXXXXXXXGOOOOOXXXXXXXXXXXXXXGOOXXXXXXXXXXXXXXXXXGOOOOOOXXXXXXXXXXXXXGOOOOOOOOXXXXXXXXXXX,0,300,0
36603,69,0,69,1,230,0,0,232,221,11,GOOOXXXXXXXXXXXXXXXXGOOOOOXXXXXXXXXXXXXXGOOOOOOOXXXXXXXXXXXXGOXXXXXXXXXXXXXXXXXXGOOOOOOOOOOXXXXXXXXXGOXXXXXXXXXXXXXXXXXXGOOOXXXXXXXXXXXXXXXXGOOXXXXXXXXXXXXXXXXXGOOOXXXXXXXXXXXXXXXXGOOOOOXXXXXXXXXXXXXXGOOXXXXXXXXXXXXXXXXXGOOOOOOXXXXXXXXXXXXXGOOOOOOOOXXXXXXXXXXX,0,300,0
36624,69,0,69,4,227,0,0,229,220,9,GOOOXXXXXXXXXXXXXXXXGOOOOOXXXXXXXXXXXXXXGOOOOOOOXXXXXXXXXXXXGOXXXXXXXXXXXXXXXXXXGOOOOOOOOOOXXXXXXXXXGOXXXXXXXXXXXXXXXXXXGOOOXXXXXXXXXXXXXXXXGOOXXXXXXXXXXXXXXXXXGOOOXXXXXXXXXXXXXXXXGOOOOOXXXXXXXXXXXXXXGOOXXXXXXXXXXXXXXXXXGOOOOOOXXXXXXXXXXXXXGOOOOOOOOXXXXXXXXXXX,0,300,0

36645,69,0,69,4,227,0,0,229,221,8,GOOOXXXXXXXXXXXXXXXXGOOOOOXXXXXXXXXXXXXXGOOOOOOOXXXXXXXXXXXXGOXXXXXXXXXXXXXXXXXXGOOOOOOOOOOXXXXXXXXXGOXXXXXXXXXXXXXXXXXXGOOOXXXXXXXXXXXXXXXXGOOXXXXXXXXXXXXXXXXXGOOOXXXXXXXXXXXXXXXXGOOOOOXXXXXXXXXXXXXXGOOXXXXXXXXXXXXXXXXXGOOOOOOXXXXXXXXXXXXXGOOOOOOOOXXXXXXXXXXX,0,300,0
36666,69,0,69,5,226,0,0,228,220,8,GOOOXXXXXXXXXXXXXXXXGOOOOOXXXXXXXXXXXXXXGOOOOOOOXXXXXXXXXXXXGOXXXXXXXXXXXXXXXXXXGOOOOOOOOOOXXXXXXXXXGOXXXXXXXXXXXXXXXXXXGOOOXXXXXXXXXXXXXXXXGOOXXXXXXXXXXXXXXXXXGOOOXXXXXXXXXXXXXXXXGOOOOOXXXXXXXXXXXXXXGOOXXXXXXXXXXXXXXXXXGOOOOOOXXXXXXXXXXXXXGOOOOOOOOXXXXXXXXXXX,0,300,0
36687,69,0,69,5,226,0,0,228,220,8,GOOOXXXXXXXXXXXXXXXXGOOOOOXXXXXXXXXXXXXXGOOOOOOOXXXXXXXXXXXXGOXXXXXXXXXXXXXXXXXXGOOOOOOOOOOXXXXXXXXXGOXXXXXXXXXXXXXXXXXXGOOOXXXXXXXXXXXXXXXXGOOXXXXXXXXXXXXXXXXXGOOOXXXXXXXXXXXXXXXXGOOOOOXXXXXXXXXXXXXXGOOXXXXXXXXXXXXXXXXXGOOOOOOXXXXXXXXXXXXXGOOOOOOOOXXXXXXXXXXX,0,300,0
36708,69,0,69,5,226,0,0,228,220,8,GOOOXXXXXXXXXXXXXXXXGOOOOOXXXXXXXXXXXXXXGOOOOOOOXXXXXXXXXXXXGOXXXXXXXXXXXXXXXXXXGOOOOOOOOOOXXXXXXXXXGOXXXXXXXXXXXXXXXXXXGOOOXXXXXXXXXXXXXXXXGOOXXXXXXXXXXXXXXXXXGOOOXXXXXXXXXXXXXXXXGOOOOOXXXXXXXXXXXXXXGOOXXXXXXXXXXXXXXXXXGOOOOOOXXXXXXXXXXXXXGOOOOOOOOXXXXXXXXXXX,0,300,0
36729,69,0,69,5,226,0,0,228,220,8,GOOOXXXXXXXXXXXXXXXXGOOOOOXXXXXXXXXXXXXXGOOOOOOOXXXXXXXXXXXXGOXXXXXXXXXXXXXXXXXXGOOOOOOOOOOXXXXXXXXXGOXXXXXXXXXXXXXXXXXXGOOOXXXXXXXXXXXXXXXXGOOXXXXXXXXXXXXXXXXXGOOOXXXXXXXXXXXXXXXXGOOOOOXXXXXXXXXXXXXXGOOXXXXXXXXXXXXXXXXXGOOOOOOXXXXXXXXXXXXXGOOOOOOOOXXXXXXXXXXX,0,300,0

36750,69,0,69,5,226,0,0,228,221,7,GOOOXXXXXXXXXXXXXXXXGOOOOOXXXXXXXXXXXXXXGOOOOOOOXXXXXXXXXXXXGOXXXXXXXXXXXXXXXXXXGOOOOOOOOOOXXXXXXXXXGOXXXXXXXXXXXXXXXXXXGOOOXXXXXXXXXXXXXXXXGOOXXXXXXXXXXXXXXXXXGOOOXXXXXXXXXXXXXXXXGOOOOOXXXXXXXXXXXXXXGOOXXXXXXXXXXXXXXXXXGOOOOOOXXXXXXXXXXXXXGOOOOOOOOXXXXXXXXXXX,0,300,0
36771,69,0,69,5,226,0,0,228,221,7,GOOOXXXXXXXXXXXXXXXXGOOOOOXXXXXXXXXXXXXXGOOOOOOOXXXXXXXXXXXXGOXXXXXXXXXXXXXXXXXXGOOOOOOOOOOXXXXXXXXXGOXXXXXXXXXXXXXXXXXXGOOOXXXXXXXXXXXXXXXXGOOXXXXXXXXXXXXXXXXXGOOOXXXXXXXXXXXXXXXXGOOOOOXXXXXXXXXXXXXXGOOXXXXXXXXXXXXXXXXXGOOOOOOXXXXXXXXXXXXXGOOOOOOOOXXXXXXXXXXX,0,300,0
36792,69,0,69,7,224,0,0,226,220,6,GOOOXXXXXXXXXXXXXXXXGOOOOOXXXXXXXXXXXXXXGOOOOOOOXXXXXXXXXXXXGOXXXXXXXXXXXXXXXXXXGOOOOOOOOOOXXXXXXXXXGOXXXXXXXXXXXXXXXXXXGOOOXXXXXXXXXXXXXXXXGOOXXXXXXXXXXXXXXXXXGOOOXXXXXXXXXXXXXXXXGOOOOOXXXXXXXXXXXXXXGOOXXXXXXXXXXXXXXXXXGOOOOOOXXXXXXXXXXXXXGOOOOOOOOXXXXXXXXXXX,0,300,0
36813,69,0,69,6,225,0,0,227,220,7,GOOOXXXXXXXXXXXXXXXXGOOOOOXXXXXXXXXXXXXXGOOOOOOOXXXXXXXXXXXXGOXXXXXXXXXXXXXXXXXXGOOOOOOOOOOXXXXXXXXXGOXXXXXXXXXXXXXXXXXXGOOOXXXXXXXXXXXXXXXXGOOXXXXXXXXXXXXXXXXXGOOOXXXXXXXXXXXXXXXXGOOOOOXXXXXXXXXXXXXXGOOXXXXXXXXXXXXXXXXXGOOOOOOXXXXXXXXXXXXXGOOOOOOOOXXXXXXXXXXX,0,300,0
36834,69,0,69,4,227,0,0,229,221,8,GOOOXXXXXXXXXXXXXXXXGOOOOOXXXXXXXXXXXXXXGOOOOOOOXXXXXXXXXXXXGOXXXXXXXXXXXXXXXXXXGOOOOOOOOOOXXXXXXXXXGOXXXXXXXXXXXXXXXXXXGOOOXXXXXXXXXXXXXXXXGOOXXXXXXXXXXXXXXXXXGOOOXXXXXXXXXXXXXXXXGOOOOOXXXXXXXXXXXXXXGOOXXXXXXXXXXXXXXXXXGOOOOOOXXXXXXXXXXXXXGOOOOOOOOXXXXXXXXXXX,0,300,0

36855,69,0,69,4,227,0,0,229,221,8,GOOOXXXXXXXXXXXXXXXXGOOOOOXXXXXXXXXXXXXXGOOOOOOOXXXXXXXXXXXXGOXXXXXXXXXXXXXXXXXXGOOOOOOOOOOXXXXXXXXXGOXXXXXXXXXXXXXXXXXXGOOOXXXXXXXXXXXXXXXXGOOXXXXXXXXXXXXXXXXXGOOOXXXXXXXXXXXXXXXXGOOOOOXXXXXXXXXXXXXXGOOXXXXXXXXXXXXXXXXXGOOOOOOXXXXXXXXXXXXXGOOOOOOOOXXXXXXXXXXX,0,300,0
36876,69,0,69,5,226,0,0,228,220,8,GOOOXXXXXXXXXXXXXXXXGOOOOOXXXXXXXXXXXXXXGOOOOOOOXXXXXXXXXXXXGOXXXXXXXXXXXXXXXXXXGOOOOOOOOOOXXXXXXXXXGOXXXXXXXXXXXXXXXXXXGOOOXXXXXXXXXXXXXXXXGOOXXXXXXXXXXXXXXXXXGOOOXXXXXXXXXXXXXXXXGOOOOOXXXXXXXXXXXXXXGOOXXXXXXXXXXXXXXXXXGOOOOOOXXXXXXXXXXXXXGOOOOOOOOXXXXXXXXXXX,0,300,0
36897,69,0,69,5,226,0,0,228,220,8,GOOOXXXXXXXXXXXXXXXXGOOOOOXXXXXXXXXXXXXXGOOOOOOOXXXXXXXXXXXXGOXXXXXXXXXXXXXXXXXXGOOOOOOOOOOXXXXXXXXXGOXXXXXXXXXXXXXXXXXXGOOOXXXXXXXXXXXXXXXXGOOXXXXXXXXXXXXXXXXXGOOOXXXXXXXXXXXXXXXXGOOOOOXXXXXXXXXXXXXXGOOXXXXXXXXXXXXXXXXXGOOOOOOXXXXXXXXXXXXXGOOOOOOOOXXXXXXXXXXX,0,300,0
36918,69,0,69,5,226,0,0,228,221,7,GOOOXXXXXXXXXXXXXXXXGOOOOOXXXXXXXXXXXXXXGOOOOOOOXXXXXXXXXXXXGOXXXXXXXXXXXXXXXXXXGOOOOOOOOOOXXXXXXXXXGOXXXXXXXXXXXXXXXXXXGOOOXXXXXXXXXXXXXXXXGOOXXXXXXXXXXXXXXXXXGOOOXXXXXXXXXXXXXXXXGOOOOOXXXXXXXXXXXXXXGOOXXXXXXXXXXXXXXXXXGOOOOOOXXXXXXXXXXXXXGOOOOOOOOXXXXXXXXXXX,0,300,0
36939,69,0,69,5,226,0,0,228,221,7,GOOOXXXXXXXXXXXXXXXXGOOOOOXXXXXXXXXXXXXXGOOOOOOOXXXXXXXXXXXXGOXXXXXXXXXXXXXXXXXXGOOOOOOOOOOXXXXXXXXXGOXXXXXXXXXXXXXXXXXXGOOOXXXXXXXXXXXXXXXXGOOXXXXXXXXXXXXXXXXXGOOOXXXXXXXXXXXXXXXXGOOOOOXXXXXXXXXXXXXXGOOXXXXXXXXXXXXXXXXXGOOOOOOXXXXXXXXXXXXXGOOOOOOOOXXXXXXXXXXX,0,300,0

36960,69,0,69,6,225,0,0,227,220,7,GOOOXXXXXXXXXXXXXXXXGOOOOOXXXXXXXXXXXXXXGOOOOOOOXXXXXXXXXXXXGOXXXXXXXXXXXXXXXXXXGOOOOOOOOOOXXXXXXXXXGOXXXXXXXXXXXXXXXXXXGOOOXXXXXXXXXXXXXXXXGOOXXXXXXXXXXXXXXXXXGOOOXXXXXXXXXXXXXXXXGOOOOOXXXXXXXXXXXXXXGOOXXXXXXXXXXXXXXXXXGOOOOOOXXXXXXXXXXXXXGOOOOOOOOXXXXXXXXXXX,0,300,0
36981,69,0,69,5,226,0,0,228,220,8,GOOOXXXXXXXXXXXXXXXXGOOOOOXXXXXXXXXXXXXXGOOOOOOOXXXXXXXXXXXXGOXXXXXXXXXXXXXXXXXXGOOOOOOOOOOXXXXXXXXXGOXXXXXXXXXXXXXXXXXXGOOOXXXXXXXXXXXXXXXXGOOXXXXXXXXXXXXXXXXXGOOOXXXXXXXXXXXXXXXXGOOOOOXXXXXXXXXXXXXXGOOXXXXXXXXXXXXXXXXXGOOOOOOXXXXXXXXXXXXXGOOOOOOOOXXXXXXXXXXX,0,300,0
37002,69,0,69,5,226,0,0,228,220,8,GOOOXXXXXXXXXXXXXXXXGOOOOOXXXXXXXXXXXXXXGOOOOOOOXXXXXXXXXXXXGOXXXXXXXXXXXXXXXXXXGOOOOOOOOOOXXXXXXXXXGOXXXXXXXXXXXXXXXXXXGOOOXXXXXXXXXXXXXXXXGOOXXXXXXXXXXXXXXXXXGOOOXXXXXXXXXXXXXXXXGOOOOOXXXXXXXXXXXXXXGOOXXXXXXXXXXXXXXXXXGOOOOOOXXXXXXXXXXXXXGOOOOOOOOXXXXXXXXXXX,0,300,0
37023,69,0,69,5,226,0,0,228,222,6,GOOOXXXXXXXXXXXXXXXXGOOOOOXXXXXXXXXXXXXXGOOOOOOOXXXXXXXXXXXXGOXXXXXXXXXXXXXXXXXXGOOOOOOOOOOXXXXXXXXXGOXXXXXXXXXXXXXXXXXXGOOOXXXXXXXXXXXXXXXXGOOXXXXXXXXXXXXXXXXXGOOOXXXXXXXXXXXXXXXXGOOOOOXXXXXXXXXXXXXXGOOXXXXXXXXXXXXXXXXXGOOOOOOXXXXXXXXXXXXXGOOOOOOOOXXXXXXXXXXX,0,300,0
37044,69,0,69,5,226,0,0,228,221,7,GOOOXXXXXXXXXXXXXXXXGOOOOOXXXXXXXXXXXXXXGOOOOOOOXXXXXXXXXXXXGOXXXXXXXXXXXXXXXXXXGOOOOOOOOOOXXXXXXXXXGOXXXXXXXXXXXXXXXXXXGOOOXXXXXXXXXXXXXXXXGOOXXXXXXXXXXXXXXXXXGOOOXXXXXXXXXXXXXXXXGOOOOOXXXXXXXXXXXXXXGOOXXXXXXXXXXXXXXXXXGOOOOOOXXXXXXXXXXXXXGOOOOOOOOXXXXXXXXXXX,0,300,0

37065,69,0,69,6,225,0,0,227,220,7,GOOOXXXXXXXXXXXXXXXXGOOOOOXXXXXXXXXXXXXXGOOOOOOOXXXXXXXXXXXXGOXXXXXXXXXXXXXXXXXXGOOOOOOOOOOXXXXXXXXXGOXXXXXXXXXXXXXXXXXXGOOOXXXXXXXXXXXXXXXXGOOXXXXXXXXXXXXXXXXXGOOOXXXXXXXXXXXXXXXXGOOOOOXXXXXXXXXXXXXXGOOXXXXXXXXXXXXXXXXXGOOOOOOXXXXXXXXXXXXXGOOOOOOOOXXXXXXXXXXX,0,300,0
37086,69,0,69,6,225,0,0,227,221,6,GOOOXXXXXXXXXXXXXXXXGOOOOOXXXXXXXXXXXXXXGOOOOOOOXXXXXXXXXXXXGOXXXXXXXXXXXXXXXXXXGOOOOOOOOOOXXXXXXXXXGOXXXXXXXXXXXXXXXXXXGOOOXXXXXXXXXXXXXXXXGOOXXXXXXXXXXXXXXXXXGOOOXXXXXXXXXXXXXXXXGOOOOOXXXXXXXXXXXXXXGOOXXXXXXXXXXXXXXXXXGOOOOOOXXXXXXXXXXXXXGOOOOOOOOXXXXXXXXXXX,0,300,0
37107,69,0,69,5,226,0,0,228,221,7,GOOOXXXXXXXXXXXXXXXXGOOOOOXXXXXXXXXXXXXXGOOOOOOOXXXXXXXXXXXXGOXXXXXXXXXXXXXXXXXXGOOOOOOOOOOXXXXXXXXXGOXXXXXXXXXXXXXXXXXXGOOOXXXXXXXXXXXXXXXXGOOXXXXXXXXXXXXXXXXXGOOOXXXXXXXXXXXXXXXXGOOOOOXXXXXXXXXXXXXXGOOXXXXXXXXXXXXXXXXXGOOOOOOXXXXXXXXXXXXXGOOOOOOOOXXXXXXXXXXX,0,300,0
37128,69,0,69,5,226,0,0,228,220,8,GOOOXXXXXXXXXXXXXXXXGOOOOOXXXXXXXXXXXXXXGOOOOOOOXXXXXXXXXXXXGOXXXXXXXXXXXXXXXXXXGOOOOOOOOOOXXXXXXXXXGOXXXXXXXXXXXXXXXXXXGOOOXXXXXXXXXXXXXXXXGOOXXXXXXXXXXXXXXXXXGOOOXXXXXXXXXXXXXXXXGOOOOOXXXXXXXXXXXXXXGOOXXXXXXXXXXXXXXXXXGOOOOOOXXXXXXXXXXXXXGOOOOOOOOXXXXXXXXXXX,0,300,0
37149,69,0,69,4,227,0,0,229,221,8,GOOOXXXXXXXXXXXXXXXXGOOOOOXXXXXXXXXXXXXXGOOOOOOOXXXXXXXXXXXXGOXXXXXXXXXXXXXXXXXXGOOOOOOOOOOXXXXXXXXXGOXXXXXXXXXXXXXXXXXXGOOOXXXXXXXXXXXXXXXXGOOXXXXXXXXXXXXXXXXXGOOOXXXXXXXXXXXXXXXXGOOOOOXXXXXXXXXXXXXXGOOXXXXXXXXXXXXXXXXXGOOOOOOXXXXXXXXXXXXXGOOOOOOOOXXXXXXXXXXX,0,300,0

37170,69,0,69,5,226,0,0,228,220,8,GOOOXXXXXXXXXXXXXXXXGOOOOOXXXXXXXXXXXXXXGOOOOOOOXXXXXXXXXXXXGOXXXXXXXXXXXXXXXXXXGOOOOOOOOOOXXXXXXXXXGOXXXXXXXXXXXXXXXXXXGOOOXXXXXXXXXXXXXXXXGOOXXXXXXXXXXXXXXXXXGOOOXXXXXXXXXXXXXXXXGOOOOOXXXXXXXXXXXXXXGOOXXXXXXXXXXXXXXXXXGOOOOOOXXXXXXXXXXXXXGOOOOOOOOXXXXXXXXXXX,0,300,0
37191,69,0,69,5,226,0,0,228,220,8,GOOOXXXXXXXXXXXXXXXXGOOOOOXXXXXXXXXXXXXXGOOOOOOOXXXXXXXXXXXXGOXXXXXXXXXXXXXXXXXXGOOOOOOOOOOXXXXXXXXXGOXXXXXXXXXXXXXXXXXXGOOOXXXXXXXXXXXXXXXXGOOXXXXXXXXXXXXXXXXXGOOOXXXXXXXXXXXXXXXXGOOOOOXXXXXXXXXXXXXXGOOXXXXXXXXXXXXXXXXXGOOOOOOXXXXXXXXXXXXXGOOOOOOOOXXXXXXXXXXX,0,300,0
37212,69,0,69,3,228,0,0,230,221,9,GOOOXXXXXXXXXXXXXXXXGOOOOOXXXXXXXXXXXXXXGOOOOOOOXXXXXXXXXXXXGOXXXXXXXXXXXXXXXXXXGOOOOOOOOOOXXXXXXXXXGOXXXXXXXXXXXXXXXXXXGOOOXXXXXXXXXXXXXXXXGOOXXXXXXXXXXXXXXXXXGOOOXXXXXXXXXXXXXXXXGOOOOOXXXXXXXXXXXXXXGOOXXXXXXXXXXXXXXXXXGOOOOOOXXXXXXXXXXXXXGOOOOOOOOXXXXXXXXXXX,0,300,0
37233,69,0,69,3,228,0,0,230,220,10,GOOOXXXXXXXXXXXXXXXXGOOOOOXXXXXXXXXXXXXXGOOOOOOOXXXXXXXXXXXXGOXXXXXXXXXXXXXXXXXXGOOOOOOOOOOXXXXXXXXXGOXXXXXXXXXXXXXXXXXXGOOOXXXXXXXXXXXXXXXXGOOXXXXXXXXXXXXXXXXXGOOOXXXXXXXXXXXXXXXXGOOOOOXXXXXXXXXXXXXXGOOXXXXXXXXXXXXXXXXXGOOOOOOXXXXXXXXXXXXXGOOOOOOOOXXXXXXXXXXX,0,300,0
37254,69,0,69,3,228,0,0,230,220,10,GOOOXXXXXXXXXXXXXXXXGOOOOOXXXXXXXXXXXXXXGOOOOOOOXXXXXXXXXXXXGOXXXXXXXXXXXXXXXXXXGOOOOOOOOOOXXXXXXXXXGOXXXXXXXXXXXXXXXXXXGOOOXXXXXXXXXXXXXXXXGOOXXXXXXXXXXXXXXXXXGOOOXXXXXXXXXXXXXXXXGOOOOOXXXXXXXXXXXXXXGOOXXXXXXXXXXXXXXXXXGOOOOOOXXXXXXXXXXXXXGOOOOOOOOXXXXXXXXXXX,0,300,0

37275,69,0,69,4,227,0,0,229,220,9,GOOOXXXXXXXXXXXXXXXXGOOOOOXXXXXXXXXXXXXXGOOOOOOOXXXXXXXXXXXXGOXXXXXXXXXXXXXXXXXXGOOOOOOOOOOXXXXXXXXXGOXXXXXXXXXXXXXXXXXXGOOOXXXXXXXXXXXXXXXXGOOXXXXXXXXXXXXXXXXXGOOOXXXXXXXXXXXXXXXXGOOOOOXXXXXXXXXXXXXXGOOXXXXXXXXXXXXXXXXXGOOOOOOXXXXXXXXXXXXXGOOOOOOOOXXXXXXXXXXX,0,300,0
37296,69,0,69,4,227,0,0,229,221,8,GOOOXXXXXXXXXXXXXXXXGOOOOOXXXXXXXXXXXXXXGOOOOOOOXXXXXXXXXXXXGOXXXXXXXXXXXXXXXXXXGOOOOOOOOOOXXXXXXXXXGOXXXXXXXXXXXXXXXXXXGOOOXXXXXXXXXXXXXXXXGOOXXXXXXXXXXXXXXXXXGOOOXXXXXXXXXXXXXXXXGOOOOOXXXXXXXXXXXXXXGOOXXXXXXXXXXXXXXXXXGOOOOOOXXXXXXXXXXXXXGOOOOOOOOXXXXXXXXXXX,0,300,0
37317,69,0,69,5,226,0,0,228,220,8,GOOOXXXXXXXXXXXXXXXXGOOOOOXXXXXXXXXXXXXXGOOOOOOOXXXXXXXXXXXXGOXXXXXXXXXXXXXXXXXXGOOOOOOOOOOXXXXXXXXXGOXXXXXXXXXXXXXXXXXXGOOOXXXXXXXXXXXXXXXXGOOXXXXXXXXXXXXXXXXXGOOOXXXXXXXXXXXXXXXXGOOOOOXXXXXXXXXXXXXXGOOXXXXXXXXXXXXXXXXXGOOOOOOXXXXXXXXXXXXXGOOOOOOOOXXXXXXXXXXX,0,300,0
37338,69,0,69,4,227,0,0,229,220,9,GOOOXXXXXXXXXXXXXXXXGOOOOOXXXXXXXXXXXXXXGOOOOOOOXXXXXXXXXXXXGOXXXXXXXXXXXXXXXXXXGOOOOOOOOOOXXXXXXXXXGOXXXXXXXXXXXXXXXXXXGOOOXXXXXXXXXXXXXXXXGOOXXXXXXXXXXXXXXXXXGOOOXXXXXXXXXXXXXXXXGOOOOOXXXXXXXXXXXXXXGOOXXXXXXXXXXXXXXXXXGOOOOOOXXXXXXXXXXXXXGOOOOOOOOXXXXXXXXXXX,0,300,0
37359,69,0,69,4,227,0,0,229,220,9,GOOOXXXXXXXXXXXXXXXXGOOOOOXXXXXXXXXXXXXXGOOOOOOOXXXXXXXXXXXXGOXXXXXXXXXXXXXXXXXXGOOOOOOOOOOXXXXXXXXXGOXXXXXXXXXXXXXXXXXXGOOOXXXXXXXXXXXXXXXXGOOXXXXXXXXXXXXXXXXXGOOOXXXXXXXXXXXXXXXXGOOOOOXXXXXXXXXXXXXXGOOXXXXXXXXXXXXXXXXXGOOOOOOXXXXXXXXXXXXXGOOOOOOOOXXXXXXXXXXX,0,300,0

37380,69,0,69,4,227,0,0,229,220,9,GOOOXXXXXXXXXXXXXXXXGOOOOOXXXXXXXXXXXXXXGOOOOOOOXXXXXXXXXXXXGOXXXXXXXXXXXXXXXXXXGOOOOOOOOOOXXXXXXXXXGOXXXXXXXXXXXXXXXXXXGOOOXXXXXXXXXXXXXXXXGOOXXXXXXXXXXXXXXXXXGOOOXXXXXXXXXXXXXXXXGOOOOOXXXXXXXXXXXXXXGOOXXXXXXXXXXXXXXXXXGOOOOOOXXXXXXXXXXXXXGOOOOOOOOXXXXXXXXXXX,0,300,0
37401,69,0,69,4,227,0,0,229,220,9,GOOOXXXXXXXXXXXXXXXXGOOOOOXXXXXXXXXXXXXXGOOOOOOOXXXXXXXXXXXXGOXXXXXXXXXXXXXXXXXXGOOOOOOOOOOXXXXXXXXXGOXXXXXXXXXXXXXXXXXXGOOOXXXXXXXXXXXXXXXXGOOXXXXXXXXXXXXXXXXXGOOOXXXXXXXXXXXXXXXXGOOOOOXXXXXXXXXXXXXXGOOXXXXXXXXXXXXXXXXXGOOOOOOXXXXXXXXXXXXXGOOOOOOOOXXXXXXXXXXX,0,300,0
37422,69,0,69,4,227,0,0,229,221,8,GOOOXXXXXXXXXXXXXXXXGOOOOOXXXXXXXXXXXXXXGOOOOOOOXXXXXXXXXXXXGOXXXXXXXXXXXXXXXXXXGOOOOOOOOOOXXXXXXXXXGOXXXXXXXXXXXXXXXXXXGOOOXXXXXXXXXXXXXXXXGOOXXXXXXXXXXXXXXXXXGOOOXXXXXXXXXXXXXXXXGOOOOOXXXXXXXXXXXXXXGOOXXXXXXXXXXXXXXXXXGOOOOOOXXXXXXXXXXXXXGOOOOOOOOXXXXXXXXXXX,0,300,0
37443,69,0,69,4,227,0,0,229,220,9,GOOOXXXXXXXXXXXXXXXXGOOOOOXXXXXXXXXXXXXXGOOOOOOOXXXXXXXXXXXXGOXXXXXXXXXXXXXXXXXXGOOOOOOOOOOXXXXXXXXXGOXXXXXXXXXXXXXXXXXXGOOOXXXXXXXXXXXXXXXXGOOXXXXXXXXXXXXXXXXXGOOOXXXXXXXXXXXXXXXXGOOOOOXXXXXXXXXXXXXXGOOXXXXXXXXXXXXXXXXXGOOOOOOXXXXXXXXXXXXXGOOOOOOOOXXXXXXXXXXX,0,300,0
37464,69,0,69,2,229,0,0,231,220,11,GOOOXXXXXXXXXXXXXXXXGOOOOOXXXXXXXXXXXXXXGOOOOOOOXXXXXXXXXXXXGOXXXXXXXXXXXXXXXXXXGOOOOOOOOOOXXXXXXXXXGOXXXXXXXXXXXXXXXXXXGOOOXXXXXXXXXXXXXXXXGOOXXXXXXXXXXXXXXXXXGOOOXXXXXXXXXXXXXXXXGOOOOOXXXXXXXXXXXXXXGOOXXXXXXXXXXXXXXXXXGOOOOOOXXXXXXXXXXXXXGOOOOOOOOXXXXXXXXXXX,0,300,0

37485,69,0,69,1,230,0,0,232,222,10,GOOOXXXXXXXXXXXXXXXXGOOOOOXXXXXXXXXXXXXXGOOOOOOOXXXXXXXXXXXXGOXXXXXXXXXXXXXXXXXXGOOOOOOOOOOXXXXXXXXXGOXXXXXXXXXXXXXXXXXXGOOOXXXXXXXXXXXXXXXXGOOXXXXXXXXXXXXXXXXXGOOOXXXXXXXXXXXXXXXXGOOOOOXXXXXXXXXXXXXXGOOXXXXXXXXXXXXXXXXXGOOOOOOXXXXXXXXXXXXXGOOOOOOOOXXXXXXXXXXX,0,300,0
37506,69,0,69,4,227,0,0,229,220,9,GOOOXXXXXXXXXXXXXXXXGOOOOOXXXXXXXXXXXXXXGOOOOOOOXXXXXXXXXXXXGOXXXXXXXXXXXXXXXXXXGOOOOOOOOOOXXXXXXXXXGOXXXXXXXXXXXXXXXXXXGOOOXXXXXXXXXXXXXXXXGOOXXXXXXXXXXXXXXXXXGOOOXXXXXXXXXXXXXXXXGOOOOOXXXXXXXXXXXXXXGOOXXXXXXXXXXXXXXXXXGOOOOOOXXXXXXXXXXXXXGOOOOOOOOXXXXXXXXXXX,0,300,0
37527,69,0,69,4,227,0,0,229,220,9,GOOOXXXXXXXXXXXXXXXXGOOOOOXXXXXXXXXXXXXXGOOOOOOOXXXXXXXXXXXXGOXXXXXXXXXXXXXXXXXXGOOOOOOOOOOXXXXXXXXXGOXXXXXXXXXXXXXXXXXXGOOOXXXXXXXXXXXXXXXXGOOXXXXXXXXXXXXXXXXXGOOOXXXXXXXXXXXXXXXXGOOOOOXXXXXXXXXXXXXXGOOXXXXXXXXXXXXXXXXXGOOOOOOXXXXXXXXXXXXXGOOOOOOOOXXXXXXXXXXX,0,300,0
37548,69,0,69,4,227,0,0,229,220,9,GOOOXXXXXXXXXXXXXXXXGOOOOOXXXXXXXXXXXXXXGOOOOOOOXXXXXXXXXXXXGOXXXXXXXXXXXXXXXXXXGOOOOOOOOOOXXXXXXXXXGOXXXXXXXXXXXXXXXXXXGOOOXXXXXXXXXXXXXXXXGOOXXXXXXXXXXXXXXXXXGOOOXXXXXXXXXXXXXXXXGOOOOOXXXXXXXXXXXXXXGOOXXXXXXXXXXXXXXXXXGOOOOOOXXXXXXXXXXXXXGOOOOOOOOXXXXXXXXXXX,0,300,0
37569,69,0,69,4,227,0,0,229,220,9,GOOOXXXXXXXXXXXXXXXXGOOOOOXXXXXXXXXXXXXXGOOOOOOOXXXXXXXXXXXXGOXXXXXXXXXXXXXXXXXXGOOOOOOOOOOXXXXXXXXXGOXXXXXXXXXXXXXXXXXXGOOOXXXXXXXXXXXXXXXXGOOXXXXXXXXXXXXXXXXXGOOOXXXXXXXXXXXXXXXXGOOOOOXXXXXXXXXXXXXXGOOXXXXXXXXXXXXXXXXXGOOOOOOXXXXXXXXXXXXXGOOOOOOOOXXXXXXXXXXX,0,300,0

37590,69,0,69,4,227,0,0,229,220,9,GOOOXXXXXXXXXXXXXXXXGOOOOOXXXXXXXXXXXXXXGOOOOOOOXXXXXXXXXXXXGOXXXXXXXXXXXXXXXXXXGOOOOOOOOOOXXXXXXXXXGOXXXXXXXXXXXXXXXXXXGOOOXXXXXXXXXXXXXXXXGOOXXXXXXXXXXXXXXXXXGOOOXXXXXXXXXXXXXXXXGOOOOOXXXXXXXXXXXXXXGOOXXXXXXXXXXXXXXXXXGOOOOOOXXXXXXXXXXXXXGOOOOOOOOXXXXXXXXXXX,0,300,0
37611,69,0,69,5,226,0,0,228,220,8,GOOOXXXXXXXXXXXXXXXXGOOOOOXXXXXXXXXXXXXXGOOOOOOOXXXXXXXXXXXXGOXXXXXXXXXXXXXXXXXXGOOOOOOOOOOXXXXXXXXXGOXXXXXXXXXXXXXXXXXXGOOOXXXXXXXXXXXXXXXXGOOXXXXXXXXXXXXXXXXXGOOOXXXXXXXXXXXXXXXXGOOOOOXXXXXXXXXXXXXXGOOXXXXXXXXXXXXXXXXXGOOOOOOXXXXXXXXXXXXXGOOOOOOOOXXXXXXXXXXX,0,300,0
37632,69,0,69,5,226,0,0,228,221,7,GOOOXXXXXXXXXXXXXXXXGOOOOOXXXXXXXXXXXXXXGOOOOOOOXXXXXXXXXXXXGOXXXXXXXXXXXXXXXXXXGOOOOOOOOOOXXXXXXXXXGOXXXXXXXXXXXXXXXXXXGOOOXXXXXXXXXXXXXXXXGOOXXXXXXXXXXXXXXXXXGOOOXXXXXXXXXXXXXXXXGOOOOOXXXXXXXXXXXXXXGOOXXXXXXXXXXXXXXXXXGOOOOOOXXXXXXXXXXXXXGOOOOOOOOXXXXXXXXXXX,0,300,0
37653,69,0,69,8,223,0,0,225,220,5,GOOOXXXXXXXXXXXXXXXXGOOOOOXXXXXXXXXXXXXXGOOOOOOOXXXXXXXXXXXXGOXXXXXXXXXXXXXXXXXXGOOOOOOOOOOXXXXXXXXXGOXXXXXXXXXXXXXXXXXXGOOOXXXXXXXXXXXXXXXXGOOXXXXXXXXXXXXXXXXXGOOOXXXXXXXXXXXXXXXXGOOOOOXXXXXXXXXXXXXXGOOXXXXXXXXXXXXXXXXXGOOOOOOXXXXXXXXXXXXXGOOOOOOOOXXXXXXXXXXX,0,300,0
37674,69,0,69,8,223,0,0,225,220,5,GOOOXXXXXXXXXXXXXXXXGOOOOOXXXXXXXXXXXXXXGOOOOOOOXXXXXXXXXXXXGOXXXXXXXXXXXXXXXXXXGOOOOOOOOOOXXXXXXXXXGOXXXXXXXXXXXXXXXXXXGOOOXXXXXXXXXXXXXXXXGOOXXXXXXXXXXXXXXXXXGOOOXXXXXXXXXXXXXXXXGOOOOOXXXXXXXXXXXXXXGOOXXXXXXXXXXXXXXXXXGOOOOOOXXXXXXXXXXXXXGOOOOOOOOXXXXXXXXXXX,0,300,0

37695,69,0,69,9,222,0,0,224,220,4,GOOOXXXXXXXXXXXXXXXXGOOOOOXXXXXXXXXXXXXXGOOOOOOOXXXXXXXXXXXXGOXXXXXXXXXXXXXXXXXXGOOOOOOOOOOXXXXXXXXXGOXXXXXXXXXXXXXXXXXXGOOOXXXXXXXXXXXXXXXXGOOXXXXXXXXXXXXXXXXXGOOOXXXXXXXXXXXXXXXXGOOOOOXXXXXXXXXXXXXXGOOXXXXXXXXXXXXXXXXXGOOOOOOXXXXXXXXXXXXXGOOOOOOOOXXXXXXXXXXX,0,300,0
37716,69,0,69,8,223,0,0,225,221,4,GOOOXXXXXXXXXXXXXXXXGOOOOOXXXXXXXXXXXXXXGOOOOOOOXXXXXXXXXXXXGOXXXXXXXXXXXXXXXXXXGOOOOOOOOOOXXXXXXXXXGOXXXXXXXXXXXXXXXXXXGOOOXXXXXXXXXXXXXXXXGOOXXXXXXXXXXXXXXXXXGOOOXXXXXXXXXXXXXXXXGOOOOOXXXXXXXXXXXXXXGOOXXXXXXXXXXXXXXXXXGOOOOOOXXXXXXXXXXXXXGOOOOOOOOXXXXXXXXXXX,0,300,0
37737,69,0,69,8,223,0,0,225,221,4,GOOOXXXXXXXXXXXXXXXXGOOOOOXXXXXXXXXXXXXXGOOOOOOOXXXXXXXXXXXXGOXXXXXXXXXXXXXXXXXXGOOOOOOOOOOXXXXXXXXXGOXXXXXXXXXXXXXXXXXXGOOOXXXXXXXXXXXXXXXXGOOXXXXXXXXXXXXXXXXXGOOOXXXXXXXXXXXXXXXXGOOOOOXXXXXXXXXXXXXXGOOXXXXXXXXXXXXXXXXXGOOOOOOXXXXXXXXXXXXXGOOOOOOOOXXXXXXXXXXX,0,300,0
37758,69,0,69,8,223,0,0,225,221,4,GOOOXXXXXXXXXXXXXXXXGOOOOOXXXXXXXXXXXXXXGOOOOOOOXXXXXXXXXXXXGOXXXXXXXXXXXXXXXXXXGOOOOOOOOOOXXXXXXXXXGOXXXXXXXXXXXXXXXXXXGOOOXXXXXXXXXXXXXXXXGOOXXXXXXXXXXXXXXXXXGOOOXXXXXXXXXXXXXXXXGOOOOOXXXXXXXXXXXXXXGOOXXXXXXXXXXXXXXXXXGOOOOOOXXXXXXXXXXXXXGOOOOOOOOXXXXXXXXXXX,0,300,0
37779,69,0,69,7,224,0,0,226,222,4,GOOOXXXXXXXXXXXXXXXXGOOOOOXXXXXXXXXXXXXXGOOOOOOOXXXXXXXXXXXXGOXXXXXXXXXXXXXXXXXXGOOOOOOOOOOXXXXXXXXXGOXXXXXXXXXXXXXXXXXXGOOOXXXXXXXXXXXXXXXXGOOXXXXXXXXXXXXXXXXXGOOOXXXXXXXXXXXXXXXXGOOOOOXXXXXXXXXXXXXXGOOXXXXXXXXXXXXXXXXXGOOOOOOXXXXXXXXXXXXXGOOOOOOOOXXXXXXXXXXX,0,300,0

37800,69,0,69,8,223,0,0,225,220,5,GOOOXXXXXXXXXXXXXXXXGOOOOOXXXXXXXXXXXXXXGOOOOOOOXXXXXXXXXXXXGOXXXXXXXXXXXXXXXXXXGOOOOOOOOOOXXXXXXXXXGOXXXXXXXXXXXXXXXXXXGOOOXXXXXXXXXXXXXXXXGOOXXXXXXXXXXXXXXXXXGOOOXXXXXXXXXXXXXXXXGOOOOOXXXXXXXXXXXXXXGOOXXXXXXXXXXXXXXXXXGOOOOOOXXXXXXXXXXXXXGOOOOOOOOXXXXXXXXXXX,0,300,0
37821,69,0,69,7,224,0,0,226,220,6,GOOOXXXXXXXXXXXXXXXXGOOOOOXXXXXXXXXXXXXXGOOOOOOOXXXXXXXXXXXXGOXXXXXXXXXXXXXXXXXXGOOOOOOOOOOXXXXXXXXXGOXXXXXXXXXXXXXXXXXXGOOOXXXXXXXXXXXXXXXXGOOXXXXXXXXXXXXXXXXXGOOOXXXXXXXXXXXXXXXXGOOOOOXXXXXXXXXXXXXXGOOXXXXXXXXXXXXXXXXXGOOOOOOXXXXXXXXXXXXXGOOOOOOOOXXXXXXXXXXX,0,300,0
37842,69,0,69,7,224,0,0,226,220,6,GOOOXXXXXXXXXXXXXXXXGOOOOOXXXXXXXXXXXXXXGOOOOOOOXXXXXXXXXXXXGOXXXXXXXXXXXXXXXXXXGOOOOOOOOOOXXXXXXXXXGOXXXXXXXXXXXXXXXXXXGOOOXXXXXXXXXXXXXXXXGOOXXXXXXXXXXXXXXXXXGOOOXXXXXXXXXXXXXXXXGOOOOOXXXXXXXXXXXXXXGOOXXXXXXXXXXXXXXXXXGOOOOOOXXXXXXXXXXXXXGOOOOOOOOXXXXXXXXXXX,0,300,0
37863,69,0,69,4,227,0,0,229,220,9,GOOOXXXXXXXXXXXXXXXXGOOOOOXXXXXXXXXXXXXXGOOOOOOOXXXXXXXXXXXXGOXXXXXXXXXXXXXXXXXXGOOOOOOOOOOXXXXXXXXXGOXXXXXXXXXXXXXXXXXXGOOOXXXXXXXXXXXXXXXXGOOXXXXXXXXXXXXXXXXXGOOOXXXXXXXXXXXXXXXXGOOOOOXXXXXXXXXXXXXXGOOXXXXXXXXXXXXXXXXXGOOOOOOXXXXXXXXXXXXXGOOOOOOOOXXXXXXXXXXX,0,300,0
37884,69,0,69,3,228,0,0,230,221,9,GOOOXXXXXXXXXXXXXXXXGOOOOOXXXXXXXXXXXXXXGOOOOOOOXXXXXXXXXXXXGOXXXXXXXXXXXXXXXXXXGOOOOOOOOOOXXXXXXXXXGOXXXXXXXXXXXXXXXXXXGOOOXXXXXXXXXXXXXXXXGOOXXXXXXXXXXXXXXXXXGOOOXXXXXXXXXXXXXXXXGOOOOOXXXXXXXXXXXXXXGOOXXXXXXXXXXXXXXXXXGOOOOOOXXXXXXXXXXXXXGOOOOOOOOXXXXXXXXXXX,0,300,0

37905,69,0,69,4,227,0,0,229,221,8,GOOOXXXXXXXXXXXXXXXXGOOOOOXXXXXXXXXXXXXXGOOOOOOOXXXXXXXXXXXXGOXXXXXXXXXXXXXXXXXXGOOOOOOOOOOXXXXXXXXXGOXXXXXXXXXXXXXXXXXXGOOOXXXXXXXXXXXXXXXXGOOXXXXXXXXXXXXXXXXXGOOOXXXXXXXXXXXXXXXXGOOOOOXXXXXXXXXXXXXXGOOXXXXXXXXXXXXXXXXXGOOOOOOXXXXXXXXXXXXXGOOOOOOOOXXXXXXXXXXX,0,300,0
37926,69,0,69,5,226,0,0,228,220,8,GOOOXXXXXXXXXXXXXXXXGOOOOOXXXXXXXXXXXXXXGOOOOOOOXXXXXXXXXXXXGOXXXXXXXXXXXXXXXXXXGOOOOOOOOOOXXXXXXXXXGOXXXXXXXXXXXXXXXXXXGOOOXXXXXXXXXXXXXXXXGOOXXXXXXXXXXXXXXXXXGOOOXXXXXXXXXXXXXXXXGOOOOOXXXXXXXXXXXXXXGOOXXXXXXXXXXXXXXXXXGOOOOOOXXXXXXXXXXXXXGOOOOOOOOXXXXXXXXXXX,0,300,0
37947,69,0,69,4,227,0,0,229,220,9,GOOOXXXXXXXXXXXXXXXXGOOOOOXXXXXXXXXXXXXXGOOOOOOOXXXXXXXXXXXXGOXXXXXXXXXXXXXXXXXXGOOOOOOOOOOXXXXXXXXXGOXXXXXXXXXXXXXXXXXXGOOOXXXXXXXXXXXXXXXXGOOXXXXXXXXXXXXXXXXXGOOOXXXXXXXXXXXXXXXXGOOOOOXXXXXXXXXXXXXXGOOXXXXXXXXXXXXXXXXXGOOOOOOXXXXXXXXXXXXXGOOOOOOOOXXXXXXXXXXX,0,300,0
37968,69,0,69,3,228,0,0,230,220,10,GOOOXXXXXXXXXXXXXXXXGOOOOOXXXXXXXXXXXXXXGOOOOOOOXXXXXXXXXXXXGOXXXXXXXXXXXXXXXXXXGOOOOOOOOOOXXXXXXXXXGOXXXXXXXXXXXXXXXXXXGOOOXXXXXXXXXXXXXXXXGOOXXXXXXXXXXXXXXXXXGOOOXXXXXXXXXXXXXXXXGOOOOOXXXXXXXXXXXXXXGOOXXXXXXXXXXXXXXXXXGOOOOOOXXXXXXXXXXXXXGOOOOOOOOXXXXXXXXXXX,0,300,0
37989,69,0,69,2,229,0,0,231,220,11,GOOOXXXXXXXXXXXXXXXXGOOOOOXXXXXXXXXXXXXXGOOOOOOOXXXXXXXXXXXXGOXXXXXXXXXXXXXXXXXXGOOOOOOOOOOXXXXXXXXXGOXXXXXXXXXXXXXXXXXXGOOOXXXXXXXXXXXXXXXXGOOXXXXXXXXXXXXXXXXXGOOOXXXXXXXXXXXXXXXXGOOOOOXXXXXXXXXXXXXXGOOXXXXXXXXXXXXXXXXXGOOOOOOXXXXXXXXXXXXXGOOOOOOOOXXXXXXXXXXX,0,300,0

38010,69,0,69,2,229,0,0,231,220,11,GOOOXXXXXXXXXXXXXXXXGOOOOOXXXXXXXXXXXXXXGOOOOOOOXXXXXXXXXXXXGOXXXXXXXXXXXXXXXXXXGOOOOOOOOOOXXXXXXXXXGOXXXXXXXXXXXXXXXXXXGOOOXXXXXXXXXXXXXXXXGOOXXXXXXXXXXXXXXXXXGOOOXXXXXXXXXXXXXXXXGOOOOOXXXXXXXXXXXXXXGOOXXXXXXXXXXXXXXXXXGOOOOOOXXXXXXXXXXXXXGOOOOOOOOXXXXXXXXXXX,0,300,0
38031,69,0,69,1,230,0,0,231,221,10,GOOOXXXXXXXXXXXXXXXXGOOOOOXXXXXXXXXXXXXXGOOOOOOOXXXXXXXXXXXXGOXXXXXXXXXXXXXXXXXXGOOOOOOOOOOXXXXXXXXXGOXXXXXXXXXXXXXXXXXXGOOOXXXXXXXXXXXXXXXXGOOXXXXXXXXXXXXXXXXXGOOOXXXXXXXXXXXXXXXXGOOOOOXXXXXXXXXXXXXXGOOXXXXXXXXXXXXXXXXXGOOOOOOXXXXXXXXXXXXXGOOOOOOOOXXXXXXXXXXX,0,300,0
38052,69,0,69,2,229,0,0,231,221,10,GOOOXXXXXXXXXXXXXXXXGOOOOOXXXXXXXXXXXXXXGOOOOOOOXXXXXXXXXXXXGOXXXXXXXXXXXXXXXXXXGOOOOOOOOOOXXXXXXXXXGOXXXXXXXXXXXXXXXXXXGOOOXXXXXXXXXXXXXXXXGOOXXXXXXXXXXXXXXXXXGOOOXXXXXXXXXXXXXXXXGOOOOOXXXXXXXXXXXXXXGOOXXXXXXXXXXXXXXXXXGOOOOOOXXXXXXXXXXXXXGOOOOOOOOXXXXXXXXXXX,0,300,0
38073,69,0,69,3,228,0,0,230,220,10,GOOOXXXXXXXXXXXXXXXXGOOOOOXXXXXXXXXXXXXXGOOOOOOOXXXXXXXXXXXXGOXXXXXXXXXXXXXXXXXXGOOOOOOOOOOXXXXXXXXXGOXXXXXXXXXXXXXXXXXXGOOOXXXXXXXXXXXXXXXXGOOXXXXXXXXXXXXXXXXXGOOOXXXXXXXXXXXXXXXXGOOOOOXXXXXXXXXXXXXXGOOXXXXXXXXXXXXXXXXXGOOOOOOXXXXXXXXXXXXXGOOOOOOOOXXXXXXXXXXX,0,300,0
38094,69,0,69,3,228,0,0,230,221,9,GOOOXXXXXXXXXXXXXXXXGOOOOOXXXXXXXXXXXXXXGOOOOOOOXXXXXXXXXXXXGOXXXXXXXXXXXXXXXXXXGOOOOOOOOOOXXXXXXXXXGOXXXXXXXXXXXXXXXXXXGOOOXXXXXXXXXXXXXXXXGOOXXXXXXXXXXXXXXXXXGOOOXXXXXXXXXXXXXXXXGOOOOOXXXXXXXXXXXXXXGOOXXXXXXXXXXXXXXXXXGOOOOOOXXXXXXXXXXXXXGOOOOOOOOXXXXXXXXXXX,0,300,0

38115,69,0,69,3,228,0,0,230,220,10,GOOOXXXXXXXXXXXXXXXXGOOOOOXXXXXXXXXXXXXXGOOOOOOOXXXXXXXXXXXXGOXXXXXXXXXXXXXXXXXXGOOOOOOOOOOXXXXXXXXXGOXXXXXXXXXXXXXXXXXXGOOOXXXXXXXXXXXXXXXXGOOXXXXXXXXXXXXXXXXXGOOOXXXXXXXXXXXXXXXXGOOOOOXXXXXXXXXXXXXXGOOXXXXXXXXXXXXXXXXXGOOOOOOXXXXXXXXXXXXXGOOOOOOOOXXXXXXXXXXX,0,300,0
38136,69,0,69,3,228,0,0,230,220,10,GOOOXXXXXXXXXXXXXXXXGOOOOOXXXXXXXXXXXXXXGOOOOOOOXXXXXXXXXXXXGOXXXXXXXXXXXXXXXXXXGOOOOOOOOOOXXXXXXXXXGOXXXXXXXXXXXXXXXXXXGOOOXXXXXXXXXXXXXXXXGOOXXXXXXXXXXXXXXXXXGOOOXXXXXXXXXXXXXXXXGOOOOOXXXXXXXXXXXXXXGOOXXXXXXXXXXXXXXXXXGOOOOOOXXXXXXXXXXXXXGOOOOOOOOXXXXXXXXXXX,0,300,0
38157,69,0,69,3,228,0,0,230,220,10,GOOOXXXXXXXXXXXXXXXXGOOOOOXXXXXXXXXXXXXXGOOOOOOOXXXXXXXXXXXXGOXXXXXXXXXXXXXXXXXXGOOOOOOOOOOXXXXXXXXXGOXXXXXXXXXXXXXXXXXXGOOOXXXXXXXXXXXXXXXXGOOXXXXXXXXXXXXXXXXXGOOOXXXXXXXXXXXXXXXXGOOOOOXXXXXXXXXXXXXXGOOXXXXXXXXXXXXXXXXXGOOOOOOXXXXXXXXXXXXXGOOOOOOOOXXXXXXXXXXX,0,300,0
38178,69,0,69,3,228,0,0,230,221,9,GOOOXXXXXXXXXXXXXXXXGOOOOOXXXXXXXXXXXXXXGOOOOOOOXXXXXXXXXXXXGOXXXXXXXXXXXXXXXXXXGOOOOOOOOOOXXXXXXXXXGOXXXXXXXXXXXXXXXXXXGOOOXXXXXXXXXXXXXXXXGOOXXXXXXXXXXXXXXXXXGOOOXXXXXXXXXXXXXXXXGOOOOOXXXXXXXXXXXXXXGOOXXXXXXXXXXXXXXXXXGOOOOOOXXXXXXXXXXXXXGOOOOOOOOXXXXXXXXXXX,0,300,0
38199,69,0,69,5,226,0,0,228,220,8,GOOOXXXXXXXXXXXXXXXXGOOOOOXXXXXXXXXXXXXXGOOOOOOOXXXXXXXXXXXXGOXXXXXXXXXXXXXXXXXXGOOOOOOOOOOXXXXXXXXXGOXXXXXXXXXXXXXXXXXXGOOOXXXXXXXXXXXXXXXXGOOXXXXXXXXXXXXXXXXXGOOOXXXXXXXXXXXXXXXXGOOOOOXXXXXXXXXXXXXXGOOXXXXXXXXXXXXXXXXXGOOOOOOXXXXXXXXXXXXXGOOOOOOOOXXXXXXXXXXX,0,300,0

38220,69,0,69,5,226,0,0,228,220,8,GOOOXXXXXXXXXXXXXXXXGOOOOOXXXXXXXXXXXXXXGOOOOOOOXXXXXXXXXXXXGOXXXXXXXXXXXXXXXXXXGOOOOOOOOOOXXXXXXXXXGOXXXXXXXXXXXXXXXXXXGOOOXXXXXXXXXXXXXXXXGOOXXXXXXXXXXXXXXXXXGOOOXXXXXXXXXXXXXXXXGOOOOOXXXXXXXXXXXXXXGOOXXXXXXXXXXXXXXXXXGOOOOOOXXXXXXXXXXXXXGOOOOOOOOXXXXXXXXXXX,0,300,0
38241,69,0,69,5,226,0,0,228,221,7,GOOOXXXXXXXXXXXXXXXXGOOOOOXXXXXXXXXXXXXXGOOOOOOOXXXXXXXXXXXXGOXXXXXXXXXXXXXXXXXXGOOOOOOOOOOXXXXXXXXXGOXXXXXXXXXXXXXXXXXXGOOOXXXXXXXXXXXXXXXXGOOXXXXXXXXXXXXXXXXXGOOOXXXXXXXXXXXXXXXXGOOOOOXXXXXXXXXXXXXXGOOXXXXXXXXXXXXXXXXXGOOOOOOXXXXXXXXXXXXXGOOOOOOOOXXXXXXXXXXX,0,300,0
38262,69,0,69,6,225,0,0,227,221,6,GOOOXXXXXXXXXXXXXXXXGOOOOOXXXXXXXXXXXXXXGOOOOOOOXXXXXXXXXXXXGOXXXXXXXXXXXXXXXXXXGOOOOOOOOOOXXXXXXXXXGOXXXXXXXXXXXXXXXXXXGOOOXXXXXXXXXXXXXXXXGOOXXXXXXXXXXXXXXXXXGOOOXXXXXXXXXXXXXXXXGOOOOOXXXXXXXXXXXXXXGOOXXXXXXXXXXXXXXXXXGOOOOOOXXXXXXXXXXXXXGOOOOOOOOXXXXXXXXXXX,0,300,0
38283,69,0,69,4,227,0,0,228,221,7,GOOOXXXXXXXXXXXXXXXXGOOOOOXXXXXXXXXXXXXXGOOOOOOOXXXXXXXXXXXXGOXXXXXXXXXXXXXXXXXXGOOOOOOOOOOXXXXXXXXXGOXXXXXXXXXXXXXXXXXXGOOOXXXXXXXXXXXXXXXXGOOXXXXXXXXXXXXXXXXXGOOOXXXXXXXXXXXXXXXXGOOOOOXXXXXXXXXXXXXXGOOXXXXXXXXXXXXXXXXXGOOOOOOXXXXXXXXXXXXXGOOOOOOOOXXXXXXXXXXX,0,300,0
38304,69,0,69,5,226,0,0,228,220,8,GOOOXXXXXXXXXXXXXXXXGOOOOOXXXXXXXXXXXXXXGOOOOOOOXXXXXXXXXXXXGOXXXXXXXXXXXXXXXXXXGOOOOOOOOOOXXXXXXXXXGOXXXXXXXXXXXXXXXXXXGOOOXXXXXXXXXXXXXXXXGOOXXXXXXXXXXXXXXXXXGOOOXXXXXXXXXXXXXXXXGOOOOOXXXXXXXXXXXXXXGOOXXXXXXXXXXXXXXXXXGOOOOOOXXXXXXXXXXXXXGOOOOOOOOXXXXXXXXXXX,0,300,0

38325,69,0,69,5,226,0,0,228,221,7,GOOOXXXXXXXXXXXXXXXXGOOOOOXXXXXXXXXXXXXXGOOOOOOOXXXXXXXXXXXXGOXXXXXXXXXXXXXXXXXXGOOOOOOOOOOXXXXXXXXXGOXXXXXXXXXXXXXXXXXXGOOOXXXXXXXXXXXXXXXXGOOXXXXXXXXXXXXXXXXXGOOOXXXXXXXXXXXXXXXXGOOOOOXXXXXXXXXXXXXXGOOXXXXXXXXXXXXXXXXXGOOOOOOXXXXXXXXXXXXXGOOOOOOOOXXXXXXXXXXX,0,300,0
38346,69,0,69,6,225,0,0,227,221,6,GOOOXXXXXXXXXXXXXXXXGOOOOOXXXXXXXXXXXXXXGOOOOOOOXXXXXXXXXXXXGOXXXXXXXXXXXXXXXXXXGOOOOOOOOOOXXXXXXXXXGOXXXXXXXXXXXXXXXXXXGOOOXXXXXXXXXXXXXXXXGOOXXXXXXXXXXXXXXXXXGOOOXXXXXXXXXXXXXXXXGOOOOOXXXXXXXXXXXXXXGOOXXXXXXXXXXXXXXXXXGOOOOOOXXXXXXXXXXXXXGOOOOOOOOXXXXXXXXXXX,0,300,0
38367,69,0,69,6,225,0,0,227,220,7,GOOOXXXXXXXXXXXXXXXXGOOOOOXXXXXXXXXXXXXXGOOOOOOOXXXXXXXXXXXXGOXXXXXXXXXXXXXXXXXXGOOOOOOOOOOXXXXXXXXXGOXXXXXXXXXXXXXXXXXXGOOOXXXXXXXXXXXXXXXXGOOXXXXXXXXXXXXXXXXXGOOOXXXXXXXXXXXXXXXXGOOOOOXXXXXXXXXXXXXXGOOXXXXXXXXXXXXXXXXXGOOOOOOXXXXXXXXXXXXXGOOOOOOOOXXXXXXXXXXX,0,300,0
38388,69,0,69,5,226,0,0,229,220,9,GOOOXXXXXXXXXXXXXXXXGOOOOOXXXXXXXXXXXXXXGOOOOOOOXXXXXXXXXXXXGOXXXXXXXXXXXXXXXXXXGOOOOOOOOOOXXXXXXXXXGOXXXXXXXXXXXXXXXXXXGOOOXXXXXXXXXXXXXXXXGOOXXXXXXXXXXXXXXXXXGOOOXXXXXXXXXXXXXXXXGOOOOOXXXXXXXXXXXXXXGOOXXXXXXXXXXXXXXXXXGOOOOOOXXXXXXXXXXXXXGOOOOOOOOXXXXXXXXXXX,0,300,0
38409,69,0,69,5,226,0,0,229,220,9,GOOOXXXXXXXXXXXXXXXXGOOOOOXXXXXXXXXXXXXXGOOOOOOOXXXXXXXXXXXXGOXXXXXXXXXXXXXXXXXXGOOOOOOOOOOXXXXXXXXXGOXXXXXXXXXXXXXXXXXXGOOOXXXXXXXXXXXXXXXXGOOXXXXXXXXXXXXXXXXXGOOOXXXXXXXXXXXXXXXXGOOOOOXXXXXXXXXXXXXXGOOXXXXXXXXXXXXXXXXXGOOOOOOXXXXXXXXXXXXXGOOOOOOOOXXXXXXXXXXX,0,300,0

38430,69,0,69,4,227,0,0,230,220,10,GOOOXXXXXXXXXXXXXXXXGOOOOOXXXXXXXXXXXXXXGOOOOOOOXXXXXXXXXXXXGOXXXXXXXXXXXXXXXXXXGOOOOOOOOOOXXXXXXXXXGOXXXXXXXXXXXXXXXXXXGOOOXXXXXXXXXXXXXXXXGOOXXXXXXXXXXXXXXXXXGOOOXXXXXXXXXXXXXXXXGOOOOOXXXXXXXXXXXXXXGOOXXXXXXXXXXXXXXXXXGOOOOOOXXXXXXXXXXXXXGOOOOOOOOXXXXXXXXXXX,0,300,0
38451,69,0,69,5,226,0,0,229,221,8,GOOOXXXXXXXXXXXXXXXXGOOOOOXXXXXXXXXXXXXXGOOOOOOOXXXXXXXXXXXXGOXXXXXXXXXXXXXXXXXXGOOOOOOOOOOXXXXXXXXXGOXXXXXXXXXXXXXXXXXXGOOOXXXXXXXXXXXXXXXXGOOXXXXXXXXXXXXXXXXXGOOOXXXXXXXXXXXXXXXXGOOOOOXXXXXXXXXXXXXXGOOXXXXXXXXXXXXXXXXXGOOOOOOXXXXXXXXXXXXXGOOOOOOOOXXXXXXXXXXX,0,300,0
38472,69,0,69,4,227,0,0,230,221,9,GOOOXXXXXXXXXXXXXXXXGOOOOOXXXXXXXXXXXXXXGOOOOOOOXXXXXXXXXXXXGOXXXXXXXXXXXXXXXXXXGOOOOOOOOOOXXXXXXXXXGOXXXXXXXXXXXXXXXXXXGOOOXXXXXXXXXXXXXXXXGOOXXXXXXXXXXXXXXXXXGOOOXXXXXXXXXXXXXXXXGOOOOOXXXXXXXXXXXXXXGOOXXXXXXXXXXXXXXXXXGOOOOOOXXXXXXXXXXXXXGOOOOOOOOXXXXXXXXXXX,0,300,0
38493,69,0,69,3,228,0,0,230,221,9,GOOOXXXXXXXXXXXXXXXXGOOOOOXXXXXXXXXXXXXXGOOOOOOOXXXXXXXXXXXXGOXXXXXXXXXXXXXXXXXXGOOOOOOOOOOXXXXXXXXXGOXXXXXXXXXXXXXXXXXXGOOOXXXXXXXXXXXXXXXXGOOXXXXXXXXXXXXXXXXXGOOOXXXXXXXXXXXXXXXXGOOOOOXXXXXXXXXXXXXXGOOXXXXXXXXXXXXXXXXXGOOOOOOXXXXXXXXXXXXXGOOOOOOOOXXXXXXXXXXX,0,300,0
38514,69,0,69,2,229,0,0,231,222,9,GOOOXXXXXXXXXXXXXXXXGOOOOOXXXXXXXXXXXXXXGOOOOOOOXXXXXXXXXXXXGOXXXXXXXXXXXXXXXXXXGOOOOOOOOOOXXXXXXXXXGOXXXXXXXXXXXXXXXXXXGOOOXXXXXXXXXXXXXXXXGOOXXXXXXXXXXXXXXXXXGOOOXXXXXXXXXXXXXXXXGOOOOOXXXXXXXXXXXXXXGOOXXXXXXXXXXXXXXXXXGOOOOOOXXXXXXXXXXXXXGOOOOOOOOXXXXXXXXXXX,0,300,0

38535,69,0,69,3,228,0,0,230,221,9,GOOOXXXXXXXXXXXXXXXXGOOOOOXXXXXXXXXXXXXXGOOOOOOOXXXXXXXXXXXXGOXXXXXXXXXXXXXXXXXXGOOOOOOOOOOXXXXXXXXXGOXXXXXXXXXXXXXXXXXXGOOOXXXXXXXXXXXXXXXXGOOXXXXXXXXXXXXXXXXXGOOOXXXXXXXXXXXXXXXXGOOOOOXXXXXXXXXXXXXXGOOXXXXXXXXXXXXXXXXXGOOOOOOXXXXXXXXXXXXXGOOOOOOOOXXXXXXXXXXX,0,300,0
38556,69,0,69,3,228,0,0,231,220,11,GOOOXXXXXXXXXXXXXXXXGOOOOOXXXXXXXXXXXXXXGOOOOOOOXXXXXXXXXXXXGOXXXXXXXXXXXXXXXXXXGOOOOOOOOOOXXXXXXXXXGOXXXXXXXXXXXXXXXXXXGOOOXXXXXXXXXXXXXXXXGOOXXXXXXXXXXXXXXXXXGOOOXXXXXXXXXXXXXXXXGOOOOOXXXXXXXXXXXXXXGOOXXXXXXXXXXXXXXXXXGOOOOOOXXXXXXXXXXXXXGOOOOOOOOXXXXXXXXXXX,0,300,0
38577,69,0,69,2,229,0,0,231,220,11,GOOOXXXXXXXXXXXXXXXXGOOOOOXXXXXXXXXXXXXXGOOOOOOOXXXXXXXXXXXXGOXXXXXXXXXXXXXXXXXXGOOOOOOOOOOXXXXXXXXXGOXXXXXXXXXXXXXXXXXXGOOOXXXXXXXXXXXXXXXXGOOXXXXXXXXXXXXXXXXXGOOOXXXXXXXXXXXXXXXXGOOOOOXXXXXXXXXXXXXXGOOXXXXXXXXXXXXXXXXXGOOOOOOXXXXXXXXXXXXXGOOOOOOOOXXXXXXXXXXX,0,300,0
38598,69,0,69,3,228,0,0,230,220,10,GOOOXXXXXXXXXXXXXXXXGOOOOOXXXXXXXXXXXXXXGOOOOOOOXXXXXXXXXXXXGOXXXXXXXXXXXXXXXXXXGOOOOOOOOOOXXXXXXXXXGOXXXXXXXXXXXXXXXXXXGOOOXXXXXXXXXXXXXXXXGOOXXXXXXXXXXXXXXXXXGOOOXXXXXXXXXXXXXXXXGOOOOOXXXXXXXXXXXXXXGOOXXXXXXXXXXXXXXXXXGOOOOOOXXXXXXXXXXXXXGOOOOOOOOXXXXXXXXXXX,0,300,0
38619,69,0,69,3,228,0,0,230,220,10,GOOOXXXXXXXXXXXXXXXXGOOOOOXXXXXXXXXXXXXXGOOOOOOOXXXXXXXXXXXXGOXXXXXXXXXXXXXXXXXXGOOOOOOOOOOXXXXXXXXXGOXXXXXXXXXXXXXXXXXXGOOOXXXXXXXXXXXXXXXXGOOXXXXXXXXXXXXXXXXXGOOOXXXXXXXXXXXXXXXXGOOOOOXXXXXXXXXXXXXXGOOXXXXXXXXXXXXXXXXXGOOOOOOXXXXXXXXXXXXXGOOOOOOOOXXXXXXXXXXX,0,300,0

38640,69,0,69,4,227,0,0,229,220,9,GOOOXXXXXXXXXXXXXXXXGOOOOOXXXXXXXXXXXXXXGOOOOOOOXXXXXXXXXXXXGOXXXXXXXXXXXXXXXXXXGOOOOOOOOOOXXXXXXXXXGOXXXXXXXXXXXXXXXXXXGOOOXXXXXXXXXXXXXXXXGOOXXXXXXXXXXXXXXXXXGOOOXXXXXXXXXXXXXXXXGOOOOOXXXXXXXXXXXXXXGOOXXXXXXXXXXXXXXXXXGOOOOOOXXXXXXXXXXXXXGOOOOOOOOXXXXXXXXXXX,0,300,0
38661,69,0,69,4,227,0,0,229,222,7,GOOOXXXXXXXXXXXXXXXXGOOOOOXXXXXXXXXXXXXXGOOOOOOOXXXXXXXXXXXXGOXXXXXXXXXXXXXXXXXXGOOOOOOOOOOXXXXXXXXXGOXXXXXXXXXXXXXXXXXXGOOOXXXXXXXXXXXXXXXXGOOXXXXXXXXXXXXXXXXXGOOOXXXXXXXXXXXXXXXXGOOOOOXXXXXXXXXXXXXXGOOXXXXXXXXXXXXXXXXXGOOOOOOXXXXXXXXXXXXXGOOOOOOOOXXXXXXXXXXX,0,300,0
38682,69,0,69,4,227,0,0,229,221,8,GOOOXXXXXXXXXXXXXXXXGOOOOOXXXXXXXXXXXXXXGOOOOOOOXXXXXXXXXXXXGOXXXXXXXXXXXXXXXXXXGOOOOOOOOOOXXXXXXXXXGOXXXXXXXXXXXXXXXXXXGOOOXXXXXXXXXXXXXXXXGOOXXXXXXXXXXXXXXXXXGOOOXXXXXXXXXXXXXXXXGOOOOOXXXXXXXXXXXXXXGOOXXXXXXXXXXXXXXXXXGOOOOOOXXXXXXXXXXXXXGOOOOOOOOXXXXXXXXXXX,0,300,0
38703,69,0,69,4,227,0,0,229,221,8,GOOOXXXXXXXXXXXXXXXXGOOOOOXXXXXXXXXXXXXXGOOOOOOOXXXXXXXXXXXXGOXXXXXXXXXXXXXXXXXXGOOOOOOOOOOXXXXXXXXXGOXXXXXXXXXXXXXXXXXXGOOOXXXXXXXXXXXXXXXXGOOXXXXXXXXXXXXXXXXXGOOOXXXXXXXXXXXXXXXXGOOOOOXXXXXXXXXXXXXXGOOXXXXXXXXXXXXXXXXXGOOOOOOXXXXXXXXXXXXXGOOOOOOOOXXXXXXXXXXX,0,300,0
38724,69,0,69,5,226,0,0,228,220,8,GOOOXXXXXXXXXXXXXXXXGOOOOOXXXXXXXXXXXXXXGOOOOOOOXXXXXXXXXXXXGOXXXXXXXXXXXXXXXXXXGOOOOOOOOOOXXXXXXXXXGOXXXXXXXXXXXXXXXXXXGOOOXXXXXXXXXXXXXXXXGOOXXXXXXXXXXXXXXXXXGOOOXXXXXXXXXXXXXXXXGOOOOOXXXXXXXXXXXXXXGOOXXXXXXXXXXXXXXXXXGOOOOOOXXXXXXXXXXXXXGOOOOOOOOXXXXXXXXXXX,0,300,0

38745,69,0,69,4,227,0,0,229,220,9,GOOOXXXXXXXXXXXXXXXXGOOOOOXXXXXXXXXXXXXXGOOOOOOOXXXXXXXXXXXXGOXXXXXXXXXXXXXXXXXXGOOOOOOOOOOXXXXXXXXXGOXXXXXXXXXXXXXXXXXXGOOOXXXXXXXXXXXXXXXXGOOXXXXXXXXXXXXXXXXXGOOOXXXXXXXXXXXXXXXXGOOOOOXXXXXXXXXXXXXXGOOXXXXXXXXXXXXXXXXXGOOOOOOXXXXXXXXXXXXXGOOOOOOOOXXXXXXXXXXX,0,300,0
38766,69,0,69,3,228,0,0,230,220,10,GOOOXXXXXXXXXXXXXXXXGOOOOOXXXXXXXXXXXXXXGOOOOOOOXXXXXXXXXXXXGOXXXXXXXXXXXXXXXXXXGOOOOOOOOOOXXXXXXXXXGOXXXXXXXXXXXXXXXXXXGOOOXXXXXXXXXXXXXXXXGOOXXXXXXXXXXXXXXXXXGOOOXXXXXXXXXXXXXXXXGOOOOOXXXXXXXXXXXXXXGOOXXXXXXXXXXXXXXXXXGOOOOOOXXXXXXXXXXXXXGOOOOOOOOXXXXXXXXXXX,0,300,0
38787,69,0,69,3,228,0,0,230,220,10,GOOOXXXXXXXXXXXXXXXXGOOOOOXXXXXXXXXXXXXXGOOOOOOOXXXXXXXXXXXXGOXXXXXXXXXXXXXXXXXXGOOOOOOOOOOXXXXXXXXXGOXXXXXXXXXXXXXXXXXXGOOOXXXXXXXXXXXXXXXXGOOXXXXXXXXXXXXXXXXXGOOOXXXXXXXXXXXXXXXXGOOOOOXXXXXXXXXXXXXXGOOXXXXXXXXXXXXXXXXXGOOOOOOXXXXXXXXXXXXXGOOOOOOOOXXXXXXXXXXX,0,300,0
38808,69,0,69,3,228,0,0,230,220,10,GOOOXXXXXXXXXXXXXXXXGOOOOOXXXXXXXXXXXXXXGOOOOOOOXXXXXXXXXXXXGOXXXXXXXXXXXXXXXXXXGOOOOOOOOOOXXXXXXXXXGOXXXXXXXXXXXXXXXXXXGOOOXXXXXXXXXXXXXXXXGOOXXXXXXXXXXXXXXXXXGOOOXXXXXXXXXXXXXXXXGOOOOOXXXXXXXXXXXXXXGOOXXXXXXXXXXXXXXXXXGOOOOOOXXXXXXXXXXXXXGOOOOOOOOXXXXXXXXXXX,0,300,0
38829,69,0,69,3,228,0,0,230,220,10,GOOOXXXXXXXXXXXXXXXXGOOOOOXXXXXXXXXXXXXXGOOOOOOOXXXXXXXXXXXXGOXXXXXXXXXXXXXXXXXXGOOOOOOOOOOXXXXXXXXXGOXXXXXXXXXXXXXXXXXXGOOOXXXXXXXXXXXXXXXXGOOXXXXXXXXXXXXXXXXXGOOOXXXXXXXXXXXXXXXXGOOOOOXXXXXXXXXXXXXXGOOXXXXXXXXXXXXXXXXXGOOOOOOXXXXXXXXXXXXXGOOOOOOOOXXXXXXXXXXX,0,300,0

38850,69,0,69,2,229,0,0,231,220,11,GOOOXXXXXXXXXXXXXXXXGOOOOOXXXXXXXXXXXXXXGOOOOOOOXXXXXXXXXXXXGOXXXXXXXXXXXXXXXXXXGOOOOOOOOOOXXXXXXXXXGOXXXXXXXXXXXXXXXXXXGOOOXXXXXXXXXXXXXXXXGOOXXXXXXXXXXXXXXXXXGOOOXXXXXXXXXXXXXXXXGOOOOOXXXXXXXXXXXXXXGOOXXXXXXXXXXXXXXXXXGOOOOOOXXXXXXXXXXXXXGOOOOOOOOXXXXXXXXXXX,0,300,0
38871,69,0,69,2,229,0,0,231,220,11,GOOOXXXXXXXXXXXXXXXXGOOOOOXXXXXXXXXXXXXXGOOOOOOOXXXXXXXXXXXXGOXXXXXXXXXXXXXXXXXXGOOOOOOOOOOXXXXXXXXXGOXXXXXXXXXXXXXXXXXXGOOOXXXXXXXXXXXXXXXXGOOXXXXXXXXXXXXXXXXXGOOOXXXXXXXXXXXXXXXXGOOOOOXXXXXXXXXXXXXXGOOXXXXXXXXXXXXXXXXXGOOOOOOXXXXXXXXXXXXXGOOOOOOOOXXXXXXXXXXX,0,300,0
38892,69,0,69,2,229,0,0,231,221,10,GOOOXXXXXXXXXXXXXXXXGOOOOOXXXXXXXXXXXXXXGOOOOOOOXXXXXXXXXXXXGOXXXXXXXXXXXXXXXXXXGOOOOOOOOOOXXXXXXXXXGOXXXXXXXXXXXXXXXXXXGOOOXXXXXXXXXXXXXXXXGOOXXXXXXXXXXXXXXXXXGOOOXXXXXXXXXXXXXXXXGOOOOOXXXXXXXXXXXXXXGOOXXXXXXXXXXXXXXXXXGOOOOOOXXXXXXXXXXXXXGOOOOOOOOXXXXXXXXXXX,0,300,0
38913,69,0,69,4,227,0,0,229,220,9,GOOOXXXXXXXXXXXXXXXXGOOOOOXXXXXXXXXXXXXXGOOOOOOOXXXXXXXXXXXXGOXXXXXXXXXXXXXXXXXXGOOOOOOOOOOXXXXXXXXXGOXXXXXXXXXXXXXXXXXXGOOOXXXXXXXXXXXXXXXXGOOXXXXXXXXXXXXXXXXXGOOOXXXXXXXXXXXXXXXXGOOOOOXXXXXXXXXXXXXXGOOXXXXXXXXXXXXXXXXXGOOOOOOXXXXXXXXXXXXXGOOOOOOOOXXXXXXXXXXX,0,300,0
38934,69,0,69,4,227,0,0,229,220,9,GOOOXXXXXXXXXXXXXXXXGOOOOOXXXXXXXXXXXXXXGOOOOOOOXXXXXXXXXXXXGOXXXXXXXXXXXXXXXXXXGOOOOOOOOOOXXXXXXXXXGOXXXXXXXXXXXXXXXXXXGOOOXXXXXXXXXXXXXXXXGOOXXXXXXXXXXXXXXXXXGOOOXXXXXXXXXXXXXXXXGOOOOOXXXXXXXXXXXXXXGOOXXXXXXXXXXXXXXXXXGOOOOOOXXXXXXXXXXXXXGOOOOOOOOXXXXXXXXXXX,0,300,0

38955,69,0,69,4,227,0,0,229,222,7,GOOOXXXXXXXXXXXXXXXXGOOOOOXXXXXXXXXXXXXXGOOOOOOOXXXXXXXXXXXXGOXXXXXXXXXXXXXXXXXXGOOOOOOOOOOXXXXXXXXXGOXXXXXXXXXXXXXXXXXXGOOOXXXXXXXXXXXXXXXXGOOXXXXXXXXXXXXXXXXXGOOOXXXXXXXXXXXXXXXXGOOOOOXXXXXXXXXXXXXXGOOXXXXXXXXXXXXXXXXXGOOOOOOXXXXXXXXXXXXXGOOOOOOOOXXXXXXXXXXX,0,300,0
38976,69,0,69,6,225,0,0,227,223,4,GOOOXXXXXXXXXXXXXXXXGOOOOOXXXXXXXXXXXXXXGOOOOOOOXXXXXXXXXXXXGOXXXXXXXXXXXXXXXXXXGOOOOOOOOOOXXXXXXXXXGOXXXXXXXXXXXXXXXXXXGOOOXXXXXXXXXXXXXXXXGOOXXXXXXXXXXXXXXXXXGOOOXXXXXXXXXXXXXXXXGOOOOOXXXXXXXXXXXXXXGOOXXXXXXXXXXXXXXXXXGOOOOOOXXXXXXXXXXXXXGOOOOOOOOXXXXXXXXXXX,0,300,0
38997,69,0,69,9,222,0,0,224,220,4,GOOOXXXXXXXXXXXXXXXXGOOOOOXXXXXXXXXXXXXXGOOOOOOOXXXXXXXXXXXXGOXXXXXXXXXXXXXXXXXXGOOOOOOOOOOXXXXXXXXXGOXXXXXXXXXXXXXXXXXXGOOOXXXXXXXXXXXXXXXXGOOXXXXXXXXXXXXXXXXXGOOOXXXXXXXXXXXXXXXXGOOOOOXXXXXXXXXXXXXXGOOXXXXXXXXXXXXXXXXXGOOOOOOXXXXXXXXXXXXXGOOOOOOOOXXXXXXXXXXX,0,300,0
39018,69,0,69,9,222,0,0,224,220,4,GOOOXXXXXXXXXXXXXXXXGOOOOOXXXXXXXXXXXXXXGOOOOOOOXXXXXXXXXXXXGOXXXXXXXXXXXXXXXXXXGOOOOOOOOOOXXXXXXXXXGOXXXXXXXXXXXXXXXXXXGOOOXXXXXXXXXXXXXXXXGOOXXXXXXXXXXXXXXXXXGOOOXXXXXXXXXXXXXXXXGOOOOOXXXXXXXXXXXXXXGOOXXXXXXXXXXXXXXXXXGOOOOOOXXXXXXXXXXXXXGOOOOOOOOXXXXXXXXXXX,0,300,0
39039,69,0,69,8,223,0,0,225,220,5,GOOOXXXXXXXXXXXXXXXXGOOOOOXXXXXXXXXXXXXXGOOOOOOOXXXXXXXXXXXXGOXXXXXXXXXXXXXXXXXXGOOOOOOOOOOXXXXXXXXXGOXXXXXXXXXXXXXXXXXXGOOOXXXXXXXXXXXXXXXXGOOXXXXXXXXXXXXXXXXXGOOOXXXXXXXXXXXXXXXXGOOOOOXXXXXXXXXXXXXXGOOXXXXXXXXXXXXXXXXXGOOOOOOXXXXXXXXXXXXXGOOOOOOOOXXXXXXXXXXX,0,300,0

39060,69,0,69,8,223,0,0,225,220,5,GOOOXXXXXXXXXXXXXXXXGOOOOOXXXXXXXXXXXXXXGOOOOOOOXXXXXXXXXXXXGOXXXXXXXXXXXXXXXXXXGOOOOOOOOOOXXXXXXXXXGOXXXXXXXXXXXXXXXXXXGOOOXXXXXXXXXXXXXXXXGOOXXXXXXXXXXXXXXXXXGOOOXXXXXXXXXXXXXXXXGOOOOOXXXXXXXXXXXXXXGOOXXXXXXXXXXXXXXXXXGOOOOOOXXXXXXXXXXXXXGOOOOOOOOXXXXXXXXXXX,0,300,0
39081,69,0,69,8,223,0,0,225,221,4,GOOOXXXXXXXXXXXXXXXXGOOOOOXXXXXXXXXXXXXXGOOOOOOOXXXXXXXXXXXXGOXXXXXXXXXXXXXXXXXXGOOOOOOOOOOXXXXXXXXXGOXXXXXXXXXXXXXXXXXXGOOOXXXXXXXXXXXXXXXXGOOXXXXXXXXXXXXXXXXXGOOOXXXXXXXXXXXXXXXXGOOOOOXXXXXXXXXXXXXXGOOXXXXXXXXXXXXXXXXXGOOOOOOXXXXXXXXXXXXXGOOOOOOOOXXXXXXXXXXX,0,300,0
39102,69,0,69,9,222,0,0,224,220,4,GOOOXXXXXXXXXXXXXXXXGOOOOOXXXXXXXXXXXXXXGOOOOOOOXXXXXXXXXXXXGOXXXXXXXXXXXXXXXXXXGOOOOOOOOOOXXXXXXXXXGOXXXXXXXXXXXXXXXXXXGOOOXXXXXXXXXXXXXXXXGOOXXXXXXXXXXXXXXXXXGOOOXXXXXXXXXXXXXXXXGOOOOOXXXXXXXXXXXXXXGOOXXXXXXXXXXXXXXXXXGOOOOOOXXXXXXXXXXXXXGOOOOOOOOXXXXXXXXXXX,0,300,0
39123,69,0,69,8,223,0,0,225,220,5,GOOOXXXXXXXXXXXXXXXXGOOOOOXXXXXXXXXXXXXXGOOOOOOOXXXXXXXXXXXXGOXXXXXXXXXXXXXXXXXXGOOOOOOOOOOXXXXXXXXXGOXXXXXXXXXXXXXXXXXXGOOOXXXXXXXXXXXXXXXXGOOXXXXXXXXXXXXXXXXXGOOOXXXXXXXXXXXXXXXXGOOOOOXXXXXXXXXXXXXXGOOXXXXXXXXXXXXXXXXXGOOOOOOXXXXXXXXXXXXXGOOOOOOOOXXXXXXXXXXX,0,300,0
39144,69,0,69,8,223,0,0,225,221,4,GOOOXXXXXXXXXXXXXXXXGOOOOOXXXXXXXXXXXXXXGOOOOOOOXXXXXXXXXXXXGOXXXXXXXXXXXXXXXXXXGOOOOOOOOOOXXXXXXXXXGOXXXXXXXXXXXXXXXXXXGOOOXXXXXXXXXXXXXXXXGOOXXXXXXXXXXXXXXXXXGOOOXXXXXXXXXXXXXXXXGOOOOOXXXXXXXXXXXXXXGOOXXXXXXXXXXXXXXXXXGOOOOOOXXXXXXXXXXXXXGOOOOOOOOXXXXXXXXXXX,0,300,0

39165,69,0,69,7,224,0,0,226,220,6,GOOOXXXXXXXXXXXXXXXXGOOOOOXXXXXXXXXXXXXXGOOOOOOOXXXXXXXXXXXXGOXXXXXXXXXXXXXXXXXXGOOOOOOOOOOXXXXXXXXXGOXXXXXXXXXXXXXXXXXXGOOOXXXXXXXXXXXXXXXXGOOXXXXXXXXXXXXXXXXXGOOOXXXXXXXXXXXXXXXXGOOOOOXXXXXXXXXXXXXXGOOXXXXXXXXXXXXXXXXXGOOOOOOXXXXXXXXXXXXXGOOOOOOOOXXXXXXXXXXX,0,300,0
39186,69,0,69,6,225,0,0,228,221,7,GOOOXXXXXXXXXXXXXXXXGOOOOOXXXXXXXXXXXXXXGOOOOOOOXXXXXXXXXXXXGOXXXXXXXXXXXXXXXXXXGOOOOOOOOOOXXXXXXXXXGOXXXXXXXXXXXXXXXXXXGOOOXXXXXXXXXXXXXXXXGOOXXXXXXXXXXXXXXXXXGOOOXXXXXXXXXXXXXXXXGOOOOOXXXXXXXXXXXXXXGOOXXXXXXXXXXXXXXXXXGOOOOOOXXXXXXXXXXXXXGOOOOOOOOXXXXXXXXXXX,0,300,0
39207,69,0,69,5,226,0,0,228,220,8,GOOOXXXXXXXXXXXXXXXXGOOOOOXXXXXXXXXXXXXXGOOOOOOOXXXXXXXXXXXXGOXXXXXXXXXXXXXXXXXXGOOOOOOOOOOXXXXXXXXXGOXXXXXXXXXXXXXXXXXXGOOOXXXXXXXXXXXXXXXXGOOXXXXXXXXXXXXXXXXXGOOOXXXXXXXXXXXXXXXXGOOOOOXXXXXXXXXXXXXXGOOXXXXXXXXXXXXXXXXXGOOOOOOXXXXXXXXXXXXXGOOOOOOOOXXXXXXXXXXX,0,300,0
39228,69,0,69,5,226,0,0,228,220,8,GOOOXXXXXXXXXXXXXXXXGOOOOOXXXXXXXXXXXXXXGOOOOOOOXXXXXXXXXXXXGOXXXXXXXXXXXXXXXXXXGOOOOOOOOOOXXXXXXXXXGOXXXXXXXXXXXXXXXXXXGOOOXXXXXXXXXXXXXXXXGOOXXXXXXXXXXXXXXXXXGOOOXXXXXXXXXXXXXXXXGOOOOOXXXXXXXXXXXXXXGOOXXXXXXXXXXXXXXXXXGOOOOOOXXXXXXXXXXXXXGOOOOOOOOXXXXXXXXXXX,0,300,0
39249,69,0,69,4,227,0,0,229,220,9,GOOOXXXXXXXXXXXXXXXXGOOOOOXXXXXXXXXXXXXXGOOOOOOOXXXXXXXXXXXXGOXXXXXXXXXXXXXXXXXXGOOOOOOOOOOXXXXXXXXXGOXXXXXXXXXXXXXXXXXXGOOOXXXXXXXXXXXXXXXXGOOXXXXXXXXXXXXXXXXXGOOOXXXXXXXXXXXXXXXXGOOOOOXXXXXXXXXXXXXXGOOXXXXXXXXXXXXXXXXXGOOOOOOXXXXXXXXXXXXXGOOOOOOOOXXXXXXXXXXX,0,300,0

39270,69,0,69,4,227,0,0,229,220,9,GOOOXXXXXXXXXXXXXXXXGOOOOOXXXXXXXXXXXXXXGOOOOOOOXXXXXXXXXXXXGOXXXXXXXXXXXXXXXXXXGOOOOOOOOOOXXXXXXXXXGOXXXXXXXXXXXXXXXXXXGOOOXXXXXXXXXXXXXXXXGOOXXXXXXXXXXXXXXXXXGOOOXXXXXXXXXXXXXXXXGOOOOOXXXXXXXXXXXXXXGOOXXXXXXXXXXXXXXXXXGOOOOOOXXXXXXXXXXXXXGOOOOOOOOXXXXXXXXXXX,0,300,0
39291,69,0,69,3,228,0,0,229,220,9,GOOOXXXXXXXXXXXXXXXXGOOOOOXXXXXXXXXXXXXXGOOOOOOOXXXXXXXXXXXXGOXXXXXXXXXXXXXXXXXXGOOOOOOOOOOXXXXXXXXXGOXXXXXXXXXXXXXXXXXXGOOOXXXXXXXXXXXXXXXXGOOXXXXXXXXXXXXXXXXXGOOOXXXXXXXXXXXXXXXXGOOOOOXXXXXXXXXXXXXXGOOXXXXXXXXXXXXXXXXXGOOOOOOXXXXXXXXXXXXXGOOOOOOOOXXXXXXXXXXX,0,300,0
39312,69,0,69,3,228,0,0,230,220,10,GOOOXXXXXXXXXXXXXXXXGOOOOOXXXXXXXXXXXXXXGOOOOOOOXXXXXXXXXXXXGOXXXXXXXXXXXXXXXXXXGOOOOOOOOOOXXXXXXXXXGOXXXXXXXXXXXXXXXXXXGOOOXXXXXXXXXXXXXXXXGOOXXXXXXXXXXXXXXXXXGOOOXXXXXXXXXXXXXXXXGOOOOOXXXXXXXXXXXXXXGOOXXXXXXXXXXXXXXXXXGOOOOOOXXXXXXXXXXXXXGOOOOOOOOXXXXXXXXXXX,0,300,0
39333,69,0,69,3,228,0,0,230,220,10,GOOOXXXXXXXXXXXXXXXXGOOOOOXXXXXXXXXXXXXXGOOOOOOOXXXXXXXXXXXXGOXXXXXXXXXXXXXXXXXXGOOOOOOOOOOXXXXXXXXXGOXXXXXXXXXXXXXXXXXXGOOOXXXXXXXXXXXXXXXXGOOXXXXXXXXXXXXXXXXXGOOOXXXXXXXXXXXXXXXXGOOOOOXXXXXXXXXXXXXXGOOXXXXXXXXXXXXXXXXXGOOOOOOXXXXXXXXXXXXXGOOOOOOOOXXXXXXXXXXX,0,300,0
39354,69,0,69,3,228,0,0,230,220,10,GOOOXXXXXXXXXXXXXXXXGOOOOOXXXXXXXXXXXXXXGOOOOOOOXXXXXXXXXXXXGOXXXXXXXXXXXXXXXXXXGOOOOOOOOOOXXXXXXXXXGOXXXXXXXXXXXXXXXXXXGOOOXXXXXXXXXXXXXXXXGOOXXXXXXXXXXXXXXXXXGOOOXXXXXXXXXXXXXXXXGOOOOOXXXXXXXXXXXXXXGOOXXXXXXXXXXXXXXXXXGOOOOOOXXXXXXXXXXXXXGOOOOOOOOXXXXXXXXXXX,0,300,0

39375,69,0,69,3,228,0,0,230,220,10,GOOOXXXXXXXXXXXXXXXXGOOOOOXXXXXXXXXXXXXXGOOOOOOOXXXXXXXXXXXXGOXXXXXXXXXXXXXXXXXXGOOOOOOOOOOXXXXXXXXXGOXXXXXXXXXXXXXXXXXXGOOOXXXXXXXXXXXXXXXXGOOXXXXXXXXXXXXXXXXXGOOOXXXXXXXXXXXXXXXXGOOOOOXXXXXXXXXXXXXXGOOXXXXXXXXXXXXXXXXXGOOOOOOXXXXXXXXXXXXXGOOOOOOOOXXXXXXXXXXX,0,300,0
39396,69,0,69,3,228,0,0,230,220,10,GOOOXXXXXXXXXXXXXXXXGOOOOOXXXXXXXXXXXXXXGOOOOOOOXXXXXXXXXXXXGOXXXXXXXXXXXXXXXXXXGOOOOOOOOOOXXXXXXXXXGOXXXXXXXXXXXXXXXXXXGOOOXXXXXXXXXXXXXXXXGOOXXXXXXXXXXXXXXXXXGOOOXXXXXXXXXXXXXXXXGOOOOOXXXXXXXXXXXXXXGOOXXXXXXXXXXXXXXXXXGOOOOOOXXXXXXXXXXXXXGOOOOOOOOXXXXXXXXXXX,0,300,0
39417,69,0,69,3,228,0,0,230,220,10,GOOOXXXXXXXXXXXXXXXXGOOOOOXXXXXXXXXXXXXXGOOOOOOOXXXXXXXXXXXXGOXXXXXXXXXXXXXXXXXXGOOOOOOOOOOXXXXXXXXXGOXXXXXXXXXXXXXXXXXXGOOOXXXXXXXXXXXXXXXXGOOXXXXXXXXXXXXXXXXXGOOOXXXXXXXXXXXXXXXXGOOOOOXXXXXXXXXXXXXXGOOXXXXXXXXXXXXXXXXXGOOOOOOXXXXXXXXXXXXXGOOOOOOOOXXXXXXXXXXX,0,300,0
39438,69,0,69,2,229,0,0,231,221,10,GOOOXXXXXXXXXXXXXXXXGOOOOOXXXXXXXXXXXXXXGOOOOOOOXXXXXXXXXXXXGOXXXXXXXXXXXXXXXXXXGOOOOOOOOOOXXXXXXXXXGOXXXXXXXXXXXXXXXXXXGOOOXXXXXXXXXXXXXXXXGOOXXXXXXXXXXXXXXXXXGOOOXXXXXXXXXXXXXXXXGOOOOOXXXXXXXXXXXXXXGOOXXXXXXXXXXXXXXXXXGOOOOOOXXXXXXXXXXXXXGOOOOOOOOXXXXXXXXXXX,0,300,0
39459,69,0,69,2,229,0,0,231,221,10,GOOOXXXXXXXXXXXXXXXXGOOOOOXXXXXXXXXXXXXXGOOOOOOOXXXXXXXXXXXXGOXXXXXXXXXXXXXXXXXXGOOOOOOOOOOXXXXXXXXXGOXXXXXXXXXXXXXXXXXXGOOOXXXXXXXXXXXXXXXXGOOXXXXXXXXXXXXXXXXXGOOOXXXXXXXXXXXXXXXXGOOOOOXXXXXXXXXXXXXXGOOXXXXXXXXXXXXXXXXXGOOOOOOXXXXXXXXXXXXXGOOOOOOOOXXXXXXXXXXX,0,300,0

39480,69,0,69,4,227,0,0,229,220,9,GOOOXXXXXXXXXXXXXXXXGOOOOOXXXXXXXXXXXXXXGOOOOOOOXXXXXXXXXXXXGOXXXXXXXXXXXXXXXXXXGOOOOOOOOOOXXXXXXXXXGOXXXXXXXXXXXXXXXXXXGOOOXXXXXXXXXXXXXXXXGOOXXXXXXXXXXXXXXXXXGOOOXXXXXXXXXXXXXXXXGOOOOOXXXXXXXXXXXXXXGOOXXXXXXXXXXXXXXXXXGOOOOOOXXXXXXXXXXXXXGOOOOOOOOXXXXXXXXXXX,0,300,0
39501,69,0,69,6,225,0,0,227,220,7,GOOOXXXXXXXXXXXXXXXXGOOOOOXXXXXXXXXXXXXXGOOOOOOOXXXXXXXXXXXXGOXXXXXXXXXXXXXXXXXXGOOOOOOOOOOXXXXXXXXXGOXXXXXXXXXXXXXXXXXXGOOOXXXXXXXXXXXXXXXXGOOXXXXXXXXXXXXXXXXXGOOOXXXXXXXXXXXXXXXXGOOOOOXXXXXXXXXXXXXXGOOXXXXXXXXXXXXXXXXXGOOOOOOXXXXXXXXXXXXXGOOOOOOOOXXXXXXXXXXX,0,300,0
39522,69,0,69,6,225,0,0,227,220,7,GOOOXXXXXXXXXXXXXXXXGOOOOOXXXXXXXXXXXXXXGOOOOOOOXXXXXXXXXXXXGOXXXXXXXXXXXXXXXXXXGOOOOOOOOOOXXXXXXXXXGOXXXXXXXXXXXXXXXXXXGOOOXXXXXXXXXXXXXXXXGOOXXXXXXXXXXXXXXXXXGOOOXXXXXXXXXXXXXXXXGOOOOOXXXXXXXXXXXXXXGOOXXXXXXXXXXXXXXXXXGOOOOOOXXXXXXXXXXXXXGOOOOOOOOXXXXXXXXXXX,0,300,0
39543,69,0,69,6,225,0,0,227,220,7,GOOOXXXXXXXXXXXXXXXXGOOOOOXXXXXXXXXXXXXXGOOOOOOOXXXXXXXXXXXXGOXXXXXXXXXXXXXXXXXXGOOOOOOOOOOXXXXXXXXXGOXXXXXXXXXXXXXXXXXXGOOOXXXXXXXXXXXXXXXXGOOXXXXXXXXXXXXXXXXXGOOOXXXXXXXXXXXXXXXXGOOOOOXXXXXXXXXXXXXXGOOXXXXXXXXXXXXXXXXXGOOOOOOXXXXXXXXXXXXXGOOOOOOOOXXXXXXXXXXX,0,300,0
39564,69,0,69,6,225,0,0,227,220,7,GOOOXXXXXXXXXXXXXXXXGOOOOOXXXXXXXXXXXXXXGOOOOOOOXXXXXXXXXXXXGOXXXXXXXXXXXXXXXXXXGOOOOOOOOOOXXXXXXXXXGOXXXXXXXXXXXXXXXXXXGOOOXXXXXXXXXXXXXXXXGOOXXXXXXXXXXXXXXXXXGOOOXXXXXXXXXXXXXXXXGOOOOOXXXXXXXXXXXXXXGOOXXXXXXXXXXXXXXXXXGOOOOOOXXXXXXXXXXXXXGOOOOOOOOXXXXXXXXXXX,0,300,0

39585,69,0,69,7,224,0,0,226,220,6,GOOOXXXXXXXXXXXXXXXXGOOOOOXXXXXXXXXXXXXXGOOOOOOOXXXXXXXXXXXXGOXXXXXXXXXXXXXXXXXXGOOOOOOOOOOXXXXXXXXXGOXXXXXXXXXXXXXXXXXXGOOOXXXXXXXXXXXXXXXXGOOXXXXXXXXXXXXXXXXXGOOOXXXXXXXXXXXXXXXXGOOOOOXXXXXXXXXXXXXXGOOXXXXXXXXXXXXXXXXXGOOOOOOXXXXXXXXXXXXXGOOOOOOOOXXXXXXXXXXX,0,300,0
39606,69,0,69,6,225,0,0,227,221,6,GOOOXXXXXXXXXXXXXXXXGOOOOOXXXXXXXXXXXXXXGOOOOOOOXXXXXXXXXXXXGOXXXXXXXXXXXXXXXXXXGOOOOOOOOOOXXXXXXXXXGOXXXXXXXXXXXXXXXXXXGOOOXXXXXXXXXXXXXXXXGOOXXXXXXXXXXXXXXXXXGOOOXXXXXXXXXXXXXXXXGOOOOOXXXXXXXXXXXXXXGOOXXXXXXXXXXXXXXXXXGOOOOOOXXXXXXXXXXXXXGOOOOOOOOXXXXXXXXXXX,0,300,0
39627,69,0,69,4,227,0,0,229,221,8,GOOOXXXXXXXXXXXXXXXXGOOOOOXXXXXXXXXXXXXXGOOOOOOOXXXXXXXXXXXXGOXXXXXXXXXXXXXXXXXXGOOOOOOOOOOXXXXXXXXXGOXXXXXXXXXXXXXXXXXXGOOOXXXXXXXXXXXXXXXXGOOXXXXXXXXXXXXXXXXXGOOOXXXXXXXXXXXXXXXXGOOOOOXXXXXXXXXXXXXXGOOXXXXXXXXXXXXXXXXXGOOOOOOXXXXXXXXXXXXXGOOOOOOOOXXXXXXXXXXX,0,300,0
39648,69,0,69,4,227,0,0,229,221,8,GOOOXXXXXXXXXXXXXXXXGOOOOOXXXXXXXXXXXXXXGOOOOOOOXXXXXXXXXXXXGOXXXXXXXXXXXXXXXXXXGOOOOOOOOOOXXXXXXXXXGOXXXXXXXXXXXXXXXXXXGOOOXXXXXXXXXXXXXXXXGOOXXXXXXXXXXXXXXXXXGOOOXXXXXXXXXXXXXXXXGOOOOOXXXXXXXXXXXXXXGOOXXXXXXXXXXXXXXXXXGOOOOOOXXXXXXXXXXXXXGOOOOOOOOXXXXXXXXXXX,0,300,0
39669,69,0,69,5,226,0,0,228,222,6,GOOOXXXXXXXXXXXXXXXXGOOOOOXXXXXXXXXXXXXXGOOOOOOOXXXXXXXXXXXXGOXXXXXXXXXXXXXXXXXXGOOOOOOOOOOXXXXXXXXXGOXXXXXXXXXXXXXXXXXXGOOOXXXXXXXXXXXXXXXXGOOXXXXXXXXXXXXXXXXXGOOOXXXXXXXXXXXXXXXXGOOOOOXXXXXXXXXXXXXXGOOXXXXXXXXXXXXXXXXXGOOOOOOXXXXXXXXXXXXXGOOOOOOOOXXXXXXXXXXX,0,300,0

39690,69,0,69,4,227,0,0,229,222,7,GOOOXXXXXXXXXXXXXXXXGOOOOOXXXXXXXXXXXXXXGOOOOOOOXXXXXXXXXXXXGOXXXXXXXXXXXXXXXXXXGOOOOOOOOOOXXXXXXXXXGOXXXXXXXXXXXXXXXXXXGOOOXXXXXXXXXXXXXXXXGOOXXXXXXXXXXXXXXXXXGOOOXXXXXXXXXXXXXXXXGOOOOOXXXXXXXXXXXXXXGOOXXXXXXXXXXXXXXXXXGOOOOOOXXXXXXXXXXXXXGOOOOOOOOXXXXXXXXXXX,0,300,0
39711,69,0,69,5,226,0,0,228,222,6,GOOOXXXXXXXXXXXXXXXXGOOOOOXXXXXXXXXXXXXXGOOOOOOOXXXXXXXXXXXXGOXXXXXXXXXXXXXXXXXXGOOOOOOOOOOXXXXXXXXXGOXXXXXXXXXXXXXXXXXXGOOOXXXXXXXXXXXXXXXXGOOXXXXXXXXXXXXXXXXXGOOOXXXXXXXXXXXXXXXXGOOOOOXXXXXXXXXXXXXXGOOXXXXXXXXXXXXXXXXXGOOOOOOXXXXXXXXXXXXXGOOOOOOOOXXXXXXXXXXX,0,300,0
39732,70,1,69,5,225,0,0,227,221,6,GOOOXXXXXXXXXXXXXXXXGOOOOOXXXXXXXXXXXXXXGOOOOOOOXXXXXXXXXXXXGOXXXXXXXXXXXXXXXXXXGOOOOOOOOOOXXXXXXXXXGOXXXXXXXXXXXXXXXXXXGOOOXXXXXXXXXXXXXXXXGOOXXXXXXXXXXXXXXXXXGOOOXXXXXXXXXXXXXXXXGOOOOOXXXXXXXXXXXXXXGOOXXXXXXXXXXXXXXXXXGOOOOOOXXXXXXXXXXXXXGOOOOOOOOAXXXXXXXXXX,0,300,0
39753,70,1,69,5,225,0,0,227,222,5,GOOOXXXXXXXXXXXXXXXXGOOOOOXXXXXXXXXXXXXXGOOOOOOOXXXXXXXXXXXXGOXXXXXXXXXXXXXXXXXXGOOOOOOOOOOXXXXXXXXXGOXXXXXXXXXXXXXXXXXXGOOOXXXXXXXXXXXXXXXXGOOXXXXXXXXXXXXXXXXXGOOOXXXXXXXXXXXXXXXXGOOOOOXXXXXXXXXXXXXXGOOXXXXXXXXXXXXXXXXXGOOOOOOXXXXXXXXXXXXXGOOOOOOOOAXXXXXXXXXX,0,300,0
39774,70,1,69,5,225,0,0,227,222,5,GOOOXXXXXXXXXXXXXXXXGOOOOOXXXXXXXXXXXXXXGOOOOOOOXXXXXXXXXXXXGOXXXXXXXXXXXXXXXXXXGOOOOOOOOOOXXXXXXXXXGOXXXXXXXXXXXXXXXXXXGOOOXXXXXXXXXXXXXXXXGOOXXXXXXXXXXXXXXXXXGOOOXXXXXXXXXXXXXXXXGOOOOOXXXXXXXXXXXXXXGOOXXXXXXXXXXXXXXXXXGOOOOOOXXXXXXXXXXXXXGOOOOOOOOAXXXXXXXXXX,0,300,0

39795,70,1,69,3,227,0,0,229,222,7,GOOOXXXXXXXXXXXXXXXXGOOOOOXXXXXXXXXXXXXXGOOOOOOOXXXXXXXXXXXXGOXXXXXXXXXXXXXXXXXXGOOOOOOOOOOXXXXXXXXXGOXXXXXXXXXXXXXXXXXXGOOOXXXXXXXXXXXXXXXXGOOXXXXXXXXXXXXXXXXXGOOOXXXXXXXXXXXXXXXXGOOOOOXXXXXXXXXXXXXXGOOXXXXXXXXXXXXXXXXXGOOOOOOXXXXXXXXXXXXXGOOOOOOOOAXXXXXXXXXX,0,300,0
39816,70,1,69,3,227,0,0,229,222,7,GOOOXXXXXXXXXXXXXXXXGOOOOOXXXXXXXXXXXXXXGOOOOOOOXXXXXXXXXXXXGOXXXXXXXXXXXXXXXXXXGOOOOOOOOOOXXXXXXXXXGOXXXXXXXXXXXXXXXXXXGOOOXXXXXXXXXXXXXXXXGOOXXXXXXXXXXXXXXXXXGOOOXXXXXXXXXXXXXXXXGOOOOOXXXXXXXXXXXXXXGOOXXXXXXXXXXXXXXXXXGOOOOOOXXXXXXXXXXXXXGOOOOOOOOAXXXXXXXXXX,0,300,0
39837,70,1,69,3,227,0,0,229,222,7,GOOOXXXXXXXXXXXXXXXXGOOOOOXXXXXXXXXXXXXXGOOOOOOOXXXXXXXXXXXXGOXXXXXXXXXXXXXXXXXXGOOOOOOOOOOXXXXXXXXXGOXXXXXXXXXXXXXXXXXXGOOOXXXXXXXXXXXXXXXXGOOXXXXXXXXXXXXXXXXXGOOOXXXXXXXXXXXXXXXXGOOOOOXXXXXXXXXXXXXXGOOXXXXXXXXXXXXXXXXXGOOOOOOXXXXXXXXXXXXXGOOOOOOOOAXXXXXXXXXX,0,300,0
39858,70,0,70,4,226,0,0,228,222,6,GOOOXXXXXXXXXXXXXXXXGOOOOOXXXXXXXXXXXXXXGOOOOOOOXXXXXXXXXXXXGOXXXXXXXXXXXXXXXXXXGOOOOOOOOOOXXXXXXXXXGOXXXXXXXXXXXXXXXXXXGOOOXXXXXXXXXXXXXXXXGOOXXXXXXXXXXXXXXXXXGOOOXXXXXXXXXXXXXXXXGOOOOOXXXXXXXXXXXXXXGOOXXXXXXXXXXXXXXXXXGOOOOOOXXXXXXXXXXXXXGOOOOOOOOOXXXXXXXXXX,0,300,0
39879,70,0,70,4,226,0,0,228,223,5,GOOOXXXXXXXXXXXXXXXXGOOOOOXXXXXXXXXXXXXXGOOOOOOOXXXXXXXXXXXXGOXXXXXXXXXXXXXXXXXXGOOOOOOOOOOXXXXXXXXXGOXXXXXXXXXXXXXXXXXXGOOOXXXXXXXXXXXXXXXXGOOXXXXXXXXXXXXXXXXXGOOOXXXXXXXXXXXXXXXXGOOOOOXXXXXXXXXXXXXXGOOXXXXXXXXXXXXXXXXXGOOOOOOXXXXXXXXXXXXXGOOOOOOOOOXXXXXXXXXX,0,300,0

39900,70,0,70,5,225,0,0,227,222,5,GOOOXXXXXXXXXXXXXXXXGOOOOOXXXXXXXXXXXXXXGOOOOOOOXXXXXXXXXXXXGOXXXXXXXXXXXXXXXXXXGOOOOOOOOOOXXXXXXXXXGOXXXXXXXXXXXXXXXXXXGOOOXXXXXXXXXXXXXXXXGOOXXXXXXXXXXXXXXXXXGOOOXXXXXXXXXXXXXXXXGOOOOOXXXXXXXXXXXXXXGOOXXXXXXXXXXXXXXXXXGOOOOOOXXXXXXXXXXXXXGOOOOOOOOOXXXXXXXXXX,0,300,0
39921,70,0,70,4,226,0,0,228,222,6,GOOOXXXXXXXXXXXXXXXXGOOOOOXXXXXXXXXXXXXXGOOOOOOOXXXXXXXXXXXXGOXXXXXXXXXXXXXXXXXXGOOOOOOOOOOXXXXXXXXXGOXXXXXXXXXXXXXXXXXXGOOOXXXXXXXXXXXXXXXXGOOXXXXXXXXXXXXXXXXXGOOOXXXXXXXXXXXXXXXXGOOOOOXXXXXXXXXXXXXXGOOXXXXXXXXXXXXXXXXXGOOOOOOXXXXXXXXXXXXXGOOOOOOOOOXXXXXXXXXX,0,300,0
39942,70,0,70,4,226,0,0,228,222,6,GOOOXXXXXXXXXXXXXXXXGOOOOOXXXXXXXXXXXXXXGOOOOOOOXXXXXXXXXXXXGOXXXXXXXXXXXXXXXXXXGOOOOOOOOOOXXXXXXXXXGOXXXXXXXXXXXXXXXXXXGOOOXXXXXXXXXXXXXXXXGOOXXXXXXXXXXXXXXXXXGOOOXXXXXXXXXXXXXXXXGOOOOOXXXXXXXXXXXXXXGOOXXXXXXXXXXXXXXXXXGOOOOOOXXXXXXXXXXXXXGOOOOOOOOOXXXXXXXXXX,0,300,0
39963,70,0,70,4,226,0,0,228,223,5,GOOOXXXXXXXXXXXXXXXXGOOOOOXXXXXXXXXXXXXXGOOOOOOOXXXXXXXXXXXXGOXXXXXXXXXXXXXXXXXXGOOOOOOOOOOXXXXXXXXXGOXXXXXXXXXXXXXXXXXXGOOOXXXXXXXXXXXXXXXXGOOXXXXXXXXXXXXXXXXXGOOOXXXXXXXXXXXXXXXXGOOOOOXXXXXXXXXXXXXXGOOXXXXXXXXXXXXXXXXXGOOOOOOXXXXXXXXXXXXXGOOOOOOOOOXXXXXXXXXX,0,300,0
39984,70,0,70,5,225,0,0,227,223,4,GOOOXXXXXXXXXXXXXXXXGOOOOOXXXXXXXXXXXXXXGOOOOOOOXXXXXXXXXXXXGOXXXXXXXXXXXXXXXXXXGOOOOOOOOOOXXXXXXXXXGOXXXXXXXXXXXXXXXXXXGOOOXXXXXXXXXXXXXXXXGOOXXXXXXXXXXXXXXXXXGOOOXXXXXXXXXXXXXXXXGOOOOOXXXXXXXXXXXXXXGOOXXXXXXXXXXXXXXXXXGOOOOOOXXXXXXXXXXXXXGOOOOOOOOOXXXXXXXXXX,0,300,0

40005,70,0,70,6,224,0,0,226,223,3,GOOOXXXXXXXXXXXXXXXXGOOOOOXXXXXXXXXXXXXXGOOOOOOOXXXXXXXXXXXXGOXXXXXXXXXXXXXXXXXXGOOOOOOOOOOXXXXXXXXXGOXXXXXXXXXXXXXXXXXXGOOOXXXXXXXXXXXXXXXXGOOXXXXXXXXXXXXXXXXXGOOOXXXXXXXXXXXXXXXXGOOOOOXXXXXXXXXXXXXXGOOXXXXXXXXXXXXXXXXXGOOOOOOXXXXXXXXXXXXXGOOOOOOOOOXXXXXXXXXX,0,300,0
40026,70,0,70,7,223,0,0,225,222,3,GOOOXXXXXXXXXXXXXXXXGOOOOOXXXXXXXXXXXXXXGOOOOOOOXXXXXXXXXXXXGOXXXXXXXXXXXXXXXXXXGOOOOOOOOOOXXXXXXXXXGOXXXXXXXXXXXXXXXXXXGOOOXXXXXXXXXXXXXXXXGOOXXXXXXXXXXXXXXXXXGOOOXXXXXXXXXXXXXXXXGOOOOOXXXXXXXXXXXXXXGOOXXXXXXXXXXXXXXXXXGOOOOOOXXXXXXXXXXXXXGOOOOOOOOOXXXXXXXXXX,0,300,0
40047,70,0,70,6,224,0,0,226,222,4,GOOOXXXXXXXXXXXXXXXXGOOOOOXXXXXXXXXXXXXXGOOOOOOOXXXXXXXXXXXXGOXXXXXXXXXXXXXXXXXXGOOOOOOOOOOXXXXXXXXXGOXXXXXXXXXXXXXXXXXXGOOOXXXXXXXXXXXXXXXXGOOXXXXXXXXXXXXXXXXXGOOOXXXXXXXXXXXXXXXXGOOOOOXXXXXXXXXXXXXXGOOXXXXXXXXXXXXXXXXXGOOOOOOXXXXXXXXXXXXXGOOOOOOOOOXXXXXXXXXX,0,300,0
40068,70,0,70,5,225,0,0,227,224,3,GOOOXXXXXXXXXXXXXXXXGOOOOOXXXXXXXXXXXXXXGOOOOOOOXXXXXXXXXXXXGOXXXXXXXXXXXXXXXXXXGOOOOOOOOOOXXXXXXXXXGOXXXXXXXXXXXXXXXXXXGOOOXXXXXXXXXXXXXXXXGOOXXXXXXXXXXXXXXXXXGOOOXXXXXXXXXXXXXXXXGOOOOOXXXXXXXXXXXXXXGOOXXXXXXXXXXXXXXXXXGOOOOOOXXXXXXXXXXXXXGOOOOOOOOOXXXXXXXXXX,0,300,0
40089,70,0,70,4,226,0,0,228,224,4,GOOOXXXXXXXXXXXXXXXXGOOOOOXXXXXXXXXXXXXXGOOOOOOOXXXXXXXXXXXXGOXXXXXXXXXXXXXXXXXXGOOOOOOOOOOXXXXXXXXXGOXXXXXXXXXXXXXXXXXXGOOOXXXXXXXXXXXXXXXXGOOXXXXXXXXXXXXXXXXXGOOOXXXXXXXXXXXXXXXXGOOOOOXXXXXXXXXXXXXXGOOXXXXXXXXXXXXXXXXXGOOOOOOXXXXXXXXXXXXXGOOOOOOOOOXXXXXXXXXX,0,300,0

40110,70,0,70,2,228,0,0,230,224,6,GOOOXXXXXXXXXXXXXXXXGOOOOOXXXXXXXXXXXXXXGOOOOOOOXXXXXXXXXXXXGOXXXXXXXXXXXXXXXXXXGOOOOOOOOOOXXXXXXXXXGOXXXXXXXXXXXXXXXXXXGOOOXXXXXXXXXXXXXXXXGOOXXXXXXXXXXXXXXXXXGOOOXXXXXXXXXXXXXXXXGOOOOOXXXXXXXXXXXXXXGOOXXXXXXXXXXXXXXXXXGOOOOOOXXXXXXXXXXXXXGOOOOOOOOOXXXXXXXXXX,0,300,0
40131,70,0,70,3,227,0,0,229,223,6,GOOOXXXXXXXXXXXXXXXXGOOOOOXXXXXXXXXXXXXXGOOOOOOOXXXXXXXXXXXXGOXXXXXXXXXXXXXXXXXXGOOOOOOOOOOXXXXXXXXXGOXXXXXXXXXXXXXXXXXXGOOOXXXXXXXXXXXXXXXXGOOXXXXXXXXXXXXXXXXXGOOOXXXXXXXXXXXXXXXXGOOOOOXXXXXXXXXXXXXXGOOXXXXXXXXXXXXXXXXXGOOOOOOXXXXXXXXXXXXXGOOOOOOOOOXXXXXXXXXX,0,300,0
40152,70,0,70,4,226,0,0,228,222,6,GOOOXXXXXXXXXXXXXXXXGOOOOOXXXXXXXXXXXXXXGOOOOOOOXXXXXXXXXXXXGOXXXXXXXXXXXXXXXXXXGOOOOOOOOOOXXXXXXXXXGOXXXXXXXXXXXXXXXXXXGOOOXXXXXXXXXXXXXXXXGOOXXXXXXXXXXXXXXXXXGOOOXXXXXXXXXXXXXXXXGOOOOOXXXXXXXXXXXXXXGOOXXXXXXXXXXXXXXXXXGOOOOOOXXXXXXXXXXXXXGOOOOOOOOOXXXXXXXXXX,0,300,0
40173,70,0,70,4,226,0,0,228,222,6,GOOOXXXXXXXXXXXXXXXXGOOOOOXXXXXXXXXXXXXXGOOOOOOOXXXXXXXXXXXXGOXXXXXXXXXXXXXXXXXXGOOOOOOOOOOXXXXXXXXXGOXXXXXXXXXXXXXXXXXXGOOOXXXXXXXXXXXXXXXXGOOXXXXXXXXXXXXXXXXXGOOOXXXXXXXXXXXXXXXXGOOOOOXXXXXXXXXXXXXXGOOXXXXXXXXXXXXXXXXXGOOOOOOXXXXXXXXXXXXXGOOOOOOOOOXXXXXXXXXX,0,300,0
40194,70,0,70,3,227,0,0,229,222,7,GOOOXXXXXXXXXXXXXXXXGOOOOOXXXXXXXXXXXXXXGOOOOOOOXXXXXXXXXXXXGOXXXXXXXXXXXXXXXXXXGOOOOOOOOOOXXXXXXXXXGOXXXXXXXXXXXXXXXXXXGOOOXXXXXXXXXXXXXXXXGOOXXXXXXXXXXXXXXXXXGOOOXXXXXXXXXXXXXXXXGOOOOOXXXXXXXXXXXXXXGOOXXXXXXXXXXXXXXXXXGOOOOOOXXXXXXXXXXXXXGOOOOOOOOOXXXXXXXXXX,0,300,0

40215,70,0,70,3,227,0,0,229,222,7,GOOOXXXXXXXXXXXXXXXXGOOOOOXXXXXXXXXXXXXXGOOOOOOOXXXXXXXXXXXXGOXXXXXXXXXXXXXXXXXXGOOOOOOOOOOXXXXXXXXXGOXXXXXXXXXXXXXXXXXXGOOOXXXXXXXXXXXXXXXXGOOXXXXXXXXXXXXXXXXXGOOOXXXXXXXXXXXXXXXXGOOOOOXXXXXXXXXXXXXXGOOXXXXXXXXXXXXXXXXXGOOOOOOXXXXXXXXXXXXXGOOOOOOOOOXXXXXXXXXX,0,300,0
40236,70,0,70,3,227,0,0,229,222,7,GOOOXXXXXXXXXXXXXXXXGOOOOOXXXXXXXXXXXXXXGOOOOOOOXXXXXXXXXXXXGOXXXXXXXXXXXXXXXXXXGOOOOOOOOOOXXXXXXXXXGOXXXXXXXXXXXXXXXXXXGOOOXXXXXXXXXXXXXXXXGOOXXXXXXXXXXXXXXXXXGOOOXXXXXXXXXXXXXXXXGOOOOOXXXXXXXXXXXXXXGOOXXXXXXXXXXXXXXXXXGOOOOOOXXXXXXXXXXXXXGOOOOOOOOOXXXXXXXXXX,0,300,0
40257,70,0,70,2,228,0,0,230,222,8,GOOOXXXXXXXXXXXXXXXXGOOOOOXXXXXXXXXXXXXXGOOOOOOOXXXXXXXXXXXXGOXXXXXXXXXXXXXXXXXXGOOOOOOOOOOXXXXXXXXXGOXXXXXXXXXXXXXXXXXXGOOOXXXXXXXXXXXXXXXXGOOXXXXXXXXXXXXXXXXXGOOOXXXXXXXXXXXXXXXXGOOOOOXXXXXXXXXXXXXXGOOXXXXXXXXXXXXXXXXXGOOOOOOXXXXXXXXXXXXXGOOOOOOOOOXXXXXXXXXX,0,300,0
40278,70,0,70,2,228,0,0,230,222,8,GOOOXXXXXXXXXXXXXXXXGOOOOOXXXXXXXXXXXXXXGOOOOOOOXXXXXXXXXXXXGOXXXXXXXXXXXXXXXXXXGOOOOOOOOOOXXXXXXXXXGOXXXXXXXXXXXXXXXXXXGOOOXXXXXXXXXXXXXXXXGOOXXXXXXXXXXXXXXXXXGOOOXXXXXXXXXXXXXXXXGOOOOOXXXXXXXXXXXXXXGOOXXXXXXXXXXXXXXXXXGOOOOOOXXXXXXXXXXXXXGOOOOOOOOOXXXXXXXXXX,0,300,0
40299,70,0,70,2,228,0,0,230,222,8,GOOOXXXXXXXXXXXXXXXXGOOOOOXXXXXXXXXXXXXXGOOOOOOOXXXXXXXXXXXXGOXXXXXXXXXXXXXXXXXXGOOOOOOOOOOXXXXXXXXXGOXXXXXXXXXXXXXXXXXXGOOOXXXXXXXXXXXXXXXXGOOXXXXXXXXXXXXXXXXXGOOOXXXXXXXXXXXXXXXXGOOOOOXXXXXXXXXXXXXXGOOXXXXXXXXXXXXXXXXXGOOOOOOXXXXXXXXXXXXXGOOOOOOOOOXXXXXXXXXX,0,300,0

40320,70,0,70,2,228,0,0,230,223,7,GOOOXXXXXXXXXXXXXXXXGOOOOOXXXXXXXXXXXXXXGOOOOOOOXXXXXXXXXXXXGOXXXXXXXXXXXXXXXXXXGOOOOOOOOOOXXXXXXXXXGOXXXXXXXXXXXXXXXXXXGOOOXXXXXXXXXXXXXXXXGOOXXXXXXXXXXXXXXXXXGOOOXXXXXXXXXXXXXXXXGOOOOOXXXXXXXXXXXXXXGOOXXXXXXXXXXXXXXXXXGOOOOOOXXXXXXXXXXXXXGOOOOOOOOOXXXXXXXXXX,0,300,0
40341,70,0,70,2,228,0,0,230,222,8,GOOOXXXXXXXXXXXXXXXXGOOOOOXXXXXXXXXXXXXXGOOOOOOOXXXXXXXXXXXXGOXXXXXXXXXXXXXXXXXXGOOOOOOOOOOXXXXXXXXXGOXXXXXXXXXXXXXXXXXXGOOOXXXXXXXXXXXXXXXXGOOXXXXXXXXXXXXXXXXXGOOOXXXXXXXXXXXXXXXXGOOOOOXXXXXXXXXXXXXXGOOXXXXXXXXXXXXXXXXXGOOOOOOXXXXXXXXXXXXXGOOOOOOOOOXXXXXXXXXX,0,300,0
40362,70,0,70,1,229,0,0,231,222,9,GOOOXXXXXXXXXXXXXXXXGOOOOOXXXXXXXXXXXXXXGOOOOOOOXXXXXXXXXXXXGOXXXXXXXXXXXXXXXXXXGOOOOOOOOOOXXXXXXXXXGOXXXXXXXXXXXXXXXXXXGOOOXXXXXXXXXXXXXXXXGOOXXXXXXXXXXXXXXXXXGOOOXXXXXXXXXXXXXXXXGOOOOOXXXXXXXXXXXXXXGOOXXXXXXXXXXXXXXXXXGOOOOOOXXXXXXXXXXXXXGOOOOOOOOOXXXXXXXXXX,0,300,0
40383,70,0,70,1,229,0,0,231,223,8,GOOOXXXXXXXXXXXXXXXXGOOOOOXXXXXXXXXXXXXXGOOOOOOOXXXXXXXXXXXXGOXXXXXXXXXXXXXXXXXXGOOOOOOOOOOXXXXXXXXXGOXXXXXXXXXXXXXXXXXXGOOOXXXXXXXXXXXXXXXXGOOXXXXXXXXXXXXXXXXXGOOOXXXXXXXXXXXXXXXXGOOOOOXXXXXXXXXXXXXXGOOXXXXXXXXXXXXXXXXXGOOOOOOXXXXXXXXXXXXXGOOOOOOOOOXXXXXXXXXX,0,300,0
40404,70,0,70,2,228,0,0,230,222,8,GOOOXXXXXXXXXXXXXXXXGOOOOOXXXXXXXXXXXXXXGOOOOOOOXXXXXXXXXXXXGOXXXXXXXXXXXXXXXXXXGOOOOOOOOOOXXXXXXXXXGOXXXXXXXXXXXXXXXXXXGOOOXXXXXXXXXXXXXXXXGOOXXXXXXXXXXXXXXXXXGOOOXXXXXXXXXXXXXXXXGOOOOOXXXXXXXXXXXXXXGOOXXXXXXXXXXXXXXXXXGOOOOOOXXXXXXXXXXXXXGOOOOOOOOOXXXXXXXXXX,0,300,0

40425,70,0,70,3,227,0,0,229,222,7,GOOOXXXXXXXXXXXXXXXXGOOOOOXXXXXXXXXXXXXXGOOOOOOOXXXXXXXXXXXXGOXXXXXXXXXXXXXXXXXXGOOOOOOOOOOXXXXXXXXXGOXXXXXXXXXXXXXXXXXXGOOOXXXXXXXXXXXXXXXXGOOXXXXXXXXXXXXXXXXXGOOOXXXXXXXXXXXXXXXXGOOOOOXXXXXXXXXXXXXXGOOXXXXXXXXXXXXXXXXXGOOOOOOXXXXXXXXXXXXXGOOOOOOOOOXXXXXXXXXX,0,300,0
40446,70,0,70,2,228,0,0,230,222,8,GOOOXXXXXXXXXXXXXXXXGOOOOOXXXXXXXXXXXXXXGOOOOOOOXXXXXXXXXXXXGOXXXXXXXXXXXXXXXXXXGOOOOOOOOOOXXXXXXXXXGOXXXXXXXXXXXXXXXXXXGOOOXXXXXXXXXXXXXXXXGOOXXXXXXXXXXXXXXXXXGOOOXXXXXXXXXXXXXXXXGOOOOOXXXXXXXXXXXXXXGOOXXXXXXXXXXXXXXXXXGOOOOOOXXXXXXXXXXXXXGOOOOOOOOOXXXXXXXXXX,0,300,0
40467,70,0,70,2,228,0,0,230,222,8,GOOOXXXXXXXXXXXXXXXXGOOOOOXXXXXXXXXXXXXXGOOOOOOOXXXXXXXXXXXXGOXXXXXXXXXXXXXXXXXXGOOOOOOOOOOXXXXXXXXXGOXXXXXXXXXXXXXXXXXXGOOOXXXXXXXXXXXXXXXXGOOXXXXXXXXXXXXXXXXXGOOOXXXXXXXXXXXXXXXXGOOOOOXXXXXXXXXXXXXXGOOXXXXXXXXXXXXXXXXXGOOOOOOXXXXXXXXXXXXXGOOOOOOOOOXXXXXXXXXX,0,300,0
40488,70,0,70,3,227,0,0,229,222,7,GOOOXXXXXXXXXXXXXXXXGOOOOOXXXXXXXXXXXXXXGOOOOOOOXXXXXXXXXXXXGOXXXXXXXXXXXXXXXXXXGOOOOOOOOOOXXXXXXXXXGOXXXXXXXXXXXXXXXXXXGOOOXXXXXXXXXXXXXXXXGOOXXXXXXXXXXXXXXXXXGOOOXXXXXXXXXXXXXXXXGOOOOOXXXXXXXXXXXXXXGOOXXXXXXXXXXXXXXXXXGOOOOOOXXXXXXXXXXXXXGOOOOOOOOOXXXXXXXXXX,0,300,0
40509,70,0,70,3,227,0,0,229,222,7,GOOOXXXXXXXXXXXXXXXXGOOOOOXXXXXXXXXXXXXXGOOOOOOOXXXXXXXXXXXXGOXXXXXXXXXXXXXXXXXXGOOOOOOOOOOXXXXXXXXXGOXXXXXXXXXXXXXXXXXXGOOOXXXXXXXXXXXXXXXXGOOXXXXXXXXXXXXXXXXXGOOOXXXXXXXXXXXXXXXXGOOOOOXXXXXXXXXXXXXXGOOXXXXXXXXXXXXXXXXXGOOOOOOXXXXXXXXXXXXXGOOOOOOOOOXXXXXXXXXX,0,300,0

40530,70,0,70,3,227,0,0,229,222,7,GOOOXXXXXXXXXXXXXXXXGOOOOOXXXXXXXXXXXXXXGOOOOOOOXXXXXXXXXXXXGOXXXXXXXXXXXXXXXXXXGOOOOOOOOOOXXXXXXXXXGOXXXXXXXXXXXXXXXXXXGOOOXXXXXXXXXXXXXXXXGOOXXXXXXXXXXXXXXXXXGOOOXXXXXXXXXXXXXXXXGOOOOOXXXXXXXXXXXXXXGOOXXXXXXXXXXXXXXXXXGOOOOOOXXXXXXXXXXXXXGOOOOOOOOOXXXXXXXXXX,0,300,0
40551,70,0,70,4,226,0,0,228,223,5,GOOOXXXXXXXXXXXXXXXXGOOOOOXXXXXXXXXXXXXXGOOOOOOOXXXXXXXXXXXXGOXXXXXXXXXXXXXXXXXXGOOOOOOOOOOXXXXXXXXXGOXXXXXXXXXXXXXXXXXXGOOOXXXXXXXXXXXXXXXXGOOXXXXXXXXXXXXXXXXXGOOOXXXXXXXXXXXXXXXXGOOOOOXXXXXXXXXXXXXXGOOXXXXXXXXXXXXXXXXXGOOOOOOXXXXXXXXXXXXXGOOOOOOOOOXXXXXXXXXX,0,300,0
40572,70,0,70,4,226,0,0,228,222,6,GOOOXXXXXXXXXXXXXXXXGOOOOOXXXXXXXXXXXXXXGOOOOOOOXXXXXXXXXXXXGOXXXXXXXXXXXXXXXXXXGOOOOOOOOOOXXXXXXXXXGOXXXXXXXXXXXXXXXXXXGOOOXXXXXXXXXXXXXXXXGOOXXXXXXXXXXXXXXXXXGOOOXXXXXXXXXXXXXXXXGOOOOOXXXXXXXXXXXXXXGOOXXXXXXXXXXXXXXXXXGOOOOOOXXXXXXXXXXXXXGOOOOOOOOOXXXXXXXXXX,0,300,0
40593,70,0,70,3,227,0,0,229,223,6,GOOOXXXXXXXXXXXXXXXXGOOOOOXXXXXXXXXXXXXXGOOOOOOOXXXXXXXXXXXXGOXXXXXXXXXXXXXXXXXXGOOOOOOOOOOXXXXXXXXXGOXXXXXXXXXXXXXXXXXXGOOOXXXXXXXXXXXXXXXXGOOXXXXXXXXXXXXXXXXXGOOOXXXXXXXXXXXXXXXXGOOOOOXXXXXXXXXXXXXXGOOXXXXXXXXXXXXXXXXXGOOOOOOXXXXXXXXXXXXXGOOOOOOOOOXXXXXXXXXX,0,300,0
40614,70,0,70,4,226,0,0,228,223,5,GOOOXXXXXXXXXXXXXXXXGOOOOOXXXXXXXXXXXXXXGOOOOOOOXXXXXXXXXXXXGOXXXXXXXXXXXXXXXXXXGOOOOOOOOOOXXXXXXXXXGOXXXXXXXXXXXXXXXXXXGOOOXXXXXXXXXXXXXXXXGOOXXXXXXXXXXXXXXXXXGOOOXXXXXXXXXXXXXXXXGOOOOOXXXXXXXXXXXXXXGOOXXXXXXXXXXXXXXXXXGOOOOOOXXXXXXXXXXXXXGOOOOOOOOOXXXXXXXXXX,0,300,0

40635,70,0,70,6,224,0,0,226,223,3,GOOOXXXXXXXXXXXXXXXXGOOOOOXXXXXXXXXXXXXXGOOOOOOOXXXXXXXXXXXXGOXXXXXXXXXXXXXXXXXXGOOOOOOOOOOXXXXXXXXXGOXXXXXXXXXXXXXXXXXXGOOOXXXXXXXXXXXXXXXXGOOXXXXXXXXXXXXXXXXXGOOOXXXXXXXXXXXXXXXXGOOOOOXXXXXXXXXXXXXXGOOXXXXXXXXXXXXXXXXXGOOOOOOXXXXXXXXXXXXXGOOOOOOOOOXXXXXXXXXX,0,300,0
40656,70,0,70,6,224,0,0,226,222,4,GOOOXXXXXXXXXXXXXXXXGOOOOOXXXXXXXXXXXXXXGOOOOOOOXXXXXXXXXXXXGOXXXXXXXXXXXXXXXXXXGOOOOOOOOOOXXXXXXXXXGOXXXXXXXXXXXXXXXXXXGOOOXXXXXXXXXXXXXXXXGOOXXXXXXXXXXXXXXXXXGOOOXXXXXXXXXXXXXXXXGOOOOOXXXXXXXXXXXXXXGOOXXXXXXXXXXXXXXXXXGOOOOOOXXXXXXXXXXXXXGOOOOOOOOOXXXXXXXXXX,0,300,0
40677,70,0,70,6,224,0,0,226,222,4,GOOOXXXXXXXXXXXXXXXXGOOOOOXXXXXXXXXXXXXXGOOOOOOOXXXXXXXXXXXXGOXXXXXXXXXXXXXXXXXXGOOOOOOOOOOXXXXXXXXXGOXXXXXXXXXXXXXXXXXXGOOOXXXXXXXXXXXXXXXXGOOXXXXXXXXXXXXXXXXXGOOOXXXXXXXXXXXXXXXXGOOOOOXXXXXXXXXXXXXXGOOXXXXXXXXXXXXXXXXXGOOOOOOXXXXXXXXXXXXXGOOOOOOOOOXXXXXXXXXX,0,300,0
40698,70,0,70,7,223,0,0,225,222,3,GOOOXXXXXXXXXXXXXXXXGOOOOOXXXXXXXXXXXXXXGOOOOOOOXXXXXXXXXXXXGOXXXXXXXXXXXXXXXXXXGOOOOOOOOOOXXXXXXXXXGOXXXXXXXXXXXXXXXXXXGOOOXXXXXXXXXXXXXXXXGOOXXXXXXXXXXXXXXXXXGOOOXXXXXXXXXXXXXXXXGOOOOOXXXXXXXXXXXXXXGOOXXXXXXXXXXXXXXXXXGOOOOOOXXXXXXXXXXXXXGOOOOOOOOOXXXXXXXXXX,0,300,0
40719,70,0,70,6,224,0,0,226,222,4,GOOOXXXXXXXXXXXXXXXXGOOOOOXXXXXXXXXXXXXXGOOOOOOOXXXXXXXXXXXXGOXXXXXXXXXXXXXXXXXXGOOOOOOOOOOXXXXXXXXXGOXXXXXXXXXXXXXXXXXXGOOOXXXXXXXXXXXXXXXXGOOXXXXXXXXXXXXXXXXXGOOOXXXXXXXXXXXXXXXXGOOOOOXXXXXXXXXXXXXXGOOXXXXXXXXXXXXXXXXXGOOOOOOXXXXXXXXXXXXXGOOOOOOOOOXXXXXXXXXX,0,300,0

40740,70,0,70,5,225,0,0,227,222,5,GOOOXXXXXXXXXXXXXXXXGOOOOOXXXXXXXXXXXXXXGOOOOOOOXXXXXXXXXXXXGOXXXXXXXXXXXXXXXXXXGOOOOOOOOOOXXXXXXXXXGOXXXXXXXXXXXXXXXXXXGOOOXXXXXXXXXXXXXXXXGOOXXXXXXXXXXXXXXXXXGOOOXXXXXXXXXXXXXXXXGOOOOOXXXXXXXXXXXXXXGOOXXXXXXXXXXXXXXXXXGOOOOOOXXXXXXXXXXXXXGOOOOOOOOOXXXXXXXXXX,0,300,0
40761,70,0,70,3,227,0,0,229,222,7,GOOOXXXXXXXXXXXXXXXXGOOOOOXXXXXXXXXXXXXXGOOOOOOOXXXXXXXXXXXXGOXXXXXXXXXXXXXXXXXXGOOOOOOOOOOXXXXXXXXXGOXXXXXXXXXXXXXXXXXXGOOOXXXXXXXXXXXXXXXXGOOXXXXXXXXXXXXXXXXXGOOOXXXXXXXXXXXXXXXXGOOOOOXXXXXXXXXXXXXXGOOXXXXXXXXXXXXXXXXXGOOOOOOXXXXXXXXXXXXXGOOOOOOOOOXXXXXXXXXX,0,300,0
40782,70,0,70,1,229,0,0,231,222,9,GOOOXXXXXXXXXXXXXXXXGOOOOOXXXXXXXXXXXXXXGOOOOOOOXXXXXXXXXXXXGOXXXXXXXXXXXXXXXXXXGOOOOOOOOOOXXXXXXXXXGOXXXXXXXXXXXXXXXXXXGOOOXXXXXXXXXXXXXXXXGOOXXXXXXXXXXXXXXXXXGOOOXXXXXXXXXXXXXXXXGOOOOOXXXXXXXXXXXXXXGOOXXXXXXXXXXXXXXXXXGOOOOOOXXXXXXXXXXXXXGOOOOOOOOOXXXXXXXXXX,0,300,0
40803,70,0,70,1,229,0,0,231,222,9,GOOOXXXXXXXXXXXXXXXXGOOOOOXXXXXXXXXXXXXXGOOOOOOOXXXXXXXXXXXXGOXXXXXXXXXXXXXXXXXXGOOOOOOOOOOXXXXXXXXXGOXXXXXXXXXXXXXXXXXXGOOOXXXXXXXXXXXXXXXXGOOXXXXXXXXXXXXXXXXXGOOOXXXXXXXXXXXXXXXXGOOOOOXXXXXXXXXXXXXXGOOXXXXXXXXXXXXXXXXXGOOOOOOXXXXXXXXXXXXXGOOOOOOOOOXXXXXXXXXX,0,300,0
40824,70,0,70,1,229,0,0,231,222,9,GOOOXXXXXXXXXXXXXXXXGOOOOOXXXXXXXXXXXXXXGOOOOOOOXXXXXXXXXXXXGOXXXXXXXXXXXXXXXXXXGOOOOOOOOOOXXXXXXXXXGOXXXXXXXXXXXXXXXXXXGOOOXXXXXXXXXXXXXXXXGOOXXXXXXXXXXXXXXXXXGOOOXXXXXXXXXXXXXXXXGOOOOOXXXXXXXXXXXXXXGOOXXXXXXXXXXXXXXXXXGOOOOOOXXXXXXXXXXXXXGOOOOOOOOOXXXXXXXXXX,0,300,0

40845,70,0,70,1,229,0,0,231,222,9,GOOOXXXXXXXXXXXXXXXXGOOOOOXXXXXXXXXXXXXXGOOOOOOOXXXXXXXXXXXXGOXXXXXXXXXXXXXXXXXXGOOOOOOOOOOXXXXXXXXXGOXXXXXXXXXXXXXXXXXXGOOOXXXXXXXXXXXXXXXXGOOXXXXXXXXXXXXXXXXXGOOOXXXXXXXXXXXXXXXXGOOOOOXXXXXXXXXXXXXXGOOXXXXXXXXXXXXXXXXXGOOOOOOXXXXXXXXXXXXXGOOOOOOOOOXXXXXXXXXX,0,300,0
40866,70,0,70,1,229,0,0,231,222,9,GOOOXXXXXXXXXXXXXXXXGOOOOOXXXXXXXXXXXXXXGOOOOOOOXXXXXXXXXXXXGOXXXXXXXXXXXXXXXXXXGOOOOOOOOOOXXXXXXXXXGOXXXXXXXXXXXXXXXXXXGOOOXXXXXXXXXXXXXXXXGOOXXXXXXXXXXXXXXXXXGOOOXXXXXXXXXXXXXXXXGOOOOOXXXXXXXXXXXXXXGOOXXXXXXXXXXXXXXXXXGOOOOOOXXXXXXXXXXXXXGOOOOOOOOOXXXXXXXXXX,0,300,0
40887,70,0,70,1,229,0,0,231,222,9,GOOOXXXXXXXXXXXXXXXXGOOOOOXXXXXXXXXXXXXXGOOOOOOOXXXXXXXXXXXXGOXXXXXXXXXXXXXXXXXXGOOOOOOOOOOXXXXXXXXXGOXXXXXXXXXXXXXXXXXXGOOOXXXXXXXXXXXXXXXXGOOXXXXXXXXXXXXXXXXXGOOOXXXXXXXXXXXXXXXXGOOOOOXXXXXXXXXXXXXXGOOXXXXXXXXXXXXXXXXXGOOOOOOXXXXXXXXXXXXXGOOOOOOOOOXXXXXXXXXX,0,300,0
40908,70,0,70,1,229,0,0,231,222,9,GOOOXXXXXXXXXXXXXXXXGOOOOOXXXXXXXXXXXXXXGOOOOOOOXXXXXXXXXXXXGOXXXXXXXXXXXXXXXXXXGOOOOOOOOOOXXXXXXXXXGOXXXXXXXXXXXXXXXXXXGOOOXXXXXXXXXXXXXXXXGOOXXXXXXXXXXXXXXXXXGOOOXXXXXXXXXXXXXXXXGOOOOOXXXXXXXXXXXXXXGOOXXXXXXXXXXXXXXXXXGOOOOOOXXXXXXXXXXXXXGOOOOOOOOOXXXXXXXXXX,0,300,0
40929,70,0,70,1,229,0,0,231,222,9,GOOOXXXXXXXXXXXXXXXXGOOOOOXXXXXXXXXXXXXXGOOOOOOOXXXXXXXXXXXXGOXXXXXXXXXXXXXXXXXXGOOOOOOOOOOXXXXXXXXXGOXXXXXXXXXXXXXXXXXXGOOOXXXXXXXXXXXXXXXXGOOXXXXXXXXXXXXXXXXXGOOOXXXXXXXXXXXXXXXXGOOOOOXXXXXXXXXXXXXXGOOXXXXXXXXXXXXXXXXXGOOOOOOXXXXXXXXXXXXXGOOOOOOOOOXXXXXXXXXX,0,300,0

40950,70,0,70,2,228,0,0,230,222,8,GOOOXXXXXXXXXXXXXXXXGOOOOOXXXXXXXXXXXXXXGOOOOOOOXXXXXXXXXXXXGOXXXXXXXXXXXXXXXXXXGOOOOOOOOOOXXXXXXXXXGOXXXXXXXXXXXXXXXXXXGOOOXXXXXXXXXXXXXXXXGOOXXXXXXXXXXXXXXXXXGOOOXXXXXXXXXXXXXXXXGOOOOOXXXXXXXXXXXXXXGOOXXXXXXXXXXXXXXXXXGOOOOOOXXXXXXXXXXXXXGOOOOOOOOOXXXXXXXXXX,0,300,0
40971,70,0,70,1,229,0,0,231,222,9,GOOOXXXXXXXXXXXXXXXXGOOOOOXXXXXXXXXXXXXXGOOOOOOOXXXXXXXXXXXXGOXXXXXXXXXXXXXXXXXXGOOOOOOOOOOXXXXXXXXXGOXXXXXXXXXXXXXXXXXXGOOOXXXXXXXXXXXXXXXXGOOXXXXXXXXXXXXXXXXXGOOOXXXXXXXXXXXXXXXXGOOOOOXXXXXXXXXXXXXXGOOXXXXXXXXXXXXXXXXXGOOOOOOXXXXXXXXXXXXXGOOOOOOOOOXXXXXXXXXX,0,300,0
40992,70,0,70,2,228,0,0,230,222,8,GOOOXXXXXXXXXXXXXXXXGOOOOOXXXXXXXXXXXXXXGOOOOOOOXXXXXXXXXXXXGOXXXXXXXXXXXXXXXXXXGOOOOOOOOOOXXXXXXXXXGOXXXXXXXXXXXXXXXXXXGOOOXXXXXXXXXXXXXXXXGOOXXXXXXXXXXXXXXXXXGOOOXXXXXXXXXXXXXXXXGOOOOOXXXXXXXXXXXXXXGOOXXXXXXXXXXXXXXXXXGOOOOOOXXXXXXXXXXXXXGOOOOOOOOOXXXXXXXXXX,0,300,0
41013,70,0,70,2,228,0,0,230,224,6,GOOOXXXXXXXXXXXXXXXXGOOOOOXXXXXXXXXXXXXXGOOOOOOOXXXXXXXXXXXXGOXXXXXXXXXXXXXXXXXXGOOOOOOOOOOXXXXXXXXXGOXXXXXXXXXXXXXXXXXXGOOOXXXXXXXXXXXXXXXXGOOXXXXXXXXXXXXXXXXXGOOOXXXXXXXXXXXXXXXXGOOOOOXXXXXXXXXXXXXXGOOXXXXXXXXXXXXXXXXXGOOOOOOXXXXXXXXXXXXXGOOOOOOOOOXXXXXXXXXX,0,300,0
41034,70,0,70,2,228,0,0,230,224,6,GOOOXXXXXXXXXXXXXXXXGOOOOOXXXXXXXXXXXXXXGOOOOOOOXXXXXXXXXXXXGOXXXXXXXXXXXXXXXXXXGOOOOOOOOOOXXXXXXXXXGOXXXXXXXXXXXXXXXXXXGOOOXXXXXXXXXXXXXXXXGOOXXXXXXXXXXXXXXXXXGOOOXXXXXXXXXXXXXXXXGOOOOOXXXXXXXXXXXXXXGOOXXXXXXXXXXXXXXXXXGOOOOOOXXXXXXXXXXXXXGOOOOOOOOOXXXXXXXXXX,0,300,0

41055,70,0,70,3,227,0,0,229,223,6,GOOOXXXXXXXXXXXXXXXXGOOOOOXXXXXXXXXXXXXXGOOOOOOOXXXXXXXXXXXXGOXXXXXXXXXXXXXXXXXXGOOOOOOOOOOXXXXXXXXXGOXXXXXXXXXXXXXXXXXXGOOOXXXXXXXXXXXXXXXXGOOXXXXXXXXXXXXXXXXXGOOOXXXXXXXXXXXXXXXXGOOOOOXXXXXXXXXXXXXXGOOXXXXXXXXXXXXXXXXXGOOOOOOXXXXXXXXXXXXXGOOOOOOOOOXXXXXXXXXX,0,300,0
41076,70,0,70,3,227,0,0,229,224,5,GOOOXXXXXXXXXXXXXXXXGOOOOOXXXXXXXXXXXXXXGOOOOOOOXXXXXXXXXXXXGOXXXXXXXXXXXXXXXXXXGOOOOOOOOOOXXXXXXXXXGOXXXXXXXXXXXXXXXXXXGOOOXXXXXXXXXXXXXXXXGOOXXXXXXXXXXXXXXXXXGOOOXXXXXXXXXXXXXXXXGOOOOOXXXXXXXXXXXXXXGOOXXXXXXXXXXXXXXXXXGOOOOOOXXXXXXXXXXXXXGOOOOOOOOOXXXXXXXXXX,0,300,0
41097,70,0,70,4,226,0,0,228,224,4,GOOOXXXXXXXXXXXXXXXXGOOOOOXXXXXXXXXXXXXXGOOOOOOOXXXXXXXXXXXXGOXXXXXXXXXXXXXXXXXXGOOOOOOOOOOXXXXXXXXXGOXXXXXXXXXXXXXXXXXXGOOOXXXXXXXXXXXXXXXXGOOXXXXXXXXXXXXXXXXXGOOOXXXXXXXXXXXXXXXXGOOOOOXXXXXXXXXXXXXXGOOXXXXXXXXXXXXXXXXXGOOOOOOXXXXXXXXXXXXXGOOOOOOOOOXXXXXXXXXX,0,300,0
41118,70,0,70,4,226,0,0,228,224,4,GOOOXXXXXXXXXXXXXXXXGOOOOOXXXXXXXXXXXXXXGOOOOOOOXXXXXXXXXXXXGOXXXXXXXXXXXXXXXXXXGOOOOOOOOOOXXXXXXXXXGOXXXXXXXXXXXXXXXXXXGOOOXXXXXXXXXXXXXXXXGOOXXXXXXXXXXXXXXXXXGOOOXXXXXXXXXXXXXXXXGOOOOOXXXXXXXXXXXXXXGOOXXXXXXXXXXXXXXXXXGOOOOOOXXXXXXXXXXXXXGOOOOOOOOOXXXXXXXXXX,0,300,0
41139,70,0,70,4,226,0,0,228,224,4,GOOOXXXXXXXXXXXXXXXXGOOOOOXXXXXXXXXXXXXXGOOOOOOOXXXXXXXXXXXXGOXXXXXXXXXXXXXXXXXXGOOOOOOOOOOXXXXXXXXXGOXXXXXXXXXXXXXXXXXXGOOOXXXXXXXXXXXXXXXXGOOXXXXXXXXXXXXXXXXXGOOOXXXXXXXXXXXXXXXXGOOOOOXXXXXXXXXXXXXXGOOXXXXXXXXXXXXXXXXXGOOOOOOXXXXXXXXXXXXXGOOOOOOOOOXXXXXXXXXX,0,300,0

41160,70,0,70,4,226,0,0,228,224,4,GOOOXXXXXXXXXXXXXXXXGOOOOOXXXXXXXXXXXXXXGOOOOOOOXXXXXXXXXXXXGOXXXXXXXXXXXXXXXXXXGOOOOOOOOOOXXXXXXXXXGOXXXXXXXXXXXXXXXXXXGOOOXXXXXXXXXXXXXXXXGOOXXXXXXXXXXXXXXXXXGOOOXXXXXXXXXXXXXXXXGOOOOOXXXXXXXXXXXXXXGOOXXXXXXXXXXXXXXXXXGOOOOOOXXXXXXXXXXXXXGOOOOOOOOOXXXXXXXXXX,0,300,0
41181,70,0,70,4,226,0,0,228,224,4,GOOOXXXXXXXXXXXXXXXXGOOOOOXXXXXXXXXXXXXXGOOOOOOOXXXXXXXXXXXXGOXXXXXXXXXXXXXXXXXXGOOOOOOOOOOXXXXXXXXXGOXXXXXXXXXXXXXXXXXXGOOOXXXXXXXXXXXXXXXXGOOXXXXXXXXXXXXXXXXXGOOOXXXXXXXXXXXXXXXXGOOOOOXXXXXXXXXXXXXXGOOXXXXXXXXXXXXXXXXXGOOOOOOXXXXXXXXXXXXXGOOOOOOOOOXXXXXXXXXX,0,300,0
41202,70,0,70,5,225,0,0,227,224,3,GOOOXXXXXXXXXXXXXXXXGOOOOOXXXXXXXXXXXXXXGOOOOOOOXXXXXXXXXXXXGOXXXXXXXXXXXXXXXXXXGOOOOOOOOOOXXXXXXXXXGOXXXXXXXXXXXXXXXXXXGOOOXXXXXXXXXXXXXXXXGOOXXXXXXXXXXXXXXXXXGOOOXXXXXXXXXXXXXXXXGOOOOOXXXXXXXXXXXXXXGOOXXXXXXXXXXXXXXXXXGOOOOOOXXXXXXXXXXXXXGOOOOOOOOOXXXXXXXXXX,0,300,0
41223,70,0,70,4,226,0,0,228,224,4,GOOOXXXXXXXXXXXXXXXXGOOOOOXXXXXXXXXXXXXXGOOOOOOOXXXXXXXXXXXXGOXXXXXXXXXXXXXXXXXXGOOOOOOOOOOXXXXXXXXXGOXXXXXXXXXXXXXXXXXXGOOOXXXXXXXXXXXXXXXXGOOXXXXXXXXXXXXXXXXXGOOOXXXXXXXXXXXXXXXXGOOOOOXXXXXXXXXXXXXXGOOXXXXXXXXXXXXXXXXXGOOOOOOXXXXXXXXXXXXXGOOOOOOOOOXXXXXXXXXX,0,300,0
41244,70,0,70,3,227,0,0,229,224,5,GOOOXXXXXXXXXXXXXXXXGOOOOOXXXXXXXXXXXXXXGOOOOOOOXXXXXXXXXXXXGOXXXXXXXXXXXXXXXXXXGOOOOOOOOOOXXXXXXXXXGOXXXXXXXXXXXXXXXXXXGOOOXXXXXXXXXXXXXXXXGOOXXXXXXXXXXXXXXXXXGOOOXXXXXXXXXXXXXXXXGOOOOOXXXXXXXXXXXXXXGOOXXXXXXXXXXXXXXXXXGOOOOOOXXXXXXXXXXXXXGOOOOOOOOOXXXXXXXXXX,0,300,0

41265,70,0,70,2,228,0,0,230,226,4,GOOOXXXXXXXXXXXXXXXXGOOOOOXXXXXXXXXXXXXXGOOOOOOOXXXXXXXXXXXXGOXXXXXXXXXXXXXXXXXXGOOOOOOOOOOXXXXXXXXXGOXXXXXXXXXXXXXXXXXXGOOOXXXXXXXXXXXXXXXXGOOXXXXXXXXXXXXXXXXXGOOOXXXXXXXXXXXXXXXXGOOOOOXXXXXXXXXXXXXXGOOXXXXXXXXXXXXXXXXXGOOOOOOXXXXXXXXXXXXXGOOOOOOOOOXXXXXXXXXX,0,300,0
41286,70,0,70,3,227,0,0,229,225,4,GOOOXXXXXXXXXXXXXXXXGOOOOOXXXXXXXXXXXXXXGOOOOOOOXXXXXXXXXXXXGOXXXXXXXXXXXXXXXXXXGOOOOOOOOOOXXXXXXXXXGOXXXXXXXXXXXXXXXXXXGOOOXXXXXXXXXXXXXXXXGOOXXXXXXXXXXXXXXXXXGOOOXXXXXXXXXXXXXXXXGOOOOOXXXXXXXXXXXXXXGOOXXXXXXXXXXXXXXXXXGOOOOOOXXXXXXXXXXXXXGOOOOOOOOOXXXXXXXXXX,0,300,0
41307,70,0,70,3,227,0,0,229,225,4,GOOOXXXXXXXXXXXXXXXXGOOOOOXXXXXXXXXXXXXXGOOOOOOOXXXXXXXXXXXXGOXXXXXXXXXXXXXXXXXXGOOOOOOOOOOXXXXXXXXXGOXXXXXXXXXXXXXXXXXXGOOOXXXXXXXXXXXXXXXXGOOXXXXXXXXXXXXXXXXXGOOOXXXXXXXXXXXXXXXXGOOOOOXXXXXXXXXXXXXXGOOXXXXXXXXXXXXXXXXXGOOOOOOXXXXXXXXXXXXXGOOOOOOOOOXXXXXXXXXX,0,300,0
41328,70,0,70,3,227,0,0,229,225,4,GOOOXXXXXXXXXXXXXXXXGOOOOOXXXXXXXXXXXXXXGOOOOOOOXXXXXXXXXXXXGOXXXXXXXXXXXXXXXXXXGOOOOOOOOOOXXXXXXXXXGOXXXXXXXXXXXXXXXXXXGOOOXXXXXXXXXXXXXXXXGOOXXXXXXXXXXXXXXXXXGOOOXXXXXXXXXXXXXXXXGOOOOOXXXXXXXXXXXXXXGOOXXXXXXXXXXXXXXXXXGOOOOOOXXXXXXXXXXXXXGOOOOOOOOOXXXXXXXXXX,0,300,0
41349,70,0,70,4,226,0,0,228,224,4,GOOOXXXXXXXXXXXXXXXXGOOOOOXXXXXXXXXXXXXXGOOOOOOOXXXXXXXXXXXXGOXXXXXXXXXXXXXXXXXXGOOOOOOOOOOXXXXXXXXXGOXXXXXXXXXXXXXXXXXXGOOOXXXXXXXXXXXXXXXXGOOXXXXXXXXXXXXXXXXXGOOOXXXXXXXXXXXXXXXXGOOOOOXXXXXXXXXXXXXXGOOXXXXXXXXXXXXXXXXXGOOOOOOXXXXXXXXXXXXXGOOOOOOOOOXXXXXXXXXX,0,300,0

41370,70,0,70,3,227,0,0,229,224,5,GOOOXXXXXXXXXXXXXXXXGOOOOOXXXXXXXXXXXXXXGOOOOOOOXXXXXXXXXXXXGOXXXXXXXXXXXXXXXXXXGOOOOOOOOOOXXXXXXXXXGOXXXXXXXXXXXXXXXXXXGOOOXXXXXXXXXXXXXXXXGOOXXXXXXXXXXXXXXXXXGOOOXXXXXXXXXXXXXXXXGOOOOOXXXXXXXXXXXXXXGOOXXXXXXXXXXXXXXXXXGOOOOOOXXXXXXXXXXXXXGOOOOOOOOOXXXXXXXXXX,0,300,0
41391,70,0,70,2,228,0,0,230,224,6,GOOOXXXXXXXXXXXXXXXXGOOOOOXXXXXXXXXXXXXXGOOOOOOOXXXXXXXXXXXXGOXXXXXXXXXXXXXXXXXXGOOOOOOOOOOXXXXXXXXXGOXXXXXXXXXXXXXXXXXXGOOOXXXXXXXXXXXXXXXXGOOXXXXXXXXXXXXXXXXXGOOOXXXXXXXXXXXXXXXXGOOOOOXXXXXXXXXXXXXXGOOXXXXXXXXXXXXXXXXXGOOOOOOXXXXXXXXXXXXXGOOOOOOOOOXXXXXXXXXX,0,300,0
41412,70,0,70,2,228,0,0,230,224,6,GOOOXXXXXXXXXXXXXXXXGOOOOOXXXXXXXXXXXXXXGOOOOOOOXXXXXXXXXXXXGOXXXXXXXXXXXXXXXXXXGOOOOOOOOOOXXXXXXXXXGOXXXXXXXXXXXXXXXXXXGOOOXXXXXXXXXXXXXXXXGOOXXXXXXXXXXXXXXXXXGOOOXXXXXXXXXXXXXXXXGOOOOOXXXXXXXXXXXXXXGOOXXXXXXXXXXXXXXXXXGOOOOOOXXXXXXXXXXXXXGOOOOOOOOOXXXXXXXXXX,0,300,0
41433,70,0,70,3,227,0,0,229,224,5,GOOOXXXXXXXXXXXXXXXXGOOOOOXXXXXXXXXXXXXXGOOOOOOOXXXXXXXXXXXXGOXXXXXXXXXXXXXXXXXXGOOOOOOOOOOXXXXXXXXXGOXXXXXXXXXXXXXXXXXXGOOOXXXXXXXXXXXXXXXXGOOXXXXXXXXXXXXXXXXXGOOOXXXXXXXXXXXXXXXXGOOOOOXXXXXXXXXXXXXXGOOXXXXXXXXXXXXXXXXXGOOOOOOXXXXXXXXXXXXXGOOOOOOOOOXXXXXXXXXX,0,300,0
41454,70,0,70,2,228,0,0,230,224,6,GOOOXXXXXXXXXXXXXXXXGOOOOOXXXXXXXXXXXXXXGOOOOOOOXXXXXXXXXXXXGOXXXXXXXXXXXXXXXXXXGOOOOOOOOOOXXXXXXXXXGOXXXXXXXXXXXXXXXXXXGOOOXXXXXXXXXXXXXXXXGOOXXXXXXXXXXXXXXXXXGOOOXXXXXXXXXXXXXXXXGOOOOOXXXXXXXXXXXXXXGOOXXXXXXXXXXXXXXXXXGOOOOOOXXXXXXXXXXXXXGOOOOOOOOOXXXXXXXXXX,0,300,0

41475,70,0,70,2,228,0,0,230,224,6,GOOOXXXXXXXXXXXXXXXXGOOOOOXXXXXXXXXXXXXXGOOOOOOOXXXXXXXXXXXXGOXXXXXXXXXXXXXXXXXXGOOOOOOOOOOXXXXXXXXXGOXXXXXXXXXXXXXXXXXXGOOOXXXXXXXXXXXXXXXXGOOXXXXXXXXXXXXXXXXXGOOOXXXXXXXXXXXXXXXXGOOOOOXXXXXXXXXXXXXXGOOXXXXXXXXXXXXXXXXXGOOOOOOXXXXXXXXXXXXXGOOOOOOOOOXXXXXXXXXX,0,300,0
41496,70,0,70,2,228,0,0,230,224,6,GOOOXXXXXXXXXXXXXXXXGOOOOOXXXXXXXXXXXXXXGOOOOOOOXXXXXXXXXXXXGOXXXXXXXXXXXXXXXXXXGOOOOOOOOOOXXXXXXXXXGOXXXXXXXXXXXXXXXXXXGOOOXXXXXXXXXXXXXXXXGOOXXXXXXXXXXXXXXXXXGOOOXXXXXXXXXXXXXXXXGOOOOOXXXXXXXXXXXXXXGOOXXXXXXXXXXXXXXXXXGOOOOOOXXXXXXXXXXXXXGOOOOOOOOOXXXXXXXXXX,0,300,0
41517,70,0,70,2,228,0,0,230,224,6,GOOOXXXXXXXXXXXXXXXXGOOOOOXXXXXXXXXXXXXXGOOOOOOOXXXXXXXXXXXXGOXXXXXXXXXXXXXXXXXXGOOOOOOOOOOXXXXXXXXXGOXXXXXXXXXXXXXXXXXXGOOOXXXXXXXXXXXXXXXXGOOXXXXXXXXXXXXXXXXXGOOOXXXXXXXXXXXXXXXXGOOOOOXXXXXXXXXXXXXXGOOXXXXXXXXXXXXXXXXXGOOOOOOXXXXXXXXXXXXXGOOOOOOOOOXXXXXXXXXX,0,300,0
41538,70,0,70,1,229,0,0,231,224,7,GOOOXXXXXXXXXXXXXXXXGOOOOOXXXXXXXXXXXXXXGOOOOOOOXXXXXXXXXXXXGOXXXXXXXXXXXXXXXXXXGOOOOOOOOOOXXXXXXXXXGOXXXXXXXXXXXXXXXXXXGOOOXXXXXXXXXXXXXXXXGOOXXXXXXXXXXXXXXXXXGOOOXXXXXXXXXXXXXXXXGOOOOOXXXXXXXXXXXXXXGOOXXXXXXXXXXXXXXXXXGOOOOOOXXXXXXXXXXXXXGOOOOOOOOOXXXXXXXXXX,0,300,0
41559,70,0,70,1,229,0,0,231,223,8,GOOOXXXXXXXXXXXXXXXXGOOOOOXXXXXXXXXXXXXXGOOOOOOOXXXXXXXXXXXXGOXXXXXXXXXXXXXXXXXXGOOOOOOOOOOXXXXXXXXXGOXXXXXXXXXXXXXXXXXXGOOOXXXXXXXXXXXXXXXXGOOXXXXXXXXXXXXXXXXXGOOOXXXXXXXXXXXXXXXXGOOOOOXXXXXXXXXXXXXXGOOXXXXXXXXXXXXXXXXXGOOOOOOXXXXXXXXXXXXXGOOOOOOOOOXXXXXXXXXX,0,300,0

41580,70,0,70,1,229,0,0,231,223,8,GOOOXXXXXXXXXXXXXXXXGOOOOOXXXXXXXXXXXXXXGOOOOOOOXXXXXXXXXXXXGOXXXXXXXXXXXXXXXXXXGOOOOOOOOOOXXXXXXXXXGOXXXXXXXXXXXXXXXXXXGOOOXXXXXXXXXXXXXXXXGOOXXXXXXXXXXXXXXXXXGOOOXXXXXXXXXXXXXXXXGOOOOOXXXXXXXXXXXXXXGOOXXXXXXXXXXXXXXXXXGOOOOOOXXXXXXXXXXXXXGOOOOOOOOOXXXXXXXXXX,0,300,0
41601,70,0,70,1,229,0,0,231,224,7,GOOOXXXXXXXXXXXXXXXXGOOOOOXXXXXXXXXXXXXXGOOOOOOOXXXXXXXXXXXXGOXXXXXXXXXXXXXXXXXXGOOOOOOOOOOXXXXXXXXXGOXXXXXXXXXXXXXXXXXXGOOOXXXXXXXXXXXXXXXXGOOXXXXXXXXXXXXXXXXXGOOOXXXXXXXXXXXXXXXXGOOOOOXXXXXXXXXXXXXXGOOXXXXXXXXXXXXXXXXXGOOOOOOXXXXXXXXXXXXXGOOOOOOOOOXXXXXXXXXX,0,300,0
41622,70,0,70,2,228,0,0,230,223,7,GOOOXXXXXXXXXXXXXXXXGOOOOOXXXXXXXXXXXXXXGOOOOOOOXXXXXXXXXXXXGOXXXXXXXXXXXXXXXXXXGOOOOOOOOOOXXXXXXXXXGOXXXXXXXXXXXXXXXXXXGOOOXXXXXXXXXXXXXXXXGOOXXXXXXXXXXXXXXXXXGOOOXXXXXXXXXXXXXXXXGOOOOOXXXXXXXXXXXXXXGOOXXXXXXXXXXXXXXXXXGOOOOOOXXXXXXXXXXXXXGOOOOOOOOOXXXXXXXXXX,0,300,0
41643,70,0,70,2,228,0,0,230,224,6,GOOOXXXXXXXXXXXXXXXXGOOOOOXXXXXXXXXXXXXXGOOOOOOOXXXXXXXXXXXXGOXXXXXXXXXXXXXXXXXXGOOOOOOOOOOXXXXXXXXXGOXXXXXXXXXXXXXXXXXXGOOOXXXXXXXXXXXXXXXXGOOXXXXXXXXXXXXXXXXXGOOOXXXXXXXXXXXXXXXXGOOOOOXXXXXXXXXXXXXXGOOXXXXXXXXXXXXXXXXXGOOOOOOXXXXXXXXXXXXXGOOOOOOOOOXXXXXXXXXX,0,300,0
41664,70,0,70,2,228,0,0,230,225,5,GOOOXXXXXXXXXXXXXXXXGOOOOOXXXXXXXXXXXXXXGOOOOOOOXXXXXXXXXXXXGOXXXXXXXXXXXXXXXXXXGOOOOOOOOOOXXXXXXXXXGOXXXXXXXXXXXXXXXXXXGOOOXXXXXXXXXXXXXXXXGOOXXXXXXXXXXXXXXXXXGOOOXXXXXXXXXXXXXXXXGOOOOOXXXXXXXXXXXXXXGOOXXXXXXXXXXXXXXXXXGOOOOOOXXXXXXXXXXXXXGOOOOOOOOOXXXXXXXXXX,0,300,0

41685,70,0,70,3,227,0,0,229,224,5,GOOOXXXXXXXXXXXXXXXXGOOOOOXXXXXXXXXXXXXXGOOOOOOOXXXXXXXXXXXXGOXXXXXXXXXXXXXXXXXXGOOOOOOOOOOXXXXXXXXXGOXXXXXXXXXXXXXXXXXXGOOOXXXXXXXXXXXXXXXXGOOXXXXXXXXXXXXXXXXXGOOOXXXXXXXXXXXXXXXXGOOOOOXXXXXXXXXXXXXXGOOXXXXXXXXXXXXXXXXXGOOOOOOXXXXXXXXXXXXXGOOOOOOOOOXXXXXXXXXX,0,300,0
41706,70,0,70,3,227,0,0,229,224,5,GOOOXXXXXXXXXXXXXXXXGOOOOOXXXXXXXXXXXXXXGOOOOOOOXXXXXXXXXXXXGOXXXXXXXXXXXXXXXXXXGOOOOOOOOOOXXXXXXXXXGOXXXXXXXXXXXXXXXXXXGOOOXXXXXXXXXXXXXXXXGOOXXXXXXXXXXXXXXXXXGOOOXXXXXXXXXXXXXXXXGOOOOOXXXXXXXXXXXXXXGOOXXXXXXXXXXXXXXXXXGOOOOOOXXXXXXXXXXXXXGOOOOOOOOOXXXXXXXXXX,0,300,0
41727,70,0,70,4,226,0,0,228,223,5,GOOOXXXXXXXXXXXXXXXXGOOOOOXXXXXXXXXXXXXXGOOOOOOOXXXXXXXXXXXXGOXXXXXXXXXXXXXXXXXXGOOOOOOOOOOXXXXXXXXXGOXXXXXXXXXXXXXXXXXXGOOOXXXXXXXXXXXXXXXXGOOXXXXXXXXXXXXXXXXXGOOOXXXXXXXXXXXXXXXXGOOOOOXXXXXXXXXXXXXXGOOXXXXXXXXXXXXXXXXXGOOOOOOXXXXXXXXXXXXXGOOOOOOOOOXXXXXXXXXX,0,300,0
41748,70,0,70,5,225,0,0,227,223,4,GOOOXXXXXXXXXXXXXXXXGOOOOOXXXXXXXXXXXXXXGOOOOOOOXXXXXXXXXXXXGOXXXXXXXXXXXXXXXXXXGOOOOOOOOOOXXXXXXXXXGOXXXXXXXXXXXXXXXXXXGOOOXXXXXXXXXXXXXXXXGOOXXXXXXXXXXXXXXXXXGOOOXXXXXXXXXXXXXXXXGOOOOOXXXXXXXXXXXXXXGOOXXXXXXXXXXXXXXXXXGOOOOOOXXXXXXXXXXXXXGOOOOOOOOOXXXXXXXXXX,0,300,0
41769,70,0,70,5,225,0,0,227,223,4,GOOOXXXXXXXXXXXXXXXXGOOOOOXXXXXXXXXXXXXXGOOOOOOOXXXXXXXXXXXXGOXXXXXXXXXXXXXXXXXXGOOOOOOOOOOXXXXXXXXXGOXXXXXXXXXXXXXXXXXXGOOOXXXXXXXXXXXXXXXXGOOXXXXXXXXXXXXXXXXXGOOOXXXXXXXXXXXXXXXXGOOOOOXXXXXXXXXXXXXXGOOXXXXXXXXXXXXXXXXXGOOOOOOXXXXXXXXXXXXXGOOOOOOOOOXXXXXXXXXX,0,300,0

41790,70,0,70,4,226,0,0,228,223,5,GOOOXXXXXXXXXXXXXXXXGOOOOOXXXXXXXXXXXXXXGOOOOOOOXXXXXXXXXXXXGOXXXXXXXXXXXXXXXXXXGOOOOOOOOOOXXXXXXXXXGOXXXXXXXXXXXXXXXXXXGOOOXXXXXXXXXXXXXXXXGOOXXXXXXXXXXXXXXXXXGOOOXXXXXXXXXXXXXXXXGOOOOOXXXXXXXXXXXXXXGOOXXXXXXXXXXXXXXXXXGOOOOOOXXXXXXXXXXXXXGOOOOOOOOOXXXXXXXXXX,0,300,0
41811,70,0,70,4,226,0,0,228,223,5,GOOOXXXXXXXXXXXXXXXXGOOOOOXXXXXXXXXXXXXXGOOOOOOOXXXXXXXXXXXXGOXXXXXXXXXXXXXXXXXXGOOOOOOOOOOXXXXXXXXXGOXXXXXXXXXXXXXXXXXXGOOOXXXXXXXXXXXXXXXXGOOXXXXXXXXXXXXXXXXXGOOOXXXXXXXXXXXXXXXXGOOOOOXXXXXXXXXXXXXXGOOXXXXXXXXXXXXXXXXXGOOOOOOXXXXXXXXXXXXXGOOOOOOOOOXXXXXXXXXX,0,300,0
41832,70,0,70,3,227,0,0,229,223,6,GOOOXXXXXXXXXXXXXXXXGOOOOOXXXXXXXXXXXXXXGOOOOOOOXXXXXXXXXXXXGOXXXXXXXXXXXXXXXXXXGOOOOOOOOOOXXXXXXXXXGOXXXXXXXXXXXXXXXXXXGOOOXXXXXXXXXXXXXXXXGOOXXXXXXXXXXXXXXXXXGOOOXXXXXXXXXXXXXXXXGOOOOOXXXXXXXXXXXXXXGOOXXXXXXXXXXXXXXXXXGOOOOOOXXXXXXXXXXXXXGOOOOOOOOOXXXXXXXXXX,0,300,0
41853,70,0,70,3,227,0,0,229,223,6,GOOOXXXXXXXXXXXXXXXXGOOOOOXXXXXXXXXXXXXXGOOOOOOOXXXXXXXXXXXXGOXXXXXXXXXXXXXXXXXXGOOOOOOOOOOXXXXXXXXXGOXXXXXXXXXXXXXXXXXXGOOOXXXXXXXXXXXXXXXXGOOXXXXXXXXXXXXXXXXXGOOOXXXXXXXXXXXXXXXXGOOOOOXXXXXXXXXXXXXXGOOXXXXXXXXXXXXXXXXXGOOOOOOXXXXXXXXXXXXXGOOOOOOOOOXXXXXXXXXX,0,300,0
41874,70,0,70,4,226,0,0,228,224,4,GOOOXXXXXXXXXXXXXXXXGOOOOOXXXXXXXXXXXXXXGOOOOOOOXXXXXXXXXXXXGOXXXXXXXXXXXXXXXXXXGOOOOOOOOOOXXXXXXXXXGOXXXXXXXXXXXXXXXXXXGOOOXXXXXXXXXXXXXXXXGOOXXXXXXXXXXXXXXXXXGOOOXXXXXXXXXXXXXXXXGOOOOOXXXXXXXXXXXXXXGOOXXXXXXXXXXXXXXXXXGOOOOOOXXXXXXXXXXXXXGOOOOOOOOOXXXXXXXXXX,0,300,0

41895,70,0,70,5,225,0,0,227,223,4,GOOOXXXXXXXXXXXXXXXXGOOOOOXXXXXXXXXXXXXXGOOOOOOOXXXXXXXXXXXXGOXXXXXXXXXXXXXXXXXXGOOOOOOOOOOXXXXXXXXXGOXXXXXXXXXXXXXXXXXXGOOOXXXXXXXXXXXXXXXXGOOXXXXXXXXXXXXXXXXXGOOOXXXXXXXXXXXXXXXXGOOOOOXXXXXXXXXXXXXXGOOXXXXXXXXXXXXXXXXXGOOOOOOXXXXXXXXXXXXXGOOOOOOOOOXXXXXXXXXX,0,300,0
41916,70,0,70,4,226,0,0,228,223,5,GOOOXXXXXXXXXXXXXXXXGOOOOOXXXXXXXXXXXXXXGOOOOOOOXXXXXXXXXXXXGOXXXXXXXXXXXXXXXXXXGOOOOOOOOOOXXXXXXXXXGOXXXXXXXXXXXXXXXXXXGOOOXXXXXXXXXXXXXXXXGOOXXXXXXXXXXXXXXXXXGOOOXXXXXXXXXXXXXXXXGOOOOOXXXXXXXXXXXXXXGOOXXXXXXXXXXXXXXXXXGOOOOOOXXXXXXXXXXXXXGOOOOOOOOOXXXXXXXXXX,0,300,0
41937,70,0,70,2,228,0,0,230,223,7,GOOOXXXXXXXXXXXXXXXXGOOOOOXXXXXXXXXXXXXXGOOOOOOOXXXXXXXXXXXXGOXXXXXXXXXXXXXXXXXXGOOOOOOOOOOXXXXXXXXXGOXXXXXXXXXXXXXXXXXXGOOOXXXXXXXXXXXXXXXXGOOXXXXXXXXXXXXXXXXXGOOOXXXXXXXXXXXXXXXXGOOOOOXXXXXXXXXXXXXXGOOXXXXXXXXXXXXXXXXXGOOOOOOXXXXXXXXXXXXXGOOOOOOOOOXXXXXXXXXX,0,300,0
41958,70,0,70,2,228,0,0,230,223,7,GOOOXXXXXXXXXXXXXXXXGOOOOOXXXXXXXXXXXXXXGOOOOOOOXXXXXXXXXXXXGOXXXXXXXXXXXXXXXXXXGOOOOOOOOOOXXXXXXXXXGOXXXXXXXXXXXXXXXXXXGOOOXXXXXXXXXXXXXXXXGOOXXXXXXXXXXXXXXXXXGOOOXXXXXXXXXXXXXXXXGOOOOOXXXXXXXXXXXXXXGOOXXXXXXXXXXXXXXXXXGOOOOOOXXXXXXXXXXXXXGOOOOOOOOOXXXXXXXXXX,0,300,0
41979,70,0,70,1,229,0,0,231,223,8,GOOOXXXXXXXXXXXXXXXXGOOOOOXXXXXXXXXXXXXXGOOOOOOOXXXXXXXXXXXXGOXXXXXXXXXXXXXXXXXXGOOOOOOOOOOXXXXXXXXXGOXXXXXXXXXXXXXXXXXXGOOOXXXXXXXXXXXXXXXXGOOXXXXXXXXXXXXXXXXXGOOOXXXXXXXXXXXXXXXXGOOOOOXXXXXXXXXXXXXXGOOXXXXXXXXXXXXXXXXXGOOOOOOXXXXXXXXXXXXXGOOOOOOOOOXXXXXXXXXX,0,300,0

42000,70,0,70,1,229,0,0,231,224,7,GOOOXXXXXXXXXXXXXXXXGOOOOOXXXXXXXXXXXXXXGOOOOOOOXXXXXXXXXXXXGOXXXXXXXXXXXXXXXXXXGOOOOOOOOOOXXXXXXXXXGOXXXXXXXXXXXXXXXXXXGOOOXXXXXXXXXXXXXXXXGOOXXXXXXXXXXXXXXXXXGOOOXXXXXXXXXXXXXXXXGOOOOOXXXXXXXXXXXXXXGOOXXXXXXXXXXXXXXXXXGOOOOOOXXXXXXXXXXXXXGOOOOOOOOOXXXXXXXXXX,0,300,0
42021,70,0,70,1,229,0,0,231,224,7,GOOOXXXXXXXXXXXXXXXXGOOOOOXXXXXXXXXXXXXXGOOOOOOOXXXXXXXXXXXXGOXXXXXXXXXXXXXXXXXXGOOOOOOOOOOXXXXXXXXXGOXXXXXXXXXXXXXXXXXXGOOOXXXXXXXXXXXXXXXXGOOXXXXXXXXXXXXXXXXXGOOOXXXXXXXXXXXXXXXXGOOOOOXXXXXXXXXXXXXXGOOXXXXXXXXXXXXXXXXXGOOOOOOXXXXXXXXXXXXXGOOOOOOOOOXXXXXXXXXX,0,300,0
42042,70,0,70,1,229,0,0,231,225,6,GOOOXXXXXXXXXXXXXXXXGOOOOOXXXXXXXXXXXXXXGOOOOOOOXXXXXXXXXXXXGOXXXXXXXXXXXXXXXXXXGOOOOOOOOOOXXXXXXXXXGOXXXXXXXXXXXXXXXXXXGOOOXXXXXXXXXXXXXXXXGOOXXXXXXXXXXXXXXXXXGOOOXXXXXXXXXXXXXXXXGOOOOOXXXXXXXXXXXXXXGOOXXXXXXXXXXXXXXXXXGOOOOOOXXXXXXXXXXXXXGOOOOOOOOOXXXXXXXXXX,0,300,0
42063,70,0,70,1,229,0,0,231,226,5,GOOOXXXXXXXXXXXXXXXXGOOOOOXXXXXXXXXXXXXXGOOOOOOOXXXXXXXXXXXXGOXXXXXXXXXXXXXXXXXXGOOOOOOOOOOXXXXXXXXXGOXXXXXXXXXXXXXXXXXXGOOOXXXXXXXXXXXXXXXXGOOXXXXXXXXXXXXXXXXXGOOOXXXXXXXXXXXXXXXXGOOOOOXXXXXXXXXXXXXXGOOXXXXXXXXXXXXXXXXXGOOOOOOXXXXXXXXXXXXXGOOOOOOOOOXXXXXXXXXX,0,300,0
42084,70,0,70,2,228,0,0,230,226,4,GOOOXXXXXXXXXXXXXXXXGOOOOOXXXXXXXXXXXXXXGOOOOOOOXXXXXXXXXXXXGOXXXXXXXXXXXXXXXXXXGOOOOOOOOOOXXXXXXXXXGOXXXXXXXXXXXXXXXXXXGOOOXXXXXXXXXXXXXXXXGOOXXXXXXXXXXXXXXXXXGOOOXXXXXXXXXXXXXXXXGOOOOOXXXXXXXXXXXXXXGOOXXXXXXXXXXXXXXXXXGOOOOOOXXXXXXXXXXXXXGOOOOOOOOOXXXXXXXXXX,0,300,0

42105,70,0,70,4,226,0,0,228,224,4,GOOOXXXXXXXXXXXXXXXXGOOOOOXXXXXXXXXXXXXXGOOOOOOOXXXXXXXXXXXXGOXXXXXXXXXXXXXXXXXXGOOOOOOOOOOXXXXXXXXXGOXXXXXXXXXXXXXXXXXXGOOOXXXXXXXXXXXXXXXXGOOXXXXXXXXXXXXXXXXXGOOOXXXXXXXXXXXXXXXXGOOOOOXXXXXXXXXXXXXXGOOXXXXXXXXXXXXXXXXXGOOOOOOXXXXXXXXXXXXXGOOOOOOOOOXXXXXXXXXX,0,300,0
42126,70,0,70,3,227,0,0,229,224,5,GOOOXXXXXXXXXXXXXXXXGOOOOOXXXXXXXXXXXXXXGOOOOOOOXXXXXXXXXXXXGOXXXXXXXXXXXXXXXXXXGOOOOOOOOOOXXXXXXXXXGOXXXXXXXXXXXXXXXXXXGOOOXXXXXXXXXXXXXXXXGOOXXXXXXXXXXXXXXXXXGOOOXXXXXXXXXXXXXXXXGOOOOOXXXXXXXXXXXXXXGOOXXXXXXXXXXXXXXXXXGOOOOOOXXXXXXXXXXXXXGOOOOOOOOOXXXXXXXXXX,0,300,0
42147,70,0,70,2,228,0,0,230,224,6,GOOOXXXXXXXXXXXXXXXXGOOOOOXXXXXXXXXXXXXXGOOOOOOOXXXXXXXXXXXXGOXXXXXXXXXXXXXXXXXXGOOOOOOOOOOXXXXXXXXXGOXXXXXXXXXXXXXXXXXXGOOOXXXXXXXXXXXXXXXXGOOXXXXXXXXXXXXXXXXXGOOOXXXXXXXXXXXXXXXXGOOOOOXXXXXXXXXXXXXXGOOXXXXXXXXXXXXXXXXXGOOOOOOXXXXXXXXXXXXXGOOOOOOOOOXXXXXXXXXX,0,300,0
42168,70,0,70,1,229,0,0,231,224,7,GOOOXXXXXXXXXXXXXXXXGOOOOOXXXXXXXXXXXXXXGOOOOOOOXXXXXXXXXXXXGOXXXXXXXXXXXXXXXXXXGOOOOOOOOOOXXXXXXXXXGOXXXXXXXXXXXXXXXXXXGOOOXXXXXXXXXXXXXXXXGOOXXXXXXXXXXXXXXXXXGOOOXXXXXXXXXXXXXXXXGOOOOOXXXXXXXXXXXXXXGOOXXXXXXXXXXXXXXXXXGOOOOOOXXXXXXXXXXXXXGOOOOOOOOOXXXXXXXXXX,0,300,0
42189,70,0,70,1,229,0,0,231,224,7,GOOOXXXXXXXXXXXXXXXXGOOOOOXXXXXXXXXXXXXXGOOOOOOOXXXXXXXXXXXXGOXXXXXXXXXXXXXXXXXXGOOOOOOOOOOXXXXXXXXXGOXXXXXXXXXXXXXXXXXXGOOOXXXXXXXXXXXXXXXXGOOXXXXXXXXXXXXXXXXXGOOOXXXXXXXXXXXXXXXXGOOOOOXXXXXXXXXXXXXXGOOXXXXXXXXXXXXXXXXXGOOOOOOXXXXXXXXXXXXXGOOOOOOOOOXXXXXXXXXX,0,300,0

42210,70,0,70,1,229,0,0,231,225,6,GOOOXXXXXXXXXXXXXXXXGOOOOOXXXXXXXXXXXXXXGOOOOOOOXXXXXXXXXXXXGOXXXXXXXXXXXXXXXXXXGOOOOOOOOOOXXXXXXXXXGOXXXXXXXXXXXXXXXXXXGOOOXXXXXXXXXXXXXXXXGOOXXXXXXXXXXXXXXXXXGOOOXXXXXXXXXXXXXXXXGOOOOOXXXXXXXXXXXXXXGOOXXXXXXXXXXXXXXXXXGOOOOOOXXXXXXXXXXXXXGOOOOOOOOOXXXXXXXXXX,0,300,0
42231,70,0,70,1,229,0,0,231,226,5,GOOOXXXXXXXXXXXXXXXXGOOOOOXXXXXXXXXXXXXXGOOOOOOOXXXXXXXXXXXXGOXXXXXXXXXXXXXXXXXXGOOOOOOOOOOXXXXXXXXXGOXXXXXXXXXXXXXXXXXXGOOOXXXXXXXXXXXXXXXXGOOXXXXXXXXXXXXXXXXXGOOOXXXXXXXXXXXXXXXXGOOOOOXXXXXXXXXXXXXXGOOXXXXXXXXXXXXXXXXXGOOOOOOXXXXXXXXXXXXXGOOOOOOOOOXXXXXXXXXX,0,300,0
42252,70,0,70,1,229,0,0,231,226,5,GOOOXXXXXXXXXXXXXXXXGOOOOOXXXXXXXXXXXXXXGOOOOOOOXXXXXXXXXXXXGOXXXXXXXXXXXXXXXXXXGOOOOOOOOOOXXXXXXXXXGOXXXXXXXXXXXXXXXXXXGOOOXXXXXXXXXXXXXXXXGOOXXXXXXXXXXXXXXXXXGOOOXXXXXXXXXXXXXXXXGOOOOOXXXXXXXXXXXXXXGOOXXXXXXXXXXXXXXXXXGOOOOOOXXXXXXXXXXXXXGOOOOOOOOOXXXXXXXXXX,0,300,0
42273,70,0,70,1,229,0,0,231,225,6,GOOOXXXXXXXXXXXXXXXXGOOOOOXXXXXXXXXXXXXXGOOOOOOOXXXXXXXXXXXXGOXXXXXXXXXXXXXXXXXXGOOOOOOOOOOXXXXXXXXXGOXXXXXXXXXXXXXXXXXXGOOOXXXXXXXXXXXXXXXXGOOXXXXXXXXXXXXXXXXXGOOOXXXXXXXXXXXXXXXXGOOOOOXXXXXXXXXXXXXXGOOXXXXXXXXXXXXXXXXXGOOOOOOXXXXXXXXXXXXXGOOOOOOOOOXXXXXXXXXX,0,300,0
42294,70,0,70,1,229,0,0,231,225,6,GOOOXXXXXXXXXXXXXXXXGOOOOOXXXXXXXXXXXXXXGOOOOOOOXXXXXXXXXXXXGOXXXXXXXXXXXXXXXXXXGOOOOOOOOOOXXXXXXXXXGOXXXXXXXXXXXXXXXXXXGOOOXXXXXXXXXXXXXXXXGOOXXXXXXXXXXXXXXXXXGOOOXXXXXXXXXXXXXXXXGOOOOOXXXXXXXXXXXXXXGOOXXXXXXXXXXXXXXXXXGOOOOOOXXXXXXXXXXXXXGOOOOOOOOOXXXXXXXXXX,0,300,0

42315,70,0,70,2,228,0,0,230,225,5,GOOOXXXXXXXXXXXXXXXXGOOOOOXXXXXXXXXXXXXXGOOOOOOOXXXXXXXXXXXXGOXXXXXXXXXXXXXXXXXXGOOOOOOOOOOXXXXXXXXXGOXXXXXXXXXXXXXXXXXXGOOOXXXXXXXXXXXXXXXXGOOXXXXXXXXXXXXXXXXXGOOOXXXXXXXXXXXXXXXXGOOOOOXXXXXXXXXXXXXXGOOXXXXXXXXXXXXXXXXXGOOOOOOXXXXXXXXXXXXXGOOOOOOOOOXXXXXXXXXX,0,300,0
42336,70,0,70,2,228,0,0,230,225,5,GOOOXXXXXXXXXXXXXXXXGOOOOOXXXXXXXXXXXXXXGOOOOOOOXXXXXXXXXXXXGOXXXXXXXXXXXXXXXXXXGOOOOOOOOOOXXXXXXXXXGOXXXXXXXXXXXXXXXXXXGOOOXXXXXXXXXXXXXXXXGOOXXXXXXXXXXXXXXXXXGOOOXXXXXXXXXXXXXXXXGOOOOOXXXXXXXXXXXXXXGOOXXXXXXXXXXXXXXXXXGOOOOOOXXXXXXXXXXXXXGOOOOOOOOOXXXXXXXXXX,0,300,0
42357,70,0,70,2,228,0,0,230,225,5,GOOOXXXXXXXXXXXXXXXXGOOOOOXXXXXXXXXXXXXXGOOOOOOOXXXXXXXXXXXXGOXXXXXXXXXXXXXXXXXXGOOOOOOOOOOXXXXXXXXXGOXXXXXXXXXXXXXXXXXXGOOOXXXXXXXXXXXXXXXXGOOXXXXXXXXXXXXXXXXXGOOOXXXXXXXXXXXXXXXXGOOOOOXXXXXXXXXXXXXXGOOXXXXXXXXXXXXXXXXXGOOOOOOXXXXXXXXXXXXXGOOOOOOOOOXXXXXXXXXX,0,300,0
42378,70,0,70,3,227,0,0,229,225,4,GOOOXXXXXXXXXXXXXXXXGOOOOOXXXXXXXXXXXXXXGOOOOOOOXXXXXXXXXXXXGOXXXXXXXXXXXXXXXXXXGOOOOOOOOOOXXXXXXXXXGOXXXXXXXXXXXXXXXXXXGOOOXXXXXXXXXXXXXXXXGOOXXXXXXXXXXXXXXXXXGOOOXXXXXXXXXXXXXXXXGOOOOOXXXXXXXXXXXXXXGOOXXXXXXXXXXXXXXXXXGOOOOOOXXXXXXXXXXXXXGOOOOOOOOOXXXXXXXXXX,0,300,0
42399,70,0,70,3,227,0,0,229,225,4,GOOOXXXXXXXXXXXXXXXXGOOOOOXXXXXXXXXXXXXXGOOOOOOOXXXXXXXXXXXXGOXXXXXXXXXXXXXXXXXXGOOOOOOOOOOXXXXXXXXXGOXXXXXXXXXXXXXXXXXXGOOOXXXXXXXXXXXXXXXXGOOXXXXXXXXXXXXXXXXXGOOOXXXXXXXXXXXXXXXXGOOOOOXXXXXXXXXXXXXXGOOXXXXXXXXXXXXXXXXXGOOOOOOXXXXXXXXXXXXXGOOOOOOOOOXXXXXXXXXX,0,300,0

42420,70,0,70,4,226,0,0,228,225,3,GOOOXXXXXXXXXXXXXXXXGOOOOOXXXXXXXXXXXXXXGOOOOOOOXXXXXXXXXXXXGOXXXXXXXXXXXXXXXXXXGOOOOOOOOOOXXXXXXXXXGOXXXXXXXXXXXXXXXXXXGOOOXXXXXXXXXXXXXXXXGOOXXXXXXXXXXXXXXXXXGOOOXXXXXXXXXXXXXXXXGOOOOOXXXXXXXXXXXXXXGOOXXXXXXXXXXXXXXXXXGOOOOOOXXXXXXXXXXXXXGOOOOOOOOOXXXXXXXXXX,0,300,0
42441,70,0,70,3,227,0,0,229,225,4,GOOOXXXXXXXXXXXXXXXXGOOOOOXXXXXXXXXXXXXXGOOOOOOOXXXXXXXXXXXXGOXXXXXXXXXXXXXXXXXXGOOOOOOOOOOXXXXXXXXXGOXXXXXXXXXXXXXXXXXXGOOOXXXXXXXXXXXXXXXXGOOXXXXXXXXXXXXXXXXXGOOOXXXXXXXXXXXXXXXXGOOOOOXXXXXXXXXXXXXXGOOXXXXXXXXXXXXXXXXXGOOOOOOXXXXXXXXXXXXXGOOOOOOOOOXXXXXXXXXX,0,300,0
42462,70,0,70,3,227,0,0,229,226,3,GOOOXXXXXXXXXXXXXXXXGOOOOOXXXXXXXXXXXXXXGOOOOOOOXXXXXXXXXXXXGOXXXXXXXXXXXXXXXXXXGOOOOOOOOOOXXXXXXXXXGOXXXXXXXXXXXXXXXXXXGOOOXXXXXXXXXXXXXXXXGOOXXXXXXXXXXXXXXXXXGOOOXXXXXXXXXXXXXXXXGOOOOOXXXXXXXXXXXXXXGOOXXXXXXXXXXXXXXXXXGOOOOOOXXXXXXXXXXXXXGOOOOOOOOOXXXXXXXXXX,0,300,0
42483,70,0,70,3,227,0,0,229,225,4,GOOOXXXXXXXXXXXXXXXXGOOOOOXXXXXXXXXXXXXXGOOOOOOOXXXXXXXXXXXXGOXXXXXXXXXXXXXXXXXXGOOOOOOOOOOXXXXXXXXXGOXXXXXXXXXXXXXXXXXXGOOOXXXXXXXXXXXXXXXXGOOXXXXXXXXXXXXXXXXXGOOOXXXXXXXXXXXXXXXXGOOOOOXXXXXXXXXXXXXXGOOXXXXXXXXXXXXXXXXXGOOOOOOXXXXXXXXXXXXXGOOOOOOOOOXXXXXXXXXX,0,300,0
42504,70,0,70,3,227,0,0,229,225,4,GOOOXXXXXXXXXXXXXXXXGOOOOOXXXXXXXXXXXXXXGOOOOOOOXXXXXXXXXXXXGOXXXXXXXXXXXXXXXXXXGOOOOOOOOOOXXXXXXXXXGOXXXXXXXXXXXXXXXXXXGOOOXXXXXXXXXXXXXXXXGOOXXXXXXXXXXXXXXXXXGOOOXXXXXXXXXXXXXXXXGOOOOOXXXXXXXXXXXXXXGOOXXXXXXXXXXXXXXXXXGOOOOOOXXXXXXXXXXXXXGOOOOOOOOOXXXXXXXXXX,0,300,0

42525,70,0,70,3,227,0,0,229,225,4,GOOOXXXXXXXXXXXXXXXXGOOOOOXXXXXXXXXXXXXXGOOOOOOOXXXXXXXXXXXXGOXXXXXXXXXXXXXXXXXXGOOOOOOOOOOXXXXXXXXXGOXXXXXXXXXXXXXXXXXXGOOOXXXXXXXXXXXXXXXXGOOXXXXXXXXXXXXXXXXXGOOOXXXXXXXXXXXXXXXXGOOOOOXXXXXXXXXXXXXXGOOXXXXXXXXXXXXXXXXXGOOOOOOXXXXXXXXXXXXXGOOOOOOOOOXXXXXXXXXX,0,300,0
42546,70,0,70,3,227,0,0,229,225,4,GOOOXXXXXXXXXXXXXXXXGOOOOOXXXXXXXXXXXXXXGOOOOOOOXXXXXXXXXXXXGOXXXXXXXXXXXXXXXXXXGOOOOOOOOOOXXXXXXXXXGOXXXXXXXXXXXXXXXXXXGOOOXXXXXXXXXXXXXXXXGOOXXXXXXXXXXXXXXXXXGOOOXXXXXXXXXXXXXXXXGOOOOOXXXXXXXXXXXXXXGOOXXXXXXXXXXXXXXXXXGOOOOOOXXXXXXXXXXXXXGOOOOOOOOOXXXXXXXXXX,0,300,0
42567,70,0,70,1,229,0,0,231,225,6,GOOOXXXXXXXXXXXXXXXXGOOOOOXXXXXXXXXXXXXXGOOOOOOOXXXXXXXXXXXXGOXXXXXXXXXXXXXXXXXXGOOOOOOOOOOXXXXXXXXXGOXXXXXXXXXXXXXXXXXXGOOOXXXXXXXXXXXXXXXXGOOXXXXXXXXXXXXXXXXXGOOOXXXXXXXXXXXXXXXXGOOOOOXXXXXXXXXXXXXXGOOXXXXXXXXXXXXXXXXXGOOOOOOXXXXXXXXXXXXXGOOOOOOOOOXXXXXXXXXX,0,300,0
42588,70,0,70,1,229,0,0,231,225,6,GOOOXXXXXXXXXXXXXXXXGOOOOOXXXXXXXXXXXXXXGOOOOOOOXXXXXXXXXXXXGOXXXXXXXXXXXXXXXXXXGOOOOOOOOOOXXXXXXXXXGOXXXXXXXXXXXXXXXXXXGOOOXXXXXXXXXXXXXXXXGOOXXXXXXXXXXXXXXXXXGOOOXXXXXXXXXXXXXXXXGOOOOOXXXXXXXXXXXXXXGOOXXXXXXXXXXXXXXXXXGOOOOOOXXXXXXXXXXXXXGOOOOOOOOOXXXXXXXXXX,0,300,0
42609,70,0,70,1,229,0,0,231,225,6,GOOOXXXXXXXXXXXXXXXXGOOOOOXXXXXXXXXXXXXXGOOOOOOOXXXXXXXXXXXXGOXXXXXXXXXXXXXXXXXXGOOOOOOOOOOXXXXXXXXXGOXXXXXXXXXXXXXXXXXXGOOOXXXXXXXXXXXXXXXXGOOXXXXXXXXXXXXXXXXXGOOOXXXXXXXXXXXXXXXXGOOOOOXXXXXXXXXXXXXXGOOXXXXXXXXXXXXXXXXXGOOOOOOXXXXXXXXXXXXXGOOOOOOOOOXXXXXXXXXX,0,300,0

42630,70,0,70,1,229,0,0,231,226,5,GOOOXXXXXXXXXXXXXXXXGOOOOOXXXXXXXXXXXXXXGOOOOOOOXXXXXXXXXXXXGOXXXXXXXXXXXXXXXXXXGOOOOOOOOOOXXXXXXXXXGOXXXXXXXXXXXXXXXXXXGOOOXXXXXXXXXXXXXXXXGOOXXXXXXXXXXXXXXXXXGOOOXXXXXXXXXXXXXXXXGOOOOOXXXXXXXXXXXXXXGOOXXXXXXXXXXXXXXXXXGOOOOOOXXXXXXXXXXXXXGOOOOOOOOOXXXXXXXXXX,0,300,0
42651,70,0,70,1,229,0,0,231,227,4,GOOOXXXXXXXXXXXXXXXXGOOOOOXXXXXXXXXXXXXXGOOOOOOOXXXXXXXXXXXXGOXXXXXXXXXXXXXXXXXXGOOOOOOOOOOXXXXXXXXXGOXXXXXXXXXXXXXXXXXXGOOOXXXXXXXXXXXXXXXXGOOXXXXXXXXXXXXXXXXXGOOOXXXXXXXXXXXXXXXXGOOOOOXXXXXXXXXXXXXXGOOXXXXXXXXXXXXXXXXXGOOOOOOXXXXXXXXXXXXXGOOOOOOOOOXXXXXXXXXX,0,300,0
42672,70,0,70,2,228,0,0,230,226,4,GOOOXXXXXXXXXXXXXXXXGOOOOOXXXXXXXXXXXXXXGOOOOOOOXXXXXXXXXXXXGOXXXXXXXXXXXXXXXXXXGOOOOOOOOOOXXXXXXXXXGOXXXXXXXXXXXXXXXXXXGOOOXXXXXXXXXXXXXXXXGOOXXXXXXXXXXXXXXXXXGOOOXXXXXXXXXXXXXXXXGOOOOOXXXXXXXXXXXXXXGOOXXXXXXXXXXXXXXXXXGOOOOOOXXXXXXXXXXXXXGOOOOOOOOOXXXXXXXXXX,0,300,0
42693,70,0,70,1,229,0,0,231,226,5,GOOOXXXXXXXXXXXXXXXXGOOOOOXXXXXXXXXXXXXXGOOOOOOOXXXXXXXXXXXXGOXXXXXXXXXXXXXXXXXXGOOOOOOOOOOXXXXXXXXXGOXXXXXXXXXXXXXXXXXXGOOOXXXXXXXXXXXXXXXXGOOXXXXXXXXXXXXXXXXXGOOOXXXXXXXXXXXXXXXXGOOOOOXXXXXXXXXXXXXXGOOXXXXXXXXXXXXXXXXXGOOOOOOXXXXXXXXXXXXXGOOOOOOOOOXXXXXXXXXX,0,300,0
42714,70,0,70,1,229,0,0,231,226,5,GOOOXXXXXXXXXXXXXXXXGOOOOOXXXXXXXXXXXXXXGOOOOOOOXXXXXXXXXXXXGOXXXXXXXXXXXXXXXXXXGOOOOOOOOOOXXXXXXXXXGOXXXXXXXXXXXXXXXXXXGOOOXXXXXXXXXXXXXXXXGOOXXXXXXXXXXXXXXXXXGOOOXXXXXXXXXXXXXXXXGOOOOOXXXXXXXXXXXXXXGOOXXXXXXXXXXXXXXXXXGOOOOOOXXXXXXXXXXXXXGOOOOOOOOOXXXXXXXXXX,0,300,0

42735,70,0,70,1,229,0,0,231,226,5,GOOOXXXXXXXXXXXXXXXXGOOOOOXXXXXXXXXXXXXXGOOOOOOOXXXXXXXXXXXXGOXXXXXXXXXXXXXXXXXXGOOOOOOOOOOXXXXXXXXXGOXXXXXXXXXXXXXXXXXXGOOOXXXXXXXXXXXXXXXXGOOXXXXXXXXXXXXXXXXXGOOOXXXXXXXXXXXXXXXXGOOOOOXXXXXXXXXXXXXXGOOXXXXXXXXXXXXXXXXXGOOOOOOXXXXXXXXXXXXXGOOOOOOOOOXXXXXXXXXX,0,300,0
42756,70,0,70,3,227,0,0,229,226,3,GOOOXXXXXXXXXXXXXXXXGOOOOOXXXXXXXXXXXXXXGOOOOOOOXXXXXXXXXXXXGOXXXXXXXXXXXXXXXXXXGOOOOOOOOOOXXXXXXXXXGOXXXXXXXXXXXXXXXXXXGOOOXXXXXXXXXXXXXXXXGOOXXXXXXXXXXXXXXXXXGOOOXXXXXXXXXXXXXXXXGOOOOOXXXXXXXXXXXXXXGOOXXXXXXXXXXXXXXXXXGOOOOOOXXXXXXXXXXXXXGOOOOOOOOOXXXXXXXXXX,0,300,0
42777,70,0,70,2,228,0,0,230,226,4,GOOOXXXXXXXXXXXXXXXXGOOOOOXXXXXXXXXXXXXXGOOOOOOOXXXXXXXXXXXXGOXXXXXXXXXXXXXXXXXXGOOOOOOOOOOXXXXXXXXXGOXXXXXXXXXXXXXXXXXXGOOOXXXXXXXXXXXXXXXXGOOXXXXXXXXXXXXXXXXXGOOOXXXXXXXXXXXXXXXXGOOOOOXXXXXXXXXXXXXXGOOXXXXXXXXXXXXXXXXXGOOOOOOXXXXXXXXXXXXXGOOOOOOOOOXXXXXXXXXX,0,300,0
42798,70,0,70,2,228,0,0,230,226,4,GOOOXXXXXXXXXXXXXXXXGOOOOOXXXXXXXXXXXXXXGOOOOOOOXXXXXXXXXXXXGOXXXXXXXXXXXXXXXXXXGOOOOOOOOOOXXXXXXXXXGOXXXXXXXXXXXXXXXXXXGOOOXXXXXXXXXXXXXXXXGOOXXXXXXXXXXXXXXXXXGOOOXXXXXXXXXXXXXXXXGOOOOOXXXXXXXXXXXXXXGOOXXXXXXXXXXXXXXXXXGOOOOOOXXXXXXXXXXXXXGOOOOOOOOOXXXXXXXXXX,0,300,0
42819,70,0,70,2,228,0,0,230,226,4,GOOOXXXXXXXXXXXXXXXXGOOOOOXXXXXXXXXXXXXXGOOOOOOOXXXXXXXXXXXXGOXXXXXXXXXXXXXXXXXXGOOOOOOOOOOXXXXXXXXXGOXXXXXXXXXXXXXXXXXXGOOOXXXXXXXXXXXXXXXXGOOXXXXXXXXXXXXXXXXXGOOOXXXXXXXXXXXXXXXXGOOOOOXXXXXXXXXXXXXXGOOXXXXXXXXXXXXXXXXXGOOOOOOXXXXXXXXXXXXXGOOOOOOOOOXXXXXXXXXX,0,300,0

42840,70,0,70,2,228,0,0,230,226,4,GOOOXXXXXXXXXXXXXXXXGOOOOOXXXXXXXXXXXXXXGOOOOOOOXXXXXXXXXXXXGOXXXXXXXXXXXXXXXXXXGOOOOOOOOOOXXXXXXXXXGOXXXXXXXXXXXXXXXXXXGOOOXXXXXXXXXXXXXXXXGOOXXXXXXXXXXXXXXXXXGOOOXXXXXXXXXXXXXXXXGOOOOOXXXXXXXXXXXXXXGOOXXXXXXXXXXXXXXXXXGOOOOOOXXXXXXXXXXXXXGOOOOOOOOOXXXXXXXXXX,0,300,0
42861,70,0,70,2,228,0,0,230,226,4,GOOOXXXXXXXXXXXXXXXXGOOOOOXXXXXXXXXXXXXXGOOOOOOOXXXXXXXXXXXXGOXXXXXXXXXXXXXXXXXXGOOOOOOOOOOXXXXXXXXXGOXXXXXXXXXXXXXXXXXXGOOOXXXXXXXXXXXXXXXXGOOXXXXXXXXXXXXXXXXXGOOOXXXXXXXXXXXXXXXXGOOOOOXXXXXXXXXXXXXXGOOXXXXXXXXXXXXXXXXXGOOOOOOXXXXXXXXXXXXXGOOOOOOOOOXXXXXXXXXX,0,300,0
42882,70,0,70,2,228,0,0,230,226,4,GOOOXXXXXXXXXXXXXXXXGOOOOOXXXXXXXXXXXXXXGOOOOOOOXXXXXXXXXXXXGOXXXXXXXXXXXXXXXXXXGOOOOOOOOOOXXXXXXXXXGOXXXXXXXXXXXXXXXXXXGOOOXXXXXXXXXXXXXXXXGOOXXXXXXXXXXXXXXXXXGOOOXXXXXXXXXXXXXXXXGOOOOOXXXXXXXXXXXXXXGOOXXXXXXXXXXXXXXXXXGOOOOOOXXXXXXXXXXXXXGOOOOOOOOOXXXXXXXXXX,0,300,0
42903,70,0,70,1,229,0,0,231,226,5,GOOOXXXXXXXXXXXXXXXXGOOOOOXXXXXXXXXXXXXXGOOOOOOOXXXXXXXXXXXXGOXXXXXXXXXXXXXXXXXXGOOOOOOOOOOXXXXXXXXXGOXXXXXXXXXXXXXXXXXXGOOOXXXXXXXXXXXXXXXXGOOXXXXXXXXXXXXXXXXXGOOOXXXXXXXXXXXXXXXXGOOOOOXXXXXXXXXXXXXXGOOXXXXXXXXXXXXXXXXXGOOOOOOXXXXXXXXXXXXXGOOOOOOOOOXXXXXXXXXX,0,300,0
42924,70,0,70,1,229,0,0,231,226,5,GOOOXXXXXXXXXXXXXXXXGOOOOOXXXXXXXXXXXXXXGOOOOOOOXXXXXXXXXXXXGOXXXXXXXXXXXXXXXXXXGOOOOOOOOOOXXXXXXXXXGOXXXXXXXXXXXXXXXXXXGOOOXXXXXXXXXXXXXXXXGOOXXXXXXXXXXXXXXXXXGOOOXXXXXXXXXXXXXXXXGOOOOOXXXXXXXXXXXXXXGOOXXXXXXXXXXXXXXXXXGOOOOOOXXXXXXXXXXXXXGOOOOOOOOOXXXXXXXXXX,0,300,0

42945,70,0,70,1,229,0,0,231,225,6,GOOOXXXXXXXXXXXXXXXXGOOOOOXXXXXXXXXXXXXXGOOOOOOOXXXXXXXXXXXXGOXXXXXXXXXXXXXXXXXXGOOOOOOOOOOXXXXXXXXXGOXXXXXXXXXXXXXXXXXXGOOOXXXXXXXXXXXXXXXXGOOXXXXXXXXXXXXXXXXXGOOOXXXXXXXXXXXXXXXXGOOOOOXXXXXXXXXXXXXXGOOXXXXXXXXXXXXXXXXXGOOOOOOXXXXXXXXXXXXXGOOOOOOOOOXXXXXXXXXX,0,300,0
42966,70,0,70,1,229,0,0,231,225,6,GOOOXXXXXXXXXXXXXXXXGOOOOOXXXXXXXXXXXXXXGOOOOOOOXXXXXXXXXXXXGOXXXXXXXXXXXXXXXXXXGOOOOOOOOOOXXXXXXXXXGOXXXXXXXXXXXXXXXXXXGOOOXXXXXXXXXXXXXXXXGOOXXXXXXXXXXXXXXXXXGOOOXXXXXXXXXXXXXXXXGOOOOOXXXXXXXXXXXXXXGOOXXXXXXXXXXXXXXXXXGOOOOOOXXXXXXXXXXXXXGOOOOOOOOOXXXXXXXXXX,0,300,0
42987,70,0,70,1,229,0,0,231,225,6,GOOOXXXXXXXXXXXXXXXXGOOOOOXXXXXXXXXXXXXXGOOOOOOOXXXXXXXXXXXXGOXXXXXXXXXXXXXXXXXXGOOOOOOOOOOXXXXXXXXXGOXXXXXXXXXXXXXXXXXXGOOOXXXXXXXXXXXXXXXXGOOXXXXXXXXXXXXXXXXXGOOOXXXXXXXXXXXXXXXXGOOOOOXXXXXXXXXXXXXXGOOXXXXXXXXXXXXXXXXXGOOOOOOXXXXXXXXXXXXXGOOOOOOOOOXXXXXXXXXX,0,300,0
43008,70,0,70,1,229,0,0,231,225,6,GOOOXXXXXXXXXXXXXXXXGOOOOOXXXXXXXXXXXXXXGOOOOOOOXXXXXXXXXXXXGOXXXXXXXXXXXXXXXXXXGOOOOOOOOOOXXXXXXXXXGOXXXXXXXXXXXXXXXXXXGOOOXXXXXXXXXXXXXXXXGOOXXXXXXXXXXXXXXXXXGOOOXXXXXXXXXXXXXXXXGOOOOOXXXXXXXXXXXXXXGOOXXXXXXXXXXXXXXXXXGOOOOOOXXXXXXXXXXXXXGOOOOOOOOOXXXXXXXXXX,0,300,0
43029,70,0,70,3,227,0,0,229,225,4,GOOOXXXXXXXXXXXXXXXXGOOOOOXXXXXXXXXXXXXXGOOOOOOOXXXXXXXXXXXXGOXXXXXXXXXXXXXXXXXXGOOOOOOOOOOXXXXXXXXXGOXXXXXXXXXXXXXXXXXXGOOOXXXXXXXXXXXXXXXXGOOXXXXXXXXXXXXXXXXXGOOOXXXXXXXXXXXXXXXXGOOOOOXXXXXXXXXXXXXXGOOXXXXXXXXXXXXXXXXXGOOOOOOXXXXXXXXXXXXXGOOOOOOOOOXXXXXXXXXX,0,300,0

43050,70,0,70,2,228,0,0,230,226,4,GOOOXXXXXXXXXXXXXXXXGOOOOOXXXXXXXXXXXXXXGOOOOOOOXXXXXXXXXXXXGOXXXXXXXXXXXXXXXXXXGOOOOOOOOOOXXXXXXXXXGOXXXXXXXXXXXXXXXXXXGOOOXXXXXXXXXXXXXXXXGOOXXXXXXXXXXXXXXXXXGOOOXXXXXXXXXXXXXXXXGOOOOOXXXXXXXXXXXXXXGOOXXXXXXXXXXXXXXXXXGOOOOOOXXXXXXXXXXXXXGOOOOOOOOOXXXXXXXXXX,0,300,0
43071,70,0,70,3,227,0,0,229,225,4,GOOOXXXXXXXXXXXXXXXXGOOOOOXXXXXXXXXXXXXXGOOOOOOOXXXXXXXXXXXXGOXXXXXXXXXXXXXXXXXXGOOOOOOOOOOXXXXXXXXXGOXXXXXXXXXXXXXXXXXXGOOOXXXXXXXXXXXXXXXXGOOXXXXXXXXXXXXXXXXXGOOOXXXXXXXXXXXXXXXXGOOOOOXXXXXXXXXXXXXXGOOXXXXXXXXXXXXXXXXXGOOOOOOXXXXXXXXXXXXXGOOOOOOOOOXXXXXXXXXX,0,300,0
43092,70,0,70,3,227,0,0,229,225,4,GOOOXXXXXXXXXXXXXXXXGOOOOOXXXXXXXXXXXXXXGOOOOOOOXXXXXXXXXXXXGOXXXXXXXXXXXXXXXXXXGOOOOOOOOOOXXXXXXXXXGOXXXXXXXXXXXXXXXXXXGOOOXXXXXXXXXXXXXXXXGOOXXXXXXXXXXXXXXXXXGOOOXXXXXXXXXXXXXXXXGOOOOOXXXXXXXXXXXXXXGOOXXXXXXXXXXXXXXXXXGOOOOOOXXXXXXXXXXXXXGOOOOOOOOOXXXXXXXXXX,0,300,0
43113,70,0,70,3,227,0,0,229,225,4,GOOOXXXXXXXXXXXXXXXXGOOOOOXXXXXXXXXXXXXXGOOOOOOOXXXXXXXXXXXXGOXXXXXXXXXXXXXXXXXXGOOOOOOOOOOXXXXXXXXXGOXXXXXXXXXXXXXXXXXXGOOOXXXXXXXXXXXXXXXXGOOXXXXXXXXXXXXXXXXXGOOOXXXXXXXXXXXXXXXXGOOOOOXXXXXXXXXXXXXXGOOXXXXXXXXXXXXXXXXXGOOOOOOXXXXXXXXXXXXXGOOOOOOOOOXXXXXXXXXX,0,300,0
43134,70,0,70,2,228,0,0,230,225,5,GOOOXXXXXXXXXXXXXXXXGOOOOOXXXXXXXXXXXXXXGOOOOOOOXXXXXXXXXXXXGOXXXXXXXXXXXXXXXXXXGOOOOOOOOOOXXXXXXXXXGOXXXXXXXXXXXXXXXXXXGOOOXXXXXXXXXXXXXXXXGOOXXXXXXXXXXXXXXXXXGOOOXXXXXXXXXXXXXXXXGOOOOOXXXXXXXXXXXXXXGOOXXXXXXXXXXXXXXXXXGOOOOOOXXXXXXXXXXXXXGOOOOOOOOOXXXXXXXXXX,0,300,0

43155,70,0,70,3,227,0,0,229,225,4,GOOOXXXXXXXXXXXXXXXXGOOOOOXXXXXXXXXXXXXXGOOOOOOOXXXXXXXXXXXXGOXXXXXXXXXXXXXXXXXXGOOOOOOOOOOXXXXXXXXXGOXXXXXXXXXXXXXXXXXXGOOOXXXXXXXXXXXXXXXXGOOXXXXXXXXXXXXXXXXXGOOOXXXXXXXXXXXXXXXXGOOOOOXXXXXXXXXXXXXXGOOXXXXXXXXXXXXXXXXXGOOOOOOXXXXXXXXXXXXXGOOOOOOOOOXXXXXXXXXX,0,300,0
43176,70,0,70,2,228,0,0,230,226,4,GOOOXXXXXXXXXXXXXXXXGOOOOOXXXXXXXXXXXXXXGOOOOOOOXXXXXXXXXXXXGOXXXXXXXXXXXXXXXXXXGOOOOOOOOOOXXXXXXXXXGOXXXXXXXXXXXXXXXXXXGOOOXXXXXXXXXXXXXXXXGOOXXXXXXXXXXXXXXXXXGOOOXXXXXXXXXXXXXXXXGOOOOOXXXXXXXXXXXXXXGOOXXXXXXXXXXXXXXXXXGOOOOOOXXXXXXXXXXXXXGOOOOOOOOOXXXXXXXXXX,0,300,0
43197,70,0,70,2,228,0,0,230,226,4,GOOOXXXXXXXXXXXXXXXXGOOOOOXXXXXXXXXXXXXXGOOOOOOOXXXXXXXXXXXXGOXXXXXXXXXXXXXXXXXXGOOOOOOOOOOXXXXXXXXXGOXXXXXXXXXXXXXXXXXXGOOOXXXXXXXXXXXXXXXXGOOXXXXXXXXXXXXXXXXXGOOOXXXXXXXXXXXXXXXXGOOOOOXXXXXXXXXXXXXXGOOXXXXXXXXXXXXXXXXXGOOOOOOXXXXXXXXXXXXXGOOOOOOOOOXXXXXXXXXX,0,300,0
43218,70,0,70,2,228,0,0,230,226,4,GOOOXXXXXXXXXXXXXXXXGOOOOOXXXXXXXXXXXXXXGOOOOOOOXXXXXXXXXXXXGOXXXXXXXXXXXXXXXXXXGOOOOOOOOOOXXXXXXXXXGOXXXXXXXXXXXXXXXXXXGOOOXXXXXXXXXXXXXXXXGOOXXXXXXXXXXXXXXXXXGOOOXXXXXXXXXXXXXXXXGOOOOOXXXXXXXXXXXXXXGOOXXXXXXXXXXXXXXXXXGOOOOOOXXXXXXXXXXXXXGOOOOOOOOOXXXXXXXXXX,0,300,0
43239,70,0,70,2,228,0,0,230,226,4,GOOOXXXXXXXXXXXXXXXXGOOOOOXXXXXXXXXXXXXXGOOOOOOOXXXXXXXXXXXXGOXXXXXXXXXXXXXXXXXXGOOOOOOOOOOXXXXXXXXXGOXXXXXXXXXXXXXXXXXXGOOOXXXXXXXXXXXXXXXXGOOXXXXXXXXXXXXXXXXXGOOOXXXXXXXXXXXXXXXXGOOOOOXXXXXXXXXXXXXXGOOXXXXXXXXXXXXXXXXXGOOOOOOXXXXXXXXXXXXXGOOOOOOOOOXXXXXXXXXX,0,300,0

43260,70,0,70,2,228,0,0,230,226,4,GOOOXXXXXXXXXXXXXXXXGOOOOOXXXXXXXXXXXXXXGOOOOOOOXXXXXXXXXXXXGOXXXXXXXXXXXXXXXXXXGOOOOOOOOOOXXXXXXXXXGOXXXXXXXXXXXXXXXXXXGOOOXXXXXXXXXXXXXXXXGOOXXXXXXXXXXXXXXXXXGOOOXXXXXXXXXXXXXXXXGOOOOOXXXXXXXXXXXXXXGOOXXXXXXXXXXXXXXXXXGOOOOOOXXXXXXXXXXXXXGOOOOOOOOOXXXXXXXXXX,0,300,0
43281,70,0,70,2,228,0,0,230,226,4,GOOOXXXXXXXXXXXXXXXXGOOOOOXXXXXXXXXXXXXXGOOOOOOOXXXXXXXXXXXXGOXXXXXXXXXXXXXXXXXXGOOOOOOOOOOXXXXXXXXXGOXXXXXXXXXXXXXXXXXXGOOOXXXXXXXXXXXXXXXXGOOXXXXXXXXXXXXXXXXXGOOOXXXXXXXXXXXXXXXXGOOOOOXXXXXXXXXXXXXXGOOXXXXXXXXXXXXXXXXXGOOOOOOXXXXXXXXXXXXXGOOOOOOOOOXXXXXXXXXX,0,300,0
43302,70,0,70,2,228,0,0,230,226,4,GOOOXXXXXXXXXXXXXXXXGOOOOOXXXXXXXXXXXXXXGOOOOOOOXXXXXXXXXXXXGOXXXXXXXXXXXXXXXXXXGOOOOOOOOOOXXXXXXXXXGOXXXXXXXXXXXXXXXXXXGOOOXXXXXXXXXXXXXXXXGOOXXXXXXXXXXXXXXXXXGOOOXXXXXXXXXXXXXXXXGOOOOOXXXXXXXXXXXXXXGOOXXXXXXXXXXXXXXXXXGOOOOOOXXXXXXXXXXXXXGOOOOOOOOOXXXXXXXXXX,0,300,0
43323,70,0,70,2,228,0,0,230,227,3,GOOOXXXXXXXXXXXXXXXXGOOOOOXXXXXXXXXXXXXXGOOOOOOOXXXXXXXXXXXXGOXXXXXXXXXXXXXXXXXXGOOOOOOOOOOXXXXXXXXXGOXXXXXXXXXXXXXXXXXXGOOOXXXXXXXXXXXXXXXXGOOXXXXXXXXXXXXXXXXXGOOOXXXXXXXXXXXXXXXXGOOOOOXXXXXXXXXXXXXXGOOXXXXXXXXXXXXXXXXXGOOOOOOXXXXXXXXXXXXXGOOOOOOOOOXXXXXXXXXX,0,300,0
43344,70,0,70,3,227,0,0,229,226,3,GOOOXXXXXXXXXXXXXXXXGOOOOOXXXXXXXXXXXXXXGOOOOOOOXXXXXXXXXXXXGOXXXXXXXXXXXXXXXXXXGOOOOOOOOOOXXXXXXXXXGOXXXXXXXXXXXXXXXXXXGOOOXXXXXXXXXXXXXXXXGOOXXXXXXXXXXXXXXXXXGOOOXXXXXXXXXXXXXXXXGOOOOOXXXXXXXXXXXXXXGOOXXXXXXXXXXXXXXXXXGOOOOOOXXXXXXXXXXXXXGOOOOOOOOOXXXXXXXXXX,0,300,0

43365,70,0,70,3,227,0,0,229,226,3,GOOOXXXXXXXXXXXXXXXXGOOOOOXXXXXXXXXXXXXXGOOOOOOOXXXXXXXXXXXXGOXXXXXXXXXXXXXXXXXXGOOOOOOOOOOXXXXXXXXXGOXXXXXXXXXXXXXXXXXXGOOOXXXXXXXXXXXXXXXXGOOXXXXXXXXXXXXXXXXXGOOOXXXXXXXXXXXXXXXXGOOOOOXXXXXXXXXXXXXXGOOXXXXXXXXXXXXXXXXXGOOOOOOXXXXXXXXXXXXXGOOOOOOOOOXXXXXXXXXX,0,300,0
43386,70,0,70,3,227,0,0,229,226,3,GOOOXXXXXXXXXXXXXXXXGOOOOOXXXXXXXXXXXXXXGOOOOOOOXXXXXXXXXXXXGOXXXXXXXXXXXXXXXXXXGOOOOOOOOOOXXXXXXXXXGOXXXXXXXXXXXXXXXXXXGOOOXXXXXXXXXXXXXXXXGOOXXXXXXXXXXXXXXXXXGOOOXXXXXXXXXXXXXXXXGOOOOOXXXXXXXXXXXXXXGOOXXXXXXXXXXXXXXXXXGOOOOOOXXXXXXXXXXXXXGOOOOOOOOOXXXXXXXXXX,0,300,0
43407,70,0,70,2,228,0,0,230,228,2,GOOOXXXXXXXXXXXXXXXXGOOOOOXXXXXXXXXXXXXXGOOOOOOOXXXXXXXXXXXXGOXXXXXXXXXXXXXXXXXXGOOOOOOOOOOXXXXXXXXXGOXXXXXXXXXXXXXXXXXXGOOOXXXXXXXXXXXXXXXXGOOXXXXXXXXXXXXXXXXXGOOOXXXXXXXXXXXXXXXXGOOOOOXXXXXXXXXXXXXXGOOXXXXXXXXXXXXXXXXXGOOOOOOXXXXXXXXXXXXXGOOOOOOOOOXXXXXXXXXX,0,300,0
43428,70,0,70,3,227,0,0,229,227,2,GOOOXXXXXXXXXXXXXXXXGOOOOOXXXXXXXXXXXXXXGOOOOOOOXXXXXXXXXXXXGOXXXXXXXXXXXXXXXXXXGOOOOOOOOOOXXXXXXXXXGOXXXXXXXXXXXXXXXXXXGOOOXXXXXXXXXXXXXXXXGOOXXXXXXXXXXXXXXXXXGOOOXXXXXXXXXXXXXXXXGOOOOOXXXXXXXXXXXXXXGOOXXXXXXXXXXXXXXXXXGOOOOOOXXXXXXXXXXXXXGOOOOOOOOOXXXXXXXXXX,0,300,0
43449,70,0,70,2,228,0,0,230,227,3,GOOOXXXXXXXXXXXXXXXXGOOOOOXXXXXXXXXXXXXXGOOOOOOOXXXXXXXXXXXXGOXXXXXXXXXXXXXXXXXXGOOOOOOOOOOXXXXXXXXXGOXXXXXXXXXXXXXXXXXXGOOOXXXXXXXXXXXXXXXXGOOXXXXXXXXXXXXXXXXXGOOOXXXXXXXXXXXXXXXXGOOOOOXXXXXXXXXXXXXXGOOXXXXXXXXXXXXXXXXXGOOOOOOXXXXXXXXXXXXXGOOOOOOOOOXXXXXXXXXX,0,300,0

43470,70,0,70,2,228,0,0,230,227,3,GOOOXXXXXXXXXXXXXXXXGOOOOOXXXXXXXXXXXXXXGOOOOOOOXXXXXXXXXXXXGOXXXXXXXXXXXXXXXXXXGOOOOOOOOOOXXXXXXXXXGOXXXXXXXXXXXXXXXXXXGOOOXXXXXXXXXXXXXXXXGOOXXXXXXXXXXXXXXXXXGOOOXXXXXXXXXXXXXXXXGOOOOOXXXXXXXXXXXXXXGOOXXXXXXXXXXXXXXXXXGOOOOOOXXXXXXXXXXXXXGOOOOOOOOOXXXXXXXXXX,0,300,0
43491,70,0,70,2,228,0,0,230,227,3,GOOOXXXXXXXXXXXXXXXXGOOOOOXXXXXXXXXXXXXXGOOOOOOOXXXXXXXXXXXXGOXXXXXXXXXXXXXXXXXXGOOOOOOOOOOXXXXXXXXXGOXXXXXXXXXXXXXXXXXXGOOOXXXXXXXXXXXXXXXXGOOXXXXXXXXXXXXXXXXXGOOOXXXXXXXXXXXXXXXXGOOOOOXXXXXXXXXXXXXXGOOXXXXXXXXXXXXXXXXXGOOOOOOXXXXXXXXXXXXXGOOOOOOOOOXXXXXXXXXX,0,300,0
43512,70,0,70,2,228,0,0,230,227,3,GOOOXXXXXXXXXXXXXXXXGOOOOOXXXXXXXXXXXXXXGOOOOOOOXXXXXXXXXXXXGOXXXXXXXXXXXXXXXXXXGOOOOOOOOOOXXXXXXXXXGOXXXXXXXXXXXXXXXXXXGOOOXXXXXXXXXXXXXXXXGOOXXXXXXXXXXXXXXXXXGOOOXXXXXXXXXXXXXXXXGOOOOOXXXXXXXXXXXXXXGOOXXXXXXXXXXXXXXXXXGOOOOOOXXXXXXXXXXXXXGOOOOOOOOOXXXXXXXXXX,0,300,0
43533,70,0,70,2,228,0,0,230,227,3,GOOOXXXXXXXXXXXXXXXXGOOOOOXXXXXXXXXXXXXXGOOOOOOOXXXXXXXXXXXXGOXXXXXXXXXXXXXXXXXXGOOOOOOOOOOXXXXXXXXXGOXXXXXXXXXXXXXXXXXXGOOOXXXXXXXXXXXXXXXXGOOXXXXXXXXXXXXXXXXXGOOOXXXXXXXXXXXXXXXXGOOOOOXXXXXXXXXXXXXXGOOXXXXXXXXXXXXXXXXXGOOOOOOXXXXXXXXXXXXXGOOOOOOOOOXXXXXXXXXX,0,300,0
43554,70,0,70,0,230,0,0,232,227,5,GOOOXXXXXXXXXXXXXXXXGOOOOOXXXXXXXXXXXXXXGOOOOOOOXXXXXXXXXXXXGOXXXXXXXXXXXXXXXXXXGOOOOOOOOOOXXXXXXXXXGOXXXXXXXXXXXXXXXXXXGOOOXXXXXXXXXXXXXXXXGOOXXXXXXXXXXXXXXXXXGOOOXXXXXXXXXXXXXXXXGOOOOOXXXXXXXXXXXXXXGOOXXXXXXXXXXXXXXXXXGOOOOOOXXXXXXXXXXXXXGOOOOOOOOOXXXXXXXXXX,0,300,0

43575,70,0,70,0,230,0,0,232,227,5,GOOOXXXXXXXXXXXXXXXXGOOOOOXXXXXXXXXXXXXXGOOOOOOOXXXXXXXXXXXXGOXXXXXXXXXXXXXXXXXXGOOOOOOOOOOXXXXXXXXXGOXXXXXXXXXXXXXXXXXXGOOOXXXXXXXXXXXXXXXXGOOXXXXXXXXXXXXXXXXXGOOOXXXXXXXXXXXXXXXXGOOOOOXXXXXXXXXXXXXXGOOXXXXXXXXXXXXXXXXXGOOOOOOXXXXXXXXXXXXXGOOOOOOOOOXXXXXXXXXX,0,300,0
43596,70,0,70,0,230,0,0,232,227,5,GOOOXXXXXXXXXXXXXXXXGOOOOOXXXXXXXXXXXXXXGOOOOOOOXXXXXXXXXXXXGOXXXXXXXXXXXXXXXXXXGOOOOOOOOOOXXXXXXXXXGOXXXXXXXXXXXXXXXXXXGOOOXXXXXXXXXXXXXXXXGOOXXXXXXXXXXXXXXXXXGOOOXXXXXXXXXXXXXXXXGOOOOOXXXXXXXXXXXXXXGOOXXXXXXXXXXXXXXXXXGOOOOOOXXXXXXXXXXXXXGOOOOOOOOOXXXXXXXXXX,0,300,0
43617,70,0,70,1,229,0,0,231,227,4,GOOOXXXXXXXXXXXXXXXXGOOOOOXXXXXXXXXXXXXXGOOOOOOOXXXXXXXXXXXXGOXXXXXXXXXXXXXXXXXXGOOOOOOOOOOXXXXXXXXXGOXXXXXXXXXXXXXXXXXXGOOOXXXXXXXXXXXXXXXXGOOXXXXXXXXXXXXXXXXXGOOOXXXXXXXXXXXXXXXXGOOOOOXXXXXXXXXXXXXXGOOXXXXXXXXXXXXXXXXXGOOOOOOXXXXXXXXXXXXXGOOOOOOOOOXXXXXXXXXX,0,300,0
43638,70,0,70,1,229,0,0,231,227,4,GOOOXXXXXXXXXXXXXXXXGOOOOOXXXXXXXXXXXXXXGOOOOOOOXXXXXXXXXXXXGOXXXXXXXXXXXXXXXXXXGOOOOOOOOOOXXXXXXXXXGOXXXXXXXXXXXXXXXXXXGOOOXXXXXXXXXXXXXXXXGOOXXXXXXXXXXXXXXXXXGOOOXXXXXXXXXXXXXXXXGOOOOOXXXXXXXXXXXXXXGOOXXXXXXXXXXXXXXXXXGOOOOOOXXXXXXXXXXXXXGOOOOOOOOOXXXXXXXXXX,0,300,0
43659,70,0,70,1,229,0,0,231,227,4,GOOOXXXXXXXXXXXXXXXXGOOOOOXXXXXXXXXXXXXXGOOOOOOOXXXXXXXXXXXXGOXXXXXXXXXXXXXXXXXXGOOOOOOOOOOXXXXXXXXXGOXXXXXXXXXXXXXXXXXXGOOOXXXXXXXXXXXXXXXXGOOXXXXXXXXXXXXXXXXXGOOOXXXXXXXXXXXXXXXXGOOOOOXXXXXXXXXXXXXXGOOXXXXXXXXXXXXXXXXXGOOOOOOXXXXXXXXXXXXXGOOOOOOOOOXXXXXXXXXX,0,300,0

43680,70,0,70,1,229,0,0,231,227,4,GOOOXXXXXXXXXXXXXXXXGOOOOOXXXXXXXXXXXXXXGOOOOOOOXXXXXXXXXXXXGOXXXXXXXXXXXXXXXXXXGOOOOOOOOOOXXXXXXXXXGOXXXXXXXXXXXXXXXXXXGOOOXXXXXXXXXXXXXXXXGOOXXXXXXXXXXXXXXXXXGOOOXXXXXXXXXXXXXXXXGOOOOOXXXXXXXXXXXXXXGOOXXXXXXXXXXXXXXXXXGOOOOOOXXXXXXXXXXXXXGOOOOOOOOOXXXXXXXXXX,0,300,0
43701,70,0,70,1,229,0,0,231,229,2,GOOOXXXXXXXXXXXXXXXXGOOOOOXXXXXXXXXXXXXXGOOOOOOOXXXXXXXXXXXXGOXXXXXXXXXXXXXXXXXXGOOOOOOOOOOXXXXXXXXXGOXXXXXXXXXXXXXXXXXXGOOOXXXXXXXXXXXXXXXXGOOXXXXXXXXXXXXXXXXXGOOOXXXXXXXXXXXXXXXXGOOOOOXXXXXXXXXXXXXXGOOXXXXXXXXXXXXXXXXXGOOOOOOXXXXXXXXXXXXXGOOOOOOOOOXXXXXXXXXX,0,300,0
43722,70,0,70,3,227,0,0,229,227,2,GOOOXXXXXXXXXXXXXXXXGOOOOOXXXXXXXXXXXXXXGOOOOOOOXXXXXXXXXXXXGOXXXXXXXXXXXXXXXXXXGOOOOOOOOOOXXXXXXXXXGOXXXXXXXXXXXXXXXXXXGOOOXXXXXXXXXXXXXXXXGOOXXXXXXXXXXXXXXXXXGOOOXXXXXXXXXXXXXXXXGOOOOOXXXXXXXXXXXXXXGOOXXXXXXXXXXXXXXXXXGOOOOOOXXXXXXXXXXXXXGOOOOOOOOOXXXXXXXXXX,0,300,0
43743,70,0,70,3,227,0,0,229,227,2,GOOOXXXXXXXXXXXXXXXXGOOOOOXXXXXXXXXXXXXXGOOOOOOOXXXXXXXXXXXXGOXXXXXXXXXXXXXXXXXXGOOOOOOOOOOXXXXXXXXXGOXXXXXXXXXXXXXXXXXXGOOOXXXXXXXXXXXXXXXXGOOXXXXXXXXXXXXXXXXXGOOOXXXXXXXXXXXXXXXXGOOOOOXXXXXXXXXXXXXXGOOXXXXXXXXXXXXXXXXXGOOOOOOXXXXXXXXXXXXXGOOOOOOOOOXXXXXXXXXX,0,300,0
43764,70,0,70,3,227,0,0,229,227,2,GOOOXXXXXXXXXXXXXXXXGOOOOOXXXXXXXXXXXXXXGOOOOOOOXXXXXXXXXXXXGOXXXXXXXXXXXXXXXXXXGOOOOOOOOOOXXXXXXXXXGOXXXXXXXXXXXXXXXXXXGOOOXXXXXXXXXXXXXXXXGOOXXXXXXXXXXXXXXXXXGOOOXXXXXXXXXXXXXXXXGOOOOOXXXXXXXXXXXXXXGOOXXXXXXXXXXXXXXXXXGOOOOOOXXXXXXXXXXXXXGOOOOOOOOOXXXXXXXXXX,0,300,0

43785,70,0,70,2,228,0,0,230,227,3,GOOOXXXXXXXXXXXXXXXXGOOOOOXXXXXXXXXXXXXXGOOOOOOOXXXXXXXXXXXXGOXXXXXXXXXXXXXXXXXXGOOOOOOOOOOXXXXXXXXXGOXXXXXXXXXXXXXXXXXXGOOOXXXXXXXXXXXXXXXXGOOXXXXXXXXXXXXXXXXXGOOOXXXXXXXXXXXXXXXXGOOOOOXXXXXXXXXXXXXXGOOXXXXXXXXXXXXXXXXXGOOOOOOXXXXXXXXXXXXXGOOOOOOOOOXXXXXXXXXX,0,300,0
43806,70,0,70,2,228,0,0,230,227,3,GOOOXXXXXXXXXXXXXXXXGOOOOOXXXXXXXXXXXXXXGOOOOOOOXXXXXXXXXXXXGOXXXXXXXXXXXXXXXXXXGOOOOOOOOOOXXXXXXXXXGOXXXXXXXXXXXXXXXXXXGOOOXXXXXXXXXXXXXXXXGOOXXXXXXXXXXXXXXXXXGOOOXXXXXXXXXXXXXXXXGOOOOOXXXXXXXXXXXXXXGOOXXXXXXXXXXXXXXXXXGOOOOOOXXXXXXXXXXXXXGOOOOOOOOOXXXXXXXXXX,0,300,0
43827,70,0,70,2,228,0,0,230,227,3,GOOOXXXXXXXXXXXXXXXXGOOOOOXXXXXXXXXXXXXXGOOOOOOOXXXXXXXXXXXXGOXXXXXXXXXXXXXXXXXXGOOOOOOOOOOXXXXXXXXXGOXXXXXXXXXXXXXXXXXXGOOOXXXXXXXXXXXXXXXXGOOXXXXXXXXXXXXXXXXXGOOOXXXXXXXXXXXXXXXXGOOOOOXXXXXXXXXXXXXXGOOXXXXXXXXXXXXXXXXXGOOOOOOXXXXXXXXXXXXXGOOOOOOOOOXXXXXXXXXX,0,300,0
43848,70,0,70,3,227,0,0,229,228,1,GOOOXXXXXXXXXXXXXXXXGOOOOOXXXXXXXXXXXXXXGOOOOOOOXXXXXXXXXXXXGOXXXXXXXXXXXXXXXXXXGOOOOOOOOOOXXXXXXXXXGOXXXXXXXXXXXXXXXXXXGOOOXXXXXXXXXXXXXXXXGOOXXXXXXXXXXXXXXXXXGOOOXXXXXXXXXXXXXXXXGOOOOOXXXXXXXXXXXXXXGOOXXXXXXXXXXXXXXXXXGOOOOOOXXXXXXXXXXXXXGOOOOOOOOOXXXXXXXXXX,0,300,0
43869,70,0,70,4,226,0,0,228,227,1,GOOOXXXXXXXXXXXXXXXXGOOOOOXXXXXXXXXXXXXXGOOOOOOOXXXXXXXXXXXXGOXXXXXXXXXXXXXXXXXXGOOOOOOOOOOXXXXXXXXXGOXXXXXXXXXXXXXXXXXXGOOOXXXXXXXXXXXXXXXXGOOXXXXXXXXXXXXXXXXXGOOOXXXXXXXXXXXXXXXXGOOOOOXXXXXXXXXXXXXXGOOXXXXXXXXXXXXXXXXXGOOOOOOXXXXXXXXXXXXXGOOOOOOOOOXXXXXXXXXX,0,300,0

43890,70,0,70,4,226,0,0,228,227,1,GOOOXXXXXXXXXXXXXXXXGOOOOOXXXXXXXXXXXXXXGOOOOOOOXXXXXXXXXXXXGOXXXXXXXXXXXXXXXXXXGOOOOOOOOOOXXXXXXXXXGOXXXXXXXXXXXXXXXXXXGOOOXXXXXXXXXXXXXXXXGOOXXXXXXXXXXXXXXXXXGOOOXXXXXXXXXXXXXXXXGOOOOOXXXXXXXXXXXXXXGOOXXXXXXXXXXXXXXXXXGOOOOOOXXXXXXXXXXXXXGOOOOOOOOOXXXXXXXXXX,0,300,0
43911,70,0,70,4,226,0,0,228,227,1,GOOOXXXXXXXXXXXXXXXXGOOOOOXXXXXXXXXXXXXXGOOOOOOOXXXXXXXXXXXXGOXXXXXXXXXXXXXXXXXXGOOOOOOOOOOXXXXXXXXXGOXXXXXXXXXXXXXXXXXXGOOOXXXXXXXXXXXXXXXXGOOXXXXXXXXXXXXXXXXXGOOOXXXXXXXXXXXXXXXXGOOOOOXXXXXXXXXXXXXXGOOXXXXXXXXXXXXXXXXXGOOOOOOXXXXXXXXXXXXXGOOOOOOOOOXXXXXXXXXX,0,300,0
43932,70,0,70,4,226,0,0,228,227,1,GOOOXXXXXXXXXXXXXXXXGOOOOOXXXXXXXXXXXXXXGOOOOOOOXXXXXXXXXXXXGOXXXXXXXXXXXXXXXXXXGOOOOOOOOOOXXXXXXXXXGOXXXXXXXXXXXXXXXXXXGOOOXXXXXXXXXXXXXXXXGOOXXXXXXXXXXXXXXXXXGOOOXXXXXXXXXXXXXXXXGOOOOOXXXXXXXXXXXXXXGOOXXXXXXXXXXXXXXXXXGOOOOOOXXXXXXXXXXXXXGOOOOOOOOOXXXXXXXXXX,0,300,0
43953,70,0,70,4,226,0,0,228,227,1,GOOOXXXXXXXXXXXXXXXXGOOOOOXXXXXXXXXXXXXXGOOOOOOOXXXXXXXXXXXXGOXXXXXXXXXXXXXXXXXXGOOOOOOOOOOXXXXXXXXXGOXXXXXXXXXXXXXXXXXXGOOOXXXXXXXXXXXXXXXXGOOXXXXXXXXXXXXXXXXXGOOOXXXXXXXXXXXXXXXXGOOOOOXXXXXXXXXXXXXXGOOXXXXXXXXXXXXXXXXXGOOOOOOXXXXXXXXXXXXXGOOOOOOOOOXXXXXXXXXX,0,300,0
43974,70,0,70,3,227,0,0,229,227,2,GOOOXXXXXXXXXXXXXXXXGOOOOOXXXXXXXXXXXXXXGOOOOOOOXXXXXXXXXXXXGOXXXXXXXXXXXXXXXXXXGOOOOOOOOOOXXXXXXXXXGOXXXXXXXXXXXXXXXXXXGOOOXXXXXXXXXXXXXXXXGOOXXXXXXXXXXXXXXXXXGOOOXXXXXXXXXXXXXXXXGOOOOOXXXXXXXXXXXXXXGOOXXXXXXXXXXXXXXXXXGOOOOOOXXXXXXXXXXXXXGOOOOOOOOOXXXXXXXXXX,0,300,0

43995,70,0,70,3,227,0,0,229,227,2,GOOOXXXXXXXXXXXXXXXXGOOOOOXXXXXXXXXXXXXXGOOOOOOOXXXXXXXXXXXXGOXXXXXXXXXXXXXXXXXXGOOOOOOOOOOXXXXXXXXXGOXXXXXXXXXXXXXXXXXXGOOOXXXXXXXXXXXXXXXXGOOXXXXXXXXXXXXXXXXXGOOOXXXXXXXXXXXXXXXXGOOOOOXXXXXXXXXXXXXXGOOXXXXXXXXXXXXXXXXXGOOOOOOXXXXXXXXXXXXXGOOOOOOOOOXXXXXXXXXX,0,300,0
44016,70,0,70,2,228,0,0,230,227,3,GOOOXXXXXXXXXXXXXXXXGOOOOOXXXXXXXXXXXXXXGOOOOOOOXXXXXXXXXXXXGOXXXXXXXXXXXXXXXXXXGOOOOOOOOOOXXXXXXXXXGOXXXXXXXXXXXXXXXXXXGOOOXXXXXXXXXXXXXXXXGOOXXXXXXXXXXXXXXXXXGOOOXXXXXXXXXXXXXXXXGOOOOOXXXXXXXXXXXXXXGOOXXXXXXXXXXXXXXXXXGOOOOOOXXXXXXXXXXXXXGOOOOOOOOOXXXXXXXXXX,0,300,0
44037,70,0,70,0,230,0,0,232,227,5,GOOOXXXXXXXXXXXXXXXXGOOOOOXXXXXXXXXXXXXXGOOOOOOOXXXXXXXXXXXXGOXXXXXXXXXXXXXXXXXXGOOOOOOOOOOXXXXXXXXXGOXXXXXXXXXXXXXXXXXXGOOOXXXXXXXXXXXXXXXXGOOXXXXXXXXXXXXXXXXXGOOOXXXXXXXXXXXXXXXXGOOOOOXXXXXXXXXXXXXXGOOXXXXXXXXXXXXXXXXXGOOOOOOXXXXXXXXXXXXXGOOOOOOOOOXXXXXXXXXX,0,300,0
44058,70,0,70,0,230,0,0,232,227,5,GOOOXXXXXXXXXXXXXXXXGOOOOOXXXXXXXXXXXXXXGOOOOOOOXXXXXXXXXXXXGOXXXXXXXXXXXXXXXXXXGOOOOOOOOOOXXXXXXXXXGOXXXXXXXXXXXXXXXXXXGOOOXXXXXXXXXXXXXXXXGOOXXXXXXXXXXXXXXXXXGOOOXXXXXXXXXXXXXXXXGOOOOOXXXXXXXXXXXXXXGOOXXXXXXXXXXXXXXXXXGOOOOOOXXXXXXXXXXXXXGOOOOOOOOOXXXXXXXXXX,0,300,0
44079,70,0,70,0,230,0,0,232,227,5,GOOOXXXXXXXXXXXXXXXXGOOOOOXXXXXXXXXXXXXXGOOOOOOOXXXXXXXXXXXXGOXXXXXXXXXXXXXXXXXXGOOOOOOOOOOXXXXXXXXXGOXXXXXXXXXXXXXXXXXXGOOOXXXXXXXXXXXXXXXXGOOXXXXXXXXXXXXXXXXXGOOOXXXXXXXXXXXXXXXXGOOOOOXXXXXXXXXXXXXXGOOXXXXXXXXXXXXXXXXXGOOOOOOXXXXXXXXXXXXXGOOOOOOOOOXXXXXXXXXX,0,300,0

44100,70,0,70,0,230,0,0,232,227,5,GOOOXXXXXXXXXXXXXXXXGOOOOOXXXXXXXXXXXXXXGOOOOOOOXXXXXXXXXXXXGOXXXXXXXXXXXXXXXXXXGOOOOOOOOOOXXXXXXXXXGOXXXXXXXXXXXXXXXXXXGOOOXXXXXXXXXXXXXXXXGOOXXXXXXXXXXXXXXXXXGOOOXXXXXXXXXXXXXXXXGOOOOOXXXXXXXXXXXXXXGOOXXXXXXXXXXXXXXXXXGOOOOOOXXXXXXXXXXXXXGOOOOOOOOOXXXXXXXXXX,0,300,0
44121,70,0,70,0,230,0,0,232,227,5,GOOOXXXXXXXXXXXXXXXXGOOOOOXXXXXXXXXXXXXXGOOOOOOOXXXXXXXXXXXXGOXXXXXXXXXXXXXXXXXXGOOOOOOOOOOXXXXXXXXXGOXXXXXXXXXXXXXXXXXXGOOOXXXXXXXXXXXXXXXXGOOXXXXXXXXXXXXXXXXXGOOOXXXXXXXXXXXXXXXXGOOOOOXXXXXXXXXXXXXXGOOXXXXXXXXXXXXXXXXXGOOOOOOXXXXXXXXXXXXXGOOOOOOOOOXXXXXXXXXX,0,300,0
44142,70,0,70,0,230,0,0,232,227,5,GOOOXXXXXXXXXXXXXXXXGOOOOOXXXXXXXXXXXXXXGOOOOOOOXXXXXXXXXXXXGOXXXXXXXXXXXXXXXXXXGOOOOOOOOOOXXXXXXXXXGOXXXXXXXXXXXXXXXXXXGOOOXXXXXXXXXXXXXXXXGOOXXXXXXXXXXXXXXXXXGOOOXXXXXXXXXXXXXXXXGOOOOOXXXXXXXXXXXXXXGOOXXXXXXXXXXXXXXXXXGOOOOOOXXXXXXXXXXXXXGOOOOOOOOOXXXXXXXXXX,0,300,0
44163,70,0,70,0,230,0,0,232,227,5,GOOOXXXXXXXXXXXXXXXXGOOOOOXXXXXXXXXXXXXXGOOOOOOOXXXXXXXXXXXXGOXXXXXXXXXXXXXXXXXXGOOOOOOOOOOXXXXXXXXXGOXXXXXXXXXXXXXXXXXXGOOOXXXXXXXXXXXXXXXXGOOXXXXXXXXXXXXXXXXXGOOOXXXXXXXXXXXXXXXXGOOOOOXXXXXXXXXXXXXXGOOXXXXXXXXXXXXXXXXXGOOOOOOXXXXXXXXXXXXXGOOOOOOOOOXXXXXXXXXX,0,300,0
44184,70,0,70,0,230,0,0,232,227,5,GOOOXXXXXXXXXXXXXXXXGOOOOOXXXXXXXXXXXXXXGOOOOOOOXXXXXXXXXXXXGOXXXXXXXXXXXXXXXXXXGOOOOOOOOOOXXXXXXXXXGOXXXXXXXXXXXXXXXXXXGOOOXXXXXXXXXXXXXXXXGOOXXXXXXXXXXXXXXXXXGOOOXXXXXXXXXXXXXXXXGOOOOOXXXXXXXXXXXXXXGOOXXXXXXXXXXXXXXXXXGOOOOOOXXXXXXXXXXXXXGOOOOOOOOOXXXXXXXXXX,0,300,0

44205,70,0,70,0,230,0,0,232,228,4,GOOOXXXXXXXXXXXXXXXXGOOOOOXXXXXXXXXXXXXXGOOOOOOOXXXXXXXXXXXXGOXXXXXXXXXXXXXXXXXXGOOOOOOOOOOXXXXXXXXXGOXXXXXXXXXXXXXXXXXXGOOOXXXXXXXXXXXXXXXXGOOXXXXXXXXXXXXXXXXXGOOOXXXXXXXXXXXXXXXXGOOOOOXXXXXXXXXXXXXXGOOXXXXXXXXXXXXXXXXXGOOOOOOXXXXXXXXXXXXXGOOOOOOOOOXXXXXXXXXX,0,300,0
44226,70,0,70,1,229,0,0,231,228,3,GOOOXXXXXXXXXXXXXXXXGOOOOOXXXXXXXXXXXXXXGOOOOOOOXXXXXXXXXXXXGOXXXXXXXXXXXXXXXXXXGOOOOOOOOOOXXXXXXXXXGOXXXXXXXXXXXXXXXXXXGOOOXXXXXXXXXXXXXXXXGOOXXXXXXXXXXXXXXXXXGOOOXXXXXXXXXXXXXXXXGOOOOOXXXXXXXXXXXXXXGOOXXXXXXXXXXXXXXXXXGOOOOOOXXXXXXXXXXXXXGOOOOOOOOOXXXXXXXXXX,0,300,0
44247,70,0,70,2,228,0,0,230,226,4,GOOOXXXXXXXXXXXXXXXXGOOOOOXXXXXXXXXXXXXXGOOOOOOOXXXXXXXXXXXXGOXXXXXXXXXXXXXXXXXXGOOOOOOOOOOXXXXXXXXXGOXXXXXXXXXXXXXXXXXXGOOOXXXXXXXXXXXXXXXXGOOXXXXXXXXXXXXXXXXXGOOOXXXXXXXXXXXXXXXXGOOOOOXXXXXXXXXXXXXXGOOXXXXXXXXXXXXXXXXXGOOOOOOXXXXXXXXXXXXXGOOOOOOOOOXXXXXXXXXX,0,300,0
44268,70,0,70,2,228,0,0,230,226,4,GOOOXXXXXXXXXXXXXXXXGOOOOOXXXXXXXXXXXXXXGOOOOOOOXXXXXXXXXXXXGOXXXXXXXXXXXXXXXXXXGOOOOOOOOOOXXXXXXXXXGOXXXXXXXXXXXXXXXXXXGOOOXXXXXXXXXXXXXXXXGOOXXXXXXXXXXXXXXXXXGOOOXXXXXXXXXXXXXXXXGOOOOOXXXXXXXXXXXXXXGOOXXXXXXXXXXXXXXXXXGOOOOOOXXXXXXXXXXXXXGOOOOOOOOOXXXXXXXXXX,0,300,0
44289,70,0,70,2,228,0,0,230,226,4,GOOOXXXXXXXXXXXXXXXXGOOOOOXXXXXXXXXXXXXXGOOOOOOOXXXXXXXXXXXXGOXXXXXXXXXXXXXXXXXXGOOOOOOOOOOXXXXXXXXXGOXXXXXXXXXXXXXXXXXXGOOOXXXXXXXXXXXXXXXXGOOXXXXXXXXXXXXXXXXXGOOOXXXXXXXXXXXXXXXXGOOOOOXXXXXXXXXXXXXXGOOXXXXXXXXXXXXXXXXXGOOOOOOXXXXXXXXXXXXXGOOOOOOOOOXXXXXXXXXX,0,300,0

44310,70,0,70,2,228,0,0,230,226,4,GOOOXXXXXXXXXXXXXXXXGOOOOOXXXXXXXXXXXXXXGOOOOOOOXXXXXXXXXXXXGOXXXXXXXXXXXXXXXXXXGOOOOOOOOOOXXXXXXXXXGOXXXXXXXXXXXXXXXXXXGOOOXXXXXXXXXXXXXXXXGOOXXXXXXXXXXXXXXXXXGOOOXXXXXXXXXXXXXXXXGOOOOOXXXXXXXXXXXXXXGOOXXXXXXXXXXXXXXXXXGOOOOOOXXXXXXXXXXXXXGOOOOOOOOOXXXXXXXXXX,0,300,0
44331,70,0,70,2,228,0,0,230,227,3,GOOOXXXXXXXXXXXXXXXXGOOOOOXXXXXXXXXXXXXXGOOOOOOOXXXXXXXXXXXXGOXXXXXXXXXXXXXXXXXXGOOOOOOOOOOXXXXXXXXXGOXXXXXXXXXXXXXXXXXXGOOOXXXXXXXXXXXXXXXXGOOXXXXXXXXXXXXXXXXXGOOOXXXXXXXXXXXXXXXXGOOOOOXXXXXXXXXXXXXXGOOXXXXXXXXXXXXXXXXXGOOOOOOXXXXXXXXXXXXXGOOOOOOOOOXXXXXXXXXX,0,300,0
44352,70,0,70,2,228,0,0,230,227,3,GOOOXXXXXXXXXXXXXXXXGOOOOOXXXXXXXXXXXXXXGOOOOOOOXXXXXXXXXXXXGOXXXXXXXXXXXXXXXXXXGOOOOOOOOOOXXXXXXXXXGOXXXXXXXXXXXXXXXXXXGOOOXXXXXXXXXXXXXXXXGOOXXXXXXXXXXXXXXXXXGOOOXXXXXXXXXXXXXXXXGOOOOOXXXXXXXXXXXXXXGOOXXXXXXXXXXXXXXXXXGOOOOOOXXXXXXXXXXXXXGOOOOOOOOOXXXXXXXXXX,0,300,0
44373,70,0,70,3,227,0,0,229,227,2,GOOOXXXXXXXXXXXXXXXXGOOOOOXXXXXXXXXXXXXXGOOOOOOOXXXXXXXXXXXXGOXXXXXXXXXXXXXXXXXXGOOOOOOOOOOXXXXXXXXXGOXXXXXXXXXXXXXXXXXXGOOOXXXXXXXXXXXXXXXXGOOXXXXXXXXXXXXXXXXXGOOOXXXXXXXXXXXXXXXXGOOOOOXXXXXXXXXXXXXXGOOXXXXXXXXXXXXXXXXXGOOOOOOXXXXXXXXXXXXXGOOOOOOOOOXXXXXXXXXX,0,300,0
44394,70,0,70,4,226,0,0,228,226,2,GOOOXXXXXXXXXXXXXXXXGOOOOOXXXXXXXXXXXXXXGOOOOOOOXXXXXXXXXXXXGOXXXXXXXXXXXXXXXXXXGOOOOOOOOOOXXXXXXXXXGOXXXXXXXXXXXXXXXXXXGOOOXXXXXXXXXXXXXXXXGOOXXXXXXXXXXXXXXXXXGOOOXXXXXXXXXXXXXXXXGOOOOOXXXXXXXXXXXXXXGOOXXXXXXXXXXXXXXXXXGOOOOOOXXXXXXXXXXXXXGOOOOOOOOOXXXXXXXXXX,0,300,0

44415,70,0,70,4,226,0,0,228,226,2,GOOOXXXXXXXXXXXXXXXXGOOOOOXXXXXXXXXXXXXXGOOOOOOOXXXXXXXXXXXXGOXXXXXXXXXXXXXXXXXXGOOOOOOOOOOXXXXXXXXXGOXXXXXXXXXXXXXXXXXXGOOOXXXXXXXXXXXXXXXXGOOXXXXXXXXXXXXXXXXXGOOOXXXXXXXXXXXXXXXXGOOOOOXXXXXXXXXXXXXXGOOXXXXXXXXXXXXXXXXXGOOOOOOXXXXXXXXXXXXXGOOOOOOOOOXXXXXXXXXX,0,300,0
44436,70,0,70,3,227,0,0,229,226,3,GOOOXXXXXXXXXXXXXXXXGOOOOOXXXXXXXXXXXXXXGOOOOOOOXXXXXXXXXXXXGOXXXXXXXXXXXXXXXXXXGOOOOOOOOOOXXXXXXXXXGOXXXXXXXXXXXXXXXXXXGOOOXXXXXXXXXXXXXXXXGOOXXXXXXXXXXXXXXXXXGOOOXXXXXXXXXXXXXXXXGOOOOOXXXXXXXXXXXXXXGOOXXXXXXXXXXXXXXXXXGOOOOOOXXXXXXXXXXXXXGOOOOOOOOOXXXXXXXXXX,0,300,0
44457,70,0,70,2,228,0,0,230,226,4,GOOOXXXXXXXXXXXXXXXXGOOOOOXXXXXXXXXXXXXXGOOOOOOOXXXXXXXXXXXXGOXXXXXXXXXXXXXXXXXXGOOOOOOOOOOXXXXXXXXXGOXXXXXXXXXXXXXXXXXXGOOOXXXXXXXXXXXXXXXXGOOXXXXXXXXXXXXXXXXXGOOOXXXXXXXXXXXXXXXXGOOOOOXXXXXXXXXXXXXXGOOXXXXXXXXXXXXXXXXXGOOOOOOXXXXXXXXXXXXXGOOOOOOOOOXXXXXXXXXX,0,300,0
44478,70,0,70,2,228,0,0,230,226,4,GOOOXXXXXXXXXXXXXXXXGOOOOOXXXXXXXXXXXXXXGOOOOOOOXXXXXXXXXXXXGOXXXXXXXXXXXXXXXXXXGOOOOOOOOOOXXXXXXXXXGOXXXXXXXXXXXXXXXXXXGOOOXXXXXXXXXXXXXXXXGOOXXXXXXXXXXXXXXXXXGOOOXXXXXXXXXXXXXXXXGOOOOOXXXXXXXXXXXXXXGOOXXXXXXXXXXXXXXXXXGOOOOOOXXXXXXXXXXXXXGOOOOOOOOOXXXXXXXXXX,0,300,0
44499,70,0,70,2,228,0,0,230,227,3,GOOOXXXXXXXXXXXXXXXXGOOOOOXXXXXXXXXXXXXXGOOOOOOOXXXXXXXXXXXXGOXXXXXXXXXXXXXXXXXXGOOOOOOOOOOXXXXXXXXXGOXXXXXXXXXXXXXXXXXXGOOOXXXXXXXXXXXXXXXXGOOXXXXXXXXXXXXXXXXXGOOOXXXXXXXXXXXXXXXXGOOOOOXXXXXXXXXXXXXXGOOXXXXXXXXXXXXXXXXXGOOOOOOXXXXXXXXXXXXXGOOOOOOOOOXXXXXXXXXX,0,300,0

44520,70,0,70,3,227,0,0,229,227,2,GOOOXXXXXXXXXXXXXXXXGOOOOOXXXXXXXXXXXXXXGOOOOOOOXXXXXXXXXXXXGOXXXXXXXXXXXXXXXXXXGOOOOOOOOOOXXXXXXXXXGOXXXXXXXXXXXXXXXXXXGOOOXXXXXXXXXXXXXXXXGOOXXXXXXXXXXXXXXXXXGOOOXXXXXXXXXXXXXXXXGOOOOOXXXXXXXXXXXXXXGOOXXXXXXXXXXXXXXXXXGOOOOOOXXXXXXXXXXXXXGOOOOOOOOOXXXXXXXXXX,0,300,0
44541,70,0,70,3,227,0,0,229,227,2,GOOOXXXXXXXXXXXXXXXXGOOOOOXXXXXXXXXXXXXXGOOOOOOOXXXXXXXXXXXXGOXXXXXXXXXXXXXXXXXXGOOOOOOOOOOXXXXXXXXXGOXXXXXXXXXXXXXXXXXXGOOOXXXXXXXXXXXXXXXXGOOXXXXXXXXXXXXXXXXXGOOOXXXXXXXXXXXXXXXXGOOOOOXXXXXXXXXXXXXXGOOXXXXXXXXXXXXXXXXXGOOOOOOXXXXXXXXXXXXXGOOOOOOOOOXXXXXXXXXX,0,300,0
44562,70,0,70,3,227,0,0,229,227,2,GOOOXXXXXXXXXXXXXXXXGOOOOOXXXXXXXXXXXXXXGOOOOOOOXXXXXXXXXXXXGOXXXXXXXXXXXXXXXXXXGOOOOOOOOOOXXXXXXXXXGOXXXXXXXXXXXXXXXXXXGOOOXXXXXXXXXXXXXXXXGOOXXXXXXXXXXXXXXXXXGOOOXXXXXXXXXXXXXXXXGOOOOOXXXXXXXXXXXXXXGOOXXXXXXXXXXXXXXXXXGOOOOOOXXXXXXXXXXXXXGOOOOOOOOOXXXXXXXXXX,0,300,0
44583,70,0,70,3,227,0,0,229,227,2,GOOOXXXXXXXXXXXXXXXXGOOOOOXXXXXXXXXXXXXXGOOOOOOOXXXXXXXXXXXXGOXXXXXXXXXXXXXXXXXXGOOOOOOOOOOXXXXXXXXXGOXXXXXXXXXXXXXXXXXXGOOOXXXXXXXXXXXXXXXXGOOXXXXXXXXXXXXXXXXXGOOOXXXXXXXXXXXXXXXXGOOOOOXXXXXXXXXXXXXXGOOXXXXXXXXXXXXXXXXXGOOOOOOXXXXXXXXXXXXXGOOOOOOOOOXXXXXXXXXX,0,300,0
44604,70,0,70,3,227,0,0,229,227,2,GOOOXXXXXXXXXXXXXXXXGOOOOOXXXXXXXXXXXXXXGOOOOOOOXXXXXXXXXXXXGOXXXXXXXXXXXXXXXXXXGOOOOOOOOOOXXXXXXXXXGOXXXXXXXXXXXXXXXXXXGOOOXXXXXXXXXXXXXXXXGOOXXXXXXXXXXXXXXXXXGOOOXXXXXXXXXXXXXXXXGOOOOOXXXXXXXXXXXXXXGOOXXXXXXXXXXXXXXXXXGOOOOOOXXXXXXXXXXXXXGOOOOOOOOOXXXXXXXXXX,0,300,0

44625,70,0,70,2,228,0,0,230,227,3,GOOOXXXXXXXXXXXXXXXXGOOOOOXXXXXXXXXXXXXXGOOOOOOOXXXXXXXXXXXXGOXXXXXXXXXXXXXXXXXXGOOOOOOOOOOXXXXXXXXXGOXXXXXXXXXXXXXXXXXXGOOOXXXXXXXXXXXXXXXXGOOXXXXXXXXXXXXXXXXXGOOOXXXXXXXXXXXXXXXXGOOOOOXXXXXXXXXXXXXXGOOXXXXXXXXXXXXXXXXXGOOOOOOXXXXXXXXXXXXXGOOOOOOOOOXXXXXXXXXX,0,300,0
44646,70,0,70,2,228,0,0,230,227,3,GOOOXXXXXXXXXXXXXXXXGOOOOOXXXXXXXXXXXXXXGOOOOOOOXXXXXXXXXXXXGOXXXXXXXXXXXXXXXXXXGOOOOOOOOOOXXXXXXXXXGOXXXXXXXXXXXXXXXXXXGOOOXXXXXXXXXXXXXXXXGOOXXXXXXXXXXXXXXXXXGOOOXXXXXXXXXXXXXXXXGOOOOOXXXXXXXXXXXXXXGOOXXXXXXXXXXXXXXXXXGOOOOOOXXXXXXXXXXXXXGOOOOOOOOOXXXXXXXXXX,0,300,0
44667,70,0,70,2,228,0,0,230,227,3,GOOOXXXXXXXXXXXXXXXXGOOOOOXXXXXXXXXXXXXXGOOOOOOOXXXXXXXXXXXXGOXXXXXXXXXXXXXXXXXXGOOOOOOOOOOXXXXXXXXXGOXXXXXXXXXXXXXXXXXXGOOOXXXXXXXXXXXXXXXXGOOXXXXXXXXXXXXXXXXXGOOOXXXXXXXXXXXXXXXXGOOOOOXXXXXXXXXXXXXXGOOXXXXXXXXXXXXXXXXXGOOOOOOXXXXXXXXXXXXXGOOOOOOOOOXXXXXXXXXX,0,300,0
44688,70,0,70,2,228,0,0,230,227,3,GOOOXXXXXXXXXXXXXXXXGOOOOOXXXXXXXXXXXXXXGOOOOOOOXXXXXXXXXXXXGOXXXXXXXXXXXXXXXXXXGOOOOOOOOOOXXXXXXXXXGOXXXXXXXXXXXXXXXXXXGOOOXXXXXXXXXXXXXXXXGOOXXXXXXXXXXXXXXXXXGOOOXXXXXXXXXXXXXXXXGOOOOOXXXXXXXXXXXXXXGOOXXXXXXXXXXXXXXXXXGOOOOOOXXXXXXXXXXXXXGOOOOOOOOOXXXXXXXXXX,0,300,0
44709,70,0,70,2,228,0,0,230,228,2,GOOOXXXXXXXXXXXXXXXXGOOOOOXXXXXXXXXXXXXXGOOOOOOOXXXXXXXXXXXXGOXXXXXXXXXXXXXXXXXXGOOOOOOOOOOXXXXXXXXXGOXXXXXXXXXXXXXXXXXXGOOOXXXXXXXXXXXXXXXXGOOXXXXXXXXXXXXXXXXXGOOOXXXXXXXXXXXXXXXXGOOOOOXXXXXXXXXXXXXXGOOXXXXXXXXXXXXXXXXXGOOOOOOXXXXXXXXXXXXXGOOOOOOOOOXXXXXXXXXX,0,300,0

44730,70,0,70,3,227,0,0,229,228,1,GOOOXXXXXXXXXXXXXXXXGOOOOOXXXXXXXXXXXXXXGOOOOOOOXXXXXXXXXXXXGOXXXXXXXXXXXXXXXXXXGOOOOOOOOOOXXXXXXXXXGOXXXXXXXXXXXXXXXXXXGOOOXXXXXXXXXXXXXXXXGOOXXXXXXXXXXXXXXXXXGOOOXXXXXXXXXXXXXXXXGOOOOOXXXXXXXXXXXXXXGOOXXXXXXXXXXXXXXXXXGOOOOOOXXXXXXXXXXXXXGOOOOOOOOOXXXXXXXXXX,0,300,0
44751,70,0,70,3,227,0,0,229,227,2,GOOOXXXXXXXXXXXXXXXXGOOOOOXXXXXXXXXXXXXXGOOOOOOOXXXXXXXXXXXXGOXXXXXXXXXXXXXXXXXXGOOOOOOOOOOXXXXXXXXXGOXXXXXXXXXXXXXXXXXXGOOOXXXXXXXXXXXXXXXXGOOXXXXXXXXXXXXXXXXXGOOOXXXXXXXXXXXXXXXXGOOOOOXXXXXXXXXXXXXXGOOXXXXXXXXXXXXXXXXXGOOOOOOXXXXXXXXXXXXXGOOOOOOOOOXXXXXXXXXX,0,300,0
44772,70,0,70,3,227,0,0,229,227,2,GOOOXXXXXXXXXXXXXXXXGOOOOOXXXXXXXXXXXXXXGOOOOOOOXXXXXXXXXXXXGOXXXXXXXXXXXXXXXXXXGOOOOOOOOOOXXXXXXXXXGOXXXXXXXXXXXXXXXXXXGOOOXXXXXXXXXXXXXXXXGOOXXXXXXXXXXXXXXXXXGOOOXXXXXXXXXXXXXXXXGOOOOOXXXXXXXXXXXXXXGOOXXXXXXXXXXXXXXXXXGOOOOOOXXXXXXXXXXXXXGOOOOOOOOOXXXXXXXXXX,0,300,0
44793,70,0,70,2,228,0,0,230,227,3,GOOOXXXXXXXXXXXXXXXXGOOOOOXXXXXXXXXXXXXXGOOOOOOOXXXXXXXXXXXXGOXXXXXXXXXXXXXXXXXXGOOOOOOOOOOXXXXXXXXXGOXXXXXXXXXXXXXXXXXXGOOOXXXXXXXXXXXXXXXXGOOXXXXXXXXXXXXXXXXXGOOOXXXXXXXXXXXXXXXXGOOOOOXXXXXXXXXXXXXXGOOXXXXXXXXXXXXXXXXXGOOOOOOXXXXXXXXXXXXXGOOOOOOOOOXXXXXXXXXX,0,300,0
44814,70,0,70,2,228,0,0,230,227,3,GOOOXXXXXXXXXXXXXXXXGOOOOOXXXXXXXXXXXXXXGOOOOOOOXXXXXXXXXXXXGOXXXXXXXXXXXXXXXXXXGOOOOOOOOOOXXXXXXXXXGOXXXXXXXXXXXXXXXXXXGOOOXXXXXXXXXXXXXXXXGOOXXXXXXXXXXXXXXXXXGOOOXXXXXXXXXXXXXXXXGOOOOOXXXXXXXXXXXXXXGOOXXXXXXXXXXXXXXXXXGOOOOOOXXXXXXXXXXXXXGOOOOOOOOOXXXXXXXXXX,0,300,0

44835,70,0,70,2,228,0,0,230,227,3,GOOOXXXXXXXXXXXXXXXXGOOOOOXXXXXXXXXXXXXXGOOOOOOOXXXXXXXXXXXXGOXXXXXXXXXXXXXXXXXXGOOOOOOOOOOXXXXXXXXXGOXXXXXXXXXXXXXXXXXXGOOOXXXXXXXXXXXXXXXXGOOXXXXXXXXXXXXXXXXXGOOOXXXXXXXXXXXXXXXXGOOOOOXXXXXXXXXXXXXXGOOXXXXXXXXXXXXXXXXXGOOOOOOXXXXXXXXXXXXXGOOOOOOOOOXXXXXXXXXX,0,300,0
44856,70,0,70,2,228,0,0,230,227,3,GOOOXXXXXXXXXXXXXXXXGOOOOOXXXXXXXXXXXXXXGOOOOOOOXXXXXXXXXXXXGOXXXXXXXXXXXXXXXXXXGOOOOOOOOOOXXXXXXXXXGOXXXXXXXXXXXXXXXXXXGOOOXXXXXXXXXXXXXXXXGOOXXXXXXXXXXXXXXXXXGOOOXXXXXXXXXXXXXXXXGOOOOOXXXXXXXXXXXXXXGOOXXXXXXXXXXXXXXXXXGOOOOOOXXXXXXXXXXXXXGOOOOOOOOOXXXXXXXXXX,0,300,0
44877,70,0,70,2,228,0,0,230,227,3,GOOOXXXXXXXXXXXXXXXXGOOOOOXXXXXXXXXXXXXXGOOOOOOOXXXXXXXXXXXXGOXXXXXXXXXXXXXXXXXXGOOOOOOOOOOXXXXXXXXXGOXXXXXXXXXXXXXXXXXXGOOOXXXXXXXXXXXXXXXXGOOXXXXXXXXXXXXXXXXXGOOOXXXXXXXXXXXXXXXXGOOOOOXXXXXXXXXXXXXXGOOXXXXXXXXXXXXXXXXXGOOOOOOXXXXXXXXXXXXXGOOOOOOOOOXXXXXXXXXX,0,300,0
44898,70,0,70,1,229,0,0,231,227,4,GOOOXXXXXXXXXXXXXXXXGOOOOOXXXXXXXXXXXXXXGOOOOOOOXXXXXXXXXXXXGOXXXXXXXXXXXXXXXXXXGOOOOOOOOOOXXXXXXXXXGOXXXXXXXXXXXXXXXXXXGOOOXXXXXXXXXXXXXXXXGOOXXXXXXXXXXXXXXXXXGOOOXXXXXXXXXXXXXXXXGOOOOOXXXXXXXXXXXXXXGOOXXXXXXXXXXXXXXXXXGOOOOOOXXXXXXXXXXXXXGOOOOOOOOOXXXXXXXXXX,0,300,0
44919,70,0,70,1,229,0,0,231,227,4,GOOOXXXXXXXXXXXXXXXXGOOOOOXXXXXXXXXXXXXXGOOOOOOOXXXXXXXXXXXXGOXXXXXXXXXXXXXXXXXXGOOOOOOOOOOXXXXXXXXXGOXXXXXXXXXXXXXXXXXXGOOOXXXXXXXXXXXXXXXXGOOXXXXXXXXXXXXXXXXXGOOOXXXXXXXXXXXXXXXXGOOOOOXXXXXXXXXXXXXXGOOXXXXXXXXXXXXXXXXXGOOOOOOXXXXXXXXXXXXXGOOOOOOOOOXXXXXXXXXX,0,300,0

44940,70,0,70,1,229,0,0,231,227,4,GOOOXXXXXXXXXXXXXXXXGOOOOOXXXXXXXXXXXXXXGOOOOOOOXXXXXXXXXXXXGOXXXXXXXXXXXXXXXXXXGOOOOOOOOOOXXXXXXXXXGOXXXXXXXXXXXXXXXXXXGOOOXXXXXXXXXXXXXXXXGOOXXXXXXXXXXXXXXXXXGOOOXXXXXXXXXXXXXXXXGOOOOOXXXXXXXXXXXXXXGOOXXXXXXXXXXXXXXXXXGOOOOOOXXXXXXXXXXXXXGOOOOOOOOOXXXXXXXXXX,0,300,0
44961,70,0,70,1,229,0,0,231,227,4,GOOOXXXXXXXXXXXXXXXXGOOOOOXXXXXXXXXXXXXXGOOOOOOOXXXXXXXXXXXXGOXXXXXXXXXXXXXXXXXXGOOOOOOOOOOXXXXXXXXXGOXXXXXXXXXXXXXXXXXXGOOOXXXXXXXXXXXXXXXXGOOXXXXXXXXXXXXXXXXXGOOOXXXXXXXXXXXXXXXXGOOOOOXXXXXXXXXXXXXXGOOXXXXXXXXXXXXXXXXXGOOOOOOXXXXXXXXXXXXXGOOOOOOOOOXXXXXXXXXX,0,300,0
44982,70,0,70,1,229,0,0,231,227,4,GOOOXXXXXXXXXXXXXXXXGOOOOOXXXXXXXXXXXXXXGOOOOOOOXXXXXXXXXXXXGOXXXXXXXXXXXXXXXXXXGOOOOOOOOOOXXXXXXXXXGOXXXXXXXXXXXXXXXXXXGOOOXXXXXXXXXXXXXXXXGOOXXXXXXXXXXXXXXXXXGOOOXXXXXXXXXXXXXXXXGOOOOOXXXXXXXXXXXXXXGOOXXXXXXXXXXXXXXXXXGOOOOOOXXXXXXXXXXXXXGOOOOOOOOOXXXXXXXXXX,0,300,0
45003,70,0,70,1,229,0,0,231,227,4,GOOOXXXXXXXXXXXXXXXXGOOOOOXXXXXXXXXXXXXXGOOOOOOOXXXXXXXXXXXXGOXXXXXXXXXXXXXXXXXXGOOOOOOOOOOXXXXXXXXXGOXXXXXXXXXXXXXXXXXXGOOOXXXXXXXXXXXXXXXXGOOXXXXXXXXXXXXXXXXXGOOOXXXXXXXXXXXXXXXXGOOOOOXXXXXXXXXXXXXXGOOXXXXXXXXXXXXXXXXXGOOOOOOXXXXXXXXXXXXXGOOOOOOOOOXXXXXXXXXX,0,300,0
45024,70,0,70,2,228,0,0,230,227,3,GOOOXXXXXXXXXXXXXXXXGOOOOOXXXXXXXXXXXXXXGOOOOOOOXXXXXXXXXXXXGOXXXXXXXXXXXXXXXXXXGOOOOOOOOOOXXXXXXXXXGOXXXXXXXXXXXXXXXXXXGOOOXXXXXXXXXXXXXXXXGOOXXXXXXXXXXXXXXXXXGOOOXXXXXXXXXXXXXXXXGOOOOOXXXXXXXXXXXXXXGOOXXXXXXXXXXXXXXXXXGOOOOOOXXXXXXXXXXXXXGOOOOOOOOOXXXXXXXXXX,0,300,0

45045,70,0,70,2,228,0,0,230,228,2,GOOOXXXXXXXXXXXXXXXXGOOOOOXXXXXXXXXXXXXXGOOOOOOOXXXXXXXXXXXXGOXXXXXXXXXXXXXXXXXXGOOOOOOOOOOXXXXXXXXXGOXXXXXXXXXXXXXXXXXXGOOOXXXXXXXXXXXXXXXXGOOXXXXXXXXXXXXXXXXXGOOOXXXXXXXXXXXXXXXXGOOOOOXXXXXXXXXXXXXXGOOXXXXXXXXXXXXXXXXXGOOOOOOXXXXXXXXXXXXXGOOOOOOOOOXXXXXXXXXX,0,300,0
45066,70,0,70,3,227,0,0,229,227,2,GOOOXXXXXXXXXXXXXXXXGOOOOOXXXXXXXXXXXXXXGOOOOOOOXXXXXXXXXXXXGOXXXXXXXXXXXXXXXXXXGOOOOOOOOOOXXXXXXXXXGOXXXXXXXXXXXXXXXXXXGOOOXXXXXXXXXXXXXXXXGOOXXXXXXXXXXXXXXXXXGOOOXXXXXXXXXXXXXXXXGOOOOOXXXXXXXXXXXXXXGOOXXXXXXXXXXXXXXXXXGOOOOOOXXXXXXXXXXXXXGOOOOOOOOOXXXXXXXXXX,0,300,0
45087,70,0,70,3,227,0,0,229,227,2,GOOOXXXXXXXXXXXXXXXXGOOOOOXXXXXXXXXXXXXXGOOOOOOOXXXXXXXXXXXXGOXXXXXXXXXXXXXXXXXXGOOOOOOOOOOXXXXXXXXXGOXXXXXXXXXXXXXXXXXXGOOOXXXXXXXXXXXXXXXXGOOXXXXXXXXXXXXXXXXXGOOOXXXXXXXXXXXXXXXXGOOOOOXXXXXXXXXXXXXXGOOXXXXXXXXXXXXXXXXXGOOOOOOXXXXXXXXXXXXXGOOOOOOOOOXXXXXXXXXX,0,300,0
45108,70,0,70,2,228,0,0,230,227,3,GOOOXXXXXXXXXXXXXXXXGOOOOOXXXXXXXXXXXXXXGOOOOOOOXXXXXXXXXXXXGOXXXXXXXXXXXXXXXXXXGOOOOOOOOOOXXXXXXXXXGOXXXXXXXXXXXXXXXXXXGOOOXXXXXXXXXXXXXXXXGOOXXXXXXXXXXXXXXXXXGOOOXXXXXXXXXXXXXXXXGOOOOOXXXXXXXXXXXXXXGOOXXXXXXXXXXXXXXXXXGOOOOOOXXXXXXXXXXXXXGOOOOOOOOOXXXXXXXXXX,0,300,0
45129,70,0,70,1,229,0,0,231,227,4,GOOOXXXXXXXXXXXXXXXXGOOOOOXXXXXXXXXXXXXXGOOOOOOOXXXXXXXXXXXXGOXXXXXXXXXXXXXXXXXXGOOOOOOOOOOXXXXXXXXXGOXXXXXXXXXXXXXXXXXXGOOOXXXXXXXXXXXXXXXXGOOXXXXXXXXXXXXXXXXXGOOOXXXXXXXXXXXXXXXXGOOOOOXXXXXXXXXXXXXXGOOXXXXXXXXXXXXXXXXXGOOOOOOXXXXXXXXXXXXXGOOOOOOOOOXXXXXXXXXX,0,300,0

45150,70,0,70,1,229,0,0,231,227,4,GOOOXXXXXXXXXXXXXXXXGOOOOOXXXXXXXXXXXXXXGOOOOOOOXXXXXXXXXXXXGOXXXXXXXXXXXXXXXXXXGOOOOOOOOOOXXXXXXXXXGOXXXXXXXXXXXXXXXXXXGOOOXXXXXXXXXXXXXXXXGOOXXXXXXXXXXXXXXXXXGOOOXXXXXXXXXXXXXXXXGOOOOOXXXXXXXXXXXXXXGOOXXXXXXXXXXXXXXXXXGOOOOOOXXXXXXXXXXXXXGOOOOOOOOOXXXXXXXXXX,0,300,0
45171,70,0,70,1,229,0,0,231,227,4,GOOOXXXXXXXXXXXXXXXXGOOOOOXXXXXXXXXXXXXXGOOOOOOOXXXXXXXXXXXXGOXXXXXXXXXXXXXXXXXXGOOOOOOOOOOXXXXXXXXXGOXXXXXXXXXXXXXXXXXXGOOOXXXXXXXXXXXXXXXXGOOXXXXXXXXXXXXXXXXXGOOOXXXXXXXXXXXXXXXXGOOOOOXXXXXXXXXXXXXXGOOXXXXXXXXXXXXXXXXXGOOOOOOXXXXXXXXXXXXXGOOOOOOOOOXXXXXXXXXX,0,300,0
45192,70,0,70,1,229,0,0,231,227,4,GOOOXXXXXXXXXXXXXXXXGOOOOOXXXXXXXXXXXXXXGOOOOOOOXXXXXXXXXXXXGOXXXXXXXXXXXXXXXXXXGOOOOOOOOOOXXXXXXXXXGOXXXXXXXXXXXXXXXXXXGOOOXXXXXXXXXXXXXXXXGOOXXXXXXXXXXXXXXXXXGOOOXXXXXXXXXXXXXXXXGOOOOOXXXXXXXXXXXXXXGOOXXXXXXXXXXXXXXXXXGOOOOOOXXXXXXXXXXXXXGOOOOOOOOOXXXXXXXXXX,0,300,0
45213,70,0,70,1,229,0,0,231,227,4,GOOOXXXXXXXXXXXXXXXXGOOOOOXXXXXXXXXXXXXXGOOOOOOOXXXXXXXXXXXXGOXXXXXXXXXXXXXXXXXXGOOOOOOOOOOXXXXXXXXXGOXXXXXXXXXXXXXXXXXXGOOOXXXXXXXXXXXXXXXXGOOXXXXXXXXXXXXXXXXXGOOOXXXXXXXXXXXXXXXXGOOOOOXXXXXXXXXXXXXXGOOXXXXXXXXXXXXXXXXXGOOOOOOXXXXXXXXXXXXXGOOOOOOOOOXXXXXXXXXX,0,300,0
45234,70,0,70,1,229,0,0,231,227,4,GOOOXXXXXXXXXXXXXXXXGOOOOOXXXXXXXXXXXXXXGOOOOOOOXXXXXXXXXXXXGOXXXXXXXXXXXXXXXXXXGOOOOOOOOOOXXXXXXXXXGOXXXXXXXXXXXXXXXXXXGOOOXXXXXXXXXXXXXXXXGOOXXXXXXXXXXXXXXXXXGOOOXXXXXXXXXXXXXXXXGOOOOOXXXXXXXXXXXXXXGOOXXXXXXXXXXXXXXXXXGOOOOOOXXXXXXXXXXXXXGOOOOOOOOOXXXXXXXXXX,0,300,0

45255,70,0,70,1,229,0,0,231,227,4,GOOOXXXXXXXXXXXXXXXXGOOOOOXXXXXXXXXXXXXXGOOOOOOOXXXXXXXXXXXXGOXXXXXXXXXXXXXXXXXXGOOOOOOOOOOXXXXXXXXXGOXXXXXXXXXXXXXXXXXXGOOOXXXXXXXXXXXXXXXXGOOXXXXXXXXXXXXXXXXXGOOOXXXXXXXXXXXXXXXXGOOOOOXXXXXXXXXXXXXXGOOXXXXXXXXXXXXXXXXXGOOOOOOXXXXXXXXXXXXXGOOOOOOOOOXXXXXXXXXX,0,300,0
45276,70,0,70,1,229,0,0,231,227,4,GOOOXXXXXXXXXXXXXXXXGOOOOOXXXXXXXXXXXXXXGOOOOOOOXXXXXXXXXXXXGOXXXXXXXXXXXXXXXXXXGOOOOOOOOOOXXXXXXXXXGOXXXXXXXXXXXXXXXXXXGOOOXXXXXXXXXXXXXXXXGOOXXXXXXXXXXXXXXXXXGOOOXXXXXXXXXXXXXXXXGOOOOOXXXXXXXXXXXXXXGOOXXXXXXXXXXXXXXXXXGOOOOOOXXXXXXXXXXXXXGOOOOOOOOOXXXXXXXXXX,0,300,0
45297,70,0,70,2,228,0,0,230,227,3,GOOOXXXXXXXXXXXXXXXXGOOOOOXXXXXXXXXXXXXXGOOOOOOOXXXXXXXXXXXXGOXXXXXXXXXXXXXXXXXXGOOOOOOOOOOXXXXXXXXXGOXXXXXXXXXXXXXXXXXXGOOOXXXXXXXXXXXXXXXXGOOXXXXXXXXXXXXXXXXXGOOOXXXXXXXXXXXXXXXXGOOOOOXXXXXXXXXXXXXXGOOXXXXXXXXXXXXXXXXXGOOOOOOXXXXXXXXXXXXXGOOOOOOOOOXXXXXXXXXX,0,300,0
45318,70,0,70,1,229,0,0,231,227,4,GOOOXXXXXXXXXXXXXXXXGOOOOOXXXXXXXXXXXXXXGOOOOOOOXXXXXXXXXXXXGOXXXXXXXXXXXXXXXXXXGOOOOOOOOOOXXXXXXXXXGOXXXXXXXXXXXXXXXXXXGOOOXXXXXXXXXXXXXXXXGOOXXXXXXXXXXXXXXXXXGOOOXXXXXXXXXXXXXXXXGOOOOOXXXXXXXXXXXXXXGOOXXXXXXXXXXXXXXXXXGOOOOOOXXXXXXXXXXXXXGOOOOOOOOOXXXXXXXXXX,0,300,0
45339,70,0,70,1,229,0,0,231,227,4,GOOOXXXXXXXXXXXXXXXXGOOOOOXXXXXXXXXXXXXXGOOOOOOOXXXXXXXXXXXXGOXXXXXXXXXXXXXXXXXXGOOOOOOOOOOXXXXXXXXXGOXXXXXXXXXXXXXXXXXXGOOOXXXXXXXXXXXXXXXXGOOXXXXXXXXXXXXXXXXXGOOOXXXXXXXXXXXXXXXXGOOOOOXXXXXXXXXXXXXXGOOXXXXXXXXXXXXXXXXXGOOOOOOXXXXXXXXXXXXXGOOOOOOOOOXXXXXXXXXX,0,300,0

45360,70,0,70,1,229,0,0,231,227,4,GOOOXXXXXXXXXXXXXXXXGOOOOOXXXXXXXXXXXXXXGOOOOOOOXXXXXXXXXXXXGOXXXXXXXXXXXXXXXXXXGOOOOOOOOOOXXXXXXXXXGOXXXXXXXXXXXXXXXXXXGOOOXXXXXXXXXXXXXXXXGOOXXXXXXXXXXXXXXXXXGOOOXXXXXXXXXXXXXXXXGOOOOOXXXXXXXXXXXXXXGOOXXXXXXXXXXXXXXXXXGOOOOOOXXXXXXXXXXXXXGOOOOOOOOOXXXXXXXXXX,0,300,0
45381,70,0,70,1,229,0,0,231,228,3,GOOOXXXXXXXXXXXXXXXXGOOOOOXXXXXXXXXXXXXXGOOOOOOOXXXXXXXXXXXXGOXXXXXXXXXXXXXXXXXXGOOOOOOOOOOXXXXXXXXXGOXXXXXXXXXXXXXXXXXXGOOOXXXXXXXXXXXXXXXXGOOXXXXXXXXXXXXXXXXXGOOOXXXXXXXXXXXXXXXXGOOOOOXXXXXXXXXXXXXXGOOXXXXXXXXXXXXXXXXXGOOOOOOXXXXXXXXXXXXXGOOOOOOOOOXXXXXXXXXX,0,300,0
45402,70,0,70,2,228,0,0,230,227,3,GOOOXXXXXXXXXXXXXXXXGOOOOOXXXXXXXXXXXXXXGOOOOOOOXXXXXXXXXXXXGOXXXXXXXXXXXXXXXXXXGOOOOOOOOOOXXXXXXXXXGOXXXXXXXXXXXXXXXXXXGOOOXXXXXXXXXXXXXXXXGOOXXXXXXXXXXXXXXXXXGOOOXXXXXXXXXXXXXXXXGOOOOOXXXXXXXXXXXXXXGOOXXXXXXXXXXXXXXXXXGOOOOOOXXXXXXXXXXXXXGOOOOOOOOOXXXXXXXXXX,0,300,0
45423,70,0,70,1,229,0,0,231,227,4,GOOOXXXXXXXXXXXXXXXXGOOOOOXXXXXXXXXXXXXXGOOOOOOOXXXXXXXXXXXXGOXXXXXXXXXXXXXXXXXXGOOOOOOOOOOXXXXXXXXXGOXXXXXXXXXXXXXXXXXXGOOOXXXXXXXXXXXXXXXXGOOXXXXXXXXXXXXXXXXXGOOOXXXXXXXXXXXXXXXXGOOOOOXXXXXXXXXXXXXXGOOXXXXXXXXXXXXXXXXXGOOOOOOXXXXXXXXXXXXXGOOOOOOOOOXXXXXXXXXX,0,300,0
45444,70,0,70,1,229,0,0,231,227,4,GOOOXXXXXXXXXXXXXXXXGOOOOOXXXXXXXXXXXXXXGOOOOOOOXXXXXXXXXXXXGOXXXXXXXXXXXXXXXXXXGOOOOOOOOOOXXXXXXXXXGOXXXXXXXXXXXXXXXXXXGOOOXXXXXXXXXXXXXXXXGOOXXXXXXXXXXXXXXXXXGOOOXXXXXXXXXXXXXXXXGOOOOOXXXXXXXXXXXXXXGOOXXXXXXXXXXXXXXXXXGOOOOOOXXXXXXXXXXXXXGOOOOOOOOOXXXXXXXXXX,0,300,0

45465,70,0,70,1,229,0,0,231,227,4,GOOOXXXXXXXXXXXXXXXXGOOOOOXXXXXXXXXXXXXXGOOOOOOOXXXXXXXXXXXXGOXXXXXXXXXXXXXXXXXXGOOOOOOOOOOXXXXXXXXXGOXXXXXXXXXXXXXXXXXXGOOOXXXXXXXXXXXXXXXXGOOXXXXXXXXXXXXXXXXXGOOOXXXXXXXXXXXXXXXXGOOOOOXXXXXXXXXXXXXXGOOXXXXXXXXXXXXXXXXXGOOOOOOXXXXXXXXXXXXXGOOOOOOOOOXXXXXXXXXX,0,300,0
45486,70,0,70,2,228,0,0,230,228,2,GOOOXXXXXXXXXXXXXXXXGOOOOOXXXXXXXXXXXXXXGOOOOOOOXXXXXXXXXXXXGOXXXXXXXXXXXXXXXXXXGOOOOOOOOOOXXXXXXXXXGOXXXXXXXXXXXXXXXXXXGOOOXXXXXXXXXXXXXXXXGOOXXXXXXXXXXXXXXXXXGOOOXXXXXXXXXXXXXXXXGOOOOOXXXXXXXXXXXXXXGOOXXXXXXXXXXXXXXXXXGOOOOOOXXXXXXXXXXXXXGOOOOOOOOOXXXXXXXXXX,0,300,0
45507,70,0,70,3,227,0,0,229,227,2,GOOOXXXXXXXXXXXXXXXXGOOOOOXXXXXXXXXXXXXXGOOOOOOOXXXXXXXXXXXXGOXXXXXXXXXXXXXXXXXXGOOOOOOOOOOXXXXXXXXXGOXXXXXXXXXXXXXXXXXXGOOOXXXXXXXXXXXXXXXXGOOXXXXXXXXXXXXXXXXXGOOOXXXXXXXXXXXXXXXXGOOOOOXXXXXXXXXXXXXXGOOXXXXXXXXXXXXXXXXXGOOOOOOXXXXXXXXXXXXXGOOOOOOOOOXXXXXXXXXX,0,300,0
45528,70,0,70,3,227,0,0,229,227,2,GOOOXXXXXXXXXXXXXXXXGOOOOOXXXXXXXXXXXXXXGOOOOOOOXXXXXXXXXXXXGOXXXXXXXXXXXXXXXXXXGOOOOOOOOOOXXXXXXXXXGOXXXXXXXXXXXXXXXXXXGOOOXXXXXXXXXXXXXXXXGOOXXXXXXXXXXXXXXXXXGOOOXXXXXXXXXXXXXXXXGOOOOOXXXXXXXXXXXXXXGOOXXXXXXXXXXXXXXXXXGOOOOOOXXXXXXXXXXXXXGOOOOOOOOOXXXXXXXXXX,0,300,0
45549,70,0,70,3,227,0,0,229,227,2,GOOOXXXXXXXXXXXXXXXXGOOOOOXXXXXXXXXXXXXXGOOOOOOOXXXXXXXXXXXXGOXXXXXXXXXXXXXXXXXXGOOOOOOOOOOXXXXXXXXXGOXXXXXXXXXXXXXXXXXXGOOOXXXXXXXXXXXXXXXXGOOXXXXXXXXXXXXXXXXXGOOOXXXXXXXXXXXXXXXXGOOOOOXXXXXXXXXXXXXXGOOXXXXXXXXXXXXXXXXXGOOOOOOXXXXXXXXXXXXXGOOOOOOOOOXXXXXXXXXX,0,300,0

45570,70,0,70,3,227,0,0,229,227,2,GOOOXXXXXXXXXXXXXXXXGOOOOOXXXXXXXXXXXXXXGOOOOOOOXXXXXXXXXXXXGOXXXXXXXXXXXXXXXXXXGOOOOOOOOOOXXXXXXXXXGOXXXXXXXXXXXXXXXXXXGOOOXXXXXXXXXXXXXXXXGOOXXXXXXXXXXXXXXXXXGOOOXXXXXXXXXXXXXXXXGOOOOOXXXXXXXXXXXXXXGOOXXXXXXXXXXXXXXXXXGOOOOOOXXXXXXXXXXXXXGOOOOOOOOOXXXXXXXXXX,0,300,0
45591,70,0,70,3,227,0,0,229,227,2,GOOOXXXXXXXXXXXXXXXXGOOOOOXXXXXXXXXXXXXXGOOOOOOOXXXXXXXXXXXXGOXXXXXXXXXXXXXXXXXXGOOOOOOOOOOXXXXXXXXXGOXXXXXXXXXXXXXXXXXXGOOOXXXXXXXXXXXXXXXXGOOXXXXXXXXXXXXXXXXXGOOOXXXXXXXXXXXXXXXXGOOOOOXXXXXXXXXXXXXXGOOXXXXXXXXXXXXXXXXXGOOOOOOXXXXXXXXXXXXXGOOOOOOOOOXXXXXXXXXX,0,300,0
45612,70,0,70,3,227,0,0,229,227,2,GOOOXXXXXXXXXXXXXXXXGOOOOOXXXXXXXXXXXXXXGOOOOOOOXXXXXXXXXXXXGOXXXXXXXXXXXXXXXXXXGOOOOOOOOOOXXXXXXXXXGOXXXXXXXXXXXXXXXXXXGOOOXXXXXXXXXXXXXXXXGOOXXXXXXXXXXXXXXXXXGOOOXXXXXXXXXXXXXXXXGOOOOOXXXXXXXXXXXXXXGOOXXXXXXXXXXXXXXXXXGOOOOOOXXXXXXXXXXXXXGOOOOOOOOOXXXXXXXXXX,0,300,0
45633,70,0,70,3,227,0,0,229,227,2,GOOOXXXXXXXXXXXXXXXXGOOOOOXXXXXXXXXXXXXXGOOOOOOOXXXXXXXXXXXXGOXXXXXXXXXXXXXXXXXXGOOOOOOOOOOXXXXXXXXXGOXXXXXXXXXXXXXXXXXXGOOOXXXXXXXXXXXXXXXXGOOXXXXXXXXXXXXXXXXXGOOOXXXXXXXXXXXXXXXXGOOOOOXXXXXXXXXXXXXXGOOXXXXXXXXXXXXXXXXXGOOOOOOXXXXXXXXXXXXXGOOOOOOOOOXXXXXXXXXX,0,300,0
45654,70,0,70,3,227,0,0,229,227,2,GOOOXXXXXXXXXXXXXXXXGOOOOOXXXXXXXXXXXXXXGOOOOOOOXXXXXXXXXXXXGOXXXXXXXXXXXXXXXXXXGOOOOOOOOOOXXXXXXXXXGOXXXXXXXXXXXXXXXXXXGOOOXXXXXXXXXXXXXXXXGOOXXXXXXXXXXXXXXXXXGOOOXXXXXXXXXXXXXXXXGOOOOOXXXXXXXXXXXXXXGOOXXXXXXXXXXXXXXXXXGOOOOOOXXXXXXXXXXXXXGOOOOOOOOOXXXXXXXXXX,0,300,0

45675,70,0,70,3,227,0,0,229,228,1,GOOOXXXXXXXXXXXXXXXXGOOOOOXXXXXXXXXXXXXXGOOOOOOOXXXXXXXXXXXXGOXXXXXXXXXXXXXXXXXXGOOOOOOOOOOXXXXXXXXXGOXXXXXXXXXXXXXXXXXXGOOOXXXXXXXXXXXXXXXXGOOXXXXXXXXXXXXXXXXXGOOOXXXXXXXXXXXXXXXXGOOOOOXXXXXXXXXXXXXXGOOXXXXXXXXXXXXXXXXXGOOOOOOXXXXXXXXXXXXXGOOOOOOOOOXXXXXXXXXX,0,300,0
45696,70,0,70,3,227,0,0,229,228,1,GOOOXXXXXXXXXXXXXXXXGOOOOOXXXXXXXXXXXXXXGOOOOOOOXXXXXXXXXXXXGOXXXXXXXXXXXXXXXXXXGOOOOOOOOOOXXXXXXXXXGOXXXXXXXXXXXXXXXXXXGOOOXXXXXXXXXXXXXXXXGOOXXXXXXXXXXXXXXXXXGOOOXXXXXXXXXXXXXXXXGOOOOOXXXXXXXXXXXXXXGOOXXXXXXXXXXXXXXXXXGOOOOOOXXXXXXXXXXXXXGOOOOOOOOOXXXXXXXXXX,0,300,0
45717,70,0,70,3,227,0,0,229,227,2,GOOOXXXXXXXXXXXXXXXXGOOOOOXXXXXXXXXXXXXXGOOOOOOOXXXXXXXXXXXXGOXXXXXXXXXXXXXXXXXXGOOOOOOOOOOXXXXXXXXXGOXXXXXXXXXXXXXXXXXXGOOOXXXXXXXXXXXXXXXXGOOXXXXXXXXXXXXXXXXXGOOOXXXXXXXXXXXXXXXXGOOOOOXXXXXXXXXXXXXXGOOXXXXXXXXXXXXXXXXXGOOOOOOXXXXXXXXXXXXXGOOOOOOOOOXXXXXXXXXX,0,300,0
45738,70,0,70,3,227,0,0,229,227,2,GOOOXXXXXXXXXXXXXXXXGOOOOOXXXXXXXXXXXXXXGOOOOOOOXXXXXXXXXXXXGOXXXXXXXXXXXXXXXXXXGOOOOOOOOOOXXXXXXXXXGOXXXXXXXXXXXXXXXXXXGOOOXXXXXXXXXXXXXXXXGOOXXXXXXXXXXXXXXXXXGOOOXXXXXXXXXXXXXXXXGOOOOOXXXXXXXXXXXXXXGOOXXXXXXXXXXXXXXXXXGOOOOOOXXXXXXXXXXXXXGOOOOOOOOOXXXXXXXXXX,0,300,0
45759,70,0,70,2,228,0,0,230,228,2,GOOOXXXXXXXXXXXXXXXXGOOOOOXXXXXXXXXXXXXXGOOOOOOOXXXXXXXXXXXXGOXXXXXXXXXXXXXXXXXXGOOOOOOOOOOXXXXXXXXXGOXXXXXXXXXXXXXXXXXXGOOOXXXXXXXXXXXXXXXXGOOXXXXXXXXXXXXXXXXXGOOOXXXXXXXXXXXXXXXXGOOOOOXXXXXXXXXXXXXXGOOXXXXXXXXXXXXXXXXXGOOOOOOXXXXXXXXXXXXXGOOOOOOOOOXXXXXXXXXX,0,300,0

45780,70,0,70,2,228,0,0,230,228,2,GOOOXXXXXXXXXXXXXXXXGOOOOOXXXXXXXXXXXXXXGOOOOOOOXXXXXXXXXXXXGOXXXXXXXXXXXXXXXXXXGOOOOOOOOOOXXXXXXXXXGOXXXXXXXXXXXXXXXXXXGOOOXXXXXXXXXXXXXXXXGOOXXXXXXXXXXXXXXXXXGOOOXXXXXXXXXXXXXXXXGOOOOOXXXXXXXXXXXXXXGOOXXXXXXXXXXXXXXXXXGOOOOOOXXXXXXXXXXXXXGOOOOOOOOOXXXXXXXXXX,0,300,0
45801,70,0,70,2,228,0,0,230,228,2,GOOOXXXXXXXXXXXXXXXXGOOOOOXXXXXXXXXXXXXXGOOOOOOOXXXXXXXXXXXXGOXXXXXXXXXXXXXXXXXXGOOOOOOOOOOXXXXXXXXXGOXXXXXXXXXXXXXXXXXXGOOOXXXXXXXXXXXXXXXXGOOXXXXXXXXXXXXXXXXXGOOOXXXXXXXXXXXXXXXXGOOOOOXXXXXXXXXXXXXXGOOXXXXXXXXXXXXXXXXXGOOOOOOXXXXXXXXXXXXXGOOOOOOOOOXXXXXXXXXX,0,300,0
45822,70,0,70,3,227,0,0,229,227,2,GOOOXXXXXXXXXXXXXXXXGOOOOOXXXXXXXXXXXXXXGOOOOOOOXXXXXXXXXXXXGOXXXXXXXXXXXXXXXXXXGOOOOOOOOOOXXXXXXXXXGOXXXXXXXXXXXXXXXXXXGOOOXXXXXXXXXXXXXXXXGOOXXXXXXXXXXXXXXXXXGOOOXXXXXXXXXXXXXXXXGOOOOOXXXXXXXXXXXXXXGOOXXXXXXXXXXXXXXXXXGOOOOOOXXXXXXXXXXXXXGOOOOOOOOOXXXXXXXXXX,0,300,0
45843,70,0,70,3,227,0,0,229,227,2,GOOOXXXXXXXXXXXXXXXXGOOOOOXXXXXXXXXXXXXXGOOOOOOOXXXXXXXXXXXXGOXXXXXXXXXXXXXXXXXXGOOOOOOOOOOXXXXXXXXXGOXXXXXXXXXXXXXXXXXXGOOOXXXXXXXXXXXXXXXXGOOXXXXXXXXXXXXXXXXXGOOOXXXXXXXXXXXXXXXXGOOOOOXXXXXXXXXXXXXXGOOXXXXXXXXXXXXXXXXXGOOOOOOXXXXXXXXXXXXXGOOOOOOOOOXXXXXXXXXX,0,300,0
45864,70,0,70,2,228,0,0,230,227,3,GOOOXXXXXXXXXXXXXXXXGOOOOOXXXXXXXXXXXXXXGOOOOOOOXXXXXXXXXXXXGOXXXXXXXXXXXXXXXXXXGOOOOOOOOOOXXXXXXXXXGOXXXXXXXXXXXXXXXXXXGOOOXXXXXXXXXXXXXXXXGOOXXXXXXXXXXXXXXXXXGOOOXXXXXXXXXXXXXXXXGOOOOOXXXXXXXXXXXXXXGOOXXXXXXXXXXXXXXXXXGOOOOOOXXXXXXXXXXXXXGOOOOOOOOOXXXXXXXXXX,0,300,0

45885,70,0,70,2,228,0,0,230,227,3,GOOOXXXXXXXXXXXXXXXXGOOOOOXXXXXXXXXXXXXXGOOOOOOOXXXXXXXXXXXXGOXXXXXXXXXXXXXXXXXXGOOOOOOOOOOXXXXXXXXXGOXXXXXXXXXXXXXXXXXXGOOOXXXXXXXXXXXXXXXXGOOXXXXXXXXXXXXXXXXXGOOOXXXXXXXXXXXXXXXXGOOOOOXXXXXXXXXXXXXXGOOXXXXXXXXXXXXXXXXXGOOOOOOXXXXXXXXXXXXXGOOOOOOOOOXXXXXXXXXX,0,300,0
45906,70,0,70,2,228,0,0,230,227,3,GOOOXXXXXXXXXXXXXXXXGOOOOOXXXXXXXXXXXXXXGOOOOOOOXXXXXXXXXXXXGOXXXXXXXXXXXXXXXXXXGOOOOOOOOOOXXXXXXXXXGOXXXXXXXXXXXXXXXXXXGOOOXXXXXXXXXXXXXXXXGOOXXXXXXXXXXXXXXXXXGOOOXXXXXXXXXXXXXXXXGOOOOOXXXXXXXXXXXXXXGOOXXXXXXXXXXXXXXXXXGOOOOOOXXXXXXXXXXXXXGOOOOOOOOOXXXXXXXXXX,0,300,0
45927,70,0,70,2,228,0,0,230,227,3,GOOOXXXXXXXXXXXXXXXXGOOOOOXXXXXXXXXXXXXXGOOOOOOOXXXXXXXXXXXXGOXXXXXXXXXXXXXXXXXXGOOOOOOOOOOXXXXXXXXXGOXXXXXXXXXXXXXXXXXXGOOOXXXXXXXXXXXXXXXXGOOXXXXXXXXXXXXXXXXXGOOOXXXXXXXXXXXXXXXXGOOOOOXXXXXXXXXXXXXXGOOXXXXXXXXXXXXXXXXXGOOOOOOXXXXXXXXXXXXXGOOOOOOOOOXXXXXXXXXX,0,300,0
45948,70,0,70,1,229,0,0,231,227,4,GOOOXXXXXXXXXXXXXXXXGOOOOOXXXXXXXXXXXXXXGOOOOOOOXXXXXXXXXXXXGOXXXXXXXXXXXXXXXXXXGOOOOOOOOOOXXXXXXXXXGOXXXXXXXXXXXXXXXXXXGOOOXXXXXXXXXXXXXXXXGOOXXXXXXXXXXXXXXXXXGOOOXXXXXXXXXXXXXXXXGOOOOOXXXXXXXXXXXXXXGOOXXXXXXXXXXXXXXXXXGOOOOOOXXXXXXXXXXXXXGOOOOOOOOOXXXXXXXXXX,0,300,0
45969,70,0,70,1,229,0,0,231,227,4,GOOOXXXXXXXXXXXXXXXXGOOOOOXXXXXXXXXXXXXXGOOOOOOOXXXXXXXXXXXXGOXXXXXXXXXXXXXXXXXXGOOOOOOOOOOXXXXXXXXXGOXXXXXXXXXXXXXXXXXXGOOOXXXXXXXXXXXXXXXXGOOXXXXXXXXXXXXXXXXXGOOOXXXXXXXXXXXXXXXXGOOOOOXXXXXXXXXXXXXXGOOXXXXXXXXXXXXXXXXXGOOOOOOXXXXXXXXXXXXXGOOOOOOOOOXXXXXXXXXX,0,300,0

45990,70,0,70,1,229,0,0,231,228,3,GOOOXXXXXXXXXXXXXXXXGOOOOOXXXXXXXXXXXXXXGOOOOOOOXXXXXXXXXXXXGOXXXXXXXXXXXXXXXXXXGOOOOOOOOOOXXXXXXXXXGOXXXXXXXXXXXXXXXXXXGOOOXXXXXXXXXXXXXXXXGOOXXXXXXXXXXXXXXXXXGOOOXXXXXXXXXXXXXXXXGOOOOOXXXXXXXXXXXXXXGOOXXXXXXXXXXXXXXXXXGOOOOOOXXXXXXXXXXXXXGOOOOOOOOOXXXXXXXXXX,0,300,0
46011,70,0,70,2,228,0,0,230,227,3,GOOOXXXXXXXXXXXXXXXXGOOOOOXXXXXXXXXXXXXXGOOOOOOOXXXXXXXXXXXXGOXXXXXXXXXXXXXXXXXXGOOOOOOOOOOXXXXXXXXXGOXXXXXXXXXXXXXXXXXXGOOOXXXXXXXXXXXXXXXXGOOXXXXXXXXXXXXXXXXXGOOOXXXXXXXXXXXXXXXXGOOOOOXXXXXXXXXXXXXXGOOXXXXXXXXXXXXXXXXXGOOOOOOXXXXXXXXXXXXXGOOOOOOOOOXXXXXXXXXX,0,300,0
46032,70,0,70,2,228,0,0,230,227,3,GOOOXXXXXXXXXXXXXXXXGOOOOOXXXXXXXXXXXXXXGOOOOOOOXXXXXXXXXXXXGOXXXXXXXXXXXXXXXXXXGOOOOOOOOOOXXXXXXXXXGOXXXXXXXXXXXXXXXXXXGOOOXXXXXXXXXXXXXXXXGOOXXXXXXXXXXXXXXXXXGOOOXXXXXXXXXXXXXXXXGOOOOOXXXXXXXXXXXXXXGOOXXXXXXXXXXXXXXXXXGOOOOOOXXXXXXXXXXXXXGOOOOOOOOOXXXXXXXXXX,0,300,0
46053,70,0,70,3,227,0,0,229,227,2,GOOOXXXXXXXXXXXXXXXXGOOOOOXXXXXXXXXXXXXXGOOOOOOOXXXXXXXXXXXXGOXXXXXXXXXXXXXXXXXXGOOOOOOOOOOXXXXXXXXXGOXXXXXXXXXXXXXXXXXXGOOOXXXXXXXXXXXXXXXXGOOXXXXXXXXXXXXXXXXXGOOOXXXXXXXXXXXXXXXXGOOOOOXXXXXXXXXXXXXXGOOXXXXXXXXXXXXXXXXXGOOOOOOXXXXXXXXXXXXXGOOOOOOOOOXXXXXXXXXX,0,300,0
46074,70,0,70,2,228,0,0,230,227,3,GOOOXXXXXXXXXXXXXXXXGOOOOOXXXXXXXXXXXXXXGOOOOOOOXXXXXXXXXXXXGOXXXXXXXXXXXXXXXXXXGOOOOOOOOOOXXXXXXXXXGOXXXXXXXXXXXXXXXXXXGOOOXXXXXXXXXXXXXXXXGOOXXXXXXXXXXXXXXXXXGOOOXXXXXXXXXXXXXXXXGOOOOOXXXXXXXXXXXXXXGOOXXXXXXXXXXXXXXXXXGOOOOOOXXXXXXXXXXXXXGOOOOOOOOOXXXXXXXXXX,0,300,0

46095,70,0,70,2,228,0,0,230,227,3,GOOOXXXXXXXXXXXXXXXXGOOOOOXXXXXXXXXXXXXXGOOOOOOOXXXXXXXXXXXXGOXXXXXXXXXXXXXXXXXXGOOOOOOOOOOXXXXXXXXXGOXXXXXXXXXXXXXXXXXXGOOOXXXXXXXXXXXXXXXXGOOXXXXXXXXXXXXXXXXXGOOOXXXXXXXXXXXXXXXXGOOOOOXXXXXXXXXXXXXXGOOXXXXXXXXXXXXXXXXXGOOOOOOXXXXXXXXXXXXXGOOOOOOOOOXXXXXXXXXX,0,300,0
46116,70,0,70,1,229,0,0,231,227,4,GOOOXXXXXXXXXXXXXXXXGOOOOOXXXXXXXXXXXXXXGOOOOOOOXXXXXXXXXXXXGOXXXXXXXXXXXXXXXXXXGOOOOOOOOOOXXXXXXXXXGOXXXXXXXXXXXXXXXXXXGOOOXXXXXXXXXXXXXXXXGOOXXXXXXXXXXXXXXXXXGOOOXXXXXXXXXXXXXXXXGOOOOOXXXXXXXXXXXXXXGOOXXXXXXXXXXXXXXXXXGOOOOOOXXXXXXXXXXXXXGOOOOOOOOOXXXXXXXXXX,0,300,0
46137,70,0,70,1,229,0,0,231,227,4,GOOOXXXXXXXXXXXXXXXXGOOOOOXXXXXXXXXXXXXXGOOOOOOOXXXXXXXXXXXXGOXXXXXXXXXXXXXXXXXXGOOOOOOOOOOXXXXXXXXXGOXXXXXXXXXXXXXXXXXXGOOOXXXXXXXXXXXXXXXXGOOXXXXXXXXXXXXXXXXXGOOOXXXXXXXXXXXXXXXXGOOOOOXXXXXXXXXXXXXXGOOXXXXXXXXXXXXXXXXXGOOOOOOXXXXXXXXXXXXXGOOOOOOOOOXXXXXXXXXX,0,300,0
46158,70,0,70,1,229,0,0,231,227,4,GOOOXXXXXXXXXXXXXXXXGOOOOOXXXXXXXXXXXXXXGOOOOOOOXXXXXXXXXXXXGOXXXXXXXXXXXXXXXXXXGOOOOOOOOOOXXXXXXXXXGOXXXXXXXXXXXXXXXXXXGOOOXXXXXXXXXXXXXXXXGOOXXXXXXXXXXXXXXXXXGOOOXXXXXXXXXXXXXXXXGOOOOOXXXXXXXXXXXXXXGOOXXXXXXXXXXXXXXXXXGOOOOOOXXXXXXXXXXXXXGOOOOOOOOOXXXXXXXXXX,0,300,0
46179,70,0,70,2,228,0,0,230,227,3,GOOOXXXXXXXXXXXXXXXXGOOOOOXXXXXXXXXXXXXXGOOOOOOOXXXXXXXXXXXXGOXXXXXXXXXXXXXXXXXXGOOOOOOOOOOXXXXXXXXXGOXXXXXXXXXXXXXXXXXXGOOOXXXXXXXXXXXXXXXXGOOXXXXXXXXXXXXXXXXXGOOOXXXXXXXXXXXXXXXXGOOOOOXXXXXXXXXXXXXXGOOXXXXXXXXXXXXXXXXXGOOOOOOXXXXXXXXXXXXXGOOOOOOOOOXXXXXXXXXX,0,300,0

46200,70,0,70,1,229,0,0,231,227,4,GOOOXXXXXXXXXXXXXXXXGOOOOOXXXXXXXXXXXXXXGOOOOOOOXXXXXXXXXXXXGOXXXXXXXXXXXXXXXXXXGOOOOOOOOOOXXXXXXXXXGOXXXXXXXXXXXXXXXXXXGOOOXXXXXXXXXXXXXXXXGOOXXXXXXXXXXXXXXXXXGOOOXXXXXXXXXXXXXXXXGOOOOOXXXXXXXXXXXXXXGOOXXXXXXXXXXXXXXXXXGOOOOOOXXXXXXXXXXXXXGOOOOOOOOOXXXXXXXXXX,0,300,0
46221,70,0,70,1,229,0,0,231,228,3,GOOOXXXXXXXXXXXXXXXXGOOOOOXXXXXXXXXXXXXXGOOOOOOOXXXXXXXXXXXXGOXXXXXXXXXXXXXXXXXXGOOOOOOOOOOXXXXXXXXXGOXXXXXXXXXXXXXXXXXXGOOOXXXXXXXXXXXXXXXXGOOXXXXXXXXXXXXXXXXXGOOOXXXXXXXXXXXXXXXXGOOOOOXXXXXXXXXXXXXXGOOXXXXXXXXXXXXXXXXXGOOOOOOXXXXXXXXXXXXXGOOOOOOOOOXXXXXXXXXX,0,300,0
46242,70,0,70,2,228,0,0,230,227,3,GOOOXXXXXXXXXXXXXXXXGOOOOOXXXXXXXXXXXXXXGOOOOOOOXXXXXXXXXXXXGOXXXXXXXXXXXXXXXXXXGOOOOOOOOOOXXXXXXXXXGOXXXXXXXXXXXXXXXXXXGOOOXXXXXXXXXXXXXXXXGOOXXXXXXXXXXXXXXXXXGOOOXXXXXXXXXXXXXXXXGOOOOOXXXXXXXXXXXXXXGOOXXXXXXXXXXXXXXXXXGOOOOOOXXXXXXXXXXXXXGOOOOOOOOOXXXXXXXXXX,0,300,0
46263,70,0,70,1,229,0,0,231,227,4,GOOOXXXXXXXXXXXXXXXXGOOOOOXXXXXXXXXXXXXXGOOOOOOOXXXXXXXXXXXXGOXXXXXXXXXXXXXXXXXXGOOOOOOOOOOXXXXXXXXXGOXXXXXXXXXXXXXXXXXXGOOOXXXXXXXXXXXXXXXXGOOXXXXXXXXXXXXXXXXXGOOOXXXXXXXXXXXXXXXXGOOOOOXXXXXXXXXXXXXXGOOXXXXXXXXXXXXXXXXXGOOOOOOXXXXXXXXXXXXXGOOOOOOOOOXXXXXXXXXX,0,300,0
46284,70,0,70,1,229,0,0,231,227,4,GOOOXXXXXXXXXXXXXXXXGOOOOOXXXXXXXXXXXXXXGOOOOOOOXXXXXXXXXXXXGOXXXXXXXXXXXXXXXXXXGOOOOOOOOOOXXXXXXXXXGOXXXXXXXXXXXXXXXXXXGOOOXXXXXXXXXXXXXXXXGOOXXXXXXXXXXXXXXXXXGOOOXXXXXXXXXXXXXXXXGOOOOOXXXXXXXXXXXXXXGOOXXXXXXXXXXXXXXXXXGOOOOOOXXXXXXXXXXXXXGOOOOOOOOOXXXXXXXXXX,0,300,0

46305,70,0,70,1,229,0,0,231,227,4,GOOOXXXXXXXXXXXXXXXXGOOOOOXXXXXXXXXXXXXXGOOOOOOOXXXXXXXXXXXXGOXXXXXXXXXXXXXXXXXXGOOOOOOOOOOXXXXXXXXXGOXXXXXXXXXXXXXXXXXXGOOOXXXXXXXXXXXXXXXXGOOXXXXXXXXXXXXXXXXXGOOOXXXXXXXXXXXXXXXXGOOOOOXXXXXXXXXXXXXXGOOXXXXXXXXXXXXXXXXXGOOOOOOXXXXXXXXXXXXXGOOOOOOOOOXXXXXXXXXX,0,300,0
46326,70,0,70,1,229,0,0,231,227,4,GOOOXXXXXXXXXXXXXXXXGOOOOOXXXXXXXXXXXXXXGOOOOOOOXXXXXXXXXXXXGOXXXXXXXXXXXXXXXXXXGOOOOOOOOOOXXXXXXXXXGOXXXXXXXXXXXXXXXXXXGOOOXXXXXXXXXXXXXXXXGOOXXXXXXXXXXXXXXXXXGOOOXXXXXXXXXXXXXXXXGOOOOOXXXXXXXXXXXXXXGOOXXXXXXXXXXXXXXXXXGOOOOOOXXXXXXXXXXXXXGOOOOOOOOOXXXXXXXXXX,0,300,0
46347,70,0,70,1,229,0,0,231,227,4,GOOOXXXXXXXXXXXXXXXXGOOOOOXXXXXXXXXXXXXXGOOOOOOOXXXXXXXXXXXXGOXXXXXXXXXXXXXXXXXXGOOOOOOOOOOXXXXXXXXXGOXXXXXXXXXXXXXXXXXXGOOOXXXXXXXXXXXXXXXXGOOXXXXXXXXXXXXXXXXXGOOOXXXXXXXXXXXXXXXXGOOOOOXXXXXXXXXXXXXXGOOXXXXXXXXXXXXXXXXXGOOOOOOXXXXXXXXXXXXXGOOOOOOOOOXXXXXXXXXX,0,300,0
46368,70,0,70,1,229,0,0,231,227,4,GOOOXXXXXXXXXXXXXXXXGOOOOOXXXXXXXXXXXXXXGOOOOOOOXXXXXXXXXXXXGOXXXXXXXXXXXXXXXXXXGOOOOOOOOOOXXXXXXXXXGOXXXXXXXXXXXXXXXXXXGOOOXXXXXXXXXXXXXXXXGOOXXXXXXXXXXXXXXXXXGOOOXXXXXXXXXXXXXXXXGOOOOOXXXXXXXXXXXXXXGOOXXXXXXXXXXXXXXXXXGOOOOOOXXXXXXXXXXXXXGOOOOOOOOOXXXXXXXXXX,0,300,0
46389,70,0,70,1,229,0,0,231,227,4,GOOOXXXXXXXXXXXXXXXXGOOOOOXXXXXXXXXXXXXXGOOOOOOOXXXXXXXXXXXXGOXXXXXXXXXXXXXXXXXXGOOOOOOOOOOXXXXXXXXXGOXXXXXXXXXXXXXXXXXXGOOOXXXXXXXXXXXXXXXXGOOXXXXXXXXXXXXXXXXXGOOOXXXXXXXXXXXXXXXXGOOOOOXXXXXXXXXXXXXXGOOXXXXXXXXXXXXXXXXXGOOOOOOXXXXXXXXXXXXXGOOOOOOOOOXXXXXXXXXX,0,300,0

46410,70,0,70,1,229,0,0,231,227,4,GOOOXXXXXXXXXXXXXXXXGOOOOOXXXXXXXXXXXXXXGOOOOOOOXXXXXXXXXXXXGOXXXXXXXXXXXXXXXXXXGOOOOOOOOOOXXXXXXXXXGOXXXXXXXXXXXXXXXXXXGOOOXXXXXXXXXXXXXXXXGOOXXXXXXXXXXXXXXXXXGOOOXXXXXXXXXXXXXXXXGOOOOOXXXXXXXXXXXXXXGOOXXXXXXXXXXXXXXXXXGOOOOOOXXXXXXXXXXXXXGOOOOOOOOOXXXXXXXXXX,0,300,0
46431,70,0,70,0,230,0,0,232,227,5,GOOOXXXXXXXXXXXXXXXXGOOOOOXXXXXXXXXXXXXXGOOOOOOOXXXXXXXXXXXXGOXXXXXXXXXXXXXXXXXXGOOOOOOOOOOXXXXXXXXXGOXXXXXXXXXXXXXXXXXXGOOOXXXXXXXXXXXXXXXXGOOXXXXXXXXXXXXXXXXXGOOOXXXXXXXXXXXXXXXXGOOOOOXXXXXXXXXXXXXXGOOXXXXXXXXXXXXXXXXXGOOOOOOXXXXXXXXXXXXXGOOOOOOOOOXXXXXXXXXX,0,300,0
46452,70,0,70,0,230,0,0,232,228,4,GOOOXXXXXXXXXXXXXXXXGOOOOOXXXXXXXXXXXXXXGOOOOOOOXXXXXXXXXXXXGOXXXXXXXXXXXXXXXXXXGOOOOOOOOOOXXXXXXXXXGOXXXXXXXXXXXXXXXXXXGOOOXXXXXXXXXXXXXXXXGOOXXXXXXXXXXXXXXXXXGOOOXXXXXXXXXXXXXXXXGOOOOOXXXXXXXXXXXXXXGOOXXXXXXXXXXXXXXXXXGOOOOOOXXXXXXXXXXXXXGOOOOOOOOOXXXXXXXXXX,0,300,0
46473,70,0,70,1,229,0,0,231,227,4,GOOOXXXXXXXXXXXXXXXXGOOOOOXXXXXXXXXXXXXXGOOOOOOOXXXXXXXXXXXXGOXXXXXXXXXXXXXXXXXXGOOOOOOOOOOXXXXXXXXXGOXXXXXXXXXXXXXXXXXXGOOOXXXXXXXXXXXXXXXXGOOXXXXXXXXXXXXXXXXXGOOOXXXXXXXXXXXXXXXXGOOOOOXXXXXXXXXXXXXXGOOXXXXXXXXXXXXXXXXXGOOOOOOXXXXXXXXXXXXXGOOOOOOOOOXXXXXXXXXX,0,300,0
46494,70,0,70,1,229,0,0,231,227,4,GOOOXXXXXXXXXXXXXXXXGOOOOOXXXXXXXXXXXXXXGOOOOOOOXXXXXXXXXXXXGOXXXXXXXXXXXXXXXXXXGOOOOOOOOOOXXXXXXXXXGOXXXXXXXXXXXXXXXXXXGOOOXXXXXXXXXXXXXXXXGOOXXXXXXXXXXXXXXXXXGOOOXXXXXXXXXXXXXXXXGOOOOOXXXXXXXXXXXXXXGOOXXXXXXXXXXXXXXXXXGOOOOOOXXXXXXXXXXXXXGOOOOOOOOOXXXXXXXXXX,0,300,0

46515,70,0,70,0,230,0,0,232,227,5,GOOOXXXXXXXXXXXXXXXXGOOOOOXXXXXXXXXXXXXXGOOOOOOOXXXXXXXXXXXXGOXXXXXXXXXXXXXXXXXXGOOOOOOOOOOXXXXXXXXXGOXXXXXXXXXXXXXXXXXXGOOOXXXXXXXXXXXXXXXXGOOXXXXXXXXXXXXXXXXXGOOOXXXXXXXXXXXXXXXXGOOOOOXXXXXXXXXXXXXXGOOXXXXXXXXXXXXXXXXXGOOOOOOXXXXXXXXXXXXXGOOOOOOOOOXXXXXXXXXX,0,300,0
46536,70,0,70,0,230,0,0,232,228,4,GOOOXXXXXXXXXXXXXXXXGOOOOOXXXXXXXXXXXXXXGOOOOOOOXXXXXXXXXXXXGOXXXXXXXXXXXXXXXXXXGOOOOOOOOOOXXXXXXXXXGOXXXXXXXXXXXXXXXXXXGOOOXXXXXXXXXXXXXXXXGOOXXXXXXXXXXXXXXXXXGOOOXXXXXXXXXXXXXXXXGOOOOOXXXXXXXXXXXXXXGOOXXXXXXXXXXXXXXXXXGOOOOOOXXXXXXXXXXXXXGOOOOOOOOOXXXXXXXXXX,0,300,0
46557,70,0,70,1,229,0,0,231,227,4,GOOOXXXXXXXXXXXXXXXXGOOOOOXXXXXXXXXXXXXXGOOOOOOOXXXXXXXXXXXXGOXXXXXXXXXXXXXXXXXXGOOOOOOOOOOXXXXXXXXXGOXXXXXXXXXXXXXXXXXXGOOOXXXXXXXXXXXXXXXXGOOXXXXXXXXXXXXXXXXXGOOOXXXXXXXXXXXXXXXXGOOOOOXXXXXXXXXXXXXXGOOXXXXXXXXXXXXXXXXXGOOOOOOXXXXXXXXXXXXXGOOOOOOOOOXXXXXXXXXX,0,300,0
46578,70,0,70,1,229,0,0,231,227,4,GOOOXXXXXXXXXXXXXXXXGOOOOOXXXXXXXXXXXXXXGOOOOOOOXXXXXXXXXXXXGOXXXXXXXXXXXXXXXXXXGOOOOOOOOOOXXXXXXXXXGOXXXXXXXXXXXXXXXXXXGOOOXXXXXXXXXXXXXXXXGOOXXXXXXXXXXXXXXXXXGOOOXXXXXXXXXXXXXXXXGOOOOOXXXXXXXXXXXXXXGOOXXXXXXXXXXXXXXXXXGOOOOOOXXXXXXXXXXXXXGOOOOOOOOOXXXXXXXXXX,0,300,0
46599,70,0,70,1,229,0,0,231,227,4,GOOOXXXXXXXXXXXXXXXXGOOOOOXXXXXXXXXXXXXXGOOOOOOOXXXXXXXXXXXXGOXXXXXXXXXXXXXXXXXXGOOOOOOOOOOXXXXXXXXXGOXXXXXXXXXXXXXXXXXXGOOOXXXXXXXXXXXXXXXXGOOXXXXXXXXXXXXXXXXXGOOOXXXXXXXXXXXXXXXXGOOOOOXXXXXXXXXXXXXXGOOXXXXXXXXXXXXXXXXXGOOOOOOXXXXXXXXXXXXXGOOOOOOOOOXXXXXXXXXX,0,300,0

46620,70,0,70,0,230,0,0,232,227,5,GOOOXXXXXXXXXXXXXXXXGOOOOOXXXXXXXXXXXXXXGOOOOOOOXXXXXXXXXXXXGOXXXXXXXXXXXXXXXXXXGOOOOOOOOOOXXXXXXXXXGOXXXXXXXXXXXXXXXXXXGOOOXXXXXXXXXXXXXXXXGOOXXXXXXXXXXXXXXXXXGOOOXXXXXXXXXXXXXXXXGOOOOOXXXXXXXXXXXXXXGOOXXXXXXXXXXXXXXXXXGOOOOOOXXXXXXXXXXXXXGOOOOOOOOOXXXXXXXXXX,0,300,0
46641,70,0,70,1,229,0,0,231,227,4,GOOOXXXXXXXXXXXXXXXXGOOOOOXXXXXXXXXXXXXXGOOOOOOOXXXXXXXXXXXXGOXXXXXXXXXXXXXXXXXXGOOOOOOOOOOXXXXXXXXXGOXXXXXXXXXXXXXXXXXXGOOOXXXXXXXXXXXXXXXXGOOXXXXXXXXXXXXXXXXXGOOOXXXXXXXXXXXXXXXXGOOOOOXXXXXXXXXXXXXXGOOXXXXXXXXXXXXXXXXXGOOOOOOXXXXXXXXXXXXXGOOOOOOOOOXXXXXXXXXX,0,300,0
46662,70,0,70,2,228,0,0,230,227,3,GOOOXXXXXXXXXXXXXXXXGOOOOOXXXXXXXXXXXXXXGOOOOOOOXXXXXXXXXXXXGOXXXXXXXXXXXXXXXXXXGOOOOOOOOOOXXXXXXXXXGOXXXXXXXXXXXXXXXXXXGOOOXXXXXXXXXXXXXXXXGOOXXXXXXXXXXXXXXXXXGOOOXXXXXXXXXXXXXXXXGOOOOOXXXXXXXXXXXXXXGOOXXXXXXXXXXXXXXXXXGOOOOOOXXXXXXXXXXXXXGOOOOOOOOOXXXXXXXXXX,0,300,0
46683,70,0,70,2,228,0,0,230,227,3,GOOOXXXXXXXXXXXXXXXXGOOOOOXXXXXXXXXXXXXXGOOOOOOOXXXXXXXXXXXXGOXXXXXXXXXXXXXXXXXXGOOOOOOOOOOXXXXXXXXXGOXXXXXXXXXXXXXXXXXXGOOOXXXXXXXXXXXXXXXXGOOXXXXXXXXXXXXXXXXXGOOOXXXXXXXXXXXXXXXXGOOOOOXXXXXXXXXXXXXXGOOXXXXXXXXXXXXXXXXXGOOOOOOXXXXXXXXXXXXXGOOOOOOOOOXXXXXXXXXX,0,300,0
46704,70,0,70,2,228,0,0,230,227,3,GOOOXXXXXXXXXXXXXXXXGOOOOOXXXXXXXXXXXXXXGOOOOOOOXXXXXXXXXXXXGOXXXXXXXXXXXXXXXXXXGOOOOOOOOOOXXXXXXXXXGOXXXXXXXXXXXXXXXXXXGOOOXXXXXXXXXXXXXXXXGOOXXXXXXXXXXXXXXXXXGOOOXXXXXXXXXXXXXXXXGOOOOOXXXXXXXXXXXXXXGOOXXXXXXXXXXXXXXXXXGOOOOOOXXXXXXXXXXXXXGOOOOOOOOOXXXXXXXXXX,0,300,0

46725,70,0,70,2,228,0,0,230,227,3,GOOOXXXXXXXXXXXXXXXXGOOOOOXXXXXXXXXXXXXXGOOOOOOOXXXXXXXXXXXXGOXXXXXXXXXXXXXXXXXXGOOOOOOOOOOXXXXXXXXXGOXXXXXXXXXXXXXXXXXXGOOOXXXXXXXXXXXXXXXXGOOXXXXXXXXXXXXXXXXXGOOOXXXXXXXXXXXXXXXXGOOOOOXXXXXXXXXXXXXXGOOXXXXXXXXXXXXXXXXXGOOOOOOXXXXXXXXXXXXXGOOOOOOOOOXXXXXXXXXX,0,300,0
46746,70,0,70,2,228,0,0,230,227,3,GOOOXXXXXXXXXXXXXXXXGOOOOOXXXXXXXXXXXXXXGOOOOOOOXXXXXXXXXXXXGOXXXXXXXXXXXXXXXXXXGOOOOOOOOOOXXXXXXXXXGOXXXXXXXXXXXXXXXXXXGOOOXXXXXXXXXXXXXXXXGOOXXXXXXXXXXXXXXXXXGOOOXXXXXXXXXXXXXXXXGOOOOOXXXXXXXXXXXXXXGOOXXXXXXXXXXXXXXXXXGOOOOOOXXXXXXXXXXXXXGOOOOOOOOOXXXXXXXXXX,0,300,0
46767,70,0,70,2,228,0,0,230,227,3,GOOOXXXXXXXXXXXXXXXXGOOOOOXXXXXXXXXXXXXXGOOOOOOOXXXXXXXXXXXXGOXXXXXXXXXXXXXXXXXXGOOOOOOOOOOXXXXXXXXXGOXXXXXXXXXXXXXXXXXXGOOOXXXXXXXXXXXXXXXXGOOXXXXXXXXXXXXXXXXXGOOOXXXXXXXXXXXXXXXXGOOOOOXXXXXXXXXXXXXXGOOXXXXXXXXXXXXXXXXXGOOOOOOXXXXXXXXXXXXXGOOOOOOOOOXXXXXXXXXX,0,300,0
46788,70,0,70,2,228,0,0,230,228,2,GOOOXXXXXXXXXXXXXXXXGOOOOOXXXXXXXXXXXXXXGOOOOOOOXXXXXXXXXXXXGOXXXXXXXXXXXXXXXXXXGOOOOOOOOOOXXXXXXXXXGOXXXXXXXXXXXXXXXXXXGOOOXXXXXXXXXXXXXXXXGOOXXXXXXXXXXXXXXXXXGOOOXXXXXXXXXXXXXXXXGOOOOOXXXXXXXXXXXXXXGOOXXXXXXXXXXXXXXXXXGOOOOOOXXXXXXXXXXXXXGOOOOOOOOOXXXXXXXXXX,0,300,0
46809,70,0,70,3,227,0,0,229,227,2,GOOOXXXXXXXXXXXXXXXXGOOOOOXXXXXXXXXXXXXXGOOOOOOOXXXXXXXXXXXXGOXXXXXXXXXXXXXXXXXXGOOOOOOOOOOXXXXXXXXXGOXXXXXXXXXXXXXXXXXXGOOOXXXXXXXXXXXXXXXXGOOXXXXXXXXXXXXXXXXXGOOOXXXXXXXXXXXXXXXXGOOOOOXXXXXXXXXXXXXXGOOXXXXXXXXXXXXXXXXXGOOOOOOXXXXXXXXXXXXXGOOOOOOOOOXXXXXXXXXX,0,300,0

46830,70,0,70,3,227,0,0,229,227,2,GOOOXXXXXXXXXXXXXXXXGOOOOOXXXXXXXXXXXXXXGOOOOOOOXXXXXXXXXXXXGOXXXXXXXXXXXXXXXXXXGOOOOOOOOOOXXXXXXXXXGOXXXXXXXXXXXXXXXXXXGOOOXXXXXXXXXXXXXXXXGOOXXXXXXXXXXXXXXXXXGOOOXXXXXXXXXXXXXXXXGOOOOOXXXXXXXXXXXXXXGOOXXXXXXXXXXXXXXXXXGOOOOOOXXXXXXXXXXXXXGOOOOOOOOOXXXXXXXXXX,0,300,0
46851,70,0,70,3,227,0,0,229,228,1,GOOOXXXXXXXXXXXXXXXXGOOOOOXXXXXXXXXXXXXXGOOOOOOOXXXXXXXXXXXXGOXXXXXXXXXXXXXXXXXXGOOOOOOOOOOXXXXXXXXXGOXXXXXXXXXXXXXXXXXXGOOOXXXXXXXXXXXXXXXXGOOXXXXXXXXXXXXXXXXXGOOOXXXXXXXXXXXXXXXXGOOOOOXXXXXXXXXXXXXXGOOXXXXXXXXXXXXXXXXXGOOOOOOXXXXXXXXXXXXXGOOOOOOOOOXXXXXXXXXX,0,300,0
46872,70,0,70,3,227,0,0,229,227,2,GOOOXXXXXXXXXXXXXXXXGOOOOOXXXXXXXXXXXXXXGOOOOOOOXXXXXXXXXXXXGOXXXXXXXXXXXXXXXXXXGOOOOOOOOOOXXXXXXXXXGOXXXXXXXXXXXXXXXXXXGOOOXXXXXXXXXXXXXXXXGOOXXXXXXXXXXXXXXXXXGOOOXXXXXXXXXXXXXXXXGOOOOOXXXXXXXXXXXXXXGOOXXXXXXXXXXXXXXXXXGOOOOOOXXXXXXXXXXXXXGOOOOOOOOOXXXXXXXXXX,0,300,0
46893,70,0,70,2,228,0,0,230,227,3,GOOOXXXXXXXXXXXXXXXXGOOOOOXXXXXXXXXXXXXXGOOOOOOOXXXXXXXXXXXXGOXXXXXXXXXXXXXXXXXXGOOOOOOOOOOXXXXXXXXXGOXXXXXXXXXXXXXXXXXXGOOOXXXXXXXXXXXXXXXXGOOXXXXXXXXXXXXXXXXXGOOOXXXXXXXXXXXXXXXXGOOOOOXXXXXXXXXXXXXXGOOXXXXXXXXXXXXXXXXXGOOOOOOXXXXXXXXXXXXXGOOOOOOOOOXXXXXXXXXX,0,300,0
46914,70,0,70,2,228,0,0,230,227,3,GOOOXXXXXXXXXXXXXXXXGOOOOOXXXXXXXXXXXXXXGOOOOOOOXXXXXXXXXXXXGOXXXXXXXXXXXXXXXXXXGOOOOOOOOOOXXXXXXXXXGOXXXXXXXXXXXXXXXXXXGOOOXXXXXXXXXXXXXXXXGOOXXXXXXXXXXXXXXXXXGOOOXXXXXXXXXXXXXXXXGOOOOOXXXXXXXXXXXXXXGOOXXXXXXXXXXXXXXXXXGOOOOOOXXXXXXXXXXXXXGOOOOOOOOOXXXXXXXXXX,0,300,0

46935,70,0,70,2,228,0,0,230,227,3,GOOOXXXXXXXXXXXXXXXXGOOOOOXXXXXXXXXXXXXXGOOOOOOOXXXXXXXXXXXXGOXXXXXXXXXXXXXXXXXXGOOOOOOOOOOXXXXXXXXXGOXXXXXXXXXXXXXXXXXXGOOOXXXXXXXXXXXXXXXXGOOXXXXXXXXXXXXXXXXXGOOOXXXXXXXXXXXXXXXXGOOOOOXXXXXXXXXXXXXXGOOXXXXXXXXXXXXXXXXXGOOOOOOXXXXXXXXXXXXXGOOOOOOOOOXXXXXXXXXX,0,300,0
46956,70,0,70,3,227,0,0,229,227,2,GOOOXXXXXXXXXXXXXXXXGOOOOOXXXXXXXXXXXXXXGOOOOOOOXXXXXXXXXXXXGOXXXXXXXXXXXXXXXXXXGOOOOOOOOOOXXXXXXXXXGOXXXXXXXXXXXXXXXXXXGOOOXXXXXXXXXXXXXXXXGOOXXXXXXXXXXXXXXXXXGOOOXXXXXXXXXXXXXXXXGOOOOOXXXXXXXXXXXXXXGOOXXXXXXXXXXXXXXXXXGOOOOOOXXXXXXXXXXXXXGOOOOOOOOOXXXXXXXXXX,0,300,0
46977,70,0,70,2,228,0,0,230,227,3,GOOOXXXXXXXXXXXXXXXXGOOOOOXXXXXXXXXXXXXXGOOOOOOOXXXXXXXXXXXXGOXXXXXXXXXXXXXXXXXXGOOOOOOOOOOXXXXXXXXXGOXXXXXXXXXXXXXXXXXXGOOOXXXXXXXXXXXXXXXXGOOXXXXXXXXXXXXXXXXXGOOOXXXXXXXXXXXXXXXXGOOOOOXXXXXXXXXXXXXXGOOXXXXXXXXXXXXXXXXXGOOOOOOXXXXXXXXXXXXXGOOOOOOOOOXXXXXXXXXX,0,300,0
46998,70,0,70,2,228,0,0,230,227,3,GOOOXXXXXXXXXXXXXXXXGOOOOOXXXXXXXXXXXXXXGOOOOOOOXXXXXXXXXXXXGOXXXXXXXXXXXXXXXXXXGOOOOOOOOOOXXXXXXXXXGOXXXXXXXXXXXXXXXXXXGOOOXXXXXXXXXXXXXXXXGOOXXXXXXXXXXXXXXXXXGOOOXXXXXXXXXXXXXXXXGOOOOOXXXXXXXXXXXXXXGOOXXXXXXXXXXXXXXXXXGOOOOOOXXXXXXXXXXXXXGOOOOOOOOOXXXXXXXXXX,0,300,0
47019,70,0,70,2,228,0,0,230,227,3,GOOOXXXXXXXXXXXXXXXXGOOOOOXXXXXXXXXXXXXXGOOOOOOOXXXXXXXXXXXXGOXXXXXXXXXXXXXXXXXXGOOOOOOOOOOXXXXXXXXXGOXXXXXXXXXXXXXXXXXXGOOOXXXXXXXXXXXXXXXXGOOXXXXXXXXXXXXXXXXXGOOOXXXXXXXXXXXXXXXXGOOOOOXXXXXXXXXXXXXXGOOXXXXXXXXXXXXXXXXXGOOOOOOXXXXXXXXXXXXXGOOOOOOOOOXXXXXXXXXX,0,300,0

47040,70,0,70,2,228,0,0,230,227,3,GOOOXXXXXXXXXXXXXXXXGOOOOOXXXXXXXXXXXXXXGOOOOOOOXXXXXXXXXXXXGOXXXXXXXXXXXXXXXXXXGOOOOOOOOOOXXXXXXXXXGOXXXXXXXXXXXXXXXXXXGOOOXXXXXXXXXXXXXXXXGOOXXXXXXXXXXXXXXXXXGOOOXXXXXXXXXXXXXXXXGOOOOOXXXXXXXXXXXXXXGOOXXXXXXXXXXXXXXXXXGOOOOOOXXXXXXXXXXXXXGOOOOOOOOOXXXXXXXXXX,0,300,0
47061,70,0,70,2,228,0,0,230,227,3,GOOOXXXXXXXXXXXXXXXXGOOOOOXXXXXXXXXXXXXXGOOOOOOOXXXXXXXXXXXXGOXXXXXXXXXXXXXXXXXXGOOOOOOOOOOXXXXXXXXXGOXXXXXXXXXXXXXXXXXXGOOOXXXXXXXXXXXXXXXXGOOXXXXXXXXXXXXXXXXXGOOOXXXXXXXXXXXXXXXXGOOOOOXXXXXXXXXXXXXXGOOXXXXXXXXXXXXXXXXXGOOOOOOXXXXXXXXXXXXXGOOOOOOOOOXXXXXXXXXX,0,300,0
47082,70,0,70,2,228,0,0,230,227,3,GOOOXXXXXXXXXXXXXXXXGOOOOOXXXXXXXXXXXXXXGOOOOOOOXXXXXXXXXXXXGOXXXXXXXXXXXXXXXXXXGOOOOOOOOOOXXXXXXXXXGOXXXXXXXXXXXXXXXXXXGOOOXXXXXXXXXXXXXXXXGOOXXXXXXXXXXXXXXXXXGOOOXXXXXXXXXXXXXXXXGOOOOOXXXXXXXXXXXXXXGOOXXXXXXXXXXXXXXXXXGOOOOOOXXXXXXXXXXXXXGOOOOOOOOOXXXXXXXXXX,0,300,0
47103,70,0,70,2,228,0,0,230,227,3,GOOOXXXXXXXXXXXXXXXXGOOOOOXXXXXXXXXXXXXXGOOOOOOOXXXXXXXXXXXXGOXXXXXXXXXXXXXXXXXXGOOOOOOOOOOXXXXXXXXXGOXXXXXXXXXXXXXXXXXXGOOOXXXXXXXXXXXXXXXXGOOXXXXXXXXXXXXXXXXXGOOOXXXXXXXXXXXXXXXXGOOOOOXXXXXXXXXXXXXXGOOXXXXXXXXXXXXXXXXXGOOOOOOXXXXXXXXXXXXXGOOOOOOOOOXXXXXXXXXX,0,300,0
47124,70,0,70,2,228,0,0,230,227,3,GOOOXXXXXXXXXXXXXXXXGOOOOOXXXXXXXXXXXXXXGOOOOOOOXXXXXXXXXXXXGOXXXXXXXXXXXXXXXXXXGOOOOOOOOOOXXXXXXXXXGOXXXXXXXXXXXXXXXXXXGOOOXXXXXXXXXXXXXXXXGOOXXXXXXXXXXXXXXXXXGOOOXXXXXXXXXXXXXXXXGOOOOOXXXXXXXXXXXXXXGOOXXXXXXXXXXXXXXXXXGOOOOOOXXXXXXXXXXXXXGOOOOOOOOOXXXXXXXXXX,0,300,0

47145,70,0,70,1,229,0,0,231,227,4,GOOOXXXXXXXXXXXXXXXXGOOOOOXXXXXXXXXXXXXXGOOOOOOOXXXXXXXXXXXXGOXXXXXXXXXXXXXXXXXXGOOOOOOOOOOXXXXXXXXXGOXXXXXXXXXXXXXXXXXXGOOOXXXXXXXXXXXXXXXXGOOXXXXXXXXXXXXXXXXXGOOOXXXXXXXXXXXXXXXXGOOOOOXXXXXXXXXXXXXXGOOXXXXXXXXXXXXXXXXXGOOOOOOXXXXXXXXXXXXXGOOOOOOOOOXXXXXXXXXX,0,300,0
47166,70,0,70,0,230,0,0,232,227,5,GOOOXXXXXXXXXXXXXXXXGOOOOOXXXXXXXXXXXXXXGOOOOOOOXXXXXXXXXXXXGOXXXXXXXXXXXXXXXXXXGOOOOOOOOOOXXXXXXXXXGOXXXXXXXXXXXXXXXXXXGOOOXXXXXXXXXXXXXXXXGOOXXXXXXXXXXXXXXXXXGOOOXXXXXXXXXXXXXXXXGOOOOOXXXXXXXXXXXXXXGOOXXXXXXXXXXXXXXXXXGOOOOOOXXXXXXXXXXXXXGOOOOOOOOOXXXXXXXXXX,0,300,0
47187,70,0,70,1,229,0,0,231,227,4,GOOOXXXXXXXXXXXXXXXXGOOOOOXXXXXXXXXXXXXXGOOOOOOOXXXXXXXXXXXXGOXXXXXXXXXXXXXXXXXXGOOOOOOOOOOXXXXXXXXXGOXXXXXXXXXXXXXXXXXXGOOOXXXXXXXXXXXXXXXXGOOXXXXXXXXXXXXXXXXXGOOOXXXXXXXXXXXXXXXXGOOOOOXXXXXXXXXXXXXXGOOXXXXXXXXXXXXXXXXXGOOOOOOXXXXXXXXXXXXXGOOOOOOOOOXXXXXXXXXX,0,300,0
47208,70,0,70,1,229,0,0,231,227,4,GOOOXXXXXXXXXXXXXXXXGOOOOOXXXXXXXXXXXXXXGOOOOOOOXXXXXXXXXXXXGOXXXXXXXXXXXXXXXXXXGOOOOOOOOOOXXXXXXXXXGOXXXXXXXXXXXXXXXXXXGOOOXXXXXXXXXXXXXXXXGOOXXXXXXXXXXXXXXXXXGOOOXXXXXXXXXXXXXXXXGOOOOOXXXXXXXXXXXXXXGOOXXXXXXXXXXXXXXXXXGOOOOOOXXXXXXXXXXXXXGOOOOOOOOOXXXXXXXXXX,0,300,0
47229,70,0,70,1,229,0,0,231,228,3,GOOOXXXXXXXXXXXXXXXXGOOOOOXXXXXXXXXXXXXXGOOOOOOOXXXXXXXXXXXXGOXXXXXXXXXXXXXXXXXXGOOOOOOOOOOXXXXXXXXXGOXXXXXXXXXXXXXXXXXXGOOOXXXXXXXXXXXXXXXXGOOXXXXXXXXXXXXXXXXXGOOOXXXXXXXXXXXXXXXXGOOOOOXXXXXXXXXXXXXXGOOXXXXXXXXXXXXXXXXXGOOOOOOXXXXXXXXXXXXXGOOOOOOOOOXXXXXXXXXX,0,300,0

47250,70,0,70,2,228,0,0,230,227,3,GOOOXXXXXXXXXXXXXXXXGOOOOOXXXXXXXXXXXXXXGOOOOOOOXXXXXXXXXXXXGOXXXXXXXXXXXXXXXXXXGOOOOOOOOOOXXXXXXXXXGOXXXXXXXXXXXXXXXXXXGOOOXXXXXXXXXXXXXXXXGOOXXXXXXXXXXXXXXXXXGOOOXXXXXXXXXXXXXXXXGOOOOOXXXXXXXXXXXXXXGOOXXXXXXXXXXXXXXXXXGOOOOOOXXXXXXXXXXXXXGOOOOOOOOOXXXXXXXXXX,0,300,0
47271,70,0,70,2,228,0,0,230,227,3,GOOOXXXXXXXXXXXXXXXXGOOOOOXXXXXXXXXXXXXXGOOOOOOOXXXXXXXXXXXXGOXXXXXXXXXXXXXXXXXXGOOOOOOOOOOXXXXXXXXXGOXXXXXXXXXXXXXXXXXXGOOOXXXXXXXXXXXXXXXXGOOXXXXXXXXXXXXXXXXXGOOOXXXXXXXXXXXXXXXXGOOOOOXXXXXXXXXXXXXXGOOXXXXXXXXXXXXXXXXXGOOOOOOXXXXXXXXXXXXXGOOOOOOOOOXXXXXXXXXX,0,300,0
47292,70,0,70,2,228,0,0,230,227,3,GOOOXXXXXXXXXXXXXXXXGOOOOOXXXXXXXXXXXXXXGOOOOOOOXXXXXXXXXXXXGOXXXXXXXXXXXXXXXXXXGOOOOOOOOOOXXXXXXXXXGOXXXXXXXXXXXXXXXXXXGOOOXXXXXXXXXXXXXXXXGOOXXXXXXXXXXXXXXXXXGOOOXXXXXXXXXXXXXXXXGOOOOOXXXXXXXXXXXXXXGOOXXXXXXXXXXXXXXXXXGOOOOOOXXXXXXXXXXXXXGOOOOOOOOOXXXXXXXXXX,0,300,0
47313,70,0,70,2,228,0,0,230,227,3,GOOOXXXXXXXXXXXXXXXXGOOOOOXXXXXXXXXXXXXXGOOOOOOOXXXXXXXXXXXXGOXXXXXXXXXXXXXXXXXXGOOOOOOOOOOXXXXXXXXXGOXXXXXXXXXXXXXXXXXXGOOOXXXXXXXXXXXXXXXXGOOXXXXXXXXXXXXXXXXXGOOOXXXXXXXXXXXXXXXXGOOOOOXXXXXXXXXXXXXXGOOXXXXXXXXXXXXXXXXXGOOOOOOXXXXXXXXXXXXXGOOOOOOOOOXXXXXXXXXX,0,300,0
47334,70,0,70,2,228,0,0,230,227,3,GOOOXXXXXXXXXXXXXXXXGOOOOOXXXXXXXXXXXXXXGOOOOOOOXXXXXXXXXXXXGOXXXXXXXXXXXXXXXXXXGOOOOOOOOOOXXXXXXXXXGOXXXXXXXXXXXXXXXXXXGOOOXXXXXXXXXXXXXXXXGOOXXXXXXXXXXXXXXXXXGOOOXXXXXXXXXXXXXXXXGOOOOOXXXXXXXXXXXXXXGOOXXXXXXXXXXXXXXXXXGOOOOOOXXXXXXXXXXXXXGOOOOOOOOOXXXXXXXXXX,0,300,0

47355,70,0,70,2,228,0,0,230,227,3,GOOOXXXXXXXXXXXXXXXXGOOOOOXXXXXXXXXXXXXXGOOOOOOOXXXXXXXXXXXXGOXXXXXXXXXXXXXXXXXXGOOOOOOOOOOXXXXXXXXXGOXXXXXXXXXXXXXXXXXXGOOOXXXXXXXXXXXXXXXXGOOXXXXXXXXXXXXXXXXXGOOOXXXXXXXXXXXXXXXXGOOOOOXXXXXXXXXXXXXXGOOXXXXXXXXXXXXXXXXXGOOOOOOXXXXXXXXXXXXXGOOOOOOOOOXXXXXXXXXX,0,300,0
47376,70,0,70,2,228,0,0,230,227,3,GOOOXXXXXXXXXXXXXXXXGOOOOOXXXXXXXXXXXXXXGOOOOOOOXXXXXXXXXXXXGOXXXXXXXXXXXXXXXXXXGOOOOOOOOOOXXXXXXXXXGOXXXXXXXXXXXXXXXXXXGOOOXXXXXXXXXXXXXXXXGOOXXXXXXXXXXXXXXXXXGOOOXXXXXXXXXXXXXXXXGOOOOOXXXXXXXXXXXXXXGOOXXXXXXXXXXXXXXXXXGOOOOOOXXXXXXXXXXXXXGOOOOOOOOOXXXXXXXXXX,0,300,0
47397,70,0,70,1,229,0,0,231,227,4,GOOOXXXXXXXXXXXXXXXXGOOOOOXXXXXXXXXXXXXXGOOOOOOOXXXXXXXXXXXXGOXXXXXXXXXXXXXXXXXXGOOOOOOOOOOXXXXXXXXXGOXXXXXXXXXXXXXXXXXXGOOOXXXXXXXXXXXXXXXXGOOXXXXXXXXXXXXXXXXXGOOOXXXXXXXXXXXXXXXXGOOOOOXXXXXXXXXXXXXXGOOXXXXXXXXXXXXXXXXXGOOOOOOXXXXXXXXXXXXXGOOOOOOOOOXXXXXXXXXX,0,300,0
47418,70,0,70,1,229,0,0,231,227,4,GOOOXXXXXXXXXXXXXXXXGOOOOOXXXXXXXXXXXXXXGOOOOOOOXXXXXXXXXXXXGOXXXXXXXXXXXXXXXXXXGOOOOOOOOOOXXXXXXXXXGOXXXXXXXXXXXXXXXXXXGOOOXXXXXXXXXXXXXXXXGOOXXXXXXXXXXXXXXXXXGOOOXXXXXXXXXXXXXXXXGOOOOOXXXXXXXXXXXXXXGOOXXXXXXXXXXXXXXXXXGOOOOOOXXXXXXXXXXXXXGOOOOOOOOOXXXXXXXXXX,0,300,0
47439,70,0,70,1,229,0,0,231,228,3,GOOOXXXXXXXXXXXXXXXXGOOOOOXXXXXXXXXXXXXXGOOOOOOOXXXXXXXXXXXXGOXXXXXXXXXXXXXXXXXXGOOOOOOOOOOXXXXXXXXXGOXXXXXXXXXXXXXXXXXXGOOOXXXXXXXXXXXXXXXXGOOXXXXXXXXXXXXXXXXXGOOOXXXXXXXXXXXXXXXXGOOOOOXXXXXXXXXXXXXXGOOXXXXXXXXXXXXXXXXXGOOOOOOXXXXXXXXXXXXXGOOOOOOOOOXXXXXXXXXX,0,300,0

47460,70,0,70,1,229,0,0,231,228,3,GOOOXXXXXXXXXXXXXXXXGOOOOOXXXXXXXXXXXXXXGOOOOOOOXXXXXXXXXXXXGOXXXXXXXXXXXXXXXXXXGOOOOOOOOOOXXXXXXXXXGOXXXXXXXXXXXXXXXXXXGOOOXXXXXXXXXXXXXXXXGOOXXXXXXXXXXXXXXXXXGOOOXXXXXXXXXXXXXXXXGOOOOOXXXXXXXXXXXXXXGOOXXXXXXXXXXXXXXXXXGOOOOOOXXXXXXXXXXXXXGOOOOOOOOOXXXXXXXXXX,0,300,0
47481,70,0,70,1,229,0,0,231,228,3,GOOOXXXXXXXXXXXXXXXXGOOOOOXXXXXXXXXXXXXXGOOOOOOOXXXXXXXXXXXXGOXXXXXXXXXXXXXXXXXXGOOOOOOOOOOXXXXXXXXXGOXXXXXXXXXXXXXXXXXXGOOOXXXXXXXXXXXXXXXXGOOXXXXXXXXXXXXXXXXXGOOOXXXXXXXXXXXXXXXXGOOOOOXXXXXXXXXXXXXXGOOXXXXXXXXXXXXXXXXXGOOOOOOXXXXXXXXXXXXXGOOOOOOOOOXXXXXXXXXX,0,300,0
47502,70,0,70,2,228,0,0,230,227,3,GOOOXXXXXXXXXXXXXXXXGOOOOOXXXXXXXXXXXXXXGOOOOOOOXXXXXXXXXXXXGOXXXXXXXXXXXXXXXXXXGOOOOOOOOOOXXXXXXXXXGOXXXXXXXXXXXXXXXXXXGOOOXXXXXXXXXXXXXXXXGOOXXXXXXXXXXXXXXXXXGOOOXXXXXXXXXXXXXXXXGOOOOOXXXXXXXXXXXXXXGOOXXXXXXXXXXXXXXXXXGOOOOOOXXXXXXXXXXXXXGOOOOOOOOOXXXXXXXXXX,0,300,0
47523,70,0,70,2,228,0,0,230,227,3,GOOOXXXXXXXXXXXXXXXXGOOOOOXXXXXXXXXXXXXXGOOOOOOOXXXXXXXXXXXXGOXXXXXXXXXXXXXXXXXXGOOOOOOOOOOXXXXXXXXXGOXXXXXXXXXXXXXXXXXXGOOOXXXXXXXXXXXXXXXXGOOXXXXXXXXXXXXXXXXXGOOOXXXXXXXXXXXXXXXXGOOOOOXXXXXXXXXXXXXXGOOXXXXXXXXXXXXXXXXXGOOOOOOXXXXXXXXXXXXXGOOOOOOOOOXXXXXXXXXX,0,300,0
47544,70,0,70,3,227,0,0,229,227,2,GOOOXXXXXXXXXXXXXXXXGOOOOOXXXXXXXXXXXXXXGOOOOOOOXXXXXXXXXXXXGOXXXXXXXXXXXXXXXXXXGOOOOOOOOOOXXXXXXXXXGOXXXXXXXXXXXXXXXXXXGOOOXXXXXXXXXXXXXXXXGOOXXXXXXXXXXXXXXXXXGOOOXXXXXXXXXXXXXXXXGOOOOOXXXXXXXXXXXXXXGOOXXXXXXXXXXXXXXXXXGOOOOOOXXXXXXXXXXXXXGOOOOOOOOOXXXXXXXXXX,0,300,0

47565,70,0,70,2,228,0,0,230,228,2,GOOOXXXXXXXXXXXXXXXXGOOOOOXXXXXXXXXXXXXXGOOOOOOOXXXXXXXXXXXXGOXXXXXXXXXXXXXXXXXXGOOOOOOOOOOXXXXXXXXXGOXXXXXXXXXXXXXXXXXXGOOOXXXXXXXXXXXXXXXXGOOXXXXXXXXXXXXXXXXXGOOOXXXXXXXXXXXXXXXXGOOOOOXXXXXXXXXXXXXXGOOXXXXXXXXXXXXXXXXXGOOOOOOXXXXXXXXXXXXXGOOOOOOOOOXXXXXXXXXX,0,300,0
47586,70,0,70,3,227,0,0,229,227,2,GOOOXXXXXXXXXXXXXXXXGOOOOOXXXXXXXXXXXXXXGOOOOOOOXXXXXXXXXXXXGOXXXXXXXXXXXXXXXXXXGOOOOOOOOOOXXXXXXXXXGOXXXXXXXXXXXXXXXXXXGOOOXXXXXXXXXXXXXXXXGOOXXXXXXXXXXXXXXXXXGOOOXXXXXXXXXXXXXXXXGOOOOOXXXXXXXXXXXXXXGOOXXXXXXXXXXXXXXXXXGOOOOOOXXXXXXXXXXXXXGOOOOOOOOOXXXXXXXXXX,0,300,0
47607,70,0,70,0,230,0,0,232,227,5,GOOOXXXXXXXXXXXXXXXXGOOOOOXXXXXXXXXXXXXXGOOOOOOOXXXXXXXXXXXXGOXXXXXXXXXXXXXXXXXXGOOOOOOOOOOXXXXXXXXXGOXXXXXXXXXXXXXXXXXXGOOOXXXXXXXXXXXXXXXXGOOXXXXXXXXXXXXXXXXXGOOOXXXXXXXXXXXXXXXXGOOOOOXXXXXXXXXXXXXXGOOXXXXXXXXXXXXXXXXXGOOOOOOXXXXXXXXXXXXXGOOOOOOOOOXXXXXXXXXX,0,300,0
47628,70,0,70,0,230,0,0,232,227,5,GOOOXXXXXXXXXXXXXXXXGOOOOOXXXXXXXXXXXXXXGOOOOOOOXXXXXXXXXXXXGOXXXXXXXXXXXXXXXXXXGOOOOOOOOOOXXXXXXXXXGOXXXXXXXXXXXXXXXXXXGOOOXXXXXXXXXXXXXXXXGOOXXXXXXXXXXXXXXXXXGOOOXXXXXXXXXXXXXXXXGOOOOOXXXXXXXXXXXXXXGOOXXXXXXXXXXXXXXXXXGOOOOOOXXXXXXXXXXXXXGOOOOOOOOOXXXXXXXXXX,0,300,0
47649,70,0,70,0,230,0,0,232,227,5,GOOOXXXXXXXXXXXXXXXXGOOOOOXXXXXXXXXXXXXXGOOOOOOOXXXXXXXXXXXXGOXXXXXXXXXXXXXXXXXXGOOOOOOOOOOXXXXXXXXXGOXXXXXXXXXXXXXXXXXXGOOOXXXXXXXXXXXXXXXXGOOXXXXXXXXXXXXXXXXXGOOOXXXXXXXXXXXXXXXXGOOOOOXXXXXXXXXXXXXXGOOXXXXXXXXXXXXXXXXXGOOOOOOXXXXXXXXXXXXXGOOOOOOOOOXXXXXXXXXX,0,300,0

47670,70,0,70,0,230,0,0,232,227,5,GOOOXXXXXXXXXXXXXXXXGOOOOOXXXXXXXXXXXXXXGOOOOOOOXXXXXXXXXXXXGOXXXXXXXXXXXXXXXXXXGOOOOOOOOOOXXXXXXXXXGOXXXXXXXXXXXXXXXXXXGOOOXXXXXXXXXXXXXXXXGOOXXXXXXXXXXXXXXXXXGOOOXXXXXXXXXXXXXXXXGOOOOOXXXXXXXXXXXXXXGOOXXXXXXXXXXXXXXXXXGOOOOOOXXXXXXXXXXXXXGOOOOOOOOOXXXXXXXXXX,0,300,0
47691,70,0,70,0,230,0,0,232,227,5,GOOOXXXXXXXXXXXXXXXXGOOOOOXXXXXXXXXXXXXXGOOOOOOOXXXXXXXXXXXXGOXXXXXXXXXXXXXXXXXXGOOOOOOOOOOXXXXXXXXXGOXXXXXXXXXXXXXXXXXXGOOOXXXXXXXXXXXXXXXXGOOXXXXXXXXXXXXXXXXXGOOOXXXXXXXXXXXXXXXXGOOOOOXXXXXXXXXXXXXXGOOXXXXXXXXXXXXXXXXXGOOOOOOXXXXXXXXXXXXXGOOOOOOOOOXXXXXXXXXX,0,300,0
47712,70,0,70,0,230,0,0,232,227,5,GOOOXXXXXXXXXXXXXXXXGOOOOOXXXXXXXXXXXXXXGOOOOOOOXXXXXXXXXXXXGOXXXXXXXXXXXXXXXXXXGOOOOOOOOOOXXXXXXXXXGOXXXXXXXXXXXXXXXXXXGOOOXXXXXXXXXXXXXXXXGOOXXXXXXXXXXXXXXXXXGOOOXXXXXXXXXXXXXXXXGOOOOOXXXXXXXXXXXXXXGOOXXXXXXXXXXXXXXXXXGOOOOOOXXXXXXXXXXXXXGOOOOOOOOOXXXXXXXXXX,0,300,0
47733,70,0,70,0,230,0,0,232,227,5,GOOOXXXXXXXXXXXXXXXXGOOOOOXXXXXXXXXXXXXXGOOOOOOOXXXXXXXXXXXXGOXXXXXXXXXXXXXXXXXXGOOOOOOOOOOXXXXXXXXXGOXXXXXXXXXXXXXXXXXXGOOOXXXXXXXXXXXXXXXXGOOXXXXXXXXXXXXXXXXXGOOOXXXXXXXXXXXXXXXXGOOOOOXXXXXXXXXXXXXXGOOXXXXXXXXXXXXXXXXXGOOOOOOXXXXXXXXXXXXXGOOOOOOOOOXXXXXXXXXX,0,300,0
47754,70,0,70,0,230,0,0,232,227,5,GOOOXXXXXXXXXXXXXXXXGOOOOOXXXXXXXXXXXXXXGOOOOOOOXXXXXXXXXXXXGOXXXXXXXXXXXXXXXXXXGOOOOOOOOOOXXXXXXXXXGOXXXXXXXXXXXXXXXXXXGOOOXXXXXXXXXXXXXXXXGOOXXXXXXXXXXXXXXXXXGOOOXXXXXXXXXXXXXXXXGOOOOOXXXXXXXXXXXXXXGOOXXXXXXXXXXXXXXXXXGOOOOOOXXXXXXXXXXXXXGOOOOOOOOOXXXXXXXXXX,0,300,0

47775,70,0,70,0,230,0,0,232,227,5,GOOOXXXXXXXXXXXXXXXXGOOOOOXXXXXXXXXXXXXXGOOOOOOOXXXXXXXXXXXXGOXXXXXXXXXXXXXXXXXXGOOOOOOOOOOXXXXXXXXXGOXXXXXXXXXXXXXXXXXXGOOOXXXXXXXXXXXXXXXXGOOXXXXXXXXXXXXXXXXXGOOOXXXXXXXXXXXXXXXXGOOOOOXXXXXXXXXXXXXXGOOXXXXXXXXXXXXXXXXXGOOOOOOXXXXXXXXXXXXXGOOOOOOOOOXXXXXXXXXX,0,300,0
47796,70,0,70,0,230,0,0,232,227,5,GOOOXXXXXXXXXXXXXXXXGOOOOOXXXXXXXXXXXXXXGOOOOOOOXXXXXXXXXXXXGOXXXXXXXXXXXXXXXXXXGOOOOOOOOOOXXXXXXXXXGOXXXXXXXXXXXXXXXXXXGOOOXXXXXXXXXXXXXXXXGOOXXXXXXXXXXXXXXXXXGOOOXXXXXXXXXXXXXXXXGOOOOOXXXXXXXXXXXXXXGOOXXXXXXXXXXXXXXXXXGOOOOOOXXXXXXXXXXXXXGOOOOOOOOOXXXXXXXXXX,0,300,0
47817,70,0,70,1,229,0,0,231,228,3,GOOOXXXXXXXXXXXXXXXXGOOOOOXXXXXXXXXXXXXXGOOOOOOOXXXXXXXXXXXXGOXXXXXXXXXXXXXXXXXXGOOOOOOOOOOXXXXXXXXXGOXXXXXXXXXXXXXXXXXXGOOOXXXXXXXXXXXXXXXXGOOXXXXXXXXXXXXXXXXXGOOOXXXXXXXXXXXXXXXXGOOOOOXXXXXXXXXXXXXXGOOXXXXXXXXXXXXXXXXXGOOOOOOXXXXXXXXXXXXXGOOOOOOOOOXXXXXXXXXX,0,300,0
47838,70,0,70,2,228,0,0,230,227,3,GOOOXXXXXXXXXXXXXXXXGOOOOOXXXXXXXXXXXXXXGOOOOOOOXXXXXXXXXXXXGOXXXXXXXXXXXXXXXXXXGOOOOOOOOOOXXXXXXXXXGOXXXXXXXXXXXXXXXXXXGOOOXXXXXXXXXXXXXXXXGOOXXXXXXXXXXXXXXXXXGOOOXXXXXXXXXXXXXXXXGOOOOOXXXXXXXXXXXXXXGOOXXXXXXXXXXXXXXXXXGOOOOOOXXXXXXXXXXXXXGOOOOOOOOOXXXXXXXXXX,0,300,0
47859,70,0,70,2,228,0,0,230,228,2,GOOOXXXXXXXXXXXXXXXXGOOOOOXXXXXXXXXXXXXXGOOOOOOOXXXXXXXXXXXXGOXXXXXXXXXXXXXXXXXXGOOOOOOOOOOXXXXXXXXXGOXXXXXXXXXXXXXXXXXXGOOOXXXXXXXXXXXXXXXXGOOXXXXXXXXXXXXXXXXXGOOOXXXXXXXXXXXXXXXXGOOOOOXXXXXXXXXXXXXXGOOXXXXXXXXXXXXXXXXXGOOOOOOXXXXXXXXXXXXXGOOOOOOOOOXXXXXXXXXX,0,300,0

47880,70,0,70,3,227,0,0,229,227,2,GOOOXXXXXXXXXXXXXXXXGOOOOOXXXXXXXXXXXXXXGOOOOOOOXXXXXXXXXXXXGOXXXXXXXXXXXXXXXXXXGOOOOOOOOOOXXXXXXXXXGOXXXXXXXXXXXXXXXXXXGOOOXXXXXXXXXXXXXXXXGOOXXXXXXXXXXXXXXXXXGOOOXXXXXXXXXXXXXXXXGOOOOOXXXXXXXXXXXXXXGOOXXXXXXXXXXXXXXXXXGOOOOOOXXXXXXXXXXXXXGOOOOOOOOOXXXXXXXXXX,0,300,0
47901,70,0,70,3,227,0,0,229,227,2,GOOOXXXXXXXXXXXXXXXXGOOOOOXXXXXXXXXXXXXXGOOOOOOOXXXXXXXXXXXXGOXXXXXXXXXXXXXXXXXXGOOOOOOOOOOXXXXXXXXXGOXXXXXXXXXXXXXXXXXXGOOOXXXXXXXXXXXXXXXXGOOXXXXXXXXXXXXXXXXXGOOOXXXXXXXXXXXXXXXXGOOOOOXXXXXXXXXXXXXXGOOXXXXXXXXXXXXXXXXXGOOOOOOXXXXXXXXXXXXXGOOOOOOOOOXXXXXXXXXX,0,300,0
47922,70,0,70,3,227,0,0,229,227,2,GOOOXXXXXXXXXXXXXXXXGOOOOOXXXXXXXXXXXXXXGOOOOOOOXXXXXXXXXXXXGOXXXXXXXXXXXXXXXXXXGOOOOOOOOOOXXXXXXXXXGOXXXXXXXXXXXXXXXXXXGOOOXXXXXXXXXXXXXXXXGOOXXXXXXXXXXXXXXXXXGOOOXXXXXXXXXXXXXXXXGOOOOOXXXXXXXXXXXXXXGOOXXXXXXXXXXXXXXXXXGOOOOOOXXXXXXXXXXXXXGOOOOOOOOOXXXXXXXXXX,0,300,0
47943,70,0,70,3,227,0,0,229,227,2,GOOOXXXXXXXXXXXXXXXXGOOOOOXXXXXXXXXXXXXXGOOOOOOOXXXXXXXXXXXXGOXXXXXXXXXXXXXXXXXXGOOOOOOOOOOXXXXXXXXXGOXXXXXXXXXXXXXXXXXXGOOOXXXXXXXXXXXXXXXXGOOXXXXXXXXXXXXXXXXXGOOOXXXXXXXXXXXXXXXXGOOOOOXXXXXXXXXXXXXXGOOXXXXXXXXXXXXXXXXXGOOOOOOXXXXXXXXXXXXXGOOOOOOOOOXXXXXXXXXX,0,300,0
47964,70,0,70,3,227,0,0,229,227,2,GOOOXXXXXXXXXXXXXXXXGOOOOOXXXXXXXXXXXXXXGOOOOOOOXXXXXXXXXXXXGOXXXXXXXXXXXXXXXXXXGOOOOOOOOOOXXXXXXXXXGOXXXXXXXXXXXXXXXXXXGOOOXXXXXXXXXXXXXXXXGOOXXXXXXXXXXXXXXXXXGOOOXXXXXXXXXXXXXXXXGOOOOOXXXXXXXXXXXXXXGOOXXXXXXXXXXXXXXXXXGOOOOOOXXXXXXXXXXXXXGOOOOOOOOOXXXXXXXXXX,0,300,0

47985,70,0,70,3,227,0,0,229,227,2,GOOOXXXXXXXXXXXXXXXXGOOOOOXXXXXXXXXXXXXXGOOOOOOOXXXXXXXXXXXXGOXXXXXXXXXXXXXXXXXXGOOOOOOOOOOXXXXXXXXXGOXXXXXXXXXXXXXXXXXXGOOOXXXXXXXXXXXXXXXXGOOXXXXXXXXXXXXXXXXXGOOOXXXXXXXXXXXXXXXXGOOOOOXXXXXXXXXXXXXXGOOXXXXXXXXXXXXXXXXXGOOOOOOXXXXXXXXXXXXXGOOOOOOOOOXXXXXXXXXX,0,300,0
48006,70,0,70,2,228,0,0,230,227,3,GOOOXXXXXXXXXXXXXXXXGOOOOOXXXXXXXXXXXXXXGOOOOOOOXXXXXXXXXXXXGOXXXXXXXXXXXXXXXXXXGOOOOOOOOOOXXXXXXXXXGOXXXXXXXXXXXXXXXXXXGOOOXXXXXXXXXXXXXXXXGOOXXXXXXXXXXXXXXXXXGOOOXXXXXXXXXXXXXXXXGOOOOOXXXXXXXXXXXXXXGOOXXXXXXXXXXXXXXXXXGOOOOOOXXXXXXXXXXXXXGOOOOOOOOOXXXXXXXXXX,0,300,0
48027,70,0,70,2,228,0,0,230,227,3,GOOOXXXXXXXXXXXXXXXXGOOOOOXXXXXXXXXXXXXXGOOOOOOOXXXXXXXXXXXXGOXXXXXXXXXXXXXXXXXXGOOOOOOOOOOXXXXXXXXXGOXXXXXXXXXXXXXXXXXXGOOOXXXXXXXXXXXXXXXXGOOXXXXXXXXXXXXXXXXXGOOOXXXXXXXXXXXXXXXXGOOOOOXXXXXXXXXXXXXXGOOXXXXXXXXXXXXXXXXXGOOOOOOXXXXXXXXXXXXXGOOOOOOOOOXXXXXXXXXX,0,300,0
48048,70,0,70,1,229,0,0,231,227,4,GOOOXXXXXXXXXXXXXXXXGOOOOOXXXXXXXXXXXXXXGOOOOOOOXXXXXXXXXXXXGOXXXXXXXXXXXXXXXXXXGOOOOOOOOOOXXXXXXXXXGOXXXXXXXXXXXXXXXXXXGOOOXXXXXXXXXXXXXXXXGOOXXXXXXXXXXXXXXXXXGOOOXXXXXXXXXXXXXXXXGOOOOOXXXXXXXXXXXXXXGOOXXXXXXXXXXXXXXXXXGOOOOOOXXXXXXXXXXXXXGOOOOOOOOOXXXXXXXXXX,0,300,0
48069,70,0,70,1,229,0,0,231,227,4,GOOOXXXXXXXXXXXXXXXXGOOOOOXXXXXXXXXXXXXXGOOOOOOOXXXXXXXXXXXXGOXXXXXXXXXXXXXXXXXXGOOOOOOOOOOXXXXXXXXXGOXXXXXXXXXXXXXXXXXXGOOOXXXXXXXXXXXXXXXXGOOXXXXXXXXXXXXXXXXXGOOOXXXXXXXXXXXXXXXXGOOOOOXXXXXXXXXXXXXXGOOXXXXXXXXXXXXXXXXXGOOOOOOXXXXXXXXXXXXXGOOOOOOOOOXXXXXXXXXX,0,300,0

48090,70,0,70,1,229,0,0,231,227,4,GOOOXXXXXXXXXXXXXXXXGOOOOOXXXXXXXXXXXXXXGOOOOOOOXXXXXXXXXXXXGOXXXXXXXXXXXXXXXXXXGOOOOOOOOOOXXXXXXXXXGOXXXXXXXXXXXXXXXXXXGOOOXXXXXXXXXXXXXXXXGOOXXXXXXXXXXXXXXXXXGOOOXXXXXXXXXXXXXXXXGOOOOOXXXXXXXXXXXXXXGOOXXXXXXXXXXXXXXXXXGOOOOOOXXXXXXXXXXXXXGOOOOOOOOOXXXXXXXXXX,0,300,0
48111,70,0,70,1,229,0,0,231,227,4,GOOOXXXXXXXXXXXXXXXXGOOOOOXXXXXXXXXXXXXXGOOOOOOOXXXXXXXXXXXXGOXXXXXXXXXXXXXXXXXXGOOOOOOOOOOXXXXXXXXXGOXXXXXXXXXXXXXXXXXXGOOOXXXXXXXXXXXXXXXXGOOXXXXXXXXXXXXXXXXXGOOOXXXXXXXXXXXXXXXXGOOOOOXXXXXXXXXXXXXXGOOXXXXXXXXXXXXXXXXXGOOOOOOXXXXXXXXXXXXXGOOOOOOOOOXXXXXXXXXX,0,300,0
48132,70,0,70,1,229,0,0,231,227,4,GOOOXXXXXXXXXXXXXXXXGOOOOOXXXXXXXXXXXXXXGOOOOOOOXXXXXXXXXXXXGOXXXXXXXXXXXXXXXXXXGOOOOOOOOOOXXXXXXXXXGOXXXXXXXXXXXXXXXXXXGOOOXXXXXXXXXXXXXXXXGOOXXXXXXXXXXXXXXXXXGOOOXXXXXXXXXXXXXXXXGOOOOOXXXXXXXXXXXXXXGOOXXXXXXXXXXXXXXXXXGOOOOOOXXXXXXXXXXXXXGOOOOOOOOOXXXXXXXXXX,0,300,0
48153,70,0,70,1,229,0,0,231,227,4,GOOOXXXXXXXXXXXXXXXXGOOOOOXXXXXXXXXXXXXXGOOOOOOOXXXXXXXXXXXXGOXXXXXXXXXXXXXXXXXXGOOOOOOOOOOXXXXXXXXXGOXXXXXXXXXXXXXXXXXXGOOOXXXXXXXXXXXXXXXXGOOXXXXXXXXXXXXXXXXXGOOOXXXXXXXXXXXXXXXXGOOOOOXXXXXXXXXXXXXXGOOXXXXXXXXXXXXXXXXXGOOOOOOXXXXXXXXXXXXXGOOOOOOOOOXXXXXXXXXX,0,300,0
48174,70,0,70,1,229,0,0,231,227,4,GOOOXXXXXXXXXXXXXXXXGOOOOOXXXXXXXXXXXXXXGOOOOOOOXXXXXXXXXXXXGOXXXXXXXXXXXXXXXXXXGOOOOOOOOOOXXXXXXXXXGOXXXXXXXXXXXXXXXXXXGOOOXXXXXXXXXXXXXXXXGOOXXXXXXXXXXXXXXXXXGOOOXXXXXXXXXXXXXXXXGOOOOOXXXXXXXXXXXXXXGOOXXXXXXXXXXXXXXXXXGOOOOOOXXXXXXXXXXXXXGOOOOOOOOOXXXXXXXXXX,0,300,0

48195,70,0,70,1,229,0,0,232,229,3,GOOOXXXXXXXXXXXXXXXXGOOOOOXXXXXXXXXXXXXXGOOOOOOOXXXXXXXXXXXXGOXXXXXXXXXXXXXXXXXXGOOOOOOOOOOXXXXXXXXXGOXXXXXXXXXXXXXXXXXXGOOOXXXXXXXXXXXXXXXXGOOXXXXXXXXXXXXXXXXXGOOOXXXXXXXXXXXXXXXXGOOOOOXXXXXXXXXXXXXXGOOXXXXXXXXXXXXXXXXXGOOOOOOXXXXXXXXXXXXXGOOOOOOOOOXXXXXXXXXX,0,300,0
48216,70,0,70,3,227,0,0,230,227,3,GOOOXXXXXXXXXXXXXXXXGOOOOOXXXXXXXXXXXXXXGOOOOOOOXXXXXXXXXXXXGOXXXXXXXXXXXXXXXXXXGOOOOOOOOOOXXXXXXXXXGOXXXXXXXXXXXXXXXXXXGOOOXXXXXXXXXXXXXXXXGOOXXXXXXXXXXXXXXXXXGOOOXXXXXXXXXXXXXXXXGOOOOOXXXXXXXXXXXXXXGOOXXXXXXXXXXXXXXXXXGOOOOOOXXXXXXXXXXXXXGOOOOOOOOOXXXXXXXXXX,0,300,0
48237,70,0,70,3,227,0,0,230,227,3,GOOOXXXXXXXXXXXXXXXXGOOOOOXXXXXXXXXXXXXXGOOOOOOOXXXXXXXXXXXXGOXXXXXXXXXXXXXXXXXXGOOOOOOOOOOXXXXXXXXXGOXXXXXXXXXXXXXXXXXXGOOOXXXXXXXXXXXXXXXXGOOXXXXXXXXXXXXXXXXXGOOOXXXXXXXXXXXXXXXXGOOOOOXXXXXXXXXXXXXXGOOXXXXXXXXXXXXXXXXXGOOOOOOXXXXXXXXXXXXXGOOOOOOOOOXXXXXXXXXX,0,300,0
48258,70,0,70,2,228,0,0,231,227,4,GOOOXXXXXXXXXXXXXXXXGOOOOOXXXXXXXXXXXXXXGOOOOOOOXXXXXXXXXXXXGOXXXXXXXXXXXXXXXXXXGOOOOOOOOOOXXXXXXXXXGOXXXXXXXXXXXXXXXXXXGOOOXXXXXXXXXXXXXXXXGOOXXXXXXXXXXXXXXXXXGOOOXXXXXXXXXXXXXXXXGOOOOOXXXXXXXXXXXXXXGOOXXXXXXXXXXXXXXXXXGOOOOOOXXXXXXXXXXXXXGOOOOOOOOOXXXXXXXXXX,0,300,0
48279,70,0,70,2,228,0,0,231,227,4,GOOOXXXXXXXXXXXXXXXXGOOOOOXXXXXXXXXXXXXXGOOOOOOOXXXXXXXXXXXXGOXXXXXXXXXXXXXXXXXXGOOOOOOOOOOXXXXXXXXXGOXXXXXXXXXXXXXXXXXXGOOOXXXXXXXXXXXXXXXXGOOXXXXXXXXXXXXXXXXXGOOOXXXXXXXXXXXXXXXXGOOOOOXXXXXXXXXXXXXXGOOXXXXXXXXXXXXXXXXXGOOOOOOXXXXXXXXXXXXXGOOOOOOOOOXXXXXXXXXX,0,300,0

48300,70,0,70,2,228,0,0,231,227,4,GOOOXXXXXXXXXXXXXXXXGOOOOOXXXXXXXXXXXXXXGOOOOOOOXXXXXXXXXXXXGOXXXXXXXXXXXXXXXXXXGOOOOOOOOOOXXXXXXXXXGOXXXXXXXXXXXXXXXXXXGOOOXXXXXXXXXXXXXXXXGOOXXXXXXXXXXXXXXXXXGOOOXXXXXXXXXXXXXXXXGOOOOOXXXXXXXXXXXXXXGOOXXXXXXXXXXXXXXXXXGOOOOOOXXXXXXXXXXXXXGOOOOOOOOOXXXXXXXXXX,0,300,0
48321,70,0,70,2,228,0,0,231,228,3,GOOOXXXXXXXXXXXXXXXXGOOOOOXXXXXXXXXXXXXXGOOOOOOOXXXXXXXXXXXXGOXXXXXXXXXXXXXXXXXXGOOOOOOOOOOXXXXXXXXXGOXXXXXXXXXXXXXXXXXXGOOOXXXXXXXXXXXXXXXXGOOXXXXXXXXXXXXXXXXXGOOOXXXXXXXXXXXXXXXXGOOOOOXXXXXXXXXXXXXXGOOXXXXXXXXXXXXXXXXXGOOOOOOXXXXXXXXXXXXXGOOOOOOOOOXXXXXXXXXX,0,300,0
48342,70,0,70,2,228,0,0,230,227,3,GOOOXXXXXXXXXXXXXXXXGOOOOOXXXXXXXXXXXXXXGOOOOOOOXXXXXXXXXXXXGOXXXXXXXXXXXXXXXXXXGOOOOOOOOOOXXXXXXXXXGOXXXXXXXXXXXXXXXXXXGOOOXXXXXXXXXXXXXXXXGOOXXXXXXXXXXXXXXXXXGOOOXXXXXXXXXXXXXXXXGOOOOOXXXXXXXXXXXXXXGOOXXXXXXXXXXXXXXXXXGOOOOOOXXXXXXXXXXXXXGOOOOOOOOOXXXXXXXXXX,0,300,0
48363,70,0,70,2,228,0,0,230,227,3,GOOOXXXXXXXXXXXXXXXXGOOOOOXXXXXXXXXXXXXXGOOOOOOOXXXXXXXXXXXXGOXXXXXXXXXXXXXXXXXXGOOOOOOOOOOXXXXXXXXXGOXXXXXXXXXXXXXXXXXXGOOOXXXXXXXXXXXXXXXXGOOXXXXXXXXXXXXXXXXXGOOOXXXXXXXXXXXXXXXXGOOOOOXXXXXXXXXXXXXXGOOXXXXXXXXXXXXXXXXXGOOOOOOXXXXXXXXXXXXXGOOOOOOOOOXXXXXXXXXX,0,300,0
48384,70,0,70,2,228,0,0,230,227,3,GOOOXXXXXXXXXXXXXXXXGOOOOOXXXXXXXXXXXXXXGOOOOOOOXXXXXXXXXXXXGOXXXXXXXXXXXXXXXXXXGOOOOOOOOOOXXXXXXXXXGOXXXXXXXXXXXXXXXXXXGOOOXXXXXXXXXXXXXXXXGOOXXXXXXXXXXXXXXXXXGOOOXXXXXXXXXXXXXXXXGOOOOOXXXXXXXXXXXXXXGOOXXXXXXXXXXXXXXXXXGOOOOOOXXXXXXXXXXXXXGOOOOOOOOOXXXXXXXXXX,0,300,0

48405,70,0,70,2,228,0,0,230,227,3,GOOOXXXXXXXXXXXXXXXXGOOOOOXXXXXXXXXXXXXXGOOOOOOOXXXXXXXXXXXXGOXXXXXXXXXXXXXXXXXXGOOOOOOOOOOXXXXXXXXXGOXXXXXXXXXXXXXXXXXXGOOOXXXXXXXXXXXXXXXXGOOXXXXXXXXXXXXXXXXXGOOOXXXXXXXXXXXXXXXXGOOOOOXXXXXXXXXXXXXXGOOXXXXXXXXXXXXXXXXXGOOOOOOXXXXXXXXXXXXXGOOOOOOOOOXXXXXXXXXX,0,300,0
48426,70,0,70,2,228,0,0,230,227,3,GOOOXXXXXXXXXXXXXXXXGOOOOOXXXXXXXXXXXXXXGOOOOOOOXXXXXXXXXXXXGOXXXXXXXXXXXXXXXXXXGOOOOOOOOOOXXXXXXXXXGOXXXXXXXXXXXXXXXXXXGOOOXXXXXXXXXXXXXXXXGOOXXXXXXXXXXXXXXXXXGOOOXXXXXXXXXXXXXXXXGOOOOOXXXXXXXXXXXXXXGOOXXXXXXXXXXXXXXXXXGOOOOOOXXXXXXXXXXXXXGOOOOOOOOOXXXXXXXXXX,0,300,0
48447,70,0,70,2,228,0,0,230,227,3,GOOOXXXXXXXXXXXXXXXXGOOOOOXXXXXXXXXXXXXXGOOOOOOOXXXXXXXXXXXXGOXXXXXXXXXXXXXXXXXXGOOOOOOOOOOXXXXXXXXXGOXXXXXXXXXXXXXXXXXXGOOOXXXXXXXXXXXXXXXXGOOXXXXXXXXXXXXXXXXXGOOOXXXXXXXXXXXXXXXXGOOOOOXXXXXXXXXXXXXXGOOXXXXXXXXXXXXXXXXXGOOOOOOXXXXXXXXXXXXXGOOOOOOOOOXXXXXXXXXX,0,300,0
48468,70,0,70,0,230,0,0,232,228,4,GOOOXXXXXXXXXXXXXXXXGOOOOOXXXXXXXXXXXXXXGOOOOOOOXXXXXXXXXXXXGOXXXXXXXXXXXXXXXXXXGOOOOOOOOOOXXXXXXXXXGOXXXXXXXXXXXXXXXXXXGOOOXXXXXXXXXXXXXXXXGOOXXXXXXXXXXXXXXXXXGOOOXXXXXXXXXXXXXXXXGOOOOOXXXXXXXXXXXXXXGOOXXXXXXXXXXXXXXXXXGOOOOOOXXXXXXXXXXXXXGOOOOOOOOOXXXXXXXXXX,0,300,0
48489,70,0,70,0,230,0,0,232,228,4,GOOOXXXXXXXXXXXXXXXXGOOOOOXXXXXXXXXXXXXXGOOOOOOOXXXXXXXXXXXXGOXXXXXXXXXXXXXXXXXXGOOOOOOOOOOXXXXXXXXXGOXXXXXXXXXXXXXXXXXXGOOOXXXXXXXXXXXXXXXXGOOXXXXXXXXXXXXXXXXXGOOOXXXXXXXXXXXXXXXXGOOOOOXXXXXXXXXXXXXXGOOXXXXXXXXXXXXXXXXXGOOOOOOXXXXXXXXXXXXXGOOOOOOOOOXXXXXXXXXX,0,300,0

48510,70,0,70,1,229,0,0,231,227,4,GOOOXXXXXXXXXXXXXXXXGOOOOOXXXXXXXXXXXXXXGOOOOOOOXXXXXXXXXXXXGOXXXXXXXXXXXXXXXXXXGOOOOOOOOOOXXXXXXXXXGOXXXXXXXXXXXXXXXXXXGOOOXXXXXXXXXXXXXXXXGOOXXXXXXXXXXXXXXXXXGOOOXXXXXXXXXXXXXXXXGOOOOOXXXXXXXXXXXXXXGOOXXXXXXXXXXXXXXXXXGOOOOOOXXXXXXXXXXXXXGOOOOOOOOOXXXXXXXXXX,0,300,0
48531,70,0,70,1,229,0,0,231,227,4,GOOOXXXXXXXXXXXXXXXXGOOOOOXXXXXXXXXXXXXXGOOOOOOOXXXXXXXXXXXXGOXXXXXXXXXXXXXXXXXXGOOOOOOOOOOXXXXXXXXXGOXXXXXXXXXXXXXXXXXXGOOOXXXXXXXXXXXXXXXXGOOXXXXXXXXXXXXXXXXXGOOOXXXXXXXXXXXXXXXXGOOOOOXXXXXXXXXXXXXXGOOXXXXXXXXXXXXXXXXXGOOOOOOXXXXXXXXXXXXXGOOOOOOOOOXXXXXXXXXX,0,300,0
48552,70,0,70,1,229,0,0,231,227,4,GOOOXXXXXXXXXXXXXXXXGOOOOOXXXXXXXXXXXXXXGOOOOOOOXXXXXXXXXXXXGOXXXXXXXXXXXXXXXXXXGOOOOOOOOOOXXXXXXXXXGOXXXXXXXXXXXXXXXXXXGOOOXXXXXXXXXXXXXXXXGOOXXXXXXXXXXXXXXXXXGOOOXXXXXXXXXXXXXXXXGOOOOOXXXXXXXXXXXXXXGOOXXXXXXXXXXXXXXXXXGOOOOOOXXXXXXXXXXXXXGOOOOOOOOOXXXXXXXXXX,0,300,0
48573,70,0,70,2,228,0,0,230,227,3,GOOOXXXXXXXXXXXXXXXXGOOOOOXXXXXXXXXXXXXXGOOOOOOOXXXXXXXXXXXXGOXXXXXXXXXXXXXXXXXXGOOOOOOOOOOXXXXXXXXXGOXXXXXXXXXXXXXXXXXXGOOOXXXXXXXXXXXXXXXXGOOXXXXXXXXXXXXXXXXXGOOOXXXXXXXXXXXXXXXXGOOOOOXXXXXXXXXXXXXXGOOXXXXXXXXXXXXXXXXXGOOOOOOXXXXXXXXXXXXXGOOOOOOOOOXXXXXXXXXX,0,300,0
48594,70,0,70,2,228,0,0,230,227,3,GOOOXXXXXXXXXXXXXXXXGOOOOOXXXXXXXXXXXXXXGOOOOOOOXXXXXXXXXXXXGOXXXXXXXXXXXXXXXXXXGOOOOOOOOOOXXXXXXXXXGOXXXXXXXXXXXXXXXXXXGOOOXXXXXXXXXXXXXXXXGOOXXXXXXXXXXXXXXXXXGOOOXXXXXXXXXXXXXXXXGOOOOOXXXXXXXXXXXXXXGOOXXXXXXXXXXXXXXXXXGOOOOOOXXXXXXXXXXXXXGOOOOOOOOOXXXXXXXXXX,0,300,0

48615,70,0,70,2,228,0,0,230,227,3,GOOOXXXXXXXXXXXXXXXXGOOOOOXXXXXXXXXXXXXXGOOOOOOOXXXXXXXXXXXXGOXXXXXXXXXXXXXXXXXXGOOOOOOOOOOXXXXXXXXXGOXXXXXXXXXXXXXXXXXXGOOOXXXXXXXXXXXXXXXXGOOXXXXXXXXXXXXXXXXXGOOOXXXXXXXXXXXXXXXXGOOOOOXXXXXXXXXXXXXXGOOXXXXXXXXXXXXXXXXXGOOOOOOXXXXXXXXXXXXXGOOOOOOOOOXXXXXXXXXX,0,300,0
48636,70,0,70,2,228,0,0,230,227,3,GOOOXXXXXXXXXXXXXXXXGOOOOOXXXXXXXXXXXXXXGOOOOOOOXXXXXXXXXXXXGOXXXXXXXXXXXXXXXXXXGOOOOOOOOOOXXXXXXXXXGOXXXXXXXXXXXXXXXXXXGOOOXXXXXXXXXXXXXXXXGOOXXXXXXXXXXXXXXXXXGOOOXXXXXXXXXXXXXXXXGOOOOOXXXXXXXXXXXXXXGOOXXXXXXXXXXXXXXXXXGOOOOOOXXXXXXXXXXXXXGOOOOOOOOOXXXXXXXXXX,0,300,0
48657,70,0,70,1,229,0,0,231,227,4,GOOOXXXXXXXXXXXXXXXXGOOOOOXXXXXXXXXXXXXXGOOOOOOOXXXXXXXXXXXXGOXXXXXXXXXXXXXXXXXXGOOOOOOOOOOXXXXXXXXXGOXXXXXXXXXXXXXXXXXXGOOOXXXXXXXXXXXXXXXXGOOXXXXXXXXXXXXXXXXXGOOOXXXXXXXXXXXXXXXXGOOOOOXXXXXXXXXXXXXXGOOXXXXXXXXXXXXXXXXXGOOOOOOXXXXXXXXXXXXXGOOOOOOOOOXXXXXXXXXX,0,300,0
48678,70,0,70,3,227,0,0,229,227,2,GOOOXXXXXXXXXXXXXXXXGOOOOOXXXXXXXXXXXXXXGOOOOOOOXXXXXXXXXXXXGOXXXXXXXXXXXXXXXXXXGOOOOOOOOOOXXXXXXXXXGOXXXXXXXXXXXXXXXXXXGOOOXXXXXXXXXXXXXXXXGOOXXXXXXXXXXXXXXXXXGOOOXXXXXXXXXXXXXXXXGOOOOOXXXXXXXXXXXXXXGOOXXXXXXXXXXXXXXXXXGOOOOOOXXXXXXXXXXXXXGOOOOOOOOOXXXXXXXXXX,0,300,0
48699,70,0,70,3,227,0,0,229,227,2,GOOOXXXXXXXXXXXXXXXXGOOOOOXXXXXXXXXXXXXXGOOOOOOOXXXXXXXXXXXXGOXXXXXXXXXXXXXXXXXXGOOOOOOOOOOXXXXXXXXXGOXXXXXXXXXXXXXXXXXXGOOOXXXXXXXXXXXXXXXXGOOXXXXXXXXXXXXXXXXXGOOOXXXXXXXXXXXXXXXXGOOOOOXXXXXXXXXXXXXXGOOXXXXXXXXXXXXXXXXXGOOOOOOXXXXXXXXXXXXXGOOOOOOOOOXXXXXXXXXX,0,300,0

48720,70,0,70,3,227,0,0,229,228,1,GOOOXXXXXXXXXXXXXXXXGOOOOOXXXXXXXXXXXXXXGOOOOOOOXXXXXXXXXXXXGOXXXXXXXXXXXXXXXXXXGOOOOOOOOOOXXXXXXXXXGOXXXXXXXXXXXXXXXXXXGOOOXXXXXXXXXXXXXXXXGOOXXXXXXXXXXXXXXXXXGOOOXXXXXXXXXXXXXXXXGOOOOOXXXXXXXXXXXXXXGOOXXXXXXXXXXXXXXXXXGOOOOOOXXXXXXXXXXXXXGOOOOOOOOOXXXXXXXXXX,0,300,0
48741,70,0,70,2,228,0,0,230,228,2,GOOOXXXXXXXXXXXXXXXXGOOOOOXXXXXXXXXXXXXXGOOOOOOOXXXXXXXXXXXXGOXXXXXXXXXXXXXXXXXXGOOOOOOOOOOXXXXXXXXXGOXXXXXXXXXXXXXXXXXXGOOOXXXXXXXXXXXXXXXXGOOXXXXXXXXXXXXXXXXXGOOOXXXXXXXXXXXXXXXXGOOOOOXXXXXXXXXXXXXXGOOXXXXXXXXXXXXXXXXXGOOOOOOXXXXXXXXXXXXXGOOOOOOOOOXXXXXXXXXX,0,300,0
48762,70,0,70,2,228,0,0,230,228,2,GOOOXXXXXXXXXXXXXXXXGOOOOOXXXXXXXXXXXXXXGOOOOOOOXXXXXXXXXXXXGOXXXXXXXXXXXXXXXXXXGOOOOOOOOOOXXXXXXXXXGOXXXXXXXXXXXXXXXXXXGOOOXXXXXXXXXXXXXXXXGOOXXXXXXXXXXXXXXXXXGOOOXXXXXXXXXXXXXXXXGOOOOOXXXXXXXXXXXXXXGOOXXXXXXXXXXXXXXXXXGOOOOOOXXXXXXXXXXXXXGOOOOOOOOOXXXXXXXXXX,0,300,0
48783,70,0,70,3,227,0,0,229,227,2,GOOOXXXXXXXXXXXXXXXXGOOOOOXXXXXXXXXXXXXXGOOOOOOOXXXXXXXXXXXXGOXXXXXXXXXXXXXXXXXXGOOOOOOOOOOXXXXXXXXXGOXXXXXXXXXXXXXXXXXXGOOOXXXXXXXXXXXXXXXXGOOXXXXXXXXXXXXXXXXXGOOOXXXXXXXXXXXXXXXXGOOOOOXXXXXXXXXXXXXXGOOXXXXXXXXXXXXXXXXXGOOOOOOXXXXXXXXXXXXXGOOOOOOOOOXXXXXXXXXX,0,300,0
48804,70,0,70,2,228,0,0,230,227,3,GOOOXXXXXXXXXXXXXXXXGOOOOOXXXXXXXXXXXXXXGOOOOOOOXXXXXXXXXXXXGOXXXXXXXXXXXXXXXXXXGOOOOOOOOOOXXXXXXXXXGOXXXXXXXXXXXXXXXXXXGOOOXXXXXXXXXXXXXXXXGOOXXXXXXXXXXXXXXXXXGOOOXXXXXXXXXXXXXXXXGOOOOOXXXXXXXXXXXXXXGOOXXXXXXXXXXXXXXXXXGOOOOOOXXXXXXXXXXXXXGOOOOOOOOOXXXXXXXXXX,0,300,0

48825,70,0,70,2,228,0,0,230,227,3,GOOOXXXXXXXXXXXXXXXXGOOOOOXXXXXXXXXXXXXXGOOOOOOOXXXXXXXXXXXXGOXXXXXXXXXXXXXXXXXXGOOOOOOOOOOXXXXXXXXXGOXXXXXXXXXXXXXXXXXXGOOOXXXXXXXXXXXXXXXXGOOXXXXXXXXXXXXXXXXXGOOOXXXXXXXXXXXXXXXXGOOOOOXXXXXXXXXXXXXXGOOXXXXXXXXXXXXXXXXXGOOOOOOXXXXXXXXXXXXXGOOOOOOOOOXXXXXXXXXX,0,300,0
48846,70,0,70,2,228,0,0,230,227,3,GOOOXXXXXXXXXXXXXXXXGOOOOOXXXXXXXXXXXXXXGOOOOOOOXXXXXXXXXXXXGOXXXXXXXXXXXXXXXXXXGOOOOOOOOOOXXXXXXXXXGOXXXXXXXXXXXXXXXXXXGOOOXXXXXXXXXXXXXXXXGOOXXXXXXXXXXXXXXXXXGOOOXXXXXXXXXXXXXXXXGOOOOOXXXXXXXXXXXXXXGOOXXXXXXXXXXXXXXXXXGOOOOOOXXXXXXXXXXXXXGOOOOOOOOOXXXXXXXXXX,0,300,0
48867,70,0,70,2,228,0,0,230,227,3,GOOOXXXXXXXXXXXXXXXXGOOOOOXXXXXXXXXXXXXXGOOOOOOOXXXXXXXXXXXXGOXXXXXXXXXXXXXXXXXXGOOOOOOOOOOXXXXXXXXXGOXXXXXXXXXXXXXXXXXXGOOOXXXXXXXXXXXXXXXXGOOXXXXXXXXXXXXXXXXXGOOOXXXXXXXXXXXXXXXXGOOOOOXXXXXXXXXXXXXXGOOXXXXXXXXXXXXXXXXXGOOOOOOXXXXXXXXXXXXXGOOOOOOOOOXXXXXXXXXX,0,300,0
48888,70,0,70,2,228,0,0,230,227,3,GOOOXXXXXXXXXXXXXXXXGOOOOOXXXXXXXXXXXXXXGOOOOOOOXXXXXXXXXXXXGOXXXXXXXXXXXXXXXXXXGOOOOOOOOOOXXXXXXXXXGOXXXXXXXXXXXXXXXXXXGOOOXXXXXXXXXXXXXXXXGOOXXXXXXXXXXXXXXXXXGOOOXXXXXXXXXXXXXXXXGOOOOOXXXXXXXXXXXXXXGOOXXXXXXXXXXXXXXXXXGOOOOOOXXXXXXXXXXXXXGOOOOOOOOOXXXXXXXXXX,0,300,0
48909,70,0,70,2,228,0,0,230,227,3,GOOOXXXXXXXXXXXXXXXXGOOOOOXXXXXXXXXXXXXXGOOOOOOOXXXXXXXXXXXXGOXXXXXXXXXXXXXXXXXXGOOOOOOOOOOXXXXXXXXXGOXXXXXXXXXXXXXXXXXXGOOOXXXXXXXXXXXXXXXXGOOXXXXXXXXXXXXXXXXXGOOOXXXXXXXXXXXXXXXXGOOOOOXXXXXXXXXXXXXXGOOXXXXXXXXXXXXXXXXXGOOOOOOXXXXXXXXXXXXXGOOOOOOOOOXXXXXXXXXX,0,300,0

48930,70,0,70,3,227,0,0,229,227,2,GOOOXXXXXXXXXXXXXXXXGOOOOOXXXXXXXXXXXXXXGOOOOOOOXXXXXXXXXXXXGOXXXXXXXXXXXXXXXXXXGOOOOOOOOOOXXXXXXXXXGOXXXXXXXXXXXXXXXXXXGOOOXXXXXXXXXXXXXXXXGOOXXXXXXXXXXXXXXXXXGOOOXXXXXXXXXXXXXXXXGOOOOOXXXXXXXXXXXXXXGOOXXXXXXXXXXXXXXXXXGOOOOOOXXXXXXXXXXXXXGOOOOOOOOOXXXXXXXXXX,0,300,0
48951,70,0,70,2,228,0,0,230,227,3,GOOOXXXXXXXXXXXXXXXXGOOOOOXXXXXXXXXXXXXXGOOOOOOOXXXXXXXXXXXXGOXXXXXXXXXXXXXXXXXXGOOOOOOOOOOXXXXXXXXXGOXXXXXXXXXXXXXXXXXXGOOOXXXXXXXXXXXXXXXXGOOXXXXXXXXXXXXXXXXXGOOOXXXXXXXXXXXXXXXXGOOOOOXXXXXXXXXXXXXXGOOXXXXXXXXXXXXXXXXXGOOOOOOXXXXXXXXXXXXXGOOOOOOOOOXXXXXXXXXX,0,300,0
48972,70,0,70,2,228,0,0,230,227,3,GOOOXXXXXXXXXXXXXXXXGOOOOOXXXXXXXXXXXXXXGOOOOOOOXXXXXXXXXXXXGOXXXXXXXXXXXXXXXXXXGOOOOOOOOOOXXXXXXXXXGOXXXXXXXXXXXXXXXXXXGOOOXXXXXXXXXXXXXXXXGOOXXXXXXXXXXXXXXXXXGOOOXXXXXXXXXXXXXXXXGOOOOOXXXXXXXXXXXXXXGOOXXXXXXXXXXXXXXXXXGOOOOOOXXXXXXXXXXXXXGOOOOOOOOOXXXXXXXXXX,0,300,0
48993,70,0,70,2,228,0,0,230,227,3,GOOOXXXXXXXXXXXXXXXXGOOOOOXXXXXXXXXXXXXXGOOOOOOOXXXXXXXXXXXXGOXXXXXXXXXXXXXXXXXXGOOOOOOOOOOXXXXXXXXXGOXXXXXXXXXXXXXXXXXXGOOOXXXXXXXXXXXXXXXXGOOXXXXXXXXXXXXXXXXXGOOOXXXXXXXXXXXXXXXXGOOOOOXXXXXXXXXXXXXXGOOXXXXXXXXXXXXXXXXXGOOOOOOXXXXXXXXXXXXXGOOOOOOOOOXXXXXXXXXX,0,300,0
49014,70,0,70,2,228,0,0,230,227,3,GOOOXXXXXXXXXXXXXXXXGOOOOOXXXXXXXXXXXXXXGOOOOOOOXXXXXXXXXXXXGOXXXXXXXXXXXXXXXXXXGOOOOOOOOOOXXXXXXXXXGOXXXXXXXXXXXXXXXXXXGOOOXXXXXXXXXXXXXXXXGOOXXXXXXXXXXXXXXXXXGOOOXXXXXXXXXXXXXXXXGOOOOOXXXXXXXXXXXXXXGOOXXXXXXXXXXXXXXXXXGOOOOOOXXXXXXXXXXXXXGOOOOOOOOOXXXXXXXXXX,0,300,0

49035,70,0,70,2,228,0,0,230,227,3,GOOOXXXXXXXXXXXXXXXXGOOOOOXXXXXXXXXXXXXXGOOOOOOOXXXXXXXXXXXXGOXXXXXXXXXXXXXXXXXXGOOOOOOOOOOXXXXXXXXXGOXXXXXXXXXXXXXXXXXXGOOOXXXXXXXXXXXXXXXXGOOXXXXXXXXXXXXXXXXXGOOOXXXXXXXXXXXXXXXXGOOOOOXXXXXXXXXXXXXXGOOXXXXXXXXXXXXXXXXXGOOOOOOXXXXXXXXXXXXXGOOOOOOOOOXXXXXXXXXX,0,300,0
49056,70,0,70,2,228,0,0,230,227,3,GOOOXXXXXXXXXXXXXXXXGOOOOOXXXXXXXXXXXXXXGOOOOOOOXXXXXXXXXXXXGOXXXXXXXXXXXXXXXXXXGOOOOOOOOOOXXXXXXXXXGOXXXXXXXXXXXXXXXXXXGOOOXXXXXXXXXXXXXXXXGOOXXXXXXXXXXXXXXXXXGOOOXXXXXXXXXXXXXXXXGOOOOOXXXXXXXXXXXXXXGOOXXXXXXXXXXXXXXXXXGOOOOOOXXXXXXXXXXXXXGOOOOOOOOOXXXXXXXXXX,0,300,0
49077,70,0,70,2,228,0,0,230,227,3,GOOOXXXXXXXXXXXXXXXXGOOOOOXXXXXXXXXXXXXXGOOOOOOOXXXXXXXXXXXXGOXXXXXXXXXXXXXXXXXXGOOOOOOOOOOXXXXXXXXXGOXXXXXXXXXXXXXXXXXXGOOOXXXXXXXXXXXXXXXXGOOXXXXXXXXXXXXXXXXXGOOOXXXXXXXXXXXXXXXXGOOOOOXXXXXXXXXXXXXXGOOXXXXXXXXXXXXXXXXXGOOOOOOXXXXXXXXXXXXXGOOOOOOOOOXXXXXXXXXX,0,300,0
49098,70,0,70,2,228,0,0,230,227,3,GOOOXXXXXXXXXXXXXXXXGOOOOOXXXXXXXXXXXXXXGOOOOOOOXXXXXXXXXXXXGOXXXXXXXXXXXXXXXXXXGOOOOOOOOOOXXXXXXXXXGOXXXXXXXXXXXXXXXXXXGOOOXXXXXXXXXXXXXXXXGOOXXXXXXXXXXXXXXXXXGOOOXXXXXXXXXXXXXXXXGOOOOOXXXXXXXXXXXXXXGOOXXXXXXXXXXXXXXXXXGOOOOOOXXXXXXXXXXXXXGOOOOOOOOOXXXXXXXXXX,0,300,0
49119,70,0,70,2,228,0,0,230,227,3,GOOOXXXXXXXXXXXXXXXXGOOOOOXXXXXXXXXXXXXXGOOOOOOOXXXXXXXXXXXXGOXXXXXXXXXXXXXXXXXXGOOOOOOOOOOXXXXXXXXXGOXXXXXXXXXXXXXXXXXXGOOOXXXXXXXXXXXXXXXXGOOXXXXXXXXXXXXXXXXXGOOOXXXXXXXXXXXXXXXXGOOOOOXXXXXXXXXXXXXXGOOXXXXXXXXXXXXXXXXXGOOOOOOXXXXXXXXXXXXXGOOOOOOOOOXXXXXXXXXX,0,300,0

49140,70,0,70,2,228,0,0,230,227,3,GOOOXXXXXXXXXXXXXXXXGOOOOOXXXXXXXXXXXXXXGOOOOOOOXXXXXXXXXXXXGOXXXXXXXXXXXXXXXXXXGOOOOOOOOOOXXXXXXXXXGOXXXXXXXXXXXXXXXXXXGOOOXXXXXXXXXXXXXXXXGOOXXXXXXXXXXXXXXXXXGOOOXXXXXXXXXXXXXXXXGOOOOOXXXXXXXXXXXXXXGOOXXXXXXXXXXXXXXXXXGOOOOOOXXXXXXXXXXXXXGOOOOOOOOOXXXXXXXXXX,0,300,0
49161,70,0,70,1,229,0,0,231,227,4,GOOOXXXXXXXXXXXXXXXXGOOOOOXXXXXXXXXXXXXXGOOOOOOOXXXXXXXXXXXXGOXXXXXXXXXXXXXXXXXXGOOOOOOOOOOXXXXXXXXXGOXXXXXXXXXXXXXXXXXXGOOOXXXXXXXXXXXXXXXXGOOXXXXXXXXXXXXXXXXXGOOOXXXXXXXXXXXXXXXXGOOOOOXXXXXXXXXXXXXXGOOXXXXXXXXXXXXXXXXXGOOOOOOXXXXXXXXXXXXXGOOOOOOOOOXXXXXXXXXX,0,300,0
49182,70,0,70,1,229,0,0,231,228,3,GOOOXXXXXXXXXXXXXXXXGOOOOOXXXXXXXXXXXXXXGOOOOOOOXXXXXXXXXXXXGOXXXXXXXXXXXXXXXXXXGOOOOOOOOOOXXXXXXXXXGOXXXXXXXXXXXXXXXXXXGOOOXXXXXXXXXXXXXXXXGOOXXXXXXXXXXXXXXXXXGOOOXXXXXXXXXXXXXXXXGOOOOOXXXXXXXXXXXXXXGOOXXXXXXXXXXXXXXXXXGOOOOOOXXXXXXXXXXXXXGOOOOOOOOOXXXXXXXXXX,0,300,0
49203,70,0,70,1,229,0,0,231,228,3,GOOOXXXXXXXXXXXXXXXXGOOOOOXXXXXXXXXXXXXXGOOOOOOOXXXXXXXXXXXXGOXXXXXXXXXXXXXXXXXXGOOOOOOOOOOXXXXXXXXXGOXXXXXXXXXXXXXXXXXXGOOOXXXXXXXXXXXXXXXXGOOXXXXXXXXXXXXXXXXXGOOOXXXXXXXXXXXXXXXXGOOOOOXXXXXXXXXXXXXXGOOXXXXXXXXXXXXXXXXXGOOOOOOXXXXXXXXXXXXXGOOOOOOOOOXXXXXXXXXX,0,300,0
49224,70,0,70,1,229,0,0,231,228,3,GOOOXXXXXXXXXXXXXXXXGOOOOOXXXXXXXXXXXXXXGOOOOOOOXXXXXXXXXXXXGOXXXXXXXXXXXXXXXXXXGOOOOOOOOOOXXXXXXXXXGOXXXXXXXXXXXXXXXXXXGOOOXXXXXXXXXXXXXXXXGOOXXXXXXXXXXXXXXXXXGOOOXXXXXXXXXXXXXXXXGOOOOOXXXXXXXXXXXXXXGOOXXXXXXXXXXXXXXXXXGOOOOOOXXXXXXXXXXXXXGOOOOOOOOOXXXXXXXXXX,0,300,0

49245,70,0,70,2,228,0,0,230,227,3,GOOOXXXXXXXXXXXXXXXXGOOOOOXXXXXXXXXXXXXXGOOOOOOOXXXXXXXXXXXXGOXXXXXXXXXXXXXXXXXXGOOOOOOOOOOXXXXXXXXXGOXXXXXXXXXXXXXXXXXXGOOOXXXXXXXXXXXXXXXXGOOXXXXXXXXXXXXXXXXXGOOOXXXXXXXXXXXXXXXXGOOOOOXXXXXXXXXXXXXXGOOXXXXXXXXXXXXXXXXXGOOOOOOXXXXXXXXXXXXXGOOOOOOOOOXXXXXXXXXX,0,300,0
49266,70,0,70,2,228,0,0,230,227,3,GOOOXXXXXXXXXXXXXXXXGOOOOOXXXXXXXXXXXXXXGOOOOOOOXXXXXXXXXXXXGOXXXXXXXXXXXXXXXXXXGOOOOOOOOOOXXXXXXXXXGOXXXXXXXXXXXXXXXXXXGOOOXXXXXXXXXXXXXXXXGOOXXXXXXXXXXXXXXXXXGOOOXXXXXXXXXXXXXXXXGOOOOOXXXXXXXXXXXXXXGOOXXXXXXXXXXXXXXXXXGOOOOOOXXXXXXXXXXXXXGOOOOOOOOOXXXXXXXXXX,0,300,0
49287,70,0,70,2,228,0,0,230,227,3,GOOOXXXXXXXXXXXXXXXXGOOOOOXXXXXXXXXXXXXXGOOOOOOOXXXXXXXXXXXXGOXXXXXXXXXXXXXXXXXXGOOOOOOOOOOXXXXXXXXXGOXXXXXXXXXXXXXXXXXXGOOOXXXXXXXXXXXXXXXXGOOXXXXXXXXXXXXXXXXXGOOOXXXXXXXXXXXXXXXXGOOOOOXXXXXXXXXXXXXXGOOXXXXXXXXXXXXXXXXXGOOOOOOXXXXXXXXXXXXXGOOOOOOOOOXXXXXXXXXX,0,300,0
49308,70,0,70,1,229,0,0,230,227,3,GOOOXXXXXXXXXXXXXXXXGOOOOOXXXXXXXXXXXXXXGOOOOOOOXXXXXXXXXXXXGOXXXXXXXXXXXXXXXXXXGOOOOOOOOOOXXXXXXXXXGOXXXXXXXXXXXXXXXXXXGOOOXXXXXXXXXXXXXXXXGOOXXXXXXXXXXXXXXXXXGOOOXXXXXXXXXXXXXXXXGOOOOOXXXXXXXXXXXXXXGOOXXXXXXXXXXXXXXXXXGOOOOOOXXXXXXXXXXXXXGOOOOOOOOOXXXXXXXXXX,0,300,0
49329,70,0,70,1,229,0,0,231,227,4,GOOOXXXXXXXXXXXXXXXXGOOOOOXXXXXXXXXXXXXXGOOOOOOOXXXXXXXXXXXXGOXXXXXXXXXXXXXXXXXXGOOOOOOOOOOXXXXXXXXXGOXXXXXXXXXXXXXXXXXXGOOOXXXXXXXXXXXXXXXXGOOXXXXXXXXXXXXXXXXXGOOOXXXXXXXXXXXXXXXXGOOOOOXXXXXXXXXXXXXXGOOXXXXXXXXXXXXXXXXXGOOOOOOXXXXXXXXXXXXXGOOOOOOOOOXXXXXXXXXX,0,300,0

49350,70,0,70,1,229,0,0,231,227,4,GOOOXXXXXXXXXXXXXXXXGOOOOOXXXXXXXXXXXXXXGOOOOOOOXXXXXXXXXXXXGOXXXXXXXXXXXXXXXXXXGOOOOOOOOOOXXXXXXXXXGOXXXXXXXXXXXXXXXXXXGOOOXXXXXXXXXXXXXXXXGOOXXXXXXXXXXXXXXXXXGOOOXXXXXXXXXXXXXXXXGOOOOOXXXXXXXXXXXXXXGOOXXXXXXXXXXXXXXXXXGOOOOOOXXXXXXXXXXXXXGOOOOOOOOOXXXXXXXXXX,0,300,0
49371,70,0,70,1,229,0,0,231,227,4,GOOOXXXXXXXXXXXXXXXXGOOOOOXXXXXXXXXXXXXXGOOOOOOOXXXXXXXXXXXXGOXXXXXXXXXXXXXXXXXXGOOOOOOOOOOXXXXXXXXXGOXXXXXXXXXXXXXXXXXXGOOOXXXXXXXXXXXXXXXXGOOXXXXXXXXXXXXXXXXXGOOOXXXXXXXXXXXXXXXXGOOOOOXXXXXXXXXXXXXXGOOXXXXXXXXXXXXXXXXXGOOOOOOXXXXXXXXXXXXXGOOOOOOOOOXXXXXXXXXX,0,300,0
49392,70,0,70,1,229,0,0,231,229,2,GOOOXXXXXXXXXXXXXXXXGOOOOOXXXXXXXXXXXXXXGOOOOOOOXXXXXXXXXXXXGOXXXXXXXXXXXXXXXXXXGOOOOOOOOOOXXXXXXXXXGOXXXXXXXXXXXXXXXXXXGOOOXXXXXXXXXXXXXXXXGOOXXXXXXXXXXXXXXXXXGOOOXXXXXXXXXXXXXXXXGOOOOOXXXXXXXXXXXXXXGOOXXXXXXXXXXXXXXXXXGOOOOOOXXXXXXXXXXXXXGOOOOOOOOOXXXXXXXXXX,0,300,0
49413,70,0,70,1,229,0,0,231,229,2,GOOOXXXXXXXXXXXXXXXXGOOOOOXXXXXXXXXXXXXXGOOOOOOOXXXXXXXXXXXXGOXXXXXXXXXXXXXXXXXXGOOOOOOOOOOXXXXXXXXXGOXXXXXXXXXXXXXXXXXXGOOOXXXXXXXXXXXXXXXXGOOXXXXXXXXXXXXXXXXXGOOOXXXXXXXXXXXXXXXXGOOOOOXXXXXXXXXXXXXXGOOXXXXXXXXXXXXXXXXXGOOOOOOXXXXXXXXXXXXXGOOOOOOOOOXXXXXXXXXX,0,300,0
49434,70,0,70,2,228,0,0,230,228,2,GOOOXXXXXXXXXXXXXXXXGOOOOOXXXXXXXXXXXXXXGOOOOOOOXXXXXXXXXXXXGOXXXXXXXXXXXXXXXXXXGOOOOOOOOOOXXXXXXXXXGOXXXXXXXXXXXXXXXXXXGOOOXXXXXXXXXXXXXXXXGOOXXXXXXXXXXXXXXXXXGOOOXXXXXXXXXXXXXXXXGOOOOOXXXXXXXXXXXXXXGOOXXXXXXXXXXXXXXXXXGOOOOOOXXXXXXXXXXXXXGOOOOOOOOOXXXXXXXXXX,0,300,0

49455,70,0,70,2,228,0,0,230,227,3,GOOOXXXXXXXXXXXXXXXXGOOOOOXXXXXXXXXXXXXXGOOOOOOOXXXXXXXXXXXXGOXXXXXXXXXXXXXXXXXXGOOOOOOOOOOXXXXXXXXXGOXXXXXXXXXXXXXXXXXXGOOOXXXXXXXXXXXXXXXXGOOXXXXXXXXXXXXXXXXXGOOOXXXXXXXXXXXXXXXXGOOOOOXXXXXXXXXXXXXXGOOXXXXXXXXXXXXXXXXXGOOOOOOXXXXXXXXXXXXXGOOOOOOOOOXXXXXXXXXX,0,300,0
49476,70,0,70,2,228,0,0,230,227,3,GOOOXXXXXXXXXXXXXXXXGOOOOOXXXXXXXXXXXXXXGOOOOOOOXXXXXXXXXXXXGOXXXXXXXXXXXXXXXXXXGOOOOOOOOOOXXXXXXXXXGOXXXXXXXXXXXXXXXXXXGOOOXXXXXXXXXXXXXXXXGOOXXXXXXXXXXXXXXXXXGOOOXXXXXXXXXXXXXXXXGOOOOOXXXXXXXXXXXXXXGOOXXXXXXXXXXXXXXXXXGOOOOOOXXXXXXXXXXXXXGOOOOOOOOOXXXXXXXXXX,0,300,0
49497,70,0,70,2,228,0,0,230,227,3,GOOOXXXXXXXXXXXXXXXXGOOOOOXXXXXXXXXXXXXXGOOOOOOOXXXXXXXXXXXXGOXXXXXXXXXXXXXXXXXXGOOOOOOOOOOXXXXXXXXXGOXXXXXXXXXXXXXXXXXXGOOOXXXXXXXXXXXXXXXXGOOXXXXXXXXXXXXXXXXXGOOOXXXXXXXXXXXXXXXXGOOOOOXXXXXXXXXXXXXXGOOXXXXXXXXXXXXXXXXXGOOOOOOXXXXXXXXXXXXXGOOOOOOOOOXXXXXXXXXX,0,300,0
49518,70,0,70,1,229,0,0,231,227,4,GOOOXXXXXXXXXXXXXXXXGOOOOOXXXXXXXXXXXXXXGOOOOOOOXXXXXXXXXXXXGOXXXXXXXXXXXXXXXXXXGOOOOOOOOOOXXXXXXXXXGOXXXXXXXXXXXXXXXXXXGOOOXXXXXXXXXXXXXXXXGOOXXXXXXXXXXXXXXXXXGOOOXXXXXXXXXXXXXXXXGOOOOOXXXXXXXXXXXXXXGOOXXXXXXXXXXXXXXXXXGOOOOOOXXXXXXXXXXXXXGOOOOOOOOOXXXXXXXXXX,0,300,0
49539,70,0,70,1,229,0,0,231,227,4,GOOOXXXXXXXXXXXXXXXXGOOOOOXXXXXXXXXXXXXXGOOOOOOOXXXXXXXXXXXXGOXXXXXXXXXXXXXXXXXXGOOOOOOOOOOXXXXXXXXXGOXXXXXXXXXXXXXXXXXXGOOOXXXXXXXXXXXXXXXXGOOXXXXXXXXXXXXXXXXXGOOOXXXXXXXXXXXXXXXXGOOOOOXXXXXXXXXXXXXXGOOXXXXXXXXXXXXXXXXXGOOOOOOXXXXXXXXXXXXXGOOOOOOOOOXXXXXXXXXX,0,300,0

49560,70,0,70,1,229,0,0,231,228,3,GOOOXXXXXXXXXXXXXXXXGOOOOOXXXXXXXXXXXXXXGOOOOOOOXXXXXXXXXXXXGOXXXXXXXXXXXXXXXXXXGOOOOOOOOOOXXXXXXXXXGOXXXXXXXXXXXXXXXXXXGOOOXXXXXXXXXXXXXXXXGOOXXXXXXXXXXXXXXXXXGOOOXXXXXXXXXXXXXXXXGOOOOOXXXXXXXXXXXXXXGOOXXXXXXXXXXXXXXXXXGOOOOOOXXXXXXXXXXXXXGOOOOOOOOOXXXXXXXXXX,0,300,0
49581,70,0,70,1,229,0,0,231,228,3,GOOOXXXXXXXXXXXXXXXXGOOOOOXXXXXXXXXXXXXXGOOOOOOOXXXXXXXXXXXXGOXXXXXXXXXXXXXXXXXXGOOOOOOOOOOXXXXXXXXXGOXXXXXXXXXXXXXXXXXXGOOOXXXXXXXXXXXXXXXXGOOXXXXXXXXXXXXXXXXXGOOOXXXXXXXXXXXXXXXXGOOOOOXXXXXXXXXXXXXXGOOXXXXXXXXXXXXXXXXXGOOOOOOXXXXXXXXXXXXXGOOOOOOOOOXXXXXXXXXX,0,300,0
49602,70,0,70,1,229,0,0,231,227,4,GOOOXXXXXXXXXXXXXXXXGOOOOOXXXXXXXXXXXXXXGOOOOOOOXXXXXXXXXXXXGOXXXXXXXXXXXXXXXXXXGOOOOOOOOOOXXXXXXXXXGOXXXXXXXXXXXXXXXXXXGOOOXXXXXXXXXXXXXXXXGOOXXXXXXXXXXXXXXXXXGOOOXXXXXXXXXXXXXXXXGOOOOOXXXXXXXXXXXXXXGOOXXXXXXXXXXXXXXXXXGOOOOOOXXXXXXXXXXXXXGOOOOOOOOOXXXXXXXXXX,0,300,0
49623,70,0,70,2,228,0,0,230,227,3,GOOOXXXXXXXXXXXXXXXXGOOOOOXXXXXXXXXXXXXXGOOOOOOOXXXXXXXXXXXXGOXXXXXXXXXXXXXXXXXXGOOOOOOOOOOXXXXXXXXXGOXXXXXXXXXXXXXXXXXXGOOOXXXXXXXXXXXXXXXXGOOXXXXXXXXXXXXXXXXXGOOOXXXXXXXXXXXXXXXXGOOOOOXXXXXXXXXXXXXXGOOXXXXXXXXXXXXXXXXXGOOOOOOXXXXXXXXXXXXXGOOOOOOOOOXXXXXXXXXX,0,300,0
49644,70,0,70,2,228,0,0,230,227,3,GOOOXXXXXXXXXXXXXXXXGOOOOOXXXXXXXXXXXXXXGOOOOOOOXXXXXXXXXXXXGOXXXXXXXXXXXXXXXXXXGOOOOOOOOOOXXXXXXXXXGOXXXXXXXXXXXXXXXXXXGOOOXXXXXXXXXXXXXXXXGOOXXXXXXXXXXXXXXXXXGOOOXXXXXXXXXXXXXXXXGOOOOOXXXXXXXXXXXXXXGOOXXXXXXXXXXXXXXXXXGOOOOOOXXXXXXXXXXXXXGOOOOOOOOOXXXXXXXXXX,0,300,0

49665,70,0,70,2,228,0,0,230,227,3,GOOOXXXXXXXXXXXXXXXXGOOOOOXXXXXXXXXXXXXXGOOOOOOOXXXXXXXXXXXXGOXXXXXXXXXXXXXXXXXXGOOOOOOOOOOXXXXXXXXXGOXXXXXXXXXXXXXXXXXXGOOOXXXXXXXXXXXXXXXXGOOXXXXXXXXXXXXXXXXXGOOOXXXXXXXXXXXXXXXXGOOOOOXXXXXXXXXXXXXXGOOXXXXXXXXXXXXXXXXXGOOOOOOXXXXXXXXXXXXXGOOOOOOOOOXXXXXXXXXX,0,300,0
49686,70,0,70,2,228,0,0,230,227,3,GOOOXXXXXXXXXXXXXXXXGOOOOOXXXXXXXXXXXXXXGOOOOOOOXXXXXXXXXXXXGOXXXXXXXXXXXXXXXXXXGOOOOOOOOOOXXXXXXXXXGOXXXXXXXXXXXXXXXXXXGOOOXXXXXXXXXXXXXXXXGOOXXXXXXXXXXXXXXXXXGOOOXXXXXXXXXXXXXXXXGOOOOOXXXXXXXXXXXXXXGOOXXXXXXXXXXXXXXXXXGOOOOOOXXXXXXXXXXXXXGOOOOOOOOOXXXXXXXXXX,0,300,0
49707,70,0,70,2,228,0,0,230,228,2,GOOOXXXXXXXXXXXXXXXXGOOOOOXXXXXXXXXXXXXXGOOOOOOOXXXXXXXXXXXXGOXXXXXXXXXXXXXXXXXXGOOOOOOOOOOXXXXXXXXXGOXXXXXXXXXXXXXXXXXXGOOOXXXXXXXXXXXXXXXXGOOXXXXXXXXXXXXXXXXXGOOOXXXXXXXXXXXXXXXXGOOOOOXXXXXXXXXXXXXXGOOXXXXXXXXXXXXXXXXXGOOOOOOXXXXXXXXXXXXXGOOOOOOOOOXXXXXXXXXX,0,300,0
49728,70,0,70,3,227,0,0,229,227,2,GOOOXXXXXXXXXXXXXXXXGOOOOOXXXXXXXXXXXXXXGOOOOOOOXXXXXXXXXXXXGOXXXXXXXXXXXXXXXXXXGOOOOOOOOOOXXXXXXXXXGOXXXXXXXXXXXXXXXXXXGOOOXXXXXXXXXXXXXXXXGOOXXXXXXXXXXXXXXXXXGOOOXXXXXXXXXXXXXXXXGOOOOOXXXXXXXXXXXXXXGOOXXXXXXXXXXXXXXXXXGOOOOOOXXXXXXXXXXXXXGOOOOOOOOOXXXXXXXXXX,0,300,0
49749,70,0,70,3,227,0,0,229,227,2,GOOOXXXXXXXXXXXXXXXXGOOOOOXXXXXXXXXXXXXXGOOOOOOOXXXXXXXXXXXXGOXXXXXXXXXXXXXXXXXXGOOOOOOOOOOXXXXXXXXXGOXXXXXXXXXXXXXXXXXXGOOOXXXXXXXXXXXXXXXXGOOXXXXXXXXXXXXXXXXXGOOOXXXXXXXXXXXXXXXXGOOOOOXXXXXXXXXXXXXXGOOXXXXXXXXXXXXXXXXXGOOOOOOXXXXXXXXXXXXXGOOOOOOOOOXXXXXXXXXX,0,300,0

49770,70,0,70,3,227,0,0,229,227,2,GOOOXXXXXXXXXXXXXXXXGOOOOOXXXXXXXXXXXXXXGOOOOOOOXXXXXXXXXXXXGOXXXXXXXXXXXXXXXXXXGOOOOOOOOOOXXXXXXXXXGOXXXXXXXXXXXXXXXXXXGOOOXXXXXXXXXXXXXXXXGOOXXXXXXXXXXXXXXXXXGOOOXXXXXXXXXXXXXXXXGOOOOOXXXXXXXXXXXXXXGOOXXXXXXXXXXXXXXXXXGOOOOOOXXXXXXXXXXXXXGOOOOOOOOOXXXXXXXXXX,0,300,0
49791,70,0,70,2,228,0,0,230,227,3,GOOOXXXXXXXXXXXXXXXXGOOOOOXXXXXXXXXXXXXXGOOOOOOOXXXXXXXXXXXXGOXXXXXXXXXXXXXXXXXXGOOOOOOOOOOXXXXXXXXXGOXXXXXXXXXXXXXXXXXXGOOOXXXXXXXXXXXXXXXXGOOXXXXXXXXXXXXXXXXXGOOOXXXXXXXXXXXXXXXXGOOOOOXXXXXXXXXXXXXXGOOXXXXXXXXXXXXXXXXXGOOOOOOXXXXXXXXXXXXXGOOOOOOOOOXXXXXXXXXX,0,300,0
49812,70,0,70,2,228,0,0,230,227,3,GOOOXXXXXXXXXXXXXXXXGOOOOOXXXXXXXXXXXXXXGOOOOOOOXXXXXXXXXXXXGOXXXXXXXXXXXXXXXXXXGOOOOOOOOOOXXXXXXXXXGOXXXXXXXXXXXXXXXXXXGOOOXXXXXXXXXXXXXXXXGOOXXXXXXXXXXXXXXXXXGOOOXXXXXXXXXXXXXXXXGOOOOOXXXXXXXXXXXXXXGOOXXXXXXXXXXXXXXXXXGOOOOOOXXXXXXXXXXXXXGOOOOOOOOOXXXXXXXXXX,0,300,0
49833,70,0,70,3,227,0,0,229,227,2,GOOOXXXXXXXXXXXXXXXXGOOOOOXXXXXXXXXXXXXXGOOOOOOOXXXXXXXXXXXXGOXXXXXXXXXXXXXXXXXXGOOOOOOOOOOXXXXXXXXXGOXXXXXXXXXXXXXXXXXXGOOOXXXXXXXXXXXXXXXXGOOXXXXXXXXXXXXXXXXXGOOOXXXXXXXXXXXXXXXXGOOOOOXXXXXXXXXXXXXXGOOXXXXXXXXXXXXXXXXXGOOOOOOXXXXXXXXXXXXXGOOOOOOOOOXXXXXXXXXX,0,300,0
49854,70,0,70,3,227,0,0,229,227,2,GOOOXXXXXXXXXXXXXXXXGOOOOOXXXXXXXXXXXXXXGOOOOOOOXXXXXXXXXXXXGOXXXXXXXXXXXXXXXXXXGOOOOOOOOOOXXXXXXXXXGOXXXXXXXXXXXXXXXXXXGOOOXXXXXXXXXXXXXXXXGOOXXXXXXXXXXXXXXXXXGOOOXXXXXXXXXXXXXXXXGOOOOOXXXXXXXXXXXXXXGOOXXXXXXXXXXXXXXXXXGOOOOOOXXXXXXXXXXXXXGOOOOOOOOOXXXXXXXXXX,0,300,0

49875,70,0,70,4,226,0,0,228,227,1,GOOOXXXXXXXXXXXXXXXXGOOOOOXXXXXXXXXXXXXXGOOOOOOOXXXXXXXXXXXXGOXXXXXXXXXXXXXXXXXXGOOOOOOOOOOXXXXXXXXXGOXXXXXXXXXXXXXXXXXXGOOOXXXXXXXXXXXXXXXXGOOXXXXXXXXXXXXXXXXXGOOOXXXXXXXXXXXXXXXXGOOOOOXXXXXXXXXXXXXXGOOXXXXXXXXXXXXXXXXXGOOOOOOXXXXXXXXXXXXXGOOOOOOOOOXXXXXXXXXX,0,300,0
49896,70,0,70,4,226,0,0,228,227,1,GOOOXXXXXXXXXXXXXXXXGOOOOOXXXXXXXXXXXXXXGOOOOOOOXXXXXXXXXXXXGOXXXXXXXXXXXXXXXXXXGOOOOOOOOOOXXXXXXXXXGOXXXXXXXXXXXXXXXXXXGOOOXXXXXXXXXXXXXXXXGOOXXXXXXXXXXXXXXXXXGOOOXXXXXXXXXXXXXXXXGOOOOOXXXXXXXXXXXXXXGOOXXXXXXXXXXXXXXXXXGOOOOOOXXXXXXXXXXXXXGOOOOOOOOOXXXXXXXXXX,0,300,0
49917,70,0,70,4,226,0,0,228,227,1,GOOOXXXXXXXXXXXXXXXXGOOOOOXXXXXXXXXXXXXXGOOOOOOOXXXXXXXXXXXXGOXXXXXXXXXXXXXXXXXXGOOOOOOOOOOXXXXXXXXXGOXXXXXXXXXXXXXXXXXXGOOOXXXXXXXXXXXXXXXXGOOXXXXXXXXXXXXXXXXXGOOOXXXXXXXXXXXXXXXXGOOOOOXXXXXXXXXXXXXXGOOXXXXXXXXXXXXXXXXXGOOOOOOXXXXXXXXXXXXXGOOOOOOOOOXXXXXXXXXX,0,300,0
49938,70,0,70,4,226,0,0,228,227,1,GOOOXXXXXXXXXXXXXXXXGOOOOOXXXXXXXXXXXXXXGOOOOOOOXXXXXXXXXXXXGOXXXXXXXXXXXXXXXXXXGOOOOOOOOOOXXXXXXXXXGOXXXXXXXXXXXXXXXXXXGOOOXXXXXXXXXXXXXXXXGOOXXXXXXXXXXXXXXXXXGOOOXXXXXXXXXXXXXXXXGOOOOOXXXXXXXXXXXXXXGOOXXXXXXXXXXXXXXXXXGOOOOOOXXXXXXXXXXXXXGOOOOOOOOOXXXXXXXXXX,0,300,0
49959,70,0,70,4,226,0,0,228,227,1,GOOOXXXXXXXXXXXXXXXXGOOOOOXXXXXXXXXXXXXXGOOOOOOOXXXXXXXXXXXXGOXXXXXXXXXXXXXXXXXXGOOOOOOOOOOXXXXXXXXXGOXXXXXXXXXXXXXXXXXXGOOOXXXXXXXXXXXXXXXXGOOXXXXXXXXXXXXXXXXXGOOOXXXXXXXXXXXXXXXXGOOOOOXXXXXXXXXXXXXXGOOXXXXXXXXXXXXXXXXXGOOOOOOXXXXXXXXXXXXXGOOOOOOOOOXXXXXXXXXX,0,300,0

