iterCounter, dimersInMT, activeDimersInMT, inactiveDimersInMT, activeDimersFree,inactiveDimersFree, longestProtoFilament, lengthOfMT, totalGTPs, activeGTPs,inactiveGTPs, mtRepresentation, DeHydro Katanins, Hydro Katanins, Bonded Katanins

21,0,0,0,0,0,0,0,0,0,0,XXXXXXXXXXXXXXXXXXXXXXXXXXXXXXXXXXXXXXXXXXXXXXXXXXXXXXXXXXXXXXXXXXXXXXXXXXXXXXXXXXXXXXXXXXXXXXXXXXXXXXXXXXXXXXXXXXXXXXXXXXXXXXXXXXXXXXXXXXXXXXXXXXXXXXXXXXXXXXXXXXXXXXXXXXXXXXXXXXXXXXXXXXXXXXXXXXXXXXXXXXXXXXXXXXXXXXXXXXXXXXXXXXXXXXXXXXXXXXXXXXXXXXXXXXXXXXXXXXXX,0,0,0
42,0,0,0,0,0,0,0,0,0,0,XXXXXXXXXXXXXXXXXXXXXXXXXXXXXXXXXXXXXXXXXXXXXXXXXXXXXXXXXXXXXXXXXXXXXXXXXXXXXXXXXXXXXXXXXXXXXXXXXXXXXXXXXXXXXXXXXXXXXXXXXXXXXXXXXXXXXXXXXXXXXXXXXXXXXXXXXXXXXXXXXXXXXXXXXXXXXXXXXXXXXXXXXXXXXXXXXXXXXXXXXXXXXXXXXXXXXXXXXXXXXXXXXXXXXXXXXXXXXXXXXXXXXXXXXXXXXXXXXXXX,0,0,0
63,0,0,0,0,0,0,0,0,0,0,XXXXXXXXXXXXXXXXXXXXXXXXXXXXXXXXXXXXXXXXXXXXXXXXXXXXXXXXXXXXXXXXXXXXXXXXXXXXXXXXXXXXXXXXXXXXXXXXXXXXXXXXXXXXXXXXXXXXXXXXXXXXXXXXXXXXXXXXXXXXXXXXXXXXXXXXXXXXXXXXXXXXXXXXXXXXXXXXXXXXXXXXXXXXXXXXXXXXXXXXXXXXXXXXXXXXXXXXXXXXXXXXXXXXXXXXXXXXXXXXXXXXXXXXXXXXXXXXXXXX,0,0,0
84,0,0,0,0,0,0,0,0,0,0,XXXXXXXXXXXXXXXXXXXXXXXXXXXXXXXXXXXXXXXXXXXXXXXXXXXXXXXXXXXXXXXXXXXXXXXXXXXXXXXXXXXXXXXXXXXXXXXXXXXXXXXXXXXXXXXXXXXXXXXXXXXXXXXXXXXXXXXXXXXXXXXXXXXXXXXXXXXXXXXXXXXXXXXXXXXXXXXXXXXXXXXXXXXXXXXXXXXXXXXXXXXXXXXXXXXXXXXXXXXXXXXXXXXXXXXXXXXXXXXXXXXXXXXXXXXXXXXXXXXX,0,0,0

105,0,0,0,0,340,0,0,500,0,500,XXXXXXXXXXXXXXXXXXXXXXXXXXXXXXXXXXXXXXXXXXXXXXXXXXXXXXXXXXXXXXXXXXXXXXXXXXXXXXXXXXXXXXXXXXXXXXXXXXXXXXXXXXXXXXXXXXXXXXXXXXXXXXXXXXXXXXXXXXXXXXXXXXXXXXXXXXXXXXXXXXXXXXXXXXXXXXXXXXXXXXXXXXXXXXXXXXXXXXXXXXXXXXXXXXXXXXXXXXXXXXXXXXXXXXXXXXXXXXXXXXXXXXXXXXXXXXXXXXXX,0,0,0
126,0,0,0,0,340,0,0,500,0,500,XXXXXXXXXXXXXXXXXXXXXXXXXXXXXXXXXXXXXXXXXXXXXXXXXXXXXXXXXXXXXXXXXXXXXXXXXXXXXXXXXXXXXXXXXXXXXXXXXXXXXXXXXXXXXXXXXXXXXXXXXXXXXXXXXXXXXXXXXXXXXXXXXXXXXXXXXXXXXXXXXXXXXXXXXXXXXXXXXXXXXXXXXXXXXXXXXXXXXXXXXXXXXXXXXXXXXXXXXXXXXXXXXXXXXXXXXXXXXXXXXXXXXXXXXXXXXXXXXXXX,0,0,0
147,0,0,0,0,340,0,0,500,0,500,XXXXXXXXXXXXXXXXXXXXXXXXXXXXXXXXXXXXXXXXXXXXXXXXXXXXXXXXXXXXXXXXXXXXXXXXXXXXXXXXXXXXXXXXXXXXXXXXXXXXXXXXXXXXXXXXXXXXXXXXXXXXXXXXXXXXXXXXXXXXXXXXXXXXXXXXXXXXXXXXXXXXXXXXXXXXXXXXXXXXXXXXXXXXXXXXXXXXXXXXXXXXXXXXXXXXXXXXXXXXXXXXXXXXXXXXXXXXXXXXXXXXXXXXXXXXXXXXXXXX,0,0,0
168,0,0,0,0,340,0,0,500,0,500,XXXXXXXXXXXXXXXXXXXXXXXXXXXXXXXXXXXXXXXXXXXXXXXXXXXXXXXXXXXXXXXXXXXXXXXXXXXXXXXXXXXXXXXXXXXXXXXXXXXXXXXXXXXXXXXXXXXXXXXXXXXXXXXXXXXXXXXXXXXXXXXXXXXXXXXXXXXXXXXXXXXXXXXXXXXXXXXXXXXXXXXXXXXXXXXXXXXXXXXXXXXXXXXXXXXXXXXXXXXXXXXXXXXXXXXXXXXXXXXXXXXXXXXXXXXXXXXXXXXX,0,0,0
189,0,0,0,0,340,0,0,500,0,500,XXXXXXXXXXXXXXXXXXXXXXXXXXXXXXXXXXXXXXXXXXXXXXXXXXXXXXXXXXXXXXXXXXXXXXXXXXXXXXXXXXXXXXXXXXXXXXXXXXXXXXXXXXXXXXXXXXXXXXXXXXXXXXXXXXXXXXXXXXXXXXXXXXXXXXXXXXXXXXXXXXXXXXXXXXXXXXXXXXXXXXXXXXXXXXXXXXXXXXXXXXXXXXXXXXXXXXXXXXXXXXXXXXXXXXXXXXXXXXXXXXXXXXXXXXXXXXXXXXXX,0,0,0

210,0,0,0,0,340,0,0,500,0,500,XXXXXXXXXXXXXXXXXXXXXXXXXXXXXXXXXXXXXXXXXXXXXXXXXXXXXXXXXXXXXXXXXXXXXXXXXXXXXXXXXXXXXXXXXXXXXXXXXXXXXXXXXXXXXXXXXXXXXXXXXXXXXXXXXXXXXXXXXXXXXXXXXXXXXXXXXXXXXXXXXXXXXXXXXXXXXXXXXXXXXXXXXXXXXXXXXXXXXXXXXXXXXXXXXXXXXXXXXXXXXXXXXXXXXXXXXXXXXXXXXXXXXXXXXXXXXXXXXXXX,0,0,0
231,0,0,0,0,340,0,0,500,0,500,XXXXXXXXXXXXXXXXXXXXXXXXXXXXXXXXXXXXXXXXXXXXXXXXXXXXXXXXXXXXXXXXXXXXXXXXXXXXXXXXXXXXXXXXXXXXXXXXXXXXXXXXXXXXXXXXXXXXXXXXXXXXXXXXXXXXXXXXXXXXXXXXXXXXXXXXXXXXXXXXXXXXXXXXXXXXXXXXXXXXXXXXXXXXXXXXXXXXXXXXXXXXXXXXXXXXXXXXXXXXXXXXXXXXXXXXXXXXXXXXXXXXXXXXXXXXXXXXXXXX,0,0,0
252,0,0,0,0,340,0,0,500,0,500,XXXXXXXXXXXXXXXXXXXXXXXXXXXXXXXXXXXXXXXXXXXXXXXXXXXXXXXXXXXXXXXXXXXXXXXXXXXXXXXXXXXXXXXXXXXXXXXXXXXXXXXXXXXXXXXXXXXXXXXXXXXXXXXXXXXXXXXXXXXXXXXXXXXXXXXXXXXXXXXXXXXXXXXXXXXXXXXXXXXXXXXXXXXXXXXXXXXXXXXXXXXXXXXXXXXXXXXXXXXXXXXXXXXXXXXXXXXXXXXXXXXXXXXXXXXXXXXXXXXX,0,0,0
273,0,0,0,0,340,0,0,500,0,500,XXXXXXXXXXXXXXXXXXXXXXXXXXXXXXXXXXXXXXXXXXXXXXXXXXXXXXXXXXXXXXXXXXXXXXXXXXXXXXXXXXXXXXXXXXXXXXXXXXXXXXXXXXXXXXXXXXXXXXXXXXXXXXXXXXXXXXXXXXXXXXXXXXXXXXXXXXXXXXXXXXXXXXXXXXXXXXXXXXXXXXXXXXXXXXXXXXXXXXXXXXXXXXXXXXXXXXXXXXXXXXXXXXXXXXXXXXXXXXXXXXXXXXXXXXXXXXXXXXXX,0,0,0
294,0,0,0,0,340,0,0,500,0,500,XXXXXXXXXXXXXXXXXXXXXXXXXXXXXXXXXXXXXXXXXXXXXXXXXXXXXXXXXXXXXXXXXXXXXXXXXXXXXXXXXXXXXXXXXXXXXXXXXXXXXXXXXXXXXXXXXXXXXXXXXXXXXXXXXXXXXXXXXXXXXXXXXXXXXXXXXXXXXXXXXXXXXXXXXXXXXXXXXXXXXXXXXXXXXXXXXXXXXXXXXXXXXXXXXXXXXXXXXXXXXXXXXXXXXXXXXXXXXXXXXXXXXXXXXXXXXXXXXXXX,0,0,0

315,0,0,0,9,331,0,0,491,17,474,XXXXXXXXXXXXXXXXXXXXXXXXXXXXXXXXXXXXXXXXXXXXXXXXXXXXXXXXXXXXXXXXXXXXXXXXXXXXXXXXXXXXXXXXXXXXXXXXXXXXXXXXXXXXXXXXXXXXXXXXXXXXXXXXXXXXXXXXXXXXXXXXXXXXXXXXXXXXXXXXXXXXXXXXXXXXXXXXXXXXXXXXXXXXXXXXXXXXXXXXXXXXXXXXXXXXXXXXXXXXXXXXXXXXXXXXXXXXXXXXXXXXXXXXXXXXXXXXXXXX,0,0,0
336,0,0,0,33,307,0,0,467,32,435,XXXXXXXXXXXXXXXXXXXXXXXXXXXXXXXXXXXXXXXXXXXXXXXXXXXXXXXXXXXXXXXXXXXXXXXXXXXXXXXXXXXXXXXXXXXXXXXXXXXXXXXXXXXXXXXXXXXXXXXXXXXXXXXXXXXXXXXXXXXXXXXXXXXXXXXXXXXXXXXXXXXXXXXXXXXXXXXXXXXXXXXXXXXXXXXXXXXXXXXXXXXXXXXXXXXXXXXXXXXXXXXXXXXXXXXXXXXXXXXXXXXXXXXXXXXXXXXXXXXX,0,0,0
357,0,0,0,64,276,0,0,436,31,405,XXXXXXXXXXXXXXXXXXXXXXXXXXXXXXXXXXXXXXXXXXXXXXXXXXXXXXXXXXXXXXXXXXXXXXXXXXXXXXXXXXXXXXXXXXXXXXXXXXXXXXXXXXXXXXXXXXXXXXXXXXXXXXXXXXXXXXXXXXXXXXXXXXXXXXXXXXXXXXXXXXXXXXXXXXXXXXXXXXXXXXXXXXXXXXXXXXXXXXXXXXXXXXXXXXXXXXXXXXXXXXXXXXXXXXXXXXXXXXXXXXXXXXXXXXXXXXXXXXXX,0,0,0
378,1,1,0,99,240,0,0,400,37,363,XXXXXXXXXXXXXXXXXXXXXXXXXXXXXXXXXXXXXXXXXXXXXXXXXXXXXXXXXXXXXXXXXXXXXXXXXXXXXXXXXXXXXXXXXXXXXXXXXXXXXXXXXXXXXXXXXXXXXXXXXXXXXXXXXXXXXXXXXXXXXXXXXXXXXXXXXXXXXXXXXXXXXXXXXXXXXXXXXXXXXXXXXXXXXXXXXXXXXXXXXXXXXXXXXXXXXXXXXXXXXXXXXXXXXXXXXXXXXXXXGXXXXXXXXXXXXXXXXXXX,0,0,0
399,2,2,0,130,208,0,0,368,31,337,XXXXXXXXXXXXXXXXXXXXXXXXXXXXXXXXXXXXXXXXXXXXXXXXXXXXXXXXXXXXXXXXXXXXXXXXXXXXXXXXGXXXXXXXXXXXXXXXXXXXXXXXXXXXXXXXXXXXXXXXXXXXXXXXXXXXXXXXXXXXXXXXXXXXXXXXXXXXXXXXXXXXXXXXXXXXXXXXXXXXXXXXXXXXXXXXXXXXXXXXXXXXXXXXXXXXXXXXXXXXXXXXXXXXXXXXXXXXXXXXGXXXXXXXXXXXXXXXXXXX,0,0,0

420,5,5,0,150,185,0,0,345,46,299,XXXXXXXXXXXXXXXXXXXXGAXXXXXXXXXXXXXXXXXXXXXXXXXXXXXXXXXXXXXXXXXXXXXXXXXXXXXXXXXXGXXXXXXXXXXXXXXXXXXXXXXXXXXXXXXXXXXXXXXXGXXXXXXXXXXXXXXXXXXXXXXXXXXXXXXXXXXXXXXXXXXXXXXXXXXXXXXXXXXXXXXXXXXXXXXXXXXXXXXXXXXXXXXXXXXXXXXXXXXXXXXXXXXXXXXXXXXXXXXXGXXXXXXXXXXXXXXXXXXX,0,0,0
441,7,7,0,178,155,0,0,315,54,261,XXXXXXXXXXXXXXXXXXXXGAXXXXXXXXXXXXXXXXXXXXXXXXXXXXXXXXXXXXXXXXXXXXXXXXXXXXXXXXXXGXXXXXXXXXXXXXXXXXXXXXXXXXXXXXXXXXXXXXXXGXXXXXXXXXXXXXXXXXXXXXXXXXXXXXXXXXXXXXXXGXXXXXXXXXXXXXXXXXXXGXXXXXXXXXXXXXXXXXXXXXXXXXXXXXXXXXXXXXXXXXXXXXXXXXXXXXXXXXXXGXXXXXXXXXXXXXXXXXXX,0,0,0
462,8,8,0,200,132,0,0,292,63,229,XXXXXXXXXXXXXXXXXXXXGAXXXXXXXXXXXXXXXXXXXXXXXXXXXXXXXXXXXXXXGXXXXXXXXXXXXXXXXXXXGXXXXXXXXXXXXXXXXXXXXXXXXXXXXXXXXXXXXXXXGXXXXXXXXXXXXXXXXXXXXXXXXXXXXXXXXXXXXXXXGXXXXXXXXXXXXXXXXXXXGXXXXXXXXXXXXXXXXXXXXXXXXXXXXXXXXXXXXXXXXXXXXXXXXXXXXXXXXXXXGXXXXXXXXXXXXXXXXXXX,0,0,0
483,9,9,0,224,107,0,0,267,76,191,XXXXXXXXXXXXXXXXXXXXGAXXXXXXXXXXXXXXXXXXXXXXXXXXXXXXXXXXXXXXGXXXXXXXXXXXXXXXXXXXGXXXXXXXXXXXXXXXXXXXXXXXXXXXXXXXXXXXXXXXGXXXXXXXXXXXXXXXXXXXGXXXXXXXXXXXXXXXXXXXGXXXXXXXXXXXXXXXXXXXGXXXXXXXXXXXXXXXXXXXXXXXXXXXXXXXXXXXXXXXXXXXXXXXXXXXXXXXXXXXGXXXXXXXXXXXXXXXXXXX,0,0,0
504,10,10,0,248,82,0,0,242,82,160,XXXXXXXXXXXXXXXXXXXXGAXXXXXXXXXXXXXXXXXXXXXXXXXXXXXXXXXXXXXXGXXXXXXXXXXXXXXXXXXXGXXXXXXXXXXXXXXXXXXXGXXXXXXXXXXXXXXXXXXXGXXXXXXXXXXXXXXXXXXXGXXXXXXXXXXXXXXXXXXXGXXXXXXXXXXXXXXXXXXXGXXXXXXXXXXXXXXXXXXXXXXXXXXXXXXXXXXXXXXXXXXXXXXXXXXXXXXXXXXXGXXXXXXXXXXXXXXXXXXX,0,0,0

525,10,10,0,260,70,0,0,230,104,126,XXXXXXXXXXXXXXXXXXXXGAXXXXXXXXXXXXXXXXXXXXXXXXXXXXXXXXXXXXXXGXXXXXXXXXXXXXXXXXXXGXXXXXXXXXXXXXXXXXXXGXXXXXXXXXXXXXXXXXXXGXXXXXXXXXXXXXXXXXXXGXXXXXXXXXXXXXXXXXXXGXXXXXXXXXXXXXXXXXXXGXXXXXXXXXXXXXXXXXXXXXXXXXXXXXXXXXXXXXXXXXXXXXXXXXXXXXXXXXXXGXXXXXXXXXXXXXXXXXXX,0,0,0
546,11,10,1,272,57,0,0,217,123,94,XXXXXXXXXXXXXXXXXXXXGAXXXXXXXXXXXXXXXXXXXXXXXXXXXXXXXXXXXXXXGXXXXXXXXXXXXXXXXXXXGXXXXXXXXXXXXXXXXXXXGXXXXXXXXXXXXXXXXXXXGXXXXXXXXXXXXXXXXXXXGXXXXXXXXXXXXXXXXXXXGXXXXXXXXXXXXXXXXXXXGXXXXXXXXXXXXXXXXXXXGXXXXXXXXXXXXXXXXXXXXXXXXXXXXXXXXXXXXXXXGXXXXXXXXXXXXXXXXXXX,0,0,0
567,11,10,1,276,53,0,0,212,150,62,XXXXXXXXXXXXXXXXXXXXGAXXXXXXXXXXXXXXXXXXXXXXXXXXXXXXXXXXXXXXGXXXXXXXXXXXXXXXXXXXGXXXXXXXXXXXXXXXXXXXGXXXXXXXXXXXXXXXXXXXGXXXXXXXXXXXXXXXXXXXGXXXXXXXXXXXXXXXXXXXGXXXXXXXXXXXXXXXXXXXGXXXXXXXXXXXXXXXXXXXGXXXXXXXXXXXXXXXXXXXXXXXXXXXXXXXXXXXXXXXGXXXXXXXXXXXXXXXXXXX,0,0,0
588,12,11,1,277,51,0,0,211,178,33,GXXXXXXXXXXXXXXXXXXXGAXXXXXXXXXXXXXXXXXXXXXXXXXXXXXXXXXXXXXXGXXXXXXXXXXXXXXXXXXXGXXXXXXXXXXXXXXXXXXXGXXXXXXXXXXXXXXXXXXXGXXXXXXXXXXXXXXXXXXXGXXXXXXXXXXXXXXXXXXXGXXXXXXXXXXXXXXXXXXXGXXXXXXXXXXXXXXXXXXXGXXXXXXXXXXXXXXXXXXXXXXXXXXXXXXXXXXXXXXXGXXXXXXXXXXXXXXXXXXX,0,0,0
609,12,10,2,282,46,0,0,206,179,27,GXXXXXXXXXXXXXXXXXXXGAXXXXXXXXXXXXXXXXXXXXXXXXXXXXXXXXXXXXXXGXXXXXXXXXXXXXXXXXXXGXXXXXXXXXXXXXXXXXXXGXXXXXXXXXXXXXXXXXXXGXXXXXXXXXXXXXXXXXXXGXXXXXXXXXXXXXXXXXXXGXXXXXXXXXXXXXXXXXXXGXXXXXXXXXXXXXXXXXXXGXXXXXXXXXXXXXXXXXXXXXXXXXXXXXXXXXXXXXXXGXXXXXXXXXXXXXXXXXXX,0,0,0

630,12,9,3,281,47,0,0,206,170,36,GXXXXXXXXXXXXXXXXXXXGAXXXXXXXXXXXXXXXXXXXXXXXXXXXXXXXXXXXXXXGXXXXXXXXXXXXXXXXXXXGXXXXXXXXXXXXXXXXXXXGXXXXXXXXXXXXXXXXXXXGXXXXXXXXXXXXXXXXXXXGXXXXXXXXXXXXXXXXXXXGXXXXXXXXXXXXXXXXXXXGXXXXXXXXXXXXXXXXXXXGXXXXXXXXXXXXXXXXXXXXXXXXXXXXXXXXXXXXXXXGXXXXXXXXXXXXXXXXXXX,0,0,0
651,12,9,3,278,50,0,0,210,160,50,GXXXXXXXXXXXXXXXXXXXGAXXXXXXXXXXXXXXXXXXXXXXXXXXXXXXXXXXXXXXGXXXXXXXXXXXXXXXXXXXGXXXXXXXXXXXXXXXXXXXGXXXXXXXXXXXXXXXXXXXGXXXXXXXXXXXXXXXXXXXGXXXXXXXXXXXXXXXXXXXGXXXXXXXXXXXXXXXXXXXGXXXXXXXXXXXXXXXXXXXGXXXXXXXXXXXXXXXXXXXXXXXXXXXXXXXXXXXXXXXGXXXXXXXXXXXXXXXXXXX,0,0,0
672,14,11,3,264,62,0,0,221,154,67,GXXXXXXXXXXXXXXXXXXXGAXXXXXXXXXXXXXXXXXXXXXXXXXXXXXXXXXXXXXXGAXXXXXXXXXXXXXXXXXXGXXXXXXXXXXXXXXXXXXXGXXXXXXXXXXXXXXXXXXXGXXXXXXXXXXXXXXXXXXXGXXXXXXXXXXXXXXXXXXXGXXXXXXXXXXXXXXXXXXXGXXXXXXXXXXXXXXXXXXXGXXXXXXXXXXXXXXXXXXXXXXXXXXXXXXXXXXXXXXXGAXXXXXXXXXXXXXXXXXX,0,0,0
693,15,11,4,265,60,0,0,220,141,79,GXXXXXXXXXXXXXXXXXXXGAXXXXXXXXXXXXXXXXXXGXXXXXXXXXXXXXXXXXXXGAXXXXXXXXXXXXXXXXXXGXXXXXXXXXXXXXXXXXXXGXXXXXXXXXXXXXXXXXXXGXXXXXXXXXXXXXXXXXXXGXXXXXXXXXXXXXXXXXXXGXXXXXXXXXXXXXXXXXXXGXXXXXXXXXXXXXXXXXXXGXXXXXXXXXXXXXXXXXXXXXXXXXXXXXXXXXXXXXXXGAXXXXXXXXXXXXXXXXXX,0,0,0
714,15,10,5,262,63,0,0,220,126,94,GXXXXXXXXXXXXXXXXXXXGAXXXXXXXXXXXXXXXXXXGXXXXXXXXXXXXXXXXXXXGAXXXXXXXXXXXXXXXXXXGXXXXXXXXXXXXXXXXXXXGXXXXXXXXXXXXXXXXXXXGXXXXXXXXXXXXXXXXXXXGXXXXXXXXXXXXXXXXXXXGXXXXXXXXXXXXXXXXXXXGXXXXXXXXXXXXXXXXXXXGXXXXXXXXXXXXXXXXXXXXXXXXXXXXXXXXXXXXXXXGAXXXXXXXXXXXXXXXXXX,0,0,0

735,15,10,5,253,72,0,0,230,109,121,GXXXXXXXXXXXXXXXXXXXGAXXXXXXXXXXXXXXXXXXGXXXXXXXXXXXXXXXXXXXGAXXXXXXXXXXXXXXXXXXGXXXXXXXXXXXXXXXXXXXGXXXXXXXXXXXXXXXXXXXGXXXXXXXXXXXXXXXXXXXGXXXXXXXXXXXXXXXXXXXGXXXXXXXXXXXXXXXXXXXGXXXXXXXXXXXXXXXXXXXGXXXXXXXXXXXXXXXXXXXXXXXXXXXXXXXXXXXXXXXGAXXXXXXXXXXXXXXXXXX,0,0,0
756,15,10,5,246,79,0,0,239,96,143,GXXXXXXXXXXXXXXXXXXXGAXXXXXXXXXXXXXXXXXXGXXXXXXXXXXXXXXXXXXXGAXXXXXXXXXXXXXXXXXXGXXXXXXXXXXXXXXXXXXXGXXXXXXXXXXXXXXXXXXXGXXXXXXXXXXXXXXXXXXXGXXXXXXXXXXXXXXXXXXXGXXXXXXXXXXXXXXXXXXXGXXXXXXXXXXXXXXXXXXXGXXXXXXXXXXXXXXXXXXXXXXXXXXXXXXXXXXXXXXXGAXXXXXXXXXXXXXXXXXX,0,0,0
777,15,8,7,247,78,0,0,238,75,163,GXXXXXXXXXXXXXXXXXXXGAXXXXXXXXXXXXXXXXXXGXXXXXXXXXXXXXXXXXXXGAXXXXXXXXXXXXXXXXXXGXXXXXXXXXXXXXXXXXXXGXXXXXXXXXXXXXXXXXXXGXXXXXXXXXXXXXXXXXXXGXXXXXXXXXXXXXXXXXXXGXXXXXXXXXXXXXXXXXXXGXXXXXXXXXXXXXXXXXXXGXXXXXXXXXXXXXXXXXXXXXXXXXXXXXXXXXXXXXXXGAXXXXXXXXXXXXXXXXXX,0,0,0
798,16,7,9,231,93,0,0,252,68,184,GXXXXXXXXXXXXXXXXXXXGAXXXXXXXXXXXXXXXXXXGXXXXXXXXXXXXXXXXXXXGAXXXXXXXXXXXXXXXXXXGXXXXXXXXXXXXXXXXXXXGXXXXXXXXXXXXXXXXXXXGXXXXXXXXXXXXXXXXXXXGAXXXXXXXXXXXXXXXXXXGXXXXXXXXXXXXXXXXXXXGXXXXXXXXXXXXXXXXXXXGXXXXXXXXXXXXXXXXXXXXXXXXXXXXXXXXXXXXXXXGAXXXXXXXXXXXXXXXXXX,0,0,0
819,17,7,10,227,96,0,0,256,54,202,GXXXXXXXXXXXXXXXXXXXGAXXXXXXXXXXXXXXXXXXGXXXXXXXXXXXXXXXXXXXGAXXXXXXXXXXXXXXXXXXGXXXXXXXXXXXXXXXXXXXGXXXXXXXXXXXXXXXXXXXGXXXXXXXXXXXXXXXXXXXGAXXXXXXXXXXXXXXXXXXGXXXXXXXXXXXXXXXXXXXGXXXXXXXXXXXXXXXXXXXGXXXXXXXXXXXXXXXXXXXGXXXXXXXXXXXXXXXXXXXGAXXXXXXXXXXXXXXXXXX,0,0,0

840,17,6,11,220,103,0,0,263,44,219,GXXXXXXXXXXXXXXXXXXXGOXXXXXXXXXXXXXXXXXXGXXXXXXXXXXXXXXXXXXXGAXXXXXXXXXXXXXXXXXXGXXXXXXXXXXXXXXXXXXXGXXXXXXXXXXXXXXXXXXXGXXXXXXXXXXXXXXXXXXXGAXXXXXXXXXXXXXXXXXXGXXXXXXXXXXXXXXXXXXXGXXXXXXXXXXXXXXXXXXXGXXXXXXXXXXXXXXXXXXXGXXXXXXXXXXXXXXXXXXXGAXXXXXXXXXXXXXXXXXX,0,0,0
861,17,5,12,210,113,0,0,272,39,233,GXXXXXXXXXXXXXXXXXXXGOXXXXXXXXXXXXXXXXXXGXXXXXXXXXXXXXXXXXXXGAXXXXXXXXXXXXXXXXXXGXXXXXXXXXXXXXXXXXXXGXXXXXXXXXXXXXXXXXXXGXXXXXXXXXXXXXXXXXXXGAXXXXXXXXXXXXXXXXXXGXXXXXXXXXXXXXXXXXXXGXXXXXXXXXXXXXXXXXXXGXXXXXXXXXXXXXXXXXXXGXXXXXXXXXXXXXXXXXXXGAXXXXXXXXXXXXXXXXXX,0,0,0
882,17,5,12,203,120,0,0,278,30,248,GXXXXXXXXXXXXXXXXXXXGOXXXXXXXXXXXXXXXXXXGXXXXXXXXXXXXXXXXXXXGAXXXXXXXXXXXXXXXXXXGXXXXXXXXXXXXXXXXXXXGXXXXXXXXXXXXXXXXXXXGXXXXXXXXXXXXXXXXXXXGAXXXXXXXXXXXXXXXXXXGXXXXXXXXXXXXXXXXXXXGXXXXXXXXXXXXXXXXXXXGXXXXXXXXXXXXXXXXXXXGXXXXXXXXXXXXXXXXXXXGAXXXXXXXXXXXXXXXXXX,0,0,0
903,18,6,12,206,116,0,0,276,24,252,GXXXXXXXXXXXXXXXXXXXGOXXXXXXXXXXXXXXXXXXGXXXXXXXXXXXXXXXXXXXGAAXXXXXXXXXXXXXXXXXGXXXXXXXXXXXXXXXXXXXGXXXXXXXXXXXXXXXXXXXGXXXXXXXXXXXXXXXXXXXGAXXXXXXXXXXXXXXXXXXGXXXXXXXXXXXXXXXXXXXGXXXXXXXXXXXXXXXXXXXGXXXXXXXXXXXXXXXXXXXGXXXXXXXXXXXXXXXXXXXGAXXXXXXXXXXXXXXXXXX,0,0,0
924,18,6,12,198,124,0,0,284,24,260,GXXXXXXXXXXXXXXXXXXXGOXXXXXXXXXXXXXXXXXXGXXXXXXXXXXXXXXXXXXXGAAXXXXXXXXXXXXXXXXXGXXXXXXXXXXXXXXXXXXXGXXXXXXXXXXXXXXXXXXXGXXXXXXXXXXXXXXXXXXXGAXXXXXXXXXXXXXXXXXXGXXXXXXXXXXXXXXXXXXXGXXXXXXXXXXXXXXXXXXXGXXXXXXXXXXXXXXXXXXXGXXXXXXXXXXXXXXXXXXXGAXXXXXXXXXXXXXXXXXX,0,0,0

945,18,4,14,194,128,0,0,288,20,268,GXXXXXXXXXXXXXXXXXXXGOXXXXXXXXXXXXXXXXXXGXXXXXXXXXXXXXXXXXXXGAOXXXXXXXXXXXXXXXXXGXXXXXXXXXXXXXXXXXXXGXXXXXXXXXXXXXXXXXXXGXXXXXXXXXXXXXXXXXXXGAXXXXXXXXXXXXXXXXXXGXXXXXXXXXXXXXXXXXXXGXXXXXXXXXXXXXXXXXXXGXXXXXXXXXXXXXXXXXXXGXXXXXXXXXXXXXXXXXXXGAXXXXXXXXXXXXXXXXXX,0,0,0
966,19,3,16,181,140,0,0,300,21,279,GXXXXXXXXXXXXXXXXXXXGOXXXXXXXXXXXXXXXXXXGXXXXXXXXXXXXXXXXXXXGAOXXXXXXXXXXXXXXXXXGXXXXXXXXXXXXXXXXXXXGXXXXXXXXXXXXXXXXXXXGXXXXXXXXXXXXXXXXXXXGOAXXXXXXXXXXXXXXXXXGXXXXXXXXXXXXXXXXXXXGXXXXXXXXXXXXXXXXXXXGXXXXXXXXXXXXXXXXXXXGXXXXXXXXXXXXXXXXXXXGOXXXXXXXXXXXXXXXXXX,0,0,0
987,19,3,16,174,147,0,0,307,23,284,GXXXXXXXXXXXXXXXXXXXGOXXXXXXXXXXXXXXXXXXGXXXXXXXXXXXXXXXXXXXGAOXXXXXXXXXXXXXXXXXGXXXXXXXXXXXXXXXXXXXGXXXXXXXXXXXXXXXXXXXGXXXXXXXXXXXXXXXXXXXGOAXXXXXXXXXXXXXXXXXGXXXXXXXXXXXXXXXXXXXGXXXXXXXXXXXXXXXXXXXGXXXXXXXXXXXXXXXXXXXGXXXXXXXXXXXXXXXXXXXGOXXXXXXXXXXXXXXXXXX,0,0,0
1008,19,1,18,172,149,0,0,307,23,284,GXXXXXXXXXXXXXXXXXXXGOXXXXXXXXXXXXXXXXXXGXXXXXXXXXXXXXXXXXXXGOOXXXXXXXXXXXXXXXXXGXXXXXXXXXXXXXXXXXXXGXXXXXXXXXXXXXXXXXXXGXXXXXXXXXXXXXXXXXXXGOAXXXXXXXXXXXXXXXXXGXXXXXXXXXXXXXXXXXXXGXXXXXXXXXXXXXXXXXXXGXXXXXXXXXXXXXXXXXXXGXXXXXXXXXXXXXXXXXXXGOXXXXXXXXXXXXXXXXXX,0,0,0
1029,19,1,18,169,152,0,0,310,21,289,GXXXXXXXXXXXXXXXXXXXGOXXXXXXXXXXXXXXXXXXGXXXXXXXXXXXXXXXXXXXGOOXXXXXXXXXXXXXXXXXGXXXXXXXXXXXXXXXXXXXGXXXXXXXXXXXXXXXXXXXGXXXXXXXXXXXXXXXXXXXGOAXXXXXXXXXXXXXXXXXGXXXXXXXXXXXXXXXXXXXGXXXXXXXXXXXXXXXXXXXGXXXXXXXXXXXXXXXXXXXGXXXXXXXXXXXXXXXXXXXGOXXXXXXXXXXXXXXXXXX,0,0,0

1050,19,1,18,164,157,0,0,317,23,294,GXXXXXXXXXXXXXXXXXXXGOXXXXXXXXXXXXXXXXXXGXXXXXXXXXXXXXXXXXXXGOOXXXXXXXXXXXXXXXXXGXXXXXXXXXXXXXXXXXXXGXXXXXXXXXXXXXXXXXXXGXXXXXXXXXXXXXXXXXXXGOAXXXXXXXXXXXXXXXXXGXXXXXXXXXXXXXXXXXXXGXXXXXXXXXXXXXXXXXXXGXXXXXXXXXXXXXXXXXXXGXXXXXXXXXXXXXXXXXXXGOXXXXXXXXXXXXXXXXXX,0,0,0
1071,20,2,18,158,162,0,0,321,29,292,GXXXXXXXXXXXXXXXXXXXGOXXXXXXXXXXXXXXXXXXGXXXXXXXXXXXXXXXXXXXGOOXXXXXXXXXXXXXXXXXGXXXXXXXXXXXXXXXXXXXGXXXXXXXXXXXXXXXXXXXGXXXXXXXXXXXXXXXXXXXGOAXXXXXXXXXXXXXXXXXGXXXXXXXXXXXXXXXXXXXGXXXXXXXXXXXXXXXXXXXGAXXXXXXXXXXXXXXXXXXGXXXXXXXXXXXXXXXXXXXGOXXXXXXXXXXXXXXXXXX,0,0,0
1092,20,1,19,159,161,0,0,321,35,286,GXXXXXXXXXXXXXXXXXXXGOXXXXXXXXXXXXXXXXXXGXXXXXXXXXXXXXXXXXXXGOOXXXXXXXXXXXXXXXXXGXXXXXXXXXXXXXXXXXXXGXXXXXXXXXXXXXXXXXXXGXXXXXXXXXXXXXXXXXXXGOAXXXXXXXXXXXXXXXXXGXXXXXXXXXXXXXXXXXXXGXXXXXXXXXXXXXXXXXXXGOXXXXXXXXXXXXXXXXXXGXXXXXXXXXXXXXXXXXXXGOXXXXXXXXXXXXXXXXXX,0,0,0
1113,20,1,19,161,159,0,0,318,38,280,GXXXXXXXXXXXXXXXXXXXGOXXXXXXXXXXXXXXXXXXGXXXXXXXXXXXXXXXXXXXGOOXXXXXXXXXXXXXXXXXGXXXXXXXXXXXXXXXXXXXGXXXXXXXXXXXXXXXXXXXGXXXXXXXXXXXXXXXXXXXGOAXXXXXXXXXXXXXXXXXGXXXXXXXXXXXXXXXXXXXGXXXXXXXXXXXXXXXXXXXGOXXXXXXXXXXXXXXXXXXGXXXXXXXXXXXXXXXXXXXGOXXXXXXXXXXXXXXXXXX,0,0,0
1134,20,1,19,160,160,0,0,320,39,281,GXXXXXXXXXXXXXXXXXXXGOXXXXXXXXXXXXXXXXXXGXXXXXXXXXXXXXXXXXXXGOOXXXXXXXXXXXXXXXXXGXXXXXXXXXXXXXXXXXXXGXXXXXXXXXXXXXXXXXXXGXXXXXXXXXXXXXXXXXXXGOAXXXXXXXXXXXXXXXXXGXXXXXXXXXXXXXXXXXXXGXXXXXXXXXXXXXXXXXXXGOXXXXXXXXXXXXXXXXXXGXXXXXXXXXXXXXXXXXXXGOXXXXXXXXXXXXXXXXXX,0,0,0

1155,20,1,19,168,152,0,0,311,38,273,GXXXXXXXXXXXXXXXXXXXGOXXXXXXXXXXXXXXXXXXGXXXXXXXXXXXXXXXXXXXGOOXXXXXXXXXXXXXXXXXGXXXXXXXXXXXXXXXXXXXGXXXXXXXXXXXXXXXXXXXGXXXXXXXXXXXXXXXXXXXGOAXXXXXXXXXXXXXXXXXGXXXXXXXXXXXXXXXXXXXGXXXXXXXXXXXXXXXXXXXGOXXXXXXXXXXXXXXXXXXGXXXXXXXXXXXXXXXXXXXGOXXXXXXXXXXXXXXXXXX,0,0,0
1176,20,1,19,166,154,0,0,314,35,279,GXXXXXXXXXXXXXXXXXXXGOXXXXXXXXXXXXXXXXXXGXXXXXXXXXXXXXXXXXXXGOOXXXXXXXXXXXXXXXXXGXXXXXXXXXXXXXXXXXXXGXXXXXXXXXXXXXXXXXXXGXXXXXXXXXXXXXXXXXXXGOAXXXXXXXXXXXXXXXXXGXXXXXXXXXXXXXXXXXXXGXXXXXXXXXXXXXXXXXXXGOXXXXXXXXXXXXXXXXXXGXXXXXXXXXXXXXXXXXXXGOXXXXXXXXXXXXXXXXXX,0,0,0
1197,20,0,20,161,159,0,0,319,45,274,GXXXXXXXXXXXXXXXXXXXGOXXXXXXXXXXXXXXXXXXGXXXXXXXXXXXXXXXXXXXGOOXXXXXXXXXXXXXXXXXGXXXXXXXXXXXXXXXXXXXGXXXXXXXXXXXXXXXXXXXGXXXXXXXXXXXXXXXXXXXGOOXXXXXXXXXXXXXXXXXGXXXXXXXXXXXXXXXXXXXGXXXXXXXXXXXXXXXXXXXGOXXXXXXXXXXXXXXXXXXGXXXXXXXXXXXXXXXXXXXGOXXXXXXXXXXXXXXXXXX,0,0,0
1218,20,0,20,172,148,0,0,308,42,266,GXXXXXXXXXXXXXXXXXXXGOXXXXXXXXXXXXXXXXXXGXXXXXXXXXXXXXXXXXXXGOOXXXXXXXXXXXXXXXXXGXXXXXXXXXXXXXXXXXXXGXXXXXXXXXXXXXXXXXXXGXXXXXXXXXXXXXXXXXXXGOOXXXXXXXXXXXXXXXXXGXXXXXXXXXXXXXXXXXXXGXXXXXXXXXXXXXXXXXXXGOXXXXXXXXXXXXXXXXXXGXXXXXXXXXXXXXXXXXXXGOXXXXXXXXXXXXXXXXXX,0,0,0
1239,21,1,20,179,140,0,0,300,38,262,GXXXXXXXXXXXXXXXXXXXGOXXXXXXXXXXXXXXXXXXGXXXXXXXXXXXXXXXXXXXGOOXXXXXXXXXXXXXXXXXGXXXXXXXXXXXXXXXXXXXGXXXXXXXXXXXXXXXXXXXGXXXXXXXXXXXXXXXXXXXGOOXXXXXXXXXXXXXXXXXGAXXXXXXXXXXXXXXXXXXGXXXXXXXXXXXXXXXXXXXGOXXXXXXXXXXXXXXXXXXGXXXXXXXXXXXXXXXXXXXGOXXXXXXXXXXXXXXXXXX,0,0,0

1260,21,1,20,175,144,0,0,302,35,267,GXXXXXXXXXXXXXXXXXXXGOXXXXXXXXXXXXXXXXXXGXXXXXXXXXXXXXXXXXXXGOOXXXXXXXXXXXXXXXXXGXXXXXXXXXXXXXXXXXXXGXXXXXXXXXXXXXXXXXXXGXXXXXXXXXXXXXXXXXXXGOOXXXXXXXXXXXXXXXXXGAXXXXXXXXXXXXXXXXXXGXXXXXXXXXXXXXXXXXXXGOXXXXXXXXXXXXXXXXXXGXXXXXXXXXXXXXXXXXXXGOXXXXXXXXXXXXXXXXXX,0,0,0
1281,22,2,20,172,146,0,0,306,46,260,GXXXXXXXXXXXXXXXXXXXGOXXXXXXXXXXXXXXXXXXGXXXXXXXXXXXXXXXXXXXGOOXXXXXXXXXXXXXXXXXGXXXXXXXXXXXXXXXXXXXGXXXXXXXXXXXXXXXXXXXGXXXXXXXXXXXXXXXXXXXGOOXXXXXXXXXXXXXXXXXGAAXXXXXXXXXXXXXXXXXGXXXXXXXXXXXXXXXXXXXGOXXXXXXXXXXXXXXXXXXGXXXXXXXXXXXXXXXXXXXGOXXXXXXXXXXXXXXXXXX,0,0,0
1302,22,2,20,172,146,0,0,305,45,260,GXXXXXXXXXXXXXXXXXXXGOXXXXXXXXXXXXXXXXXXGXXXXXXXXXXXXXXXXXXXGOOXXXXXXXXXXXXXXXXXGXXXXXXXXXXXXXXXXXXXGXXXXXXXXXXXXXXXXXXXGXXXXXXXXXXXXXXXXXXXGOOXXXXXXXXXXXXXXXXXGAAXXXXXXXXXXXXXXXXXGXXXXXXXXXXXXXXXXXXXGOXXXXXXXXXXXXXXXXXXGXXXXXXXXXXXXXXXXXXXGOXXXXXXXXXXXXXXXXXX,0,0,0
1323,22,2,20,179,139,0,0,298,41,257,GXXXXXXXXXXXXXXXXXXXGOXXXXXXXXXXXXXXXXXXGXXXXXXXXXXXXXXXXXXXGOOXXXXXXXXXXXXXXXXXGXXXXXXXXXXXXXXXXXXXGXXXXXXXXXXXXXXXXXXXGXXXXXXXXXXXXXXXXXXXGOOXXXXXXXXXXXXXXXXXGAAXXXXXXXXXXXXXXXXXGXXXXXXXXXXXXXXXXXXXGOXXXXXXXXXXXXXXXXXXGXXXXXXXXXXXXXXXXXXXGOXXXXXXXXXXXXXXXXXX,0,0,0
1344,22,2,20,159,159,0,0,317,47,270,GXXXXXXXXXXXXXXXXXXXGOXXXXXXXXXXXXXXXXXXGXXXXXXXXXXXXXXXXXXXGOOXXXXXXXXXXXXXXXXXGXXXXXXXXXXXXXXXXXXXGXXXXXXXXXXXXXXXXXXXGXXXXXXXXXXXXXXXXXXXGOOXXXXXXXXXXXXXXXXXGAAXXXXXXXXXXXXXXXXXGXXXXXXXXXXXXXXXXXXXGOXXXXXXXXXXXXXXXXXXGXXXXXXXXXXXXXXXXXXXGOXXXXXXXXXXXXXXXXXX,0,0,0

1365,22,2,20,163,155,0,0,315,53,262,GXXXXXXXXXXXXXXXXXXXGOXXXXXXXXXXXXXXXXXXGXXXXXXXXXXXXXXXXXXXGOOXXXXXXXXXXXXXXXXXGXXXXXXXXXXXXXXXXXXXGXXXXXXXXXXXXXXXXXXXGXXXXXXXXXXXXXXXXXXXGOOXXXXXXXXXXXXXXXXXGAAXXXXXXXXXXXXXXXXXGXXXXXXXXXXXXXXXXXXXGOXXXXXXXXXXXXXXXXXXGXXXXXXXXXXXXXXXXXXXGOXXXXXXXXXXXXXXXXXX,0,0,0
1386,22,2,20,169,149,0,0,309,42,267,GXXXXXXXXXXXXXXXXXXXGOXXXXXXXXXXXXXXXXXXGXXXXXXXXXXXXXXXXXXXGOOXXXXXXXXXXXXXXXXXGXXXXXXXXXXXXXXXXXXXGXXXXXXXXXXXXXXXXXXXGXXXXXXXXXXXXXXXXXXXGOOXXXXXXXXXXXXXXXXXGAAXXXXXXXXXXXXXXXXXGXXXXXXXXXXXXXXXXXXXGOXXXXXXXXXXXXXXXXXXGXXXXXXXXXXXXXXXXXXXGOXXXXXXXXXXXXXXXXXX,0,0,0
1407,23,3,20,178,139,0,0,299,39,260,GXXXXXXXXXXXXXXXXXXXGOXXXXXXXXXXXXXXXXXXGXXXXXXXXXXXXXXXXXXXGOOXXXXXXXXXXXXXXXXXGXXXXXXXXXXXXXXXXXXXGXXXXXXXXXXXXXXXXXXXGXXXXXXXXXXXXXXXXXXXGOOXXXXXXXXXXXXXXXXXGAAXXXXXXXXXXXXXXXXXGXXXXXXXXXXXXXXXXXXXGOXXXXXXXXXXXXXXXXXXGAXXXXXXXXXXXXXXXXXXGOXXXXXXXXXXXXXXXXXX,0,0,0
1428,23,3,20,180,137,0,0,295,40,255,GXXXXXXXXXXXXXXXXXXXGOXXXXXXXXXXXXXXXXXXGXXXXXXXXXXXXXXXXXXXGOOXXXXXXXXXXXXXXXXXGXXXXXXXXXXXXXXXXXXXGXXXXXXXXXXXXXXXXXXXGXXXXXXXXXXXXXXXXXXXGOOXXXXXXXXXXXXXXXXXGAAXXXXXXXXXXXXXXXXXGXXXXXXXXXXXXXXXXXXXGOXXXXXXXXXXXXXXXXXXGAXXXXXXXXXXXXXXXXXXGOXXXXXXXXXXXXXXXXXX,0,0,0
1449,23,2,21,183,134,0,0,294,46,248,GXXXXXXXXXXXXXXXXXXXGOXXXXXXXXXXXXXXXXXXGXXXXXXXXXXXXXXXXXXXGOOXXXXXXXXXXXXXXXXXGXXXXXXXXXXXXXXXXXXXGXXXXXXXXXXXXXXXXXXXGXXXXXXXXXXXXXXXXXXXGOOXXXXXXXXXXXXXXXXXGOAXXXXXXXXXXXXXXXXXGXXXXXXXXXXXXXXXXXXXGOXXXXXXXXXXXXXXXXXXGAXXXXXXXXXXXXXXXXXXGOXXXXXXXXXXXXXXXXXX,0,0,0

1470,23,2,21,188,129,0,0,287,50,237,GXXXXXXXXXXXXXXXXXXXGOXXXXXXXXXXXXXXXXXXGXXXXXXXXXXXXXXXXXXXGOOXXXXXXXXXXXXXXXXXGXXXXXXXXXXXXXXXXXXXGXXXXXXXXXXXXXXXXXXXGXXXXXXXXXXXXXXXXXXXGOOXXXXXXXXXXXXXXXXXGOAXXXXXXXXXXXXXXXXXGXXXXXXXXXXXXXXXXXXXGOXXXXXXXXXXXXXXXXXXGAXXXXXXXXXXXXXXXXXXGOXXXXXXXXXXXXXXXXXX,0,0,0
1491,23,2,21,186,131,0,0,291,51,240,GXXXXXXXXXXXXXXXXXXXGOXXXXXXXXXXXXXXXXXXGXXXXXXXXXXXXXXXXXXXGOOXXXXXXXXXXXXXXXXXGXXXXXXXXXXXXXXXXXXXGXXXXXXXXXXXXXXXXXXXGXXXXXXXXXXXXXXXXXXXGOOXXXXXXXXXXXXXXXXXGOAXXXXXXXXXXXXXXXXXGXXXXXXXXXXXXXXXXXXXGOXXXXXXXXXXXXXXXXXXGAXXXXXXXXXXXXXXXXXXGOXXXXXXXXXXXXXXXXXX,0,0,0
1512,24,3,21,185,131,0,0,291,51,240,GXXXXXXXXXXXXXXXXXXXGOXXXXXXXXXXXXXXXXXXGXXXXXXXXXXXXXXXXXXXGOOXXXXXXXXXXXXXXXXXGXXXXXXXXXXXXXXXXXXXGXXXXXXXXXXXXXXXXXXXGXXXXXXXXXXXXXXXXXXXGOOXXXXXXXXXXXXXXXXXGOAAXXXXXXXXXXXXXXXXGXXXXXXXXXXXXXXXXXXXGOXXXXXXXXXXXXXXXXXXGAXXXXXXXXXXXXXXXXXXGOXXXXXXXXXXXXXXXXXX,0,0,0
1533,24,3,21,193,123,0,0,283,42,241,GXXXXXXXXXXXXXXXXXXXGOXXXXXXXXXXXXXXXXXXGXXXXXXXXXXXXXXXXXXXGOOXXXXXXXXXXXXXXXXXGXXXXXXXXXXXXXXXXXXXGXXXXXXXXXXXXXXXXXXXGXXXXXXXXXXXXXXXXXXXGOOXXXXXXXXXXXXXXXXXGOAAXXXXXXXXXXXXXXXXGXXXXXXXXXXXXXXXXXXXGOXXXXXXXXXXXXXXXXXXGAXXXXXXXXXXXXXXXXXXGOXXXXXXXXXXXXXXXXXX,0,0,0
1554,26,4,22,187,127,0,0,288,40,248,GXXXXXXXXXXXXXXXXXXXGOXXXXXXXXXXXXXXXXXXGAXXXXXXXXXXXXXXXXXXGOOXXXXXXXXXXXXXXXXXGXXXXXXXXXXXXXXXXXXXGAXXXXXXXXXXXXXXXXXXGXXXXXXXXXXXXXXXXXXXGOOXXXXXXXXXXXXXXXXXGOAOXXXXXXXXXXXXXXXXGXXXXXXXXXXXXXXXXXXXGOXXXXXXXXXXXXXXXXXXGAXXXXXXXXXXXXXXXXXXGOXXXXXXXXXXXXXXXXXX,0,0,0

1575,26,4,22,180,134,0,0,295,41,254,GXXXXXXXXXXXXXXXXXXXGOXXXXXXXXXXXXXXXXXXGAXXXXXXXXXXXXXXXXXXGOOXXXXXXXXXXXXXXXXXGXXXXXXXXXXXXXXXXXXXGAXXXXXXXXXXXXXXXXXXGXXXXXXXXXXXXXXXXXXXGOOXXXXXXXXXXXXXXXXXGOAOXXXXXXXXXXXXXXXXGXXXXXXXXXXXXXXXXXXXGOXXXXXXXXXXXXXXXXXXGAXXXXXXXXXXXXXXXXXXGOXXXXXXXXXXXXXXXXXX,0,0,0
1596,26,3,23,179,135,0,0,294,44,250,GXXXXXXXXXXXXXXXXXXXGOXXXXXXXXXXXXXXXXXXGAXXXXXXXXXXXXXXXXXXGOOXXXXXXXXXXXXXXXXXGXXXXXXXXXXXXXXXXXXXGOXXXXXXXXXXXXXXXXXXGXXXXXXXXXXXXXXXXXXXGOOXXXXXXXXXXXXXXXXXGOAOXXXXXXXXXXXXXXXXGXXXXXXXXXXXXXXXXXXXGOXXXXXXXXXXXXXXXXXXGAXXXXXXXXXXXXXXXXXXGOXXXXXXXXXXXXXXXXXX,0,0,0
1617,26,2,24,180,134,0,0,295,38,257,GXXXXXXXXXXXXXXXXXXXGOXXXXXXXXXXXXXXXXXXGAXXXXXXXXXXXXXXXXXXGOOXXXXXXXXXXXXXXXXXGXXXXXXXXXXXXXXXXXXXGOXXXXXXXXXXXXXXXXXXGXXXXXXXXXXXXXXXXXXXGOOXXXXXXXXXXXXXXXXXGOOOXXXXXXXXXXXXXXXXGXXXXXXXXXXXXXXXXXXXGOXXXXXXXXXXXXXXXXXXGAXXXXXXXXXXXXXXXXXXGOXXXXXXXXXXXXXXXXXX,0,0,0
1638,26,2,24,183,131,0,0,291,36,255,GXXXXXXXXXXXXXXXXXXXGOXXXXXXXXXXXXXXXXXXGAXXXXXXXXXXXXXXXXXXGOOXXXXXXXXXXXXXXXXXGXXXXXXXXXXXXXXXXXXXGOXXXXXXXXXXXXXXXXXXGXXXXXXXXXXXXXXXXXXXGOOXXXXXXXXXXXXXXXXXGOOOXXXXXXXXXXXXXXXXGXXXXXXXXXXXXXXXXXXXGOXXXXXXXXXXXXXXXXXXGAXXXXXXXXXXXXXXXXXXGOXXXXXXXXXXXXXXXXXX,0,0,0
1659,27,3,24,181,132,0,0,293,39,254,GXXXXXXXXXXXXXXXXXXXGOXXXXXXXXXXXXXXXXXXGAXXXXXXXXXXXXXXXXXXGOOXXXXXXXXXXXXXXXXXGXXXXXXXXXXXXXXXXXXXGOXXXXXXXXXXXXXXXXXXGXXXXXXXXXXXXXXXXXXXGOOXXXXXXXXXXXXXXXXXGOOOXXXXXXXXXXXXXXXXGXXXXXXXXXXXXXXXXXXXGOXXXXXXXXXXXXXXXXXXGAXXXXXXXXXXXXXXXXXXGOAXXXXXXXXXXXXXXXXX,0,0,0

1680,27,3,24,185,128,0,0,289,39,250,GXXXXXXXXXXXXXXXXXXXGOXXXXXXXXXXXXXXXXXXGAXXXXXXXXXXXXXXXXXXGOOXXXXXXXXXXXXXXXXXGXXXXXXXXXXXXXXXXXXXGOXXXXXXXXXXXXXXXXXXGXXXXXXXXXXXXXXXXXXXGOOXXXXXXXXXXXXXXXXXGOOOXXXXXXXXXXXXXXXXGXXXXXXXXXXXXXXXXXXXGOXXXXXXXXXXXXXXXXXXGAXXXXXXXXXXXXXXXXXXGOAXXXXXXXXXXXXXXXXX,0,0,0
1701,27,3,24,182,131,0,0,291,48,243,GXXXXXXXXXXXXXXXXXXXGOXXXXXXXXXXXXXXXXXXGAXXXXXXXXXXXXXXXXXXGOOXXXXXXXXXXXXXXXXXGXXXXXXXXXXXXXXXXXXXGOXXXXXXXXXXXXXXXXXXGXXXXXXXXXXXXXXXXXXXGOOXXXXXXXXXXXXXXXXXGOOOXXXXXXXXXXXXXXXXGXXXXXXXXXXXXXXXXXXXGOXXXXXXXXXXXXXXXXXXGAXXXXXXXXXXXXXXXXXXGOAXXXXXXXXXXXXXXXXX,0,0,0
1722,27,3,24,187,126,0,0,286,45,241,GXXXXXXXXXXXXXXXXXXXGOXXXXXXXXXXXXXXXXXXGAXXXXXXXXXXXXXXXXXXGOOXXXXXXXXXXXXXXXXXGXXXXXXXXXXXXXXXXXXXGOXXXXXXXXXXXXXXXXXXGXXXXXXXXXXXXXXXXXXXGOOXXXXXXXXXXXXXXXXXGOOOXXXXXXXXXXXXXXXXGXXXXXXXXXXXXXXXXXXXGOXXXXXXXXXXXXXXXXXXGAXXXXXXXXXXXXXXXXXXGOAXXXXXXXXXXXXXXXXX,0,0,0
1743,27,3,24,190,123,0,0,279,39,240,GXXXXXXXXXXXXXXXXXXXGOXXXXXXXXXXXXXXXXXXGAXXXXXXXXXXXXXXXXXXGOOXXXXXXXXXXXXXXXXXGXXXXXXXXXXXXXXXXXXXGOXXXXXXXXXXXXXXXXXXGXXXXXXXXXXXXXXXXXXXGOOXXXXXXXXXXXXXXXXXGOOOXXXXXXXXXXXXXXXXGXXXXXXXXXXXXXXXXXXXGOXXXXXXXXXXXXXXXXXXGAXXXXXXXXXXXXXXXXXXGOAXXXXXXXXXXXXXXXXX,0,0,0
1764,28,3,25,188,124,0,0,283,40,243,GXXXXXXXXXXXXXXXXXXXGOAXXXXXXXXXXXXXXXXXGAXXXXXXXXXXXXXXXXXXGOOXXXXXXXXXXXXXXXXXGXXXXXXXXXXXXXXXXXXXGOXXXXXXXXXXXXXXXXXXGXXXXXXXXXXXXXXXXXXXGOOXXXXXXXXXXXXXXXXXGOOOXXXXXXXXXXXXXXXXGXXXXXXXXXXXXXXXXXXXGOXXXXXXXXXXXXXXXXXXGOXXXXXXXXXXXXXXXXXXGOAXXXXXXXXXXXXXXXXX,0,0,0

1785,29,4,25,180,131,0,0,290,43,247,GXXXXXXXXXXXXXXXXXXXGOAAXXXXXXXXXXXXXXXXGAXXXXXXXXXXXXXXXXXXGOOXXXXXXXXXXXXXXXXXGXXXXXXXXXXXXXXXXXXXGOXXXXXXXXXXXXXXXXXXGXXXXXXXXXXXXXXXXXXXGOOXXXXXXXXXXXXXXXXXGOOOXXXXXXXXXXXXXXXXGXXXXXXXXXXXXXXXXXXXGOXXXXXXXXXXXXXXXXXXGOXXXXXXXXXXXXXXXXXXGOAXXXXXXXXXXXXXXXXX,0,0,0
1806,29,4,25,179,132,0,0,292,47,245,GXXXXXXXXXXXXXXXXXXXGOAAXXXXXXXXXXXXXXXXGAXXXXXXXXXXXXXXXXXXGOOXXXXXXXXXXXXXXXXXGXXXXXXXXXXXXXXXXXXXGOXXXXXXXXXXXXXXXXXXGXXXXXXXXXXXXXXXXXXXGOOXXXXXXXXXXXXXXXXXGOOOXXXXXXXXXXXXXXXXGXXXXXXXXXXXXXXXXXXXGOXXXXXXXXXXXXXXXXXXGOXXXXXXXXXXXXXXXXXXGOAXXXXXXXXXXXXXXXXX,0,0,0
1827,30,5,25,183,127,0,0,287,45,242,GXXXXXXXXXXXXXXXXXXXGOAAXXXXXXXXXXXXXXXXGAXXXXXXXXXXXXXXXXXXGOOAXXXXXXXXXXXXXXXXGXXXXXXXXXXXXXXXXXXXGOXXXXXXXXXXXXXXXXXXGXXXXXXXXXXXXXXXXXXXGOOXXXXXXXXXXXXXXXXXGOOOXXXXXXXXXXXXXXXXGXXXXXXXXXXXXXXXXXXXGOXXXXXXXXXXXXXXXXXXGOXXXXXXXXXXXXXXXXXXGOAXXXXXXXXXXXXXXXXX,0,0,0
1848,31,4,27,180,129,0,0,289,40,249,GXXXXXXXXXXXXXXXXXXXGOAOXXXXXXXXXXXXXXXXGAXXXXXXXXXXXXXXXXXXGOOOXXXXXXXXXXXXXXXXGXXXXXXXXXXXXXXXXXXXGOXXXXXXXXXXXXXXXXXXGXXXXXXXXXXXXXXXXXXXGOOXXXXXXXXXXXXXXXXXGOOOAXXXXXXXXXXXXXXXGXXXXXXXXXXXXXXXXXXXGOXXXXXXXXXXXXXXXXXXGOXXXXXXXXXXXXXXXXXXGOAXXXXXXXXXXXXXXXXX,0,0,0
1869,31,4,27,185,124,0,0,282,35,247,GXXXXXXXXXXXXXXXXXXXGOAOXXXXXXXXXXXXXXXXGAXXXXXXXXXXXXXXXXXXGOOOXXXXXXXXXXXXXXXXGXXXXXXXXXXXXXXXXXXXGOXXXXXXXXXXXXXXXXXXGXXXXXXXXXXXXXXXXXXXGOOXXXXXXXXXXXXXXXXXGOOOAXXXXXXXXXXXXXXXGXXXXXXXXXXXXXXXXXXXGOXXXXXXXXXXXXXXXXXXGOXXXXXXXXXXXXXXXXXXGOAXXXXXXXXXXXXXXXXX,0,0,0

1890,32,5,27,187,121,0,0,279,37,242,GXXXXXXXXXXXXXXXXXXXGOAOXXXXXXXXXXXXXXXXGAXXXXXXXXXXXXXXXXXXGOOOXXXXXXXXXXXXXXXXGAXXXXXXXXXXXXXXXXXXGOXXXXXXXXXXXXXXXXXXGXXXXXXXXXXXXXXXXXXXGOOXXXXXXXXXXXXXXXXXGOOOAXXXXXXXXXXXXXXXGXXXXXXXXXXXXXXXXXXXGOXXXXXXXXXXXXXXXXXXGOXXXXXXXXXXXXXXXXXXGOAXXXXXXXXXXXXXXXXX,0,0,0
1911,33,3,30,180,127,0,0,287,43,244,GXXXXXXXXXXXXXXXXXXXGOOOXXXXXXXXXXXXXXXXGAOXXXXXXXXXXXXXXXXXGOOOXXXXXXXXXXXXXXXXGAXXXXXXXXXXXXXXXXXXGOXXXXXXXXXXXXXXXXXXGXXXXXXXXXXXXXXXXXXXGOOXXXXXXXXXXXXXXXXXGOOOAXXXXXXXXXXXXXXXGXXXXXXXXXXXXXXXXXXXGOXXXXXXXXXXXXXXXXXXGOXXXXXXXXXXXXXXXXXXGOOXXXXXXXXXXXXXXXXX,0,0,0
1932,33,2,31,184,123,0,0,283,32,251,GXXXXXXXXXXXXXXXXXXXGOOOXXXXXXXXXXXXXXXXGOOXXXXXXXXXXXXXXXXXGOOOXXXXXXXXXXXXXXXXGAXXXXXXXXXXXXXXXXXXGOXXXXXXXXXXXXXXXXXXGXXXXXXXXXXXXXXXXXXXGOOXXXXXXXXXXXXXXXXXGOOOAXXXXXXXXXXXXXXXGXXXXXXXXXXXXXXXXXXXGOXXXXXXXXXXXXXXXXXXGOXXXXXXXXXXXXXXXXXXGOOXXXXXXXXXXXXXXXXX,0,0,0
1953,33,2,31,182,125,0,0,285,35,250,GXXXXXXXXXXXXXXXXXXXGOOOXXXXXXXXXXXXXXXXGOOXXXXXXXXXXXXXXXXXGOOOXXXXXXXXXXXXXXXXGAXXXXXXXXXXXXXXXXXXGOXXXXXXXXXXXXXXXXXXGXXXXXXXXXXXXXXXXXXXGOOXXXXXXXXXXXXXXXXXGOOOAXXXXXXXXXXXXXXXGXXXXXXXXXXXXXXXXXXXGOXXXXXXXXXXXXXXXXXXGOXXXXXXXXXXXXXXXXXXGOOXXXXXXXXXXXXXXXXX,0,0,0
1974,33,2,31,180,127,0,0,284,42,242,GXXXXXXXXXXXXXXXXXXXGOOOXXXXXXXXXXXXXXXXGOOXXXXXXXXXXXXXXXXXGOOOXXXXXXXXXXXXXXXXGAXXXXXXXXXXXXXXXXXXGOXXXXXXXXXXXXXXXXXXGXXXXXXXXXXXXXXXXXXXGOOXXXXXXXXXXXXXXXXXGOOOAXXXXXXXXXXXXXXXGXXXXXXXXXXXXXXXXXXXGOXXXXXXXXXXXXXXXXXXGOXXXXXXXXXXXXXXXXXXGOOXXXXXXXXXXXXXXXXX,0,0,0

1995,34,3,31,175,131,0,0,291,37,254,GXXXXXXXXXXXXXXXXXXXGOOOXXXXXXXXXXXXXXXXGOOXXXXXXXXXXXXXXXXXGOOOXXXXXXXXXXXXXXXXGAXXXXXXXXXXXXXXXXXXGOXXXXXXXXXXXXXXXXXXGXXXXXXXXXXXXXXXXXXXGOOXXXXXXXXXXXXXXXXXGOOOAXXXXXXXXXXXXXXXGXXXXXXXXXXXXXXXXXXXGOXXXXXXXXXXXXXXXXXXGOXXXXXXXXXXXXXXXXXXGOOAXXXXXXXXXXXXXXXX,0,0,0
2016,35,3,32,175,130,0,0,290,38,252,GXXXXXXXXXXXXXXXXXXXGOOOXXXXXXXXXXXXXXXXGOOXXXXXXXXXXXXXXXXXGOOOXXXXXXXXXXXXXXXXGAXXXXXXXXXXXXXXXXXXGOAXXXXXXXXXXXXXXXXXGXXXXXXXXXXXXXXXXXXXGOOXXXXXXXXXXXXXXXXXGOOOOXXXXXXXXXXXXXXXGXXXXXXXXXXXXXXXXXXXGOXXXXXXXXXXXXXXXXXXGOXXXXXXXXXXXXXXXXXXGOOAXXXXXXXXXXXXXXXX,0,0,0
2037,36,4,32,167,137,0,0,294,44,250,GXXXXXXXXXXXXXXXXXXXGOOOXXXXXXXXXXXXXXXXGOOXXXXXXXXXXXXXXXXXGOOOXXXXXXXXXXXXXXXXGAXXXXXXXXXXXXXXXXXXGOAXXXXXXXXXXXXXXXXXGXXXXXXXXXXXXXXXXXXXGOOXXXXXXXXXXXXXXXXXGOOOOXXXXXXXXXXXXXXXGXXXXXXXXXXXXXXXXXXXGOXXXXXXXXXXXXXXXXXXGOAXXXXXXXXXXXXXXXXXGOOAXXXXXXXXXXXXXXXX,0,0,0
2058,36,4,32,171,133,0,0,292,35,257,GXXXXXXXXXXXXXXXXXXXGOOOXXXXXXXXXXXXXXXXGOOXXXXXXXXXXXXXXXXXGOOOXXXXXXXXXXXXXXXXGAXXXXXXXXXXXXXXXXXXGOAXXXXXXXXXXXXXXXXXGXXXXXXXXXXXXXXXXXXXGOOXXXXXXXXXXXXXXXXXGOOOOXXXXXXXXXXXXXXXGXXXXXXXXXXXXXXXXXXXGOXXXXXXXXXXXXXXXXXXGOAXXXXXXXXXXXXXXXXXGOOAXXXXXXXXXXXXXXXX,0,0,0
2079,37,4,33,167,136,0,0,296,46,250,GXXXXXXXXXXXXXXXXXXXGOOOXXXXXXXXXXXXXXXXGOOXXXXXXXXXXXXXXXXXGOOOXXXXXXXXXXXXXXXXGAXXXXXXXXXXXXXXXXXXGOAXXXXXXXXXXXXXXXXXGXXXXXXXXXXXXXXXXXXXGOOXXXXXXXXXXXXXXXXXGOOOOXXXXXXXXXXXXXXXGXXXXXXXXXXXXXXXXXXXGOAXXXXXXXXXXXXXXXXXGOOXXXXXXXXXXXXXXXXXGOOAXXXXXXXXXXXXXXXX,0,0,0

2100,37,4,33,168,135,0,0,293,48,245,GXXXXXXXXXXXXXXXXXXXGOOOXXXXXXXXXXXXXXXXGOOXXXXXXXXXXXXXXXXXGOOOXXXXXXXXXXXXXXXXGAXXXXXXXXXXXXXXXXXXGOAXXXXXXXXXXXXXXXXXGXXXXXXXXXXXXXXXXXXXGOOXXXXXXXXXXXXXXXXXGOOOOXXXXXXXXXXXXXXXGXXXXXXXXXXXXXXXXXXXGOAXXXXXXXXXXXXXXXXXGOOXXXXXXXXXXXXXXXXXGOOAXXXXXXXXXXXXXXXX,0,0,0
2121,37,3,34,172,131,0,0,291,47,244,GXXXXXXXXXXXXXXXXXXXGOOOXXXXXXXXXXXXXXXXGOOXXXXXXXXXXXXXXXXXGOOOXXXXXXXXXXXXXXXXGAXXXXXXXXXXXXXXXXXXGOAXXXXXXXXXXXXXXXXXGXXXXXXXXXXXXXXXXXXXGOOXXXXXXXXXXXXXXXXXGOOOOXXXXXXXXXXXXXXXGXXXXXXXXXXXXXXXXXXXGOOXXXXXXXXXXXXXXXXXGOOXXXXXXXXXXXXXXXXXGOOAXXXXXXXXXXXXXXXX,0,0,0
2142,37,3,34,174,129,0,0,288,43,245,GXXXXXXXXXXXXXXXXXXXGOOOXXXXXXXXXXXXXXXXGOOXXXXXXXXXXXXXXXXXGOOOXXXXXXXXXXXXXXXXGAXXXXXXXXXXXXXXXXXXGOAXXXXXXXXXXXXXXXXXGXXXXXXXXXXXXXXXXXXXGOOXXXXXXXXXXXXXXXXXGOOOOXXXXXXXXXXXXXXXGXXXXXXXXXXXXXXXXXXXGOOXXXXXXXXXXXXXXXXXGOOXXXXXXXXXXXXXXXXXGOOAXXXXXXXXXXXXXXXX,0,0,0
2163,37,3,34,171,132,0,0,291,43,248,GXXXXXXXXXXXXXXXXXXXGOOOXXXXXXXXXXXXXXXXGOOXXXXXXXXXXXXXXXXXGOOOXXXXXXXXXXXXXXXXGAXXXXXXXXXXXXXXXXXXGOAXXXXXXXXXXXXXXXXXGXXXXXXXXXXXXXXXXXXXGOOXXXXXXXXXXXXXXXXXGOOOOXXXXXXXXXXXXXXXGXXXXXXXXXXXXXXXXXXXGOOXXXXXXXXXXXXXXXXXGOOXXXXXXXXXXXXXXXXXGOOAXXXXXXXXXXXXXXXX,0,0,0
2184,37,3,34,168,135,0,0,295,49,246,GXXXXXXXXXXXXXXXXXXXGOOOXXXXXXXXXXXXXXXXGOOXXXXXXXXXXXXXXXXXGOOOXXXXXXXXXXXXXXXXGAXXXXXXXXXXXXXXXXXXGOAXXXXXXXXXXXXXXXXXGXXXXXXXXXXXXXXXXXXXGOOXXXXXXXXXXXXXXXXXGOOOOXXXXXXXXXXXXXXXGXXXXXXXXXXXXXXXXXXXGOOXXXXXXXXXXXXXXXXXGOOXXXXXXXXXXXXXXXXXGOOAXXXXXXXXXXXXXXXX,0,0,0

2205,37,3,34,167,136,0,0,295,50,245,GXXXXXXXXXXXXXXXXXXXGOOOXXXXXXXXXXXXXXXXGOOXXXXXXXXXXXXXXXXXGOOOXXXXXXXXXXXXXXXXGAXXXXXXXXXXXXXXXXXXGOAXXXXXXXXXXXXXXXXXGXXXXXXXXXXXXXXXXXXXGOOXXXXXXXXXXXXXXXXXGOOOOXXXXXXXXXXXXXXXGXXXXXXXXXXXXXXXXXXXGOOXXXXXXXXXXXXXXXXXGOOXXXXXXXXXXXXXXXXXGOOAXXXXXXXXXXXXXXXX,0,0,0
2226,37,2,35,174,129,0,0,288,41,247,GXXXXXXXXXXXXXXXXXXXGOOOXXXXXXXXXXXXXXXXGOOXXXXXXXXXXXXXXXXXGOOOXXXXXXXXXXXXXXXXGAXXXXXXXXXXXXXXXXXXGOAXXXXXXXXXXXXXXXXXGXXXXXXXXXXXXXXXXXXXGOOXXXXXXXXXXXXXXXXXGOOOOXXXXXXXXXXXXXXXGXXXXXXXXXXXXXXXXXXXGOOXXXXXXXXXXXXXXXXXGOOXXXXXXXXXXXXXXXXXGOOOXXXXXXXXXXXXXXXX,0,0,0
2247,38,3,35,166,136,0,0,296,49,247,GXXXXXXXXXXXXXXXXXXXGOOOXXXXXXXXXXXXXXXXGOOXXXXXXXXXXXXXXXXXGOOOXXXXXXXXXXXXXXXXGAXXXXXXXXXXXXXXXXXXGOAXXXXXXXXXXXXXXXXXGXXXXXXXXXXXXXXXXXXXGOOXXXXXXXXXXXXXXXXXGOOOOXXXXXXXXXXXXXXXGXXXXXXXXXXXXXXXXXXXGOOXXXXXXXXXXXXXXXXXGOOXXXXXXXXXXXXXXXXXGOOOAXXXXXXXXXXXXXXX,0,0,0
2268,38,2,36,165,137,0,0,297,46,251,GXXXXXXXXXXXXXXXXXXXGOOOXXXXXXXXXXXXXXXXGOOXXXXXXXXXXXXXXXXXGOOOXXXXXXXXXXXXXXXXGOXXXXXXXXXXXXXXXXXXGOAXXXXXXXXXXXXXXXXXGXXXXXXXXXXXXXXXXXXXGOOXXXXXXXXXXXXXXXXXGOOOOXXXXXXXXXXXXXXXGXXXXXXXXXXXXXXXXXXXGOOXXXXXXXXXXXXXXXXXGOOXXXXXXXXXXXXXXXXXGOOOAXXXXXXXXXXXXXXX,0,0,0
2289,38,2,36,166,136,0,0,293,42,251,GXXXXXXXXXXXXXXXXXXXGOOOXXXXXXXXXXXXXXXXGOOXXXXXXXXXXXXXXXXXGOOOXXXXXXXXXXXXXXXXGOXXXXXXXXXXXXXXXXXXGOAXXXXXXXXXXXXXXXXXGXXXXXXXXXXXXXXXXXXXGOOXXXXXXXXXXXXXXXXXGOOOOXXXXXXXXXXXXXXXGXXXXXXXXXXXXXXXXXXXGOOXXXXXXXXXXXXXXXXXGOOXXXXXXXXXXXXXXXXXGOOOAXXXXXXXXXXXXXXX,0,0,0

2310,38,2,36,170,132,0,0,291,43,248,GXXXXXXXXXXXXXXXXXXXGOOOXXXXXXXXXXXXXXXXGOOXXXXXXXXXXXXXXXXXGOOOXXXXXXXXXXXXXXXXGOXXXXXXXXXXXXXXXXXXGOAXXXXXXXXXXXXXXXXXGXXXXXXXXXXXXXXXXXXXGOOXXXXXXXXXXXXXXXXXGOOOOXXXXXXXXXXXXXXXGXXXXXXXXXXXXXXXXXXXGOOXXXXXXXXXXXXXXXXXGOOXXXXXXXXXXXXXXXXXGOOOAXXXXXXXXXXXXXXX,0,0,0
2331,38,2,36,172,130,0,0,290,40,250,GXXXXXXXXXXXXXXXXXXXGOOOXXXXXXXXXXXXXXXXGOOXXXXXXXXXXXXXXXXXGOOOXXXXXXXXXXXXXXXXGOXXXXXXXXXXXXXXXXXXGOAXXXXXXXXXXXXXXXXXGXXXXXXXXXXXXXXXXXXXGOOXXXXXXXXXXXXXXXXXGOOOOXXXXXXXXXXXXXXXGXXXXXXXXXXXXXXXXXXXGOOXXXXXXXXXXXXXXXXXGOOXXXXXXXXXXXXXXXXXGOOOAXXXXXXXXXXXXXXX,0,0,0
2352,38,2,36,168,134,0,0,292,51,241,GXXXXXXXXXXXXXXXXXXXGOOOXXXXXXXXXXXXXXXXGOOXXXXXXXXXXXXXXXXXGOOOXXXXXXXXXXXXXXXXGOXXXXXXXXXXXXXXXXXXGOAXXXXXXXXXXXXXXXXXGXXXXXXXXXXXXXXXXXXXGOOXXXXXXXXXXXXXXXXXGOOOOXXXXXXXXXXXXXXXGXXXXXXXXXXXXXXXXXXXGOOXXXXXXXXXXXXXXXXXGOOXXXXXXXXXXXXXXXXXGOOOAXXXXXXXXXXXXXXX,0,0,0
2373,39,2,37,168,133,0,0,293,55,238,GXXXXXXXXXXXXXXXXXXXGOOOXXXXXXXXXXXXXXXXGOOAXXXXXXXXXXXXXXXXGOOOXXXXXXXXXXXXXXXXGOXXXXXXXXXXXXXXXXXXGOOXXXXXXXXXXXXXXXXXGXXXXXXXXXXXXXXXXXXXGOOXXXXXXXXXXXXXXXXXGOOOOXXXXXXXXXXXXXXXGXXXXXXXXXXXXXXXXXXXGOOXXXXXXXXXXXXXXXXXGOOXXXXXXXXXXXXXXXXXGOOOAXXXXXXXXXXXXXXX,0,0,0
2394,39,2,37,170,131,0,0,290,62,228,GXXXXXXXXXXXXXXXXXXXGOOOXXXXXXXXXXXXXXXXGOOAXXXXXXXXXXXXXXXXGOOOXXXXXXXXXXXXXXXXGOXXXXXXXXXXXXXXXXXXGOOXXXXXXXXXXXXXXXXXGXXXXXXXXXXXXXXXXXXXGOOXXXXXXXXXXXXXXXXXGOOOOXXXXXXXXXXXXXXXGXXXXXXXXXXXXXXXXXXXGOOXXXXXXXXXXXXXXXXXGOOXXXXXXXXXXXXXXXXXGOOOAXXXXXXXXXXXXXXX,0,0,0

2415,39,2,37,178,123,0,0,284,55,229,GXXXXXXXXXXXXXXXXXXXGOOOXXXXXXXXXXXXXXXXGOOAXXXXXXXXXXXXXXXXGOOOXXXXXXXXXXXXXXXXGOXXXXXXXXXXXXXXXXXXGOOXXXXXXXXXXXXXXXXXGXXXXXXXXXXXXXXXXXXXGOOXXXXXXXXXXXXXXXXXGOOOOXXXXXXXXXXXXXXXGXXXXXXXXXXXXXXXXXXXGOOXXXXXXXXXXXXXXXXXGOOXXXXXXXXXXXXXXXXXGOOOAXXXXXXXXXXXXXXX,0,0,0
2436,39,2,37,180,121,0,0,281,53,228,GXXXXXXXXXXXXXXXXXXXGOOOXXXXXXXXXXXXXXXXGOOAXXXXXXXXXXXXXXXXGOOOXXXXXXXXXXXXXXXXGOXXXXXXXXXXXXXXXXXXGOOXXXXXXXXXXXXXXXXXGXXXXXXXXXXXXXXXXXXXGOOXXXXXXXXXXXXXXXXXGOOOOXXXXXXXXXXXXXXXGXXXXXXXXXXXXXXXXXXXGOOXXXXXXXXXXXXXXXXXGOOXXXXXXXXXXXXXXXXXGOOOAXXXXXXXXXXXXXXX,0,0,0
2457,39,2,37,183,118,0,0,278,49,229,GXXXXXXXXXXXXXXXXXXXGOOOXXXXXXXXXXXXXXXXGOOAXXXXXXXXXXXXXXXXGOOOXXXXXXXXXXXXXXXXGOXXXXXXXXXXXXXXXXXXGOOXXXXXXXXXXXXXXXXXGXXXXXXXXXXXXXXXXXXXGOOXXXXXXXXXXXXXXXXXGOOOOXXXXXXXXXXXXXXXGXXXXXXXXXXXXXXXXXXXGOOXXXXXXXXXXXXXXXXXGOOXXXXXXXXXXXXXXXXXGOOOAXXXXXXXXXXXXXXX,0,0,0
2478,41,4,37,179,120,0,0,281,50,231,GXXXXXXXXXXXXXXXXXXXGOOOXXXXXXXXXXXXXXXXGOOAXXXXXXXXXXXXXXXXGOOOXXXXXXXXXXXXXXXXGOXXXXXXXXXXXXXXXXXXGOOXXXXXXXXXXXXXXXXXGAXXXXXXXXXXXXXXXXXXGOOXXXXXXXXXXXXXXXXXGOOOOXXXXXXXXXXXXXXXGXXXXXXXXXXXXXXXXXXXGOOXXXXXXXXXXXXXXXXXGOOXXXXXXXXXXXXXXXXXGOOOAAXXXXXXXXXXXXXX,0,0,0
2499,42,4,38,176,122,0,0,281,51,230,GXXXXXXXXXXXXXXXXXXXGOOOXXXXXXXXXXXXXXXXGOOAXXXXXXXXXXXXXXXXGOOOXXXXXXXXXXXXXXXXGOXXXXXXXXXXXXXXXXXXGOOAXXXXXXXXXXXXXXXXGAXXXXXXXXXXXXXXXXXXGOOXXXXXXXXXXXXXXXXXGOOOOXXXXXXXXXXXXXXXGXXXXXXXXXXXXXXXXXXXGOOXXXXXXXXXXXXXXXXXGOOXXXXXXXXXXXXXXXXXGOOOOAXXXXXXXXXXXXXX,0,0,0

2520,42,4,38,180,118,0,0,279,59,220,GXXXXXXXXXXXXXXXXXXXGOOOXXXXXXXXXXXXXXXXGOOAXXXXXXXXXXXXXXXXGOOOXXXXXXXXXXXXXXXXGOXXXXXXXXXXXXXXXXXXGOOAXXXXXXXXXXXXXXXXGAXXXXXXXXXXXXXXXXXXGOOXXXXXXXXXXXXXXXXXGOOOOXXXXXXXXXXXXXXXGXXXXXXXXXXXXXXXXXXXGOOXXXXXXXXXXXXXXXXXGOOXXXXXXXXXXXXXXXXXGOOOOAXXXXXXXXXXXXXX,0,0,0
2541,44,6,38,182,114,0,0,274,46,228,GAXXXXXXXXXXXXXXXXXXGOOOXXXXXXXXXXXXXXXXGOOAXXXXXXXXXXXXXXXXGOOOXXXXXXXXXXXXXXXXGOXXXXXXXXXXXXXXXXXXGOOAXXXXXXXXXXXXXXXXGAXXXXXXXXXXXXXXXXXXGOOXXXXXXXXXXXXXXXXXGOOOOXXXXXXXXXXXXXXXGXXXXXXXXXXXXXXXXXXXGOOXXXXXXXXXXXXXXXXXGOOXXXXXXXXXXXXXXXXXGOOOOAAXXXXXXXXXXXXX,0,0,0
2562,44,5,39,180,116,0,0,276,44,232,GAXXXXXXXXXXXXXXXXXXGOOOXXXXXXXXXXXXXXXXGOOAXXXXXXXXXXXXXXXXGOOOXXXXXXXXXXXXXXXXGOXXXXXXXXXXXXXXXXXXGOOAXXXXXXXXXXXXXXXXGAXXXXXXXXXXXXXXXXXXGOOXXXXXXXXXXXXXXXXXGOOOOXXXXXXXXXXXXXXXGXXXXXXXXXXXXXXXXXXXGOOXXXXXXXXXXXXXXXXXGOOXXXXXXXXXXXXXXXXXGOOOOOAXXXXXXXXXXXXX,0,0,0
2583,44,4,40,172,124,0,0,283,44,239,GAXXXXXXXXXXXXXXXXXXGOOOXXXXXXXXXXXXXXXXGOOOXXXXXXXXXXXXXXXXGOOOXXXXXXXXXXXXXXXXGOXXXXXXXXXXXXXXXXXXGOOAXXXXXXXXXXXXXXXXGAXXXXXXXXXXXXXXXXXXGOOXXXXXXXXXXXXXXXXXGOOOOXXXXXXXXXXXXXXXGXXXXXXXXXXXXXXXXXXXGOOXXXXXXXXXXXXXXXXXGOOXXXXXXXXXXXXXXXXXGOOOOOAXXXXXXXXXXXXX,0,0,0
2604,44,3,41,173,123,0,0,282,57,225,GOXXXXXXXXXXXXXXXXXXGOOOXXXXXXXXXXXXXXXXGOOOXXXXXXXXXXXXXXXXGOOOXXXXXXXXXXXXXXXXGOXXXXXXXXXXXXXXXXXXGOOAXXXXXXXXXXXXXXXXGAXXXXXXXXXXXXXXXXXXGOOXXXXXXXXXXXXXXXXXGOOOOXXXXXXXXXXXXXXXGXXXXXXXXXXXXXXXXXXXGOOXXXXXXXXXXXXXXXXXGOOXXXXXXXXXXXXXXXXXGOOOOOAXXXXXXXXXXXXX,0,0,0

2625,44,3,41,171,125,0,0,285,56,229,GOXXXXXXXXXXXXXXXXXXGOOOXXXXXXXXXXXXXXXXGOOOXXXXXXXXXXXXXXXXGOOOXXXXXXXXXXXXXXXXGOXXXXXXXXXXXXXXXXXXGOOAXXXXXXXXXXXXXXXXGAXXXXXXXXXXXXXXXXXXGOOXXXXXXXXXXXXXXXXXGOOOOXXXXXXXXXXXXXXXGXXXXXXXXXXXXXXXXXXXGOOXXXXXXXXXXXXXXXXXGOOXXXXXXXXXXXXXXXXXGOOOOOAXXXXXXXXXXXXX,0,0,0
2646,44,3,41,169,127,0,0,287,52,235,GOXXXXXXXXXXXXXXXXXXGOOOXXXXXXXXXXXXXXXXGOOOXXXXXXXXXXXXXXXXGOOOXXXXXXXXXXXXXXXXGOXXXXXXXXXXXXXXXXXXGOOAXXXXXXXXXXXXXXXXGAXXXXXXXXXXXXXXXXXXGOOXXXXXXXXXXXXXXXXXGOOOOXXXXXXXXXXXXXXXGXXXXXXXXXXXXXXXXXXXGOOXXXXXXXXXXXXXXXXXGOOXXXXXXXXXXXXXXXXXGOOOOOAXXXXXXXXXXXXX,0,0,0
2667,44,3,41,176,120,0,0,279,47,232,GOXXXXXXXXXXXXXXXXXXGOOOXXXXXXXXXXXXXXXXGOOOXXXXXXXXXXXXXXXXGOOOXXXXXXXXXXXXXXXXGOXXXXXXXXXXXXXXXXXXGOOAXXXXXXXXXXXXXXXXGAXXXXXXXXXXXXXXXXXXGOOXXXXXXXXXXXXXXXXXGOOOOXXXXXXXXXXXXXXXGXXXXXXXXXXXXXXXXXXXGOOXXXXXXXXXXXXXXXXXGOOXXXXXXXXXXXXXXXXXGOOOOOAXXXXXXXXXXXXX,0,0,0
2688,44,3,41,171,125,0,0,285,45,240,GOXXXXXXXXXXXXXXXXXXGOOOXXXXXXXXXXXXXXXXGOOOXXXXXXXXXXXXXXXXGOOOXXXXXXXXXXXXXXXXGOXXXXXXXXXXXXXXXXXXGOOAXXXXXXXXXXXXXXXXGAXXXXXXXXXXXXXXXXXXGOOXXXXXXXXXXXXXXXXXGOOOOXXXXXXXXXXXXXXXGXXXXXXXXXXXXXXXXXXXGOOXXXXXXXXXXXXXXXXXGOOXXXXXXXXXXXXXXXXXGOOOOOAXXXXXXXXXXXXX,0,0,0
2709,44,2,42,169,127,0,0,286,41,245,GOXXXXXXXXXXXXXXXXXXGOOOXXXXXXXXXXXXXXXXGOOOXXXXXXXXXXXXXXXXGOOOXXXXXXXXXXXXXXXXGOXXXXXXXXXXXXXXXXXXGOOAXXXXXXXXXXXXXXXXGOXXXXXXXXXXXXXXXXXXGOOXXXXXXXXXXXXXXXXXGOOOOXXXXXXXXXXXXXXXGXXXXXXXXXXXXXXXXXXXGOOXXXXXXXXXXXXXXXXXGOOXXXXXXXXXXXXXXXXXGOOOOOAXXXXXXXXXXXXX,0,0,0

2730,44,2,42,168,128,0,0,288,52,236,GOXXXXXXXXXXXXXXXXXXGOOOXXXXXXXXXXXXXXXXGOOOXXXXXXXXXXXXXXXXGOOOXXXXXXXXXXXXXXXXGOXXXXXXXXXXXXXXXXXXGOOAXXXXXXXXXXXXXXXXGOXXXXXXXXXXXXXXXXXXGOOXXXXXXXXXXXXXXXXXGOOOOXXXXXXXXXXXXXXXGXXXXXXXXXXXXXXXXXXXGOOXXXXXXXXXXXXXXXXXGOOXXXXXXXXXXXXXXXXXGOOOOOAXXXXXXXXXXXXX,0,0,0
2751,44,1,43,172,124,0,0,284,52,232,GOXXXXXXXXXXXXXXXXXXGOOOXXXXXXXXXXXXXXXXGOOOXXXXXXXXXXXXXXXXGOOOXXXXXXXXXXXXXXXXGOXXXXXXXXXXXXXXXXXXGOOAXXXXXXXXXXXXXXXXGOXXXXXXXXXXXXXXXXXXGOOXXXXXXXXXXXXXXXXXGOOOOXXXXXXXXXXXXXXXGXXXXXXXXXXXXXXXXXXXGOOXXXXXXXXXXXXXXXXXGOOXXXXXXXXXXXXXXXXXGOOOOOOXXXXXXXXXXXXX,0,0,0
2772,44,1,43,175,121,0,0,281,49,232,GOXXXXXXXXXXXXXXXXXXGOOOXXXXXXXXXXXXXXXXGOOOXXXXXXXXXXXXXXXXGOOOXXXXXXXXXXXXXXXXGOXXXXXXXXXXXXXXXXXXGOOAXXXXXXXXXXXXXXXXGOXXXXXXXXXXXXXXXXXXGOOXXXXXXXXXXXXXXXXXGOOOOXXXXXXXXXXXXXXXGXXXXXXXXXXXXXXXXXXXGOOXXXXXXXXXXXXXXXXXGOOXXXXXXXXXXXXXXXXXGOOOOOOXXXXXXXXXXXXX,0,0,0
2793,44,0,44,178,118,0,0,278,53,225,GOXXXXXXXXXXXXXXXXXXGOOOXXXXXXXXXXXXXXXXGOOOXXXXXXXXXXXXXXXXGOOOXXXXXXXXXXXXXXXXGOXXXXXXXXXXXXXXXXXXGOOOXXXXXXXXXXXXXXXXGOXXXXXXXXXXXXXXXXXXGOOXXXXXXXXXXXXXXXXXGOOOOXXXXXXXXXXXXXXXGXXXXXXXXXXXXXXXXXXXGOOXXXXXXXXXXXXXXXXXGOOXXXXXXXXXXXXXXXXXGOOOOOOXXXXXXXXXXXXX,0,0,0
2814,44,0,44,180,116,0,0,276,51,225,GOXXXXXXXXXXXXXXXXXXGOOOXXXXXXXXXXXXXXXXGOOOXXXXXXXXXXXXXXXXGOOOXXXXXXXXXXXXXXXXGOXXXXXXXXXXXXXXXXXXGOOOXXXXXXXXXXXXXXXXGOXXXXXXXXXXXXXXXXXXGOOXXXXXXXXXXXXXXXXXGOOOOXXXXXXXXXXXXXXXGXXXXXXXXXXXXXXXXXXXGOOXXXXXXXXXXXXXXXXXGOOXXXXXXXXXXXXXXXXXGOOOOOOXXXXXXXXXXXXX,0,0,0

2835,44,0,44,176,120,0,0,280,50,230,GOXXXXXXXXXXXXXXXXXXGOOOXXXXXXXXXXXXXXXXGOOOXXXXXXXXXXXXXXXXGOOOXXXXXXXXXXXXXXXXGOXXXXXXXXXXXXXXXXXXGOOOXXXXXXXXXXXXXXXXGOXXXXXXXXXXXXXXXXXXGOOXXXXXXXXXXXXXXXXXGOOOOXXXXXXXXXXXXXXXGXXXXXXXXXXXXXXXXXXXGOOXXXXXXXXXXXXXXXXXGOOXXXXXXXXXXXXXXXXXGOOOOOOXXXXXXXXXXXXX,0,0,0
2856,44,0,44,175,121,0,0,280,52,228,GOXXXXXXXXXXXXXXXXXXGOOOXXXXXXXXXXXXXXXXGOOOXXXXXXXXXXXXXXXXGOOOXXXXXXXXXXXXXXXXGOXXXXXXXXXXXXXXXXXXGOOOXXXXXXXXXXXXXXXXGOXXXXXXXXXXXXXXXXXXGOOXXXXXXXXXXXXXXXXXGOOOOXXXXXXXXXXXXXXXGXXXXXXXXXXXXXXXXXXXGOOXXXXXXXXXXXXXXXXXGOOXXXXXXXXXXXXXXXXXGOOOOOOXXXXXXXXXXXXX,0,0,0
2877,44,0,44,166,130,0,0,290,55,235,GOXXXXXXXXXXXXXXXXXXGOOOXXXXXXXXXXXXXXXXGOOOXXXXXXXXXXXXXXXXGOOOXXXXXXXXXXXXXXXXGOXXXXXXXXXXXXXXXXXXGOOOXXXXXXXXXXXXXXXXGOXXXXXXXXXXXXXXXXXXGOOXXXXXXXXXXXXXXXXXGOOOOXXXXXXXXXXXXXXXGXXXXXXXXXXXXXXXXXXXGOOXXXXXXXXXXXXXXXXXGOOXXXXXXXXXXXXXXXXXGOOOOOOXXXXXXXXXXXXX,0,0,0
2898,44,0,44,164,132,0,0,293,49,244,GOXXXXXXXXXXXXXXXXXXGOOOXXXXXXXXXXXXXXXXGOOOXXXXXXXXXXXXXXXXGOOOXXXXXXXXXXXXXXXXGOXXXXXXXXXXXXXXXXXXGOOOXXXXXXXXXXXXXXXXGOXXXXXXXXXXXXXXXXXXGOOXXXXXXXXXXXXXXXXXGOOOOXXXXXXXXXXXXXXXGXXXXXXXXXXXXXXXXXXXGOOXXXXXXXXXXXXXXXXXGOOXXXXXXXXXXXXXXXXXGOOOOOOXXXXXXXXXXXXX,0,0,0
2919,44,0,44,163,133,0,0,293,50,243,GOXXXXXXXXXXXXXXXXXXGOOOXXXXXXXXXXXXXXXXGOOOXXXXXXXXXXXXXXXXGOOOXXXXXXXXXXXXXXXXGOXXXXXXXXXXXXXXXXXXGOOOXXXXXXXXXXXXXXXXGOXXXXXXXXXXXXXXXXXXGOOXXXXXXXXXXXXXXXXXGOOOOXXXXXXXXXXXXXXXGXXXXXXXXXXXXXXXXXXXGOOXXXXXXXXXXXXXXXXXGOOXXXXXXXXXXXXXXXXXGOOOOOOXXXXXXXXXXXXX,0,0,0

2940,44,0,44,161,135,0,0,295,48,247,GOXXXXXXXXXXXXXXXXXXGOOOXXXXXXXXXXXXXXXXGOOOXXXXXXXXXXXXXXXXGOOOXXXXXXXXXXXXXXXXGOXXXXXXXXXXXXXXXXXXGOOOXXXXXXXXXXXXXXXXGOXXXXXXXXXXXXXXXXXXGOOXXXXXXXXXXXXXXXXXGOOOOXXXXXXXXXXXXXXXGXXXXXXXXXXXXXXXXXXXGOOXXXXXXXXXXXXXXXXXGOOXXXXXXXXXXXXXXXXXGOOOOOOXXXXXXXXXXXXX,0,0,0
2961,44,0,44,163,133,0,0,294,45,249,GOXXXXXXXXXXXXXXXXXXGOOOXXXXXXXXXXXXXXXXGOOOXXXXXXXXXXXXXXXXGOOOXXXXXXXXXXXXXXXXGOXXXXXXXXXXXXXXXXXXGOOOXXXXXXXXXXXXXXXXGOXXXXXXXXXXXXXXXXXXGOOXXXXXXXXXXXXXXXXXGOOOOXXXXXXXXXXXXXXXGXXXXXXXXXXXXXXXXXXXGOOXXXXXXXXXXXXXXXXXGOOXXXXXXXXXXXXXXXXXGOOOOOOXXXXXXXXXXXXX,0,0,0
2982,44,0,44,168,128,0,0,289,40,249,GOXXXXXXXXXXXXXXXXXXGOOOXXXXXXXXXXXXXXXXGOOOXXXXXXXXXXXXXXXXGOOOXXXXXXXXXXXXXXXXGOXXXXXXXXXXXXXXXXXXGOOOXXXXXXXXXXXXXXXXGOXXXXXXXXXXXXXXXXXXGOOXXXXXXXXXXXXXXXXXGOOOOXXXXXXXXXXXXXXXGXXXXXXXXXXXXXXXXXXXGOOXXXXXXXXXXXXXXXXXGOOXXXXXXXXXXXXXXXXXGOOOOOOXXXXXXXXXXXXX,0,0,0
3003,45,1,44,169,126,0,0,286,43,243,GOXXXXXXXXXXXXXXXXXXGOOOXXXXXXXXXXXXXXXXGOOOXXXXXXXXXXXXXXXXGOOOXXXXXXXXXXXXXXXXGOXXXXXXXXXXXXXXXXXXGOOOXXXXXXXXXXXXXXXXGOAXXXXXXXXXXXXXXXXXGOOXXXXXXXXXXXXXXXXXGOOOOXXXXXXXXXXXXXXXGXXXXXXXXXXXXXXXXXXXGOOXXXXXXXXXXXXXXXXXGOOXXXXXXXXXXXXXXXXXGOOOOOOXXXXXXXXXXXXX,0,0,0
3024,45,1,44,171,124,0,0,285,42,243,GOXXXXXXXXXXXXXXXXXXGOOOXXXXXXXXXXXXXXXXGOOOXXXXXXXXXXXXXXXXGOOOXXXXXXXXXXXXXXXXGOXXXXXXXXXXXXXXXXXXGOOOXXXXXXXXXXXXXXXXGOAXXXXXXXXXXXXXXXXXGOOXXXXXXXXXXXXXXXXXGOOOOXXXXXXXXXXXXXXXGXXXXXXXXXXXXXXXXXXXGOOXXXXXXXXXXXXXXXXXGOOXXXXXXXXXXXXXXXXXGOOOOOOXXXXXXXXXXXXX,0,0,0

3045,45,1,44,164,131,0,0,292,40,252,GOXXXXXXXXXXXXXXXXXXGOOOXXXXXXXXXXXXXXXXGOOOXXXXXXXXXXXXXXXXGOOOXXXXXXXXXXXXXXXXGOXXXXXXXXXXXXXXXXXXGOOOXXXXXXXXXXXXXXXXGOAXXXXXXXXXXXXXXXXXGOOXXXXXXXXXXXXXXXXXGOOOOXXXXXXXXXXXXXXXGXXXXXXXXXXXXXXXXXXXGOOXXXXXXXXXXXXXXXXXGOOXXXXXXXXXXXXXXXXXGOOOOOOXXXXXXXXXXXXX,0,0,0
3066,45,0,45,165,130,0,0,291,45,246,GOXXXXXXXXXXXXXXXXXXGOOOXXXXXXXXXXXXXXXXGOOOXXXXXXXXXXXXXXXXGOOOXXXXXXXXXXXXXXXXGOXXXXXXXXXXXXXXXXXXGOOOXXXXXXXXXXXXXXXXGOOXXXXXXXXXXXXXXXXXGOOXXXXXXXXXXXXXXXXXGOOOOXXXXXXXXXXXXXXXGXXXXXXXXXXXXXXXXXXXGOOXXXXXXXXXXXXXXXXXGOOXXXXXXXXXXXXXXXXXGOOOOOOXXXXXXXXXXXXX,0,0,0
3087,45,0,45,167,128,0,0,289,43,246,GOXXXXXXXXXXXXXXXXXXGOOOXXXXXXXXXXXXXXXXGOOOXXXXXXXXXXXXXXXXGOOOXXXXXXXXXXXXXXXXGOXXXXXXXXXXXXXXXXXXGOOOXXXXXXXXXXXXXXXXGOOXXXXXXXXXXXXXXXXXGOOXXXXXXXXXXXXXXXXXGOOOOXXXXXXXXXXXXXXXGXXXXXXXXXXXXXXXXXXXGOOXXXXXXXXXXXXXXXXXGOOXXXXXXXXXXXXXXXXXGOOOOOOXXXXXXXXXXXXX,0,0,0
3108,45,0,45,165,130,0,0,291,41,250,GOXXXXXXXXXXXXXXXXXXGOOOXXXXXXXXXXXXXXXXGOOOXXXXXXXXXXXXXXXXGOOOXXXXXXXXXXXXXXXXGOXXXXXXXXXXXXXXXXXXGOOOXXXXXXXXXXXXXXXXGOOXXXXXXXXXXXXXXXXXGOOXXXXXXXXXXXXXXXXXGOOOOXXXXXXXXXXXXXXXGXXXXXXXXXXXXXXXXXXXGOOXXXXXXXXXXXXXXXXXGOOXXXXXXXXXXXXXXXXXGOOOOOOXXXXXXXXXXXXX,0,0,0
3129,46,1,45,158,136,0,0,297,49,248,GOXXXXXXXXXXXXXXXXXXGOOOXXXXXXXXXXXXXXXXGOOOXXXXXXXXXXXXXXXXGOOOXXXXXXXXXXXXXXXXGOXXXXXXXXXXXXXXXXXXGOOOXXXXXXXXXXXXXXXXGOOXXXXXXXXXXXXXXXXXGOOAXXXXXXXXXXXXXXXXGOOOOXXXXXXXXXXXXXXXGXXXXXXXXXXXXXXXXXXXGOOXXXXXXXXXXXXXXXXXGOOXXXXXXXXXXXXXXXXXGOOOOOOXXXXXXXXXXXXX,0,0,0

3150,46,1,45,152,142,0,0,303,47,256,GOXXXXXXXXXXXXXXXXXXGOOOXXXXXXXXXXXXXXXXGOOOXXXXXXXXXXXXXXXXGOOOXXXXXXXXXXXXXXXXGOXXXXXXXXXXXXXXXXXXGOOOXXXXXXXXXXXXXXXXGOOXXXXXXXXXXXXXXXXXGOOAXXXXXXXXXXXXXXXXGOOOOXXXXXXXXXXXXXXXGXXXXXXXXXXXXXXXXXXXGOOXXXXXXXXXXXXXXXXXGOOXXXXXXXXXXXXXXXXXGOOOOOOXXXXXXXXXXXXX,0,0,0
3171,46,0,46,151,143,0,0,304,56,248,GOXXXXXXXXXXXXXXXXXXGOOOXXXXXXXXXXXXXXXXGOOOXXXXXXXXXXXXXXXXGOOOXXXXXXXXXXXXXXXXGOXXXXXXXXXXXXXXXXXXGOOOXXXXXXXXXXXXXXXXGOOXXXXXXXXXXXXXXXXXGOOOXXXXXXXXXXXXXXXXGOOOOXXXXXXXXXXXXXXXGXXXXXXXXXXXXXXXXXXXGOOXXXXXXXXXXXXXXXXXGOOXXXXXXXXXXXXXXXXXGOOOOOOXXXXXXXXXXXXX,0,0,0
3192,46,0,46,155,139,0,0,298,49,249,GOXXXXXXXXXXXXXXXXXXGOOOXXXXXXXXXXXXXXXXGOOOXXXXXXXXXXXXXXXXGOOOXXXXXXXXXXXXXXXXGOXXXXXXXXXXXXXXXXXXGOOOXXXXXXXXXXXXXXXXGOOXXXXXXXXXXXXXXXXXGOOOXXXXXXXXXXXXXXXXGOOOOXXXXXXXXXXXXXXXGXXXXXXXXXXXXXXXXXXXGOOXXXXXXXXXXXXXXXXXGOOXXXXXXXXXXXXXXXXXGOOOOOOXXXXXXXXXXXXX,0,0,0
3213,46,0,46,157,137,0,0,296,47,249,GOXXXXXXXXXXXXXXXXXXGOOOXXXXXXXXXXXXXXXXGOOOXXXXXXXXXXXXXXXXGOOOXXXXXXXXXXXXXXXXGOXXXXXXXXXXXXXXXXXXGOOOXXXXXXXXXXXXXXXXGOOXXXXXXXXXXXXXXXXXGOOOXXXXXXXXXXXXXXXXGOOOOXXXXXXXXXXXXXXXGXXXXXXXXXXXXXXXXXXXGOOXXXXXXXXXXXXXXXXXGOOXXXXXXXXXXXXXXXXXGOOOOOOXXXXXXXXXXXXX,0,0,0
3234,46,0,46,163,131,0,0,290,43,247,GOXXXXXXXXXXXXXXXXXXGOOOXXXXXXXXXXXXXXXXGOOOXXXXXXXXXXXXXXXXGOOOXXXXXXXXXXXXXXXXGOXXXXXXXXXXXXXXXXXXGOOOXXXXXXXXXXXXXXXXGOOXXXXXXXXXXXXXXXXXGOOOXXXXXXXXXXXXXXXXGOOOOXXXXXXXXXXXXXXXGXXXXXXXXXXXXXXXXXXXGOOXXXXXXXXXXXXXXXXXGOOXXXXXXXXXXXXXXXXXGOOOOOOXXXXXXXXXXXXX,0,0,0

3255,46,0,46,159,135,0,0,295,43,252,GOXXXXXXXXXXXXXXXXXXGOOOXXXXXXXXXXXXXXXXGOOOXXXXXXXXXXXXXXXXGOOOXXXXXXXXXXXXXXXXGOXXXXXXXXXXXXXXXXXXGOOOXXXXXXXXXXXXXXXXGOOXXXXXXXXXXXXXXXXXGOOOXXXXXXXXXXXXXXXXGOOOOXXXXXXXXXXXXXXXGXXXXXXXXXXXXXXXXXXXGOOXXXXXXXXXXXXXXXXXGOOXXXXXXXXXXXXXXXXXGOOOOOOXXXXXXXXXXXXX,0,0,0
3276,46,0,46,164,130,0,0,290,50,240,GOXXXXXXXXXXXXXXXXXXGOOOXXXXXXXXXXXXXXXXGOOOXXXXXXXXXXXXXXXXGOOOXXXXXXXXXXXXXXXXGOXXXXXXXXXXXXXXXXXXGOOOXXXXXXXXXXXXXXXXGOOXXXXXXXXXXXXXXXXXGOOOXXXXXXXXXXXXXXXXGOOOOXXXXXXXXXXXXXXXGXXXXXXXXXXXXXXXXXXXGOOXXXXXXXXXXXXXXXXXGOOXXXXXXXXXXXXXXXXXGOOOOOOXXXXXXXXXXXXX,0,0,0
3297,46,0,46,173,121,0,0,281,52,229,GOXXXXXXXXXXXXXXXXXXGOOOXXXXXXXXXXXXXXXXGOOOXXXXXXXXXXXXXXXXGOOOXXXXXXXXXXXXXXXXGOXXXXXXXXXXXXXXXXXXGOOOXXXXXXXXXXXXXXXXGOOXXXXXXXXXXXXXXXXXGOOOXXXXXXXXXXXXXXXXGOOOOXXXXXXXXXXXXXXXGXXXXXXXXXXXXXXXXXXXGOOXXXXXXXXXXXXXXXXXGOOXXXXXXXXXXXXXXXXXGOOOOOOXXXXXXXXXXXXX,0,0,0
3318,46,0,46,180,114,0,0,273,54,219,GOXXXXXXXXXXXXXXXXXXGOOOXXXXXXXXXXXXXXXXGOOOXXXXXXXXXXXXXXXXGOOOXXXXXXXXXXXXXXXXGOXXXXXXXXXXXXXXXXXXGOOOXXXXXXXXXXXXXXXXGOOXXXXXXXXXXXXXXXXXGOOOXXXXXXXXXXXXXXXXGOOOOXXXXXXXXXXXXXXXGXXXXXXXXXXXXXXXXXXXGOOXXXXXXXXXXXXXXXXXGOOXXXXXXXXXXXXXXXXXGOOOOOOXXXXXXXXXXXXX,0,0,0
3339,46,0,46,178,116,0,0,275,62,213,GOXXXXXXXXXXXXXXXXXXGOOOXXXXXXXXXXXXXXXXGOOOXXXXXXXXXXXXXXXXGOOOXXXXXXXXXXXXXXXXGOXXXXXXXXXXXXXXXXXXGOOOXXXXXXXXXXXXXXXXGOOXXXXXXXXXXXXXXXXXGOOOXXXXXXXXXXXXXXXXGOOOOXXXXXXXXXXXXXXXGXXXXXXXXXXXXXXXXXXXGOOXXXXXXXXXXXXXXXXXGOOXXXXXXXXXXXXXXXXXGOOOOOOXXXXXXXXXXXXX,0,0,0

3360,46,0,46,174,120,0,0,279,71,208,GOXXXXXXXXXXXXXXXXXXGOOOXXXXXXXXXXXXXXXXGOOOXXXXXXXXXXXXXXXXGOOOXXXXXXXXXXXXXXXXGOXXXXXXXXXXXXXXXXXXGOOOXXXXXXXXXXXXXXXXGOOXXXXXXXXXXXXXXXXXGOOOXXXXXXXXXXXXXXXXGOOOOXXXXXXXXXXXXXXXGXXXXXXXXXXXXXXXXXXXGOOXXXXXXXXXXXXXXXXXGOOXXXXXXXXXXXXXXXXXGOOOOOOXXXXXXXXXXXXX,0,0,0
3381,46,0,46,177,117,0,0,277,66,211,GOXXXXXXXXXXXXXXXXXXGOOOXXXXXXXXXXXXXXXXGOOOXXXXXXXXXXXXXXXXGOOOXXXXXXXXXXXXXXXXGOXXXXXXXXXXXXXXXXXXGOOOXXXXXXXXXXXXXXXXGOOXXXXXXXXXXXXXXXXXGOOOXXXXXXXXXXXXXXXXGOOOOXXXXXXXXXXXXXXXGXXXXXXXXXXXXXXXXXXXGOOXXXXXXXXXXXXXXXXXGOOXXXXXXXXXXXXXXXXXGOOOOOOXXXXXXXXXXXXX,0,0,0
3402,46,0,46,178,116,0,0,276,65,211,GOXXXXXXXXXXXXXXXXXXGOOOXXXXXXXXXXXXXXXXGOOOXXXXXXXXXXXXXXXXGOOOXXXXXXXXXXXXXXXXGOXXXXXXXXXXXXXXXXXXGOOOXXXXXXXXXXXXXXXXGOOXXXXXXXXXXXXXXXXXGOOOXXXXXXXXXXXXXXXXGOOOOXXXXXXXXXXXXXXXGXXXXXXXXXXXXXXXXXXXGOOXXXXXXXXXXXXXXXXXGOOXXXXXXXXXXXXXXXXXGOOOOOOXXXXXXXXXXXXX,0,0,0
3423,46,0,46,178,116,0,0,276,62,214,GOXXXXXXXXXXXXXXXXXXGOOOXXXXXXXXXXXXXXXXGOOOXXXXXXXXXXXXXXXXGOOOXXXXXXXXXXXXXXXXGOXXXXXXXXXXXXXXXXXXGOOOXXXXXXXXXXXXXXXXGOOXXXXXXXXXXXXXXXXXGOOOXXXXXXXXXXXXXXXXGOOOOXXXXXXXXXXXXXXXGXXXXXXXXXXXXXXXXXXXGOOXXXXXXXXXXXXXXXXXGOOXXXXXXXXXXXXXXXXXGOOOOOOXXXXXXXXXXXXX,0,0,0
3444,46,0,46,179,115,0,0,276,60,216,GOXXXXXXXXXXXXXXXXXXGOOOXXXXXXXXXXXXXXXXGOOOXXXXXXXXXXXXXXXXGOOOXXXXXXXXXXXXXXXXGOXXXXXXXXXXXXXXXXXXGOOOXXXXXXXXXXXXXXXXGOOXXXXXXXXXXXXXXXXXGOOOXXXXXXXXXXXXXXXXGOOOOXXXXXXXXXXXXXXXGXXXXXXXXXXXXXXXXXXXGOOXXXXXXXXXXXXXXXXXGOOXXXXXXXXXXXXXXXXXGOOOOOOXXXXXXXXXXXXX,0,0,0

3465,46,0,46,167,127,0,0,287,70,217,GOXXXXXXXXXXXXXXXXXXGOOOXXXXXXXXXXXXXXXXGOOOXXXXXXXXXXXXXXXXGOOOXXXXXXXXXXXXXXXXGOXXXXXXXXXXXXXXXXXXGOOOXXXXXXXXXXXXXXXXGOOXXXXXXXXXXXXXXXXXGOOOXXXXXXXXXXXXXXXXGOOOOXXXXXXXXXXXXXXXGXXXXXXXXXXXXXXXXXXXGOOXXXXXXXXXXXXXXXXXGOOXXXXXXXXXXXXXXXXXGOOOOOOXXXXXXXXXXXXX,0,0,0
3486,47,1,46,166,127,0,0,288,71,217,GOXXXXXXXXXXXXXXXXXXGOOOXXXXXXXXXXXXXXXXGOOOXXXXXXXXXXXXXXXXGOOOXXXXXXXXXXXXXXXXGOXXXXXXXXXXXXXXXXXXGOOOXXXXXXXXXXXXXXXXGOOXXXXXXXXXXXXXXXXXGOOOXXXXXXXXXXXXXXXXGOOOOAXXXXXXXXXXXXXXGXXXXXXXXXXXXXXXXXXXGOOXXXXXXXXXXXXXXXXXGOOXXXXXXXXXXXXXXXXXGOOOOOOXXXXXXXXXXXXX,0,0,0
3507,47,1,46,163,130,0,0,290,69,221,GOXXXXXXXXXXXXXXXXXXGOOOXXXXXXXXXXXXXXXXGOOOXXXXXXXXXXXXXXXXGOOOXXXXXXXXXXXXXXXXGOXXXXXXXXXXXXXXXXXXGOOOXXXXXXXXXXXXXXXXGOOXXXXXXXXXXXXXXXXXGOOOXXXXXXXXXXXXXXXXGOOOOAXXXXXXXXXXXXXXGXXXXXXXXXXXXXXXXXXXGOOXXXXXXXXXXXXXXXXXGOOXXXXXXXXXXXXXXXXXGOOOOOOXXXXXXXXXXXXX,0,0,0
3528,47,0,47,167,126,0,0,286,68,218,GOXXXXXXXXXXXXXXXXXXGOOOXXXXXXXXXXXXXXXXGOOOXXXXXXXXXXXXXXXXGOOOXXXXXXXXXXXXXXXXGOXXXXXXXXXXXXXXXXXXGOOOXXXXXXXXXXXXXXXXGOOXXXXXXXXXXXXXXXXXGOOOXXXXXXXXXXXXXXXXGOOOOOXXXXXXXXXXXXXXGXXXXXXXXXXXXXXXXXXXGOOXXXXXXXXXXXXXXXXXGOOXXXXXXXXXXXXXXXXXGOOOOOOXXXXXXXXXXXXX,0,0,0
3549,47,0,47,165,128,0,0,287,65,222,GOXXXXXXXXXXXXXXXXXXGOOOXXXXXXXXXXXXXXXXGOOOXXXXXXXXXXXXXXXXGOOOXXXXXXXXXXXXXXXXGOXXXXXXXXXXXXXXXXXXGOOOXXXXXXXXXXXXXXXXGOOXXXXXXXXXXXXXXXXXGOOOXXXXXXXXXXXXXXXXGOOOOOXXXXXXXXXXXXXXGXXXXXXXXXXXXXXXXXXXGOOXXXXXXXXXXXXXXXXXGOOXXXXXXXXXXXXXXXXXGOOOOOOXXXXXXXXXXXXX,0,0,0

3570,47,0,47,160,133,0,0,291,69,222,GOXXXXXXXXXXXXXXXXXXGOOOXXXXXXXXXXXXXXXXGOOOXXXXXXXXXXXXXXXXGOOOXXXXXXXXXXXXXXXXGOXXXXXXXXXXXXXXXXXXGOOOXXXXXXXXXXXXXXXXGOOXXXXXXXXXXXXXXXXXGOOOXXXXXXXXXXXXXXXXGOOOOOXXXXXXXXXXXXXXGXXXXXXXXXXXXXXXXXXXGOOXXXXXXXXXXXXXXXXXGOOXXXXXXXXXXXXXXXXXGOOOOOOXXXXXXXXXXXXX,0,0,0
3591,47,0,47,155,138,0,0,295,67,228,GOXXXXXXXXXXXXXXXXXXGOOOXXXXXXXXXXXXXXXXGOOOXXXXXXXXXXXXXXXXGOOOXXXXXXXXXXXXXXXXGOXXXXXXXXXXXXXXXXXXGOOOXXXXXXXXXXXXXXXXGOOXXXXXXXXXXXXXXXXXGOOOXXXXXXXXXXXXXXXXGOOOOOXXXXXXXXXXXXXXGXXXXXXXXXXXXXXXXXXXGOOXXXXXXXXXXXXXXXXXGOOXXXXXXXXXXXXXXXXXGOOOOOOXXXXXXXXXXXXX,0,0,0
3612,47,0,47,158,135,0,0,295,60,235,GOXXXXXXXXXXXXXXXXXXGOOOXXXXXXXXXXXXXXXXGOOOXXXXXXXXXXXXXXXXGOOOXXXXXXXXXXXXXXXXGOXXXXXXXXXXXXXXXXXXGOOOXXXXXXXXXXXXXXXXGOOXXXXXXXXXXXXXXXXXGOOOXXXXXXXXXXXXXXXXGOOOOOXXXXXXXXXXXXXXGXXXXXXXXXXXXXXXXXXXGOOXXXXXXXXXXXXXXXXXGOOXXXXXXXXXXXXXXXXXGOOOOOOXXXXXXXXXXXXX,0,0,0
3633,47,0,47,166,127,0,0,287,53,234,GOXXXXXXXXXXXXXXXXXXGOOOXXXXXXXXXXXXXXXXGOOOXXXXXXXXXXXXXXXXGOOOXXXXXXXXXXXXXXXXGOXXXXXXXXXXXXXXXXXXGOOOXXXXXXXXXXXXXXXXGOOXXXXXXXXXXXXXXXXXGOOOXXXXXXXXXXXXXXXXGOOOOOXXXXXXXXXXXXXXGXXXXXXXXXXXXXXXXXXXGOOXXXXXXXXXXXXXXXXXGOOXXXXXXXXXXXXXXXXXGOOOOOOXXXXXXXXXXXXX,0,0,0
3654,47,0,47,159,134,0,0,293,51,242,GOXXXXXXXXXXXXXXXXXXGOOOXXXXXXXXXXXXXXXXGOOOXXXXXXXXXXXXXXXXGOOOXXXXXXXXXXXXXXXXGOXXXXXXXXXXXXXXXXXXGOOOXXXXXXXXXXXXXXXXGOOXXXXXXXXXXXXXXXXXGOOOXXXXXXXXXXXXXXXXGOOOOOXXXXXXXXXXXXXXGXXXXXXXXXXXXXXXXXXXGOOXXXXXXXXXXXXXXXXXGOOXXXXXXXXXXXXXXXXXGOOOOOOXXXXXXXXXXXXX,0,0,0

3675,47,0,47,157,136,0,0,295,50,245,GOXXXXXXXXXXXXXXXXXXGOOOXXXXXXXXXXXXXXXXGOOOXXXXXXXXXXXXXXXXGOOOXXXXXXXXXXXXXXXXGOXXXXXXXXXXXXXXXXXXGOOOXXXXXXXXXXXXXXXXGOOXXXXXXXXXXXXXXXXXGOOOXXXXXXXXXXXXXXXXGOOOOOXXXXXXXXXXXXXXGXXXXXXXXXXXXXXXXXXXGOOXXXXXXXXXXXXXXXXXGOOXXXXXXXXXXXXXXXXXGOOOOOOXXXXXXXXXXXXX,0,0,0
3696,47,0,47,160,133,0,0,293,56,237,GOXXXXXXXXXXXXXXXXXXGOOOXXXXXXXXXXXXXXXXGOOOXXXXXXXXXXXXXXXXGOOOXXXXXXXXXXXXXXXXGOXXXXXXXXXXXXXXXXXXGOOOXXXXXXXXXXXXXXXXGOOXXXXXXXXXXXXXXXXXGOOOXXXXXXXXXXXXXXXXGOOOOOXXXXXXXXXXXXXXGXXXXXXXXXXXXXXXXXXXGOOXXXXXXXXXXXXXXXXXGOOXXXXXXXXXXXXXXXXXGOOOOOOXXXXXXXXXXXXX,0,0,0
3717,48,1,47,159,133,0,0,293,50,243,GOXXXXXXXXXXXXXXXXXXGOOOXXXXXXXXXXXXXXXXGOOOXXXXXXXXXXXXXXXXGOOOAXXXXXXXXXXXXXXXGOXXXXXXXXXXXXXXXXXXGOOOXXXXXXXXXXXXXXXXGOOXXXXXXXXXXXXXXXXXGOOOXXXXXXXXXXXXXXXXGOOOOOXXXXXXXXXXXXXXGXXXXXXXXXXXXXXXXXXXGOOXXXXXXXXXXXXXXXXXGOOXXXXXXXXXXXXXXXXXGOOOOOOXXXXXXXXXXXXX,0,0,0
3738,48,1,47,158,134,0,0,294,49,245,GOXXXXXXXXXXXXXXXXXXGOOOXXXXXXXXXXXXXXXXGOOOXXXXXXXXXXXXXXXXGOOOAXXXXXXXXXXXXXXXGOXXXXXXXXXXXXXXXXXXGOOOXXXXXXXXXXXXXXXXGOOXXXXXXXXXXXXXXXXXGOOOXXXXXXXXXXXXXXXXGOOOOOXXXXXXXXXXXXXXGXXXXXXXXXXXXXXXXXXXGOOXXXXXXXXXXXXXXXXXGOOXXXXXXXXXXXXXXXXXGOOOOOOXXXXXXXXXXXXX,0,0,0
3759,48,1,47,153,139,0,0,299,53,246,GOXXXXXXXXXXXXXXXXXXGOOOXXXXXXXXXXXXXXXXGOOOXXXXXXXXXXXXXXXXGOOOAXXXXXXXXXXXXXXXGOXXXXXXXXXXXXXXXXXXGOOOXXXXXXXXXXXXXXXXGOOXXXXXXXXXXXXXXXXXGOOOXXXXXXXXXXXXXXXXGOOOOOXXXXXXXXXXXXXXGXXXXXXXXXXXXXXXXXXXGOOXXXXXXXXXXXXXXXXXGOOXXXXXXXXXXXXXXXXXGOOOOOOXXXXXXXXXXXXX,0,0,0

3780,50,3,47,151,139,0,0,298,59,239,GOAXXXXXXXXXXXXXXXXXGOOOAXXXXXXXXXXXXXXXGOOOXXXXXXXXXXXXXXXXGOOOAXXXXXXXXXXXXXXXGOXXXXXXXXXXXXXXXXXXGOOOXXXXXXXXXXXXXXXXGOOXXXXXXXXXXXXXXXXXGOOOXXXXXXXXXXXXXXXXGOOOOOXXXXXXXXXXXXXXGXXXXXXXXXXXXXXXXXXXGOOXXXXXXXXXXXXXXXXXGOOXXXXXXXXXXXXXXXXXGOOOOOOXXXXXXXXXXXXX,0,0,0
3801,50,3,47,152,138,0,0,300,60,240,GOAXXXXXXXXXXXXXXXXXGOOOAXXXXXXXXXXXXXXXGOOOXXXXXXXXXXXXXXXXGOOOAXXXXXXXXXXXXXXXGOXXXXXXXXXXXXXXXXXXGOOOXXXXXXXXXXXXXXXXGOOXXXXXXXXXXXXXXXXXGOOOXXXXXXXXXXXXXXXXGOOOOOXXXXXXXXXXXXXXGXXXXXXXXXXXXXXXXXXXGOOXXXXXXXXXXXXXXXXXGOOXXXXXXXXXXXXXXXXXGOOOOOOXXXXXXXXXXXXX,0,0,0
3822,50,3,47,155,135,0,0,296,57,239,GOAXXXXXXXXXXXXXXXXXGOOOAXXXXXXXXXXXXXXXGOOOXXXXXXXXXXXXXXXXGOOOAXXXXXXXXXXXXXXXGOXXXXXXXXXXXXXXXXXXGOOOXXXXXXXXXXXXXXXXGOOXXXXXXXXXXXXXXXXXGOOOXXXXXXXXXXXXXXXXGOOOOOXXXXXXXXXXXXXXGXXXXXXXXXXXXXXXXXXXGOOXXXXXXXXXXXXXXXXXGOOXXXXXXXXXXXXXXXXXGOOOOOOXXXXXXXXXXXXX,0,0,0
3843,50,3,47,156,134,0,0,295,58,237,GOAXXXXXXXXXXXXXXXXXGOOOAXXXXXXXXXXXXXXXGOOOXXXXXXXXXXXXXXXXGOOOAXXXXXXXXXXXXXXXGOXXXXXXXXXXXXXXXXXXGOOOXXXXXXXXXXXXXXXXGOOXXXXXXXXXXXXXXXXXGOOOXXXXXXXXXXXXXXXXGOOOOOXXXXXXXXXXXXXXGXXXXXXXXXXXXXXXXXXXGOOXXXXXXXXXXXXXXXXXGOOXXXXXXXXXXXXXXXXXGOOOOOOXXXXXXXXXXXXX,0,0,0
3864,50,3,47,152,138,0,0,299,58,241,GOAXXXXXXXXXXXXXXXXXGOOOAXXXXXXXXXXXXXXXGOOOXXXXXXXXXXXXXXXXGOOOAXXXXXXXXXXXXXXXGOXXXXXXXXXXXXXXXXXXGOOOXXXXXXXXXXXXXXXXGOOXXXXXXXXXXXXXXXXXGOOOXXXXXXXXXXXXXXXXGOOOOOXXXXXXXXXXXXXXGXXXXXXXXXXXXXXXXXXXGOOXXXXXXXXXXXXXXXXXGOOXXXXXXXXXXXXXXXXXGOOOOOOXXXXXXXXXXXXX,0,0,0

3885,50,2,48,152,138,0,0,298,61,237,GOAXXXXXXXXXXXXXXXXXGOOOAXXXXXXXXXXXXXXXGOOOXXXXXXXXXXXXXXXXGOOOOXXXXXXXXXXXXXXXGOXXXXXXXXXXXXXXXXXXGOOOXXXXXXXXXXXXXXXXGOOXXXXXXXXXXXXXXXXXGOOOXXXXXXXXXXXXXXXXGOOOOOXXXXXXXXXXXXXXGXXXXXXXXXXXXXXXXXXXGOOXXXXXXXXXXXXXXXXXGOOXXXXXXXXXXXXXXXXXGOOOOOOXXXXXXXXXXXXX,0,0,0
3906,50,2,48,156,134,0,0,295,57,238,GOAXXXXXXXXXXXXXXXXXGOOOAXXXXXXXXXXXXXXXGOOOXXXXXXXXXXXXXXXXGOOOOXXXXXXXXXXXXXXXGOXXXXXXXXXXXXXXXXXXGOOOXXXXXXXXXXXXXXXXGOOXXXXXXXXXXXXXXXXXGOOOXXXXXXXXXXXXXXXXGOOOOOXXXXXXXXXXXXXXGXXXXXXXXXXXXXXXXXXXGOOXXXXXXXXXXXXXXXXXGOOXXXXXXXXXXXXXXXXXGOOOOOOXXXXXXXXXXXXX,0,0,0
3927,50,2,48,167,123,0,0,283,54,229,GOAXXXXXXXXXXXXXXXXXGOOOAXXXXXXXXXXXXXXXGOOOXXXXXXXXXXXXXXXXGOOOOXXXXXXXXXXXXXXXGOXXXXXXXXXXXXXXXXXXGOOOXXXXXXXXXXXXXXXXGOOXXXXXXXXXXXXXXXXXGOOOXXXXXXXXXXXXXXXXGOOOOOXXXXXXXXXXXXXXGXXXXXXXXXXXXXXXXXXXGOOXXXXXXXXXXXXXXXXXGOOXXXXXXXXXXXXXXXXXGOOOOOOXXXXXXXXXXXXX,0,0,0
3948,50,0,50,159,131,0,0,292,58,234,GOOXXXXXXXXXXXXXXXXXGOOOOXXXXXXXXXXXXXXXGOOOXXXXXXXXXXXXXXXXGOOOOXXXXXXXXXXXXXXXGOXXXXXXXXXXXXXXXXXXGOOOXXXXXXXXXXXXXXXXGOOXXXXXXXXXXXXXXXXXGOOOXXXXXXXXXXXXXXXXGOOOOOXXXXXXXXXXXXXXGXXXXXXXXXXXXXXXXXXXGOOXXXXXXXXXXXXXXXXXGOOXXXXXXXXXXXXXXXXXGOOOOOOXXXXXXXXXXXXX,0,0,0
3969,50,0,50,168,122,0,0,281,54,227,GOOXXXXXXXXXXXXXXXXXGOOOOXXXXXXXXXXXXXXXGOOOXXXXXXXXXXXXXXXXGOOOOXXXXXXXXXXXXXXXGOXXXXXXXXXXXXXXXXXXGOOOXXXXXXXXXXXXXXXXGOOXXXXXXXXXXXXXXXXXGOOOXXXXXXXXXXXXXXXXGOOOOOXXXXXXXXXXXXXXGXXXXXXXXXXXXXXXXXXXGOOXXXXXXXXXXXXXXXXXGOOXXXXXXXXXXXXXXXXXGOOOOOOXXXXXXXXXXXXX,0,0,0

3990,50,0,50,168,122,0,0,281,56,225,GOOXXXXXXXXXXXXXXXXXGOOOOXXXXXXXXXXXXXXXGOOOXXXXXXXXXXXXXXXXGOOOOXXXXXXXXXXXXXXXGOXXXXXXXXXXXXXXXXXXGOOOXXXXXXXXXXXXXXXXGOOXXXXXXXXXXXXXXXXXGOOOXXXXXXXXXXXXXXXXGOOOOOXXXXXXXXXXXXXXGXXXXXXXXXXXXXXXXXXXGOOXXXXXXXXXXXXXXXXXGOOXXXXXXXXXXXXXXXXXGOOOOOOXXXXXXXXXXXXX,0,0,0
4011,51,1,50,159,130,0,0,290,62,228,GOOXXXXXXXXXXXXXXXXXGOOOOXXXXXXXXXXXXXXXGOOOXXXXXXXXXXXXXXXXGOOOOXXXXXXXXXXXXXXXGOXXXXXXXXXXXXXXXXXXGOOOXXXXXXXXXXXXXXXXGOOXXXXXXXXXXXXXXXXXGOOOXXXXXXXXXXXXXXXXGOOOOOXXXXXXXXXXXXXXGXXXXXXXXXXXXXXXXXXXGOOXXXXXXXXXXXXXXXXXGOOXXXXXXXXXXXXXXXXXGOOOOOOAXXXXXXXXXXXX,0,0,0
4032,51,1,50,162,127,0,0,287,64,223,GOOXXXXXXXXXXXXXXXXXGOOOOXXXXXXXXXXXXXXXGOOOXXXXXXXXXXXXXXXXGOOOOXXXXXXXXXXXXXXXGOXXXXXXXXXXXXXXXXXXGOOOXXXXXXXXXXXXXXXXGOOXXXXXXXXXXXXXXXXXGOOOXXXXXXXXXXXXXXXXGOOOOOXXXXXXXXXXXXXXGXXXXXXXXXXXXXXXXXXXGOOXXXXXXXXXXXXXXXXXGOOXXXXXXXXXXXXXXXXXGOOOOOOAXXXXXXXXXXXX,0,0,0
4053,51,1,50,162,127,0,0,286,64,222,GOOXXXXXXXXXXXXXXXXXGOOOOXXXXXXXXXXXXXXXGOOOXXXXXXXXXXXXXXXXGOOOOXXXXXXXXXXXXXXXGOXXXXXXXXXXXXXXXXXXGOOOXXXXXXXXXXXXXXXXGOOXXXXXXXXXXXXXXXXXGOOOXXXXXXXXXXXXXXXXGOOOOOXXXXXXXXXXXXXXGXXXXXXXXXXXXXXXXXXXGOOXXXXXXXXXXXXXXXXXGOOXXXXXXXXXXXXXXXXXGOOOOOOAXXXXXXXXXXXX,0,0,0
4074,51,1,50,165,124,0,0,283,62,221,GOOXXXXXXXXXXXXXXXXXGOOOOXXXXXXXXXXXXXXXGOOOXXXXXXXXXXXXXXXXGOOOOXXXXXXXXXXXXXXXGOXXXXXXXXXXXXXXXXXXGOOOXXXXXXXXXXXXXXXXGOOXXXXXXXXXXXXXXXXXGOOOXXXXXXXXXXXXXXXXGOOOOOXXXXXXXXXXXXXXGXXXXXXXXXXXXXXXXXXXGOOXXXXXXXXXXXXXXXXXGOOXXXXXXXXXXXXXXXXXGOOOOOOAXXXXXXXXXXXX,0,0,0

4095,51,1,50,167,122,0,0,281,59,222,GOOXXXXXXXXXXXXXXXXXGOOOOXXXXXXXXXXXXXXXGOOOXXXXXXXXXXXXXXXXGOOOOXXXXXXXXXXXXXXXGOXXXXXXXXXXXXXXXXXXGOOOXXXXXXXXXXXXXXXXGOOXXXXXXXXXXXXXXXXXGOOOXXXXXXXXXXXXXXXXGOOOOOXXXXXXXXXXXXXXGXXXXXXXXXXXXXXXXXXXGOOXXXXXXXXXXXXXXXXXGOOXXXXXXXXXXXXXXXXXGOOOOOOAXXXXXXXXXXXX,0,0,0
4116,51,1,50,167,122,0,0,280,62,218,GOOXXXXXXXXXXXXXXXXXGOOOOXXXXXXXXXXXXXXXGOOOXXXXXXXXXXXXXXXXGOOOOXXXXXXXXXXXXXXXGOXXXXXXXXXXXXXXXXXXGOOOXXXXXXXXXXXXXXXXGOOXXXXXXXXXXXXXXXXXGOOOXXXXXXXXXXXXXXXXGOOOOOXXXXXXXXXXXXXXGXXXXXXXXXXXXXXXXXXXGOOXXXXXXXXXXXXXXXXXGOOXXXXXXXXXXXXXXXXXGOOOOOOAXXXXXXXXXXXX,0,0,0
4137,51,1,50,173,116,0,0,276,66,210,GOOXXXXXXXXXXXXXXXXXGOOOOXXXXXXXXXXXXXXXGOOOXXXXXXXXXXXXXXXXGOOOOXXXXXXXXXXXXXXXGOXXXXXXXXXXXXXXXXXXGOOOXXXXXXXXXXXXXXXXGOOXXXXXXXXXXXXXXXXXGOOOXXXXXXXXXXXXXXXXGOOOOOXXXXXXXXXXXXXXGXXXXXXXXXXXXXXXXXXXGOOXXXXXXXXXXXXXXXXXGOOXXXXXXXXXXXXXXXXXGOOOOOOAXXXXXXXXXXXX,0,0,0
4158,52,2,50,175,113,0,0,273,70,203,GOOXXXXXXXXXXXXXXXXXGOOOOAXXXXXXXXXXXXXXGOOOXXXXXXXXXXXXXXXXGOOOOXXXXXXXXXXXXXXXGOXXXXXXXXXXXXXXXXXXGOOOXXXXXXXXXXXXXXXXGOOXXXXXXXXXXXXXXXXXGOOOXXXXXXXXXXXXXXXXGOOOOOXXXXXXXXXXXXXXGXXXXXXXXXXXXXXXXXXXGOOXXXXXXXXXXXXXXXXXGOOXXXXXXXXXXXXXXXXXGOOOOOOAXXXXXXXXXXXX,0,0,0
4179,52,2,50,174,114,0,0,272,70,202,GOOXXXXXXXXXXXXXXXXXGOOOOAXXXXXXXXXXXXXXGOOOXXXXXXXXXXXXXXXXGOOOOXXXXXXXXXXXXXXXGOXXXXXXXXXXXXXXXXXXGOOOXXXXXXXXXXXXXXXXGOOXXXXXXXXXXXXXXXXXGOOOXXXXXXXXXXXXXXXXGOOOOOXXXXXXXXXXXXXXGXXXXXXXXXXXXXXXXXXXGOOXXXXXXXXXXXXXXXXXGOOXXXXXXXXXXXXXXXXXGOOOOOOAXXXXXXXXXXXX,0,0,0

4200,52,1,51,171,117,0,0,276,66,210,GOOXXXXXXXXXXXXXXXXXGOOOOAXXXXXXXXXXXXXXGOOOXXXXXXXXXXXXXXXXGOOOOXXXXXXXXXXXXXXXGOXXXXXXXXXXXXXXXXXXGOOOXXXXXXXXXXXXXXXXGOOXXXXXXXXXXXXXXXXXGOOOXXXXXXXXXXXXXXXXGOOOOOXXXXXXXXXXXXXXGXXXXXXXXXXXXXXXXXXXGOOXXXXXXXXXXXXXXXXXGOOXXXXXXXXXXXXXXXXXGOOOOOOOXXXXXXXXXXXX,0,0,0
4221,52,1,51,175,113,0,0,274,59,215,GOOXXXXXXXXXXXXXXXXXGOOOOAXXXXXXXXXXXXXXGOOOXXXXXXXXXXXXXXXXGOOOOXXXXXXXXXXXXXXXGOXXXXXXXXXXXXXXXXXXGOOOXXXXXXXXXXXXXXXXGOOXXXXXXXXXXXXXXXXXGOOOXXXXXXXXXXXXXXXXGOOOOOXXXXXXXXXXXXXXGXXXXXXXXXXXXXXXXXXXGOOXXXXXXXXXXXXXXXXXGOOXXXXXXXXXXXXXXXXXGOOOOOOOXXXXXXXXXXXX,0,0,0
4242,52,1,51,175,113,0,0,273,60,213,GOOXXXXXXXXXXXXXXXXXGOOOOAXXXXXXXXXXXXXXGOOOXXXXXXXXXXXXXXXXGOOOOXXXXXXXXXXXXXXXGOXXXXXXXXXXXXXXXXXXGOOOXXXXXXXXXXXXXXXXGOOXXXXXXXXXXXXXXXXXGOOOXXXXXXXXXXXXXXXXGOOOOOXXXXXXXXXXXXXXGXXXXXXXXXXXXXXXXXXXGOOXXXXXXXXXXXXXXXXXGOOXXXXXXXXXXXXXXXXXGOOOOOOOXXXXXXXXXXXX,0,0,0
4263,52,1,51,171,117,0,0,277,68,209,GOOXXXXXXXXXXXXXXXXXGOOOOAXXXXXXXXXXXXXXGOOOXXXXXXXXXXXXXXXXGOOOOXXXXXXXXXXXXXXXGOXXXXXXXXXXXXXXXXXXGOOOXXXXXXXXXXXXXXXXGOOXXXXXXXXXXXXXXXXXGOOOXXXXXXXXXXXXXXXXGOOOOOXXXXXXXXXXXXXXGXXXXXXXXXXXXXXXXXXXGOOXXXXXXXXXXXXXXXXXGOOXXXXXXXXXXXXXXXXXGOOOOOOOXXXXXXXXXXXX,0,0,0
4284,53,2,51,178,109,0,0,270,65,205,GOOXXXXXXXXXXXXXXXXXGOOOOAXXXXXXXXXXXXXXGOOOAXXXXXXXXXXXXXXXGOOOOXXXXXXXXXXXXXXXGOXXXXXXXXXXXXXXXXXXGOOOXXXXXXXXXXXXXXXXGOOXXXXXXXXXXXXXXXXXGOOOXXXXXXXXXXXXXXXXGOOOOOXXXXXXXXXXXXXXGXXXXXXXXXXXXXXXXXXXGOOXXXXXXXXXXXXXXXXXGOOXXXXXXXXXXXXXXXXXGOOOOOOOXXXXXXXXXXXX,0,0,0

4305,53,1,52,182,105,0,0,266,62,204,GOOXXXXXXXXXXXXXXXXXGOOOOAXXXXXXXXXXXXXXGOOOOXXXXXXXXXXXXXXXGOOOOXXXXXXXXXXXXXXXGOXXXXXXXXXXXXXXXXXXGOOOXXXXXXXXXXXXXXXXGOOXXXXXXXXXXXXXXXXXGOOOXXXXXXXXXXXXXXXXGOOOOOXXXXXXXXXXXXXXGXXXXXXXXXXXXXXXXXXXGOOXXXXXXXXXXXXXXXXXGOOXXXXXXXXXXXXXXXXXGOOOOOOOXXXXXXXXXXXX,0,0,0
4326,53,1,52,169,118,0,0,278,64,214,GOOXXXXXXXXXXXXXXXXXGOOOOAXXXXXXXXXXXXXXGOOOOXXXXXXXXXXXXXXXGOOOOXXXXXXXXXXXXXXXGOXXXXXXXXXXXXXXXXXXGOOOXXXXXXXXXXXXXXXXGOOXXXXXXXXXXXXXXXXXGOOOXXXXXXXXXXXXXXXXGOOOOOXXXXXXXXXXXXXXGXXXXXXXXXXXXXXXXXXXGOOXXXXXXXXXXXXXXXXXGOOXXXXXXXXXXXXXXXXXGOOOOOOOXXXXXXXXXXXX,0,0,0
4347,53,1,52,166,121,0,0,280,58,222,GOOXXXXXXXXXXXXXXXXXGOOOOAXXXXXXXXXXXXXXGOOOOXXXXXXXXXXXXXXXGOOOOXXXXXXXXXXXXXXXGOXXXXXXXXXXXXXXXXXXGOOOXXXXXXXXXXXXXXXXGOOXXXXXXXXXXXXXXXXXGOOOXXXXXXXXXXXXXXXXGOOOOOXXXXXXXXXXXXXXGXXXXXXXXXXXXXXXXXXXGOOXXXXXXXXXXXXXXXXXGOOXXXXXXXXXXXXXXXXXGOOOOOOOXXXXXXXXXXXX,0,0,0
4368,53,1,52,165,122,0,0,282,59,223,GOOXXXXXXXXXXXXXXXXXGOOOOAXXXXXXXXXXXXXXGOOOOXXXXXXXXXXXXXXXGOOOOXXXXXXXXXXXXXXXGOXXXXXXXXXXXXXXXXXXGOOOXXXXXXXXXXXXXXXXGOOXXXXXXXXXXXXXXXXXGOOOXXXXXXXXXXXXXXXXGOOOOOXXXXXXXXXXXXXXGXXXXXXXXXXXXXXXXXXXGOOXXXXXXXXXXXXXXXXXGOOXXXXXXXXXXXXXXXXXGOOOOOOOXXXXXXXXXXXX,0,0,0
4389,53,1,52,162,125,0,0,285,53,232,GOOXXXXXXXXXXXXXXXXXGOOOOAXXXXXXXXXXXXXXGOOOOXXXXXXXXXXXXXXXGOOOOXXXXXXXXXXXXXXXGOXXXXXXXXXXXXXXXXXXGOOOXXXXXXXXXXXXXXXXGOOXXXXXXXXXXXXXXXXXGOOOXXXXXXXXXXXXXXXXGOOOOOXXXXXXXXXXXXXXGXXXXXXXXXXXXXXXXXXXGOOXXXXXXXXXXXXXXXXXGOOXXXXXXXXXXXXXXXXXGOOOOOOOXXXXXXXXXXXX,0,0,0

4410,53,1,52,163,124,0,0,283,50,233,GOOXXXXXXXXXXXXXXXXXGOOOOAXXXXXXXXXXXXXXGOOOOXXXXXXXXXXXXXXXGOOOOXXXXXXXXXXXXXXXGOXXXXXXXXXXXXXXXXXXGOOOXXXXXXXXXXXXXXXXGOOXXXXXXXXXXXXXXXXXGOOOXXXXXXXXXXXXXXXXGOOOOOXXXXXXXXXXXXXXGXXXXXXXXXXXXXXXXXXXGOOXXXXXXXXXXXXXXXXXGOOXXXXXXXXXXXXXXXXXGOOOOOOOXXXXXXXXXXXX,0,0,0
4431,53,1,52,158,129,0,0,288,55,233,GOOXXXXXXXXXXXXXXXXXGOOOOAXXXXXXXXXXXXXXGOOOOXXXXXXXXXXXXXXXGOOOOXXXXXXXXXXXXXXXGOXXXXXXXXXXXXXXXXXXGOOOXXXXXXXXXXXXXXXXGOOXXXXXXXXXXXXXXXXXGOOOXXXXXXXXXXXXXXXXGOOOOOXXXXXXXXXXXXXXGXXXXXXXXXXXXXXXXXXXGOOXXXXXXXXXXXXXXXXXGOOXXXXXXXXXXXXXXXXXGOOOOOOOXXXXXXXXXXXX,0,0,0
4452,53,1,52,162,125,0,0,285,54,231,GOOXXXXXXXXXXXXXXXXXGOOOOAXXXXXXXXXXXXXXGOOOOXXXXXXXXXXXXXXXGOOOOXXXXXXXXXXXXXXXGOXXXXXXXXXXXXXXXXXXGOOOXXXXXXXXXXXXXXXXGOOXXXXXXXXXXXXXXXXXGOOOXXXXXXXXXXXXXXXXGOOOOOXXXXXXXXXXXXXXGXXXXXXXXXXXXXXXXXXXGOOXXXXXXXXXXXXXXXXXGOOXXXXXXXXXXXXXXXXXGOOOOOOOXXXXXXXXXXXX,0,0,0
4473,53,0,53,154,133,0,0,293,55,238,GOOXXXXXXXXXXXXXXXXXGOOOOOXXXXXXXXXXXXXXGOOOOXXXXXXXXXXXXXXXGOOOOXXXXXXXXXXXXXXXGOXXXXXXXXXXXXXXXXXXGOOOXXXXXXXXXXXXXXXXGOOXXXXXXXXXXXXXXXXXGOOOXXXXXXXXXXXXXXXXGOOOOOXXXXXXXXXXXXXXGXXXXXXXXXXXXXXXXXXXGOOXXXXXXXXXXXXXXXXXGOOXXXXXXXXXXXXXXXXXGOOOOOOOXXXXXXXXXXXX,0,0,0
4494,53,0,53,159,128,0,0,288,54,234,GOOXXXXXXXXXXXXXXXXXGOOOOOXXXXXXXXXXXXXXGOOOOXXXXXXXXXXXXXXXGOOOOXXXXXXXXXXXXXXXGOXXXXXXXXXXXXXXXXXXGOOOXXXXXXXXXXXXXXXXGOOXXXXXXXXXXXXXXXXXGOOOXXXXXXXXXXXXXXXXGOOOOOXXXXXXXXXXXXXXGXXXXXXXXXXXXXXXXXXXGOOXXXXXXXXXXXXXXXXXGOOXXXXXXXXXXXXXXXXXGOOOOOOOXXXXXXXXXXXX,0,0,0

4515,53,0,53,153,134,0,0,293,59,234,GOOXXXXXXXXXXXXXXXXXGOOOOOXXXXXXXXXXXXXXGOOOOXXXXXXXXXXXXXXXGOOOOXXXXXXXXXXXXXXXGOXXXXXXXXXXXXXXXXXXGOOOXXXXXXXXXXXXXXXXGOOXXXXXXXXXXXXXXXXXGOOOXXXXXXXXXXXXXXXXGOOOOOXXXXXXXXXXXXXXGXXXXXXXXXXXXXXXXXXXGOOXXXXXXXXXXXXXXXXXGOOXXXXXXXXXXXXXXXXXGOOOOOOOXXXXXXXXXXXX,0,0,0
4536,53,0,53,156,131,0,0,291,57,234,GOOXXXXXXXXXXXXXXXXXGOOOOOXXXXXXXXXXXXXXGOOOOXXXXXXXXXXXXXXXGOOOOXXXXXXXXXXXXXXXGOXXXXXXXXXXXXXXXXXXGOOOXXXXXXXXXXXXXXXXGOOXXXXXXXXXXXXXXXXXGOOOXXXXXXXXXXXXXXXXGOOOOOXXXXXXXXXXXXXXGXXXXXXXXXXXXXXXXXXXGOOXXXXXXXXXXXXXXXXXGOOXXXXXXXXXXXXXXXXXGOOOOOOOXXXXXXXXXXXX,0,0,0
4557,53,0,53,156,131,0,0,290,60,230,GOOXXXXXXXXXXXXXXXXXGOOOOOXXXXXXXXXXXXXXGOOOOXXXXXXXXXXXXXXXGOOOOXXXXXXXXXXXXXXXGOXXXXXXXXXXXXXXXXXXGOOOXXXXXXXXXXXXXXXXGOOXXXXXXXXXXXXXXXXXGOOOXXXXXXXXXXXXXXXXGOOOOOXXXXXXXXXXXXXXGXXXXXXXXXXXXXXXXXXXGOOXXXXXXXXXXXXXXXXXGOOXXXXXXXXXXXXXXXXXGOOOOOOOXXXXXXXXXXXX,0,0,0
4578,53,0,53,157,130,0,0,289,66,223,GOOXXXXXXXXXXXXXXXXXGOOOOOXXXXXXXXXXXXXXGOOOOXXXXXXXXXXXXXXXGOOOOXXXXXXXXXXXXXXXGOXXXXXXXXXXXXXXXXXXGOOOXXXXXXXXXXXXXXXXGOOXXXXXXXXXXXXXXXXXGOOOXXXXXXXXXXXXXXXXGOOOOOXXXXXXXXXXXXXXGXXXXXXXXXXXXXXXXXXXGOOXXXXXXXXXXXXXXXXXGOOXXXXXXXXXXXXXXXXXGOOOOOOOXXXXXXXXXXXX,0,0,0
4599,53,0,53,158,129,0,0,289,62,227,GOOXXXXXXXXXXXXXXXXXGOOOOOXXXXXXXXXXXXXXGOOOOXXXXXXXXXXXXXXXGOOOOXXXXXXXXXXXXXXXGOXXXXXXXXXXXXXXXXXXGOOOXXXXXXXXXXXXXXXXGOOXXXXXXXXXXXXXXXXXGOOOXXXXXXXXXXXXXXXXGOOOOOXXXXXXXXXXXXXXGXXXXXXXXXXXXXXXXXXXGOOXXXXXXXXXXXXXXXXXGOOXXXXXXXXXXXXXXXXXGOOOOOOOXXXXXXXXXXXX,0,0,0

4620,53,0,53,162,125,0,0,285,54,231,GOOXXXXXXXXXXXXXXXXXGOOOOOXXXXXXXXXXXXXXGOOOOXXXXXXXXXXXXXXXGOOOOXXXXXXXXXXXXXXXGOXXXXXXXXXXXXXXXXXXGOOOXXXXXXXXXXXXXXXXGOOXXXXXXXXXXXXXXXXXGOOOXXXXXXXXXXXXXXXXGOOOOOXXXXXXXXXXXXXXGXXXXXXXXXXXXXXXXXXXGOOXXXXXXXXXXXXXXXXXGOOXXXXXXXXXXXXXXXXXGOOOOOOOXXXXXXXXXXXX,0,0,0
4641,53,0,53,161,126,0,0,286,56,230,GOOXXXXXXXXXXXXXXXXXGOOOOOXXXXXXXXXXXXXXGOOOOXXXXXXXXXXXXXXXGOOOOXXXXXXXXXXXXXXXGOXXXXXXXXXXXXXXXXXXGOOOXXXXXXXXXXXXXXXXGOOXXXXXXXXXXXXXXXXXGOOOXXXXXXXXXXXXXXXXGOOOOOXXXXXXXXXXXXXXGXXXXXXXXXXXXXXXXXXXGOOXXXXXXXXXXXXXXXXXGOOXXXXXXXXXXXXXXXXXGOOOOOOOXXXXXXXXXXXX,0,0,0
4662,53,0,53,156,131,0,0,291,55,236,GOOXXXXXXXXXXXXXXXXXGOOOOOXXXXXXXXXXXXXXGOOOOXXXXXXXXXXXXXXXGOOOOXXXXXXXXXXXXXXXGOXXXXXXXXXXXXXXXXXXGOOOXXXXXXXXXXXXXXXXGOOXXXXXXXXXXXXXXXXXGOOOXXXXXXXXXXXXXXXXGOOOOOXXXXXXXXXXXXXXGXXXXXXXXXXXXXXXXXXXGOOXXXXXXXXXXXXXXXXXGOOXXXXXXXXXXXXXXXXXGOOOOOOOXXXXXXXXXXXX,0,0,0
4683,53,0,53,159,128,0,0,288,55,233,GOOXXXXXXXXXXXXXXXXXGOOOOOXXXXXXXXXXXXXXGOOOOXXXXXXXXXXXXXXXGOOOOXXXXXXXXXXXXXXXGOXXXXXXXXXXXXXXXXXXGOOOXXXXXXXXXXXXXXXXGOOXXXXXXXXXXXXXXXXXGOOOXXXXXXXXXXXXXXXXGOOOOOXXXXXXXXXXXXXXGXXXXXXXXXXXXXXXXXXXGOOXXXXXXXXXXXXXXXXXGOOXXXXXXXXXXXXXXXXXGOOOOOOOXXXXXXXXXXXX,0,0,0
4704,53,0,53,159,128,0,0,288,59,229,GOOXXXXXXXXXXXXXXXXXGOOOOOXXXXXXXXXXXXXXGOOOOXXXXXXXXXXXXXXXGOOOOXXXXXXXXXXXXXXXGOXXXXXXXXXXXXXXXXXXGOOOXXXXXXXXXXXXXXXXGOOXXXXXXXXXXXXXXXXXGOOOXXXXXXXXXXXXXXXXGOOOOOXXXXXXXXXXXXXXGXXXXXXXXXXXXXXXXXXXGOOXXXXXXXXXXXXXXXXXGOOXXXXXXXXXXXXXXXXXGOOOOOOOXXXXXXXXXXXX,0,0,0

4725,53,0,53,156,131,0,0,291,62,229,GOOXXXXXXXXXXXXXXXXXGOOOOOXXXXXXXXXXXXXXGOOOOXXXXXXXXXXXXXXXGOOOOXXXXXXXXXXXXXXXGOXXXXXXXXXXXXXXXXXXGOOOXXXXXXXXXXXXXXXXGOOXXXXXXXXXXXXXXXXXGOOOXXXXXXXXXXXXXXXXGOOOOOXXXXXXXXXXXXXXGXXXXXXXXXXXXXXXXXXXGOOXXXXXXXXXXXXXXXXXGOOXXXXXXXXXXXXXXXXXGOOOOOOOXXXXXXXXXXXX,0,0,0
4746,53,0,53,159,128,0,0,288,58,230,GOOXXXXXXXXXXXXXXXXXGOOOOOXXXXXXXXXXXXXXGOOOOXXXXXXXXXXXXXXXGOOOOXXXXXXXXXXXXXXXGOXXXXXXXXXXXXXXXXXXGOOOXXXXXXXXXXXXXXXXGOOXXXXXXXXXXXXXXXXXGOOOXXXXXXXXXXXXXXXXGOOOOOXXXXXXXXXXXXXXGXXXXXXXXXXXXXXXXXXXGOOXXXXXXXXXXXXXXXXXGOOXXXXXXXXXXXXXXXXXGOOOOOOOXXXXXXXXXXXX,0,0,0
4767,53,0,53,159,128,0,0,288,66,222,GOOXXXXXXXXXXXXXXXXXGOOOOOXXXXXXXXXXXXXXGOOOOXXXXXXXXXXXXXXXGOOOOXXXXXXXXXXXXXXXGOXXXXXXXXXXXXXXXXXXGOOOXXXXXXXXXXXXXXXXGOOXXXXXXXXXXXXXXXXXGOOOXXXXXXXXXXXXXXXXGOOOOOXXXXXXXXXXXXXXGXXXXXXXXXXXXXXXXXXXGOOXXXXXXXXXXXXXXXXXGOOXXXXXXXXXXXXXXXXXGOOOOOOOXXXXXXXXXXXX,0,0,0
4788,53,0,53,158,129,0,0,286,65,221,GOOXXXXXXXXXXXXXXXXXGOOOOOXXXXXXXXXXXXXXGOOOOXXXXXXXXXXXXXXXGOOOOXXXXXXXXXXXXXXXGOXXXXXXXXXXXXXXXXXXGOOOXXXXXXXXXXXXXXXXGOOXXXXXXXXXXXXXXXXXGOOOXXXXXXXXXXXXXXXXGOOOOOXXXXXXXXXXXXXXGXXXXXXXXXXXXXXXXXXXGOOXXXXXXXXXXXXXXXXXGOOXXXXXXXXXXXXXXXXXGOOOOOOOXXXXXXXXXXXX,0,0,0
4809,53,0,53,162,125,0,0,285,67,218,GOOXXXXXXXXXXXXXXXXXGOOOOOXXXXXXXXXXXXXXGOOOOXXXXXXXXXXXXXXXGOOOOXXXXXXXXXXXXXXXGOXXXXXXXXXXXXXXXXXXGOOOXXXXXXXXXXXXXXXXGOOXXXXXXXXXXXXXXXXXGOOOXXXXXXXXXXXXXXXXGOOOOOXXXXXXXXXXXXXXGXXXXXXXXXXXXXXXXXXXGOOXXXXXXXXXXXXXXXXXGOOXXXXXXXXXXXXXXXXXGOOOOOOOXXXXXXXXXXXX,0,0,0

4830,53,0,53,162,125,0,0,284,63,221,GOOXXXXXXXXXXXXXXXXXGOOOOOXXXXXXXXXXXXXXGOOOOXXXXXXXXXXXXXXXGOOOOXXXXXXXXXXXXXXXGOXXXXXXXXXXXXXXXXXXGOOOXXXXXXXXXXXXXXXXGOOXXXXXXXXXXXXXXXXXGOOOXXXXXXXXXXXXXXXXGOOOOOXXXXXXXXXXXXXXGXXXXXXXXXXXXXXXXXXXGOOXXXXXXXXXXXXXXXXXGOOXXXXXXXXXXXXXXXXXGOOOOOOOXXXXXXXXXXXX,0,0,0
4851,53,0,53,161,126,0,0,285,54,231,GOOXXXXXXXXXXXXXXXXXGOOOOOXXXXXXXXXXXXXXGOOOOXXXXXXXXXXXXXXXGOOOOXXXXXXXXXXXXXXXGOXXXXXXXXXXXXXXXXXXGOOOXXXXXXXXXXXXXXXXGOOXXXXXXXXXXXXXXXXXGOOOXXXXXXXXXXXXXXXXGOOOOOXXXXXXXXXXXXXXGXXXXXXXXXXXXXXXXXXXGOOXXXXXXXXXXXXXXXXXGOOXXXXXXXXXXXXXXXXXGOOOOOOOXXXXXXXXXXXX,0,0,0
4872,53,0,53,160,127,0,0,287,56,231,GOOXXXXXXXXXXXXXXXXXGOOOOOXXXXXXXXXXXXXXGOOOOXXXXXXXXXXXXXXXGOOOOXXXXXXXXXXXXXXXGOXXXXXXXXXXXXXXXXXXGOOOXXXXXXXXXXXXXXXXGOOXXXXXXXXXXXXXXXXXGOOOXXXXXXXXXXXXXXXXGOOOOOXXXXXXXXXXXXXXGXXXXXXXXXXXXXXXXXXXGOOXXXXXXXXXXXXXXXXXGOOXXXXXXXXXXXXXXXXXGOOOOOOOXXXXXXXXXXXX,0,0,0
4893,53,0,53,154,133,0,0,291,65,226,GOOXXXXXXXXXXXXXXXXXGOOOOOXXXXXXXXXXXXXXGOOOOXXXXXXXXXXXXXXXGOOOOXXXXXXXXXXXXXXXGOXXXXXXXXXXXXXXXXXXGOOOXXXXXXXXXXXXXXXXGOOXXXXXXXXXXXXXXXXXGOOOXXXXXXXXXXXXXXXXGOOOOOXXXXXXXXXXXXXXGXXXXXXXXXXXXXXXXXXXGOOXXXXXXXXXXXXXXXXXGOOXXXXXXXXXXXXXXXXXGOOOOOOOXXXXXXXXXXXX,0,0,0
4914,54,1,53,153,133,0,0,293,63,230,GOOXXXXXXXXXXXXXXXXXGOOOOOXXXXXXXXXXXXXXGOOOOXXXXXXXXXXXXXXXGOOOOXXXXXXXXXXXXXXXGOXXXXXXXXXXXXXXXXXXGOOOXXXXXXXXXXXXXXXXGOOXXXXXXXXXXXXXXXXXGOOOXXXXXXXXXXXXXXXXGOOOOOAXXXXXXXXXXXXXGXXXXXXXXXXXXXXXXXXXGOOXXXXXXXXXXXXXXXXXGOOXXXXXXXXXXXXXXXXXGOOOOOOOXXXXXXXXXXXX,0,0,0

4935,54,1,53,147,139,0,0,298,67,231,GOOXXXXXXXXXXXXXXXXXGOOOOOXXXXXXXXXXXXXXGOOOOXXXXXXXXXXXXXXXGOOOOXXXXXXXXXXXXXXXGOXXXXXXXXXXXXXXXXXXGOOOXXXXXXXXXXXXXXXXGOOXXXXXXXXXXXXXXXXXGOOOXXXXXXXXXXXXXXXXGOOOOOAXXXXXXXXXXXXXGXXXXXXXXXXXXXXXXXXXGOOXXXXXXXXXXXXXXXXXGOOXXXXXXXXXXXXXXXXXGOOOOOOOXXXXXXXXXXXX,0,0,0
4956,54,1,53,164,122,0,0,282,61,221,GOOXXXXXXXXXXXXXXXXXGOOOOOXXXXXXXXXXXXXXGOOOOXXXXXXXXXXXXXXXGOOOOXXXXXXXXXXXXXXXGOXXXXXXXXXXXXXXXXXXGOOOXXXXXXXXXXXXXXXXGOOXXXXXXXXXXXXXXXXXGOOOXXXXXXXXXXXXXXXXGOOOOOAXXXXXXXXXXXXXGXXXXXXXXXXXXXXXXXXXGOOXXXXXXXXXXXXXXXXXGOOXXXXXXXXXXXXXXXXXGOOOOOOOXXXXXXXXXXXX,0,0,0
4977,54,1,53,171,115,0,0,274,60,214,GOOXXXXXXXXXXXXXXXXXGOOOOOXXXXXXXXXXXXXXGOOOOXXXXXXXXXXXXXXXGOOOOXXXXXXXXXXXXXXXGOXXXXXXXXXXXXXXXXXXGOOOXXXXXXXXXXXXXXXXGOOXXXXXXXXXXXXXXXXXGOOOXXXXXXXXXXXXXXXXGOOOOOAXXXXXXXXXXXXXGXXXXXXXXXXXXXXXXXXXGOOXXXXXXXXXXXXXXXXXGOOXXXXXXXXXXXXXXXXXGOOOOOOOXXXXXXXXXXXX,0,0,0
4998,54,1,53,170,116,0,0,276,63,213,GOOXXXXXXXXXXXXXXXXXGOOOOOXXXXXXXXXXXXXXGOOOOXXXXXXXXXXXXXXXGOOOOXXXXXXXXXXXXXXXGOXXXXXXXXXXXXXXXXXXGOOOXXXXXXXXXXXXXXXXGOOXXXXXXXXXXXXXXXXXGOOOXXXXXXXXXXXXXXXXGOOOOOAXXXXXXXXXXXXXGXXXXXXXXXXXXXXXXXXXGOOXXXXXXXXXXXXXXXXXGOOXXXXXXXXXXXXXXXXXGOOOOOOOXXXXXXXXXXXX,0,0,0
5019,54,0,54,156,130,0,0,285,66,219,GOOXXXXXXXXXXXXXXXXXGOOOOOXXXXXXXXXXXXXXGOOOOXXXXXXXXXXXXXXXGOOOOXXXXXXXXXXXXXXXGOXXXXXXXXXXXXXXXXXXGOOOXXXXXXXXXXXXXXXXGOOXXXXXXXXXXXXXXXXXGOOOXXXXXXXXXXXXXXXXGOOOOOOXXXXXXXXXXXXXGXXXXXXXXXXXXXXXXXXXGOOXXXXXXXXXXXXXXXXXGOOXXXXXXXXXXXXXXXXXGOOOOOOOXXXXXXXXXXXX,0,0,0

5040,54,0,54,157,129,0,0,288,68,220,GOOXXXXXXXXXXXXXXXXXGOOOOOXXXXXXXXXXXXXXGOOOOXXXXXXXXXXXXXXXGOOOOXXXXXXXXXXXXXXXGOXXXXXXXXXXXXXXXXXXGOOOXXXXXXXXXXXXXXXXGOOXXXXXXXXXXXXXXXXXGOOOXXXXXXXXXXXXXXXXGOOOOOOXXXXXXXXXXXXXGXXXXXXXXXXXXXXXXXXXGOOXXXXXXXXXXXXXXXXXGOOXXXXXXXXXXXXXXXXXGOOOOOOOXXXXXXXXXXXX,0,0,0
5061,54,0,54,156,130,0,0,288,60,228,GOOXXXXXXXXXXXXXXXXXGOOOOOXXXXXXXXXXXXXXGOOOOXXXXXXXXXXXXXXXGOOOOXXXXXXXXXXXXXXXGOXXXXXXXXXXXXXXXXXXGOOOXXXXXXXXXXXXXXXXGOOXXXXXXXXXXXXXXXXXGOOOXXXXXXXXXXXXXXXXGOOOOOOXXXXXXXXXXXXXGXXXXXXXXXXXXXXXXXXXGOOXXXXXXXXXXXXXXXXXGOOXXXXXXXXXXXXXXXXXGOOOOOOOXXXXXXXXXXXX,0,0,0
5082,54,0,54,149,137,0,0,297,68,229,GOOXXXXXXXXXXXXXXXXXGOOOOOXXXXXXXXXXXXXXGOOOOXXXXXXXXXXXXXXXGOOOOXXXXXXXXXXXXXXXGOXXXXXXXXXXXXXXXXXXGOOOXXXXXXXXXXXXXXXXGOOXXXXXXXXXXXXXXXXXGOOOXXXXXXXXXXXXXXXXGOOOOOOXXXXXXXXXXXXXGXXXXXXXXXXXXXXXXXXXGOOXXXXXXXXXXXXXXXXXGOOXXXXXXXXXXXXXXXXXGOOOOOOOXXXXXXXXXXXX,0,0,0
5103,54,0,54,155,131,0,0,291,70,221,GOOXXXXXXXXXXXXXXXXXGOOOOOXXXXXXXXXXXXXXGOOOOXXXXXXXXXXXXXXXGOOOOXXXXXXXXXXXXXXXGOXXXXXXXXXXXXXXXXXXGOOOXXXXXXXXXXXXXXXXGOOXXXXXXXXXXXXXXXXXGOOOXXXXXXXXXXXXXXXXGOOOOOOXXXXXXXXXXXXXGXXXXXXXXXXXXXXXXXXXGOOXXXXXXXXXXXXXXXXXGOOXXXXXXXXXXXXXXXXXGOOOOOOOXXXXXXXXXXXX,0,0,0
5124,54,0,54,157,129,0,0,289,73,216,GOOXXXXXXXXXXXXXXXXXGOOOOOXXXXXXXXXXXXXXGOOOOXXXXXXXXXXXXXXXGOOOOXXXXXXXXXXXXXXXGOXXXXXXXXXXXXXXXXXXGOOOXXXXXXXXXXXXXXXXGOOXXXXXXXXXXXXXXXXXGOOOXXXXXXXXXXXXXXXXGOOOOOOXXXXXXXXXXXXXGXXXXXXXXXXXXXXXXXXXGOOXXXXXXXXXXXXXXXXXGOOXXXXXXXXXXXXXXXXXGOOOOOOOXXXXXXXXXXXX,0,0,0

5145,54,0,54,157,129,0,0,288,70,218,GOOXXXXXXXXXXXXXXXXXGOOOOOXXXXXXXXXXXXXXGOOOOXXXXXXXXXXXXXXXGOOOOXXXXXXXXXXXXXXXGOXXXXXXXXXXXXXXXXXXGOOOXXXXXXXXXXXXXXXXGOOXXXXXXXXXXXXXXXXXGOOOXXXXXXXXXXXXXXXXGOOOOOOXXXXXXXXXXXXXGXXXXXXXXXXXXXXXXXXXGOOXXXXXXXXXXXXXXXXXGOOXXXXXXXXXXXXXXXXXGOOOOOOOXXXXXXXXXXXX,0,0,0
5166,54,0,54,156,130,0,0,289,68,221,GOOXXXXXXXXXXXXXXXXXGOOOOOXXXXXXXXXXXXXXGOOOOXXXXXXXXXXXXXXXGOOOOXXXXXXXXXXXXXXXGOXXXXXXXXXXXXXXXXXXGOOOXXXXXXXXXXXXXXXXGOOXXXXXXXXXXXXXXXXXGOOOXXXXXXXXXXXXXXXXGOOOOOOXXXXXXXXXXXXXGXXXXXXXXXXXXXXXXXXXGOOXXXXXXXXXXXXXXXXXGOOXXXXXXXXXXXXXXXXXGOOOOOOOXXXXXXXXXXXX,0,0,0
5187,54,0,54,158,128,0,0,287,63,224,GOOXXXXXXXXXXXXXXXXXGOOOOOXXXXXXXXXXXXXXGOOOOXXXXXXXXXXXXXXXGOOOOXXXXXXXXXXXXXXXGOXXXXXXXXXXXXXXXXXXGOOOXXXXXXXXXXXXXXXXGOOXXXXXXXXXXXXXXXXXGOOOXXXXXXXXXXXXXXXXGOOOOOOXXXXXXXXXXXXXGXXXXXXXXXXXXXXXXXXXGOOXXXXXXXXXXXXXXXXXGOOXXXXXXXXXXXXXXXXXGOOOOOOOXXXXXXXXXXXX,0,0,0
5208,54,0,54,161,125,0,0,285,60,225,GOOXXXXXXXXXXXXXXXXXGOOOOOXXXXXXXXXXXXXXGOOOOXXXXXXXXXXXXXXXGOOOOXXXXXXXXXXXXXXXGOXXXXXXXXXXXXXXXXXXGOOOXXXXXXXXXXXXXXXXGOOXXXXXXXXXXXXXXXXXGOOOXXXXXXXXXXXXXXXXGOOOOOOXXXXXXXXXXXXXGXXXXXXXXXXXXXXXXXXXGOOXXXXXXXXXXXXXXXXXGOOXXXXXXXXXXXXXXXXXGOOOOOOOXXXXXXXXXXXX,0,0,0
5229,54,0,54,161,125,0,0,283,63,220,GOOXXXXXXXXXXXXXXXXXGOOOOOXXXXXXXXXXXXXXGOOOOXXXXXXXXXXXXXXXGOOOOXXXXXXXXXXXXXXXGOXXXXXXXXXXXXXXXXXXGOOOXXXXXXXXXXXXXXXXGOOXXXXXXXXXXXXXXXXXGOOOXXXXXXXXXXXXXXXXGOOOOOOXXXXXXXXXXXXXGXXXXXXXXXXXXXXXXXXXGOOXXXXXXXXXXXXXXXXXGOOXXXXXXXXXXXXXXXXXGOOOOOOOXXXXXXXXXXXX,0,0,0

5250,55,1,54,159,126,0,0,286,60,226,GOOXXXXXXXXXXXXXXXXXGOOOOOXXXXXXXXXXXXXXGOOOOAXXXXXXXXXXXXXXGOOOOXXXXXXXXXXXXXXXGOXXXXXXXXXXXXXXXXXXGOOOXXXXXXXXXXXXXXXXGOOXXXXXXXXXXXXXXXXXGOOOXXXXXXXXXXXXXXXXGOOOOOOXXXXXXXXXXXXXGXXXXXXXXXXXXXXXXXXXGOOXXXXXXXXXXXXXXXXXGOOXXXXXXXXXXXXXXXXXGOOOOOOOXXXXXXXXXXXX,0,0,0
5271,56,2,54,151,133,0,0,292,64,228,GOOXXXXXXXXXXXXXXXXXGOOOOOXXXXXXXXXXXXXXGOOOOAXXXXXXXXXXXXXXGOOOOXXXXXXXXXXXXXXXGOXXXXXXXXXXXXXXXXXXGOOOAXXXXXXXXXXXXXXXGOOXXXXXXXXXXXXXXXXXGOOOXXXXXXXXXXXXXXXXGOOOOOOXXXXXXXXXXXXXGXXXXXXXXXXXXXXXXXXXGOOXXXXXXXXXXXXXXXXXGOOXXXXXXXXXXXXXXXXXGOOOOOOOXXXXXXXXXXXX,0,0,0
5292,56,2,54,158,126,0,0,286,57,229,GOOXXXXXXXXXXXXXXXXXGOOOOOXXXXXXXXXXXXXXGOOOOAXXXXXXXXXXXXXXGOOOOXXXXXXXXXXXXXXXGOXXXXXXXXXXXXXXXXXXGOOOAXXXXXXXXXXXXXXXGOOXXXXXXXXXXXXXXXXXGOOOXXXXXXXXXXXXXXXXGOOOOOOXXXXXXXXXXXXXGXXXXXXXXXXXXXXXXXXXGOOXXXXXXXXXXXXXXXXXGOOXXXXXXXXXXXXXXXXXGOOOOOOOXXXXXXXXXXXX,0,0,0
5313,56,2,54,158,126,0,0,287,59,228,GOOXXXXXXXXXXXXXXXXXGOOOOOXXXXXXXXXXXXXXGOOOOAXXXXXXXXXXXXXXGOOOOXXXXXXXXXXXXXXXGOXXXXXXXXXXXXXXXXXXGOOOAXXXXXXXXXXXXXXXGOOXXXXXXXXXXXXXXXXXGOOOXXXXXXXXXXXXXXXXGOOOOOOXXXXXXXXXXXXXGXXXXXXXXXXXXXXXXXXXGOOXXXXXXXXXXXXXXXXXGOOXXXXXXXXXXXXXXXXXGOOOOOOOXXXXXXXXXXXX,0,0,0
5334,56,1,55,161,123,0,0,284,55,229,GOOXXXXXXXXXXXXXXXXXGOOOOOXXXXXXXXXXXXXXGOOOOOXXXXXXXXXXXXXXGOOOOXXXXXXXXXXXXXXXGOXXXXXXXXXXXXXXXXXXGOOOAXXXXXXXXXXXXXXXGOOXXXXXXXXXXXXXXXXXGOOOXXXXXXXXXXXXXXXXGOOOOOOXXXXXXXXXXXXXGXXXXXXXXXXXXXXXXXXXGOOXXXXXXXXXXXXXXXXXGOOXXXXXXXXXXXXXXXXXGOOOOOOOXXXXXXXXXXXX,0,0,0

5355,56,1,55,155,129,0,0,291,63,228,GOOXXXXXXXXXXXXXXXXXGOOOOOXXXXXXXXXXXXXXGOOOOOXXXXXXXXXXXXXXGOOOOXXXXXXXXXXXXXXXGOXXXXXXXXXXXXXXXXXXGOOOAXXXXXXXXXXXXXXXGOOXXXXXXXXXXXXXXXXXGOOOXXXXXXXXXXXXXXXXGOOOOOOXXXXXXXXXXXXXGXXXXXXXXXXXXXXXXXXXGOOXXXXXXXXXXXXXXXXXGOOXXXXXXXXXXXXXXXXXGOOOOOOOXXXXXXXXXXXX,0,0,0
5376,56,1,55,163,121,0,0,283,57,226,GOOXXXXXXXXXXXXXXXXXGOOOOOXXXXXXXXXXXXXXGOOOOOXXXXXXXXXXXXXXGOOOOXXXXXXXXXXXXXXXGOXXXXXXXXXXXXXXXXXXGOOOAXXXXXXXXXXXXXXXGOOXXXXXXXXXXXXXXXXXGOOOXXXXXXXXXXXXXXXXGOOOOOOXXXXXXXXXXXXXGXXXXXXXXXXXXXXXXXXXGOOXXXXXXXXXXXXXXXXXGOOXXXXXXXXXXXXXXXXXGOOOOOOOXXXXXXXXXXXX,0,0,0
5397,56,1,55,160,124,0,0,286,62,224,GOOXXXXXXXXXXXXXXXXXGOOOOOXXXXXXXXXXXXXXGOOOOOXXXXXXXXXXXXXXGOOOOXXXXXXXXXXXXXXXGOXXXXXXXXXXXXXXXXXXGOOOAXXXXXXXXXXXXXXXGOOXXXXXXXXXXXXXXXXXGOOOXXXXXXXXXXXXXXXXGOOOOOOXXXXXXXXXXXXXGXXXXXXXXXXXXXXXXXXXGOOXXXXXXXXXXXXXXXXXGOOXXXXXXXXXXXXXXXXXGOOOOOOOXXXXXXXXXXXX,0,0,0
5418,56,1,55,162,122,0,0,281,67,214,GOOXXXXXXXXXXXXXXXXXGOOOOOXXXXXXXXXXXXXXGOOOOOXXXXXXXXXXXXXXGOOOOXXXXXXXXXXXXXXXGOXXXXXXXXXXXXXXXXXXGOOOAXXXXXXXXXXXXXXXGOOXXXXXXXXXXXXXXXXXGOOOXXXXXXXXXXXXXXXXGOOOOOOXXXXXXXXXXXXXGXXXXXXXXXXXXXXXXXXXGOOXXXXXXXXXXXXXXXXXGOOXXXXXXXXXXXXXXXXXGOOOOOOOXXXXXXXXXXXX,0,0,0
5439,56,1,55,159,125,0,0,286,61,225,GOOXXXXXXXXXXXXXXXXXGOOOOOXXXXXXXXXXXXXXGOOOOOXXXXXXXXXXXXXXGOOOOXXXXXXXXXXXXXXXGOXXXXXXXXXXXXXXXXXXGOOOAXXXXXXXXXXXXXXXGOOXXXXXXXXXXXXXXXXXGOOOXXXXXXXXXXXXXXXXGOOOOOOXXXXXXXXXXXXXGXXXXXXXXXXXXXXXXXXXGOOXXXXXXXXXXXXXXXXXGOOXXXXXXXXXXXXXXXXXGOOOOOOOXXXXXXXXXXXX,0,0,0

5460,56,1,55,151,133,0,0,293,60,233,GOOXXXXXXXXXXXXXXXXXGOOOOOXXXXXXXXXXXXXXGOOOOOXXXXXXXXXXXXXXGOOOOXXXXXXXXXXXXXXXGOXXXXXXXXXXXXXXXXXXGOOOAXXXXXXXXXXXXXXXGOOXXXXXXXXXXXXXXXXXGOOOXXXXXXXXXXXXXXXXGOOOOOOXXXXXXXXXXXXXGXXXXXXXXXXXXXXXXXXXGOOXXXXXXXXXXXXXXXXXGOOXXXXXXXXXXXXXXXXXGOOOOOOOXXXXXXXXXXXX,0,0,0
5481,56,0,56,149,135,0,0,296,64,232,GOOXXXXXXXXXXXXXXXXXGOOOOOXXXXXXXXXXXXXXGOOOOOXXXXXXXXXXXXXXGOOOOXXXXXXXXXXXXXXXGOXXXXXXXXXXXXXXXXXXGOOOOXXXXXXXXXXXXXXXGOOXXXXXXXXXXXXXXXXXGOOOXXXXXXXXXXXXXXXXGOOOOOOXXXXXXXXXXXXXGXXXXXXXXXXXXXXXXXXXGOOXXXXXXXXXXXXXXXXXGOOXXXXXXXXXXXXXXXXXGOOOOOOOXXXXXXXXXXXX,0,0,0
5502,56,0,56,155,129,0,0,288,64,224,GOOXXXXXXXXXXXXXXXXXGOOOOOXXXXXXXXXXXXXXGOOOOOXXXXXXXXXXXXXXGOOOOXXXXXXXXXXXXXXXGOXXXXXXXXXXXXXXXXXXGOOOOXXXXXXXXXXXXXXXGOOXXXXXXXXXXXXXXXXXGOOOXXXXXXXXXXXXXXXXGOOOOOOXXXXXXXXXXXXXGXXXXXXXXXXXXXXXXXXXGOOXXXXXXXXXXXXXXXXXGOOXXXXXXXXXXXXXXXXXGOOOOOOOXXXXXXXXXXXX,0,0,0
5523,56,0,56,157,127,0,0,287,64,223,GOOXXXXXXXXXXXXXXXXXGOOOOOXXXXXXXXXXXXXXGOOOOOXXXXXXXXXXXXXXGOOOOXXXXXXXXXXXXXXXGOXXXXXXXXXXXXXXXXXXGOOOOXXXXXXXXXXXXXXXGOOXXXXXXXXXXXXXXXXXGOOOXXXXXXXXXXXXXXXXGOOOOOOXXXXXXXXXXXXXGXXXXXXXXXXXXXXXXXXXGOOXXXXXXXXXXXXXXXXXGOOXXXXXXXXXXXXXXXXXGOOOOOOOXXXXXXXXXXXX,0,0,0
5544,56,0,56,155,129,0,0,290,63,227,GOOXXXXXXXXXXXXXXXXXGOOOOOXXXXXXXXXXXXXXGOOOOOXXXXXXXXXXXXXXGOOOOXXXXXXXXXXXXXXXGOXXXXXXXXXXXXXXXXXXGOOOOXXXXXXXXXXXXXXXGOOXXXXXXXXXXXXXXXXXGOOOXXXXXXXXXXXXXXXXGOOOOOOXXXXXXXXXXXXXGXXXXXXXXXXXXXXXXXXXGOOXXXXXXXXXXXXXXXXXGOOXXXXXXXXXXXXXXXXXGOOOOOOOXXXXXXXXXXXX,0,0,0

5565,56,0,56,154,130,0,0,291,68,223,GOOXXXXXXXXXXXXXXXXXGOOOOOXXXXXXXXXXXXXXGOOOOOXXXXXXXXXXXXXXGOOOOXXXXXXXXXXXXXXXGOXXXXXXXXXXXXXXXXXXGOOOOXXXXXXXXXXXXXXXGOOXXXXXXXXXXXXXXXXXGOOOXXXXXXXXXXXXXXXXGOOOOOOXXXXXXXXXXXXXGXXXXXXXXXXXXXXXXXXXGOOXXXXXXXXXXXXXXXXXGOOXXXXXXXXXXXXXXXXXGOOOOOOOXXXXXXXXXXXX,0,0,0
5586,56,0,56,156,128,0,0,286,76,210,GOOXXXXXXXXXXXXXXXXXGOOOOOXXXXXXXXXXXXXXGOOOOOXXXXXXXXXXXXXXGOOOOXXXXXXXXXXXXXXXGOXXXXXXXXXXXXXXXXXXGOOOOXXXXXXXXXXXXXXXGOOXXXXXXXXXXXXXXXXXGOOOXXXXXXXXXXXXXXXXGOOOOOOXXXXXXXXXXXXXGXXXXXXXXXXXXXXXXXXXGOOXXXXXXXXXXXXXXXXXGOOXXXXXXXXXXXXXXXXXGOOOOOOOXXXXXXXXXXXX,0,0,0
5607,56,0,56,153,131,0,0,290,78,212,GOOXXXXXXXXXXXXXXXXXGOOOOOXXXXXXXXXXXXXXGOOOOOXXXXXXXXXXXXXXGOOOOXXXXXXXXXXXXXXXGOXXXXXXXXXXXXXXXXXXGOOOOXXXXXXXXXXXXXXXGOOXXXXXXXXXXXXXXXXXGOOOXXXXXXXXXXXXXXXXGOOOOOOXXXXXXXXXXXXXGXXXXXXXXXXXXXXXXXXXGOOXXXXXXXXXXXXXXXXXGOOXXXXXXXXXXXXXXXXXGOOOOOOOXXXXXXXXXXXX,0,0,0
5628,56,0,56,155,129,0,0,290,74,216,GOOXXXXXXXXXXXXXXXXXGOOOOOXXXXXXXXXXXXXXGOOOOOXXXXXXXXXXXXXXGOOOOXXXXXXXXXXXXXXXGOXXXXXXXXXXXXXXXXXXGOOOOXXXXXXXXXXXXXXXGOOXXXXXXXXXXXXXXXXXGOOOXXXXXXXXXXXXXXXXGOOOOOOXXXXXXXXXXXXXGXXXXXXXXXXXXXXXXXXXGOOXXXXXXXXXXXXXXXXXGOOXXXXXXXXXXXXXXXXXGOOOOOOOXXXXXXXXXXXX,0,0,0
5649,56,0,56,155,129,0,0,290,72,218,GOOXXXXXXXXXXXXXXXXXGOOOOOXXXXXXXXXXXXXXGOOOOOXXXXXXXXXXXXXXGOOOOXXXXXXXXXXXXXXXGOXXXXXXXXXXXXXXXXXXGOOOOXXXXXXXXXXXXXXXGOOXXXXXXXXXXXXXXXXXGOOOXXXXXXXXXXXXXXXXGOOOOOOXXXXXXXXXXXXXGXXXXXXXXXXXXXXXXXXXGOOXXXXXXXXXXXXXXXXXGOOXXXXXXXXXXXXXXXXXGOOOOOOOXXXXXXXXXXXX,0,0,0

5670,58,2,56,145,137,0,0,296,63,233,GOOXXXXXXXXXXXXXXXXXGOOOOOAXXXXXXXXXXXXXGOOOOOXXXXXXXXXXXXXXGOOOOXXXXXXXXXXXXXXXGOXXXXXXXXXXXXXXXXXXGOOOOXXXXXXXXXXXXXXXGOOXXXXXXXXXXXXXXXXXGOOOXXXXXXXXXXXXXXXXGOOOOOOXXXXXXXXXXXXXGXXXXXXXXXXXXXXXXXXXGOOAXXXXXXXXXXXXXXXXGOOXXXXXXXXXXXXXXXXXGOOOOOOOXXXXXXXXXXXX,0,0,0
5691,58,2,56,155,127,0,0,287,64,223,GOOXXXXXXXXXXXXXXXXXGOOOOOAXXXXXXXXXXXXXGOOOOOXXXXXXXXXXXXXXGOOOOXXXXXXXXXXXXXXXGOXXXXXXXXXXXXXXXXXXGOOOOXXXXXXXXXXXXXXXGOOXXXXXXXXXXXXXXXXXGOOOXXXXXXXXXXXXXXXXGOOOOOOXXXXXXXXXXXXXGXXXXXXXXXXXXXXXXXXXGOOAXXXXXXXXXXXXXXXXGOOXXXXXXXXXXXXXXXXXGOOOOOOOXXXXXXXXXXXX,0,0,0
5712,58,2,56,145,137,0,0,296,65,231,GOOXXXXXXXXXXXXXXXXXGOOOOOAXXXXXXXXXXXXXGOOOOOXXXXXXXXXXXXXXGOOOOXXXXXXXXXXXXXXXGOXXXXXXXXXXXXXXXXXXGOOOOXXXXXXXXXXXXXXXGOOXXXXXXXXXXXXXXXXXGOOOXXXXXXXXXXXXXXXXGOOOOOOXXXXXXXXXXXXXGXXXXXXXXXXXXXXXXXXXGOOAXXXXXXXXXXXXXXXXGOOXXXXXXXXXXXXXXXXXGOOOOOOOXXXXXXXXXXXX,0,0,0
5733,58,2,56,148,134,0,0,292,64,228,GOOXXXXXXXXXXXXXXXXXGOOOOOAXXXXXXXXXXXXXGOOOOOXXXXXXXXXXXXXXGOOOOXXXXXXXXXXXXXXXGOXXXXXXXXXXXXXXXXXXGOOOOXXXXXXXXXXXXXXXGOOXXXXXXXXXXXXXXXXXGOOOXXXXXXXXXXXXXXXXGOOOOOOXXXXXXXXXXXXXGXXXXXXXXXXXXXXXXXXXGOOAXXXXXXXXXXXXXXXXGOOXXXXXXXXXXXXXXXXXGOOOOOOOXXXXXXXXXXXX,0,0,0
5754,58,2,56,145,137,0,0,296,65,231,GOOXXXXXXXXXXXXXXXXXGOOOOOAXXXXXXXXXXXXXGOOOOOXXXXXXXXXXXXXXGOOOOXXXXXXXXXXXXXXXGOXXXXXXXXXXXXXXXXXXGOOOOXXXXXXXXXXXXXXXGOOXXXXXXXXXXXXXXXXXGOOOXXXXXXXXXXXXXXXXGOOOOOOXXXXXXXXXXXXXGXXXXXXXXXXXXXXXXXXXGOOAXXXXXXXXXXXXXXXXGOOXXXXXXXXXXXXXXXXXGOOOOOOOXXXXXXXXXXXX,0,0,0

5775,59,3,56,145,136,0,0,296,63,233,GOOXXXXXXXXXXXXXXXXXGOOOOOAXXXXXXXXXXXXXGOOOOOXXXXXXXXXXXXXXGOOOOXXXXXXXXXXXXXXXGOXXXXXXXXXXXXXXXXXXGOOOOXXXXXXXXXXXXXXXGOOXXXXXXXXXXXXXXXXXGOOOXXXXXXXXXXXXXXXXGOOOOOOXXXXXXXXXXXXXGXXXXXXXXXXXXXXXXXXXGOOAXXXXXXXXXXXXXXXXGOOAXXXXXXXXXXXXXXXXGOOOOOOOXXXXXXXXXXXX,0,0,0
5796,59,2,57,142,139,0,0,299,68,231,GOOXXXXXXXXXXXXXXXXXGOOOOOAXXXXXXXXXXXXXGOOOOOXXXXXXXXXXXXXXGOOOOXXXXXXXXXXXXXXXGOXXXXXXXXXXXXXXXXXXGOOOOXXXXXXXXXXXXXXXGOOXXXXXXXXXXXXXXXXXGOOOXXXXXXXXXXXXXXXXGOOOOOOXXXXXXXXXXXXXGXXXXXXXXXXXXXXXXXXXGOOOXXXXXXXXXXXXXXXXGOOAXXXXXXXXXXXXXXXXGOOOOOOOXXXXXXXXXXXX,0,0,0
5817,59,2,57,148,133,0,0,293,57,236,GOOXXXXXXXXXXXXXXXXXGOOOOOAXXXXXXXXXXXXXGOOOOOXXXXXXXXXXXXXXGOOOOXXXXXXXXXXXXXXXGOXXXXXXXXXXXXXXXXXXGOOOOXXXXXXXXXXXXXXXGOOXXXXXXXXXXXXXXXXXGOOOXXXXXXXXXXXXXXXXGOOOOOOXXXXXXXXXXXXXGXXXXXXXXXXXXXXXXXXXGOOOXXXXXXXXXXXXXXXXGOOAXXXXXXXXXXXXXXXXGOOOOOOOXXXXXXXXXXXX,0,0,0
5838,59,2,57,148,133,0,0,292,59,233,GOOXXXXXXXXXXXXXXXXXGOOOOOAXXXXXXXXXXXXXGOOOOOXXXXXXXXXXXXXXGOOOOXXXXXXXXXXXXXXXGOXXXXXXXXXXXXXXXXXXGOOOOXXXXXXXXXXXXXXXGOOXXXXXXXXXXXXXXXXXGOOOXXXXXXXXXXXXXXXXGOOOOOOXXXXXXXXXXXXXGXXXXXXXXXXXXXXXXXXXGOOOXXXXXXXXXXXXXXXXGOOAXXXXXXXXXXXXXXXXGOOOOOOOXXXXXXXXXXXX,0,0,0
5859,59,2,57,141,140,0,0,300,64,236,GOOXXXXXXXXXXXXXXXXXGOOOOOAXXXXXXXXXXXXXGOOOOOXXXXXXXXXXXXXXGOOOOXXXXXXXXXXXXXXXGOXXXXXXXXXXXXXXXXXXGOOOOXXXXXXXXXXXXXXXGOOXXXXXXXXXXXXXXXXXGOOOXXXXXXXXXXXXXXXXGOOOOOOXXXXXXXXXXXXXGXXXXXXXXXXXXXXXXXXXGOOOXXXXXXXXXXXXXXXXGOOAXXXXXXXXXXXXXXXXGOOOOOOOXXXXXXXXXXXX,0,0,0

5880,59,2,57,142,139,0,0,299,67,232,GOOXXXXXXXXXXXXXXXXXGOOOOOAXXXXXXXXXXXXXGOOOOOXXXXXXXXXXXXXXGOOOOXXXXXXXXXXXXXXXGOXXXXXXXXXXXXXXXXXXGOOOOXXXXXXXXXXXXXXXGOOXXXXXXXXXXXXXXXXXGOOOXXXXXXXXXXXXXXXXGOOOOOOXXXXXXXXXXXXXGXXXXXXXXXXXXXXXXXXXGOOOXXXXXXXXXXXXXXXXGOOAXXXXXXXXXXXXXXXXGOOOOOOOXXXXXXXXXXXX,0,0,0
5901,60,2,58,148,132,0,0,290,71,219,GOOXXXXXXXXXXXXXXXXXGOOOOOOXXXXXXXXXXXXXGOOOOOXXXXXXXXXXXXXXGOOOOXXXXXXXXXXXXXXXGOXXXXXXXXXXXXXXXXXXGOOOOXXXXXXXXXXXXXXXGOOXXXXXXXXXXXXXXXXXGOOOXXXXXXXXXXXXXXXXGOOOOOOXXXXXXXXXXXXXGXXXXXXXXXXXXXXXXXXXGOOOAXXXXXXXXXXXXXXXGOOAXXXXXXXXXXXXXXXXGOOOOOOOXXXXXXXXXXXX,0,0,0
5922,60,2,58,147,133,0,0,293,74,219,GOOXXXXXXXXXXXXXXXXXGOOOOOOXXXXXXXXXXXXXGOOOOOXXXXXXXXXXXXXXGOOOOXXXXXXXXXXXXXXXGOXXXXXXXXXXXXXXXXXXGOOOOXXXXXXXXXXXXXXXGOOXXXXXXXXXXXXXXXXXGOOOXXXXXXXXXXXXXXXXGOOOOOOXXXXXXXXXXXXXGXXXXXXXXXXXXXXXXXXXGOOOAXXXXXXXXXXXXXXXGOOAXXXXXXXXXXXXXXXXGOOOOOOOXXXXXXXXXXXX,0,0,0
5943,60,2,58,152,128,0,0,288,73,215,GOOXXXXXXXXXXXXXXXXXGOOOOOOXXXXXXXXXXXXXGOOOOOXXXXXXXXXXXXXXGOOOOXXXXXXXXXXXXXXXGOXXXXXXXXXXXXXXXXXXGOOOOXXXXXXXXXXXXXXXGOOXXXXXXXXXXXXXXXXXGOOOXXXXXXXXXXXXXXXXGOOOOOOXXXXXXXXXXXXXGXXXXXXXXXXXXXXXXXXXGOOOAXXXXXXXXXXXXXXXGOOAXXXXXXXXXXXXXXXXGOOOOOOOXXXXXXXXXXXX,0,0,0
5964,61,2,59,152,127,0,0,288,73,215,GOOXXXXXXXXXXXXXXXXXGOOOOOOXXXXXXXXXXXXXGOOOOOXXXXXXXXXXXXXXGOOOOXXXXXXXXXXXXXXXGOXXXXXXXXXXXXXXXXXXGOOOOXXXXXXXXXXXXXXXGOOXXXXXXXXXXXXXXXXXGOOOXXXXXXXXXXXXXXXXGOOOOOOXXXXXXXXXXXXXGXXXXXXXXXXXXXXXXXXXGOOOOAXXXXXXXXXXXXXXGOOAXXXXXXXXXXXXXXXXGOOOOOOOXXXXXXXXXXXX,0,0,0

5985,61,2,59,155,124,0,0,283,70,213,GOOXXXXXXXXXXXXXXXXXGOOOOOOXXXXXXXXXXXXXGOOOOOXXXXXXXXXXXXXXGOOOOXXXXXXXXXXXXXXXGOXXXXXXXXXXXXXXXXXXGOOOOXXXXXXXXXXXXXXXGOOXXXXXXXXXXXXXXXXXGOOOXXXXXXXXXXXXXXXXGOOOOOOXXXXXXXXXXXXXGXXXXXXXXXXXXXXXXXXXGOOOOAXXXXXXXXXXXXXXGOOAXXXXXXXXXXXXXXXXGOOOOOOOXXXXXXXXXXXX,0,0,0
6006,61,1,60,160,119,0,0,279,77,202,GOOXXXXXXXXXXXXXXXXXGOOOOOOXXXXXXXXXXXXXGOOOOOXXXXXXXXXXXXXXGOOOOXXXXXXXXXXXXXXXGOXXXXXXXXXXXXXXXXXXGOOOOXXXXXXXXXXXXXXXGOOXXXXXXXXXXXXXXXXXGOOOXXXXXXXXXXXXXXXXGOOOOOOXXXXXXXXXXXXXGXXXXXXXXXXXXXXXXXXXGOOOOAXXXXXXXXXXXXXXGOOOXXXXXXXXXXXXXXXXGOOOOOOOXXXXXXXXXXXX,0,0,0
6027,61,1,60,158,121,0,0,281,78,203,GOOXXXXXXXXXXXXXXXXXGOOOOOOXXXXXXXXXXXXXGOOOOOXXXXXXXXXXXXXXGOOOOXXXXXXXXXXXXXXXGOXXXXXXXXXXXXXXXXXXGOOOOXXXXXXXXXXXXXXXGOOXXXXXXXXXXXXXXXXXGOOOXXXXXXXXXXXXXXXXGOOOOOOXXXXXXXXXXXXXGXXXXXXXXXXXXXXXXXXXGOOOOAXXXXXXXXXXXXXXGOOOXXXXXXXXXXXXXXXXGOOOOOOOXXXXXXXXXXXX,0,0,0
6048,62,2,60,159,119,0,0,280,81,199,GOOXXXXXXXXXXXXXXXXXGOOOOOOXXXXXXXXXXXXXGOOOOOXXXXXXXXXXXXXXGOOOOXXXXXXXXXXXXXXXGOXXXXXXXXXXXXXXXXXXGOOOOAXXXXXXXXXXXXXXGOOXXXXXXXXXXXXXXXXXGOOOXXXXXXXXXXXXXXXXGOOOOOOXXXXXXXXXXXXXGXXXXXXXXXXXXXXXXXXXGOOOOAXXXXXXXXXXXXXXGOOOXXXXXXXXXXXXXXXXGOOOOOOOXXXXXXXXXXXX,0,0,0
6069,62,2,60,163,115,0,0,275,74,201,GOOXXXXXXXXXXXXXXXXXGOOOOOOXXXXXXXXXXXXXGOOOOOXXXXXXXXXXXXXXGOOOOXXXXXXXXXXXXXXXGOXXXXXXXXXXXXXXXXXXGOOOOAXXXXXXXXXXXXXXGOOXXXXXXXXXXXXXXXXXGOOOXXXXXXXXXXXXXXXXGOOOOOOXXXXXXXXXXXXXGXXXXXXXXXXXXXXXXXXXGOOOOAXXXXXXXXXXXXXXGOOOXXXXXXXXXXXXXXXXGOOOOOOOXXXXXXXXXXXX,0,0,0

6090,62,2,60,156,122,0,0,283,77,206,GOOXXXXXXXXXXXXXXXXXGOOOOOOXXXXXXXXXXXXXGOOOOOXXXXXXXXXXXXXXGOOOOXXXXXXXXXXXXXXXGOXXXXXXXXXXXXXXXXXXGOOOOAXXXXXXXXXXXXXXGOOXXXXXXXXXXXXXXXXXGOOOXXXXXXXXXXXXXXXXGOOOOOOXXXXXXXXXXXXXGXXXXXXXXXXXXXXXXXXXGOOOOAXXXXXXXXXXXXXXGOOOXXXXXXXXXXXXXXXXGOOOOOOOXXXXXXXXXXXX,0,0,0
6111,62,2,60,162,116,0,0,277,78,199,GOOXXXXXXXXXXXXXXXXXGOOOOOOXXXXXXXXXXXXXGOOOOOXXXXXXXXXXXXXXGOOOOXXXXXXXXXXXXXXXGOXXXXXXXXXXXXXXXXXXGOOOOAXXXXXXXXXXXXXXGOOXXXXXXXXXXXXXXXXXGOOOXXXXXXXXXXXXXXXXGOOOOOOXXXXXXXXXXXXXGXXXXXXXXXXXXXXXXXXXGOOOOAXXXXXXXXXXXXXXGOOOXXXXXXXXXXXXXXXXGOOOOOOOXXXXXXXXXXXX,0,0,0
6132,62,2,60,164,114,0,0,275,76,199,GOOXXXXXXXXXXXXXXXXXGOOOOOOXXXXXXXXXXXXXGOOOOOXXXXXXXXXXXXXXGOOOOXXXXXXXXXXXXXXXGOXXXXXXXXXXXXXXXXXXGOOOOAXXXXXXXXXXXXXXGOOXXXXXXXXXXXXXXXXXGOOOXXXXXXXXXXXXXXXXGOOOOOOXXXXXXXXXXXXXGXXXXXXXXXXXXXXXXXXXGOOOOAXXXXXXXXXXXXXXGOOOXXXXXXXXXXXXXXXXGOOOOOOOXXXXXXXXXXXX,0,0,0
6153,62,1,61,159,119,0,0,278,74,204,GOOXXXXXXXXXXXXXXXXXGOOOOOOXXXXXXXXXXXXXGOOOOOXXXXXXXXXXXXXXGOOOOXXXXXXXXXXXXXXXGOXXXXXXXXXXXXXXXXXXGOOOOOXXXXXXXXXXXXXXGOOXXXXXXXXXXXXXXXXXGOOOXXXXXXXXXXXXXXXXGOOOOOOXXXXXXXXXXXXXGXXXXXXXXXXXXXXXXXXXGOOOOAXXXXXXXXXXXXXXGOOOXXXXXXXXXXXXXXXXGOOOOOOOXXXXXXXXXXXX,0,0,0
6174,62,1,61,162,116,0,0,277,68,209,GOOXXXXXXXXXXXXXXXXXGOOOOOOXXXXXXXXXXXXXGOOOOOXXXXXXXXXXXXXXGOOOOXXXXXXXXXXXXXXXGOXXXXXXXXXXXXXXXXXXGOOOOOXXXXXXXXXXXXXXGOOXXXXXXXXXXXXXXXXXGOOOXXXXXXXXXXXXXXXXGOOOOOOXXXXXXXXXXXXXGXXXXXXXXXXXXXXXXXXXGOOOOAXXXXXXXXXXXXXXGOOOXXXXXXXXXXXXXXXXGOOOOOOOXXXXXXXXXXXX,0,0,0

6195,62,1,61,159,119,0,0,279,77,202,GOOXXXXXXXXXXXXXXXXXGOOOOOOXXXXXXXXXXXXXGOOOOOXXXXXXXXXXXXXXGOOOOXXXXXXXXXXXXXXXGOXXXXXXXXXXXXXXXXXXGOOOOOXXXXXXXXXXXXXXGOOXXXXXXXXXXXXXXXXXGOOOXXXXXXXXXXXXXXXXGOOOOOOXXXXXXXXXXXXXGXXXXXXXXXXXXXXXXXXXGOOOOAXXXXXXXXXXXXXXGOOOXXXXXXXXXXXXXXXXGOOOOOOOXXXXXXXXXXXX,0,0,0
6216,62,0,62,155,123,0,0,284,74,210,GOOXXXXXXXXXXXXXXXXXGOOOOOOXXXXXXXXXXXXXGOOOOOXXXXXXXXXXXXXXGOOOOXXXXXXXXXXXXXXXGOXXXXXXXXXXXXXXXXXXGOOOOOXXXXXXXXXXXXXXGOOXXXXXXXXXXXXXXXXXGOOOXXXXXXXXXXXXXXXXGOOOOOOXXXXXXXXXXXXXGXXXXXXXXXXXXXXXXXXXGOOOOOXXXXXXXXXXXXXXGOOOXXXXXXXXXXXXXXXXGOOOOOOOXXXXXXXXXXXX,0,0,0
6237,62,0,62,158,120,0,0,280,68,212,GOOXXXXXXXXXXXXXXXXXGOOOOOOXXXXXXXXXXXXXGOOOOOXXXXXXXXXXXXXXGOOOOXXXXXXXXXXXXXXXGOXXXXXXXXXXXXXXXXXXGOOOOOXXXXXXXXXXXXXXGOOXXXXXXXXXXXXXXXXXGOOOXXXXXXXXXXXXXXXXGOOOOOOXXXXXXXXXXXXXGXXXXXXXXXXXXXXXXXXXGOOOOOXXXXXXXXXXXXXXGOOOXXXXXXXXXXXXXXXXGOOOOOOOXXXXXXXXXXXX,0,0,0
6258,62,0,62,156,122,0,0,282,68,214,GOOXXXXXXXXXXXXXXXXXGOOOOOOXXXXXXXXXXXXXGOOOOOXXXXXXXXXXXXXXGOOOOXXXXXXXXXXXXXXXGOXXXXXXXXXXXXXXXXXXGOOOOOXXXXXXXXXXXXXXGOOXXXXXXXXXXXXXXXXXGOOOXXXXXXXXXXXXXXXXGOOOOOOXXXXXXXXXXXXXGXXXXXXXXXXXXXXXXXXXGOOOOOXXXXXXXXXXXXXXGOOOXXXXXXXXXXXXXXXXGOOOOOOOXXXXXXXXXXXX,0,0,0
6279,62,0,62,152,126,0,0,286,66,220,GOOXXXXXXXXXXXXXXXXXGOOOOOOXXXXXXXXXXXXXGOOOOOXXXXXXXXXXXXXXGOOOOXXXXXXXXXXXXXXXGOXXXXXXXXXXXXXXXXXXGOOOOOXXXXXXXXXXXXXXGOOXXXXXXXXXXXXXXXXXGOOOXXXXXXXXXXXXXXXXGOOOOOOXXXXXXXXXXXXXGXXXXXXXXXXXXXXXXXXXGOOOOOXXXXXXXXXXXXXXGOOOXXXXXXXXXXXXXXXXGOOOOOOOXXXXXXXXXXXX,0,0,0

6300,62,0,62,146,132,0,0,292,66,226,GOOXXXXXXXXXXXXXXXXXGOOOOOOXXXXXXXXXXXXXGOOOOOXXXXXXXXXXXXXXGOOOOXXXXXXXXXXXXXXXGOXXXXXXXXXXXXXXXXXXGOOOOOXXXXXXXXXXXXXXGOOXXXXXXXXXXXXXXXXXGOOOXXXXXXXXXXXXXXXXGOOOOOOXXXXXXXXXXXXXGXXXXXXXXXXXXXXXXXXXGOOOOOXXXXXXXXXXXXXXGOOOXXXXXXXXXXXXXXXXGOOOOOOOXXXXXXXXXXXX,0,0,0
6321,62,0,62,147,131,0,0,290,63,227,GOOXXXXXXXXXXXXXXXXXGOOOOOOXXXXXXXXXXXXXGOOOOOXXXXXXXXXXXXXXGOOOOXXXXXXXXXXXXXXXGOXXXXXXXXXXXXXXXXXXGOOOOOXXXXXXXXXXXXXXGOOXXXXXXXXXXXXXXXXXGOOOXXXXXXXXXXXXXXXXGOOOOOOXXXXXXXXXXXXXGXXXXXXXXXXXXXXXXXXXGOOOOOXXXXXXXXXXXXXXGOOOXXXXXXXXXXXXXXXXGOOOOOOOXXXXXXXXXXXX,0,0,0
6342,62,0,62,149,129,0,0,288,63,225,GOOXXXXXXXXXXXXXXXXXGOOOOOOXXXXXXXXXXXXXGOOOOOXXXXXXXXXXXXXXGOOOOXXXXXXXXXXXXXXXGOXXXXXXXXXXXXXXXXXXGOOOOOXXXXXXXXXXXXXXGOOXXXXXXXXXXXXXXXXXGOOOXXXXXXXXXXXXXXXXGOOOOOOXXXXXXXXXXXXXGXXXXXXXXXXXXXXXXXXXGOOOOOXXXXXXXXXXXXXXGOOOXXXXXXXXXXXXXXXXGOOOOOOOXXXXXXXXXXXX,0,0,0
6363,63,1,62,156,121,0,0,281,56,225,GOOXXXXXXXXXXXXXXXXXGOOOOOOXXXXXXXXXXXXXGOOOOOXXXXXXXXXXXXXXGOOOOXXXXXXXXXXXXXXXGOXXXXXXXXXXXXXXXXXXGOOOOOXXXXXXXXXXXXXXGOOXXXXXXXXXXXXXXXXXGOOOXXXXXXXXXXXXXXXXGOOOOOOXXXXXXXXXXXXXGXXXXXXXXXXXXXXXXXXXGOOOOOXXXXXXXXXXXXXXGOOOXXXXXXXXXXXXXXXXGOOOOOOOAXXXXXXXXXXX,0,0,0
6384,63,1,62,148,129,0,0,288,62,226,GOOXXXXXXXXXXXXXXXXXGOOOOOOXXXXXXXXXXXXXGOOOOOXXXXXXXXXXXXXXGOOOOXXXXXXXXXXXXXXXGOXXXXXXXXXXXXXXXXXXGOOOOOXXXXXXXXXXXXXXGOOXXXXXXXXXXXXXXXXXGOOOXXXXXXXXXXXXXXXXGOOOOOOXXXXXXXXXXXXXGXXXXXXXXXXXXXXXXXXXGOOOOOXXXXXXXXXXXXXXGOOOXXXXXXXXXXXXXXXXGOOOOOOOAXXXXXXXXXXX,0,0,0

6405,63,1,62,147,130,0,0,289,68,221,GOOXXXXXXXXXXXXXXXXXGOOOOOOXXXXXXXXXXXXXGOOOOOXXXXXXXXXXXXXXGOOOOXXXXXXXXXXXXXXXGOXXXXXXXXXXXXXXXXXXGOOOOOXXXXXXXXXXXXXXGOOXXXXXXXXXXXXXXXXXGOOOXXXXXXXXXXXXXXXXGOOOOOOXXXXXXXXXXXXXGXXXXXXXXXXXXXXXXXXXGOOOOOXXXXXXXXXXXXXXGOOOXXXXXXXXXXXXXXXXGOOOOOOOAXXXXXXXXXXX,0,0,0
6426,63,1,62,154,123,0,0,283,64,219,GOOXXXXXXXXXXXXXXXXXGOOOOOOXXXXXXXXXXXXXGOOOOOXXXXXXXXXXXXXXGOOOOXXXXXXXXXXXXXXXGOXXXXXXXXXXXXXXXXXXGOOOOOXXXXXXXXXXXXXXGOOXXXXXXXXXXXXXXXXXGOOOXXXXXXXXXXXXXXXXGOOOOOOXXXXXXXXXXXXXGXXXXXXXXXXXXXXXXXXXGOOOOOXXXXXXXXXXXXXXGOOOXXXXXXXXXXXXXXXXGOOOOOOOAXXXXXXXXXXX,0,0,0
6447,63,1,62,146,131,0,0,291,65,226,GOOXXXXXXXXXXXXXXXXXGOOOOOOXXXXXXXXXXXXXGOOOOOXXXXXXXXXXXXXXGOOOOXXXXXXXXXXXXXXXGOXXXXXXXXXXXXXXXXXXGOOOOOXXXXXXXXXXXXXXGOOXXXXXXXXXXXXXXXXXGOOOXXXXXXXXXXXXXXXXGOOOOOOXXXXXXXXXXXXXGXXXXXXXXXXXXXXXXXXXGOOOOOXXXXXXXXXXXXXXGOOOXXXXXXXXXXXXXXXXGOOOOOOOAXXXXXXXXXXX,0,0,0
6468,63,1,62,150,127,0,0,286,69,217,GOOXXXXXXXXXXXXXXXXXGOOOOOOXXXXXXXXXXXXXGOOOOOXXXXXXXXXXXXXXGOOOOXXXXXXXXXXXXXXXGOXXXXXXXXXXXXXXXXXXGOOOOOXXXXXXXXXXXXXXGOOXXXXXXXXXXXXXXXXXGOOOXXXXXXXXXXXXXXXXGOOOOOOXXXXXXXXXXXXXGXXXXXXXXXXXXXXXXXXXGOOOOOXXXXXXXXXXXXXXGOOOXXXXXXXXXXXXXXXXGOOOOOOOAXXXXXXXXXXX,0,0,0
6489,63,1,62,148,129,0,0,287,74,213,GOOXXXXXXXXXXXXXXXXXGOOOOOOXXXXXXXXXXXXXGOOOOOXXXXXXXXXXXXXXGOOOOXXXXXXXXXXXXXXXGOXXXXXXXXXXXXXXXXXXGOOOOOXXXXXXXXXXXXXXGOOXXXXXXXXXXXXXXXXXGOOOXXXXXXXXXXXXXXXXGOOOOOOXXXXXXXXXXXXXGXXXXXXXXXXXXXXXXXXXGOOOOOXXXXXXXXXXXXXXGOOOXXXXXXXXXXXXXXXXGOOOOOOOAXXXXXXXXXXX,0,0,0

6510,63,1,62,143,134,0,0,294,79,215,GOOXXXXXXXXXXXXXXXXXGOOOOOOXXXXXXXXXXXXXGOOOOOXXXXXXXXXXXXXXGOOOOXXXXXXXXXXXXXXXGOXXXXXXXXXXXXXXXXXXGOOOOOXXXXXXXXXXXXXXGOOXXXXXXXXXXXXXXXXXGOOOXXXXXXXXXXXXXXXXGOOOOOOXXXXXXXXXXXXXGXXXXXXXXXXXXXXXXXXXGOOOOOXXXXXXXXXXXXXXGOOOXXXXXXXXXXXXXXXXGOOOOOOOAXXXXXXXXXXX,0,0,0
6531,63,1,62,144,133,0,0,293,79,214,GOOXXXXXXXXXXXXXXXXXGOOOOOOXXXXXXXXXXXXXGOOOOOXXXXXXXXXXXXXXGOOOOXXXXXXXXXXXXXXXGOXXXXXXXXXXXXXXXXXXGOOOOOXXXXXXXXXXXXXXGOOXXXXXXXXXXXXXXXXXGOOOXXXXXXXXXXXXXXXXGOOOOOOXXXXXXXXXXXXXGXXXXXXXXXXXXXXXXXXXGOOOOOXXXXXXXXXXXXXXGOOOXXXXXXXXXXXXXXXXGOOOOOOOAXXXXXXXXXXX,0,0,0
6552,63,1,62,147,130,0,0,289,76,213,GOOXXXXXXXXXXXXXXXXXGOOOOOOXXXXXXXXXXXXXGOOOOOXXXXXXXXXXXXXXGOOOOXXXXXXXXXXXXXXXGOXXXXXXXXXXXXXXXXXXGOOOOOXXXXXXXXXXXXXXGOOXXXXXXXXXXXXXXXXXGOOOXXXXXXXXXXXXXXXXGOOOOOOXXXXXXXXXXXXXGXXXXXXXXXXXXXXXXXXXGOOOOOXXXXXXXXXXXXXXGOOOXXXXXXXXXXXXXXXXGOOOOOOOAXXXXXXXXXXX,0,0,0
6573,63,0,63,147,130,0,0,289,76,213,GOOXXXXXXXXXXXXXXXXXGOOOOOOXXXXXXXXXXXXXGOOOOOXXXXXXXXXXXXXXGOOOOXXXXXXXXXXXXXXXGOXXXXXXXXXXXXXXXXXXGOOOOOXXXXXXXXXXXXXXGOOXXXXXXXXXXXXXXXXXGOOOXXXXXXXXXXXXXXXXGOOOOOOXXXXXXXXXXXXXGXXXXXXXXXXXXXXXXXXXGOOOOOXXXXXXXXXXXXXXGOOOXXXXXXXXXXXXXXXXGOOOOOOOOXXXXXXXXXXX,0,0,0
6594,64,1,63,148,128,0,0,287,70,217,GOOXXXXXXXXXXXXXXXXXGOOOOOOXXXXXXXXXXXXXGOOOOOAXXXXXXXXXXXXXGOOOOXXXXXXXXXXXXXXXGOXXXXXXXXXXXXXXXXXXGOOOOOXXXXXXXXXXXXXXGOOXXXXXXXXXXXXXXXXXGOOOXXXXXXXXXXXXXXXXGOOOOOOXXXXXXXXXXXXXGXXXXXXXXXXXXXXXXXXXGOOOOOXXXXXXXXXXXXXXGOOOXXXXXXXXXXXXXXXXGOOOOOOOOXXXXXXXXXXX,0,0,0

6615,64,1,63,154,122,0,0,281,67,214,GOOXXXXXXXXXXXXXXXXXGOOOOOOXXXXXXXXXXXXXGOOOOOAXXXXXXXXXXXXXGOOOOXXXXXXXXXXXXXXXGOXXXXXXXXXXXXXXXXXXGOOOOOXXXXXXXXXXXXXXGOOXXXXXXXXXXXXXXXXXGOOOXXXXXXXXXXXXXXXXGOOOOOOXXXXXXXXXXXXXGXXXXXXXXXXXXXXXXXXXGOOOOOXXXXXXXXXXXXXXGOOOXXXXXXXXXXXXXXXXGOOOOOOOOXXXXXXXXXXX,0,0,0
6636,64,1,63,154,122,0,0,282,69,213,GOOXXXXXXXXXXXXXXXXXGOOOOOOXXXXXXXXXXXXXGOOOOOAXXXXXXXXXXXXXGOOOOXXXXXXXXXXXXXXXGOXXXXXXXXXXXXXXXXXXGOOOOOXXXXXXXXXXXXXXGOOXXXXXXXXXXXXXXXXXGOOOXXXXXXXXXXXXXXXXGOOOOOOXXXXXXXXXXXXXGXXXXXXXXXXXXXXXXXXXGOOOOOXXXXXXXXXXXXXXGOOOXXXXXXXXXXXXXXXXGOOOOOOOOXXXXXXXXXXX,0,0,0
6657,64,1,63,154,122,0,0,281,66,215,GOOXXXXXXXXXXXXXXXXXGOOOOOOXXXXXXXXXXXXXGOOOOOAXXXXXXXXXXXXXGOOOOXXXXXXXXXXXXXXXGOXXXXXXXXXXXXXXXXXXGOOOOOXXXXXXXXXXXXXXGOOXXXXXXXXXXXXXXXXXGOOOXXXXXXXXXXXXXXXXGOOOOOOXXXXXXXXXXXXXGXXXXXXXXXXXXXXXXXXXGOOOOOXXXXXXXXXXXXXXGOOOXXXXXXXXXXXXXXXXGOOOOOOOOXXXXXXXXXXX,0,0,0
6678,64,1,63,152,124,0,0,284,67,217,GOOXXXXXXXXXXXXXXXXXGOOOOOOXXXXXXXXXXXXXGOOOOOAXXXXXXXXXXXXXGOOOOXXXXXXXXXXXXXXXGOXXXXXXXXXXXXXXXXXXGOOOOOXXXXXXXXXXXXXXGOOXXXXXXXXXXXXXXXXXGOOOXXXXXXXXXXXXXXXXGOOOOOOXXXXXXXXXXXXXGXXXXXXXXXXXXXXXXXXXGOOOOOXXXXXXXXXXXXXXGOOOXXXXXXXXXXXXXXXXGOOOOOOOOXXXXXXXXXXX,0,0,0
6699,64,1,63,145,131,0,0,292,71,221,GOOXXXXXXXXXXXXXXXXXGOOOOOOXXXXXXXXXXXXXGOOOOOAXXXXXXXXXXXXXGOOOOXXXXXXXXXXXXXXXGOXXXXXXXXXXXXXXXXXXGOOOOOXXXXXXXXXXXXXXGOOXXXXXXXXXXXXXXXXXGOOOXXXXXXXXXXXXXXXXGOOOOOOXXXXXXXXXXXXXGXXXXXXXXXXXXXXXXXXXGOOOOOXXXXXXXXXXXXXXGOOOXXXXXXXXXXXXXXXXGOOOOOOOOXXXXXXXXXXX,0,0,0

6720,64,0,64,143,133,0,0,292,67,225,GOOXXXXXXXXXXXXXXXXXGOOOOOOXXXXXXXXXXXXXGOOOOOOXXXXXXXXXXXXXGOOOOXXXXXXXXXXXXXXXGOXXXXXXXXXXXXXXXXXXGOOOOOXXXXXXXXXXXXXXGOOXXXXXXXXXXXXXXXXXGOOOXXXXXXXXXXXXXXXXGOOOOOOXXXXXXXXXXXXXGXXXXXXXXXXXXXXXXXXXGOOOOOXXXXXXXXXXXXXXGOOOXXXXXXXXXXXXXXXXGOOOOOOOOXXXXXXXXXXX,0,0,0
6741,65,1,64,148,127,0,0,287,64,223,GOOXXXXXXXXXXXXXXXXXGOOOOOOXXXXXXXXXXXXXGOOOOOOXXXXXXXXXXXXXGOOOOXXXXXXXXXXXXXXXGOXXXXXXXXXXXXXXXXXXGOOOOOAXXXXXXXXXXXXXGOOXXXXXXXXXXXXXXXXXGOOOXXXXXXXXXXXXXXXXGOOOOOOXXXXXXXXXXXXXGXXXXXXXXXXXXXXXXXXXGOOOOOXXXXXXXXXXXXXXGOOOXXXXXXXXXXXXXXXXGOOOOOOOOXXXXXXXXXXX,0,0,0
6762,66,1,65,149,125,0,0,286,68,218,GOOXXXXXXXXXXXXXXXXXGOOOOOOXXXXXXXXXXXXXGOOOOOOXXXXXXXXXXXXXGOOOOXXXXXXXXXXXXXXXGOXXXXXXXXXXXXXXXXXXGOOOOOOAXXXXXXXXXXXXGOOXXXXXXXXXXXXXXXXXGOOOXXXXXXXXXXXXXXXXGOOOOOOXXXXXXXXXXXXXGXXXXXXXXXXXXXXXXXXXGOOOOOXXXXXXXXXXXXXXGOOOXXXXXXXXXXXXXXXXGOOOOOOOOXXXXXXXXXXX,0,0,0
6783,67,1,66,149,124,0,0,284,79,205,GOOXXXXXXXXXXXXXXXXXGOOOOOOXXXXXXXXXXXXXGOOOOOOXXXXXXXXXXXXXGOOOOXXXXXXXXXXXXXXXGOXXXXXXXXXXXXXXXXXXGOOOOOOAXXXXXXXXXXXXGOOXXXXXXXXXXXXXXXXXGOOOXXXXXXXXXXXXXXXXGOOOOOOXXXXXXXXXXXXXGXXXXXXXXXXXXXXXXXXXGOOOOOXXXXXXXXXXXXXXGOOOOXXXXXXXXXXXXXXXGOOOOOOOOXXXXXXXXXXX,0,0,0
6804,67,1,66,148,125,0,0,283,73,210,GOOXXXXXXXXXXXXXXXXXGOOOOOOXXXXXXXXXXXXXGOOOOOOXXXXXXXXXXXXXGOOOOXXXXXXXXXXXXXXXGOXXXXXXXXXXXXXXXXXXGOOOOOOAXXXXXXXXXXXXGOOXXXXXXXXXXXXXXXXXGOOOXXXXXXXXXXXXXXXXGOOOOOOXXXXXXXXXXXXXGXXXXXXXXXXXXXXXXXXXGOOOOOXXXXXXXXXXXXXXGOOOOXXXXXXXXXXXXXXXGOOOOOOOOXXXXXXXXXXX,0,0,0

6825,68,2,66,144,128,0,0,289,71,218,GOOXXXXXXXXXXXXXXXXXGOOOOOOXXXXXXXXXXXXXGOOOOOOXXXXXXXXXXXXXGOOOOXXXXXXXXXXXXXXXGOXXXXXXXXXXXXXXXXXXGOOOOOOAXXXXXXXXXXXXGOOXXXXXXXXXXXXXXXXXGOOOXXXXXXXXXXXXXXXXGOOOOOOXXXXXXXXXXXXXGAXXXXXXXXXXXXXXXXXXGOOOOOXXXXXXXXXXXXXXGOOOOXXXXXXXXXXXXXXXGOOOOOOOOXXXXXXXXXXX,0,0,0
6846,68,2,66,146,126,0,0,287,69,218,GOOXXXXXXXXXXXXXXXXXGOOOOOOXXXXXXXXXXXXXGOOOOOOXXXXXXXXXXXXXGOOOOXXXXXXXXXXXXXXXGOXXXXXXXXXXXXXXXXXXGOOOOOOAXXXXXXXXXXXXGOOXXXXXXXXXXXXXXXXXGOOOXXXXXXXXXXXXXXXXGOOOOOOXXXXXXXXXXXXXGAXXXXXXXXXXXXXXXXXXGOOOOOXXXXXXXXXXXXXXGOOOOXXXXXXXXXXXXXXXGOOOOOOOOXXXXXXXXXXX,0,0,0
6867,69,3,66,148,123,0,0,285,69,216,GOOXXXXXXXXXXXXXXXXXGOOOOOOXXXXXXXXXXXXXGOOOOOOXXXXXXXXXXXXXGOOOOXXXXXXXXXXXXXXXGOXXXXXXXXXXXXXXXXXXGOOOOOOAXXXXXXXXXXXXGOOAXXXXXXXXXXXXXXXXGOOOXXXXXXXXXXXXXXXXGOOOOOOXXXXXXXXXXXXXGAXXXXXXXXXXXXXXXXXXGOOOOOXXXXXXXXXXXXXXGOOOOXXXXXXXXXXXXXXXGOOOOOOOOXXXXXXXXXXX,0,0,0
6888,69,2,67,158,113,0,0,275,69,206,GOOXXXXXXXXXXXXXXXXXGOOOOOOXXXXXXXXXXXXXGOOOOOOXXXXXXXXXXXXXGOOOOXXXXXXXXXXXXXXXGOXXXXXXXXXXXXXXXXXXGOOOOOOAXXXXXXXXXXXXGOOAXXXXXXXXXXXXXXXXGOOOXXXXXXXXXXXXXXXXGOOOOOOXXXXXXXXXXXXXGOXXXXXXXXXXXXXXXXXXGOOOOOXXXXXXXXXXXXXXGOOOOXXXXXXXXXXXXXXXGOOOOOOOOXXXXXXXXXXX,0,0,0
6909,71,4,67,165,104,0,0,266,68,198,GOOXXXXXXXXXXXXXXXXXGOOOOOOXXXXXXXXXXXXXGOOOOOOXXXXXXXXXXXXXGOOOOXXXXXXXXXXXXXXXGOAAXXXXXXXXXXXXXXXXGOOOOOOAXXXXXXXXXXXXGOOAXXXXXXXXXXXXXXXXGOOOXXXXXXXXXXXXXXXXGOOOOOOXXXXXXXXXXXXXGOXXXXXXXXXXXXXXXXXXGOOOOOXXXXXXXXXXXXXXGOOOOXXXXXXXXXXXXXXXGOOOOOOOOXXXXXXXXXXX,0,0,0

6930,71,4,67,164,105,0,0,267,73,194,GOOXXXXXXXXXXXXXXXXXGOOOOOOXXXXXXXXXXXXXGOOOOOOXXXXXXXXXXXXXGOOOOXXXXXXXXXXXXXXXGOAAXXXXXXXXXXXXXXXXGOOOOOOAXXXXXXXXXXXXGOOAXXXXXXXXXXXXXXXXGOOOXXXXXXXXXXXXXXXXGOOOOOOXXXXXXXXXXXXXGOXXXXXXXXXXXXXXXXXXGOOOOOXXXXXXXXXXXXXXGOOOOXXXXXXXXXXXXXXXGOOOOOOOOXXXXXXXXXXX,0,0,0
6951,72,3,69,164,104,0,0,266,72,194,GOOXXXXXXXXXXXXXXXXXGOOOOOOXXXXXXXXXXXXXGOOOOOOXXXXXXXXXXXXXGOOOOXXXXXXXXXXXXXXXGOAAXXXXXXXXXXXXXXXXGOOOOOOOXXXXXXXXXXXXGOOAXXXXXXXXXXXXXXXXGOOOXXXXXXXXXXXXXXXXGOOOOOOXXXXXXXXXXXXXGOOXXXXXXXXXXXXXXXXXGOOOOOXXXXXXXXXXXXXXGOOOOXXXXXXXXXXXXXXXGOOOOOOOOXXXXXXXXXXX,0,0,0
6972,72,3,69,156,112,0,0,274,76,198,GOOXXXXXXXXXXXXXXXXXGOOOOOOXXXXXXXXXXXXXGOOOOOOXXXXXXXXXXXXXGOOOOXXXXXXXXXXXXXXXGOAAXXXXXXXXXXXXXXXXGOOOOOOOXXXXXXXXXXXXGOOAXXXXXXXXXXXXXXXXGOOOXXXXXXXXXXXXXXXXGOOOOOOXXXXXXXXXXXXXGOOXXXXXXXXXXXXXXXXXGOOOOOXXXXXXXXXXXXXXGOOOOXXXXXXXXXXXXXXXGOOOOOOOOXXXXXXXXXXX,0,0,0
6993,72,3,69,162,106,0,0,266,71,195,GOOXXXXXXXXXXXXXXXXXGOOOOOOXXXXXXXXXXXXXGOOOOOOXXXXXXXXXXXXXGOOOOXXXXXXXXXXXXXXXGOAAXXXXXXXXXXXXXXXXGOOOOOOOXXXXXXXXXXXXGOOAXXXXXXXXXXXXXXXXGOOOXXXXXXXXXXXXXXXXGOOOOOOXXXXXXXXXXXXXGOOXXXXXXXXXXXXXXXXXGOOOOOXXXXXXXXXXXXXXGOOOOXXXXXXXXXXXXXXXGOOOOOOOOXXXXXXXXXXX,0,0,0
7014,72,3,69,158,110,0,0,270,79,191,GOOXXXXXXXXXXXXXXXXXGOOOOOOXXXXXXXXXXXXXGOOOOOOXXXXXXXXXXXXXGOOOOXXXXXXXXXXXXXXXGOAAXXXXXXXXXXXXXXXXGOOOOOOOXXXXXXXXXXXXGOOAXXXXXXXXXXXXXXXXGOOOXXXXXXXXXXXXXXXXGOOOOOOXXXXXXXXXXXXXGOOXXXXXXXXXXXXXXXXXGOOOOOXXXXXXXXXXXXXXGOOOOXXXXXXXXXXXXXXXGOOOOOOOOXXXXXXXXXXX,0,0,0

7035,72,3,69,158,110,0,0,271,80,191,GOOXXXXXXXXXXXXXXXXXGOOOOOOXXXXXXXXXXXXXGOOOOOOXXXXXXXXXXXXXGOOOOXXXXXXXXXXXXXXXGOAAXXXXXXXXXXXXXXXXGOOOOOOOXXXXXXXXXXXXGOOAXXXXXXXXXXXXXXXXGOOOXXXXXXXXXXXXXXXXGOOOOOOXXXXXXXXXXXXXGOOXXXXXXXXXXXXXXXXXGOOOOOXXXXXXXXXXXXXXGOOOOXXXXXXXXXXXXXXXGOOOOOOOOXXXXXXXXXXX,0,0,0
7056,72,2,70,156,112,0,0,273,76,197,GOOXXXXXXXXXXXXXXXXXGOOOOOOXXXXXXXXXXXXXGOOOOOOXXXXXXXXXXXXXGOOOOXXXXXXXXXXXXXXXGOAAXXXXXXXXXXXXXXXXGOOOOOOOXXXXXXXXXXXXGOOOXXXXXXXXXXXXXXXXGOOOXXXXXXXXXXXXXXXXGOOOOOOXXXXXXXXXXXXXGOOXXXXXXXXXXXXXXXXXGOOOOOXXXXXXXXXXXXXXGOOOOXXXXXXXXXXXXXXXGOOOOOOOOXXXXXXXXXXX,0,0,0
7077,72,2,70,161,107,0,0,266,73,193,GOOXXXXXXXXXXXXXXXXXGOOOOOOXXXXXXXXXXXXXGOOOOOOXXXXXXXXXXXXXGOOOOXXXXXXXXXXXXXXXGOAAXXXXXXXXXXXXXXXXGOOOOOOOXXXXXXXXXXXXGOOOXXXXXXXXXXXXXXXXGOOOXXXXXXXXXXXXXXXXGOOOOOOXXXXXXXXXXXXXGOOXXXXXXXXXXXXXXXXXGOOOOOXXXXXXXXXXXXXXGOOOOXXXXXXXXXXXXXXXGOOOOOOOOXXXXXXXXXXX,0,0,0
7098,72,2,70,160,108,0,0,269,69,200,GOOXXXXXXXXXXXXXXXXXGOOOOOOXXXXXXXXXXXXXGOOOOOOXXXXXXXXXXXXXGOOOOXXXXXXXXXXXXXXXGOAAXXXXXXXXXXXXXXXXGOOOOOOOXXXXXXXXXXXXGOOOXXXXXXXXXXXXXXXXGOOOXXXXXXXXXXXXXXXXGOOOOOOXXXXXXXXXXXXXGOOXXXXXXXXXXXXXXXXXGOOOOOXXXXXXXXXXXXXXGOOOOXXXXXXXXXXXXXXXGOOOOOOOOXXXXXXXXXXX,0,0,0
7119,72,2,70,152,116,0,0,277,75,202,GOOXXXXXXXXXXXXXXXXXGOOOOOOXXXXXXXXXXXXXGOOOOOOXXXXXXXXXXXXXGOOOOXXXXXXXXXXXXXXXGOAAXXXXXXXXXXXXXXXXGOOOOOOOXXXXXXXXXXXXGOOOXXXXXXXXXXXXXXXXGOOOXXXXXXXXXXXXXXXXGOOOOOOXXXXXXXXXXXXXGOOXXXXXXXXXXXXXXXXXGOOOOOXXXXXXXXXXXXXXGOOOOXXXXXXXXXXXXXXXGOOOOOOOOXXXXXXXXXXX,0,0,0

7140,72,2,70,151,117,0,0,276,74,202,GOOXXXXXXXXXXXXXXXXXGOOOOOOXXXXXXXXXXXXXGOOOOOOXXXXXXXXXXXXXGOOOOXXXXXXXXXXXXXXXGOAAXXXXXXXXXXXXXXXXGOOOOOOOXXXXXXXXXXXXGOOOXXXXXXXXXXXXXXXXGOOOXXXXXXXXXXXXXXXXGOOOOOOXXXXXXXXXXXXXGOOXXXXXXXXXXXXXXXXXGOOOOOXXXXXXXXXXXXXXGOOOOXXXXXXXXXXXXXXXGOOOOOOOOXXXXXXXXXXX,0,0,0
7161,72,2,70,150,118,0,0,276,81,195,GOOXXXXXXXXXXXXXXXXXGOOOOOOXXXXXXXXXXXXXGOOOOOOXXXXXXXXXXXXXGOOOOXXXXXXXXXXXXXXXGOAAXXXXXXXXXXXXXXXXGOOOOOOOXXXXXXXXXXXXGOOOXXXXXXXXXXXXXXXXGOOOXXXXXXXXXXXXXXXXGOOOOOOXXXXXXXXXXXXXGOOXXXXXXXXXXXXXXXXXGOOOOOXXXXXXXXXXXXXXGOOOOXXXXXXXXXXXXXXXGOOOOOOOOXXXXXXXXXXX,0,0,0
7182,72,1,71,143,125,0,0,285,79,206,GOOXXXXXXXXXXXXXXXXXGOOOOOOXXXXXXXXXXXXXGOOOOOOXXXXXXXXXXXXXGOOOOXXXXXXXXXXXXXXXGOOAXXXXXXXXXXXXXXXXGOOOOOOOXXXXXXXXXXXXGOOOXXXXXXXXXXXXXXXXGOOOXXXXXXXXXXXXXXXXGOOOOOOXXXXXXXXXXXXXGOOXXXXXXXXXXXXXXXXXGOOOOOXXXXXXXXXXXXXXGOOOOXXXXXXXXXXXXXXXGOOOOOOOOXXXXXXXXXXX,0,0,0
7203,72,1,71,146,122,0,0,282,76,206,GOOXXXXXXXXXXXXXXXXXGOOOOOOXXXXXXXXXXXXXGOOOOOOXXXXXXXXXXXXXGOOOOXXXXXXXXXXXXXXXGOOAXXXXXXXXXXXXXXXXGOOOOOOOXXXXXXXXXXXXGOOOXXXXXXXXXXXXXXXXGOOOXXXXXXXXXXXXXXXXGOOOOOOXXXXXXXXXXXXXGOOXXXXXXXXXXXXXXXXXGOOOOOXXXXXXXXXXXXXXGOOOOXXXXXXXXXXXXXXXGOOOOOOOOXXXXXXXXXXX,0,0,0
7224,72,1,71,150,118,0,0,276,69,207,GOOXXXXXXXXXXXXXXXXXGOOOOOOXXXXXXXXXXXXXGOOOOOOXXXXXXXXXXXXXGOOOOXXXXXXXXXXXXXXXGOOAXXXXXXXXXXXXXXXXGOOOOOOOXXXXXXXXXXXXGOOOXXXXXXXXXXXXXXXXGOOOXXXXXXXXXXXXXXXXGOOOOOOXXXXXXXXXXXXXGOOXXXXXXXXXXXXXXXXXGOOOOOXXXXXXXXXXXXXXGOOOOXXXXXXXXXXXXXXXGOOOOOOOOXXXXXXXXXXX,0,0,0

7245,72,1,71,150,118,0,0,278,71,207,GOOXXXXXXXXXXXXXXXXXGOOOOOOXXXXXXXXXXXXXGOOOOOOXXXXXXXXXXXXXGOOOOXXXXXXXXXXXXXXXGOOAXXXXXXXXXXXXXXXXGOOOOOOOXXXXXXXXXXXXGOOOXXXXXXXXXXXXXXXXGOOOXXXXXXXXXXXXXXXXGOOOOOOXXXXXXXXXXXXXGOOXXXXXXXXXXXXXXXXXGOOOOOXXXXXXXXXXXXXXGOOOOXXXXXXXXXXXXXXXGOOOOOOOOXXXXXXXXXXX,0,0,0
7266,73,2,71,151,116,0,0,277,70,207,GOOXXXXXXXXXXXXXXXXXGOOOOOOXXXXXXXXXXXXXGOOOOOOXXXXXXXXXXXXXGOOOOXXXXXXXXXXXXXXXGOOAXXXXXXXXXXXXXXXXGOOOOOOOXXXXXXXXXXXXGOOOXXXXXXXXXXXXXXXXGOOOXXXXXXXXXXXXXXXXGOOOOOOAXXXXXXXXXXXXGOOXXXXXXXXXXXXXXXXXGOOOOOXXXXXXXXXXXXXXGOOOOXXXXXXXXXXXXXXXGOOOOOOOOXXXXXXXXXXX,0,0,0
7287,73,2,71,150,117,0,0,278,67,211,GOOXXXXXXXXXXXXXXXXXGOOOOOOXXXXXXXXXXXXXGOOOOOOXXXXXXXXXXXXXGOOOOXXXXXXXXXXXXXXXGOOAXXXXXXXXXXXXXXXXGOOOOOOOXXXXXXXXXXXXGOOOXXXXXXXXXXXXXXXXGOOOXXXXXXXXXXXXXXXXGOOOOOOAXXXXXXXXXXXXGOOXXXXXXXXXXXXXXXXXGOOOOOXXXXXXXXXXXXXXGOOOOXXXXXXXXXXXXXXXGOOOOOOOOXXXXXXXXXXX,0,0,0
7308,74,3,71,143,123,0,0,284,71,213,GOOXXXXXXXXXXXXXXXXXGOOOOOOAXXXXXXXXXXXXGOOOOOOXXXXXXXXXXXXXGOOOOXXXXXXXXXXXXXXXGOOAXXXXXXXXXXXXXXXXGOOOOOOOXXXXXXXXXXXXGOOOXXXXXXXXXXXXXXXXGOOOXXXXXXXXXXXXXXXXGOOOOOOAXXXXXXXXXXXXGOOXXXXXXXXXXXXXXXXXGOOOOOXXXXXXXXXXXXXXGOOOOXXXXXXXXXXXXXXXGOOOOOOOOXXXXXXXXXXX,0,0,0
7329,75,4,71,145,120,0,0,280,68,212,GOOXXXXXXXXXXXXXXXXXGOOOOOOAXXXXXXXXXXXXGOOOOOOXXXXXXXXXXXXXGOOOOXXXXXXXXXXXXXXXGOOAXXXXXXXXXXXXXXXXGOOOOOOOAXXXXXXXXXXXGOOOXXXXXXXXXXXXXXXXGOOOXXXXXXXXXXXXXXXXGOOOOOOAXXXXXXXXXXXXGOOXXXXXXXXXXXXXXXXXGOOOOOXXXXXXXXXXXXXXGOOOOXXXXXXXXXXXXXXXGOOOOOOOOXXXXXXXXXXX,0,0,0

7350,75,3,72,152,113,0,0,274,65,209,GOOXXXXXXXXXXXXXXXXXGOOOOOOAXXXXXXXXXXXXGOOOOOOXXXXXXXXXXXXXGOOOOXXXXXXXXXXXXXXXGOOOXXXXXXXXXXXXXXXXGOOOOOOOAXXXXXXXXXXXGOOOXXXXXXXXXXXXXXXXGOOOXXXXXXXXXXXXXXXXGOOOOOOAXXXXXXXXXXXXGOOXXXXXXXXXXXXXXXXXGOOOOOXXXXXXXXXXXXXXGOOOOXXXXXXXXXXXXXXXGOOOOOOOOXXXXXXXXXXX,0,0,0
7371,75,3,72,148,117,0,0,278,65,213,GOOXXXXXXXXXXXXXXXXXGOOOOOOAXXXXXXXXXXXXGOOOOOOXXXXXXXXXXXXXGOOOOXXXXXXXXXXXXXXXGOOOXXXXXXXXXXXXXXXXGOOOOOOOAXXXXXXXXXXXGOOOXXXXXXXXXXXXXXXXGOOOXXXXXXXXXXXXXXXXGOOOOOOAXXXXXXXXXXXXGOOXXXXXXXXXXXXXXXXXGOOOOOXXXXXXXXXXXXXXGOOOOXXXXXXXXXXXXXXXGOOOOOOOOXXXXXXXXXXX,0,0,0
7392,75,2,73,147,118,0,0,279,65,214,GOOXXXXXXXXXXXXXXXXXGOOOOOOOXXXXXXXXXXXXGOOOOOOXXXXXXXXXXXXXGOOOOXXXXXXXXXXXXXXXGOOOXXXXXXXXXXXXXXXXGOOOOOOOAXXXXXXXXXXXGOOOXXXXXXXXXXXXXXXXGOOOXXXXXXXXXXXXXXXXGOOOOOOAXXXXXXXXXXXXGOOXXXXXXXXXXXXXXXXXGOOOOOXXXXXXXXXXXXXXGOOOOXXXXXXXXXXXXXXXGOOOOOOOOXXXXXXXXXXX,0,0,0
7413,75,2,73,145,120,0,0,280,70,210,GOOXXXXXXXXXXXXXXXXXGOOOOOOOXXXXXXXXXXXXGOOOOOOXXXXXXXXXXXXXGOOOOXXXXXXXXXXXXXXXGOOOXXXXXXXXXXXXXXXXGOOOOOOOAXXXXXXXXXXXGOOOXXXXXXXXXXXXXXXXGOOOXXXXXXXXXXXXXXXXGOOOOOOAXXXXXXXXXXXXGOOXXXXXXXXXXXXXXXXXGOOOOOXXXXXXXXXXXXXXGOOOOXXXXXXXXXXXXXXXGOOOOOOOOXXXXXXXXXXX,0,0,0
7434,75,2,73,142,123,0,0,285,75,210,GOOXXXXXXXXXXXXXXXXXGOOOOOOOXXXXXXXXXXXXGOOOOOOXXXXXXXXXXXXXGOOOOXXXXXXXXXXXXXXXGOOOXXXXXXXXXXXXXXXXGOOOOOOOAXXXXXXXXXXXGOOOXXXXXXXXXXXXXXXXGOOOXXXXXXXXXXXXXXXXGOOOOOOAXXXXXXXXXXXXGOOXXXXXXXXXXXXXXXXXGOOOOOXXXXXXXXXXXXXXGOOOOXXXXXXXXXXXXXXXGOOOOOOOOXXXXXXXXXXX,0,0,0

7455,76,3,73,140,124,0,0,285,69,216,GOOXXXXXXXXXXXXXXXXXGOOOOOOOXXXXXXXXXXXXGOOOOOOXXXXXXXXXXXXXGOOOOXXXXXXXXXXXXXXXGOOOXXXXXXXXXXXXXXXXGOOOOOOOAXXXXXXXXXXXGOOOXXXXXXXXXXXXXXXXGOOOAXXXXXXXXXXXXXXXGOOOOOOAXXXXXXXXXXXXGOOXXXXXXXXXXXXXXXXXGOOOOOXXXXXXXXXXXXXXGOOOOXXXXXXXXXXXXXXXGOOOOOOOOXXXXXXXXXXX,0,0,0
7476,76,3,73,144,120,0,0,281,67,214,GOOXXXXXXXXXXXXXXXXXGOOOOOOOXXXXXXXXXXXXGOOOOOOXXXXXXXXXXXXXGOOOOXXXXXXXXXXXXXXXGOOOXXXXXXXXXXXXXXXXGOOOOOOOAXXXXXXXXXXXGOOOXXXXXXXXXXXXXXXXGOOOAXXXXXXXXXXXXXXXGOOOOOOAXXXXXXXXXXXXGOOXXXXXXXXXXXXXXXXXGOOOOOXXXXXXXXXXXXXXGOOOOXXXXXXXXXXXXXXXGOOOOOOOOXXXXXXXXXXX,0,0,0
7497,76,3,73,143,121,0,0,281,74,207,GOOXXXXXXXXXXXXXXXXXGOOOOOOOXXXXXXXXXXXXGOOOOOOXXXXXXXXXXXXXGOOOOXXXXXXXXXXXXXXXGOOOXXXXXXXXXXXXXXXXGOOOOOOOAXXXXXXXXXXXGOOOXXXXXXXXXXXXXXXXGOOOAXXXXXXXXXXXXXXXGOOOOOOAXXXXXXXXXXXXGOOXXXXXXXXXXXXXXXXXGOOOOOXXXXXXXXXXXXXXGOOOOXXXXXXXXXXXXXXXGOOOOOOOOXXXXXXXXXXX,0,0,0
7518,76,3,73,135,129,0,0,289,73,216,GOOXXXXXXXXXXXXXXXXXGOOOOOOOXXXXXXXXXXXXGOOOOOOXXXXXXXXXXXXXGOOOOXXXXXXXXXXXXXXXGOOOXXXXXXXXXXXXXXXXGOOOOOOOAXXXXXXXXXXXGOOOXXXXXXXXXXXXXXXXGOOOAXXXXXXXXXXXXXXXGOOOOOOAXXXXXXXXXXXXGOOXXXXXXXXXXXXXXXXXGOOOOOXXXXXXXXXXXXXXGOOOOXXXXXXXXXXXXXXXGOOOOOOOOXXXXXXXXXXX,0,0,0
7539,76,2,74,137,127,0,0,288,74,214,GOOXXXXXXXXXXXXXXXXXGOOOOOOOXXXXXXXXXXXXGOOOOOOXXXXXXXXXXXXXGOOOOXXXXXXXXXXXXXXXGOOOXXXXXXXXXXXXXXXXGOOOOOOOAXXXXXXXXXXXGOOOXXXXXXXXXXXXXXXXGOOOAXXXXXXXXXXXXXXXGOOOOOOOXXXXXXXXXXXXGOOXXXXXXXXXXXXXXXXXGOOOOOXXXXXXXXXXXXXXGOOOOXXXXXXXXXXXXXXXGOOOOOOOOXXXXXXXXXXX,0,0,0

7560,76,2,74,141,123,0,0,284,69,215,GOOXXXXXXXXXXXXXXXXXGOOOOOOOXXXXXXXXXXXXGOOOOOOXXXXXXXXXXXXXGOOOOXXXXXXXXXXXXXXXGOOOXXXXXXXXXXXXXXXXGOOOOOOOAXXXXXXXXXXXGOOOXXXXXXXXXXXXXXXXGOOOAXXXXXXXXXXXXXXXGOOOOOOOXXXXXXXXXXXXGOOXXXXXXXXXXXXXXXXXGOOOOOXXXXXXXXXXXXXXGOOOOXXXXXXXXXXXXXXXGOOOOOOOOXXXXXXXXXXX,0,0,0
7581,76,2,74,144,120,0,0,279,68,211,GOOXXXXXXXXXXXXXXXXXGOOOOOOOXXXXXXXXXXXXGOOOOOOXXXXXXXXXXXXXGOOOOXXXXXXXXXXXXXXXGOOOXXXXXXXXXXXXXXXXGOOOOOOOAXXXXXXXXXXXGOOOXXXXXXXXXXXXXXXXGOOOAXXXXXXXXXXXXXXXGOOOOOOOXXXXXXXXXXXXGOOXXXXXXXXXXXXXXXXXGOOOOOXXXXXXXXXXXXXXGOOOOXXXXXXXXXXXXXXXGOOOOOOOOXXXXXXXXXXX,0,0,0
7602,76,2,74,143,121,0,0,282,72,210,GOOXXXXXXXXXXXXXXXXXGOOOOOOOXXXXXXXXXXXXGOOOOOOXXXXXXXXXXXXXGOOOOXXXXXXXXXXXXXXXGOOOXXXXXXXXXXXXXXXXGOOOOOOOAXXXXXXXXXXXGOOOXXXXXXXXXXXXXXXXGOOOAXXXXXXXXXXXXXXXGOOOOOOOXXXXXXXXXXXXGOOXXXXXXXXXXXXXXXXXGOOOOOXXXXXXXXXXXXXXGOOOOXXXXXXXXXXXXXXXGOOOOOOOOXXXXXXXXXXX,0,0,0
7623,76,2,74,142,122,0,0,282,72,210,GOOXXXXXXXXXXXXXXXXXGOOOOOOOXXXXXXXXXXXXGOOOOOOXXXXXXXXXXXXXGOOOOXXXXXXXXXXXXXXXGOOOXXXXXXXXXXXXXXXXGOOOOOOOAXXXXXXXXXXXGOOOXXXXXXXXXXXXXXXXGOOOAXXXXXXXXXXXXXXXGOOOOOOOXXXXXXXXXXXXGOOXXXXXXXXXXXXXXXXXGOOOOOXXXXXXXXXXXXXXGOOOOXXXXXXXXXXXXXXXGOOOOOOOOXXXXXXXXXXX,0,0,0
7644,76,0,76,138,126,0,0,286,82,204,GOOXXXXXXXXXXXXXXXXXGOOOOOOOXXXXXXXXXXXXGOOOOOOXXXXXXXXXXXXXGOOOOXXXXXXXXXXXXXXXGOOOXXXXXXXXXXXXXXXXGOOOOOOOOXXXXXXXXXXXGOOOXXXXXXXXXXXXXXXXGOOOOXXXXXXXXXXXXXXXGOOOOOOOXXXXXXXXXXXXGOOXXXXXXXXXXXXXXXXXGOOOOOXXXXXXXXXXXXXXGOOOOXXXXXXXXXXXXXXXGOOOOOOOOXXXXXXXXXXX,0,0,0

7665,76,0,76,144,120,0,0,280,85,195,GOOXXXXXXXXXXXXXXXXXGOOOOOOOXXXXXXXXXXXXGOOOOOOXXXXXXXXXXXXXGOOOOXXXXXXXXXXXXXXXGOOOXXXXXXXXXXXXXXXXGOOOOOOOOXXXXXXXXXXXGOOOXXXXXXXXXXXXXXXXGOOOOXXXXXXXXXXXXXXXGOOOOOOOXXXXXXXXXXXXGOOXXXXXXXXXXXXXXXXXGOOOOOXXXXXXXXXXXXXXGOOOOXXXXXXXXXXXXXXXGOOOOOOOOXXXXXXXXXXX,0,0,0
7686,76,0,76,149,115,0,0,275,80,195,GOOXXXXXXXXXXXXXXXXXGOOOOOOOXXXXXXXXXXXXGOOOOOOXXXXXXXXXXXXXGOOOOXXXXXXXXXXXXXXXGOOOXXXXXXXXXXXXXXXXGOOOOOOOOXXXXXXXXXXXGOOOXXXXXXXXXXXXXXXXGOOOOXXXXXXXXXXXXXXXGOOOOOOOXXXXXXXXXXXXGOOXXXXXXXXXXXXXXXXXGOOOOOXXXXXXXXXXXXXXGOOOOXXXXXXXXXXXXXXXGOOOOOOOOXXXXXXXXXXX,0,0,0
7707,76,0,76,145,119,0,0,276,81,195,GOOXXXXXXXXXXXXXXXXXGOOOOOOOXXXXXXXXXXXXGOOOOOOXXXXXXXXXXXXXGOOOOXXXXXXXXXXXXXXXGOOOXXXXXXXXXXXXXXXXGOOOOOOOOXXXXXXXXXXXGOOOXXXXXXXXXXXXXXXXGOOOOXXXXXXXXXXXXXXXGOOOOOOOXXXXXXXXXXXXGOOXXXXXXXXXXXXXXXXXGOOOOOXXXXXXXXXXXXXXGOOOOXXXXXXXXXXXXXXXGOOOOOOOOXXXXXXXXXXX,0,0,0
7728,76,0,76,142,122,0,0,280,88,192,GOOXXXXXXXXXXXXXXXXXGOOOOOOOXXXXXXXXXXXXGOOOOOOXXXXXXXXXXXXXGOOOOXXXXXXXXXXXXXXXGOOOXXXXXXXXXXXXXXXXGOOOOOOOOXXXXXXXXXXXGOOOXXXXXXXXXXXXXXXXGOOOOXXXXXXXXXXXXXXXGOOOOOOOXXXXXXXXXXXXGOOXXXXXXXXXXXXXXXXXGOOOOOXXXXXXXXXXXXXXGOOOOXXXXXXXXXXXXXXXGOOOOOOOOXXXXXXXXXXX,0,0,0
7749,76,0,76,145,119,0,0,276,83,193,GOOXXXXXXXXXXXXXXXXXGOOOOOOOXXXXXXXXXXXXGOOOOOOXXXXXXXXXXXXXGOOOOXXXXXXXXXXXXXXXGOOOXXXXXXXXXXXXXXXXGOOOOOOOOXXXXXXXXXXXGOOOXXXXXXXXXXXXXXXXGOOOOXXXXXXXXXXXXXXXGOOOOOOOXXXXXXXXXXXXGOOXXXXXXXXXXXXXXXXXGOOOOOXXXXXXXXXXXXXXGOOOOXXXXXXXXXXXXXXXGOOOOOOOOXXXXXXXXXXX,0,0,0

7770,76,0,76,139,125,0,0,285,80,205,GOOXXXXXXXXXXXXXXXXXGOOOOOOOXXXXXXXXXXXXGOOOOOOXXXXXXXXXXXXXGOOOOXXXXXXXXXXXXXXXGOOOXXXXXXXXXXXXXXXXGOOOOOOOOXXXXXXXXXXXGOOOXXXXXXXXXXXXXXXXGOOOOXXXXXXXXXXXXXXXGOOOOOOOXXXXXXXXXXXXGOOXXXXXXXXXXXXXXXXXGOOOOOXXXXXXXXXXXXXXGOOOOXXXXXXXXXXXXXXXGOOOOOOOOXXXXXXXXXXX,0,0,0
7791,77,1,76,142,121,0,0,283,77,206,GOOXXXXXXXXXXXXXXXXXGOOOOOOOXXXXXXXXXXXXGOOOOOOXXXXXXXXXXXXXGOOOOXXXXXXXXXXXXXXXGOOOXXXXXXXXXXXXXXXXGOOOOOOOOXXXXXXXXXXXGOOOXXXXXXXXXXXXXXXXGOOOOXXXXXXXXXXXXXXXGOOOOOOOXXXXXXXXXXXXGOOXXXXXXXXXXXXXXXXXGOOOOOXXXXXXXXXXXXXXGOOOOXXXXXXXXXXXXXXXGOOOOOOOOAXXXXXXXXXX,0,0,0
7812,77,1,76,144,119,0,0,282,75,207,GOOXXXXXXXXXXXXXXXXXGOOOOOOOXXXXXXXXXXXXGOOOOOOXXXXXXXXXXXXXGOOOOXXXXXXXXXXXXXXXGOOOXXXXXXXXXXXXXXXXGOOOOOOOOXXXXXXXXXXXGOOOXXXXXXXXXXXXXXXXGOOOOXXXXXXXXXXXXXXXGOOOOOOOXXXXXXXXXXXXGOOXXXXXXXXXXXXXXXXXGOOOOOXXXXXXXXXXXXXXGOOOOXXXXXXXXXXXXXXXGOOOOOOOOAXXXXXXXXXX,0,0,0
7833,77,0,77,142,121,0,0,281,79,202,GOOXXXXXXXXXXXXXXXXXGOOOOOOOXXXXXXXXXXXXGOOOOOOXXXXXXXXXXXXXGOOOOXXXXXXXXXXXXXXXGOOOXXXXXXXXXXXXXXXXGOOOOOOOOXXXXXXXXXXXGOOOXXXXXXXXXXXXXXXXGOOOOXXXXXXXXXXXXXXXGOOOOOOOXXXXXXXXXXXXGOOXXXXXXXXXXXXXXXXXGOOOOOXXXXXXXXXXXXXXGOOOOXXXXXXXXXXXXXXXGOOOOOOOOOXXXXXXXXXX,0,0,0
7854,77,0,77,138,125,0,0,288,78,210,GOOXXXXXXXXXXXXXXXXXGOOOOOOOXXXXXXXXXXXXGOOOOOOXXXXXXXXXXXXXGOOOOXXXXXXXXXXXXXXXGOOOXXXXXXXXXXXXXXXXGOOOOOOOOXXXXXXXXXXXGOOOXXXXXXXXXXXXXXXXGOOOOXXXXXXXXXXXXXXXGOOOOOOOXXXXXXXXXXXXGOOXXXXXXXXXXXXXXXXXGOOOOOXXXXXXXXXXXXXXGOOOOXXXXXXXXXXXXXXXGOOOOOOOOOXXXXXXXXXX,0,0,0

7875,77,0,77,138,125,0,0,287,73,214,GOOXXXXXXXXXXXXXXXXXGOOOOOOOXXXXXXXXXXXXGOOOOOOXXXXXXXXXXXXXGOOOOXXXXXXXXXXXXXXXGOOOXXXXXXXXXXXXXXXXGOOOOOOOOXXXXXXXXXXXGOOOXXXXXXXXXXXXXXXXGOOOOXXXXXXXXXXXXXXXGOOOOOOOXXXXXXXXXXXXGOOXXXXXXXXXXXXXXXXXGOOOOOXXXXXXXXXXXXXXGOOOOXXXXXXXXXXXXXXXGOOOOOOOOOXXXXXXXXXX,0,0,0
7896,77,0,77,139,124,0,0,286,76,210,GOOXXXXXXXXXXXXXXXXXGOOOOOOOXXXXXXXXXXXXGOOOOOOXXXXXXXXXXXXXGOOOOXXXXXXXXXXXXXXXGOOOXXXXXXXXXXXXXXXXGOOOOOOOOXXXXXXXXXXXGOOOXXXXXXXXXXXXXXXXGOOOOXXXXXXXXXXXXXXXGOOOOOOOXXXXXXXXXXXXGOOXXXXXXXXXXXXXXXXXGOOOOOXXXXXXXXXXXXXXGOOOOXXXXXXXXXXXXXXXGOOOOOOOOOXXXXXXXXXX,0,0,0
7917,77,0,77,135,128,0,0,289,77,212,GOOXXXXXXXXXXXXXXXXXGOOOOOOOXXXXXXXXXXXXGOOOOOOXXXXXXXXXXXXXGOOOOXXXXXXXXXXXXXXXGOOOXXXXXXXXXXXXXXXXGOOOOOOOOXXXXXXXXXXXGOOOXXXXXXXXXXXXXXXXGOOOOXXXXXXXXXXXXXXXGOOOOOOOXXXXXXXXXXXXGOOXXXXXXXXXXXXXXXXXGOOOOOXXXXXXXXXXXXXXGOOOOXXXXXXXXXXXXXXXGOOOOOOOOOXXXXXXXXXX,0,0,0
7938,77,0,77,138,125,0,0,287,73,214,GOOXXXXXXXXXXXXXXXXXGOOOOOOOXXXXXXXXXXXXGOOOOOOXXXXXXXXXXXXXGOOOOXXXXXXXXXXXXXXXGOOOXXXXXXXXXXXXXXXXGOOOOOOOOXXXXXXXXXXXGOOOXXXXXXXXXXXXXXXXGOOOOXXXXXXXXXXXXXXXGOOOOOOOXXXXXXXXXXXXGOOXXXXXXXXXXXXXXXXXGOOOOOXXXXXXXXXXXXXXGOOOOXXXXXXXXXXXXXXXGOOOOOOOOOXXXXXXXXXX,0,0,0
7959,77,0,77,141,122,0,0,282,67,215,GOOXXXXXXXXXXXXXXXXXGOOOOOOOXXXXXXXXXXXXGOOOOOOXXXXXXXXXXXXXGOOOOXXXXXXXXXXXXXXXGOOOXXXXXXXXXXXXXXXXGOOOOOOOOXXXXXXXXXXXGOOOXXXXXXXXXXXXXXXXGOOOOXXXXXXXXXXXXXXXGOOOOOOOXXXXXXXXXXXXGOOXXXXXXXXXXXXXXXXXGOOOOOXXXXXXXXXXXXXXGOOOOXXXXXXXXXXXXXXXGOOOOOOOOOXXXXXXXXXX,0,0,0

7980,77,0,77,142,121,0,0,282,70,212,GOOXXXXXXXXXXXXXXXXXGOOOOOOOXXXXXXXXXXXXGOOOOOOXXXXXXXXXXXXXGOOOOXXXXXXXXXXXXXXXGOOOXXXXXXXXXXXXXXXXGOOOOOOOOXXXXXXXXXXXGOOOXXXXXXXXXXXXXXXXGOOOOXXXXXXXXXXXXXXXGOOOOOOOXXXXXXXXXXXXGOOXXXXXXXXXXXXXXXXXGOOOOOXXXXXXXXXXXXXXGOOOOXXXXXXXXXXXXXXXGOOOOOOOOOXXXXXXXXXX,0,0,0
8001,77,0,77,144,119,0,0,279,78,201,GOOXXXXXXXXXXXXXXXXXGOOOOOOOXXXXXXXXXXXXGOOOOOOXXXXXXXXXXXXXGOOOOXXXXXXXXXXXXXXXGOOOXXXXXXXXXXXXXXXXGOOOOOOOOXXXXXXXXXXXGOOOXXXXXXXXXXXXXXXXGOOOOXXXXXXXXXXXXXXXGOOOOOOOXXXXXXXXXXXXGOOXXXXXXXXXXXXXXXXXGOOOOOXXXXXXXXXXXXXXGOOOOXXXXXXXXXXXXXXXGOOOOOOOOOXXXXXXXXXX,0,0,0
8022,77,0,77,134,129,0,0,288,78,210,GOOXXXXXXXXXXXXXXXXXGOOOOOOOXXXXXXXXXXXXGOOOOOOXXXXXXXXXXXXXGOOOOXXXXXXXXXXXXXXXGOOOXXXXXXXXXXXXXXXXGOOOOOOOOXXXXXXXXXXXGOOOXXXXXXXXXXXXXXXXGOOOOXXXXXXXXXXXXXXXGOOOOOOOXXXXXXXXXXXXGOOXXXXXXXXXXXXXXXXXGOOOOOXXXXXXXXXXXXXXGOOOOXXXXXXXXXXXXXXXGOOOOOOOOOXXXXXXXXXX,0,0,0
8043,77,0,77,134,129,0,0,289,80,209,GOOXXXXXXXXXXXXXXXXXGOOOOOOOXXXXXXXXXXXXGOOOOOOXXXXXXXXXXXXXGOOOOXXXXXXXXXXXXXXXGOOOXXXXXXXXXXXXXXXXGOOOOOOOOXXXXXXXXXXXGOOOXXXXXXXXXXXXXXXXGOOOOXXXXXXXXXXXXXXXGOOOOOOOXXXXXXXXXXXXGOOXXXXXXXXXXXXXXXXXGOOOOOXXXXXXXXXXXXXXGOOOOXXXXXXXXXXXXXXXGOOOOOOOOOXXXXXXXXXX,0,0,0
8064,77,0,77,144,119,0,0,279,74,205,GOOXXXXXXXXXXXXXXXXXGOOOOOOOXXXXXXXXXXXXGOOOOOOXXXXXXXXXXXXXGOOOOXXXXXXXXXXXXXXXGOOOXXXXXXXXXXXXXXXXGOOOOOOOOXXXXXXXXXXXGOOOXXXXXXXXXXXXXXXXGOOOOXXXXXXXXXXXXXXXGOOOOOOOXXXXXXXXXXXXGOOXXXXXXXXXXXXXXXXXGOOOOOXXXXXXXXXXXXXXGOOOOXXXXXXXXXXXXXXXGOOOOOOOOOXXXXXXXXXX,0,0,0

8085,77,0,77,142,121,0,0,280,73,207,GOOXXXXXXXXXXXXXXXXXGOOOOOOOXXXXXXXXXXXXGOOOOOOXXXXXXXXXXXXXGOOOOXXXXXXXXXXXXXXXGOOOXXXXXXXXXXXXXXXXGOOOOOOOOXXXXXXXXXXXGOOOXXXXXXXXXXXXXXXXGOOOOXXXXXXXXXXXXXXXGOOOOOOOXXXXXXXXXXXXGOOXXXXXXXXXXXXXXXXXGOOOOOXXXXXXXXXXXXXXGOOOOXXXXXXXXXXXXXXXGOOOOOOOOOXXXXXXXXXX,0,0,0
8106,77,0,77,142,121,0,0,281,78,203,GOOXXXXXXXXXXXXXXXXXGOOOOOOOXXXXXXXXXXXXGOOOOOOXXXXXXXXXXXXXGOOOOXXXXXXXXXXXXXXXGOOOXXXXXXXXXXXXXXXXGOOOOOOOOXXXXXXXXXXXGOOOXXXXXXXXXXXXXXXXGOOOOXXXXXXXXXXXXXXXGOOOOOOOXXXXXXXXXXXXGOOXXXXXXXXXXXXXXXXXGOOOOOXXXXXXXXXXXXXXGOOOOXXXXXXXXXXXXXXXGOOOOOOOOOXXXXXXXXXX,0,0,0
8127,77,0,77,144,119,0,0,279,84,195,GOOXXXXXXXXXXXXXXXXXGOOOOOOOXXXXXXXXXXXXGOOOOOOXXXXXXXXXXXXXGOOOOXXXXXXXXXXXXXXXGOOOXXXXXXXXXXXXXXXXGOOOOOOOOXXXXXXXXXXXGOOOXXXXXXXXXXXXXXXXGOOOOXXXXXXXXXXXXXXXGOOOOOOOXXXXXXXXXXXXGOOXXXXXXXXXXXXXXXXXGOOOOOXXXXXXXXXXXXXXGOOOOXXXXXXXXXXXXXXXGOOOOOOOOOXXXXXXXXXX,0,0,0
8148,77,0,77,147,116,0,0,276,95,181,GOOXXXXXXXXXXXXXXXXXGOOOOOOOXXXXXXXXXXXXGOOOOOOXXXXXXXXXXXXXGOOOOXXXXXXXXXXXXXXXGOOOXXXXXXXXXXXXXXXXGOOOOOOOOXXXXXXXXXXXGOOOXXXXXXXXXXXXXXXXGOOOOXXXXXXXXXXXXXXXGOOOOOOOXXXXXXXXXXXXGOOXXXXXXXXXXXXXXXXXGOOOOOXXXXXXXXXXXXXXGOOOOXXXXXXXXXXXXXXXGOOOOOOOOOXXXXXXXXXX,0,0,0
8169,78,0,78,153,109,0,0,268,88,180,GOOOXXXXXXXXXXXXXXXXGOOOOOOOXXXXXXXXXXXXGOOOOOOXXXXXXXXXXXXXGOOOOXXXXXXXXXXXXXXXGOOOXXXXXXXXXXXXXXXXGOOOOOOOOXXXXXXXXXXXGOOOXXXXXXXXXXXXXXXXGOOOOXXXXXXXXXXXXXXXGOOOOOOOXXXXXXXXXXXXGOOXXXXXXXXXXXXXXXXXGOOOOOXXXXXXXXXXXXXXGOOOOXXXXXXXXXXXXXXXGOOOOOOOOOXXXXXXXXXX,0,0,0

8190,78,0,78,157,105,0,0,265,82,183,GOOOXXXXXXXXXXXXXXXXGOOOOOOOXXXXXXXXXXXXGOOOOOOXXXXXXXXXXXXXGOOOOXXXXXXXXXXXXXXXGOOOXXXXXXXXXXXXXXXXGOOOOOOOOXXXXXXXXXXXGOOOXXXXXXXXXXXXXXXXGOOOOXXXXXXXXXXXXXXXGOOOOOOOXXXXXXXXXXXXGOOXXXXXXXXXXXXXXXXXGOOOOOXXXXXXXXXXXXXXGOOOOXXXXXXXXXXXXXXXGOOOOOOOOOXXXXXXXXXX,0,0,0
8211,79,1,78,159,102,0,0,262,79,183,GOOOXXXXXXXXXXXXXXXXGOOOOOOOXXXXXXXXXXXXGOOOOOOAXXXXXXXXXXXXGOOOOXXXXXXXXXXXXXXXGOOOXXXXXXXXXXXXXXXXGOOOOOOOOXXXXXXXXXXXGOOOXXXXXXXXXXXXXXXXGOOOOXXXXXXXXXXXXXXXGOOOOOOOXXXXXXXXXXXXGOOXXXXXXXXXXXXXXXXXGOOOOOXXXXXXXXXXXXXXGOOOOXXXXXXXXXXXXXXXGOOOOOOOOOXXXXXXXXXX,0,0,0
8232,79,1,78,167,94,0,0,254,75,179,GOOOXXXXXXXXXXXXXXXXGOOOOOOOXXXXXXXXXXXXGOOOOOOAXXXXXXXXXXXXGOOOOXXXXXXXXXXXXXXXGOOOXXXXXXXXXXXXXXXXGOOOOOOOOXXXXXXXXXXXGOOOXXXXXXXXXXXXXXXXGOOOOXXXXXXXXXXXXXXXGOOOOOOOXXXXXXXXXXXXGOOXXXXXXXXXXXXXXXXXGOOOOOXXXXXXXXXXXXXXGOOOOXXXXXXXXXXXXXXXGOOOOOOOOOXXXXXXXXXX,0,0,0
8253,79,1,78,162,99,0,0,259,78,181,GOOOXXXXXXXXXXXXXXXXGOOOOOOOXXXXXXXXXXXXGOOOOOOAXXXXXXXXXXXXGOOOOXXXXXXXXXXXXXXXGOOOXXXXXXXXXXXXXXXXGOOOOOOOOXXXXXXXXXXXGOOOXXXXXXXXXXXXXXXXGOOOOXXXXXXXXXXXXXXXGOOOOOOOXXXXXXXXXXXXGOOXXXXXXXXXXXXXXXXXGOOOOOXXXXXXXXXXXXXXGOOOOXXXXXXXXXXXXXXXGOOOOOOOOOXXXXXXXXXX,0,0,0
8274,79,1,78,163,98,0,0,258,77,181,GOOOXXXXXXXXXXXXXXXXGOOOOOOOXXXXXXXXXXXXGOOOOOOAXXXXXXXXXXXXGOOOOXXXXXXXXXXXXXXXGOOOXXXXXXXXXXXXXXXXGOOOOOOOOXXXXXXXXXXXGOOOXXXXXXXXXXXXXXXXGOOOOXXXXXXXXXXXXXXXGOOOOOOOXXXXXXXXXXXXGOOXXXXXXXXXXXXXXXXXGOOOOOXXXXXXXXXXXXXXGOOOOXXXXXXXXXXXXXXXGOOOOOOOOOXXXXXXXXXX,0,0,0

8295,79,1,78,158,103,0,0,263,83,180,GOOOXXXXXXXXXXXXXXXXGOOOOOOOXXXXXXXXXXXXGOOOOOOAXXXXXXXXXXXXGOOOOXXXXXXXXXXXXXXXGOOOXXXXXXXXXXXXXXXXGOOOOOOOOXXXXXXXXXXXGOOOXXXXXXXXXXXXXXXXGOOOOXXXXXXXXXXXXXXXGOOOOOOOXXXXXXXXXXXXGOOXXXXXXXXXXXXXXXXXGOOOOOXXXXXXXXXXXXXXGOOOOXXXXXXXXXXXXXXXGOOOOOOOOOXXXXXXXXXX,0,0,0
8316,79,1,78,158,103,0,0,263,85,178,GOOOXXXXXXXXXXXXXXXXGOOOOOOOXXXXXXXXXXXXGOOOOOOAXXXXXXXXXXXXGOOOOXXXXXXXXXXXXXXXGOOOXXXXXXXXXXXXXXXXGOOOOOOOOXXXXXXXXXXXGOOOXXXXXXXXXXXXXXXXGOOOOXXXXXXXXXXXXXXXGOOOOOOOXXXXXXXXXXXXGOOXXXXXXXXXXXXXXXXXGOOOOOXXXXXXXXXXXXXXGOOOOXXXXXXXXXXXXXXXGOOOOOOOOOXXXXXXXXXX,0,0,0
8337,79,0,79,151,110,0,0,269,84,185,GOOOXXXXXXXXXXXXXXXXGOOOOOOOXXXXXXXXXXXXGOOOOOOOXXXXXXXXXXXXGOOOOXXXXXXXXXXXXXXXGOOOXXXXXXXXXXXXXXXXGOOOOOOOOXXXXXXXXXXXGOOOXXXXXXXXXXXXXXXXGOOOOXXXXXXXXXXXXXXXGOOOOOOOXXXXXXXXXXXXGOOXXXXXXXXXXXXXXXXXGOOOOOXXXXXXXXXXXXXXGOOOOXXXXXXXXXXXXXXXGOOOOOOOOOXXXXXXXXXX,0,0,0
8358,79,0,79,146,115,0,0,275,83,192,GOOOXXXXXXXXXXXXXXXXGOOOOOOOXXXXXXXXXXXXGOOOOOOOXXXXXXXXXXXXGOOOOXXXXXXXXXXXXXXXGOOOXXXXXXXXXXXXXXXXGOOOOOOOOXXXXXXXXXXXGOOOXXXXXXXXXXXXXXXXGOOOOXXXXXXXXXXXXXXXGOOOOOOOXXXXXXXXXXXXGOOXXXXXXXXXXXXXXXXXGOOOOOXXXXXXXXXXXXXXGOOOOXXXXXXXXXXXXXXXGOOOOOOOOOXXXXXXXXXX,0,0,0
8379,79,0,79,142,119,0,0,277,90,187,GOOOXXXXXXXXXXXXXXXXGOOOOOOOXXXXXXXXXXXXGOOOOOOOXXXXXXXXXXXXGOOOOXXXXXXXXXXXXXXXGOOOXXXXXXXXXXXXXXXXGOOOOOOOOXXXXXXXXXXXGOOOXXXXXXXXXXXXXXXXGOOOOXXXXXXXXXXXXXXXGOOOOOOOXXXXXXXXXXXXGOOXXXXXXXXXXXXXXXXXGOOOOOXXXXXXXXXXXXXXGOOOOXXXXXXXXXXXXXXXGOOOOOOOOOXXXXXXXXXX,0,0,0

8400,80,1,79,146,114,0,0,274,85,189,GOOOXXXXXXXXXXXXXXXXGOOOOOOOXXXXXXXXXXXXGOOOOOOOXXXXXXXXXXXXGOOOOXXXXXXXXXXXXXXXGOOOXXXXXXXXXXXXXXXXGOOOOOOOOXXXXXXXXXXXGOOOXXXXXXXXXXXXXXXXGOOOOXXXXXXXXXXXXXXXGOOOOOOOXXXXXXXXXXXXGOOXXXXXXXXXXXXXXXXXGOOOOOAXXXXXXXXXXXXXGOOOOXXXXXXXXXXXXXXXGOOOOOOOOOXXXXXXXXXX,0,0,0
8421,80,0,80,153,107,0,0,267,82,185,GOOOXXXXXXXXXXXXXXXXGOOOOOOOXXXXXXXXXXXXGOOOOOOOXXXXXXXXXXXXGOOOOXXXXXXXXXXXXXXXGOOOXXXXXXXXXXXXXXXXGOOOOOOOOXXXXXXXXXXXGOOOXXXXXXXXXXXXXXXXGOOOOXXXXXXXXXXXXXXXGOOOOOOOXXXXXXXXXXXXGOOXXXXXXXXXXXXXXXXXGOOOOOOXXXXXXXXXXXXXGOOOOXXXXXXXXXXXXXXXGOOOOOOOOOXXXXXXXXXX,0,0,0
8442,80,0,80,141,119,0,0,277,83,194,GOOOXXXXXXXXXXXXXXXXGOOOOOOOXXXXXXXXXXXXGOOOOOOOXXXXXXXXXXXXGOOOOXXXXXXXXXXXXXXXGOOOXXXXXXXXXXXXXXXXGOOOOOOOOXXXXXXXXXXXGOOOXXXXXXXXXXXXXXXXGOOOOXXXXXXXXXXXXXXXGOOOOOOOXXXXXXXXXXXXGOOXXXXXXXXXXXXXXXXXGOOOOOOXXXXXXXXXXXXXGOOOOXXXXXXXXXXXXXXXGOOOOOOOOOXXXXXXXXXX,0,0,0
8463,80,0,80,141,119,0,0,279,80,199,GOOOXXXXXXXXXXXXXXXXGOOOOOOOXXXXXXXXXXXXGOOOOOOOXXXXXXXXXXXXGOOOOXXXXXXXXXXXXXXXGOOOXXXXXXXXXXXXXXXXGOOOOOOOOXXXXXXXXXXXGOOOXXXXXXXXXXXXXXXXGOOOOXXXXXXXXXXXXXXXGOOOOOOOXXXXXXXXXXXXGOOXXXXXXXXXXXXXXXXXGOOOOOOXXXXXXXXXXXXXGOOOOXXXXXXXXXXXXXXXGOOOOOOOOOXXXXXXXXXX,0,0,0
8484,80,0,80,137,123,0,0,283,80,203,GOOOXXXXXXXXXXXXXXXXGOOOOOOOXXXXXXXXXXXXGOOOOOOOXXXXXXXXXXXXGOOOOXXXXXXXXXXXXXXXGOOOXXXXXXXXXXXXXXXXGOOOOOOOOXXXXXXXXXXXGOOOXXXXXXXXXXXXXXXXGOOOOXXXXXXXXXXXXXXXGOOOOOOOXXXXXXXXXXXXGOOXXXXXXXXXXXXXXXXXGOOOOOOXXXXXXXXXXXXXGOOOOXXXXXXXXXXXXXXXGOOOOOOOOOXXXXXXXXXX,0,0,0

8505,81,1,80,138,121,0,0,281,80,201,GOOOXXXXXXXXXXXXXXXXGOOOOOOOXXXXXXXXXXXXGOOOOOOOXXXXXXXXXXXXGOOOOXXXXXXXXXXXXXXXGOOOXXXXXXXXXXXXXXXXGOOOOOOOOXXXXXXXXXXXGOOOXXXXXXXXXXXXXXXXGOOOOXXXXXXXXXXXXXXXGOOOOOOOAXXXXXXXXXXXGOOXXXXXXXXXXXXXXXXXGOOOOOOXXXXXXXXXXXXXGOOOOXXXXXXXXXXXXXXXGOOOOOOOOOXXXXXXXXXX,0,0,0
8526,81,1,80,139,120,0,0,279,78,201,GOOOXXXXXXXXXXXXXXXXGOOOOOOOXXXXXXXXXXXXGOOOOOOOXXXXXXXXXXXXGOOOOXXXXXXXXXXXXXXXGOOOXXXXXXXXXXXXXXXXGOOOOOOOOXXXXXXXXXXXGOOOXXXXXXXXXXXXXXXXGOOOOXXXXXXXXXXXXXXXGOOOOOOOAXXXXXXXXXXXGOOXXXXXXXXXXXXXXXXXGOOOOOOXXXXXXXXXXXXXGOOOOXXXXXXXXXXXXXXXGOOOOOOOOOXXXXXXXXXX,0,0,0
8547,81,1,80,138,121,0,0,281,79,202,GOOOXXXXXXXXXXXXXXXXGOOOOOOOXXXXXXXXXXXXGOOOOOOOXXXXXXXXXXXXGOOOOXXXXXXXXXXXXXXXGOOOXXXXXXXXXXXXXXXXGOOOOOOOOXXXXXXXXXXXGOOOXXXXXXXXXXXXXXXXGOOOOXXXXXXXXXXXXXXXGOOOOOOOAXXXXXXXXXXXGOOXXXXXXXXXXXXXXXXXGOOOOOOXXXXXXXXXXXXXGOOOOXXXXXXXXXXXXXXXGOOOOOOOOOXXXXXXXXXX,0,0,0
8568,81,1,80,136,123,0,0,283,84,199,GOOOXXXXXXXXXXXXXXXXGOOOOOOOXXXXXXXXXXXXGOOOOOOOXXXXXXXXXXXXGOOOOXXXXXXXXXXXXXXXGOOOXXXXXXXXXXXXXXXXGOOOOOOOOXXXXXXXXXXXGOOOXXXXXXXXXXXXXXXXGOOOOXXXXXXXXXXXXXXXGOOOOOOOAXXXXXXXXXXXGOOXXXXXXXXXXXXXXXXXGOOOOOOXXXXXXXXXXXXXGOOOOXXXXXXXXXXXXXXXGOOOOOOOOOXXXXXXXXXX,0,0,0
8589,81,1,80,136,123,0,0,284,85,199,GOOOXXXXXXXXXXXXXXXXGOOOOOOOXXXXXXXXXXXXGOOOOOOOXXXXXXXXXXXXGOOOOXXXXXXXXXXXXXXXGOOOXXXXXXXXXXXXXXXXGOOOOOOOOXXXXXXXXXXXGOOOXXXXXXXXXXXXXXXXGOOOOXXXXXXXXXXXXXXXGOOOOOOOAXXXXXXXXXXXGOOXXXXXXXXXXXXXXXXXGOOOOOOXXXXXXXXXXXXXGOOOOXXXXXXXXXXXXXXXGOOOOOOOOOXXXXXXXXXX,0,0,0

8610,81,1,80,140,119,0,0,280,79,201,GOOOXXXXXXXXXXXXXXXXGOOOOOOOXXXXXXXXXXXXGOOOOOOOXXXXXXXXXXXXGOOOOXXXXXXXXXXXXXXXGOOOXXXXXXXXXXXXXXXXGOOOOOOOOXXXXXXXXXXXGOOOXXXXXXXXXXXXXXXXGOOOOXXXXXXXXXXXXXXXGOOOOOOOAXXXXXXXXXXXGOOXXXXXXXXXXXXXXXXXGOOOOOOXXXXXXXXXXXXXGOOOOXXXXXXXXXXXXXXXGOOOOOOOOOXXXXXXXXXX,0,0,0
8631,81,1,80,135,124,0,0,284,78,206,GOOOXXXXXXXXXXXXXXXXGOOOOOOOXXXXXXXXXXXXGOOOOOOOXXXXXXXXXXXXGOOOOXXXXXXXXXXXXXXXGOOOXXXXXXXXXXXXXXXXGOOOOOOOOXXXXXXXXXXXGOOOXXXXXXXXXXXXXXXXGOOOOXXXXXXXXXXXXXXXGOOOOOOOAXXXXXXXXXXXGOOXXXXXXXXXXXXXXXXXGOOOOOOXXXXXXXXXXXXXGOOOOXXXXXXXXXXXXXXXGOOOOOOOOOXXXXXXXXXX,0,0,0
8652,82,1,81,129,129,0,0,290,83,207,GOOOXXXXXXXXXXXXXXXXGOOOOOOOXXXXXXXXXXXXGOOOOOOOXXXXXXXXXXXXGOOOOAXXXXXXXXXXXXXXGOOOXXXXXXXXXXXXXXXXGOOOOOOOOXXXXXXXXXXXGOOOXXXXXXXXXXXXXXXXGOOOOXXXXXXXXXXXXXXXGOOOOOOOOXXXXXXXXXXXGOOXXXXXXXXXXXXXXXXXGOOOOOOXXXXXXXXXXXXXGOOOOXXXXXXXXXXXXXXXGOOOOOOOOOXXXXXXXXXX,0,0,0
8673,82,1,81,128,130,0,0,290,81,209,GOOOXXXXXXXXXXXXXXXXGOOOOOOOXXXXXXXXXXXXGOOOOOOOXXXXXXXXXXXXGOOOOAXXXXXXXXXXXXXXGOOOXXXXXXXXXXXXXXXXGOOOOOOOOXXXXXXXXXXXGOOOXXXXXXXXXXXXXXXXGOOOOXXXXXXXXXXXXXXXGOOOOOOOOXXXXXXXXXXXGOOXXXXXXXXXXXXXXXXXGOOOOOOXXXXXXXXXXXXXGOOOOXXXXXXXXXXXXXXXGOOOOOOOOOXXXXXXXXXX,0,0,0
8694,82,1,81,126,132,0,0,290,83,207,GOOOXXXXXXXXXXXXXXXXGOOOOOOOXXXXXXXXXXXXGOOOOOOOXXXXXXXXXXXXGOOOOAXXXXXXXXXXXXXXGOOOXXXXXXXXXXXXXXXXGOOOOOOOOXXXXXXXXXXXGOOOXXXXXXXXXXXXXXXXGOOOOXXXXXXXXXXXXXXXGOOOOOOOOXXXXXXXXXXXGOOXXXXXXXXXXXXXXXXXGOOOOOOXXXXXXXXXXXXXGOOOOXXXXXXXXXXXXXXXGOOOOOOOOOXXXXXXXXXX,0,0,0

8715,82,1,81,130,128,0,0,288,88,200,GOOOXXXXXXXXXXXXXXXXGOOOOOOOXXXXXXXXXXXXGOOOOOOOXXXXXXXXXXXXGOOOOAXXXXXXXXXXXXXXGOOOXXXXXXXXXXXXXXXXGOOOOOOOOXXXXXXXXXXXGOOOXXXXXXXXXXXXXXXXGOOOOXXXXXXXXXXXXXXXGOOOOOOOOXXXXXXXXXXXGOOXXXXXXXXXXXXXXXXXGOOOOOOXXXXXXXXXXXXXGOOOOXXXXXXXXXXXXXXXGOOOOOOOOOXXXXXXXXXX,0,0,0
8736,82,1,81,130,128,0,0,286,89,197,GOOOXXXXXXXXXXXXXXXXGOOOOOOOXXXXXXXXXXXXGOOOOOOOXXXXXXXXXXXXGOOOOAXXXXXXXXXXXXXXGOOOXXXXXXXXXXXXXXXXGOOOOOOOOXXXXXXXXXXXGOOOXXXXXXXXXXXXXXXXGOOOOXXXXXXXXXXXXXXXGOOOOOOOOXXXXXXXXXXXGOOXXXXXXXXXXXXXXXXXGOOOOOOXXXXXXXXXXXXXGOOOOXXXXXXXXXXXXXXXGOOOOOOOOOXXXXXXXXXX,0,0,0
8757,82,1,81,136,122,0,0,282,93,189,GOOOXXXXXXXXXXXXXXXXGOOOOOOOXXXXXXXXXXXXGOOOOOOOXXXXXXXXXXXXGOOOOAXXXXXXXXXXXXXXGOOOXXXXXXXXXXXXXXXXGOOOOOOOOXXXXXXXXXXXGOOOXXXXXXXXXXXXXXXXGOOOOXXXXXXXXXXXXXXXGOOOOOOOOXXXXXXXXXXXGOOXXXXXXXXXXXXXXXXXGOOOOOOXXXXXXXXXXXXXGOOOOXXXXXXXXXXXXXXXGOOOOOOOOOXXXXXXXXXX,0,0,0
8778,82,1,81,134,124,0,0,284,94,190,GOOOXXXXXXXXXXXXXXXXGOOOOOOOXXXXXXXXXXXXGOOOOOOOXXXXXXXXXXXXGOOOOAXXXXXXXXXXXXXXGOOOXXXXXXXXXXXXXXXXGOOOOOOOOXXXXXXXXXXXGOOOXXXXXXXXXXXXXXXXGOOOOXXXXXXXXXXXXXXXGOOOOOOOOXXXXXXXXXXXGOOXXXXXXXXXXXXXXXXXGOOOOOOXXXXXXXXXXXXXGOOOOXXXXXXXXXXXXXXXGOOOOOOOOOXXXXXXXXXX,0,0,0
8799,82,0,82,135,123,0,0,283,92,191,GOOOXXXXXXXXXXXXXXXXGOOOOOOOXXXXXXXXXXXXGOOOOOOOXXXXXXXXXXXXGOOOOOXXXXXXXXXXXXXXGOOOXXXXXXXXXXXXXXXXGOOOOOOOOXXXXXXXXXXXGOOOXXXXXXXXXXXXXXXXGOOOOXXXXXXXXXXXXXXXGOOOOOOOOXXXXXXXXXXXGOOXXXXXXXXXXXXXXXXXGOOOOOOXXXXXXXXXXXXXGOOOOXXXXXXXXXXXXXXXGOOOOOOOOOXXXXXXXXXX,0,0,0

8820,82,0,82,133,125,0,0,285,89,196,GOOOXXXXXXXXXXXXXXXXGOOOOOOOXXXXXXXXXXXXGOOOOOOOXXXXXXXXXXXXGOOOOOXXXXXXXXXXXXXXGOOOXXXXXXXXXXXXXXXXGOOOOOOOOXXXXXXXXXXXGOOOXXXXXXXXXXXXXXXXGOOOOXXXXXXXXXXXXXXXGOOOOOOOOXXXXXXXXXXXGOOXXXXXXXXXXXXXXXXXGOOOOOOXXXXXXXXXXXXXGOOOOXXXXXXXXXXXXXXXGOOOOOOOOOXXXXXXXXXX,0,0,0
8841,82,0,82,134,124,0,0,281,82,199,GOOOXXXXXXXXXXXXXXXXGOOOOOOOXXXXXXXXXXXXGOOOOOOOXXXXXXXXXXXXGOOOOOXXXXXXXXXXXXXXGOOOXXXXXXXXXXXXXXXXGOOOOOOOOXXXXXXXXXXXGOOOXXXXXXXXXXXXXXXXGOOOOXXXXXXXXXXXXXXXGOOOOOOOOXXXXXXXXXXXGOOXXXXXXXXXXXXXXXXXGOOOOOOXXXXXXXXXXXXXGOOOOXXXXXXXXXXXXXXXGOOOOOOOOOXXXXXXXXXX,0,0,0
8862,82,0,82,135,123,0,0,282,82,200,GOOOXXXXXXXXXXXXXXXXGOOOOOOOXXXXXXXXXXXXGOOOOOOOXXXXXXXXXXXXGOOOOOXXXXXXXXXXXXXXGOOOXXXXXXXXXXXXXXXXGOOOOOOOOXXXXXXXXXXXGOOOXXXXXXXXXXXXXXXXGOOOOXXXXXXXXXXXXXXXGOOOOOOOOXXXXXXXXXXXGOOXXXXXXXXXXXXXXXXXGOOOOOOXXXXXXXXXXXXXGOOOOXXXXXXXXXXXXXXXGOOOOOOOOOXXXXXXXXXX,0,0,0
8883,82,0,82,124,134,0,0,293,84,209,GOOOXXXXXXXXXXXXXXXXGOOOOOOOXXXXXXXXXXXXGOOOOOOOXXXXXXXXXXXXGOOOOOXXXXXXXXXXXXXXGOOOXXXXXXXXXXXXXXXXGOOOOOOOOXXXXXXXXXXXGOOOXXXXXXXXXXXXXXXXGOOOOXXXXXXXXXXXXXXXGOOOOOOOOXXXXXXXXXXXGOOXXXXXXXXXXXXXXXXXGOOOOOOXXXXXXXXXXXXXGOOOOXXXXXXXXXXXXXXXGOOOOOOOOOXXXXXXXXXX,0,0,0
8904,82,0,82,124,134,0,0,294,87,207,GOOOXXXXXXXXXXXXXXXXGOOOOOOOXXXXXXXXXXXXGOOOOOOOXXXXXXXXXXXXGOOOOOXXXXXXXXXXXXXXGOOOXXXXXXXXXXXXXXXXGOOOOOOOOXXXXXXXXXXXGOOOXXXXXXXXXXXXXXXXGOOOOXXXXXXXXXXXXXXXGOOOOOOOOXXXXXXXXXXXGOOXXXXXXXXXXXXXXXXXGOOOOOOXXXXXXXXXXXXXGOOOOXXXXXXXXXXXXXXXGOOOOOOOOOXXXXXXXXXX,0,0,0

8925,82,0,82,123,135,0,0,295,92,203,GOOOXXXXXXXXXXXXXXXXGOOOOOOOXXXXXXXXXXXXGOOOOOOOXXXXXXXXXXXXGOOOOOXXXXXXXXXXXXXXGOOOXXXXXXXXXXXXXXXXGOOOOOOOOXXXXXXXXXXXGOOOXXXXXXXXXXXXXXXXGOOOOXXXXXXXXXXXXXXXGOOOOOOOOXXXXXXXXXXXGOOXXXXXXXXXXXXXXXXXGOOOOOOXXXXXXXXXXXXXGOOOOXXXXXXXXXXXXXXXGOOOOOOOOOXXXXXXXXXX,0,0,0
8946,82,0,82,126,132,0,0,292,87,205,GOOOXXXXXXXXXXXXXXXXGOOOOOOOXXXXXXXXXXXXGOOOOOOOXXXXXXXXXXXXGOOOOOXXXXXXXXXXXXXXGOOOXXXXXXXXXXXXXXXXGOOOOOOOOXXXXXXXXXXXGOOOXXXXXXXXXXXXXXXXGOOOOXXXXXXXXXXXXXXXGOOOOOOOOXXXXXXXXXXXGOOXXXXXXXXXXXXXXXXXGOOOOOOXXXXXXXXXXXXXGOOOOXXXXXXXXXXXXXXXGOOOOOOOOOXXXXXXXXXX,0,0,0
8967,82,0,82,132,126,0,0,286,87,199,GOOOXXXXXXXXXXXXXXXXGOOOOOOOXXXXXXXXXXXXGOOOOOOOXXXXXXXXXXXXGOOOOOXXXXXXXXXXXXXXGOOOXXXXXXXXXXXXXXXXGOOOOOOOOXXXXXXXXXXXGOOOXXXXXXXXXXXXXXXXGOOOOXXXXXXXXXXXXXXXGOOOOOOOOXXXXXXXXXXXGOOXXXXXXXXXXXXXXXXXGOOOOOOXXXXXXXXXXXXXGOOOOXXXXXXXXXXXXXXXGOOOOOOOOOXXXXXXXXXX,0,0,0
8988,82,0,82,135,123,0,0,280,82,198,GOOOXXXXXXXXXXXXXXXXGOOOOOOOXXXXXXXXXXXXGOOOOOOOXXXXXXXXXXXXGOOOOOXXXXXXXXXXXXXXGOOOXXXXXXXXXXXXXXXXGOOOOOOOOXXXXXXXXXXXGOOOXXXXXXXXXXXXXXXXGOOOOXXXXXXXXXXXXXXXGOOOOOOOOXXXXXXXXXXXGOOXXXXXXXXXXXXXXXXXGOOOOOOXXXXXXXXXXXXXGOOOOXXXXXXXXXXXXXXXGOOOOOOOOOXXXXXXXXXX,0,0,0
9009,82,0,82,135,123,0,0,284,83,201,GOOOXXXXXXXXXXXXXXXXGOOOOOOOXXXXXXXXXXXXGOOOOOOOXXXXXXXXXXXXGOOOOOXXXXXXXXXXXXXXGOOOXXXXXXXXXXXXXXXXGOOOOOOOOXXXXXXXXXXXGOOOXXXXXXXXXXXXXXXXGOOOOXXXXXXXXXXXXXXXGOOOOOOOOXXXXXXXXXXXGOOXXXXXXXXXXXXXXXXXGOOOOOOXXXXXXXXXXXXXGOOOOXXXXXXXXXXXXXXXGOOOOOOOOOXXXXXXXXXX,0,0,0

9030,82,0,82,134,124,0,0,285,82,203,GOOOXXXXXXXXXXXXXXXXGOOOOOOOXXXXXXXXXXXXGOOOOOOOXXXXXXXXXXXXGOOOOOXXXXXXXXXXXXXXGOOOXXXXXXXXXXXXXXXXGOOOOOOOOXXXXXXXXXXXGOOOXXXXXXXXXXXXXXXXGOOOOXXXXXXXXXXXXXXXGOOOOOOOOXXXXXXXXXXXGOOXXXXXXXXXXXXXXXXXGOOOOOOXXXXXXXXXXXXXGOOOOXXXXXXXXXXXXXXXGOOOOOOOOOXXXXXXXXXX,0,0,0
9051,82,0,82,130,128,0,0,288,83,205,GOOOXXXXXXXXXXXXXXXXGOOOOOOOXXXXXXXXXXXXGOOOOOOOXXXXXXXXXXXXGOOOOOXXXXXXXXXXXXXXGOOOXXXXXXXXXXXXXXXXGOOOOOOOOXXXXXXXXXXXGOOOXXXXXXXXXXXXXXXXGOOOOXXXXXXXXXXXXXXXGOOOOOOOOXXXXXXXXXXXGOOXXXXXXXXXXXXXXXXXGOOOOOOXXXXXXXXXXXXXGOOOOXXXXXXXXXXXXXXXGOOOOOOOOOXXXXXXXXXX,0,0,0
9072,83,1,82,140,117,0,0,278,72,206,GOOOXXXXXXXXXXXXXXXXGOOOOOOOXXXXXXXXXXXXGOOOOOOOXXXXXXXXXXXXGOOOOOXXXXXXXXXXXXXXGOOOXXXXXXXXXXXXXXXXGOOOOOOOOAXXXXXXXXXXGOOOXXXXXXXXXXXXXXXXGOOOOXXXXXXXXXXXXXXXGOOOOOOOOXXXXXXXXXXXGOOXXXXXXXXXXXXXXXXXGOOOOOOXXXXXXXXXXXXXGOOOOXXXXXXXXXXXXXXXGOOOOOOOOOXXXXXXXXXX,0,0,0
9093,83,1,82,130,127,0,0,285,73,212,GOOOXXXXXXXXXXXXXXXXGOOOOOOOXXXXXXXXXXXXGOOOOOOOXXXXXXXXXXXXGOOOOOXXXXXXXXXXXXXXGOOOXXXXXXXXXXXXXXXXGOOOOOOOOAXXXXXXXXXXGOOOXXXXXXXXXXXXXXXXGOOOOXXXXXXXXXXXXXXXGOOOOOOOOXXXXXXXXXXXGOOXXXXXXXXXXXXXXXXXGOOOOOOXXXXXXXXXXXXXGOOOOXXXXXXXXXXXXXXXGOOOOOOOOOXXXXXXXXXX,0,0,0
9114,83,1,82,132,125,0,0,285,76,209,GOOOXXXXXXXXXXXXXXXXGOOOOOOOXXXXXXXXXXXXGOOOOOOOXXXXXXXXXXXXGOOOOOXXXXXXXXXXXXXXGOOOXXXXXXXXXXXXXXXXGOOOOOOOOAXXXXXXXXXXGOOOXXXXXXXXXXXXXXXXGOOOOXXXXXXXXXXXXXXXGOOOOOOOOXXXXXXXXXXXGOOXXXXXXXXXXXXXXXXXGOOOOOOXXXXXXXXXXXXXGOOOOXXXXXXXXXXXXXXXGOOOOOOOOOXXXXXXXXXX,0,0,0

9135,83,1,82,132,125,0,0,286,79,207,GOOOXXXXXXXXXXXXXXXXGOOOOOOOXXXXXXXXXXXXGOOOOOOOXXXXXXXXXXXXGOOOOOXXXXXXXXXXXXXXGOOOXXXXXXXXXXXXXXXXGOOOOOOOOAXXXXXXXXXXGOOOXXXXXXXXXXXXXXXXGOOOOXXXXXXXXXXXXXXXGOOOOOOOOXXXXXXXXXXXGOOXXXXXXXXXXXXXXXXXGOOOOOOXXXXXXXXXXXXXGOOOOXXXXXXXXXXXXXXXGOOOOOOOOOXXXXXXXXXX,0,0,0
9156,83,1,82,132,125,0,0,285,85,200,GOOOXXXXXXXXXXXXXXXXGOOOOOOOXXXXXXXXXXXXGOOOOOOOXXXXXXXXXXXXGOOOOOXXXXXXXXXXXXXXGOOOXXXXXXXXXXXXXXXXGOOOOOOOOAXXXXXXXXXXGOOOXXXXXXXXXXXXXXXXGOOOOXXXXXXXXXXXXXXXGOOOOOOOOXXXXXXXXXXXGOOXXXXXXXXXXXXXXXXXGOOOOOOXXXXXXXXXXXXXGOOOOXXXXXXXXXXXXXXXGOOOOOOOOOXXXXXXXXXX,0,0,0
9177,83,1,82,126,131,0,0,292,90,202,GOOOXXXXXXXXXXXXXXXXGOOOOOOOXXXXXXXXXXXXGOOOOOOOXXXXXXXXXXXXGOOOOOXXXXXXXXXXXXXXGOOOXXXXXXXXXXXXXXXXGOOOOOOOOAXXXXXXXXXXGOOOXXXXXXXXXXXXXXXXGOOOOXXXXXXXXXXXXXXXGOOOOOOOOXXXXXXXXXXXGOOXXXXXXXXXXXXXXXXXGOOOOOOXXXXXXXXXXXXXGOOOOXXXXXXXXXXXXXXXGOOOOOOOOOXXXXXXXXXX,0,0,0
9198,83,1,82,134,123,0,0,284,84,200,GOOOXXXXXXXXXXXXXXXXGOOOOOOOXXXXXXXXXXXXGOOOOOOOXXXXXXXXXXXXGOOOOOXXXXXXXXXXXXXXGOOOXXXXXXXXXXXXXXXXGOOOOOOOOAXXXXXXXXXXGOOOXXXXXXXXXXXXXXXXGOOOOXXXXXXXXXXXXXXXGOOOOOOOOXXXXXXXXXXXGOOXXXXXXXXXXXXXXXXXGOOOOOOXXXXXXXXXXXXXGOOOOXXXXXXXXXXXXXXXGOOOOOOOOOXXXXXXXXXX,0,0,0
9219,83,1,82,134,123,0,0,283,83,200,GOOOXXXXXXXXXXXXXXXXGOOOOOOOXXXXXXXXXXXXGOOOOOOOXXXXXXXXXXXXGOOOOOXXXXXXXXXXXXXXGOOOXXXXXXXXXXXXXXXXGOOOOOOOOAXXXXXXXXXXGOOOXXXXXXXXXXXXXXXXGOOOOXXXXXXXXXXXXXXXGOOOOOOOOXXXXXXXXXXXGOOXXXXXXXXXXXXXXXXXGOOOOOOXXXXXXXXXXXXXGOOOOXXXXXXXXXXXXXXXGOOOOOOOOOXXXXXXXXXX,0,0,0

9240,83,1,82,142,115,0,0,276,84,192,GOOOXXXXXXXXXXXXXXXXGOOOOOOOXXXXXXXXXXXXGOOOOOOOXXXXXXXXXXXXGOOOOOXXXXXXXXXXXXXXGOOOXXXXXXXXXXXXXXXXGOOOOOOOOAXXXXXXXXXXGOOOXXXXXXXXXXXXXXXXGOOOOXXXXXXXXXXXXXXXGOOOOOOOOXXXXXXXXXXXGOOXXXXXXXXXXXXXXXXXGOOOOOOXXXXXXXXXXXXXGOOOOXXXXXXXXXXXXXXXGOOOOOOOOOXXXXXXXXXX,0,0,0
9261,83,0,83,142,115,0,0,276,82,194,GOOOXXXXXXXXXXXXXXXXGOOOOOOOXXXXXXXXXXXXGOOOOOOOXXXXXXXXXXXXGOOOOOXXXXXXXXXXXXXXGOOOXXXXXXXXXXXXXXXXGOOOOOOOOOXXXXXXXXXXGOOOXXXXXXXXXXXXXXXXGOOOOXXXXXXXXXXXXXXXGOOOOOOOOXXXXXXXXXXXGOOXXXXXXXXXXXXXXXXXGOOOOOOXXXXXXXXXXXXXGOOOOXXXXXXXXXXXXXXXGOOOOOOOOOXXXXXXXXXX,0,0,0
9282,83,0,83,145,112,0,0,274,82,192,GOOOXXXXXXXXXXXXXXXXGOOOOOOOXXXXXXXXXXXXGOOOOOOOXXXXXXXXXXXXGOOOOOXXXXXXXXXXXXXXGOOOXXXXXXXXXXXXXXXXGOOOOOOOOOXXXXXXXXXXGOOOXXXXXXXXXXXXXXXXGOOOOXXXXXXXXXXXXXXXGOOOOOOOOXXXXXXXXXXXGOOXXXXXXXXXXXXXXXXXGOOOOOOXXXXXXXXXXXXXGOOOOXXXXXXXXXXXXXXXGOOOOOOOOOXXXXXXXXXX,0,0,0
9303,83,0,83,139,118,0,0,280,85,195,GOOOXXXXXXXXXXXXXXXXGOOOOOOOXXXXXXXXXXXXGOOOOOOOXXXXXXXXXXXXGOOOOOXXXXXXXXXXXXXXGOOOXXXXXXXXXXXXXXXXGOOOOOOOOOXXXXXXXXXXGOOOXXXXXXXXXXXXXXXXGOOOOXXXXXXXXXXXXXXXGOOOOOOOOXXXXXXXXXXXGOOXXXXXXXXXXXXXXXXXGOOOOOOXXXXXXXXXXXXXGOOOOXXXXXXXXXXXXXXXGOOOOOOOOOXXXXXXXXXX,0,0,0
9324,83,0,83,143,114,0,0,275,91,184,GOOOXXXXXXXXXXXXXXXXGOOOOOOOXXXXXXXXXXXXGOOOOOOOXXXXXXXXXXXXGOOOOOXXXXXXXXXXXXXXGOOOXXXXXXXXXXXXXXXXGOOOOOOOOOXXXXXXXXXXGOOOXXXXXXXXXXXXXXXXGOOOOXXXXXXXXXXXXXXXGOOOOOOOOXXXXXXXXXXXGOOXXXXXXXXXXXXXXXXXGOOOOOOXXXXXXXXXXXXXGOOOOXXXXXXXXXXXXXXXGOOOOOOOOOXXXXXXXXXX,0,0,0

9345,83,0,83,137,120,0,0,281,86,195,GOOOXXXXXXXXXXXXXXXXGOOOOOOOXXXXXXXXXXXXGOOOOOOOXXXXXXXXXXXXGOOOOOXXXXXXXXXXXXXXGOOOXXXXXXXXXXXXXXXXGOOOOOOOOOXXXXXXXXXXGOOOXXXXXXXXXXXXXXXXGOOOOXXXXXXXXXXXXXXXGOOOOOOOOXXXXXXXXXXXGOOXXXXXXXXXXXXXXXXXGOOOOOOXXXXXXXXXXXXXGOOOOXXXXXXXXXXXXXXXGOOOOOOOOOXXXXXXXXXX,0,0,0
9366,83,0,83,142,115,0,0,275,83,192,GOOOXXXXXXXXXXXXXXXXGOOOOOOOXXXXXXXXXXXXGOOOOOOOXXXXXXXXXXXXGOOOOOXXXXXXXXXXXXXXGOOOXXXXXXXXXXXXXXXXGOOOOOOOOOXXXXXXXXXXGOOOXXXXXXXXXXXXXXXXGOOOOXXXXXXXXXXXXXXXGOOOOOOOOXXXXXXXXXXXGOOXXXXXXXXXXXXXXXXXGOOOOOOXXXXXXXXXXXXXGOOOOXXXXXXXXXXXXXXXGOOOOOOOOOXXXXXXXXXX,0,0,0
9387,83,0,83,140,117,0,0,278,91,187,GOOOXXXXXXXXXXXXXXXXGOOOOOOOXXXXXXXXXXXXGOOOOOOOXXXXXXXXXXXXGOOOOOXXXXXXXXXXXXXXGOOOXXXXXXXXXXXXXXXXGOOOOOOOOOXXXXXXXXXXGOOOXXXXXXXXXXXXXXXXGOOOOXXXXXXXXXXXXXXXGOOOOOOOOXXXXXXXXXXXGOOXXXXXXXXXXXXXXXXXGOOOOOOXXXXXXXXXXXXXGOOOOXXXXXXXXXXXXXXXGOOOOOOOOOXXXXXXXXXX,0,0,0
9408,83,0,83,144,113,0,0,274,88,186,GOOOXXXXXXXXXXXXXXXXGOOOOOOOXXXXXXXXXXXXGOOOOOOOXXXXXXXXXXXXGOOOOOXXXXXXXXXXXXXXGOOOXXXXXXXXXXXXXXXXGOOOOOOOOOXXXXXXXXXXGOOOXXXXXXXXXXXXXXXXGOOOOXXXXXXXXXXXXXXXGOOOOOOOOXXXXXXXXXXXGOOXXXXXXXXXXXXXXXXXGOOOOOOXXXXXXXXXXXXXGOOOOXXXXXXXXXXXXXXXGOOOOOOOOOXXXXXXXXXX,0,0,0
9429,83,0,83,141,116,0,0,276,87,189,GOOOXXXXXXXXXXXXXXXXGOOOOOOOXXXXXXXXXXXXGOOOOOOOXXXXXXXXXXXXGOOOOOXXXXXXXXXXXXXXGOOOXXXXXXXXXXXXXXXXGOOOOOOOOOXXXXXXXXXXGOOOXXXXXXXXXXXXXXXXGOOOOXXXXXXXXXXXXXXXGOOOOOOOOXXXXXXXXXXXGOOXXXXXXXXXXXXXXXXXGOOOOOOXXXXXXXXXXXXXGOOOOXXXXXXXXXXXXXXXGOOOOOOOOOXXXXXXXXXX,0,0,0

9450,83,0,83,139,118,0,0,277,93,184,GOOOXXXXXXXXXXXXXXXXGOOOOOOOXXXXXXXXXXXXGOOOOOOOXXXXXXXXXXXXGOOOOOXXXXXXXXXXXXXXGOOOXXXXXXXXXXXXXXXXGOOOOOOOOOXXXXXXXXXXGOOOXXXXXXXXXXXXXXXXGOOOOXXXXXXXXXXXXXXXGOOOOOOOOXXXXXXXXXXXGOOXXXXXXXXXXXXXXXXXGOOOOOOXXXXXXXXXXXXXGOOOOXXXXXXXXXXXXXXXGOOOOOOOOOXXXXXXXXXX,0,0,0
9471,83,0,83,141,116,0,0,275,85,190,GOOOXXXXXXXXXXXXXXXXGOOOOOOOXXXXXXXXXXXXGOOOOOOOXXXXXXXXXXXXGOOOOOXXXXXXXXXXXXXXGOOOXXXXXXXXXXXXXXXXGOOOOOOOOOXXXXXXXXXXGOOOXXXXXXXXXXXXXXXXGOOOOXXXXXXXXXXXXXXXGOOOOOOOOXXXXXXXXXXXGOOXXXXXXXXXXXXXXXXXGOOOOOOXXXXXXXXXXXXXGOOOOXXXXXXXXXXXXXXXGOOOOOOOOOXXXXXXXXXX,0,0,0
9492,83,0,83,137,120,0,0,280,84,196,GOOOXXXXXXXXXXXXXXXXGOOOOOOOXXXXXXXXXXXXGOOOOOOOXXXXXXXXXXXXGOOOOOXXXXXXXXXXXXXXGOOOXXXXXXXXXXXXXXXXGOOOOOOOOOXXXXXXXXXXGOOOXXXXXXXXXXXXXXXXGOOOOXXXXXXXXXXXXXXXGOOOOOOOOXXXXXXXXXXXGOOXXXXXXXXXXXXXXXXXGOOOOOOXXXXXXXXXXXXXGOOOOXXXXXXXXXXXXXXXGOOOOOOOOOXXXXXXXXXX,0,0,0
9513,85,2,83,137,118,0,0,277,89,188,GOOOXXXXXXXXXXXXXXXXGOOOOOOOXXXXXXXXXXXXGOOOOOOOXXXXXXXXXXXXGOOOOOXXXXXXXXXXXXXXGOOOXXXXXXXXXXXXXXXXGOOOOOOOOOXXXXXXXXXXGOOOXXXXXXXXXXXXXXXXGOOOOXXXXXXXXXXXXXXXGOOOOOOOOAAXXXXXXXXXGOOXXXXXXXXXXXXXXXXXGOOOOOOXXXXXXXXXXXXXGOOOOXXXXXXXXXXXXXXXGOOOOOOOOOXXXXXXXXXX,0,0,0
9534,86,3,83,145,109,0,0,269,88,181,GOOOXXXXXXXXXXXXXXXXGOOOOOOOXXXXXXXXXXXXGOOOOOOOXXXXXXXXXXXXGOOOOOAXXXXXXXXXXXXXGOOOXXXXXXXXXXXXXXXXGOOOOOOOOOXXXXXXXXXXGOOOXXXXXXXXXXXXXXXXGOOOOXXXXXXXXXXXXXXXGOOOOOOOOAAXXXXXXXXXGOOXXXXXXXXXXXXXXXXXGOOOOOOXXXXXXXXXXXXXGOOOOXXXXXXXXXXXXXXXGOOOOOOOOOXXXXXXXXXX,0,0,0

9555,86,3,83,139,115,0,0,274,86,188,GOOOXXXXXXXXXXXXXXXXGOOOOOOOXXXXXXXXXXXXGOOOOOOOXXXXXXXXXXXXGOOOOOAXXXXXXXXXXXXXGOOOXXXXXXXXXXXXXXXXGOOOOOOOOOXXXXXXXXXXGOOOXXXXXXXXXXXXXXXXGOOOOXXXXXXXXXXXXXXXGOOOOOOOOAAXXXXXXXXXGOOXXXXXXXXXXXXXXXXXGOOOOOOXXXXXXXXXXXXXGOOOOXXXXXXXXXXXXXXXGOOOOOOOOOXXXXXXXXXX,0,0,0
9576,87,4,83,141,112,0,0,271,84,187,GOOOXXXXXXXXXXXXXXXXGOOOOOOOXXXXXXXXXXXXGOOOOOOOXXXXXXXXXXXXGOOOOOAXXXXXXXXXXXXXGOOOXXXXXXXXXXXXXXXXGOOOOOOOOOXXXXXXXXXXGOOOXXXXXXXXXXXXXXXXGOOOOXXXXXXXXXXXXXXXGOOOOOOOOAAXXXXXXXXXGOOAXXXXXXXXXXXXXXXXGOOOOOOXXXXXXXXXXXXXGOOOOXXXXXXXXXXXXXXXGOOOOOOOOOXXXXXXXXXX,0,0,0
9597,87,4,83,140,113,0,0,273,83,190,GOOOXXXXXXXXXXXXXXXXGOOOOOOOXXXXXXXXXXXXGOOOOOOOXXXXXXXXXXXXGOOOOOAXXXXXXXXXXXXXGOOOXXXXXXXXXXXXXXXXGOOOOOOOOOXXXXXXXXXXGOOOXXXXXXXXXXXXXXXXGOOOOXXXXXXXXXXXXXXXGOOOOOOOOAAXXXXXXXXXGOOAXXXXXXXXXXXXXXXXGOOOOOOXXXXXXXXXXXXXGOOOOXXXXXXXXXXXXXXXGOOOOOOOOOXXXXXXXXXX,0,0,0
9618,87,3,84,139,114,0,0,274,82,192,GOOOXXXXXXXXXXXXXXXXGOOOOOOOXXXXXXXXXXXXGOOOOOOOXXXXXXXXXXXXGOOOOOAXXXXXXXXXXXXXGOOOXXXXXXXXXXXXXXXXGOOOOOOOOOXXXXXXXXXXGOOOXXXXXXXXXXXXXXXXGOOOOXXXXXXXXXXXXXXXGOOOOOOOOAOXXXXXXXXXGOOAXXXXXXXXXXXXXXXXGOOOOOOXXXXXXXXXXXXXGOOOOXXXXXXXXXXXXXXXGOOOOOOOOOXXXXXXXXXX,0,0,0
9639,87,3,84,140,113,0,0,272,77,195,GOOOXXXXXXXXXXXXXXXXGOOOOOOOXXXXXXXXXXXXGOOOOOOOXXXXXXXXXXXXGOOOOOAXXXXXXXXXXXXXGOOOXXXXXXXXXXXXXXXXGOOOOOOOOOXXXXXXXXXXGOOOXXXXXXXXXXXXXXXXGOOOOXXXXXXXXXXXXXXXGOOOOOOOOAOXXXXXXXXXGOOAXXXXXXXXXXXXXXXXGOOOOOOXXXXXXXXXXXXXGOOOOXXXXXXXXXXXXXXXGOOOOOOOOOXXXXXXXXXX,0,0,0

9660,87,2,85,133,120,0,0,277,77,200,GOOOXXXXXXXXXXXXXXXXGOOOOOOOXXXXXXXXXXXXGOOOOOOOXXXXXXXXXXXXGOOOOOAXXXXXXXXXXXXXGOOOXXXXXXXXXXXXXXXXGOOOOOOOOOXXXXXXXXXXGOOOXXXXXXXXXXXXXXXXGOOOOXXXXXXXXXXXXXXXGOOOOOOOOAOXXXXXXXXXGOOOXXXXXXXXXXXXXXXXGOOOOOOXXXXXXXXXXXXXGOOOOXXXXXXXXXXXXXXXGOOOOOOOOOXXXXXXXXXX,0,0,0
9681,87,2,85,135,118,0,0,278,82,196,GOOOXXXXXXXXXXXXXXXXGOOOOOOOXXXXXXXXXXXXGOOOOOOOXXXXXXXXXXXXGOOOOOAXXXXXXXXXXXXXGOOOXXXXXXXXXXXXXXXXGOOOOOOOOOXXXXXXXXXXGOOOXXXXXXXXXXXXXXXXGOOOOXXXXXXXXXXXXXXXGOOOOOOOOAOXXXXXXXXXGOOOXXXXXXXXXXXXXXXXGOOOOOOXXXXXXXXXXXXXGOOOOXXXXXXXXXXXXXXXGOOOOOOOOOXXXXXXXXXX,0,0,0
9702,87,1,86,131,122,0,0,281,82,199,GOOOXXXXXXXXXXXXXXXXGOOOOOOOXXXXXXXXXXXXGOOOOOOOXXXXXXXXXXXXGOOOOOAXXXXXXXXXXXXXGOOOXXXXXXXXXXXXXXXXGOOOOOOOOOXXXXXXXXXXGOOOXXXXXXXXXXXXXXXXGOOOOXXXXXXXXXXXXXXXGOOOOOOOOOOXXXXXXXXXGOOOXXXXXXXXXXXXXXXXGOOOOOOXXXXXXXXXXXXXGOOOOXXXXXXXXXXXXXXXGOOOOOOOOOXXXXXXXXXX,0,0,0
9723,87,1,86,129,124,0,0,284,85,199,GOOOXXXXXXXXXXXXXXXXGOOOOOOOXXXXXXXXXXXXGOOOOOOOXXXXXXXXXXXXGOOOOOAXXXXXXXXXXXXXGOOOXXXXXXXXXXXXXXXXGOOOOOOOOOXXXXXXXXXXGOOOXXXXXXXXXXXXXXXXGOOOOXXXXXXXXXXXXXXXGOOOOOOOOOOXXXXXXXXXGOOOXXXXXXXXXXXXXXXXGOOOOOOXXXXXXXXXXXXXGOOOOXXXXXXXXXXXXXXXGOOOOOOOOOXXXXXXXXXX,0,0,0
9744,87,1,86,132,121,0,0,281,83,198,GOOOXXXXXXXXXXXXXXXXGOOOOOOOXXXXXXXXXXXXGOOOOOOOXXXXXXXXXXXXGOOOOOAXXXXXXXXXXXXXGOOOXXXXXXXXXXXXXXXXGOOOOOOOOOXXXXXXXXXXGOOOXXXXXXXXXXXXXXXXGOOOOXXXXXXXXXXXXXXXGOOOOOOOOOOXXXXXXXXXGOOOXXXXXXXXXXXXXXXXGOOOOOOXXXXXXXXXXXXXGOOOOXXXXXXXXXXXXXXXGOOOOOOOOOXXXXXXXXXX,0,0,0

9765,87,0,87,128,125,0,0,284,84,200,GOOOXXXXXXXXXXXXXXXXGOOOOOOOXXXXXXXXXXXXGOOOOOOOXXXXXXXXXXXXGOOOOOOXXXXXXXXXXXXXGOOOXXXXXXXXXXXXXXXXGOOOOOOOOOXXXXXXXXXXGOOOXXXXXXXXXXXXXXXXGOOOOXXXXXXXXXXXXXXXGOOOOOOOOOOXXXXXXXXXGOOOXXXXXXXXXXXXXXXXGOOOOOOXXXXXXXXXXXXXGOOOOXXXXXXXXXXXXXXXGOOOOOOOOOXXXXXXXXXX,0,0,0
9786,87,0,87,133,120,0,0,281,82,199,GOOOXXXXXXXXXXXXXXXXGOOOOOOOXXXXXXXXXXXXGOOOOOOOXXXXXXXXXXXXGOOOOOOXXXXXXXXXXXXXGOOOXXXXXXXXXXXXXXXXGOOOOOOOOOXXXXXXXXXXGOOOXXXXXXXXXXXXXXXXGOOOOXXXXXXXXXXXXXXXGOOOOOOOOOOXXXXXXXXXGOOOXXXXXXXXXXXXXXXXGOOOOOOXXXXXXXXXXXXXGOOOOXXXXXXXXXXXXXXXGOOOOOOOOOXXXXXXXXXX,0,0,0
9807,87,0,87,132,121,0,0,282,84,198,GOOOXXXXXXXXXXXXXXXXGOOOOOOOXXXXXXXXXXXXGOOOOOOOXXXXXXXXXXXXGOOOOOOXXXXXXXXXXXXXGOOOXXXXXXXXXXXXXXXXGOOOOOOOOOXXXXXXXXXXGOOOXXXXXXXXXXXXXXXXGOOOOXXXXXXXXXXXXXXXGOOOOOOOOOOXXXXXXXXXGOOOXXXXXXXXXXXXXXXXGOOOOOOXXXXXXXXXXXXXGOOOOXXXXXXXXXXXXXXXGOOOOOOOOOXXXXXXXXXX,0,0,0
9828,87,0,87,133,120,0,0,277,92,185,GOOOXXXXXXXXXXXXXXXXGOOOOOOOXXXXXXXXXXXXGOOOOOOOXXXXXXXXXXXXGOOOOOOXXXXXXXXXXXXXGOOOXXXXXXXXXXXXXXXXGOOOOOOOOOXXXXXXXXXXGOOOXXXXXXXXXXXXXXXXGOOOOXXXXXXXXXXXXXXXGOOOOOOOOOOXXXXXXXXXGOOOXXXXXXXXXXXXXXXXGOOOOOOXXXXXXXXXXXXXGOOOOXXXXXXXXXXXXXXXGOOOOOOOOOXXXXXXXXXX,0,0,0
9849,87,0,87,137,116,0,0,277,89,188,GOOOXXXXXXXXXXXXXXXXGOOOOOOOXXXXXXXXXXXXGOOOOOOOXXXXXXXXXXXXGOOOOOOXXXXXXXXXXXXXGOOOXXXXXXXXXXXXXXXXGOOOOOOOOOXXXXXXXXXXGOOOXXXXXXXXXXXXXXXXGOOOOXXXXXXXXXXXXXXXGOOOOOOOOOOXXXXXXXXXGOOOXXXXXXXXXXXXXXXXGOOOOOOXXXXXXXXXXXXXGOOOOXXXXXXXXXXXXXXXGOOOOOOOOOXXXXXXXXXX,0,0,0

9870,87,0,87,132,121,0,0,282,89,193,GOOOXXXXXXXXXXXXXXXXGOOOOOOOXXXXXXXXXXXXGOOOOOOOXXXXXXXXXXXXGOOOOOOXXXXXXXXXXXXXGOOOXXXXXXXXXXXXXXXXGOOOOOOOOOXXXXXXXXXXGOOOXXXXXXXXXXXXXXXXGOOOOXXXXXXXXXXXXXXXGOOOOOOOOOOXXXXXXXXXGOOOXXXXXXXXXXXXXXXXGOOOOOOXXXXXXXXXXXXXGOOOOXXXXXXXXXXXXXXXGOOOOOOOOOXXXXXXXXXX,0,0,0
9891,87,0,87,130,123,0,0,283,88,195,GOOOXXXXXXXXXXXXXXXXGOOOOOOOXXXXXXXXXXXXGOOOOOOOXXXXXXXXXXXXGOOOOOOXXXXXXXXXXXXXGOOOXXXXXXXXXXXXXXXXGOOOOOOOOOXXXXXXXXXXGOOOXXXXXXXXXXXXXXXXGOOOOXXXXXXXXXXXXXXXGOOOOOOOOOOXXXXXXXXXGOOOXXXXXXXXXXXXXXXXGOOOOOOXXXXXXXXXXXXXGOOOOXXXXXXXXXXXXXXXGOOOOOOOOOXXXXXXXXXX,0,0,0
9912,87,0,87,133,120,0,0,281,83,198,GOOOXXXXXXXXXXXXXXXXGOOOOOOOXXXXXXXXXXXXGOOOOOOOXXXXXXXXXXXXGOOOOOOXXXXXXXXXXXXXGOOOXXXXXXXXXXXXXXXXGOOOOOOOOOXXXXXXXXXXGOOOXXXXXXXXXXXXXXXXGOOOOXXXXXXXXXXXXXXXGOOOOOOOOOOXXXXXXXXXGOOOXXXXXXXXXXXXXXXXGOOOOOOXXXXXXXXXXXXXGOOOOXXXXXXXXXXXXXXXGOOOOOOOOOXXXXXXXXXX,0,0,0
9933,87,0,87,127,126,0,0,287,80,207,GOOOXXXXXXXXXXXXXXXXGOOOOOOOXXXXXXXXXXXXGOOOOOOOXXXXXXXXXXXXGOOOOOOXXXXXXXXXXXXXGOOOXXXXXXXXXXXXXXXXGOOOOOOOOOXXXXXXXXXXGOOOXXXXXXXXXXXXXXXXGOOOOXXXXXXXXXXXXXXXGOOOOOOOOOOXXXXXXXXXGOOOXXXXXXXXXXXXXXXXGOOOOOOXXXXXXXXXXXXXGOOOOXXXXXXXXXXXXXXXGOOOOOOOOOXXXXXXXXXX,0,0,0
9954,87,0,87,124,129,0,0,288,81,207,GOOOXXXXXXXXXXXXXXXXGOOOOOOOXXXXXXXXXXXXGOOOOOOOXXXXXXXXXXXXGOOOOOOXXXXXXXXXXXXXGOOOXXXXXXXXXXXXXXXXGOOOOOOOOOXXXXXXXXXXGOOOXXXXXXXXXXXXXXXXGOOOOXXXXXXXXXXXXXXXGOOOOOOOOOOXXXXXXXXXGOOOXXXXXXXXXXXXXXXXGOOOOOOXXXXXXXXXXXXXGOOOOXXXXXXXXXXXXXXXGOOOOOOOOOXXXXXXXXXX,0,0,0

9975,87,0,87,122,131,0,0,291,80,211,GOOOXXXXXXXXXXXXXXXXGOOOOOOOXXXXXXXXXXXXGOOOOOOOXXXXXXXXXXXXGOOOOOOXXXXXXXXXXXXXGOOOXXXXXXXXXXXXXXXXGOOOOOOOOOXXXXXXXXXXGOOOXXXXXXXXXXXXXXXXGOOOOXXXXXXXXXXXXXXXGOOOOOOOOOOXXXXXXXXXGOOOXXXXXXXXXXXXXXXXGOOOOOOXXXXXXXXXXXXXGOOOOXXXXXXXXXXXXXXXGOOOOOOOOOXXXXXXXXXX,0,0,0
9996,87,0,87,118,135,0,0,295,90,205,GOOOXXXXXXXXXXXXXXXXGOOOOOOOXXXXXXXXXXXXGOOOOOOOXXXXXXXXXXXXGOOOOOOXXXXXXXXXXXXXGOOOXXXXXXXXXXXXXXXXGOOOOOOOOOXXXXXXXXXXGOOOXXXXXXXXXXXXXXXXGOOOOXXXXXXXXXXXXXXXGOOOOOOOOOOXXXXXXXXXGOOOXXXXXXXXXXXXXXXXGOOOOOOXXXXXXXXXXXXXGOOOOXXXXXXXXXXXXXXXGOOOOOOOOOXXXXXXXXXX,0,0,0
10017,87,0,87,124,129,0,0,289,93,196,GOOOXXXXXXXXXXXXXXXXGOOOOOOOXXXXXXXXXXXXGOOOOOOOXXXXXXXXXXXXGOOOOOOXXXXXXXXXXXXXGOOOXXXXXXXXXXXXXXXXGOOOOOOOOOXXXXXXXXXXGOOOXXXXXXXXXXXXXXXXGOOOOXXXXXXXXXXXXXXXGOOOOOOOOOOXXXXXXXXXGOOOXXXXXXXXXXXXXXXXGOOOOOOXXXXXXXXXXXXXGOOOOXXXXXXXXXXXXXXXGOOOOOOOOOXXXXXXXXXX,0,0,0
10038,87,0,87,129,124,0,0,282,86,196,GOOOXXXXXXXXXXXXXXXXGOOOOOOOXXXXXXXXXXXXGOOOOOOOXXXXXXXXXXXXGOOOOOOXXXXXXXXXXXXXGOOOXXXXXXXXXXXXXXXXGOOOOOOOOOXXXXXXXXXXGOOOXXXXXXXXXXXXXXXXGOOOOXXXXXXXXXXXXXXXGOOOOOOOOOOXXXXXXXXXGOOOXXXXXXXXXXXXXXXXGOOOOOOXXXXXXXXXXXXXGOOOOXXXXXXXXXXXXXXXGOOOOOOOOOXXXXXXXXXX,0,0,0
10059,87,0,87,133,120,0,0,280,83,197,GOOOXXXXXXXXXXXXXXXXGOOOOOOOXXXXXXXXXXXXGOOOOOOOXXXXXXXXXXXXGOOOOOOXXXXXXXXXXXXXGOOOXXXXXXXXXXXXXXXXGOOOOOOOOOXXXXXXXXXXGOOOXXXXXXXXXXXXXXXXGOOOOXXXXXXXXXXXXXXXGOOOOOOOOOOXXXXXXXXXGOOOXXXXXXXXXXXXXXXXGOOOOOOXXXXXXXXXXXXXGOOOOXXXXXXXXXXXXXXXGOOOOOOOOOXXXXXXXXXX,0,0,0

10080,87,0,87,131,122,0,0,281,78,203,GOOOXXXXXXXXXXXXXXXXGOOOOOOOXXXXXXXXXXXXGOOOOOOOXXXXXXXXXXXXGOOOOOOXXXXXXXXXXXXXGOOOXXXXXXXXXXXXXXXXGOOOOOOOOOXXXXXXXXXXGOOOXXXXXXXXXXXXXXXXGOOOOXXXXXXXXXXXXXXXGOOOOOOOOOOXXXXXXXXXGOOOXXXXXXXXXXXXXXXXGOOOOOOXXXXXXXXXXXXXGOOOOXXXXXXXXXXXXXXXGOOOOOOOOOXXXXXXXXXX,0,0,0
10101,87,0,87,123,130,0,0,288,83,205,GOOOXXXXXXXXXXXXXXXXGOOOOOOOXXXXXXXXXXXXGOOOOOOOXXXXXXXXXXXXGOOOOOOXXXXXXXXXXXXXGOOOXXXXXXXXXXXXXXXXGOOOOOOOOOXXXXXXXXXXGOOOXXXXXXXXXXXXXXXXGOOOOXXXXXXXXXXXXXXXGOOOOOOOOOOXXXXXXXXXGOOOXXXXXXXXXXXXXXXXGOOOOOOXXXXXXXXXXXXXGOOOOXXXXXXXXXXXXXXXGOOOOOOOOOXXXXXXXXXX,0,0,0
10122,87,0,87,123,130,0,0,290,88,202,GOOOXXXXXXXXXXXXXXXXGOOOOOOOXXXXXXXXXXXXGOOOOOOOXXXXXXXXXXXXGOOOOOOXXXXXXXXXXXXXGOOOXXXXXXXXXXXXXXXXGOOOOOOOOOXXXXXXXXXXGOOOXXXXXXXXXXXXXXXXGOOOOXXXXXXXXXXXXXXXGOOOOOOOOOOXXXXXXXXXGOOOXXXXXXXXXXXXXXXXGOOOOOOXXXXXXXXXXXXXGOOOOXXXXXXXXXXXXXXXGOOOOOOOOOXXXXXXXXXX,0,0,0
10143,87,0,87,127,126,0,0,285,88,197,GOOOXXXXXXXXXXXXXXXXGOOOOOOOXXXXXXXXXXXXGOOOOOOOXXXXXXXXXXXXGOOOOOOXXXXXXXXXXXXXGOOOXXXXXXXXXXXXXXXXGOOOOOOOOOXXXXXXXXXXGOOOXXXXXXXXXXXXXXXXGOOOOXXXXXXXXXXXXXXXGOOOOOOOOOOXXXXXXXXXGOOOXXXXXXXXXXXXXXXXGOOOOOOXXXXXXXXXXXXXGOOOOXXXXXXXXXXXXXXXGOOOOOOOOOXXXXXXXXXX,0,0,0
10164,87,0,87,123,130,0,0,289,97,192,GOOOXXXXXXXXXXXXXXXXGOOOOOOOXXXXXXXXXXXXGOOOOOOOXXXXXXXXXXXXGOOOOOOXXXXXXXXXXXXXGOOOXXXXXXXXXXXXXXXXGOOOOOOOOOXXXXXXXXXXGOOOXXXXXXXXXXXXXXXXGOOOOXXXXXXXXXXXXXXXGOOOOOOOOOOXXXXXXXXXGOOOXXXXXXXXXXXXXXXXGOOOOOOXXXXXXXXXXXXXGOOOOXXXXXXXXXXXXXXXGOOOOOOOOOXXXXXXXXXX,0,0,0

10185,87,0,87,125,128,0,0,288,96,192,GOOOXXXXXXXXXXXXXXXXGOOOOOOOXXXXXXXXXXXXGOOOOOOOXXXXXXXXXXXXGOOOOOOXXXXXXXXXXXXXGOOOXXXXXXXXXXXXXXXXGOOOOOOOOOXXXXXXXXXXGOOOXXXXXXXXXXXXXXXXGOOOOXXXXXXXXXXXXXXXGOOOOOOOOOOXXXXXXXXXGOOOXXXXXXXXXXXXXXXXGOOOOOOXXXXXXXXXXXXXGOOOOXXXXXXXXXXXXXXXGOOOOOOOOOXXXXXXXXXX,0,0,0
10206,87,0,87,127,126,0,0,285,92,193,GOOOXXXXXXXXXXXXXXXXGOOOOOOOXXXXXXXXXXXXGOOOOOOOXXXXXXXXXXXXGOOOOOOXXXXXXXXXXXXXGOOOXXXXXXXXXXXXXXXXGOOOOOOOOOXXXXXXXXXXGOOOXXXXXXXXXXXXXXXXGOOOOXXXXXXXXXXXXXXXGOOOOOOOOOOXXXXXXXXXGOOOXXXXXXXXXXXXXXXXGOOOOOOXXXXXXXXXXXXXGOOOOXXXXXXXXXXXXXXXGOOOOOOOOOXXXXXXXXXX,0,0,0
10227,87,0,87,128,125,0,0,285,93,192,GOOOXXXXXXXXXXXXXXXXGOOOOOOOXXXXXXXXXXXXGOOOOOOOXXXXXXXXXXXXGOOOOOOXXXXXXXXXXXXXGOOOXXXXXXXXXXXXXXXXGOOOOOOOOOXXXXXXXXXXGOOOXXXXXXXXXXXXXXXXGOOOOXXXXXXXXXXXXXXXGOOOOOOOOOOXXXXXXXXXGOOOXXXXXXXXXXXXXXXXGOOOOOOXXXXXXXXXXXXXGOOOOXXXXXXXXXXXXXXXGOOOOOOOOOXXXXXXXXXX,0,0,0
10248,88,1,87,133,119,0,0,279,87,192,GOOOXXXXXXXXXXXXXXXXGOOOOOOOXXXXXXXXXXXXGOOOOOOOXXXXXXXXXXXXGOOOOOOXXXXXXXXXXXXXGOOOXXXXXXXXXXXXXXXXGOOOOOOOOOXXXXXXXXXXGOOOXXXXXXXXXXXXXXXXGOOOOXXXXXXXXXXXXXXXGOOOOOOOOOOAXXXXXXXXGOOOXXXXXXXXXXXXXXXXGOOOOOOXXXXXXXXXXXXXGOOOOXXXXXXXXXXXXXXXGOOOOOOOOOXXXXXXXXXX,0,0,0
10269,89,2,87,125,126,0,0,286,80,206,GOOOXXXXXXXXXXXXXXXXGOOOOOOOXXXXXXXXXXXXGOOOOOOOXXXXXXXXXXXXGOOOOOOAXXXXXXXXXXXXGOOOXXXXXXXXXXXXXXXXGOOOOOOOOOXXXXXXXXXXGOOOXXXXXXXXXXXXXXXXGOOOOXXXXXXXXXXXXXXXGOOOOOOOOOOAXXXXXXXXGOOOXXXXXXXXXXXXXXXXGOOOOOOXXXXXXXXXXXXXGOOOOXXXXXXXXXXXXXXXGOOOOOOOOOXXXXXXXXXX,0,0,0

10290,89,2,87,121,130,0,0,290,88,202,GOOOXXXXXXXXXXXXXXXXGOOOOOOOXXXXXXXXXXXXGOOOOOOOXXXXXXXXXXXXGOOOOOOAXXXXXXXXXXXXGOOOXXXXXXXXXXXXXXXXGOOOOOOOOOXXXXXXXXXXGOOOXXXXXXXXXXXXXXXXGOOOOXXXXXXXXXXXXXXXGOOOOOOOOOOAXXXXXXXXGOOOXXXXXXXXXXXXXXXXGOOOOOOXXXXXXXXXXXXXGOOOOXXXXXXXXXXXXXXXGOOOOOOOOOXXXXXXXXXX,0,0,0
10311,89,1,88,126,125,0,0,285,91,194,GOOOXXXXXXXXXXXXXXXXGOOOOOOOXXXXXXXXXXXXGOOOOOOOXXXXXXXXXXXXGOOOOOOOXXXXXXXXXXXXGOOOXXXXXXXXXXXXXXXXGOOOOOOOOOXXXXXXXXXXGOOOXXXXXXXXXXXXXXXXGOOOOXXXXXXXXXXXXXXXGOOOOOOOOOOAXXXXXXXXGOOOXXXXXXXXXXXXXXXXGOOOOOOXXXXXXXXXXXXXGOOOOXXXXXXXXXXXXXXXGOOOOOOOOOXXXXXXXXXX,0,0,0
10332,89,1,88,123,128,0,0,287,90,197,GOOOXXXXXXXXXXXXXXXXGOOOOOOOXXXXXXXXXXXXGOOOOOOOXXXXXXXXXXXXGOOOOOOOXXXXXXXXXXXXGOOOXXXXXXXXXXXXXXXXGOOOOOOOOOXXXXXXXXXXGOOOXXXXXXXXXXXXXXXXGOOOOXXXXXXXXXXXXXXXGOOOOOOOOOOAXXXXXXXXGOOOXXXXXXXXXXXXXXXXGOOOOOOXXXXXXXXXXXXXGOOOOXXXXXXXXXXXXXXXGOOOOOOOOOXXXXXXXXXX,0,0,0
10353,89,1,88,130,121,0,0,281,86,195,GOOOXXXXXXXXXXXXXXXXGOOOOOOOXXXXXXXXXXXXGOOOOOOOXXXXXXXXXXXXGOOOOOOOXXXXXXXXXXXXGOOOXXXXXXXXXXXXXXXXGOOOOOOOOOXXXXXXXXXXGOOOXXXXXXXXXXXXXXXXGOOOOXXXXXXXXXXXXXXXGOOOOOOOOOOAXXXXXXXXGOOOXXXXXXXXXXXXXXXXGOOOOOOXXXXXXXXXXXXXGOOOOXXXXXXXXXXXXXXXGOOOOOOOOOXXXXXXXXXX,0,0,0
10374,89,1,88,133,118,0,0,278,85,193,GOOOXXXXXXXXXXXXXXXXGOOOOOOOXXXXXXXXXXXXGOOOOOOOXXXXXXXXXXXXGOOOOOOOXXXXXXXXXXXXGOOOXXXXXXXXXXXXXXXXGOOOOOOOOOXXXXXXXXXXGOOOXXXXXXXXXXXXXXXXGOOOOXXXXXXXXXXXXXXXGOOOOOOOOOOAXXXXXXXXGOOOXXXXXXXXXXXXXXXXGOOOOOOXXXXXXXXXXXXXGOOOOXXXXXXXXXXXXXXXGOOOOOOOOOXXXXXXXXXX,0,0,0

10395,89,1,88,125,126,0,0,285,85,200,GOOOXXXXXXXXXXXXXXXXGOOOOOOOXXXXXXXXXXXXGOOOOOOOXXXXXXXXXXXXGOOOOOOOXXXXXXXXXXXXGOOOXXXXXXXXXXXXXXXXGOOOOOOOOOXXXXXXXXXXGOOOXXXXXXXXXXXXXXXXGOOOOXXXXXXXXXXXXXXXGOOOOOOOOOOAXXXXXXXXGOOOXXXXXXXXXXXXXXXXGOOOOOOXXXXXXXXXXXXXGOOOOXXXXXXXXXXXXXXXGOOOOOOOOOXXXXXXXXXX,0,0,0
10416,90,1,89,123,127,0,0,286,88,198,GOOOXXXXXXXXXXXXXXXXGOOOOOOOXXXXXXXXXXXXGOOOOOOOXXXXXXXXXXXXGOOOOOOOXXXXXXXXXXXXGOOOXXXXXXXXXXXXXXXXGOOOOOOOOOXXXXXXXXXXGOOOXXXXXXXXXXXXXXXXGOOOOAXXXXXXXXXXXXXXGOOOOOOOOOOOXXXXXXXXGOOOXXXXXXXXXXXXXXXXGOOOOOOXXXXXXXXXXXXXGOOOOXXXXXXXXXXXXXXXGOOOOOOOOOXXXXXXXXXX,0,0,0
10437,90,1,89,125,125,0,0,284,80,204,GOOOXXXXXXXXXXXXXXXXGOOOOOOOXXXXXXXXXXXXGOOOOOOOXXXXXXXXXXXXGOOOOOOOXXXXXXXXXXXXGOOOXXXXXXXXXXXXXXXXGOOOOOOOOOXXXXXXXXXXGOOOXXXXXXXXXXXXXXXXGOOOOAXXXXXXXXXXXXXXGOOOOOOOOOOOXXXXXXXXGOOOXXXXXXXXXXXXXXXXGOOOOOOXXXXXXXXXXXXXGOOOOXXXXXXXXXXXXXXXGOOOOOOOOOXXXXXXXXXX,0,0,0
10458,90,1,89,128,122,0,0,282,78,204,GOOOXXXXXXXXXXXXXXXXGOOOOOOOXXXXXXXXXXXXGOOOOOOOXXXXXXXXXXXXGOOOOOOOXXXXXXXXXXXXGOOOXXXXXXXXXXXXXXXXGOOOOOOOOOXXXXXXXXXXGOOOXXXXXXXXXXXXXXXXGOOOOAXXXXXXXXXXXXXXGOOOOOOOOOOOXXXXXXXXGOOOXXXXXXXXXXXXXXXXGOOOOOOXXXXXXXXXXXXXGOOOOXXXXXXXXXXXXXXXGOOOOOOOOOXXXXXXXXXX,0,0,0
10479,90,1,89,130,120,0,0,280,78,202,GOOOXXXXXXXXXXXXXXXXGOOOOOOOXXXXXXXXXXXXGOOOOOOOXXXXXXXXXXXXGOOOOOOOXXXXXXXXXXXXGOOOXXXXXXXXXXXXXXXXGOOOOOOOOOXXXXXXXXXXGOOOXXXXXXXXXXXXXXXXGOOOOAXXXXXXXXXXXXXXGOOOOOOOOOOOXXXXXXXXGOOOXXXXXXXXXXXXXXXXGOOOOOOXXXXXXXXXXXXXGOOOOXXXXXXXXXXXXXXXGOOOOOOOOOXXXXXXXXXX,0,0,0

10500,90,1,89,133,117,0,0,277,85,192,GOOOXXXXXXXXXXXXXXXXGOOOOOOOXXXXXXXXXXXXGOOOOOOOXXXXXXXXXXXXGOOOOOOOXXXXXXXXXXXXGOOOXXXXXXXXXXXXXXXXGOOOOOOOOOXXXXXXXXXXGOOOXXXXXXXXXXXXXXXXGOOOOAXXXXXXXXXXXXXXGOOOOOOOOOOOXXXXXXXXGOOOXXXXXXXXXXXXXXXXGOOOOOOXXXXXXXXXXXXXGOOOOXXXXXXXXXXXXXXXGOOOOOOOOOXXXXXXXXXX,0,0,0
10521,90,1,89,130,120,0,0,278,99,179,GOOOXXXXXXXXXXXXXXXXGOOOOOOOXXXXXXXXXXXXGOOOOOOOXXXXXXXXXXXXGOOOOOOOXXXXXXXXXXXXGOOOXXXXXXXXXXXXXXXXGOOOOOOOOOXXXXXXXXXXGOOOXXXXXXXXXXXXXXXXGOOOOAXXXXXXXXXXXXXXGOOOOOOOOOOOXXXXXXXXGOOOXXXXXXXXXXXXXXXXGOOOOOOXXXXXXXXXXXXXGOOOOXXXXXXXXXXXXXXXGOOOOOOOOOXXXXXXXXXX,0,0,0
10542,90,1,89,135,115,0,0,275,91,184,GOOOXXXXXXXXXXXXXXXXGOOOOOOOXXXXXXXXXXXXGOOOOOOOXXXXXXXXXXXXGOOOOOOOXXXXXXXXXXXXGOOOXXXXXXXXXXXXXXXXGOOOOOOOOOXXXXXXXXXXGOOOXXXXXXXXXXXXXXXXGOOOOAXXXXXXXXXXXXXXGOOOOOOOOOOOXXXXXXXXGOOOXXXXXXXXXXXXXXXXGOOOOOOXXXXXXXXXXXXXGOOOOXXXXXXXXXXXXXXXGOOOOOOOOOXXXXXXXXXX,0,0,0
10563,90,1,89,130,120,0,0,279,98,181,GOOOXXXXXXXXXXXXXXXXGOOOOOOOXXXXXXXXXXXXGOOOOOOOXXXXXXXXXXXXGOOOOOOOXXXXXXXXXXXXGOOOXXXXXXXXXXXXXXXXGOOOOOOOOOXXXXXXXXXXGOOOXXXXXXXXXXXXXXXXGOOOOAXXXXXXXXXXXXXXGOOOOOOOOOOOXXXXXXXXGOOOXXXXXXXXXXXXXXXXGOOOOOOXXXXXXXXXXXXXGOOOOXXXXXXXXXXXXXXXGOOOOOOOOOXXXXXXXXXX,0,0,0
10584,90,0,90,131,119,0,0,279,97,182,GOOOXXXXXXXXXXXXXXXXGOOOOOOOXXXXXXXXXXXXGOOOOOOOXXXXXXXXXXXXGOOOOOOOXXXXXXXXXXXXGOOOXXXXXXXXXXXXXXXXGOOOOOOOOOXXXXXXXXXXGOOOXXXXXXXXXXXXXXXXGOOOOOXXXXXXXXXXXXXXGOOOOOOOOOOOXXXXXXXXGOOOXXXXXXXXXXXXXXXXGOOOOOOXXXXXXXXXXXXXGOOOOXXXXXXXXXXXXXXXGOOOOOOOOOXXXXXXXXXX,0,0,0

10605,90,0,90,125,125,0,0,285,96,189,GOOOXXXXXXXXXXXXXXXXGOOOOOOOXXXXXXXXXXXXGOOOOOOOXXXXXXXXXXXXGOOOOOOOXXXXXXXXXXXXGOOOXXXXXXXXXXXXXXXXGOOOOOOOOOXXXXXXXXXXGOOOXXXXXXXXXXXXXXXXGOOOOOXXXXXXXXXXXXXXGOOOOOOOOOOOXXXXXXXXGOOOXXXXXXXXXXXXXXXXGOOOOOOXXXXXXXXXXXXXGOOOOXXXXXXXXXXXXXXXGOOOOOOOOOXXXXXXXXXX,0,0,0
10626,90,0,90,124,126,0,0,286,92,194,GOOOXXXXXXXXXXXXXXXXGOOOOOOOXXXXXXXXXXXXGOOOOOOOXXXXXXXXXXXXGOOOOOOOXXXXXXXXXXXXGOOOXXXXXXXXXXXXXXXXGOOOOOOOOOXXXXXXXXXXGOOOXXXXXXXXXXXXXXXXGOOOOOXXXXXXXXXXXXXXGOOOOOOOOOOOXXXXXXXXGOOOXXXXXXXXXXXXXXXXGOOOOOOXXXXXXXXXXXXXGOOOOXXXXXXXXXXXXXXXGOOOOOOOOOXXXXXXXXXX,0,0,0
10647,90,0,90,127,123,0,0,283,90,193,GOOOXXXXXXXXXXXXXXXXGOOOOOOOXXXXXXXXXXXXGOOOOOOOXXXXXXXXXXXXGOOOOOOOXXXXXXXXXXXXGOOOXXXXXXXXXXXXXXXXGOOOOOOOOOXXXXXXXXXXGOOOXXXXXXXXXXXXXXXXGOOOOOXXXXXXXXXXXXXXGOOOOOOOOOOOXXXXXXXXGOOOXXXXXXXXXXXXXXXXGOOOOOOXXXXXXXXXXXXXGOOOOXXXXXXXXXXXXXXXGOOOOOOOOOXXXXXXXXXX,0,0,0
10668,90,0,90,129,121,0,0,281,94,187,GOOOXXXXXXXXXXXXXXXXGOOOOOOOXXXXXXXXXXXXGOOOOOOOXXXXXXXXXXXXGOOOOOOOXXXXXXXXXXXXGOOOXXXXXXXXXXXXXXXXGOOOOOOOOOXXXXXXXXXXGOOOXXXXXXXXXXXXXXXXGOOOOOXXXXXXXXXXXXXXGOOOOOOOOOOOXXXXXXXXGOOOXXXXXXXXXXXXXXXXGOOOOOOXXXXXXXXXXXXXGOOOOXXXXXXXXXXXXXXXGOOOOOOOOOXXXXXXXXXX,0,0,0
10689,90,0,90,136,114,0,0,273,95,178,GOOOXXXXXXXXXXXXXXXXGOOOOOOOXXXXXXXXXXXXGOOOOOOOXXXXXXXXXXXXGOOOOOOOXXXXXXXXXXXXGOOOXXXXXXXXXXXXXXXXGOOOOOOOOOXXXXXXXXXXGOOOXXXXXXXXXXXXXXXXGOOOOOXXXXXXXXXXXXXXGOOOOOOOOOOOXXXXXXXXGOOOXXXXXXXXXXXXXXXXGOOOOOOXXXXXXXXXXXXXGOOOOXXXXXXXXXXXXXXXGOOOOOOOOOXXXXXXXXXX,0,0,0

10710,90,0,90,142,108,0,0,267,82,185,GOOOXXXXXXXXXXXXXXXXGOOOOOOOXXXXXXXXXXXXGOOOOOOOXXXXXXXXXXXXGOOOOOOOXXXXXXXXXXXXGOOOXXXXXXXXXXXXXXXXGOOOOOOOOOXXXXXXXXXXGOOOXXXXXXXXXXXXXXXXGOOOOOXXXXXXXXXXXXXXGOOOOOOOOOOOXXXXXXXXGOOOXXXXXXXXXXXXXXXXGOOOOOOXXXXXXXXXXXXXGOOOOXXXXXXXXXXXXXXXGOOOOOOOOOXXXXXXXXXX,0,0,0
10731,90,0,90,138,112,0,0,271,88,183,GOOOXXXXXXXXXXXXXXXXGOOOOOOOXXXXXXXXXXXXGOOOOOOOXXXXXXXXXXXXGOOOOOOOXXXXXXXXXXXXGOOOXXXXXXXXXXXXXXXXGOOOOOOOOOXXXXXXXXXXGOOOXXXXXXXXXXXXXXXXGOOOOOXXXXXXXXXXXXXXGOOOOOOOOOOOXXXXXXXXGOOOXXXXXXXXXXXXXXXXGOOOOOOXXXXXXXXXXXXXGOOOOXXXXXXXXXXXXXXXGOOOOOOOOOXXXXXXXXXX,0,0,0
10752,91,1,90,139,110,0,0,269,87,182,GOOOXXXXXXXXXXXXXXXXGOOOOOOOXXXXXXXXXXXXGOOOOOOOAXXXXXXXXXXXGOOOOOOOXXXXXXXXXXXXGOOOXXXXXXXXXXXXXXXXGOOOOOOOOOXXXXXXXXXXGOOOXXXXXXXXXXXXXXXXGOOOOOXXXXXXXXXXXXXXGOOOOOOOOOOOXXXXXXXXGOOOXXXXXXXXXXXXXXXXGOOOOOOXXXXXXXXXXXXXGOOOOXXXXXXXXXXXXXXXGOOOOOOOOOXXXXXXXXXX,0,0,0
10773,91,1,90,141,108,0,0,268,90,178,GOOOXXXXXXXXXXXXXXXXGOOOOOOOXXXXXXXXXXXXGOOOOOOOAXXXXXXXXXXXGOOOOOOOXXXXXXXXXXXXGOOOXXXXXXXXXXXXXXXXGOOOOOOOOOXXXXXXXXXXGOOOXXXXXXXXXXXXXXXXGOOOOOXXXXXXXXXXXXXXGOOOOOOOOOOOXXXXXXXXGOOOXXXXXXXXXXXXXXXXGOOOOOOXXXXXXXXXXXXXGOOOOXXXXXXXXXXXXXXXGOOOOOOOOOXXXXXXXXXX,0,0,0
10794,91,1,90,142,107,0,0,266,86,180,GOOOXXXXXXXXXXXXXXXXGOOOOOOOXXXXXXXXXXXXGOOOOOOOAXXXXXXXXXXXGOOOOOOOXXXXXXXXXXXXGOOOXXXXXXXXXXXXXXXXGOOOOOOOOOXXXXXXXXXXGOOOXXXXXXXXXXXXXXXXGOOOOOXXXXXXXXXXXXXXGOOOOOOOOOOOXXXXXXXXGOOOXXXXXXXXXXXXXXXXGOOOOOOXXXXXXXXXXXXXGOOOOXXXXXXXXXXXXXXXGOOOOOOOOOXXXXXXXXXX,0,0,0

10815,91,1,90,143,106,0,0,266,86,180,GOOOXXXXXXXXXXXXXXXXGOOOOOOOXXXXXXXXXXXXGOOOOOOOAXXXXXXXXXXXGOOOOOOOXXXXXXXXXXXXGOOOXXXXXXXXXXXXXXXXGOOOOOOOOOXXXXXXXXXXGOOOXXXXXXXXXXXXXXXXGOOOOOXXXXXXXXXXXXXXGOOOOOOOOOOOXXXXXXXXGOOOXXXXXXXXXXXXXXXXGOOOOOOXXXXXXXXXXXXXGOOOOXXXXXXXXXXXXXXXGOOOOOOOOOXXXXXXXXXX,0,0,0
10836,91,1,90,142,107,0,0,268,95,173,GOOOXXXXXXXXXXXXXXXXGOOOOOOOXXXXXXXXXXXXGOOOOOOOAXXXXXXXXXXXGOOOOOOOXXXXXXXXXXXXGOOOXXXXXXXXXXXXXXXXGOOOOOOOOOXXXXXXXXXXGOOOXXXXXXXXXXXXXXXXGOOOOOXXXXXXXXXXXXXXGOOOOOOOOOOOXXXXXXXXGOOOXXXXXXXXXXXXXXXXGOOOOOOXXXXXXXXXXXXXGOOOOXXXXXXXXXXXXXXXGOOOOOOOOOXXXXXXXXXX,0,0,0
10857,91,1,90,136,113,0,0,274,93,181,GOOOXXXXXXXXXXXXXXXXGOOOOOOOXXXXXXXXXXXXGOOOOOOOAXXXXXXXXXXXGOOOOOOOXXXXXXXXXXXXGOOOXXXXXXXXXXXXXXXXGOOOOOOOOOXXXXXXXXXXGOOOXXXXXXXXXXXXXXXXGOOOOOXXXXXXXXXXXXXXGOOOOOOOOOOOXXXXXXXXGOOOXXXXXXXXXXXXXXXXGOOOOOOXXXXXXXXXXXXXGOOOOXXXXXXXXXXXXXXXGOOOOOOOOOXXXXXXXXXX,0,0,0
10878,91,1,90,140,109,0,0,269,95,174,GOOOXXXXXXXXXXXXXXXXGOOOOOOOXXXXXXXXXXXXGOOOOOOOAXXXXXXXXXXXGOOOOOOOXXXXXXXXXXXXGOOOXXXXXXXXXXXXXXXXGOOOOOOOOOXXXXXXXXXXGOOOXXXXXXXXXXXXXXXXGOOOOOXXXXXXXXXXXXXXGOOOOOOOOOOOXXXXXXXXGOOOXXXXXXXXXXXXXXXXGOOOOOOXXXXXXXXXXXXXGOOOOXXXXXXXXXXXXXXXGOOOOOOOOOXXXXXXXXXX,0,0,0
10899,91,1,90,143,106,0,0,267,95,172,GOOOXXXXXXXXXXXXXXXXGOOOOOOOXXXXXXXXXXXXGOOOOOOOAXXXXXXXXXXXGOOOOOOOXXXXXXXXXXXXGOOOXXXXXXXXXXXXXXXXGOOOOOOOOOXXXXXXXXXXGOOOXXXXXXXXXXXXXXXXGOOOOOXXXXXXXXXXXXXXGOOOOOOOOOOOXXXXXXXXGOOOXXXXXXXXXXXXXXXXGOOOOOOXXXXXXXXXXXXXGOOOOXXXXXXXXXXXXXXXGOOOOOOOOOXXXXXXXXXX,0,0,0

10920,91,1,90,141,108,0,0,268,96,172,GOOOXXXXXXXXXXXXXXXXGOOOOOOOXXXXXXXXXXXXGOOOOOOOAXXXXXXXXXXXGOOOOOOOXXXXXXXXXXXXGOOOXXXXXXXXXXXXXXXXGOOOOOOOOOXXXXXXXXXXGOOOXXXXXXXXXXXXXXXXGOOOOOXXXXXXXXXXXXXXGOOOOOOOOOOOXXXXXXXXGOOOXXXXXXXXXXXXXXXXGOOOOOOXXXXXXXXXXXXXGOOOOXXXXXXXXXXXXXXXGOOOOOOOOOXXXXXXXXXX,0,0,0
10941,91,1,90,134,115,0,0,276,101,175,GOOOXXXXXXXXXXXXXXXXGOOOOOOOXXXXXXXXXXXXGOOOOOOOAXXXXXXXXXXXGOOOOOOOXXXXXXXXXXXXGOOOXXXXXXXXXXXXXXXXGOOOOOOOOOXXXXXXXXXXGOOOXXXXXXXXXXXXXXXXGOOOOOXXXXXXXXXXXXXXGOOOOOOOOOOOXXXXXXXXGOOOXXXXXXXXXXXXXXXXGOOOOOOXXXXXXXXXXXXXGOOOOXXXXXXXXXXXXXXXGOOOOOOOOOXXXXXXXXXX,0,0,0
10962,91,1,90,132,117,0,0,278,93,185,GOOOXXXXXXXXXXXXXXXXGOOOOOOOXXXXXXXXXXXXGOOOOOOOAXXXXXXXXXXXGOOOOOOOXXXXXXXXXXXXGOOOXXXXXXXXXXXXXXXXGOOOOOOOOOXXXXXXXXXXGOOOXXXXXXXXXXXXXXXXGOOOOOXXXXXXXXXXXXXXGOOOOOOOOOOOXXXXXXXXGOOOXXXXXXXXXXXXXXXXGOOOOOOXXXXXXXXXXXXXGOOOOXXXXXXXXXXXXXXXGOOOOOOOOOXXXXXXXXXX,0,0,0
10983,91,1,90,134,115,0,0,279,88,191,GOOOXXXXXXXXXXXXXXXXGOOOOOOOXXXXXXXXXXXXGOOOOOOOAXXXXXXXXXXXGOOOOOOOXXXXXXXXXXXXGOOOXXXXXXXXXXXXXXXXGOOOOOOOOOXXXXXXXXXXGOOOXXXXXXXXXXXXXXXXGOOOOOXXXXXXXXXXXXXXGOOOOOOOOOOOXXXXXXXXGOOOXXXXXXXXXXXXXXXXGOOOOOOXXXXXXXXXXXXXGOOOOXXXXXXXXXXXXXXXGOOOOOOOOOXXXXXXXXXX,0,0,0
11004,91,1,90,132,117,0,0,282,87,195,GOOOXXXXXXXXXXXXXXXXGOOOOOOOXXXXXXXXXXXXGOOOOOOOAXXXXXXXXXXXGOOOOOOOXXXXXXXXXXXXGOOOXXXXXXXXXXXXXXXXGOOOOOOOOOXXXXXXXXXXGOOOXXXXXXXXXXXXXXXXGOOOOOXXXXXXXXXXXXXXGOOOOOOOOOOOXXXXXXXXGOOOXXXXXXXXXXXXXXXXGOOOOOOXXXXXXXXXXXXXGOOOOXXXXXXXXXXXXXXXGOOOOOOOOOXXXXXXXXXX,0,0,0

11025,91,1,90,128,121,0,0,283,87,196,GOOOXXXXXXXXXXXXXXXXGOOOOOOOXXXXXXXXXXXXGOOOOOOOAXXXXXXXXXXXGOOOOOOOXXXXXXXXXXXXGOOOXXXXXXXXXXXXXXXXGOOOOOOOOOXXXXXXXXXXGOOOXXXXXXXXXXXXXXXXGOOOOOXXXXXXXXXXXXXXGOOOOOOOOOOOXXXXXXXXGOOOXXXXXXXXXXXXXXXXGOOOOOOXXXXXXXXXXXXXGOOOOXXXXXXXXXXXXXXXGOOOOOOOOOXXXXXXXXXX,0,0,0
11046,91,1,90,126,123,0,0,285,83,202,GOOOXXXXXXXXXXXXXXXXGOOOOOOOXXXXXXXXXXXXGOOOOOOOAXXXXXXXXXXXGOOOOOOOXXXXXXXXXXXXGOOOXXXXXXXXXXXXXXXXGOOOOOOOOOXXXXXXXXXXGOOOXXXXXXXXXXXXXXXXGOOOOOXXXXXXXXXXXXXXGOOOOOOOOOOOXXXXXXXXGOOOXXXXXXXXXXXXXXXXGOOOOOOXXXXXXXXXXXXXGOOOOXXXXXXXXXXXXXXXGOOOOOOOOOXXXXXXXXXX,0,0,0
11067,91,1,90,127,122,0,0,285,84,201,GOOOXXXXXXXXXXXXXXXXGOOOOOOOXXXXXXXXXXXXGOOOOOOOAXXXXXXXXXXXGOOOOOOOXXXXXXXXXXXXGOOOXXXXXXXXXXXXXXXXGOOOOOOOOOXXXXXXXXXXGOOOXXXXXXXXXXXXXXXXGOOOOOXXXXXXXXXXXXXXGOOOOOOOOOOOXXXXXXXXGOOOXXXXXXXXXXXXXXXXGOOOOOOXXXXXXXXXXXXXGOOOOXXXXXXXXXXXXXXXGOOOOOOOOOXXXXXXXXXX,0,0,0
11088,91,1,90,125,124,0,0,286,83,203,GOOOXXXXXXXXXXXXXXXXGOOOOOOOXXXXXXXXXXXXGOOOOOOOAXXXXXXXXXXXGOOOOOOOXXXXXXXXXXXXGOOOXXXXXXXXXXXXXXXXGOOOOOOOOOXXXXXXXXXXGOOOXXXXXXXXXXXXXXXXGOOOOOXXXXXXXXXXXXXXGOOOOOOOOOOOXXXXXXXXGOOOXXXXXXXXXXXXXXXXGOOOOOOXXXXXXXXXXXXXGOOOOXXXXXXXXXXXXXXXGOOOOOOOOOXXXXXXXXXX,0,0,0
11109,91,1,90,125,124,0,0,287,84,203,GOOOXXXXXXXXXXXXXXXXGOOOOOOOXXXXXXXXXXXXGOOOOOOOAXXXXXXXXXXXGOOOOOOOXXXXXXXXXXXXGOOOXXXXXXXXXXXXXXXXGOOOOOOOOOXXXXXXXXXXGOOOXXXXXXXXXXXXXXXXGOOOOOXXXXXXXXXXXXXXGOOOOOOOOOOOXXXXXXXXGOOOXXXXXXXXXXXXXXXXGOOOOOOXXXXXXXXXXXXXGOOOOXXXXXXXXXXXXXXXGOOOOOOOOOXXXXXXXXXX,0,0,0

11130,92,2,90,129,119,0,0,281,84,197,GOOOXXXXXXXXXXXXXXXXGOOOOOOOXXXXXXXXXXXXGOOOOOOOAXXXXXXXXXXXGOOOOOOOAXXXXXXXXXXXGOOOXXXXXXXXXXXXXXXXGOOOOOOOOOXXXXXXXXXXGOOOXXXXXXXXXXXXXXXXGOOOOOXXXXXXXXXXXXXXGOOOOOOOOOOOXXXXXXXXGOOOXXXXXXXXXXXXXXXXGOOOOOOXXXXXXXXXXXXXGOOOOXXXXXXXXXXXXXXXGOOOOOOOOOXXXXXXXXXX,0,0,0
11151,92,1,91,133,115,0,0,278,89,189,GOOOXXXXXXXXXXXXXXXXGOOOOOOOXXXXXXXXXXXXGOOOOOOOOXXXXXXXXXXXGOOOOOOOAXXXXXXXXXXXGOOOXXXXXXXXXXXXXXXXGOOOOOOOOOXXXXXXXXXXGOOOXXXXXXXXXXXXXXXXGOOOOOXXXXXXXXXXXXXXGOOOOOOOOOOOXXXXXXXXGOOOXXXXXXXXXXXXXXXXGOOOOOOXXXXXXXXXXXXXGOOOOXXXXXXXXXXXXXXXGOOOOOOOOOXXXXXXXXXX,0,0,0
11172,92,1,91,132,116,0,0,279,85,194,GOOOXXXXXXXXXXXXXXXXGOOOOOOOXXXXXXXXXXXXGOOOOOOOOXXXXXXXXXXXGOOOOOOOAXXXXXXXXXXXGOOOXXXXXXXXXXXXXXXXGOOOOOOOOOXXXXXXXXXXGOOOXXXXXXXXXXXXXXXXGOOOOOXXXXXXXXXXXXXXGOOOOOOOOOOOXXXXXXXXGOOOXXXXXXXXXXXXXXXXGOOOOOOXXXXXXXXXXXXXGOOOOXXXXXXXXXXXXXXXGOOOOOOOOOXXXXXXXXXX,0,0,0
11193,92,0,92,134,114,0,0,276,91,185,GOOOXXXXXXXXXXXXXXXXGOOOOOOOXXXXXXXXXXXXGOOOOOOOOXXXXXXXXXXXGOOOOOOOOXXXXXXXXXXXGOOOXXXXXXXXXXXXXXXXGOOOOOOOOOXXXXXXXXXXGOOOXXXXXXXXXXXXXXXXGOOOOOXXXXXXXXXXXXXXGOOOOOOOOOOOXXXXXXXXGOOOXXXXXXXXXXXXXXXXGOOOOOOXXXXXXXXXXXXXGOOOOXXXXXXXXXXXXXXXGOOOOOOOOOXXXXXXXXXX,0,0,0
11214,92,0,92,135,113,0,0,275,94,181,GOOOXXXXXXXXXXXXXXXXGOOOOOOOXXXXXXXXXXXXGOOOOOOOOXXXXXXXXXXXGOOOOOOOOXXXXXXXXXXXGOOOXXXXXXXXXXXXXXXXGOOOOOOOOOXXXXXXXXXXGOOOXXXXXXXXXXXXXXXXGOOOOOXXXXXXXXXXXXXXGOOOOOOOOOOOXXXXXXXXGOOOXXXXXXXXXXXXXXXXGOOOOOOXXXXXXXXXXXXXGOOOOXXXXXXXXXXXXXXXGOOOOOOOOOXXXXXXXXXX,0,0,0

11235,92,0,92,132,116,0,0,279,95,184,GOOOXXXXXXXXXXXXXXXXGOOOOOOOXXXXXXXXXXXXGOOOOOOOOXXXXXXXXXXXGOOOOOOOOXXXXXXXXXXXGOOOXXXXXXXXXXXXXXXXGOOOOOOOOOXXXXXXXXXXGOOOXXXXXXXXXXXXXXXXGOOOOOXXXXXXXXXXXXXXGOOOOOOOOOOOXXXXXXXXGOOOXXXXXXXXXXXXXXXXGOOOOOOXXXXXXXXXXXXXGOOOOXXXXXXXXXXXXXXXGOOOOOOOOOXXXXXXXXXX,0,0,0
11256,92,0,92,138,110,0,0,273,100,173,GOOOXXXXXXXXXXXXXXXXGOOOOOOOXXXXXXXXXXXXGOOOOOOOOXXXXXXXXXXXGOOOOOOOOXXXXXXXXXXXGOOOXXXXXXXXXXXXXXXXGOOOOOOOOOXXXXXXXXXXGOOOXXXXXXXXXXXXXXXXGOOOOOXXXXXXXXXXXXXXGOOOOOOOOOOOXXXXXXXXGOOOXXXXXXXXXXXXXXXXGOOOOOOXXXXXXXXXXXXXGOOOOXXXXXXXXXXXXXXXGOOOOOOOOOXXXXXXXXXX,0,0,0
11277,93,1,92,135,112,0,0,273,107,166,GOOOXXXXXXXXXXXXXXXXGOOOOOOOXXXXXXXXXXXXGOOOOOOOOXXXXXXXXXXXGOOOOOOOOXXXXXXXXXXXGOOOXXXXXXXXXXXXXXXXGOOOOOOOOOXXXXXXXXXXGOOOXXXXXXXXXXXXXXXXGOOOOOXXXXXXXXXXXXXXGOOOOOOOOOOOXXXXXXXXGOOOXXXXXXXXXXXXXXXXGOOOOOOXXXXXXXXXXXXXGOOOOXXXXXXXXXXXXXXXGOOOOOOOOOAXXXXXXXXX,0,0,0
11298,93,0,93,136,111,0,0,272,109,163,GOOOXXXXXXXXXXXXXXXXGOOOOOOOXXXXXXXXXXXXGOOOOOOOOXXXXXXXXXXXGOOOOOOOOXXXXXXXXXXXGOOOXXXXXXXXXXXXXXXXGOOOOOOOOOXXXXXXXXXXGOOOXXXXXXXXXXXXXXXXGOOOOOXXXXXXXXXXXXXXGOOOOOOOOOOOXXXXXXXXGOOOXXXXXXXXXXXXXXXXGOOOOOOXXXXXXXXXXXXXGOOOOXXXXXXXXXXXXXXXGOOOOOOOOOOXXXXXXXXX,0,0,0
11319,93,0,93,137,110,0,0,272,114,158,GOOOXXXXXXXXXXXXXXXXGOOOOOOOXXXXXXXXXXXXGOOOOOOOOXXXXXXXXXXXGOOOOOOOOXXXXXXXXXXXGOOOXXXXXXXXXXXXXXXXGOOOOOOOOOXXXXXXXXXXGOOOXXXXXXXXXXXXXXXXGOOOOOXXXXXXXXXXXXXXGOOOOOOOOOOOXXXXXXXXGOOOXXXXXXXXXXXXXXXXGOOOOOOXXXXXXXXXXXXXGOOOOXXXXXXXXXXXXXXXGOOOOOOOOOOXXXXXXXXX,0,0,0

11340,93,0,93,132,115,0,0,275,107,168,GOOOXXXXXXXXXXXXXXXXGOOOOOOOXXXXXXXXXXXXGOOOOOOOOXXXXXXXXXXXGOOOOOOOOXXXXXXXXXXXGOOOXXXXXXXXXXXXXXXXGOOOOOOOOOXXXXXXXXXXGOOOXXXXXXXXXXXXXXXXGOOOOOXXXXXXXXXXXXXXGOOOOOOOOOOOXXXXXXXXGOOOXXXXXXXXXXXXXXXXGOOOOOOXXXXXXXXXXXXXGOOOOXXXXXXXXXXXXXXXGOOOOOOOOOOXXXXXXXXX,0,0,0
11361,93,0,93,141,106,0,0,267,98,169,GOOOXXXXXXXXXXXXXXXXGOOOOOOOXXXXXXXXXXXXGOOOOOOOOXXXXXXXXXXXGOOOOOOOOXXXXXXXXXXXGOOOXXXXXXXXXXXXXXXXGOOOOOOOOOXXXXXXXXXXGOOOXXXXXXXXXXXXXXXXGOOOOOXXXXXXXXXXXXXXGOOOOOOOOOOOXXXXXXXXGOOOXXXXXXXXXXXXXXXXGOOOOOOXXXXXXXXXXXXXGOOOOXXXXXXXXXXXXXXXGOOOOOOOOOOXXXXXXXXX,0,0,0
11382,93,0,93,138,109,0,0,269,95,174,GOOOXXXXXXXXXXXXXXXXGOOOOOOOXXXXXXXXXXXXGOOOOOOOOXXXXXXXXXXXGOOOOOOOOXXXXXXXXXXXGOOOXXXXXXXXXXXXXXXXGOOOOOOOOOXXXXXXXXXXGOOOXXXXXXXXXXXXXXXXGOOOOOXXXXXXXXXXXXXXGOOOOOOOOOOOXXXXXXXXGOOOXXXXXXXXXXXXXXXXGOOOOOOXXXXXXXXXXXXXGOOOOXXXXXXXXXXXXXXXGOOOOOOOOOOXXXXXXXXX,0,0,0
11403,93,0,93,141,106,0,0,267,98,169,GOOOXXXXXXXXXXXXXXXXGOOOOOOOXXXXXXXXXXXXGOOOOOOOOXXXXXXXXXXXGOOOOOOOOXXXXXXXXXXXGOOOXXXXXXXXXXXXXXXXGOOOOOOOOOXXXXXXXXXXGOOOXXXXXXXXXXXXXXXXGOOOOOXXXXXXXXXXXXXXGOOOOOOOOOOOXXXXXXXXGOOOXXXXXXXXXXXXXXXXGOOOOOOXXXXXXXXXXXXXGOOOOXXXXXXXXXXXXXXXGOOOOOOOOOOXXXXXXXXX,0,0,0
11424,93,0,93,145,102,0,0,262,97,165,GOOOXXXXXXXXXXXXXXXXGOOOOOOOXXXXXXXXXXXXGOOOOOOOOXXXXXXXXXXXGOOOOOOOOXXXXXXXXXXXGOOOXXXXXXXXXXXXXXXXGOOOOOOOOOXXXXXXXXXXGOOOXXXXXXXXXXXXXXXXGOOOOOXXXXXXXXXXXXXXGOOOOOOOOOOOXXXXXXXXGOOOXXXXXXXXXXXXXXXXGOOOOOOXXXXXXXXXXXXXGOOOOXXXXXXXXXXXXXXXGOOOOOOOOOOXXXXXXXXX,0,0,0

11445,94,1,93,143,103,0,0,264,98,166,GOOOXXXXXXXXXXXXXXXXGOOOOOOOXXXXXXXXXXXXGOOOOOOOOXXXXXXXXXXXGOOOOOOOOXXXXXXXXXXXGOOOXXXXXXXXXXXXXXXXGOOOOOOOOOXXXXXXXXXXGOOOXXXXXXXXXXXXXXXXGOOOOOAXXXXXXXXXXXXXGOOOOOOOOOOOXXXXXXXXGOOOXXXXXXXXXXXXXXXXGOOOOOOXXXXXXXXXXXXXGOOOOXXXXXXXXXXXXXXXGOOOOOOOOOOXXXXXXXXX,0,0,0
11466,94,0,94,141,105,0,0,266,99,167,GOOOXXXXXXXXXXXXXXXXGOOOOOOOXXXXXXXXXXXXGOOOOOOOOXXXXXXXXXXXGOOOOOOOOXXXXXXXXXXXGOOOXXXXXXXXXXXXXXXXGOOOOOOOOOXXXXXXXXXXGOOOXXXXXXXXXXXXXXXXGOOOOOOXXXXXXXXXXXXXGOOOOOOOOOOOXXXXXXXXGOOOXXXXXXXXXXXXXXXXGOOOOOOXXXXXXXXXXXXXGOOOOXXXXXXXXXXXXXXXGOOOOOOOOOOXXXXXXXXX,0,0,0
11487,94,0,94,135,111,0,0,271,102,169,GOOOXXXXXXXXXXXXXXXXGOOOOOOOXXXXXXXXXXXXGOOOOOOOOXXXXXXXXXXXGOOOOOOOOXXXXXXXXXXXGOOOXXXXXXXXXXXXXXXXGOOOOOOOOOXXXXXXXXXXGOOOXXXXXXXXXXXXXXXXGOOOOOOXXXXXXXXXXXXXGOOOOOOOOOOOXXXXXXXXGOOOXXXXXXXXXXXXXXXXGOOOOOOXXXXXXXXXXXXXGOOOOXXXXXXXXXXXXXXXGOOOOOOOOOOXXXXXXXXX,0,0,0
11508,94,0,94,126,120,0,0,280,103,177,GOOOXXXXXXXXXXXXXXXXGOOOOOOOXXXXXXXXXXXXGOOOOOOOOXXXXXXXXXXXGOOOOOOOOXXXXXXXXXXXGOOOXXXXXXXXXXXXXXXXGOOOOOOOOOXXXXXXXXXXGOOOXXXXXXXXXXXXXXXXGOOOOOOXXXXXXXXXXXXXGOOOOOOOOOOOXXXXXXXXGOOOXXXXXXXXXXXXXXXXGOOOOOOXXXXXXXXXXXXXGOOOOXXXXXXXXXXXXXXXGOOOOOOOOOOXXXXXXXXX,0,0,0
11529,94,0,94,129,117,0,0,276,97,179,GOOOXXXXXXXXXXXXXXXXGOOOOOOOXXXXXXXXXXXXGOOOOOOOOXXXXXXXXXXXGOOOOOOOOXXXXXXXXXXXGOOOXXXXXXXXXXXXXXXXGOOOOOOOOOXXXXXXXXXXGOOOXXXXXXXXXXXXXXXXGOOOOOOXXXXXXXXXXXXXGOOOOOOOOOOOXXXXXXXXGOOOXXXXXXXXXXXXXXXXGOOOOOOXXXXXXXXXXXXXGOOOOXXXXXXXXXXXXXXXGOOOOOOOOOOXXXXXXXXX,0,0,0

11550,95,1,94,129,116,0,0,275,92,183,GOOOXXXXXXXXXXXXXXXXGOOOOOOOAXXXXXXXXXXXGOOOOOOOOXXXXXXXXXXXGOOOOOOOOXXXXXXXXXXXGOOOXXXXXXXXXXXXXXXXGOOOOOOOOOXXXXXXXXXXGOOOXXXXXXXXXXXXXXXXGOOOOOOXXXXXXXXXXXXXGOOOOOOOOOOOXXXXXXXXGOOOXXXXXXXXXXXXXXXXGOOOOOOXXXXXXXXXXXXXGOOOOXXXXXXXXXXXXXXXGOOOOOOOOOOXXXXXXXXX,0,0,0
11571,95,1,94,125,120,0,0,279,93,186,GOOOXXXXXXXXXXXXXXXXGOOOOOOOAXXXXXXXXXXXGOOOOOOOOXXXXXXXXXXXGOOOOOOOOXXXXXXXXXXXGOOOXXXXXXXXXXXXXXXXGOOOOOOOOOXXXXXXXXXXGOOOXXXXXXXXXXXXXXXXGOOOOOOXXXXXXXXXXXXXGOOOOOOOOOOOXXXXXXXXGOOOXXXXXXXXXXXXXXXXGOOOOOOXXXXXXXXXXXXXGOOOOXXXXXXXXXXXXXXXGOOOOOOOOOOXXXXXXXXX,0,0,0
11592,95,1,94,133,112,0,0,272,91,181,GOOOXXXXXXXXXXXXXXXXGOOOOOOOAXXXXXXXXXXXGOOOOOOOOXXXXXXXXXXXGOOOOOOOOXXXXXXXXXXXGOOOXXXXXXXXXXXXXXXXGOOOOOOOOOXXXXXXXXXXGOOOXXXXXXXXXXXXXXXXGOOOOOOXXXXXXXXXXXXXGOOOOOOOOOOOXXXXXXXXGOOOXXXXXXXXXXXXXXXXGOOOOOOXXXXXXXXXXXXXGOOOOXXXXXXXXXXXXXXXGOOOOOOOOOOXXXXXXXXX,0,0,0
11613,95,0,95,132,113,0,0,272,95,177,GOOOXXXXXXXXXXXXXXXXGOOOOOOOOXXXXXXXXXXXGOOOOOOOOXXXXXXXXXXXGOOOOOOOOXXXXXXXXXXXGOOOXXXXXXXXXXXXXXXXGOOOOOOOOOXXXXXXXXXXGOOOXXXXXXXXXXXXXXXXGOOOOOOXXXXXXXXXXXXXGOOOOOOOOOOOXXXXXXXXGOOOXXXXXXXXXXXXXXXXGOOOOOOXXXXXXXXXXXXXGOOOOXXXXXXXXXXXXXXXGOOOOOOOOOOXXXXXXXXX,0,0,0
11634,95,0,95,133,112,0,0,272,96,176,GOOOXXXXXXXXXXXXXXXXGOOOOOOOOXXXXXXXXXXXGOOOOOOOOXXXXXXXXXXXGOOOOOOOOXXXXXXXXXXXGOOOXXXXXXXXXXXXXXXXGOOOOOOOOOXXXXXXXXXXGOOOXXXXXXXXXXXXXXXXGOOOOOOXXXXXXXXXXXXXGOOOOOOOOOOOXXXXXXXXGOOOXXXXXXXXXXXXXXXXGOOOOOOXXXXXXXXXXXXXGOOOOXXXXXXXXXXXXXXXGOOOOOOOOOOXXXXXXXXX,0,0,0

11655,95,0,95,134,111,0,0,270,103,167,GOOOXXXXXXXXXXXXXXXXGOOOOOOOOXXXXXXXXXXXGOOOOOOOOXXXXXXXXXXXGOOOOOOOOXXXXXXXXXXXGOOOXXXXXXXXXXXXXXXXGOOOOOOOOOXXXXXXXXXXGOOOXXXXXXXXXXXXXXXXGOOOOOOXXXXXXXXXXXXXGOOOOOOOOOOOXXXXXXXXGOOOXXXXXXXXXXXXXXXXGOOOOOOXXXXXXXXXXXXXGOOOOXXXXXXXXXXXXXXXGOOOOOOOOOOXXXXXXXXX,0,0,0
11676,95,0,95,139,106,0,0,266,97,169,GOOOXXXXXXXXXXXXXXXXGOOOOOOOOXXXXXXXXXXXGOOOOOOOOXXXXXXXXXXXGOOOOOOOOXXXXXXXXXXXGOOOXXXXXXXXXXXXXXXXGOOOOOOOOOXXXXXXXXXXGOOOXXXXXXXXXXXXXXXXGOOOOOOXXXXXXXXXXXXXGOOOOOOOOOOOXXXXXXXXGOOOXXXXXXXXXXXXXXXXGOOOOOOXXXXXXXXXXXXXGOOOOXXXXXXXXXXXXXXXGOOOOOOOOOOXXXXXXXXX,0,0,0
11697,95,0,95,146,99,0,0,257,94,163,GOOOXXXXXXXXXXXXXXXXGOOOOOOOOXXXXXXXXXXXGOOOOOOOOXXXXXXXXXXXGOOOOOOOOXXXXXXXXXXXGOOOXXXXXXXXXXXXXXXXGOOOOOOOOOXXXXXXXXXXGOOOXXXXXXXXXXXXXXXXGOOOOOOXXXXXXXXXXXXXGOOOOOOOOOOOXXXXXXXXGOOOXXXXXXXXXXXXXXXXGOOOOOOXXXXXXXXXXXXXGOOOOXXXXXXXXXXXXXXXGOOOOOOOOOOXXXXXXXXX,0,0,0
11718,95,0,95,136,109,0,0,269,92,177,GOOOXXXXXXXXXXXXXXXXGOOOOOOOOXXXXXXXXXXXGOOOOOOOOXXXXXXXXXXXGOOOOOOOOXXXXXXXXXXXGOOOXXXXXXXXXXXXXXXXGOOOOOOOOOXXXXXXXXXXGOOOXXXXXXXXXXXXXXXXGOOOOOOXXXXXXXXXXXXXGOOOOOOOOOOOXXXXXXXXGOOOXXXXXXXXXXXXXXXXGOOOOOOXXXXXXXXXXXXXGOOOOXXXXXXXXXXXXXXXGOOOOOOOOOOXXXXXXXXX,0,0,0
11739,95,0,95,130,115,0,0,274,95,179,GOOOXXXXXXXXXXXXXXXXGOOOOOOOOXXXXXXXXXXXGOOOOOOOOXXXXXXXXXXXGOOOOOOOOXXXXXXXXXXXGOOOXXXXXXXXXXXXXXXXGOOOOOOOOOXXXXXXXXXXGOOOXXXXXXXXXXXXXXXXGOOOOOOXXXXXXXXXXXXXGOOOOOOOOOOOXXXXXXXXGOOOXXXXXXXXXXXXXXXXGOOOOOOXXXXXXXXXXXXXGOOOOXXXXXXXXXXXXXXXGOOOOOOOOOOXXXXXXXXX,0,0,0

11760,95,0,95,130,115,0,0,275,92,183,GOOOXXXXXXXXXXXXXXXXGOOOOOOOOXXXXXXXXXXXGOOOOOOOOXXXXXXXXXXXGOOOOOOOOXXXXXXXXXXXGOOOXXXXXXXXXXXXXXXXGOOOOOOOOOXXXXXXXXXXGOOOXXXXXXXXXXXXXXXXGOOOOOOXXXXXXXXXXXXXGOOOOOOOOOOOXXXXXXXXGOOOXXXXXXXXXXXXXXXXGOOOOOOXXXXXXXXXXXXXGOOOOXXXXXXXXXXXXXXXGOOOOOOOOOOXXXXXXXXX,0,0,0
11781,96,1,95,121,123,0,0,282,104,178,GOOOXXXXXXXXXXXXXXXXGOOOOOOOOAXXXXXXXXXXGOOOOOOOOXXXXXXXXXXXGOOOOOOOOXXXXXXXXXXXGOOOXXXXXXXXXXXXXXXXGOOOOOOOOOXXXXXXXXXXGOOOXXXXXXXXXXXXXXXXGOOOOOOXXXXXXXXXXXXXGOOOOOOOOOOOXXXXXXXXGOOOXXXXXXXXXXXXXXXXGOOOOOOXXXXXXXXXXXXXGOOOOXXXXXXXXXXXXXXXGOOOOOOOOOOXXXXXXXXX,0,0,0
11802,96,1,95,124,120,0,0,280,103,177,GOOOXXXXXXXXXXXXXXXXGOOOOOOOOAXXXXXXXXXXGOOOOOOOOXXXXXXXXXXXGOOOOOOOOXXXXXXXXXXXGOOOXXXXXXXXXXXXXXXXGOOOOOOOOOXXXXXXXXXXGOOOXXXXXXXXXXXXXXXXGOOOOOOXXXXXXXXXXXXXGOOOOOOOOOOOXXXXXXXXGOOOXXXXXXXXXXXXXXXXGOOOOOOXXXXXXXXXXXXXGOOOOXXXXXXXXXXXXXXXGOOOOOOOOOOXXXXXXXXX,0,0,0
11823,96,1,95,126,118,0,0,277,99,178,GOOOXXXXXXXXXXXXXXXXGOOOOOOOOAXXXXXXXXXXGOOOOOOOOXXXXXXXXXXXGOOOOOOOOXXXXXXXXXXXGOOOXXXXXXXXXXXXXXXXGOOOOOOOOOXXXXXXXXXXGOOOXXXXXXXXXXXXXXXXGOOOOOOXXXXXXXXXXXXXGOOOOOOOOOOOXXXXXXXXGOOOXXXXXXXXXXXXXXXXGOOOOOOXXXXXXXXXXXXXGOOOOXXXXXXXXXXXXXXXGOOOOOOOOOOXXXXXXXXX,0,0,0
11844,96,1,95,124,120,0,0,276,97,179,GOOOXXXXXXXXXXXXXXXXGOOOOOOOOAXXXXXXXXXXGOOOOOOOOXXXXXXXXXXXGOOOOOOOOXXXXXXXXXXXGOOOXXXXXXXXXXXXXXXXGOOOOOOOOOXXXXXXXXXXGOOOXXXXXXXXXXXXXXXXGOOOOOOXXXXXXXXXXXXXGOOOOOOOOOOOXXXXXXXXGOOOXXXXXXXXXXXXXXXXGOOOOOOXXXXXXXXXXXXXGOOOOXXXXXXXXXXXXXXXGOOOOOOOOOOXXXXXXXXX,0,0,0

11865,96,1,95,126,118,0,0,278,101,177,GOOOXXXXXXXXXXXXXXXXGOOOOOOOOAXXXXXXXXXXGOOOOOOOOXXXXXXXXXXXGOOOOOOOOXXXXXXXXXXXGOOOXXXXXXXXXXXXXXXXGOOOOOOOOOXXXXXXXXXXGOOOXXXXXXXXXXXXXXXXGOOOOOOXXXXXXXXXXXXXGOOOOOOOOOOOXXXXXXXXGOOOXXXXXXXXXXXXXXXXGOOOOOOXXXXXXXXXXXXXGOOOOXXXXXXXXXXXXXXXGOOOOOOOOOOXXXXXXXXX,0,0,0
11886,96,1,95,122,122,0,0,280,96,184,GOOOXXXXXXXXXXXXXXXXGOOOOOOOOAXXXXXXXXXXGOOOOOOOOXXXXXXXXXXXGOOOOOOOOXXXXXXXXXXXGOOOXXXXXXXXXXXXXXXXGOOOOOOOOOXXXXXXXXXXGOOOXXXXXXXXXXXXXXXXGOOOOOOXXXXXXXXXXXXXGOOOOOOOOOOOXXXXXXXXGOOOXXXXXXXXXXXXXXXXGOOOOOOXXXXXXXXXXXXXGOOOOXXXXXXXXXXXXXXXGOOOOOOOOOOXXXXXXXXX,0,0,0
11907,96,0,96,126,118,0,0,277,94,183,GOOOXXXXXXXXXXXXXXXXGOOOOOOOOOXXXXXXXXXXGOOOOOOOOXXXXXXXXXXXGOOOOOOOOXXXXXXXXXXXGOOOXXXXXXXXXXXXXXXXGOOOOOOOOOXXXXXXXXXXGOOOXXXXXXXXXXXXXXXXGOOOOOOXXXXXXXXXXXXXGOOOOOOOOOOOXXXXXXXXGOOOXXXXXXXXXXXXXXXXGOOOOOOXXXXXXXXXXXXXGOOOOXXXXXXXXXXXXXXXGOOOOOOOOOOXXXXXXXXX,0,0,0
11928,96,0,96,131,113,0,0,273,90,183,GOOOXXXXXXXXXXXXXXXXGOOOOOOOOOXXXXXXXXXXGOOOOOOOOXXXXXXXXXXXGOOOOOOOOXXXXXXXXXXXGOOOXXXXXXXXXXXXXXXXGOOOOOOOOOXXXXXXXXXXGOOOXXXXXXXXXXXXXXXXGOOOOOOXXXXXXXXXXXXXGOOOOOOOOOOOXXXXXXXXGOOOXXXXXXXXXXXXXXXXGOOOOOOXXXXXXXXXXXXXGOOOOXXXXXXXXXXXXXXXGOOOOOOOOOOXXXXXXXXX,0,0,0
11949,96,0,96,129,115,0,0,274,94,180,GOOOXXXXXXXXXXXXXXXXGOOOOOOOOOXXXXXXXXXXGOOOOOOOOXXXXXXXXXXXGOOOOOOOOXXXXXXXXXXXGOOOXXXXXXXXXXXXXXXXGOOOOOOOOOXXXXXXXXXXGOOOXXXXXXXXXXXXXXXXGOOOOOOXXXXXXXXXXXXXGOOOOOOOOOOOXXXXXXXXGOOOXXXXXXXXXXXXXXXXGOOOOOOXXXXXXXXXXXXXGOOOOXXXXXXXXXXXXXXXGOOOOOOOOOOXXXXXXXXX,0,0,0

11970,96,0,96,124,120,0,0,279,97,182,GOOOXXXXXXXXXXXXXXXXGOOOOOOOOOXXXXXXXXXXGOOOOOOOOXXXXXXXXXXXGOOOOOOOOXXXXXXXXXXXGOOOXXXXXXXXXXXXXXXXGOOOOOOOOOXXXXXXXXXXGOOOXXXXXXXXXXXXXXXXGOOOOOOXXXXXXXXXXXXXGOOOOOOOOOOOXXXXXXXXGOOOXXXXXXXXXXXXXXXXGOOOOOOXXXXXXXXXXXXXGOOOOXXXXXXXXXXXXXXXGOOOOOOOOOOXXXXXXXXX,0,0,0
11991,96,0,96,124,120,0,0,280,98,182,GOOOXXXXXXXXXXXXXXXXGOOOOOOOOOXXXXXXXXXXGOOOOOOOOXXXXXXXXXXXGOOOOOOOOXXXXXXXXXXXGOOOXXXXXXXXXXXXXXXXGOOOOOOOOOXXXXXXXXXXGOOOXXXXXXXXXXXXXXXXGOOOOOOXXXXXXXXXXXXXGOOOOOOOOOOOXXXXXXXXGOOOXXXXXXXXXXXXXXXXGOOOOOOXXXXXXXXXXXXXGOOOOXXXXXXXXXXXXXXXGOOOOOOOOOOXXXXXXXXX,0,0,0
12012,96,0,96,118,126,0,0,286,100,186,GOOOXXXXXXXXXXXXXXXXGOOOOOOOOOXXXXXXXXXXGOOOOOOOOXXXXXXXXXXXGOOOOOOOOXXXXXXXXXXXGOOOXXXXXXXXXXXXXXXXGOOOOOOOOOXXXXXXXXXXGOOOXXXXXXXXXXXXXXXXGOOOOOOXXXXXXXXXXXXXGOOOOOOOOOOOXXXXXXXXGOOOXXXXXXXXXXXXXXXXGOOOOOOXXXXXXXXXXXXXGOOOOXXXXXXXXXXXXXXXGOOOOOOOOOOXXXXXXXXX,0,0,0
12033,96,0,96,122,122,0,0,281,101,180,GOOOXXXXXXXXXXXXXXXXGOOOOOOOOOXXXXXXXXXXGOOOOOOOOXXXXXXXXXXXGOOOOOOOOXXXXXXXXXXXGOOOXXXXXXXXXXXXXXXXGOOOOOOOOOXXXXXXXXXXGOOOXXXXXXXXXXXXXXXXGOOOOOOXXXXXXXXXXXXXGOOOOOOOOOOOXXXXXXXXGOOOXXXXXXXXXXXXXXXXGOOOOOOXXXXXXXXXXXXXGOOOOXXXXXXXXXXXXXXXGOOOOOOOOOOXXXXXXXXX,0,0,0
12054,96,0,96,119,125,0,0,284,92,192,GOOOXXXXXXXXXXXXXXXXGOOOOOOOOOXXXXXXXXXXGOOOOOOOOXXXXXXXXXXXGOOOOOOOOXXXXXXXXXXXGOOOXXXXXXXXXXXXXXXXGOOOOOOOOOXXXXXXXXXXGOOOXXXXXXXXXXXXXXXXGOOOOOOXXXXXXXXXXXXXGOOOOOOOOOOOXXXXXXXXGOOOXXXXXXXXXXXXXXXXGOOOOOOXXXXXXXXXXXXXGOOOOXXXXXXXXXXXXXXXGOOOOOOOOOOXXXXXXXXX,0,0,0

12075,96,0,96,121,123,0,0,283,92,191,GOOOXXXXXXXXXXXXXXXXGOOOOOOOOOXXXXXXXXXXGOOOOOOOOXXXXXXXXXXXGOOOOOOOOXXXXXXXXXXXGOOOXXXXXXXXXXXXXXXXGOOOOOOOOOXXXXXXXXXXGOOOXXXXXXXXXXXXXXXXGOOOOOOXXXXXXXXXXXXXGOOOOOOOOOOOXXXXXXXXGOOOXXXXXXXXXXXXXXXXGOOOOOOXXXXXXXXXXXXXGOOOOXXXXXXXXXXXXXXXGOOOOOOOOOOXXXXXXXXX,0,0,0
12096,97,1,96,123,120,0,0,279,95,184,GOOOAXXXXXXXXXXXXXXXGOOOOOOOOOXXXXXXXXXXGOOOOOOOOXXXXXXXXXXXGOOOOOOOOXXXXXXXXXXXGOOOXXXXXXXXXXXXXXXXGOOOOOOOOOXXXXXXXXXXGOOOXXXXXXXXXXXXXXXXGOOOOOOXXXXXXXXXXXXXGOOOOOOOOOOOXXXXXXXXGOOOXXXXXXXXXXXXXXXXGOOOOOOXXXXXXXXXXXXXGOOOOXXXXXXXXXXXXXXXGOOOOOOOOOOXXXXXXXXX,0,0,0
12117,97,1,96,122,121,0,0,281,100,181,GOOOAXXXXXXXXXXXXXXXGOOOOOOOOOXXXXXXXXXXGOOOOOOOOXXXXXXXXXXXGOOOOOOOOXXXXXXXXXXXGOOOXXXXXXXXXXXXXXXXGOOOOOOOOOXXXXXXXXXXGOOOXXXXXXXXXXXXXXXXGOOOOOOXXXXXXXXXXXXXGOOOOOOOOOOOXXXXXXXXGOOOXXXXXXXXXXXXXXXXGOOOOOOXXXXXXXXXXXXXGOOOOXXXXXXXXXXXXXXXGOOOOOOOOOOXXXXXXXXX,0,0,0
12138,97,1,96,124,119,0,0,278,99,179,GOOOAXXXXXXXXXXXXXXXGOOOOOOOOOXXXXXXXXXXGOOOOOOOOXXXXXXXXXXXGOOOOOOOOXXXXXXXXXXXGOOOXXXXXXXXXXXXXXXXGOOOOOOOOOXXXXXXXXXXGOOOXXXXXXXXXXXXXXXXGOOOOOOXXXXXXXXXXXXXGOOOOOOOOOOOXXXXXXXXGOOOXXXXXXXXXXXXXXXXGOOOOOOXXXXXXXXXXXXXGOOOOXXXXXXXXXXXXXXXGOOOOOOOOOOXXXXXXXXX,0,0,0
12159,98,2,96,125,117,0,0,277,102,175,GOOOAXXXXXXXXXXXXXXXGOOOOOOOOOXXXXXXXXXXGOOOOOOOOXXXXXXXXXXXGOOOOOOOOAXXXXXXXXXXGOOOXXXXXXXXXXXXXXXXGOOOOOOOOOXXXXXXXXXXGOOOXXXXXXXXXXXXXXXXGOOOOOOXXXXXXXXXXXXXGOOOOOOOOOOOXXXXXXXXGOOOXXXXXXXXXXXXXXXXGOOOOOOXXXXXXXXXXXXXGOOOOXXXXXXXXXXXXXXXGOOOOOOOOOOXXXXXXXXX,0,0,0

12180,98,2,96,127,115,0,0,275,102,173,GOOOAXXXXXXXXXXXXXXXGOOOOOOOOOXXXXXXXXXXGOOOOOOOOXXXXXXXXXXXGOOOOOOOOAXXXXXXXXXXGOOOXXXXXXXXXXXXXXXXGOOOOOOOOOXXXXXXXXXXGOOOXXXXXXXXXXXXXXXXGOOOOOOXXXXXXXXXXXXXGOOOOOOOOOOOXXXXXXXXGOOOXXXXXXXXXXXXXXXXGOOOOOOXXXXXXXXXXXXXGOOOOXXXXXXXXXXXXXXXGOOOOOOOOOOXXXXXXXXX,0,0,0
12201,98,2,96,127,115,0,0,275,103,172,GOOOAXXXXXXXXXXXXXXXGOOOOOOOOOXXXXXXXXXXGOOOOOOOOXXXXXXXXXXXGOOOOOOOOAXXXXXXXXXXGOOOXXXXXXXXXXXXXXXXGOOOOOOOOOXXXXXXXXXXGOOOXXXXXXXXXXXXXXXXGOOOOOOXXXXXXXXXXXXXGOOOOOOOOOOOXXXXXXXXGOOOXXXXXXXXXXXXXXXXGOOOOOOXXXXXXXXXXXXXGOOOOXXXXXXXXXXXXXXXGOOOOOOOOOOXXXXXXXXX,0,0,0
12222,98,1,97,123,119,0,0,279,109,170,GOOOAXXXXXXXXXXXXXXXGOOOOOOOOOXXXXXXXXXXGOOOOOOOOXXXXXXXXXXXGOOOOOOOOOXXXXXXXXXXGOOOXXXXXXXXXXXXXXXXGOOOOOOOOOXXXXXXXXXXGOOOXXXXXXXXXXXXXXXXGOOOOOOXXXXXXXXXXXXXGOOOOOOOOOOOXXXXXXXXGOOOXXXXXXXXXXXXXXXXGOOOOOOXXXXXXXXXXXXXGOOOOXXXXXXXXXXXXXXXGOOOOOOOOOOXXXXXXXXX,0,0,0
12243,98,0,98,134,108,0,0,268,100,168,GOOOOXXXXXXXXXXXXXXXGOOOOOOOOOXXXXXXXXXXGOOOOOOOOXXXXXXXXXXXGOOOOOOOOOXXXXXXXXXXGOOOXXXXXXXXXXXXXXXXGOOOOOOOOOXXXXXXXXXXGOOOXXXXXXXXXXXXXXXXGOOOOOOXXXXXXXXXXXXXGOOOOOOOOOOOXXXXXXXXGOOOXXXXXXXXXXXXXXXXGOOOOOOXXXXXXXXXXXXXGOOOOXXXXXXXXXXXXXXXGOOOOOOOOOOXXXXXXXXX,0,0,0
12264,98,0,98,132,110,0,0,269,104,165,GOOOOXXXXXXXXXXXXXXXGOOOOOOOOOXXXXXXXXXXGOOOOOOOOXXXXXXXXXXXGOOOOOOOOOXXXXXXXXXXGOOOXXXXXXXXXXXXXXXXGOOOOOOOOOXXXXXXXXXXGOOOXXXXXXXXXXXXXXXXGOOOOOOXXXXXXXXXXXXXGOOOOOOOOOOOXXXXXXXXGOOOXXXXXXXXXXXXXXXXGOOOOOOXXXXXXXXXXXXXGOOOOXXXXXXXXXXXXXXXGOOOOOOOOOOXXXXXXXXX,0,0,0

12285,98,0,98,132,110,0,0,267,102,165,GOOOOXXXXXXXXXXXXXXXGOOOOOOOOOXXXXXXXXXXGOOOOOOOOXXXXXXXXXXXGOOOOOOOOOXXXXXXXXXXGOOOXXXXXXXXXXXXXXXXGOOOOOOOOOXXXXXXXXXXGOOOXXXXXXXXXXXXXXXXGOOOOOOXXXXXXXXXXXXXGOOOOOOOOOOOXXXXXXXXGOOOXXXXXXXXXXXXXXXXGOOOOOOXXXXXXXXXXXXXGOOOOXXXXXXXXXXXXXXXGOOOOOOOOOOXXXXXXXXX,0,0,0
12306,98,0,98,129,113,0,0,273,105,168,GOOOOXXXXXXXXXXXXXXXGOOOOOOOOOXXXXXXXXXXGOOOOOOOOXXXXXXXXXXXGOOOOOOOOOXXXXXXXXXXGOOOXXXXXXXXXXXXXXXXGOOOOOOOOOXXXXXXXXXXGOOOXXXXXXXXXXXXXXXXGOOOOOOXXXXXXXXXXXXXGOOOOOOOOOOOXXXXXXXXGOOOXXXXXXXXXXXXXXXXGOOOOOOXXXXXXXXXXXXXGOOOOXXXXXXXXXXXXXXXGOOOOOOOOOOXXXXXXXXX,0,0,0
12327,98,0,98,130,112,0,0,272,106,166,GOOOOXXXXXXXXXXXXXXXGOOOOOOOOOXXXXXXXXXXGOOOOOOOOXXXXXXXXXXXGOOOOOOOOOXXXXXXXXXXGOOOXXXXXXXXXXXXXXXXGOOOOOOOOOXXXXXXXXXXGOOOXXXXXXXXXXXXXXXXGOOOOOOXXXXXXXXXXXXXGOOOOOOOOOOOXXXXXXXXGOOOXXXXXXXXXXXXXXXXGOOOOOOXXXXXXXXXXXXXGOOOOXXXXXXXXXXXXXXXGOOOOOOOOOOXXXXXXXXX,0,0,0
12348,98,0,98,140,102,0,0,262,99,163,GOOOOXXXXXXXXXXXXXXXGOOOOOOOOOXXXXXXXXXXGOOOOOOOOXXXXXXXXXXXGOOOOOOOOOXXXXXXXXXXGOOOXXXXXXXXXXXXXXXXGOOOOOOOOOXXXXXXXXXXGOOOXXXXXXXXXXXXXXXXGOOOOOOXXXXXXXXXXXXXGOOOOOOOOOOOXXXXXXXXGOOOXXXXXXXXXXXXXXXXGOOOOOOXXXXXXXXXXXXXGOOOOXXXXXXXXXXXXXXXGOOOOOOOOOOXXXXXXXXX,0,0,0
12369,98,0,98,132,110,0,0,270,100,170,GOOOOXXXXXXXXXXXXXXXGOOOOOOOOOXXXXXXXXXXGOOOOOOOOXXXXXXXXXXXGOOOOOOOOOXXXXXXXXXXGOOOXXXXXXXXXXXXXXXXGOOOOOOOOOXXXXXXXXXXGOOOXXXXXXXXXXXXXXXXGOOOOOOXXXXXXXXXXXXXGOOOOOOOOOOOXXXXXXXXGOOOXXXXXXXXXXXXXXXXGOOOOOOXXXXXXXXXXXXXGOOOOXXXXXXXXXXXXXXXGOOOOOOOOOOXXXXXXXXX,0,0,0

12390,98,0,98,125,117,0,0,277,96,181,GOOOOXXXXXXXXXXXXXXXGOOOOOOOOOXXXXXXXXXXGOOOOOOOOXXXXXXXXXXXGOOOOOOOOOXXXXXXXXXXGOOOXXXXXXXXXXXXXXXXGOOOOOOOOOXXXXXXXXXXGOOOXXXXXXXXXXXXXXXXGOOOOOOXXXXXXXXXXXXXGOOOOOOOOOOOXXXXXXXXGOOOXXXXXXXXXXXXXXXXGOOOOOOXXXXXXXXXXXXXGOOOOXXXXXXXXXXXXXXXGOOOOOOOOOOXXXXXXXXX,0,0,0
12411,98,0,98,128,114,0,0,274,94,180,GOOOOXXXXXXXXXXXXXXXGOOOOOOOOOXXXXXXXXXXGOOOOOOOOXXXXXXXXXXXGOOOOOOOOOXXXXXXXXXXGOOOXXXXXXXXXXXXXXXXGOOOOOOOOOXXXXXXXXXXGOOOXXXXXXXXXXXXXXXXGOOOOOOXXXXXXXXXXXXXGOOOOOOOOOOOXXXXXXXXGOOOXXXXXXXXXXXXXXXXGOOOOOOXXXXXXXXXXXXXGOOOOXXXXXXXXXXXXXXXGOOOOOOOOOOXXXXXXXXX,0,0,0
12432,98,0,98,129,113,0,0,271,98,173,GOOOOXXXXXXXXXXXXXXXGOOOOOOOOOXXXXXXXXXXGOOOOOOOOXXXXXXXXXXXGOOOOOOOOOXXXXXXXXXXGOOOXXXXXXXXXXXXXXXXGOOOOOOOOOXXXXXXXXXXGOOOXXXXXXXXXXXXXXXXGOOOOOOXXXXXXXXXXXXXGOOOOOOOOOOOXXXXXXXXGOOOXXXXXXXXXXXXXXXXGOOOOOOXXXXXXXXXXXXXGOOOOXXXXXXXXXXXXXXXGOOOOOOOOOOXXXXXXXXX,0,0,0
12453,98,0,98,127,115,0,0,275,95,180,GOOOOXXXXXXXXXXXXXXXGOOOOOOOOOXXXXXXXXXXGOOOOOOOOXXXXXXXXXXXGOOOOOOOOOXXXXXXXXXXGOOOXXXXXXXXXXXXXXXXGOOOOOOOOOXXXXXXXXXXGOOOXXXXXXXXXXXXXXXXGOOOOOOXXXXXXXXXXXXXGOOOOOOOOOOOXXXXXXXXGOOOXXXXXXXXXXXXXXXXGOOOOOOXXXXXXXXXXXXXGOOOOXXXXXXXXXXXXXXXGOOOOOOOOOOXXXXXXXXX,0,0,0
12474,99,0,99,122,119,0,0,278,94,184,GOOOOXXXXXXXXXXXXXXXGOOOOOOOOOXXXXXXXXXXGOOOOOOOOXXXXXXXXXXXGOOOOOOOOOXXXXXXXXXXGOOOXXXXXXXXXXXXXXXXGOOOOOOOOOXXXXXXXXXXGOOOXXXXXXXXXXXXXXXXGOOOOOOOXXXXXXXXXXXXGOOOOOOOOOOOXXXXXXXXGOOOXXXXXXXXXXXXXXXXGOOOOOOXXXXXXXXXXXXXGOOOOXXXXXXXXXXXXXXXGOOOOOOOOOOXXXXXXXXX,0,0,0

12495,99,0,99,119,122,0,0,280,97,183,GOOOOXXXXXXXXXXXXXXXGOOOOOOOOOXXXXXXXXXXGOOOOOOOOXXXXXXXXXXXGOOOOOOOOOXXXXXXXXXXGOOOXXXXXXXXXXXXXXXXGOOOOOOOOOXXXXXXXXXXGOOOXXXXXXXXXXXXXXXXGOOOOOOOXXXXXXXXXXXXGOOOOOOOOOOOXXXXXXXXGOOOXXXXXXXXXXXXXXXXGOOOOOOXXXXXXXXXXXXXGOOOOXXXXXXXXXXXXXXXGOOOOOOOOOOXXXXXXXXX,0,0,0
12516,99,0,99,117,124,0,0,284,102,182,GOOOOXXXXXXXXXXXXXXXGOOOOOOOOOXXXXXXXXXXGOOOOOOOOXXXXXXXXXXXGOOOOOOOOOXXXXXXXXXXGOOOXXXXXXXXXXXXXXXXGOOOOOOOOOXXXXXXXXXXGOOOXXXXXXXXXXXXXXXXGOOOOOOOXXXXXXXXXXXXGOOOOOOOOOOOXXXXXXXXGOOOXXXXXXXXXXXXXXXXGOOOOOOXXXXXXXXXXXXXGOOOOXXXXXXXXXXXXXXXGOOOOOOOOOOXXXXXXXXX,0,0,0
12537,99,0,99,119,122,0,0,281,95,186,GOOOOXXXXXXXXXXXXXXXGOOOOOOOOOXXXXXXXXXXGOOOOOOOOXXXXXXXXXXXGOOOOOOOOOXXXXXXXXXXGOOOXXXXXXXXXXXXXXXXGOOOOOOOOOXXXXXXXXXXGOOOXXXXXXXXXXXXXXXXGOOOOOOOXXXXXXXXXXXXGOOOOOOOOOOOXXXXXXXXGOOOXXXXXXXXXXXXXXXXGOOOOOOXXXXXXXXXXXXXGOOOOXXXXXXXXXXXXXXXGOOOOOOOOOOXXXXXXXXX,0,0,0
12558,99,0,99,121,120,0,0,280,94,186,GOOOOXXXXXXXXXXXXXXXGOOOOOOOOOXXXXXXXXXXGOOOOOOOOXXXXXXXXXXXGOOOOOOOOOXXXXXXXXXXGOOOXXXXXXXXXXXXXXXXGOOOOOOOOOXXXXXXXXXXGOOOXXXXXXXXXXXXXXXXGOOOOOOOXXXXXXXXXXXXGOOOOOOOOOOOXXXXXXXXGOOOXXXXXXXXXXXXXXXXGOOOOOOXXXXXXXXXXXXXGOOOOXXXXXXXXXXXXXXXGOOOOOOOOOOXXXXXXXXX,0,0,0
12579,99,0,99,119,122,0,0,282,91,191,GOOOOXXXXXXXXXXXXXXXGOOOOOOOOOXXXXXXXXXXGOOOOOOOOXXXXXXXXXXXGOOOOOOOOOXXXXXXXXXXGOOOXXXXXXXXXXXXXXXXGOOOOOOOOOXXXXXXXXXXGOOOXXXXXXXXXXXXXXXXGOOOOOOOXXXXXXXXXXXXGOOOOOOOOOOOXXXXXXXXGOOOXXXXXXXXXXXXXXXXGOOOOOOXXXXXXXXXXXXXGOOOOXXXXXXXXXXXXXXXGOOOOOOOOOOXXXXXXXXX,0,0,0

12600,99,0,99,118,123,0,0,282,95,187,GOOOOXXXXXXXXXXXXXXXGOOOOOOOOOXXXXXXXXXXGOOOOOOOOXXXXXXXXXXXGOOOOOOOOOXXXXXXXXXXGOOOXXXXXXXXXXXXXXXXGOOOOOOOOOXXXXXXXXXXGOOOXXXXXXXXXXXXXXXXGOOOOOOOXXXXXXXXXXXXGOOOOOOOOOOOXXXXXXXXGOOOXXXXXXXXXXXXXXXXGOOOOOOXXXXXXXXXXXXXGOOOOXXXXXXXXXXXXXXXGOOOOOOOOOOXXXXXXXXX,0,0,0
12621,99,0,99,116,125,0,0,285,100,185,GOOOOXXXXXXXXXXXXXXXGOOOOOOOOOXXXXXXXXXXGOOOOOOOOXXXXXXXXXXXGOOOOOOOOOXXXXXXXXXXGOOOXXXXXXXXXXXXXXXXGOOOOOOOOOXXXXXXXXXXGOOOXXXXXXXXXXXXXXXXGOOOOOOOXXXXXXXXXXXXGOOOOOOOOOOOXXXXXXXXGOOOXXXXXXXXXXXXXXXXGOOOOOOXXXXXXXXXXXXXGOOOOXXXXXXXXXXXXXXXGOOOOOOOOOOXXXXXXXXX,0,0,0
12642,99,0,99,117,124,0,0,285,97,188,GOOOOXXXXXXXXXXXXXXXGOOOOOOOOOXXXXXXXXXXGOOOOOOOOXXXXXXXXXXXGOOOOOOOOOXXXXXXXXXXGOOOXXXXXXXXXXXXXXXXGOOOOOOOOOXXXXXXXXXXGOOOXXXXXXXXXXXXXXXXGOOOOOOOXXXXXXXXXXXXGOOOOOOOOOOOXXXXXXXXGOOOXXXXXXXXXXXXXXXXGOOOOOOXXXXXXXXXXXXXGOOOOXXXXXXXXXXXXXXXGOOOOOOOOOOXXXXXXXXX,0,0,0
12663,99,0,99,122,119,0,0,279,98,181,GOOOOXXXXXXXXXXXXXXXGOOOOOOOOOXXXXXXXXXXGOOOOOOOOXXXXXXXXXXXGOOOOOOOOOXXXXXXXXXXGOOOXXXXXXXXXXXXXXXXGOOOOOOOOOXXXXXXXXXXGOOOXXXXXXXXXXXXXXXXGOOOOOOOXXXXXXXXXXXXGOOOOOOOOOOOXXXXXXXXGOOOXXXXXXXXXXXXXXXXGOOOOOOXXXXXXXXXXXXXGOOOOXXXXXXXXXXXXXXXGOOOOOOOOOOXXXXXXXXX,0,0,0
12684,99,0,99,124,117,0,0,277,93,184,GOOOOXXXXXXXXXXXXXXXGOOOOOOOOOXXXXXXXXXXGOOOOOOOOXXXXXXXXXXXGOOOOOOOOOXXXXXXXXXXGOOOXXXXXXXXXXXXXXXXGOOOOOOOOOXXXXXXXXXXGOOOXXXXXXXXXXXXXXXXGOOOOOOOXXXXXXXXXXXXGOOOOOOOOOOOXXXXXXXXGOOOXXXXXXXXXXXXXXXXGOOOOOOXXXXXXXXXXXXXGOOOOXXXXXXXXXXXXXXXGOOOOOOOOOOXXXXXXXXX,0,0,0

12705,100,1,99,125,115,0,0,274,95,179,GOOOOXXXXXXXXXXXXXXXGOOOOOOOOOXXXXXXXXXXGOOOOOOOOXXXXXXXXXXXGOOOOOOOOOAXXXXXXXXXGOOOXXXXXXXXXXXXXXXXGOOOOOOOOOXXXXXXXXXXGOOOXXXXXXXXXXXXXXXXGOOOOOOOXXXXXXXXXXXXGOOOOOOOOOOOXXXXXXXXGOOOXXXXXXXXXXXXXXXXGOOOOOOXXXXXXXXXXXXXGOOOOXXXXXXXXXXXXXXXGOOOOOOOOOOXXXXXXXXX,0,0,0
12726,100,1,99,124,116,0,0,277,92,185,GOOOOXXXXXXXXXXXXXXXGOOOOOOOOOXXXXXXXXXXGOOOOOOOOXXXXXXXXXXXGOOOOOOOOOAXXXXXXXXXGOOOXXXXXXXXXXXXXXXXGOOOOOOOOOXXXXXXXXXXGOOOXXXXXXXXXXXXXXXXGOOOOOOOXXXXXXXXXXXXGOOOOOOOOOOOXXXXXXXXGOOOXXXXXXXXXXXXXXXXGOOOOOOXXXXXXXXXXXXXGOOOOXXXXXXXXXXXXXXXGOOOOOOOOOOXXXXXXXXX,0,0,0
12747,100,1,99,118,122,0,0,282,91,191,GOOOOXXXXXXXXXXXXXXXGOOOOOOOOOXXXXXXXXXXGOOOOOOOOXXXXXXXXXXXGOOOOOOOOOAXXXXXXXXXGOOOXXXXXXXXXXXXXXXXGOOOOOOOOOXXXXXXXXXXGOOOXXXXXXXXXXXXXXXXGOOOOOOOXXXXXXXXXXXXGOOOOOOOOOOOXXXXXXXXGOOOXXXXXXXXXXXXXXXXGOOOOOOXXXXXXXXXXXXXGOOOOXXXXXXXXXXXXXXXGOOOOOOOOOOXXXXXXXXX,0,0,0
12768,100,1,99,120,120,0,0,280,96,184,GOOOOXXXXXXXXXXXXXXXGOOOOOOOOOXXXXXXXXXXGOOOOOOOOXXXXXXXXXXXGOOOOOOOOOAXXXXXXXXXGOOOXXXXXXXXXXXXXXXXGOOOOOOOOOXXXXXXXXXXGOOOXXXXXXXXXXXXXXXXGOOOOOOOXXXXXXXXXXXXGOOOOOOOOOOOXXXXXXXXGOOOXXXXXXXXXXXXXXXXGOOOOOOXXXXXXXXXXXXXGOOOOXXXXXXXXXXXXXXXGOOOOOOOOOOXXXXXXXXX,0,0,0
12789,100,1,99,121,119,0,0,279,95,184,GOOOOXXXXXXXXXXXXXXXGOOOOOOOOOXXXXXXXXXXGOOOOOOOOXXXXXXXXXXXGOOOOOOOOOAXXXXXXXXXGOOOXXXXXXXXXXXXXXXXGOOOOOOOOOXXXXXXXXXXGOOOXXXXXXXXXXXXXXXXGOOOOOOOXXXXXXXXXXXXGOOOOOOOOOOOXXXXXXXXGOOOXXXXXXXXXXXXXXXXGOOOOOOXXXXXXXXXXXXXGOOOOXXXXXXXXXXXXXXXGOOOOOOOOOOXXXXXXXXX,0,0,0

12810,100,1,99,117,123,0,0,282,96,186,GOOOOXXXXXXXXXXXXXXXGOOOOOOOOOXXXXXXXXXXGOOOOOOOOXXXXXXXXXXXGOOOOOOOOOAXXXXXXXXXGOOOXXXXXXXXXXXXXXXXGOOOOOOOOOXXXXXXXXXXGOOOXXXXXXXXXXXXXXXXGOOOOOOOXXXXXXXXXXXXGOOOOOOOOOOOXXXXXXXXGOOOXXXXXXXXXXXXXXXXGOOOOOOXXXXXXXXXXXXXGOOOOXXXXXXXXXXXXXXXGOOOOOOOOOOXXXXXXXXX,0,0,0
12831,100,1,99,117,123,0,0,283,102,181,GOOOOXXXXXXXXXXXXXXXGOOOOOOOOOXXXXXXXXXXGOOOOOOOOXXXXXXXXXXXGOOOOOOOOOAXXXXXXXXXGOOOXXXXXXXXXXXXXXXXGOOOOOOOOOXXXXXXXXXXGOOOXXXXXXXXXXXXXXXXGOOOOOOOXXXXXXXXXXXXGOOOOOOOOOOOXXXXXXXXGOOOXXXXXXXXXXXXXXXXGOOOOOOXXXXXXXXXXXXXGOOOOXXXXXXXXXXXXXXXGOOOOOOOOOOXXXXXXXXX,0,0,0
12852,100,1,99,110,130,0,0,288,101,187,GOOOOXXXXXXXXXXXXXXXGOOOOOOOOOXXXXXXXXXXGOOOOOOOOXXXXXXXXXXXGOOOOOOOOOAXXXXXXXXXGOOOXXXXXXXXXXXXXXXXGOOOOOOOOOXXXXXXXXXXGOOOXXXXXXXXXXXXXXXXGOOOOOOOXXXXXXXXXXXXGOOOOOOOOOOOXXXXXXXXGOOOXXXXXXXXXXXXXXXXGOOOOOOXXXXXXXXXXXXXGOOOOXXXXXXXXXXXXXXXGOOOOOOOOOOXXXXXXXXX,0,0,0
12873,100,1,99,111,129,0,0,289,105,184,GOOOOXXXXXXXXXXXXXXXGOOOOOOOOOXXXXXXXXXXGOOOOOOOOXXXXXXXXXXXGOOOOOOOOOAXXXXXXXXXGOOOXXXXXXXXXXXXXXXXGOOOOOOOOOXXXXXXXXXXGOOOXXXXXXXXXXXXXXXXGOOOOOOOXXXXXXXXXXXXGOOOOOOOOOOOXXXXXXXXGOOOXXXXXXXXXXXXXXXXGOOOOOOXXXXXXXXXXXXXGOOOOXXXXXXXXXXXXXXXGOOOOOOOOOOXXXXXXXXX,0,0,0
12894,100,1,99,115,125,0,0,284,100,184,GOOOOXXXXXXXXXXXXXXXGOOOOOOOOOXXXXXXXXXXGOOOOOOOOXXXXXXXXXXXGOOOOOOOOOAXXXXXXXXXGOOOXXXXXXXXXXXXXXXXGOOOOOOOOOXXXXXXXXXXGOOOXXXXXXXXXXXXXXXXGOOOOOOOXXXXXXXXXXXXGOOOOOOOOOOOXXXXXXXXGOOOXXXXXXXXXXXXXXXXGOOOOOOXXXXXXXXXXXXXGOOOOXXXXXXXXXXXXXXXGOOOOOOOOOOXXXXXXXXX,0,0,0

12915,100,1,99,121,119,0,0,280,98,182,GOOOOXXXXXXXXXXXXXXXGOOOOOOOOOXXXXXXXXXXGOOOOOOOOXXXXXXXXXXXGOOOOOOOOOAXXXXXXXXXGOOOXXXXXXXXXXXXXXXXGOOOOOOOOOXXXXXXXXXXGOOOXXXXXXXXXXXXXXXXGOOOOOOOXXXXXXXXXXXXGOOOOOOOOOOOXXXXXXXXGOOOXXXXXXXXXXXXXXXXGOOOOOOXXXXXXXXXXXXXGOOOOXXXXXXXXXXXXXXXGOOOOOOOOOOXXXXXXXXX,0,0,0
12936,100,1,99,119,121,0,0,282,101,181,GOOOOXXXXXXXXXXXXXXXGOOOOOOOOOXXXXXXXXXXGOOOOOOOOXXXXXXXXXXXGOOOOOOOOOAXXXXXXXXXGOOOXXXXXXXXXXXXXXXXGOOOOOOOOOXXXXXXXXXXGOOOXXXXXXXXXXXXXXXXGOOOOOOOXXXXXXXXXXXXGOOOOOOOOOOOXXXXXXXXGOOOXXXXXXXXXXXXXXXXGOOOOOOXXXXXXXXXXXXXGOOOOXXXXXXXXXXXXXXXGOOOOOOOOOOXXXXXXXXX,0,0,0
12957,100,1,99,116,124,0,0,284,98,186,GOOOOXXXXXXXXXXXXXXXGOOOOOOOOOXXXXXXXXXXGOOOOOOOOXXXXXXXXXXXGOOOOOOOOOAXXXXXXXXXGOOOXXXXXXXXXXXXXXXXGOOOOOOOOOXXXXXXXXXXGOOOXXXXXXXXXXXXXXXXGOOOOOOOXXXXXXXXXXXXGOOOOOOOOOOOXXXXXXXXGOOOXXXXXXXXXXXXXXXXGOOOOOOXXXXXXXXXXXXXGOOOOXXXXXXXXXXXXXXXGOOOOOOOOOOXXXXXXXXX,0,0,0
12978,100,0,100,114,126,0,0,287,99,188,GOOOOXXXXXXXXXXXXXXXGOOOOOOOOOXXXXXXXXXXGOOOOOOOOXXXXXXXXXXXGOOOOOOOOOOXXXXXXXXXGOOOXXXXXXXXXXXXXXXXGOOOOOOOOOXXXXXXXXXXGOOOXXXXXXXXXXXXXXXXGOOOOOOOXXXXXXXXXXXXGOOOOOOOOOOOXXXXXXXXGOOOXXXXXXXXXXXXXXXXGOOOOOOXXXXXXXXXXXXXGOOOOXXXXXXXXXXXXXXXGOOOOOOOOOOXXXXXXXXX,0,0,0
12999,100,0,100,114,126,0,0,285,103,182,GOOOOXXXXXXXXXXXXXXXGOOOOOOOOOXXXXXXXXXXGOOOOOOOOXXXXXXXXXXXGOOOOOOOOOOXXXXXXXXXGOOOXXXXXXXXXXXXXXXXGOOOOOOOOOXXXXXXXXXXGOOOXXXXXXXXXXXXXXXXGOOOOOOOXXXXXXXXXXXXGOOOOOOOOOOOXXXXXXXXGOOOXXXXXXXXXXXXXXXXGOOOOOOXXXXXXXXXXXXXGOOOOXXXXXXXXXXXXXXXGOOOOOOOOOOXXXXXXXXX,0,0,0

13020,100,0,100,113,127,0,0,286,104,182,GOOOOXXXXXXXXXXXXXXXGOOOOOOOOOXXXXXXXXXXGOOOOOOOOXXXXXXXXXXXGOOOOOOOOOOXXXXXXXXXGOOOXXXXXXXXXXXXXXXXGOOOOOOOOOXXXXXXXXXXGOOOXXXXXXXXXXXXXXXXGOOOOOOOXXXXXXXXXXXXGOOOOOOOOOOOXXXXXXXXGOOOXXXXXXXXXXXXXXXXGOOOOOOXXXXXXXXXXXXXGOOOOXXXXXXXXXXXXXXXGOOOOOOOOOOXXXXXXXXX,0,0,0
13041,100,0,100,114,126,0,0,286,102,184,GOOOOXXXXXXXXXXXXXXXGOOOOOOOOOXXXXXXXXXXGOOOOOOOOXXXXXXXXXXXGOOOOOOOOOOXXXXXXXXXGOOOXXXXXXXXXXXXXXXXGOOOOOOOOOXXXXXXXXXXGOOOXXXXXXXXXXXXXXXXGOOOOOOOXXXXXXXXXXXXGOOOOOOOOOOOXXXXXXXXGOOOXXXXXXXXXXXXXXXXGOOOOOOXXXXXXXXXXXXXGOOOOXXXXXXXXXXXXXXXGOOOOOOOOOOXXXXXXXXX,0,0,0
13062,100,0,100,117,123,0,0,283,97,186,GOOOOXXXXXXXXXXXXXXXGOOOOOOOOOXXXXXXXXXXGOOOOOOOOXXXXXXXXXXXGOOOOOOOOOOXXXXXXXXXGOOOXXXXXXXXXXXXXXXXGOOOOOOOOOXXXXXXXXXXGOOOXXXXXXXXXXXXXXXXGOOOOOOOXXXXXXXXXXXXGOOOOOOOOOOOXXXXXXXXGOOOXXXXXXXXXXXXXXXXGOOOOOOXXXXXXXXXXXXXGOOOOXXXXXXXXXXXXXXXGOOOOOOOOOOXXXXXXXXX,0,0,0
13083,100,0,100,125,115,0,0,275,96,179,GOOOOXXXXXXXXXXXXXXXGOOOOOOOOOXXXXXXXXXXGOOOOOOOOXXXXXXXXXXXGOOOOOOOOOOXXXXXXXXXGOOOXXXXXXXXXXXXXXXXGOOOOOOOOOXXXXXXXXXXGOOOXXXXXXXXXXXXXXXXGOOOOOOOXXXXXXXXXXXXGOOOOOOOOOOOXXXXXXXXGOOOXXXXXXXXXXXXXXXXGOOOOOOXXXXXXXXXXXXXGOOOOXXXXXXXXXXXXXXXGOOOOOOOOOOXXXXXXXXX,0,0,0
13104,100,0,100,126,114,0,0,274,97,177,GOOOOXXXXXXXXXXXXXXXGOOOOOOOOOXXXXXXXXXXGOOOOOOOOXXXXXXXXXXXGOOOOOOOOOOXXXXXXXXXGOOOXXXXXXXXXXXXXXXXGOOOOOOOOOXXXXXXXXXXGOOOXXXXXXXXXXXXXXXXGOOOOOOOXXXXXXXXXXXXGOOOOOOOOOOOXXXXXXXXGOOOXXXXXXXXXXXXXXXXGOOOOOOXXXXXXXXXXXXXGOOOOXXXXXXXXXXXXXXXGOOOOOOOOOOXXXXXXXXX,0,0,0

13125,100,0,100,131,109,0,0,269,96,173,GOOOOXXXXXXXXXXXXXXXGOOOOOOOOOXXXXXXXXXXGOOOOOOOOXXXXXXXXXXXGOOOOOOOOOOXXXXXXXXXGOOOXXXXXXXXXXXXXXXXGOOOOOOOOOXXXXXXXXXXGOOOXXXXXXXXXXXXXXXXGOOOOOOOXXXXXXXXXXXXGOOOOOOOOOOOXXXXXXXXGOOOXXXXXXXXXXXXXXXXGOOOOOOXXXXXXXXXXXXXGOOOOXXXXXXXXXXXXXXXGOOOOOOOOOOXXXXXXXXX,0,0,0
13146,100,0,100,125,115,0,0,275,101,174,GOOOOXXXXXXXXXXXXXXXGOOOOOOOOOXXXXXXXXXXGOOOOOOOOXXXXXXXXXXXGOOOOOOOOOOXXXXXXXXXGOOOXXXXXXXXXXXXXXXXGOOOOOOOOOXXXXXXXXXXGOOOXXXXXXXXXXXXXXXXGOOOOOOOXXXXXXXXXXXXGOOOOOOOOOOOXXXXXXXXGOOOXXXXXXXXXXXXXXXXGOOOOOOXXXXXXXXXXXXXGOOOOXXXXXXXXXXXXXXXGOOOOOOOOOOXXXXXXXXX,0,0,0
13167,100,0,100,127,113,0,0,273,96,177,GOOOOXXXXXXXXXXXXXXXGOOOOOOOOOXXXXXXXXXXGOOOOOOOOXXXXXXXXXXXGOOOOOOOOOOXXXXXXXXXGOOOXXXXXXXXXXXXXXXXGOOOOOOOOOXXXXXXXXXXGOOOXXXXXXXXXXXXXXXXGOOOOOOOXXXXXXXXXXXXGOOOOOOOOOOOXXXXXXXXGOOOXXXXXXXXXXXXXXXXGOOOOOOXXXXXXXXXXXXXGOOOOXXXXXXXXXXXXXXXGOOOOOOOOOOXXXXXXXXX,0,0,0
13188,101,1,100,130,109,0,0,269,99,170,GOOOOXXXXXXXXXXXXXXXGOOOOOOOOOXXXXXXXXXXGOOOOOOOOAXXXXXXXXXXGOOOOOOOOOOXXXXXXXXXGOOOXXXXXXXXXXXXXXXXGOOOOOOOOOXXXXXXXXXXGOOOXXXXXXXXXXXXXXXXGOOOOOOOXXXXXXXXXXXXGOOOOOOOOOOOXXXXXXXXGOOOXXXXXXXXXXXXXXXXGOOOOOOXXXXXXXXXXXXXGOOOOXXXXXXXXXXXXXXXGOOOOOOOOOOXXXXXXXXX,0,0,0
13209,101,0,101,130,109,0,0,268,92,176,GOOOOXXXXXXXXXXXXXXXGOOOOOOOOOXXXXXXXXXXGOOOOOOOOOXXXXXXXXXXGOOOOOOOOOOXXXXXXXXXGOOOXXXXXXXXXXXXXXXXGOOOOOOOOOXXXXXXXXXXGOOOXXXXXXXXXXXXXXXXGOOOOOOOXXXXXXXXXXXXGOOOOOOOOOOOXXXXXXXXGOOOXXXXXXXXXXXXXXXXGOOOOOOXXXXXXXXXXXXXGOOOOXXXXXXXXXXXXXXXGOOOOOOOOOOXXXXXXXXX,0,0,0

13230,101,0,101,120,119,0,0,278,100,178,GOOOOXXXXXXXXXXXXXXXGOOOOOOOOOXXXXXXXXXXGOOOOOOOOOXXXXXXXXXXGOOOOOOOOOOXXXXXXXXXGOOOXXXXXXXXXXXXXXXXGOOOOOOOOOXXXXXXXXXXGOOOXXXXXXXXXXXXXXXXGOOOOOOOXXXXXXXXXXXXGOOOOOOOOOOOXXXXXXXXGOOOXXXXXXXXXXXXXXXXGOOOOOOXXXXXXXXXXXXXGOOOOXXXXXXXXXXXXXXXGOOOOOOOOOOXXXXXXXXX,0,0,0
13251,101,0,101,118,121,0,0,281,106,175,GOOOOXXXXXXXXXXXXXXXGOOOOOOOOOXXXXXXXXXXGOOOOOOOOOXXXXXXXXXXGOOOOOOOOOOXXXXXXXXXGOOOXXXXXXXXXXXXXXXXGOOOOOOOOOXXXXXXXXXXGOOOXXXXXXXXXXXXXXXXGOOOOOOOXXXXXXXXXXXXGOOOOOOOOOOOXXXXXXXXGOOOXXXXXXXXXXXXXXXXGOOOOOOXXXXXXXXXXXXXGOOOOXXXXXXXXXXXXXXXGOOOOOOOOOOXXXXXXXXX,0,0,0
13272,101,0,101,121,118,0,0,278,102,176,GOOOOXXXXXXXXXXXXXXXGOOOOOOOOOXXXXXXXXXXGOOOOOOOOOXXXXXXXXXXGOOOOOOOOOOXXXXXXXXXGOOOXXXXXXXXXXXXXXXXGOOOOOOOOOXXXXXXXXXXGOOOXXXXXXXXXXXXXXXXGOOOOOOOXXXXXXXXXXXXGOOOOOOOOOOOXXXXXXXXGOOOXXXXXXXXXXXXXXXXGOOOOOOXXXXXXXXXXXXXGOOOOXXXXXXXXXXXXXXXGOOOOOOOOOOXXXXXXXXX,0,0,0
13293,101,0,101,128,111,0,0,271,101,170,GOOOOXXXXXXXXXXXXXXXGOOOOOOOOOXXXXXXXXXXGOOOOOOOOOXXXXXXXXXXGOOOOOOOOOOXXXXXXXXXGOOOXXXXXXXXXXXXXXXXGOOOOOOOOOXXXXXXXXXXGOOOXXXXXXXXXXXXXXXXGOOOOOOOXXXXXXXXXXXXGOOOOOOOOOOOXXXXXXXXGOOOXXXXXXXXXXXXXXXXGOOOOOOXXXXXXXXXXXXXGOOOOXXXXXXXXXXXXXXXGOOOOOOOOOOXXXXXXXXX,0,0,0
13314,102,1,101,122,116,0,0,276,109,167,GOOOOXXXXXXXXXXXXXXXGOOOOOOOOOXXXXXXXXXXGOOOOOOOOOXXXXXXXXXXGOOOOOOOOOOAXXXXXXXXGOOOXXXXXXXXXXXXXXXXGOOOOOOOOOXXXXXXXXXXGOOOXXXXXXXXXXXXXXXXGOOOOOOOXXXXXXXXXXXXGOOOOOOOOOOOXXXXXXXXGOOOXXXXXXXXXXXXXXXXGOOOOOOXXXXXXXXXXXXXGOOOOXXXXXXXXXXXXXXXGOOOOOOOOOOXXXXXXXXX,0,0,0

13335,102,1,101,123,115,0,0,274,107,167,GOOOOXXXXXXXXXXXXXXXGOOOOOOOOOXXXXXXXXXXGOOOOOOOOOXXXXXXXXXXGOOOOOOOOOOAXXXXXXXXGOOOXXXXXXXXXXXXXXXXGOOOOOOOOOXXXXXXXXXXGOOOXXXXXXXXXXXXXXXXGOOOOOOOXXXXXXXXXXXXGOOOOOOOOOOOXXXXXXXXGOOOXXXXXXXXXXXXXXXXGOOOOOOXXXXXXXXXXXXXGOOOOXXXXXXXXXXXXXXXGOOOOOOOOOOXXXXXXXXX,0,0,0
13356,102,1,101,120,118,0,0,276,101,175,GOOOOXXXXXXXXXXXXXXXGOOOOOOOOOXXXXXXXXXXGOOOOOOOOOXXXXXXXXXXGOOOOOOOOOOAXXXXXXXXGOOOXXXXXXXXXXXXXXXXGOOOOOOOOOXXXXXXXXXXGOOOXXXXXXXXXXXXXXXXGOOOOOOOXXXXXXXXXXXXGOOOOOOOOOOOXXXXXXXXGOOOXXXXXXXXXXXXXXXXGOOOOOOXXXXXXXXXXXXXGOOOOXXXXXXXXXXXXXXXGOOOOOOOOOOXXXXXXXXX,0,0,0
13377,102,0,102,117,121,0,0,281,99,182,GOOOOXXXXXXXXXXXXXXXGOOOOOOOOOXXXXXXXXXXGOOOOOOOOOXXXXXXXXXXGOOOOOOOOOOOXXXXXXXXGOOOXXXXXXXXXXXXXXXXGOOOOOOOOOXXXXXXXXXXGOOOXXXXXXXXXXXXXXXXGOOOOOOOXXXXXXXXXXXXGOOOOOOOOOOOXXXXXXXXGOOOXXXXXXXXXXXXXXXXGOOOOOOXXXXXXXXXXXXXGOOOOXXXXXXXXXXXXXXXGOOOOOOOOOOXXXXXXXXX,0,0,0
13398,103,1,102,112,125,0,0,285,100,185,GOOOOXXXXXXXXXXXXXXXGOOOOOOOOOXXXXXXXXXXGOOOOOOOOOXXXXXXXXXXGOOOOOOOOOOOXXXXXXXXGOOOXXXXXXXXXXXXXXXXGOOOOOOOOOAXXXXXXXXXGOOOXXXXXXXXXXXXXXXXGOOOOOOOXXXXXXXXXXXXGOOOOOOOOOOOXXXXXXXXGOOOXXXXXXXXXXXXXXXXGOOOOOOXXXXXXXXXXXXXGOOOOXXXXXXXXXXXXXXXGOOOOOOOOOOXXXXXXXXX,0,0,0
13419,103,1,102,116,121,0,0,280,99,181,GOOOOXXXXXXXXXXXXXXXGOOOOOOOOOXXXXXXXXXXGOOOOOOOOOXXXXXXXXXXGOOOOOOOOOOOXXXXXXXXGOOOXXXXXXXXXXXXXXXXGOOOOOOOOOAXXXXXXXXXGOOOXXXXXXXXXXXXXXXXGOOOOOOOXXXXXXXXXXXXGOOOOOOOOOOOXXXXXXXXGOOOXXXXXXXXXXXXXXXXGOOOOOOXXXXXXXXXXXXXGOOOOXXXXXXXXXXXXXXXGOOOOOOOOOOXXXXXXXXX,0,0,0

13440,103,1,102,112,125,0,0,285,100,185,GOOOOXXXXXXXXXXXXXXXGOOOOOOOOOXXXXXXXXXXGOOOOOOOOOXXXXXXXXXXGOOOOOOOOOOOXXXXXXXXGOOOXXXXXXXXXXXXXXXXGOOOOOOOOOAXXXXXXXXXGOOOXXXXXXXXXXXXXXXXGOOOOOOOXXXXXXXXXXXXGOOOOOOOOOOOXXXXXXXXGOOOXXXXXXXXXXXXXXXXGOOOOOOXXXXXXXXXXXXXGOOOOXXXXXXXXXXXXXXXGOOOOOOOOOOXXXXXXXXX,0,0,0
13461,103,0,103,116,121,0,0,281,97,184,GOOOOXXXXXXXXXXXXXXXGOOOOOOOOOXXXXXXXXXXGOOOOOOOOOXXXXXXXXXXGOOOOOOOOOOOXXXXXXXXGOOOXXXXXXXXXXXXXXXXGOOOOOOOOOOXXXXXXXXXGOOOXXXXXXXXXXXXXXXXGOOOOOOOXXXXXXXXXXXXGOOOOOOOOOOOXXXXXXXXGOOOXXXXXXXXXXXXXXXXGOOOOOOXXXXXXXXXXXXXGOOOOXXXXXXXXXXXXXXXGOOOOOOOOOOXXXXXXXXX,0,0,0
13482,103,0,103,116,121,0,0,281,97,184,GOOOOXXXXXXXXXXXXXXXGOOOOOOOOOXXXXXXXXXXGOOOOOOOOOXXXXXXXXXXGOOOOOOOOOOOXXXXXXXXGOOOXXXXXXXXXXXXXXXXGOOOOOOOOOOXXXXXXXXXGOOOXXXXXXXXXXXXXXXXGOOOOOOOXXXXXXXXXXXXGOOOOOOOOOOOXXXXXXXXGOOOXXXXXXXXXXXXXXXXGOOOOOOXXXXXXXXXXXXXGOOOOXXXXXXXXXXXXXXXGOOOOOOOOOOXXXXXXXXX,0,0,0
13503,103,0,103,115,122,0,0,282,89,193,GOOOOXXXXXXXXXXXXXXXGOOOOOOOOOXXXXXXXXXXGOOOOOOOOOXXXXXXXXXXGOOOOOOOOOOOXXXXXXXXGOOOXXXXXXXXXXXXXXXXGOOOOOOOOOOXXXXXXXXXGOOOXXXXXXXXXXXXXXXXGOOOOOOOXXXXXXXXXXXXGOOOOOOOOOOOXXXXXXXXGOOOXXXXXXXXXXXXXXXXGOOOOOOXXXXXXXXXXXXXGOOOOXXXXXXXXXXXXXXXGOOOOOOOOOOXXXXXXXXX,0,0,0
13524,103,0,103,115,122,0,0,282,93,189,GOOOOXXXXXXXXXXXXXXXGOOOOOOOOOXXXXXXXXXXGOOOOOOOOOXXXXXXXXXXGOOOOOOOOOOOXXXXXXXXGOOOXXXXXXXXXXXXXXXXGOOOOOOOOOOXXXXXXXXXGOOOXXXXXXXXXXXXXXXXGOOOOOOOXXXXXXXXXXXXGOOOOOOOOOOOXXXXXXXXGOOOXXXXXXXXXXXXXXXXGOOOOOOXXXXXXXXXXXXXGOOOOXXXXXXXXXXXXXXXGOOOOOOOOOOXXXXXXXXX,0,0,0

13545,103,0,103,109,128,0,0,287,101,186,GOOOOXXXXXXXXXXXXXXXGOOOOOOOOOXXXXXXXXXXGOOOOOOOOOXXXXXXXXXXGOOOOOOOOOOOXXXXXXXXGOOOXXXXXXXXXXXXXXXXGOOOOOOOOOOXXXXXXXXXGOOOXXXXXXXXXXXXXXXXGOOOOOOOXXXXXXXXXXXXGOOOOOOOOOOOXXXXXXXXGOOOXXXXXXXXXXXXXXXXGOOOOOOXXXXXXXXXXXXXGOOOOXXXXXXXXXXXXXXXGOOOOOOOOOOXXXXXXXXX,0,0,0
13566,103,0,103,115,122,0,0,281,104,177,GOOOOXXXXXXXXXXXXXXXGOOOOOOOOOXXXXXXXXXXGOOOOOOOOOXXXXXXXXXXGOOOOOOOOOOOXXXXXXXXGOOOXXXXXXXXXXXXXXXXGOOOOOOOOOOXXXXXXXXXGOOOXXXXXXXXXXXXXXXXGOOOOOOOXXXXXXXXXXXXGOOOOOOOOOOOXXXXXXXXGOOOXXXXXXXXXXXXXXXXGOOOOOOXXXXXXXXXXXXXGOOOOXXXXXXXXXXXXXXXGOOOOOOOOOOXXXXXXXXX,0,0,0
13587,103,0,103,116,121,0,0,280,106,174,GOOOOXXXXXXXXXXXXXXXGOOOOOOOOOXXXXXXXXXXGOOOOOOOOOXXXXXXXXXXGOOOOOOOOOOOXXXXXXXXGOOOXXXXXXXXXXXXXXXXGOOOOOOOOOOXXXXXXXXXGOOOXXXXXXXXXXXXXXXXGOOOOOOOXXXXXXXXXXXXGOOOOOOOOOOOXXXXXXXXGOOOXXXXXXXXXXXXXXXXGOOOOOOXXXXXXXXXXXXXGOOOOXXXXXXXXXXXXXXXGOOOOOOOOOOXXXXXXXXX,0,0,0
13608,103,0,103,111,126,0,0,286,116,170,GOOOOXXXXXXXXXXXXXXXGOOOOOOOOOXXXXXXXXXXGOOOOOOOOOXXXXXXXXXXGOOOOOOOOOOOXXXXXXXXGOOOXXXXXXXXXXXXXXXXGOOOOOOOOOOXXXXXXXXXGOOOXXXXXXXXXXXXXXXXGOOOOOOOXXXXXXXXXXXXGOOOOOOOOOOOXXXXXXXXGOOOXXXXXXXXXXXXXXXXGOOOOOOXXXXXXXXXXXXXGOOOOXXXXXXXXXXXXXXXGOOOOOOOOOOXXXXXXXXX,0,0,0
13629,103,0,103,114,123,0,0,283,106,177,GOOOOXXXXXXXXXXXXXXXGOOOOOOOOOXXXXXXXXXXGOOOOOOOOOXXXXXXXXXXGOOOOOOOOOOOXXXXXXXXGOOOXXXXXXXXXXXXXXXXGOOOOOOOOOOXXXXXXXXXGOOOXXXXXXXXXXXXXXXXGOOOOOOOXXXXXXXXXXXXGOOOOOOOOOOOXXXXXXXXGOOOXXXXXXXXXXXXXXXXGOOOOOOXXXXXXXXXXXXXGOOOOXXXXXXXXXXXXXXXGOOOOOOOOOOXXXXXXXXX,0,0,0

13650,103,0,103,115,122,0,0,282,108,174,GOOOOXXXXXXXXXXXXXXXGOOOOOOOOOXXXXXXXXXXGOOOOOOOOOXXXXXXXXXXGOOOOOOOOOOOXXXXXXXXGOOOXXXXXXXXXXXXXXXXGOOOOOOOOOOXXXXXXXXXGOOOXXXXXXXXXXXXXXXXGOOOOOOOXXXXXXXXXXXXGOOOOOOOOOOOXXXXXXXXGOOOXXXXXXXXXXXXXXXXGOOOOOOXXXXXXXXXXXXXGOOOOXXXXXXXXXXXXXXXGOOOOOOOOOOXXXXXXXXX,0,0,0
13671,103,0,103,119,118,0,0,278,109,169,GOOOOXXXXXXXXXXXXXXXGOOOOOOOOOXXXXXXXXXXGOOOOOOOOOXXXXXXXXXXGOOOOOOOOOOOXXXXXXXXGOOOXXXXXXXXXXXXXXXXGOOOOOOOOOOXXXXXXXXXGOOOXXXXXXXXXXXXXXXXGOOOOOOOXXXXXXXXXXXXGOOOOOOOOOOOXXXXXXXXGOOOXXXXXXXXXXXXXXXXGOOOOOOXXXXXXXXXXXXXGOOOOXXXXXXXXXXXXXXXGOOOOOOOOOOXXXXXXXXX,0,0,0
13692,103,0,103,119,118,0,0,278,108,170,GOOOOXXXXXXXXXXXXXXXGOOOOOOOOOXXXXXXXXXXGOOOOOOOOOXXXXXXXXXXGOOOOOOOOOOOXXXXXXXXGOOOXXXXXXXXXXXXXXXXGOOOOOOOOOOXXXXXXXXXGOOOXXXXXXXXXXXXXXXXGOOOOOOOXXXXXXXXXXXXGOOOOOOOOOOOXXXXXXXXGOOOXXXXXXXXXXXXXXXXGOOOOOOXXXXXXXXXXXXXGOOOOXXXXXXXXXXXXXXXGOOOOOOOOOOXXXXXXXXX,0,0,0
13713,103,0,103,122,115,0,0,275,109,166,GOOOOXXXXXXXXXXXXXXXGOOOOOOOOOXXXXXXXXXXGOOOOOOOOOXXXXXXXXXXGOOOOOOOOOOOXXXXXXXXGOOOXXXXXXXXXXXXXXXXGOOOOOOOOOOXXXXXXXXXGOOOXXXXXXXXXXXXXXXXGOOOOOOOXXXXXXXXXXXXGOOOOOOOOOOOXXXXXXXXGOOOXXXXXXXXXXXXXXXXGOOOOOOXXXXXXXXXXXXXGOOOOXXXXXXXXXXXXXXXGOOOOOOOOOOXXXXXXXXX,0,0,0
13734,103,0,103,131,106,0,0,265,100,165,GOOOOXXXXXXXXXXXXXXXGOOOOOOOOOXXXXXXXXXXGOOOOOOOOOXXXXXXXXXXGOOOOOOOOOOOXXXXXXXXGOOOXXXXXXXXXXXXXXXXGOOOOOOOOOOXXXXXXXXXGOOOXXXXXXXXXXXXXXXXGOOOOOOOXXXXXXXXXXXXGOOOOOOOOOOOXXXXXXXXGOOOXXXXXXXXXXXXXXXXGOOOOOOXXXXXXXXXXXXXGOOOOXXXXXXXXXXXXXXXGOOOOOOOOOOXXXXXXXXX,0,0,0

13755,103,0,103,129,108,0,0,266,103,163,GOOOOXXXXXXXXXXXXXXXGOOOOOOOOOXXXXXXXXXXGOOOOOOOOOXXXXXXXXXXGOOOOOOOOOOOXXXXXXXXGOOOXXXXXXXXXXXXXXXXGOOOOOOOOOOXXXXXXXXXGOOOXXXXXXXXXXXXXXXXGOOOOOOOXXXXXXXXXXXXGOOOOOOOOOOOXXXXXXXXGOOOXXXXXXXXXXXXXXXXGOOOOOOXXXXXXXXXXXXXGOOOOXXXXXXXXXXXXXXXGOOOOOOOOOOXXXXXXXXX,0,0,0
13776,103,0,103,121,116,0,0,276,107,169,GOOOOXXXXXXXXXXXXXXXGOOOOOOOOOXXXXXXXXXXGOOOOOOOOOXXXXXXXXXXGOOOOOOOOOOOXXXXXXXXGOOOXXXXXXXXXXXXXXXXGOOOOOOOOOOXXXXXXXXXGOOOXXXXXXXXXXXXXXXXGOOOOOOOXXXXXXXXXXXXGOOOOOOOOOOOXXXXXXXXGOOOXXXXXXXXXXXXXXXXGOOOOOOXXXXXXXXXXXXXGOOOOXXXXXXXXXXXXXXXGOOOOOOOOOOXXXXXXXXX,0,0,0
13797,103,0,103,122,115,0,0,273,103,170,GOOOOXXXXXXXXXXXXXXXGOOOOOOOOOXXXXXXXXXXGOOOOOOOOOXXXXXXXXXXGOOOOOOOOOOOXXXXXXXXGOOOXXXXXXXXXXXXXXXXGOOOOOOOOOOXXXXXXXXXGOOOXXXXXXXXXXXXXXXXGOOOOOOOXXXXXXXXXXXXGOOOOOOOOOOOXXXXXXXXGOOOXXXXXXXXXXXXXXXXGOOOOOOXXXXXXXXXXXXXGOOOOXXXXXXXXXXXXXXXGOOOOOOOOOOXXXXXXXXX,0,0,0
13818,103,0,103,120,117,0,0,276,107,169,GOOOOXXXXXXXXXXXXXXXGOOOOOOOOOXXXXXXXXXXGOOOOOOOOOXXXXXXXXXXGOOOOOOOOOOOXXXXXXXXGOOOXXXXXXXXXXXXXXXXGOOOOOOOOOOXXXXXXXXXGOOOXXXXXXXXXXXXXXXXGOOOOOOOXXXXXXXXXXXXGOOOOOOOOOOOXXXXXXXXGOOOXXXXXXXXXXXXXXXXGOOOOOOXXXXXXXXXXXXXGOOOOXXXXXXXXXXXXXXXGOOOOOOOOOOXXXXXXXXX,0,0,0
13839,103,0,103,118,119,0,0,278,106,172,GOOOOXXXXXXXXXXXXXXXGOOOOOOOOOXXXXXXXXXXGOOOOOOOOOXXXXXXXXXXGOOOOOOOOOOOXXXXXXXXGOOOXXXXXXXXXXXXXXXXGOOOOOOOOOOXXXXXXXXXGOOOXXXXXXXXXXXXXXXXGOOOOOOOXXXXXXXXXXXXGOOOOOOOOOOOXXXXXXXXGOOOXXXXXXXXXXXXXXXXGOOOOOOXXXXXXXXXXXXXGOOOOXXXXXXXXXXXXXXXGOOOOOOOOOOXXXXXXXXX,0,0,0

13860,103,0,103,117,120,0,0,280,109,171,GOOOOXXXXXXXXXXXXXXXGOOOOOOOOOXXXXXXXXXXGOOOOOOOOOXXXXXXXXXXGOOOOOOOOOOOXXXXXXXXGOOOXXXXXXXXXXXXXXXXGOOOOOOOOOOXXXXXXXXXGOOOXXXXXXXXXXXXXXXXGOOOOOOOXXXXXXXXXXXXGOOOOOOOOOOOXXXXXXXXGOOOXXXXXXXXXXXXXXXXGOOOOOOXXXXXXXXXXXXXGOOOOXXXXXXXXXXXXXXXGOOOOOOOOOOXXXXXXXXX,0,0,0
13881,103,0,103,110,127,0,0,287,113,174,GOOOOXXXXXXXXXXXXXXXGOOOOOOOOOXXXXXXXXXXGOOOOOOOOOXXXXXXXXXXGOOOOOOOOOOOXXXXXXXXGOOOXXXXXXXXXXXXXXXXGOOOOOOOOOOXXXXXXXXXGOOOXXXXXXXXXXXXXXXXGOOOOOOOXXXXXXXXXXXXGOOOOOOOOOOOXXXXXXXXGOOOXXXXXXXXXXXXXXXXGOOOOOOXXXXXXXXXXXXXGOOOOXXXXXXXXXXXXXXXGOOOOOOOOOOXXXXXXXXX,0,0,0
13902,103,0,103,111,126,0,0,285,112,173,GOOOOXXXXXXXXXXXXXXXGOOOOOOOOOXXXXXXXXXXGOOOOOOOOOXXXXXXXXXXGOOOOOOOOOOOXXXXXXXXGOOOXXXXXXXXXXXXXXXXGOOOOOOOOOOXXXXXXXXXGOOOXXXXXXXXXXXXXXXXGOOOOOOOXXXXXXXXXXXXGOOOOOOOOOOOXXXXXXXXGOOOXXXXXXXXXXXXXXXXGOOOOOOXXXXXXXXXXXXXGOOOOXXXXXXXXXXXXXXXGOOOOOOOOOOXXXXXXXXX,0,0,0
13923,103,0,103,110,127,0,0,287,112,175,GOOOOXXXXXXXXXXXXXXXGOOOOOOOOOXXXXXXXXXXGOOOOOOOOOXXXXXXXXXXGOOOOOOOOOOOXXXXXXXXGOOOXXXXXXXXXXXXXXXXGOOOOOOOOOOXXXXXXXXXGOOOXXXXXXXXXXXXXXXXGOOOOOOOXXXXXXXXXXXXGOOOOOOOOOOOXXXXXXXXGOOOXXXXXXXXXXXXXXXXGOOOOOOXXXXXXXXXXXXXGOOOOXXXXXXXXXXXXXXXGOOOOOOOOOOXXXXXXXXX,0,0,0
13944,103,0,103,114,123,0,0,283,115,168,GOOOOXXXXXXXXXXXXXXXGOOOOOOOOOXXXXXXXXXXGOOOOOOOOOXXXXXXXXXXGOOOOOOOOOOOXXXXXXXXGOOOXXXXXXXXXXXXXXXXGOOOOOOOOOOXXXXXXXXXGOOOXXXXXXXXXXXXXXXXGOOOOOOOXXXXXXXXXXXXGOOOOOOOOOOOXXXXXXXXGOOOXXXXXXXXXXXXXXXXGOOOOOOXXXXXXXXXXXXXGOOOOXXXXXXXXXXXXXXXGOOOOOOOOOOXXXXXXXXX,0,0,0

13965,103,0,103,111,126,0,0,286,118,168,GOOOOXXXXXXXXXXXXXXXGOOOOOOOOOXXXXXXXXXXGOOOOOOOOOXXXXXXXXXXGOOOOOOOOOOOXXXXXXXXGOOOXXXXXXXXXXXXXXXXGOOOOOOOOOOXXXXXXXXXGOOOXXXXXXXXXXXXXXXXGOOOOOOOXXXXXXXXXXXXGOOOOOOOOOOOXXXXXXXXGOOOXXXXXXXXXXXXXXXXGOOOOOOXXXXXXXXXXXXXGOOOOXXXXXXXXXXXXXXXGOOOOOOOOOOXXXXXXXXX,0,0,0
13986,103,0,103,119,118,0,0,277,111,166,GOOOOXXXXXXXXXXXXXXXGOOOOOOOOOXXXXXXXXXXGOOOOOOOOOXXXXXXXXXXGOOOOOOOOOOOXXXXXXXXGOOOXXXXXXXXXXXXXXXXGOOOOOOOOOOXXXXXXXXXGOOOXXXXXXXXXXXXXXXXGOOOOOOOXXXXXXXXXXXXGOOOOOOOOOOOXXXXXXXXGOOOXXXXXXXXXXXXXXXXGOOOOOOXXXXXXXXXXXXXGOOOOXXXXXXXXXXXXXXXGOOOOOOOOOOXXXXXXXXX,0,0,0
14007,103,0,103,120,117,0,0,277,103,174,GOOOOXXXXXXXXXXXXXXXGOOOOOOOOOXXXXXXXXXXGOOOOOOOOOXXXXXXXXXXGOOOOOOOOOOOXXXXXXXXGOOOXXXXXXXXXXXXXXXXGOOOOOOOOOOXXXXXXXXXGOOOXXXXXXXXXXXXXXXXGOOOOOOOXXXXXXXXXXXXGOOOOOOOOOOOXXXXXXXXGOOOXXXXXXXXXXXXXXXXGOOOOOOXXXXXXXXXXXXXGOOOOXXXXXXXXXXXXXXXGOOOOOOOOOOXXXXXXXXX,0,0,0
14028,103,0,103,122,115,0,0,274,102,172,GOOOOXXXXXXXXXXXXXXXGOOOOOOOOOXXXXXXXXXXGOOOOOOOOOXXXXXXXXXXGOOOOOOOOOOOXXXXXXXXGOOOXXXXXXXXXXXXXXXXGOOOOOOOOOOXXXXXXXXXGOOOXXXXXXXXXXXXXXXXGOOOOOOOXXXXXXXXXXXXGOOOOOOOOOOOXXXXXXXXGOOOXXXXXXXXXXXXXXXXGOOOOOOXXXXXXXXXXXXXGOOOOXXXXXXXXXXXXXXXGOOOOOOOOOOXXXXXXXXX,0,0,0
14049,103,0,103,122,115,0,0,275,102,173,GOOOOXXXXXXXXXXXXXXXGOOOOOOOOOXXXXXXXXXXGOOOOOOOOOXXXXXXXXXXGOOOOOOOOOOOXXXXXXXXGOOOXXXXXXXXXXXXXXXXGOOOOOOOOOOXXXXXXXXXGOOOXXXXXXXXXXXXXXXXGOOOOOOOXXXXXXXXXXXXGOOOOOOOOOOOXXXXXXXXGOOOXXXXXXXXXXXXXXXXGOOOOOOXXXXXXXXXXXXXGOOOOXXXXXXXXXXXXXXXGOOOOOOOOOOXXXXXXXXX,0,0,0

14070,103,0,103,115,122,0,0,280,105,175,GOOOOXXXXXXXXXXXXXXXGOOOOOOOOOXXXXXXXXXXGOOOOOOOOOXXXXXXXXXXGOOOOOOOOOOOXXXXXXXXGOOOXXXXXXXXXXXXXXXXGOOOOOOOOOOXXXXXXXXXGOOOXXXXXXXXXXXXXXXXGOOOOOOOXXXXXXXXXXXXGOOOOOOOOOOOXXXXXXXXGOOOXXXXXXXXXXXXXXXXGOOOOOOXXXXXXXXXXXXXGOOOOXXXXXXXXXXXXXXXGOOOOOOOOOOXXXXXXXXX,0,0,0
14091,103,0,103,110,127,0,0,287,105,182,GOOOOXXXXXXXXXXXXXXXGOOOOOOOOOXXXXXXXXXXGOOOOOOOOOXXXXXXXXXXGOOOOOOOOOOOXXXXXXXXGOOOXXXXXXXXXXXXXXXXGOOOOOOOOOOXXXXXXXXXGOOOXXXXXXXXXXXXXXXXGOOOOOOOXXXXXXXXXXXXGOOOOOOOOOOOXXXXXXXXGOOOXXXXXXXXXXXXXXXXGOOOOOOXXXXXXXXXXXXXGOOOOXXXXXXXXXXXXXXXGOOOOOOOOOOXXXXXXXXX,0,0,0
14112,103,0,103,113,124,0,0,284,107,177,GOOOOXXXXXXXXXXXXXXXGOOOOOOOOOXXXXXXXXXXGOOOOOOOOOXXXXXXXXXXGOOOOOOOOOOOXXXXXXXXGOOOXXXXXXXXXXXXXXXXGOOOOOOOOOOXXXXXXXXXGOOOXXXXXXXXXXXXXXXXGOOOOOOOXXXXXXXXXXXXGOOOOOOOOOOOXXXXXXXXGOOOXXXXXXXXXXXXXXXXGOOOOOOXXXXXXXXXXXXXGOOOOXXXXXXXXXXXXXXXGOOOOOOOOOOXXXXXXXXX,0,0,0
14133,103,0,103,114,123,0,0,283,106,177,GOOOOXXXXXXXXXXXXXXXGOOOOOOOOOXXXXXXXXXXGOOOOOOOOOXXXXXXXXXXGOOOOOOOOOOOXXXXXXXXGOOOXXXXXXXXXXXXXXXXGOOOOOOOOOOXXXXXXXXXGOOOXXXXXXXXXXXXXXXXGOOOOOOOXXXXXXXXXXXXGOOOOOOOOOOOXXXXXXXXGOOOXXXXXXXXXXXXXXXXGOOOOOOXXXXXXXXXXXXXGOOOOXXXXXXXXXXXXXXXGOOOOOOOOOOXXXXXXXXX,0,0,0
14154,103,0,103,113,124,0,0,284,108,176,GOOOOXXXXXXXXXXXXXXXGOOOOOOOOOXXXXXXXXXXGOOOOOOOOOXXXXXXXXXXGOOOOOOOOOOOXXXXXXXXGOOOXXXXXXXXXXXXXXXXGOOOOOOOOOOXXXXXXXXXGOOOXXXXXXXXXXXXXXXXGOOOOOOOXXXXXXXXXXXXGOOOOOOOOOOOXXXXXXXXGOOOXXXXXXXXXXXXXXXXGOOOOOOXXXXXXXXXXXXXGOOOOXXXXXXXXXXXXXXXGOOOOOOOOOOXXXXXXXXX,0,0,0

14175,103,0,103,115,122,0,0,283,105,178,GOOOOXXXXXXXXXXXXXXXGOOOOOOOOOXXXXXXXXXXGOOOOOOOOOXXXXXXXXXXGOOOOOOOOOOOXXXXXXXXGOOOXXXXXXXXXXXXXXXXGOOOOOOOOOOXXXXXXXXXGOOOXXXXXXXXXXXXXXXXGOOOOOOOXXXXXXXXXXXXGOOOOOOOOOOOXXXXXXXXGOOOXXXXXXXXXXXXXXXXGOOOOOOXXXXXXXXXXXXXGOOOOXXXXXXXXXXXXXXXGOOOOOOOOOOXXXXXXXXX,0,0,0
14196,103,0,103,112,125,0,0,286,111,175,GOOOOXXXXXXXXXXXXXXXGOOOOOOOOOXXXXXXXXXXGOOOOOOOOOXXXXXXXXXXGOOOOOOOOOOOXXXXXXXXGOOOXXXXXXXXXXXXXXXXGOOOOOOOOOOXXXXXXXXXGOOOXXXXXXXXXXXXXXXXGOOOOOOOXXXXXXXXXXXXGOOOOOOOOOOOXXXXXXXXGOOOXXXXXXXXXXXXXXXXGOOOOOOXXXXXXXXXXXXXGOOOOXXXXXXXXXXXXXXXGOOOOOOOOOOXXXXXXXXX,0,0,0
14217,103,0,103,114,123,0,0,285,105,180,GOOOOXXXXXXXXXXXXXXXGOOOOOOOOOXXXXXXXXXXGOOOOOOOOOXXXXXXXXXXGOOOOOOOOOOOXXXXXXXXGOOOXXXXXXXXXXXXXXXXGOOOOOOOOOOXXXXXXXXXGOOOXXXXXXXXXXXXXXXXGOOOOOOOXXXXXXXXXXXXGOOOOOOOOOOOXXXXXXXXGOOOXXXXXXXXXXXXXXXXGOOOOOOXXXXXXXXXXXXXGOOOOXXXXXXXXXXXXXXXGOOOOOOOOOOXXXXXXXXX,0,0,0
14238,103,0,103,118,119,0,0,281,105,176,GOOOOXXXXXXXXXXXXXXXGOOOOOOOOOXXXXXXXXXXGOOOOOOOOOXXXXXXXXXXGOOOOOOOOOOOXXXXXXXXGOOOXXXXXXXXXXXXXXXXGOOOOOOOOOOXXXXXXXXXGOOOXXXXXXXXXXXXXXXXGOOOOOOOXXXXXXXXXXXXGOOOOOOOOOOOXXXXXXXXGOOOXXXXXXXXXXXXXXXXGOOOOOOXXXXXXXXXXXXXGOOOOXXXXXXXXXXXXXXXGOOOOOOOOOOXXXXXXXXX,0,0,0
14259,103,0,103,121,116,0,0,278,99,179,GOOOOXXXXXXXXXXXXXXXGOOOOOOOOOXXXXXXXXXXGOOOOOOOOOXXXXXXXXXXGOOOOOOOOOOOXXXXXXXXGOOOXXXXXXXXXXXXXXXXGOOOOOOOOOOXXXXXXXXXGOOOXXXXXXXXXXXXXXXXGOOOOOOOXXXXXXXXXXXXGOOOOOOOOOOOXXXXXXXXGOOOXXXXXXXXXXXXXXXXGOOOOOOXXXXXXXXXXXXXGOOOOXXXXXXXXXXXXXXXGOOOOOOOOOOXXXXXXXXX,0,0,0

14280,103,0,103,116,121,0,0,281,104,177,GOOOOXXXXXXXXXXXXXXXGOOOOOOOOOXXXXXXXXXXGOOOOOOOOOXXXXXXXXXXGOOOOOOOOOOOXXXXXXXXGOOOXXXXXXXXXXXXXXXXGOOOOOOOOOOXXXXXXXXXGOOOXXXXXXXXXXXXXXXXGOOOOOOOXXXXXXXXXXXXGOOOOOOOOOOOXXXXXXXXGOOOXXXXXXXXXXXXXXXXGOOOOOOXXXXXXXXXXXXXGOOOOXXXXXXXXXXXXXXXGOOOOOOOOOOXXXXXXXXX,0,0,0
14301,103,0,103,113,124,0,0,285,106,179,GOOOOXXXXXXXXXXXXXXXGOOOOOOOOOXXXXXXXXXXGOOOOOOOOOXXXXXXXXXXGOOOOOOOOOOOXXXXXXXXGOOOXXXXXXXXXXXXXXXXGOOOOOOOOOOXXXXXXXXXGOOOXXXXXXXXXXXXXXXXGOOOOOOOXXXXXXXXXXXXGOOOOOOOOOOOXXXXXXXXGOOOXXXXXXXXXXXXXXXXGOOOOOOXXXXXXXXXXXXXGOOOOXXXXXXXXXXXXXXXGOOOOOOOOOOXXXXXXXXX,0,0,0
14322,103,0,103,111,126,0,0,287,98,189,GOOOOXXXXXXXXXXXXXXXGOOOOOOOOOXXXXXXXXXXGOOOOOOOOOXXXXXXXXXXGOOOOOOOOOOOXXXXXXXXGOOOXXXXXXXXXXXXXXXXGOOOOOOOOOOXXXXXXXXXGOOOXXXXXXXXXXXXXXXXGOOOOOOOXXXXXXXXXXXXGOOOOOOOOOOOXXXXXXXXGOOOXXXXXXXXXXXXXXXXGOOOOOOXXXXXXXXXXXXXGOOOOXXXXXXXXXXXXXXXGOOOOOOOOOOXXXXXXXXX,0,0,0
14343,104,1,103,115,121,0,0,283,96,187,GOOOOXXXXXXXXXXXXXXXGOOOOOOOOOXXXXXXXXXXGOOOOOOOOOXXXXXXXXXXGOOOOOOOOOOOAXXXXXXXGOOOXXXXXXXXXXXXXXXXGOOOOOOOOOOXXXXXXXXXGOOOXXXXXXXXXXXXXXXXGOOOOOOOXXXXXXXXXXXXGOOOOOOOOOOOXXXXXXXXGOOOXXXXXXXXXXXXXXXXGOOOOOOXXXXXXXXXXXXXGOOOOXXXXXXXXXXXXXXXGOOOOOOOOOOXXXXXXXXX,0,0,0
14364,104,0,104,110,126,0,0,287,106,181,GOOOOXXXXXXXXXXXXXXXGOOOOOOOOOXXXXXXXXXXGOOOOOOOOOXXXXXXXXXXGOOOOOOOOOOOOXXXXXXXGOOOXXXXXXXXXXXXXXXXGOOOOOOOOOOXXXXXXXXXGOOOXXXXXXXXXXXXXXXXGOOOOOOOXXXXXXXXXXXXGOOOOOOOOOOOXXXXXXXXGOOOXXXXXXXXXXXXXXXXGOOOOOOXXXXXXXXXXXXXGOOOOXXXXXXXXXXXXXXXGOOOOOOOOOOXXXXXXXXX,0,0,0

14385,104,0,104,108,128,0,0,290,106,184,GOOOOXXXXXXXXXXXXXXXGOOOOOOOOOXXXXXXXXXXGOOOOOOOOOXXXXXXXXXXGOOOOOOOOOOOOXXXXXXXGOOOXXXXXXXXXXXXXXXXGOOOOOOOOOOXXXXXXXXXGOOOXXXXXXXXXXXXXXXXGOOOOOOOXXXXXXXXXXXXGOOOOOOOOOOOXXXXXXXXGOOOXXXXXXXXXXXXXXXXGOOOOOOXXXXXXXXXXXXXGOOOOXXXXXXXXXXXXXXXGOOOOOOOOOOXXXXXXXXX,0,0,0
14406,104,0,104,111,125,0,0,287,106,181,GOOOOXXXXXXXXXXXXXXXGOOOOOOOOOXXXXXXXXXXGOOOOOOOOOXXXXXXXXXXGOOOOOOOOOOOOXXXXXXXGOOOXXXXXXXXXXXXXXXXGOOOOOOOOOOXXXXXXXXXGOOOXXXXXXXXXXXXXXXXGOOOOOOOXXXXXXXXXXXXGOOOOOOOOOOOXXXXXXXXGOOOXXXXXXXXXXXXXXXXGOOOOOOXXXXXXXXXXXXXGOOOOXXXXXXXXXXXXXXXGOOOOOOOOOOXXXXXXXXX,0,0,0
14427,104,0,104,116,120,0,0,281,108,173,GOOOOXXXXXXXXXXXXXXXGOOOOOOOOOXXXXXXXXXXGOOOOOOOOOXXXXXXXXXXGOOOOOOOOOOOOXXXXXXXGOOOXXXXXXXXXXXXXXXXGOOOOOOOOOOXXXXXXXXXGOOOXXXXXXXXXXXXXXXXGOOOOOOOXXXXXXXXXXXXGOOOOOOOOOOOXXXXXXXXGOOOXXXXXXXXXXXXXXXXGOOOOOOXXXXXXXXXXXXXGOOOOXXXXXXXXXXXXXXXGOOOOOOOOOOXXXXXXXXX,0,0,0
14448,104,0,104,123,113,0,0,274,100,174,GOOOOXXXXXXXXXXXXXXXGOOOOOOOOOXXXXXXXXXXGOOOOOOOOOXXXXXXXXXXGOOOOOOOOOOOOXXXXXXXGOOOXXXXXXXXXXXXXXXXGOOOOOOOOOOXXXXXXXXXGOOOXXXXXXXXXXXXXXXXGOOOOOOOXXXXXXXXXXXXGOOOOOOOOOOOXXXXXXXXGOOOXXXXXXXXXXXXXXXXGOOOOOOXXXXXXXXXXXXXGOOOOXXXXXXXXXXXXXXXGOOOOOOOOOOXXXXXXXXX,0,0,0
14469,105,1,104,123,112,0,0,271,102,169,GOOOOXXXXXXXXXXXXXXXGOOOOOOOOOAXXXXXXXXXGOOOOOOOOOXXXXXXXXXXGOOOOOOOOOOOOXXXXXXXGOOOXXXXXXXXXXXXXXXXGOOOOOOOOOOXXXXXXXXXGOOOXXXXXXXXXXXXXXXXGOOOOOOOXXXXXXXXXXXXGOOOOOOOOOOOXXXXXXXXGOOOXXXXXXXXXXXXXXXXGOOOOOOXXXXXXXXXXXXXGOOOOXXXXXXXXXXXXXXXGOOOOOOOOOOXXXXXXXXX,0,0,0

14490,105,1,104,120,115,0,0,274,103,171,GOOOOXXXXXXXXXXXXXXXGOOOOOOOOOAXXXXXXXXXGOOOOOOOOOXXXXXXXXXXGOOOOOOOOOOOOXXXXXXXGOOOXXXXXXXXXXXXXXXXGOOOOOOOOOOXXXXXXXXXGOOOXXXXXXXXXXXXXXXXGOOOOOOOXXXXXXXXXXXXGOOOOOOOOOOOXXXXXXXXGOOOXXXXXXXXXXXXXXXXGOOOOOOXXXXXXXXXXXXXGOOOOXXXXXXXXXXXXXXXGOOOOOOOOOOXXXXXXXXX,0,0,0
14511,105,1,104,119,116,0,0,276,110,166,GOOOOXXXXXXXXXXXXXXXGOOOOOOOOOAXXXXXXXXXGOOOOOOOOOXXXXXXXXXXGOOOOOOOOOOOOXXXXXXXGOOOXXXXXXXXXXXXXXXXGOOOOOOOOOOXXXXXXXXXGOOOXXXXXXXXXXXXXXXXGOOOOOOOXXXXXXXXXXXXGOOOOOOOOOOOXXXXXXXXGOOOXXXXXXXXXXXXXXXXGOOOOOOXXXXXXXXXXXXXGOOOOXXXXXXXXXXXXXXXGOOOOOOOOOOXXXXXXXXX,0,0,0
14532,106,2,104,121,113,0,0,273,106,167,GOOOOXXXXXXXXXXXXXXXGOOOOOOOOOAXXXXXXXXXGOOOOOOOOOXXXXXXXXXXGOOOOOOOOOOOOXXXXXXXGOOOXXXXXXXXXXXXXXXXGOOOOOOOOOOXXXXXXXXXGOOOXXXXXXXXXXXXXXXXGOOOOOOOXXXXXXXXXXXXGOOOOOOOOOOOAXXXXXXXGOOOXXXXXXXXXXXXXXXXGOOOOOOXXXXXXXXXXXXXGOOOOXXXXXXXXXXXXXXXGOOOOOOOOOOXXXXXXXXX,0,0,0
14553,106,2,104,122,112,0,0,271,103,168,GOOOOXXXXXXXXXXXXXXXGOOOOOOOOOAXXXXXXXXXGOOOOOOOOOXXXXXXXXXXGOOOOOOOOOOOOXXXXXXXGOOOXXXXXXXXXXXXXXXXGOOOOOOOOOOXXXXXXXXXGOOOXXXXXXXXXXXXXXXXGOOOOOOOXXXXXXXXXXXXGOOOOOOOOOOOAXXXXXXXGOOOXXXXXXXXXXXXXXXXGOOOOOOXXXXXXXXXXXXXGOOOOXXXXXXXXXXXXXXXGOOOOOOOOOOXXXXXXXXX,0,0,0
14574,106,2,104,121,113,0,0,273,99,174,GOOOOXXXXXXXXXXXXXXXGOOOOOOOOOAXXXXXXXXXGOOOOOOOOOXXXXXXXXXXGOOOOOOOOOOOOXXXXXXXGOOOXXXXXXXXXXXXXXXXGOOOOOOOOOOXXXXXXXXXGOOOXXXXXXXXXXXXXXXXGOOOOOOOXXXXXXXXXXXXGOOOOOOOOOOOAXXXXXXXGOOOXXXXXXXXXXXXXXXXGOOOOOOXXXXXXXXXXXXXGOOOOXXXXXXXXXXXXXXXGOOOOOOOOOOXXXXXXXXX,0,0,0

14595,106,2,104,119,115,0,0,275,104,171,GOOOOXXXXXXXXXXXXXXXGOOOOOOOOOAXXXXXXXXXGOOOOOOOOOXXXXXXXXXXGOOOOOOOOOOOOXXXXXXXGOOOXXXXXXXXXXXXXXXXGOOOOOOOOOOXXXXXXXXXGOOOXXXXXXXXXXXXXXXXGOOOOOOOXXXXXXXXXXXXGOOOOOOOOOOOAXXXXXXXGOOOXXXXXXXXXXXXXXXXGOOOOOOXXXXXXXXXXXXXGOOOOXXXXXXXXXXXXXXXGOOOOOOOOOOXXXXXXXXX,0,0,0
14616,106,2,104,117,117,0,0,277,106,171,GOOOOXXXXXXXXXXXXXXXGOOOOOOOOOAXXXXXXXXXGOOOOOOOOOXXXXXXXXXXGOOOOOOOOOOOOXXXXXXXGOOOXXXXXXXXXXXXXXXXGOOOOOOOOOOXXXXXXXXXGOOOXXXXXXXXXXXXXXXXGOOOOOOOXXXXXXXXXXXXGOOOOOOOOOOOAXXXXXXXGOOOXXXXXXXXXXXXXXXXGOOOOOOXXXXXXXXXXXXXGOOOOXXXXXXXXXXXXXXXGOOOOOOOOOOXXXXXXXXX,0,0,0
14637,106,2,104,122,112,0,0,271,104,167,GOOOOXXXXXXXXXXXXXXXGOOOOOOOOOAXXXXXXXXXGOOOOOOOOOXXXXXXXXXXGOOOOOOOOOOOOXXXXXXXGOOOXXXXXXXXXXXXXXXXGOOOOOOOOOOXXXXXXXXXGOOOXXXXXXXXXXXXXXXXGOOOOOOOXXXXXXXXXXXXGOOOOOOOOOOOAXXXXXXXGOOOXXXXXXXXXXXXXXXXGOOOOOOXXXXXXXXXXXXXGOOOOXXXXXXXXXXXXXXXGOOOOOOOOOOXXXXXXXXX,0,0,0
14658,106,1,105,121,113,0,0,273,110,163,GOOOOXXXXXXXXXXXXXXXGOOOOOOOOOAXXXXXXXXXGOOOOOOOOOXXXXXXXXXXGOOOOOOOOOOOOXXXXXXXGOOOXXXXXXXXXXXXXXXXGOOOOOOOOOOXXXXXXXXXGOOOXXXXXXXXXXXXXXXXGOOOOOOOXXXXXXXXXXXXGOOOOOOOOOOOOXXXXXXXGOOOXXXXXXXXXXXXXXXXGOOOOOOXXXXXXXXXXXXXGOOOOXXXXXXXXXXXXXXXGOOOOOOOOOOXXXXXXXXX,0,0,0
14679,106,0,106,119,115,0,0,274,113,161,GOOOOXXXXXXXXXXXXXXXGOOOOOOOOOOXXXXXXXXXGOOOOOOOOOXXXXXXXXXXGOOOOOOOOOOOOXXXXXXXGOOOXXXXXXXXXXXXXXXXGOOOOOOOOOOXXXXXXXXXGOOOXXXXXXXXXXXXXXXXGOOOOOOOXXXXXXXXXXXXGOOOOOOOOOOOOXXXXXXXGOOOXXXXXXXXXXXXXXXXGOOOOOOXXXXXXXXXXXXXGOOOOXXXXXXXXXXXXXXXGOOOOOOOOOOXXXXXXXXX,0,0,0

14700,106,0,106,117,117,0,0,275,108,167,GOOOOXXXXXXXXXXXXXXXGOOOOOOOOOOXXXXXXXXXGOOOOOOOOOXXXXXXXXXXGOOOOOOOOOOOOXXXXXXXGOOOXXXXXXXXXXXXXXXXGOOOOOOOOOOXXXXXXXXXGOOOXXXXXXXXXXXXXXXXGOOOOOOOXXXXXXXXXXXXGOOOOOOOOOOOOXXXXXXXGOOOXXXXXXXXXXXXXXXXGOOOOOOXXXXXXXXXXXXXGOOOOXXXXXXXXXXXXXXXGOOOOOOOOOOXXXXXXXXX,0,0,0
14721,106,0,106,115,119,0,0,278,103,175,GOOOOXXXXXXXXXXXXXXXGOOOOOOOOOOXXXXXXXXXGOOOOOOOOOXXXXXXXXXXGOOOOOOOOOOOOXXXXXXXGOOOXXXXXXXXXXXXXXXXGOOOOOOOOOOXXXXXXXXXGOOOXXXXXXXXXXXXXXXXGOOOOOOOXXXXXXXXXXXXGOOOOOOOOOOOOXXXXXXXGOOOXXXXXXXXXXXXXXXXGOOOOOOXXXXXXXXXXXXXGOOOOXXXXXXXXXXXXXXXGOOOOOOOOOOXXXXXXXXX,0,0,0
14742,106,0,106,116,118,0,0,278,113,165,GOOOOXXXXXXXXXXXXXXXGOOOOOOOOOOXXXXXXXXXGOOOOOOOOOXXXXXXXXXXGOOOOOOOOOOOOXXXXXXXGOOOXXXXXXXXXXXXXXXXGOOOOOOOOOOXXXXXXXXXGOOOXXXXXXXXXXXXXXXXGOOOOOOOXXXXXXXXXXXXGOOOOOOOOOOOOXXXXXXXGOOOXXXXXXXXXXXXXXXXGOOOOOOXXXXXXXXXXXXXGOOOOXXXXXXXXXXXXXXXGOOOOOOOOOOXXXXXXXXX,0,0,0
14763,106,0,106,126,108,0,0,267,104,163,GOOOOXXXXXXXXXXXXXXXGOOOOOOOOOOXXXXXXXXXGOOOOOOOOOXXXXXXXXXXGOOOOOOOOOOOOXXXXXXXGOOOXXXXXXXXXXXXXXXXGOOOOOOOOOOXXXXXXXXXGOOOXXXXXXXXXXXXXXXXGOOOOOOOXXXXXXXXXXXXGOOOOOOOOOOOOXXXXXXXGOOOXXXXXXXXXXXXXXXXGOOOOOOXXXXXXXXXXXXXGOOOOXXXXXXXXXXXXXXXGOOOOOOOOOOXXXXXXXXX,0,0,0
14784,106,0,106,122,112,0,0,272,104,168,GOOOOXXXXXXXXXXXXXXXGOOOOOOOOOOXXXXXXXXXGOOOOOOOOOXXXXXXXXXXGOOOOOOOOOOOOXXXXXXXGOOOXXXXXXXXXXXXXXXXGOOOOOOOOOOXXXXXXXXXGOOOXXXXXXXXXXXXXXXXGOOOOOOOXXXXXXXXXXXXGOOOOOOOOOOOOXXXXXXXGOOOXXXXXXXXXXXXXXXXGOOOOOOXXXXXXXXXXXXXGOOOOXXXXXXXXXXXXXXXGOOOOOOOOOOXXXXXXXXX,0,0,0

14805,106,0,106,122,112,0,0,271,101,170,GOOOOXXXXXXXXXXXXXXXGOOOOOOOOOOXXXXXXXXXGOOOOOOOOOXXXXXXXXXXGOOOOOOOOOOOOXXXXXXXGOOOXXXXXXXXXXXXXXXXGOOOOOOOOOOXXXXXXXXXGOOOXXXXXXXXXXXXXXXXGOOOOOOOXXXXXXXXXXXXGOOOOOOOOOOOOXXXXXXXGOOOXXXXXXXXXXXXXXXXGOOOOOOXXXXXXXXXXXXXGOOOOXXXXXXXXXXXXXXXGOOOOOOOOOOXXXXXXXXX,0,0,0
14826,106,0,106,120,114,0,0,273,102,171,GOOOOXXXXXXXXXXXXXXXGOOOOOOOOOOXXXXXXXXXGOOOOOOOOOXXXXXXXXXXGOOOOOOOOOOOOXXXXXXXGOOOXXXXXXXXXXXXXXXXGOOOOOOOOOOXXXXXXXXXGOOOXXXXXXXXXXXXXXXXGOOOOOOOXXXXXXXXXXXXGOOOOOOOOOOOOXXXXXXXGOOOXXXXXXXXXXXXXXXXGOOOOOOXXXXXXXXXXXXXGOOOOXXXXXXXXXXXXXXXGOOOOOOOOOOXXXXXXXXX,0,0,0
14847,106,0,106,121,113,0,0,272,105,167,GOOOOXXXXXXXXXXXXXXXGOOOOOOOOOOXXXXXXXXXGOOOOOOOOOXXXXXXXXXXGOOOOOOOOOOOOXXXXXXXGOOOXXXXXXXXXXXXXXXXGOOOOOOOOOOXXXXXXXXXGOOOXXXXXXXXXXXXXXXXGOOOOOOOXXXXXXXXXXXXGOOOOOOOOOOOOXXXXXXXGOOOXXXXXXXXXXXXXXXXGOOOOOOXXXXXXXXXXXXXGOOOOXXXXXXXXXXXXXXXGOOOOOOOOOOXXXXXXXXX,0,0,0
14868,106,0,106,112,122,0,0,282,102,180,GOOOOXXXXXXXXXXXXXXXGOOOOOOOOOOXXXXXXXXXGOOOOOOOOOXXXXXXXXXXGOOOOOOOOOOOOXXXXXXXGOOOXXXXXXXXXXXXXXXXGOOOOOOOOOOXXXXXXXXXGOOOXXXXXXXXXXXXXXXXGOOOOOOOXXXXXXXXXXXXGOOOOOOOOOOOOXXXXXXXGOOOXXXXXXXXXXXXXXXXGOOOOOOXXXXXXXXXXXXXGOOOOXXXXXXXXXXXXXXXGOOOOOOOOOOXXXXXXXXX,0,0,0
14889,106,0,106,110,124,0,0,284,98,186,GOOOOXXXXXXXXXXXXXXXGOOOOOOOOOOXXXXXXXXXGOOOOOOOOOXXXXXXXXXXGOOOOOOOOOOOOXXXXXXXGOOOXXXXXXXXXXXXXXXXGOOOOOOOOOOXXXXXXXXXGOOOXXXXXXXXXXXXXXXXGOOOOOOOXXXXXXXXXXXXGOOOOOOOOOOOOXXXXXXXGOOOXXXXXXXXXXXXXXXXGOOOOOOXXXXXXXXXXXXXGOOOOXXXXXXXXXXXXXXXGOOOOOOOOOOXXXXXXXXX,0,0,0

14910,106,0,106,104,130,0,0,290,107,183,GOOOOXXXXXXXXXXXXXXXGOOOOOOOOOOXXXXXXXXXGOOOOOOOOOXXXXXXXXXXGOOOOOOOOOOOOXXXXXXXGOOOXXXXXXXXXXXXXXXXGOOOOOOOOOOXXXXXXXXXGOOOXXXXXXXXXXXXXXXXGOOOOOOOXXXXXXXXXXXXGOOOOOOOOOOOOXXXXXXXGOOOXXXXXXXXXXXXXXXXGOOOOOOXXXXXXXXXXXXXGOOOOXXXXXXXXXXXXXXXGOOOOOOOOOOXXXXXXXXX,0,0,0
14931,106,0,106,99,135,0,0,295,105,190,GOOOOXXXXXXXXXXXXXXXGOOOOOOOOOOXXXXXXXXXGOOOOOOOOOXXXXXXXXXXGOOOOOOOOOOOOXXXXXXXGOOOXXXXXXXXXXXXXXXXGOOOOOOOOOOXXXXXXXXXGOOOXXXXXXXXXXXXXXXXGOOOOOOOXXXXXXXXXXXXGOOOOOOOOOOOOXXXXXXXGOOOXXXXXXXXXXXXXXXXGOOOOOOXXXXXXXXXXXXXGOOOOXXXXXXXXXXXXXXXGOOOOOOOOOOXXXXXXXXX,0,0,0
14952,106,0,106,101,133,0,0,293,101,192,GOOOOXXXXXXXXXXXXXXXGOOOOOOOOOOXXXXXXXXXGOOOOOOOOOXXXXXXXXXXGOOOOOOOOOOOOXXXXXXXGOOOXXXXXXXXXXXXXXXXGOOOOOOOOOOXXXXXXXXXGOOOXXXXXXXXXXXXXXXXGOOOOOOOXXXXXXXXXXXXGOOOOOOOOOOOOXXXXXXXGOOOXXXXXXXXXXXXXXXXGOOOOOOXXXXXXXXXXXXXGOOOOXXXXXXXXXXXXXXXGOOOOOOOOOOXXXXXXXXX,0,0,0
14973,106,0,106,95,139,0,0,298,106,192,GOOOOXXXXXXXXXXXXXXXGOOOOOOOOOOXXXXXXXXXGOOOOOOOOOXXXXXXXXXXGOOOOOOOOOOOOXXXXXXXGOOOXXXXXXXXXXXXXXXXGOOOOOOOOOOXXXXXXXXXGOOOXXXXXXXXXXXXXXXXGOOOOOOOXXXXXXXXXXXXGOOOOOOOOOOOOXXXXXXXGOOOXXXXXXXXXXXXXXXXGOOOOOOXXXXXXXXXXXXXGOOOOXXXXXXXXXXXXXXXGOOOOOOOOOOXXXXXXXXX,0,0,0
14994,107,1,106,99,134,0,0,294,106,188,GOOOOAXXXXXXXXXXXXXXGOOOOOOOOOOXXXXXXXXXGOOOOOOOOOXXXXXXXXXXGOOOOOOOOOOOOXXXXXXXGOOOXXXXXXXXXXXXXXXXGOOOOOOOOOOXXXXXXXXXGOOOXXXXXXXXXXXXXXXXGOOOOOOOXXXXXXXXXXXXGOOOOOOOOOOOOXXXXXXXGOOOXXXXXXXXXXXXXXXXGOOOOOOXXXXXXXXXXXXXGOOOOXXXXXXXXXXXXXXXGOOOOOOOOOOXXXXXXXXX,0,0,0

15015,107,1,106,107,126,0,0,285,101,184,GOOOOAXXXXXXXXXXXXXXGOOOOOOOOOOXXXXXXXXXGOOOOOOOOOXXXXXXXXXXGOOOOOOOOOOOOXXXXXXXGOOOXXXXXXXXXXXXXXXXGOOOOOOOOOOXXXXXXXXXGOOOXXXXXXXXXXXXXXXXGOOOOOOOXXXXXXXXXXXXGOOOOOOOOOOOOXXXXXXXGOOOXXXXXXXXXXXXXXXXGOOOOOOXXXXXXXXXXXXXGOOOOXXXXXXXXXXXXXXXGOOOOOOOOOOXXXXXXXXX,0,0,0
15036,107,0,107,101,132,0,0,292,112,180,GOOOOOXXXXXXXXXXXXXXGOOOOOOOOOOXXXXXXXXXGOOOOOOOOOXXXXXXXXXXGOOOOOOOOOOOOXXXXXXXGOOOXXXXXXXXXXXXXXXXGOOOOOOOOOOXXXXXXXXXGOOOXXXXXXXXXXXXXXXXGOOOOOOOXXXXXXXXXXXXGOOOOOOOOOOOOXXXXXXXGOOOXXXXXXXXXXXXXXXXGOOOOOOXXXXXXXXXXXXXGOOOOXXXXXXXXXXXXXXXGOOOOOOOOOOXXXXXXXXX,0,0,0
15057,107,0,107,108,125,0,0,284,110,174,GOOOOOXXXXXXXXXXXXXXGOOOOOOOOOOXXXXXXXXXGOOOOOOOOOXXXXXXXXXXGOOOOOOOOOOOOXXXXXXXGOOOXXXXXXXXXXXXXXXXGOOOOOOOOOOXXXXXXXXXGOOOXXXXXXXXXXXXXXXXGOOOOOOOXXXXXXXXXXXXGOOOOOOOOOOOOXXXXXXXGOOOXXXXXXXXXXXXXXXXGOOOOOOXXXXXXXXXXXXXGOOOOXXXXXXXXXXXXXXXGOOOOOOOOOOXXXXXXXXX,0,0,0
15078,107,0,107,109,124,0,0,284,110,174,GOOOOOXXXXXXXXXXXXXXGOOOOOOOOOOXXXXXXXXXGOOOOOOOOOXXXXXXXXXXGOOOOOOOOOOOOXXXXXXXGOOOXXXXXXXXXXXXXXXXGOOOOOOOOOOXXXXXXXXXGOOOXXXXXXXXXXXXXXXXGOOOOOOOXXXXXXXXXXXXGOOOOOOOOOOOOXXXXXXXGOOOXXXXXXXXXXXXXXXXGOOOOOOXXXXXXXXXXXXXGOOOOXXXXXXXXXXXXXXXGOOOOOOOOOOXXXXXXXXX,0,0,0
15099,107,0,107,111,122,0,0,282,107,175,GOOOOOXXXXXXXXXXXXXXGOOOOOOOOOOXXXXXXXXXGOOOOOOOOOXXXXXXXXXXGOOOOOOOOOOOOXXXXXXXGOOOXXXXXXXXXXXXXXXXGOOOOOOOOOOXXXXXXXXXGOOOXXXXXXXXXXXXXXXXGOOOOOOOXXXXXXXXXXXXGOOOOOOOOOOOOXXXXXXXGOOOXXXXXXXXXXXXXXXXGOOOOOOXXXXXXXXXXXXXGOOOOXXXXXXXXXXXXXXXGOOOOOOOOOOXXXXXXXXX,0,0,0

15120,107,0,107,114,119,0,0,279,109,170,GOOOOOXXXXXXXXXXXXXXGOOOOOOOOOOXXXXXXXXXGOOOOOOOOOXXXXXXXXXXGOOOOOOOOOOOOXXXXXXXGOOOXXXXXXXXXXXXXXXXGOOOOOOOOOOXXXXXXXXXGOOOXXXXXXXXXXXXXXXXGOOOOOOOXXXXXXXXXXXXGOOOOOOOOOOOOXXXXXXXGOOOXXXXXXXXXXXXXXXXGOOOOOOXXXXXXXXXXXXXGOOOOXXXXXXXXXXXXXXXGOOOOOOOOOOXXXXXXXXX,0,0,0
15141,108,1,107,117,115,0,0,275,108,167,GOOOOOXXXXXXXXXXXXXXGOOOOOOOOOOXXXXXXXXXGOOOOOOOOOXXXXXXXXXXGOOOOOOOOOOOOXXXXXXXGOOOXXXXXXXXXXXXXXXXGOOOOOOOOOOXXXXXXXXXGOOOXXXXXXXXXXXXXXXXGOOOOOOOAXXXXXXXXXXXGOOOOOOOOOOOOXXXXXXXGOOOXXXXXXXXXXXXXXXXGOOOOOOXXXXXXXXXXXXXGOOOOXXXXXXXXXXXXXXXGOOOOOOOOOOXXXXXXXXX,0,0,0
15162,108,1,107,123,109,0,0,268,108,160,GOOOOOXXXXXXXXXXXXXXGOOOOOOOOOOXXXXXXXXXGOOOOOOOOOXXXXXXXXXXGOOOOOOOOOOOOXXXXXXXGOOOXXXXXXXXXXXXXXXXGOOOOOOOOOOXXXXXXXXXGOOOXXXXXXXXXXXXXXXXGOOOOOOOAXXXXXXXXXXXGOOOOOOOOOOOOXXXXXXXGOOOXXXXXXXXXXXXXXXXGOOOOOOXXXXXXXXXXXXXGOOOOXXXXXXXXXXXXXXXGOOOOOOOOOOXXXXXXXXX,0,0,0
15183,108,1,107,122,110,0,0,268,107,161,GOOOOOXXXXXXXXXXXXXXGOOOOOOOOOOXXXXXXXXXGOOOOOOOOOXXXXXXXXXXGOOOOOOOOOOOOXXXXXXXGOOOXXXXXXXXXXXXXXXXGOOOOOOOOOOXXXXXXXXXGOOOXXXXXXXXXXXXXXXXGOOOOOOOAXXXXXXXXXXXGOOOOOOOOOOOOXXXXXXXGOOOXXXXXXXXXXXXXXXXGOOOOOOXXXXXXXXXXXXXGOOOOXXXXXXXXXXXXXXXGOOOOOOOOOOXXXXXXXXX,0,0,0
15204,108,1,107,120,112,0,0,271,100,171,GOOOOOXXXXXXXXXXXXXXGOOOOOOOOOOXXXXXXXXXGOOOOOOOOOXXXXXXXXXXGOOOOOOOOOOOOXXXXXXXGOOOXXXXXXXXXXXXXXXXGOOOOOOOOOOXXXXXXXXXGOOOXXXXXXXXXXXXXXXXGOOOOOOOAXXXXXXXXXXXGOOOOOOOOOOOOXXXXXXXGOOOXXXXXXXXXXXXXXXXGOOOOOOXXXXXXXXXXXXXGOOOOXXXXXXXXXXXXXXXGOOOOOOOOOOXXXXXXXXX,0,0,0

15225,108,1,107,112,120,0,0,280,109,171,GOOOOOXXXXXXXXXXXXXXGOOOOOOOOOOXXXXXXXXXGOOOOOOOOOXXXXXXXXXXGOOOOOOOOOOOOXXXXXXXGOOOXXXXXXXXXXXXXXXXGOOOOOOOOOOXXXXXXXXXGOOOXXXXXXXXXXXXXXXXGOOOOOOOAXXXXXXXXXXXGOOOOOOOOOOOOXXXXXXXGOOOXXXXXXXXXXXXXXXXGOOOOOOXXXXXXXXXXXXXGOOOOXXXXXXXXXXXXXXXGOOOOOOOOOOXXXXXXXXX,0,0,0
15246,108,1,107,107,125,0,0,285,111,174,GOOOOOXXXXXXXXXXXXXXGOOOOOOOOOOXXXXXXXXXGOOOOOOOOOXXXXXXXXXXGOOOOOOOOOOOOXXXXXXXGOOOXXXXXXXXXXXXXXXXGOOOOOOOOOOXXXXXXXXXGOOOXXXXXXXXXXXXXXXXGOOOOOOOAXXXXXXXXXXXGOOOOOOOOOOOOXXXXXXXGOOOXXXXXXXXXXXXXXXXGOOOOOOXXXXXXXXXXXXXGOOOOXXXXXXXXXXXXXXXGOOOOOOOOOOXXXXXXXXX,0,0,0
15267,108,1,107,111,121,0,0,280,111,169,GOOOOOXXXXXXXXXXXXXXGOOOOOOOOOOXXXXXXXXXGOOOOOOOOOXXXXXXXXXXGOOOOOOOOOOOOXXXXXXXGOOOXXXXXXXXXXXXXXXXGOOOOOOOOOOXXXXXXXXXGOOOXXXXXXXXXXXXXXXXGOOOOOOOAXXXXXXXXXXXGOOOOOOOOOOOOXXXXXXXGOOOXXXXXXXXXXXXXXXXGOOOOOOXXXXXXXXXXXXXGOOOOXXXXXXXXXXXXXXXGOOOOOOOOOOXXXXXXXXX,0,0,0
15288,108,1,107,110,122,0,0,281,111,170,GOOOOOXXXXXXXXXXXXXXGOOOOOOOOOOXXXXXXXXXGOOOOOOOOOXXXXXXXXXXGOOOOOOOOOOOOXXXXXXXGOOOXXXXXXXXXXXXXXXXGOOOOOOOOOOXXXXXXXXXGOOOXXXXXXXXXXXXXXXXGOOOOOOOAXXXXXXXXXXXGOOOOOOOOOOOOXXXXXXXGOOOXXXXXXXXXXXXXXXXGOOOOOOXXXXXXXXXXXXXGOOOOXXXXXXXXXXXXXXXGOOOOOOOOOOXXXXXXXXX,0,0,0
15309,108,1,107,113,119,0,0,279,109,170,GOOOOOXXXXXXXXXXXXXXGOOOOOOOOOOXXXXXXXXXGOOOOOOOOOXXXXXXXXXXGOOOOOOOOOOOOXXXXXXXGOOOXXXXXXXXXXXXXXXXGOOOOOOOOOOXXXXXXXXXGOOOXXXXXXXXXXXXXXXXGOOOOOOOAXXXXXXXXXXXGOOOOOOOOOOOOXXXXXXXGOOOXXXXXXXXXXXXXXXXGOOOOOOXXXXXXXXXXXXXGOOOOXXXXXXXXXXXXXXXGOOOOOOOOOOXXXXXXXXX,0,0,0

15330,108,1,107,108,124,0,0,284,112,172,GOOOOOXXXXXXXXXXXXXXGOOOOOOOOOOXXXXXXXXXGOOOOOOOOOXXXXXXXXXXGOOOOOOOOOOOOXXXXXXXGOOOXXXXXXXXXXXXXXXXGOOOOOOOOOOXXXXXXXXXGOOOXXXXXXXXXXXXXXXXGOOOOOOOAXXXXXXXXXXXGOOOOOOOOOOOOXXXXXXXGOOOXXXXXXXXXXXXXXXXGOOOOOOXXXXXXXXXXXXXGOOOOXXXXXXXXXXXXXXXGOOOOOOOOOOXXXXXXXXX,0,0,0
15351,108,1,107,108,124,0,0,284,117,167,GOOOOOXXXXXXXXXXXXXXGOOOOOOOOOOXXXXXXXXXGOOOOOOOOOXXXXXXXXXXGOOOOOOOOOOOOXXXXXXXGOOOXXXXXXXXXXXXXXXXGOOOOOOOOOOXXXXXXXXXGOOOXXXXXXXXXXXXXXXXGOOOOOOOAXXXXXXXXXXXGOOOOOOOOOOOOXXXXXXXGOOOXXXXXXXXXXXXXXXXGOOOOOOXXXXXXXXXXXXXGOOOOXXXXXXXXXXXXXXXGOOOOOOOOOOXXXXXXXXX,0,0,0
15372,108,1,107,110,122,0,0,282,108,174,GOOOOOXXXXXXXXXXXXXXGOOOOOOOOOOXXXXXXXXXGOOOOOOOOOXXXXXXXXXXGOOOOOOOOOOOOXXXXXXXGOOOXXXXXXXXXXXXXXXXGOOOOOOOOOOXXXXXXXXXGOOOXXXXXXXXXXXXXXXXGOOOOOOOAXXXXXXXXXXXGOOOOOOOOOOOOXXXXXXXGOOOXXXXXXXXXXXXXXXXGOOOOOOXXXXXXXXXXXXXGOOOOXXXXXXXXXXXXXXXGOOOOOOOOOOXXXXXXXXX,0,0,0
15393,108,1,107,117,115,0,0,274,115,159,GOOOOOXXXXXXXXXXXXXXGOOOOOOOOOOXXXXXXXXXGOOOOOOOOOXXXXXXXXXXGOOOOOOOOOOOOXXXXXXXGOOOXXXXXXXXXXXXXXXXGOOOOOOOOOOXXXXXXXXXGOOOXXXXXXXXXXXXXXXXGOOOOOOOAXXXXXXXXXXXGOOOOOOOOOOOOXXXXXXXGOOOXXXXXXXXXXXXXXXXGOOOOOOXXXXXXXXXXXXXGOOOOXXXXXXXXXXXXXXXGOOOOOOOOOOXXXXXXXXX,0,0,0
15414,108,0,108,120,112,0,0,272,114,158,GOOOOOXXXXXXXXXXXXXXGOOOOOOOOOOXXXXXXXXXGOOOOOOOOOXXXXXXXXXXGOOOOOOOOOOOOXXXXXXXGOOOXXXXXXXXXXXXXXXXGOOOOOOOOOOXXXXXXXXXGOOOXXXXXXXXXXXXXXXXGOOOOOOOOXXXXXXXXXXXGOOOOOOOOOOOOXXXXXXXGOOOXXXXXXXXXXXXXXXXGOOOOOOXXXXXXXXXXXXXGOOOOXXXXXXXXXXXXXXXGOOOOOOOOOOXXXXXXXXX,0,0,0

15435,108,0,108,118,114,0,0,274,114,160,GOOOOOXXXXXXXXXXXXXXGOOOOOOOOOOXXXXXXXXXGOOOOOOOOOXXXXXXXXXXGOOOOOOOOOOOOXXXXXXXGOOOXXXXXXXXXXXXXXXXGOOOOOOOOOOXXXXXXXXXGOOOXXXXXXXXXXXXXXXXGOOOOOOOOXXXXXXXXXXXGOOOOOOOOOOOOXXXXXXXGOOOXXXXXXXXXXXXXXXXGOOOOOOXXXXXXXXXXXXXGOOOOXXXXXXXXXXXXXXXGOOOOOOOOOOXXXXXXXXX,0,0,0
15456,108,0,108,121,111,0,0,270,106,164,GOOOOOXXXXXXXXXXXXXXGOOOOOOOOOOXXXXXXXXXGOOOOOOOOOXXXXXXXXXXGOOOOOOOOOOOOXXXXXXXGOOOXXXXXXXXXXXXXXXXGOOOOOOOOOOXXXXXXXXXGOOOXXXXXXXXXXXXXXXXGOOOOOOOOXXXXXXXXXXXGOOOOOOOOOOOOXXXXXXXGOOOXXXXXXXXXXXXXXXXGOOOOOOXXXXXXXXXXXXXGOOOOXXXXXXXXXXXXXXXGOOOOOOOOOOXXXXXXXXX,0,0,0
15477,108,0,108,121,111,0,0,271,112,159,GOOOOOXXXXXXXXXXXXXXGOOOOOOOOOOXXXXXXXXXGOOOOOOOOOXXXXXXXXXXGOOOOOOOOOOOOXXXXXXXGOOOXXXXXXXXXXXXXXXXGOOOOOOOOOOXXXXXXXXXGOOOXXXXXXXXXXXXXXXXGOOOOOOOOXXXXXXXXXXXGOOOOOOOOOOOOXXXXXXXGOOOXXXXXXXXXXXXXXXXGOOOOOOXXXXXXXXXXXXXGOOOOXXXXXXXXXXXXXXXGOOOOOOOOOOXXXXXXXXX,0,0,0
15498,108,0,108,112,120,0,0,279,116,163,GOOOOOXXXXXXXXXXXXXXGOOOOOOOOOOXXXXXXXXXGOOOOOOOOOXXXXXXXXXXGOOOOOOOOOOOOXXXXXXXGOOOXXXXXXXXXXXXXXXXGOOOOOOOOOOXXXXXXXXXGOOOXXXXXXXXXXXXXXXXGOOOOOOOOXXXXXXXXXXXGOOOOOOOOOOOOXXXXXXXGOOOXXXXXXXXXXXXXXXXGOOOOOOXXXXXXXXXXXXXGOOOOXXXXXXXXXXXXXXXGOOOOOOOOOOXXXXXXXXX,0,0,0
15519,108,0,108,120,112,0,0,272,111,161,GOOOOOXXXXXXXXXXXXXXGOOOOOOOOOOXXXXXXXXXGOOOOOOOOOXXXXXXXXXXGOOOOOOOOOOOOXXXXXXXGOOOXXXXXXXXXXXXXXXXGOOOOOOOOOOXXXXXXXXXGOOOXXXXXXXXXXXXXXXXGOOOOOOOOXXXXXXXXXXXGOOOOOOOOOOOOXXXXXXXGOOOXXXXXXXXXXXXXXXXGOOOOOOXXXXXXXXXXXXXGOOOOXXXXXXXXXXXXXXXGOOOOOOOOOOXXXXXXXXX,0,0,0

15540,108,0,108,112,120,0,0,280,113,167,GOOOOOXXXXXXXXXXXXXXGOOOOOOOOOOXXXXXXXXXGOOOOOOOOOXXXXXXXXXXGOOOOOOOOOOOOXXXXXXXGOOOXXXXXXXXXXXXXXXXGOOOOOOOOOOXXXXXXXXXGOOOXXXXXXXXXXXXXXXXGOOOOOOOOXXXXXXXXXXXGOOOOOOOOOOOOXXXXXXXGOOOXXXXXXXXXXXXXXXXGOOOOOOXXXXXXXXXXXXXGOOOOXXXXXXXXXXXXXXXGOOOOOOOOOOXXXXXXXXX,0,0,0
15561,108,0,108,116,116,0,0,276,114,162,GOOOOOXXXXXXXXXXXXXXGOOOOOOOOOOXXXXXXXXXGOOOOOOOOOXXXXXXXXXXGOOOOOOOOOOOOXXXXXXXGOOOXXXXXXXXXXXXXXXXGOOOOOOOOOOXXXXXXXXXGOOOXXXXXXXXXXXXXXXXGOOOOOOOOXXXXXXXXXXXGOOOOOOOOOOOOXXXXXXXGOOOXXXXXXXXXXXXXXXXGOOOOOOXXXXXXXXXXXXXGOOOOXXXXXXXXXXXXXXXGOOOOOOOOOOXXXXXXXXX,0,0,0
15582,108,0,108,121,111,0,0,271,110,161,GOOOOOXXXXXXXXXXXXXXGOOOOOOOOOOXXXXXXXXXGOOOOOOOOOXXXXXXXXXXGOOOOOOOOOOOOXXXXXXXGOOOXXXXXXXXXXXXXXXXGOOOOOOOOOOXXXXXXXXXGOOOXXXXXXXXXXXXXXXXGOOOOOOOOXXXXXXXXXXXGOOOOOOOOOOOOXXXXXXXGOOOXXXXXXXXXXXXXXXXGOOOOOOXXXXXXXXXXXXXGOOOOXXXXXXXXXXXXXXXGOOOOOOOOOOXXXXXXXXX,0,0,0
15603,108,0,108,122,110,0,0,269,108,161,GOOOOOXXXXXXXXXXXXXXGOOOOOOOOOOXXXXXXXXXGOOOOOOOOOXXXXXXXXXXGOOOOOOOOOOOOXXXXXXXGOOOXXXXXXXXXXXXXXXXGOOOOOOOOOOXXXXXXXXXGOOOXXXXXXXXXXXXXXXXGOOOOOOOOXXXXXXXXXXXGOOOOOOOOOOOOXXXXXXXGOOOXXXXXXXXXXXXXXXXGOOOOOOXXXXXXXXXXXXXGOOOOXXXXXXXXXXXXXXXGOOOOOOOOOOXXXXXXXXX,0,0,0
15624,108,0,108,121,111,0,0,270,108,162,GOOOOOXXXXXXXXXXXXXXGOOOOOOOOOOXXXXXXXXXGOOOOOOOOOXXXXXXXXXXGOOOOOOOOOOOOXXXXXXXGOOOXXXXXXXXXXXXXXXXGOOOOOOOOOOXXXXXXXXXGOOOXXXXXXXXXXXXXXXXGOOOOOOOOXXXXXXXXXXXGOOOOOOOOOOOOXXXXXXXGOOOXXXXXXXXXXXXXXXXGOOOOOOXXXXXXXXXXXXXGOOOOXXXXXXXXXXXXXXXGOOOOOOOOOOXXXXXXXXX,0,0,0

15645,108,0,108,114,118,0,0,278,118,160,GOOOOOXXXXXXXXXXXXXXGOOOOOOOOOOXXXXXXXXXGOOOOOOOOOXXXXXXXXXXGOOOOOOOOOOOOXXXXXXXGOOOXXXXXXXXXXXXXXXXGOOOOOOOOOOXXXXXXXXXGOOOXXXXXXXXXXXXXXXXGOOOOOOOOXXXXXXXXXXXGOOOOOOOOOOOOXXXXXXXGOOOXXXXXXXXXXXXXXXXGOOOOOOXXXXXXXXXXXXXGOOOOXXXXXXXXXXXXXXXGOOOOOOOOOOXXXXXXXXX,0,0,0
15666,108,0,108,120,112,0,0,271,117,154,GOOOOOXXXXXXXXXXXXXXGOOOOOOOOOOXXXXXXXXXGOOOOOOOOOXXXXXXXXXXGOOOOOOOOOOOOXXXXXXXGOOOXXXXXXXXXXXXXXXXGOOOOOOOOOOXXXXXXXXXGOOOXXXXXXXXXXXXXXXXGOOOOOOOOXXXXXXXXXXXGOOOOOOOOOOOOXXXXXXXGOOOXXXXXXXXXXXXXXXXGOOOOOOXXXXXXXXXXXXXGOOOOXXXXXXXXXXXXXXXGOOOOOOOOOOXXXXXXXXX,0,0,0
15687,108,0,108,123,109,0,0,268,114,154,GOOOOOXXXXXXXXXXXXXXGOOOOOOOOOOXXXXXXXXXGOOOOOOOOOXXXXXXXXXXGOOOOOOOOOOOOXXXXXXXGOOOXXXXXXXXXXXXXXXXGOOOOOOOOOOXXXXXXXXXGOOOXXXXXXXXXXXXXXXXGOOOOOOOOXXXXXXXXXXXGOOOOOOOOOOOOXXXXXXXGOOOXXXXXXXXXXXXXXXXGOOOOOOXXXXXXXXXXXXXGOOOOXXXXXXXXXXXXXXXGOOOOOOOOOOXXXXXXXXX,0,0,0
15708,108,0,108,120,112,0,0,272,111,161,GOOOOOXXXXXXXXXXXXXXGOOOOOOOOOOXXXXXXXXXGOOOOOOOOOXXXXXXXXXXGOOOOOOOOOOOOXXXXXXXGOOOXXXXXXXXXXXXXXXXGOOOOOOOOOOXXXXXXXXXGOOOXXXXXXXXXXXXXXXXGOOOOOOOOXXXXXXXXXXXGOOOOOOOOOOOOXXXXXXXGOOOXXXXXXXXXXXXXXXXGOOOOOOXXXXXXXXXXXXXGOOOOXXXXXXXXXXXXXXXGOOOOOOOOOOXXXXXXXXX,0,0,0
15729,108,0,108,117,115,0,0,276,112,164,GOOOOOXXXXXXXXXXXXXXGOOOOOOOOOOXXXXXXXXXGOOOOOOOOOXXXXXXXXXXGOOOOOOOOOOOOXXXXXXXGOOOXXXXXXXXXXXXXXXXGOOOOOOOOOOXXXXXXXXXGOOOXXXXXXXXXXXXXXXXGOOOOOOOOXXXXXXXXXXXGOOOOOOOOOOOOXXXXXXXGOOOXXXXXXXXXXXXXXXXGOOOOOOXXXXXXXXXXXXXGOOOOXXXXXXXXXXXXXXXGOOOOOOOOOOXXXXXXXXX,0,0,0

15750,108,0,108,110,122,0,0,283,113,170,GOOOOOXXXXXXXXXXXXXXGOOOOOOOOOOXXXXXXXXXGOOOOOOOOOXXXXXXXXXXGOOOOOOOOOOOOXXXXXXXGOOOXXXXXXXXXXXXXXXXGOOOOOOOOOOXXXXXXXXXGOOOXXXXXXXXXXXXXXXXGOOOOOOOOXXXXXXXXXXXGOOOOOOOOOOOOXXXXXXXGOOOXXXXXXXXXXXXXXXXGOOOOOOXXXXXXXXXXXXXGOOOOXXXXXXXXXXXXXXXGOOOOOOOOOOXXXXXXXXX,0,0,0
15771,108,0,108,108,124,0,0,285,110,175,GOOOOOXXXXXXXXXXXXXXGOOOOOOOOOOXXXXXXXXXGOOOOOOOOOXXXXXXXXXXGOOOOOOOOOOOOXXXXXXXGOOOXXXXXXXXXXXXXXXXGOOOOOOOOOOXXXXXXXXXGOOOXXXXXXXXXXXXXXXXGOOOOOOOOXXXXXXXXXXXGOOOOOOOOOOOOXXXXXXXGOOOXXXXXXXXXXXXXXXXGOOOOOOXXXXXXXXXXXXXGOOOOXXXXXXXXXXXXXXXGOOOOOOOOOOXXXXXXXXX,0,0,0
15792,108,0,108,112,120,0,0,280,106,174,GOOOOOXXXXXXXXXXXXXXGOOOOOOOOOOXXXXXXXXXGOOOOOOOOOXXXXXXXXXXGOOOOOOOOOOOOXXXXXXXGOOOXXXXXXXXXXXXXXXXGOOOOOOOOOOXXXXXXXXXGOOOXXXXXXXXXXXXXXXXGOOOOOOOOXXXXXXXXXXXGOOOOOOOOOOOOXXXXXXXGOOOXXXXXXXXXXXXXXXXGOOOOOOXXXXXXXXXXXXXGOOOOXXXXXXXXXXXXXXXGOOOOOOOOOOXXXXXXXXX,0,0,0
15813,108,0,108,111,121,0,0,281,102,179,GOOOOOXXXXXXXXXXXXXXGOOOOOOOOOOXXXXXXXXXGOOOOOOOOOXXXXXXXXXXGOOOOOOOOOOOOXXXXXXXGOOOXXXXXXXXXXXXXXXXGOOOOOOOOOOXXXXXXXXXGOOOXXXXXXXXXXXXXXXXGOOOOOOOOXXXXXXXXXXXGOOOOOOOOOOOOXXXXXXXGOOOXXXXXXXXXXXXXXXXGOOOOOOXXXXXXXXXXXXXGOOOOXXXXXXXXXXXXXXXGOOOOOOOOOOXXXXXXXXX,0,0,0
15834,108,0,108,114,118,0,0,278,99,179,GOOOOOXXXXXXXXXXXXXXGOOOOOOOOOOXXXXXXXXXGOOOOOOOOOXXXXXXXXXXGOOOOOOOOOOOOXXXXXXXGOOOXXXXXXXXXXXXXXXXGOOOOOOOOOOXXXXXXXXXGOOOXXXXXXXXXXXXXXXXGOOOOOOOOXXXXXXXXXXXGOOOOOOOOOOOOXXXXXXXGOOOXXXXXXXXXXXXXXXXGOOOOOOXXXXXXXXXXXXXGOOOOXXXXXXXXXXXXXXXGOOOOOOOOOOXXXXXXXXX,0,0,0

15855,108,0,108,115,117,0,0,278,111,167,GOOOOOXXXXXXXXXXXXXXGOOOOOOOOOOXXXXXXXXXGOOOOOOOOOXXXXXXXXXXGOOOOOOOOOOOOXXXXXXXGOOOXXXXXXXXXXXXXXXXGOOOOOOOOOOXXXXXXXXXGOOOXXXXXXXXXXXXXXXXGOOOOOOOOXXXXXXXXXXXGOOOOOOOOOOOOXXXXXXXGOOOXXXXXXXXXXXXXXXXGOOOOOOXXXXXXXXXXXXXGOOOOXXXXXXXXXXXXXXXGOOOOOOOOOOXXXXXXXXX,0,0,0
15876,108,0,108,116,116,0,0,277,107,170,GOOOOOXXXXXXXXXXXXXXGOOOOOOOOOOXXXXXXXXXGOOOOOOOOOXXXXXXXXXXGOOOOOOOOOOOOXXXXXXXGOOOXXXXXXXXXXXXXXXXGOOOOOOOOOOXXXXXXXXXGOOOXXXXXXXXXXXXXXXXGOOOOOOOOXXXXXXXXXXXGOOOOOOOOOOOOXXXXXXXGOOOXXXXXXXXXXXXXXXXGOOOOOOXXXXXXXXXXXXXGOOOOXXXXXXXXXXXXXXXGOOOOOOOOOOXXXXXXXXX,0,0,0
15897,108,0,108,115,117,0,0,278,114,164,GOOOOOXXXXXXXXXXXXXXGOOOOOOOOOOXXXXXXXXXGOOOOOOOOOXXXXXXXXXXGOOOOOOOOOOOOXXXXXXXGOOOXXXXXXXXXXXXXXXXGOOOOOOOOOOXXXXXXXXXGOOOXXXXXXXXXXXXXXXXGOOOOOOOOXXXXXXXXXXXGOOOOOOOOOOOOXXXXXXXGOOOXXXXXXXXXXXXXXXXGOOOOOOXXXXXXXXXXXXXGOOOOXXXXXXXXXXXXXXXGOOOOOOOOOOXXXXXXXXX,0,0,0
15918,108,0,108,121,111,0,0,272,108,164,GOOOOOXXXXXXXXXXXXXXGOOOOOOOOOOXXXXXXXXXGOOOOOOOOOXXXXXXXXXXGOOOOOOOOOOOOXXXXXXXGOOOXXXXXXXXXXXXXXXXGOOOOOOOOOOXXXXXXXXXGOOOXXXXXXXXXXXXXXXXGOOOOOOOOXXXXXXXXXXXGOOOOOOOOOOOOXXXXXXXGOOOXXXXXXXXXXXXXXXXGOOOOOOXXXXXXXXXXXXXGOOOOXXXXXXXXXXXXXXXGOOOOOOOOOOXXXXXXXXX,0,0,0
15939,108,0,108,114,118,0,0,279,112,167,GOOOOOXXXXXXXXXXXXXXGOOOOOOOOOOXXXXXXXXXGOOOOOOOOOXXXXXXXXXXGOOOOOOOOOOOOXXXXXXXGOOOXXXXXXXXXXXXXXXXGOOOOOOOOOOXXXXXXXXXGOOOXXXXXXXXXXXXXXXXGOOOOOOOOXXXXXXXXXXXGOOOOOOOOOOOOXXXXXXXGOOOXXXXXXXXXXXXXXXXGOOOOOOXXXXXXXXXXXXXGOOOOXXXXXXXXXXXXXXXGOOOOOOOOOOXXXXXXXXX,0,0,0

15960,108,0,108,118,114,0,0,272,116,156,GOOOOOXXXXXXXXXXXXXXGOOOOOOOOOOXXXXXXXXXGOOOOOOOOOXXXXXXXXXXGOOOOOOOOOOOOXXXXXXXGOOOXXXXXXXXXXXXXXXXGOOOOOOOOOOXXXXXXXXXGOOOXXXXXXXXXXXXXXXXGOOOOOOOOXXXXXXXXXXXGOOOOOOOOOOOOXXXXXXXGOOOXXXXXXXXXXXXXXXXGOOOOOOXXXXXXXXXXXXXGOOOOXXXXXXXXXXXXXXXGOOOOOOOOOOXXXXXXXXX,0,0,0
15981,108,0,108,121,111,0,0,271,113,158,GOOOOOXXXXXXXXXXXXXXGOOOOOOOOOOXXXXXXXXXGOOOOOOOOOXXXXXXXXXXGOOOOOOOOOOOOXXXXXXXGOOOXXXXXXXXXXXXXXXXGOOOOOOOOOOXXXXXXXXXGOOOXXXXXXXXXXXXXXXXGOOOOOOOOXXXXXXXXXXXGOOOOOOOOOOOOXXXXXXXGOOOXXXXXXXXXXXXXXXXGOOOOOOXXXXXXXXXXXXXGOOOOXXXXXXXXXXXXXXXGOOOOOOOOOOXXXXXXXXX,0,0,0
16002,108,0,108,117,115,0,0,275,112,163,GOOOOOXXXXXXXXXXXXXXGOOOOOOOOOOXXXXXXXXXGOOOOOOOOOXXXXXXXXXXGOOOOOOOOOOOOXXXXXXXGOOOXXXXXXXXXXXXXXXXGOOOOOOOOOOXXXXXXXXXGOOOXXXXXXXXXXXXXXXXGOOOOOOOOXXXXXXXXXXXGOOOOOOOOOOOOXXXXXXXGOOOXXXXXXXXXXXXXXXXGOOOOOOXXXXXXXXXXXXXGOOOOXXXXXXXXXXXXXXXGOOOOOOOOOOXXXXXXXXX,0,0,0
16023,108,0,108,115,117,0,0,277,114,163,GOOOOOXXXXXXXXXXXXXXGOOOOOOOOOOXXXXXXXXXGOOOOOOOOOXXXXXXXXXXGOOOOOOOOOOOOXXXXXXXGOOOXXXXXXXXXXXXXXXXGOOOOOOOOOOXXXXXXXXXGOOOXXXXXXXXXXXXXXXXGOOOOOOOOXXXXXXXXXXXGOOOOOOOOOOOOXXXXXXXGOOOXXXXXXXXXXXXXXXXGOOOOOOXXXXXXXXXXXXXGOOOOXXXXXXXXXXXXXXXGOOOOOOOOOOXXXXXXXXX,0,0,0
16044,108,0,108,116,116,0,0,276,107,169,GOOOOOXXXXXXXXXXXXXXGOOOOOOOOOOXXXXXXXXXGOOOOOOOOOXXXXXXXXXXGOOOOOOOOOOOOXXXXXXXGOOOXXXXXXXXXXXXXXXXGOOOOOOOOOOXXXXXXXXXGOOOXXXXXXXXXXXXXXXXGOOOOOOOOXXXXXXXXXXXGOOOOOOOOOOOOXXXXXXXGOOOXXXXXXXXXXXXXXXXGOOOOOOXXXXXXXXXXXXXGOOOOXXXXXXXXXXXXXXXGOOOOOOOOOOXXXXXXXXX,0,0,0

16065,109,1,108,118,113,0,0,273,108,165,GOOOOOXXXXXXXXXXXXXXGOOOOOOOOOOXXXXXXXXXGOOOOOOOOOXXXXXXXXXXGOOOOOOOOOOOOXXXXXXXGOOOXXXXXXXXXXXXXXXXGOOOOOOOOOOXXXXXXXXXGOOOAXXXXXXXXXXXXXXXGOOOOOOOOXXXXXXXXXXXGOOOOOOOOOOOOXXXXXXXGOOOXXXXXXXXXXXXXXXXGOOOOOOXXXXXXXXXXXXXGOOOOXXXXXXXXXXXXXXXGOOOOOOOOOOXXXXXXXXX,0,0,0
16086,109,1,108,113,118,0,0,278,114,164,GOOOOOXXXXXXXXXXXXXXGOOOOOOOOOOXXXXXXXXXGOOOOOOOOOXXXXXXXXXXGOOOOOOOOOOOOXXXXXXXGOOOXXXXXXXXXXXXXXXXGOOOOOOOOOOXXXXXXXXXGOOOAXXXXXXXXXXXXXXXGOOOOOOOOXXXXXXXXXXXGOOOOOOOOOOOOXXXXXXXGOOOXXXXXXXXXXXXXXXXGOOOOOOXXXXXXXXXXXXXGOOOOXXXXXXXXXXXXXXXGOOOOOOOOOOXXXXXXXXX,0,0,0
16107,109,1,108,107,124,0,0,284,114,170,GOOOOOXXXXXXXXXXXXXXGOOOOOOOOOOXXXXXXXXXGOOOOOOOOOXXXXXXXXXXGOOOOOOOOOOOOXXXXXXXGOOOXXXXXXXXXXXXXXXXGOOOOOOOOOOXXXXXXXXXGOOOAXXXXXXXXXXXXXXXGOOOOOOOOXXXXXXXXXXXGOOOOOOOOOOOOXXXXXXXGOOOXXXXXXXXXXXXXXXXGOOOOOOXXXXXXXXXXXXXGOOOOXXXXXXXXXXXXXXXGOOOOOOOOOOXXXXXXXXX,0,0,0
16128,109,1,108,102,129,0,0,288,117,171,GOOOOOXXXXXXXXXXXXXXGOOOOOOOOOOXXXXXXXXXGOOOOOOOOOXXXXXXXXXXGOOOOOOOOOOOOXXXXXXXGOOOXXXXXXXXXXXXXXXXGOOOOOOOOOOXXXXXXXXXGOOOAXXXXXXXXXXXXXXXGOOOOOOOOXXXXXXXXXXXGOOOOOOOOOOOOXXXXXXXGOOOXXXXXXXXXXXXXXXXGOOOOOOXXXXXXXXXXXXXGOOOOXXXXXXXXXXXXXXXGOOOOOOOOOOXXXXXXXXX,0,0,0
16149,110,2,108,102,128,0,0,288,115,173,GOOOOOXXXXXXXXXXXXXXGOOOOOOOOOOXXXXXXXXXGOOOOOOOOOXXXXXXXXXXGOOOOOOOOOOOOXXXXXXXGOOOAXXXXXXXXXXXXXXXGOOOOOOOOOOXXXXXXXXXGOOOAXXXXXXXXXXXXXXXGOOOOOOOOXXXXXXXXXXXGOOOOOOOOOOOOXXXXXXXGOOOXXXXXXXXXXXXXXXXGOOOOOOXXXXXXXXXXXXXGOOOOXXXXXXXXXXXXXXXGOOOOOOOOOOXXXXXXXXX,0,0,0

16170,110,2,108,108,122,0,0,281,109,172,GOOOOOXXXXXXXXXXXXXXGOOOOOOOOOOXXXXXXXXXGOOOOOOOOOXXXXXXXXXXGOOOOOOOOOOOOXXXXXXXGOOOAXXXXXXXXXXXXXXXGOOOOOOOOOOXXXXXXXXXGOOOAXXXXXXXXXXXXXXXGOOOOOOOOXXXXXXXXXXXGOOOOOOOOOOOOXXXXXXXGOOOXXXXXXXXXXXXXXXXGOOOOOOXXXXXXXXXXXXXGOOOOXXXXXXXXXXXXXXXGOOOOOOOOOOXXXXXXXXX,0,0,0
16191,110,1,109,113,117,0,0,277,107,170,GOOOOOXXXXXXXXXXXXXXGOOOOOOOOOOXXXXXXXXXGOOOOOOOOOXXXXXXXXXXGOOOOOOOOOOOOXXXXXXXGOOOAXXXXXXXXXXXXXXXGOOOOOOOOOOXXXXXXXXXGOOOOXXXXXXXXXXXXXXXGOOOOOOOOXXXXXXXXXXXGOOOOOOOOOOOOXXXXXXXGOOOXXXXXXXXXXXXXXXXGOOOOOOXXXXXXXXXXXXXGOOOOXXXXXXXXXXXXXXXGOOOOOOOOOOXXXXXXXXX,0,0,0
16212,110,1,109,112,118,0,0,278,114,164,GOOOOOXXXXXXXXXXXXXXGOOOOOOOOOOXXXXXXXXXGOOOOOOOOOXXXXXXXXXXGOOOOOOOOOOOOXXXXXXXGOOOAXXXXXXXXXXXXXXXGOOOOOOOOOOXXXXXXXXXGOOOOXXXXXXXXXXXXXXXGOOOOOOOOXXXXXXXXXXXGOOOOOOOOOOOOXXXXXXXGOOOXXXXXXXXXXXXXXXXGOOOOOOXXXXXXXXXXXXXGOOOOXXXXXXXXXXXXXXXGOOOOOOOOOOXXXXXXXXX,0,0,0
16233,110,1,109,115,115,0,0,274,110,164,GOOOOOXXXXXXXXXXXXXXGOOOOOOOOOOXXXXXXXXXGOOOOOOOOOXXXXXXXXXXGOOOOOOOOOOOOXXXXXXXGOOOAXXXXXXXXXXXXXXXGOOOOOOOOOOXXXXXXXXXGOOOOXXXXXXXXXXXXXXXGOOOOOOOOXXXXXXXXXXXGOOOOOOOOOOOOXXXXXXXGOOOXXXXXXXXXXXXXXXXGOOOOOOXXXXXXXXXXXXXGOOOOXXXXXXXXXXXXXXXGOOOOOOOOOOXXXXXXXXX,0,0,0
16254,110,1,109,111,119,0,0,279,107,172,GOOOOOXXXXXXXXXXXXXXGOOOOOOOOOOXXXXXXXXXGOOOOOOOOOXXXXXXXXXXGOOOOOOOOOOOOXXXXXXXGOOOAXXXXXXXXXXXXXXXGOOOOOOOOOOXXXXXXXXXGOOOOXXXXXXXXXXXXXXXGOOOOOOOOXXXXXXXXXXXGOOOOOOOOOOOOXXXXXXXGOOOXXXXXXXXXXXXXXXXGOOOOOOXXXXXXXXXXXXXGOOOOXXXXXXXXXXXXXXXGOOOOOOOOOOXXXXXXXXX,0,0,0

16275,111,1,110,108,121,0,0,281,108,173,GOOOOOXXXXXXXXXXXXXXGOOOOOOOOOOXXXXXXXXXGOOOOOOOOOXXXXXXXXXXGOOOOOOOOOOOOXXXXXXXGOOOOXXXXXXXXXXXXXXXGOOOOOOOOOOXXXXXXXXXGOOOOXXXXXXXXXXXXXXXGOOOOOOOOAXXXXXXXXXXGOOOOOOOOOOOOXXXXXXXGOOOXXXXXXXXXXXXXXXXGOOOOOOXXXXXXXXXXXXXGOOOOXXXXXXXXXXXXXXXGOOOOOOOOOOXXXXXXXXX,0,0,0
16296,111,1,110,104,125,0,0,285,107,178,GOOOOOXXXXXXXXXXXXXXGOOOOOOOOOOXXXXXXXXXGOOOOOOOOOXXXXXXXXXXGOOOOOOOOOOOOXXXXXXXGOOOOXXXXXXXXXXXXXXXGOOOOOOOOOOXXXXXXXXXGOOOOXXXXXXXXXXXXXXXGOOOOOOOOAXXXXXXXXXXGOOOOOOOOOOOOXXXXXXXGOOOXXXXXXXXXXXXXXXXGOOOOOOXXXXXXXXXXXXXGOOOOXXXXXXXXXXXXXXXGOOOOOOOOOOXXXXXXXXX,0,0,0
16317,111,1,110,104,125,0,0,285,106,179,GOOOOOXXXXXXXXXXXXXXGOOOOOOOOOOXXXXXXXXXGOOOOOOOOOXXXXXXXXXXGOOOOOOOOOOOOXXXXXXXGOOOOXXXXXXXXXXXXXXXGOOOOOOOOOOXXXXXXXXXGOOOOXXXXXXXXXXXXXXXGOOOOOOOOAXXXXXXXXXXGOOOOOOOOOOOOXXXXXXXGOOOXXXXXXXXXXXXXXXXGOOOOOOXXXXXXXXXXXXXGOOOOXXXXXXXXXXXXXXXGOOOOOOOOOOXXXXXXXXX,0,0,0
16338,111,1,110,103,126,0,0,286,106,180,GOOOOOXXXXXXXXXXXXXXGOOOOOOOOOOXXXXXXXXXGOOOOOOOOOXXXXXXXXXXGOOOOOOOOOOOOXXXXXXXGOOOOXXXXXXXXXXXXXXXGOOOOOOOOOOXXXXXXXXXGOOOOXXXXXXXXXXXXXXXGOOOOOOOOAXXXXXXXXXXGOOOOOOOOOOOOXXXXXXXGOOOXXXXXXXXXXXXXXXXGOOOOOOXXXXXXXXXXXXXGOOOOXXXXXXXXXXXXXXXGOOOOOOOOOOXXXXXXXXX,0,0,0
16359,111,1,110,100,129,0,0,289,111,178,GOOOOOXXXXXXXXXXXXXXGOOOOOOOOOOXXXXXXXXXGOOOOOOOOOXXXXXXXXXXGOOOOOOOOOOOOXXXXXXXGOOOOXXXXXXXXXXXXXXXGOOOOOOOOOOXXXXXXXXXGOOOOXXXXXXXXXXXXXXXGOOOOOOOOAXXXXXXXXXXGOOOOOOOOOOOOXXXXXXXGOOOXXXXXXXXXXXXXXXXGOOOOOOXXXXXXXXXXXXXGOOOOXXXXXXXXXXXXXXXGOOOOOOOOOOXXXXXXXXX,0,0,0

16380,111,1,110,103,126,0,0,287,109,178,GOOOOOXXXXXXXXXXXXXXGOOOOOOOOOOXXXXXXXXXGOOOOOOOOOXXXXXXXXXXGOOOOOOOOOOOOXXXXXXXGOOOOXXXXXXXXXXXXXXXGOOOOOOOOOOXXXXXXXXXGOOOOXXXXXXXXXXXXXXXGOOOOOOOOAXXXXXXXXXXGOOOOOOOOOOOOXXXXXXXGOOOXXXXXXXXXXXXXXXXGOOOOOOXXXXXXXXXXXXXGOOOOXXXXXXXXXXXXXXXGOOOOOOOOOOXXXXXXXXX,0,0,0
16401,111,0,111,105,124,0,0,285,110,175,GOOOOOXXXXXXXXXXXXXXGOOOOOOOOOOXXXXXXXXXGOOOOOOOOOXXXXXXXXXXGOOOOOOOOOOOOXXXXXXXGOOOOXXXXXXXXXXXXXXXGOOOOOOOOOOXXXXXXXXXGOOOOXXXXXXXXXXXXXXXGOOOOOOOOOXXXXXXXXXXGOOOOOOOOOOOOXXXXXXXGOOOXXXXXXXXXXXXXXXXGOOOOOOXXXXXXXXXXXXXGOOOOXXXXXXXXXXXXXXXGOOOOOOOOOOXXXXXXXXX,0,0,0
16422,111,0,111,106,123,0,0,284,112,172,GOOOOOXXXXXXXXXXXXXXGOOOOOOOOOOXXXXXXXXXGOOOOOOOOOXXXXXXXXXXGOOOOOOOOOOOOXXXXXXXGOOOOXXXXXXXXXXXXXXXGOOOOOOOOOOXXXXXXXXXGOOOOXXXXXXXXXXXXXXXGOOOOOOOOOXXXXXXXXXXGOOOOOOOOOOOOXXXXXXXGOOOXXXXXXXXXXXXXXXXGOOOOOOXXXXXXXXXXXXXGOOOOXXXXXXXXXXXXXXXGOOOOOOOOOOXXXXXXXXX,0,0,0
16443,111,0,111,110,119,0,0,280,110,170,GOOOOOXXXXXXXXXXXXXXGOOOOOOOOOOXXXXXXXXXGOOOOOOOOOXXXXXXXXXXGOOOOOOOOOOOOXXXXXXXGOOOOXXXXXXXXXXXXXXXGOOOOOOOOOOXXXXXXXXXGOOOOXXXXXXXXXXXXXXXGOOOOOOOOOXXXXXXXXXXGOOOOOOOOOOOOXXXXXXXGOOOXXXXXXXXXXXXXXXXGOOOOOOXXXXXXXXXXXXXGOOOOXXXXXXXXXXXXXXXGOOOOOOOOOOXXXXXXXXX,0,0,0
16464,111,0,111,115,114,0,0,274,110,164,GOOOOOXXXXXXXXXXXXXXGOOOOOOOOOOXXXXXXXXXGOOOOOOOOOXXXXXXXXXXGOOOOOOOOOOOOXXXXXXXGOOOOXXXXXXXXXXXXXXXGOOOOOOOOOOXXXXXXXXXGOOOOXXXXXXXXXXXXXXXGOOOOOOOOOXXXXXXXXXXGOOOOOOOOOOOOXXXXXXXGOOOXXXXXXXXXXXXXXXXGOOOOOOXXXXXXXXXXXXXGOOOOXXXXXXXXXXXXXXXGOOOOOOOOOOXXXXXXXXX,0,0,0

16485,111,0,111,112,117,0,0,277,111,166,GOOOOOXXXXXXXXXXXXXXGOOOOOOOOOOXXXXXXXXXGOOOOOOOOOXXXXXXXXXXGOOOOOOOOOOOOXXXXXXXGOOOOXXXXXXXXXXXXXXXGOOOOOOOOOOXXXXXXXXXGOOOOXXXXXXXXXXXXXXXGOOOOOOOOOXXXXXXXXXXGOOOOOOOOOOOOXXXXXXXGOOOXXXXXXXXXXXXXXXXGOOOOOOXXXXXXXXXXXXXGOOOOXXXXXXXXXXXXXXXGOOOOOOOOOOXXXXXXXXX,0,0,0
16506,111,0,111,105,124,0,0,283,117,166,GOOOOOXXXXXXXXXXXXXXGOOOOOOOOOOXXXXXXXXXGOOOOOOOOOXXXXXXXXXXGOOOOOOOOOOOOXXXXXXXGOOOOXXXXXXXXXXXXXXXGOOOOOOOOOOXXXXXXXXXGOOOOXXXXXXXXXXXXXXXGOOOOOOOOOXXXXXXXXXXGOOOOOOOOOOOOXXXXXXXGOOOXXXXXXXXXXXXXXXXGOOOOOOXXXXXXXXXXXXXGOOOOXXXXXXXXXXXXXXXGOOOOOOOOOOXXXXXXXXX,0,0,0
16527,111,0,111,109,120,0,0,280,117,163,GOOOOOXXXXXXXXXXXXXXGOOOOOOOOOOXXXXXXXXXGOOOOOOOOOXXXXXXXXXXGOOOOOOOOOOOOXXXXXXXGOOOOXXXXXXXXXXXXXXXGOOOOOOOOOOXXXXXXXXXGOOOOXXXXXXXXXXXXXXXGOOOOOOOOOXXXXXXXXXXGOOOOOOOOOOOOXXXXXXXGOOOXXXXXXXXXXXXXXXXGOOOOOOXXXXXXXXXXXXXGOOOOXXXXXXXXXXXXXXXGOOOOOOOOOOXXXXXXXXX,0,0,0
16548,111,0,111,111,118,0,0,277,119,158,GOOOOOXXXXXXXXXXXXXXGOOOOOOOOOOXXXXXXXXXGOOOOOOOOOXXXXXXXXXXGOOOOOOOOOOOOXXXXXXXGOOOOXXXXXXXXXXXXXXXGOOOOOOOOOOXXXXXXXXXGOOOOXXXXXXXXXXXXXXXGOOOOOOOOOXXXXXXXXXXGOOOOOOOOOOOOXXXXXXXGOOOXXXXXXXXXXXXXXXXGOOOOOOXXXXXXXXXXXXXGOOOOXXXXXXXXXXXXXXXGOOOOOOOOOOXXXXXXXXX,0,0,0
16569,111,0,111,117,112,0,0,272,115,157,GOOOOOXXXXXXXXXXXXXXGOOOOOOOOOOXXXXXXXXXGOOOOOOOOOXXXXXXXXXXGOOOOOOOOOOOOXXXXXXXGOOOOXXXXXXXXXXXXXXXGOOOOOOOOOOXXXXXXXXXGOOOOXXXXXXXXXXXXXXXGOOOOOOOOOXXXXXXXXXXGOOOOOOOOOOOOXXXXXXXGOOOXXXXXXXXXXXXXXXXGOOOOOOXXXXXXXXXXXXXGOOOOXXXXXXXXXXXXXXXGOOOOOOOOOOXXXXXXXXX,0,0,0

16590,111,0,111,116,113,0,0,272,116,156,GOOOOOXXXXXXXXXXXXXXGOOOOOOOOOOXXXXXXXXXGOOOOOOOOOXXXXXXXXXXGOOOOOOOOOOOOXXXXXXXGOOOOXXXXXXXXXXXXXXXGOOOOOOOOOOXXXXXXXXXGOOOOXXXXXXXXXXXXXXXGOOOOOOOOOXXXXXXXXXXGOOOOOOOOOOOOXXXXXXXGOOOXXXXXXXXXXXXXXXXGOOOOOOXXXXXXXXXXXXXGOOOOXXXXXXXXXXXXXXXGOOOOOOOOOOXXXXXXXXX,0,0,0
16611,111,0,111,115,114,0,0,274,113,161,GOOOOOXXXXXXXXXXXXXXGOOOOOOOOOOXXXXXXXXXGOOOOOOOOOXXXXXXXXXXGOOOOOOOOOOOOXXXXXXXGOOOOXXXXXXXXXXXXXXXGOOOOOOOOOOXXXXXXXXXGOOOOXXXXXXXXXXXXXXXGOOOOOOOOOXXXXXXXXXXGOOOOOOOOOOOOXXXXXXXGOOOXXXXXXXXXXXXXXXXGOOOOOOXXXXXXXXXXXXXGOOOOXXXXXXXXXXXXXXXGOOOOOOOOOOXXXXXXXXX,0,0,0
16632,112,1,111,115,113,0,0,273,118,155,GOOOOOXXXXXXXXXXXXXXGOOOOOOOOOOXXXXXXXXXGOOOOOOOOOXXXXXXXXXXGOOOOOOOOOOOOXXXXXXXGOOOOXXXXXXXXXXXXXXXGOOOOOOOOOOXXXXXXXXXGOOOOXXXXXXXXXXXXXXXGOOOOOOOOOXXXXXXXXXXGOOOOOOOOOOOOXXXXXXXGOOOXXXXXXXXXXXXXXXXGOOOOOOAXXXXXXXXXXXXGOOOOXXXXXXXXXXXXXXXGOOOOOOOOOOXXXXXXXXX,0,0,0
16653,112,1,111,112,116,0,0,276,117,159,GOOOOOXXXXXXXXXXXXXXGOOOOOOOOOOXXXXXXXXXGOOOOOOOOOXXXXXXXXXXGOOOOOOOOOOOOXXXXXXXGOOOOXXXXXXXXXXXXXXXGOOOOOOOOOOXXXXXXXXXGOOOOXXXXXXXXXXXXXXXGOOOOOOOOOXXXXXXXXXXGOOOOOOOOOOOOXXXXXXXGOOOXXXXXXXXXXXXXXXXGOOOOOOAXXXXXXXXXXXXGOOOOXXXXXXXXXXXXXXXGOOOOOOOOOOXXXXXXXXX,0,0,0
16674,112,1,111,114,114,0,0,274,120,154,GOOOOOXXXXXXXXXXXXXXGOOOOOOOOOOXXXXXXXXXGOOOOOOOOOXXXXXXXXXXGOOOOOOOOOOOOXXXXXXXGOOOOXXXXXXXXXXXXXXXGOOOOOOOOOOXXXXXXXXXGOOOOXXXXXXXXXXXXXXXGOOOOOOOOOXXXXXXXXXXGOOOOOOOOOOOOXXXXXXXGOOOXXXXXXXXXXXXXXXXGOOOOOOAXXXXXXXXXXXXGOOOOXXXXXXXXXXXXXXXGOOOOOOOOOOXXXXXXXXX,0,0,0

16695,112,0,112,121,107,0,0,266,113,153,GOOOOOXXXXXXXXXXXXXXGOOOOOOOOOOXXXXXXXXXGOOOOOOOOOXXXXXXXXXXGOOOOOOOOOOOOXXXXXXXGOOOOXXXXXXXXXXXXXXXGOOOOOOOOOOXXXXXXXXXGOOOOXXXXXXXXXXXXXXXGOOOOOOOOOXXXXXXXXXXGOOOOOOOOOOOOXXXXXXXGOOOXXXXXXXXXXXXXXXXGOOOOOOOXXXXXXXXXXXXGOOOOXXXXXXXXXXXXXXXGOOOOOOOOOOXXXXXXXXX,0,0,0
16716,112,0,112,122,106,0,0,267,112,155,GOOOOOXXXXXXXXXXXXXXGOOOOOOOOOOXXXXXXXXXGOOOOOOOOOXXXXXXXXXXGOOOOOOOOOOOOXXXXXXXGOOOOXXXXXXXXXXXXXXXGOOOOOOOOOOXXXXXXXXXGOOOOXXXXXXXXXXXXXXXGOOOOOOOOOXXXXXXXXXXGOOOOOOOOOOOOXXXXXXXGOOOXXXXXXXXXXXXXXXXGOOOOOOOXXXXXXXXXXXXGOOOOXXXXXXXXXXXXXXXGOOOOOOOOOOXXXXXXXXX,0,0,0
16737,112,0,112,115,113,0,0,274,118,156,GOOOOOXXXXXXXXXXXXXXGOOOOOOOOOOXXXXXXXXXGOOOOOOOOOXXXXXXXXXXGOOOOOOOOOOOOXXXXXXXGOOOOXXXXXXXXXXXXXXXGOOOOOOOOOOXXXXXXXXXGOOOOXXXXXXXXXXXXXXXGOOOOOOOOOXXXXXXXXXXGOOOOOOOOOOOOXXXXXXXGOOOXXXXXXXXXXXXXXXXGOOOOOOOXXXXXXXXXXXXGOOOOXXXXXXXXXXXXXXXGOOOOOOOOOOXXXXXXXXX,0,0,0
16758,112,0,112,117,111,0,0,271,126,145,GOOOOOXXXXXXXXXXXXXXGOOOOOOOOOOXXXXXXXXXGOOOOOOOOOXXXXXXXXXXGOOOOOOOOOOOOXXXXXXXGOOOOXXXXXXXXXXXXXXXGOOOOOOOOOOXXXXXXXXXGOOOOXXXXXXXXXXXXXXXGOOOOOOOOOXXXXXXXXXXGOOOOOOOOOOOOXXXXXXXGOOOXXXXXXXXXXXXXXXXGOOOOOOOXXXXXXXXXXXXGOOOOXXXXXXXXXXXXXXXGOOOOOOOOOOXXXXXXXXX,0,0,0
16779,112,0,112,112,116,0,0,277,123,154,GOOOOOXXXXXXXXXXXXXXGOOOOOOOOOOXXXXXXXXXGOOOOOOOOOXXXXXXXXXXGOOOOOOOOOOOOXXXXXXXGOOOOXXXXXXXXXXXXXXXGOOOOOOOOOOXXXXXXXXXGOOOOXXXXXXXXXXXXXXXGOOOOOOOOOXXXXXXXXXXGOOOOOOOOOOOOXXXXXXXGOOOXXXXXXXXXXXXXXXXGOOOOOOOXXXXXXXXXXXXGOOOOXXXXXXXXXXXXXXXGOOOOOOOOOOXXXXXXXXX,0,0,0

16800,112,0,112,110,118,0,0,279,122,157,GOOOOOXXXXXXXXXXXXXXGOOOOOOOOOOXXXXXXXXXGOOOOOOOOOXXXXXXXXXXGOOOOOOOOOOOOXXXXXXXGOOOOXXXXXXXXXXXXXXXGOOOOOOOOOOXXXXXXXXXGOOOOXXXXXXXXXXXXXXXGOOOOOOOOOXXXXXXXXXXGOOOOOOOOOOOOXXXXXXXGOOOXXXXXXXXXXXXXXXXGOOOOOOOXXXXXXXXXXXXGOOOOXXXXXXXXXXXXXXXGOOOOOOOOOOXXXXXXXXX,0,0,0
16821,112,0,112,106,122,0,0,283,119,164,GOOOOOXXXXXXXXXXXXXXGOOOOOOOOOOXXXXXXXXXGOOOOOOOOOXXXXXXXXXXGOOOOOOOOOOOOXXXXXXXGOOOOXXXXXXXXXXXXXXXGOOOOOOOOOOXXXXXXXXXGOOOOXXXXXXXXXXXXXXXGOOOOOOOOOXXXXXXXXXXGOOOOOOOOOOOOXXXXXXXGOOOXXXXXXXXXXXXXXXXGOOOOOOOXXXXXXXXXXXXGOOOOXXXXXXXXXXXXXXXGOOOOOOOOOOXXXXXXXXX,0,0,0
16842,112,0,112,110,118,0,0,278,110,168,GOOOOOXXXXXXXXXXXXXXGOOOOOOOOOOXXXXXXXXXGOOOOOOOOOXXXXXXXXXXGOOOOOOOOOOOOXXXXXXXGOOOOXXXXXXXXXXXXXXXGOOOOOOOOOOXXXXXXXXXGOOOOXXXXXXXXXXXXXXXGOOOOOOOOOXXXXXXXXXXGOOOOOOOOOOOOXXXXXXXGOOOXXXXXXXXXXXXXXXXGOOOOOOOXXXXXXXXXXXXGOOOOXXXXXXXXXXXXXXXGOOOOOOOOOOXXXXXXXXX,0,0,0
16863,112,0,112,112,116,0,0,277,105,172,GOOOOOXXXXXXXXXXXXXXGOOOOOOOOOOXXXXXXXXXGOOOOOOOOOXXXXXXXXXXGOOOOOOOOOOOOXXXXXXXGOOOOXXXXXXXXXXXXXXXGOOOOOOOOOOXXXXXXXXXGOOOOXXXXXXXXXXXXXXXGOOOOOOOOOXXXXXXXXXXGOOOOOOOOOOOOXXXXXXXGOOOXXXXXXXXXXXXXXXXGOOOOOOOXXXXXXXXXXXXGOOOOXXXXXXXXXXXXXXXGOOOOOOOOOOXXXXXXXXX,0,0,0
16884,112,0,112,108,120,0,0,280,108,172,GOOOOOXXXXXXXXXXXXXXGOOOOOOOOOOXXXXXXXXXGOOOOOOOOOXXXXXXXXXXGOOOOOOOOOOOOXXXXXXXGOOOOXXXXXXXXXXXXXXXGOOOOOOOOOOXXXXXXXXXGOOOOXXXXXXXXXXXXXXXGOOOOOOOOOXXXXXXXXXXGOOOOOOOOOOOOXXXXXXXGOOOXXXXXXXXXXXXXXXXGOOOOOOOXXXXXXXXXXXXGOOOOXXXXXXXXXXXXXXXGOOOOOOOOOOXXXXXXXXX,0,0,0

16905,112,0,112,112,116,0,0,276,117,159,GOOOOOXXXXXXXXXXXXXXGOOOOOOOOOOXXXXXXXXXGOOOOOOOOOXXXXXXXXXXGOOOOOOOOOOOOXXXXXXXGOOOOXXXXXXXXXXXXXXXGOOOOOOOOOOXXXXXXXXXGOOOOXXXXXXXXXXXXXXXGOOOOOOOOOXXXXXXXXXXGOOOOOOOOOOOOXXXXXXXGOOOXXXXXXXXXXXXXXXXGOOOOOOOXXXXXXXXXXXXGOOOOXXXXXXXXXXXXXXXGOOOOOOOOOOXXXXXXXXX,0,0,0
16926,112,0,112,113,115,0,0,275,112,163,GOOOOOXXXXXXXXXXXXXXGOOOOOOOOOOXXXXXXXXXGOOOOOOOOOXXXXXXXXXXGOOOOOOOOOOOOXXXXXXXGOOOOXXXXXXXXXXXXXXXGOOOOOOOOOOXXXXXXXXXGOOOOXXXXXXXXXXXXXXXGOOOOOOOOOXXXXXXXXXXGOOOOOOOOOOOOXXXXXXXGOOOXXXXXXXXXXXXXXXXGOOOOOOOXXXXXXXXXXXXGOOOOXXXXXXXXXXXXXXXGOOOOOOOOOOXXXXXXXXX,0,0,0
16947,112,0,112,108,120,0,0,280,116,164,GOOOOOXXXXXXXXXXXXXXGOOOOOOOOOOXXXXXXXXXGOOOOOOOOOXXXXXXXXXXGOOOOOOOOOOOOXXXXXXXGOOOOXXXXXXXXXXXXXXXGOOOOOOOOOOXXXXXXXXXGOOOOXXXXXXXXXXXXXXXGOOOOOOOOOXXXXXXXXXXGOOOOOOOOOOOOXXXXXXXGOOOXXXXXXXXXXXXXXXXGOOOOOOOXXXXXXXXXXXXGOOOOXXXXXXXXXXXXXXXGOOOOOOOOOOXXXXXXXXX,0,0,0
16968,112,0,112,107,121,0,0,281,118,163,GOOOOOXXXXXXXXXXXXXXGOOOOOOOOOOXXXXXXXXXGOOOOOOOOOXXXXXXXXXXGOOOOOOOOOOOOXXXXXXXGOOOOXXXXXXXXXXXXXXXGOOOOOOOOOOXXXXXXXXXGOOOOXXXXXXXXXXXXXXXGOOOOOOOOOXXXXXXXXXXGOOOOOOOOOOOOXXXXXXXGOOOXXXXXXXXXXXXXXXXGOOOOOOOXXXXXXXXXXXXGOOOOXXXXXXXXXXXXXXXGOOOOOOOOOOXXXXXXXXX,0,0,0
16989,112,0,112,108,120,0,0,279,118,161,GOOOOOXXXXXXXXXXXXXXGOOOOOOOOOOXXXXXXXXXGOOOOOOOOOXXXXXXXXXXGOOOOOOOOOOOOXXXXXXXGOOOOXXXXXXXXXXXXXXXGOOOOOOOOOOXXXXXXXXXGOOOOXXXXXXXXXXXXXXXGOOOOOOOOOXXXXXXXXXXGOOOOOOOOOOOOXXXXXXXGOOOXXXXXXXXXXXXXXXXGOOOOOOOXXXXXXXXXXXXGOOOOXXXXXXXXXXXXXXXGOOOOOOOOOOXXXXXXXXX,0,0,0

17010,112,0,112,112,116,0,0,276,114,162,GOOOOOXXXXXXXXXXXXXXGOOOOOOOOOOXXXXXXXXXGOOOOOOOOOXXXXXXXXXXGOOOOOOOOOOOOXXXXXXXGOOOOXXXXXXXXXXXXXXXGOOOOOOOOOOXXXXXXXXXGOOOOXXXXXXXXXXXXXXXGOOOOOOOOOXXXXXXXXXXGOOOOOOOOOOOOXXXXXXXGOOOXXXXXXXXXXXXXXXXGOOOOOOOXXXXXXXXXXXXGOOOOXXXXXXXXXXXXXXXGOOOOOOOOOOXXXXXXXXX,0,0,0
17031,112,0,112,104,124,0,0,283,120,163,GOOOOOXXXXXXXXXXXXXXGOOOOOOOOOOXXXXXXXXXGOOOOOOOOOXXXXXXXXXXGOOOOOOOOOOOOXXXXXXXGOOOOXXXXXXXXXXXXXXXGOOOOOOOOOOXXXXXXXXXGOOOOXXXXXXXXXXXXXXXGOOOOOOOOOXXXXXXXXXXGOOOOOOOOOOOOXXXXXXXGOOOXXXXXXXXXXXXXXXXGOOOOOOOXXXXXXXXXXXXGOOOOXXXXXXXXXXXXXXXGOOOOOOOOOOXXXXXXXXX,0,0,0
17052,112,0,112,109,119,0,0,279,122,157,GOOOOOXXXXXXXXXXXXXXGOOOOOOOOOOXXXXXXXXXGOOOOOOOOOXXXXXXXXXXGOOOOOOOOOOOOXXXXXXXGOOOOXXXXXXXXXXXXXXXGOOOOOOOOOOXXXXXXXXXGOOOOXXXXXXXXXXXXXXXGOOOOOOOOOXXXXXXXXXXGOOOOOOOOOOOOXXXXXXXGOOOXXXXXXXXXXXXXXXXGOOOOOOOXXXXXXXXXXXXGOOOOXXXXXXXXXXXXXXXGOOOOOOOOOOXXXXXXXXX,0,0,0
17073,112,0,112,111,117,0,0,277,115,162,GOOOOOXXXXXXXXXXXXXXGOOOOOOOOOOXXXXXXXXXGOOOOOOOOOXXXXXXXXXXGOOOOOOOOOOOOXXXXXXXGOOOOXXXXXXXXXXXXXXXGOOOOOOOOOOXXXXXXXXXGOOOOXXXXXXXXXXXXXXXGOOOOOOOOOXXXXXXXXXXGOOOOOOOOOOOOXXXXXXXGOOOXXXXXXXXXXXXXXXXGOOOOOOOXXXXXXXXXXXXGOOOOXXXXXXXXXXXXXXXGOOOOOOOOOOXXXXXXXXX,0,0,0
17094,112,0,112,111,117,0,0,277,118,159,GOOOOOXXXXXXXXXXXXXXGOOOOOOOOOOXXXXXXXXXGOOOOOOOOOXXXXXXXXXXGOOOOOOOOOOOOXXXXXXXGOOOOXXXXXXXXXXXXXXXGOOOOOOOOOOXXXXXXXXXGOOOOXXXXXXXXXXXXXXXGOOOOOOOOOXXXXXXXXXXGOOOOOOOOOOOOXXXXXXXGOOOXXXXXXXXXXXXXXXXGOOOOOOOXXXXXXXXXXXXGOOOOXXXXXXXXXXXXXXXGOOOOOOOOOOXXXXXXXXX,0,0,0

17115,112,0,112,107,121,0,0,279,121,158,GOOOOOXXXXXXXXXXXXXXGOOOOOOOOOOXXXXXXXXXGOOOOOOOOOXXXXXXXXXXGOOOOOOOOOOOOXXXXXXXGOOOOXXXXXXXXXXXXXXXGOOOOOOOOOOXXXXXXXXXGOOOOXXXXXXXXXXXXXXXGOOOOOOOOOXXXXXXXXXXGOOOOOOOOOOOOXXXXXXXGOOOXXXXXXXXXXXXXXXXGOOOOOOOXXXXXXXXXXXXGOOOOXXXXXXXXXXXXXXXGOOOOOOOOOOXXXXXXXXX,0,0,0
17136,112,0,112,111,117,0,0,278,113,165,GOOOOOXXXXXXXXXXXXXXGOOOOOOOOOOXXXXXXXXXGOOOOOOOOOXXXXXXXXXXGOOOOOOOOOOOOXXXXXXXGOOOOXXXXXXXXXXXXXXXGOOOOOOOOOOXXXXXXXXXGOOOOXXXXXXXXXXXXXXXGOOOOOOOOOXXXXXXXXXXGOOOOOOOOOOOOXXXXXXXGOOOXXXXXXXXXXXXXXXXGOOOOOOOXXXXXXXXXXXXGOOOOXXXXXXXXXXXXXXXGOOOOOOOOOOXXXXXXXXX,0,0,0
17157,112,0,112,103,125,0,0,285,116,169,GOOOOOXXXXXXXXXXXXXXGOOOOOOOOOOXXXXXXXXXGOOOOOOOOOXXXXXXXXXXGOOOOOOOOOOOOXXXXXXXGOOOOXXXXXXXXXXXXXXXGOOOOOOOOOOXXXXXXXXXGOOOOXXXXXXXXXXXXXXXGOOOOOOOOOXXXXXXXXXXGOOOOOOOOOOOOXXXXXXXGOOOXXXXXXXXXXXXXXXXGOOOOOOOXXXXXXXXXXXXGOOOOXXXXXXXXXXXXXXXGOOOOOOOOOOXXXXXXXXX,0,0,0
17178,113,0,113,111,116,0,0,277,112,165,GOOOOOXXXXXXXXXXXXXXGOOOOOOOOOOXXXXXXXXXGOOOOOOOOOXXXXXXXXXXGOOOOOOOOOOOOOXXXXXXGOOOOXXXXXXXXXXXXXXXGOOOOOOOOOOXXXXXXXXXGOOOOXXXXXXXXXXXXXXXGOOOOOOOOOXXXXXXXXXXGOOOOOOOOOOOOXXXXXXXGOOOXXXXXXXXXXXXXXXXGOOOOOOOXXXXXXXXXXXXGOOOOXXXXXXXXXXXXXXXGOOOOOOOOOOXXXXXXXXX,0,0,0
17199,113,0,113,110,117,0,0,278,114,164,GOOOOOXXXXXXXXXXXXXXGOOOOOOOOOOXXXXXXXXXGOOOOOOOOOXXXXXXXXXXGOOOOOOOOOOOOOXXXXXXGOOOOXXXXXXXXXXXXXXXGOOOOOOOOOOXXXXXXXXXGOOOOXXXXXXXXXXXXXXXGOOOOOOOOOXXXXXXXXXXGOOOOOOOOOOOOXXXXXXXGOOOXXXXXXXXXXXXXXXXGOOOOOOOXXXXXXXXXXXXGOOOOXXXXXXXXXXXXXXXGOOOOOOOOOOXXXXXXXXX,0,0,0

17220,113,0,113,112,115,0,0,276,113,163,GOOOOOXXXXXXXXXXXXXXGOOOOOOOOOOXXXXXXXXXGOOOOOOOOOXXXXXXXXXXGOOOOOOOOOOOOOXXXXXXGOOOOXXXXXXXXXXXXXXXGOOOOOOOOOOXXXXXXXXXGOOOOXXXXXXXXXXXXXXXGOOOOOOOOOXXXXXXXXXXGOOOOOOOOOOOOXXXXXXXGOOOXXXXXXXXXXXXXXXXGOOOOOOOXXXXXXXXXXXXGOOOOXXXXXXXXXXXXXXXGOOOOOOOOOOXXXXXXXXX,0,0,0
17241,113,0,113,108,119,0,0,280,111,169,GOOOOOXXXXXXXXXXXXXXGOOOOOOOOOOXXXXXXXXXGOOOOOOOOOXXXXXXXXXXGOOOOOOOOOOOOOXXXXXXGOOOOXXXXXXXXXXXXXXXGOOOOOOOOOOXXXXXXXXXGOOOOXXXXXXXXXXXXXXXGOOOOOOOOOXXXXXXXXXXGOOOOOOOOOOOOXXXXXXXGOOOXXXXXXXXXXXXXXXXGOOOOOOOXXXXXXXXXXXXGOOOOXXXXXXXXXXXXXXXGOOOOOOOOOOXXXXXXXXX,0,0,0
17262,114,1,113,106,120,0,0,281,114,167,GOOOOOXXXXXXXXXXXXXXGOOOOOOOOOOXXXXXXXXXGOOOOOOOOOXXXXXXXXXXGOOOOOOOOOOOOOXXXXXXGOOOOXXXXXXXXXXXXXXXGOOOOOOOOOOXXXXXXXXXGOOOOXXXXXXXXXXXXXXXGOOOOOOOOOXXXXXXXXXXGOOOOOOOOOOOOXXXXXXXGOOOAXXXXXXXXXXXXXXXGOOOOOOOXXXXXXXXXXXXGOOOOXXXXXXXXXXXXXXXGOOOOOOOOOOXXXXXXXXX,0,0,0
17283,114,1,113,107,119,0,0,280,120,160,GOOOOOXXXXXXXXXXXXXXGOOOOOOOOOOXXXXXXXXXGOOOOOOOOOXXXXXXXXXXGOOOOOOOOOOOOOXXXXXXGOOOOXXXXXXXXXXXXXXXGOOOOOOOOOOXXXXXXXXXGOOOOXXXXXXXXXXXXXXXGOOOOOOOOOXXXXXXXXXXGOOOOOOOOOOOOXXXXXXXGOOOAXXXXXXXXXXXXXXXGOOOOOOOXXXXXXXXXXXXGOOOOXXXXXXXXXXXXXXXGOOOOOOOOOOXXXXXXXXX,0,0,0
17304,114,1,113,106,120,0,0,280,124,156,GOOOOOXXXXXXXXXXXXXXGOOOOOOOOOOXXXXXXXXXGOOOOOOOOOXXXXXXXXXXGOOOOOOOOOOOOOXXXXXXGOOOOXXXXXXXXXXXXXXXGOOOOOOOOOOXXXXXXXXXGOOOOXXXXXXXXXXXXXXXGOOOOOOOOOXXXXXXXXXXGOOOOOOOOOOOOXXXXXXXGOOOAXXXXXXXXXXXXXXXGOOOOOOOXXXXXXXXXXXXGOOOOXXXXXXXXXXXXXXXGOOOOOOOOOOXXXXXXXXX,0,0,0

17325,114,1,113,105,121,0,0,280,128,152,GOOOOOXXXXXXXXXXXXXXGOOOOOOOOOOXXXXXXXXXGOOOOOOOOOXXXXXXXXXXGOOOOOOOOOOOOOXXXXXXGOOOOXXXXXXXXXXXXXXXGOOOOOOOOOOXXXXXXXXXGOOOOXXXXXXXXXXXXXXXGOOOOOOOOOXXXXXXXXXXGOOOOOOOOOOOOXXXXXXXGOOOAXXXXXXXXXXXXXXXGOOOOOOOXXXXXXXXXXXXGOOOOXXXXXXXXXXXXXXXGOOOOOOOOOOXXXXXXXXX,0,0,0
17346,114,1,113,117,109,0,0,268,120,148,GOOOOOXXXXXXXXXXXXXXGOOOOOOOOOOXXXXXXXXXGOOOOOOOOOXXXXXXXXXXGOOOOOOOOOOOOOXXXXXXGOOOOXXXXXXXXXXXXXXXGOOOOOOOOOOXXXXXXXXXGOOOOXXXXXXXXXXXXXXXGOOOOOOOOOXXXXXXXXXXGOOOOOOOOOOOOXXXXXXXGOOOAXXXXXXXXXXXXXXXGOOOOOOOXXXXXXXXXXXXGOOOOXXXXXXXXXXXXXXXGOOOOOOOOOOXXXXXXXXX,0,0,0
17367,114,1,113,116,110,0,0,269,122,147,GOOOOOXXXXXXXXXXXXXXGOOOOOOOOOOXXXXXXXXXGOOOOOOOOOXXXXXXXXXXGOOOOOOOOOOOOOXXXXXXGOOOOXXXXXXXXXXXXXXXGOOOOOOOOOOXXXXXXXXXGOOOOXXXXXXXXXXXXXXXGOOOOOOOOOXXXXXXXXXXGOOOOOOOOOOOOXXXXXXXGOOOAXXXXXXXXXXXXXXXGOOOOOOOXXXXXXXXXXXXGOOOOXXXXXXXXXXXXXXXGOOOOOOOOOOXXXXXXXXX,0,0,0
17388,114,1,113,119,107,0,0,267,114,153,GOOOOOXXXXXXXXXXXXXXGOOOOOOOOOOXXXXXXXXXGOOOOOOOOOXXXXXXXXXXGOOOOOOOOOOOOOXXXXXXGOOOOXXXXXXXXXXXXXXXGOOOOOOOOOOXXXXXXXXXGOOOOXXXXXXXXXXXXXXXGOOOOOOOOOXXXXXXXXXXGOOOOOOOOOOOOXXXXXXXGOOOAXXXXXXXXXXXXXXXGOOOOOOOXXXXXXXXXXXXGOOOOXXXXXXXXXXXXXXXGOOOOOOOOOOXXXXXXXXX,0,0,0
17409,114,1,113,116,110,0,0,270,121,149,GOOOOOXXXXXXXXXXXXXXGOOOOOOOOOOXXXXXXXXXGOOOOOOOOOXXXXXXXXXXGOOOOOOOOOOOOOXXXXXXGOOOOXXXXXXXXXXXXXXXGOOOOOOOOOOXXXXXXXXXGOOOOXXXXXXXXXXXXXXXGOOOOOOOOOXXXXXXXXXXGOOOOOOOOOOOOXXXXXXXGOOOAXXXXXXXXXXXXXXXGOOOOOOOXXXXXXXXXXXXGOOOOXXXXXXXXXXXXXXXGOOOOOOOOOOXXXXXXXXX,0,0,0

17430,114,1,113,120,106,0,0,264,122,142,GOOOOOXXXXXXXXXXXXXXGOOOOOOOOOOXXXXXXXXXGOOOOOOOOOXXXXXXXXXXGOOOOOOOOOOOOOXXXXXXGOOOOXXXXXXXXXXXXXXXGOOOOOOOOOOXXXXXXXXXGOOOOXXXXXXXXXXXXXXXGOOOOOOOOOXXXXXXXXXXGOOOOOOOOOOOOXXXXXXXGOOOAXXXXXXXXXXXXXXXGOOOOOOOXXXXXXXXXXXXGOOOOXXXXXXXXXXXXXXXGOOOOOOOOOOXXXXXXXXX,0,0,0
17451,114,0,114,120,106,0,0,265,122,143,GOOOOOXXXXXXXXXXXXXXGOOOOOOOOOOXXXXXXXXXGOOOOOOOOOXXXXXXXXXXGOOOOOOOOOOOOOXXXXXXGOOOOXXXXXXXXXXXXXXXGOOOOOOOOOOXXXXXXXXXGOOOOXXXXXXXXXXXXXXXGOOOOOOOOOXXXXXXXXXXGOOOOOOOOOOOOXXXXXXXGOOOOXXXXXXXXXXXXXXXGOOOOOOOXXXXXXXXXXXXGOOOOXXXXXXXXXXXXXXXGOOOOOOOOOOXXXXXXXXX,0,0,0
17472,114,0,114,122,104,0,0,264,115,149,GOOOOOXXXXXXXXXXXXXXGOOOOOOOOOOXXXXXXXXXGOOOOOOOOOXXXXXXXXXXGOOOOOOOOOOOOOXXXXXXGOOOOXXXXXXXXXXXXXXXGOOOOOOOOOOXXXXXXXXXGOOOOXXXXXXXXXXXXXXXGOOOOOOOOOXXXXXXXXXXGOOOOOOOOOOOOXXXXXXXGOOOOXXXXXXXXXXXXXXXGOOOOOOOXXXXXXXXXXXXGOOOOXXXXXXXXXXXXXXXGOOOOOOOOOOXXXXXXXXX,0,0,0
17493,114,0,114,116,110,0,0,270,118,152,GOOOOOXXXXXXXXXXXXXXGOOOOOOOOOOXXXXXXXXXGOOOOOOOOOXXXXXXXXXXGOOOOOOOOOOOOOXXXXXXGOOOOXXXXXXXXXXXXXXXGOOOOOOOOOOXXXXXXXXXGOOOOXXXXXXXXXXXXXXXGOOOOOOOOOXXXXXXXXXXGOOOOOOOOOOOOXXXXXXXGOOOOXXXXXXXXXXXXXXXGOOOOOOOXXXXXXXXXXXXGOOOOXXXXXXXXXXXXXXXGOOOOOOOOOOXXXXXXXXX,0,0,0
17514,114,0,114,111,115,0,0,273,116,157,GOOOOOXXXXXXXXXXXXXXGOOOOOOOOOOXXXXXXXXXGOOOOOOOOOXXXXXXXXXXGOOOOOOOOOOOOOXXXXXXGOOOOXXXXXXXXXXXXXXXGOOOOOOOOOOXXXXXXXXXGOOOOXXXXXXXXXXXXXXXGOOOOOOOOOXXXXXXXXXXGOOOOOOOOOOOOXXXXXXXGOOOOXXXXXXXXXXXXXXXGOOOOOOOXXXXXXXXXXXXGOOOOXXXXXXXXXXXXXXXGOOOOOOOOOOXXXXXXXXX,0,0,0

17535,115,1,114,115,110,0,0,269,113,156,GOOOOOXXXXXXXXXXXXXXGOOOOOOOOOOXXXXXXXXXGOOOOOOOOOXXXXXXXXXXGOOOOOOOOOOOOOXXXXXXGOOOOXXXXXXXXXXXXXXXGOOOOOOOOOOAXXXXXXXXGOOOOXXXXXXXXXXXXXXXGOOOOOOOOOXXXXXXXXXXGOOOOOOOOOOOOXXXXXXXGOOOOXXXXXXXXXXXXXXXGOOOOOOOXXXXXXXXXXXXGOOOOXXXXXXXXXXXXXXXGOOOOOOOOOOXXXXXXXXX,0,0,0
17556,115,1,114,112,113,0,0,272,114,158,GOOOOOXXXXXXXXXXXXXXGOOOOOOOOOOXXXXXXXXXGOOOOOOOOOXXXXXXXXXXGOOOOOOOOOOOOOXXXXXXGOOOOXXXXXXXXXXXXXXXGOOOOOOOOOOAXXXXXXXXGOOOOXXXXXXXXXXXXXXXGOOOOOOOOOXXXXXXXXXXGOOOOOOOOOOOOXXXXXXXGOOOOXXXXXXXXXXXXXXXGOOOOOOOXXXXXXXXXXXXGOOOOXXXXXXXXXXXXXXXGOOOOOOOOOOXXXXXXXXX,0,0,0
17577,115,0,115,106,119,0,0,279,113,166,GOOOOOXXXXXXXXXXXXXXGOOOOOOOOOOXXXXXXXXXGOOOOOOOOOXXXXXXXXXXGOOOOOOOOOOOOOXXXXXXGOOOOXXXXXXXXXXXXXXXGOOOOOOOOOOOXXXXXXXXGOOOOXXXXXXXXXXXXXXXGOOOOOOOOOXXXXXXXXXXGOOOOOOOOOOOOXXXXXXXGOOOOXXXXXXXXXXXXXXXGOOOOOOOXXXXXXXXXXXXGOOOOXXXXXXXXXXXXXXXGOOOOOOOOOOXXXXXXXXX,0,0,0
17598,115,0,115,112,113,0,0,273,109,164,GOOOOOXXXXXXXXXXXXXXGOOOOOOOOOOXXXXXXXXXGOOOOOOOOOXXXXXXXXXXGOOOOOOOOOOOOOXXXXXXGOOOOXXXXXXXXXXXXXXXGOOOOOOOOOOOXXXXXXXXGOOOOXXXXXXXXXXXXXXXGOOOOOOOOOXXXXXXXXXXGOOOOOOOOOOOOXXXXXXXGOOOOXXXXXXXXXXXXXXXGOOOOOOOXXXXXXXXXXXXGOOOOXXXXXXXXXXXXXXXGOOOOOOOOOOXXXXXXXXX,0,0,0
17619,115,0,115,108,117,0,0,277,108,169,GOOOOOXXXXXXXXXXXXXXGOOOOOOOOOOXXXXXXXXXGOOOOOOOOOXXXXXXXXXXGOOOOOOOOOOOOOXXXXXXGOOOOXXXXXXXXXXXXXXXGOOOOOOOOOOOXXXXXXXXGOOOOXXXXXXXXXXXXXXXGOOOOOOOOOXXXXXXXXXXGOOOOOOOOOOOOXXXXXXXGOOOOXXXXXXXXXXXXXXXGOOOOOOOXXXXXXXXXXXXGOOOOXXXXXXXXXXXXXXXGOOOOOOOOOOXXXXXXXXX,0,0,0

17640,115,0,115,107,118,0,0,277,110,167,GOOOOOXXXXXXXXXXXXXXGOOOOOOOOOOXXXXXXXXXGOOOOOOOOOXXXXXXXXXXGOOOOOOOOOOOOOXXXXXXGOOOOXXXXXXXXXXXXXXXGOOOOOOOOOOOXXXXXXXXGOOOOXXXXXXXXXXXXXXXGOOOOOOOOOXXXXXXXXXXGOOOOOOOOOOOOXXXXXXXGOOOOXXXXXXXXXXXXXXXGOOOOOOOXXXXXXXXXXXXGOOOOXXXXXXXXXXXXXXXGOOOOOOOOOOXXXXXXXXX,0,0,0
17661,115,0,115,105,120,0,0,280,107,173,GOOOOOXXXXXXXXXXXXXXGOOOOOOOOOOXXXXXXXXXGOOOOOOOOOXXXXXXXXXXGOOOOOOOOOOOOOXXXXXXGOOOOXXXXXXXXXXXXXXXGOOOOOOOOOOOXXXXXXXXGOOOOXXXXXXXXXXXXXXXGOOOOOOOOOXXXXXXXXXXGOOOOOOOOOOOOXXXXXXXGOOOOXXXXXXXXXXXXXXXGOOOOOOOXXXXXXXXXXXXGOOOOXXXXXXXXXXXXXXXGOOOOOOOOOOXXXXXXXXX,0,0,0
17682,115,0,115,101,124,0,0,282,107,175,GOOOOOXXXXXXXXXXXXXXGOOOOOOOOOOXXXXXXXXXGOOOOOOOOOXXXXXXXXXXGOOOOOOOOOOOOOXXXXXXGOOOOXXXXXXXXXXXXXXXGOOOOOOOOOOOXXXXXXXXGOOOOXXXXXXXXXXXXXXXGOOOOOOOOOXXXXXXXXXXGOOOOOOOOOOOOXXXXXXXGOOOOXXXXXXXXXXXXXXXGOOOOOOOXXXXXXXXXXXXGOOOOXXXXXXXXXXXXXXXGOOOOOOOOOOXXXXXXXXX,0,0,0
17703,115,0,115,96,129,0,0,290,113,177,GOOOOOXXXXXXXXXXXXXXGOOOOOOOOOOXXXXXXXXXGOOOOOOOOOXXXXXXXXXXGOOOOOOOOOOOOOXXXXXXGOOOOXXXXXXXXXXXXXXXGOOOOOOOOOOOXXXXXXXXGOOOOXXXXXXXXXXXXXXXGOOOOOOOOOXXXXXXXXXXGOOOOOOOOOOOOXXXXXXXGOOOOXXXXXXXXXXXXXXXGOOOOOOOXXXXXXXXXXXXGOOOOXXXXXXXXXXXXXXXGOOOOOOOOOOXXXXXXXXX,0,0,0
17724,115,0,115,92,133,0,0,293,118,175,GOOOOOXXXXXXXXXXXXXXGOOOOOOOOOOXXXXXXXXXGOOOOOOOOOXXXXXXXXXXGOOOOOOOOOOOOOXXXXXXGOOOOXXXXXXXXXXXXXXXGOOOOOOOOOOOXXXXXXXXGOOOOXXXXXXXXXXXXXXXGOOOOOOOOOXXXXXXXXXXGOOOOOOOOOOOOXXXXXXXGOOOOXXXXXXXXXXXXXXXGOOOOOOOXXXXXXXXXXXXGOOOOXXXXXXXXXXXXXXXGOOOOOOOOOOXXXXXXXXX,0,0,0

17745,116,1,115,86,138,0,0,299,120,179,GOOOOOXXXXXXXXXXXXXXGOOOOOOOOOOXXXXXXXXXGOOOOOOOOOXXXXXXXXXXGOOOOOOOOOOOOOXXXXXXGOOOOXXXXXXXXXXXXXXXGOOOOOOOOOOOXXXXXXXXGOOOOXXXXXXXXXXXXXXXGOOOOOOOOOAXXXXXXXXXGOOOOOOOOOOOOXXXXXXXGOOOOXXXXXXXXXXXXXXXGOOOOOOOXXXXXXXXXXXXGOOOOXXXXXXXXXXXXXXXGOOOOOOOOOOXXXXXXXXX,0,0,0
17766,116,1,115,86,138,0,0,299,124,175,GOOOOOXXXXXXXXXXXXXXGOOOOOOOOOOXXXXXXXXXGOOOOOOOOOXXXXXXXXXXGOOOOOOOOOOOOOXXXXXXGOOOOXXXXXXXXXXXXXXXGOOOOOOOOOOOXXXXXXXXGOOOOXXXXXXXXXXXXXXXGOOOOOOOOOAXXXXXXXXXGOOOOOOOOOOOOXXXXXXXGOOOOXXXXXXXXXXXXXXXGOOOOOOOXXXXXXXXXXXXGOOOOXXXXXXXXXXXXXXXGOOOOOOOOOOXXXXXXXXX,0,0,0
17787,116,1,115,95,129,0,0,290,123,167,GOOOOOXXXXXXXXXXXXXXGOOOOOOOOOOXXXXXXXXXGOOOOOOOOOXXXXXXXXXXGOOOOOOOOOOOOOXXXXXXGOOOOXXXXXXXXXXXXXXXGOOOOOOOOOOOXXXXXXXXGOOOOXXXXXXXXXXXXXXXGOOOOOOOOOAXXXXXXXXXGOOOOOOOOOOOOXXXXXXXGOOOOXXXXXXXXXXXXXXXGOOOOOOOXXXXXXXXXXXXGOOOOXXXXXXXXXXXXXXXGOOOOOOOOOOXXXXXXXXX,0,0,0
17808,116,1,115,106,118,0,0,279,117,162,GOOOOOXXXXXXXXXXXXXXGOOOOOOOOOOXXXXXXXXXGOOOOOOOOOXXXXXXXXXXGOOOOOOOOOOOOOXXXXXXGOOOOXXXXXXXXXXXXXXXGOOOOOOOOOOOXXXXXXXXGOOOOXXXXXXXXXXXXXXXGOOOOOOOOOAXXXXXXXXXGOOOOOOOOOOOOXXXXXXXGOOOOXXXXXXXXXXXXXXXGOOOOOOOXXXXXXXXXXXXGOOOOXXXXXXXXXXXXXXXGOOOOOOOOOOXXXXXXXXX,0,0,0
17829,116,1,115,107,117,0,0,278,118,160,GOOOOOXXXXXXXXXXXXXXGOOOOOOOOOOXXXXXXXXXGOOOOOOOOOXXXXXXXXXXGOOOOOOOOOOOOOXXXXXXGOOOOXXXXXXXXXXXXXXXGOOOOOOOOOOOXXXXXXXXGOOOOXXXXXXXXXXXXXXXGOOOOOOOOOAXXXXXXXXXGOOOOOOOOOOOOXXXXXXXGOOOOXXXXXXXXXXXXXXXGOOOOOOOXXXXXXXXXXXXGOOOOXXXXXXXXXXXXXXXGOOOOOOOOOOXXXXXXXXX,0,0,0

17850,116,1,115,113,111,0,0,271,117,154,GOOOOOXXXXXXXXXXXXXXGOOOOOOOOOOXXXXXXXXXGOOOOOOOOOXXXXXXXXXXGOOOOOOOOOOOOOXXXXXXGOOOOXXXXXXXXXXXXXXXGOOOOOOOOOOOXXXXXXXXGOOOOXXXXXXXXXXXXXXXGOOOOOOOOOAXXXXXXXXXGOOOOOOOOOOOOXXXXXXXGOOOOXXXXXXXXXXXXXXXGOOOOOOOXXXXXXXXXXXXGOOOOXXXXXXXXXXXXXXXGOOOOOOOOOOXXXXXXXXX,0,0,0
17871,116,0,116,106,118,0,0,280,127,153,GOOOOOXXXXXXXXXXXXXXGOOOOOOOOOOXXXXXXXXXGOOOOOOOOOXXXXXXXXXXGOOOOOOOOOOOOOXXXXXXGOOOOXXXXXXXXXXXXXXXGOOOOOOOOOOOXXXXXXXXGOOOOXXXXXXXXXXXXXXXGOOOOOOOOOOXXXXXXXXXGOOOOOOOOOOOOXXXXXXXGOOOOXXXXXXXXXXXXXXXGOOOOOOOXXXXXXXXXXXXGOOOOXXXXXXXXXXXXXXXGOOOOOOOOOOXXXXXXXXX,0,0,0
17892,116,0,116,114,110,0,0,271,122,149,GOOOOOXXXXXXXXXXXXXXGOOOOOOOOOOXXXXXXXXXGOOOOOOOOOXXXXXXXXXXGOOOOOOOOOOOOOXXXXXXGOOOOXXXXXXXXXXXXXXXGOOOOOOOOOOOXXXXXXXXGOOOOXXXXXXXXXXXXXXXGOOOOOOOOOOXXXXXXXXXGOOOOOOOOOOOOXXXXXXXGOOOOXXXXXXXXXXXXXXXGOOOOOOOXXXXXXXXXXXXGOOOOXXXXXXXXXXXXXXXGOOOOOOOOOOXXXXXXXXX,0,0,0
17913,116,0,116,113,111,0,0,272,122,150,GOOOOOXXXXXXXXXXXXXXGOOOOOOOOOOXXXXXXXXXGOOOOOOOOOXXXXXXXXXXGOOOOOOOOOOOOOXXXXXXGOOOOXXXXXXXXXXXXXXXGOOOOOOOOOOOXXXXXXXXGOOOOXXXXXXXXXXXXXXXGOOOOOOOOOOXXXXXXXXXGOOOOOOOOOOOOXXXXXXXGOOOOXXXXXXXXXXXXXXXGOOOOOOOXXXXXXXXXXXXGOOOOXXXXXXXXXXXXXXXGOOOOOOOOOOXXXXXXXXX,0,0,0
17934,116,0,116,116,108,0,0,269,116,153,GOOOOOXXXXXXXXXXXXXXGOOOOOOOOOOXXXXXXXXXGOOOOOOOOOXXXXXXXXXXGOOOOOOOOOOOOOXXXXXXGOOOOXXXXXXXXXXXXXXXGOOOOOOOOOOOXXXXXXXXGOOOOXXXXXXXXXXXXXXXGOOOOOOOOOOXXXXXXXXXGOOOOOOOOOOOOXXXXXXXGOOOOXXXXXXXXXXXXXXXGOOOOOOOXXXXXXXXXXXXGOOOOXXXXXXXXXXXXXXXGOOOOOOOOOOXXXXXXXXX,0,0,0

17955,116,0,116,112,112,0,0,274,117,157,GOOOOOXXXXXXXXXXXXXXGOOOOOOOOOOXXXXXXXXXGOOOOOOOOOXXXXXXXXXXGOOOOOOOOOOOOOXXXXXXGOOOOXXXXXXXXXXXXXXXGOOOOOOOOOOOXXXXXXXXGOOOOXXXXXXXXXXXXXXXGOOOOOOOOOOXXXXXXXXXGOOOOOOOOOOOOXXXXXXXGOOOOXXXXXXXXXXXXXXXGOOOOOOOXXXXXXXXXXXXGOOOOXXXXXXXXXXXXXXXGOOOOOOOOOOXXXXXXXXX,0,0,0
17976,116,0,116,117,107,0,0,269,115,154,GOOOOOXXXXXXXXXXXXXXGOOOOOOOOOOXXXXXXXXXGOOOOOOOOOXXXXXXXXXXGOOOOOOOOOOOOOXXXXXXGOOOOXXXXXXXXXXXXXXXGOOOOOOOOOOOXXXXXXXXGOOOOXXXXXXXXXXXXXXXGOOOOOOOOOOXXXXXXXXXGOOOOOOOOOOOOXXXXXXXGOOOOXXXXXXXXXXXXXXXGOOOOOOOXXXXXXXXXXXXGOOOOXXXXXXXXXXXXXXXGOOOOOOOOOOXXXXXXXXX,0,0,0
17997,116,0,116,120,104,0,0,266,115,151,GOOOOOXXXXXXXXXXXXXXGOOOOOOOOOOXXXXXXXXXGOOOOOOOOOXXXXXXXXXXGOOOOOOOOOOOOOXXXXXXGOOOOXXXXXXXXXXXXXXXGOOOOOOOOOOOXXXXXXXXGOOOOXXXXXXXXXXXXXXXGOOOOOOOOOOXXXXXXXXXGOOOOOOOOOOOOXXXXXXXGOOOOXXXXXXXXXXXXXXXGOOOOOOOXXXXXXXXXXXXGOOOOXXXXXXXXXXXXXXXGOOOOOOOOOOXXXXXXXXX,0,0,0
18018,116,0,116,112,112,0,0,273,125,148,GOOOOOXXXXXXXXXXXXXXGOOOOOOOOOOXXXXXXXXXGOOOOOOOOOXXXXXXXXXXGOOOOOOOOOOOOOXXXXXXGOOOOXXXXXXXXXXXXXXXGOOOOOOOOOOOXXXXXXXXGOOOOXXXXXXXXXXXXXXXGOOOOOOOOOOXXXXXXXXXGOOOOOOOOOOOOXXXXXXXGOOOOXXXXXXXXXXXXXXXGOOOOOOOXXXXXXXXXXXXGOOOOXXXXXXXXXXXXXXXGOOOOOOOOOOXXXXXXXXX,0,0,0
18039,116,0,116,118,106,0,0,267,122,145,GOOOOOXXXXXXXXXXXXXXGOOOOOOOOOOXXXXXXXXXGOOOOOOOOOXXXXXXXXXXGOOOOOOOOOOOOOXXXXXXGOOOOXXXXXXXXXXXXXXXGOOOOOOOOOOOXXXXXXXXGOOOOXXXXXXXXXXXXXXXGOOOOOOOOOOXXXXXXXXXGOOOOOOOOOOOOXXXXXXXGOOOOXXXXXXXXXXXXXXXGOOOOOOOXXXXXXXXXXXXGOOOOXXXXXXXXXXXXXXXGOOOOOOOOOOXXXXXXXXX,0,0,0

18060,116,0,116,127,97,0,0,257,112,145,GOOOOOXXXXXXXXXXXXXXGOOOOOOOOOOXXXXXXXXXGOOOOOOOOOXXXXXXXXXXGOOOOOOOOOOOOOXXXXXXGOOOOXXXXXXXXXXXXXXXGOOOOOOOOOOOXXXXXXXXGOOOOXXXXXXXXXXXXXXXGOOOOOOOOOOXXXXXXXXXGOOOOOOOOOOOOXXXXXXXGOOOOXXXXXXXXXXXXXXXGOOOOOOOXXXXXXXXXXXXGOOOOXXXXXXXXXXXXXXXGOOOOOOOOOOXXXXXXXXX,0,0,0
18081,116,0,116,120,104,0,0,264,113,151,GOOOOOXXXXXXXXXXXXXXGOOOOOOOOOOXXXXXXXXXGOOOOOOOOOXXXXXXXXXXGOOOOOOOOOOOOOXXXXXXGOOOOXXXXXXXXXXXXXXXGOOOOOOOOOOOXXXXXXXXGOOOOXXXXXXXXXXXXXXXGOOOOOOOOOOXXXXXXXXXGOOOOOOOOOOOOXXXXXXXGOOOOXXXXXXXXXXXXXXXGOOOOOOOXXXXXXXXXXXXGOOOOXXXXXXXXXXXXXXXGOOOOOOOOOOXXXXXXXXX,0,0,0
18102,116,0,116,113,111,0,0,271,116,155,GOOOOOXXXXXXXXXXXXXXGOOOOOOOOOOXXXXXXXXXGOOOOOOOOOXXXXXXXXXXGOOOOOOOOOOOOOXXXXXXGOOOOXXXXXXXXXXXXXXXGOOOOOOOOOOOXXXXXXXXGOOOOXXXXXXXXXXXXXXXGOOOOOOOOOOXXXXXXXXXGOOOOOOOOOOOOXXXXXXXGOOOOXXXXXXXXXXXXXXXGOOOOOOOXXXXXXXXXXXXGOOOOXXXXXXXXXXXXXXXGOOOOOOOOOOXXXXXXXXX,0,0,0
18123,116,0,116,110,114,0,0,274,111,163,GOOOOOXXXXXXXXXXXXXXGOOOOOOOOOOXXXXXXXXXGOOOOOOOOOXXXXXXXXXXGOOOOOOOOOOOOOXXXXXXGOOOOXXXXXXXXXXXXXXXGOOOOOOOOOOOXXXXXXXXGOOOOXXXXXXXXXXXXXXXGOOOOOOOOOOXXXXXXXXXGOOOOOOOOOOOOXXXXXXXGOOOOXXXXXXXXXXXXXXXGOOOOOOOXXXXXXXXXXXXGOOOOXXXXXXXXXXXXXXXGOOOOOOOOOOXXXXXXXXX,0,0,0
18144,116,0,116,106,118,0,0,277,118,159,GOOOOOXXXXXXXXXXXXXXGOOOOOOOOOOXXXXXXXXXGOOOOOOOOOXXXXXXXXXXGOOOOOOOOOOOOOXXXXXXGOOOOXXXXXXXXXXXXXXXGOOOOOOOOOOOXXXXXXXXGOOOOXXXXXXXXXXXXXXXGOOOOOOOOOOXXXXXXXXXGOOOOOOOOOOOOXXXXXXXGOOOOXXXXXXXXXXXXXXXGOOOOOOOXXXXXXXXXXXXGOOOOXXXXXXXXXXXXXXXGOOOOOOOOOOXXXXXXXXX,0,0,0

18165,116,0,116,108,116,0,0,276,115,161,GOOOOOXXXXXXXXXXXXXXGOOOOOOOOOOXXXXXXXXXGOOOOOOOOOXXXXXXXXXXGOOOOOOOOOOOOOXXXXXXGOOOOXXXXXXXXXXXXXXXGOOOOOOOOOOOXXXXXXXXGOOOOXXXXXXXXXXXXXXXGOOOOOOOOOOXXXXXXXXXGOOOOOOOOOOOOXXXXXXXGOOOOXXXXXXXXXXXXXXXGOOOOOOOXXXXXXXXXXXXGOOOOXXXXXXXXXXXXXXXGOOOOOOOOOOXXXXXXXXX,0,0,0
18186,116,0,116,107,117,0,0,277,118,159,GOOOOOXXXXXXXXXXXXXXGOOOOOOOOOOXXXXXXXXXGOOOOOOOOOXXXXXXXXXXGOOOOOOOOOOOOOXXXXXXGOOOOXXXXXXXXXXXXXXXGOOOOOOOOOOOXXXXXXXXGOOOOXXXXXXXXXXXXXXXGOOOOOOOOOOXXXXXXXXXGOOOOOOOOOOOOXXXXXXXGOOOOXXXXXXXXXXXXXXXGOOOOOOOXXXXXXXXXXXXGOOOOXXXXXXXXXXXXXXXGOOOOOOOOOOXXXXXXXXX,0,0,0
18207,118,2,116,110,112,0,0,272,117,155,GOOOOOXXXXXXXXXXXXXXGOOOOOOOOOOXXXXXXXXXGOOOOOOOOOAXXXXXXXXXGOOOOOOOOOOOOOAXXXXXGOOOOXXXXXXXXXXXXXXXGOOOOOOOOOOOXXXXXXXXGOOOOXXXXXXXXXXXXXXXGOOOOOOOOOOXXXXXXXXXGOOOOOOOOOOOOXXXXXXXGOOOOXXXXXXXXXXXXXXXGOOOOOOOXXXXXXXXXXXXGOOOOXXXXXXXXXXXXXXXGOOOOOOOOOOXXXXXXXXX,0,0,0
18228,118,2,116,110,112,0,0,271,128,143,GOOOOOXXXXXXXXXXXXXXGOOOOOOOOOOXXXXXXXXXGOOOOOOOOOAXXXXXXXXXGOOOOOOOOOOOOOAXXXXXGOOOOXXXXXXXXXXXXXXXGOOOOOOOOOOOXXXXXXXXGOOOOXXXXXXXXXXXXXXXGOOOOOOOOOOXXXXXXXXXGOOOOOOOOOOOOXXXXXXXGOOOOXXXXXXXXXXXXXXXGOOOOOOOXXXXXXXXXXXXGOOOOXXXXXXXXXXXXXXXGOOOOOOOOOOXXXXXXXXX,0,0,0
18249,118,1,117,113,109,0,0,268,118,150,GOOOOOXXXXXXXXXXXXXXGOOOOOOOOOOXXXXXXXXXGOOOOOOOOOOXXXXXXXXXGOOOOOOOOOOOOOAXXXXXGOOOOXXXXXXXXXXXXXXXGOOOOOOOOOOOXXXXXXXXGOOOOXXXXXXXXXXXXXXXGOOOOOOOOOOXXXXXXXXXGOOOOOOOOOOOOXXXXXXXGOOOOXXXXXXXXXXXXXXXGOOOOOOOXXXXXXXXXXXXGOOOOXXXXXXXXXXXXXXXGOOOOOOOOOOXXXXXXXXX,0,0,0

18270,118,0,118,112,110,0,0,270,115,155,GOOOOOXXXXXXXXXXXXXXGOOOOOOOOOOXXXXXXXXXGOOOOOOOOOOXXXXXXXXXGOOOOOOOOOOOOOOXXXXXGOOOOXXXXXXXXXXXXXXXGOOOOOOOOOOOXXXXXXXXGOOOOXXXXXXXXXXXXXXXGOOOOOOOOOOXXXXXXXXXGOOOOOOOOOOOOXXXXXXXGOOOOXXXXXXXXXXXXXXXGOOOOOOOXXXXXXXXXXXXGOOOOXXXXXXXXXXXXXXXGOOOOOOOOOOXXXXXXXXX,0,0,0
18291,118,0,118,102,120,0,0,281,119,162,GOOOOOXXXXXXXXXXXXXXGOOOOOOOOOOXXXXXXXXXGOOOOOOOOOOXXXXXXXXXGOOOOOOOOOOOOOOXXXXXGOOOOXXXXXXXXXXXXXXXGOOOOOOOOOOOXXXXXXXXGOOOOXXXXXXXXXXXXXXXGOOOOOOOOOOXXXXXXXXXGOOOOOOOOOOOOXXXXXXXGOOOOXXXXXXXXXXXXXXXGOOOOOOOXXXXXXXXXXXXGOOOOXXXXXXXXXXXXXXXGOOOOOOOOOOXXXXXXXXX,0,0,0
18312,118,0,118,100,122,0,0,282,120,162,GOOOOOXXXXXXXXXXXXXXGOOOOOOOOOOXXXXXXXXXGOOOOOOOOOOXXXXXXXXXGOOOOOOOOOOOOOOXXXXXGOOOOXXXXXXXXXXXXXXXGOOOOOOOOOOOXXXXXXXXGOOOOXXXXXXXXXXXXXXXGOOOOOOOOOOXXXXXXXXXGOOOOOOOOOOOOXXXXXXXGOOOOXXXXXXXXXXXXXXXGOOOOOOOXXXXXXXXXXXXGOOOOXXXXXXXXXXXXXXXGOOOOOOOOOOXXXXXXXXX,0,0,0
18333,118,0,118,98,124,0,0,285,122,163,GOOOOOXXXXXXXXXXXXXXGOOOOOOOOOOXXXXXXXXXGOOOOOOOOOOXXXXXXXXXGOOOOOOOOOOOOOOXXXXXGOOOOXXXXXXXXXXXXXXXGOOOOOOOOOOOXXXXXXXXGOOOOXXXXXXXXXXXXXXXGOOOOOOOOOOXXXXXXXXXGOOOOOOOOOOOOXXXXXXXGOOOOXXXXXXXXXXXXXXXGOOOOOOOXXXXXXXXXXXXGOOOOXXXXXXXXXXXXXXXGOOOOOOOOOOXXXXXXXXX,0,0,0
18354,118,0,118,97,125,0,0,286,121,165,GOOOOOXXXXXXXXXXXXXXGOOOOOOOOOOXXXXXXXXXGOOOOOOOOOOXXXXXXXXXGOOOOOOOOOOOOOOXXXXXGOOOOXXXXXXXXXXXXXXXGOOOOOOOOOOOXXXXXXXXGOOOOXXXXXXXXXXXXXXXGOOOOOOOOOOXXXXXXXXXGOOOOOOOOOOOOXXXXXXXGOOOOXXXXXXXXXXXXXXXGOOOOOOOXXXXXXXXXXXXGOOOOXXXXXXXXXXXXXXXGOOOOOOOOOOXXXXXXXXX,0,0,0

18375,118,0,118,102,120,0,0,280,114,166,GOOOOOXXXXXXXXXXXXXXGOOOOOOOOOOXXXXXXXXXGOOOOOOOOOOXXXXXXXXXGOOOOOOOOOOOOOOXXXXXGOOOOXXXXXXXXXXXXXXXGOOOOOOOOOOOXXXXXXXXGOOOOXXXXXXXXXXXXXXXGOOOOOOOOOOXXXXXXXXXGOOOOOOOOOOOOXXXXXXXGOOOOXXXXXXXXXXXXXXXGOOOOOOOXXXXXXXXXXXXGOOOOXXXXXXXXXXXXXXXGOOOOOOOOOOXXXXXXXXX,0,0,0
18396,118,0,118,97,125,0,0,286,111,175,GOOOOOXXXXXXXXXXXXXXGOOOOOOOOOOXXXXXXXXXGOOOOOOOOOOXXXXXXXXXGOOOOOOOOOOOOOOXXXXXGOOOOXXXXXXXXXXXXXXXGOOOOOOOOOOOXXXXXXXXGOOOOXXXXXXXXXXXXXXXGOOOOOOOOOOXXXXXXXXXGOOOOOOOOOOOOXXXXXXXGOOOOXXXXXXXXXXXXXXXGOOOOOOOXXXXXXXXXXXXGOOOOXXXXXXXXXXXXXXXGOOOOOOOOOOXXXXXXXXX,0,0,0
18417,118,0,118,94,128,0,0,288,112,176,GOOOOOXXXXXXXXXXXXXXGOOOOOOOOOOXXXXXXXXXGOOOOOOOOOOXXXXXXXXXGOOOOOOOOOOOOOOXXXXXGOOOOXXXXXXXXXXXXXXXGOOOOOOOOOOOXXXXXXXXGOOOOXXXXXXXXXXXXXXXGOOOOOOOOOOXXXXXXXXXGOOOOOOOOOOOOXXXXXXXGOOOOXXXXXXXXXXXXXXXGOOOOOOOXXXXXXXXXXXXGOOOOXXXXXXXXXXXXXXXGOOOOOOOOOOXXXXXXXXX,0,0,0
18438,118,0,118,94,128,0,0,289,110,179,GOOOOOXXXXXXXXXXXXXXGOOOOOOOOOOXXXXXXXXXGOOOOOOOOOOXXXXXXXXXGOOOOOOOOOOOOOOXXXXXGOOOOXXXXXXXXXXXXXXXGOOOOOOOOOOOXXXXXXXXGOOOOXXXXXXXXXXXXXXXGOOOOOOOOOOXXXXXXXXXGOOOOOOOOOOOOXXXXXXXGOOOOXXXXXXXXXXXXXXXGOOOOOOOXXXXXXXXXXXXGOOOOXXXXXXXXXXXXXXXGOOOOOOOOOOXXXXXXXXX,0,0,0
18459,118,0,118,98,124,0,0,285,115,170,GOOOOOXXXXXXXXXXXXXXGOOOOOOOOOOXXXXXXXXXGOOOOOOOOOOXXXXXXXXXGOOOOOOOOOOOOOOXXXXXGOOOOXXXXXXXXXXXXXXXGOOOOOOOOOOOXXXXXXXXGOOOOXXXXXXXXXXXXXXXGOOOOOOOOOOXXXXXXXXXGOOOOOOOOOOOOXXXXXXXGOOOOXXXXXXXXXXXXXXXGOOOOOOOXXXXXXXXXXXXGOOOOXXXXXXXXXXXXXXXGOOOOOOOOOOXXXXXXXXX,0,0,0

18480,118,0,118,90,132,0,0,292,120,172,GOOOOOXXXXXXXXXXXXXXGOOOOOOOOOOXXXXXXXXXGOOOOOOOOOOXXXXXXXXXGOOOOOOOOOOOOOOXXXXXGOOOOXXXXXXXXXXXXXXXGOOOOOOOOOOOXXXXXXXXGOOOOXXXXXXXXXXXXXXXGOOOOOOOOOOXXXXXXXXXGOOOOOOOOOOOOXXXXXXXGOOOOXXXXXXXXXXXXXXXGOOOOOOOXXXXXXXXXXXXGOOOOXXXXXXXXXXXXXXXGOOOOOOOOOOXXXXXXXXX,0,0,0
18501,118,0,118,92,130,0,0,290,123,167,GOOOOOXXXXXXXXXXXXXXGOOOOOOOOOOXXXXXXXXXGOOOOOOOOOOXXXXXXXXXGOOOOOOOOOOOOOOXXXXXGOOOOXXXXXXXXXXXXXXXGOOOOOOOOOOOXXXXXXXXGOOOOXXXXXXXXXXXXXXXGOOOOOOOOOOXXXXXXXXXGOOOOOOOOOOOOXXXXXXXGOOOOXXXXXXXXXXXXXXXGOOOOOOOXXXXXXXXXXXXGOOOOXXXXXXXXXXXXXXXGOOOOOOOOOOXXXXXXXXX,0,0,0
18522,118,0,118,99,123,0,0,283,122,161,GOOOOOXXXXXXXXXXXXXXGOOOOOOOOOOXXXXXXXXXGOOOOOOOOOOXXXXXXXXXGOOOOOOOOOOOOOOXXXXXGOOOOXXXXXXXXXXXXXXXGOOOOOOOOOOOXXXXXXXXGOOOOXXXXXXXXXXXXXXXGOOOOOOOOOOXXXXXXXXXGOOOOOOOOOOOOXXXXXXXGOOOOXXXXXXXXXXXXXXXGOOOOOOOXXXXXXXXXXXXGOOOOXXXXXXXXXXXXXXXGOOOOOOOOOOXXXXXXXXX,0,0,0
18543,118,0,118,96,126,0,0,286,127,159,GOOOOOXXXXXXXXXXXXXXGOOOOOOOOOOXXXXXXXXXGOOOOOOOOOOXXXXXXXXXGOOOOOOOOOOOOOOXXXXXGOOOOXXXXXXXXXXXXXXXGOOOOOOOOOOOXXXXXXXXGOOOOXXXXXXXXXXXXXXXGOOOOOOOOOOXXXXXXXXXGOOOOOOOOOOOOXXXXXXXGOOOOXXXXXXXXXXXXXXXGOOOOOOOXXXXXXXXXXXXGOOOOXXXXXXXXXXXXXXXGOOOOOOOOOOXXXXXXXXX,0,0,0
18564,118,0,118,100,122,0,0,282,131,151,GOOOOOXXXXXXXXXXXXXXGOOOOOOOOOOXXXXXXXXXGOOOOOOOOOOXXXXXXXXXGOOOOOOOOOOOOOOXXXXXGOOOOXXXXXXXXXXXXXXXGOOOOOOOOOOOXXXXXXXXGOOOOXXXXXXXXXXXXXXXGOOOOOOOOOOXXXXXXXXXGOOOOOOOOOOOOXXXXXXXGOOOOXXXXXXXXXXXXXXXGOOOOOOOXXXXXXXXXXXXGOOOOXXXXXXXXXXXXXXXGOOOOOOOOOOXXXXXXXXX,0,0,0

18585,118,0,118,106,116,0,0,276,127,149,GOOOOOXXXXXXXXXXXXXXGOOOOOOOOOOXXXXXXXXXGOOOOOOOOOOXXXXXXXXXGOOOOOOOOOOOOOOXXXXXGOOOOXXXXXXXXXXXXXXXGOOOOOOOOOOOXXXXXXXXGOOOOXXXXXXXXXXXXXXXGOOOOOOOOOOXXXXXXXXXGOOOOOOOOOOOOXXXXXXXGOOOOXXXXXXXXXXXXXXXGOOOOOOOXXXXXXXXXXXXGOOOOXXXXXXXXXXXXXXXGOOOOOOOOOOXXXXXXXXX,0,0,0
18606,118,0,118,107,115,0,0,274,123,151,GOOOOOXXXXXXXXXXXXXXGOOOOOOOOOOXXXXXXXXXGOOOOOOOOOOXXXXXXXXXGOOOOOOOOOOOOOOXXXXXGOOOOXXXXXXXXXXXXXXXGOOOOOOOOOOOXXXXXXXXGOOOOXXXXXXXXXXXXXXXGOOOOOOOOOOXXXXXXXXXGOOOOOOOOOOOOXXXXXXXGOOOOXXXXXXXXXXXXXXXGOOOOOOOXXXXXXXXXXXXGOOOOXXXXXXXXXXXXXXXGOOOOOOOOOOXXXXXXXXX,0,0,0
18627,118,0,118,108,114,0,0,274,124,150,GOOOOOXXXXXXXXXXXXXXGOOOOOOOOOOXXXXXXXXXGOOOOOOOOOOXXXXXXXXXGOOOOOOOOOOOOOOXXXXXGOOOOXXXXXXXXXXXXXXXGOOOOOOOOOOOXXXXXXXXGOOOOXXXXXXXXXXXXXXXGOOOOOOOOOOXXXXXXXXXGOOOOOOOOOOOOXXXXXXXGOOOOXXXXXXXXXXXXXXXGOOOOOOOXXXXXXXXXXXXGOOOOXXXXXXXXXXXXXXXGOOOOOOOOOOXXXXXXXXX,0,0,0
18648,118,0,118,110,112,0,0,273,126,147,GOOOOOXXXXXXXXXXXXXXGOOOOOOOOOOXXXXXXXXXGOOOOOOOOOOXXXXXXXXXGOOOOOOOOOOOOOOXXXXXGOOOOXXXXXXXXXXXXXXXGOOOOOOOOOOOXXXXXXXXGOOOOXXXXXXXXXXXXXXXGOOOOOOOOOOXXXXXXXXXGOOOOOOOOOOOOXXXXXXXGOOOOXXXXXXXXXXXXXXXGOOOOOOOXXXXXXXXXXXXGOOOOXXXXXXXXXXXXXXXGOOOOOOOOOOXXXXXXXXX,0,0,0
18669,118,0,118,113,109,0,0,269,121,148,GOOOOOXXXXXXXXXXXXXXGOOOOOOOOOOXXXXXXXXXGOOOOOOOOOOXXXXXXXXXGOOOOOOOOOOOOOOXXXXXGOOOOXXXXXXXXXXXXXXXGOOOOOOOOOOOXXXXXXXXGOOOOXXXXXXXXXXXXXXXGOOOOOOOOOOXXXXXXXXXGOOOOOOOOOOOOXXXXXXXGOOOOXXXXXXXXXXXXXXXGOOOOOOOXXXXXXXXXXXXGOOOOXXXXXXXXXXXXXXXGOOOOOOOOOOXXXXXXXXX,0,0,0

18690,118,0,118,110,112,0,0,273,119,154,GOOOOOXXXXXXXXXXXXXXGOOOOOOOOOOXXXXXXXXXGOOOOOOOOOOXXXXXXXXXGOOOOOOOOOOOOOOXXXXXGOOOOXXXXXXXXXXXXXXXGOOOOOOOOOOOXXXXXXXXGOOOOXXXXXXXXXXXXXXXGOOOOOOOOOOXXXXXXXXXGOOOOOOOOOOOOXXXXXXXGOOOOXXXXXXXXXXXXXXXGOOOOOOOXXXXXXXXXXXXGOOOOXXXXXXXXXXXXXXXGOOOOOOOOOOXXXXXXXXX,0,0,0
18711,118,0,118,108,114,0,0,275,119,156,GOOOOOXXXXXXXXXXXXXXGOOOOOOOOOOXXXXXXXXXGOOOOOOOOOOXXXXXXXXXGOOOOOOOOOOOOOOXXXXXGOOOOXXXXXXXXXXXXXXXGOOOOOOOOOOOXXXXXXXXGOOOOXXXXXXXXXXXXXXXGOOOOOOOOOOXXXXXXXXXGOOOOOOOOOOOOXXXXXXXGOOOOXXXXXXXXXXXXXXXGOOOOOOOXXXXXXXXXXXXGOOOOXXXXXXXXXXXXXXXGOOOOOOOOOOXXXXXXXXX,0,0,0
18732,119,1,118,103,118,0,0,279,121,158,GOOOOOXXXXXXXXXXXXXXGOOOOOOOOOOXXXXXXXXXGOOOOOOOOOOXXXXXXXXXGOOOOOOOOOOOOOOXXXXXGOOOOXXXXXXXXXXXXXXXGOOOOOOOOOOOXXXXXXXXGOOOOAXXXXXXXXXXXXXXGOOOOOOOOOOXXXXXXXXXGOOOOOOOOOOOOXXXXXXXGOOOOXXXXXXXXXXXXXXXGOOOOOOOXXXXXXXXXXXXGOOOOXXXXXXXXXXXXXXXGOOOOOOOOOOXXXXXXXXX,0,0,0
18753,119,1,118,109,112,0,0,273,114,159,GOOOOOXXXXXXXXXXXXXXGOOOOOOOOOOXXXXXXXXXGOOOOOOOOOOXXXXXXXXXGOOOOOOOOOOOOOOXXXXXGOOOOXXXXXXXXXXXXXXXGOOOOOOOOOOOXXXXXXXXGOOOOAXXXXXXXXXXXXXXGOOOOOOOOOOXXXXXXXXXGOOOOOOOOOOOOXXXXXXXGOOOOXXXXXXXXXXXXXXXGOOOOOOOXXXXXXXXXXXXGOOOOXXXXXXXXXXXXXXXGOOOOOOOOOOXXXXXXXXX,0,0,0
18774,119,1,118,109,112,0,0,272,113,159,GOOOOOXXXXXXXXXXXXXXGOOOOOOOOOOXXXXXXXXXGOOOOOOOOOOXXXXXXXXXGOOOOOOOOOOOOOOXXXXXGOOOOXXXXXXXXXXXXXXXGOOOOOOOOOOOXXXXXXXXGOOOOAXXXXXXXXXXXXXXGOOOOOOOOOOXXXXXXXXXGOOOOOOOOOOOOXXXXXXXGOOOOXXXXXXXXXXXXXXXGOOOOOOOXXXXXXXXXXXXGOOOOXXXXXXXXXXXXXXXGOOOOOOOOOOXXXXXXXXX,0,0,0

18795,119,1,118,102,119,0,0,280,117,163,GOOOOOXXXXXXXXXXXXXXGOOOOOOOOOOXXXXXXXXXGOOOOOOOOOOXXXXXXXXXGOOOOOOOOOOOOOOXXXXXGOOOOXXXXXXXXXXXXXXXGOOOOOOOOOOOXXXXXXXXGOOOOAXXXXXXXXXXXXXXGOOOOOOOOOOXXXXXXXXXGOOOOOOOOOOOOXXXXXXXGOOOOXXXXXXXXXXXXXXXGOOOOOOOXXXXXXXXXXXXGOOOOXXXXXXXXXXXXXXXGOOOOOOOOOOXXXXXXXXX,0,0,0
18816,120,2,118,98,122,0,0,283,125,158,GOOOOOXXXXXXXXXXXXXXGOOOOOOOOOOXXXXXXXXXGOOOOOOOOOOXXXXXXXXXGOOOOOOOOOOOOOOXXXXXGOOOOXXXXXXXXXXXXXXXGOOOOOOOOOOOXXXXXXXXGOOOOAXXXXXXXXXXXXXXGOOOOOOOOOOXXXXXXXXXGOOOOOOOOOOOOAXXXXXXGOOOOXXXXXXXXXXXXXXXGOOOOOOOXXXXXXXXXXXXGOOOOXXXXXXXXXXXXXXXGOOOOOOOOOOXXXXXXXXX,0,0,0
18837,121,3,118,101,118,0,0,279,120,159,GOOOOOXXXXXXXXXXXXXXGOOOOOOOOOOXXXXXXXXXGOOOOOOOOOOXXXXXXXXXGOOOOOOOOOOOOOOXXXXXGOOOOAXXXXXXXXXXXXXXGOOOOOOOOOOOXXXXXXXXGOOOOAXXXXXXXXXXXXXXGOOOOOOOOOOXXXXXXXXXGOOOOOOOOOOOOAXXXXXXGOOOOXXXXXXXXXXXXXXXGOOOOOOOXXXXXXXXXXXXGOOOOXXXXXXXXXXXXXXXGOOOOOOOOOOXXXXXXXXX,0,0,0
18858,121,3,118,93,126,0,0,287,121,166,GOOOOOXXXXXXXXXXXXXXGOOOOOOOOOOXXXXXXXXXGOOOOOOOOOOXXXXXXXXXGOOOOOOOOOOOOOOXXXXXGOOOOAXXXXXXXXXXXXXXGOOOOOOOOOOOXXXXXXXXGOOOOAXXXXXXXXXXXXXXGOOOOOOOOOOXXXXXXXXXGOOOOOOOOOOOOAXXXXXXGOOOOXXXXXXXXXXXXXXXGOOOOOOOXXXXXXXXXXXXGOOOOXXXXXXXXXXXXXXXGOOOOOOOOOOXXXXXXXXX,0,0,0
18879,121,2,119,96,123,0,0,284,117,167,GOOOOOXXXXXXXXXXXXXXGOOOOOOOOOOXXXXXXXXXGOOOOOOOOOOXXXXXXXXXGOOOOOOOOOOOOOOXXXXXGOOOOOXXXXXXXXXXXXXXGOOOOOOOOOOOXXXXXXXXGOOOOAXXXXXXXXXXXXXXGOOOOOOOOOOXXXXXXXXXGOOOOOOOOOOOOAXXXXXXGOOOOXXXXXXXXXXXXXXXGOOOOOOOXXXXXXXXXXXXGOOOOXXXXXXXXXXXXXXXGOOOOOOOOOOXXXXXXXXX,0,0,0

18900,121,2,119,97,122,0,0,284,118,166,GOOOOOXXXXXXXXXXXXXXGOOOOOOOOOOXXXXXXXXXGOOOOOOOOOOXXXXXXXXXGOOOOOOOOOOOOOOXXXXXGOOOOOXXXXXXXXXXXXXXGOOOOOOOOOOOXXXXXXXXGOOOOAXXXXXXXXXXXXXXGOOOOOOOOOOXXXXXXXXXGOOOOOOOOOOOOAXXXXXXGOOOOXXXXXXXXXXXXXXXGOOOOOOOXXXXXXXXXXXXGOOOOXXXXXXXXXXXXXXXGOOOOOOOOOOXXXXXXXXX,0,0,0
18921,121,1,120,92,127,0,0,288,118,170,GOOOOOXXXXXXXXXXXXXXGOOOOOOOOOOXXXXXXXXXGOOOOOOOOOOXXXXXXXXXGOOOOOOOOOOOOOOXXXXXGOOOOOXXXXXXXXXXXXXXGOOOOOOOOOOOXXXXXXXXGOOOOAXXXXXXXXXXXXXXGOOOOOOOOOOXXXXXXXXXGOOOOOOOOOOOOOXXXXXXGOOOOXXXXXXXXXXXXXXXGOOOOOOOXXXXXXXXXXXXGOOOOXXXXXXXXXXXXXXXGOOOOOOOOOOXXXXXXXXX,0,0,0
18942,121,1,120,99,120,0,0,280,119,161,GOOOOOXXXXXXXXXXXXXXGOOOOOOOOOOXXXXXXXXXGOOOOOOOOOOXXXXXXXXXGOOOOOOOOOOOOOOXXXXXGOOOOOXXXXXXXXXXXXXXGOOOOOOOOOOOXXXXXXXXGOOOOAXXXXXXXXXXXXXXGOOOOOOOOOOXXXXXXXXXGOOOOOOOOOOOOOXXXXXXGOOOOXXXXXXXXXXXXXXXGOOOOOOOXXXXXXXXXXXXGOOOOXXXXXXXXXXXXXXXGOOOOOOOOOOXXXXXXXXX,0,0,0
18963,121,1,120,100,119,0,0,278,121,157,GOOOOOXXXXXXXXXXXXXXGOOOOOOOOOOXXXXXXXXXGOOOOOOOOOOXXXXXXXXXGOOOOOOOOOOOOOOXXXXXGOOOOOXXXXXXXXXXXXXXGOOOOOOOOOOOXXXXXXXXGOOOOAXXXXXXXXXXXXXXGOOOOOOOOOOXXXXXXXXXGOOOOOOOOOOOOOXXXXXXGOOOOXXXXXXXXXXXXXXXGOOOOOOOXXXXXXXXXXXXGOOOOXXXXXXXXXXXXXXXGOOOOOOOOOOXXXXXXXXX,0,0,0
18984,121,1,120,98,121,0,0,280,122,158,GOOOOOXXXXXXXXXXXXXXGOOOOOOOOOOXXXXXXXXXGOOOOOOOOOOXXXXXXXXXGOOOOOOOOOOOOOOXXXXXGOOOOOXXXXXXXXXXXXXXGOOOOOOOOOOOXXXXXXXXGOOOOAXXXXXXXXXXXXXXGOOOOOOOOOOXXXXXXXXXGOOOOOOOOOOOOOXXXXXXGOOOOXXXXXXXXXXXXXXXGOOOOOOOXXXXXXXXXXXXGOOOOXXXXXXXXXXXXXXXGOOOOOOOOOOXXXXXXXXX,0,0,0

19005,121,1,120,100,119,0,0,278,119,159,GOOOOOXXXXXXXXXXXXXXGOOOOOOOOOOXXXXXXXXXGOOOOOOOOOOXXXXXXXXXGOOOOOOOOOOOOOOXXXXXGOOOOOXXXXXXXXXXXXXXGOOOOOOOOOOOXXXXXXXXGOOOOAXXXXXXXXXXXXXXGOOOOOOOOOOXXXXXXXXXGOOOOOOOOOOOOOXXXXXXGOOOOXXXXXXXXXXXXXXXGOOOOOOOXXXXXXXXXXXXGOOOOXXXXXXXXXXXXXXXGOOOOOOOOOOXXXXXXXXX,256,0,0
19026,121,1,120,102,117,0,0,277,117,160,GOOOOOXXXXXXXXXXXXXXGOOOOOOOOOOXXXXXXXXXGOOOOOOOOOOXXXXXXXXXGOOOOOOOOOOOOOOXXXXXGOOOOOXXXXXXXXXXXXXXGOOOOOOOOOOOXXXXXXXXGOOOOAXXXXXXXXXXXXXXGOOOOOOOOOOXXXXXXXXXGOOOOOOOOOOOOOXXXXXXGOOOOXXXXXXXXXXXXXXXGOOOOOOOXXXXXXXXXXXXGOOOOXXXXXXXXXXXXXXXGOOOOOOOOOOXXXXXXXXX,256,0,0
19047,122,2,120,94,124,0,0,284,117,167,GOOOOOXXXXXXXXXXXXXXGOOOOOOOOOOXXXXXXXXXGOOOOOOOOOOXXXXXXXXXGOOOOOOOOOOOOOOXXXXXGOOOOOXXXXXXXXXXXXXXGOOOOOOOOOOOXXXXXXXXGOOOOAXXXXXXXXXXXXXXGOOOOOOOOOOAXXXXXXXXGOOOOOOOOOOOOOXXXXXXGOOOOXXXXXXXXXXXXXXXGOOOOOOOXXXXXXXXXXXXGOOOOXXXXXXXXXXXXXXXGOOOOOOOOOOXXXXXXXXX,256,0,0
19068,122,2,120,93,125,0,0,285,117,168,GOOOOOXXXXXXXXXXXXXXGOOOOOOOOOOXXXXXXXXXGOOOOOOOOOOXXXXXXXXXGOOOOOOOOOOOOOOXXXXXGOOOOOXXXXXXXXXXXXXXGOOOOOOOOOOOXXXXXXXXGOOOOAXXXXXXXXXXXXXXGOOOOOOOOOOAXXXXXXXXGOOOOOOOOOOOOOXXXXXXGOOOOXXXXXXXXXXXXXXXGOOOOOOOXXXXXXXXXXXXGOOOOXXXXXXXXXXXXXXXGOOOOOOOOOOXXXXXXXXX,256,0,0
19089,122,2,120,90,128,0,0,288,115,173,GOOOOOXXXXXXXXXXXXXXGOOOOOOOOOOXXXXXXXXXGOOOOOOOOOOXXXXXXXXXGOOOOOOOOOOOOOOXXXXXGOOOOOXXXXXXXXXXXXXXGOOOOOOOOOOOXXXXXXXXGOOOOAXXXXXXXXXXXXXXGOOOOOOOOOOAXXXXXXXXGOOOOOOOOOOOOOXXXXXXGOOOOXXXXXXXXXXXXXXXGOOOOOOOXXXXXXXXXXXXGOOOOXXXXXXXXXXXXXXXGOOOOOOOOOOXXXXXXXXX,256,0,0

19110,122,2,120,90,128,0,0,287,119,168,GOOOOOXXXXXXXXXXXXXXGOOOOOOOOOOXXXXXXXXXGOOOOOOOOOOXXXXXXXXXGOOOOOOOOOOOOOOXXXXXGOOOOOXXXXXXXXXXXXXXGOOOOOOOOOOOXXXXXXXXGOOOOAXXXXXXXXXXXXXXGOOOOOOOOOOAXXXXXXXXGOOOOOOOOOOOOOXXXXXXGOOOOXXXXXXXXXXXXXXXGOOOOOOOXXXXXXXXXXXXGOOOOXXXXXXXXXXXXXXXGOOOOOOOOOOXXXXXXXXX,256,0,0
19131,122,1,121,97,121,0,0,281,119,162,GOOOOOXXXXXXXXXXXXXXGOOOOOOOOOOXXXXXXXXXGOOOOOOOOOOXXXXXXXXXGOOOOOOOOOOOOOOXXXXXGOOOOOXXXXXXXXXXXXXXGOOOOOOOOOOOXXXXXXXXGOOOOOXXXXXXXXXXXXXXGOOOOOOOOOOAXXXXXXXXGOOOOOOOOOOOOOXXXXXXGOOOOXXXXXXXXXXXXXXXGOOOOOOOXXXXXXXXXXXXGOOOOXXXXXXXXXXXXXXXGOOOOOOOOOOXXXXXXXXX,256,0,0
19152,122,1,121,98,120,0,0,280,123,157,GOOOOOXXXXXXXXXXXXXXGOOOOOOOOOOXXXXXXXXXGOOOOOOOOOOXXXXXXXXXGOOOOOOOOOOOOOOXXXXXGOOOOOXXXXXXXXXXXXXXGOOOOOOOOOOOXXXXXXXXGOOOOOXXXXXXXXXXXXXXGOOOOOOOOOOAXXXXXXXXGOOOOOOOOOOOOOXXXXXXGOOOOXXXXXXXXXXXXXXXGOOOOOOOXXXXXXXXXXXXGOOOOXXXXXXXXXXXXXXXGOOOOOOOOOOXXXXXXXXX,256,0,0
19173,122,0,122,98,120,0,0,279,124,155,GOOOOOXXXXXXXXXXXXXXGOOOOOOOOOOXXXXXXXXXGOOOOOOOOOOXXXXXXXXXGOOOOOOOOOOOOOOXXXXXGOOOOOXXXXXXXXXXXXXXGOOOOOOOOOOOXXXXXXXXGOOOOOXXXXXXXXXXXXXXGOOOOOOOOOOOXXXXXXXXGOOOOOOOOOOOOOXXXXXXGOOOOXXXXXXXXXXXXXXXGOOOOOOOXXXXXXXXXXXXGOOOOXXXXXXXXXXXXXXXGOOOOOOOOOOXXXXXXXXX,256,0,0
19194,122,0,122,98,120,0,0,278,118,160,GOOOOOXXXXXXXXXXXXXXGOOOOOOOOOOXXXXXXXXXGOOOOOOOOOOXXXXXXXXXGOOOOOOOOOOOOOOXXXXXGOOOOOXXXXXXXXXXXXXXGOOOOOOOOOOOXXXXXXXXGOOOOOXXXXXXXXXXXXXXGOOOOOOOOOOOXXXXXXXXGOOOOOOOOOOOOOXXXXXXGOOOOXXXXXXXXXXXXXXXGOOOOOOOXXXXXXXXXXXXGOOOOXXXXXXXXXXXXXXXGOOOOOOOOOOXXXXXXXXX,256,0,0

19215,122,0,122,99,119,0,0,279,121,158,GOOOOOXXXXXXXXXXXXXXGOOOOOOOOOOXXXXXXXXXGOOOOOOOOOOXXXXXXXXXGOOOOOOOOOOOOOOXXXXXGOOOOOXXXXXXXXXXXXXXGOOOOOOOOOOOXXXXXXXXGOOOOOXXXXXXXXXXXXXXGOOOOOOOOOOOXXXXXXXXGOOOOOOOOOOOOOXXXXXXGOOOOXXXXXXXXXXXXXXXGOOOOOOOXXXXXXXXXXXXGOOOOXXXXXXXXXXXXXXXGOOOOOOOOOOXXXXXXXXX,256,0,0
19236,122,0,122,99,119,0,0,279,130,149,GOOOOOXXXXXXXXXXXXXXGOOOOOOOOOOXXXXXXXXXGOOOOOOOOOOXXXXXXXXXGOOOOOOOOOOOOOOXXXXXGOOOOOXXXXXXXXXXXXXXGOOOOOOOOOOOXXXXXXXXGOOOOOXXXXXXXXXXXXXXGOOOOOOOOOOOXXXXXXXXGOOOOOOOOOOOOOXXXXXXGOOOOXXXXXXXXXXXXXXXGOOOOOOOXXXXXXXXXXXXGOOOOXXXXXXXXXXXXXXXGOOOOOOOOOOXXXXXXXXX,256,0,0
19257,122,0,122,100,118,0,0,277,129,148,GOOOOOXXXXXXXXXXXXXXGOOOOOOOOOOXXXXXXXXXGOOOOOOOOOOXXXXXXXXXGOOOOOOOOOOOOOOXXXXXGOOOOOXXXXXXXXXXXXXXGOOOOOOOOOOOXXXXXXXXGOOOOOXXXXXXXXXXXXXXGOOOOOOOOOOOXXXXXXXXGOOOOOOOOOOOOOXXXXXXGOOOOXXXXXXXXXXXXXXXGOOOOOOOXXXXXXXXXXXXGOOOOXXXXXXXXXXXXXXXGOOOOOOOOOOXXXXXXXXX,256,0,0
19278,122,0,122,101,117,0,0,277,128,149,GOOOOOXXXXXXXXXXXXXXGOOOOOOOOOOXXXXXXXXXGOOOOOOOOOOXXXXXXXXXGOOOOOOOOOOOOOOXXXXXGOOOOOXXXXXXXXXXXXXXGOOOOOOOOOOOXXXXXXXXGOOOOOXXXXXXXXXXXXXXGOOOOOOOOOOOXXXXXXXXGOOOOOOOOOOOOOXXXXXXGOOOOXXXXXXXXXXXXXXXGOOOOOOOXXXXXXXXXXXXGOOOOXXXXXXXXXXXXXXXGOOOOOOOOOOXXXXXXXXX,256,0,0
19299,122,0,122,95,123,0,0,282,134,148,GOOOOOXXXXXXXXXXXXXXGOOOOOOOOOOXXXXXXXXXGOOOOOOOOOOXXXXXXXXXGOOOOOOOOOOOOOOXXXXXGOOOOOXXXXXXXXXXXXXXGOOOOOOOOOOOXXXXXXXXGOOOOOXXXXXXXXXXXXXXGOOOOOOOOOOOXXXXXXXXGOOOOOOOOOOOOOXXXXXXGOOOOXXXXXXXXXXXXXXXGOOOOOOOXXXXXXXXXXXXGOOOOXXXXXXXXXXXXXXXGOOOOOOOOOOXXXXXXXXX,256,0,0

19320,122,0,122,93,125,0,0,285,135,150,GOOOOOXXXXXXXXXXXXXXGOOOOOOOOOOXXXXXXXXXGOOOOOOOOOOXXXXXXXXXGOOOOOOOOOOOOOOXXXXXGOOOOOXXXXXXXXXXXXXXGOOOOOOOOOOOXXXXXXXXGOOOOOXXXXXXXXXXXXXXGOOOOOOOOOOOXXXXXXXXGOOOOOOOOOOOOOXXXXXXGOOOOXXXXXXXXXXXXXXXGOOOOOOOXXXXXXXXXXXXGOOOOXXXXXXXXXXXXXXXGOOOOOOOOOOXXXXXXXXX,256,0,0
19341,122,0,122,101,117,0,0,276,129,147,GOOOOOXXXXXXXXXXXXXXGOOOOOOOOOOXXXXXXXXXGOOOOOOOOOOXXXXXXXXXGOOOOOOOOOOOOOOXXXXXGOOOOOXXXXXXXXXXXXXXGOOOOOOOOOOOXXXXXXXXGOOOOOXXXXXXXXXXXXXXGOOOOOOOOOOOXXXXXXXXGOOOOOOOOOOOOOXXXXXXGOOOOXXXXXXXXXXXXXXXGOOOOOOOXXXXXXXXXXXXGOOOOXXXXXXXXXXXXXXXGOOOOOOOOOOXXXXXXXXX,256,0,0
19362,122,0,122,105,113,0,0,272,127,145,GOOOOOXXXXXXXXXXXXXXGOOOOOOOOOOXXXXXXXXXGOOOOOOOOOOXXXXXXXXXGOOOOOOOOOOOOOOXXXXXGOOOOOXXXXXXXXXXXXXXGOOOOOOOOOOOXXXXXXXXGOOOOOXXXXXXXXXXXXXXGOOOOOOOOOOOXXXXXXXXGOOOOOOOOOOOOOXXXXXXGOOOOXXXXXXXXXXXXXXXGOOOOOOOXXXXXXXXXXXXGOOOOXXXXXXXXXXXXXXXGOOOOOOOOOOXXXXXXXXX,256,0,0
19383,122,0,122,111,107,0,0,267,122,145,GOOOOOXXXXXXXXXXXXXXGOOOOOOOOOOXXXXXXXXXGOOOOOOOOOOXXXXXXXXXGOOOOOOOOOOOOOOXXXXXGOOOOOXXXXXXXXXXXXXXGOOOOOOOOOOOXXXXXXXXGOOOOOXXXXXXXXXXXXXXGOOOOOOOOOOOXXXXXXXXGOOOOOOOOOOOOOXXXXXXGOOOOXXXXXXXXXXXXXXXGOOOOOOOXXXXXXXXXXXXGOOOOXXXXXXXXXXXXXXXGOOOOOOOOOOXXXXXXXXX,256,0,0
19404,122,0,122,108,110,0,0,270,127,143,GOOOOOXXXXXXXXXXXXXXGOOOOOOOOOOXXXXXXXXXGOOOOOOOOOOXXXXXXXXXGOOOOOOOOOOOOOOXXXXXGOOOOOXXXXXXXXXXXXXXGOOOOOOOOOOOXXXXXXXXGOOOOOXXXXXXXXXXXXXXGOOOOOOOOOOOXXXXXXXXGOOOOOOOOOOOOOXXXXXXGOOOOXXXXXXXXXXXXXXXGOOOOOOOXXXXXXXXXXXXGOOOOXXXXXXXXXXXXXXXGOOOOOOOOOOXXXXXXXXX,256,0,0

19425,122,0,122,101,117,0,0,277,128,149,GOOOOOXXXXXXXXXXXXXXGOOOOOOOOOOXXXXXXXXXGOOOOOOOOOOXXXXXXXXXGOOOOOOOOOOOOOOXXXXXGOOOOOXXXXXXXXXXXXXXGOOOOOOOOOOOXXXXXXXXGOOOOOXXXXXXXXXXXXXXGOOOOOOOOOOOXXXXXXXXGOOOOOOOOOOOOOXXXXXXGOOOOXXXXXXXXXXXXXXXGOOOOOOOXXXXXXXXXXXXGOOOOXXXXXXXXXXXXXXXGOOOOOOOOOOXXXXXXXXX,256,0,0
19446,122,0,122,101,117,0,0,278,132,146,GOOOOOXXXXXXXXXXXXXXGOOOOOOOOOOXXXXXXXXXGOOOOOOOOOOXXXXXXXXXGOOOOOOOOOOOOOOXXXXXGOOOOOXXXXXXXXXXXXXXGOOOOOOOOOOOXXXXXXXXGOOOOOXXXXXXXXXXXXXXGOOOOOOOOOOOXXXXXXXXGOOOOOOOOOOOOOXXXXXXGOOOOXXXXXXXXXXXXXXXGOOOOOOOXXXXXXXXXXXXGOOOOXXXXXXXXXXXXXXXGOOOOOOOOOOXXXXXXXXX,256,0,0
19467,122,0,122,102,116,0,0,275,129,146,GOOOOOXXXXXXXXXXXXXXGOOOOOOOOOOXXXXXXXXXGOOOOOOOOOOXXXXXXXXXGOOOOOOOOOOOOOOXXXXXGOOOOOXXXXXXXXXXXXXXGOOOOOOOOOOOXXXXXXXXGOOOOOXXXXXXXXXXXXXXGOOOOOOOOOOOXXXXXXXXGOOOOOOOOOOOOOXXXXXXGOOOOXXXXXXXXXXXXXXXGOOOOOOOXXXXXXXXXXXXGOOOOXXXXXXXXXXXXXXXGOOOOOOOOOOXXXXXXXXX,256,0,0
19488,122,0,122,104,114,0,0,274,130,144,GOOOOOXXXXXXXXXXXXXXGOOOOOOOOOOXXXXXXXXXGOOOOOOOOOOXXXXXXXXXGOOOOOOOOOOOOOOXXXXXGOOOOOXXXXXXXXXXXXXXGOOOOOOOOOOOXXXXXXXXGOOOOOXXXXXXXXXXXXXXGOOOOOOOOOOOXXXXXXXXGOOOOOOOOOOOOOXXXXXXGOOOOXXXXXXXXXXXXXXXGOOOOOOOXXXXXXXXXXXXGOOOOXXXXXXXXXXXXXXXGOOOOOOOOOOXXXXXXXXX,256,0,0
19509,122,0,122,107,111,0,0,270,123,147,GOOOOOXXXXXXXXXXXXXXGOOOOOOOOOOXXXXXXXXXGOOOOOOOOOOXXXXXXXXXGOOOOOOOOOOOOOOXXXXXGOOOOOXXXXXXXXXXXXXXGOOOOOOOOOOOXXXXXXXXGOOOOOXXXXXXXXXXXXXXGOOOOOOOOOOOXXXXXXXXGOOOOOOOOOOOOOXXXXXXGOOOOXXXXXXXXXXXXXXXGOOOOOOOXXXXXXXXXXXXGOOOOXXXXXXXXXXXXXXXGOOOOOOOOOOXXXXXXXXX,251,5,0

19530,123,1,122,103,114,0,0,272,125,147,GOOOOOXXXXXXXXXXXXXXGOOOOOOOOOOXXXXXXXXXGOOOOOOOOOOXXXXXXXXXGOOOOOOOOOOOOOOXXXXXGOOOOOXXXXXXXXXXXXXXGOOOOOOOOOOOAXXXXXXXGOOOOOXXXXXXXXXXXXXXGOOOOOOOOOOOXXXXXXXXGOOOOOOOOOOOOOXXXXXXGOOOOXXXXXXXXXXXXXXXGOOOOOOOXXXXXXXXXXXXGOOOOXXXXXXXXXXXXXXXGOOOOOOOOOOXXXXXXXXX,239,17,0
19551,123,1,122,105,112,0,0,272,127,145,GOOOOOXXXXXXXXXXXXXXGOOOOOOOOOOXXXXXXXXXGOOOOOOOOOOXXXXXXXXXGOOOOOOOOOOOOOOXXXXXGOOOOOXXXXXXXXXXXXXXGOOOOOOOOOOOAXXXXXXXGOOOOOXXXXXXXXXXXXXXGOOOOOOOOOOOXXXXXXXXGOOOOOOOOOOOOOXXXXXXGOOOOXXXXXXXXXXXXXXXGOOOOOOOXXXXXXXXXXXXGOOOOXXXXXXXXXXXXXXXGOOOOOOOOOOXXXXXXXXX,230,26,0
19572,123,1,122,105,112,0,0,272,132,140,GOOOOOXXXXXXXXXXXXXXGOOOOOOOOOOXXXXXXXXXGOOOOOOOOOOXXXXXXXXXGOOOOOOOOOOOOOOXXXXXGOOOOOXXXXXXXXXXXXXXGOOOOOOOOOOOAXXXXXXXGOOOOOXXXXXXXXXXXXXXGOOOOOOOOOOOXXXXXXXXGOOOOOOOOOOOOOXXXXXXGOOOOXXXXXXXXXXXXXXXGOOOOOOOXXXXXXXXXXXXGOOOOXXXXXXXXXXXXXXXGOOOOOOOOOOXXXXXXXXX,224,32,0
19593,123,1,122,105,112,0,0,272,130,142,GOOOOOXXXXXXXXXXXXXXGOOOOOOOOOOXXXXXXXXXGOOOOOOOOOOXXXXXXXXXGOOOOOOOOOOOOOOXXXXXGOOOOOXXXXXXXXXXXXXXGOOOOOOOOOOOAXXXXXXXGOOOOOXXXXXXXXXXXXXXGOOOOOOOOOOOXXXXXXXXGOOOOOOOOOOOOOXXXXXXGOOOOXXXXXXXXXXXXXXXGOOOOOOOXXXXXXXXXXXXGOOOOXXXXXXXXXXXXXXXGOOOOOOOOOOXXXXXXXXX,209,47,0
19614,123,1,122,109,108,0,0,267,131,136,GOOOOOXXXXXXXXXXXXXXGOOOOOOOOOOXXXXXXXXXGOOOOOOOOOOXXXXXXXXXGOOOOOOOOOOOOOOXXXXXGOOOOOXXXXXXXXXXXXXXGOOOOOOOOOOOAXXXXXXXGOOOOOXXXXXXXXXXXXXXGOOOOOOOOOOOXXXXXXXXGOOOOOOOOOOOOOXXXXXXGOOOOXXXXXXXXXXXXXXXGOOOOOOOXXXXXXXXXXXXGOOOOXXXXXXXXXXXXXXXGOOOOOOOOOOXXXXXXXXX,196,60,0

19635,124,1,123,108,108,0,0,268,128,140,GOOOOOXXXXXXXXXXXXXXGOOOOOOOOOOXXXXXXXXXGOOOOOOOOOOXXXXXXXXXGOOOOOOOOOOOOOOAXXXXGOOOOOXXXXXXXXXXXXXXGOOOOOOOOOOOOXXXXXXXGOOOOOXXXXXXXXXXXXXXGOOOOOOOOOOOXXXXXXXXGOOOOOOOOOOOOOXXXXXXGOOOOXXXXXXXXXXXXXXXGOOOOOOOXXXXXXXXXXXXGOOOOXXXXXXXXXXXXXXXGOOOOOOOOOOXXXXXXXXX,186,70,0
19656,124,1,123,101,115,0,0,272,128,144,GOOOOOXXXXXXXXXXXXXXGOOOOOOOOOOXXXXXXXXXGOOOOOOOOOOXXXXXXXXXGOOOOOOOOOOOOOOAXXXXGOOOOOXXXXXXXXXXXXXXGOOOOOOOOOOOOXXXXXXXGOOOOOXXXXXXXXXXXXXXGOOOOOOOOOOOXXXXXXXXGOOOOOOOOOOOOOXXXXXXGOOOOXXXXXXXXXXXXXXXGOOOOOOOXXXXXXXXXXXXGOOOOXXXXXXXXXXXXXXXGOOOOOOOOOOXXXXXXXXX,177,79,0
19677,124,0,124,98,118,0,0,278,129,149,GOOOOOXXXXXXXXXXXXXXGOOOOOOOOOOXXXXXXXXXGOOOOOOOOOOXXXXXXXXXGOOOOOOOOOOOOOOOXXXXGOOOOOXXXXXXXXXXXXXXGOOOOOOOOOOOOXXXXXXXGOOOOOXXXXXXXXXXXXXXGOOOOOOOOOOOXXXXXXXXGOOOOOOOOOOOOOXXXXXXGOOOOXXXXXXXXXXXXXXXGOOOOOOOXXXXXXXXXXXXGOOOOXXXXXXXXXXXXXXXGOOOOOOOOOOXXXXXXXXX,170,86,0
19698,124,0,124,89,127,0,0,286,133,153,GOOOOOXXXXXXXXXXXXXXGOOOOOOOOOOXXXXXXXXXGOOOOOOOOOOXXXXXXXXXGOOOOOOOOOOOOOOOXXXXGOOOOOXXXXXXXXXXXXXXGOOOOOOOOOOOOXXXXXXXGOOOOOXXXXXXXXXXXXXXGOOOOOOOOOOOXXXXXXXXGOOOOOOOOOOOOOXXXXXXGOOOOXXXXXXXXXXXXXXXGOOOOOOOXXXXXXXXXXXXGOOOOXXXXXXXXXXXXXXXGOOOOOOOOOOXXXXXXXXX,157,99,0
19719,124,0,124,91,125,0,0,284,130,154,GOOOOOXXXXXXXXXXXXXXGOOOOOOOOOOXXXXXXXXXGOOOOOOOOOOXXXXXXXXXGOOOOOOOOOOOOOOOXXXXGOOOOOXXXXXXXXXXXXXXGOOOOOOOOOOOOXXXXXXXGOOOOOXXXXXXXXXXXXXXGOOOOOOOOOOOXXXXXXXXGOOOOOOOOOOOOOXXXXXXGOOOOXXXXXXXXXXXXXXXGOOOOOOOXXXXXXXXXXXXGOOOOXXXXXXXXXXXXXXXGOOOOOOOOOOXXXXXXXXX,145,111,0

19740,125,1,124,99,116,0,0,276,126,150,GOOOOOXXXXXXXXXXXXXXGOOOOOOOOOOXXXXXXXXXGOOOOOOOOOOXXXXXXXXXGOOOOOOOOOOOOOOOXXXXGOOOOOXXXXXXXXXXXXXXGOOOOOOOOOOOOAXXXXXXGOOOOOXXXXXXXXXXXXXXGOOOOOOOOOOOXXXXXXXXGOOOOOOOOOOOOOXXXXXXGOOOOXXXXXXXXXXXXXXXGOOOOOOOXXXXXXXXXXXXGOOOOXXXXXXXXXXXXXXXGOOOOOOOOOOXXXXXXXXX,135,121,0
19761,125,1,124,97,118,0,0,278,132,146,GOOOOOXXXXXXXXXXXXXXGOOOOOOOOOOXXXXXXXXXGOOOOOOOOOOXXXXXXXXXGOOOOOOOOOOOOOOOXXXXGOOOOOXXXXXXXXXXXXXXGOOOOOOOOOOOOAXXXXXXGOOOOOXXXXXXXXXXXXXXGOOOOOOOOOOOXXXXXXXXGOOOOOOOOOOOOOXXXXXXGOOOOXXXXXXXXXXXXXXXGOOOOOOOXXXXXXXXXXXXGOOOOXXXXXXXXXXXXXXXGOOOOOOOOOOXXXXXXXXX,124,132,0
19782,125,1,124,99,116,0,0,276,131,145,GOOOOOXXXXXXXXXXXXXXGOOOOOOOOOOXXXXXXXXXGOOOOOOOOOOXXXXXXXXXGOOOOOOOOOOOOOOOXXXXGOOOOOXXXXXXXXXXXXXXGOOOOOOOOOOOOAXXXXXXGOOOOOXXXXXXXXXXXXXXGOOOOOOOOOOOXXXXXXXXGOOOOOOOOOOOOOXXXXXXGOOOOXXXXXXXXXXXXXXXGOOOOOOOXXXXXXXXXXXXGOOOOXXXXXXXXXXXXXXXGOOOOOOOOOOXXXXXXXXX,111,145,0
19803,125,1,124,106,109,0,0,269,127,142,GOOOOOXXXXXXXXXXXXXXGOOOOOOOOOOXXXXXXXXXGOOOOOOOOOOXXXXXXXXXGOOOOOOOOOOOOOOOXXXXGOOOOOXXXXXXXXXXXXXXGOOOOOOOOOOOOAXXXXXXGOOOOOXXXXXXXXXXXXXXGOOOOOOOOOOOXXXXXXXXGOOOOOOOOOOOOOXXXXXXGOOOOXXXXXXXXXXXXXXXGOOOOOOOXXXXXXXXXXXXGOOOOXXXXXXXXXXXXXXXGOOOOOOOOOOXXXXXXXXX,101,155,0
19824,125,1,124,103,112,0,0,272,126,146,GOOOOOXXXXXXXXXXXXXXGOOOOOOOOOOXXXXXXXXXGOOOOOOOOOOXXXXXXXXXGOOOOOOOOOOOOOOOXXXXGOOOOOXXXXXXXXXXXXXXGOOOOOOOOOOOOAXXXXXXGOOOOOXXXXXXXXXXXXXXGOOOOOOOOOOOXXXXXXXXGOOOOOOOOOOOOOXXXXXXGOOOOXXXXXXXXXXXXXXXGOOOOOOOXXXXXXXXXXXXGOOOOXXXXXXXXXXXXXXXGOOOOOOOOOOXXXXXXXXX,92,164,0

19845,125,1,124,108,107,0,0,266,120,146,GOOOOOXXXXXXXXXXXXXXGOOOOOOOOOOXXXXXXXXXGOOOOOOOOOOXXXXXXXXXGOOOOOOOOOOOOOOOXXXXGOOOOOXXXXXXXXXXXXXXGOOOOOOOOOOOOAXXXXXXGOOOOOXXXXXXXXXXXXXXGOOOOOOOOOOOXXXXXXXXGOOOOOOOOOOOOOXXXXXXGOOOOXXXXXXXXXXXXXXXGOOOOOOOXXXXXXXXXXXXGOOOOXXXXXXXXXXXXXXXGOOOOOOOOOOXXXXXXXXX,84,172,0
19866,125,1,124,105,110,0,0,269,126,143,GOOOOOXXXXXXXXXXXXXXGOOOOOOOOOOXXXXXXXXXGOOOOOOOOOOXXXXXXXXXGOOOOOOOOOOOOOOOXXXXGOOOOOXXXXXXXXXXXXXXGOOOOOOOOOOOOAXXXXXXGOOOOOXXXXXXXXXXXXXXGOOOOOOOOOOOXXXXXXXXGOOOOOOOOOOOOOXXXXXXGOOOOXXXXXXXXXXXXXXXGOOOOOOOXXXXXXXXXXXXGOOOOXXXXXXXXXXXXXXXGOOOOOOOOOOXXXXXXXXX,69,187,0
19887,125,1,124,109,106,0,0,266,121,145,GOOOOOXXXXXXXXXXXXXXGOOOOOOOOOOXXXXXXXXXGOOOOOOOOOOXXXXXXXXXGOOOOOOOOOOOOOOOXXXXGOOOOOXXXXXXXXXXXXXXGOOOOOOOOOOOOAXXXXXXGOOOOOXXXXXXXXXXXXXXGOOOOOOOOOOOXXXXXXXXGOOOOOOOOOOOOOXXXXXXGOOOOXXXXXXXXXXXXXXXGOOOOOOOXXXXXXXXXXXXGOOOOXXXXXXXXXXXXXXXGOOOOOOOOOOXXXXXXXXX,62,194,0
19908,125,1,124,102,113,0,0,271,122,149,GOOOOOXXXXXXXXXXXXXXGOOOOOOOOOOXXXXXXXXXGOOOOOOOOOOXXXXXXXXXGOOOOOOOOOOOOOOOXXXXGOOOOOXXXXXXXXXXXXXXGOOOOOOOOOOOOAXXXXXXGOOOOOXXXXXXXXXXXXXXGOOOOOOOOOOOXXXXXXXXGOOOOOOOOOOOOOXXXXXXGOOOOXXXXXXXXXXXXXXXGOOOOOOOXXXXXXXXXXXXGOOOOXXXXXXXXXXXXXXXGOOOOOOOOOOXXXXXXXXX,54,202,0
19929,125,1,124,98,117,0,0,276,124,152,GOOOOOXXXXXXXXXXXXXXGOOOOOOOOOOXXXXXXXXXGOOOOOOOOOOXXXXXXXXXGOOOOOOOOOOOOOOOXXXXGOOOOOXXXXXXXXXXXXXXGOOOOOOOOOOOOAXXXXXXGOOOOOXXXXXXXXXXXXXXGOOOOOOOOOOOXXXXXXXXGOOOOOOOOOOOOOXXXXXXGOOOOXXXXXXXXXXXXXXXGOOOOOOOXXXXXXXXXXXXGOOOOXXXXXXXXXXXXXXXGOOOOOOOOOOXXXXXXXXX,39,217,0

19950,125,1,124,100,115,0,0,275,124,151,GOOOOOXXXXXXXXXXXXXXGOOOOOOOOOOXXXXXXXXXGOOOOOOOOOOXXXXXXXXXGOOOOOOOOOOOOOOOXXXXGOOOOOXXXXXXXXXXXXXXGOOOOOOOOOOOOAXXXXXXGOOOOOXXXXXXXXXXXXXXGOOOOOOOOOOOXXXXXXXXGOOOOOOOOOOOOOXXXXXXGOOOOXXXXXXXXXXXXXXXGOOOOOOOXXXXXXXXXXXXGOOOOXXXXXXXXXXXXXXXGOOOOOOOOOOXXXXXXXXX,25,231,0
19971,125,1,124,105,110,0,0,270,126,144,GOOOOOXXXXXXXXXXXXXXGOOOOOOOOOOXXXXXXXXXGOOOOOOOOOOXXXXXXXXXGOOOOOOOOOOOOOOOXXXXGOOOOOXXXXXXXXXXXXXXGOOOOOOOOOOOOAXXXXXXGOOOOOXXXXXXXXXXXXXXGOOOOOOOOOOOXXXXXXXXGOOOOOOOOOOOOOXXXXXXGOOOOXXXXXXXXXXXXXXXGOOOOOOOXXXXXXXXXXXXGOOOOXXXXXXXXXXXXXXXGOOOOOOOOOOXXXXXXXXX,15,241,0
19992,125,1,124,102,113,0,0,273,121,152,GOOOOOXXXXXXXXXXXXXXGOOOOOOOOOOXXXXXXXXXGOOOOOOOOOOXXXXXXXXXGOOOOOOOOOOOOOOOXXXXGOOOOOXXXXXXXXXXXXXXGOOOOOOOOOOOOAXXXXXXGOOOOOXXXXXXXXXXXXXXGOOOOOOOOOOOXXXXXXXXGOOOOOOOOOOOOOXXXXXXGOOOOXXXXXXXXXXXXXXXGOOOOOOOXXXXXXXXXXXXGOOOOXXXXXXXXXXXXXXXGOOOOOOOOOOXXXXXXXXX,4,252,0
20013,126,1,125,99,115,0,0,275,122,153,GOOOOOXXXXXXXXXXXXXXGOOOOOOOOOOXXXXXXXXXGOOOOOOOOOOXXXXXXXXXGOOOOOOOOOOOOOOOXXXXGOOOOOXXXXXXXXXXXXXXGOOOOOOOOOOOOOXXXXXXGOOOOOXXXXXXXXXXXXXXGOOOOOOOOOOOXXXXXXXXGOOOOOOOOOOOOOAXXXXXGOOOOXXXXXXXXXXXXXXXGOOOOOOOXXXXXXXXXXXXGOOOOXXXXXXXXXXXXXXXGOOOOOOOOOOXXXXXXXXX,0,256,0
20034,126,1,125,103,111,0,0,271,122,149,GOOOOOXXXXXXXXXXXXXXGOOOOOOOOOOXXXXXXXXXGOOOOOOOOOOXXXXXXXXXGOOOOOOOOOOOOOOOXXXXGOOOOOXXXXXXXXXXXXXXGOOOOOOOOOOOOOXXXXXXGOOOOOXXXXXXXXXXXXXXGOOOOOOOOOOOXXXXXXXXGOOOOOOOOOOOOOAXXXXXGOOOOXXXXXXXXXXXXXXXGOOOOOOOXXXXXXXXXXXXGOOOOXXXXXXXXXXXXXXXGOOOOOOOOOOXXXXXXXXX,0,256,0

20055,126,1,125,102,112,0,0,273,127,146,GOOOOOXXXXXXXXXXXXXXGOOOOOOOOOOXXXXXXXXXGOOOOOOOOOOXXXXXXXXXGOOOOOOOOOOOOOOOXXXXGOOOOOXXXXXXXXXXXXXXGOOOOOOOOOOOOOXXXXXXGOOOOOXXXXXXXXXXXXXXGOOOOOOOOOOOXXXXXXXXGOOOOOOOOOOOOOAXXXXXGOOOOXXXXXXXXXXXXXXXGOOOOOOOXXXXXXXXXXXXGOOOOXXXXXXXXXXXXXXXGOOOOOOOOOOXXXXXXXXX,0,256,0
20076,126,1,125,98,116,0,0,277,129,148,GOOOOOXXXXXXXXXXXXXXGOOOOOOOOOOXXXXXXXXXGOOOOOOOOOOXXXXXXXXXGOOOOOOOOOOOOOOOXXXXGOOOOOXXXXXXXXXXXXXXGOOOOOOOOOOOOOXXXXXXGOOOOOXXXXXXXXXXXXXXGOOOOOOOOOOOXXXXXXXXGOOOOOOOOOOOOOAXXXXXGOOOOXXXXXXXXXXXXXXXGOOOOOOOXXXXXXXXXXXXGOOOOXXXXXXXXXXXXXXXGOOOOOOOOOOXXXXXXXXX,0,256,0
20097,126,1,125,97,117,0,0,278,130,148,GOOOOOXXXXXXXXXXXXXXGOOOOOOOOOOXXXXXXXXXGOOOOOOOOOOXXXXXXXXXGOOOOOOOOOOOOOOOXXXXGOOOOOXXXXXXXXXXXXXXGOOOOOOOOOOOOOXXXXXXGOOOOOXXXXXXXXXXXXXXGOOOOOOOOOOOXXXXXXXXGOOOOOOOOOOOOOAXXXXXGOOOOXXXXXXXXXXXXXXXGOOOOOOOXXXXXXXXXXXXGOOOOXXXXXXXXXXXXXXXGOOOOOOOOOOXXXXXXXXX,0,256,0
20118,126,1,125,99,115,0,0,276,129,147,GOOOOOXXXXXXXXXXXXXXGOOOOOOOOOOXXXXXXXXXGOOOOOOOOOOXXXXXXXXXGOOOOOOOOOOOOOOOXXXXGOOOOOXXXXXXXXXXXXXXGOOOOOOOOOOOOOXXXXXXGOOOOOXXXXXXXXXXXXXXGOOOOOOOOOOOXXXXXXXXGOOOOOOOOOOOOOAXXXXXGOOOOXXXXXXXXXXXXXXXGOOOOOOOXXXXXXXXXXXXGOOOOXXXXXXXXXXXXXXXGOOOOOOOOOOXXXXXXXXX,0,256,0
20139,126,1,125,100,114,0,0,275,128,147,GOOOOOXXXXXXXXXXXXXXGOOOOOOOOOOXXXXXXXXXGOOOOOOOOOOXXXXXXXXXGOOOOOOOOOOOOOOOXXXXGOOOOOXXXXXXXXXXXXXXGOOOOOOOOOOOOOXXXXXXGOOOOOXXXXXXXXXXXXXXGOOOOOOOOOOOXXXXXXXXGOOOOOOOOOOOOOAXXXXXGOOOOXXXXXXXXXXXXXXXGOOOOOOOXXXXXXXXXXXXGOOOOXXXXXXXXXXXXXXXGOOOOOOOOOOXXXXXXXXX,0,256,0

20160,126,0,126,100,114,0,0,274,121,153,GOOOOOXXXXXXXXXXXXXXGOOOOOOOOOOXXXXXXXXXGOOOOOOOOOOXXXXXXXXXGOOOOOOOOOOOOOOOXXXXGOOOOOXXXXXXXXXXXXXXGOOOOOOOOOOOOOXXXXXXGOOOOOXXXXXXXXXXXXXXGOOOOOOOOOOOXXXXXXXXGOOOOOOOOOOOOOOXXXXXGOOOOXXXXXXXXXXXXXXXGOOOOOOOXXXXXXXXXXXXGOOOOXXXXXXXXXXXXXXXGOOOOOOOOOOXXXXXXXXX,0,256,0
20181,126,0,126,102,112,0,0,272,125,147,GOOOOOXXXXXXXXXXXXXXGOOOOOOOOOOXXXXXXXXXGOOOOOOOOOOXXXXXXXXXGOOOOOOOOOOOOOOOXXXXGOOOOOXXXXXXXXXXXXXXGOOOOOOOOOOOOOXXXXXXGOOOOOXXXXXXXXXXXXXXGOOOOOOOOOOOXXXXXXXXGOOOOOOOOOOOOOOXXXXXGOOOOXXXXXXXXXXXXXXXGOOOOOOOXXXXXXXXXXXXGOOOOXXXXXXXXXXXXXXXGOOOOOOOOOOXXXXXXXXX,0,256,0
20202,126,0,126,99,115,0,0,275,128,147,GOOOOOXXXXXXXXXXXXXXGOOOOOOOOOOXXXXXXXXXGOOOOOOOOOOXXXXXXXXXGOOOOOOOOOOOOOOOXXXXGOOOOOXXXXXXXXXXXXXXGOOOOOOOOOOOOOXXXXXXGOOOOOXXXXXXXXXXXXXXGOOOOOOOOOOOXXXXXXXXGOOOOOOOOOOOOOOXXXXXGOOOOXXXXXXXXXXXXXXXGOOOOOOOXXXXXXXXXXXXGOOOOXXXXXXXXXXXXXXXGOOOOOOOOOOXXXXXXXXX,0,256,0
20223,126,0,126,103,111,0,0,271,130,141,GOOOOOXXXXXXXXXXXXXXGOOOOOOOOOOXXXXXXXXXGOOOOOOOOOOXXXXXXXXXGOOOOOOOOOOOOOOOXXXXGOOOOOXXXXXXXXXXXXXXGOOOOOOOOOOOOOXXXXXXGOOOOOXXXXXXXXXXXXXXGOOOOOOOOOOOXXXXXXXXGOOOOOOOOOOOOOOXXXXXGOOOOXXXXXXXXXXXXXXXGOOOOOOOXXXXXXXXXXXXGOOOOXXXXXXXXXXXXXXXGOOOOOOOOOOXXXXXXXXX,0,256,0
20244,126,0,126,101,113,0,0,273,126,147,GOOOOOXXXXXXXXXXXXXXGOOOOOOOOOOXXXXXXXXXGOOOOOOOOOOXXXXXXXXXGOOOOOOOOOOOOOOOXXXXGOOOOOXXXXXXXXXXXXXXGOOOOOOOOOOOOOXXXXXXGOOOOOXXXXXXXXXXXXXXGOOOOOOOOOOOXXXXXXXXGOOOOOOOOOOOOOOXXXXXGOOOOXXXXXXXXXXXXXXXGOOOOOOOXXXXXXXXXXXXGOOOOXXXXXXXXXXXXXXXGOOOOOOOOOOXXXXXXXXX,0,256,0

20265,126,0,126,99,115,0,0,275,124,151,GOOOOOXXXXXXXXXXXXXXGOOOOOOOOOOXXXXXXXXXGOOOOOOOOOOXXXXXXXXXGOOOOOOOOOOOOOOOXXXXGOOOOOXXXXXXXXXXXXXXGOOOOOOOOOOOOOXXXXXXGOOOOOXXXXXXXXXXXXXXGOOOOOOOOOOOXXXXXXXXGOOOOOOOOOOOOOOXXXXXGOOOOXXXXXXXXXXXXXXXGOOOOOOOXXXXXXXXXXXXGOOOOXXXXXXXXXXXXXXXGOOOOOOOOOOXXXXXXXXX,0,256,0
20286,126,0,126,94,120,0,0,281,124,157,GOOOOOXXXXXXXXXXXXXXGOOOOOOOOOOXXXXXXXXXGOOOOOOOOOOXXXXXXXXXGOOOOOOOOOOOOOOOXXXXGOOOOOXXXXXXXXXXXXXXGOOOOOOOOOOOOOXXXXXXGOOOOOXXXXXXXXXXXXXXGOOOOOOOOOOOXXXXXXXXGOOOOOOOOOOOOOOXXXXXGOOOOXXXXXXXXXXXXXXXGOOOOOOOXXXXXXXXXXXXGOOOOXXXXXXXXXXXXXXXGOOOOOOOOOOXXXXXXXXX,0,256,0
20307,126,0,126,98,116,0,0,277,127,150,GOOOOOXXXXXXXXXXXXXXGOOOOOOOOOOXXXXXXXXXGOOOOOOOOOOXXXXXXXXXGOOOOOOOOOOOOOOOXXXXGOOOOOXXXXXXXXXXXXXXGOOOOOOOOOOOOOXXXXXXGOOOOOXXXXXXXXXXXXXXGOOOOOOOOOOOXXXXXXXXGOOOOOOOOOOOOOOXXXXXGOOOOXXXXXXXXXXXXXXXGOOOOOOOXXXXXXXXXXXXGOOOOXXXXXXXXXXXXXXXGOOOOOOOOOOXXXXXXXXX,0,256,0
20328,126,0,126,104,110,0,0,271,126,145,GOOOOOXXXXXXXXXXXXXXGOOOOOOOOOOXXXXXXXXXGOOOOOOOOOOXXXXXXXXXGOOOOOOOOOOOOOOOXXXXGOOOOOXXXXXXXXXXXXXXGOOOOOOOOOOOOOXXXXXXGOOOOOXXXXXXXXXXXXXXGOOOOOOOOOOOXXXXXXXXGOOOOOOOOOOOOOOXXXXXGOOOOXXXXXXXXXXXXXXXGOOOOOOOXXXXXXXXXXXXGOOOOXXXXXXXXXXXXXXXGOOOOOOOOOOXXXXXXXXX,0,256,0
20349,126,0,126,101,113,0,0,274,126,148,GOOOOOXXXXXXXXXXXXXXGOOOOOOOOOOXXXXXXXXXGOOOOOOOOOOXXXXXXXXXGOOOOOOOOOOOOOOOXXXXGOOOOOXXXXXXXXXXXXXXGOOOOOOOOOOOOOXXXXXXGOOOOOXXXXXXXXXXXXXXGOOOOOOOOOOOXXXXXXXXGOOOOOOOOOOOOOOXXXXXGOOOOXXXXXXXXXXXXXXXGOOOOOOOXXXXXXXXXXXXGOOOOXXXXXXXXXXXXXXXGOOOOOOOOOOXXXXXXXXX,0,256,0

20370,126,0,126,102,112,0,0,273,125,148,GOOOOOXXXXXXXXXXXXXXGOOOOOOOOOOXXXXXXXXXGOOOOOOOOOOXXXXXXXXXGOOOOOOOOOOOOOOOXXXXGOOOOOXXXXXXXXXXXXXXGOOOOOOOOOOOOOXXXXXXGOOOOOXXXXXXXXXXXXXXGOOOOOOOOOOOXXXXXXXXGOOOOOOOOOOOOOOXXXXXGOOOOXXXXXXXXXXXXXXXGOOOOOOOXXXXXXXXXXXXGOOOOXXXXXXXXXXXXXXXGOOOOOOOOOOXXXXXXXXX,0,256,0
20391,126,0,126,100,114,0,0,275,128,147,GOOOOOXXXXXXXXXXXXXXGOOOOOOOOOOXXXXXXXXXGOOOOOOOOOOXXXXXXXXXGOOOOOOOOOOOOOOOXXXXGOOOOOXXXXXXXXXXXXXXGOOOOOOOOOOOOOXXXXXXGOOOOOXXXXXXXXXXXXXXGOOOOOOOOOOOXXXXXXXXGOOOOOOOOOOOOOOXXXXXGOOOOXXXXXXXXXXXXXXXGOOOOOOOXXXXXXXXXXXXGOOOOXXXXXXXXXXXXXXXGOOOOOOOOOOXXXXXXXXX,0,256,0
20412,126,0,126,98,116,0,0,276,132,144,GOOOOOXXXXXXXXXXXXXXGOOOOOOOOOOXXXXXXXXXGOOOOOOOOOOXXXXXXXXXGOOOOOOOOOOOOOOOXXXXGOOOOOXXXXXXXXXXXXXXGOOOOOOOOOOOOOXXXXXXGOOOOOXXXXXXXXXXXXXXGOOOOOOOOOOOXXXXXXXXGOOOOOOOOOOOOOOXXXXXGOOOOXXXXXXXXXXXXXXXGOOOOOOOXXXXXXXXXXXXGOOOOXXXXXXXXXXXXXXXGOOOOOOOOOOXXXXXXXXX,0,256,0
20433,126,0,126,98,116,0,0,277,128,149,GOOOOOXXXXXXXXXXXXXXGOOOOOOOOOOXXXXXXXXXGOOOOOOOOOOXXXXXXXXXGOOOOOOOOOOOOOOOXXXXGOOOOOXXXXXXXXXXXXXXGOOOOOOOOOOOOOXXXXXXGOOOOOXXXXXXXXXXXXXXGOOOOOOOOOOOXXXXXXXXGOOOOOOOOOOOOOOXXXXXGOOOOXXXXXXXXXXXXXXXGOOOOOOOXXXXXXXXXXXXGOOOOXXXXXXXXXXXXXXXGOOOOOOOOOOXXXXXXXXX,0,256,0
20454,126,0,126,90,124,0,0,284,131,153,GOOOOOXXXXXXXXXXXXXXGOOOOOOOOOOXXXXXXXXXGOOOOOOOOOOXXXXXXXXXGOOOOOOOOOOOOOOOXXXXGOOOOOXXXXXXXXXXXXXXGOOOOOOOOOOOOOXXXXXXGOOOOOXXXXXXXXXXXXXXGOOOOOOOOOOOXXXXXXXXGOOOOOOOOOOOOOOXXXXXGOOOOXXXXXXXXXXXXXXXGOOOOOOOXXXXXXXXXXXXGOOOOXXXXXXXXXXXXXXXGOOOOOOOOOOXXXXXXXXX,0,256,0

20475,126,0,126,87,127,0,0,284,131,153,GOOOOOXXXXXXXXXXXXXXGOOOOOOOOOOXXXXXXXXXGOOOOOOOOOOXXXXXXXXXGOOOOOOOOOOOOOOOXXXXGOOOOOXXXXXXXXXXXXXXGOOOOOOOOOOOOOXXXXXXGOOOOOXXXXXXXXXXXXXXGOOOOOOOOOOOXXXXXXXXGOOOOOOOOOOOOOOXXXXXGOOOOXXXXXXXXXXXXXXXGOOOOOOOXXXXXXXXXXXXGOOOOXXXXXXXXXXXXXXXGOOOOOOOOOOXXXXXXXXX,0,256,0
20496,126,0,126,87,127,0,0,286,123,163,GOOOOOXXXXXXXXXXXXXXGOOOOOOOOOOXXXXXXXXXGOOOOOOOOOOXXXXXXXXXGOOOOOOOOOOOOOOOXXXXGOOOOOXXXXXXXXXXXXXXGOOOOOOOOOOOOOXXXXXXGOOOOOXXXXXXXXXXXXXXGOOOOOOOOOOOXXXXXXXXGOOOOOOOOOOOOOOXXXXXGOOOOXXXXXXXXXXXXXXXGOOOOOOOXXXXXXXXXXXXGOOOOXXXXXXXXXXXXXXXGOOOOOOOOOOXXXXXXXXX,0,256,0
20517,126,0,126,85,129,0,0,288,128,160,GOOOOOXXXXXXXXXXXXXXGOOOOOOOOOOXXXXXXXXXGOOOOOOOOOOXXXXXXXXXGOOOOOOOOOOOOOOOXXXXGOOOOOXXXXXXXXXXXXXXGOOOOOOOOOOOOOXXXXXXGOOOOOXXXXXXXXXXXXXXGOOOOOOOOOOOXXXXXXXXGOOOOOOOOOOOOOOXXXXXGOOOOXXXXXXXXXXXXXXXGOOOOOOOXXXXXXXXXXXXGOOOOXXXXXXXXXXXXXXXGOOOOOOOOOOXXXXXXXXX,0,256,0
20538,126,0,126,90,124,0,0,284,126,158,GOOOOOXXXXXXXXXXXXXXGOOOOOOOOOOXXXXXXXXXGOOOOOOOOOOXXXXXXXXXGOOOOOOOOOOOOOOOXXXXGOOOOOXXXXXXXXXXXXXXGOOOOOOOOOOOOOXXXXXXGOOOOOXXXXXXXXXXXXXXGOOOOOOOOOOOXXXXXXXXGOOOOOOOOOOOOOOXXXXXGOOOOXXXXXXXXXXXXXXXGOOOOOOOXXXXXXXXXXXXGOOOOXXXXXXXXXXXXXXXGOOOOOOOOOOXXXXXXXXX,0,256,0
20559,126,0,126,95,119,0,0,279,123,156,GOOOOOXXXXXXXXXXXXXXGOOOOOOOOOOXXXXXXXXXGOOOOOOOOOOXXXXXXXXXGOOOOOOOOOOOOOOOXXXXGOOOOOXXXXXXXXXXXXXXGOOOOOOOOOOOOOXXXXXXGOOOOOXXXXXXXXXXXXXXGOOOOOOOOOOOXXXXXXXXGOOOOOOOOOOOOOOXXXXXGOOOOXXXXXXXXXXXXXXXGOOOOOOOXXXXXXXXXXXXGOOOOXXXXXXXXXXXXXXXGOOOOOOOOOOXXXXXXXXX,0,256,0

20580,126,0,126,97,117,0,0,276,126,150,GOOOOOXXXXXXXXXXXXXXGOOOOOOOOOOXXXXXXXXXGOOOOOOOOOOXXXXXXXXXGOOOOOOOOOOOOOOOXXXXGOOOOOXXXXXXXXXXXXXXGOOOOOOOOOOOOOXXXXXXGOOOOOXXXXXXXXXXXXXXGOOOOOOOOOOOXXXXXXXXGOOOOOOOOOOOOOOXXXXXGOOOOXXXXXXXXXXXXXXXGOOOOOOOXXXXXXXXXXXXGOOOOXXXXXXXXXXXXXXXGOOOOOOOOOOXXXXXXXXX,0,256,0
20601,126,0,126,101,113,0,0,273,132,141,GOOOOOXXXXXXXXXXXXXXGOOOOOOOOOOXXXXXXXXXGOOOOOOOOOOXXXXXXXXXGOOOOOOOOOOOOOOOXXXXGOOOOOXXXXXXXXXXXXXXGOOOOOOOOOOOOOXXXXXXGOOOOOXXXXXXXXXXXXXXGOOOOOOOOOOOXXXXXXXXGOOOOOOOOOOOOOOXXXXXGOOOOXXXXXXXXXXXXXXXGOOOOOOOXXXXXXXXXXXXGOOOOXXXXXXXXXXXXXXXGOOOOOOOOOOXXXXXXXXX,0,256,0
20622,126,0,126,102,112,0,0,272,131,141,GOOOOOXXXXXXXXXXXXXXGOOOOOOOOOOXXXXXXXXXGOOOOOOOOOOXXXXXXXXXGOOOOOOOOOOOOOOOXXXXGOOOOOXXXXXXXXXXXXXXGOOOOOOOOOOOOOXXXXXXGOOOOOXXXXXXXXXXXXXXGOOOOOOOOOOOXXXXXXXXGOOOOOOOOOOOOOOXXXXXGOOOOXXXXXXXXXXXXXXXGOOOOOOOXXXXXXXXXXXXGOOOOXXXXXXXXXXXXXXXGOOOOOOOOOOXXXXXXXXX,0,256,0
20643,128,2,126,99,113,0,0,271,133,138,GOOOOOAXXXXXXXXXXXXXGOOOOOOOOOOXXXXXXXXXGOOOOOOOOOOXXXXXXXXXGOOOOOOOOOOOOOOOXXXXGOOOOOAXXXXXXXXXXXXXGOOOOOOOOOOOOOXXXXXXGOOOOOXXXXXXXXXXXXXXGOOOOOOOOOOOXXXXXXXXGOOOOOOOOOOOOOOXXXXXGOOOOXXXXXXXXXXXXXXXGOOOOOOOXXXXXXXXXXXXGOOOOXXXXXXXXXXXXXXXGOOOOOOOOOOXXXXXXXXX,0,256,0
20664,128,2,126,103,109,0,0,269,134,135,GOOOOOAXXXXXXXXXXXXXGOOOOOOOOOOXXXXXXXXXGOOOOOOOOOOXXXXXXXXXGOOOOOOOOOOOOOOOXXXXGOOOOOAXXXXXXXXXXXXXGOOOOOOOOOOOOOXXXXXXGOOOOOXXXXXXXXXXXXXXGOOOOOOOOOOOXXXXXXXXGOOOOOOOOOOOOOOXXXXXGOOOOXXXXXXXXXXXXXXXGOOOOOOOXXXXXXXXXXXXGOOOOXXXXXXXXXXXXXXXGOOOOOOOOOOXXXXXXXXX,0,256,0

20685,128,1,127,104,108,0,0,267,136,131,GOOOOOAXXXXXXXXXXXXXGOOOOOOOOOOXXXXXXXXXGOOOOOOOOOOXXXXXXXXXGOOOOOOOOOOOOOOOXXXXGOOOOOOXXXXXXXXXXXXXGOOOOOOOOOOOOOXXXXXXGOOOOOXXXXXXXXXXXXXXGOOOOOOOOOOOXXXXXXXXGOOOOOOOOOOOOOOXXXXXGOOOOXXXXXXXXXXXXXXXGOOOOOOOXXXXXXXXXXXXGOOOOXXXXXXXXXXXXXXXGOOOOOOOOOOXXXXXXXXX,0,256,0
20706,128,1,127,106,106,0,0,266,133,133,GOOOOOAXXXXXXXXXXXXXGOOOOOOOOOOXXXXXXXXXGOOOOOOOOOOXXXXXXXXXGOOOOOOOOOOOOOOOXXXXGOOOOOOXXXXXXXXXXXXXGOOOOOOOOOOOOOXXXXXXGOOOOOXXXXXXXXXXXXXXGOOOOOOOOOOOXXXXXXXXGOOOOOOOOOOOOOOXXXXXGOOOOXXXXXXXXXXXXXXXGOOOOOOOXXXXXXXXXXXXGOOOOXXXXXXXXXXXXXXXGOOOOOOOOOOXXXXXXXXX,0,256,0
20727,128,1,127,108,104,0,0,264,126,138,GOOOOOAXXXXXXXXXXXXXGOOOOOOOOOOXXXXXXXXXGOOOOOOOOOOXXXXXXXXXGOOOOOOOOOOOOOOOXXXXGOOOOOOXXXXXXXXXXXXXGOOOOOOOOOOOOOXXXXXXGOOOOOXXXXXXXXXXXXXXGOOOOOOOOOOOXXXXXXXXGOOOOOOOOOOOOOOXXXXXGOOOOXXXXXXXXXXXXXXXGOOOOOOOXXXXXXXXXXXXGOOOOXXXXXXXXXXXXXXXGOOOOOOOOOOXXXXXXXXX,0,256,0
20748,128,1,127,109,103,0,0,262,127,135,GOOOOOAXXXXXXXXXXXXXGOOOOOOOOOOXXXXXXXXXGOOOOOOOOOOXXXXXXXXXGOOOOOOOOOOOOOOOXXXXGOOOOOOXXXXXXXXXXXXXGOOOOOOOOOOOOOXXXXXXGOOOOOXXXXXXXXXXXXXXGOOOOOOOOOOOXXXXXXXXGOOOOOOOOOOOOOOXXXXXGOOOOXXXXXXXXXXXXXXXGOOOOOOOXXXXXXXXXXXXGOOOOXXXXXXXXXXXXXXXGOOOOOOOOOOXXXXXXXXX,0,256,0
20769,128,1,127,108,104,0,0,263,129,134,GOOOOOAXXXXXXXXXXXXXGOOOOOOOOOOXXXXXXXXXGOOOOOOOOOOXXXXXXXXXGOOOOOOOOOOOOOOOXXXXGOOOOOOXXXXXXXXXXXXXGOOOOOOOOOOOOOXXXXXXGOOOOOXXXXXXXXXXXXXXGOOOOOOOOOOOXXXXXXXXGOOOOOOOOOOOOOOXXXXXGOOOOXXXXXXXXXXXXXXXGOOOOOOOXXXXXXXXXXXXGOOOOXXXXXXXXXXXXXXXGOOOOOOOOOOXXXXXXXXX,0,256,0

20790,128,1,127,110,102,0,0,262,127,135,GOOOOOAXXXXXXXXXXXXXGOOOOOOOOOOXXXXXXXXXGOOOOOOOOOOXXXXXXXXXGOOOOOOOOOOOOOOOXXXXGOOOOOOXXXXXXXXXXXXXGOOOOOOOOOOOOOXXXXXXGOOOOOXXXXXXXXXXXXXXGOOOOOOOOOOOXXXXXXXXGOOOOOOOOOOOOOOXXXXXGOOOOXXXXXXXXXXXXXXXGOOOOOOOXXXXXXXXXXXXGOOOOXXXXXXXXXXXXXXXGOOOOOOOOOOXXXXXXXXX,0,256,0
20811,128,0,128,105,107,0,0,266,130,136,GOOOOOOXXXXXXXXXXXXXGOOOOOOOOOOXXXXXXXXXGOOOOOOOOOOXXXXXXXXXGOOOOOOOOOOOOOOOXXXXGOOOOOOXXXXXXXXXXXXXGOOOOOOOOOOOOOXXXXXXGOOOOOXXXXXXXXXXXXXXGOOOOOOOOOOOXXXXXXXXGOOOOOOOOOOOOOOXXXXXGOOOOXXXXXXXXXXXXXXXGOOOOOOOXXXXXXXXXXXXGOOOOXXXXXXXXXXXXXXXGOOOOOOOOOOXXXXXXXXX,0,256,0
20832,128,0,128,105,107,0,0,267,126,141,GOOOOOOXXXXXXXXXXXXXGOOOOOOOOOOXXXXXXXXXGOOOOOOOOOOXXXXXXXXXGOOOOOOOOOOOOOOOXXXXGOOOOOOXXXXXXXXXXXXXGOOOOOOOOOOOOOXXXXXXGOOOOOXXXXXXXXXXXXXXGOOOOOOOOOOOXXXXXXXXGOOOOOOOOOOOOOOXXXXXGOOOOXXXXXXXXXXXXXXXGOOOOOOOXXXXXXXXXXXXGOOOOXXXXXXXXXXXXXXXGOOOOOOOOOOXXXXXXXXX,0,256,0
20853,128,0,128,99,113,0,0,272,127,145,GOOOOOOXXXXXXXXXXXXXGOOOOOOOOOOXXXXXXXXXGOOOOOOOOOOXXXXXXXXXGOOOOOOOOOOOOOOOXXXXGOOOOOOXXXXXXXXXXXXXGOOOOOOOOOOOOOXXXXXXGOOOOOXXXXXXXXXXXXXXGOOOOOOOOOOOXXXXXXXXGOOOOOOOOOOOOOOXXXXXGOOOOXXXXXXXXXXXXXXXGOOOOOOOXXXXXXXXXXXXGOOOOXXXXXXXXXXXXXXXGOOOOOOOOOOXXXXXXXXX,0,256,0
20874,128,0,128,101,111,0,0,271,118,153,GOOOOOOXXXXXXXXXXXXXGOOOOOOOOOOXXXXXXXXXGOOOOOOOOOOXXXXXXXXXGOOOOOOOOOOOOOOOXXXXGOOOOOOXXXXXXXXXXXXXGOOOOOOOOOOOOOXXXXXXGOOOOOXXXXXXXXXXXXXXGOOOOOOOOOOOXXXXXXXXGOOOOOOOOOOOOOOXXXXXGOOOOXXXXXXXXXXXXXXXGOOOOOOOXXXXXXXXXXXXGOOOOXXXXXXXXXXXXXXXGOOOOOOOOOOXXXXXXXXX,0,256,0

20895,128,0,128,94,118,0,0,278,126,152,GOOOOOOXXXXXXXXXXXXXGOOOOOOOOOOXXXXXXXXXGOOOOOOOOOOXXXXXXXXXGOOOOOOOOOOOOOOOXXXXGOOOOOOXXXXXXXXXXXXXGOOOOOOOOOOOOOXXXXXXGOOOOOXXXXXXXXXXXXXXGOOOOOOOOOOOXXXXXXXXGOOOOOOOOOOOOOOXXXXXGOOOOXXXXXXXXXXXXXXXGOOOOOOOXXXXXXXXXXXXGOOOOXXXXXXXXXXXXXXXGOOOOOOOOOOXXXXXXXXX,0,256,0
20916,128,0,128,92,120,0,0,280,122,158,GOOOOOOXXXXXXXXXXXXXGOOOOOOOOOOXXXXXXXXXGOOOOOOOOOOXXXXXXXXXGOOOOOOOOOOOOOOOXXXXGOOOOOOXXXXXXXXXXXXXGOOOOOOOOOOOOOXXXXXXGOOOOOXXXXXXXXXXXXXXGOOOOOOOOOOOXXXXXXXXGOOOOOOOOOOOOOOXXXXXGOOOOXXXXXXXXXXXXXXXGOOOOOOOXXXXXXXXXXXXGOOOOXXXXXXXXXXXXXXXGOOOOOOOOOOXXXXXXXXX,0,256,0
20937,128,0,128,92,120,0,0,280,121,159,GOOOOOOXXXXXXXXXXXXXGOOOOOOOOOOXXXXXXXXXGOOOOOOOOOOXXXXXXXXXGOOOOOOOOOOOOOOOXXXXGOOOOOOXXXXXXXXXXXXXGOOOOOOOOOOOOOXXXXXXGOOOOOXXXXXXXXXXXXXXGOOOOOOOOOOOXXXXXXXXGOOOOOOOOOOOOOOXXXXXGOOOOXXXXXXXXXXXXXXXGOOOOOOOXXXXXXXXXXXXGOOOOXXXXXXXXXXXXXXXGOOOOOOOOOOXXXXXXXXX,0,256,0
20958,128,0,128,94,118,0,0,278,125,153,GOOOOOOXXXXXXXXXXXXXGOOOOOOOOOOXXXXXXXXXGOOOOOOOOOOXXXXXXXXXGOOOOOOOOOOOOOOOXXXXGOOOOOOXXXXXXXXXXXXXGOOOOOOOOOOOOOXXXXXXGOOOOOXXXXXXXXXXXXXXGOOOOOOOOOOOXXXXXXXXGOOOOOOOOOOOOOOXXXXXGOOOOXXXXXXXXXXXXXXXGOOOOOOOXXXXXXXXXXXXGOOOOXXXXXXXXXXXXXXXGOOOOOOOOOOXXXXXXXXX,0,256,0
20979,128,0,128,100,112,0,0,272,128,144,GOOOOOOXXXXXXXXXXXXXGOOOOOOOOOOXXXXXXXXXGOOOOOOOOOOXXXXXXXXXGOOOOOOOOOOOOOOOXXXXGOOOOOOXXXXXXXXXXXXXGOOOOOOOOOOOOOXXXXXXGOOOOOXXXXXXXXXXXXXXGOOOOOOOOOOOXXXXXXXXGOOOOOOOOOOOOOOXXXXXGOOOOXXXXXXXXXXXXXXXGOOOOOOOXXXXXXXXXXXXGOOOOXXXXXXXXXXXXXXXGOOOOOOOOOOXXXXXXXXX,0,256,0

21000,128,0,128,100,112,0,0,271,128,143,GOOOOOOXXXXXXXXXXXXXGOOOOOOOOOOXXXXXXXXXGOOOOOOOOOOXXXXXXXXXGOOOOOOOOOOOOOOOXXXXGOOOOOOXXXXXXXXXXXXXGOOOOOOOOOOOOOXXXXXXGOOOOOXXXXXXXXXXXXXXGOOOOOOOOOOOXXXXXXXXGOOOOOOOOOOOOOOXXXXXGOOOOXXXXXXXXXXXXXXXGOOOOOOOXXXXXXXXXXXXGOOOOXXXXXXXXXXXXXXXGOOOOOOOOOOXXXXXXXXX,0,256,0
21021,128,0,128,93,119,0,0,279,131,148,GOOOOOOXXXXXXXXXXXXXGOOOOOOOOOOXXXXXXXXXGOOOOOOOOOOXXXXXXXXXGOOOOOOOOOOOOOOOXXXXGOOOOOOXXXXXXXXXXXXXGOOOOOOOOOOOOOXXXXXXGOOOOOXXXXXXXXXXXXXXGOOOOOOOOOOOXXXXXXXXGOOOOOOOOOOOOOOXXXXXGOOOOXXXXXXXXXXXXXXXGOOOOOOOXXXXXXXXXXXXGOOOOXXXXXXXXXXXXXXXGOOOOOOOOOOXXXXXXXXX,0,256,0
21042,128,0,128,94,118,0,0,277,128,149,GOOOOOOXXXXXXXXXXXXXGOOOOOOOOOOXXXXXXXXXGOOOOOOOOOOXXXXXXXXXGOOOOOOOOOOOOOOOXXXXGOOOOOOXXXXXXXXXXXXXGOOOOOOOOOOOOOXXXXXXGOOOOOXXXXXXXXXXXXXXGOOOOOOOOOOOXXXXXXXXGOOOOOOOOOOOOOOXXXXXGOOOOXXXXXXXXXXXXXXXGOOOOOOOXXXXXXXXXXXXGOOOOXXXXXXXXXXXXXXXGOOOOOOOOOOXXXXXXXXX,0,256,0
21063,129,1,128,90,121,0,0,280,132,148,GOOOOOOXXXXXXXXXXXXXGOOOOOOOOOOXXXXXXXXXGOOOOOOOOOOXXXXXXXXXGOOOOOOOOOOOOOOOXXXXGOOOOOOXXXXXXXXXXXXXGOOOOOOOOOOOOOXXXXXXGOOOOOXXXXXXXXXXXXXXGOOOOOOOOOOOXXXXXXXXGOOOOOOOOOOOOOOXXXXXGOOOOAXXXXXXXXXXXXXXGOOOOOOOXXXXXXXXXXXXGOOOOXXXXXXXXXXXXXXXGOOOOOOOOOOXXXXXXXXX,0,256,0
21084,129,1,128,89,122,0,0,281,136,145,GOOOOOOXXXXXXXXXXXXXGOOOOOOOOOOXXXXXXXXXGOOOOOOOOOOXXXXXXXXXGOOOOOOOOOOOOOOOXXXXGOOOOOOXXXXXXXXXXXXXGOOOOOOOOOOOOOXXXXXXGOOOOOXXXXXXXXXXXXXXGOOOOOOOOOOOXXXXXXXXGOOOOOOOOOOOOOOXXXXXGOOOOAXXXXXXXXXXXXXXGOOOOOOOXXXXXXXXXXXXGOOOOXXXXXXXXXXXXXXXGOOOOOOOOOOXXXXXXXXX,0,256,0

21105,129,0,129,89,122,0,0,281,138,143,GOOOOOOXXXXXXXXXXXXXGOOOOOOOOOOXXXXXXXXXGOOOOOOOOOOXXXXXXXXXGOOOOOOOOOOOOOOOXXXXGOOOOOOXXXXXXXXXXXXXGOOOOOOOOOOOOOXXXXXXGOOOOOXXXXXXXXXXXXXXGOOOOOOOOOOOXXXXXXXXGOOOOOOOOOOOOOOXXXXXGOOOOOXXXXXXXXXXXXXXGOOOOOOOXXXXXXXXXXXXGOOOOXXXXXXXXXXXXXXXGOOOOOOOOOOXXXXXXXXX,0,256,0
21126,129,0,129,93,118,0,0,277,135,142,GOOOOOOXXXXXXXXXXXXXGOOOOOOOOOOXXXXXXXXXGOOOOOOOOOOXXXXXXXXXGOOOOOOOOOOOOOOOXXXXGOOOOOOXXXXXXXXXXXXXGOOOOOOOOOOOOOXXXXXXGOOOOOXXXXXXXXXXXXXXGOOOOOOOOOOOXXXXXXXXGOOOOOOOOOOOOOOXXXXXGOOOOOXXXXXXXXXXXXXXGOOOOOOOXXXXXXXXXXXXGOOOOXXXXXXXXXXXXXXXGOOOOOOOOOOXXXXXXXXX,0,256,0
21147,129,0,129,99,112,0,0,271,131,140,GOOOOOOXXXXXXXXXXXXXGOOOOOOOOOOXXXXXXXXXGOOOOOOOOOOXXXXXXXXXGOOOOOOOOOOOOOOOXXXXGOOOOOOXXXXXXXXXXXXXGOOOOOOOOOOOOOXXXXXXGOOOOOXXXXXXXXXXXXXXGOOOOOOOOOOOXXXXXXXXGOOOOOOOOOOOOOOXXXXXGOOOOOXXXXXXXXXXXXXXGOOOOOOOXXXXXXXXXXXXGOOOOXXXXXXXXXXXXXXXGOOOOOOOOOOXXXXXXXXX,0,256,0
21168,129,0,129,102,109,0,0,268,126,142,GOOOOOOXXXXXXXXXXXXXGOOOOOOOOOOXXXXXXXXXGOOOOOOOOOOXXXXXXXXXGOOOOOOOOOOOOOOOXXXXGOOOOOOXXXXXXXXXXXXXGOOOOOOOOOOOOOXXXXXXGOOOOOXXXXXXXXXXXXXXGOOOOOOOOOOOXXXXXXXXGOOOOOOOOOOOOOOXXXXXGOOOOOXXXXXXXXXXXXXXGOOOOOOOXXXXXXXXXXXXGOOOOXXXXXXXXXXXXXXXGOOOOOOOOOOXXXXXXXXX,0,256,0
21189,129,0,129,100,111,0,0,271,126,145,GOOOOOOXXXXXXXXXXXXXGOOOOOOOOOOXXXXXXXXXGOOOOOOOOOOXXXXXXXXXGOOOOOOOOOOOOOOOXXXXGOOOOOOXXXXXXXXXXXXXGOOOOOOOOOOOOOXXXXXXGOOOOOXXXXXXXXXXXXXXGOOOOOOOOOOOXXXXXXXXGOOOOOOOOOOOOOOXXXXXGOOOOOXXXXXXXXXXXXXXGOOOOOOOXXXXXXXXXXXXGOOOOXXXXXXXXXXXXXXXGOOOOOOOOOOXXXXXXXXX,0,256,0

21210,129,0,129,97,114,0,0,274,129,145,GOOOOOOXXXXXXXXXXXXXGOOOOOOOOOOXXXXXXXXXGOOOOOOOOOOXXXXXXXXXGOOOOOOOOOOOOOOOXXXXGOOOOOOXXXXXXXXXXXXXGOOOOOOOOOOOOOXXXXXXGOOOOOXXXXXXXXXXXXXXGOOOOOOOOOOOXXXXXXXXGOOOOOOOOOOOOOOXXXXXGOOOOOXXXXXXXXXXXXXXGOOOOOOOXXXXXXXXXXXXGOOOOXXXXXXXXXXXXXXXGOOOOOOOOOOXXXXXXXXX,0,256,0
21231,129,0,129,98,113,0,0,273,134,139,GOOOOOOXXXXXXXXXXXXXGOOOOOOOOOOXXXXXXXXXGOOOOOOOOOOXXXXXXXXXGOOOOOOOOOOOOOOOXXXXGOOOOOOXXXXXXXXXXXXXGOOOOOOOOOOOOOXXXXXXGOOOOOXXXXXXXXXXXXXXGOOOOOOOOOOOXXXXXXXXGOOOOOOOOOOOOOOXXXXXGOOOOOXXXXXXXXXXXXXXGOOOOOOOXXXXXXXXXXXXGOOOOXXXXXXXXXXXXXXXGOOOOOOOOOOXXXXXXXXX,0,256,0
21252,129,0,129,102,109,0,0,269,128,141,GOOOOOOXXXXXXXXXXXXXGOOOOOOOOOOXXXXXXXXXGOOOOOOOOOOXXXXXXXXXGOOOOOOOOOOOOOOOXXXXGOOOOOOXXXXXXXXXXXXXGOOOOOOOOOOOOOXXXXXXGOOOOOXXXXXXXXXXXXXXGOOOOOOOOOOOXXXXXXXXGOOOOOOOOOOOOOOXXXXXGOOOOOXXXXXXXXXXXXXXGOOOOOOOXXXXXXXXXXXXGOOOOXXXXXXXXXXXXXXXGOOOOOOOOOOXXXXXXXXX,0,256,0
21273,129,0,129,96,115,0,0,275,128,147,GOOOOOOXXXXXXXXXXXXXGOOOOOOOOOOXXXXXXXXXGOOOOOOOOOOXXXXXXXXXGOOOOOOOOOOOOOOOXXXXGOOOOOOXXXXXXXXXXXXXGOOOOOOOOOOOOOXXXXXXGOOOOOXXXXXXXXXXXXXXGOOOOOOOOOOOXXXXXXXXGOOOOOOOOOOOOOOXXXXXGOOOOOXXXXXXXXXXXXXXGOOOOOOOXXXXXXXXXXXXGOOOOXXXXXXXXXXXXXXXGOOOOOOOOOOXXXXXXXXX,0,256,0
21294,129,0,129,91,120,0,0,279,131,148,GOOOOOOXXXXXXXXXXXXXGOOOOOOOOOOXXXXXXXXXGOOOOOOOOOOXXXXXXXXXGOOOOOOOOOOOOOOOXXXXGOOOOOOXXXXXXXXXXXXXGOOOOOOOOOOOOOXXXXXXGOOOOOXXXXXXXXXXXXXXGOOOOOOOOOOOXXXXXXXXGOOOOOOOOOOOOOOXXXXXGOOOOOXXXXXXXXXXXXXXGOOOOOOOXXXXXXXXXXXXGOOOOXXXXXXXXXXXXXXXGOOOOOOOOOOXXXXXXXXX,0,256,0

21315,129,0,129,96,115,0,0,275,128,147,GOOOOOOXXXXXXXXXXXXXGOOOOOOOOOOXXXXXXXXXGOOOOOOOOOOXXXXXXXXXGOOOOOOOOOOOOOOOXXXXGOOOOOOXXXXXXXXXXXXXGOOOOOOOOOOOOOXXXXXXGOOOOOXXXXXXXXXXXXXXGOOOOOOOOOOOXXXXXXXXGOOOOOOOOOOOOOOXXXXXGOOOOOXXXXXXXXXXXXXXGOOOOOOOXXXXXXXXXXXXGOOOOXXXXXXXXXXXXXXXGOOOOOOOOOOXXXXXXXXX,0,256,0
21336,129,0,129,98,113,0,0,273,129,144,GOOOOOOXXXXXXXXXXXXXGOOOOOOOOOOXXXXXXXXXGOOOOOOOOOOXXXXXXXXXGOOOOOOOOOOOOOOOXXXXGOOOOOOXXXXXXXXXXXXXGOOOOOOOOOOOOOXXXXXXGOOOOOXXXXXXXXXXXXXXGOOOOOOOOOOOXXXXXXXXGOOOOOOOOOOOOOOXXXXXGOOOOOXXXXXXXXXXXXXXGOOOOOOOXXXXXXXXXXXXGOOOOXXXXXXXXXXXXXXXGOOOOOOOOOOXXXXXXXXX,0,256,0
21357,129,0,129,102,109,0,0,269,134,135,GOOOOOOXXXXXXXXXXXXXGOOOOOOOOOOXXXXXXXXXGOOOOOOOOOOXXXXXXXXXGOOOOOOOOOOOOOOOXXXXGOOOOOOXXXXXXXXXXXXXGOOOOOOOOOOOOOXXXXXXGOOOOOXXXXXXXXXXXXXXGOOOOOOOOOOOXXXXXXXXGOOOOOOOOOOOOOOXXXXXGOOOOOXXXXXXXXXXXXXXGOOOOOOOXXXXXXXXXXXXGOOOOXXXXXXXXXXXXXXXGOOOOOOOOOOXXXXXXXXX,0,256,0
21378,129,0,129,98,113,0,0,273,131,142,GOOOOOOXXXXXXXXXXXXXGOOOOOOOOOOXXXXXXXXXGOOOOOOOOOOXXXXXXXXXGOOOOOOOOOOOOOOOXXXXGOOOOOOXXXXXXXXXXXXXGOOOOOOOOOOOOOXXXXXXGOOOOOXXXXXXXXXXXXXXGOOOOOOOOOOOXXXXXXXXGOOOOOOOOOOOOOOXXXXXGOOOOOXXXXXXXXXXXXXXGOOOOOOOXXXXXXXXXXXXGOOOOXXXXXXXXXXXXXXXGOOOOOOOOOOXXXXXXXXX,0,256,0
21399,129,0,129,97,114,0,0,274,137,137,GOOOOOOXXXXXXXXXXXXXGOOOOOOOOOOXXXXXXXXXGOOOOOOOOOOXXXXXXXXXGOOOOOOOOOOOOOOOXXXXGOOOOOOXXXXXXXXXXXXXGOOOOOOOOOOOOOXXXXXXGOOOOOXXXXXXXXXXXXXXGOOOOOOOOOOOXXXXXXXXGOOOOOOOOOOOOOOXXXXXGOOOOOXXXXXXXXXXXXXXGOOOOOOOXXXXXXXXXXXXGOOOOXXXXXXXXXXXXXXXGOOOOOOOOOOXXXXXXXXX,0,256,0

21420,129,0,129,95,116,0,0,276,138,138,GOOOOOOXXXXXXXXXXXXXGOOOOOOOOOOXXXXXXXXXGOOOOOOOOOOXXXXXXXXXGOOOOOOOOOOOOOOOXXXXGOOOOOOXXXXXXXXXXXXXGOOOOOOOOOOOOOXXXXXXGOOOOOXXXXXXXXXXXXXXGOOOOOOOOOOOXXXXXXXXGOOOOOOOOOOOOOOXXXXXGOOOOOXXXXXXXXXXXXXXGOOOOOOOXXXXXXXXXXXXGOOOOXXXXXXXXXXXXXXXGOOOOOOOOOOXXXXXXXXX,0,256,0
21441,129,0,129,96,115,0,0,275,133,142,GOOOOOOXXXXXXXXXXXXXGOOOOOOOOOOXXXXXXXXXGOOOOOOOOOOXXXXXXXXXGOOOOOOOOOOOOOOOXXXXGOOOOOOXXXXXXXXXXXXXGOOOOOOOOOOOOOXXXXXXGOOOOOXXXXXXXXXXXXXXGOOOOOOOOOOOXXXXXXXXGOOOOOOOOOOOOOOXXXXXGOOOOOXXXXXXXXXXXXXXGOOOOOOOXXXXXXXXXXXXGOOOOXXXXXXXXXXXXXXXGOOOOOOOOOOXXXXXXXXX,0,256,0
21462,130,1,129,91,119,0,0,278,135,143,GOOOOOOXXXXXXXXXXXXXGOOOOOOOOOOXXXXXXXXXGOOOOOOOOOOXXXXXXXXXGOOOOOOOOOOOOOOOXXXXGOOOOOOXXXXXXXXXXXXXGOOOOOOOOOOOOOXXXXXXGOOOOOXXXXXXXXXXXXXXGOOOOOOOOOOOXXXXXXXXGOOOOOOOOOOOOOOAXXXXGOOOOOXXXXXXXXXXXXXXGOOOOOOOXXXXXXXXXXXXGOOOOXXXXXXXXXXXXXXXGOOOOOOOOOOXXXXXXXXX,0,256,0
21483,130,1,129,89,121,0,0,280,132,148,GOOOOOOXXXXXXXXXXXXXGOOOOOOOOOOXXXXXXXXXGOOOOOOOOOOXXXXXXXXXGOOOOOOOOOOOOOOOXXXXGOOOOOOXXXXXXXXXXXXXGOOOOOOOOOOOOOXXXXXXGOOOOOXXXXXXXXXXXXXXGOOOOOOOOOOOXXXXXXXXGOOOOOOOOOOOOOOAXXXXGOOOOOXXXXXXXXXXXXXXGOOOOOOOXXXXXXXXXXXXGOOOOXXXXXXXXXXXXXXXGOOOOOOOOOOXXXXXXXXX,0,256,0
21504,130,1,129,91,119,0,0,279,128,151,GOOOOOOXXXXXXXXXXXXXGOOOOOOOOOOXXXXXXXXXGOOOOOOOOOOXXXXXXXXXGOOOOOOOOOOOOOOOXXXXGOOOOOOXXXXXXXXXXXXXGOOOOOOOOOOOOOXXXXXXGOOOOOXXXXXXXXXXXXXXGOOOOOOOOOOOXXXXXXXXGOOOOOOOOOOOOOOAXXXXGOOOOOXXXXXXXXXXXXXXGOOOOOOOXXXXXXXXXXXXGOOOOXXXXXXXXXXXXXXXGOOOOOOOOOOXXXXXXXXX,0,256,0

21525,130,1,129,91,119,0,0,279,134,145,GOOOOOOXXXXXXXXXXXXXGOOOOOOOOOOXXXXXXXXXGOOOOOOOOOOXXXXXXXXXGOOOOOOOOOOOOOOOXXXXGOOOOOOXXXXXXXXXXXXXGOOOOOOOOOOOOOXXXXXXGOOOOOXXXXXXXXXXXXXXGOOOOOOOOOOOXXXXXXXXGOOOOOOOOOOOOOOAXXXXGOOOOOXXXXXXXXXXXXXXGOOOOOOOXXXXXXXXXXXXGOOOOXXXXXXXXXXXXXXXGOOOOOOOOOOXXXXXXXXX,0,256,0
21546,130,1,129,87,123,0,0,282,136,146,GOOOOOOXXXXXXXXXXXXXGOOOOOOOOOOXXXXXXXXXGOOOOOOOOOOXXXXXXXXXGOOOOOOOOOOOOOOOXXXXGOOOOOOXXXXXXXXXXXXXGOOOOOOOOOOOOOXXXXXXGOOOOOXXXXXXXXXXXXXXGOOOOOOOOOOOXXXXXXXXGOOOOOOOOOOOOOOAXXXXGOOOOOXXXXXXXXXXXXXXGOOOOOOOXXXXXXXXXXXXGOOOOXXXXXXXXXXXXXXXGOOOOOOOOOOXXXXXXXXX,0,256,0
21567,130,1,129,93,117,0,0,277,130,147,GOOOOOOXXXXXXXXXXXXXGOOOOOOOOOOXXXXXXXXXGOOOOOOOOOOXXXXXXXXXGOOOOOOOOOOOOOOOXXXXGOOOOOOXXXXXXXXXXXXXGOOOOOOOOOOOOOXXXXXXGOOOOOXXXXXXXXXXXXXXGOOOOOOOOOOOXXXXXXXXGOOOOOOOOOOOOOOAXXXXGOOOOOXXXXXXXXXXXXXXGOOOOOOOXXXXXXXXXXXXGOOOOXXXXXXXXXXXXXXXGOOOOOOOOOOXXXXXXXXX,0,256,0
21588,130,1,129,94,116,0,0,276,131,145,GOOOOOOXXXXXXXXXXXXXGOOOOOOOOOOXXXXXXXXXGOOOOOOOOOOXXXXXXXXXGOOOOOOOOOOOOOOOXXXXGOOOOOOXXXXXXXXXXXXXGOOOOOOOOOOOOOXXXXXXGOOOOOXXXXXXXXXXXXXXGOOOOOOOOOOOXXXXXXXXGOOOOOOOOOOOOOOAXXXXGOOOOOXXXXXXXXXXXXXXGOOOOOOOXXXXXXXXXXXXGOOOOXXXXXXXXXXXXXXXGOOOOOOOOOOXXXXXXXXX,0,256,0
21609,130,1,129,94,116,0,0,275,129,146,GOOOOOOXXXXXXXXXXXXXGOOOOOOOOOOXXXXXXXXXGOOOOOOOOOOXXXXXXXXXGOOOOOOOOOOOOOOOXXXXGOOOOOOXXXXXXXXXXXXXGOOOOOOOOOOOOOXXXXXXGOOOOOXXXXXXXXXXXXXXGOOOOOOOOOOOXXXXXXXXGOOOOOOOOOOOOOOAXXXXGOOOOOXXXXXXXXXXXXXXGOOOOOOOXXXXXXXXXXXXGOOOOXXXXXXXXXXXXXXXGOOOOOOOOOOXXXXXXXXX,0,256,0

21630,130,1,129,100,110,0,0,269,129,140,GOOOOOOXXXXXXXXXXXXXGOOOOOOOOOOXXXXXXXXXGOOOOOOOOOOXXXXXXXXXGOOOOOOOOOOOOOOOXXXXGOOOOOOXXXXXXXXXXXXXGOOOOOOOOOOOOOXXXXXXGOOOOOXXXXXXXXXXXXXXGOOOOOOOOOOOXXXXXXXXGOOOOOOOOOOOOOOAXXXXGOOOOOXXXXXXXXXXXXXXGOOOOOOOXXXXXXXXXXXXGOOOOXXXXXXXXXXXXXXXGOOOOOOOOOOXXXXXXXXX,0,256,0
21651,130,1,129,102,108,0,0,267,131,136,GOOOOOOXXXXXXXXXXXXXGOOOOOOOOOOXXXXXXXXXGOOOOOOOOOOXXXXXXXXXGOOOOOOOOOOOOOOOXXXXGOOOOOOXXXXXXXXXXXXXGOOOOOOOOOOOOOXXXXXXGOOOOOXXXXXXXXXXXXXXGOOOOOOOOOOOXXXXXXXXGOOOOOOOOOOOOOOAXXXXGOOOOOXXXXXXXXXXXXXXGOOOOOOOXXXXXXXXXXXXGOOOOXXXXXXXXXXXXXXXGOOOOOOOOOOXXXXXXXXX,0,256,0
21672,130,0,130,95,115,0,0,275,131,144,GOOOOOOXXXXXXXXXXXXXGOOOOOOOOOOXXXXXXXXXGOOOOOOOOOOXXXXXXXXXGOOOOOOOOOOOOOOOXXXXGOOOOOOXXXXXXXXXXXXXGOOOOOOOOOOOOOXXXXXXGOOOOOXXXXXXXXXXXXXXGOOOOOOOOOOOXXXXXXXXGOOOOOOOOOOOOOOOXXXXGOOOOOXXXXXXXXXXXXXXGOOOOOOOXXXXXXXXXXXXGOOOOXXXXXXXXXXXXXXXGOOOOOOOOOOXXXXXXXXX,0,256,0
21693,130,0,130,101,109,0,0,268,130,138,GOOOOOOXXXXXXXXXXXXXGOOOOOOOOOOXXXXXXXXXGOOOOOOOOOOXXXXXXXXXGOOOOOOOOOOOOOOOXXXXGOOOOOOXXXXXXXXXXXXXGOOOOOOOOOOOOOXXXXXXGOOOOOXXXXXXXXXXXXXXGOOOOOOOOOOOXXXXXXXXGOOOOOOOOOOOOOOOXXXXGOOOOOXXXXXXXXXXXXXXGOOOOOOOXXXXXXXXXXXXGOOOOXXXXXXXXXXXXXXXGOOOOOOOOOOXXXXXXXXX,0,256,0
21714,130,0,130,103,107,0,0,267,125,142,GOOOOOOXXXXXXXXXXXXXGOOOOOOOOOOXXXXXXXXXGOOOOOOOOOOXXXXXXXXXGOOOOOOOOOOOOOOOXXXXGOOOOOOXXXXXXXXXXXXXGOOOOOOOOOOOOOXXXXXXGOOOOOXXXXXXXXXXXXXXGOOOOOOOOOOOXXXXXXXXGOOOOOOOOOOOOOOOXXXXGOOOOOXXXXXXXXXXXXXXGOOOOOOOXXXXXXXXXXXXGOOOOXXXXXXXXXXXXXXXGOOOOOOOOOOXXXXXXXXX,0,256,0

21735,130,0,130,99,111,0,0,272,130,142,GOOOOOOXXXXXXXXXXXXXGOOOOOOOOOOXXXXXXXXXGOOOOOOOOOOXXXXXXXXXGOOOOOOOOOOOOOOOXXXXGOOOOOOXXXXXXXXXXXXXGOOOOOOOOOOOOOXXXXXXGOOOOOXXXXXXXXXXXXXXGOOOOOOOOOOOXXXXXXXXGOOOOOOOOOOOOOOOXXXXGOOOOOXXXXXXXXXXXXXXGOOOOOOOXXXXXXXXXXXXGOOOOXXXXXXXXXXXXXXXGOOOOOOOOOOXXXXXXXXX,0,256,0
21756,130,0,130,92,118,0,0,280,135,145,GOOOOOOXXXXXXXXXXXXXGOOOOOOOOOOXXXXXXXXXGOOOOOOOOOOXXXXXXXXXGOOOOOOOOOOOOOOOXXXXGOOOOOOXXXXXXXXXXXXXGOOOOOOOOOOOOOXXXXXXGOOOOOXXXXXXXXXXXXXXGOOOOOOOOOOOXXXXXXXXGOOOOOOOOOOOOOOOXXXXGOOOOOXXXXXXXXXXXXXXGOOOOOOOXXXXXXXXXXXXGOOOOXXXXXXXXXXXXXXXGOOOOOOOOOOXXXXXXXXX,0,256,0
21777,130,0,130,93,117,0,0,279,139,140,GOOOOOOXXXXXXXXXXXXXGOOOOOOOOOOXXXXXXXXXGOOOOOOOOOOXXXXXXXXXGOOOOOOOOOOOOOOOXXXXGOOOOOOXXXXXXXXXXXXXGOOOOOOOOOOOOOXXXXXXGOOOOOXXXXXXXXXXXXXXGOOOOOOOOOOOXXXXXXXXGOOOOOOOOOOOOOOOXXXXGOOOOOXXXXXXXXXXXXXXGOOOOOOOXXXXXXXXXXXXGOOOOXXXXXXXXXXXXXXXGOOOOOOOOOOXXXXXXXXX,0,256,0
21798,130,0,130,93,117,0,0,279,141,138,GOOOOOOXXXXXXXXXXXXXGOOOOOOOOOOXXXXXXXXXGOOOOOOOOOOXXXXXXXXXGOOOOOOOOOOOOOOOXXXXGOOOOOOXXXXXXXXXXXXXGOOOOOOOOOOOOOXXXXXXGOOOOOXXXXXXXXXXXXXXGOOOOOOOOOOOXXXXXXXXGOOOOOOOOOOOOOOOXXXXGOOOOOXXXXXXXXXXXXXXGOOOOOOOXXXXXXXXXXXXGOOOOXXXXXXXXXXXXXXXGOOOOOOOOOOXXXXXXXXX,0,256,0
21819,130,0,130,92,118,0,0,279,138,141,GOOOOOOXXXXXXXXXXXXXGOOOOOOOOOOXXXXXXXXXGOOOOOOOOOOXXXXXXXXXGOOOOOOOOOOOOOOOXXXXGOOOOOOXXXXXXXXXXXXXGOOOOOOOOOOOOOXXXXXXGOOOOOXXXXXXXXXXXXXXGOOOOOOOOOOOXXXXXXXXGOOOOOOOOOOOOOOOXXXXGOOOOOXXXXXXXXXXXXXXGOOOOOOOXXXXXXXXXXXXGOOOOXXXXXXXXXXXXXXXGOOOOOOOOOOXXXXXXXXX,0,256,0

21840,130,0,130,99,111,0,0,272,139,133,GOOOOOOXXXXXXXXXXXXXGOOOOOOOOOOXXXXXXXXXGOOOOOOOOOOXXXXXXXXXGOOOOOOOOOOOOOOOXXXXGOOOOOOXXXXXXXXXXXXXGOOOOOOOOOOOOOXXXXXXGOOOOOXXXXXXXXXXXXXXGOOOOOOOOOOOXXXXXXXXGOOOOOOOOOOOOOOOXXXXGOOOOOXXXXXXXXXXXXXXGOOOOOOOXXXXXXXXXXXXGOOOOXXXXXXXXXXXXXXXGOOOOOOOOOOXXXXXXXXX,0,256,0
21861,130,0,130,97,113,0,0,273,139,134,GOOOOOOXXXXXXXXXXXXXGOOOOOOOOOOXXXXXXXXXGOOOOOOOOOOXXXXXXXXXGOOOOOOOOOOOOOOOXXXXGOOOOOOXXXXXXXXXXXXXGOOOOOOOOOOOOOXXXXXXGOOOOOXXXXXXXXXXXXXXGOOOOOOOOOOOXXXXXXXXGOOOOOOOOOOOOOOOXXXXGOOOOOXXXXXXXXXXXXXXGOOOOOOOXXXXXXXXXXXXGOOOOXXXXXXXXXXXXXXXGOOOOOOOOOOXXXXXXXXX,0,256,0
21882,130,0,130,93,117,0,0,278,143,135,GOOOOOOXXXXXXXXXXXXXGOOOOOOOOOOXXXXXXXXXGOOOOOOOOOOXXXXXXXXXGOOOOOOOOOOOOOOOXXXXGOOOOOOXXXXXXXXXXXXXGOOOOOOOOOOOOOXXXXXXGOOOOOXXXXXXXXXXXXXXGOOOOOOOOOOOXXXXXXXXGOOOOOOOOOOOOOOOXXXXGOOOOOXXXXXXXXXXXXXXGOOOOOOOXXXXXXXXXXXXGOOOOXXXXXXXXXXXXXXXGOOOOOOOOOOXXXXXXXXX,0,256,0
21903,130,0,130,102,108,0,0,269,139,130,GOOOOOOXXXXXXXXXXXXXGOOOOOOOOOOXXXXXXXXXGOOOOOOOOOOXXXXXXXXXGOOOOOOOOOOOOOOOXXXXGOOOOOOXXXXXXXXXXXXXGOOOOOOOOOOOOOXXXXXXGOOOOOXXXXXXXXXXXXXXGOOOOOOOOOOOXXXXXXXXGOOOOOOOOOOOOOOOXXXXGOOOOOXXXXXXXXXXXXXXGOOOOOOOXXXXXXXXXXXXGOOOOXXXXXXXXXXXXXXXGOOOOOOOOOOXXXXXXXXX,0,256,0
21924,130,0,130,102,108,0,0,269,134,135,GOOOOOOXXXXXXXXXXXXXGOOOOOOOOOOXXXXXXXXXGOOOOOOOOOOXXXXXXXXXGOOOOOOOOOOOOOOOXXXXGOOOOOOXXXXXXXXXXXXXGOOOOOOOOOOOOOXXXXXXGOOOOOXXXXXXXXXXXXXXGOOOOOOOOOOOXXXXXXXXGOOOOOOOOOOOOOOOXXXXGOOOOOXXXXXXXXXXXXXXGOOOOOOOXXXXXXXXXXXXGOOOOXXXXXXXXXXXXXXXGOOOOOOOOOOXXXXXXXXX,0,256,0

21945,130,0,130,107,103,0,0,264,128,136,GOOOOOOXXXXXXXXXXXXXGOOOOOOOOOOXXXXXXXXXGOOOOOOOOOOXXXXXXXXXGOOOOOOOOOOOOOOOXXXXGOOOOOOXXXXXXXXXXXXXGOOOOOOOOOOOOOXXXXXXGOOOOOXXXXXXXXXXXXXXGOOOOOOOOOOOXXXXXXXXGOOOOOOOOOOOOOOOXXXXGOOOOOXXXXXXXXXXXXXXGOOOOOOOXXXXXXXXXXXXGOOOOXXXXXXXXXXXXXXXGOOOOOOOOOOXXXXXXXXX,0,256,0
21966,130,0,130,96,114,0,0,273,132,141,GOOOOOOXXXXXXXXXXXXXGOOOOOOOOOOXXXXXXXXXGOOOOOOOOOOXXXXXXXXXGOOOOOOOOOOOOOOOXXXXGOOOOOOXXXXXXXXXXXXXGOOOOOOOOOOOOOXXXXXXGOOOOOXXXXXXXXXXXXXXGOOOOOOOOOOOXXXXXXXXGOOOOOOOOOOOOOOOXXXXGOOOOOXXXXXXXXXXXXXXGOOOOOOOXXXXXXXXXXXXGOOOOXXXXXXXXXXXXXXXGOOOOOOOOOOXXXXXXXXX,0,256,0
21987,130,0,130,96,114,0,0,274,129,145,GOOOOOOXXXXXXXXXXXXXGOOOOOOOOOOXXXXXXXXXGOOOOOOOOOOXXXXXXXXXGOOOOOOOOOOOOOOOXXXXGOOOOOOXXXXXXXXXXXXXGOOOOOOOOOOOOOXXXXXXGOOOOOXXXXXXXXXXXXXXGOOOOOOOOOOOXXXXXXXXGOOOOOOOOOOOOOOOXXXXGOOOOOXXXXXXXXXXXXXXGOOOOOOOXXXXXXXXXXXXGOOOOXXXXXXXXXXXXXXXGOOOOOOOOOOXXXXXXXXX,0,256,0
22008,130,0,130,95,115,0,0,275,126,149,GOOOOOOXXXXXXXXXXXXXGOOOOOOOOOOXXXXXXXXXGOOOOOOOOOOXXXXXXXXXGOOOOOOOOOOOOOOOXXXXGOOOOOOXXXXXXXXXXXXXGOOOOOOOOOOOOOXXXXXXGOOOOOXXXXXXXXXXXXXXGOOOOOOOOOOOXXXXXXXXGOOOOOOOOOOOOOOOXXXXGOOOOOXXXXXXXXXXXXXXGOOOOOOOXXXXXXXXXXXXGOOOOXXXXXXXXXXXXXXXGOOOOOOOOOOXXXXXXXXX,0,256,0
22029,130,0,130,101,109,0,0,268,126,142,GOOOOOOXXXXXXXXXXXXXGOOOOOOOOOOXXXXXXXXXGOOOOOOOOOOXXXXXXXXXGOOOOOOOOOOOOOOOXXXXGOOOOOOXXXXXXXXXXXXXGOOOOOOOOOOOOOXXXXXXGOOOOOXXXXXXXXXXXXXXGOOOOOOOOOOOXXXXXXXXGOOOOOOOOOOOOOOOXXXXGOOOOOXXXXXXXXXXXXXXGOOOOOOOXXXXXXXXXXXXGOOOOXXXXXXXXXXXXXXXGOOOOOOOOOOXXXXXXXXX,0,256,0

22050,130,0,130,95,115,0,0,275,131,144,GOOOOOOXXXXXXXXXXXXXGOOOOOOOOOOXXXXXXXXXGOOOOOOOOOOXXXXXXXXXGOOOOOOOOOOOOOOOXXXXGOOOOOOXXXXXXXXXXXXXGOOOOOOOOOOOOOXXXXXXGOOOOOXXXXXXXXXXXXXXGOOOOOOOOOOOXXXXXXXXGOOOOOOOOOOOOOOOXXXXGOOOOOXXXXXXXXXXXXXXGOOOOOOOXXXXXXXXXXXXGOOOOXXXXXXXXXXXXXXXGOOOOOOOOOOXXXXXXXXX,0,256,0
22071,130,0,130,96,114,0,0,274,127,147,GOOOOOOXXXXXXXXXXXXXGOOOOOOOOOOXXXXXXXXXGOOOOOOOOOOXXXXXXXXXGOOOOOOOOOOOOOOOXXXXGOOOOOOXXXXXXXXXXXXXGOOOOOOOOOOOOOXXXXXXGOOOOOXXXXXXXXXXXXXXGOOOOOOOOOOOXXXXXXXXGOOOOOOOOOOOOOOOXXXXGOOOOOXXXXXXXXXXXXXXGOOOOOOOXXXXXXXXXXXXGOOOOXXXXXXXXXXXXXXXGOOOOOOOOOOXXXXXXXXX,0,256,0
22092,130,0,130,100,110,0,0,270,126,144,GOOOOOOXXXXXXXXXXXXXGOOOOOOOOOOXXXXXXXXXGOOOOOOOOOOXXXXXXXXXGOOOOOOOOOOOOOOOXXXXGOOOOOOXXXXXXXXXXXXXGOOOOOOOOOOOOOXXXXXXGOOOOOXXXXXXXXXXXXXXGOOOOOOOOOOOXXXXXXXXGOOOOOOOOOOOOOOOXXXXGOOOOOXXXXXXXXXXXXXXGOOOOOOOXXXXXXXXXXXXGOOOOXXXXXXXXXXXXXXXGOOOOOOOOOOXXXXXXXXX,0,256,0
22113,130,0,130,98,112,0,0,270,130,140,GOOOOOOXXXXXXXXXXXXXGOOOOOOOOOOXXXXXXXXXGOOOOOOOOOOXXXXXXXXXGOOOOOOOOOOOOOOOXXXXGOOOOOOXXXXXXXXXXXXXGOOOOOOOOOOOOOXXXXXXGOOOOOXXXXXXXXXXXXXXGOOOOOOOOOOOXXXXXXXXGOOOOOOOOOOOOOOOXXXXGOOOOOXXXXXXXXXXXXXXGOOOOOOOXXXXXXXXXXXXGOOOOXXXXXXXXXXXXXXXGOOOOOOOOOOXXXXXXXXX,0,256,0
22134,130,0,130,96,114,0,0,274,128,146,GOOOOOOXXXXXXXXXXXXXGOOOOOOOOOOXXXXXXXXXGOOOOOOOOOOXXXXXXXXXGOOOOOOOOOOOOOOOXXXXGOOOOOOXXXXXXXXXXXXXGOOOOOOOOOOOOOXXXXXXGOOOOOXXXXXXXXXXXXXXGOOOOOOOOOOOXXXXXXXXGOOOOOOOOOOOOOOOXXXXGOOOOOXXXXXXXXXXXXXXGOOOOOOOXXXXXXXXXXXXGOOOOXXXXXXXXXXXXXXXGOOOOOOOOOOXXXXXXXXX,0,256,0

22155,130,0,130,87,123,0,0,283,130,153,GOOOOOOXXXXXXXXXXXXXGOOOOOOOOOOXXXXXXXXXGOOOOOOOOOOXXXXXXXXXGOOOOOOOOOOOOOOOXXXXGOOOOOOXXXXXXXXXXXXXGOOOOOOOOOOOOOXXXXXXGOOOOOXXXXXXXXXXXXXXGOOOOOOOOOOOXXXXXXXXGOOOOOOOOOOOOOOOXXXXGOOOOOXXXXXXXXXXXXXXGOOOOOOOXXXXXXXXXXXXGOOOOXXXXXXXXXXXXXXXGOOOOOOOOOOXXXXXXXXX,0,256,0
22176,130,0,130,88,122,0,0,281,129,152,GOOOOOOXXXXXXXXXXXXXGOOOOOOOOOOXXXXXXXXXGOOOOOOOOOOXXXXXXXXXGOOOOOOOOOOOOOOOXXXXGOOOOOOXXXXXXXXXXXXXGOOOOOOOOOOOOOXXXXXXGOOOOOXXXXXXXXXXXXXXGOOOOOOOOOOOXXXXXXXXGOOOOOOOOOOOOOOOXXXXGOOOOOXXXXXXXXXXXXXXGOOOOOOOXXXXXXXXXXXXGOOOOXXXXXXXXXXXXXXXGOOOOOOOOOOXXXXXXXXX,0,256,0
22197,130,0,130,90,120,0,0,279,126,153,GOOOOOOXXXXXXXXXXXXXGOOOOOOOOOOXXXXXXXXXGOOOOOOOOOOXXXXXXXXXGOOOOOOOOOOOOOOOXXXXGOOOOOOXXXXXXXXXXXXXGOOOOOOOOOOOOOXXXXXXGOOOOOXXXXXXXXXXXXXXGOOOOOOOOOOOXXXXXXXXGOOOOOOOOOOOOOOOXXXXGOOOOOXXXXXXXXXXXXXXGOOOOOOOXXXXXXXXXXXXGOOOOXXXXXXXXXXXXXXXGOOOOOOOOOOXXXXXXXXX,0,256,0
22218,130,0,130,88,122,0,0,282,125,157,GOOOOOOXXXXXXXXXXXXXGOOOOOOOOOOXXXXXXXXXGOOOOOOOOOOXXXXXXXXXGOOOOOOOOOOOOOOOXXXXGOOOOOOXXXXXXXXXXXXXGOOOOOOOOOOOOOXXXXXXGOOOOOXXXXXXXXXXXXXXGOOOOOOOOOOOXXXXXXXXGOOOOOOOOOOOOOOOXXXXGOOOOOXXXXXXXXXXXXXXGOOOOOOOXXXXXXXXXXXXGOOOOXXXXXXXXXXXXXXXGOOOOOOOOOOXXXXXXXXX,0,256,0
22239,130,0,130,85,125,0,0,285,131,154,GOOOOOOXXXXXXXXXXXXXGOOOOOOOOOOXXXXXXXXXGOOOOOOOOOOXXXXXXXXXGOOOOOOOOOOOOOOOXXXXGOOOOOOXXXXXXXXXXXXXGOOOOOOOOOOOOOXXXXXXGOOOOOXXXXXXXXXXXXXXGOOOOOOOOOOOXXXXXXXXGOOOOOOOOOOOOOOOXXXXGOOOOOXXXXXXXXXXXXXXGOOOOOOOXXXXXXXXXXXXGOOOOXXXXXXXXXXXXXXXGOOOOOOOOOOXXXXXXXXX,0,256,0

22260,130,0,130,89,121,0,0,281,128,153,GOOOOOOXXXXXXXXXXXXXGOOOOOOOOOOXXXXXXXXXGOOOOOOOOOOXXXXXXXXXGOOOOOOOOOOOOOOOXXXXGOOOOOOXXXXXXXXXXXXXGOOOOOOOOOOOOOXXXXXXGOOOOOXXXXXXXXXXXXXXGOOOOOOOOOOOXXXXXXXXGOOOOOOOOOOOOOOOXXXXGOOOOOXXXXXXXXXXXXXXGOOOOOOOXXXXXXXXXXXXGOOOOXXXXXXXXXXXXXXXGOOOOOOOOOOXXXXXXXXX,0,256,0
22281,130,0,130,96,114,0,0,274,124,150,GOOOOOOXXXXXXXXXXXXXGOOOOOOOOOOXXXXXXXXXGOOOOOOOOOOXXXXXXXXXGOOOOOOOOOOOOOOOXXXXGOOOOOOXXXXXXXXXXXXXGOOOOOOOOOOOOOXXXXXXGOOOOOXXXXXXXXXXXXXXGOOOOOOOOOOOXXXXXXXXGOOOOOOOOOOOOOOOXXXXGOOOOOXXXXXXXXXXXXXXGOOOOOOOXXXXXXXXXXXXGOOOOXXXXXXXXXXXXXXXGOOOOOOOOOOXXXXXXXXX,0,256,0
22302,130,0,130,89,121,0,0,281,132,149,GOOOOOOXXXXXXXXXXXXXGOOOOOOOOOOXXXXXXXXXGOOOOOOOOOOXXXXXXXXXGOOOOOOOOOOOOOOOXXXXGOOOOOOXXXXXXXXXXXXXGOOOOOOOOOOOOOXXXXXXGOOOOOXXXXXXXXXXXXXXGOOOOOOOOOOOXXXXXXXXGOOOOOOOOOOOOOOOXXXXGOOOOOXXXXXXXXXXXXXXGOOOOOOOXXXXXXXXXXXXGOOOOXXXXXXXXXXXXXXXGOOOOOOOOOOXXXXXXXXX,0,256,0
22323,130,0,130,86,124,0,0,283,138,145,GOOOOOOXXXXXXXXXXXXXGOOOOOOOOOOXXXXXXXXXGOOOOOOOOOOXXXXXXXXXGOOOOOOOOOOOOOOOXXXXGOOOOOOXXXXXXXXXXXXXGOOOOOOOOOOOOOXXXXXXGOOOOOXXXXXXXXXXXXXXGOOOOOOOOOOOXXXXXXXXGOOOOOOOOOOOOOOOXXXXGOOOOOXXXXXXXXXXXXXXGOOOOOOOXXXXXXXXXXXXGOOOOXXXXXXXXXXXXXXXGOOOOOOOOOOXXXXXXXXX,0,256,0
22344,130,0,130,88,122,0,0,282,137,145,GOOOOOOXXXXXXXXXXXXXGOOOOOOOOOOXXXXXXXXXGOOOOOOOOOOXXXXXXXXXGOOOOOOOOOOOOOOOXXXXGOOOOOOXXXXXXXXXXXXXGOOOOOOOOOOOOOXXXXXXGOOOOOXXXXXXXXXXXXXXGOOOOOOOOOOOXXXXXXXXGOOOOOOOOOOOOOOOXXXXGOOOOOXXXXXXXXXXXXXXGOOOOOOOXXXXXXXXXXXXGOOOOXXXXXXXXXXXXXXXGOOOOOOOOOOXXXXXXXXX,0,256,0

22365,130,0,130,90,120,0,0,280,135,145,GOOOOOOXXXXXXXXXXXXXGOOOOOOOOOOXXXXXXXXXGOOOOOOOOOOXXXXXXXXXGOOOOOOOOOOOOOOOXXXXGOOOOOOXXXXXXXXXXXXXGOOOOOOOOOOOOOXXXXXXGOOOOOXXXXXXXXXXXXXXGOOOOOOOOOOOXXXXXXXXGOOOOOOOOOOOOOOOXXXXGOOOOOXXXXXXXXXXXXXXGOOOOOOOXXXXXXXXXXXXGOOOOXXXXXXXXXXXXXXXGOOOOOOOOOOXXXXXXXXX,0,256,0
22386,130,0,130,91,119,0,0,279,129,150,GOOOOOOXXXXXXXXXXXXXGOOOOOOOOOOXXXXXXXXXGOOOOOOOOOOXXXXXXXXXGOOOOOOOOOOOOOOOXXXXGOOOOOOXXXXXXXXXXXXXGOOOOOOOOOOOOOXXXXXXGOOOOOXXXXXXXXXXXXXXGOOOOOOOOOOOXXXXXXXXGOOOOOOOOOOOOOOOXXXXGOOOOOXXXXXXXXXXXXXXGOOOOOOOXXXXXXXXXXXXGOOOOXXXXXXXXXXXXXXXGOOOOOOOOOOXXXXXXXXX,0,256,0
22407,130,0,130,87,123,0,0,282,131,151,GOOOOOOXXXXXXXXXXXXXGOOOOOOOOOOXXXXXXXXXGOOOOOOOOOOXXXXXXXXXGOOOOOOOOOOOOOOOXXXXGOOOOOOXXXXXXXXXXXXXGOOOOOOOOOOOOOXXXXXXGOOOOOXXXXXXXXXXXXXXGOOOOOOOOOOOXXXXXXXXGOOOOOOOOOOOOOOOXXXXGOOOOOXXXXXXXXXXXXXXGOOOOOOOXXXXXXXXXXXXGOOOOXXXXXXXXXXXXXXXGOOOOOOOOOOXXXXXXXXX,0,256,0
22428,130,0,130,88,122,0,0,282,129,153,GOOOOOOXXXXXXXXXXXXXGOOOOOOOOOOXXXXXXXXXGOOOOOOOOOOXXXXXXXXXGOOOOOOOOOOOOOOOXXXXGOOOOOOXXXXXXXXXXXXXGOOOOOOOOOOOOOXXXXXXGOOOOOXXXXXXXXXXXXXXGOOOOOOOOOOOXXXXXXXXGOOOOOOOOOOOOOOOXXXXGOOOOOXXXXXXXXXXXXXXGOOOOOOOXXXXXXXXXXXXGOOOOXXXXXXXXXXXXXXXGOOOOOOOOOOXXXXXXXXX,0,256,0
22449,130,0,130,84,126,0,0,286,128,158,GOOOOOOXXXXXXXXXXXXXGOOOOOOOOOOXXXXXXXXXGOOOOOOOOOOXXXXXXXXXGOOOOOOOOOOOOOOOXXXXGOOOOOOXXXXXXXXXXXXXGOOOOOOOOOOOOOXXXXXXGOOOOOXXXXXXXXXXXXXXGOOOOOOOOOOOXXXXXXXXGOOOOOOOOOOOOOOOXXXXGOOOOOXXXXXXXXXXXXXXGOOOOOOOXXXXXXXXXXXXGOOOOXXXXXXXXXXXXXXXGOOOOOOOOOOXXXXXXXXX,0,256,0

22470,130,0,130,84,126,0,0,286,130,156,GOOOOOOXXXXXXXXXXXXXGOOOOOOOOOOXXXXXXXXXGOOOOOOOOOOXXXXXXXXXGOOOOOOOOOOOOOOOXXXXGOOOOOOXXXXXXXXXXXXXGOOOOOOOOOOOOOXXXXXXGOOOOOXXXXXXXXXXXXXXGOOOOOOOOOOOXXXXXXXXGOOOOOOOOOOOOOOOXXXXGOOOOOXXXXXXXXXXXXXXGOOOOOOOXXXXXXXXXXXXGOOOOXXXXXXXXXXXXXXXGOOOOOOOOOOXXXXXXXXX,0,256,0
22491,130,0,130,84,126,0,0,286,137,149,GOOOOOOXXXXXXXXXXXXXGOOOOOOOOOOXXXXXXXXXGOOOOOOOOOOXXXXXXXXXGOOOOOOOOOOOOOOOXXXXGOOOOOOXXXXXXXXXXXXXGOOOOOOOOOOOOOXXXXXXGOOOOOXXXXXXXXXXXXXXGOOOOOOOOOOOXXXXXXXXGOOOOOOOOOOOOOOOXXXXGOOOOOXXXXXXXXXXXXXXGOOOOOOOXXXXXXXXXXXXGOOOOXXXXXXXXXXXXXXXGOOOOOOOOOOXXXXXXXXX,0,256,0
22512,130,0,130,83,127,0,0,287,141,146,GOOOOOOXXXXXXXXXXXXXGOOOOOOOOOOXXXXXXXXXGOOOOOOOOOOXXXXXXXXXGOOOOOOOOOOOOOOOXXXXGOOOOOOXXXXXXXXXXXXXGOOOOOOOOOOOOOXXXXXXGOOOOOXXXXXXXXXXXXXXGOOOOOOOOOOOXXXXXXXXGOOOOOOOOOOOOOOOXXXXGOOOOOXXXXXXXXXXXXXXGOOOOOOOXXXXXXXXXXXXGOOOOXXXXXXXXXXXXXXXGOOOOOOOOOOXXXXXXXXX,0,256,0
22533,130,0,130,90,120,0,0,280,139,141,GOOOOOOXXXXXXXXXXXXXGOOOOOOOOOOXXXXXXXXXGOOOOOOOOOOXXXXXXXXXGOOOOOOOOOOOOOOOXXXXGOOOOOOXXXXXXXXXXXXXGOOOOOOOOOOOOOXXXXXXGOOOOOXXXXXXXXXXXXXXGOOOOOOOOOOOXXXXXXXXGOOOOOOOOOOOOOOOXXXXGOOOOOXXXXXXXXXXXXXXGOOOOOOOXXXXXXXXXXXXGOOOOXXXXXXXXXXXXXXXGOOOOOOOOOOXXXXXXXXX,0,256,0
22554,130,0,130,91,119,0,0,278,140,138,GOOOOOOXXXXXXXXXXXXXGOOOOOOOOOOXXXXXXXXXGOOOOOOOOOOXXXXXXXXXGOOOOOOOOOOOOOOOXXXXGOOOOOOXXXXXXXXXXXXXGOOOOOOOOOOOOOXXXXXXGOOOOOXXXXXXXXXXXXXXGOOOOOOOOOOOXXXXXXXXGOOOOOOOOOOOOOOOXXXXGOOOOOXXXXXXXXXXXXXXGOOOOOOOXXXXXXXXXXXXGOOOOXXXXXXXXXXXXXXXGOOOOOOOOOOXXXXXXXXX,0,256,0

22575,130,0,130,92,118,0,0,278,133,145,GOOOOOOXXXXXXXXXXXXXGOOOOOOOOOOXXXXXXXXXGOOOOOOOOOOXXXXXXXXXGOOOOOOOOOOOOOOOXXXXGOOOOOOXXXXXXXXXXXXXGOOOOOOOOOOOOOXXXXXXGOOOOOXXXXXXXXXXXXXXGOOOOOOOOOOOXXXXXXXXGOOOOOOOOOOOOOOOXXXXGOOOOOXXXXXXXXXXXXXXGOOOOOOOXXXXXXXXXXXXGOOOOXXXXXXXXXXXXXXXGOOOOOOOOOOXXXXXXXXX,0,256,0
22596,130,0,130,94,116,0,0,276,135,141,GOOOOOOXXXXXXXXXXXXXGOOOOOOOOOOXXXXXXXXXGOOOOOOOOOOXXXXXXXXXGOOOOOOOOOOOOOOOXXXXGOOOOOOXXXXXXXXXXXXXGOOOOOOOOOOOOOXXXXXXGOOOOOXXXXXXXXXXXXXXGOOOOOOOOOOOXXXXXXXXGOOOOOOOOOOOOOOOXXXXGOOOOOXXXXXXXXXXXXXXGOOOOOOOXXXXXXXXXXXXGOOOOXXXXXXXXXXXXXXXGOOOOOOOOOOXXXXXXXXX,0,256,0
22617,131,1,130,90,119,0,0,279,138,141,GOOOOOOXXXXXXXXXXXXXGOOOOOOOOOOXXXXXXXXXGOOOOOOOOOOXXXXXXXXXGOOOOOOOOOOOOOOOXXXXGOOOOOOXXXXXXXXXXXXXGOOOOOOOOOOOOOXXXXXXGOOOOOXXXXXXXXXXXXXXGOOOOOOOOOOOXXXXXXXXGOOOOOOOOOOOOOOOXXXXGOOOOOXXXXXXXXXXXXXXGOOOOOOOAXXXXXXXXXXXGOOOOXXXXXXXXXXXXXXXGOOOOOOOOOOXXXXXXXXX,0,256,0
22638,131,1,130,94,115,0,0,276,138,138,GOOOOOOXXXXXXXXXXXXXGOOOOOOOOOOXXXXXXXXXGOOOOOOOOOOXXXXXXXXXGOOOOOOOOOOOOOOOXXXXGOOOOOOXXXXXXXXXXXXXGOOOOOOOOOOOOOXXXXXXGOOOOOXXXXXXXXXXXXXXGOOOOOOOOOOOXXXXXXXXGOOOOOOOOOOOOOOOXXXXGOOOOOXXXXXXXXXXXXXXGOOOOOOOAXXXXXXXXXXXGOOOOXXXXXXXXXXXXXXXGOOOOOOOOOOXXXXXXXXX,0,256,0
22659,131,1,130,95,114,0,0,273,139,134,GOOOOOOXXXXXXXXXXXXXGOOOOOOOOOOXXXXXXXXXGOOOOOOOOOOXXXXXXXXXGOOOOOOOOOOOOOOOXXXXGOOOOOOXXXXXXXXXXXXXGOOOOOOOOOOOOOXXXXXXGOOOOOXXXXXXXXXXXXXXGOOOOOOOOOOOXXXXXXXXGOOOOOOOOOOOOOOOXXXXGOOOOOXXXXXXXXXXXXXXGOOOOOOOAXXXXXXXXXXXGOOOOXXXXXXXXXXXXXXXGOOOOOOOOOOXXXXXXXXX,0,256,0

22680,131,1,130,99,110,0,0,271,132,139,GOOOOOOXXXXXXXXXXXXXGOOOOOOOOOOXXXXXXXXXGOOOOOOOOOOXXXXXXXXXGOOOOOOOOOOOOOOOXXXXGOOOOOOXXXXXXXXXXXXXGOOOOOOOOOOOOOXXXXXXGOOOOOXXXXXXXXXXXXXXGOOOOOOOOOOOXXXXXXXXGOOOOOOOOOOOOOOOXXXXGOOOOOXXXXXXXXXXXXXXGOOOOOOOAXXXXXXXXXXXGOOOOXXXXXXXXXXXXXXXGOOOOOOOOOOXXXXXXXXX,0,256,0
22701,131,1,130,102,107,0,0,268,135,133,GOOOOOOXXXXXXXXXXXXXGOOOOOOOOOOXXXXXXXXXGOOOOOOOOOOXXXXXXXXXGOOOOOOOOOOOOOOOXXXXGOOOOOOXXXXXXXXXXXXXGOOOOOOOOOOOOOXXXXXXGOOOOOXXXXXXXXXXXXXXGOOOOOOOOOOOXXXXXXXXGOOOOOOOOOOOOOOOXXXXGOOOOOXXXXXXXXXXXXXXGOOOOOOOAXXXXXXXXXXXGOOOOXXXXXXXXXXXXXXXGOOOOOOOOOOXXXXXXXXX,0,256,0
22722,131,0,131,102,107,0,0,266,133,133,GOOOOOOXXXXXXXXXXXXXGOOOOOOOOOOXXXXXXXXXGOOOOOOOOOOXXXXXXXXXGOOOOOOOOOOOOOOOXXXXGOOOOOOXXXXXXXXXXXXXGOOOOOOOOOOOOOXXXXXXGOOOOOXXXXXXXXXXXXXXGOOOOOOOOOOOXXXXXXXXGOOOOOOOOOOOOOOOXXXXGOOOOOXXXXXXXXXXXXXXGOOOOOOOOXXXXXXXXXXXGOOOOXXXXXXXXXXXXXXXGOOOOOOOOOOXXXXXXXXX,0,256,0
22743,131,0,131,102,107,0,0,266,132,134,GOOOOOOXXXXXXXXXXXXXGOOOOOOOOOOXXXXXXXXXGOOOOOOOOOOXXXXXXXXXGOOOOOOOOOOOOOOOXXXXGOOOOOOXXXXXXXXXXXXXGOOOOOOOOOOOOOXXXXXXGOOOOOXXXXXXXXXXXXXXGOOOOOOOOOOOXXXXXXXXGOOOOOOOOOOOOOOOXXXXGOOOOOXXXXXXXXXXXXXXGOOOOOOOOXXXXXXXXXXXGOOOOXXXXXXXXXXXXXXXGOOOOOOOOOOXXXXXXXXX,0,256,0
22764,131,0,131,100,109,0,0,269,131,138,GOOOOOOXXXXXXXXXXXXXGOOOOOOOOOOXXXXXXXXXGOOOOOOOOOOXXXXXXXXXGOOOOOOOOOOOOOOOXXXXGOOOOOOXXXXXXXXXXXXXGOOOOOOOOOOOOOXXXXXXGOOOOOXXXXXXXXXXXXXXGOOOOOOOOOOOXXXXXXXXGOOOOOOOOOOOOOOOXXXXGOOOOOXXXXXXXXXXXXXXGOOOOOOOOXXXXXXXXXXXGOOOOXXXXXXXXXXXXXXXGOOOOOOOOOOXXXXXXXXX,0,256,0

22785,132,1,131,98,110,0,0,270,134,136,GOOOOOOXXXXXXXXXXXXXGOOOOOOOOOOXXXXXXXXXGOOOOOOOOOOXXXXXXXXXGOOOOOOOOOOOOOOOXXXXGOOOOOOXXXXXXXXXXXXXGOOOOOOOOOOOOOXXXXXXGOOOOOAXXXXXXXXXXXXXGOOOOOOOOOOOXXXXXXXXGOOOOOOOOOOOOOOOXXXXGOOOOOXXXXXXXXXXXXXXGOOOOOOOOXXXXXXXXXXXGOOOOXXXXXXXXXXXXXXXGOOOOOOOOOOXXXXXXXXX,0,256,0
22806,132,1,131,98,110,0,0,270,135,135,GOOOOOOXXXXXXXXXXXXXGOOOOOOOOOOXXXXXXXXXGOOOOOOOOOOXXXXXXXXXGOOOOOOOOOOOOOOOXXXXGOOOOOOXXXXXXXXXXXXXGOOOOOOOOOOOOOXXXXXXGOOOOOAXXXXXXXXXXXXXGOOOOOOOOOOOXXXXXXXXGOOOOOOOOOOOOOOOXXXXGOOOOOXXXXXXXXXXXXXXGOOOOOOOOXXXXXXXXXXXGOOOOXXXXXXXXXXXXXXXGOOOOOOOOOOXXXXXXXXX,0,256,0
22827,132,1,131,99,109,0,0,269,133,136,GOOOOOOXXXXXXXXXXXXXGOOOOOOOOOOXXXXXXXXXGOOOOOOOOOOXXXXXXXXXGOOOOOOOOOOOOOOOXXXXGOOOOOOXXXXXXXXXXXXXGOOOOOOOOOOOOOXXXXXXGOOOOOAXXXXXXXXXXXXXGOOOOOOOOOOOXXXXXXXXGOOOOOOOOOOOOOOOXXXXGOOOOOXXXXXXXXXXXXXXGOOOOOOOOXXXXXXXXXXXGOOOOXXXXXXXXXXXXXXXGOOOOOOOOOOXXXXXXXXX,0,256,0
22848,132,0,132,95,113,0,0,271,132,139,GOOOOOOXXXXXXXXXXXXXGOOOOOOOOOOXXXXXXXXXGOOOOOOOOOOXXXXXXXXXGOOOOOOOOOOOOOOOXXXXGOOOOOOXXXXXXXXXXXXXGOOOOOOOOOOOOOXXXXXXGOOOOOOXXXXXXXXXXXXXGOOOOOOOOOOOXXXXXXXXGOOOOOOOOOOOOOOOXXXXGOOOOOXXXXXXXXXXXXXXGOOOOOOOOXXXXXXXXXXXGOOOOXXXXXXXXXXXXXXXGOOOOOOOOOOXXXXXXXXX,0,256,0
22869,132,0,132,96,112,0,0,272,131,141,GOOOOOOXXXXXXXXXXXXXGOOOOOOOOOOXXXXXXXXXGOOOOOOOOOOXXXXXXXXXGOOOOOOOOOOOOOOOXXXXGOOOOOOXXXXXXXXXXXXXGOOOOOOOOOOOOOXXXXXXGOOOOOOXXXXXXXXXXXXXGOOOOOOOOOOOXXXXXXXXGOOOOOOOOOOOOOOOXXXXGOOOOOXXXXXXXXXXXXXXGOOOOOOOOXXXXXXXXXXXGOOOOXXXXXXXXXXXXXXXGOOOOOOOOOOXXXXXXXXX,0,256,0

22890,132,0,132,97,111,0,0,270,131,139,GOOOOOOXXXXXXXXXXXXXGOOOOOOOOOOXXXXXXXXXGOOOOOOOOOOXXXXXXXXXGOOOOOOOOOOOOOOOXXXXGOOOOOOXXXXXXXXXXXXXGOOOOOOOOOOOOOXXXXXXGOOOOOOXXXXXXXXXXXXXGOOOOOOOOOOOXXXXXXXXGOOOOOOOOOOOOOOOXXXXGOOOOOXXXXXXXXXXXXXXGOOOOOOOOXXXXXXXXXXXGOOOOXXXXXXXXXXXXXXXGOOOOOOOOOOXXXXXXXXX,0,256,0
22911,132,0,132,99,109,0,0,269,129,140,GOOOOOOXXXXXXXXXXXXXGOOOOOOOOOOXXXXXXXXXGOOOOOOOOOOXXXXXXXXXGOOOOOOOOOOOOOOOXXXXGOOOOOOXXXXXXXXXXXXXGOOOOOOOOOOOOOXXXXXXGOOOOOOXXXXXXXXXXXXXGOOOOOOOOOOOXXXXXXXXGOOOOOOOOOOOOOOOXXXXGOOOOOXXXXXXXXXXXXXXGOOOOOOOOXXXXXXXXXXXGOOOOXXXXXXXXXXXXXXXGOOOOOOOOOOXXXXXXXXX,0,256,0
22932,132,0,132,96,112,0,0,272,130,142,GOOOOOOXXXXXXXXXXXXXGOOOOOOOOOOXXXXXXXXXGOOOOOOOOOOXXXXXXXXXGOOOOOOOOOOOOOOOXXXXGOOOOOOXXXXXXXXXXXXXGOOOOOOOOOOOOOXXXXXXGOOOOOOXXXXXXXXXXXXXGOOOOOOOOOOOXXXXXXXXGOOOOOOOOOOOOOOOXXXXGOOOOOXXXXXXXXXXXXXXGOOOOOOOOXXXXXXXXXXXGOOOOXXXXXXXXXXXXXXXGOOOOOOOOOOXXXXXXXXX,0,256,0
22953,132,0,132,94,114,0,0,273,131,142,GOOOOOOXXXXXXXXXXXXXGOOOOOOOOOOXXXXXXXXXGOOOOOOOOOOXXXXXXXXXGOOOOOOOOOOOOOOOXXXXGOOOOOOXXXXXXXXXXXXXGOOOOOOOOOOOOOXXXXXXGOOOOOOXXXXXXXXXXXXXGOOOOOOOOOOOXXXXXXXXGOOOOOOOOOOOOOOOXXXXGOOOOOXXXXXXXXXXXXXXGOOOOOOOOXXXXXXXXXXXGOOOOXXXXXXXXXXXXXXXGOOOOOOOOOOXXXXXXXXX,0,256,0
22974,132,0,132,91,117,0,0,277,133,144,GOOOOOOXXXXXXXXXXXXXGOOOOOOOOOOXXXXXXXXXGOOOOOOOOOOXXXXXXXXXGOOOOOOOOOOOOOOOXXXXGOOOOOOXXXXXXXXXXXXXGOOOOOOOOOOOOOXXXXXXGOOOOOOXXXXXXXXXXXXXGOOOOOOOOOOOXXXXXXXXGOOOOOOOOOOOOOOOXXXXGOOOOOXXXXXXXXXXXXXXGOOOOOOOOXXXXXXXXXXXGOOOOXXXXXXXXXXXXXXXGOOOOOOOOOOXXXXXXXXX,0,256,0

22995,132,0,132,94,114,0,0,275,131,144,GOOOOOOXXXXXXXXXXXXXGOOOOOOOOOOXXXXXXXXXGOOOOOOOOOOXXXXXXXXXGOOOOOOOOOOOOOOOXXXXGOOOOOOXXXXXXXXXXXXXGOOOOOOOOOOOOOXXXXXXGOOOOOOXXXXXXXXXXXXXGOOOOOOOOOOOXXXXXXXXGOOOOOOOOOOOOOOOXXXXGOOOOOXXXXXXXXXXXXXXGOOOOOOOOXXXXXXXXXXXGOOOOXXXXXXXXXXXXXXXGOOOOOOOOOOXXXXXXXXX,0,256,0
23016,132,0,132,89,119,0,0,280,135,145,GOOOOOOXXXXXXXXXXXXXGOOOOOOOOOOXXXXXXXXXGOOOOOOOOOOXXXXXXXXXGOOOOOOOOOOOOOOOXXXXGOOOOOOXXXXXXXXXXXXXGOOOOOOOOOOOOOXXXXXXGOOOOOOXXXXXXXXXXXXXGOOOOOOOOOOOXXXXXXXXGOOOOOOOOOOOOOOOXXXXGOOOOOXXXXXXXXXXXXXXGOOOOOOOOXXXXXXXXXXXGOOOOXXXXXXXXXXXXXXXGOOOOOOOOOOXXXXXXXXX,0,256,0
23037,132,0,132,94,114,0,0,275,133,142,GOOOOOOXXXXXXXXXXXXXGOOOOOOOOOOXXXXXXXXXGOOOOOOOOOOXXXXXXXXXGOOOOOOOOOOOOOOOXXXXGOOOOOOXXXXXXXXXXXXXGOOOOOOOOOOOOOXXXXXXGOOOOOOXXXXXXXXXXXXXGOOOOOOOOOOOXXXXXXXXGOOOOOOOOOOOOOOOXXXXGOOOOOXXXXXXXXXXXXXXGOOOOOOOOXXXXXXXXXXXGOOOOXXXXXXXXXXXXXXXGOOOOOOOOOOXXXXXXXXX,0,256,0
23058,133,1,132,91,116,0,0,276,136,140,GOOOOOOXXXXXXXXXXXXXGOOOOOOOOOOXXXXXXXXXGOOOOOOOOOOXXXXXXXXXGOOOOOOOOOOOOOOOXXXXGOOOOOOXXXXXXXXXXXXXGOOOOOOOOOOOOOAXXXXXGOOOOOOXXXXXXXXXXXXXGOOOOOOOOOOOXXXXXXXXGOOOOOOOOOOOOOOOXXXXGOOOOOXXXXXXXXXXXXXXGOOOOOOOOXXXXXXXXXXXGOOOOXXXXXXXXXXXXXXXGOOOOOOOOOOXXXXXXXXX,0,256,0
23079,133,1,132,95,112,0,0,272,139,133,GOOOOOOXXXXXXXXXXXXXGOOOOOOOOOOXXXXXXXXXGOOOOOOOOOOXXXXXXXXXGOOOOOOOOOOOOOOOXXXXGOOOOOOXXXXXXXXXXXXXGOOOOOOOOOOOOOAXXXXXGOOOOOOXXXXXXXXXXXXXGOOOOOOOOOOOXXXXXXXXGOOOOOOOOOOOOOOOXXXXGOOOOOXXXXXXXXXXXXXXGOOOOOOOOXXXXXXXXXXXGOOOOXXXXXXXXXXXXXXXGOOOOOOOOOOXXXXXXXXX,0,256,0

23100,133,1,132,96,111,0,0,271,140,131,GOOOOOOXXXXXXXXXXXXXGOOOOOOOOOOXXXXXXXXXGOOOOOOOOOOXXXXXXXXXGOOOOOOOOOOOOOOOXXXXGOOOOOOXXXXXXXXXXXXXGOOOOOOOOOOOOOAXXXXXGOOOOOOXXXXXXXXXXXXXGOOOOOOOOOOOXXXXXXXXGOOOOOOOOOOOOOOOXXXXGOOOOOXXXXXXXXXXXXXXGOOOOOOOOXXXXXXXXXXXGOOOOXXXXXXXXXXXXXXXGOOOOOOOOOOXXXXXXXXX,0,256,0
23121,133,1,132,101,106,0,0,266,133,133,GOOOOOOXXXXXXXXXXXXXGOOOOOOOOOOXXXXXXXXXGOOOOOOOOOOXXXXXXXXXGOOOOOOOOOOOOOOOXXXXGOOOOOOXXXXXXXXXXXXXGOOOOOOOOOOOOOAXXXXXGOOOOOOXXXXXXXXXXXXXGOOOOOOOOOOOXXXXXXXXGOOOOOOOOOOOOOOOXXXXGOOOOOXXXXXXXXXXXXXXGOOOOOOOOXXXXXXXXXXXGOOOOXXXXXXXXXXXXXXXGOOOOOOOOOOXXXXXXXXX,0,256,0
23142,133,1,132,105,102,0,0,261,135,126,GOOOOOOXXXXXXXXXXXXXGOOOOOOOOOOXXXXXXXXXGOOOOOOOOOOXXXXXXXXXGOOOOOOOOOOOOOOOXXXXGOOOOOOXXXXXXXXXXXXXGOOOOOOOOOOOOOAXXXXXGOOOOOOXXXXXXXXXXXXXGOOOOOOOOOOOXXXXXXXXGOOOOOOOOOOOOOOOXXXXGOOOOOXXXXXXXXXXXXXXGOOOOOOOOXXXXXXXXXXXGOOOOXXXXXXXXXXXXXXXGOOOOOOOOOOXXXXXXXXX,0,256,0
23163,133,1,132,101,106,0,0,265,134,131,GOOOOOOXXXXXXXXXXXXXGOOOOOOOOOOXXXXXXXXXGOOOOOOOOOOXXXXXXXXXGOOOOOOOOOOOOOOOXXXXGOOOOOOXXXXXXXXXXXXXGOOOOOOOOOOOOOAXXXXXGOOOOOOXXXXXXXXXXXXXGOOOOOOOOOOOXXXXXXXXGOOOOOOOOOOOOOOOXXXXGOOOOOXXXXXXXXXXXXXXGOOOOOOOOXXXXXXXXXXXGOOOOXXXXXXXXXXXXXXXGOOOOOOOOOOXXXXXXXXX,0,256,0
23184,133,1,132,104,103,0,0,263,132,131,GOOOOOOXXXXXXXXXXXXXGOOOOOOOOOOXXXXXXXXXGOOOOOOOOOOXXXXXXXXXGOOOOOOOOOOOOOOOXXXXGOOOOOOXXXXXXXXXXXXXGOOOOOOOOOOOOOAXXXXXGOOOOOOXXXXXXXXXXXXXGOOOOOOOOOOOXXXXXXXXGOOOOOOOOOOOOOOOXXXXGOOOOOXXXXXXXXXXXXXXGOOOOOOOOXXXXXXXXXXXGOOOOXXXXXXXXXXXXXXXGOOOOOOOOOOXXXXXXXXX,0,256,0

23205,133,1,132,100,107,0,0,267,133,134,GOOOOOOXXXXXXXXXXXXXGOOOOOOOOOOXXXXXXXXXGOOOOOOOOOOXXXXXXXXXGOOOOOOOOOOOOOOOXXXXGOOOOOOXXXXXXXXXXXXXGOOOOOOOOOOOOOAXXXXXGOOOOOOXXXXXXXXXXXXXGOOOOOOOOOOOXXXXXXXXGOOOOOOOOOOOOOOOXXXXGOOOOOXXXXXXXXXXXXXXGOOOOOOOOXXXXXXXXXXXGOOOOXXXXXXXXXXXXXXXGOOOOOOOOOOXXXXXXXXX,0,256,0
23226,133,0,133,101,106,0,0,265,131,134,GOOOOOOXXXXXXXXXXXXXGOOOOOOOOOOXXXXXXXXXGOOOOOOOOOOXXXXXXXXXGOOOOOOOOOOOOOOOXXXXGOOOOOOXXXXXXXXXXXXXGOOOOOOOOOOOOOOXXXXXGOOOOOOXXXXXXXXXXXXXGOOOOOOOOOOOXXXXXXXXGOOOOOOOOOOOOOOOXXXXGOOOOOXXXXXXXXXXXXXXGOOOOOOOOXXXXXXXXXXXGOOOOXXXXXXXXXXXXXXXGOOOOOOOOOOXXXXXXXXX,0,256,0
23247,133,0,133,101,106,0,0,265,128,137,GOOOOOOXXXXXXXXXXXXXGOOOOOOOOOOXXXXXXXXXGOOOOOOOOOOXXXXXXXXXGOOOOOOOOOOOOOOOXXXXGOOOOOOXXXXXXXXXXXXXGOOOOOOOOOOOOOOXXXXXGOOOOOOXXXXXXXXXXXXXGOOOOOOOOOOOXXXXXXXXGOOOOOOOOOOOOOOOXXXXGOOOOOXXXXXXXXXXXXXXGOOOOOOOOXXXXXXXXXXXGOOOOXXXXXXXXXXXXXXXGOOOOOOOOOOXXXXXXXXX,0,256,0
23268,133,0,133,99,108,0,0,267,130,137,GOOOOOOXXXXXXXXXXXXXGOOOOOOOOOOXXXXXXXXXGOOOOOOOOOOXXXXXXXXXGOOOOOOOOOOOOOOOXXXXGOOOOOOXXXXXXXXXXXXXGOOOOOOOOOOOOOOXXXXXGOOOOOOXXXXXXXXXXXXXGOOOOOOOOOOOXXXXXXXXGOOOOOOOOOOOOOOOXXXXGOOOOOXXXXXXXXXXXXXXGOOOOOOOOXXXXXXXXXXXGOOOOXXXXXXXXXXXXXXXGOOOOOOOOOOXXXXXXXXX,0,256,0
23289,133,0,133,94,113,0,0,272,135,137,GOOOOOOXXXXXXXXXXXXXGOOOOOOOOOOXXXXXXXXXGOOOOOOOOOOXXXXXXXXXGOOOOOOOOOOOOOOOXXXXGOOOOOOXXXXXXXXXXXXXGOOOOOOOOOOOOOOXXXXXGOOOOOOXXXXXXXXXXXXXGOOOOOOOOOOOXXXXXXXXGOOOOOOOOOOOOOOOXXXXGOOOOOXXXXXXXXXXXXXXGOOOOOOOOXXXXXXXXXXXGOOOOXXXXXXXXXXXXXXXGOOOOOOOOOOXXXXXXXXX,0,256,0

23310,133,0,133,94,113,0,0,273,133,140,GOOOOOOXXXXXXXXXXXXXGOOOOOOOOOOXXXXXXXXXGOOOOOOOOOOXXXXXXXXXGOOOOOOOOOOOOOOOXXXXGOOOOOOXXXXXXXXXXXXXGOOOOOOOOOOOOOOXXXXXGOOOOOOXXXXXXXXXXXXXGOOOOOOOOOOOXXXXXXXXGOOOOOOOOOOOOOOOXXXXGOOOOOXXXXXXXXXXXXXXGOOOOOOOOXXXXXXXXXXXGOOOOXXXXXXXXXXXXXXXGOOOOOOOOOOXXXXXXXXX,0,256,0
23331,133,0,133,86,121,0,0,281,131,150,GOOOOOOXXXXXXXXXXXXXGOOOOOOOOOOXXXXXXXXXGOOOOOOOOOOXXXXXXXXXGOOOOOOOOOOOOOOOXXXXGOOOOOOXXXXXXXXXXXXXGOOOOOOOOOOOOOOXXXXXGOOOOOOXXXXXXXXXXXXXGOOOOOOOOOOOXXXXXXXXGOOOOOOOOOOOOOOOXXXXGOOOOOXXXXXXXXXXXXXXGOOOOOOOOXXXXXXXXXXXGOOOOXXXXXXXXXXXXXXXGOOOOOOOOOOXXXXXXXXX,0,256,0
23352,134,1,133,91,115,0,0,276,132,144,GOOOOOOXXXXXXXXXXXXXGOOOOOOOOOOXXXXXXXXXGOOOOOOOOOOXXXXXXXXXGOOOOOOOOOOOOOOOXXXXGOOOOOOXXXXXXXXXXXXXGOOOOOOOOOOOOOOXXXXXGOOOOOOAXXXXXXXXXXXXGOOOOOOOOOOOXXXXXXXXGOOOOOOOOOOOOOOOXXXXGOOOOOXXXXXXXXXXXXXXGOOOOOOOOXXXXXXXXXXXGOOOOXXXXXXXXXXXXXXXGOOOOOOOOOOXXXXXXXXX,0,256,0
23373,134,1,133,90,116,0,0,277,131,146,GOOOOOOXXXXXXXXXXXXXGOOOOOOOOOOXXXXXXXXXGOOOOOOOOOOXXXXXXXXXGOOOOOOOOOOOOOOOXXXXGOOOOOOXXXXXXXXXXXXXGOOOOOOOOOOOOOOXXXXXGOOOOOOAXXXXXXXXXXXXGOOOOOOOOOOOXXXXXXXXGOOOOOOOOOOOOOOOXXXXGOOOOOXXXXXXXXXXXXXXGOOOOOOOOXXXXXXXXXXXGOOOOXXXXXXXXXXXXXXXGOOOOOOOOOOXXXXXXXXX,0,256,0
23394,134,1,133,91,115,0,0,276,135,141,GOOOOOOXXXXXXXXXXXXXGOOOOOOOOOOXXXXXXXXXGOOOOOOOOOOXXXXXXXXXGOOOOOOOOOOOOOOOXXXXGOOOOOOXXXXXXXXXXXXXGOOOOOOOOOOOOOOXXXXXGOOOOOOAXXXXXXXXXXXXGOOOOOOOOOOOXXXXXXXXGOOOOOOOOOOOOOOOXXXXGOOOOOXXXXXXXXXXXXXXGOOOOOOOOXXXXXXXXXXXGOOOOXXXXXXXXXXXXXXXGOOOOOOOOOOXXXXXXXXX,0,256,0

23415,134,0,134,91,115,0,0,275,138,137,GOOOOOOXXXXXXXXXXXXXGOOOOOOOOOOXXXXXXXXXGOOOOOOOOOOXXXXXXXXXGOOOOOOOOOOOOOOOXXXXGOOOOOOXXXXXXXXXXXXXGOOOOOOOOOOOOOOXXXXXGOOOOOOOXXXXXXXXXXXXGOOOOOOOOOOOXXXXXXXXGOOOOOOOOOOOOOOOXXXXGOOOOOXXXXXXXXXXXXXXGOOOOOOOOXXXXXXXXXXXGOOOOXXXXXXXXXXXXXXXGOOOOOOOOOOXXXXXXXXX,0,256,0
23436,134,0,134,99,107,0,0,268,134,134,GOOOOOOXXXXXXXXXXXXXGOOOOOOOOOOXXXXXXXXXGOOOOOOOOOOXXXXXXXXXGOOOOOOOOOOOOOOOXXXXGOOOOOOXXXXXXXXXXXXXGOOOOOOOOOOOOOOXXXXXGOOOOOOOXXXXXXXXXXXXGOOOOOOOOOOOXXXXXXXXGOOOOOOOOOOOOOOOXXXXGOOOOOXXXXXXXXXXXXXXGOOOOOOOOXXXXXXXXXXXGOOOOXXXXXXXXXXXXXXXGOOOOOOOOOOXXXXXXXXX,0,256,0
23457,134,0,134,97,109,0,0,269,131,138,GOOOOOOXXXXXXXXXXXXXGOOOOOOOOOOXXXXXXXXXGOOOOOOOOOOXXXXXXXXXGOOOOOOOOOOOOOOOXXXXGOOOOOOXXXXXXXXXXXXXGOOOOOOOOOOOOOOXXXXXGOOOOOOOXXXXXXXXXXXXGOOOOOOOOOOOXXXXXXXXGOOOOOOOOOOOOOOOXXXXGOOOOOXXXXXXXXXXXXXXGOOOOOOOOXXXXXXXXXXXGOOOOXXXXXXXXXXXXXXXGOOOOOOOOOOXXXXXXXXX,0,256,0
23478,134,0,134,91,115,0,0,275,137,138,GOOOOOOXXXXXXXXXXXXXGOOOOOOOOOOXXXXXXXXXGOOOOOOOOOOXXXXXXXXXGOOOOOOOOOOOOOOOXXXXGOOOOOOXXXXXXXXXXXXXGOOOOOOOOOOOOOOXXXXXGOOOOOOOXXXXXXXXXXXXGOOOOOOOOOOOXXXXXXXXGOOOOOOOOOOOOOOOXXXXGOOOOOXXXXXXXXXXXXXXGOOOOOOOOXXXXXXXXXXXGOOOOXXXXXXXXXXXXXXXGOOOOOOOOOOXXXXXXXXX,0,256,0
23499,134,0,134,87,119,0,0,279,139,140,GOOOOOOXXXXXXXXXXXXXGOOOOOOOOOOXXXXXXXXXGOOOOOOOOOOXXXXXXXXXGOOOOOOOOOOOOOOOXXXXGOOOOOOXXXXXXXXXXXXXGOOOOOOOOOOOOOOXXXXXGOOOOOOOXXXXXXXXXXXXGOOOOOOOOOOOXXXXXXXXGOOOOOOOOOOOOOOOXXXXGOOOOOXXXXXXXXXXXXXXGOOOOOOOOXXXXXXXXXXXGOOOOXXXXXXXXXXXXXXXGOOOOOOOOOOXXXXXXXXX,0,256,0

23520,134,0,134,91,115,0,0,274,136,138,GOOOOOOXXXXXXXXXXXXXGOOOOOOOOOOXXXXXXXXXGOOOOOOOOOOXXXXXXXXXGOOOOOOOOOOOOOOOXXXXGOOOOOOXXXXXXXXXXXXXGOOOOOOOOOOOOOOXXXXXGOOOOOOOXXXXXXXXXXXXGOOOOOOOOOOOXXXXXXXXGOOOOOOOOOOOOOOOXXXXGOOOOOXXXXXXXXXXXXXXGOOOOOOOOXXXXXXXXXXXGOOOOXXXXXXXXXXXXXXXGOOOOOOOOOOXXXXXXXXX,0,256,0
23541,134,0,134,93,113,0,0,273,132,141,GOOOOOOXXXXXXXXXXXXXGOOOOOOOOOOXXXXXXXXXGOOOOOOOOOOXXXXXXXXXGOOOOOOOOOOOOOOOXXXXGOOOOOOXXXXXXXXXXXXXGOOOOOOOOOOOOOOXXXXXGOOOOOOOXXXXXXXXXXXXGOOOOOOOOOOOXXXXXXXXGOOOOOOOOOOOOOOOXXXXGOOOOOXXXXXXXXXXXXXXGOOOOOOOOXXXXXXXXXXXGOOOOXXXXXXXXXXXXXXXGOOOOOOOOOOXXXXXXXXX,0,256,0
23562,134,0,134,90,116,0,0,276,134,142,GOOOOOOXXXXXXXXXXXXXGOOOOOOOOOOXXXXXXXXXGOOOOOOOOOOXXXXXXXXXGOOOOOOOOOOOOOOOXXXXGOOOOOOXXXXXXXXXXXXXGOOOOOOOOOOOOOOXXXXXGOOOOOOOXXXXXXXXXXXXGOOOOOOOOOOOXXXXXXXXGOOOOOOOOOOOOOOOXXXXGOOOOOXXXXXXXXXXXXXXGOOOOOOOOXXXXXXXXXXXGOOOOXXXXXXXXXXXXXXXGOOOOOOOOOOXXXXXXXXX,0,256,0
23583,134,0,134,88,118,0,0,278,142,136,GOOOOOOXXXXXXXXXXXXXGOOOOOOOOOOXXXXXXXXXGOOOOOOOOOOXXXXXXXXXGOOOOOOOOOOOOOOOXXXXGOOOOOOXXXXXXXXXXXXXGOOOOOOOOOOOOOOXXXXXGOOOOOOOXXXXXXXXXXXXGOOOOOOOOOOOXXXXXXXXGOOOOOOOOOOOOOOOXXXXGOOOOOXXXXXXXXXXXXXXGOOOOOOOOXXXXXXXXXXXGOOOOXXXXXXXXXXXXXXXGOOOOOOOOOOXXXXXXXXX,0,256,0
23604,134,0,134,91,115,0,0,275,140,135,GOOOOOOXXXXXXXXXXXXXGOOOOOOOOOOXXXXXXXXXGOOOOOOOOOOXXXXXXXXXGOOOOOOOOOOOOOOOXXXXGOOOOOOXXXXXXXXXXXXXGOOOOOOOOOOOOOOXXXXXGOOOOOOOXXXXXXXXXXXXGOOOOOOOOOOOXXXXXXXXGOOOOOOOOOOOOOOOXXXXGOOOOOXXXXXXXXXXXXXXGOOOOOOOOXXXXXXXXXXXGOOOOXXXXXXXXXXXXXXXGOOOOOOOOOOXXXXXXXXX,0,256,0

23625,134,0,134,92,114,0,0,270,138,132,GOOOOOOXXXXXXXXXXXXXGOOOOOOOOOOXXXXXXXXXGOOOOOOOOOOXXXXXXXXXGOOOOOOOOOOOOOOOXXXXGOOOOOOXXXXXXXXXXXXXGOOOOOOOOOOOOOOXXXXXGOOOOOOOXXXXXXXXXXXXGOOOOOOOOOOOXXXXXXXXGOOOOOOOOOOOOOOOXXXXGOOOOOXXXXXXXXXXXXXXGOOOOOOOOXXXXXXXXXXXGOOOOXXXXXXXXXXXXXXXGOOOOOOOOOOXXXXXXXXX,0,256,0
23646,134,0,134,92,114,0,0,274,141,133,GOOOOOOXXXXXXXXXXXXXGOOOOOOOOOOXXXXXXXXXGOOOOOOOOOOXXXXXXXXXGOOOOOOOOOOOOOOOXXXXGOOOOOOXXXXXXXXXXXXXGOOOOOOOOOOOOOOXXXXXGOOOOOOOXXXXXXXXXXXXGOOOOOOOOOOOXXXXXXXXGOOOOOOOOOOOOOOOXXXXGOOOOOXXXXXXXXXXXXXXGOOOOOOOOXXXXXXXXXXXGOOOOXXXXXXXXXXXXXXXGOOOOOOOOOOXXXXXXXXX,0,256,0
23667,134,0,134,87,119,0,0,277,146,131,GOOOOOOXXXXXXXXXXXXXGOOOOOOOOOOXXXXXXXXXGOOOOOOOOOOXXXXXXXXXGOOOOOOOOOOOOOOOXXXXGOOOOOOXXXXXXXXXXXXXGOOOOOOOOOOOOOOXXXXXGOOOOOOOXXXXXXXXXXXXGOOOOOOOOOOOXXXXXXXXGOOOOOOOOOOOOOOOXXXXGOOOOOXXXXXXXXXXXXXXGOOOOOOOOXXXXXXXXXXXGOOOOXXXXXXXXXXXXXXXGOOOOOOOOOOXXXXXXXXX,0,256,0
23688,134,0,134,92,114,0,0,273,141,132,GOOOOOOXXXXXXXXXXXXXGOOOOOOOOOOXXXXXXXXXGOOOOOOOOOOXXXXXXXXXGOOOOOOOOOOOOOOOXXXXGOOOOOOXXXXXXXXXXXXXGOOOOOOOOOOOOOOXXXXXGOOOOOOOXXXXXXXXXXXXGOOOOOOOOOOOXXXXXXXXGOOOOOOOOOOOOOOOXXXXGOOOOOXXXXXXXXXXXXXXGOOOOOOOOXXXXXXXXXXXGOOOOXXXXXXXXXXXXXXXGOOOOOOOOOOXXXXXXXXX,0,256,0
23709,134,0,134,92,114,0,0,275,141,134,GOOOOOOXXXXXXXXXXXXXGOOOOOOOOOOXXXXXXXXXGOOOOOOOOOOXXXXXXXXXGOOOOOOOOOOOOOOOXXXXGOOOOOOXXXXXXXXXXXXXGOOOOOOOOOOOOOOXXXXXGOOOOOOOXXXXXXXXXXXXGOOOOOOOOOOOXXXXXXXXGOOOOOOOOOOOOOOOXXXXGOOOOOXXXXXXXXXXXXXXGOOOOOOOOXXXXXXXXXXXGOOOOXXXXXXXXXXXXXXXGOOOOOOOOOOXXXXXXXXX,0,256,0

23730,134,0,134,93,113,0,0,274,137,137,GOOOOOOXXXXXXXXXXXXXGOOOOOOOOOOXXXXXXXXXGOOOOOOOOOOXXXXXXXXXGOOOOOOOOOOOOOOOXXXXGOOOOOOXXXXXXXXXXXXXGOOOOOOOOOOOOOOXXXXXGOOOOOOOXXXXXXXXXXXXGOOOOOOOOOOOXXXXXXXXGOOOOOOOOOOOOOOOXXXXGOOOOOXXXXXXXXXXXXXXGOOOOOOOOXXXXXXXXXXXGOOOOXXXXXXXXXXXXXXXGOOOOOOOOOOXXXXXXXXX,0,256,0
23751,134,0,134,91,115,0,0,276,139,137,GOOOOOOXXXXXXXXXXXXXGOOOOOOOOOOXXXXXXXXXGOOOOOOOOOOXXXXXXXXXGOOOOOOOOOOOOOOOXXXXGOOOOOOXXXXXXXXXXXXXGOOOOOOOOOOOOOOXXXXXGOOOOOOOXXXXXXXXXXXXGOOOOOOOOOOOXXXXXXXXGOOOOOOOOOOOOOOOXXXXGOOOOOXXXXXXXXXXXXXXGOOOOOOOOXXXXXXXXXXXGOOOOXXXXXXXXXXXXXXXGOOOOOOOOOOXXXXXXXXX,0,256,0
23772,134,0,134,89,117,0,0,278,140,138,GOOOOOOXXXXXXXXXXXXXGOOOOOOOOOOXXXXXXXXXGOOOOOOOOOOXXXXXXXXXGOOOOOOOOOOOOOOOXXXXGOOOOOOXXXXXXXXXXXXXGOOOOOOOOOOOOOOXXXXXGOOOOOOOXXXXXXXXXXXXGOOOOOOOOOOOXXXXXXXXGOOOOOOOOOOOOOOOXXXXGOOOOOXXXXXXXXXXXXXXGOOOOOOOOXXXXXXXXXXXGOOOOXXXXXXXXXXXXXXXGOOOOOOOOOOXXXXXXXXX,0,256,0
23793,134,0,134,88,118,0,0,279,146,133,GOOOOOOXXXXXXXXXXXXXGOOOOOOOOOOXXXXXXXXXGOOOOOOOOOOXXXXXXXXXGOOOOOOOOOOOOOOOXXXXGOOOOOOXXXXXXXXXXXXXGOOOOOOOOOOOOOOXXXXXGOOOOOOOXXXXXXXXXXXXGOOOOOOOOOOOXXXXXXXXGOOOOOOOOOOOOOOOXXXXGOOOOOXXXXXXXXXXXXXXGOOOOOOOOXXXXXXXXXXXGOOOOXXXXXXXXXXXXXXXGOOOOOOOOOOXXXXXXXXX,0,256,0
23814,134,0,134,93,113,0,0,274,144,130,GOOOOOOXXXXXXXXXXXXXGOOOOOOOOOOXXXXXXXXXGOOOOOOOOOOXXXXXXXXXGOOOOOOOOOOOOOOOXXXXGOOOOOOXXXXXXXXXXXXXGOOOOOOOOOOOOOOXXXXXGOOOOOOOXXXXXXXXXXXXGOOOOOOOOOOOXXXXXXXXGOOOOOOOOOOOOOOOXXXXGOOOOOXXXXXXXXXXXXXXGOOOOOOOOXXXXXXXXXXXGOOOOXXXXXXXXXXXXXXXGOOOOOOOOOOXXXXXXXXX,0,256,0

23835,134,0,134,96,110,0,0,271,137,134,GOOOOOOXXXXXXXXXXXXXGOOOOOOOOOOXXXXXXXXXGOOOOOOOOOOXXXXXXXXXGOOOOOOOOOOOOOOOXXXXGOOOOOOXXXXXXXXXXXXXGOOOOOOOOOOOOOOXXXXXGOOOOOOOXXXXXXXXXXXXGOOOOOOOOOOOXXXXXXXXGOOOOOOOOOOOOOOOXXXXGOOOOOXXXXXXXXXXXXXXGOOOOOOOOXXXXXXXXXXXGOOOOXXXXXXXXXXXXXXXGOOOOOOOOOOXXXXXXXXX,0,256,0
23856,134,0,134,96,110,0,0,270,138,132,GOOOOOOXXXXXXXXXXXXXGOOOOOOOOOOXXXXXXXXXGOOOOOOOOOOXXXXXXXXXGOOOOOOOOOOOOOOOXXXXGOOOOOOXXXXXXXXXXXXXGOOOOOOOOOOOOOOXXXXXGOOOOOOOXXXXXXXXXXXXGOOOOOOOOOOOXXXXXXXXGOOOOOOOOOOOOOOOXXXXGOOOOOXXXXXXXXXXXXXXGOOOOOOOOXXXXXXXXXXXGOOOOXXXXXXXXXXXXXXXGOOOOOOOOOOXXXXXXXXX,0,256,0
23877,134,0,134,92,114,0,0,275,144,131,GOOOOOOXXXXXXXXXXXXXGOOOOOOOOOOXXXXXXXXXGOOOOOOOOOOXXXXXXXXXGOOOOOOOOOOOOOOOXXXXGOOOOOOXXXXXXXXXXXXXGOOOOOOOOOOOOOOXXXXXGOOOOOOOXXXXXXXXXXXXGOOOOOOOOOOOXXXXXXXXGOOOOOOOOOOOOOOOXXXXGOOOOOXXXXXXXXXXXXXXGOOOOOOOOXXXXXXXXXXXGOOOOXXXXXXXXXXXXXXXGOOOOOOOOOOXXXXXXXXX,0,256,0
23898,134,0,134,91,115,0,0,276,148,128,GOOOOOOXXXXXXXXXXXXXGOOOOOOOOOOXXXXXXXXXGOOOOOOOOOOXXXXXXXXXGOOOOOOOOOOOOOOOXXXXGOOOOOOXXXXXXXXXXXXXGOOOOOOOOOOOOOOXXXXXGOOOOOOOXXXXXXXXXXXXGOOOOOOOOOOOXXXXXXXXGOOOOOOOOOOOOOOOXXXXGOOOOOXXXXXXXXXXXXXXGOOOOOOOOXXXXXXXXXXXGOOOOXXXXXXXXXXXXXXXGOOOOOOOOOOXXXXXXXXX,0,256,0
23919,135,1,134,83,122,0,0,281,150,131,GOOOOOOXXXXXXXXXXXXXGOOOOOOOOOOXXXXXXXXXGOOOOOOOOOOXXXXXXXXXGOOOOOOOOOOOOOOOXXXXGOOOOOOXXXXXXXXXXXXXGOOOOOOOOOOOOOOXXXXXGOOOOOOOAXXXXXXXXXXXGOOOOOOOOOOOXXXXXXXXGOOOOOOOOOOOOOOOXXXXGOOOOOXXXXXXXXXXXXXXGOOOOOOOOXXXXXXXXXXXGOOOOXXXXXXXXXXXXXXXGOOOOOOOOOOXXXXXXXXX,0,256,0

23940,135,1,134,85,120,0,0,280,140,140,GOOOOOOXXXXXXXXXXXXXGOOOOOOOOOOXXXXXXXXXGOOOOOOOOOOXXXXXXXXXGOOOOOOOOOOOOOOOXXXXGOOOOOOXXXXXXXXXXXXXGOOOOOOOOOOOOOOXXXXXGOOOOOOOAXXXXXXXXXXXGOOOOOOOOOOOXXXXXXXXGOOOOOOOOOOOOOOOXXXXGOOOOOXXXXXXXXXXXXXXGOOOOOOOOXXXXXXXXXXXGOOOOXXXXXXXXXXXXXXXGOOOOOOOOOOXXXXXXXXX,0,256,0
23961,135,0,135,82,123,0,0,283,147,136,GOOOOOOXXXXXXXXXXXXXGOOOOOOOOOOXXXXXXXXXGOOOOOOOOOOXXXXXXXXXGOOOOOOOOOOOOOOOXXXXGOOOOOOXXXXXXXXXXXXXGOOOOOOOOOOOOOOXXXXXGOOOOOOOOXXXXXXXXXXXGOOOOOOOOOOOXXXXXXXXGOOOOOOOOOOOOOOOXXXXGOOOOOXXXXXXXXXXXXXXGOOOOOOOOXXXXXXXXXXXGOOOOXXXXXXXXXXXXXXXGOOOOOOOOOOXXXXXXXXX,0,256,0
23982,135,0,135,86,119,0,0,278,140,138,GOOOOOOXXXXXXXXXXXXXGOOOOOOOOOOXXXXXXXXXGOOOOOOOOOOXXXXXXXXXGOOOOOOOOOOOOOOOXXXXGOOOOOOXXXXXXXXXXXXXGOOOOOOOOOOOOOOXXXXXGOOOOOOOOXXXXXXXXXXXGOOOOOOOOOOOXXXXXXXXGOOOOOOOOOOOOOOOXXXXGOOOOOXXXXXXXXXXXXXXGOOOOOOOOXXXXXXXXXXXGOOOOXXXXXXXXXXXXXXXGOOOOOOOOOOXXXXXXXXX,0,256,0
24003,135,0,135,83,122,0,0,282,139,143,GOOOOOOXXXXXXXXXXXXXGOOOOOOOOOOXXXXXXXXXGOOOOOOOOOOXXXXXXXXXGOOOOOOOOOOOOOOOXXXXGOOOOOOXXXXXXXXXXXXXGOOOOOOOOOOOOOOXXXXXGOOOOOOOOXXXXXXXXXXXGOOOOOOOOOOOXXXXXXXXGOOOOOOOOOOOOOOOXXXXGOOOOOXXXXXXXXXXXXXXGOOOOOOOOXXXXXXXXXXXGOOOOXXXXXXXXXXXXXXXGOOOOOOOOOOXXXXXXXXX,0,256,0
24024,135,0,135,82,123,0,0,283,143,140,GOOOOOOXXXXXXXXXXXXXGOOOOOOOOOOXXXXXXXXXGOOOOOOOOOOXXXXXXXXXGOOOOOOOOOOOOOOOXXXXGOOOOOOXXXXXXXXXXXXXGOOOOOOOOOOOOOOXXXXXGOOOOOOOOXXXXXXXXXXXGOOOOOOOOOOOXXXXXXXXGOOOOOOOOOOOOOOOXXXXGOOOOOXXXXXXXXXXXXXXGOOOOOOOOXXXXXXXXXXXGOOOOXXXXXXXXXXXXXXXGOOOOOOOOOOXXXXXXXXX,0,256,0

24045,135,0,135,80,125,0,0,284,141,143,GOOOOOOXXXXXXXXXXXXXGOOOOOOOOOOXXXXXXXXXGOOOOOOOOOOXXXXXXXXXGOOOOOOOOOOOOOOOXXXXGOOOOOOXXXXXXXXXXXXXGOOOOOOOOOOOOOOXXXXXGOOOOOOOOXXXXXXXXXXXGOOOOOOOOOOOXXXXXXXXGOOOOOOOOOOOOOOOXXXXGOOOOOXXXXXXXXXXXXXXGOOOOOOOOXXXXXXXXXXXGOOOOXXXXXXXXXXXXXXXGOOOOOOOOOOXXXXXXXXX,0,256,0
24066,135,0,135,83,122,0,0,282,140,142,GOOOOOOXXXXXXXXXXXXXGOOOOOOOOOOXXXXXXXXXGOOOOOOOOOOXXXXXXXXXGOOOOOOOOOOOOOOOXXXXGOOOOOOXXXXXXXXXXXXXGOOOOOOOOOOOOOOXXXXXGOOOOOOOOXXXXXXXXXXXGOOOOOOOOOOOXXXXXXXXGOOOOOOOOOOOOOOOXXXXGOOOOOXXXXXXXXXXXXXXGOOOOOOOOXXXXXXXXXXXGOOOOXXXXXXXXXXXXXXXGOOOOOOOOOOXXXXXXXXX,0,256,0
24087,135,0,135,90,115,0,0,275,143,132,GOOOOOOXXXXXXXXXXXXXGOOOOOOOOOOXXXXXXXXXGOOOOOOOOOOXXXXXXXXXGOOOOOOOOOOOOOOOXXXXGOOOOOOXXXXXXXXXXXXXGOOOOOOOOOOOOOOXXXXXGOOOOOOOOXXXXXXXXXXXGOOOOOOOOOOOXXXXXXXXGOOOOOOOOOOOOOOOXXXXGOOOOOXXXXXXXXXXXXXXGOOOOOOOOXXXXXXXXXXXGOOOOXXXXXXXXXXXXXXXGOOOOOOOOOOXXXXXXXXX,0,256,0
24108,135,0,135,90,115,0,0,275,144,131,GOOOOOOXXXXXXXXXXXXXGOOOOOOOOOOXXXXXXXXXGOOOOOOOOOOXXXXXXXXXGOOOOOOOOOOOOOOOXXXXGOOOOOOXXXXXXXXXXXXXGOOOOOOOOOOOOOOXXXXXGOOOOOOOOXXXXXXXXXXXGOOOOOOOOOOOXXXXXXXXGOOOOOOOOOOOOOOOXXXXGOOOOOXXXXXXXXXXXXXXGOOOOOOOOXXXXXXXXXXXGOOOOXXXXXXXXXXXXXXXGOOOOOOOOOOXXXXXXXXX,0,256,0
24129,135,0,135,89,116,0,0,276,147,129,GOOOOOOXXXXXXXXXXXXXGOOOOOOOOOOXXXXXXXXXGOOOOOOOOOOXXXXXXXXXGOOOOOOOOOOOOOOOXXXXGOOOOOOXXXXXXXXXXXXXGOOOOOOOOOOOOOOXXXXXGOOOOOOOOXXXXXXXXXXXGOOOOOOOOOOOXXXXXXXXGOOOOOOOOOOOOOOOXXXXGOOOOOXXXXXXXXXXXXXXGOOOOOOOOXXXXXXXXXXXGOOOOXXXXXXXXXXXXXXXGOOOOOOOOOOXXXXXXXXX,0,256,0

24150,135,0,135,87,118,0,0,277,148,129,GOOOOOOXXXXXXXXXXXXXGOOOOOOOOOOXXXXXXXXXGOOOOOOOOOOXXXXXXXXXGOOOOOOOOOOOOOOOXXXXGOOOOOOXXXXXXXXXXXXXGOOOOOOOOOOOOOOXXXXXGOOOOOOOOXXXXXXXXXXXGOOOOOOOOOOOXXXXXXXXGOOOOOOOOOOOOOOOXXXXGOOOOOXXXXXXXXXXXXXXGOOOOOOOOXXXXXXXXXXXGOOOOXXXXXXXXXXXXXXXGOOOOOOOOOOXXXXXXXXX,0,256,0
24171,135,0,135,94,111,0,0,271,142,129,GOOOOOOXXXXXXXXXXXXXGOOOOOOOOOOXXXXXXXXXGOOOOOOOOOOXXXXXXXXXGOOOOOOOOOOOOOOOXXXXGOOOOOOXXXXXXXXXXXXXGOOOOOOOOOOOOOOXXXXXGOOOOOOOOXXXXXXXXXXXGOOOOOOOOOOOXXXXXXXXGOOOOOOOOOOOOOOOXXXXGOOOOOXXXXXXXXXXXXXXGOOOOOOOOXXXXXXXXXXXGOOOOXXXXXXXXXXXXXXXGOOOOOOOOOOXXXXXXXXX,0,256,0
24192,135,0,135,95,110,0,0,270,139,131,GOOOOOOXXXXXXXXXXXXXGOOOOOOOOOOXXXXXXXXXGOOOOOOOOOOXXXXXXXXXGOOOOOOOOOOOOOOOXXXXGOOOOOOXXXXXXXXXXXXXGOOOOOOOOOOOOOOXXXXXGOOOOOOOOXXXXXXXXXXXGOOOOOOOOOOOXXXXXXXXGOOOOOOOOOOOOOOOXXXXGOOOOOXXXXXXXXXXXXXXGOOOOOOOOXXXXXXXXXXXGOOOOXXXXXXXXXXXXXXXGOOOOOOOOOOXXXXXXXXX,0,256,0
24213,135,0,135,94,111,0,0,271,145,126,GOOOOOOXXXXXXXXXXXXXGOOOOOOOOOOXXXXXXXXXGOOOOOOOOOOXXXXXXXXXGOOOOOOOOOOOOOOOXXXXGOOOOOOXXXXXXXXXXXXXGOOOOOOOOOOOOOOXXXXXGOOOOOOOOXXXXXXXXXXXGOOOOOOOOOOOXXXXXXXXGOOOOOOOOOOOOOOOXXXXGOOOOOXXXXXXXXXXXXXXGOOOOOOOOXXXXXXXXXXXGOOOOXXXXXXXXXXXXXXXGOOOOOOOOOOXXXXXXXXX,0,256,0
24234,135,0,135,95,110,0,0,269,148,121,GOOOOOOXXXXXXXXXXXXXGOOOOOOOOOOXXXXXXXXXGOOOOOOOOOOXXXXXXXXXGOOOOOOOOOOOOOOOXXXXGOOOOOOXXXXXXXXXXXXXGOOOOOOOOOOOOOOXXXXXGOOOOOOOOXXXXXXXXXXXGOOOOOOOOOOOXXXXXXXXGOOOOOOOOOOOOOOOXXXXGOOOOOXXXXXXXXXXXXXXGOOOOOOOOXXXXXXXXXXXGOOOOXXXXXXXXXXXXXXXGOOOOOOOOOOXXXXXXXXX,0,256,0

24255,135,0,135,91,114,0,0,273,147,126,GOOOOOOXXXXXXXXXXXXXGOOOOOOOOOOXXXXXXXXXGOOOOOOOOOOXXXXXXXXXGOOOOOOOOOOOOOOOXXXXGOOOOOOXXXXXXXXXXXXXGOOOOOOOOOOOOOOXXXXXGOOOOOOOOXXXXXXXXXXXGOOOOOOOOOOOXXXXXXXXGOOOOOOOOOOOOOOOXXXXGOOOOOXXXXXXXXXXXXXXGOOOOOOOOXXXXXXXXXXXGOOOOXXXXXXXXXXXXXXXGOOOOOOOOOOXXXXXXXXX,0,256,0
24276,135,0,135,89,116,0,0,276,147,129,GOOOOOOXXXXXXXXXXXXXGOOOOOOOOOOXXXXXXXXXGOOOOOOOOOOXXXXXXXXXGOOOOOOOOOOOOOOOXXXXGOOOOOOXXXXXXXXXXXXXGOOOOOOOOOOOOOOXXXXXGOOOOOOOOXXXXXXXXXXXGOOOOOOOOOOOXXXXXXXXGOOOOOOOOOOOOOOOXXXXGOOOOOXXXXXXXXXXXXXXGOOOOOOOOXXXXXXXXXXXGOOOOXXXXXXXXXXXXXXXGOOOOOOOOOOXXXXXXXXX,0,256,0
24297,135,0,135,92,113,0,0,273,144,129,GOOOOOOXXXXXXXXXXXXXGOOOOOOOOOOXXXXXXXXXGOOOOOOOOOOXXXXXXXXXGOOOOOOOOOOOOOOOXXXXGOOOOOOXXXXXXXXXXXXXGOOOOOOOOOOOOOOXXXXXGOOOOOOOOXXXXXXXXXXXGOOOOOOOOOOOXXXXXXXXGOOOOOOOOOOOOOOOXXXXGOOOOOXXXXXXXXXXXXXXGOOOOOOOOXXXXXXXXXXXGOOOOXXXXXXXXXXXXXXXGOOOOOOOOOOXXXXXXXXX,0,256,0
24318,136,1,135,90,114,0,0,274,143,131,GOOOOOOXXXXXXXXXXXXXGOOOOOOOOOOAXXXXXXXXGOOOOOOOOOOXXXXXXXXXGOOOOOOOOOOOOOOOXXXXGOOOOOOXXXXXXXXXXXXXGOOOOOOOOOOOOOOXXXXXGOOOOOOOOXXXXXXXXXXXGOOOOOOOOOOOXXXXXXXXGOOOOOOOOOOOOOOOXXXXGOOOOOXXXXXXXXXXXXXXGOOOOOOOOXXXXXXXXXXXGOOOOXXXXXXXXXXXXXXXGOOOOOOOOOOXXXXXXXXX,0,256,0
24339,136,0,136,86,118,0,0,277,143,134,GOOOOOOXXXXXXXXXXXXXGOOOOOOOOOOOXXXXXXXXGOOOOOOOOOOXXXXXXXXXGOOOOOOOOOOOOOOOXXXXGOOOOOOXXXXXXXXXXXXXGOOOOOOOOOOOOOOXXXXXGOOOOOOOOXXXXXXXXXXXGOOOOOOOOOOOXXXXXXXXGOOOOOOOOOOOOOOOXXXXGOOOOOXXXXXXXXXXXXXXGOOOOOOOOXXXXXXXXXXXGOOOOXXXXXXXXXXXXXXXGOOOOOOOOOOXXXXXXXXX,0,256,0

24360,136,0,136,86,118,0,0,278,140,138,GOOOOOOXXXXXXXXXXXXXGOOOOOOOOOOOXXXXXXXXGOOOOOOOOOOXXXXXXXXXGOOOOOOOOOOOOOOOXXXXGOOOOOOXXXXXXXXXXXXXGOOOOOOOOOOOOOOXXXXXGOOOOOOOOXXXXXXXXXXXGOOOOOOOOOOOXXXXXXXXGOOOOOOOOOOOOOOOXXXXGOOOOOXXXXXXXXXXXXXXGOOOOOOOOXXXXXXXXXXXGOOOOXXXXXXXXXXXXXXXGOOOOOOOOOOXXXXXXXXX,0,256,0
24381,136,0,136,83,121,0,0,281,142,139,GOOOOOOXXXXXXXXXXXXXGOOOOOOOOOOOXXXXXXXXGOOOOOOOOOOXXXXXXXXXGOOOOOOOOOOOOOOOXXXXGOOOOOOXXXXXXXXXXXXXGOOOOOOOOOOOOOOXXXXXGOOOOOOOOXXXXXXXXXXXGOOOOOOOOOOOXXXXXXXXGOOOOOOOOOOOOOOOXXXXGOOOOOXXXXXXXXXXXXXXGOOOOOOOOXXXXXXXXXXXGOOOOXXXXXXXXXXXXXXXGOOOOOOOOOOXXXXXXXXX,0,256,0
24402,136,0,136,84,120,0,0,280,141,139,GOOOOOOXXXXXXXXXXXXXGOOOOOOOOOOOXXXXXXXXGOOOOOOOOOOXXXXXXXXXGOOOOOOOOOOOOOOOXXXXGOOOOOOXXXXXXXXXXXXXGOOOOOOOOOOOOOOXXXXXGOOOOOOOOXXXXXXXXXXXGOOOOOOOOOOOXXXXXXXXGOOOOOOOOOOOOOOOXXXXGOOOOOXXXXXXXXXXXXXXGOOOOOOOOXXXXXXXXXXXGOOOOXXXXXXXXXXXXXXXGOOOOOOOOOOXXXXXXXXX,0,256,0
24423,136,0,136,86,118,0,0,278,138,140,GOOOOOOXXXXXXXXXXXXXGOOOOOOOOOOOXXXXXXXXGOOOOOOOOOOXXXXXXXXXGOOOOOOOOOOOOOOOXXXXGOOOOOOXXXXXXXXXXXXXGOOOOOOOOOOOOOOXXXXXGOOOOOOOOXXXXXXXXXXXGOOOOOOOOOOOXXXXXXXXGOOOOOOOOOOOOOOOXXXXGOOOOOXXXXXXXXXXXXXXGOOOOOOOOXXXXXXXXXXXGOOOOXXXXXXXXXXXXXXXGOOOOOOOOOOXXXXXXXXX,0,256,0
24444,137,1,136,89,114,0,0,274,136,138,GOOOOOOXXXXXXXXXXXXXGOOOOOOOOOOOXXXXXXXXGOOOOOOOOOOXXXXXXXXXGOOOOOOOOOOOOOOOXXXXGOOOOOOXXXXXXXXXXXXXGOOOOOOOOOOOOOOAXXXXGOOOOOOOOXXXXXXXXXXXGOOOOOOOOOOOXXXXXXXXGOOOOOOOOOOOOOOOXXXXGOOOOOXXXXXXXXXXXXXXGOOOOOOOOXXXXXXXXXXXGOOOOXXXXXXXXXXXXXXXGOOOOOOOOOOXXXXXXXXX,0,256,0

24465,137,1,136,86,117,0,0,276,139,137,GOOOOOOXXXXXXXXXXXXXGOOOOOOOOOOOXXXXXXXXGOOOOOOOOOOXXXXXXXXXGOOOOOOOOOOOOOOOXXXXGOOOOOOXXXXXXXXXXXXXGOOOOOOOOOOOOOOAXXXXGOOOOOOOOXXXXXXXXXXXGOOOOOOOOOOOXXXXXXXXGOOOOOOOOOOOOOOOXXXXGOOOOOXXXXXXXXXXXXXXGOOOOOOOOXXXXXXXXXXXGOOOOXXXXXXXXXXXXXXXGOOOOOOOOOOXXXXXXXXX,0,256,0
24486,138,2,136,80,122,0,0,282,138,144,GOOOOOOXXXXXXXXXXXXXGOOOOOOOOOOOXXXXXXXXGOOOOOOOOOOXXXXXXXXXGOOOOOOOOOOOOOOOAXXXGOOOOOOXXXXXXXXXXXXXGOOOOOOOOOOOOOOAXXXXGOOOOOOOOXXXXXXXXXXXGOOOOOOOOOOOXXXXXXXXGOOOOOOOOOOOOOOOXXXXGOOOOOXXXXXXXXXXXXXXGOOOOOOOOXXXXXXXXXXXGOOOOXXXXXXXXXXXXXXXGOOOOOOOOOOXXXXXXXXX,0,256,0
24507,138,2,136,86,116,0,0,276,141,135,GOOOOOOXXXXXXXXXXXXXGOOOOOOOOOOOXXXXXXXXGOOOOOOOOOOXXXXXXXXXGOOOOOOOOOOOOOOOAXXXGOOOOOOXXXXXXXXXXXXXGOOOOOOOOOOOOOOAXXXXGOOOOOOOOXXXXXXXXXXXGOOOOOOOOOOOXXXXXXXXGOOOOOOOOOOOOOOOXXXXGOOOOOXXXXXXXXXXXXXXGOOOOOOOOXXXXXXXXXXXGOOOOXXXXXXXXXXXXXXXGOOOOOOOOOOXXXXXXXXX,0,256,0
24528,138,2,136,93,109,0,0,267,139,128,GOOOOOOXXXXXXXXXXXXXGOOOOOOOOOOOXXXXXXXXGOOOOOOOOOOXXXXXXXXXGOOOOOOOOOOOOOOOAXXXGOOOOOOXXXXXXXXXXXXXGOOOOOOOOOOOOOOAXXXXGOOOOOOOOXXXXXXXXXXXGOOOOOOOOOOOXXXXXXXXGOOOOOOOOOOOOOOOXXXXGOOOOOXXXXXXXXXXXXXXGOOOOOOOOXXXXXXXXXXXGOOOOXXXXXXXXXXXXXXXGOOOOOOOOOOXXXXXXXXX,0,256,0
24549,138,2,136,95,107,0,0,266,139,127,GOOOOOOXXXXXXXXXXXXXGOOOOOOOOOOOXXXXXXXXGOOOOOOOOOOXXXXXXXXXGOOOOOOOOOOOOOOOAXXXGOOOOOOXXXXXXXXXXXXXGOOOOOOOOOOOOOOAXXXXGOOOOOOOOXXXXXXXXXXXGOOOOOOOOOOOXXXXXXXXGOOOOOOOOOOOOOOOXXXXGOOOOOXXXXXXXXXXXXXXGOOOOOOOOXXXXXXXXXXXGOOOOXXXXXXXXXXXXXXXGOOOOOOOOOOXXXXXXXXX,0,256,0

24570,138,1,137,89,113,0,0,272,139,133,GOOOOOOXXXXXXXXXXXXXGOOOOOOOOOOOXXXXXXXXGOOOOOOOOOOXXXXXXXXXGOOOOOOOOOOOOOOOOXXXGOOOOOOXXXXXXXXXXXXXGOOOOOOOOOOOOOOAXXXXGOOOOOOOOXXXXXXXXXXXGOOOOOOOOOOOXXXXXXXXGOOOOOOOOOOOOOOOXXXXGOOOOOXXXXXXXXXXXXXXGOOOOOOOOXXXXXXXXXXXGOOOOXXXXXXXXXXXXXXXGOOOOOOOOOOXXXXXXXXX,0,256,0
24591,138,1,137,92,110,0,0,270,137,133,GOOOOOOXXXXXXXXXXXXXGOOOOOOOOOOOXXXXXXXXGOOOOOOOOOOXXXXXXXXXGOOOOOOOOOOOOOOOOXXXGOOOOOOXXXXXXXXXXXXXGOOOOOOOOOOOOOOAXXXXGOOOOOOOOXXXXXXXXXXXGOOOOOOOOOOOXXXXXXXXGOOOOOOOOOOOOOOOXXXXGOOOOOXXXXXXXXXXXXXXGOOOOOOOOXXXXXXXXXXXGOOOOXXXXXXXXXXXXXXXGOOOOOOOOOOXXXXXXXXX,0,256,0
24612,138,1,137,90,112,0,0,272,142,130,GOOOOOOXXXXXXXXXXXXXGOOOOOOOOOOOXXXXXXXXGOOOOOOOOOOXXXXXXXXXGOOOOOOOOOOOOOOOOXXXGOOOOOOXXXXXXXXXXXXXGOOOOOOOOOOOOOOAXXXXGOOOOOOOOXXXXXXXXXXXGOOOOOOOOOOOXXXXXXXXGOOOOOOOOOOOOOOOXXXXGOOOOOXXXXXXXXXXXXXXGOOOOOOOOXXXXXXXXXXXGOOOOXXXXXXXXXXXXXXXGOOOOOOOOOOXXXXXXXXX,0,256,0
24633,138,1,137,91,111,0,0,271,150,121,GOOOOOOXXXXXXXXXXXXXGOOOOOOOOOOOXXXXXXXXGOOOOOOOOOOXXXXXXXXXGOOOOOOOOOOOOOOOOXXXGOOOOOOXXXXXXXXXXXXXGOOOOOOOOOOOOOOAXXXXGOOOOOOOOXXXXXXXXXXXGOOOOOOOOOOOXXXXXXXXGOOOOOOOOOOOOOOOXXXXGOOOOOXXXXXXXXXXXXXXGOOOOOOOOXXXXXXXXXXXGOOOOXXXXXXXXXXXXXXXGOOOOOOOOOOXXXXXXXXX,0,256,0
24654,138,1,137,86,116,0,0,275,151,124,GOOOOOOXXXXXXXXXXXXXGOOOOOOOOOOOXXXXXXXXGOOOOOOOOOOXXXXXXXXXGOOOOOOOOOOOOOOOOXXXGOOOOOOXXXXXXXXXXXXXGOOOOOOOOOOOOOOAXXXXGOOOOOOOOXXXXXXXXXXXGOOOOOOOOOOOXXXXXXXXGOOOOOOOOOOOOOOOXXXXGOOOOOXXXXXXXXXXXXXXGOOOOOOOOXXXXXXXXXXXGOOOOXXXXXXXXXXXXXXXGOOOOOOOOOOXXXXXXXXX,0,256,0

24675,138,1,137,89,113,0,0,273,145,128,GOOOOOOXXXXXXXXXXXXXGOOOOOOOOOOOXXXXXXXXGOOOOOOOOOOXXXXXXXXXGOOOOOOOOOOOOOOOOXXXGOOOOOOXXXXXXXXXXXXXGOOOOOOOOOOOOOOAXXXXGOOOOOOOOXXXXXXXXXXXGOOOOOOOOOOOXXXXXXXXGOOOOOOOOOOOOOOOXXXXGOOOOOXXXXXXXXXXXXXXGOOOOOOOOXXXXXXXXXXXGOOOOXXXXXXXXXXXXXXXGOOOOOOOOOOXXXXXXXXX,0,256,0
24696,138,1,137,89,113,0,0,273,146,127,GOOOOOOXXXXXXXXXXXXXGOOOOOOOOOOOXXXXXXXXGOOOOOOOOOOXXXXXXXXXGOOOOOOOOOOOOOOOOXXXGOOOOOOXXXXXXXXXXXXXGOOOOOOOOOOOOOOAXXXXGOOOOOOOOXXXXXXXXXXXGOOOOOOOOOOOXXXXXXXXGOOOOOOOOOOOOOOOXXXXGOOOOOXXXXXXXXXXXXXXGOOOOOOOOXXXXXXXXXXXGOOOOXXXXXXXXXXXXXXXGOOOOOOOOOOXXXXXXXXX,0,256,0
24717,138,1,137,85,117,0,0,277,150,127,GOOOOOOXXXXXXXXXXXXXGOOOOOOOOOOOXXXXXXXXGOOOOOOOOOOXXXXXXXXXGOOOOOOOOOOOOOOOOXXXGOOOOOOXXXXXXXXXXXXXGOOOOOOOOOOOOOOAXXXXGOOOOOOOOXXXXXXXXXXXGOOOOOOOOOOOXXXXXXXXGOOOOOOOOOOOOOOOXXXXGOOOOOXXXXXXXXXXXXXXGOOOOOOOOXXXXXXXXXXXGOOOOXXXXXXXXXXXXXXXGOOOOOOOOOOXXXXXXXXX,0,256,0
24738,138,1,137,96,106,0,0,266,141,125,GOOOOOOXXXXXXXXXXXXXGOOOOOOOOOOOXXXXXXXXGOOOOOOOOOOXXXXXXXXXGOOOOOOOOOOOOOOOOXXXGOOOOOOXXXXXXXXXXXXXGOOOOOOOOOOOOOOAXXXXGOOOOOOOOXXXXXXXXXXXGOOOOOOOOOOOXXXXXXXXGOOOOOOOOOOOOOOOXXXXGOOOOOXXXXXXXXXXXXXXGOOOOOOOOXXXXXXXXXXXGOOOOXXXXXXXXXXXXXXXGOOOOOOOOOOXXXXXXXXX,0,256,0
24759,138,1,137,87,115,0,0,275,141,134,GOOOOOOXXXXXXXXXXXXXGOOOOOOOOOOOXXXXXXXXGOOOOOOOOOOXXXXXXXXXGOOOOOOOOOOOOOOOOXXXGOOOOOOXXXXXXXXXXXXXGOOOOOOOOOOOOOOAXXXXGOOOOOOOOXXXXXXXXXXXGOOOOOOOOOOOXXXXXXXXGOOOOOOOOOOOOOOOXXXXGOOOOOXXXXXXXXXXXXXXGOOOOOOOOXXXXXXXXXXXGOOOOXXXXXXXXXXXXXXXGOOOOOOOOOOXXXXXXXXX,0,256,0

24780,138,1,137,85,117,0,0,278,148,130,GOOOOOOXXXXXXXXXXXXXGOOOOOOOOOOOXXXXXXXXGOOOOOOOOOOXXXXXXXXXGOOOOOOOOOOOOOOOOXXXGOOOOOOXXXXXXXXXXXXXGOOOOOOOOOOOOOOAXXXXGOOOOOOOOXXXXXXXXXXXGOOOOOOOOOOOXXXXXXXXGOOOOOOOOOOOOOOOXXXXGOOOOOXXXXXXXXXXXXXXGOOOOOOOOXXXXXXXXXXXGOOOOXXXXXXXXXXXXXXXGOOOOOOOOOOXXXXXXXXX,0,256,0
24801,138,1,137,83,119,0,0,279,150,129,GOOOOOOXXXXXXXXXXXXXGOOOOOOOOOOOXXXXXXXXGOOOOOOOOOOXXXXXXXXXGOOOOOOOOOOOOOOOOXXXGOOOOOOXXXXXXXXXXXXXGOOOOOOOOOOOOOOAXXXXGOOOOOOOOXXXXXXXXXXXGOOOOOOOOOOOXXXXXXXXGOOOOOOOOOOOOOOOXXXXGOOOOOXXXXXXXXXXXXXXGOOOOOOOOXXXXXXXXXXXGOOOOXXXXXXXXXXXXXXXGOOOOOOOOOOXXXXXXXXX,0,256,0
24822,140,3,137,88,112,0,0,272,149,123,GOOOOOOAXXXXXXXXXXXXGOOOOOOOOOOOXXXXXXXXGOOOOOOOOOOXXXXXXXXXGOOOOOOOOOOOOOOOOXXXGOOOOOOXXXXXXXXXXXXXGOOOOOOOOOOOOOOAXXXXGOOOOOOOOXXXXXXXXXXXGOOOOOOOOOOOXXXXXXXXGOOOOOOOOOOOOOOOXXXXGOOOOOXXXXXXXXXXXXXXGOOOOOOOOXXXXXXXXXXXGOOOOAXXXXXXXXXXXXXXGOOOOOOOOOOXXXXXXXXX,0,256,0
24843,140,2,138,83,117,0,0,277,149,128,GOOOOOOAXXXXXXXXXXXXGOOOOOOOOOOOXXXXXXXXGOOOOOOOOOOXXXXXXXXXGOOOOOOOOOOOOOOOOXXXGOOOOOOXXXXXXXXXXXXXGOOOOOOOOOOOOOOOXXXXGOOOOOOOOXXXXXXXXXXXGOOOOOOOOOOOXXXXXXXXGOOOOOOOOOOOOOOOXXXXGOOOOOXXXXXXXXXXXXXXGOOOOOOOOXXXXXXXXXXXGOOOOAXXXXXXXXXXXXXXGOOOOOOOOOOXXXXXXXXX,0,256,0
24864,140,2,138,88,112,0,0,272,143,129,GOOOOOOAXXXXXXXXXXXXGOOOOOOOOOOOXXXXXXXXGOOOOOOOOOOXXXXXXXXXGOOOOOOOOOOOOOOOOXXXGOOOOOOXXXXXXXXXXXXXGOOOOOOOOOOOOOOOXXXXGOOOOOOOOXXXXXXXXXXXGOOOOOOOOOOOXXXXXXXXGOOOOOOOOOOOOOOOXXXXGOOOOOXXXXXXXXXXXXXXGOOOOOOOOXXXXXXXXXXXGOOOOAXXXXXXXXXXXXXXGOOOOOOOOOOXXXXXXXXX,0,256,0

24885,140,1,139,85,115,0,0,273,142,131,GOOOOOOOXXXXXXXXXXXXGOOOOOOOOOOOXXXXXXXXGOOOOOOOOOOXXXXXXXXXGOOOOOOOOOOOOOOOOXXXGOOOOOOXXXXXXXXXXXXXGOOOOOOOOOOOOOOOXXXXGOOOOOOOOXXXXXXXXXXXGOOOOOOOOOOOXXXXXXXXGOOOOOOOOOOOOOOOXXXXGOOOOOXXXXXXXXXXXXXXGOOOOOOOOXXXXXXXXXXXGOOOOAXXXXXXXXXXXXXXGOOOOOOOOOOXXXXXXXXX,0,256,0
24906,140,1,139,88,112,0,0,272,139,133,GOOOOOOOXXXXXXXXXXXXGOOOOOOOOOOOXXXXXXXXGOOOOOOOOOOXXXXXXXXXGOOOOOOOOOOOOOOOOXXXGOOOOOOXXXXXXXXXXXXXGOOOOOOOOOOOOOOOXXXXGOOOOOOOOXXXXXXXXXXXGOOOOOOOOOOOXXXXXXXXGOOOOOOOOOOOOOOOXXXXGOOOOOXXXXXXXXXXXXXXGOOOOOOOOXXXXXXXXXXXGOOOOAXXXXXXXXXXXXXXGOOOOOOOOOOXXXXXXXXX,0,256,0
24927,140,1,139,91,109,0,0,269,135,134,GOOOOOOOXXXXXXXXXXXXGOOOOOOOOOOOXXXXXXXXGOOOOOOOOOOXXXXXXXXXGOOOOOOOOOOOOOOOOXXXGOOOOOOXXXXXXXXXXXXXGOOOOOOOOOOOOOOOXXXXGOOOOOOOOXXXXXXXXXXXGOOOOOOOOOOOXXXXXXXXGOOOOOOOOOOOOOOOXXXXGOOOOOXXXXXXXXXXXXXXGOOOOOOOOXXXXXXXXXXXGOOOOAXXXXXXXXXXXXXXGOOOOOOOOOOXXXXXXXXX,0,256,0
24948,140,1,139,94,106,0,0,265,137,128,GOOOOOOOXXXXXXXXXXXXGOOOOOOOOOOOXXXXXXXXGOOOOOOOOOOXXXXXXXXXGOOOOOOOOOOOOOOOOXXXGOOOOOOXXXXXXXXXXXXXGOOOOOOOOOOOOOOOXXXXGOOOOOOOOXXXXXXXXXXXGOOOOOOOOOOOXXXXXXXXGOOOOOOOOOOOOOOOXXXXGOOOOOXXXXXXXXXXXXXXGOOOOOOOOXXXXXXXXXXXGOOOOAXXXXXXXXXXXXXXGOOOOOOOOOOXXXXXXXXX,0,256,0
24969,140,1,139,93,107,0,0,267,145,122,GOOOOOOOXXXXXXXXXXXXGOOOOOOOOOOOXXXXXXXXGOOOOOOOOOOXXXXXXXXXGOOOOOOOOOOOOOOOOXXXGOOOOOOXXXXXXXXXXXXXGOOOOOOOOOOOOOOOXXXXGOOOOOOOOXXXXXXXXXXXGOOOOOOOOOOOXXXXXXXXGOOOOOOOOOOOOOOOXXXXGOOOOOXXXXXXXXXXXXXXGOOOOOOOOXXXXXXXXXXXGOOOOAXXXXXXXXXXXXXXGOOOOOOOOOOXXXXXXXXX,0,256,0

24990,140,1,139,95,105,0,0,264,151,113,GOOOOOOOXXXXXXXXXXXXGOOOOOOOOOOOXXXXXXXXGOOOOOOOOOOXXXXXXXXXGOOOOOOOOOOOOOOOOXXXGOOOOOOXXXXXXXXXXXXXGOOOOOOOOOOOOOOOXXXXGOOOOOOOOXXXXXXXXXXXGOOOOOOOOOOOXXXXXXXXGOOOOOOOOOOOOOOOXXXXGOOOOOXXXXXXXXXXXXXXGOOOOOOOOXXXXXXXXXXXGOOOOAXXXXXXXXXXXXXXGOOOOOOOOOOXXXXXXXXX,0,256,0
25011,140,1,139,97,103,0,0,263,145,118,GOOOOOOOXXXXXXXXXXXXGOOOOOOOOOOOXXXXXXXXGOOOOOOOOOOXXXXXXXXXGOOOOOOOOOOOOOOOOXXXGOOOOOOXXXXXXXXXXXXXGOOOOOOOOOOOOOOOXXXXGOOOOOOOOXXXXXXXXXXXGOOOOOOOOOOOXXXXXXXXGOOOOOOOOOOOOOOOXXXXGOOOOOXXXXXXXXXXXXXXGOOOOOOOOXXXXXXXXXXXGOOOOAXXXXXXXXXXXXXXGOOOOOOOOOOXXXXXXXXX,0,256,0
25032,140,1,139,97,103,0,0,263,138,125,GOOOOOOOXXXXXXXXXXXXGOOOOOOOOOOOXXXXXXXXGOOOOOOOOOOXXXXXXXXXGOOOOOOOOOOOOOOOOXXXGOOOOOOXXXXXXXXXXXXXGOOOOOOOOOOOOOOOXXXXGOOOOOOOOXXXXXXXXXXXGOOOOOOOOOOOXXXXXXXXGOOOOOOOOOOOOOOOXXXXGOOOOOXXXXXXXXXXXXXXGOOOOOOOOXXXXXXXXXXXGOOOOAXXXXXXXXXXXXXXGOOOOOOOOOOXXXXXXXXX,0,256,0
25053,140,1,139,92,108,0,0,269,138,131,GOOOOOOOXXXXXXXXXXXXGOOOOOOOOOOOXXXXXXXXGOOOOOOOOOOXXXXXXXXXGOOOOOOOOOOOOOOOOXXXGOOOOOOXXXXXXXXXXXXXGOOOOOOOOOOOOOOOXXXXGOOOOOOOOXXXXXXXXXXXGOOOOOOOOOOOXXXXXXXXGOOOOOOOOOOOOOOOXXXXGOOOOOXXXXXXXXXXXXXXGOOOOOOOOXXXXXXXXXXXGOOOOAXXXXXXXXXXXXXXGOOOOOOOOOOXXXXXXXXX,0,256,0
25074,140,1,139,85,115,0,0,276,144,132,GOOOOOOOXXXXXXXXXXXXGOOOOOOOOOOOXXXXXXXXGOOOOOOOOOOXXXXXXXXXGOOOOOOOOOOOOOOOOXXXGOOOOOOXXXXXXXXXXXXXGOOOOOOOOOOOOOOOXXXXGOOOOOOOOXXXXXXXXXXXGOOOOOOOOOOOXXXXXXXXGOOOOOOOOOOOOOOOXXXXGOOOOOXXXXXXXXXXXXXXGOOOOOOOOXXXXXXXXXXXGOOOOAXXXXXXXXXXXXXXGOOOOOOOOOOXXXXXXXXX,0,256,0

25095,140,1,139,88,112,0,0,273,148,125,GOOOOOOOXXXXXXXXXXXXGOOOOOOOOOOOXXXXXXXXGOOOOOOOOOOXXXXXXXXXGOOOOOOOOOOOOOOOOXXXGOOOOOOXXXXXXXXXXXXXGOOOOOOOOOOOOOOOXXXXGOOOOOOOOXXXXXXXXXXXGOOOOOOOOOOOXXXXXXXXGOOOOOOOOOOOOOOOXXXXGOOOOOXXXXXXXXXXXXXXGOOOOOOOOXXXXXXXXXXXGOOOOAXXXXXXXXXXXXXXGOOOOOOOOOOXXXXXXXXX,0,256,0
25116,140,1,139,92,108,0,0,268,141,127,GOOOOOOOXXXXXXXXXXXXGOOOOOOOOOOOXXXXXXXXGOOOOOOOOOOXXXXXXXXXGOOOOOOOOOOOOOOOOXXXGOOOOOOXXXXXXXXXXXXXGOOOOOOOOOOOOOOOXXXXGOOOOOOOOXXXXXXXXXXXGOOOOOOOOOOOXXXXXXXXGOOOOOOOOOOOOOOOXXXXGOOOOOXXXXXXXXXXXXXXGOOOOOOOOXXXXXXXXXXXGOOOOAXXXXXXXXXXXXXXGOOOOOOOOOOXXXXXXXXX,0,256,0
25137,140,1,139,94,106,0,0,267,136,131,GOOOOOOOXXXXXXXXXXXXGOOOOOOOOOOOXXXXXXXXGOOOOOOOOOOXXXXXXXXXGOOOOOOOOOOOOOOOOXXXGOOOOOOXXXXXXXXXXXXXGOOOOOOOOOOOOOOOXXXXGOOOOOOOOXXXXXXXXXXXGOOOOOOOOOOOXXXXXXXXGOOOOOOOOOOOOOOOXXXXGOOOOOXXXXXXXXXXXXXXGOOOOOOOOXXXXXXXXXXXGOOOOAXXXXXXXXXXXXXXGOOOOOOOOOOXXXXXXXXX,0,256,0
25158,140,1,139,93,107,0,0,268,144,124,GOOOOOOOXXXXXXXXXXXXGOOOOOOOOOOOXXXXXXXXGOOOOOOOOOOXXXXXXXXXGOOOOOOOOOOOOOOOOXXXGOOOOOOXXXXXXXXXXXXXGOOOOOOOOOOOOOOOXXXXGOOOOOOOOXXXXXXXXXXXGOOOOOOOOOOOXXXXXXXXGOOOOOOOOOOOOOOOXXXXGOOOOOXXXXXXXXXXXXXXGOOOOOOOOXXXXXXXXXXXGOOOOAXXXXXXXXXXXXXXGOOOOOOOOOOXXXXXXXXX,0,256,0
25179,140,0,140,84,116,0,0,277,152,125,GOOOOOOOXXXXXXXXXXXXGOOOOOOOOOOOXXXXXXXXGOOOOOOOOOOXXXXXXXXXGOOOOOOOOOOOOOOOOXXXGOOOOOOXXXXXXXXXXXXXGOOOOOOOOOOOOOOOXXXXGOOOOOOOOXXXXXXXXXXXGOOOOOOOOOOOXXXXXXXXGOOOOOOOOOOOOOOOXXXXGOOOOOXXXXXXXXXXXXXXGOOOOOOOOXXXXXXXXXXXGOOOOOXXXXXXXXXXXXXXGOOOOOOOOOOXXXXXXXXX,0,256,0

25200,140,0,140,95,105,0,0,265,147,118,GOOOOOOOXXXXXXXXXXXXGOOOOOOOOOOOXXXXXXXXGOOOOOOOOOOXXXXXXXXXGOOOOOOOOOOOOOOOOXXXGOOOOOOXXXXXXXXXXXXXGOOOOOOOOOOOOOOOXXXXGOOOOOOOOXXXXXXXXXXXGOOOOOOOOOOOXXXXXXXXGOOOOOOOOOOOOOOOXXXXGOOOOOXXXXXXXXXXXXXXGOOOOOOOOXXXXXXXXXXXGOOOOOXXXXXXXXXXXXXXGOOOOOOOOOOXXXXXXXXX,0,256,0
25221,140,0,140,90,110,0,0,271,143,128,GOOOOOOOXXXXXXXXXXXXGOOOOOOOOOOOXXXXXXXXGOOOOOOOOOOXXXXXXXXXGOOOOOOOOOOOOOOOOXXXGOOOOOOXXXXXXXXXXXXXGOOOOOOOOOOOOOOOXXXXGOOOOOOOOXXXXXXXXXXXGOOOOOOOOOOOXXXXXXXXGOOOOOOOOOOOOOOOXXXXGOOOOOXXXXXXXXXXXXXXGOOOOOOOOXXXXXXXXXXXGOOOOOXXXXXXXXXXXXXXGOOOOOOOOOOXXXXXXXXX,0,256,0
25242,140,0,140,95,105,0,0,266,145,121,GOOOOOOOXXXXXXXXXXXXGOOOOOOOOOOOXXXXXXXXGOOOOOOOOOOXXXXXXXXXGOOOOOOOOOOOOOOOOXXXGOOOOOOXXXXXXXXXXXXXGOOOOOOOOOOOOOOOXXXXGOOOOOOOOXXXXXXXXXXXGOOOOOOOOOOOXXXXXXXXGOOOOOOOOOOOOOOOXXXXGOOOOOXXXXXXXXXXXXXXGOOOOOOOOXXXXXXXXXXXGOOOOOXXXXXXXXXXXXXXGOOOOOOOOOOXXXXXXXXX,0,256,0
25263,140,0,140,94,106,0,0,267,146,121,GOOOOOOOXXXXXXXXXXXXGOOOOOOOOOOOXXXXXXXXGOOOOOOOOOOXXXXXXXXXGOOOOOOOOOOOOOOOOXXXGOOOOOOXXXXXXXXXXXXXGOOOOOOOOOOOOOOOXXXXGOOOOOOOOXXXXXXXXXXXGOOOOOOOOOOOXXXXXXXXGOOOOOOOOOOOOOOOXXXXGOOOOOXXXXXXXXXXXXXXGOOOOOOOOXXXXXXXXXXXGOOOOOXXXXXXXXXXXXXXGOOOOOOOOOOXXXXXXXXX,0,256,0
25284,140,0,140,90,110,0,0,271,148,123,GOOOOOOOXXXXXXXXXXXXGOOOOOOOOOOOXXXXXXXXGOOOOOOOOOOXXXXXXXXXGOOOOOOOOOOOOOOOOXXXGOOOOOOXXXXXXXXXXXXXGOOOOOOOOOOOOOOOXXXXGOOOOOOOOXXXXXXXXXXXGOOOOOOOOOOOXXXXXXXXGOOOOOOOOOOOOOOOXXXXGOOOOOXXXXXXXXXXXXXXGOOOOOOOOXXXXXXXXXXXGOOOOOXXXXXXXXXXXXXXGOOOOOOOOOOXXXXXXXXX,0,256,0

25305,140,0,140,93,107,0,0,268,144,124,GOOOOOOOXXXXXXXXXXXXGOOOOOOOOOOOXXXXXXXXGOOOOOOOOOOXXXXXXXXXGOOOOOOOOOOOOOOOOXXXGOOOOOOXXXXXXXXXXXXXGOOOOOOOOOOOOOOOXXXXGOOOOOOOOXXXXXXXXXXXGOOOOOOOOOOOXXXXXXXXGOOOOOOOOOOOOOOOXXXXGOOOOOXXXXXXXXXXXXXXGOOOOOOOOXXXXXXXXXXXGOOOOOXXXXXXXXXXXXXXGOOOOOOOOOOXXXXXXXXX,0,256,0
25326,140,0,140,95,105,0,0,265,144,121,GOOOOOOOXXXXXXXXXXXXGOOOOOOOOOOOXXXXXXXXGOOOOOOOOOOXXXXXXXXXGOOOOOOOOOOOOOOOOXXXGOOOOOOXXXXXXXXXXXXXGOOOOOOOOOOOOOOOXXXXGOOOOOOOOXXXXXXXXXXXGOOOOOOOOOOOXXXXXXXXGOOOOOOOOOOOOOOOXXXXGOOOOOXXXXXXXXXXXXXXGOOOOOOOOXXXXXXXXXXXGOOOOOXXXXXXXXXXXXXXGOOOOOOOOOOXXXXXXXXX,0,256,0
25347,140,0,140,96,104,0,0,264,140,124,GOOOOOOOXXXXXXXXXXXXGOOOOOOOOOOOXXXXXXXXGOOOOOOOOOOXXXXXXXXXGOOOOOOOOOOOOOOOOXXXGOOOOOOXXXXXXXXXXXXXGOOOOOOOOOOOOOOOXXXXGOOOOOOOOXXXXXXXXXXXGOOOOOOOOOOOXXXXXXXXGOOOOOOOOOOOOOOOXXXXGOOOOOXXXXXXXXXXXXXXGOOOOOOOOXXXXXXXXXXXGOOOOOXXXXXXXXXXXXXXGOOOOOOOOOOXXXXXXXXX,0,256,0
25368,140,0,140,94,106,0,0,267,139,128,GOOOOOOOXXXXXXXXXXXXGOOOOOOOOOOOXXXXXXXXGOOOOOOOOOOXXXXXXXXXGOOOOOOOOOOOOOOOOXXXGOOOOOOXXXXXXXXXXXXXGOOOOOOOOOOOOOOOXXXXGOOOOOOOOXXXXXXXXXXXGOOOOOOOOOOOXXXXXXXXGOOOOOOOOOOOOOOOXXXXGOOOOOXXXXXXXXXXXXXXGOOOOOOOOXXXXXXXXXXXGOOOOOXXXXXXXXXXXXXXGOOOOOOOOOOXXXXXXXXX,0,256,0
25389,140,0,140,97,103,0,0,264,135,129,GOOOOOOOXXXXXXXXXXXXGOOOOOOOOOOOXXXXXXXXGOOOOOOOOOOXXXXXXXXXGOOOOOOOOOOOOOOOOXXXGOOOOOOXXXXXXXXXXXXXGOOOOOOOOOOOOOOOXXXXGOOOOOOOOXXXXXXXXXXXGOOOOOOOOOOOXXXXXXXXGOOOOOOOOOOOOOOOXXXXGOOOOOXXXXXXXXXXXXXXGOOOOOOOOXXXXXXXXXXXGOOOOOXXXXXXXXXXXXXXGOOOOOOOOOOXXXXXXXXX,0,256,0

25410,141,1,140,94,105,0,0,266,142,124,GOOOOOOOXXXXXXXXXXXXGOOOOOOOOOOOXXXXXXXXGOOOOOOOOOOXXXXXXXXXGOOOOOOOOOOOOOOOOXXXGOOOOOOXXXXXXXXXXXXXGOOOOOOOOOOOOOOOXXXXGOOOOOOOOXXXXXXXXXXXGOOOOOOOOOOOAXXXXXXXGOOOOOOOOOOOOOOOXXXXGOOOOOXXXXXXXXXXXXXXGOOOOOOOOXXXXXXXXXXXGOOOOOXXXXXXXXXXXXXXGOOOOOOOOOOXXXXXXXXX,0,256,0
25431,141,1,140,91,108,0,0,268,141,127,GOOOOOOOXXXXXXXXXXXXGOOOOOOOOOOOXXXXXXXXGOOOOOOOOOOXXXXXXXXXGOOOOOOOOOOOOOOOOXXXGOOOOOOXXXXXXXXXXXXXGOOOOOOOOOOOOOOOXXXXGOOOOOOOOXXXXXXXXXXXGOOOOOOOOOOOAXXXXXXXGOOOOOOOOOOOOOOOXXXXGOOOOOXXXXXXXXXXXXXXGOOOOOOOOXXXXXXXXXXXGOOOOOXXXXXXXXXXXXXXGOOOOOOOOOOXXXXXXXXX,0,256,0
25452,141,1,140,87,112,0,0,273,141,132,GOOOOOOOXXXXXXXXXXXXGOOOOOOOOOOOXXXXXXXXGOOOOOOOOOOXXXXXXXXXGOOOOOOOOOOOOOOOOXXXGOOOOOOXXXXXXXXXXXXXGOOOOOOOOOOOOOOOXXXXGOOOOOOOOXXXXXXXXXXXGOOOOOOOOOOOAXXXXXXXGOOOOOOOOOOOOOOOXXXXGOOOOOXXXXXXXXXXXXXXGOOOOOOOOXXXXXXXXXXXGOOOOOXXXXXXXXXXXXXXGOOOOOOOOOOXXXXXXXXX,0,256,0
25473,141,1,140,85,114,0,0,274,143,131,GOOOOOOOXXXXXXXXXXXXGOOOOOOOOOOOXXXXXXXXGOOOOOOOOOOXXXXXXXXXGOOOOOOOOOOOOOOOOXXXGOOOOOOXXXXXXXXXXXXXGOOOOOOOOOOOOOOOXXXXGOOOOOOOOXXXXXXXXXXXGOOOOOOOOOOOAXXXXXXXGOOOOOOOOOOOOOOOXXXXGOOOOOXXXXXXXXXXXXXXGOOOOOOOOXXXXXXXXXXXGOOOOOXXXXXXXXXXXXXXGOOOOOOOOOOXXXXXXXXX,0,256,0
25494,141,0,141,85,114,0,0,273,145,128,GOOOOOOOXXXXXXXXXXXXGOOOOOOOOOOOXXXXXXXXGOOOOOOOOOOXXXXXXXXXGOOOOOOOOOOOOOOOOXXXGOOOOOOXXXXXXXXXXXXXGOOOOOOOOOOOOOOOXXXXGOOOOOOOOXXXXXXXXXXXGOOOOOOOOOOOOXXXXXXXGOOOOOOOOOOOOOOOXXXXGOOOOOXXXXXXXXXXXXXXGOOOOOOOOXXXXXXXXXXXGOOOOOXXXXXXXXXXXXXXGOOOOOOOOOOXXXXXXXXX,0,256,0

25515,141,0,141,86,113,0,0,273,144,129,GOOOOOOOXXXXXXXXXXXXGOOOOOOOOOOOXXXXXXXXGOOOOOOOOOOXXXXXXXXXGOOOOOOOOOOOOOOOOXXXGOOOOOOXXXXXXXXXXXXXGOOOOOOOOOOOOOOOXXXXGOOOOOOOOXXXXXXXXXXXGOOOOOOOOOOOOXXXXXXXGOOOOOOOOOOOOOOOXXXXGOOOOOXXXXXXXXXXXXXXGOOOOOOOOXXXXXXXXXXXGOOOOOXXXXXXXXXXXXXXGOOOOOOOOOOXXXXXXXXX,0,256,0
25536,141,0,141,83,116,0,0,276,146,130,GOOOOOOOXXXXXXXXXXXXGOOOOOOOOOOOXXXXXXXXGOOOOOOOOOOXXXXXXXXXGOOOOOOOOOOOOOOOOXXXGOOOOOOXXXXXXXXXXXXXGOOOOOOOOOOOOOOOXXXXGOOOOOOOOXXXXXXXXXXXGOOOOOOOOOOOOXXXXXXXGOOOOOOOOOOOOOOOXXXXGOOOOOXXXXXXXXXXXXXXGOOOOOOOOXXXXXXXXXXXGOOOOOXXXXXXXXXXXXXXGOOOOOOOOOOXXXXXXXXX,0,256,0
25557,141,0,141,78,121,0,0,281,143,138,GOOOOOOOXXXXXXXXXXXXGOOOOOOOOOOOXXXXXXXXGOOOOOOOOOOXXXXXXXXXGOOOOOOOOOOOOOOOOXXXGOOOOOOXXXXXXXXXXXXXGOOOOOOOOOOOOOOOXXXXGOOOOOOOOXXXXXXXXXXXGOOOOOOOOOOOOXXXXXXXGOOOOOOOOOOOOOOOXXXXGOOOOOXXXXXXXXXXXXXXGOOOOOOOOXXXXXXXXXXXGOOOOOXXXXXXXXXXXXXXGOOOOOOOOOOXXXXXXXXX,0,256,0
25578,141,0,141,81,118,0,0,278,140,138,GOOOOOOOXXXXXXXXXXXXGOOOOOOOOOOOXXXXXXXXGOOOOOOOOOOXXXXXXXXXGOOOOOOOOOOOOOOOOXXXGOOOOOOXXXXXXXXXXXXXGOOOOOOOOOOOOOOOXXXXGOOOOOOOOXXXXXXXXXXXGOOOOOOOOOOOOXXXXXXXGOOOOOOOOOOOOOOOXXXXGOOOOOXXXXXXXXXXXXXXGOOOOOOOOXXXXXXXXXXXGOOOOOXXXXXXXXXXXXXXGOOOOOOOOOOXXXXXXXXX,0,256,0
25599,141,0,141,85,114,0,0,274,139,135,GOOOOOOOXXXXXXXXXXXXGOOOOOOOOOOOXXXXXXXXGOOOOOOOOOOXXXXXXXXXGOOOOOOOOOOOOOOOOXXXGOOOOOOXXXXXXXXXXXXXGOOOOOOOOOOOOOOOXXXXGOOOOOOOOXXXXXXXXXXXGOOOOOOOOOOOOXXXXXXXGOOOOOOOOOOOOOOOXXXXGOOOOOXXXXXXXXXXXXXXGOOOOOOOOXXXXXXXXXXXGOOOOOXXXXXXXXXXXXXXGOOOOOOOOOOXXXXXXXXX,0,256,0

25620,141,0,141,76,123,0,0,283,144,139,GOOOOOOOXXXXXXXXXXXXGOOOOOOOOOOOXXXXXXXXGOOOOOOOOOOXXXXXXXXXGOOOOOOOOOOOOOOOOXXXGOOOOOOXXXXXXXXXXXXXGOOOOOOOOOOOOOOOXXXXGOOOOOOOOXXXXXXXXXXXGOOOOOOOOOOOOXXXXXXXGOOOOOOOOOOOOOOOXXXXGOOOOOXXXXXXXXXXXXXXGOOOOOOOOXXXXXXXXXXXGOOOOOXXXXXXXXXXXXXXGOOOOOOOOOOXXXXXXXXX,0,256,0
25641,142,1,141,76,122,0,0,282,142,140,GOOOOOOOXXXXXXXXXXXXGOOOOOOOOOOOXXXXXXXXGOOOOOOOOOOXXXXXXXXXGOOOOOOOOOOOOOOOOXXXGOOOOOOXXXXXXXXXXXXXGOOOOOOOOOOOOOOOXXXXGOOOOOOOOXXXXXXXXXXXGOOOOOOOOOOOOXXXXXXXGOOOOOOOOOOOOOOOXXXXGOOOOOXXXXXXXXXXXXXXGOOOOOOOOXXXXXXXXXXXGOOOOOAXXXXXXXXXXXXXGOOOOOOOOOOXXXXXXXXX,0,256,0
25662,142,1,141,78,120,0,0,281,144,137,GOOOOOOOXXXXXXXXXXXXGOOOOOOOOOOOXXXXXXXXGOOOOOOOOOOXXXXXXXXXGOOOOOOOOOOOOOOOOXXXGOOOOOOXXXXXXXXXXXXXGOOOOOOOOOOOOOOOXXXXGOOOOOOOOXXXXXXXXXXXGOOOOOOOOOOOOXXXXXXXGOOOOOOOOOOOOOOOXXXXGOOOOOXXXXXXXXXXXXXXGOOOOOOOOXXXXXXXXXXXGOOOOOAXXXXXXXXXXXXXGOOOOOOOOOOXXXXXXXXX,0,256,0
25683,142,0,142,81,117,0,0,277,144,133,GOOOOOOOXXXXXXXXXXXXGOOOOOOOOOOOXXXXXXXXGOOOOOOOOOOXXXXXXXXXGOOOOOOOOOOOOOOOOXXXGOOOOOOXXXXXXXXXXXXXGOOOOOOOOOOOOOOOXXXXGOOOOOOOOXXXXXXXXXXXGOOOOOOOOOOOOXXXXXXXGOOOOOOOOOOOOOOOXXXXGOOOOOXXXXXXXXXXXXXXGOOOOOOOOXXXXXXXXXXXGOOOOOOXXXXXXXXXXXXXGOOOOOOOOOOXXXXXXXXX,0,256,0
25704,142,0,142,85,113,0,0,273,143,130,GOOOOOOOXXXXXXXXXXXXGOOOOOOOOOOOXXXXXXXXGOOOOOOOOOOXXXXXXXXXGOOOOOOOOOOOOOOOOXXXGOOOOOOXXXXXXXXXXXXXGOOOOOOOOOOOOOOOXXXXGOOOOOOOOXXXXXXXXXXXGOOOOOOOOOOOOXXXXXXXGOOOOOOOOOOOOOOOXXXXGOOOOOXXXXXXXXXXXXXXGOOOOOOOOXXXXXXXXXXXGOOOOOOXXXXXXXXXXXXXGOOOOOOOOOOXXXXXXXXX,0,256,0

25725,142,0,142,86,112,0,0,272,140,132,GOOOOOOOXXXXXXXXXXXXGOOOOOOOOOOOXXXXXXXXGOOOOOOOOOOXXXXXXXXXGOOOOOOOOOOOOOOOOXXXGOOOOOOXXXXXXXXXXXXXGOOOOOOOOOOOOOOOXXXXGOOOOOOOOXXXXXXXXXXXGOOOOOOOOOOOOXXXXXXXGOOOOOOOOOOOOOOOXXXXGOOOOOXXXXXXXXXXXXXXGOOOOOOOOXXXXXXXXXXXGOOOOOOXXXXXXXXXXXXXGOOOOOOOOOOXXXXXXXXX,0,256,0
25746,142,0,142,81,117,0,0,277,144,133,GOOOOOOOXXXXXXXXXXXXGOOOOOOOOOOOXXXXXXXXGOOOOOOOOOOXXXXXXXXXGOOOOOOOOOOOOOOOOXXXGOOOOOOXXXXXXXXXXXXXGOOOOOOOOOOOOOOOXXXXGOOOOOOOOXXXXXXXXXXXGOOOOOOOOOOOOXXXXXXXGOOOOOOOOOOOOOOOXXXXGOOOOOXXXXXXXXXXXXXXGOOOOOOOOXXXXXXXXXXXGOOOOOOXXXXXXXXXXXXXGOOOOOOOOOOXXXXXXXXX,0,256,0
25767,142,0,142,83,115,0,0,275,145,130,GOOOOOOOXXXXXXXXXXXXGOOOOOOOOOOOXXXXXXXXGOOOOOOOOOOXXXXXXXXXGOOOOOOOOOOOOOOOOXXXGOOOOOOXXXXXXXXXXXXXGOOOOOOOOOOOOOOOXXXXGOOOOOOOOXXXXXXXXXXXGOOOOOOOOOOOOXXXXXXXGOOOOOOOOOOOOOOOXXXXGOOOOOXXXXXXXXXXXXXXGOOOOOOOOXXXXXXXXXXXGOOOOOOXXXXXXXXXXXXXGOOOOOOOOOOXXXXXXXXX,0,256,0
25788,142,0,142,88,110,0,0,270,148,122,GOOOOOOOXXXXXXXXXXXXGOOOOOOOOOOOXXXXXXXXGOOOOOOOOOOXXXXXXXXXGOOOOOOOOOOOOOOOOXXXGOOOOOOXXXXXXXXXXXXXGOOOOOOOOOOOOOOOXXXXGOOOOOOOOXXXXXXXXXXXGOOOOOOOOOOOOXXXXXXXGOOOOOOOOOOOOOOOXXXXGOOOOOXXXXXXXXXXXXXXGOOOOOOOOXXXXXXXXXXXGOOOOOOXXXXXXXXXXXXXGOOOOOOOOOOXXXXXXXXX,0,256,0
25809,142,0,142,92,106,0,0,266,142,124,GOOOOOOOXXXXXXXXXXXXGOOOOOOOOOOOXXXXXXXXGOOOOOOOOOOXXXXXXXXXGOOOOOOOOOOOOOOOOXXXGOOOOOOXXXXXXXXXXXXXGOOOOOOOOOOOOOOOXXXXGOOOOOOOOXXXXXXXXXXXGOOOOOOOOOOOOXXXXXXXGOOOOOOOOOOOOOOOXXXXGOOOOOXXXXXXXXXXXXXXGOOOOOOOOXXXXXXXXXXXGOOOOOOXXXXXXXXXXXXXGOOOOOOOOOOXXXXXXXXX,0,256,0

25830,142,0,142,86,112,0,0,272,144,128,GOOOOOOOXXXXXXXXXXXXGOOOOOOOOOOOXXXXXXXXGOOOOOOOOOOXXXXXXXXXGOOOOOOOOOOOOOOOOXXXGOOOOOOXXXXXXXXXXXXXGOOOOOOOOOOOOOOOXXXXGOOOOOOOOXXXXXXXXXXXGOOOOOOOOOOOOXXXXXXXGOOOOOOOOOOOOOOOXXXXGOOOOOXXXXXXXXXXXXXXGOOOOOOOOXXXXXXXXXXXGOOOOOOXXXXXXXXXXXXXGOOOOOOOOOOXXXXXXXXX,0,256,0
25851,142,0,142,83,115,0,0,276,141,135,GOOOOOOOXXXXXXXXXXXXGOOOOOOOOOOOXXXXXXXXGOOOOOOOOOOXXXXXXXXXGOOOOOOOOOOOOOOOOXXXGOOOOOOXXXXXXXXXXXXXGOOOOOOOOOOOOOOOXXXXGOOOOOOOOXXXXXXXXXXXGOOOOOOOOOOOOXXXXXXXGOOOOOOOOOOOOOOOXXXXGOOOOOXXXXXXXXXXXXXXGOOOOOOOOXXXXXXXXXXXGOOOOOOXXXXXXXXXXXXXGOOOOOOOOOOXXXXXXXXX,0,256,0
25872,142,0,142,87,111,0,0,272,145,127,GOOOOOOOXXXXXXXXXXXXGOOOOOOOOOOOXXXXXXXXGOOOOOOOOOOXXXXXXXXXGOOOOOOOOOOOOOOOOXXXGOOOOOOXXXXXXXXXXXXXGOOOOOOOOOOOOOOOXXXXGOOOOOOOOXXXXXXXXXXXGOOOOOOOOOOOOXXXXXXXGOOOOOOOOOOOOOOOXXXXGOOOOOXXXXXXXXXXXXXXGOOOOOOOOXXXXXXXXXXXGOOOOOOXXXXXXXXXXXXXGOOOOOOOOOOXXXXXXXXX,0,256,0
25893,142,0,142,82,116,0,0,277,145,132,GOOOOOOOXXXXXXXXXXXXGOOOOOOOOOOOXXXXXXXXGOOOOOOOOOOXXXXXXXXXGOOOOOOOOOOOOOOOOXXXGOOOOOOXXXXXXXXXXXXXGOOOOOOOOOOOOOOOXXXXGOOOOOOOOXXXXXXXXXXXGOOOOOOOOOOOOXXXXXXXGOOOOOOOOOOOOOOOXXXXGOOOOOXXXXXXXXXXXXXXGOOOOOOOOXXXXXXXXXXXGOOOOOOXXXXXXXXXXXXXGOOOOOOOOOOXXXXXXXXX,0,256,0
25914,142,0,142,81,117,0,0,278,152,126,GOOOOOOOXXXXXXXXXXXXGOOOOOOOOOOOXXXXXXXXGOOOOOOOOOOXXXXXXXXXGOOOOOOOOOOOOOOOOXXXGOOOOOOXXXXXXXXXXXXXGOOOOOOOOOOOOOOOXXXXGOOOOOOOOXXXXXXXXXXXGOOOOOOOOOOOOXXXXXXXGOOOOOOOOOOOOOOOXXXXGOOOOOXXXXXXXXXXXXXXGOOOOOOOOXXXXXXXXXXXGOOOOOOXXXXXXXXXXXXXGOOOOOOOOOOXXXXXXXXX,0,256,0

25935,142,0,142,83,115,0,0,276,153,123,GOOOOOOOXXXXXXXXXXXXGOOOOOOOOOOOXXXXXXXXGOOOOOOOOOOXXXXXXXXXGOOOOOOOOOOOOOOOOXXXGOOOOOOXXXXXXXXXXXXXGOOOOOOOOOOOOOOOXXXXGOOOOOOOOXXXXXXXXXXXGOOOOOOOOOOOOXXXXXXXGOOOOOOOOOOOOOOOXXXXGOOOOOXXXXXXXXXXXXXXGOOOOOOOOXXXXXXXXXXXGOOOOOOXXXXXXXXXXXXXGOOOOOOOOOOXXXXXXXXX,0,256,0
25956,142,0,142,84,114,0,0,274,147,127,GOOOOOOOXXXXXXXXXXXXGOOOOOOOOOOOXXXXXXXXGOOOOOOOOOOXXXXXXXXXGOOOOOOOOOOOOOOOOXXXGOOOOOOXXXXXXXXXXXXXGOOOOOOOOOOOOOOOXXXXGOOOOOOOOXXXXXXXXXXXGOOOOOOOOOOOOXXXXXXXGOOOOOOOOOOOOOOOXXXXGOOOOOXXXXXXXXXXXXXXGOOOOOOOOXXXXXXXXXXXGOOOOOOXXXXXXXXXXXXXGOOOOOOOOOOXXXXXXXXX,0,256,0
25977,142,0,142,89,109,0,0,270,146,124,GOOOOOOOXXXXXXXXXXXXGOOOOOOOOOOOXXXXXXXXGOOOOOOOOOOXXXXXXXXXGOOOOOOOOOOOOOOOOXXXGOOOOOOXXXXXXXXXXXXXGOOOOOOOOOOOOOOOXXXXGOOOOOOOOXXXXXXXXXXXGOOOOOOOOOOOOXXXXXXXGOOOOOOOOOOOOOOOXXXXGOOOOOXXXXXXXXXXXXXXGOOOOOOOOXXXXXXXXXXXGOOOOOOXXXXXXXXXXXXXGOOOOOOOOOOXXXXXXXXX,0,256,0
25998,142,0,142,83,115,0,0,276,147,129,GOOOOOOOXXXXXXXXXXXXGOOOOOOOOOOOXXXXXXXXGOOOOOOOOOOXXXXXXXXXGOOOOOOOOOOOOOOOOXXXGOOOOOOXXXXXXXXXXXXXGOOOOOOOOOOOOOOOXXXXGOOOOOOOOXXXXXXXXXXXGOOOOOOOOOOOOXXXXXXXGOOOOOOOOOOOOOOOXXXXGOOOOOXXXXXXXXXXXXXXGOOOOOOOOXXXXXXXXXXXGOOOOOOXXXXXXXXXXXXXGOOOOOOOOOOXXXXXXXXX,0,256,0
26019,142,0,142,82,116,0,0,277,151,126,GOOOOOOOXXXXXXXXXXXXGOOOOOOOOOOOXXXXXXXXGOOOOOOOOOOXXXXXXXXXGOOOOOOOOOOOOOOOOXXXGOOOOOOXXXXXXXXXXXXXGOOOOOOOOOOOOOOOXXXXGOOOOOOOOXXXXXXXXXXXGOOOOOOOOOOOOXXXXXXXGOOOOOOOOOOOOOOOXXXXGOOOOOXXXXXXXXXXXXXXGOOOOOOOOXXXXXXXXXXXGOOOOOOXXXXXXXXXXXXXGOOOOOOOOOOXXXXXXXXX,0,256,0

26040,142,0,142,89,109,0,0,269,146,123,GOOOOOOOXXXXXXXXXXXXGOOOOOOOOOOOXXXXXXXXGOOOOOOOOOOXXXXXXXXXGOOOOOOOOOOOOOOOOXXXGOOOOOOXXXXXXXXXXXXXGOOOOOOOOOOOOOOOXXXXGOOOOOOOOXXXXXXXXXXXGOOOOOOOOOOOOXXXXXXXGOOOOOOOOOOOOOOOXXXXGOOOOOXXXXXXXXXXXXXXGOOOOOOOOXXXXXXXXXXXGOOOOOOXXXXXXXXXXXXXGOOOOOOOOOOXXXXXXXXX,0,256,0
26061,142,0,142,87,111,0,0,271,148,123,GOOOOOOOXXXXXXXXXXXXGOOOOOOOOOOOXXXXXXXXGOOOOOOOOOOXXXXXXXXXGOOOOOOOOOOOOOOOOXXXGOOOOOOXXXXXXXXXXXXXGOOOOOOOOOOOOOOOXXXXGOOOOOOOOXXXXXXXXXXXGOOOOOOOOOOOOXXXXXXXGOOOOOOOOOOOOOOOXXXXGOOOOOXXXXXXXXXXXXXXGOOOOOOOOXXXXXXXXXXXGOOOOOOXXXXXXXXXXXXXGOOOOOOOOOOXXXXXXXXX,0,256,0
26082,142,0,142,89,109,0,0,269,149,120,GOOOOOOOXXXXXXXXXXXXGOOOOOOOOOOOXXXXXXXXGOOOOOOOOOOXXXXXXXXXGOOOOOOOOOOOOOOOOXXXGOOOOOOXXXXXXXXXXXXXGOOOOOOOOOOOOOOOXXXXGOOOOOOOOXXXXXXXXXXXGOOOOOOOOOOOOXXXXXXXGOOOOOOOOOOOOOOOXXXXGOOOOOXXXXXXXXXXXXXXGOOOOOOOOXXXXXXXXXXXGOOOOOOXXXXXXXXXXXXXGOOOOOOOOOOXXXXXXXXX,0,256,0
26103,142,0,142,87,111,0,0,270,148,122,GOOOOOOOXXXXXXXXXXXXGOOOOOOOOOOOXXXXXXXXGOOOOOOOOOOXXXXXXXXXGOOOOOOOOOOOOOOOOXXXGOOOOOOXXXXXXXXXXXXXGOOOOOOOOOOOOOOOXXXXGOOOOOOOOXXXXXXXXXXXGOOOOOOOOOOOOXXXXXXXGOOOOOOOOOOOOOOOXXXXGOOOOOXXXXXXXXXXXXXXGOOOOOOOOXXXXXXXXXXXGOOOOOOXXXXXXXXXXXXXGOOOOOOOOOOXXXXXXXXX,0,256,0
26124,142,0,142,92,106,0,0,266,143,123,GOOOOOOOXXXXXXXXXXXXGOOOOOOOOOOOXXXXXXXXGOOOOOOOOOOXXXXXXXXXGOOOOOOOOOOOOOOOOXXXGOOOOOOXXXXXXXXXXXXXGOOOOOOOOOOOOOOOXXXXGOOOOOOOOXXXXXXXXXXXGOOOOOOOOOOOOXXXXXXXGOOOOOOOOOOOOOOOXXXXGOOOOOXXXXXXXXXXXXXXGOOOOOOOOXXXXXXXXXXXGOOOOOOXXXXXXXXXXXXXGOOOOOOOOOOXXXXXXXXX,0,256,0

26145,142,0,142,83,115,0,0,275,144,131,GOOOOOOOXXXXXXXXXXXXGOOOOOOOOOOOXXXXXXXXGOOOOOOOOOOXXXXXXXXXGOOOOOOOOOOOOOOOOXXXGOOOOOOXXXXXXXXXXXXXGOOOOOOOOOOOOOOOXXXXGOOOOOOOOXXXXXXXXXXXGOOOOOOOOOOOOXXXXXXXGOOOOOOOOOOOOOOOXXXXGOOOOOXXXXXXXXXXXXXXGOOOOOOOOXXXXXXXXXXXGOOOOOOXXXXXXXXXXXXXGOOOOOOOOOOXXXXXXXXX,0,256,0
26166,142,0,142,83,115,0,0,275,145,130,GOOOOOOOXXXXXXXXXXXXGOOOOOOOOOOOXXXXXXXXGOOOOOOOOOOXXXXXXXXXGOOOOOOOOOOOOOOOOXXXGOOOOOOXXXXXXXXXXXXXGOOOOOOOOOOOOOOOXXXXGOOOOOOOOXXXXXXXXXXXGOOOOOOOOOOOOXXXXXXXGOOOOOOOOOOOOOOOXXXXGOOOOOXXXXXXXXXXXXXXGOOOOOOOOXXXXXXXXXXXGOOOOOOXXXXXXXXXXXXXGOOOOOOOOOOXXXXXXXXX,0,256,0
26187,142,0,142,77,121,0,0,281,148,133,GOOOOOOOXXXXXXXXXXXXGOOOOOOOOOOOXXXXXXXXGOOOOOOOOOOXXXXXXXXXGOOOOOOOOOOOOOOOOXXXGOOOOOOXXXXXXXXXXXXXGOOOOOOOOOOOOOOOXXXXGOOOOOOOOXXXXXXXXXXXGOOOOOOOOOOOOXXXXXXXGOOOOOOOOOOOOOOOXXXXGOOOOOXXXXXXXXXXXXXXGOOOOOOOOXXXXXXXXXXXGOOOOOOXXXXXXXXXXXXXGOOOOOOOOOOXXXXXXXXX,0,256,0
26208,142,0,142,73,125,0,0,285,149,136,GOOOOOOOXXXXXXXXXXXXGOOOOOOOOOOOXXXXXXXXGOOOOOOOOOOXXXXXXXXXGOOOOOOOOOOOOOOOOXXXGOOOOOOXXXXXXXXXXXXXGOOOOOOOOOOOOOOOXXXXGOOOOOOOOXXXXXXXXXXXGOOOOOOOOOOOOXXXXXXXGOOOOOOOOOOOOOOOXXXXGOOOOOXXXXXXXXXXXXXXGOOOOOOOOXXXXXXXXXXXGOOOOOOXXXXXXXXXXXXXGOOOOOOOOOOXXXXXXXXX,0,256,0
26229,142,0,142,73,125,0,0,285,151,134,GOOOOOOOXXXXXXXXXXXXGOOOOOOOOOOOXXXXXXXXGOOOOOOOOOOXXXXXXXXXGOOOOOOOOOOOOOOOOXXXGOOOOOOXXXXXXXXXXXXXGOOOOOOOOOOOOOOOXXXXGOOOOOOOOXXXXXXXXXXXGOOOOOOOOOOOOXXXXXXXGOOOOOOOOOOOOOOOXXXXGOOOOOXXXXXXXXXXXXXXGOOOOOOOOXXXXXXXXXXXGOOOOOOXXXXXXXXXXXXXGOOOOOOOOOOXXXXXXXXX,0,256,0

26250,142,0,142,73,125,0,0,285,147,138,GOOOOOOOXXXXXXXXXXXXGOOOOOOOOOOOXXXXXXXXGOOOOOOOOOOXXXXXXXXXGOOOOOOOOOOOOOOOOXXXGOOOOOOXXXXXXXXXXXXXGOOOOOOOOOOOOOOOXXXXGOOOOOOOOXXXXXXXXXXXGOOOOOOOOOOOOXXXXXXXGOOOOOOOOOOOOOOOXXXXGOOOOOXXXXXXXXXXXXXXGOOOOOOOOXXXXXXXXXXXGOOOOOOXXXXXXXXXXXXXGOOOOOOOOOOXXXXXXXXX,0,256,0
26271,142,0,142,75,123,0,0,282,147,135,GOOOOOOOXXXXXXXXXXXXGOOOOOOOOOOOXXXXXXXXGOOOOOOOOOOXXXXXXXXXGOOOOOOOOOOOOOOOOXXXGOOOOOOXXXXXXXXXXXXXGOOOOOOOOOOOOOOOXXXXGOOOOOOOOXXXXXXXXXXXGOOOOOOOOOOOOXXXXXXXGOOOOOOOOOOOOOOOXXXXGOOOOOXXXXXXXXXXXXXXGOOOOOOOOXXXXXXXXXXXGOOOOOOXXXXXXXXXXXXXGOOOOOOOOOOXXXXXXXXX,0,256,0
26292,142,0,142,70,128,0,0,288,146,142,GOOOOOOOXXXXXXXXXXXXGOOOOOOOOOOOXXXXXXXXGOOOOOOOOOOXXXXXXXXXGOOOOOOOOOOOOOOOOXXXGOOOOOOXXXXXXXXXXXXXGOOOOOOOOOOOOOOOXXXXGOOOOOOOOXXXXXXXXXXXGOOOOOOOOOOOOXXXXXXXGOOOOOOOOOOOOOOOXXXXGOOOOOXXXXXXXXXXXXXXGOOOOOOOOXXXXXXXXXXXGOOOOOOXXXXXXXXXXXXXGOOOOOOOOOOXXXXXXXXX,0,256,0
26313,142,0,142,71,127,0,0,288,151,137,GOOOOOOOXXXXXXXXXXXXGOOOOOOOOOOOXXXXXXXXGOOOOOOOOOOXXXXXXXXXGOOOOOOOOOOOOOOOOXXXGOOOOOOXXXXXXXXXXXXXGOOOOOOOOOOOOOOOXXXXGOOOOOOOOXXXXXXXXXXXGOOOOOOOOOOOOXXXXXXXGOOOOOOOOOOOOOOOXXXXGOOOOOXXXXXXXXXXXXXXGOOOOOOOOXXXXXXXXXXXGOOOOOOXXXXXXXXXXXXXGOOOOOOOOOOXXXXXXXXX,0,256,0
26334,142,0,142,77,121,0,0,282,144,138,GOOOOOOOXXXXXXXXXXXXGOOOOOOOOOOOXXXXXXXXGOOOOOOOOOOXXXXXXXXXGOOOOOOOOOOOOOOOOXXXGOOOOOOXXXXXXXXXXXXXGOOOOOOOOOOOOOOOXXXXGOOOOOOOOXXXXXXXXXXXGOOOOOOOOOOOOXXXXXXXGOOOOOOOOOOOOOOOXXXXGOOOOOXXXXXXXXXXXXXXGOOOOOOOOXXXXXXXXXXXGOOOOOOXXXXXXXXXXXXXGOOOOOOOOOOXXXXXXXXX,0,256,0

26355,142,0,142,75,123,0,0,284,145,139,GOOOOOOOXXXXXXXXXXXXGOOOOOOOOOOOXXXXXXXXGOOOOOOOOOOXXXXXXXXXGOOOOOOOOOOOOOOOOXXXGOOOOOOXXXXXXXXXXXXXGOOOOOOOOOOOOOOOXXXXGOOOOOOOOXXXXXXXXXXXGOOOOOOOOOOOOXXXXXXXGOOOOOOOOOOOOOOOXXXXGOOOOOXXXXXXXXXXXXXXGOOOOOOOOXXXXXXXXXXXGOOOOOOXXXXXXXXXXXXXGOOOOOOOOOOXXXXXXXXX,0,256,0
26376,142,0,142,75,123,0,0,282,145,137,GOOOOOOOXXXXXXXXXXXXGOOOOOOOOOOOXXXXXXXXGOOOOOOOOOOXXXXXXXXXGOOOOOOOOOOOOOOOOXXXGOOOOOOXXXXXXXXXXXXXGOOOOOOOOOOOOOOOXXXXGOOOOOOOOXXXXXXXXXXXGOOOOOOOOOOOOXXXXXXXGOOOOOOOOOOOOOOOXXXXGOOOOOXXXXXXXXXXXXXXGOOOOOOOOXXXXXXXXXXXGOOOOOOXXXXXXXXXXXXXGOOOOOOOOOOXXXXXXXXX,0,256,0
26397,142,0,142,76,122,0,0,282,148,134,GOOOOOOOXXXXXXXXXXXXGOOOOOOOOOOOXXXXXXXXGOOOOOOOOOOXXXXXXXXXGOOOOOOOOOOOOOOOOXXXGOOOOOOXXXXXXXXXXXXXGOOOOOOOOOOOOOOOXXXXGOOOOOOOOXXXXXXXXXXXGOOOOOOOOOOOOXXXXXXXGOOOOOOOOOOOOOOOXXXXGOOOOOXXXXXXXXXXXXXXGOOOOOOOOXXXXXXXXXXXGOOOOOOXXXXXXXXXXXXXGOOOOOOOOOOXXXXXXXXX,0,256,0
26418,143,1,142,73,124,0,0,282,153,129,GOOOOOOOXXXXXXXXXXXXGOOOOOOOOOOOXXXXXXXXGOOOOOOOOOOXXXXXXXXXGOOOOOOOOOOOOOOOOXXXGOOOOOOXXXXXXXXXXXXXGOOOOOOOOOOOOOOOXXXXGOOOOOOOOXXXXXXXXXXXGOOOOOOOOOOOOXXXXXXXGOOOOOOOOOOOOOOOXXXXGOOOOOXXXXXXXXXXXXXXGOOOOOOOOAXXXXXXXXXXGOOOOOOXXXXXXXXXXXXXGOOOOOOOOOOXXXXXXXXX,0,256,0
26439,143,1,142,73,124,0,0,282,156,126,GOOOOOOOXXXXXXXXXXXXGOOOOOOOOOOOXXXXXXXXGOOOOOOOOOOXXXXXXXXXGOOOOOOOOOOOOOOOOXXXGOOOOOOXXXXXXXXXXXXXGOOOOOOOOOOOOOOOXXXXGOOOOOOOOXXXXXXXXXXXGOOOOOOOOOOOOXXXXXXXGOOOOOOOOOOOOOOOXXXXGOOOOOXXXXXXXXXXXXXXGOOOOOOOOAXXXXXXXXXXGOOOOOOXXXXXXXXXXXXXGOOOOOOOOOOXXXXXXXXX,0,256,0

26460,143,1,142,75,122,0,0,282,153,129,GOOOOOOOXXXXXXXXXXXXGOOOOOOOOOOOXXXXXXXXGOOOOOOOOOOXXXXXXXXXGOOOOOOOOOOOOOOOOXXXGOOOOOOXXXXXXXXXXXXXGOOOOOOOOOOOOOOOXXXXGOOOOOOOOXXXXXXXXXXXGOOOOOOOOOOOOXXXXXXXGOOOOOOOOOOOOOOOXXXXGOOOOOXXXXXXXXXXXXXXGOOOOOOOOAXXXXXXXXXXGOOOOOOXXXXXXXXXXXXXGOOOOOOOOOOXXXXXXXXX,0,256,0
26481,143,1,142,75,122,0,0,279,153,126,GOOOOOOOXXXXXXXXXXXXGOOOOOOOOOOOXXXXXXXXGOOOOOOOOOOXXXXXXXXXGOOOOOOOOOOOOOOOOXXXGOOOOOOXXXXXXXXXXXXXGOOOOOOOOOOOOOOOXXXXGOOOOOOOOXXXXXXXXXXXGOOOOOOOOOOOOXXXXXXXGOOOOOOOOOOOOOOOXXXXGOOOOOXXXXXXXXXXXXXXGOOOOOOOOAXXXXXXXXXXGOOOOOOXXXXXXXXXXXXXGOOOOOOOOOOXXXXXXXXX,0,256,0
26502,143,1,142,77,120,0,0,280,151,129,GOOOOOOOXXXXXXXXXXXXGOOOOOOOOOOOXXXXXXXXGOOOOOOOOOOXXXXXXXXXGOOOOOOOOOOOOOOOOXXXGOOOOOOXXXXXXXXXXXXXGOOOOOOOOOOOOOOOXXXXGOOOOOOOOXXXXXXXXXXXGOOOOOOOOOOOOXXXXXXXGOOOOOOOOOOOOOOOXXXXGOOOOOXXXXXXXXXXXXXXGOOOOOOOOAXXXXXXXXXXGOOOOOOXXXXXXXXXXXXXGOOOOOOOOOOXXXXXXXXX,0,256,0
26523,143,1,142,74,123,0,0,283,151,132,GOOOOOOOXXXXXXXXXXXXGOOOOOOOOOOOXXXXXXXXGOOOOOOOOOOXXXXXXXXXGOOOOOOOOOOOOOOOOXXXGOOOOOOXXXXXXXXXXXXXGOOOOOOOOOOOOOOOXXXXGOOOOOOOOXXXXXXXXXXXGOOOOOOOOOOOOXXXXXXXGOOOOOOOOOOOOOOOXXXXGOOOOOXXXXXXXXXXXXXXGOOOOOOOOAXXXXXXXXXXGOOOOOOXXXXXXXXXXXXXGOOOOOOOOOOXXXXXXXXX,0,256,0
26544,143,0,143,80,117,0,0,275,150,125,GOOOOOOOXXXXXXXXXXXXGOOOOOOOOOOOXXXXXXXXGOOOOOOOOOOXXXXXXXXXGOOOOOOOOOOOOOOOOXXXGOOOOOOXXXXXXXXXXXXXGOOOOOOOOOOOOOOOXXXXGOOOOOOOOXXXXXXXXXXXGOOOOOOOOOOOOXXXXXXXGOOOOOOOOOOOOOOOXXXXGOOOOOXXXXXXXXXXXXXXGOOOOOOOOOXXXXXXXXXXGOOOOOOXXXXXXXXXXXXXGOOOOOOOOOOXXXXXXXXX,0,256,0

26565,144,1,143,76,120,0,0,280,153,127,GOOOOOOOXXXXXXXXXXXXGOOOOOOOOOOOXXXXXXXXGOOOOOOOOOOXXXXXXXXXGOOOOOOOOOOOOOOOOXXXGOOOOOOXXXXXXXXXXXXXGOOOOOOOOOOOOOOOAXXXGOOOOOOOOXXXXXXXXXXXGOOOOOOOOOOOOXXXXXXXGOOOOOOOOOOOOOOOXXXXGOOOOOXXXXXXXXXXXXXXGOOOOOOOOOXXXXXXXXXXGOOOOOOXXXXXXXXXXXXXGOOOOOOOOOOXXXXXXXXX,0,256,0
26586,144,1,143,80,116,0,0,276,150,126,GOOOOOOOXXXXXXXXXXXXGOOOOOOOOOOOXXXXXXXXGOOOOOOOOOOXXXXXXXXXGOOOOOOOOOOOOOOOOXXXGOOOOOOXXXXXXXXXXXXXGOOOOOOOOOOOOOOOAXXXGOOOOOOOOXXXXXXXXXXXGOOOOOOOOOOOOXXXXXXXGOOOOOOOOOOOOOOOXXXXGOOOOOXXXXXXXXXXXXXXGOOOOOOOOOXXXXXXXXXXGOOOOOOXXXXXXXXXXXXXGOOOOOOOOOOXXXXXXXXX,0,256,0
26607,144,1,143,80,116,0,0,276,151,125,GOOOOOOOXXXXXXXXXXXXGOOOOOOOOOOOXXXXXXXXGOOOOOOOOOOXXXXXXXXXGOOOOOOOOOOOOOOOOXXXGOOOOOOXXXXXXXXXXXXXGOOOOOOOOOOOOOOOAXXXGOOOOOOOOXXXXXXXXXXXGOOOOOOOOOOOOXXXXXXXGOOOOOOOOOOOOOOOXXXXGOOOOOXXXXXXXXXXXXXXGOOOOOOOOOXXXXXXXXXXGOOOOOOXXXXXXXXXXXXXGOOOOOOOOOOXXXXXXXXX,0,256,0
26628,144,1,143,84,112,0,0,272,149,123,GOOOOOOOXXXXXXXXXXXXGOOOOOOOOOOOXXXXXXXXGOOOOOOOOOOXXXXXXXXXGOOOOOOOOOOOOOOOOXXXGOOOOOOXXXXXXXXXXXXXGOOOOOOOOOOOOOOOAXXXGOOOOOOOOXXXXXXXXXXXGOOOOOOOOOOOOXXXXXXXGOOOOOOOOOOOOOOOXXXXGOOOOOXXXXXXXXXXXXXXGOOOOOOOOOXXXXXXXXXXGOOOOOOXXXXXXXXXXXXXGOOOOOOOOOOXXXXXXXXX,0,256,0
26649,144,1,143,80,116,0,0,274,153,121,GOOOOOOOXXXXXXXXXXXXGOOOOOOOOOOOXXXXXXXXGOOOOOOOOOOXXXXXXXXXGOOOOOOOOOOOOOOOOXXXGOOOOOOXXXXXXXXXXXXXGOOOOOOOOOOOOOOOAXXXGOOOOOOOOXXXXXXXXXXXGOOOOOOOOOOOOXXXXXXXGOOOOOOOOOOOOOOOXXXXGOOOOOXXXXXXXXXXXXXXGOOOOOOOOOXXXXXXXXXXGOOOOOOXXXXXXXXXXXXXGOOOOOOOOOOXXXXXXXXX,0,256,0

26670,144,1,143,80,116,0,0,276,155,121,GOOOOOOOXXXXXXXXXXXXGOOOOOOOOOOOXXXXXXXXGOOOOOOOOOOXXXXXXXXXGOOOOOOOOOOOOOOOOXXXGOOOOOOXXXXXXXXXXXXXGOOOOOOOOOOOOOOOAXXXGOOOOOOOOXXXXXXXXXXXGOOOOOOOOOOOOXXXXXXXGOOOOOOOOOOOOOOOXXXXGOOOOOXXXXXXXXXXXXXXGOOOOOOOOOXXXXXXXXXXGOOOOOOXXXXXXXXXXXXXGOOOOOOOOOOXXXXXXXXX,0,256,0
26691,144,1,143,88,108,0,0,267,145,122,GOOOOOOOXXXXXXXXXXXXGOOOOOOOOOOOXXXXXXXXGOOOOOOOOOOXXXXXXXXXGOOOOOOOOOOOOOOOOXXXGOOOOOOXXXXXXXXXXXXXGOOOOOOOOOOOOOOOAXXXGOOOOOOOOXXXXXXXXXXXGOOOOOOOOOOOOXXXXXXXGOOOOOOOOOOOOOOOXXXXGOOOOOXXXXXXXXXXXXXXGOOOOOOOOOXXXXXXXXXXGOOOOOOXXXXXXXXXXXXXGOOOOOOOOOOXXXXXXXXX,0,256,0
26712,144,1,143,86,110,0,0,270,144,126,GOOOOOOOXXXXXXXXXXXXGOOOOOOOOOOOXXXXXXXXGOOOOOOOOOOXXXXXXXXXGOOOOOOOOOOOOOOOOXXXGOOOOOOXXXXXXXXXXXXXGOOOOOOOOOOOOOOOAXXXGOOOOOOOOXXXXXXXXXXXGOOOOOOOOOOOOXXXXXXXGOOOOOOOOOOOOOOOXXXXGOOOOOXXXXXXXXXXXXXXGOOOOOOOOOXXXXXXXXXXGOOOOOOXXXXXXXXXXXXXGOOOOOOOOOOXXXXXXXXX,0,256,0
26733,144,1,143,79,117,0,0,276,150,126,GOOOOOOOXXXXXXXXXXXXGOOOOOOOOOOOXXXXXXXXGOOOOOOOOOOXXXXXXXXXGOOOOOOOOOOOOOOOOXXXGOOOOOOXXXXXXXXXXXXXGOOOOOOOOOOOOOOOAXXXGOOOOOOOOXXXXXXXXXXXGOOOOOOOOOOOOXXXXXXXGOOOOOOOOOOOOOOOXXXXGOOOOOXXXXXXXXXXXXXXGOOOOOOOOOXXXXXXXXXXGOOOOOOXXXXXXXXXXXXXGOOOOOOOOOOXXXXXXXXX,0,256,0
26754,144,1,143,77,119,0,0,277,151,126,GOOOOOOOXXXXXXXXXXXXGOOOOOOOOOOOXXXXXXXXGOOOOOOOOOOXXXXXXXXXGOOOOOOOOOOOOOOOOXXXGOOOOOOXXXXXXXXXXXXXGOOOOOOOOOOOOOOOAXXXGOOOOOOOOXXXXXXXXXXXGOOOOOOOOOOOOXXXXXXXGOOOOOOOOOOOOOOOXXXXGOOOOOXXXXXXXXXXXXXXGOOOOOOOOOXXXXXXXXXXGOOOOOOXXXXXXXXXXXXXGOOOOOOOOOOXXXXXXXXX,0,256,0

26775,144,1,143,78,118,0,0,278,151,127,GOOOOOOOXXXXXXXXXXXXGOOOOOOOOOOOXXXXXXXXGOOOOOOOOOOXXXXXXXXXGOOOOOOOOOOOOOOOOXXXGOOOOOOXXXXXXXXXXXXXGOOOOOOOOOOOOOOOAXXXGOOOOOOOOXXXXXXXXXXXGOOOOOOOOOOOOXXXXXXXGOOOOOOOOOOOOOOOXXXXGOOOOOXXXXXXXXXXXXXXGOOOOOOOOOXXXXXXXXXXGOOOOOOXXXXXXXXXXXXXGOOOOOOOOOOXXXXXXXXX,0,256,0
26796,144,1,143,80,116,0,0,276,149,127,GOOOOOOOXXXXXXXXXXXXGOOOOOOOOOOOXXXXXXXXGOOOOOOOOOOXXXXXXXXXGOOOOOOOOOOOOOOOOXXXGOOOOOOXXXXXXXXXXXXXGOOOOOOOOOOOOOOOAXXXGOOOOOOOOXXXXXXXXXXXGOOOOOOOOOOOOXXXXXXXGOOOOOOOOOOOOOOOXXXXGOOOOOXXXXXXXXXXXXXXGOOOOOOOOOXXXXXXXXXXGOOOOOOXXXXXXXXXXXXXGOOOOOOOOOOXXXXXXXXX,0,256,0
26817,144,1,143,79,117,0,0,277,151,126,GOOOOOOOXXXXXXXXXXXXGOOOOOOOOOOOXXXXXXXXGOOOOOOOOOOXXXXXXXXXGOOOOOOOOOOOOOOOOXXXGOOOOOOXXXXXXXXXXXXXGOOOOOOOOOOOOOOOAXXXGOOOOOOOOXXXXXXXXXXXGOOOOOOOOOOOOXXXXXXXGOOOOOOOOOOOOOOOXXXXGOOOOOXXXXXXXXXXXXXXGOOOOOOOOOXXXXXXXXXXGOOOOOOXXXXXXXXXXXXXGOOOOOOOOOOXXXXXXXXX,0,256,0
26838,144,1,143,79,117,0,0,276,155,121,GOOOOOOOXXXXXXXXXXXXGOOOOOOOOOOOXXXXXXXXGOOOOOOOOOOXXXXXXXXXGOOOOOOOOOOOOOOOOXXXGOOOOOOXXXXXXXXXXXXXGOOOOOOOOOOOOOOOAXXXGOOOOOOOOXXXXXXXXXXXGOOOOOOOOOOOOXXXXXXXGOOOOOOOOOOOOOOOXXXXGOOOOOXXXXXXXXXXXXXXGOOOOOOOOOXXXXXXXXXXGOOOOOOXXXXXXXXXXXXXGOOOOOOOOOOXXXXXXXXX,0,256,0
26859,144,1,143,82,114,0,0,274,151,123,GOOOOOOOXXXXXXXXXXXXGOOOOOOOOOOOXXXXXXXXGOOOOOOOOOOXXXXXXXXXGOOOOOOOOOOOOOOOOXXXGOOOOOOXXXXXXXXXXXXXGOOOOOOOOOOOOOOOAXXXGOOOOOOOOXXXXXXXXXXXGOOOOOOOOOOOOXXXXXXXGOOOOOOOOOOOOOOOXXXXGOOOOOXXXXXXXXXXXXXXGOOOOOOOOOXXXXXXXXXXGOOOOOOXXXXXXXXXXXXXGOOOOOOOOOOXXXXXXXXX,0,256,0

26880,144,1,143,78,118,0,0,278,153,125,GOOOOOOOXXXXXXXXXXXXGOOOOOOOOOOOXXXXXXXXGOOOOOOOOOOXXXXXXXXXGOOOOOOOOOOOOOOOOXXXGOOOOOOXXXXXXXXXXXXXGOOOOOOOOOOOOOOOAXXXGOOOOOOOOXXXXXXXXXXXGOOOOOOOOOOOOXXXXXXXGOOOOOOOOOOOOOOOXXXXGOOOOOXXXXXXXXXXXXXXGOOOOOOOOOXXXXXXXXXXGOOOOOOXXXXXXXXXXXXXGOOOOOOOOOOXXXXXXXXX,0,256,0
26901,144,0,144,78,118,0,0,277,153,124,GOOOOOOOXXXXXXXXXXXXGOOOOOOOOOOOXXXXXXXXGOOOOOOOOOOXXXXXXXXXGOOOOOOOOOOOOOOOOXXXGOOOOOOXXXXXXXXXXXXXGOOOOOOOOOOOOOOOOXXXGOOOOOOOOXXXXXXXXXXXGOOOOOOOOOOOOXXXXXXXGOOOOOOOOOOOOOOOXXXXGOOOOOXXXXXXXXXXXXXXGOOOOOOOOOXXXXXXXXXXGOOOOOOXXXXXXXXXXXXXGOOOOOOOOOOXXXXXXXXX,0,256,0
26922,144,0,144,79,117,0,0,277,152,125,GOOOOOOOXXXXXXXXXXXXGOOOOOOOOOOOXXXXXXXXGOOOOOOOOOOXXXXXXXXXGOOOOOOOOOOOOOOOOXXXGOOOOOOXXXXXXXXXXXXXGOOOOOOOOOOOOOOOOXXXGOOOOOOOOXXXXXXXXXXXGOOOOOOOOOOOOXXXXXXXGOOOOOOOOOOOOOOOXXXXGOOOOOXXXXXXXXXXXXXXGOOOOOOOOOXXXXXXXXXXGOOOOOOXXXXXXXXXXXXXGOOOOOOOOOOXXXXXXXXX,0,256,0
26943,144,0,144,77,119,0,0,278,156,122,GOOOOOOOXXXXXXXXXXXXGOOOOOOOOOOOXXXXXXXXGOOOOOOOOOOXXXXXXXXXGOOOOOOOOOOOOOOOOXXXGOOOOOOXXXXXXXXXXXXXGOOOOOOOOOOOOOOOOXXXGOOOOOOOOXXXXXXXXXXXGOOOOOOOOOOOOXXXXXXXGOOOOOOOOOOOOOOOXXXXGOOOOOXXXXXXXXXXXXXXGOOOOOOOOOXXXXXXXXXXGOOOOOOXXXXXXXXXXXXXGOOOOOOOOOOXXXXXXXXX,0,256,0
26964,144,0,144,71,125,0,0,283,159,124,GOOOOOOOXXXXXXXXXXXXGOOOOOOOOOOOXXXXXXXXGOOOOOOOOOOXXXXXXXXXGOOOOOOOOOOOOOOOOXXXGOOOOOOXXXXXXXXXXXXXGOOOOOOOOOOOOOOOOXXXGOOOOOOOOXXXXXXXXXXXGOOOOOOOOOOOOXXXXXXXGOOOOOOOOOOOOOOOXXXXGOOOOOXXXXXXXXXXXXXXGOOOOOOOOOXXXXXXXXXXGOOOOOOXXXXXXXXXXXXXGOOOOOOOOOOXXXXXXXXX,0,256,0

26985,144,0,144,75,121,0,0,281,149,132,GOOOOOOOXXXXXXXXXXXXGOOOOOOOOOOOXXXXXXXXGOOOOOOOOOOXXXXXXXXXGOOOOOOOOOOOOOOOOXXXGOOOOOOXXXXXXXXXXXXXGOOOOOOOOOOOOOOOOXXXGOOOOOOOOXXXXXXXXXXXGOOOOOOOOOOOOXXXXXXXGOOOOOOOOOOOOOOOXXXXGOOOOOXXXXXXXXXXXXXXGOOOOOOOOOXXXXXXXXXXGOOOOOOXXXXXXXXXXXXXGOOOOOOOOOOXXXXXXXXX,0,256,0
27006,144,0,144,72,124,0,0,283,154,129,GOOOOOOOXXXXXXXXXXXXGOOOOOOOOOOOXXXXXXXXGOOOOOOOOOOXXXXXXXXXGOOOOOOOOOOOOOOOOXXXGOOOOOOXXXXXXXXXXXXXGOOOOOOOOOOOOOOOOXXXGOOOOOOOOXXXXXXXXXXXGOOOOOOOOOOOOXXXXXXXGOOOOOOOOOOOOOOOXXXXGOOOOOXXXXXXXXXXXXXXGOOOOOOOOOXXXXXXXXXXGOOOOOOXXXXXXXXXXXXXGOOOOOOOOOOXXXXXXXXX,0,256,0
27027,144,0,144,74,122,0,0,282,154,128,GOOOOOOOXXXXXXXXXXXXGOOOOOOOOOOOXXXXXXXXGOOOOOOOOOOXXXXXXXXXGOOOOOOOOOOOOOOOOXXXGOOOOOOXXXXXXXXXXXXXGOOOOOOOOOOOOOOOOXXXGOOOOOOOOXXXXXXXXXXXGOOOOOOOOOOOOXXXXXXXGOOOOOOOOOOOOOOOXXXXGOOOOOXXXXXXXXXXXXXXGOOOOOOOOOXXXXXXXXXXGOOOOOOXXXXXXXXXXXXXGOOOOOOOOOOXXXXXXXXX,0,256,0
27048,144,0,144,76,120,0,0,281,154,127,GOOOOOOOXXXXXXXXXXXXGOOOOOOOOOOOXXXXXXXXGOOOOOOOOOOXXXXXXXXXGOOOOOOOOOOOOOOOOXXXGOOOOOOXXXXXXXXXXXXXGOOOOOOOOOOOOOOOOXXXGOOOOOOOOXXXXXXXXXXXGOOOOOOOOOOOOXXXXXXXGOOOOOOOOOOOOOOOXXXXGOOOOOXXXXXXXXXXXXXXGOOOOOOOOOXXXXXXXXXXGOOOOOOXXXXXXXXXXXXXGOOOOOOOOOOXXXXXXXXX,0,256,0
27069,144,0,144,72,124,0,0,284,155,129,GOOOOOOOXXXXXXXXXXXXGOOOOOOOOOOOXXXXXXXXGOOOOOOOOOOXXXXXXXXXGOOOOOOOOOOOOOOOOXXXGOOOOOOXXXXXXXXXXXXXGOOOOOOOOOOOOOOOOXXXGOOOOOOOOXXXXXXXXXXXGOOOOOOOOOOOOXXXXXXXGOOOOOOOOOOOOOOOXXXXGOOOOOXXXXXXXXXXXXXXGOOOOOOOOOXXXXXXXXXXGOOOOOOXXXXXXXXXXXXXGOOOOOOOOOOXXXXXXXXX,0,256,0

27090,144,0,144,77,119,0,0,279,152,127,GOOOOOOOXXXXXXXXXXXXGOOOOOOOOOOOXXXXXXXXGOOOOOOOOOOXXXXXXXXXGOOOOOOOOOOOOOOOOXXXGOOOOOOXXXXXXXXXXXXXGOOOOOOOOOOOOOOOOXXXGOOOOOOOOXXXXXXXXXXXGOOOOOOOOOOOOXXXXXXXGOOOOOOOOOOOOOOOXXXXGOOOOOXXXXXXXXXXXXXXGOOOOOOOOOXXXXXXXXXXGOOOOOOXXXXXXXXXXXXXGOOOOOOOOOOXXXXXXXXX,0,256,0
27111,145,1,144,77,118,0,0,279,152,127,GOOOOOOOXXXXXXXXXXXXGOOOOOOOOOOOXXXXXXXXGOOOOOOOOOOXXXXXXXXXGOOOOOOOOOOOOOOOOXXXGOOOOOOXXXXXXXXXXXXXGOOOOOOOOOOOOOOOOAXXGOOOOOOOOXXXXXXXXXXXGOOOOOOOOOOOOXXXXXXXGOOOOOOOOOOOOOOOXXXXGOOOOOXXXXXXXXXXXXXXGOOOOOOOOOXXXXXXXXXXGOOOOOOXXXXXXXXXXXXXGOOOOOOOOOOXXXXXXXXX,0,256,0
27132,145,1,144,76,119,0,0,280,155,125,GOOOOOOOXXXXXXXXXXXXGOOOOOOOOOOOXXXXXXXXGOOOOOOOOOOXXXXXXXXXGOOOOOOOOOOOOOOOOXXXGOOOOOOXXXXXXXXXXXXXGOOOOOOOOOOOOOOOOAXXGOOOOOOOOXXXXXXXXXXXGOOOOOOOOOOOOXXXXXXXGOOOOOOOOOOOOOOOXXXXGOOOOOXXXXXXXXXXXXXXGOOOOOOOOOXXXXXXXXXXGOOOOOOXXXXXXXXXXXXXGOOOOOOOOOOXXXXXXXXX,0,256,0
27153,145,1,144,80,115,0,0,276,158,118,GOOOOOOOXXXXXXXXXXXXGOOOOOOOOOOOXXXXXXXXGOOOOOOOOOOXXXXXXXXXGOOOOOOOOOOOOOOOOXXXGOOOOOOXXXXXXXXXXXXXGOOOOOOOOOOOOOOOOAXXGOOOOOOOOXXXXXXXXXXXGOOOOOOOOOOOOXXXXXXXGOOOOOOOOOOOOOOOXXXXGOOOOOXXXXXXXXXXXXXXGOOOOOOOOOXXXXXXXXXXGOOOOOOXXXXXXXXXXXXXGOOOOOOOOOOXXXXXXXXX,0,256,0
27174,145,1,144,83,112,0,0,272,159,113,GOOOOOOOXXXXXXXXXXXXGOOOOOOOOOOOXXXXXXXXGOOOOOOOOOOXXXXXXXXXGOOOOOOOOOOOOOOOOXXXGOOOOOOXXXXXXXXXXXXXGOOOOOOOOOOOOOOOOAXXGOOOOOOOOXXXXXXXXXXXGOOOOOOOOOOOOXXXXXXXGOOOOOOOOOOOOOOOXXXXGOOOOOXXXXXXXXXXXXXXGOOOOOOOOOXXXXXXXXXXGOOOOOOXXXXXXXXXXXXXGOOOOOOOOOOXXXXXXXXX,0,256,0

27195,145,1,144,86,109,0,0,270,158,112,GOOOOOOOXXXXXXXXXXXXGOOOOOOOOOOOXXXXXXXXGOOOOOOOOOOXXXXXXXXXGOOOOOOOOOOOOOOOOXXXGOOOOOOXXXXXXXXXXXXXGOOOOOOOOOOOOOOOOAXXGOOOOOOOOXXXXXXXXXXXGOOOOOOOOOOOOXXXXXXXGOOOOOOOOOOOOOOOXXXXGOOOOOXXXXXXXXXXXXXXGOOOOOOOOOXXXXXXXXXXGOOOOOOXXXXXXXXXXXXXGOOOOOOOOOOXXXXXXXXX,0,256,0
27216,145,1,144,90,105,0,0,266,152,114,GOOOOOOOXXXXXXXXXXXXGOOOOOOOOOOOXXXXXXXXGOOOOOOOOOOXXXXXXXXXGOOOOOOOOOOOOOOOOXXXGOOOOOOXXXXXXXXXXXXXGOOOOOOOOOOOOOOOOAXXGOOOOOOOOXXXXXXXXXXXGOOOOOOOOOOOOXXXXXXXGOOOOOOOOOOOOOOOXXXXGOOOOOXXXXXXXXXXXXXXGOOOOOOOOOXXXXXXXXXXGOOOOOOXXXXXXXXXXXXXGOOOOOOOOOOXXXXXXXXX,0,256,0
27237,145,1,144,91,104,0,0,265,150,115,GOOOOOOOXXXXXXXXXXXXGOOOOOOOOOOOXXXXXXXXGOOOOOOOOOOXXXXXXXXXGOOOOOOOOOOOOOOOOXXXGOOOOOOXXXXXXXXXXXXXGOOOOOOOOOOOOOOOOAXXGOOOOOOOOXXXXXXXXXXXGOOOOOOOOOOOOXXXXXXXGOOOOOOOOOOOOOOOXXXXGOOOOOXXXXXXXXXXXXXXGOOOOOOOOOXXXXXXXXXXGOOOOOOXXXXXXXXXXXXXGOOOOOOOOOOXXXXXXXXX,0,256,0
27258,145,1,144,86,109,0,0,270,156,114,GOOOOOOOXXXXXXXXXXXXGOOOOOOOOOOOXXXXXXXXGOOOOOOOOOOXXXXXXXXXGOOOOOOOOOOOOOOOOXXXGOOOOOOXXXXXXXXXXXXXGOOOOOOOOOOOOOOOOAXXGOOOOOOOOXXXXXXXXXXXGOOOOOOOOOOOOXXXXXXXGOOOOOOOOOOOOOOOXXXXGOOOOOXXXXXXXXXXXXXXGOOOOOOOOOXXXXXXXXXXGOOOOOOXXXXXXXXXXXXXGOOOOOOOOOOXXXXXXXXX,0,256,0
27279,145,1,144,82,113,0,0,273,152,121,GOOOOOOOXXXXXXXXXXXXGOOOOOOOOOOOXXXXXXXXGOOOOOOOOOOXXXXXXXXXGOOOOOOOOOOOOOOOOXXXGOOOOOOXXXXXXXXXXXXXGOOOOOOOOOOOOOOOOAXXGOOOOOOOOXXXXXXXXXXXGOOOOOOOOOOOOXXXXXXXGOOOOOOOOOOOOOOOXXXXGOOOOOXXXXXXXXXXXXXXGOOOOOOOOOXXXXXXXXXXGOOOOOOXXXXXXXXXXXXXGOOOOOOOOOOXXXXXXXXX,0,256,0

27300,145,1,144,81,114,0,0,274,152,122,GOOOOOOOXXXXXXXXXXXXGOOOOOOOOOOOXXXXXXXXGOOOOOOOOOOXXXXXXXXXGOOOOOOOOOOOOOOOOXXXGOOOOOOXXXXXXXXXXXXXGOOOOOOOOOOOOOOOOAXXGOOOOOOOOXXXXXXXXXXXGOOOOOOOOOOOOXXXXXXXGOOOOOOOOOOOOOOOXXXXGOOOOOXXXXXXXXXXXXXXGOOOOOOOOOXXXXXXXXXXGOOOOOOXXXXXXXXXXXXXGOOOOOOOOOOXXXXXXXXX,0,256,0
27321,145,1,144,82,113,0,0,273,151,122,GOOOOOOOXXXXXXXXXXXXGOOOOOOOOOOOXXXXXXXXGOOOOOOOOOOXXXXXXXXXGOOOOOOOOOOOOOOOOXXXGOOOOOOXXXXXXXXXXXXXGOOOOOOOOOOOOOOOOAXXGOOOOOOOOXXXXXXXXXXXGOOOOOOOOOOOOXXXXXXXGOOOOOOOOOOOOOOOXXXXGOOOOOXXXXXXXXXXXXXXGOOOOOOOOOXXXXXXXXXXGOOOOOOXXXXXXXXXXXXXGOOOOOOOOOOXXXXXXXXX,0,256,0
27342,145,1,144,78,117,0,0,277,154,123,GOOOOOOOXXXXXXXXXXXXGOOOOOOOOOOOXXXXXXXXGOOOOOOOOOOXXXXXXXXXGOOOOOOOOOOOOOOOOXXXGOOOOOOXXXXXXXXXXXXXGOOOOOOOOOOOOOOOOAXXGOOOOOOOOXXXXXXXXXXXGOOOOOOOOOOOOXXXXXXXGOOOOOOOOOOOOOOOXXXXGOOOOOXXXXXXXXXXXXXXGOOOOOOOOOXXXXXXXXXXGOOOOOOXXXXXXXXXXXXXGOOOOOOOOOOXXXXXXXXX,0,256,0
27363,145,1,144,74,121,0,0,281,159,122,GOOOOOOOXXXXXXXXXXXXGOOOOOOOOOOOXXXXXXXXGOOOOOOOOOOXXXXXXXXXGOOOOOOOOOOOOOOOOXXXGOOOOOOXXXXXXXXXXXXXGOOOOOOOOOOOOOOOOAXXGOOOOOOOOXXXXXXXXXXXGOOOOOOOOOOOOXXXXXXXGOOOOOOOOOOOOOOOXXXXGOOOOOXXXXXXXXXXXXXXGOOOOOOOOOXXXXXXXXXXGOOOOOOXXXXXXXXXXXXXGOOOOOOOOOOXXXXXXXXX,0,256,0
27384,145,1,144,70,125,0,0,285,164,121,GOOOOOOOXXXXXXXXXXXXGOOOOOOOOOOOXXXXXXXXGOOOOOOOOOOXXXXXXXXXGOOOOOOOOOOOOOOOOXXXGOOOOOOXXXXXXXXXXXXXGOOOOOOOOOOOOOOOOAXXGOOOOOOOOXXXXXXXXXXXGOOOOOOOOOOOOXXXXXXXGOOOOOOOOOOOOOOOXXXXGOOOOOXXXXXXXXXXXXXXGOOOOOOOOOXXXXXXXXXXGOOOOOOXXXXXXXXXXXXXGOOOOOOOOOOXXXXXXXXX,0,256,0

27405,145,1,144,75,120,0,0,280,157,123,GOOOOOOOXXXXXXXXXXXXGOOOOOOOOOOOXXXXXXXXGOOOOOOOOOOXXXXXXXXXGOOOOOOOOOOOOOOOOXXXGOOOOOOXXXXXXXXXXXXXGOOOOOOOOOOOOOOOOAXXGOOOOOOOOXXXXXXXXXXXGOOOOOOOOOOOOXXXXXXXGOOOOOOOOOOOOOOOXXXXGOOOOOXXXXXXXXXXXXXXGOOOOOOOOOXXXXXXXXXXGOOOOOOXXXXXXXXXXXXXGOOOOOOOOOOXXXXXXXXX,0,256,0
27426,145,1,144,80,115,0,0,275,152,123,GOOOOOOOXXXXXXXXXXXXGOOOOOOOOOOOXXXXXXXXGOOOOOOOOOOXXXXXXXXXGOOOOOOOOOOOOOOOOXXXGOOOOOOXXXXXXXXXXXXXGOOOOOOOOOOOOOOOOAXXGOOOOOOOOXXXXXXXXXXXGOOOOOOOOOOOOXXXXXXXGOOOOOOOOOOOOOOOXXXXGOOOOOXXXXXXXXXXXXXXGOOOOOOOOOXXXXXXXXXXGOOOOOOXXXXXXXXXXXXXGOOOOOOOOOOXXXXXXXXX,0,256,0
27447,145,0,145,84,111,0,0,270,148,122,GOOOOOOOXXXXXXXXXXXXGOOOOOOOOOOOXXXXXXXXGOOOOOOOOOOXXXXXXXXXGOOOOOOOOOOOOOOOOXXXGOOOOOOXXXXXXXXXXXXXGOOOOOOOOOOOOOOOOOXXGOOOOOOOOXXXXXXXXXXXGOOOOOOOOOOOOXXXXXXXGOOOOOOOOOOOOOOOXXXXGOOOOOXXXXXXXXXXXXXXGOOOOOOOOOXXXXXXXXXXGOOOOOOXXXXXXXXXXXXXGOOOOOOOOOOXXXXXXXXX,0,256,0
27468,145,0,145,81,114,0,0,274,151,123,GOOOOOOOXXXXXXXXXXXXGOOOOOOOOOOOXXXXXXXXGOOOOOOOOOOXXXXXXXXXGOOOOOOOOOOOOOOOOXXXGOOOOOOXXXXXXXXXXXXXGOOOOOOOOOOOOOOOOOXXGOOOOOOOOXXXXXXXXXXXGOOOOOOOOOOOOXXXXXXXGOOOOOOOOOOOOOOOXXXXGOOOOOXXXXXXXXXXXXXXGOOOOOOOOOXXXXXXXXXXGOOOOOOXXXXXXXXXXXXXGOOOOOOOOOOXXXXXXXXX,0,256,0
27489,145,0,145,77,118,0,0,277,153,124,GOOOOOOOXXXXXXXXXXXXGOOOOOOOOOOOXXXXXXXXGOOOOOOOOOOXXXXXXXXXGOOOOOOOOOOOOOOOOXXXGOOOOOOXXXXXXXXXXXXXGOOOOOOOOOOOOOOOOOXXGOOOOOOOOXXXXXXXXXXXGOOOOOOOOOOOOXXXXXXXGOOOOOOOOOOOOOOOXXXXGOOOOOXXXXXXXXXXXXXXGOOOOOOOOOXXXXXXXXXXGOOOOOOXXXXXXXXXXXXXGOOOOOOOOOOXXXXXXXXX,0,256,0

27510,145,0,145,77,118,0,0,278,152,126,GOOOOOOOXXXXXXXXXXXXGOOOOOOOOOOOXXXXXXXXGOOOOOOOOOOXXXXXXXXXGOOOOOOOOOOOOOOOOXXXGOOOOOOXXXXXXXXXXXXXGOOOOOOOOOOOOOOOOOXXGOOOOOOOOXXXXXXXXXXXGOOOOOOOOOOOOXXXXXXXGOOOOOOOOOOOOOOOXXXXGOOOOOXXXXXXXXXXXXXXGOOOOOOOOOXXXXXXXXXXGOOOOOOXXXXXXXXXXXXXGOOOOOOOOOOXXXXXXXXX,0,256,0
27531,145,0,145,75,120,0,0,280,159,121,GOOOOOOOXXXXXXXXXXXXGOOOOOOOOOOOXXXXXXXXGOOOOOOOOOOXXXXXXXXXGOOOOOOOOOOOOOOOOXXXGOOOOOOXXXXXXXXXXXXXGOOOOOOOOOOOOOOOOOXXGOOOOOOOOXXXXXXXXXXXGOOOOOOOOOOOOXXXXXXXGOOOOOOOOOOOOOOOXXXXGOOOOOXXXXXXXXXXXXXXGOOOOOOOOOXXXXXXXXXXGOOOOOOXXXXXXXXXXXXXGOOOOOOOOOOXXXXXXXXX,0,256,0
27552,145,0,145,78,117,0,0,277,163,114,GOOOOOOOXXXXXXXXXXXXGOOOOOOOOOOOXXXXXXXXGOOOOOOOOOOXXXXXXXXXGOOOOOOOOOOOOOOOOXXXGOOOOOOXXXXXXXXXXXXXGOOOOOOOOOOOOOOOOOXXGOOOOOOOOXXXXXXXXXXXGOOOOOOOOOOOOXXXXXXXGOOOOOOOOOOOOOOOXXXXGOOOOOXXXXXXXXXXXXXXGOOOOOOOOOXXXXXXXXXXGOOOOOOXXXXXXXXXXXXXGOOOOOOOOOOXXXXXXXXX,0,256,0
27573,145,0,145,77,118,0,0,277,165,112,GOOOOOOOXXXXXXXXXXXXGOOOOOOOOOOOXXXXXXXXGOOOOOOOOOOXXXXXXXXXGOOOOOOOOOOOOOOOOXXXGOOOOOOXXXXXXXXXXXXXGOOOOOOOOOOOOOOOOOXXGOOOOOOOOXXXXXXXXXXXGOOOOOOOOOOOOXXXXXXXGOOOOOOOOOOOOOOOXXXXGOOOOOXXXXXXXXXXXXXXGOOOOOOOOOXXXXXXXXXXGOOOOOOXXXXXXXXXXXXXGOOOOOOOOOOXXXXXXXXX,0,256,0
27594,145,0,145,80,115,0,0,275,161,114,GOOOOOOOXXXXXXXXXXXXGOOOOOOOOOOOXXXXXXXXGOOOOOOOOOOXXXXXXXXXGOOOOOOOOOOOOOOOOXXXGOOOOOOXXXXXXXXXXXXXGOOOOOOOOOOOOOOOOOXXGOOOOOOOOXXXXXXXXXXXGOOOOOOOOOOOOXXXXXXXGOOOOOOOOOOOOOOOXXXXGOOOOOXXXXXXXXXXXXXXGOOOOOOOOOXXXXXXXXXXGOOOOOOXXXXXXXXXXXXXGOOOOOOOOOOXXXXXXXXX,0,256,0

27615,145,0,145,78,117,0,0,277,166,111,GOOOOOOOXXXXXXXXXXXXGOOOOOOOOOOOXXXXXXXXGOOOOOOOOOOXXXXXXXXXGOOOOOOOOOOOOOOOOXXXGOOOOOOXXXXXXXXXXXXXGOOOOOOOOOOOOOOOOOXXGOOOOOOOOXXXXXXXXXXXGOOOOOOOOOOOOXXXXXXXGOOOOOOOOOOOOOOOXXXXGOOOOOXXXXXXXXXXXXXXGOOOOOOOOOXXXXXXXXXXGOOOOOOXXXXXXXXXXXXXGOOOOOOOOOOXXXXXXXXX,0,256,0
27636,145,0,145,75,120,0,0,280,164,116,GOOOOOOOXXXXXXXXXXXXGOOOOOOOOOOOXXXXXXXXGOOOOOOOOOOXXXXXXXXXGOOOOOOOOOOOOOOOOXXXGOOOOOOXXXXXXXXXXXXXGOOOOOOOOOOOOOOOOOXXGOOOOOOOOXXXXXXXXXXXGOOOOOOOOOOOOXXXXXXXGOOOOOOOOOOOOOOOXXXXGOOOOOXXXXXXXXXXXXXXGOOOOOOOOOXXXXXXXXXXGOOOOOOXXXXXXXXXXXXXGOOOOOOOOOOXXXXXXXXX,0,256,0
27657,145,0,145,78,117,0,0,277,161,116,GOOOOOOOXXXXXXXXXXXXGOOOOOOOOOOOXXXXXXXXGOOOOOOOOOOXXXXXXXXXGOOOOOOOOOOOOOOOOXXXGOOOOOOXXXXXXXXXXXXXGOOOOOOOOOOOOOOOOOXXGOOOOOOOOXXXXXXXXXXXGOOOOOOOOOOOOXXXXXXXGOOOOOOOOOOOOOOOXXXXGOOOOOXXXXXXXXXXXXXXGOOOOOOOOOXXXXXXXXXXGOOOOOOXXXXXXXXXXXXXGOOOOOOOOOOXXXXXXXXX,0,256,0
27678,145,0,145,81,114,0,0,273,157,116,GOOOOOOOXXXXXXXXXXXXGOOOOOOOOOOOXXXXXXXXGOOOOOOOOOOXXXXXXXXXGOOOOOOOOOOOOOOOOXXXGOOOOOOXXXXXXXXXXXXXGOOOOOOOOOOOOOOOOOXXGOOOOOOOOXXXXXXXXXXXGOOOOOOOOOOOOXXXXXXXGOOOOOOOOOOOOOOOXXXXGOOOOOXXXXXXXXXXXXXXGOOOOOOOOOXXXXXXXXXXGOOOOOOXXXXXXXXXXXXXGOOOOOOOOOOXXXXXXXXX,0,256,0
27699,145,0,145,72,123,0,0,282,156,126,GOOOOOOOXXXXXXXXXXXXGOOOOOOOOOOOXXXXXXXXGOOOOOOOOOOXXXXXXXXXGOOOOOOOOOOOOOOOOXXXGOOOOOOXXXXXXXXXXXXXGOOOOOOOOOOOOOOOOOXXGOOOOOOOOXXXXXXXXXXXGOOOOOOOOOOOOXXXXXXXGOOOOOOOOOOOOOOOXXXXGOOOOOXXXXXXXXXXXXXXGOOOOOOOOOXXXXXXXXXXGOOOOOOXXXXXXXXXXXXXGOOOOOOOOOOXXXXXXXXX,0,256,0

27720,145,0,145,72,123,0,0,283,161,122,GOOOOOOOXXXXXXXXXXXXGOOOOOOOOOOOXXXXXXXXGOOOOOOOOOOXXXXXXXXXGOOOOOOOOOOOOOOOOXXXGOOOOOOXXXXXXXXXXXXXGOOOOOOOOOOOOOOOOOXXGOOOOOOOOXXXXXXXXXXXGOOOOOOOOOOOOXXXXXXXGOOOOOOOOOOOOOOOXXXXGOOOOOXXXXXXXXXXXXXXGOOOOOOOOOXXXXXXXXXXGOOOOOOXXXXXXXXXXXXXGOOOOOOOOOOXXXXXXXXX,0,256,0
27741,145,0,145,69,126,0,0,286,159,127,GOOOOOOOXXXXXXXXXXXXGOOOOOOOOOOOXXXXXXXXGOOOOOOOOOOXXXXXXXXXGOOOOOOOOOOOOOOOOXXXGOOOOOOXXXXXXXXXXXXXGOOOOOOOOOOOOOOOOOXXGOOOOOOOOXXXXXXXXXXXGOOOOOOOOOOOOXXXXXXXGOOOOOOOOOOOOOOOXXXXGOOOOOXXXXXXXXXXXXXXGOOOOOOOOOXXXXXXXXXXGOOOOOOXXXXXXXXXXXXXGOOOOOOOOOOXXXXXXXXX,0,256,0
27762,145,0,145,61,134,0,0,292,158,134,GOOOOOOOXXXXXXXXXXXXGOOOOOOOOOOOXXXXXXXXGOOOOOOOOOOXXXXXXXXXGOOOOOOOOOOOOOOOOXXXGOOOOOOXXXXXXXXXXXXXGOOOOOOOOOOOOOOOOOXXGOOOOOOOOXXXXXXXXXXXGOOOOOOOOOOOOXXXXXXXGOOOOOOOOOOOOOOOXXXXGOOOOOXXXXXXXXXXXXXXGOOOOOOOOOXXXXXXXXXXGOOOOOOXXXXXXXXXXXXXGOOOOOOOOOOXXXXXXXXX,0,256,0
27783,145,0,145,64,131,0,0,291,154,137,GOOOOOOOXXXXXXXXXXXXGOOOOOOOOOOOXXXXXXXXGOOOOOOOOOOXXXXXXXXXGOOOOOOOOOOOOOOOOXXXGOOOOOOXXXXXXXXXXXXXGOOOOOOOOOOOOOOOOOXXGOOOOOOOOXXXXXXXXXXXGOOOOOOOOOOOOXXXXXXXGOOOOOOOOOOOOOOOXXXXGOOOOOXXXXXXXXXXXXXXGOOOOOOOOOXXXXXXXXXXGOOOOOOXXXXXXXXXXXXXGOOOOOOOOOOXXXXXXXXX,0,256,0
27804,145,0,145,60,135,0,0,295,154,141,GOOOOOOOXXXXXXXXXXXXGOOOOOOOOOOOXXXXXXXXGOOOOOOOOOOXXXXXXXXXGOOOOOOOOOOOOOOOOXXXGOOOOOOXXXXXXXXXXXXXGOOOOOOOOOOOOOOOOOXXGOOOOOOOOXXXXXXXXXXXGOOOOOOOOOOOOXXXXXXXGOOOOOOOOOOOOOOOXXXXGOOOOOXXXXXXXXXXXXXXGOOOOOOOOOXXXXXXXXXXGOOOOOOXXXXXXXXXXXXXGOOOOOOOOOOXXXXXXXXX,0,256,0

27825,145,0,145,60,135,0,0,295,158,137,GOOOOOOOXXXXXXXXXXXXGOOOOOOOOOOOXXXXXXXXGOOOOOOOOOOXXXXXXXXXGOOOOOOOOOOOOOOOOXXXGOOOOOOXXXXXXXXXXXXXGOOOOOOOOOOOOOOOOOXXGOOOOOOOOXXXXXXXXXXXGOOOOOOOOOOOOXXXXXXXGOOOOOOOOOOOOOOOXXXXGOOOOOXXXXXXXXXXXXXXGOOOOOOOOOXXXXXXXXXXGOOOOOOXXXXXXXXXXXXXGOOOOOOOOOOXXXXXXXXX,0,256,0
27846,145,0,145,67,128,0,0,288,157,131,GOOOOOOOXXXXXXXXXXXXGOOOOOOOOOOOXXXXXXXXGOOOOOOOOOOXXXXXXXXXGOOOOOOOOOOOOOOOOXXXGOOOOOOXXXXXXXXXXXXXGOOOOOOOOOOOOOOOOOXXGOOOOOOOOXXXXXXXXXXXGOOOOOOOOOOOOXXXXXXXGOOOOOOOOOOOOOOOXXXXGOOOOOXXXXXXXXXXXXXXGOOOOOOOOOXXXXXXXXXXGOOOOOOXXXXXXXXXXXXXGOOOOOOOOOOXXXXXXXXX,0,256,0
27867,145,0,145,71,124,0,0,284,152,132,GOOOOOOOXXXXXXXXXXXXGOOOOOOOOOOOXXXXXXXXGOOOOOOOOOOXXXXXXXXXGOOOOOOOOOOOOOOOOXXXGOOOOOOXXXXXXXXXXXXXGOOOOOOOOOOOOOOOOOXXGOOOOOOOOXXXXXXXXXXXGOOOOOOOOOOOOXXXXXXXGOOOOOOOOOOOOOOOXXXXGOOOOOXXXXXXXXXXXXXXGOOOOOOOOOXXXXXXXXXXGOOOOOOXXXXXXXXXXXXXGOOOOOOOOOOXXXXXXXXX,0,256,0
27888,145,0,145,67,128,0,0,287,156,131,GOOOOOOOXXXXXXXXXXXXGOOOOOOOOOOOXXXXXXXXGOOOOOOOOOOXXXXXXXXXGOOOOOOOOOOOOOOOOXXXGOOOOOOXXXXXXXXXXXXXGOOOOOOOOOOOOOOOOOXXGOOOOOOOOXXXXXXXXXXXGOOOOOOOOOOOOXXXXXXXGOOOOOOOOOOOOOOOXXXXGOOOOOXXXXXXXXXXXXXXGOOOOOOOOOXXXXXXXXXXGOOOOOOXXXXXXXXXXXXXGOOOOOOOOOOXXXXXXXXX,0,256,0
27909,145,0,145,63,132,0,0,292,159,133,GOOOOOOOXXXXXXXXXXXXGOOOOOOOOOOOXXXXXXXXGOOOOOOOOOOXXXXXXXXXGOOOOOOOOOOOOOOOOXXXGOOOOOOXXXXXXXXXXXXXGOOOOOOOOOOOOOOOOOXXGOOOOOOOOXXXXXXXXXXXGOOOOOOOOOOOOXXXXXXXGOOOOOOOOOOOOOOOXXXXGOOOOOXXXXXXXXXXXXXXGOOOOOOOOOXXXXXXXXXXGOOOOOOXXXXXXXXXXXXXGOOOOOOOOOOXXXXXXXXX,0,256,0

27930,146,1,145,62,132,0,0,292,160,132,GOOOOOOOAXXXXXXXXXXXGOOOOOOOOOOOXXXXXXXXGOOOOOOOOOOXXXXXXXXXGOOOOOOOOOOOOOOOOXXXGOOOOOOXXXXXXXXXXXXXGOOOOOOOOOOOOOOOOOXXGOOOOOOOOXXXXXXXXXXXGOOOOOOOOOOOOXXXXXXXGOOOOOOOOOOOOOOOXXXXGOOOOOXXXXXXXXXXXXXXGOOOOOOOOOXXXXXXXXXXGOOOOOOXXXXXXXXXXXXXGOOOOOOOOOOXXXXXXXXX,0,256,0
27951,146,1,145,65,129,0,0,289,156,133,GOOOOOOOAXXXXXXXXXXXGOOOOOOOOOOOXXXXXXXXGOOOOOOOOOOXXXXXXXXXGOOOOOOOOOOOOOOOOXXXGOOOOOOXXXXXXXXXXXXXGOOOOOOOOOOOOOOOOOXXGOOOOOOOOXXXXXXXXXXXGOOOOOOOOOOOOXXXXXXXGOOOOOOOOOOOOOOOXXXXGOOOOOXXXXXXXXXXXXXXGOOOOOOOOOXXXXXXXXXXGOOOOOOXXXXXXXXXXXXXGOOOOOOOOOOXXXXXXXXX,0,256,0
27972,146,1,145,63,131,0,0,291,155,136,GOOOOOOOAXXXXXXXXXXXGOOOOOOOOOOOXXXXXXXXGOOOOOOOOOOXXXXXXXXXGOOOOOOOOOOOOOOOOXXXGOOOOOOXXXXXXXXXXXXXGOOOOOOOOOOOOOOOOOXXGOOOOOOOOXXXXXXXXXXXGOOOOOOOOOOOOXXXXXXXGOOOOOOOOOOOOOOOXXXXGOOOOOXXXXXXXXXXXXXXGOOOOOOOOOXXXXXXXXXXGOOOOOOXXXXXXXXXXXXXGOOOOOOOOOOXXXXXXXXX,0,256,0
27993,146,1,145,58,136,0,0,296,163,133,GOOOOOOOAXXXXXXXXXXXGOOOOOOOOOOOXXXXXXXXGOOOOOOOOOOXXXXXXXXXGOOOOOOOOOOOOOOOOXXXGOOOOOOXXXXXXXXXXXXXGOOOOOOOOOOOOOOOOOXXGOOOOOOOOXXXXXXXXXXXGOOOOOOOOOOOOXXXXXXXGOOOOOOOOOOOOOOOXXXXGOOOOOXXXXXXXXXXXXXXGOOOOOOOOOXXXXXXXXXXGOOOOOOXXXXXXXXXXXXXGOOOOOOOOOOXXXXXXXXX,0,256,0
28014,146,1,145,69,125,0,0,285,156,129,GOOOOOOOAXXXXXXXXXXXGOOOOOOOOOOOXXXXXXXXGOOOOOOOOOOXXXXXXXXXGOOOOOOOOOOOOOOOOXXXGOOOOOOXXXXXXXXXXXXXGOOOOOOOOOOOOOOOOOXXGOOOOOOOOXXXXXXXXXXXGOOOOOOOOOOOOXXXXXXXGOOOOOOOOOOOOOOOXXXXGOOOOOXXXXXXXXXXXXXXGOOOOOOOOOXXXXXXXXXXGOOOOOOXXXXXXXXXXXXXGOOOOOOOOOOXXXXXXXXX,0,256,0

28035,146,1,145,73,121,0,0,281,158,123,GOOOOOOOAXXXXXXXXXXXGOOOOOOOOOOOXXXXXXXXGOOOOOOOOOOXXXXXXXXXGOOOOOOOOOOOOOOOOXXXGOOOOOOXXXXXXXXXXXXXGOOOOOOOOOOOOOOOOOXXGOOOOOOOOXXXXXXXXXXXGOOOOOOOOOOOOXXXXXXXGOOOOOOOOOOOOOOOXXXXGOOOOOXXXXXXXXXXXXXXGOOOOOOOOOXXXXXXXXXXGOOOOOOXXXXXXXXXXXXXGOOOOOOOOOOXXXXXXXXX,0,256,0
28056,146,1,145,73,121,0,0,280,162,118,GOOOOOOOAXXXXXXXXXXXGOOOOOOOOOOOXXXXXXXXGOOOOOOOOOOXXXXXXXXXGOOOOOOOOOOOOOOOOXXXGOOOOOOXXXXXXXXXXXXXGOOOOOOOOOOOOOOOOOXXGOOOOOOOOXXXXXXXXXXXGOOOOOOOOOOOOXXXXXXXGOOOOOOOOOOOOOOOXXXXGOOOOOXXXXXXXXXXXXXXGOOOOOOOOOXXXXXXXXXXGOOOOOOXXXXXXXXXXXXXGOOOOOOOOOOXXXXXXXXX,0,256,0
28077,146,1,145,73,121,0,0,281,163,118,GOOOOOOOAXXXXXXXXXXXGOOOOOOOOOOOXXXXXXXXGOOOOOOOOOOXXXXXXXXXGOOOOOOOOOOOOOOOOXXXGOOOOOOXXXXXXXXXXXXXGOOOOOOOOOOOOOOOOOXXGOOOOOOOOXXXXXXXXXXXGOOOOOOOOOOOOXXXXXXXGOOOOOOOOOOOOOOOXXXXGOOOOOXXXXXXXXXXXXXXGOOOOOOOOOXXXXXXXXXXGOOOOOOXXXXXXXXXXXXXGOOOOOOOOOOXXXXXXXXX,0,256,0
28098,146,1,145,77,117,0,0,277,164,113,GOOOOOOOAXXXXXXXXXXXGOOOOOOOOOOOXXXXXXXXGOOOOOOOOOOXXXXXXXXXGOOOOOOOOOOOOOOOOXXXGOOOOOOXXXXXXXXXXXXXGOOOOOOOOOOOOOOOOOXXGOOOOOOOOXXXXXXXXXXXGOOOOOOOOOOOOXXXXXXXGOOOOOOOOOOOOOOOXXXXGOOOOOXXXXXXXXXXXXXXGOOOOOOOOOXXXXXXXXXXGOOOOOOXXXXXXXXXXXXXGOOOOOOOOOOXXXXXXXXX,0,256,0
28119,146,1,145,80,114,0,0,274,159,115,GOOOOOOOAXXXXXXXXXXXGOOOOOOOOOOOXXXXXXXXGOOOOOOOOOOXXXXXXXXXGOOOOOOOOOOOOOOOOXXXGOOOOOOXXXXXXXXXXXXXGOOOOOOOOOOOOOOOOOXXGOOOOOOOOXXXXXXXXXXXGOOOOOOOOOOOOXXXXXXXGOOOOOOOOOOOOOOOXXXXGOOOOOXXXXXXXXXXXXXXGOOOOOOOOOXXXXXXXXXXGOOOOOOXXXXXXXXXXXXXGOOOOOOOOOOXXXXXXXXX,0,256,0

28140,146,1,145,76,118,0,0,278,164,114,GOOOOOOOAXXXXXXXXXXXGOOOOOOOOOOOXXXXXXXXGOOOOOOOOOOXXXXXXXXXGOOOOOOOOOOOOOOOOXXXGOOOOOOXXXXXXXXXXXXXGOOOOOOOOOOOOOOOOOXXGOOOOOOOOXXXXXXXXXXXGOOOOOOOOOOOOXXXXXXXGOOOOOOOOOOOOOOOXXXXGOOOOOXXXXXXXXXXXXXXGOOOOOOOOOXXXXXXXXXXGOOOOOOXXXXXXXXXXXXXGOOOOOOOOOOXXXXXXXXX,0,256,0
28161,146,1,145,76,118,0,0,278,156,122,GOOOOOOOAXXXXXXXXXXXGOOOOOOOOOOOXXXXXXXXGOOOOOOOOOOXXXXXXXXXGOOOOOOOOOOOOOOOOXXXGOOOOOOXXXXXXXXXXXXXGOOOOOOOOOOOOOOOOOXXGOOOOOOOOXXXXXXXXXXXGOOOOOOOOOOOOXXXXXXXGOOOOOOOOOOOOOOOXXXXGOOOOOXXXXXXXXXXXXXXGOOOOOOOOOXXXXXXXXXXGOOOOOOXXXXXXXXXXXXXGOOOOOOOOOOXXXXXXXXX,0,256,0
28182,146,1,145,70,124,0,0,282,159,123,GOOOOOOOAXXXXXXXXXXXGOOOOOOOOOOOXXXXXXXXGOOOOOOOOOOXXXXXXXXXGOOOOOOOOOOOOOOOOXXXGOOOOOOXXXXXXXXXXXXXGOOOOOOOOOOOOOOOOOXXGOOOOOOOOXXXXXXXXXXXGOOOOOOOOOOOOXXXXXXXGOOOOOOOOOOOOOOOXXXXGOOOOOXXXXXXXXXXXXXXGOOOOOOOOOXXXXXXXXXXGOOOOOOXXXXXXXXXXXXXGOOOOOOOOOOXXXXXXXXX,0,256,0
28203,146,1,145,73,121,0,0,281,160,121,GOOOOOOOAXXXXXXXXXXXGOOOOOOOOOOOXXXXXXXXGOOOOOOOOOOXXXXXXXXXGOOOOOOOOOOOOOOOOXXXGOOOOOOXXXXXXXXXXXXXGOOOOOOOOOOOOOOOOOXXGOOOOOOOOXXXXXXXXXXXGOOOOOOOOOOOOXXXXXXXGOOOOOOOOOOOOOOOXXXXGOOOOOXXXXXXXXXXXXXXGOOOOOOOOOXXXXXXXXXXGOOOOOOXXXXXXXXXXXXXGOOOOOOOOOOXXXXXXXXX,0,256,0
28224,146,1,145,74,120,0,0,280,163,117,GOOOOOOOAXXXXXXXXXXXGOOOOOOOOOOOXXXXXXXXGOOOOOOOOOOXXXXXXXXXGOOOOOOOOOOOOOOOOXXXGOOOOOOXXXXXXXXXXXXXGOOOOOOOOOOOOOOOOOXXGOOOOOOOOXXXXXXXXXXXGOOOOOOOOOOOOXXXXXXXGOOOOOOOOOOOOOOOXXXXGOOOOOXXXXXXXXXXXXXXGOOOOOOOOOXXXXXXXXXXGOOOOOOXXXXXXXXXXXXXGOOOOOOOOOOXXXXXXXXX,0,256,0

28245,146,1,145,75,119,0,0,279,159,120,GOOOOOOOAXXXXXXXXXXXGOOOOOOOOOOOXXXXXXXXGOOOOOOOOOOXXXXXXXXXGOOOOOOOOOOOOOOOOXXXGOOOOOOXXXXXXXXXXXXXGOOOOOOOOOOOOOOOOOXXGOOOOOOOOXXXXXXXXXXXGOOOOOOOOOOOOXXXXXXXGOOOOOOOOOOOOOOOXXXXGOOOOOXXXXXXXXXXXXXXGOOOOOOOOOXXXXXXXXXXGOOOOOOXXXXXXXXXXXXXGOOOOOOOOOOXXXXXXXXX,0,256,0
28266,146,1,145,78,116,0,0,276,151,125,GOOOOOOOAXXXXXXXXXXXGOOOOOOOOOOOXXXXXXXXGOOOOOOOOOOXXXXXXXXXGOOOOOOOOOOOOOOOOXXXGOOOOOOXXXXXXXXXXXXXGOOOOOOOOOOOOOOOOOXXGOOOOOOOOXXXXXXXXXXXGOOOOOOOOOOOOXXXXXXXGOOOOOOOOOOOOOOOXXXXGOOOOOXXXXXXXXXXXXXXGOOOOOOOOOXXXXXXXXXXGOOOOOOXXXXXXXXXXXXXGOOOOOOOOOOXXXXXXXXX,0,256,0
28287,146,0,146,76,118,0,0,278,153,125,GOOOOOOOOXXXXXXXXXXXGOOOOOOOOOOOXXXXXXXXGOOOOOOOOOOXXXXXXXXXGOOOOOOOOOOOOOOOOXXXGOOOOOOXXXXXXXXXXXXXGOOOOOOOOOOOOOOOOOXXGOOOOOOOOXXXXXXXXXXXGOOOOOOOOOOOOXXXXXXXGOOOOOOOOOOOOOOOXXXXGOOOOOXXXXXXXXXXXXXXGOOOOOOOOOXXXXXXXXXXGOOOOOOXXXXXXXXXXXXXGOOOOOOOOOOXXXXXXXXX,0,256,0
28308,146,0,146,76,118,0,0,277,154,123,GOOOOOOOOXXXXXXXXXXXGOOOOOOOOOOOXXXXXXXXGOOOOOOOOOOXXXXXXXXXGOOOOOOOOOOOOOOOOXXXGOOOOOOXXXXXXXXXXXXXGOOOOOOOOOOOOOOOOOXXGOOOOOOOOXXXXXXXXXXXGOOOOOOOOOOOOXXXXXXXGOOOOOOOOOOOOOOOXXXXGOOOOOXXXXXXXXXXXXXXGOOOOOOOOOXXXXXXXXXXGOOOOOOXXXXXXXXXXXXXGOOOOOOOOOOXXXXXXXXX,0,256,0
28329,146,0,146,70,124,0,0,286,156,130,GOOOOOOOOXXXXXXXXXXXGOOOOOOOOOOOXXXXXXXXGOOOOOOOOOOXXXXXXXXXGOOOOOOOOOOOOOOOOXXXGOOOOOOXXXXXXXXXXXXXGOOOOOOOOOOOOOOOOOXXGOOOOOOOOXXXXXXXXXXXGOOOOOOOOOOOOXXXXXXXGOOOOOOOOOOOOOOOXXXXGOOOOOXXXXXXXXXXXXXXGOOOOOOOOOXXXXXXXXXXGOOOOOOXXXXXXXXXXXXXGOOOOOOOOOOXXXXXXXXX,0,256,0

28350,146,0,146,71,123,0,0,285,155,130,GOOOOOOOOXXXXXXXXXXXGOOOOOOOOOOOXXXXXXXXGOOOOOOOOOOXXXXXXXXXGOOOOOOOOOOOOOOOOXXXGOOOOOOXXXXXXXXXXXXXGOOOOOOOOOOOOOOOOOXXGOOOOOOOOXXXXXXXXXXXGOOOOOOOOOOOOXXXXXXXGOOOOOOOOOOOOOOOXXXXGOOOOOXXXXXXXXXXXXXXGOOOOOOOOOXXXXXXXXXXGOOOOOOXXXXXXXXXXXXXGOOOOOOOOOOXXXXXXXXX,0,256,0
28371,146,0,146,72,122,0,0,284,155,129,GOOOOOOOOXXXXXXXXXXXGOOOOOOOOOOOXXXXXXXXGOOOOOOOOOOXXXXXXXXXGOOOOOOOOOOOOOOOOXXXGOOOOOOXXXXXXXXXXXXXGOOOOOOOOOOOOOOOOOXXGOOOOOOOOXXXXXXXXXXXGOOOOOOOOOOOOXXXXXXXGOOOOOOOOOOOOOOOXXXXGOOOOOXXXXXXXXXXXXXXGOOOOOOOOOXXXXXXXXXXGOOOOOOXXXXXXXXXXXXXGOOOOOOOOOOXXXXXXXXX,0,256,0
28392,146,0,146,68,126,0,0,286,157,129,GOOOOOOOOXXXXXXXXXXXGOOOOOOOOOOOXXXXXXXXGOOOOOOOOOOXXXXXXXXXGOOOOOOOOOOOOOOOOXXXGOOOOOOXXXXXXXXXXXXXGOOOOOOOOOOOOOOOOOXXGOOOOOOOOXXXXXXXXXXXGOOOOOOOOOOOOXXXXXXXGOOOOOOOOOOOOOOOXXXXGOOOOOXXXXXXXXXXXXXXGOOOOOOOOOXXXXXXXXXXGOOOOOOXXXXXXXXXXXXXGOOOOOOOOOOXXXXXXXXX,0,256,0
28413,146,0,146,73,121,0,0,283,156,127,GOOOOOOOOXXXXXXXXXXXGOOOOOOOOOOOXXXXXXXXGOOOOOOOOOOXXXXXXXXXGOOOOOOOOOOOOOOOOXXXGOOOOOOXXXXXXXXXXXXXGOOOOOOOOOOOOOOOOOXXGOOOOOOOOXXXXXXXXXXXGOOOOOOOOOOOOXXXXXXXGOOOOOOOOOOOOOOOXXXXGOOOOOXXXXXXXXXXXXXXGOOOOOOOOOXXXXXXXXXXGOOOOOOXXXXXXXXXXXXXGOOOOOOOOOOXXXXXXXXX,0,256,0
28434,146,0,146,77,117,0,0,279,159,120,GOOOOOOOOXXXXXXXXXXXGOOOOOOOOOOOXXXXXXXXGOOOOOOOOOOXXXXXXXXXGOOOOOOOOOOOOOOOOXXXGOOOOOOXXXXXXXXXXXXXGOOOOOOOOOOOOOOOOOXXGOOOOOOOOXXXXXXXXXXXGOOOOOOOOOOOOXXXXXXXGOOOOOOOOOOOOOOOXXXXGOOOOOXXXXXXXXXXXXXXGOOOOOOOOOXXXXXXXXXXGOOOOOOXXXXXXXXXXXXXGOOOOOOOOOOXXXXXXXXX,0,256,0

28455,146,0,146,82,112,0,0,274,161,113,GOOOOOOOOXXXXXXXXXXXGOOOOOOOOOOOXXXXXXXXGOOOOOOOOOOXXXXXXXXXGOOOOOOOOOOOOOOOOXXXGOOOOOOXXXXXXXXXXXXXGOOOOOOOOOOOOOOOOOXXGOOOOOOOOXXXXXXXXXXXGOOOOOOOOOOOOXXXXXXXGOOOOOOOOOOOOOOOXXXXGOOOOOXXXXXXXXXXXXXXGOOOOOOOOOXXXXXXXXXXGOOOOOOXXXXXXXXXXXXXGOOOOOOOOOOXXXXXXXXX,0,256,0
28476,146,0,146,83,111,0,0,273,163,110,GOOOOOOOOXXXXXXXXXXXGOOOOOOOOOOOXXXXXXXXGOOOOOOOOOOXXXXXXXXXGOOOOOOOOOOOOOOOOXXXGOOOOOOXXXXXXXXXXXXXGOOOOOOOOOOOOOOOOOXXGOOOOOOOOXXXXXXXXXXXGOOOOOOOOOOOOXXXXXXXGOOOOOOOOOOOOOOOXXXXGOOOOOXXXXXXXXXXXXXXGOOOOOOOOOXXXXXXXXXXGOOOOOOXXXXXXXXXXXXXGOOOOOOOOOOXXXXXXXXX,0,256,0
28497,146,0,146,82,112,0,0,274,160,114,GOOOOOOOOXXXXXXXXXXXGOOOOOOOOOOOXXXXXXXXGOOOOOOOOOOXXXXXXXXXGOOOOOOOOOOOOOOOOXXXGOOOOOOXXXXXXXXXXXXXGOOOOOOOOOOOOOOOOOXXGOOOOOOOOXXXXXXXXXXXGOOOOOOOOOOOOXXXXXXXGOOOOOOOOOOOOOOOXXXXGOOOOOXXXXXXXXXXXXXXGOOOOOOOOOXXXXXXXXXXGOOOOOOXXXXXXXXXXXXXGOOOOOOOOOOXXXXXXXXX,0,256,0
28518,146,0,146,79,115,0,0,277,166,111,GOOOOOOOOXXXXXXXXXXXGOOOOOOOOOOOXXXXXXXXGOOOOOOOOOOXXXXXXXXXGOOOOOOOOOOOOOOOOXXXGOOOOOOXXXXXXXXXXXXXGOOOOOOOOOOOOOOOOOXXGOOOOOOOOXXXXXXXXXXXGOOOOOOOOOOOOXXXXXXXGOOOOOOOOOOOOOOOXXXXGOOOOOXXXXXXXXXXXXXXGOOOOOOOOOXXXXXXXXXXGOOOOOOXXXXXXXXXXXXXGOOOOOOOOOOXXXXXXXXX,0,256,0
28539,146,0,146,80,114,0,0,276,169,107,GOOOOOOOOXXXXXXXXXXXGOOOOOOOOOOOXXXXXXXXGOOOOOOOOOOXXXXXXXXXGOOOOOOOOOOOOOOOOXXXGOOOOOOXXXXXXXXXXXXXGOOOOOOOOOOOOOOOOOXXGOOOOOOOOXXXXXXXXXXXGOOOOOOOOOOOOXXXXXXXGOOOOOOOOOOOOOOOXXXXGOOOOOXXXXXXXXXXXXXXGOOOOOOOOOXXXXXXXXXXGOOOOOOXXXXXXXXXXXXXGOOOOOOOOOOXXXXXXXXX,0,256,0

28560,146,0,146,84,110,0,0,273,161,112,GOOOOOOOOXXXXXXXXXXXGOOOOOOOOOOOXXXXXXXXGOOOOOOOOOOXXXXXXXXXGOOOOOOOOOOOOOOOOXXXGOOOOOOXXXXXXXXXXXXXGOOOOOOOOOOOOOOOOOXXGOOOOOOOOXXXXXXXXXXXGOOOOOOOOOOOOXXXXXXXGOOOOOOOOOOOOOOOXXXXGOOOOOXXXXXXXXXXXXXXGOOOOOOOOOXXXXXXXXXXGOOOOOOXXXXXXXXXXXXXGOOOOOOOOOOXXXXXXXXX,0,256,0
28581,146,0,146,84,110,0,0,273,163,110,GOOOOOOOOXXXXXXXXXXXGOOOOOOOOOOOXXXXXXXXGOOOOOOOOOOXXXXXXXXXGOOOOOOOOOOOOOOOOXXXGOOOOOOXXXXXXXXXXXXXGOOOOOOOOOOOOOOOOOXXGOOOOOOOOXXXXXXXXXXXGOOOOOOOOOOOOXXXXXXXGOOOOOOOOOOOOOOOXXXXGOOOOOXXXXXXXXXXXXXXGOOOOOOOOOXXXXXXXXXXGOOOOOOXXXXXXXXXXXXXGOOOOOOOOOOXXXXXXXXX,0,256,0
28602,146,0,146,90,104,0,0,266,162,104,GOOOOOOOOXXXXXXXXXXXGOOOOOOOOOOOXXXXXXXXGOOOOOOOOOOXXXXXXXXXGOOOOOOOOOOOOOOOOXXXGOOOOOOXXXXXXXXXXXXXGOOOOOOOOOOOOOOOOOXXGOOOOOOOOXXXXXXXXXXXGOOOOOOOOOOOOXXXXXXXGOOOOOOOOOOOOOOOXXXXGOOOOOXXXXXXXXXXXXXXGOOOOOOOOOXXXXXXXXXXGOOOOOOXXXXXXXXXXXXXGOOOOOOOOOOXXXXXXXXX,0,256,0
28623,146,0,146,92,102,0,0,265,160,105,GOOOOOOOOXXXXXXXXXXXGOOOOOOOOOOOXXXXXXXXGOOOOOOOOOOXXXXXXXXXGOOOOOOOOOOOOOOOOXXXGOOOOOOXXXXXXXXXXXXXGOOOOOOOOOOOOOOOOOXXGOOOOOOOOXXXXXXXXXXXGOOOOOOOOOOOOXXXXXXXGOOOOOOOOOOOOOOOXXXXGOOOOOXXXXXXXXXXXXXXGOOOOOOOOOXXXXXXXXXXGOOOOOOXXXXXXXXXXXXXGOOOOOOOOOOXXXXXXXXX,0,256,0
28644,146,0,146,86,108,0,0,269,162,107,GOOOOOOOOXXXXXXXXXXXGOOOOOOOOOOOXXXXXXXXGOOOOOOOOOOXXXXXXXXXGOOOOOOOOOOOOOOOOXXXGOOOOOOXXXXXXXXXXXXXGOOOOOOOOOOOOOOOOOXXGOOOOOOOOXXXXXXXXXXXGOOOOOOOOOOOOXXXXXXXGOOOOOOOOOOOOOOOXXXXGOOOOOXXXXXXXXXXXXXXGOOOOOOOOOXXXXXXXXXXGOOOOOOXXXXXXXXXXXXXGOOOOOOOOOOXXXXXXXXX,0,256,0

28665,146,0,146,85,109,0,0,271,158,113,GOOOOOOOOXXXXXXXXXXXGOOOOOOOOOOOXXXXXXXXGOOOOOOOOOOXXXXXXXXXGOOOOOOOOOOOOOOOOXXXGOOOOOOXXXXXXXXXXXXXGOOOOOOOOOOOOOOOOOXXGOOOOOOOOXXXXXXXXXXXGOOOOOOOOOOOOXXXXXXXGOOOOOOOOOOOOOOOXXXXGOOOOOXXXXXXXXXXXXXXGOOOOOOOOOXXXXXXXXXXGOOOOOOXXXXXXXXXXXXXGOOOOOOOOOOXXXXXXXXX,0,256,0
28686,146,0,146,82,112,0,0,272,157,115,GOOOOOOOOXXXXXXXXXXXGOOOOOOOOOOOXXXXXXXXGOOOOOOOOOOXXXXXXXXXGOOOOOOOOOOOOOOOOXXXGOOOOOOXXXXXXXXXXXXXGOOOOOOOOOOOOOOOOOXXGOOOOOOOOXXXXXXXXXXXGOOOOOOOOOOOOXXXXXXXGOOOOOOOOOOOOOOOXXXXGOOOOOXXXXXXXXXXXXXXGOOOOOOOOOXXXXXXXXXXGOOOOOOXXXXXXXXXXXXXGOOOOOOOOOOXXXXXXXXX,0,256,0
28707,146,0,146,82,112,0,0,271,159,112,GOOOOOOOOXXXXXXXXXXXGOOOOOOOOOOOXXXXXXXXGOOOOOOOOOOXXXXXXXXXGOOOOOOOOOOOOOOOOXXXGOOOOOOXXXXXXXXXXXXXGOOOOOOOOOOOOOOOOOXXGOOOOOOOOXXXXXXXXXXXGOOOOOOOOOOOOXXXXXXXGOOOOOOOOOOOOOOOXXXXGOOOOOXXXXXXXXXXXXXXGOOOOOOOOOXXXXXXXXXXGOOOOOOXXXXXXXXXXXXXGOOOOOOOOOOXXXXXXXXX,0,256,0
28728,147,1,146,82,111,0,0,271,157,114,GOOOOOOOOXXXXXXXXXXXGOOOOOOOOOOOXXXXXXXXGOOOOOOOOOOXXXXXXXXXGOOOOOOOOOOOOOOOOXXXGOOOOOOXXXXXXXXXXXXXGOOOOOOOOOOOOOOOOOXXGOOOOOOOOXXXXXXXXXXXGOOOOOOOOOOOOXXXXXXXGOOOOOOOOOOOOOOOAXXXGOOOOOXXXXXXXXXXXXXXGOOOOOOOOOXXXXXXXXXXGOOOOOOXXXXXXXXXXXXXGOOOOOOOOOOXXXXXXXXX,0,256,0
28749,147,1,146,74,119,0,0,279,163,116,GOOOOOOOOXXXXXXXXXXXGOOOOOOOOOOOXXXXXXXXGOOOOOOOOOOXXXXXXXXXGOOOOOOOOOOOOOOOOXXXGOOOOOOXXXXXXXXXXXXXGOOOOOOOOOOOOOOOOOXXGOOOOOOOOXXXXXXXXXXXGOOOOOOOOOOOOXXXXXXXGOOOOOOOOOOOOOOOAXXXGOOOOOXXXXXXXXXXXXXXGOOOOOOOOOXXXXXXXXXXGOOOOOOXXXXXXXXXXXXXGOOOOOOOOOOXXXXXXXXX,0,256,0

28770,147,1,146,75,118,0,0,278,160,118,GOOOOOOOOXXXXXXXXXXXGOOOOOOOOOOOXXXXXXXXGOOOOOOOOOOXXXXXXXXXGOOOOOOOOOOOOOOOOXXXGOOOOOOXXXXXXXXXXXXXGOOOOOOOOOOOOOOOOOXXGOOOOOOOOXXXXXXXXXXXGOOOOOOOOOOOOXXXXXXXGOOOOOOOOOOOOOOOAXXXGOOOOOXXXXXXXXXXXXXXGOOOOOOOOOXXXXXXXXXXGOOOOOOXXXXXXXXXXXXXGOOOOOOOOOOXXXXXXXXX,0,256,0
28791,147,1,146,73,120,0,0,279,158,121,GOOOOOOOOXXXXXXXXXXXGOOOOOOOOOOOXXXXXXXXGOOOOOOOOOOXXXXXXXXXGOOOOOOOOOOOOOOOOXXXGOOOOOOXXXXXXXXXXXXXGOOOOOOOOOOOOOOOOOXXGOOOOOOOOXXXXXXXXXXXGOOOOOOOOOOOOXXXXXXXGOOOOOOOOOOOOOOOAXXXGOOOOOXXXXXXXXXXXXXXGOOOOOOOOOXXXXXXXXXXGOOOOOOXXXXXXXXXXXXXGOOOOOOOOOOXXXXXXXXX,0,256,0
28812,147,1,146,68,125,0,0,285,163,122,GOOOOOOOOXXXXXXXXXXXGOOOOOOOOOOOXXXXXXXXGOOOOOOOOOOXXXXXXXXXGOOOOOOOOOOOOOOOOXXXGOOOOOOXXXXXXXXXXXXXGOOOOOOOOOOOOOOOOOXXGOOOOOOOOXXXXXXXXXXXGOOOOOOOOOOOOXXXXXXXGOOOOOOOOOOOOOOOAXXXGOOOOOXXXXXXXXXXXXXXGOOOOOOOOOXXXXXXXXXXGOOOOOOXXXXXXXXXXXXXGOOOOOOOOOOXXXXXXXXX,0,256,0
28833,147,1,146,72,121,0,0,281,163,118,GOOOOOOOOXXXXXXXXXXXGOOOOOOOOOOOXXXXXXXXGOOOOOOOOOOXXXXXXXXXGOOOOOOOOOOOOOOOOXXXGOOOOOOXXXXXXXXXXXXXGOOOOOOOOOOOOOOOOOXXGOOOOOOOOXXXXXXXXXXXGOOOOOOOOOOOOXXXXXXXGOOOOOOOOOOOOOOOAXXXGOOOOOXXXXXXXXXXXXXXGOOOOOOOOOXXXXXXXXXXGOOOOOOXXXXXXXXXXXXXGOOOOOOOOOOXXXXXXXXX,0,256,0
28854,147,1,146,67,126,0,0,286,158,128,GOOOOOOOOXXXXXXXXXXXGOOOOOOOOOOOXXXXXXXXGOOOOOOOOOOXXXXXXXXXGOOOOOOOOOOOOOOOOXXXGOOOOOOXXXXXXXXXXXXXGOOOOOOOOOOOOOOOOOXXGOOOOOOOOXXXXXXXXXXXGOOOOOOOOOOOOXXXXXXXGOOOOOOOOOOOOOOOAXXXGOOOOOXXXXXXXXXXXXXXGOOOOOOOOOXXXXXXXXXXGOOOOOOXXXXXXXXXXXXXGOOOOOOOOOOXXXXXXXXX,0,256,0

28875,147,1,146,63,130,0,0,290,159,131,GOOOOOOOOXXXXXXXXXXXGOOOOOOOOOOOXXXXXXXXGOOOOOOOOOOXXXXXXXXXGOOOOOOOOOOOOOOOOXXXGOOOOOOXXXXXXXXXXXXXGOOOOOOOOOOOOOOOOOXXGOOOOOOOOXXXXXXXXXXXGOOOOOOOOOOOOXXXXXXXGOOOOOOOOOOOOOOOAXXXGOOOOOXXXXXXXXXXXXXXGOOOOOOOOOXXXXXXXXXXGOOOOOOXXXXXXXXXXXXXGOOOOOOOOOOXXXXXXXXX,0,256,0
28896,147,1,146,59,134,0,0,295,163,132,GOOOOOOOOXXXXXXXXXXXGOOOOOOOOOOOXXXXXXXXGOOOOOOOOOOXXXXXXXXXGOOOOOOOOOOOOOOOOXXXGOOOOOOXXXXXXXXXXXXXGOOOOOOOOOOOOOOOOOXXGOOOOOOOOXXXXXXXXXXXGOOOOOOOOOOOOXXXXXXXGOOOOOOOOOOOOOOOAXXXGOOOOOXXXXXXXXXXXXXXGOOOOOOOOOXXXXXXXXXXGOOOOOOXXXXXXXXXXXXXGOOOOOOOOOOXXXXXXXXX,0,256,0
28917,147,0,147,66,127,0,0,288,160,128,GOOOOOOOOXXXXXXXXXXXGOOOOOOOOOOOXXXXXXXXGOOOOOOOOOOXXXXXXXXXGOOOOOOOOOOOOOOOOXXXGOOOOOOXXXXXXXXXXXXXGOOOOOOOOOOOOOOOOOXXGOOOOOOOOXXXXXXXXXXXGOOOOOOOOOOOOXXXXXXXGOOOOOOOOOOOOOOOOXXXGOOOOOXXXXXXXXXXXXXXGOOOOOOOOOXXXXXXXXXXGOOOOOOXXXXXXXXXXXXXGOOOOOOOOOOXXXXXXXXX,0,256,0
28938,147,0,147,64,129,0,0,289,159,130,GOOOOOOOOXXXXXXXXXXXGOOOOOOOOOOOXXXXXXXXGOOOOOOOOOOXXXXXXXXXGOOOOOOOOOOOOOOOOXXXGOOOOOOXXXXXXXXXXXXXGOOOOOOOOOOOOOOOOOXXGOOOOOOOOXXXXXXXXXXXGOOOOOOOOOOOOXXXXXXXGOOOOOOOOOOOOOOOOXXXGOOOOOXXXXXXXXXXXXXXGOOOOOOOOOXXXXXXXXXXGOOOOOOXXXXXXXXXXXXXGOOOOOOOOOOXXXXXXXXX,0,256,0
28959,147,0,147,63,130,0,0,290,162,128,GOOOOOOOOXXXXXXXXXXXGOOOOOOOOOOOXXXXXXXXGOOOOOOOOOOXXXXXXXXXGOOOOOOOOOOOOOOOOXXXGOOOOOOXXXXXXXXXXXXXGOOOOOOOOOOOOOOOOOXXGOOOOOOOOXXXXXXXXXXXGOOOOOOOOOOOOXXXXXXXGOOOOOOOOOOOOOOOOXXXGOOOOOXXXXXXXXXXXXXXGOOOOOOOOOXXXXXXXXXXGOOOOOOXXXXXXXXXXXXXGOOOOOOOOOOXXXXXXXXX,0,256,0

28980,147,0,147,67,126,0,0,285,159,126,GOOOOOOOOXXXXXXXXXXXGOOOOOOOOOOOXXXXXXXXGOOOOOOOOOOXXXXXXXXXGOOOOOOOOOOOOOOOOXXXGOOOOOOXXXXXXXXXXXXXGOOOOOOOOOOOOOOOOOXXGOOOOOOOOXXXXXXXXXXXGOOOOOOOOOOOOXXXXXXXGOOOOOOOOOOOOOOOOXXXGOOOOOXXXXXXXXXXXXXXGOOOOOOOOOXXXXXXXXXXGOOOOOOXXXXXXXXXXXXXGOOOOOOOOOOXXXXXXXXX,0,256,0
29001,147,0,147,62,131,0,0,291,157,134,GOOOOOOOOXXXXXXXXXXXGOOOOOOOOOOOXXXXXXXXGOOOOOOOOOOXXXXXXXXXGOOOOOOOOOOOOOOOOXXXGOOOOOOXXXXXXXXXXXXXGOOOOOOOOOOOOOOOOOXXGOOOOOOOOXXXXXXXXXXXGOOOOOOOOOOOOXXXXXXXGOOOOOOOOOOOOOOOOXXXGOOOOOXXXXXXXXXXXXXXGOOOOOOOOOXXXXXXXXXXGOOOOOOXXXXXXXXXXXXXGOOOOOOOOOOXXXXXXXXX,0,256,0
29022,147,0,147,62,131,0,0,289,156,133,GOOOOOOOOXXXXXXXXXXXGOOOOOOOOOOOXXXXXXXXGOOOOOOOOOOXXXXXXXXXGOOOOOOOOOOOOOOOOXXXGOOOOOOXXXXXXXXXXXXXGOOOOOOOOOOOOOOOOOXXGOOOOOOOOXXXXXXXXXXXGOOOOOOOOOOOOXXXXXXXGOOOOOOOOOOOOOOOOXXXGOOOOOXXXXXXXXXXXXXXGOOOOOOOOOXXXXXXXXXXGOOOOOOXXXXXXXXXXXXXGOOOOOOOOOOXXXXXXXXX,0,256,0
29043,147,0,147,67,126,0,0,285,156,129,GOOOOOOOOXXXXXXXXXXXGOOOOOOOOOOOXXXXXXXXGOOOOOOOOOOXXXXXXXXXGOOOOOOOOOOOOOOOOXXXGOOOOOOXXXXXXXXXXXXXGOOOOOOOOOOOOOOOOOXXGOOOOOOOOXXXXXXXXXXXGOOOOOOOOOOOOXXXXXXXGOOOOOOOOOOOOOOOOXXXGOOOOOXXXXXXXXXXXXXXGOOOOOOOOOXXXXXXXXXXGOOOOOOXXXXXXXXXXXXXGOOOOOOOOOOXXXXXXXXX,0,256,0
29064,147,0,147,65,128,0,0,288,161,127,GOOOOOOOOXXXXXXXXXXXGOOOOOOOOOOOXXXXXXXXGOOOOOOOOOOXXXXXXXXXGOOOOOOOOOOOOOOOOXXXGOOOOOOXXXXXXXXXXXXXGOOOOOOOOOOOOOOOOOXXGOOOOOOOOXXXXXXXXXXXGOOOOOOOOOOOOXXXXXXXGOOOOOOOOOOOOOOOOXXXGOOOOOXXXXXXXXXXXXXXGOOOOOOOOOXXXXXXXXXXGOOOOOOXXXXXXXXXXXXXGOOOOOOOOOOXXXXXXXXX,0,256,0

29085,147,0,147,65,128,0,0,287,162,125,GOOOOOOOOXXXXXXXXXXXGOOOOOOOOOOOXXXXXXXXGOOOOOOOOOOXXXXXXXXXGOOOOOOOOOOOOOOOOXXXGOOOOOOXXXXXXXXXXXXXGOOOOOOOOOOOOOOOOOXXGOOOOOOOOXXXXXXXXXXXGOOOOOOOOOOOOXXXXXXXGOOOOOOOOOOOOOOOOXXXGOOOOOXXXXXXXXXXXXXXGOOOOOOOOOXXXXXXXXXXGOOOOOOXXXXXXXXXXXXXGOOOOOOOOOOXXXXXXXXX,0,256,0
29106,147,0,147,69,124,0,0,285,161,124,GOOOOOOOOXXXXXXXXXXXGOOOOOOOOOOOXXXXXXXXGOOOOOOOOOOXXXXXXXXXGOOOOOOOOOOOOOOOOXXXGOOOOOOXXXXXXXXXXXXXGOOOOOOOOOOOOOOOOOXXGOOOOOOOOXXXXXXXXXXXGOOOOOOOOOOOOXXXXXXXGOOOOOOOOOOOOOOOOXXXGOOOOOXXXXXXXXXXXXXXGOOOOOOOOOXXXXXXXXXXGOOOOOOXXXXXXXXXXXXXGOOOOOOOOOOXXXXXXXXX,0,256,0
29127,147,0,147,66,127,0,0,288,167,121,GOOOOOOOOXXXXXXXXXXXGOOOOOOOOOOOXXXXXXXXGOOOOOOOOOOXXXXXXXXXGOOOOOOOOOOOOOOOOXXXGOOOOOOXXXXXXXXXXXXXGOOOOOOOOOOOOOOOOOXXGOOOOOOOOXXXXXXXXXXXGOOOOOOOOOOOOXXXXXXXGOOOOOOOOOOOOOOOOXXXGOOOOOXXXXXXXXXXXXXXGOOOOOOOOOXXXXXXXXXXGOOOOOOXXXXXXXXXXXXXGOOOOOOOOOOXXXXXXXXX,0,256,0
29148,147,0,147,66,127,0,0,288,167,121,GOOOOOOOOXXXXXXXXXXXGOOOOOOOOOOOXXXXXXXXGOOOOOOOOOOXXXXXXXXXGOOOOOOOOOOOOOOOOXXXGOOOOOOXXXXXXXXXXXXXGOOOOOOOOOOOOOOOOOXXGOOOOOOOOXXXXXXXXXXXGOOOOOOOOOOOOXXXXXXXGOOOOOOOOOOOOOOOOXXXGOOOOOXXXXXXXXXXXXXXGOOOOOOOOOXXXXXXXXXXGOOOOOOXXXXXXXXXXXXXGOOOOOOOOOOXXXXXXXXX,0,256,0
29169,148,1,147,71,121,0,0,282,161,121,GOOOOOOOOXXXXXXXXXXXGOOOOOOOOOOOXXXXXXXXGOOOOOOOOOOXXXXXXXXXGOOOOOOOOOOOOOOOOXXXGOOOOOOXXXXXXXXXXXXXGOOOOOOOOOOOOOOOOOXXGOOOOOOOOXXXXXXXXXXXGOOOOOOOOOOOOXXXXXXXGOOOOOOOOOOOOOOOOAXXGOOOOOXXXXXXXXXXXXXXGOOOOOOOOOXXXXXXXXXXGOOOOOOXXXXXXXXXXXXXGOOOOOOOOOOXXXXXXXXX,0,256,0

29190,148,1,147,74,118,0,0,279,164,115,GOOOOOOOOXXXXXXXXXXXGOOOOOOOOOOOXXXXXXXXGOOOOOOOOOOXXXXXXXXXGOOOOOOOOOOOOOOOOXXXGOOOOOOXXXXXXXXXXXXXGOOOOOOOOOOOOOOOOOXXGOOOOOOOOXXXXXXXXXXXGOOOOOOOOOOOOXXXXXXXGOOOOOOOOOOOOOOOOAXXGOOOOOXXXXXXXXXXXXXXGOOOOOOOOOXXXXXXXXXXGOOOOOOXXXXXXXXXXXXXGOOOOOOOOOOXXXXXXXXX,0,256,0
29211,148,1,147,72,120,0,0,279,164,115,GOOOOOOOOXXXXXXXXXXXGOOOOOOOOOOOXXXXXXXXGOOOOOOOOOOXXXXXXXXXGOOOOOOOOOOOOOOOOXXXGOOOOOOXXXXXXXXXXXXXGOOOOOOOOOOOOOOOOOXXGOOOOOOOOXXXXXXXXXXXGOOOOOOOOOOOOXXXXXXXGOOOOOOOOOOOOOOOOAXXGOOOOOXXXXXXXXXXXXXXGOOOOOOOOOXXXXXXXXXXGOOOOOOXXXXXXXXXXXXXGOOOOOOOOOOXXXXXXXXX,0,256,0
29232,148,1,147,76,116,0,0,277,167,110,GOOOOOOOOXXXXXXXXXXXGOOOOOOOOOOOXXXXXXXXGOOOOOOOOOOXXXXXXXXXGOOOOOOOOOOOOOOOOXXXGOOOOOOXXXXXXXXXXXXXGOOOOOOOOOOOOOOOOOXXGOOOOOOOOXXXXXXXXXXXGOOOOOOOOOOOOXXXXXXXGOOOOOOOOOOOOOOOOAXXGOOOOOXXXXXXXXXXXXXXGOOOOOOOOOXXXXXXXXXXGOOOOOOXXXXXXXXXXXXXGOOOOOOOOOOXXXXXXXXX,0,256,0
29253,148,1,147,82,110,0,0,272,163,109,GOOOOOOOOXXXXXXXXXXXGOOOOOOOOOOOXXXXXXXXGOOOOOOOOOOXXXXXXXXXGOOOOOOOOOOOOOOOOXXXGOOOOOOXXXXXXXXXXXXXGOOOOOOOOOOOOOOOOOXXGOOOOOOOOXXXXXXXXXXXGOOOOOOOOOOOOXXXXXXXGOOOOOOOOOOOOOOOOAXXGOOOOOXXXXXXXXXXXXXXGOOOOOOOOOXXXXXXXXXXGOOOOOOXXXXXXXXXXXXXGOOOOOOOOOOXXXXXXXXX,0,256,0
29274,148,1,147,77,115,0,0,277,166,111,GOOOOOOOOXXXXXXXXXXXGOOOOOOOOOOOXXXXXXXXGOOOOOOOOOOXXXXXXXXXGOOOOOOOOOOOOOOOOXXXGOOOOOOXXXXXXXXXXXXXGOOOOOOOOOOOOOOOOOXXGOOOOOOOOXXXXXXXXXXXGOOOOOOOOOOOOXXXXXXXGOOOOOOOOOOOOOOOOAXXGOOOOOXXXXXXXXXXXXXXGOOOOOOOOOXXXXXXXXXXGOOOOOOXXXXXXXXXXXXXGOOOOOOOOOOXXXXXXXXX,0,256,0

29295,148,1,147,79,113,0,0,273,167,106,GOOOOOOOOXXXXXXXXXXXGOOOOOOOOOOOXXXXXXXXGOOOOOOOOOOXXXXXXXXXGOOOOOOOOOOOOOOOOXXXGOOOOOOXXXXXXXXXXXXXGOOOOOOOOOOOOOOOOOXXGOOOOOOOOXXXXXXXXXXXGOOOOOOOOOOOOXXXXXXXGOOOOOOOOOOOOOOOOAXXGOOOOOXXXXXXXXXXXXXXGOOOOOOOOOXXXXXXXXXXGOOOOOOXXXXXXXXXXXXXGOOOOOOOOOOXXXXXXXXX,0,256,0
29316,148,1,147,77,115,0,0,275,166,109,GOOOOOOOOXXXXXXXXXXXGOOOOOOOOOOOXXXXXXXXGOOOOOOOOOOXXXXXXXXXGOOOOOOOOOOOOOOOOXXXGOOOOOOXXXXXXXXXXXXXGOOOOOOOOOOOOOOOOOXXGOOOOOOOOXXXXXXXXXXXGOOOOOOOOOOOOXXXXXXXGOOOOOOOOOOOOOOOOAXXGOOOOOXXXXXXXXXXXXXXGOOOOOOOOOXXXXXXXXXXGOOOOOOXXXXXXXXXXXXXGOOOOOOOOOOXXXXXXXXX,0,256,0
29337,148,1,147,77,115,0,0,277,164,113,GOOOOOOOOXXXXXXXXXXXGOOOOOOOOOOOXXXXXXXXGOOOOOOOOOOXXXXXXXXXGOOOOOOOOOOOOOOOOXXXGOOOOOOXXXXXXXXXXXXXGOOOOOOOOOOOOOOOOOXXGOOOOOOOOXXXXXXXXXXXGOOOOOOOOOOOOXXXXXXXGOOOOOOOOOOOOOOOOAXXGOOOOOXXXXXXXXXXXXXXGOOOOOOOOOXXXXXXXXXXGOOOOOOXXXXXXXXXXXXXGOOOOOOOOOOXXXXXXXXX,0,256,0
29358,148,1,147,75,117,0,0,278,164,114,GOOOOOOOOXXXXXXXXXXXGOOOOOOOOOOOXXXXXXXXGOOOOOOOOOOXXXXXXXXXGOOOOOOOOOOOOOOOOXXXGOOOOOOXXXXXXXXXXXXXGOOOOOOOOOOOOOOOOOXXGOOOOOOOOXXXXXXXXXXXGOOOOOOOOOOOOXXXXXXXGOOOOOOOOOOOOOOOOAXXGOOOOOXXXXXXXXXXXXXXGOOOOOOOOOXXXXXXXXXXGOOOOOOXXXXXXXXXXXXXGOOOOOOOOOOXXXXXXXXX,0,256,0
29379,148,1,147,71,121,0,0,281,164,117,GOOOOOOOOXXXXXXXXXXXGOOOOOOOOOOOXXXXXXXXGOOOOOOOOOOXXXXXXXXXGOOOOOOOOOOOOOOOOXXXGOOOOOOXXXXXXXXXXXXXGOOOOOOOOOOOOOOOOOXXGOOOOOOOOXXXXXXXXXXXGOOOOOOOOOOOOXXXXXXXGOOOOOOOOOOOOOOOOAXXGOOOOOXXXXXXXXXXXXXXGOOOOOOOOOXXXXXXXXXXGOOOOOOXXXXXXXXXXXXXGOOOOOOOOOOXXXXXXXXX,0,256,0

29400,148,1,147,74,118,0,0,278,160,118,GOOOOOOOOXXXXXXXXXXXGOOOOOOOOOOOXXXXXXXXGOOOOOOOOOOXXXXXXXXXGOOOOOOOOOOOOOOOOXXXGOOOOOOXXXXXXXXXXXXXGOOOOOOOOOOOOOOOOOXXGOOOOOOOOXXXXXXXXXXXGOOOOOOOOOOOOXXXXXXXGOOOOOOOOOOOOOOOOAXXGOOOOOXXXXXXXXXXXXXXGOOOOOOOOOXXXXXXXXXXGOOOOOOXXXXXXXXXXXXXGOOOOOOOOOOXXXXXXXXX,0,256,0
29421,148,1,147,74,118,0,0,278,160,118,GOOOOOOOOXXXXXXXXXXXGOOOOOOOOOOOXXXXXXXXGOOOOOOOOOOXXXXXXXXXGOOOOOOOOOOOOOOOOXXXGOOOOOOXXXXXXXXXXXXXGOOOOOOOOOOOOOOOOOXXGOOOOOOOOXXXXXXXXXXXGOOOOOOOOOOOOXXXXXXXGOOOOOOOOOOOOOOOOAXXGOOOOOXXXXXXXXXXXXXXGOOOOOOOOOXXXXXXXXXXGOOOOOOXXXXXXXXXXXXXGOOOOOOOOOOXXXXXXXXX,0,256,0
29442,148,0,148,71,121,0,0,279,164,115,GOOOOOOOOXXXXXXXXXXXGOOOOOOOOOOOXXXXXXXXGOOOOOOOOOOXXXXXXXXXGOOOOOOOOOOOOOOOOXXXGOOOOOOXXXXXXXXXXXXXGOOOOOOOOOOOOOOOOOXXGOOOOOOOOXXXXXXXXXXXGOOOOOOOOOOOOXXXXXXXGOOOOOOOOOOOOOOOOOXXGOOOOOXXXXXXXXXXXXXXGOOOOOOOOOXXXXXXXXXXGOOOOOOXXXXXXXXXXXXXGOOOOOOOOOOXXXXXXXXX,0,256,0
29463,148,0,148,70,122,0,0,282,164,118,GOOOOOOOOXXXXXXXXXXXGOOOOOOOOOOOXXXXXXXXGOOOOOOOOOOXXXXXXXXXGOOOOOOOOOOOOOOOOXXXGOOOOOOXXXXXXXXXXXXXGOOOOOOOOOOOOOOOOOXXGOOOOOOOOXXXXXXXXXXXGOOOOOOOOOOOOXXXXXXXGOOOOOOOOOOOOOOOOOXXGOOOOOXXXXXXXXXXXXXXGOOOOOOOOOXXXXXXXXXXGOOOOOOXXXXXXXXXXXXXGOOOOOOOOOOXXXXXXXXX,0,256,0
29484,148,0,148,68,124,0,0,284,167,117,GOOOOOOOOXXXXXXXXXXXGOOOOOOOOOOOXXXXXXXXGOOOOOOOOOOXXXXXXXXXGOOOOOOOOOOOOOOOOXXXGOOOOOOXXXXXXXXXXXXXGOOOOOOOOOOOOOOOOOXXGOOOOOOOOXXXXXXXXXXXGOOOOOOOOOOOOXXXXXXXGOOOOOOOOOOOOOOOOOXXGOOOOOXXXXXXXXXXXXXXGOOOOOOOOOXXXXXXXXXXGOOOOOOXXXXXXXXXXXXXGOOOOOOOOOOXXXXXXXXX,0,256,0

29505,148,0,148,70,122,0,0,281,165,116,GOOOOOOOOXXXXXXXXXXXGOOOOOOOOOOOXXXXXXXXGOOOOOOOOOOXXXXXXXXXGOOOOOOOOOOOOOOOOXXXGOOOOOOXXXXXXXXXXXXXGOOOOOOOOOOOOOOOOOXXGOOOOOOOOXXXXXXXXXXXGOOOOOOOOOOOOXXXXXXXGOOOOOOOOOOOOOOOOOXXGOOOOOXXXXXXXXXXXXXXGOOOOOOOOOXXXXXXXXXXGOOOOOOXXXXXXXXXXXXXGOOOOOOOOOOXXXXXXXXX,0,256,0
29526,148,0,148,76,116,0,0,275,158,117,GOOOOOOOOXXXXXXXXXXXGOOOOOOOOOOOXXXXXXXXGOOOOOOOOOOXXXXXXXXXGOOOOOOOOOOOOOOOOXXXGOOOOOOXXXXXXXXXXXXXGOOOOOOOOOOOOOOOOOXXGOOOOOOOOXXXXXXXXXXXGOOOOOOOOOOOOXXXXXXXGOOOOOOOOOOOOOOOOOXXGOOOOOXXXXXXXXXXXXXXGOOOOOOOOOXXXXXXXXXXGOOOOOOXXXXXXXXXXXXXGOOOOOOOOOOXXXXXXXXX,0,256,0
29547,148,0,148,73,119,0,0,279,161,118,GOOOOOOOOXXXXXXXXXXXGOOOOOOOOOOOXXXXXXXXGOOOOOOOOOOXXXXXXXXXGOOOOOOOOOOOOOOOOXXXGOOOOOOXXXXXXXXXXXXXGOOOOOOOOOOOOOOOOOXXGOOOOOOOOXXXXXXXXXXXGOOOOOOOOOOOOXXXXXXXGOOOOOOOOOOOOOOOOOXXGOOOOOXXXXXXXXXXXXXXGOOOOOOOOOXXXXXXXXXXGOOOOOOXXXXXXXXXXXXXGOOOOOOOOOOXXXXXXXXX,0,256,0
29568,148,0,148,75,117,0,0,275,162,113,GOOOOOOOOXXXXXXXXXXXGOOOOOOOOOOOXXXXXXXXGOOOOOOOOOOXXXXXXXXXGOOOOOOOOOOOOOOOOXXXGOOOOOOXXXXXXXXXXXXXGOOOOOOOOOOOOOOOOOXXGOOOOOOOOXXXXXXXXXXXGOOOOOOOOOOOOXXXXXXXGOOOOOOOOOOOOOOOOOXXGOOOOOXXXXXXXXXXXXXXGOOOOOOOOOXXXXXXXXXXGOOOOOOXXXXXXXXXXXXXGOOOOOOOOOOXXXXXXXXX,0,256,0
29589,148,0,148,73,119,0,0,278,167,111,GOOOOOOOOXXXXXXXXXXXGOOOOOOOOOOOXXXXXXXXGOOOOOOOOOOXXXXXXXXXGOOOOOOOOOOOOOOOOXXXGOOOOOOXXXXXXXXXXXXXGOOOOOOOOOOOOOOOOOXXGOOOOOOOOXXXXXXXXXXXGOOOOOOOOOOOOXXXXXXXGOOOOOOOOOOOOOOOOOXXGOOOOOXXXXXXXXXXXXXXGOOOOOOOOOXXXXXXXXXXGOOOOOOXXXXXXXXXXXXXGOOOOOOOOOOXXXXXXXXX,0,256,0

29610,148,0,148,67,125,0,0,285,166,119,GOOOOOOOOXXXXXXXXXXXGOOOOOOOOOOOXXXXXXXXGOOOOOOOOOOXXXXXXXXXGOOOOOOOOOOOOOOOOXXXGOOOOOOXXXXXXXXXXXXXGOOOOOOOOOOOOOOOOOXXGOOOOOOOOXXXXXXXXXXXGOOOOOOOOOOOOXXXXXXXGOOOOOOOOOOOOOOOOOXXGOOOOOXXXXXXXXXXXXXXGOOOOOOOOOXXXXXXXXXXGOOOOOOXXXXXXXXXXXXXGOOOOOOOOOOXXXXXXXXX,0,256,0
29631,148,0,148,72,120,0,0,280,163,117,GOOOOOOOOXXXXXXXXXXXGOOOOOOOOOOOXXXXXXXXGOOOOOOOOOOXXXXXXXXXGOOOOOOOOOOOOOOOOXXXGOOOOOOXXXXXXXXXXXXXGOOOOOOOOOOOOOOOOOXXGOOOOOOOOXXXXXXXXXXXGOOOOOOOOOOOOXXXXXXXGOOOOOOOOOOOOOOOOOXXGOOOOOXXXXXXXXXXXXXXGOOOOOOOOOXXXXXXXXXXGOOOOOOXXXXXXXXXXXXXGOOOOOOOOOOXXXXXXXXX,0,256,0
29652,148,0,148,75,117,0,0,277,169,108,GOOOOOOOOXXXXXXXXXXXGOOOOOOOOOOOXXXXXXXXGOOOOOOOOOOXXXXXXXXXGOOOOOOOOOOOOOOOOXXXGOOOOOOXXXXXXXXXXXXXGOOOOOOOOOOOOOOOOOXXGOOOOOOOOXXXXXXXXXXXGOOOOOOOOOOOOXXXXXXXGOOOOOOOOOOOOOOOOOXXGOOOOOXXXXXXXXXXXXXXGOOOOOOOOOXXXXXXXXXXGOOOOOOXXXXXXXXXXXXXGOOOOOOOOOOXXXXXXXXX,0,256,0
29673,148,0,148,71,121,0,0,281,173,108,GOOOOOOOOXXXXXXXXXXXGOOOOOOOOOOOXXXXXXXXGOOOOOOOOOOXXXXXXXXXGOOOOOOOOOOOOOOOOXXXGOOOOOOXXXXXXXXXXXXXGOOOOOOOOOOOOOOOOOXXGOOOOOOOOXXXXXXXXXXXGOOOOOOOOOOOOXXXXXXXGOOOOOOOOOOOOOOOOOXXGOOOOOXXXXXXXXXXXXXXGOOOOOOOOOXXXXXXXXXXGOOOOOOXXXXXXXXXXXXXGOOOOOOOOOOXXXXXXXXX,0,256,0
29694,148,0,148,69,123,0,0,282,174,108,GOOOOOOOOXXXXXXXXXXXGOOOOOOOOOOOXXXXXXXXGOOOOOOOOOOXXXXXXXXXGOOOOOOOOOOOOOOOOXXXGOOOOOOXXXXXXXXXXXXXGOOOOOOOOOOOOOOOOOXXGOOOOOOOOXXXXXXXXXXXGOOOOOOOOOOOOXXXXXXXGOOOOOOOOOOOOOOOOOXXGOOOOOXXXXXXXXXXXXXXGOOOOOOOOOXXXXXXXXXXGOOOOOOXXXXXXXXXXXXXGOOOOOOOOOOXXXXXXXXX,0,256,0

29715,148,0,148,75,117,0,0,277,168,109,GOOOOOOOOXXXXXXXXXXXGOOOOOOOOOOOXXXXXXXXGOOOOOOOOOOXXXXXXXXXGOOOOOOOOOOOOOOOOXXXGOOOOOOXXXXXXXXXXXXXGOOOOOOOOOOOOOOOOOXXGOOOOOOOOXXXXXXXXXXXGOOOOOOOOOOOOXXXXXXXGOOOOOOOOOOOOOOOOOXXGOOOOOXXXXXXXXXXXXXXGOOOOOOOOOXXXXXXXXXXGOOOOOOXXXXXXXXXXXXXGOOOOOOOOOOXXXXXXXXX,0,256,0
29736,148,0,148,78,114,0,0,275,169,106,GOOOOOOOOXXXXXXXXXXXGOOOOOOOOOOOXXXXXXXXGOOOOOOOOOOXXXXXXXXXGOOOOOOOOOOOOOOOOXXXGOOOOOOXXXXXXXXXXXXXGOOOOOOOOOOOOOOOOOXXGOOOOOOOOXXXXXXXXXXXGOOOOOOOOOOOOXXXXXXXGOOOOOOOOOOOOOOOOOXXGOOOOOXXXXXXXXXXXXXXGOOOOOOOOOXXXXXXXXXXGOOOOOOXXXXXXXXXXXXXGOOOOOOOOOOXXXXXXXXX,0,256,0
29757,148,0,148,75,117,0,0,278,171,107,GOOOOOOOOXXXXXXXXXXXGOOOOOOOOOOOXXXXXXXXGOOOOOOOOOOXXXXXXXXXGOOOOOOOOOOOOOOOOXXXGOOOOOOXXXXXXXXXXXXXGOOOOOOOOOOOOOOOOOXXGOOOOOOOOXXXXXXXXXXXGOOOOOOOOOOOOXXXXXXXGOOOOOOOOOOOOOOOOOXXGOOOOOXXXXXXXXXXXXXXGOOOOOOOOOXXXXXXXXXXGOOOOOOXXXXXXXXXXXXXGOOOOOOOOOOXXXXXXXXX,0,256,0
29778,148,0,148,74,118,0,0,278,168,110,GOOOOOOOOXXXXXXXXXXXGOOOOOOOOOOOXXXXXXXXGOOOOOOOOOOXXXXXXXXXGOOOOOOOOOOOOOOOOXXXGOOOOOOXXXXXXXXXXXXXGOOOOOOOOOOOOOOOOOXXGOOOOOOOOXXXXXXXXXXXGOOOOOOOOOOOOXXXXXXXGOOOOOOOOOOOOOOOOOXXGOOOOOXXXXXXXXXXXXXXGOOOOOOOOOXXXXXXXXXXGOOOOOOXXXXXXXXXXXXXGOOOOOOOOOOXXXXXXXXX,0,256,0
29799,148,0,148,74,118,0,0,279,167,112,GOOOOOOOOXXXXXXXXXXXGOOOOOOOOOOOXXXXXXXXGOOOOOOOOOOXXXXXXXXXGOOOOOOOOOOOOOOOOXXXGOOOOOOXXXXXXXXXXXXXGOOOOOOOOOOOOOOOOOXXGOOOOOOOOXXXXXXXXXXXGOOOOOOOOOOOOXXXXXXXGOOOOOOOOOOOOOOOOOXXGOOOOOXXXXXXXXXXXXXXGOOOOOOOOOXXXXXXXXXXGOOOOOOXXXXXXXXXXXXXGOOOOOOOOOOXXXXXXXXX,0,256,0

29820,148,0,148,72,120,0,0,280,167,113,GOOOOOOOOXXXXXXXXXXXGOOOOOOOOOOOXXXXXXXXGOOOOOOOOOOXXXXXXXXXGOOOOOOOOOOOOOOOOXXXGOOOOOOXXXXXXXXXXXXXGOOOOOOOOOOOOOOOOOXXGOOOOOOOOXXXXXXXXXXXGOOOOOOOOOOOOXXXXXXXGOOOOOOOOOOOOOOOOOXXGOOOOOXXXXXXXXXXXXXXGOOOOOOOOOXXXXXXXXXXGOOOOOOXXXXXXXXXXXXXGOOOOOOOOOOXXXXXXXXX,0,256,0
29841,148,0,148,76,116,0,0,277,173,104,GOOOOOOOOXXXXXXXXXXXGOOOOOOOOOOOXXXXXXXXGOOOOOOOOOOXXXXXXXXXGOOOOOOOOOOOOOOOOXXXGOOOOOOXXXXXXXXXXXXXGOOOOOOOOOOOOOOOOOXXGOOOOOOOOXXXXXXXXXXXGOOOOOOOOOOOOXXXXXXXGOOOOOOOOOOOOOOOOOXXGOOOOOXXXXXXXXXXXXXXGOOOOOOOOOXXXXXXXXXXGOOOOOOXXXXXXXXXXXXXGOOOOOOOOOOXXXXXXXXX,0,256,0
29862,148,0,148,74,118,0,0,278,176,102,GOOOOOOOOXXXXXXXXXXXGOOOOOOOOOOOXXXXXXXXGOOOOOOOOOOXXXXXXXXXGOOOOOOOOOOOOOOOOXXXGOOOOOOXXXXXXXXXXXXXGOOOOOOOOOOOOOOOOOXXGOOOOOOOOXXXXXXXXXXXGOOOOOOOOOOOOXXXXXXXGOOOOOOOOOOOOOOOOOXXGOOOOOXXXXXXXXXXXXXXGOOOOOOOOOXXXXXXXXXXGOOOOOOXXXXXXXXXXXXXGOOOOOOOOOOXXXXXXXXX,0,256,0
29883,148,0,148,79,113,0,0,274,169,105,GOOOOOOOOXXXXXXXXXXXGOOOOOOOOOOOXXXXXXXXGOOOOOOOOOOXXXXXXXXXGOOOOOOOOOOOOOOOOXXXGOOOOOOXXXXXXXXXXXXXGOOOOOOOOOOOOOOOOOXXGOOOOOOOOXXXXXXXXXXXGOOOOOOOOOOOOXXXXXXXGOOOOOOOOOOOOOOOOOXXGOOOOOXXXXXXXXXXXXXXGOOOOOOOOOXXXXXXXXXXGOOOOOOXXXXXXXXXXXXXGOOOOOOOOOOXXXXXXXXX,0,256,0
29904,149,1,148,83,108,0,0,269,165,104,GOOOOOOOOXXXXXXXXXXXGOOOOOOOOOOOXXXXXXXXGOOOOOOOOOOXXXXXXXXXGOOOOOOOOOOOOOOOOXXXGOOOOOOXXXXXXXXXXXXXGOOOOOOOOOOOOOOOOOAXGOOOOOOOOXXXXXXXXXXXGOOOOOOOOOOOOXXXXXXXGOOOOOOOOOOOOOOOOOXXGOOOOOXXXXXXXXXXXXXXGOOOOOOOOOXXXXXXXXXXGOOOOOOXXXXXXXXXXXXXGOOOOOOOOOOXXXXXXXXX,0,256,0

29925,149,1,148,79,112,0,0,273,164,109,GOOOOOOOOXXXXXXXXXXXGOOOOOOOOOOOXXXXXXXXGOOOOOOOOOOXXXXXXXXXGOOOOOOOOOOOOOOOOXXXGOOOOOOXXXXXXXXXXXXXGOOOOOOOOOOOOOOOOOAXGOOOOOOOOXXXXXXXXXXXGOOOOOOOOOOOOXXXXXXXGOOOOOOOOOOOOOOOOOXXGOOOOOXXXXXXXXXXXXXXGOOOOOOOOOXXXXXXXXXXGOOOOOOXXXXXXXXXXXXXGOOOOOOOOOOXXXXXXXXX,0,256,0
29946,149,1,148,77,114,0,0,275,170,105,GOOOOOOOOXXXXXXXXXXXGOOOOOOOOOOOXXXXXXXXGOOOOOOOOOOXXXXXXXXXGOOOOOOOOOOOOOOOOXXXGOOOOOOXXXXXXXXXXXXXGOOOOOOOOOOOOOOOOOAXGOOOOOOOOXXXXXXXXXXXGOOOOOOOOOOOOXXXXXXXGOOOOOOOOOOOOOOOOOXXGOOOOOXXXXXXXXXXXXXXGOOOOOOOOOXXXXXXXXXXGOOOOOOXXXXXXXXXXXXXGOOOOOOOOOOXXXXXXXXX,0,256,0
29967,149,1,148,74,117,0,0,275,169,106,GOOOOOOOOXXXXXXXXXXXGOOOOOOOOOOOXXXXXXXXGOOOOOOOOOOXXXXXXXXXGOOOOOOOOOOOOOOOOXXXGOOOOOOXXXXXXXXXXXXXGOOOOOOOOOOOOOOOOOAXGOOOOOOOOXXXXXXXXXXXGOOOOOOOOOOOOXXXXXXXGOOOOOOOOOOOOOOOOOXXGOOOOOXXXXXXXXXXXXXXGOOOOOOOOOXXXXXXXXXXGOOOOOOXXXXXXXXXXXXXGOOOOOOOOOOXXXXXXXXX,0,256,0
29988,149,1,148,72,119,0,0,279,166,113,GOOOOOOOOXXXXXXXXXXXGOOOOOOOOOOOXXXXXXXXGOOOOOOOOOOXXXXXXXXXGOOOOOOOOOOOOOOOOXXXGOOOOOOXXXXXXXXXXXXXGOOOOOOOOOOOOOOOOOAXGOOOOOOOOXXXXXXXXXXXGOOOOOOOOOOOOXXXXXXXGOOOOOOOOOOOOOOOOOXXGOOOOOXXXXXXXXXXXXXXGOOOOOOOOOXXXXXXXXXXGOOOOOOXXXXXXXXXXXXXGOOOOOOOOOOXXXXXXXXX,0,256,0
30009,149,1,148,74,117,0,0,277,163,114,GOOOOOOOOXXXXXXXXXXXGOOOOOOOOOOOXXXXXXXXGOOOOOOOOOOXXXXXXXXXGOOOOOOOOOOOOOOOOXXXGOOOOOOXXXXXXXXXXXXXGOOOOOOOOOOOOOOOOOAXGOOOOOOOOXXXXXXXXXXXGOOOOOOOOOOOOXXXXXXXGOOOOOOOOOOOOOOOOOXXGOOOOOXXXXXXXXXXXXXXGOOOOOOOOOXXXXXXXXXXGOOOOOOXXXXXXXXXXXXXGOOOOOOOOOOXXXXXXXXX,0,256,0

30030,149,1,148,71,120,0,0,279,164,115,GOOOOOOOOXXXXXXXXXXXGOOOOOOOOOOOXXXXXXXXGOOOOOOOOOOXXXXXXXXXGOOOOOOOOOOOOOOOOXXXGOOOOOOXXXXXXXXXXXXXGOOOOOOOOOOOOOOOOOAXGOOOOOOOOXXXXXXXXXXXGOOOOOOOOOOOOXXXXXXXGOOOOOOOOOOOOOOOOOXXGOOOOOXXXXXXXXXXXXXXGOOOOOOOOOXXXXXXXXXXGOOOOOOXXXXXXXXXXXXXGOOOOOOOOOOXXXXXXXXX,0,256,0
30051,149,0,149,69,122,0,0,282,163,119,GOOOOOOOOXXXXXXXXXXXGOOOOOOOOOOOXXXXXXXXGOOOOOOOOOOXXXXXXXXXGOOOOOOOOOOOOOOOOXXXGOOOOOOXXXXXXXXXXXXXGOOOOOOOOOOOOOOOOOOXGOOOOOOOOXXXXXXXXXXXGOOOOOOOOOOOOXXXXXXXGOOOOOOOOOOOOOOOOOXXGOOOOOXXXXXXXXXXXXXXGOOOOOOOOOXXXXXXXXXXGOOOOOOXXXXXXXXXXXXXGOOOOOOOOOOXXXXXXXXX,0,256,0
30072,149,0,149,67,124,0,0,284,166,118,GOOOOOOOOXXXXXXXXXXXGOOOOOOOOOOOXXXXXXXXGOOOOOOOOOOXXXXXXXXXGOOOOOOOOOOOOOOOOXXXGOOOOOOXXXXXXXXXXXXXGOOOOOOOOOOOOOOOOOOXGOOOOOOOOXXXXXXXXXXXGOOOOOOOOOOOOXXXXXXXGOOOOOOOOOOOOOOOOOXXGOOOOOXXXXXXXXXXXXXXGOOOOOOOOOXXXXXXXXXXGOOOOOOXXXXXXXXXXXXXGOOOOOOOOOOXXXXXXXXX,0,256,0
30093,149,0,149,66,125,0,0,285,168,117,GOOOOOOOOXXXXXXXXXXXGOOOOOOOOOOOXXXXXXXXGOOOOOOOOOOXXXXXXXXXGOOOOOOOOOOOOOOOOXXXGOOOOOOXXXXXXXXXXXXXGOOOOOOOOOOOOOOOOOOXGOOOOOOOOXXXXXXXXXXXGOOOOOOOOOOOOXXXXXXXGOOOOOOOOOOOOOOOOOXXGOOOOOXXXXXXXXXXXXXXGOOOOOOOOOXXXXXXXXXXGOOOOOOXXXXXXXXXXXXXGOOOOOOOOOOXXXXXXXXX,0,256,0
30114,149,0,149,69,122,0,0,282,166,116,GOOOOOOOOXXXXXXXXXXXGOOOOOOOOOOOXXXXXXXXGOOOOOOOOOOXXXXXXXXXGOOOOOOOOOOOOOOOOXXXGOOOOOOXXXXXXXXXXXXXGOOOOOOOOOOOOOOOOOOXGOOOOOOOOXXXXXXXXXXXGOOOOOOOOOOOOXXXXXXXGOOOOOOOOOOOOOOOOOXXGOOOOOXXXXXXXXXXXXXXGOOOOOOOOOXXXXXXXXXXGOOOOOOXXXXXXXXXXXXXGOOOOOOOOOOXXXXXXXXX,0,256,0

30135,149,0,149,72,119,0,0,279,166,113,GOOOOOOOOXXXXXXXXXXXGOOOOOOOOOOOXXXXXXXXGOOOOOOOOOOXXXXXXXXXGOOOOOOOOOOOOOOOOXXXGOOOOOOXXXXXXXXXXXXXGOOOOOOOOOOOOOOOOOOXGOOOOOOOOXXXXXXXXXXXGOOOOOOOOOOOOXXXXXXXGOOOOOOOOOOOOOOOOOXXGOOOOOXXXXXXXXXXXXXXGOOOOOOOOOXXXXXXXXXXGOOOOOOXXXXXXXXXXXXXGOOOOOOOOOOXXXXXXXXX,0,256,0
30156,149,0,149,73,118,0,0,277,163,114,GOOOOOOOOXXXXXXXXXXXGOOOOOOOOOOOXXXXXXXXGOOOOOOOOOOXXXXXXXXXGOOOOOOOOOOOOOOOOXXXGOOOOOOXXXXXXXXXXXXXGOOOOOOOOOOOOOOOOOOXGOOOOOOOOXXXXXXXXXXXGOOOOOOOOOOOOXXXXXXXGOOOOOOOOOOOOOOOOOXXGOOOOOXXXXXXXXXXXXXXGOOOOOOOOOXXXXXXXXXXGOOOOOOXXXXXXXXXXXXXGOOOOOOOOOOXXXXXXXXX,0,256,0
30177,149,0,149,71,120,0,0,280,162,118,GOOOOOOOOXXXXXXXXXXXGOOOOOOOOOOOXXXXXXXXGOOOOOOOOOOXXXXXXXXXGOOOOOOOOOOOOOOOOXXXGOOOOOOXXXXXXXXXXXXXGOOOOOOOOOOOOOOOOOOXGOOOOOOOOXXXXXXXXXXXGOOOOOOOOOOOOXXXXXXXGOOOOOOOOOOOOOOOOOXXGOOOOOXXXXXXXXXXXXXXGOOOOOOOOOXXXXXXXXXXGOOOOOOXXXXXXXXXXXXXGOOOOOOOOOOXXXXXXXXX,0,256,0
30198,149,0,149,70,121,0,0,280,164,116,GOOOOOOOOXXXXXXXXXXXGOOOOOOOOOOOXXXXXXXXGOOOOOOOOOOXXXXXXXXXGOOOOOOOOOOOOOOOOXXXGOOOOOOXXXXXXXXXXXXXGOOOOOOOOOOOOOOOOOOXGOOOOOOOOXXXXXXXXXXXGOOOOOOOOOOOOXXXXXXXGOOOOOOOOOOOOOOOOOXXGOOOOOXXXXXXXXXXXXXXGOOOOOOOOOXXXXXXXXXXGOOOOOOXXXXXXXXXXXXXGOOOOOOOOOOXXXXXXXXX,0,256,0
30219,149,0,149,71,120,0,0,280,168,112,GOOOOOOOOXXXXXXXXXXXGOOOOOOOOOOOXXXXXXXXGOOOOOOOOOOXXXXXXXXXGOOOOOOOOOOOOOOOOXXXGOOOOOOXXXXXXXXXXXXXGOOOOOOOOOOOOOOOOOOXGOOOOOOOOXXXXXXXXXXXGOOOOOOOOOOOOXXXXXXXGOOOOOOOOOOOOOOOOOXXGOOOOOXXXXXXXXXXXXXXGOOOOOOOOOXXXXXXXXXXGOOOOOOXXXXXXXXXXXXXGOOOOOOOOOOXXXXXXXXX,0,256,0

30240,151,2,149,69,120,0,0,281,168,113,GOOOOOOOOXXXXXXXXXXXGOOOOOOOOOOOAXXXXXXXGOOOOOOOOOOXXXXXXXXXGOOOOOOOOOOOOOOOOXXXGOOOOOOXXXXXXXXXXXXXGOOOOOOOOOOOOOOOOOOAGOOOOOOOOXXXXXXXXXXXGOOOOOOOOOOOOXXXXXXXGOOOOOOOOOOOOOOOOOXXGOOOOOXXXXXXXXXXXXXXGOOOOOOOOOXXXXXXXXXXGOOOOOOXXXXXXXXXXXXXGOOOOOOOOOOXXXXXXXXX,0,256,0
30261,151,2,149,69,120,0,0,281,167,114,GOOOOOOOOXXXXXXXXXXXGOOOOOOOOOOOAXXXXXXXGOOOOOOOOOOXXXXXXXXXGOOOOOOOOOOOOOOOOXXXGOOOOOOXXXXXXXXXXXXXGOOOOOOOOOOOOOOOOOOAGOOOOOOOOXXXXXXXXXXXGOOOOOOOOOOOOXXXXXXXGOOOOOOOOOOOOOOOOOXXGOOOOOXXXXXXXXXXXXXXGOOOOOOOOOXXXXXXXXXXGOOOOOOXXXXXXXXXXXXXGOOOOOOOOOOXXXXXXXXX,0,256,0
30282,151,2,149,69,120,0,0,280,168,112,GOOOOOOOOXXXXXXXXXXXGOOOOOOOOOOOAXXXXXXXGOOOOOOOOOOXXXXXXXXXGOOOOOOOOOOOOOOOOXXXGOOOOOOXXXXXXXXXXXXXGOOOOOOOOOOOOOOOOOOAGOOOOOOOOXXXXXXXXXXXGOOOOOOOOOOOOXXXXXXXGOOOOOOOOOOOOOOOOOXXGOOOOOXXXXXXXXXXXXXXGOOOOOOOOOXXXXXXXXXXGOOOOOOXXXXXXXXXXXXXGOOOOOOOOOOXXXXXXXXX,0,256,0
30303,151,2,149,65,124,0,0,284,165,119,GOOOOOOOOXXXXXXXXXXXGOOOOOOOOOOOAXXXXXXXGOOOOOOOOOOXXXXXXXXXGOOOOOOOOOOOOOOOOXXXGOOOOOOXXXXXXXXXXXXXGOOOOOOOOOOOOOOOOOOAGOOOOOOOOXXXXXXXXXXXGOOOOOOOOOOOOXXXXXXXGOOOOOOOOOOOOOOOOOXXGOOOOOXXXXXXXXXXXXXXGOOOOOOOOOXXXXXXXXXXGOOOOOOXXXXXXXXXXXXXGOOOOOOOOOOXXXXXXXXX,0,256,0
30324,151,2,149,66,123,0,0,284,173,111,GOOOOOOOOXXXXXXXXXXXGOOOOOOOOOOOAXXXXXXXGOOOOOOOOOOXXXXXXXXXGOOOOOOOOOOOOOOOOXXXGOOOOOOXXXXXXXXXXXXXGOOOOOOOOOOOOOOOOOOAGOOOOOOOOXXXXXXXXXXXGOOOOOOOOOOOOXXXXXXXGOOOOOOOOOOOOOOOOOXXGOOOOOXXXXXXXXXXXXXXGOOOOOOOOOXXXXXXXXXXGOOOOOOXXXXXXXXXXXXXGOOOOOOOOOOXXXXXXXXX,0,256,0

30345,151,1,150,68,121,0,0,282,170,112,GOOOOOOOOXXXXXXXXXXXGOOOOOOOOOOOOXXXXXXXGOOOOOOOOOOXXXXXXXXXGOOOOOOOOOOOOOOOOXXXGOOOOOOXXXXXXXXXXXXXGOOOOOOOOOOOOOOOOOOAGOOOOOOOOXXXXXXXXXXXGOOOOOOOOOOOOXXXXXXXGOOOOOOOOOOOOOOOOOXXGOOOOOXXXXXXXXXXXXXXGOOOOOOOOOXXXXXXXXXXGOOOOOOXXXXXXXXXXXXXGOOOOOOOOOOXXXXXXXXX,0,256,0
30366,151,1,150,69,120,0,0,280,164,116,GOOOOOOOOXXXXXXXXXXXGOOOOOOOOOOOOXXXXXXXGOOOOOOOOOOXXXXXXXXXGOOOOOOOOOOOOOOOOXXXGOOOOOOXXXXXXXXXXXXXGOOOOOOOOOOOOOOOOOOAGOOOOOOOOXXXXXXXXXXXGOOOOOOOOOOOOXXXXXXXGOOOOOOOOOOOOOOOOOXXGOOOOOXXXXXXXXXXXXXXGOOOOOOOOOXXXXXXXXXXGOOOOOOXXXXXXXXXXXXXGOOOOOOOOOOXXXXXXXXX,0,256,0
30387,151,0,151,61,128,0,0,288,169,119,GOOOOOOOOXXXXXXXXXXXGOOOOOOOOOOOOXXXXXXXGOOOOOOOOOOXXXXXXXXXGOOOOOOOOOOOOOOOOXXXGOOOOOOXXXXXXXXXXXXXGOOOOOOOOOOOOOOOOOOOGOOOOOOOOXXXXXXXXXXXGOOOOOOOOOOOOXXXXXXXGOOOOOOOOOOOOOOOOOXXGOOOOOXXXXXXXXXXXXXXGOOOOOOOOOXXXXXXXXXXGOOOOOOXXXXXXXXXXXXXGOOOOOOOOOOXXXXXXXXX,0,256,0
30408,151,0,151,60,129,0,0,289,165,124,GOOOOOOOOXXXXXXXXXXXGOOOOOOOOOOOOXXXXXXXGOOOOOOOOOOXXXXXXXXXGOOOOOOOOOOOOOOOOXXXGOOOOOOXXXXXXXXXXXXXGOOOOOOOOOOOOOOOOOOOGOOOOOOOOXXXXXXXXXXXGOOOOOOOOOOOOXXXXXXXGOOOOOOOOOOOOOOOOOXXGOOOOOXXXXXXXXXXXXXXGOOOOOOOOOXXXXXXXXXXGOOOOOOXXXXXXXXXXXXXGOOOOOOOOOOXXXXXXXXX,0,256,0
30429,152,1,151,64,124,0,0,285,163,122,GOOOOOOOOXXXXXXXXXXXGOOOOOOOOOOOOXXXXXXXGOOOOOOOOOOXXXXXXXXXGOOOOOOOOOOOOOOOOXXXGOOOOOOXXXXXXXXXXXXXGOOOOOOOOOOOOOOOOOOOGOOOOOOOOXXXXXXXXXXXGOOOOOOOOOOOOXXXXXXXGOOOOOOOOOOOOOOOOOXXGOOOOOXXXXXXXXXXXXXXGOOOOOOOOOAXXXXXXXXXGOOOOOOXXXXXXXXXXXXXGOOOOOOOOOOXXXXXXXXX,0,256,0

30450,152,1,151,66,122,0,0,283,164,119,GOOOOOOOOXXXXXXXXXXXGOOOOOOOOOOOOXXXXXXXGOOOOOOOOOOXXXXXXXXXGOOOOOOOOOOOOOOOOXXXGOOOOOOXXXXXXXXXXXXXGOOOOOOOOOOOOOOOOOOOGOOOOOOOOXXXXXXXXXXXGOOOOOOOOOOOOXXXXXXXGOOOOOOOOOOOOOOOOOXXGOOOOOXXXXXXXXXXXXXXGOOOOOOOOOAXXXXXXXXXGOOOOOOXXXXXXXXXXXXXGOOOOOOOOOOXXXXXXXXX,0,256,0
30471,152,1,151,64,124,0,0,285,169,116,GOOOOOOOOXXXXXXXXXXXGOOOOOOOOOOOOXXXXXXXGOOOOOOOOOOXXXXXXXXXGOOOOOOOOOOOOOOOOXXXGOOOOOOXXXXXXXXXXXXXGOOOOOOOOOOOOOOOOOOOGOOOOOOOOXXXXXXXXXXXGOOOOOOOOOOOOXXXXXXXGOOOOOOOOOOOOOOOOOXXGOOOOOXXXXXXXXXXXXXXGOOOOOOOOOAXXXXXXXXXGOOOOOOXXXXXXXXXXXXXGOOOOOOOOOOXXXXXXXXX,0,256,0
30492,152,1,151,68,120,0,0,281,166,115,GOOOOOOOOXXXXXXXXXXXGOOOOOOOOOOOOXXXXXXXGOOOOOOOOOOXXXXXXXXXGOOOOOOOOOOOOOOOOXXXGOOOOOOXXXXXXXXXXXXXGOOOOOOOOOOOOOOOOOOOGOOOOOOOOXXXXXXXXXXXGOOOOOOOOOOOOXXXXXXXGOOOOOOOOOOOOOOOOOXXGOOOOOXXXXXXXXXXXXXXGOOOOOOOOOAXXXXXXXXXGOOOOOOXXXXXXXXXXXXXGOOOOOOOOOOXXXXXXXXX,0,256,0
30513,152,1,151,70,118,0,0,279,166,113,GOOOOOOOOXXXXXXXXXXXGOOOOOOOOOOOOXXXXXXXGOOOOOOOOOOXXXXXXXXXGOOOOOOOOOOOOOOOOXXXGOOOOOOXXXXXXXXXXXXXGOOOOOOOOOOOOOOOOOOOGOOOOOOOOXXXXXXXXXXXGOOOOOOOOOOOOXXXXXXXGOOOOOOOOOOOOOOOOOXXGOOOOOXXXXXXXXXXXXXXGOOOOOOOOOAXXXXXXXXXGOOOOOOXXXXXXXXXXXXXGOOOOOOOOOOXXXXXXXXX,0,256,0
30534,152,1,151,67,121,0,0,282,172,110,GOOOOOOOOXXXXXXXXXXXGOOOOOOOOOOOOXXXXXXXGOOOOOOOOOOXXXXXXXXXGOOOOOOOOOOOOOOOOXXXGOOOOOOXXXXXXXXXXXXXGOOOOOOOOOOOOOOOOOOOGOOOOOOOOXXXXXXXXXXXGOOOOOOOOOOOOXXXXXXXGOOOOOOOOOOOOOOOOOXXGOOOOOXXXXXXXXXXXXXXGOOOOOOOOOAXXXXXXXXXGOOOOOOXXXXXXXXXXXXXGOOOOOOOOOOXXXXXXXXX,0,256,0

30555,152,1,151,63,125,0,0,285,171,114,GOOOOOOOOXXXXXXXXXXXGOOOOOOOOOOOOXXXXXXXGOOOOOOOOOOXXXXXXXXXGOOOOOOOOOOOOOOOOXXXGOOOOOOXXXXXXXXXXXXXGOOOOOOOOOOOOOOOOOOOGOOOOOOOOXXXXXXXXXXXGOOOOOOOOOOOOXXXXXXXGOOOOOOOOOOOOOOOOOXXGOOOOOXXXXXXXXXXXXXXGOOOOOOOOOAXXXXXXXXXGOOOOOOXXXXXXXXXXXXXGOOOOOOOOOOXXXXXXXXX,0,256,0
30576,153,2,151,61,126,0,0,287,170,117,GOOOOOOOOAXXXXXXXXXXGOOOOOOOOOOOOXXXXXXXGOOOOOOOOOOXXXXXXXXXGOOOOOOOOOOOOOOOOXXXGOOOOOOXXXXXXXXXXXXXGOOOOOOOOOOOOOOOOOOOGOOOOOOOOXXXXXXXXXXXGOOOOOOOOOOOOXXXXXXXGOOOOOOOOOOOOOOOOOXXGOOOOOXXXXXXXXXXXXXXGOOOOOOOOOAXXXXXXXXXGOOOOOOXXXXXXXXXXXXXGOOOOOOOOOOXXXXXXXXX,0,256,0
30597,153,2,151,64,123,0,0,283,168,115,GOOOOOOOOAXXXXXXXXXXGOOOOOOOOOOOOXXXXXXXGOOOOOOOOOOXXXXXXXXXGOOOOOOOOOOOOOOOOXXXGOOOOOOXXXXXXXXXXXXXGOOOOOOOOOOOOOOOOOOOGOOOOOOOOXXXXXXXXXXXGOOOOOOOOOOOOXXXXXXXGOOOOOOOOOOOOOOOOOXXGOOOOOXXXXXXXXXXXXXXGOOOOOOOOOAXXXXXXXXXGOOOOOOXXXXXXXXXXXXXGOOOOOOOOOOXXXXXXXXX,0,256,0
30618,153,1,152,61,126,0,0,284,171,113,GOOOOOOOOAXXXXXXXXXXGOOOOOOOOOOOOXXXXXXXGOOOOOOOOOOXXXXXXXXXGOOOOOOOOOOOOOOOOXXXGOOOOOOXXXXXXXXXXXXXGOOOOOOOOOOOOOOOOOOOGOOOOOOOOXXXXXXXXXXXGOOOOOOOOOOOOXXXXXXXGOOOOOOOOOOOOOOOOOXXGOOOOOXXXXXXXXXXXXXXGOOOOOOOOOOXXXXXXXXXGOOOOOOXXXXXXXXXXXXXGOOOOOOOOOOXXXXXXXXX,0,256,0
30639,153,1,152,64,123,0,0,282,171,111,GOOOOOOOOAXXXXXXXXXXGOOOOOOOOOOOOXXXXXXXGOOOOOOOOOOXXXXXXXXXGOOOOOOOOOOOOOOOOXXXGOOOOOOXXXXXXXXXXXXXGOOOOOOOOOOOOOOOOOOOGOOOOOOOOXXXXXXXXXXXGOOOOOOOOOOOOXXXXXXXGOOOOOOOOOOOOOOOOOXXGOOOOOXXXXXXXXXXXXXXGOOOOOOOOOOXXXXXXXXXGOOOOOOXXXXXXXXXXXXXGOOOOOOOOOOXXXXXXXXX,0,256,0

30660,153,1,152,65,122,0,0,282,164,118,GOOOOOOOOAXXXXXXXXXXGOOOOOOOOOOOOXXXXXXXGOOOOOOOOOOXXXXXXXXXGOOOOOOOOOOOOOOOOXXXGOOOOOOXXXXXXXXXXXXXGOOOOOOOOOOOOOOOOOOOGOOOOOOOOXXXXXXXXXXXGOOOOOOOOOOOOXXXXXXXGOOOOOOOOOOOOOOOOOXXGOOOOOXXXXXXXXXXXXXXGOOOOOOOOOOXXXXXXXXXGOOOOOOXXXXXXXXXXXXXGOOOOOOOOOOXXXXXXXXX,0,256,0
30681,153,1,152,66,121,0,0,280,165,115,GOOOOOOOOAXXXXXXXXXXGOOOOOOOOOOOOXXXXXXXGOOOOOOOOOOXXXXXXXXXGOOOOOOOOOOOOOOOOXXXGOOOOOOXXXXXXXXXXXXXGOOOOOOOOOOOOOOOOOOOGOOOOOOOOXXXXXXXXXXXGOOOOOOOOOOOOXXXXXXXGOOOOOOOOOOOOOOOOOXXGOOOOOXXXXXXXXXXXXXXGOOOOOOOOOOXXXXXXXXXGOOOOOOXXXXXXXXXXXXXGOOOOOOOOOOXXXXXXXXX,0,256,0
30702,153,1,152,68,119,0,0,279,166,113,GOOOOOOOOAXXXXXXXXXXGOOOOOOOOOOOOXXXXXXXGOOOOOOOOOOXXXXXXXXXGOOOOOOOOOOOOOOOOXXXGOOOOOOXXXXXXXXXXXXXGOOOOOOOOOOOOOOOOOOOGOOOOOOOOXXXXXXXXXXXGOOOOOOOOOOOOXXXXXXXGOOOOOOOOOOOOOOOOOXXGOOOOOXXXXXXXXXXXXXXGOOOOOOOOOOXXXXXXXXXGOOOOOOXXXXXXXXXXXXXGOOOOOOOOOOXXXXXXXXX,0,256,0
30723,153,1,152,70,117,0,0,277,170,107,GOOOOOOOOAXXXXXXXXXXGOOOOOOOOOOOOXXXXXXXGOOOOOOOOOOXXXXXXXXXGOOOOOOOOOOOOOOOOXXXGOOOOOOXXXXXXXXXXXXXGOOOOOOOOOOOOOOOOOOOGOOOOOOOOXXXXXXXXXXXGOOOOOOOOOOOOXXXXXXXGOOOOOOOOOOOOOOOOOXXGOOOOOXXXXXXXXXXXXXXGOOOOOOOOOOXXXXXXXXXGOOOOOOXXXXXXXXXXXXXGOOOOOOOOOOXXXXXXXXX,0,256,0
30744,153,1,152,61,126,0,0,285,170,115,GOOOOOOOOAXXXXXXXXXXGOOOOOOOOOOOOXXXXXXXGOOOOOOOOOOXXXXXXXXXGOOOOOOOOOOOOOOOOXXXGOOOOOOXXXXXXXXXXXXXGOOOOOOOOOOOOOOOOOOOGOOOOOOOOXXXXXXXXXXXGOOOOOOOOOOOOXXXXXXXGOOOOOOOOOOOOOOOOOXXGOOOOOXXXXXXXXXXXXXXGOOOOOOOOOOXXXXXXXXXGOOOOOOXXXXXXXXXXXXXGOOOOOOOOOOXXXXXXXXX,0,256,0

30765,153,1,152,62,125,0,0,285,175,110,GOOOOOOOOAXXXXXXXXXXGOOOOOOOOOOOOXXXXXXXGOOOOOOOOOOXXXXXXXXXGOOOOOOOOOOOOOOOOXXXGOOOOOOXXXXXXXXXXXXXGOOOOOOOOOOOOOOOOOOOGOOOOOOOOXXXXXXXXXXXGOOOOOOOOOOOOXXXXXXXGOOOOOOOOOOOOOOOOOXXGOOOOOXXXXXXXXXXXXXXGOOOOOOOOOOXXXXXXXXXGOOOOOOXXXXXXXXXXXXXGOOOOOOOOOOXXXXXXXXX,0,256,0
30786,153,1,152,65,122,0,0,282,179,103,GOOOOOOOOAXXXXXXXXXXGOOOOOOOOOOOOXXXXXXXGOOOOOOOOOOXXXXXXXXXGOOOOOOOOOOOOOOOOXXXGOOOOOOXXXXXXXXXXXXXGOOOOOOOOOOOOOOOOOOOGOOOOOOOOXXXXXXXXXXXGOOOOOOOOOOOOXXXXXXXGOOOOOOOOOOOOOOOOOXXGOOOOOXXXXXXXXXXXXXXGOOOOOOOOOOXXXXXXXXXGOOOOOOXXXXXXXXXXXXXGOOOOOOOOOOXXXXXXXXX,0,256,0
30807,153,1,152,72,115,0,0,275,171,104,GOOOOOOOOAXXXXXXXXXXGOOOOOOOOOOOOXXXXXXXGOOOOOOOOOOXXXXXXXXXGOOOOOOOOOOOOOOOOXXXGOOOOOOXXXXXXXXXXXXXGOOOOOOOOOOOOOOOOOOOGOOOOOOOOXXXXXXXXXXXGOOOOOOOOOOOOXXXXXXXGOOOOOOOOOOOOOOOOOXXGOOOOOXXXXXXXXXXXXXXGOOOOOOOOOOXXXXXXXXXGOOOOOOXXXXXXXXXXXXXGOOOOOOOOOOXXXXXXXXX,0,256,0
30828,154,2,152,69,117,0,0,277,172,105,GOOOOOOOOAXXXXXXXXXXGOOOOOOOOOOOOXXXXXXXGOOOOOOOOOOXXXXXXXXXGOOOOOOOOOOOOOOOOXXXGOOOOOOXXXXXXXXXXXXXGOOOOOOOOOOOOOOOOOOOGOOOOOOOOXXXXXXXXXXXGOOOOOOOOOOOOXXXXXXXGOOOOOOOOOOOOOOOOOXXGOOOOOXXXXXXXXXXXXXXGOOOOOOOOOOXXXXXXXXXGOOOOOOAXXXXXXXXXXXXGOOOOOOOOOOXXXXXXXXX,0,256,0
30849,154,1,153,71,115,0,0,275,171,104,GOOOOOOOOOXXXXXXXXXXGOOOOOOOOOOOOXXXXXXXGOOOOOOOOOOXXXXXXXXXGOOOOOOOOOOOOOOOOXXXGOOOOOOXXXXXXXXXXXXXGOOOOOOOOOOOOOOOOOOOGOOOOOOOOXXXXXXXXXXXGOOOOOOOOOOOOXXXXXXXGOOOOOOOOOOOOOOOOOXXGOOOOOXXXXXXXXXXXXXXGOOOOOOOOOOXXXXXXXXXGOOOOOOAXXXXXXXXXXXXGOOOOOOOOOOXXXXXXXXX,0,256,0

30870,154,0,154,69,117,0,0,275,174,101,GOOOOOOOOOXXXXXXXXXXGOOOOOOOOOOOOXXXXXXXGOOOOOOOOOOXXXXXXXXXGOOOOOOOOOOOOOOOOXXXGOOOOOOXXXXXXXXXXXXXGOOOOOOOOOOOOOOOOOOOGOOOOOOOOXXXXXXXXXXXGOOOOOOOOOOOOXXXXXXXGOOOOOOOOOOOOOOOOOXXGOOOOOXXXXXXXXXXXXXXGOOOOOOOOOOXXXXXXXXXGOOOOOOOXXXXXXXXXXXXGOOOOOOOOOOXXXXXXXXX,0,256,0
30891,154,0,154,78,108,0,0,268,169,99,GOOOOOOOOOXXXXXXXXXXGOOOOOOOOOOOOXXXXXXXGOOOOOOOOOOXXXXXXXXXGOOOOOOOOOOOOOOOOXXXGOOOOOOXXXXXXXXXXXXXGOOOOOOOOOOOOOOOOOOOGOOOOOOOOXXXXXXXXXXXGOOOOOOOOOOOOXXXXXXXGOOOOOOOOOOOOOOOOOXXGOOOOOXXXXXXXXXXXXXXGOOOOOOOOOOXXXXXXXXXGOOOOOOOXXXXXXXXXXXXGOOOOOOOOOOXXXXXXXXX,0,256,0
30912,154,0,154,78,108,0,0,268,167,101,GOOOOOOOOOXXXXXXXXXXGOOOOOOOOOOOOXXXXXXXGOOOOOOOOOOXXXXXXXXXGOOOOOOOOOOOOOOOOXXXGOOOOOOXXXXXXXXXXXXXGOOOOOOOOOOOOOOOOOOOGOOOOOOOOXXXXXXXXXXXGOOOOOOOOOOOOXXXXXXXGOOOOOOOOOOOOOOOOOXXGOOOOOXXXXXXXXXXXXXXGOOOOOOOOOOXXXXXXXXXGOOOOOOOXXXXXXXXXXXXGOOOOOOOOOOXXXXXXXXX,0,256,0
30933,154,0,154,69,117,0,0,277,173,104,GOOOOOOOOOXXXXXXXXXXGOOOOOOOOOOOOXXXXXXXGOOOOOOOOOOXXXXXXXXXGOOOOOOOOOOOOOOOOXXXGOOOOOOXXXXXXXXXXXXXGOOOOOOOOOOOOOOOOOOOGOOOOOOOOXXXXXXXXXXXGOOOOOOOOOOOOXXXXXXXGOOOOOOOOOOOOOOOOOXXGOOOOOXXXXXXXXXXXXXXGOOOOOOOOOOXXXXXXXXXGOOOOOOOXXXXXXXXXXXXGOOOOOOOOOOXXXXXXXXX,0,256,0
30954,154,0,154,65,121,0,0,281,175,106,GOOOOOOOOOXXXXXXXXXXGOOOOOOOOOOOOXXXXXXXGOOOOOOOOOOXXXXXXXXXGOOOOOOOOOOOOOOOOXXXGOOOOOOXXXXXXXXXXXXXGOOOOOOOOOOOOOOOOOOOGOOOOOOOOXXXXXXXXXXXGOOOOOOOOOOOOXXXXXXXGOOOOOOOOOOOOOOOOOXXGOOOOOXXXXXXXXXXXXXXGOOOOOOOOOOXXXXXXXXXGOOOOOOOXXXXXXXXXXXXGOOOOOOOOOOXXXXXXXXX,0,256,0

30975,154,0,154,65,121,0,0,281,175,106,GOOOOOOOOOXXXXXXXXXXGOOOOOOOOOOOOXXXXXXXGOOOOOOOOOOXXXXXXXXXGOOOOOOOOOOOOOOOOXXXGOOOOOOXXXXXXXXXXXXXGOOOOOOOOOOOOOOOOOOOGOOOOOOOOXXXXXXXXXXXGOOOOOOOOOOOOXXXXXXXGOOOOOOOOOOOOOOOOOXXGOOOOOXXXXXXXXXXXXXXGOOOOOOOOOOXXXXXXXXXGOOOOOOOXXXXXXXXXXXXGOOOOOOOOOOXXXXXXXXX,0,256,0
30996,154,0,154,64,122,0,0,282,171,111,GOOOOOOOOOXXXXXXXXXXGOOOOOOOOOOOOXXXXXXXGOOOOOOOOOOXXXXXXXXXGOOOOOOOOOOOOOOOOXXXGOOOOOOXXXXXXXXXXXXXGOOOOOOOOOOOOOOOOOOOGOOOOOOOOXXXXXXXXXXXGOOOOOOOOOOOOXXXXXXXGOOOOOOOOOOOOOOOOOXXGOOOOOXXXXXXXXXXXXXXGOOOOOOOOOOXXXXXXXXXGOOOOOOOXXXXXXXXXXXXGOOOOOOOOOOXXXXXXXXX,0,256,0
31017,154,0,154,66,120,0,0,280,173,107,GOOOOOOOOOXXXXXXXXXXGOOOOOOOOOOOOXXXXXXXGOOOOOOOOOOXXXXXXXXXGOOOOOOOOOOOOOOOOXXXGOOOOOOXXXXXXXXXXXXXGOOOOOOOOOOOOOOOOOOOGOOOOOOOOXXXXXXXXXXXGOOOOOOOOOOOOXXXXXXXGOOOOOOOOOOOOOOOOOXXGOOOOOXXXXXXXXXXXXXXGOOOOOOOOOOXXXXXXXXXGOOOOOOOXXXXXXXXXXXXGOOOOOOOOOOXXXXXXXXX,0,256,0
31038,154,0,154,61,125,0,0,285,174,111,GOOOOOOOOOXXXXXXXXXXGOOOOOOOOOOOOXXXXXXXGOOOOOOOOOOXXXXXXXXXGOOOOOOOOOOOOOOOOXXXGOOOOOOXXXXXXXXXXXXXGOOOOOOOOOOOOOOOOOOOGOOOOOOOOXXXXXXXXXXXGOOOOOOOOOOOOXXXXXXXGOOOOOOOOOOOOOOOOOXXGOOOOOXXXXXXXXXXXXXXGOOOOOOOOOOXXXXXXXXXGOOOOOOOXXXXXXXXXXXXGOOOOOOOOOOXXXXXXXXX,0,256,0
31059,154,0,154,67,119,0,0,278,169,109,GOOOOOOOOOXXXXXXXXXXGOOOOOOOOOOOOXXXXXXXGOOOOOOOOOOXXXXXXXXXGOOOOOOOOOOOOOOOOXXXGOOOOOOXXXXXXXXXXXXXGOOOOOOOOOOOOOOOOOOOGOOOOOOOOXXXXXXXXXXXGOOOOOOOOOOOOXXXXXXXGOOOOOOOOOOOOOOOOOXXGOOOOOXXXXXXXXXXXXXXGOOOOOOOOOOXXXXXXXXXGOOOOOOOXXXXXXXXXXXXGOOOOOOOOOOXXXXXXXXX,0,256,0

31080,154,0,154,72,114,0,0,273,170,103,GOOOOOOOOOXXXXXXXXXXGOOOOOOOOOOOOXXXXXXXGOOOOOOOOOOXXXXXXXXXGOOOOOOOOOOOOOOOOXXXGOOOOOOXXXXXXXXXXXXXGOOOOOOOOOOOOOOOOOOOGOOOOOOOOXXXXXXXXXXXGOOOOOOOOOOOOXXXXXXXGOOOOOOOOOOOOOOOOOXXGOOOOOXXXXXXXXXXXXXXGOOOOOOOOOOXXXXXXXXXGOOOOOOOXXXXXXXXXXXXGOOOOOOOOOOXXXXXXXXX,0,256,0
31101,154,0,154,69,117,0,0,277,170,107,GOOOOOOOOOXXXXXXXXXXGOOOOOOOOOOOOXXXXXXXGOOOOOOOOOOXXXXXXXXXGOOOOOOOOOOOOOOOOXXXGOOOOOOXXXXXXXXXXXXXGOOOOOOOOOOOOOOOOOOOGOOOOOOOOXXXXXXXXXXXGOOOOOOOOOOOOXXXXXXXGOOOOOOOOOOOOOOOOOXXGOOOOOXXXXXXXXXXXXXXGOOOOOOOOOOXXXXXXXXXGOOOOOOOXXXXXXXXXXXXGOOOOOOOOOOXXXXXXXXX,0,256,0
31122,154,0,154,71,115,0,0,275,169,106,GOOOOOOOOOXXXXXXXXXXGOOOOOOOOOOOOXXXXXXXGOOOOOOOOOOXXXXXXXXXGOOOOOOOOOOOOOOOOXXXGOOOOOOXXXXXXXXXXXXXGOOOOOOOOOOOOOOOOOOOGOOOOOOOOXXXXXXXXXXXGOOOOOOOOOOOOXXXXXXXGOOOOOOOOOOOOOOOOOXXGOOOOOXXXXXXXXXXXXXXGOOOOOOOOOOXXXXXXXXXGOOOOOOOXXXXXXXXXXXXGOOOOOOOOOOXXXXXXXXX,0,256,0
31143,154,0,154,70,116,0,0,275,172,103,GOOOOOOOOOXXXXXXXXXXGOOOOOOOOOOOOXXXXXXXGOOOOOOOOOOXXXXXXXXXGOOOOOOOOOOOOOOOOXXXGOOOOOOXXXXXXXXXXXXXGOOOOOOOOOOOOOOOOOOOGOOOOOOOOXXXXXXXXXXXGOOOOOOOOOOOOXXXXXXXGOOOOOOOOOOOOOOOOOXXGOOOOOXXXXXXXXXXXXXXGOOOOOOOOOOXXXXXXXXXGOOOOOOOXXXXXXXXXXXXGOOOOOOOOOOXXXXXXXXX,0,256,0
31164,154,0,154,71,115,0,0,275,171,104,GOOOOOOOOOXXXXXXXXXXGOOOOOOOOOOOOXXXXXXXGOOOOOOOOOOXXXXXXXXXGOOOOOOOOOOOOOOOOXXXGOOOOOOXXXXXXXXXXXXXGOOOOOOOOOOOOOOOOOOOGOOOOOOOOXXXXXXXXXXXGOOOOOOOOOOOOXXXXXXXGOOOOOOOOOOOOOOOOOXXGOOOOOXXXXXXXXXXXXXXGOOOOOOOOOOXXXXXXXXXGOOOOOOOXXXXXXXXXXXXGOOOOOOOOOOXXXXXXXXX,0,256,0

31185,154,0,154,74,112,0,0,272,169,103,GOOOOOOOOOXXXXXXXXXXGOOOOOOOOOOOOXXXXXXXGOOOOOOOOOOXXXXXXXXXGOOOOOOOOOOOOOOOOXXXGOOOOOOXXXXXXXXXXXXXGOOOOOOOOOOOOOOOOOOOGOOOOOOOOXXXXXXXXXXXGOOOOOOOOOOOOXXXXXXXGOOOOOOOOOOOOOOOOOXXGOOOOOXXXXXXXXXXXXXXGOOOOOOOOOOXXXXXXXXXGOOOOOOOXXXXXXXXXXXXGOOOOOOOOOOXXXXXXXXX,0,256,0
31206,154,0,154,72,114,0,0,274,172,102,GOOOOOOOOOXXXXXXXXXXGOOOOOOOOOOOOXXXXXXXGOOOOOOOOOOXXXXXXXXXGOOOOOOOOOOOOOOOOXXXGOOOOOOXXXXXXXXXXXXXGOOOOOOOOOOOOOOOOOOOGOOOOOOOOXXXXXXXXXXXGOOOOOOOOOOOOXXXXXXXGOOOOOOOOOOOOOOOOOXXGOOOOOXXXXXXXXXXXXXXGOOOOOOOOOOXXXXXXXXXGOOOOOOOXXXXXXXXXXXXGOOOOOOOOOOXXXXXXXXX,0,256,0
31227,154,0,154,67,119,0,0,279,178,101,GOOOOOOOOOXXXXXXXXXXGOOOOOOOOOOOOXXXXXXXGOOOOOOOOOOXXXXXXXXXGOOOOOOOOOOOOOOOOXXXGOOOOOOXXXXXXXXXXXXXGOOOOOOOOOOOOOOOOOOOGOOOOOOOOXXXXXXXXXXXGOOOOOOOOOOOOXXXXXXXGOOOOOOOOOOOOOOOOOXXGOOOOOXXXXXXXXXXXXXXGOOOOOOOOOOXXXXXXXXXGOOOOOOOXXXXXXXXXXXXGOOOOOOOOOOXXXXXXXXX,0,256,0
31248,154,0,154,70,116,0,0,275,169,106,GOOOOOOOOOXXXXXXXXXXGOOOOOOOOOOOOXXXXXXXGOOOOOOOOOOXXXXXXXXXGOOOOOOOOOOOOOOOOXXXGOOOOOOXXXXXXXXXXXXXGOOOOOOOOOOOOOOOOOOOGOOOOOOOOXXXXXXXXXXXGOOOOOOOOOOOOXXXXXXXGOOOOOOOOOOOOOOOOOXXGOOOOOXXXXXXXXXXXXXXGOOOOOOOOOOXXXXXXXXXGOOOOOOOXXXXXXXXXXXXGOOOOOOOOOOXXXXXXXXX,0,256,0
31269,155,1,154,65,120,0,0,280,167,113,GOOOOOOOOOXXXXXXXXXXGOOOOOOOOOOOOAXXXXXXGOOOOOOOOOOXXXXXXXXXGOOOOOOOOOOOOOOOOXXXGOOOOOOXXXXXXXXXXXXXGOOOOOOOOOOOOOOOOOOOGOOOOOOOOXXXXXXXXXXXGOOOOOOOOOOOOXXXXXXXGOOOOOOOOOOOOOOOOOXXGOOOOOXXXXXXXXXXXXXXGOOOOOOOOOOXXXXXXXXXGOOOOOOOXXXXXXXXXXXXGOOOOOOOOOOXXXXXXXXX,0,256,0

31290,155,1,154,63,122,0,0,281,169,112,GOOOOOOOOOXXXXXXXXXXGOOOOOOOOOOOOAXXXXXXGOOOOOOOOOOXXXXXXXXXGOOOOOOOOOOOOOOOOXXXGOOOOOOXXXXXXXXXXXXXGOOOOOOOOOOOOOOOOOOOGOOOOOOOOXXXXXXXXXXXGOOOOOOOOOOOOXXXXXXXGOOOOOOOOOOOOOOOOOXXGOOOOOXXXXXXXXXXXXXXGOOOOOOOOOOXXXXXXXXXGOOOOOOOXXXXXXXXXXXXGOOOOOOOOOOXXXXXXXXX,0,256,0
31311,155,1,154,62,123,0,0,283,166,117,GOOOOOOOOOXXXXXXXXXXGOOOOOOOOOOOOAXXXXXXGOOOOOOOOOOXXXXXXXXXGOOOOOOOOOOOOOOOOXXXGOOOOOOXXXXXXXXXXXXXGOOOOOOOOOOOOOOOOOOOGOOOOOOOOXXXXXXXXXXXGOOOOOOOOOOOOXXXXXXXGOOOOOOOOOOOOOOOOOXXGOOOOOXXXXXXXXXXXXXXGOOOOOOOOOOXXXXXXXXXGOOOOOOOXXXXXXXXXXXXGOOOOOOOOOOXXXXXXXXX,0,256,0
31332,155,1,154,64,121,0,0,281,164,117,GOOOOOOOOOXXXXXXXXXXGOOOOOOOOOOOOAXXXXXXGOOOOOOOOOOXXXXXXXXXGOOOOOOOOOOOOOOOOXXXGOOOOOOXXXXXXXXXXXXXGOOOOOOOOOOOOOOOOOOOGOOOOOOOOXXXXXXXXXXXGOOOOOOOOOOOOXXXXXXXGOOOOOOOOOOOOOOOOOXXGOOOOOXXXXXXXXXXXXXXGOOOOOOOOOOXXXXXXXXXGOOOOOOOXXXXXXXXXXXXGOOOOOOOOOOXXXXXXXXX,0,256,0
31353,155,1,154,62,123,0,0,283,169,114,GOOOOOOOOOXXXXXXXXXXGOOOOOOOOOOOOAXXXXXXGOOOOOOOOOOXXXXXXXXXGOOOOOOOOOOOOOOOOXXXGOOOOOOXXXXXXXXXXXXXGOOOOOOOOOOOOOOOOOOOGOOOOOOOOXXXXXXXXXXXGOOOOOOOOOOOOXXXXXXXGOOOOOOOOOOOOOOOOOXXGOOOOOXXXXXXXXXXXXXXGOOOOOOOOOOXXXXXXXXXGOOOOOOOXXXXXXXXXXXXGOOOOOOOOOOXXXXXXXXX,0,256,0
31374,155,1,154,62,123,0,0,282,171,111,GOOOOOOOOOXXXXXXXXXXGOOOOOOOOOOOOAXXXXXXGOOOOOOOOOOXXXXXXXXXGOOOOOOOOOOOOOOOOXXXGOOOOOOXXXXXXXXXXXXXGOOOOOOOOOOOOOOOOOOOGOOOOOOOOXXXXXXXXXXXGOOOOOOOOOOOOXXXXXXXGOOOOOOOOOOOOOOOOOXXGOOOOOXXXXXXXXXXXXXXGOOOOOOOOOOXXXXXXXXXGOOOOOOOXXXXXXXXXXXXGOOOOOOOOOOXXXXXXXXX,0,256,0

31395,155,1,154,66,119,0,0,279,167,112,GOOOOOOOOOXXXXXXXXXXGOOOOOOOOOOOOAXXXXXXGOOOOOOOOOOXXXXXXXXXGOOOOOOOOOOOOOOOOXXXGOOOOOOXXXXXXXXXXXXXGOOOOOOOOOOOOOOOOOOOGOOOOOOOOXXXXXXXXXXXGOOOOOOOOOOOOXXXXXXXGOOOOOOOOOOOOOOOOOXXGOOOOOXXXXXXXXXXXXXXGOOOOOOOOOOXXXXXXXXXGOOOOOOOXXXXXXXXXXXXGOOOOOOOOOOXXXXXXXXX,0,256,0
31416,155,1,154,63,122,0,0,282,167,115,GOOOOOOOOOXXXXXXXXXXGOOOOOOOOOOOOAXXXXXXGOOOOOOOOOOXXXXXXXXXGOOOOOOOOOOOOOOOOXXXGOOOOOOXXXXXXXXXXXXXGOOOOOOOOOOOOOOOOOOOGOOOOOOOOXXXXXXXXXXXGOOOOOOOOOOOOXXXXXXXGOOOOOOOOOOOOOOOOOXXGOOOOOXXXXXXXXXXXXXXGOOOOOOOOOOXXXXXXXXXGOOOOOOOXXXXXXXXXXXXGOOOOOOOOOOXXXXXXXXX,0,256,0
31437,155,1,154,66,119,0,0,278,168,110,GOOOOOOOOOXXXXXXXXXXGOOOOOOOOOOOOAXXXXXXGOOOOOOOOOOXXXXXXXXXGOOOOOOOOOOOOOOOOXXXGOOOOOOXXXXXXXXXXXXXGOOOOOOOOOOOOOOOOOOOGOOOOOOOOXXXXXXXXXXXGOOOOOOOOOOOOXXXXXXXGOOOOOOOOOOOOOOOOOXXGOOOOOXXXXXXXXXXXXXXGOOOOOOOOOOXXXXXXXXXGOOOOOOOXXXXXXXXXXXXGOOOOOOOOOOXXXXXXXXX,0,256,0
31458,155,1,154,70,115,0,0,275,167,108,GOOOOOOOOOXXXXXXXXXXGOOOOOOOOOOOOAXXXXXXGOOOOOOOOOOXXXXXXXXXGOOOOOOOOOOOOOOOOXXXGOOOOOOXXXXXXXXXXXXXGOOOOOOOOOOOOOOOOOOOGOOOOOOOOXXXXXXXXXXXGOOOOOOOOOOOOXXXXXXXGOOOOOOOOOOOOOOOOOXXGOOOOOXXXXXXXXXXXXXXGOOOOOOOOOOXXXXXXXXXGOOOOOOOXXXXXXXXXXXXGOOOOOOOOOOXXXXXXXXX,0,256,0
31479,155,1,154,69,116,0,0,276,170,106,GOOOOOOOOOXXXXXXXXXXGOOOOOOOOOOOOAXXXXXXGOOOOOOOOOOXXXXXXXXXGOOOOOOOOOOOOOOOOXXXGOOOOOOXXXXXXXXXXXXXGOOOOOOOOOOOOOOOOOOOGOOOOOOOOXXXXXXXXXXXGOOOOOOOOOOOOXXXXXXXGOOOOOOOOOOOOOOOOOXXGOOOOOXXXXXXXXXXXXXXGOOOOOOOOOOXXXXXXXXXGOOOOOOOXXXXXXXXXXXXGOOOOOOOOOOXXXXXXXXX,0,256,0

31500,155,1,154,70,115,0,0,275,172,103,GOOOOOOOOOXXXXXXXXXXGOOOOOOOOOOOOAXXXXXXGOOOOOOOOOOXXXXXXXXXGOOOOOOOOOOOOOOOOXXXGOOOOOOXXXXXXXXXXXXXGOOOOOOOOOOOOOOOOOOOGOOOOOOOOXXXXXXXXXXXGOOOOOOOOOOOOXXXXXXXGOOOOOOOOOOOOOOOOOXXGOOOOOXXXXXXXXXXXXXXGOOOOOOOOOOXXXXXXXXXGOOOOOOOXXXXXXXXXXXXGOOOOOOOOOOXXXXXXXXX,0,256,0
31521,155,1,154,73,112,0,0,271,170,101,GOOOOOOOOOXXXXXXXXXXGOOOOOOOOOOOOAXXXXXXGOOOOOOOOOOXXXXXXXXXGOOOOOOOOOOOOOOOOXXXGOOOOOOXXXXXXXXXXXXXGOOOOOOOOOOOOOOOOOOOGOOOOOOOOXXXXXXXXXXXGOOOOOOOOOOOOXXXXXXXGOOOOOOOOOOOOOOOOOXXGOOOOOXXXXXXXXXXXXXXGOOOOOOOOOOXXXXXXXXXGOOOOOOOXXXXXXXXXXXXGOOOOOOOOOOXXXXXXXXX,0,256,0
31542,155,0,155,73,112,0,0,272,170,102,GOOOOOOOOOXXXXXXXXXXGOOOOOOOOOOOOOXXXXXXGOOOOOOOOOOXXXXXXXXXGOOOOOOOOOOOOOOOOXXXGOOOOOOXXXXXXXXXXXXXGOOOOOOOOOOOOOOOOOOOGOOOOOOOOXXXXXXXXXXXGOOOOOOOOOOOOXXXXXXXGOOOOOOOOOOOOOOOOOXXGOOOOOXXXXXXXXXXXXXXGOOOOOOOOOOXXXXXXXXXGOOOOOOOXXXXXXXXXXXXGOOOOOOOOOOXXXXXXXXX,0,256,0
31563,155,0,155,71,114,0,0,274,170,104,GOOOOOOOOOXXXXXXXXXXGOOOOOOOOOOOOOXXXXXXGOOOOOOOOOOXXXXXXXXXGOOOOOOOOOOOOOOOOXXXGOOOOOOXXXXXXXXXXXXXGOOOOOOOOOOOOOOOOOOOGOOOOOOOOXXXXXXXXXXXGOOOOOOOOOOOOXXXXXXXGOOOOOOOOOOOOOOOOOXXGOOOOOXXXXXXXXXXXXXXGOOOOOOOOOOXXXXXXXXXGOOOOOOOXXXXXXXXXXXXGOOOOOOOOOOXXXXXXXXX,0,256,0
31584,156,1,155,64,120,0,0,280,174,106,GOOOOOOOOOXXXXXXXXXXGOOOOOOOOOOOOOXXXXXXGOOOOOOOOOOXXXXXXXXXGOOOOOOOOOOOOOOOOXXXGOOOOOOXXXXXXXXXXXXXGOOOOOOOOOOOOOOOOOOOGOOOOOOOOXXXXXXXXXXXGOOOOOOOOOOOOXXXXXXXGOOOOOOOOOOOOOOOOOXXGOOOOOAXXXXXXXXXXXXXGOOOOOOOOOOXXXXXXXXXGOOOOOOOXXXXXXXXXXXXGOOOOOOOOOOXXXXXXXXX,0,256,0

31605,156,0,156,61,123,0,0,284,175,109,GOOOOOOOOOXXXXXXXXXXGOOOOOOOOOOOOOXXXXXXGOOOOOOOOOOXXXXXXXXXGOOOOOOOOOOOOOOOOXXXGOOOOOOXXXXXXXXXXXXXGOOOOOOOOOOOOOOOOOOOGOOOOOOOOXXXXXXXXXXXGOOOOOOOOOOOOXXXXXXXGOOOOOOOOOOOOOOOOOXXGOOOOOOXXXXXXXXXXXXXGOOOOOOOOOOXXXXXXXXXGOOOOOOOXXXXXXXXXXXXGOOOOOOOOOOXXXXXXXXX,0,256,0
31626,156,0,156,60,124,0,0,285,175,110,GOOOOOOOOOXXXXXXXXXXGOOOOOOOOOOOOOXXXXXXGOOOOOOOOOOXXXXXXXXXGOOOOOOOOOOOOOOOOXXXGOOOOOOXXXXXXXXXXXXXGOOOOOOOOOOOOOOOOOOOGOOOOOOOOXXXXXXXXXXXGOOOOOOOOOOOOXXXXXXXGOOOOOOOOOOOOOOOOOXXGOOOOOOXXXXXXXXXXXXXGOOOOOOOOOOXXXXXXXXXGOOOOOOOXXXXXXXXXXXXGOOOOOOOOOOXXXXXXXXX,0,256,0
31647,156,0,156,59,125,0,0,286,174,112,GOOOOOOOOOXXXXXXXXXXGOOOOOOOOOOOOOXXXXXXGOOOOOOOOOOXXXXXXXXXGOOOOOOOOOOOOOOOOXXXGOOOOOOXXXXXXXXXXXXXGOOOOOOOOOOOOOOOOOOOGOOOOOOOOXXXXXXXXXXXGOOOOOOOOOOOOXXXXXXXGOOOOOOOOOOOOOOOOOXXGOOOOOOXXXXXXXXXXXXXGOOOOOOOOOOXXXXXXXXXGOOOOOOOXXXXXXXXXXXXGOOOOOOOOOOXXXXXXXXX,0,256,0
31668,156,0,156,59,125,0,0,285,171,114,GOOOOOOOOOXXXXXXXXXXGOOOOOOOOOOOOOXXXXXXGOOOOOOOOOOXXXXXXXXXGOOOOOOOOOOOOOOOOXXXGOOOOOOXXXXXXXXXXXXXGOOOOOOOOOOOOOOOOOOOGOOOOOOOOXXXXXXXXXXXGOOOOOOOOOOOOXXXXXXXGOOOOOOOOOOOOOOOOOXXGOOOOOOXXXXXXXXXXXXXGOOOOOOOOOOXXXXXXXXXGOOOOOOOXXXXXXXXXXXXGOOOOOOOOOOXXXXXXXXX,0,256,0
31689,156,0,156,62,122,0,0,282,169,113,GOOOOOOOOOXXXXXXXXXXGOOOOOOOOOOOOOXXXXXXGOOOOOOOOOOXXXXXXXXXGOOOOOOOOOOOOOOOOXXXGOOOOOOXXXXXXXXXXXXXGOOOOOOOOOOOOOOOOOOOGOOOOOOOOXXXXXXXXXXXGOOOOOOOOOOOOXXXXXXXGOOOOOOOOOOOOOOOOOXXGOOOOOOXXXXXXXXXXXXXGOOOOOOOOOOXXXXXXXXXGOOOOOOOXXXXXXXXXXXXGOOOOOOOOOOXXXXXXXXX,0,256,0

31710,156,0,156,64,120,0,0,280,169,111,GOOOOOOOOOXXXXXXXXXXGOOOOOOOOOOOOOXXXXXXGOOOOOOOOOOXXXXXXXXXGOOOOOOOOOOOOOOOOXXXGOOOOOOXXXXXXXXXXXXXGOOOOOOOOOOOOOOOOOOOGOOOOOOOOXXXXXXXXXXXGOOOOOOOOOOOOXXXXXXXGOOOOOOOOOOOOOOOOOXXGOOOOOOXXXXXXXXXXXXXGOOOOOOOOOOXXXXXXXXXGOOOOOOOXXXXXXXXXXXXGOOOOOOOOOOXXXXXXXXX,0,256,0
31731,156,0,156,58,126,0,0,286,172,114,GOOOOOOOOOXXXXXXXXXXGOOOOOOOOOOOOOXXXXXXGOOOOOOOOOOXXXXXXXXXGOOOOOOOOOOOOOOOOXXXGOOOOOOXXXXXXXXXXXXXGOOOOOOOOOOOOOOOOOOOGOOOOOOOOXXXXXXXXXXXGOOOOOOOOOOOOXXXXXXXGOOOOOOOOOOOOOOOOOXXGOOOOOOXXXXXXXXXXXXXGOOOOOOOOOOXXXXXXXXXGOOOOOOOXXXXXXXXXXXXGOOOOOOOOOOXXXXXXXXX,0,256,0
31752,156,0,156,60,124,0,0,283,170,113,GOOOOOOOOOXXXXXXXXXXGOOOOOOOOOOOOOXXXXXXGOOOOOOOOOOXXXXXXXXXGOOOOOOOOOOOOOOOOXXXGOOOOOOXXXXXXXXXXXXXGOOOOOOOOOOOOOOOOOOOGOOOOOOOOXXXXXXXXXXXGOOOOOOOOOOOOXXXXXXXGOOOOOOOOOOOOOOOOOXXGOOOOOOXXXXXXXXXXXXXGOOOOOOOOOOXXXXXXXXXGOOOOOOOXXXXXXXXXXXXGOOOOOOOOOOXXXXXXXXX,0,256,0
31773,156,0,156,57,127,0,0,286,175,111,GOOOOOOOOOXXXXXXXXXXGOOOOOOOOOOOOOXXXXXXGOOOOOOOOOOXXXXXXXXXGOOOOOOOOOOOOOOOOXXXGOOOOOOXXXXXXXXXXXXXGOOOOOOOOOOOOOOOOOOOGOOOOOOOOXXXXXXXXXXXGOOOOOOOOOOOOXXXXXXXGOOOOOOOOOOOOOOOOOXXGOOOOOOXXXXXXXXXXXXXGOOOOOOOOOOXXXXXXXXXGOOOOOOOXXXXXXXXXXXXGOOOOOOOOOOXXXXXXXXX,0,256,0
31794,156,0,156,61,123,0,0,283,175,108,GOOOOOOOOOXXXXXXXXXXGOOOOOOOOOOOOOXXXXXXGOOOOOOOOOOXXXXXXXXXGOOOOOOOOOOOOOOOOXXXGOOOOOOXXXXXXXXXXXXXGOOOOOOOOOOOOOOOOOOOGOOOOOOOOXXXXXXXXXXXGOOOOOOOOOOOOXXXXXXXGOOOOOOOOOOOOOOOOOXXGOOOOOOXXXXXXXXXXXXXGOOOOOOOOOOXXXXXXXXXGOOOOOOOXXXXXXXXXXXXGOOOOOOOOOOXXXXXXXXX,0,256,0

31815,156,0,156,65,119,0,0,278,173,105,GOOOOOOOOOXXXXXXXXXXGOOOOOOOOOOOOOXXXXXXGOOOOOOOOOOXXXXXXXXXGOOOOOOOOOOOOOOOOXXXGOOOOOOXXXXXXXXXXXXXGOOOOOOOOOOOOOOOOOOOGOOOOOOOOXXXXXXXXXXXGOOOOOOOOOOOOXXXXXXXGOOOOOOOOOOOOOOOOOXXGOOOOOOXXXXXXXXXXXXXGOOOOOOOOOOXXXXXXXXXGOOOOOOOXXXXXXXXXXXXGOOOOOOOOOOXXXXXXXXX,0,256,0
31836,156,0,156,69,115,0,0,274,168,106,GOOOOOOOOOXXXXXXXXXXGOOOOOOOOOOOOOXXXXXXGOOOOOOOOOOXXXXXXXXXGOOOOOOOOOOOOOOOOXXXGOOOOOOXXXXXXXXXXXXXGOOOOOOOOOOOOOOOOOOOGOOOOOOOOXXXXXXXXXXXGOOOOOOOOOOOOXXXXXXXGOOOOOOOOOOOOOOOOOXXGOOOOOOXXXXXXXXXXXXXGOOOOOOOOOOXXXXXXXXXGOOOOOOOXXXXXXXXXXXXGOOOOOOOOOOXXXXXXXXX,0,256,0
31857,156,0,156,71,113,0,0,273,166,107,GOOOOOOOOOXXXXXXXXXXGOOOOOOOOOOOOOXXXXXXGOOOOOOOOOOXXXXXXXXXGOOOOOOOOOOOOOOOOXXXGOOOOOOXXXXXXXXXXXXXGOOOOOOOOOOOOOOOOOOOGOOOOOOOOXXXXXXXXXXXGOOOOOOOOOOOOXXXXXXXGOOOOOOOOOOOOOOOOOXXGOOOOOOXXXXXXXXXXXXXGOOOOOOOOOOXXXXXXXXXGOOOOOOOXXXXXXXXXXXXGOOOOOOOOOOXXXXXXXXX,0,256,0
31878,156,0,156,70,114,0,0,274,162,112,GOOOOOOOOOXXXXXXXXXXGOOOOOOOOOOOOOXXXXXXGOOOOOOOOOOXXXXXXXXXGOOOOOOOOOOOOOOOOXXXGOOOOOOXXXXXXXXXXXXXGOOOOOOOOOOOOOOOOOOOGOOOOOOOOXXXXXXXXXXXGOOOOOOOOOOOOXXXXXXXGOOOOOOOOOOOOOOOOOXXGOOOOOOXXXXXXXXXXXXXGOOOOOOOOOOXXXXXXXXXGOOOOOOOXXXXXXXXXXXXGOOOOOOOOOOXXXXXXXXX,0,256,0
31899,156,0,156,69,115,0,0,275,165,110,GOOOOOOOOOXXXXXXXXXXGOOOOOOOOOOOOOXXXXXXGOOOOOOOOOOXXXXXXXXXGOOOOOOOOOOOOOOOOXXXGOOOOOOXXXXXXXXXXXXXGOOOOOOOOOOOOOOOOOOOGOOOOOOOOXXXXXXXXXXXGOOOOOOOOOOOOXXXXXXXGOOOOOOOOOOOOOOOOOXXGOOOOOOXXXXXXXXXXXXXGOOOOOOOOOOXXXXXXXXXGOOOOOOOXXXXXXXXXXXXGOOOOOOOOOOXXXXXXXXX,0,256,0

31920,156,0,156,69,115,0,0,275,167,108,GOOOOOOOOOXXXXXXXXXXGOOOOOOOOOOOOOXXXXXXGOOOOOOOOOOXXXXXXXXXGOOOOOOOOOOOOOOOOXXXGOOOOOOXXXXXXXXXXXXXGOOOOOOOOOOOOOOOOOOOGOOOOOOOOXXXXXXXXXXXGOOOOOOOOOOOOXXXXXXXGOOOOOOOOOOOOOOOOOXXGOOOOOOXXXXXXXXXXXXXGOOOOOOOOOOXXXXXXXXXGOOOOOOOXXXXXXXXXXXXGOOOOOOOOOOXXXXXXXXX,0,256,0
31941,156,0,156,72,112,0,0,272,168,104,GOOOOOOOOOXXXXXXXXXXGOOOOOOOOOOOOOXXXXXXGOOOOOOOOOOXXXXXXXXXGOOOOOOOOOOOOOOOOXXXGOOOOOOXXXXXXXXXXXXXGOOOOOOOOOOOOOOOOOOOGOOOOOOOOXXXXXXXXXXXGOOOOOOOOOOOOXXXXXXXGOOOOOOOOOOOOOOOOOXXGOOOOOOXXXXXXXXXXXXXGOOOOOOOOOOXXXXXXXXXGOOOOOOOXXXXXXXXXXXXGOOOOOOOOOOXXXXXXXXX,0,256,0
31962,156,0,156,74,110,0,0,270,162,108,GOOOOOOOOOXXXXXXXXXXGOOOOOOOOOOOOOXXXXXXGOOOOOOOOOOXXXXXXXXXGOOOOOOOOOOOOOOOOXXXGOOOOOOXXXXXXXXXXXXXGOOOOOOOOOOOOOOOOOOOGOOOOOOOOXXXXXXXXXXXGOOOOOOOOOOOOXXXXXXXGOOOOOOOOOOOOOOOOOXXGOOOOOOXXXXXXXXXXXXXGOOOOOOOOOOXXXXXXXXXGOOOOOOOXXXXXXXXXXXXGOOOOOOOOOOXXXXXXXXX,0,256,0
31983,156,0,156,72,112,0,0,272,163,109,GOOOOOOOOOXXXXXXXXXXGOOOOOOOOOOOOOXXXXXXGOOOOOOOOOOXXXXXXXXXGOOOOOOOOOOOOOOOOXXXGOOOOOOXXXXXXXXXXXXXGOOOOOOOOOOOOOOOOOOOGOOOOOOOOXXXXXXXXXXXGOOOOOOOOOOOOXXXXXXXGOOOOOOOOOOOOOOOOOXXGOOOOOOXXXXXXXXXXXXXGOOOOOOOOOOXXXXXXXXXGOOOOOOOXXXXXXXXXXXXGOOOOOOOOOOXXXXXXXXX,0,256,0
32004,156,0,156,65,119,0,0,279,168,111,GOOOOOOOOOXXXXXXXXXXGOOOOOOOOOOOOOXXXXXXGOOOOOOOOOOXXXXXXXXXGOOOOOOOOOOOOOOOOXXXGOOOOOOXXXXXXXXXXXXXGOOOOOOOOOOOOOOOOOOOGOOOOOOOOXXXXXXXXXXXGOOOOOOOOOOOOXXXXXXXGOOOOOOOOOOOOOOOOOXXGOOOOOOXXXXXXXXXXXXXGOOOOOOOOOOXXXXXXXXXGOOOOOOOXXXXXXXXXXXXGOOOOOOOOOOXXXXXXXXX,0,256,0

32025,156,0,156,62,122,0,0,282,169,113,GOOOOOOOOOXXXXXXXXXXGOOOOOOOOOOOOOXXXXXXGOOOOOOOOOOXXXXXXXXXGOOOOOOOOOOOOOOOOXXXGOOOOOOXXXXXXXXXXXXXGOOOOOOOOOOOOOOOOOOOGOOOOOOOOXXXXXXXXXXXGOOOOOOOOOOOOXXXXXXXGOOOOOOOOOOOOOOOOOXXGOOOOOOXXXXXXXXXXXXXGOOOOOOOOOOXXXXXXXXXGOOOOOOOXXXXXXXXXXXXGOOOOOOOOOOXXXXXXXXX,0,256,0
32046,156,0,156,63,121,0,0,281,168,113,GOOOOOOOOOXXXXXXXXXXGOOOOOOOOOOOOOXXXXXXGOOOOOOOOOOXXXXXXXXXGOOOOOOOOOOOOOOOOXXXGOOOOOOXXXXXXXXXXXXXGOOOOOOOOOOOOOOOOOOOGOOOOOOOOXXXXXXXXXXXGOOOOOOOOOOOOXXXXXXXGOOOOOOOOOOOOOOOOOXXGOOOOOOXXXXXXXXXXXXXGOOOOOOOOOOXXXXXXXXXGOOOOOOOXXXXXXXXXXXXGOOOOOOOOOOXXXXXXXXX,0,256,0
32067,156,0,156,61,123,0,0,281,167,114,GOOOOOOOOOXXXXXXXXXXGOOOOOOOOOOOOOXXXXXXGOOOOOOOOOOXXXXXXXXXGOOOOOOOOOOOOOOOOXXXGOOOOOOXXXXXXXXXXXXXGOOOOOOOOOOOOOOOOOOOGOOOOOOOOXXXXXXXXXXXGOOOOOOOOOOOOXXXXXXXGOOOOOOOOOOOOOOOOOXXGOOOOOOXXXXXXXXXXXXXGOOOOOOOOOOXXXXXXXXXGOOOOOOOXXXXXXXXXXXXGOOOOOOOOOOXXXXXXXXX,0,256,0
32088,156,0,156,59,125,0,0,285,172,113,GOOOOOOOOOXXXXXXXXXXGOOOOOOOOOOOOOXXXXXXGOOOOOOOOOOXXXXXXXXXGOOOOOOOOOOOOOOOOXXXGOOOOOOXXXXXXXXXXXXXGOOOOOOOOOOOOOOOOOOOGOOOOOOOOXXXXXXXXXXXGOOOOOOOOOOOOXXXXXXXGOOOOOOOOOOOOOOOOOXXGOOOOOOXXXXXXXXXXXXXGOOOOOOOOOOXXXXXXXXXGOOOOOOOXXXXXXXXXXXXGOOOOOOOOOOXXXXXXXXX,0,256,0
32109,156,0,156,63,121,0,0,280,165,115,GOOOOOOOOOXXXXXXXXXXGOOOOOOOOOOOOOXXXXXXGOOOOOOOOOOXXXXXXXXXGOOOOOOOOOOOOOOOOXXXGOOOOOOXXXXXXXXXXXXXGOOOOOOOOOOOOOOOOOOOGOOOOOOOOXXXXXXXXXXXGOOOOOOOOOOOOXXXXXXXGOOOOOOOOOOOOOOOOOXXGOOOOOOXXXXXXXXXXXXXGOOOOOOOOOOXXXXXXXXXGOOOOOOOXXXXXXXXXXXXGOOOOOOOOOOXXXXXXXXX,0,256,0

32130,156,0,156,61,123,0,0,283,172,111,GOOOOOOOOOXXXXXXXXXXGOOOOOOOOOOOOOXXXXXXGOOOOOOOOOOXXXXXXXXXGOOOOOOOOOOOOOOOOXXXGOOOOOOXXXXXXXXXXXXXGOOOOOOOOOOOOOOOOOOOGOOOOOOOOXXXXXXXXXXXGOOOOOOOOOOOOXXXXXXXGOOOOOOOOOOOOOOOOOXXGOOOOOOXXXXXXXXXXXXXGOOOOOOOOOOXXXXXXXXXGOOOOOOOXXXXXXXXXXXXGOOOOOOOOOOXXXXXXXXX,0,256,0
32151,156,0,156,61,123,0,0,283,172,111,GOOOOOOOOOXXXXXXXXXXGOOOOOOOOOOOOOXXXXXXGOOOOOOOOOOXXXXXXXXXGOOOOOOOOOOOOOOOOXXXGOOOOOOXXXXXXXXXXXXXGOOOOOOOOOOOOOOOOOOOGOOOOOOOOXXXXXXXXXXXGOOOOOOOOOOOOXXXXXXXGOOOOOOOOOOOOOOOOOXXGOOOOOOXXXXXXXXXXXXXGOOOOOOOOOOXXXXXXXXXGOOOOOOOXXXXXXXXXXXXGOOOOOOOOOOXXXXXXXXX,0,256,0
32172,156,0,156,64,120,0,0,280,171,109,GOOOOOOOOOXXXXXXXXXXGOOOOOOOOOOOOOXXXXXXGOOOOOOOOOOXXXXXXXXXGOOOOOOOOOOOOOOOOXXXGOOOOOOXXXXXXXXXXXXXGOOOOOOOOOOOOOOOOOOOGOOOOOOOOXXXXXXXXXXXGOOOOOOOOOOOOXXXXXXXGOOOOOOOOOOOOOOOOOXXGOOOOOOXXXXXXXXXXXXXGOOOOOOOOOOXXXXXXXXXGOOOOOOOXXXXXXXXXXXXGOOOOOOOOOOXXXXXXXXX,0,256,0
32193,156,0,156,65,119,0,0,278,168,110,GOOOOOOOOOXXXXXXXXXXGOOOOOOOOOOOOOXXXXXXGOOOOOOOOOOXXXXXXXXXGOOOOOOOOOOOOOOOOXXXGOOOOOOXXXXXXXXXXXXXGOOOOOOOOOOOOOOOOOOOGOOOOOOOOXXXXXXXXXXXGOOOOOOOOOOOOXXXXXXXGOOOOOOOOOOOOOOOOOXXGOOOOOOXXXXXXXXXXXXXGOOOOOOOOOOXXXXXXXXXGOOOOOOOXXXXXXXXXXXXGOOOOOOOOOOXXXXXXXXX,0,256,0
32214,156,0,156,62,122,0,0,282,170,112,GOOOOOOOOOXXXXXXXXXXGOOOOOOOOOOOOOXXXXXXGOOOOOOOOOOXXXXXXXXXGOOOOOOOOOOOOOOOOXXXGOOOOOOXXXXXXXXXXXXXGOOOOOOOOOOOOOOOOOOOGOOOOOOOOXXXXXXXXXXXGOOOOOOOOOOOOXXXXXXXGOOOOOOOOOOOOOOOOOXXGOOOOOOXXXXXXXXXXXXXGOOOOOOOOOOXXXXXXXXXGOOOOOOOXXXXXXXXXXXXGOOOOOOOOOOXXXXXXXXX,0,256,0

32235,157,1,156,68,115,0,0,275,170,105,GOOOOOOOOOXXXXXXXXXXGOOOOOOOOOOOOOXXXXXXGOOOOOOOOOOXXXXXXXXXGOOOOOOOOOOOOOOOOXXXGOOOOOOXXXXXXXXXXXXXGOOOOOOOOOOOOOOOOOOOGOOOOOOOOXXXXXXXXXXXGOOOOOOOOOOOOXXXXXXXGOOOOOOOOOOOOOOOOOXXGOOOOOOXXXXXXXXXXXXXGOOOOOOOOOOAXXXXXXXXGOOOOOOOXXXXXXXXXXXXGOOOOOOOOOOXXXXXXXXX,0,256,0
32256,157,1,156,64,119,0,0,278,173,105,GOOOOOOOOOXXXXXXXXXXGOOOOOOOOOOOOOXXXXXXGOOOOOOOOOOXXXXXXXXXGOOOOOOOOOOOOOOOOXXXGOOOOOOXXXXXXXXXXXXXGOOOOOOOOOOOOOOOOOOOGOOOOOOOOXXXXXXXXXXXGOOOOOOOOOOOOXXXXXXXGOOOOOOOOOOOOOOOOOXXGOOOOOOXXXXXXXXXXXXXGOOOOOOOOOOAXXXXXXXXGOOOOOOOXXXXXXXXXXXXGOOOOOOOOOOXXXXXXXXX,0,256,0
32277,157,1,156,65,118,0,0,278,174,104,GOOOOOOOOOXXXXXXXXXXGOOOOOOOOOOOOOXXXXXXGOOOOOOOOOOXXXXXXXXXGOOOOOOOOOOOOOOOOXXXGOOOOOOXXXXXXXXXXXXXGOOOOOOOOOOOOOOOOOOOGOOOOOOOOXXXXXXXXXXXGOOOOOOOOOOOOXXXXXXXGOOOOOOOOOOOOOOOOOXXGOOOOOOXXXXXXXXXXXXXGOOOOOOOOOOAXXXXXXXXGOOOOOOOXXXXXXXXXXXXGOOOOOOOOOOXXXXXXXXX,0,256,0
32298,157,1,156,71,112,0,0,272,170,102,GOOOOOOOOOXXXXXXXXXXGOOOOOOOOOOOOOXXXXXXGOOOOOOOOOOXXXXXXXXXGOOOOOOOOOOOOOOOOXXXGOOOOOOXXXXXXXXXXXXXGOOOOOOOOOOOOOOOOOOOGOOOOOOOOXXXXXXXXXXXGOOOOOOOOOOOOXXXXXXXGOOOOOOOOOOOOOOOOOXXGOOOOOOXXXXXXXXXXXXXGOOOOOOOOOOAXXXXXXXXGOOOOOOOXXXXXXXXXXXXGOOOOOOOOOOXXXXXXXXX,0,256,0
32319,157,1,156,70,113,0,0,273,176,97,GOOOOOOOOOXXXXXXXXXXGOOOOOOOOOOOOOXXXXXXGOOOOOOOOOOXXXXXXXXXGOOOOOOOOOOOOOOOOXXXGOOOOOOXXXXXXXXXXXXXGOOOOOOOOOOOOOOOOOOOGOOOOOOOOXXXXXXXXXXXGOOOOOOOOOOOOXXXXXXXGOOOOOOOOOOOOOOOOOXXGOOOOOOXXXXXXXXXXXXXGOOOOOOOOOOAXXXXXXXXGOOOOOOOXXXXXXXXXXXXGOOOOOOOOOOXXXXXXXXX,0,256,0

32340,157,0,157,76,107,0,0,267,172,95,GOOOOOOOOOXXXXXXXXXXGOOOOOOOOOOOOOXXXXXXGOOOOOOOOOOXXXXXXXXXGOOOOOOOOOOOOOOOOXXXGOOOOOOXXXXXXXXXXXXXGOOOOOOOOOOOOOOOOOOOGOOOOOOOOXXXXXXXXXXXGOOOOOOOOOOOOXXXXXXXGOOOOOOOOOOOOOOOOOXXGOOOOOOXXXXXXXXXXXXXGOOOOOOOOOOOXXXXXXXXGOOOOOOOXXXXXXXXXXXXGOOOOOOOOOOXXXXXXXXX,0,256,0
32361,157,0,157,75,108,0,0,268,166,102,GOOOOOOOOOXXXXXXXXXXGOOOOOOOOOOOOOXXXXXXGOOOOOOOOOOXXXXXXXXXGOOOOOOOOOOOOOOOOXXXGOOOOOOXXXXXXXXXXXXXGOOOOOOOOOOOOOOOOOOOGOOOOOOOOXXXXXXXXXXXGOOOOOOOOOOOOXXXXXXXGOOOOOOOOOOOOOOOOOXXGOOOOOOXXXXXXXXXXXXXGOOOOOOOOOOOXXXXXXXXGOOOOOOOXXXXXXXXXXXXGOOOOOOOOOOXXXXXXXXX,0,256,0
32382,157,0,157,74,109,0,0,269,169,100,GOOOOOOOOOXXXXXXXXXXGOOOOOOOOOOOOOXXXXXXGOOOOOOOOOOXXXXXXXXXGOOOOOOOOOOOOOOOOXXXGOOOOOOXXXXXXXXXXXXXGOOOOOOOOOOOOOOOOOOOGOOOOOOOOXXXXXXXXXXXGOOOOOOOOOOOOXXXXXXXGOOOOOOOOOOOOOOOOOXXGOOOOOOXXXXXXXXXXXXXGOOOOOOOOOOOXXXXXXXXGOOOOOOOXXXXXXXXXXXXGOOOOOOOOOOXXXXXXXXX,0,256,0
32403,157,0,157,71,112,0,0,271,173,98,GOOOOOOOOOXXXXXXXXXXGOOOOOOOOOOOOOXXXXXXGOOOOOOOOOOXXXXXXXXXGOOOOOOOOOOOOOOOOXXXGOOOOOOXXXXXXXXXXXXXGOOOOOOOOOOOOOOOOOOOGOOOOOOOOXXXXXXXXXXXGOOOOOOOOOOOOXXXXXXXGOOOOOOOOOOOOOOOOOXXGOOOOOOXXXXXXXXXXXXXGOOOOOOOOOOOXXXXXXXXGOOOOOOOXXXXXXXXXXXXGOOOOOOOOOOXXXXXXXXX,0,256,0
32424,157,0,157,67,116,0,0,274,174,100,GOOOOOOOOOXXXXXXXXXXGOOOOOOOOOOOOOXXXXXXGOOOOOOOOOOXXXXXXXXXGOOOOOOOOOOOOOOOOXXXGOOOOOOXXXXXXXXXXXXXGOOOOOOOOOOOOOOOOOOOGOOOOOOOOXXXXXXXXXXXGOOOOOOOOOOOOXXXXXXXGOOOOOOOOOOOOOOOOOXXGOOOOOOXXXXXXXXXXXXXGOOOOOOOOOOOXXXXXXXXGOOOOOOOXXXXXXXXXXXXGOOOOOOOOOOXXXXXXXXX,0,256,0

32445,157,0,157,66,117,0,0,277,178,99,GOOOOOOOOOXXXXXXXXXXGOOOOOOOOOOOOOXXXXXXGOOOOOOOOOOXXXXXXXXXGOOOOOOOOOOOOOOOOXXXGOOOOOOXXXXXXXXXXXXXGOOOOOOOOOOOOOOOOOOOGOOOOOOOOXXXXXXXXXXXGOOOOOOOOOOOOXXXXXXXGOOOOOOOOOOOOOOOOOXXGOOOOOOXXXXXXXXXXXXXGOOOOOOOOOOOXXXXXXXXGOOOOOOOXXXXXXXXXXXXGOOOOOOOOOOXXXXXXXXX,0,256,0
32466,157,0,157,71,112,0,0,272,176,96,GOOOOOOOOOXXXXXXXXXXGOOOOOOOOOOOOOXXXXXXGOOOOOOOOOOXXXXXXXXXGOOOOOOOOOOOOOOOOXXXGOOOOOOXXXXXXXXXXXXXGOOOOOOOOOOOOOOOOOOOGOOOOOOOOXXXXXXXXXXXGOOOOOOOOOOOOXXXXXXXGOOOOOOOOOOOOOOOOOXXGOOOOOOXXXXXXXXXXXXXGOOOOOOOOOOOXXXXXXXXGOOOOOOOXXXXXXXXXXXXGOOOOOOOOOOXXXXXXXXX,0,256,0
32487,157,0,157,67,116,0,0,276,176,100,GOOOOOOOOOXXXXXXXXXXGOOOOOOOOOOOOOXXXXXXGOOOOOOOOOOXXXXXXXXXGOOOOOOOOOOOOOOOOXXXGOOOOOOXXXXXXXXXXXXXGOOOOOOOOOOOOOOOOOOOGOOOOOOOOXXXXXXXXXXXGOOOOOOOOOOOOXXXXXXXGOOOOOOOOOOOOOOOOOXXGOOOOOOXXXXXXXXXXXXXGOOOOOOOOOOOXXXXXXXXGOOOOOOOXXXXXXXXXXXXGOOOOOOOOOOXXXXXXXXX,0,256,0
32508,157,0,157,68,115,0,0,275,171,104,GOOOOOOOOOXXXXXXXXXXGOOOOOOOOOOOOOXXXXXXGOOOOOOOOOOXXXXXXXXXGOOOOOOOOOOOOOOOOXXXGOOOOOOXXXXXXXXXXXXXGOOOOOOOOOOOOOOOOOOOGOOOOOOOOXXXXXXXXXXXGOOOOOOOOOOOOXXXXXXXGOOOOOOOOOOOOOOOOOXXGOOOOOOXXXXXXXXXXXXXGOOOOOOOOOOOXXXXXXXXGOOOOOOOXXXXXXXXXXXXGOOOOOOOOOOXXXXXXXXX,0,256,0
32529,157,0,157,67,116,0,0,276,169,107,GOOOOOOOOOXXXXXXXXXXGOOOOOOOOOOOOOXXXXXXGOOOOOOOOOOXXXXXXXXXGOOOOOOOOOOOOOOOOXXXGOOOOOOXXXXXXXXXXXXXGOOOOOOOOOOOOOOOOOOOGOOOOOOOOXXXXXXXXXXXGOOOOOOOOOOOOXXXXXXXGOOOOOOOOOOOOOOOOOXXGOOOOOOXXXXXXXXXXXXXGOOOOOOOOOOOXXXXXXXXGOOOOOOOXXXXXXXXXXXXGOOOOOOOOOOXXXXXXXXX,0,256,0

32550,157,0,157,64,119,0,0,279,170,109,GOOOOOOOOOXXXXXXXXXXGOOOOOOOOOOOOOXXXXXXGOOOOOOOOOOXXXXXXXXXGOOOOOOOOOOOOOOOOXXXGOOOOOOXXXXXXXXXXXXXGOOOOOOOOOOOOOOOOOOOGOOOOOOOOXXXXXXXXXXXGOOOOOOOOOOOOXXXXXXXGOOOOOOOOOOOOOOOOOXXGOOOOOOXXXXXXXXXXXXXGOOOOOOOOOOOXXXXXXXXGOOOOOOOXXXXXXXXXXXXGOOOOOOOOOOXXXXXXXXX,0,256,0
32571,157,0,157,63,120,0,0,280,171,109,GOOOOOOOOOXXXXXXXXXXGOOOOOOOOOOOOOXXXXXXGOOOOOOOOOOXXXXXXXXXGOOOOOOOOOOOOOOOOXXXGOOOOOOXXXXXXXXXXXXXGOOOOOOOOOOOOOOOOOOOGOOOOOOOOXXXXXXXXXXXGOOOOOOOOOOOOXXXXXXXGOOOOOOOOOOOOOOOOOXXGOOOOOOXXXXXXXXXXXXXGOOOOOOOOOOOXXXXXXXXGOOOOOOOXXXXXXXXXXXXGOOOOOOOOOOXXXXXXXXX,0,256,0
32592,157,0,157,64,119,0,0,279,172,107,GOOOOOOOOOXXXXXXXXXXGOOOOOOOOOOOOOXXXXXXGOOOOOOOOOOXXXXXXXXXGOOOOOOOOOOOOOOOOXXXGOOOOOOXXXXXXXXXXXXXGOOOOOOOOOOOOOOOOOOOGOOOOOOOOXXXXXXXXXXXGOOOOOOOOOOOOXXXXXXXGOOOOOOOOOOOOOOOOOXXGOOOOOOXXXXXXXXXXXXXGOOOOOOOOOOOXXXXXXXXGOOOOOOOXXXXXXXXXXXXGOOOOOOOOOOXXXXXXXXX,0,256,0
32613,157,0,157,66,117,0,0,277,174,103,GOOOOOOOOOXXXXXXXXXXGOOOOOOOOOOOOOXXXXXXGOOOOOOOOOOXXXXXXXXXGOOOOOOOOOOOOOOOOXXXGOOOOOOXXXXXXXXXXXXXGOOOOOOOOOOOOOOOOOOOGOOOOOOOOXXXXXXXXXXXGOOOOOOOOOOOOXXXXXXXGOOOOOOOOOOOOOOOOOXXGOOOOOOXXXXXXXXXXXXXGOOOOOOOOOOOXXXXXXXXGOOOOOOOXXXXXXXXXXXXGOOOOOOOOOOXXXXXXXXX,0,256,0
32634,157,0,157,63,120,0,0,280,177,103,GOOOOOOOOOXXXXXXXXXXGOOOOOOOOOOOOOXXXXXXGOOOOOOOOOOXXXXXXXXXGOOOOOOOOOOOOOOOOXXXGOOOOOOXXXXXXXXXXXXXGOOOOOOOOOOOOOOOOOOOGOOOOOOOOXXXXXXXXXXXGOOOOOOOOOOOOXXXXXXXGOOOOOOOOOOOOOOOOOXXGOOOOOOXXXXXXXXXXXXXGOOOOOOOOOOOXXXXXXXXGOOOOOOOXXXXXXXXXXXXGOOOOOOOOOOXXXXXXXXX,0,256,0

32655,157,0,157,69,114,0,0,274,173,101,GOOOOOOOOOXXXXXXXXXXGOOOOOOOOOOOOOXXXXXXGOOOOOOOOOOXXXXXXXXXGOOOOOOOOOOOOOOOOXXXGOOOOOOXXXXXXXXXXXXXGOOOOOOOOOOOOOOOOOOOGOOOOOOOOXXXXXXXXXXXGOOOOOOOOOOOOXXXXXXXGOOOOOOOOOOOOOOOOOXXGOOOOOOXXXXXXXXXXXXXGOOOOOOOOOOOXXXXXXXXGOOOOOOOXXXXXXXXXXXXGOOOOOOOOOOXXXXXXXXX,0,256,0
32676,157,0,157,69,114,0,0,274,174,100,GOOOOOOOOOXXXXXXXXXXGOOOOOOOOOOOOOXXXXXXGOOOOOOOOOOXXXXXXXXXGOOOOOOOOOOOOOOOOXXXGOOOOOOXXXXXXXXXXXXXGOOOOOOOOOOOOOOOOOOOGOOOOOOOOXXXXXXXXXXXGOOOOOOOOOOOOXXXXXXXGOOOOOOOOOOOOOOOOOXXGOOOOOOXXXXXXXXXXXXXGOOOOOOOOOOOXXXXXXXXGOOOOOOOXXXXXXXXXXXXGOOOOOOOOOOXXXXXXXXX,0,256,0
32697,157,0,157,72,111,0,0,271,170,101,GOOOOOOOOOXXXXXXXXXXGOOOOOOOOOOOOOXXXXXXGOOOOOOOOOOXXXXXXXXXGOOOOOOOOOOOOOOOOXXXGOOOOOOXXXXXXXXXXXXXGOOOOOOOOOOOOOOOOOOOGOOOOOOOOXXXXXXXXXXXGOOOOOOOOOOOOXXXXXXXGOOOOOOOOOOOOOOOOOXXGOOOOOOXXXXXXXXXXXXXGOOOOOOOOOOOXXXXXXXXGOOOOOOOXXXXXXXXXXXXGOOOOOOOOOOXXXXXXXXX,0,256,0
32718,157,0,157,69,114,0,0,274,167,107,GOOOOOOOOOXXXXXXXXXXGOOOOOOOOOOOOOXXXXXXGOOOOOOOOOOXXXXXXXXXGOOOOOOOOOOOOOOOOXXXGOOOOOOXXXXXXXXXXXXXGOOOOOOOOOOOOOOOOOOOGOOOOOOOOXXXXXXXXXXXGOOOOOOOOOOOOXXXXXXXGOOOOOOOOOOOOOOOOOXXGOOOOOOXXXXXXXXXXXXXGOOOOOOOOOOOXXXXXXXXGOOOOOOOXXXXXXXXXXXXGOOOOOOOOOOXXXXXXXXX,0,256,0
32739,157,0,157,66,117,0,0,278,170,108,GOOOOOOOOOXXXXXXXXXXGOOOOOOOOOOOOOXXXXXXGOOOOOOOOOOXXXXXXXXXGOOOOOOOOOOOOOOOOXXXGOOOOOOXXXXXXXXXXXXXGOOOOOOOOOOOOOOOOOOOGOOOOOOOOXXXXXXXXXXXGOOOOOOOOOOOOXXXXXXXGOOOOOOOOOOOOOOOOOXXGOOOOOOXXXXXXXXXXXXXGOOOOOOOOOOOXXXXXXXXGOOOOOOOXXXXXXXXXXXXGOOOOOOOOOOXXXXXXXXX,0,256,0

32760,157,0,157,69,114,0,0,275,168,107,GOOOOOOOOOXXXXXXXXXXGOOOOOOOOOOOOOXXXXXXGOOOOOOOOOOXXXXXXXXXGOOOOOOOOOOOOOOOOXXXGOOOOOOXXXXXXXXXXXXXGOOOOOOOOOOOOOOOOOOOGOOOOOOOOXXXXXXXXXXXGOOOOOOOOOOOOXXXXXXXGOOOOOOOOOOOOOOOOOXXGOOOOOOXXXXXXXXXXXXXGOOOOOOOOOOOXXXXXXXXGOOOOOOOXXXXXXXXXXXXGOOOOOOOOOOXXXXXXXXX,0,256,0
32781,157,0,157,65,118,0,0,278,169,109,GOOOOOOOOOXXXXXXXXXXGOOOOOOOOOOOOOXXXXXXGOOOOOOOOOOXXXXXXXXXGOOOOOOOOOOOOOOOOXXXGOOOOOOXXXXXXXXXXXXXGOOOOOOOOOOOOOOOOOOOGOOOOOOOOXXXXXXXXXXXGOOOOOOOOOOOOXXXXXXXGOOOOOOOOOOOOOOOOOXXGOOOOOOXXXXXXXXXXXXXGOOOOOOOOOOOXXXXXXXXGOOOOOOOXXXXXXXXXXXXGOOOOOOOOOOXXXXXXXXX,0,256,0
32802,157,0,157,67,116,0,0,277,170,107,GOOOOOOOOOXXXXXXXXXXGOOOOOOOOOOOOOXXXXXXGOOOOOOOOOOXXXXXXXXXGOOOOOOOOOOOOOOOOXXXGOOOOOOXXXXXXXXXXXXXGOOOOOOOOOOOOOOOOOOOGOOOOOOOOXXXXXXXXXXXGOOOOOOOOOOOOXXXXXXXGOOOOOOOOOOOOOOOOOXXGOOOOOOXXXXXXXXXXXXXGOOOOOOOOOOOXXXXXXXXGOOOOOOOXXXXXXXXXXXXGOOOOOOOOOOXXXXXXXXX,0,256,0
32823,157,0,157,67,116,0,0,277,175,102,GOOOOOOOOOXXXXXXXXXXGOOOOOOOOOOOOOXXXXXXGOOOOOOOOOOXXXXXXXXXGOOOOOOOOOOOOOOOOXXXGOOOOOOXXXXXXXXXXXXXGOOOOOOOOOOOOOOOOOOOGOOOOOOOOXXXXXXXXXXXGOOOOOOOOOOOOXXXXXXXGOOOOOOOOOOOOOOOOOXXGOOOOOOXXXXXXXXXXXXXGOOOOOOOOOOOXXXXXXXXGOOOOOOOXXXXXXXXXXXXGOOOOOOOOOOXXXXXXXXX,0,256,0
32844,157,0,157,66,117,0,0,278,177,101,GOOOOOOOOOXXXXXXXXXXGOOOOOOOOOOOOOXXXXXXGOOOOOOOOOOXXXXXXXXXGOOOOOOOOOOOOOOOOXXXGOOOOOOXXXXXXXXXXXXXGOOOOOOOOOOOOOOOOOOOGOOOOOOOOXXXXXXXXXXXGOOOOOOOOOOOOXXXXXXXGOOOOOOOOOOOOOOOOOXXGOOOOOOXXXXXXXXXXXXXGOOOOOOOOOOOXXXXXXXXGOOOOOOOXXXXXXXXXXXXGOOOOOOOOOOXXXXXXXXX,0,256,0

32865,157,0,157,63,120,0,0,281,173,108,GOOOOOOOOOXXXXXXXXXXGOOOOOOOOOOOOOXXXXXXGOOOOOOOOOOXXXXXXXXXGOOOOOOOOOOOOOOOOXXXGOOOOOOXXXXXXXXXXXXXGOOOOOOOOOOOOOOOOOOOGOOOOOOOOXXXXXXXXXXXGOOOOOOOOOOOOXXXXXXXGOOOOOOOOOOOOOOOOOXXGOOOOOOXXXXXXXXXXXXXGOOOOOOOOOOOXXXXXXXXGOOOOOOOXXXXXXXXXXXXGOOOOOOOOOOXXXXXXXXX,0,256,0
32886,157,0,157,67,116,0,0,275,171,104,GOOOOOOOOOXXXXXXXXXXGOOOOOOOOOOOOOXXXXXXGOOOOOOOOOOXXXXXXXXXGOOOOOOOOOOOOOOOOXXXGOOOOOOXXXXXXXXXXXXXGOOOOOOOOOOOOOOOOOOOGOOOOOOOOXXXXXXXXXXXGOOOOOOOOOOOOXXXXXXXGOOOOOOOOOOOOOOOOOXXGOOOOOOXXXXXXXXXXXXXGOOOOOOOOOOOXXXXXXXXGOOOOOOOXXXXXXXXXXXXGOOOOOOOOOOXXXXXXXXX,0,256,0
32907,157,0,157,67,116,0,0,276,175,101,GOOOOOOOOOXXXXXXXXXXGOOOOOOOOOOOOOXXXXXXGOOOOOOOOOOXXXXXXXXXGOOOOOOOOOOOOOOOOXXXGOOOOOOXXXXXXXXXXXXXGOOOOOOOOOOOOOOOOOOOGOOOOOOOOXXXXXXXXXXXGOOOOOOOOOOOOXXXXXXXGOOOOOOOOOOOOOOOOOXXGOOOOOOXXXXXXXXXXXXXGOOOOOOOOOOOXXXXXXXXGOOOOOOOXXXXXXXXXXXXGOOOOOOOOOOXXXXXXXXX,0,256,0
32928,157,0,157,65,118,0,0,278,176,102,GOOOOOOOOOXXXXXXXXXXGOOOOOOOOOOOOOXXXXXXGOOOOOOOOOOXXXXXXXXXGOOOOOOOOOOOOOOOOXXXGOOOOOOXXXXXXXXXXXXXGOOOOOOOOOOOOOOOOOOOGOOOOOOOOXXXXXXXXXXXGOOOOOOOOOOOOXXXXXXXGOOOOOOOOOOOOOOOOOXXGOOOOOOXXXXXXXXXXXXXGOOOOOOOOOOOXXXXXXXXGOOOOOOOXXXXXXXXXXXXGOOOOOOOOOOXXXXXXXXX,0,256,0
32949,157,0,157,68,115,0,0,275,180,95,GOOOOOOOOOXXXXXXXXXXGOOOOOOOOOOOOOXXXXXXGOOOOOOOOOOXXXXXXXXXGOOOOOOOOOOOOOOOOXXXGOOOOOOXXXXXXXXXXXXXGOOOOOOOOOOOOOOOOOOOGOOOOOOOOXXXXXXXXXXXGOOOOOOOOOOOOXXXXXXXGOOOOOOOOOOOOOOOOOXXGOOOOOOXXXXXXXXXXXXXGOOOOOOOOOOOXXXXXXXXGOOOOOOOXXXXXXXXXXXXGOOOOOOOOOOXXXXXXXXX,0,256,0

32970,157,0,157,63,120,0,0,280,179,101,GOOOOOOOOOXXXXXXXXXXGOOOOOOOOOOOOOXXXXXXGOOOOOOOOOOXXXXXXXXXGOOOOOOOOOOOOOOOOXXXGOOOOOOXXXXXXXXXXXXXGOOOOOOOOOOOOOOOOOOOGOOOOOOOOXXXXXXXXXXXGOOOOOOOOOOOOXXXXXXXGOOOOOOOOOOOOOOOOOXXGOOOOOOXXXXXXXXXXXXXGOOOOOOOOOOOXXXXXXXXGOOOOOOOXXXXXXXXXXXXGOOOOOOOOOOXXXXXXXXX,0,256,0
32991,157,0,157,71,112,0,0,273,171,102,GOOOOOOOOOXXXXXXXXXXGOOOOOOOOOOOOOXXXXXXGOOOOOOOOOOXXXXXXXXXGOOOOOOOOOOOOOOOOXXXGOOOOOOXXXXXXXXXXXXXGOOOOOOOOOOOOOOOOOOOGOOOOOOOOXXXXXXXXXXXGOOOOOOOOOOOOXXXXXXXGOOOOOOOOOOOOOOOOOXXGOOOOOOXXXXXXXXXXXXXGOOOOOOOOOOOXXXXXXXXGOOOOOOOXXXXXXXXXXXXGOOOOOOOOOOXXXXXXXXX,0,256,0
33012,157,0,157,71,112,0,0,273,177,96,GOOOOOOOOOXXXXXXXXXXGOOOOOOOOOOOOOXXXXXXGOOOOOOOOOOXXXXXXXXXGOOOOOOOOOOOOOOOOXXXGOOOOOOXXXXXXXXXXXXXGOOOOOOOOOOOOOOOOOOOGOOOOOOOOXXXXXXXXXXXGOOOOOOOOOOOOXXXXXXXGOOOOOOOOOOOOOOOOOXXGOOOOOOXXXXXXXXXXXXXGOOOOOOOOOOOXXXXXXXXGOOOOOOOXXXXXXXXXXXXGOOOOOOOOOOXXXXXXXXX,0,256,0
33033,157,0,157,74,109,0,0,270,178,92,GOOOOOOOOOXXXXXXXXXXGOOOOOOOOOOOOOXXXXXXGOOOOOOOOOOXXXXXXXXXGOOOOOOOOOOOOOOOOXXXGOOOOOOXXXXXXXXXXXXXGOOOOOOOOOOOOOOOOOOOGOOOOOOOOXXXXXXXXXXXGOOOOOOOOOOOOXXXXXXXGOOOOOOOOOOOOOOOOOXXGOOOOOOXXXXXXXXXXXXXGOOOOOOOOOOOXXXXXXXXGOOOOOOOXXXXXXXXXXXXGOOOOOOOOOOXXXXXXXXX,0,256,0
33054,157,0,157,77,106,0,0,267,170,97,GOOOOOOOOOXXXXXXXXXXGOOOOOOOOOOOOOXXXXXXGOOOOOOOOOOXXXXXXXXXGOOOOOOOOOOOOOOOOXXXGOOOOOOXXXXXXXXXXXXXGOOOOOOOOOOOOOOOOOOOGOOOOOOOOXXXXXXXXXXXGOOOOOOOOOOOOXXXXXXXGOOOOOOOOOOOOOOOOOXXGOOOOOOXXXXXXXXXXXXXGOOOOOOOOOOOXXXXXXXXGOOOOOOOXXXXXXXXXXXXGOOOOOOOOOOXXXXXXXXX,0,256,0

33075,157,0,157,70,113,0,0,273,169,104,GOOOOOOOOOXXXXXXXXXXGOOOOOOOOOOOOOXXXXXXGOOOOOOOOOOXXXXXXXXXGOOOOOOOOOOOOOOOOXXXGOOOOOOXXXXXXXXXXXXXGOOOOOOOOOOOOOOOOOOOGOOOOOOOOXXXXXXXXXXXGOOOOOOOOOOOOXXXXXXXGOOOOOOOOOOOOOOOOOXXGOOOOOOXXXXXXXXXXXXXGOOOOOOOOOOOXXXXXXXXGOOOOOOOXXXXXXXXXXXXGOOOOOOOOOOXXXXXXXXX,0,256,0
33096,157,0,157,64,119,0,0,278,176,102,GOOOOOOOOOXXXXXXXXXXGOOOOOOOOOOOOOXXXXXXGOOOOOOOOOOXXXXXXXXXGOOOOOOOOOOOOOOOOXXXGOOOOOOXXXXXXXXXXXXXGOOOOOOOOOOOOOOOOOOOGOOOOOOOOXXXXXXXXXXXGOOOOOOOOOOOOXXXXXXXGOOOOOOOOOOOOOOOOOXXGOOOOOOXXXXXXXXXXXXXGOOOOOOOOOOOXXXXXXXXGOOOOOOOXXXXXXXXXXXXGOOOOOOOOOOXXXXXXXXX,0,256,0
33117,157,0,157,64,119,0,0,280,172,108,GOOOOOOOOOXXXXXXXXXXGOOOOOOOOOOOOOXXXXXXGOOOOOOOOOOXXXXXXXXXGOOOOOOOOOOOOOOOOXXXGOOOOOOXXXXXXXXXXXXXGOOOOOOOOOOOOOOOOOOOGOOOOOOOOXXXXXXXXXXXGOOOOOOOOOOOOXXXXXXXGOOOOOOOOOOOOOOOOOXXGOOOOOOXXXXXXXXXXXXXGOOOOOOOOOOOXXXXXXXXGOOOOOOOXXXXXXXXXXXXGOOOOOOOOOOXXXXXXXXX,0,256,0
33138,157,0,157,65,118,0,0,279,176,103,GOOOOOOOOOXXXXXXXXXXGOOOOOOOOOOOOOXXXXXXGOOOOOOOOOOXXXXXXXXXGOOOOOOOOOOOOOOOOXXXGOOOOOOXXXXXXXXXXXXXGOOOOOOOOOOOOOOOOOOOGOOOOOOOOXXXXXXXXXXXGOOOOOOOOOOOOXXXXXXXGOOOOOOOOOOOOOOOOOXXGOOOOOOXXXXXXXXXXXXXGOOOOOOOOOOOXXXXXXXXGOOOOOOOXXXXXXXXXXXXGOOOOOOOOOOXXXXXXXXX,0,256,0
33159,157,0,157,65,118,0,0,279,177,102,GOOOOOOOOOXXXXXXXXXXGOOOOOOOOOOOOOXXXXXXGOOOOOOOOOOXXXXXXXXXGOOOOOOOOOOOOOOOOXXXGOOOOOOXXXXXXXXXXXXXGOOOOOOOOOOOOOOOOOOOGOOOOOOOOXXXXXXXXXXXGOOOOOOOOOOOOXXXXXXXGOOOOOOOOOOOOOOOOOXXGOOOOOOXXXXXXXXXXXXXGOOOOOOOOOOOXXXXXXXXGOOOOOOOXXXXXXXXXXXXGOOOOOOOOOOXXXXXXXXX,0,256,0

33180,157,0,157,69,114,0,0,274,174,100,GOOOOOOOOOXXXXXXXXXXGOOOOOOOOOOOOOXXXXXXGOOOOOOOOOOXXXXXXXXXGOOOOOOOOOOOOOOOOXXXGOOOOOOXXXXXXXXXXXXXGOOOOOOOOOOOOOOOOOOOGOOOOOOOOXXXXXXXXXXXGOOOOOOOOOOOOXXXXXXXGOOOOOOOOOOOOOOOOOXXGOOOOOOXXXXXXXXXXXXXGOOOOOOOOOOOXXXXXXXXGOOOOOOOXXXXXXXXXXXXGOOOOOOOOOOXXXXXXXXX,0,256,0
33201,157,0,157,69,114,0,0,273,175,98,GOOOOOOOOOXXXXXXXXXXGOOOOOOOOOOOOOXXXXXXGOOOOOOOOOOXXXXXXXXXGOOOOOOOOOOOOOOOOXXXGOOOOOOXXXXXXXXXXXXXGOOOOOOOOOOOOOOOOOOOGOOOOOOOOXXXXXXXXXXXGOOOOOOOOOOOOXXXXXXXGOOOOOOOOOOOOOOOOOXXGOOOOOOXXXXXXXXXXXXXGOOOOOOOOOOOXXXXXXXXGOOOOOOOXXXXXXXXXXXXGOOOOOOOOOOXXXXXXXXX,0,256,0
33222,157,0,157,69,114,0,0,274,171,103,GOOOOOOOOOXXXXXXXXXXGOOOOOOOOOOOOOXXXXXXGOOOOOOOOOOXXXXXXXXXGOOOOOOOOOOOOOOOOXXXGOOOOOOXXXXXXXXXXXXXGOOOOOOOOOOOOOOOOOOOGOOOOOOOOXXXXXXXXXXXGOOOOOOOOOOOOXXXXXXXGOOOOOOOOOOOOOOOOOXXGOOOOOOXXXXXXXXXXXXXGOOOOOOOOOOOXXXXXXXXGOOOOOOOXXXXXXXXXXXXGOOOOOOOOOOXXXXXXXXX,0,256,0
33243,157,0,157,63,120,0,0,279,172,107,GOOOOOOOOOXXXXXXXXXXGOOOOOOOOOOOOOXXXXXXGOOOOOOOOOOXXXXXXXXXGOOOOOOOOOOOOOOOOXXXGOOOOOOXXXXXXXXXXXXXGOOOOOOOOOOOOOOOOOOOGOOOOOOOOXXXXXXXXXXXGOOOOOOOOOOOOXXXXXXXGOOOOOOOOOOOOOOOOOXXGOOOOOOXXXXXXXXXXXXXGOOOOOOOOOOOXXXXXXXXGOOOOOOOXXXXXXXXXXXXGOOOOOOOOOOXXXXXXXXX,0,256,0
33264,157,0,157,60,123,0,0,283,172,111,GOOOOOOOOOXXXXXXXXXXGOOOOOOOOOOOOOXXXXXXGOOOOOOOOOOXXXXXXXXXGOOOOOOOOOOOOOOOOXXXGOOOOOOXXXXXXXXXXXXXGOOOOOOOOOOOOOOOOOOOGOOOOOOOOXXXXXXXXXXXGOOOOOOOOOOOOXXXXXXXGOOOOOOOOOOOOOOOOOXXGOOOOOOXXXXXXXXXXXXXGOOOOOOOOOOOXXXXXXXXGOOOOOOOXXXXXXXXXXXXGOOOOOOOOOOXXXXXXXXX,0,256,0

33285,157,0,157,60,123,0,0,283,174,109,GOOOOOOOOOXXXXXXXXXXGOOOOOOOOOOOOOXXXXXXGOOOOOOOOOOXXXXXXXXXGOOOOOOOOOOOOOOOOXXXGOOOOOOXXXXXXXXXXXXXGOOOOOOOOOOOOOOOOOOOGOOOOOOOOXXXXXXXXXXXGOOOOOOOOOOOOXXXXXXXGOOOOOOOOOOOOOOOOOXXGOOOOOOXXXXXXXXXXXXXGOOOOOOOOOOOXXXXXXXXGOOOOOOOXXXXXXXXXXXXGOOOOOOOOOOXXXXXXXXX,0,256,0
33306,157,0,157,58,125,0,0,285,178,107,GOOOOOOOOOXXXXXXXXXXGOOOOOOOOOOOOOXXXXXXGOOOOOOOOOOXXXXXXXXXGOOOOOOOOOOOOOOOOXXXGOOOOOOXXXXXXXXXXXXXGOOOOOOOOOOOOOOOOOOOGOOOOOOOOXXXXXXXXXXXGOOOOOOOOOOOOXXXXXXXGOOOOOOOOOOOOOOOOOXXGOOOOOOXXXXXXXXXXXXXGOOOOOOOOOOOXXXXXXXXGOOOOOOOXXXXXXXXXXXXGOOOOOOOOOOXXXXXXXXX,0,256,0
33327,157,0,157,65,118,0,0,278,173,105,GOOOOOOOOOXXXXXXXXXXGOOOOOOOOOOOOOXXXXXXGOOOOOOOOOOXXXXXXXXXGOOOOOOOOOOOOOOOOXXXGOOOOOOXXXXXXXXXXXXXGOOOOOOOOOOOOOOOOOOOGOOOOOOOOXXXXXXXXXXXGOOOOOOOOOOOOXXXXXXXGOOOOOOOOOOOOOOOOOXXGOOOOOOXXXXXXXXXXXXXGOOOOOOOOOOOXXXXXXXXGOOOOOOOXXXXXXXXXXXXGOOOOOOOOOOXXXXXXXXX,0,256,0
33348,157,0,157,67,116,0,0,276,179,97,GOOOOOOOOOXXXXXXXXXXGOOOOOOOOOOOOOXXXXXXGOOOOOOOOOOXXXXXXXXXGOOOOOOOOOOOOOOOOXXXGOOOOOOXXXXXXXXXXXXXGOOOOOOOOOOOOOOOOOOOGOOOOOOOOXXXXXXXXXXXGOOOOOOOOOOOOXXXXXXXGOOOOOOOOOOOOOOOOOXXGOOOOOOXXXXXXXXXXXXXGOOOOOOOOOOOXXXXXXXXGOOOOOOOXXXXXXXXXXXXGOOOOOOOOOOXXXXXXXXX,0,256,0
33369,157,0,157,70,113,0,0,273,178,95,GOOOOOOOOOXXXXXXXXXXGOOOOOOOOOOOOOXXXXXXGOOOOOOOOOOXXXXXXXXXGOOOOOOOOOOOOOOOOXXXGOOOOOOXXXXXXXXXXXXXGOOOOOOOOOOOOOOOOOOOGOOOOOOOOXXXXXXXXXXXGOOOOOOOOOOOOXXXXXXXGOOOOOOOOOOOOOOOOOXXGOOOOOOXXXXXXXXXXXXXGOOOOOOOOOOOXXXXXXXXGOOOOOOOXXXXXXXXXXXXGOOOOOOOOOOXXXXXXXXX,0,256,0

33390,157,0,157,72,111,0,0,271,178,93,GOOOOOOOOOXXXXXXXXXXGOOOOOOOOOOOOOXXXXXXGOOOOOOOOOOXXXXXXXXXGOOOOOOOOOOOOOOOOXXXGOOOOOOXXXXXXXXXXXXXGOOOOOOOOOOOOOOOOOOOGOOOOOOOOXXXXXXXXXXXGOOOOOOOOOOOOXXXXXXXGOOOOOOOOOOOOOOOOOXXGOOOOOOXXXXXXXXXXXXXGOOOOOOOOOOOXXXXXXXXGOOOOOOOXXXXXXXXXXXXGOOOOOOOOOOXXXXXXXXX,0,256,0
33411,157,0,157,72,111,0,0,271,175,96,GOOOOOOOOOXXXXXXXXXXGOOOOOOOOOOOOOXXXXXXGOOOOOOOOOOXXXXXXXXXGOOOOOOOOOOOOOOOOXXXGOOOOOOXXXXXXXXXXXXXGOOOOOOOOOOOOOOOOOOOGOOOOOOOOXXXXXXXXXXXGOOOOOOOOOOOOXXXXXXXGOOOOOOOOOOOOOOOOOXXGOOOOOOXXXXXXXXXXXXXGOOOOOOOOOOOXXXXXXXXGOOOOOOOXXXXXXXXXXXXGOOOOOOOOOOXXXXXXXXX,0,256,0
33432,157,0,157,70,113,0,0,272,177,95,GOOOOOOOOOXXXXXXXXXXGOOOOOOOOOOOOOXXXXXXGOOOOOOOOOOXXXXXXXXXGOOOOOOOOOOOOOOOOXXXGOOOOOOXXXXXXXXXXXXXGOOOOOOOOOOOOOOOOOOOGOOOOOOOOXXXXXXXXXXXGOOOOOOOOOOOOXXXXXXXGOOOOOOOOOOOOOOOOOXXGOOOOOOXXXXXXXXXXXXXGOOOOOOOOOOOXXXXXXXXGOOOOOOOXXXXXXXXXXXXGOOOOOOOOOOXXXXXXXXX,0,256,0
33453,157,0,157,68,115,0,0,275,178,97,GOOOOOOOOOXXXXXXXXXXGOOOOOOOOOOOOOXXXXXXGOOOOOOOOOOXXXXXXXXXGOOOOOOOOOOOOOOOOXXXGOOOOOOXXXXXXXXXXXXXGOOOOOOOOOOOOOOOOOOOGOOOOOOOOXXXXXXXXXXXGOOOOOOOOOOOOXXXXXXXGOOOOOOOOOOOOOOOOOXXGOOOOOOXXXXXXXXXXXXXGOOOOOOOOOOOXXXXXXXXGOOOOOOOXXXXXXXXXXXXGOOOOOOOOOOXXXXXXXXX,0,256,0
33474,157,0,157,67,116,0,0,276,182,94,GOOOOOOOOOXXXXXXXXXXGOOOOOOOOOOOOOXXXXXXGOOOOOOOOOOXXXXXXXXXGOOOOOOOOOOOOOOOOXXXGOOOOOOXXXXXXXXXXXXXGOOOOOOOOOOOOOOOOOOOGOOOOOOOOXXXXXXXXXXXGOOOOOOOOOOOOXXXXXXXGOOOOOOOOOOOOOOOOOXXGOOOOOOXXXXXXXXXXXXXGOOOOOOOOOOOXXXXXXXXGOOOOOOOXXXXXXXXXXXXGOOOOOOOOOOXXXXXXXXX,0,256,0

33495,157,0,157,69,114,0,0,274,179,95,GOOOOOOOOOXXXXXXXXXXGOOOOOOOOOOOOOXXXXXXGOOOOOOOOOOXXXXXXXXXGOOOOOOOOOOOOOOOOXXXGOOOOOOXXXXXXXXXXXXXGOOOOOOOOOOOOOOOOOOOGOOOOOOOOXXXXXXXXXXXGOOOOOOOOOOOOXXXXXXXGOOOOOOOOOOOOOOOOOXXGOOOOOOXXXXXXXXXXXXXGOOOOOOOOOOOXXXXXXXXGOOOOOOOXXXXXXXXXXXXGOOOOOOOOOOXXXXXXXXX,0,256,0
33516,157,0,157,70,113,0,0,272,176,96,GOOOOOOOOOXXXXXXXXXXGOOOOOOOOOOOOOXXXXXXGOOOOOOOOOOXXXXXXXXXGOOOOOOOOOOOOOOOOXXXGOOOOOOXXXXXXXXXXXXXGOOOOOOOOOOOOOOOOOOOGOOOOOOOOXXXXXXXXXXXGOOOOOOOOOOOOXXXXXXXGOOOOOOOOOOOOOOOOOXXGOOOOOOXXXXXXXXXXXXXGOOOOOOOOOOOXXXXXXXXGOOOOOOOXXXXXXXXXXXXGOOOOOOOOOOXXXXXXXXX,0,256,0
33537,158,1,157,72,110,0,0,270,176,94,GOOOOOOOOOXXXXXXXXXXGOOOOOOOOOOOOOXXXXXXGOOOOOOOOOOAXXXXXXXXGOOOOOOOOOOOOOOOOXXXGOOOOOOXXXXXXXXXXXXXGOOOOOOOOOOOOOOOOOOOGOOOOOOOOXXXXXXXXXXXGOOOOOOOOOOOOXXXXXXXGOOOOOOOOOOOOOOOOOXXGOOOOOOXXXXXXXXXXXXXGOOOOOOOOOOOXXXXXXXXGOOOOOOOXXXXXXXXXXXXGOOOOOOOOOOXXXXXXXXX,0,256,0
33558,158,1,157,73,109,0,0,268,175,93,GOOOOOOOOOXXXXXXXXXXGOOOOOOOOOOOOOXXXXXXGOOOOOOOOOOAXXXXXXXXGOOOOOOOOOOOOOOOOXXXGOOOOOOXXXXXXXXXXXXXGOOOOOOOOOOOOOOOOOOOGOOOOOOOOXXXXXXXXXXXGOOOOOOOOOOOOXXXXXXXGOOOOOOOOOOOOOOOOOXXGOOOOOOXXXXXXXXXXXXXGOOOOOOOOOOOXXXXXXXXGOOOOOOOXXXXXXXXXXXXGOOOOOOOOOOXXXXXXXXX,0,256,0
33579,158,1,157,72,110,0,0,270,169,101,GOOOOOOOOOXXXXXXXXXXGOOOOOOOOOOOOOXXXXXXGOOOOOOOOOOAXXXXXXXXGOOOOOOOOOOOOOOOOXXXGOOOOOOXXXXXXXXXXXXXGOOOOOOOOOOOOOOOOOOOGOOOOOOOOXXXXXXXXXXXGOOOOOOOOOOOOXXXXXXXGOOOOOOOOOOOOOOOOOXXGOOOOOOXXXXXXXXXXXXXGOOOOOOOOOOOXXXXXXXXGOOOOOOOXXXXXXXXXXXXGOOOOOOOOOOXXXXXXXXX,0,256,0

33600,158,1,157,72,110,0,0,270,175,95,GOOOOOOOOOXXXXXXXXXXGOOOOOOOOOOOOOXXXXXXGOOOOOOOOOOAXXXXXXXXGOOOOOOOOOOOOOOOOXXXGOOOOOOXXXXXXXXXXXXXGOOOOOOOOOOOOOOOOOOOGOOOOOOOOXXXXXXXXXXXGOOOOOOOOOOOOXXXXXXXGOOOOOOOOOOOOOOOOOXXGOOOOOOXXXXXXXXXXXXXGOOOOOOOOOOOXXXXXXXXGOOOOOOOXXXXXXXXXXXXGOOOOOOOOOOXXXXXXXXX,0,256,0
33621,158,1,157,72,110,0,0,270,178,92,GOOOOOOOOOXXXXXXXXXXGOOOOOOOOOOOOOXXXXXXGOOOOOOOOOOAXXXXXXXXGOOOOOOOOOOOOOOOOXXXGOOOOOOXXXXXXXXXXXXXGOOOOOOOOOOOOOOOOOOOGOOOOOOOOXXXXXXXXXXXGOOOOOOOOOOOOXXXXXXXGOOOOOOOOOOOOOOOOOXXGOOOOOOXXXXXXXXXXXXXGOOOOOOOOOOOXXXXXXXXGOOOOOOOXXXXXXXXXXXXGOOOOOOOOOOXXXXXXXXX,0,256,0
33642,158,0,158,69,113,0,0,273,176,97,GOOOOOOOOOXXXXXXXXXXGOOOOOOOOOOOOOXXXXXXGOOOOOOOOOOOXXXXXXXXGOOOOOOOOOOOOOOOOXXXGOOOOOOXXXXXXXXXXXXXGOOOOOOOOOOOOOOOOOOOGOOOOOOOOXXXXXXXXXXXGOOOOOOOOOOOOXXXXXXXGOOOOOOOOOOOOOOOOOXXGOOOOOOXXXXXXXXXXXXXGOOOOOOOOOOOXXXXXXXXGOOOOOOOXXXXXXXXXXXXGOOOOOOOOOOXXXXXXXXX,0,256,0
33663,158,0,158,68,114,0,0,274,177,97,GOOOOOOOOOXXXXXXXXXXGOOOOOOOOOOOOOXXXXXXGOOOOOOOOOOOXXXXXXXXGOOOOOOOOOOOOOOOOXXXGOOOOOOXXXXXXXXXXXXXGOOOOOOOOOOOOOOOOOOOGOOOOOOOOXXXXXXXXXXXGOOOOOOOOOOOOXXXXXXXGOOOOOOOOOOOOOOOOOXXGOOOOOOXXXXXXXXXXXXXGOOOOOOOOOOOXXXXXXXXGOOOOOOOXXXXXXXXXXXXGOOOOOOOOOOXXXXXXXXX,0,256,0
33684,158,0,158,73,109,0,0,269,172,97,GOOOOOOOOOXXXXXXXXXXGOOOOOOOOOOOOOXXXXXXGOOOOOOOOOOOXXXXXXXXGOOOOOOOOOOOOOOOOXXXGOOOOOOXXXXXXXXXXXXXGOOOOOOOOOOOOOOOOOOOGOOOOOOOOXXXXXXXXXXXGOOOOOOOOOOOOXXXXXXXGOOOOOOOOOOOOOOOOOXXGOOOOOOXXXXXXXXXXXXXGOOOOOOOOOOOXXXXXXXXGOOOOOOOXXXXXXXXXXXXGOOOOOOOOOOXXXXXXXXX,0,256,0

33705,158,0,158,78,104,0,0,264,173,91,GOOOOOOOOOXXXXXXXXXXGOOOOOOOOOOOOOXXXXXXGOOOOOOOOOOOXXXXXXXXGOOOOOOOOOOOOOOOOXXXGOOOOOOXXXXXXXXXXXXXGOOOOOOOOOOOOOOOOOOOGOOOOOOOOXXXXXXXXXXXGOOOOOOOOOOOOXXXXXXXGOOOOOOOOOOOOOOOOOXXGOOOOOOXXXXXXXXXXXXXGOOOOOOOOOOOXXXXXXXXGOOOOOOOXXXXXXXXXXXXGOOOOOOOOOOXXXXXXXXX,0,256,0
33726,158,0,158,69,113,0,0,273,175,98,GOOOOOOOOOXXXXXXXXXXGOOOOOOOOOOOOOXXXXXXGOOOOOOOOOOOXXXXXXXXGOOOOOOOOOOOOOOOOXXXGOOOOOOXXXXXXXXXXXXXGOOOOOOOOOOOOOOOOOOOGOOOOOOOOXXXXXXXXXXXGOOOOOOOOOOOOXXXXXXXGOOOOOOOOOOOOOOOOOXXGOOOOOOXXXXXXXXXXXXXGOOOOOOOOOOOXXXXXXXXGOOOOOOOXXXXXXXXXXXXGOOOOOOOOOOXXXXXXXXX,0,256,0
33747,158,0,158,67,115,0,0,275,172,103,GOOOOOOOOOXXXXXXXXXXGOOOOOOOOOOOOOXXXXXXGOOOOOOOOOOOXXXXXXXXGOOOOOOOOOOOOOOOOXXXGOOOOOOXXXXXXXXXXXXXGOOOOOOOOOOOOOOOOOOOGOOOOOOOOXXXXXXXXXXXGOOOOOOOOOOOOXXXXXXXGOOOOOOOOOOOOOOOOOXXGOOOOOOXXXXXXXXXXXXXGOOOOOOOOOOOXXXXXXXXGOOOOOOOXXXXXXXXXXXXGOOOOOOOOOOXXXXXXXXX,0,256,0
33768,158,0,158,65,117,0,0,276,175,101,GOOOOOOOOOXXXXXXXXXXGOOOOOOOOOOOOOXXXXXXGOOOOOOOOOOOXXXXXXXXGOOOOOOOOOOOOOOOOXXXGOOOOOOXXXXXXXXXXXXXGOOOOOOOOOOOOOOOOOOOGOOOOOOOOXXXXXXXXXXXGOOOOOOOOOOOOXXXXXXXGOOOOOOOOOOOOOOOOOXXGOOOOOOXXXXXXXXXXXXXGOOOOOOOOOOOXXXXXXXXGOOOOOOOXXXXXXXXXXXXGOOOOOOOOOOXXXXXXXXX,0,256,0
33789,158,0,158,64,118,0,0,278,174,104,GOOOOOOOOOXXXXXXXXXXGOOOOOOOOOOOOOXXXXXXGOOOOOOOOOOOXXXXXXXXGOOOOOOOOOOOOOOOOXXXGOOOOOOXXXXXXXXXXXXXGOOOOOOOOOOOOOOOOOOOGOOOOOOOOXXXXXXXXXXXGOOOOOOOOOOOOXXXXXXXGOOOOOOOOOOOOOOOOOXXGOOOOOOXXXXXXXXXXXXXGOOOOOOOOOOOXXXXXXXXGOOOOOOOXXXXXXXXXXXXGOOOOOOOOOOXXXXXXXXX,0,256,0

33810,158,0,158,61,121,0,0,281,175,106,GOOOOOOOOOXXXXXXXXXXGOOOOOOOOOOOOOXXXXXXGOOOOOOOOOOOXXXXXXXXGOOOOOOOOOOOOOOOOXXXGOOOOOOXXXXXXXXXXXXXGOOOOOOOOOOOOOOOOOOOGOOOOOOOOXXXXXXXXXXXGOOOOOOOOOOOOXXXXXXXGOOOOOOOOOOOOOOOOOXXGOOOOOOXXXXXXXXXXXXXGOOOOOOOOOOOXXXXXXXXGOOOOOOOXXXXXXXXXXXXGOOOOOOOOOOXXXXXXXXX,0,256,0
33831,158,0,158,67,115,0,0,275,172,103,GOOOOOOOOOXXXXXXXXXXGOOOOOOOOOOOOOXXXXXXGOOOOOOOOOOOXXXXXXXXGOOOOOOOOOOOOOOOOXXXGOOOOOOXXXXXXXXXXXXXGOOOOOOOOOOOOOOOOOOOGOOOOOOOOXXXXXXXXXXXGOOOOOOOOOOOOXXXXXXXGOOOOOOOOOOOOOOOOOXXGOOOOOOXXXXXXXXXXXXXGOOOOOOOOOOOXXXXXXXXGOOOOOOOXXXXXXXXXXXXGOOOOOOOOOOXXXXXXXXX,0,256,0
33852,158,0,158,68,114,0,0,274,171,103,GOOOOOOOOOXXXXXXXXXXGOOOOOOOOOOOOOXXXXXXGOOOOOOOOOOOXXXXXXXXGOOOOOOOOOOOOOOOOXXXGOOOOOOXXXXXXXXXXXXXGOOOOOOOOOOOOOOOOOOOGOOOOOOOOXXXXXXXXXXXGOOOOOOOOOOOOXXXXXXXGOOOOOOOOOOOOOOOOOXXGOOOOOOXXXXXXXXXXXXXGOOOOOOOOOOOXXXXXXXXGOOOOOOOXXXXXXXXXXXXGOOOOOOOOOOXXXXXXXXX,0,256,0
33873,159,1,158,58,123,0,0,282,177,105,GOOOOOOOOOXXXXXXXXXXGOOOOOOOOOOOOOXXXXXXGOOOOOOOOOOOXXXXXXXXGOOOOOOOOOOOOOOOOXXXGOOOOOOXXXXXXXXXXXXXGOOOOOOOOOOOOOOOOOOOGOOOOOOOOXXXXXXXXXXXGOOOOOOOOOOOOXXXXXXXGOOOOOOOOOOOOOOOOOAXGOOOOOOXXXXXXXXXXXXXGOOOOOOOOOOOXXXXXXXXGOOOOOOOXXXXXXXXXXXXGOOOOOOOOOOXXXXXXXXX,0,256,0
33894,159,0,159,57,124,0,0,284,181,103,GOOOOOOOOOXXXXXXXXXXGOOOOOOOOOOOOOXXXXXXGOOOOOOOOOOOXXXXXXXXGOOOOOOOOOOOOOOOOXXXGOOOOOOXXXXXXXXXXXXXGOOOOOOOOOOOOOOOOOOOGOOOOOOOOXXXXXXXXXXXGOOOOOOOOOOOOXXXXXXXGOOOOOOOOOOOOOOOOOOXGOOOOOOXXXXXXXXXXXXXGOOOOOOOOOOOXXXXXXXXGOOOOOOOXXXXXXXXXXXXGOOOOOOOOOOXXXXXXXXX,0,256,0

33915,159,0,159,66,115,0,0,275,172,103,GOOOOOOOOOXXXXXXXXXXGOOOOOOOOOOOOOXXXXXXGOOOOOOOOOOOXXXXXXXXGOOOOOOOOOOOOOOOOXXXGOOOOOOXXXXXXXXXXXXXGOOOOOOOOOOOOOOOOOOOGOOOOOOOOXXXXXXXXXXXGOOOOOOOOOOOOXXXXXXXGOOOOOOOOOOOOOOOOOOXGOOOOOOXXXXXXXXXXXXXGOOOOOOOOOOOXXXXXXXXGOOOOOOOXXXXXXXXXXXXGOOOOOOOOOOXXXXXXXXX,0,256,0
33936,159,0,159,67,114,0,0,273,174,99,GOOOOOOOOOXXXXXXXXXXGOOOOOOOOOOOOOXXXXXXGOOOOOOOOOOOXXXXXXXXGOOOOOOOOOOOOOOOOXXXGOOOOOOXXXXXXXXXXXXXGOOOOOOOOOOOOOOOOOOOGOOOOOOOOXXXXXXXXXXXGOOOOOOOOOOOOXXXXXXXGOOOOOOOOOOOOOOOOOOXGOOOOOOXXXXXXXXXXXXXGOOOOOOOOOOOXXXXXXXXGOOOOOOOXXXXXXXXXXXXGOOOOOOOOOOXXXXXXXXX,0,256,0
33957,159,0,159,66,115,0,0,275,175,100,GOOOOOOOOOXXXXXXXXXXGOOOOOOOOOOOOOXXXXXXGOOOOOOOOOOOXXXXXXXXGOOOOOOOOOOOOOOOOXXXGOOOOOOXXXXXXXXXXXXXGOOOOOOOOOOOOOOOOOOOGOOOOOOOOXXXXXXXXXXXGOOOOOOOOOOOOXXXXXXXGOOOOOOOOOOOOOOOOOOXGOOOOOOXXXXXXXXXXXXXGOOOOOOOOOOOXXXXXXXXGOOOOOOOXXXXXXXXXXXXGOOOOOOOOOOXXXXXXXXX,0,256,0
33978,159,0,159,59,122,0,0,282,177,105,GOOOOOOOOOXXXXXXXXXXGOOOOOOOOOOOOOXXXXXXGOOOOOOOOOOOXXXXXXXXGOOOOOOOOOOOOOOOOXXXGOOOOOOXXXXXXXXXXXXXGOOOOOOOOOOOOOOOOOOOGOOOOOOOOXXXXXXXXXXXGOOOOOOOOOOOOXXXXXXXGOOOOOOOOOOOOOOOOOOXGOOOOOOXXXXXXXXXXXXXGOOOOOOOOOOOXXXXXXXXGOOOOOOOXXXXXXXXXXXXGOOOOOOOOOOXXXXXXXXX,0,256,0
33999,159,0,159,54,127,0,0,287,179,108,GOOOOOOOOOXXXXXXXXXXGOOOOOOOOOOOOOXXXXXXGOOOOOOOOOOOXXXXXXXXGOOOOOOOOOOOOOOOOXXXGOOOOOOXXXXXXXXXXXXXGOOOOOOOOOOOOOOOOOOOGOOOOOOOOXXXXXXXXXXXGOOOOOOOOOOOOXXXXXXXGOOOOOOOOOOOOOOOOOOXGOOOOOOXXXXXXXXXXXXXGOOOOOOOOOOOXXXXXXXXGOOOOOOOXXXXXXXXXXXXGOOOOOOOOOOXXXXXXXXX,0,256,0

34020,160,1,159,54,126,0,0,286,177,109,GOOOOOOOOOXXXXXXXXXXGOOOOOOOOOOOOOAXXXXXGOOOOOOOOOOOXXXXXXXXGOOOOOOOOOOOOOOOOXXXGOOOOOOXXXXXXXXXXXXXGOOOOOOOOOOOOOOOOOOOGOOOOOOOOXXXXXXXXXXXGOOOOOOOOOOOOXXXXXXXGOOOOOOOOOOOOOOOOOOXGOOOOOOXXXXXXXXXXXXXGOOOOOOOOOOOXXXXXXXXGOOOOOOOXXXXXXXXXXXXGOOOOOOOOOOXXXXXXXXX,0,256,0
34041,160,1,159,56,124,0,0,284,176,108,GOOOOOOOOOXXXXXXXXXXGOOOOOOOOOOOOOAXXXXXGOOOOOOOOOOOXXXXXXXXGOOOOOOOOOOOOOOOOXXXGOOOOOOXXXXXXXXXXXXXGOOOOOOOOOOOOOOOOOOOGOOOOOOOOXXXXXXXXXXXGOOOOOOOOOOOOXXXXXXXGOOOOOOOOOOOOOOOOOOXGOOOOOOXXXXXXXXXXXXXGOOOOOOOOOOOXXXXXXXXGOOOOOOOXXXXXXXXXXXXGOOOOOOOOOOXXXXXXXXX,0,256,0
34062,160,1,159,56,124,0,0,283,174,109,GOOOOOOOOOXXXXXXXXXXGOOOOOOOOOOOOOAXXXXXGOOOOOOOOOOOXXXXXXXXGOOOOOOOOOOOOOOOOXXXGOOOOOOXXXXXXXXXXXXXGOOOOOOOOOOOOOOOOOOOGOOOOOOOOXXXXXXXXXXXGOOOOOOOOOOOOXXXXXXXGOOOOOOOOOOOOOOOOOOXGOOOOOOXXXXXXXXXXXXXGOOOOOOOOOOOXXXXXXXXGOOOOOOOXXXXXXXXXXXXGOOOOOOOOOOXXXXXXXXX,0,256,0
34083,160,1,159,57,123,0,0,283,176,107,GOOOOOOOOOXXXXXXXXXXGOOOOOOOOOOOOOAXXXXXGOOOOOOOOOOOXXXXXXXXGOOOOOOOOOOOOOOOOXXXGOOOOOOXXXXXXXXXXXXXGOOOOOOOOOOOOOOOOOOOGOOOOOOOOXXXXXXXXXXXGOOOOOOOOOOOOXXXXXXXGOOOOOOOOOOOOOOOOOOXGOOOOOOXXXXXXXXXXXXXGOOOOOOOOOOOXXXXXXXXGOOOOOOOXXXXXXXXXXXXGOOOOOOOOOOXXXXXXXXX,0,256,0
34104,160,1,159,61,119,0,0,279,179,100,GOOOOOOOOOXXXXXXXXXXGOOOOOOOOOOOOOAXXXXXGOOOOOOOOOOOXXXXXXXXGOOOOOOOOOOOOOOOOXXXGOOOOOOXXXXXXXXXXXXXGOOOOOOOOOOOOOOOOOOOGOOOOOOOOXXXXXXXXXXXGOOOOOOOOOOOOXXXXXXXGOOOOOOOOOOOOOOOOOOXGOOOOOOXXXXXXXXXXXXXGOOOOOOOOOOOXXXXXXXXGOOOOOOOXXXXXXXXXXXXGOOOOOOOOOOXXXXXXXXX,0,256,0

34125,160,1,159,62,118,0,0,278,178,100,GOOOOOOOOOXXXXXXXXXXGOOOOOOOOOOOOOAXXXXXGOOOOOOOOOOOXXXXXXXXGOOOOOOOOOOOOOOOOXXXGOOOOOOXXXXXXXXXXXXXGOOOOOOOOOOOOOOOOOOOGOOOOOOOOXXXXXXXXXXXGOOOOOOOOOOOOXXXXXXXGOOOOOOOOOOOOOOOOOOXGOOOOOOXXXXXXXXXXXXXGOOOOOOOOOOOXXXXXXXXGOOOOOOOXXXXXXXXXXXXGOOOOOOOOOOXXXXXXXXX,0,256,0
34146,160,1,159,61,119,0,0,279,181,98,GOOOOOOOOOXXXXXXXXXXGOOOOOOOOOOOOOAXXXXXGOOOOOOOOOOOXXXXXXXXGOOOOOOOOOOOOOOOOXXXGOOOOOOXXXXXXXXXXXXXGOOOOOOOOOOOOOOOOOOOGOOOOOOOOXXXXXXXXXXXGOOOOOOOOOOOOXXXXXXXGOOOOOOOOOOOOOOOOOOXGOOOOOOXXXXXXXXXXXXXGOOOOOOOOOOOXXXXXXXXGOOOOOOOXXXXXXXXXXXXGOOOOOOOOOOXXXXXXXXX,0,256,0
34167,160,1,159,56,124,0,0,284,178,106,GOOOOOOOOOXXXXXXXXXXGOOOOOOOOOOOOOAXXXXXGOOOOOOOOOOOXXXXXXXXGOOOOOOOOOOOOOOOOXXXGOOOOOOXXXXXXXXXXXXXGOOOOOOOOOOOOOOOOOOOGOOOOOOOOXXXXXXXXXXXGOOOOOOOOOOOOXXXXXXXGOOOOOOOOOOOOOOOOOOXGOOOOOOXXXXXXXXXXXXXGOOOOOOOOOOOXXXXXXXXGOOOOOOOXXXXXXXXXXXXGOOOOOOOOOOXXXXXXXXX,0,256,0
34188,160,1,159,58,122,0,0,282,178,104,GOOOOOOOOOXXXXXXXXXXGOOOOOOOOOOOOOAXXXXXGOOOOOOOOOOOXXXXXXXXGOOOOOOOOOOOOOOOOXXXGOOOOOOXXXXXXXXXXXXXGOOOOOOOOOOOOOOOOOOOGOOOOOOOOXXXXXXXXXXXGOOOOOOOOOOOOXXXXXXXGOOOOOOOOOOOOOOOOOOXGOOOOOOXXXXXXXXXXXXXGOOOOOOOOOOOXXXXXXXXGOOOOOOOXXXXXXXXXXXXGOOOOOOOOOOXXXXXXXXX,0,256,0
34209,160,0,160,62,118,0,0,278,175,103,GOOOOOOOOOXXXXXXXXXXGOOOOOOOOOOOOOOXXXXXGOOOOOOOOOOOXXXXXXXXGOOOOOOOOOOOOOOOOXXXGOOOOOOXXXXXXXXXXXXXGOOOOOOOOOOOOOOOOOOOGOOOOOOOOXXXXXXXXXXXGOOOOOOOOOOOOXXXXXXXGOOOOOOOOOOOOOOOOOOXGOOOOOOXXXXXXXXXXXXXGOOOOOOOOOOOXXXXXXXXGOOOOOOOXXXXXXXXXXXXGOOOOOOOOOOXXXXXXXXX,0,256,0

34230,160,0,160,66,114,0,0,274,176,98,GOOOOOOOOOXXXXXXXXXXGOOOOOOOOOOOOOOXXXXXGOOOOOOOOOOOXXXXXXXXGOOOOOOOOOOOOOOOOXXXGOOOOOOXXXXXXXXXXXXXGOOOOOOOOOOOOOOOOOOOGOOOOOOOOXXXXXXXXXXXGOOOOOOOOOOOOXXXXXXXGOOOOOOOOOOOOOOOOOOXGOOOOOOXXXXXXXXXXXXXGOOOOOOOOOOOXXXXXXXXGOOOOOOOXXXXXXXXXXXXGOOOOOOOOOOXXXXXXXXX,0,256,0
34251,160,0,160,60,120,0,0,280,179,101,GOOOOOOOOOXXXXXXXXXXGOOOOOOOOOOOOOOXXXXXGOOOOOOOOOOOXXXXXXXXGOOOOOOOOOOOOOOOOXXXGOOOOOOXXXXXXXXXXXXXGOOOOOOOOOOOOOOOOOOOGOOOOOOOOXXXXXXXXXXXGOOOOOOOOOOOOXXXXXXXGOOOOOOOOOOOOOOOOOOXGOOOOOOXXXXXXXXXXXXXGOOOOOOOOOOOXXXXXXXXGOOOOOOOXXXXXXXXXXXXGOOOOOOOOOOXXXXXXXXX,0,256,0
34272,160,0,160,65,115,0,0,275,178,97,GOOOOOOOOOXXXXXXXXXXGOOOOOOOOOOOOOOXXXXXGOOOOOOOOOOOXXXXXXXXGOOOOOOOOOOOOOOOOXXXGOOOOOOXXXXXXXXXXXXXGOOOOOOOOOOOOOOOOOOOGOOOOOOOOXXXXXXXXXXXGOOOOOOOOOOOOXXXXXXXGOOOOOOOOOOOOOOOOOOXGOOOOOOXXXXXXXXXXXXXGOOOOOOOOOOOXXXXXXXXGOOOOOOOXXXXXXXXXXXXGOOOOOOOOOOXXXXXXXXX,0,256,0
34293,160,0,160,64,116,0,0,276,181,95,GOOOOOOOOOXXXXXXXXXXGOOOOOOOOOOOOOOXXXXXGOOOOOOOOOOOXXXXXXXXGOOOOOOOOOOOOOOOOXXXGOOOOOOXXXXXXXXXXXXXGOOOOOOOOOOOOOOOOOOOGOOOOOOOOXXXXXXXXXXXGOOOOOOOOOOOOXXXXXXXGOOOOOOOOOOOOOOOOOOXGOOOOOOXXXXXXXXXXXXXGOOOOOOOOOOOXXXXXXXXGOOOOOOOXXXXXXXXXXXXGOOOOOOOOOOXXXXXXXXX,0,256,0
34314,160,0,160,63,117,0,0,277,181,96,GOOOOOOOOOXXXXXXXXXXGOOOOOOOOOOOOOOXXXXXGOOOOOOOOOOOXXXXXXXXGOOOOOOOOOOOOOOOOXXXGOOOOOOXXXXXXXXXXXXXGOOOOOOOOOOOOOOOOOOOGOOOOOOOOXXXXXXXXXXXGOOOOOOOOOOOOXXXXXXXGOOOOOOOOOOOOOOOOOOXGOOOOOOXXXXXXXXXXXXXGOOOOOOOOOOOXXXXXXXXGOOOOOOOXXXXXXXXXXXXGOOOOOOOOOOXXXXXXXXX,0,256,0

34335,160,0,160,68,112,0,0,272,180,92,GOOOOOOOOOXXXXXXXXXXGOOOOOOOOOOOOOOXXXXXGOOOOOOOOOOOXXXXXXXXGOOOOOOOOOOOOOOOOXXXGOOOOOOXXXXXXXXXXXXXGOOOOOOOOOOOOOOOOOOOGOOOOOOOOXXXXXXXXXXXGOOOOOOOOOOOOXXXXXXXGOOOOOOOOOOOOOOOOOOXGOOOOOOXXXXXXXXXXXXXGOOOOOOOOOOOXXXXXXXXGOOOOOOOXXXXXXXXXXXXGOOOOOOOOOOXXXXXXXXX,0,256,0
34356,160,0,160,64,116,0,0,276,175,101,GOOOOOOOOOXXXXXXXXXXGOOOOOOOOOOOOOOXXXXXGOOOOOOOOOOOXXXXXXXXGOOOOOOOOOOOOOOOOXXXGOOOOOOXXXXXXXXXXXXXGOOOOOOOOOOOOOOOOOOOGOOOOOOOOXXXXXXXXXXXGOOOOOOOOOOOOXXXXXXXGOOOOOOOOOOOOOOOOOOXGOOOOOOXXXXXXXXXXXXXGOOOOOOOOOOOXXXXXXXXGOOOOOOOXXXXXXXXXXXXGOOOOOOOOOOXXXXXXXXX,0,256,0
34377,160,0,160,60,120,0,0,280,177,103,GOOOOOOOOOXXXXXXXXXXGOOOOOOOOOOOOOOXXXXXGOOOOOOOOOOOXXXXXXXXGOOOOOOOOOOOOOOOOXXXGOOOOOOXXXXXXXXXXXXXGOOOOOOOOOOOOOOOOOOOGOOOOOOOOXXXXXXXXXXXGOOOOOOOOOOOOXXXXXXXGOOOOOOOOOOOOOOOOOOXGOOOOOOXXXXXXXXXXXXXGOOOOOOOOOOOXXXXXXXXGOOOOOOOXXXXXXXXXXXXGOOOOOOOOOOXXXXXXXXX,0,256,0
34398,160,0,160,60,120,0,0,280,173,107,GOOOOOOOOOXXXXXXXXXXGOOOOOOOOOOOOOOXXXXXGOOOOOOOOOOOXXXXXXXXGOOOOOOOOOOOOOOOOXXXGOOOOOOXXXXXXXXXXXXXGOOOOOOOOOOOOOOOOOOOGOOOOOOOOXXXXXXXXXXXGOOOOOOOOOOOOXXXXXXXGOOOOOOOOOOOOOOOOOOXGOOOOOOXXXXXXXXXXXXXGOOOOOOOOOOOXXXXXXXXGOOOOOOOXXXXXXXXXXXXGOOOOOOOOOOXXXXXXXXX,0,256,0
34419,160,0,160,66,114,0,0,274,173,101,GOOOOOOOOOXXXXXXXXXXGOOOOOOOOOOOOOOXXXXXGOOOOOOOOOOOXXXXXXXXGOOOOOOOOOOOOOOOOXXXGOOOOOOXXXXXXXXXXXXXGOOOOOOOOOOOOOOOOOOOGOOOOOOOOXXXXXXXXXXXGOOOOOOOOOOOOXXXXXXXGOOOOOOOOOOOOOOOOOOXGOOOOOOXXXXXXXXXXXXXGOOOOOOOOOOOXXXXXXXXGOOOOOOOXXXXXXXXXXXXGOOOOOOOOOOXXXXXXXXX,0,256,0

34440,160,0,160,64,116,0,0,276,176,100,GOOOOOOOOOXXXXXXXXXXGOOOOOOOOOOOOOOXXXXXGOOOOOOOOOOOXXXXXXXXGOOOOOOOOOOOOOOOOXXXGOOOOOOXXXXXXXXXXXXXGOOOOOOOOOOOOOOOOOOOGOOOOOOOOXXXXXXXXXXXGOOOOOOOOOOOOXXXXXXXGOOOOOOOOOOOOOOOOOOXGOOOOOOXXXXXXXXXXXXXGOOOOOOOOOOOXXXXXXXXGOOOOOOOXXXXXXXXXXXXGOOOOOOOOOOXXXXXXXXX,0,256,0
34461,160,0,160,60,120,0,0,280,181,99,GOOOOOOOOOXXXXXXXXXXGOOOOOOOOOOOOOOXXXXXGOOOOOOOOOOOXXXXXXXXGOOOOOOOOOOOOOOOOXXXGOOOOOOXXXXXXXXXXXXXGOOOOOOOOOOOOOOOOOOOGOOOOOOOOXXXXXXXXXXXGOOOOOOOOOOOOXXXXXXXGOOOOOOOOOOOOOOOOOOXGOOOOOOXXXXXXXXXXXXXGOOOOOOOOOOOXXXXXXXXGOOOOOOOXXXXXXXXXXXXGOOOOOOOOOOXXXXXXXXX,0,256,0
34482,160,0,160,64,116,0,0,276,178,98,GOOOOOOOOOXXXXXXXXXXGOOOOOOOOOOOOOOXXXXXGOOOOOOOOOOOXXXXXXXXGOOOOOOOOOOOOOOOOXXXGOOOOOOXXXXXXXXXXXXXGOOOOOOOOOOOOOOOOOOOGOOOOOOOOXXXXXXXXXXXGOOOOOOOOOOOOXXXXXXXGOOOOOOOOOOOOOOOOOOXGOOOOOOXXXXXXXXXXXXXGOOOOOOOOOOOXXXXXXXXGOOOOOOOXXXXXXXXXXXXGOOOOOOOOOOXXXXXXXXX,0,256,0
34503,160,0,160,66,114,0,0,274,176,98,GOOOOOOOOOXXXXXXXXXXGOOOOOOOOOOOOOOXXXXXGOOOOOOOOOOOXXXXXXXXGOOOOOOOOOOOOOOOOXXXGOOOOOOXXXXXXXXXXXXXGOOOOOOOOOOOOOOOOOOOGOOOOOOOOXXXXXXXXXXXGOOOOOOOOOOOOXXXXXXXGOOOOOOOOOOOOOOOOOOXGOOOOOOXXXXXXXXXXXXXGOOOOOOOOOOOXXXXXXXXGOOOOOOOXXXXXXXXXXXXGOOOOOOOOOOXXXXXXXXX,0,256,0
34524,160,0,160,60,120,0,0,281,181,100,GOOOOOOOOOXXXXXXXXXXGOOOOOOOOOOOOOOXXXXXGOOOOOOOOOOOXXXXXXXXGOOOOOOOOOOOOOOOOXXXGOOOOOOXXXXXXXXXXXXXGOOOOOOOOOOOOOOOOOOOGOOOOOOOOXXXXXXXXXXXGOOOOOOOOOOOOXXXXXXXGOOOOOOOOOOOOOOOOOOXGOOOOOOXXXXXXXXXXXXXGOOOOOOOOOOOXXXXXXXXGOOOOOOOXXXXXXXXXXXXGOOOOOOOOOOXXXXXXXXX,0,256,0

34545,160,0,160,61,119,0,0,280,179,101,GOOOOOOOOOXXXXXXXXXXGOOOOOOOOOOOOOOXXXXXGOOOOOOOOOOOXXXXXXXXGOOOOOOOOOOOOOOOOXXXGOOOOOOXXXXXXXXXXXXXGOOOOOOOOOOOOOOOOOOOGOOOOOOOOXXXXXXXXXXXGOOOOOOOOOOOOXXXXXXXGOOOOOOOOOOOOOOOOOOXGOOOOOOXXXXXXXXXXXXXGOOOOOOOOOOOXXXXXXXXGOOOOOOOXXXXXXXXXXXXGOOOOOOOOOOXXXXXXXXX,0,256,0
34566,160,0,160,58,122,0,0,283,185,98,GOOOOOOOOOXXXXXXXXXXGOOOOOOOOOOOOOOXXXXXGOOOOOOOOOOOXXXXXXXXGOOOOOOOOOOOOOOOOXXXGOOOOOOXXXXXXXXXXXXXGOOOOOOOOOOOOOOOOOOOGOOOOOOOOXXXXXXXXXXXGOOOOOOOOOOOOXXXXXXXGOOOOOOOOOOOOOOOOOOXGOOOOOOXXXXXXXXXXXXXGOOOOOOOOOOOXXXXXXXXGOOOOOOOXXXXXXXXXXXXGOOOOOOOOOOXXXXXXXXX,0,256,0
34587,160,0,160,59,121,0,0,282,178,104,GOOOOOOOOOXXXXXXXXXXGOOOOOOOOOOOOOOXXXXXGOOOOOOOOOOOXXXXXXXXGOOOOOOOOOOOOOOOOXXXGOOOOOOXXXXXXXXXXXXXGOOOOOOOOOOOOOOOOOOOGOOOOOOOOXXXXXXXXXXXGOOOOOOOOOOOOXXXXXXXGOOOOOOOOOOOOOOOOOOXGOOOOOOXXXXXXXXXXXXXGOOOOOOOOOOOXXXXXXXXGOOOOOOOXXXXXXXXXXXXGOOOOOOOOOOXXXXXXXXX,0,256,0
34608,160,0,160,56,124,0,0,285,181,104,GOOOOOOOOOXXXXXXXXXXGOOOOOOOOOOOOOOXXXXXGOOOOOOOOOOOXXXXXXXXGOOOOOOOOOOOOOOOOXXXGOOOOOOXXXXXXXXXXXXXGOOOOOOOOOOOOOOOOOOOGOOOOOOOOXXXXXXXXXXXGOOOOOOOOOOOOXXXXXXXGOOOOOOOOOOOOOOOOOOXGOOOOOOXXXXXXXXXXXXXGOOOOOOOOOOOXXXXXXXXGOOOOOOOXXXXXXXXXXXXGOOOOOOOOOOXXXXXXXXX,0,256,0
34629,160,0,160,56,124,0,0,285,179,106,GOOOOOOOOOXXXXXXXXXXGOOOOOOOOOOOOOOXXXXXGOOOOOOOOOOOXXXXXXXXGOOOOOOOOOOOOOOOOXXXGOOOOOOXXXXXXXXXXXXXGOOOOOOOOOOOOOOOOOOOGOOOOOOOOXXXXXXXXXXXGOOOOOOOOOOOOXXXXXXXGOOOOOOOOOOOOOOOOOOXGOOOOOOXXXXXXXXXXXXXGOOOOOOOOOOOXXXXXXXXGOOOOOOOXXXXXXXXXXXXGOOOOOOOOOOXXXXXXXXX,0,256,0

34650,160,0,160,51,129,0,0,288,182,106,GOOOOOOOOOXXXXXXXXXXGOOOOOOOOOOOOOOXXXXXGOOOOOOOOOOOXXXXXXXXGOOOOOOOOOOOOOOOOXXXGOOOOOOXXXXXXXXXXXXXGOOOOOOOOOOOOOOOOOOOGOOOOOOOOXXXXXXXXXXXGOOOOOOOOOOOOXXXXXXXGOOOOOOOOOOOOOOOOOOXGOOOOOOXXXXXXXXXXXXXGOOOOOOOOOOOXXXXXXXXGOOOOOOOXXXXXXXXXXXXGOOOOOOOOOOXXXXXXXXX,0,256,0
34671,160,0,160,52,128,0,0,288,187,101,GOOOOOOOOOXXXXXXXXXXGOOOOOOOOOOOOOOXXXXXGOOOOOOOOOOOXXXXXXXXGOOOOOOOOOOOOOOOOXXXGOOOOOOXXXXXXXXXXXXXGOOOOOOOOOOOOOOOOOOOGOOOOOOOOXXXXXXXXXXXGOOOOOOOOOOOOXXXXXXXGOOOOOOOOOOOOOOOOOOXGOOOOOOXXXXXXXXXXXXXGOOOOOOOOOOOXXXXXXXXGOOOOOOOXXXXXXXXXXXXGOOOOOOOOOOXXXXXXXXX,0,256,0
34692,160,0,160,57,123,0,0,283,183,100,GOOOOOOOOOXXXXXXXXXXGOOOOOOOOOOOOOOXXXXXGOOOOOOOOOOOXXXXXXXXGOOOOOOOOOOOOOOOOXXXGOOOOOOXXXXXXXXXXXXXGOOOOOOOOOOOOOOOOOOOGOOOOOOOOXXXXXXXXXXXGOOOOOOOOOOOOXXXXXXXGOOOOOOOOOOOOOOOOOOXGOOOOOOXXXXXXXXXXXXXGOOOOOOOOOOOXXXXXXXXGOOOOOOOXXXXXXXXXXXXGOOOOOOOOOOXXXXXXXXX,0,256,0
34713,160,0,160,58,122,0,0,282,178,104,GOOOOOOOOOXXXXXXXXXXGOOOOOOOOOOOOOOXXXXXGOOOOOOOOOOOXXXXXXXXGOOOOOOOOOOOOOOOOXXXGOOOOOOXXXXXXXXXXXXXGOOOOOOOOOOOOOOOOOOOGOOOOOOOOXXXXXXXXXXXGOOOOOOOOOOOOXXXXXXXGOOOOOOOOOOOOOOOOOOXGOOOOOOXXXXXXXXXXXXXGOOOOOOOOOOOXXXXXXXXGOOOOOOOXXXXXXXXXXXXGOOOOOOOOOOXXXXXXXXX,0,256,0
34734,160,0,160,59,121,0,0,280,178,102,GOOOOOOOOOXXXXXXXXXXGOOOOOOOOOOOOOOXXXXXGOOOOOOOOOOOXXXXXXXXGOOOOOOOOOOOOOOOOXXXGOOOOOOXXXXXXXXXXXXXGOOOOOOOOOOOOOOOOOOOGOOOOOOOOXXXXXXXXXXXGOOOOOOOOOOOOXXXXXXXGOOOOOOOOOOOOOOOOOOXGOOOOOOXXXXXXXXXXXXXGOOOOOOOOOOOXXXXXXXXGOOOOOOOXXXXXXXXXXXXGOOOOOOOOOOXXXXXXXXX,0,256,0

34755,160,0,160,62,118,0,0,277,178,99,GOOOOOOOOOXXXXXXXXXXGOOOOOOOOOOOOOOXXXXXGOOOOOOOOOOOXXXXXXXXGOOOOOOOOOOOOOOOOXXXGOOOOOOXXXXXXXXXXXXXGOOOOOOOOOOOOOOOOOOOGOOOOOOOOXXXXXXXXXXXGOOOOOOOOOOOOXXXXXXXGOOOOOOOOOOOOOOOOOOXGOOOOOOXXXXXXXXXXXXXGOOOOOOOOOOOXXXXXXXXGOOOOOOOXXXXXXXXXXXXGOOOOOOOOOOXXXXXXXXX,0,256,0
34776,160,0,160,61,119,0,0,279,176,103,GOOOOOOOOOXXXXXXXXXXGOOOOOOOOOOOOOOXXXXXGOOOOOOOOOOOXXXXXXXXGOOOOOOOOOOOOOOOOXXXGOOOOOOXXXXXXXXXXXXXGOOOOOOOOOOOOOOOOOOOGOOOOOOOOXXXXXXXXXXXGOOOOOOOOOOOOXXXXXXXGOOOOOOOOOOOOOOOOOOXGOOOOOOXXXXXXXXXXXXXGOOOOOOOOOOOXXXXXXXXGOOOOOOOXXXXXXXXXXXXGOOOOOOOOOOXXXXXXXXX,0,256,0
34797,160,0,160,59,121,0,0,281,176,105,GOOOOOOOOOXXXXXXXXXXGOOOOOOOOOOOOOOXXXXXGOOOOOOOOOOOXXXXXXXXGOOOOOOOOOOOOOOOOXXXGOOOOOOXXXXXXXXXXXXXGOOOOOOOOOOOOOOOOOOOGOOOOOOOOXXXXXXXXXXXGOOOOOOOOOOOOXXXXXXXGOOOOOOOOOOOOOOOOOOXGOOOOOOXXXXXXXXXXXXXGOOOOOOOOOOOXXXXXXXXGOOOOOOOXXXXXXXXXXXXGOOOOOOOOOOXXXXXXXXX,0,256,0
34818,160,0,160,51,129,0,0,288,178,110,GOOOOOOOOOXXXXXXXXXXGOOOOOOOOOOOOOOXXXXXGOOOOOOOOOOOXXXXXXXXGOOOOOOOOOOOOOOOOXXXGOOOOOOXXXXXXXXXXXXXGOOOOOOOOOOOOOOOOOOOGOOOOOOOOXXXXXXXXXXXGOOOOOOOOOOOOXXXXXXXGOOOOOOOOOOOOOOOOOOXGOOOOOOXXXXXXXXXXXXXGOOOOOOOOOOOXXXXXXXXGOOOOOOOXXXXXXXXXXXXGOOOOOOOOOOXXXXXXXXX,0,256,0
34839,160,0,160,49,131,0,0,291,184,107,GOOOOOOOOOXXXXXXXXXXGOOOOOOOOOOOOOOXXXXXGOOOOOOOOOOOXXXXXXXXGOOOOOOOOOOOOOOOOXXXGOOOOOOXXXXXXXXXXXXXGOOOOOOOOOOOOOOOOOOOGOOOOOOOOXXXXXXXXXXXGOOOOOOOOOOOOXXXXXXXGOOOOOOOOOOOOOOOOOOXGOOOOOOXXXXXXXXXXXXXGOOOOOOOOOOOXXXXXXXXGOOOOOOOXXXXXXXXXXXXGOOOOOOOOOOXXXXXXXXX,0,256,0

34860,160,0,160,51,129,0,0,290,182,108,GOOOOOOOOOXXXXXXXXXXGOOOOOOOOOOOOOOXXXXXGOOOOOOOOOOOXXXXXXXXGOOOOOOOOOOOOOOOOXXXGOOOOOOXXXXXXXXXXXXXGOOOOOOOOOOOOOOOOOOOGOOOOOOOOXXXXXXXXXXXGOOOOOOOOOOOOXXXXXXXGOOOOOOOOOOOOOOOOOOXGOOOOOOXXXXXXXXXXXXXGOOOOOOOOOOOXXXXXXXXGOOOOOOOXXXXXXXXXXXXGOOOOOOOOOOXXXXXXXXX,0,256,0
34881,160,0,160,46,134,0,0,295,184,111,GOOOOOOOOOXXXXXXXXXXGOOOOOOOOOOOOOOXXXXXGOOOOOOOOOOOXXXXXXXXGOOOOOOOOOOOOOOOOXXXGOOOOOOXXXXXXXXXXXXXGOOOOOOOOOOOOOOOOOOOGOOOOOOOOXXXXXXXXXXXGOOOOOOOOOOOOXXXXXXXGOOOOOOOOOOOOOOOOOOXGOOOOOOXXXXXXXXXXXXXGOOOOOOOOOOOXXXXXXXXGOOOOOOOXXXXXXXXXXXXGOOOOOOOOOOXXXXXXXXX,0,256,0
34902,160,0,160,56,124,0,0,285,180,105,GOOOOOOOOOXXXXXXXXXXGOOOOOOOOOOOOOOXXXXXGOOOOOOOOOOOXXXXXXXXGOOOOOOOOOOOOOOOOXXXGOOOOOOXXXXXXXXXXXXXGOOOOOOOOOOOOOOOOOOOGOOOOOOOOXXXXXXXXXXXGOOOOOOOOOOOOXXXXXXXGOOOOOOOOOOOOOOOOOOXGOOOOOOXXXXXXXXXXXXXGOOOOOOOOOOOXXXXXXXXGOOOOOOOXXXXXXXXXXXXGOOOOOOOOOOXXXXXXXXX,0,256,0
34923,160,0,160,63,117,0,0,278,179,99,GOOOOOOOOOXXXXXXXXXXGOOOOOOOOOOOOOOXXXXXGOOOOOOOOOOOXXXXXXXXGOOOOOOOOOOOOOOOOXXXGOOOOOOXXXXXXXXXXXXXGOOOOOOOOOOOOOOOOOOOGOOOOOOOOXXXXXXXXXXXGOOOOOOOOOOOOXXXXXXXGOOOOOOOOOOOOOOOOOOXGOOOOOOXXXXXXXXXXXXXGOOOOOOOOOOOXXXXXXXXGOOOOOOOXXXXXXXXXXXXGOOOOOOOOOOXXXXXXXXX,0,256,0
34944,160,0,160,66,114,0,0,275,179,96,GOOOOOOOOOXXXXXXXXXXGOOOOOOOOOOOOOOXXXXXGOOOOOOOOOOOXXXXXXXXGOOOOOOOOOOOOOOOOXXXGOOOOOOXXXXXXXXXXXXXGOOOOOOOOOOOOOOOOOOOGOOOOOOOOXXXXXXXXXXXGOOOOOOOOOOOOXXXXXXXGOOOOOOOOOOOOOOOOOOXGOOOOOOXXXXXXXXXXXXXGOOOOOOOOOOOXXXXXXXXGOOOOOOOXXXXXXXXXXXXGOOOOOOOOOOXXXXXXXXX,0,256,0

34965,160,0,160,68,112,0,0,273,178,95,GOOOOOOOOOXXXXXXXXXXGOOOOOOOOOOOOOOXXXXXGOOOOOOOOOOOXXXXXXXXGOOOOOOOOOOOOOOOOXXXGOOOOOOXXXXXXXXXXXXXGOOOOOOOOOOOOOOOOOOOGOOOOOOOOXXXXXXXXXXXGOOOOOOOOOOOOXXXXXXXGOOOOOOOOOOOOOOOOOOXGOOOOOOXXXXXXXXXXXXXGOOOOOOOOOOOXXXXXXXXGOOOOOOOXXXXXXXXXXXXGOOOOOOOOOOXXXXXXXXX,0,256,0
34986,160,0,160,67,113,0,0,273,180,93,GOOOOOOOOOXXXXXXXXXXGOOOOOOOOOOOOOOXXXXXGOOOOOOOOOOOXXXXXXXXGOOOOOOOOOOOOOOOOXXXGOOOOOOXXXXXXXXXXXXXGOOOOOOOOOOOOOOOOOOOGOOOOOOOOXXXXXXXXXXXGOOOOOOOOOOOOXXXXXXXGOOOOOOOOOOOOOOOOOOXGOOOOOOXXXXXXXXXXXXXGOOOOOOOOOOOXXXXXXXXGOOOOOOOXXXXXXXXXXXXGOOOOOOOOOOXXXXXXXXX,0,256,0
35007,160,0,160,66,114,0,0,274,181,93,GOOOOOOOOOXXXXXXXXXXGOOOOOOOOOOOOOOXXXXXGOOOOOOOOOOOXXXXXXXXGOOOOOOOOOOOOOOOOXXXGOOOOOOXXXXXXXXXXXXXGOOOOOOOOOOOOOOOOOOOGOOOOOOOOXXXXXXXXXXXGOOOOOOOOOOOOXXXXXXXGOOOOOOOOOOOOOOOOOOXGOOOOOOXXXXXXXXXXXXXGOOOOOOOOOOOXXXXXXXXGOOOOOOOXXXXXXXXXXXXGOOOOOOOOOOXXXXXXXXX,0,256,0
35028,160,0,160,62,118,0,0,279,183,96,GOOOOOOOOOXXXXXXXXXXGOOOOOOOOOOOOOOXXXXXGOOOOOOOOOOOXXXXXXXXGOOOOOOOOOOOOOOOOXXXGOOOOOOXXXXXXXXXXXXXGOOOOOOOOOOOOOOOOOOOGOOOOOOOOXXXXXXXXXXXGOOOOOOOOOOOOXXXXXXXGOOOOOOOOOOOOOOOOOOXGOOOOOOXXXXXXXXXXXXXGOOOOOOOOOOOXXXXXXXXGOOOOOOOXXXXXXXXXXXXGOOOOOOOOOOXXXXXXXXX,0,256,0
35049,160,0,160,61,119,0,0,281,185,96,GOOOOOOOOOXXXXXXXXXXGOOOOOOOOOOOOOOXXXXXGOOOOOOOOOOOXXXXXXXXGOOOOOOOOOOOOOOOOXXXGOOOOOOXXXXXXXXXXXXXGOOOOOOOOOOOOOOOOOOOGOOOOOOOOXXXXXXXXXXXGOOOOOOOOOOOOXXXXXXXGOOOOOOOOOOOOOOOOOOXGOOOOOOXXXXXXXXXXXXXGOOOOOOOOOOOXXXXXXXXGOOOOOOOXXXXXXXXXXXXGOOOOOOOOOOXXXXXXXXX,0,256,0

35070,160,0,160,61,119,0,0,281,183,98,GOOOOOOOOOXXXXXXXXXXGOOOOOOOOOOOOOOXXXXXGOOOOOOOOOOOXXXXXXXXGOOOOOOOOOOOOOOOOXXXGOOOOOOXXXXXXXXXXXXXGOOOOOOOOOOOOOOOOOOOGOOOOOOOOXXXXXXXXXXXGOOOOOOOOOOOOXXXXXXXGOOOOOOOOOOOOOOOOOOXGOOOOOOXXXXXXXXXXXXXGOOOOOOOOOOOXXXXXXXXGOOOOOOOXXXXXXXXXXXXGOOOOOOOOOOXXXXXXXXX,0,256,0
35091,160,0,160,64,116,0,0,277,181,96,GOOOOOOOOOXXXXXXXXXXGOOOOOOOOOOOOOOXXXXXGOOOOOOOOOOOXXXXXXXXGOOOOOOOOOOOOOOOOXXXGOOOOOOXXXXXXXXXXXXXGOOOOOOOOOOOOOOOOOOOGOOOOOOOOXXXXXXXXXXXGOOOOOOOOOOOOXXXXXXXGOOOOOOOOOOOOOOOOOOXGOOOOOOXXXXXXXXXXXXXGOOOOOOOOOOOXXXXXXXXGOOOOOOOXXXXXXXXXXXXGOOOOOOOOOOXXXXXXXXX,0,256,0
35112,160,0,160,63,117,0,0,279,183,96,GOOOOOOOOOXXXXXXXXXXGOOOOOOOOOOOOOOXXXXXGOOOOOOOOOOOXXXXXXXXGOOOOOOOOOOOOOOOOXXXGOOOOOOXXXXXXXXXXXXXGOOOOOOOOOOOOOOOOOOOGOOOOOOOOXXXXXXXXXXXGOOOOOOOOOOOOXXXXXXXGOOOOOOOOOOOOOOOOOOXGOOOOOOXXXXXXXXXXXXXGOOOOOOOOOOOXXXXXXXXGOOOOOOOXXXXXXXXXXXXGOOOOOOOOOOXXXXXXXXX,0,256,0
35133,160,0,160,60,120,0,0,281,182,99,GOOOOOOOOOXXXXXXXXXXGOOOOOOOOOOOOOOXXXXXGOOOOOOOOOOOXXXXXXXXGOOOOOOOOOOOOOOOOXXXGOOOOOOXXXXXXXXXXXXXGOOOOOOOOOOOOOOOOOOOGOOOOOOOOXXXXXXXXXXXGOOOOOOOOOOOOXXXXXXXGOOOOOOOOOOOOOOOOOOXGOOOOOOXXXXXXXXXXXXXGOOOOOOOOOOOXXXXXXXXGOOOOOOOXXXXXXXXXXXXGOOOOOOOOOOXXXXXXXXX,0,256,0
35154,160,0,160,61,119,0,0,280,180,100,GOOOOOOOOOXXXXXXXXXXGOOOOOOOOOOOOOOXXXXXGOOOOOOOOOOOXXXXXXXXGOOOOOOOOOOOOOOOOXXXGOOOOOOXXXXXXXXXXXXXGOOOOOOOOOOOOOOOOOOOGOOOOOOOOXXXXXXXXXXXGOOOOOOOOOOOOXXXXXXXGOOOOOOOOOOOOOOOOOOXGOOOOOOXXXXXXXXXXXXXGOOOOOOOOOOOXXXXXXXXGOOOOOOOXXXXXXXXXXXXGOOOOOOOOOOXXXXXXXXX,0,256,0

35175,160,0,160,61,119,0,0,279,182,97,GOOOOOOOOOXXXXXXXXXXGOOOOOOOOOOOOOOXXXXXGOOOOOOOOOOOXXXXXXXXGOOOOOOOOOOOOOOOOXXXGOOOOOOXXXXXXXXXXXXXGOOOOOOOOOOOOOOOOOOOGOOOOOOOOXXXXXXXXXXXGOOOOOOOOOOOOXXXXXXXGOOOOOOOOOOOOOOOOOOXGOOOOOOXXXXXXXXXXXXXGOOOOOOOOOOOXXXXXXXXGOOOOOOOXXXXXXXXXXXXGOOOOOOOOOOXXXXXXXXX,0,256,0
35196,160,0,160,59,121,0,0,280,186,94,GOOOOOOOOOXXXXXXXXXXGOOOOOOOOOOOOOOXXXXXGOOOOOOOOOOOXXXXXXXXGOOOOOOOOOOOOOOOOXXXGOOOOOOXXXXXXXXXXXXXGOOOOOOOOOOOOOOOOOOOGOOOOOOOOXXXXXXXXXXXGOOOOOOOOOOOOXXXXXXXGOOOOOOOOOOOOOOOOOOXGOOOOOOXXXXXXXXXXXXXGOOOOOOOOOOOXXXXXXXXGOOOOOOOXXXXXXXXXXXXGOOOOOOOOOOXXXXXXXXX,0,256,0
35217,160,0,160,62,118,0,0,278,183,95,GOOOOOOOOOXXXXXXXXXXGOOOOOOOOOOOOOOXXXXXGOOOOOOOOOOOXXXXXXXXGOOOOOOOOOOOOOOOOXXXGOOOOOOXXXXXXXXXXXXXGOOOOOOOOOOOOOOOOOOOGOOOOOOOOXXXXXXXXXXXGOOOOOOOOOOOOXXXXXXXGOOOOOOOOOOOOOOOOOOXGOOOOOOXXXXXXXXXXXXXGOOOOOOOOOOOXXXXXXXXGOOOOOOOXXXXXXXXXXXXGOOOOOOOOOOXXXXXXXXX,0,256,0
35238,160,0,160,64,116,0,0,276,182,94,GOOOOOOOOOXXXXXXXXXXGOOOOOOOOOOOOOOXXXXXGOOOOOOOOOOOXXXXXXXXGOOOOOOOOOOOOOOOOXXXGOOOOOOXXXXXXXXXXXXXGOOOOOOOOOOOOOOOOOOOGOOOOOOOOXXXXXXXXXXXGOOOOOOOOOOOOXXXXXXXGOOOOOOOOOOOOOOOOOOXGOOOOOOXXXXXXXXXXXXXGOOOOOOOOOOOXXXXXXXXGOOOOOOOXXXXXXXXXXXXGOOOOOOOOOOXXXXXXXXX,0,256,0
35259,160,0,160,61,119,0,0,277,177,100,GOOOOOOOOOXXXXXXXXXXGOOOOOOOOOOOOOOXXXXXGOOOOOOOOOOOXXXXXXXXGOOOOOOOOOOOOOOOOXXXGOOOOOOXXXXXXXXXXXXXGOOOOOOOOOOOOOOOOOOOGOOOOOOOOXXXXXXXXXXXGOOOOOOOOOOOOXXXXXXXGOOOOOOOOOOOOOOOOOOXGOOOOOOXXXXXXXXXXXXXGOOOOOOOOOOOXXXXXXXXGOOOOOOOXXXXXXXXXXXXGOOOOOOOOOOXXXXXXXXX,0,256,0

35280,160,0,160,58,122,0,0,281,177,104,GOOOOOOOOOXXXXXXXXXXGOOOOOOOOOOOOOOXXXXXGOOOOOOOOOOOXXXXXXXXGOOOOOOOOOOOOOOOOXXXGOOOOOOXXXXXXXXXXXXXGOOOOOOOOOOOOOOOOOOOGOOOOOOOOXXXXXXXXXXXGOOOOOOOOOOOOXXXXXXXGOOOOOOOOOOOOOOOOOOXGOOOOOOXXXXXXXXXXXXXGOOOOOOOOOOOXXXXXXXXGOOOOOOOXXXXXXXXXXXXGOOOOOOOOOOXXXXXXXXX,0,256,0
35301,160,0,160,59,121,0,0,281,176,105,GOOOOOOOOOXXXXXXXXXXGOOOOOOOOOOOOOOXXXXXGOOOOOOOOOOOXXXXXXXXGOOOOOOOOOOOOOOOOXXXGOOOOOOXXXXXXXXXXXXXGOOOOOOOOOOOOOOOOOOOGOOOOOOOOXXXXXXXXXXXGOOOOOOOOOOOOXXXXXXXGOOOOOOOOOOOOOOOOOOXGOOOOOOXXXXXXXXXXXXXGOOOOOOOOOOOXXXXXXXXGOOOOOOOXXXXXXXXXXXXGOOOOOOOOOOXXXXXXXXX,0,256,0
35322,160,0,160,57,123,0,0,283,186,97,GOOOOOOOOOXXXXXXXXXXGOOOOOOOOOOOOOOXXXXXGOOOOOOOOOOOXXXXXXXXGOOOOOOOOOOOOOOOOXXXGOOOOOOXXXXXXXXXXXXXGOOOOOOOOOOOOOOOOOOOGOOOOOOOOXXXXXXXXXXXGOOOOOOOOOOOOXXXXXXXGOOOOOOOOOOOOOOOOOOXGOOOOOOXXXXXXXXXXXXXGOOOOOOOOOOOXXXXXXXXGOOOOOOOXXXXXXXXXXXXGOOOOOOOOOOXXXXXXXXX,0,256,0
35343,160,0,160,54,126,0,0,286,185,101,GOOOOOOOOOXXXXXXXXXXGOOOOOOOOOOOOOOXXXXXGOOOOOOOOOOOXXXXXXXXGOOOOOOOOOOOOOOOOXXXGOOOOOOXXXXXXXXXXXXXGOOOOOOOOOOOOOOOOOOOGOOOOOOOOXXXXXXXXXXXGOOOOOOOOOOOOXXXXXXXGOOOOOOOOOOOOOOOOOOXGOOOOOOXXXXXXXXXXXXXGOOOOOOOOOOOXXXXXXXXGOOOOOOOXXXXXXXXXXXXGOOOOOOOOOOXXXXXXXXX,0,256,0
35364,160,0,160,58,122,0,0,282,182,100,GOOOOOOOOOXXXXXXXXXXGOOOOOOOOOOOOOOXXXXXGOOOOOOOOOOOXXXXXXXXGOOOOOOOOOOOOOOOOXXXGOOOOOOXXXXXXXXXXXXXGOOOOOOOOOOOOOOOOOOOGOOOOOOOOXXXXXXXXXXXGOOOOOOOOOOOOXXXXXXXGOOOOOOOOOOOOOOOOOOXGOOOOOOXXXXXXXXXXXXXGOOOOOOOOOOOXXXXXXXXGOOOOOOOXXXXXXXXXXXXGOOOOOOOOOOXXXXXXXXX,0,256,0

35385,160,0,160,65,115,0,0,274,177,97,GOOOOOOOOOXXXXXXXXXXGOOOOOOOOOOOOOOXXXXXGOOOOOOOOOOOXXXXXXXXGOOOOOOOOOOOOOOOOXXXGOOOOOOXXXXXXXXXXXXXGOOOOOOOOOOOOOOOOOOOGOOOOOOOOXXXXXXXXXXXGOOOOOOOOOOOOXXXXXXXGOOOOOOOOOOOOOOOOOOXGOOOOOOXXXXXXXXXXXXXGOOOOOOOOOOOXXXXXXXXGOOOOOOOXXXXXXXXXXXXGOOOOOOOOOOXXXXXXXXX,0,256,0
35406,160,0,160,67,113,0,0,273,171,102,GOOOOOOOOOXXXXXXXXXXGOOOOOOOOOOOOOOXXXXXGOOOOOOOOOOOXXXXXXXXGOOOOOOOOOOOOOOOOXXXGOOOOOOXXXXXXXXXXXXXGOOOOOOOOOOOOOOOOOOOGOOOOOOOOXXXXXXXXXXXGOOOOOOOOOOOOXXXXXXXGOOOOOOOOOOOOOOOOOOXGOOOOOOXXXXXXXXXXXXXGOOOOOOOOOOOXXXXXXXXGOOOOOOOXXXXXXXXXXXXGOOOOOOOOOOXXXXXXXXX,0,256,0
35427,160,0,160,58,122,0,0,282,174,108,GOOOOOOOOOXXXXXXXXXXGOOOOOOOOOOOOOOXXXXXGOOOOOOOOOOOXXXXXXXXGOOOOOOOOOOOOOOOOXXXGOOOOOOXXXXXXXXXXXXXGOOOOOOOOOOOOOOOOOOOGOOOOOOOOXXXXXXXXXXXGOOOOOOOOOOOOXXXXXXXGOOOOOOOOOOOOOOOOOOXGOOOOOOXXXXXXXXXXXXXGOOOOOOOOOOOXXXXXXXXGOOOOOOOXXXXXXXXXXXXGOOOOOOOOOOXXXXXXXXX,0,256,0
35448,160,0,160,60,120,0,0,280,173,107,GOOOOOOOOOXXXXXXXXXXGOOOOOOOOOOOOOOXXXXXGOOOOOOOOOOOXXXXXXXXGOOOOOOOOOOOOOOOOXXXGOOOOOOXXXXXXXXXXXXXGOOOOOOOOOOOOOOOOOOOGOOOOOOOOXXXXXXXXXXXGOOOOOOOOOOOOXXXXXXXGOOOOOOOOOOOOOOOOOOXGOOOOOOXXXXXXXXXXXXXGOOOOOOOOOOOXXXXXXXXGOOOOOOOXXXXXXXXXXXXGOOOOOOOOOOXXXXXXXXX,0,256,0
35469,160,0,160,56,124,0,0,284,178,106,GOOOOOOOOOXXXXXXXXXXGOOOOOOOOOOOOOOXXXXXGOOOOOOOOOOOXXXXXXXXGOOOOOOOOOOOOOOOOXXXGOOOOOOXXXXXXXXXXXXXGOOOOOOOOOOOOOOOOOOOGOOOOOOOOXXXXXXXXXXXGOOOOOOOOOOOOXXXXXXXGOOOOOOOOOOOOOOOOOOXGOOOOOOXXXXXXXXXXXXXGOOOOOOOOOOOXXXXXXXXGOOOOOOOXXXXXXXXXXXXGOOOOOOOOOOXXXXXXXXX,0,256,0

35490,160,0,160,56,124,0,0,284,180,104,GOOOOOOOOOXXXXXXXXXXGOOOOOOOOOOOOOOXXXXXGOOOOOOOOOOOXXXXXXXXGOOOOOOOOOOOOOOOOXXXGOOOOOOXXXXXXXXXXXXXGOOOOOOOOOOOOOOOOOOOGOOOOOOOOXXXXXXXXXXXGOOOOOOOOOOOOXXXXXXXGOOOOOOOOOOOOOOOOOOXGOOOOOOXXXXXXXXXXXXXGOOOOOOOOOOOXXXXXXXXGOOOOOOOXXXXXXXXXXXXGOOOOOOOOOOXXXXXXXXX,0,256,0
35511,160,0,160,55,125,0,0,285,183,102,GOOOOOOOOOXXXXXXXXXXGOOOOOOOOOOOOOOXXXXXGOOOOOOOOOOOXXXXXXXXGOOOOOOOOOOOOOOOOXXXGOOOOOOXXXXXXXXXXXXXGOOOOOOOOOOOOOOOOOOOGOOOOOOOOXXXXXXXXXXXGOOOOOOOOOOOOXXXXXXXGOOOOOOOOOOOOOOOOOOXGOOOOOOXXXXXXXXXXXXXGOOOOOOOOOOOXXXXXXXXGOOOOOOOXXXXXXXXXXXXGOOOOOOOOOOXXXXXXXXX,0,256,0
35532,160,0,160,53,127,0,0,287,183,104,GOOOOOOOOOXXXXXXXXXXGOOOOOOOOOOOOOOXXXXXGOOOOOOOOOOOXXXXXXXXGOOOOOOOOOOOOOOOOXXXGOOOOOOXXXXXXXXXXXXXGOOOOOOOOOOOOOOOOOOOGOOOOOOOOXXXXXXXXXXXGOOOOOOOOOOOOXXXXXXXGOOOOOOOOOOOOOOOOOOXGOOOOOOXXXXXXXXXXXXXGOOOOOOOOOOOXXXXXXXXGOOOOOOOXXXXXXXXXXXXGOOOOOOOOOOXXXXXXXXX,0,256,0
35553,160,0,160,53,127,0,0,287,185,102,GOOOOOOOOOXXXXXXXXXXGOOOOOOOOOOOOOOXXXXXGOOOOOOOOOOOXXXXXXXXGOOOOOOOOOOOOOOOOXXXGOOOOOOXXXXXXXXXXXXXGOOOOOOOOOOOOOOOOOOOGOOOOOOOOXXXXXXXXXXXGOOOOOOOOOOOOXXXXXXXGOOOOOOOOOOOOOOOOOOXGOOOOOOXXXXXXXXXXXXXGOOOOOOOOOOOXXXXXXXXGOOOOOOOXXXXXXXXXXXXGOOOOOOOOOOXXXXXXXXX,0,256,0
35574,160,0,160,52,128,0,0,287,181,106,GOOOOOOOOOXXXXXXXXXXGOOOOOOOOOOOOOOXXXXXGOOOOOOOOOOOXXXXXXXXGOOOOOOOOOOOOOOOOXXXGOOOOOOXXXXXXXXXXXXXGOOOOOOOOOOOOOOOOOOOGOOOOOOOOXXXXXXXXXXXGOOOOOOOOOOOOXXXXXXXGOOOOOOOOOOOOOOOOOOXGOOOOOOXXXXXXXXXXXXXGOOOOOOOOOOOXXXXXXXXGOOOOOOOXXXXXXXXXXXXGOOOOOOOOOOXXXXXXXXX,0,256,0

35595,160,0,160,56,124,0,0,284,183,101,GOOOOOOOOOXXXXXXXXXXGOOOOOOOOOOOOOOXXXXXGOOOOOOOOOOOXXXXXXXXGOOOOOOOOOOOOOOOOXXXGOOOOOOXXXXXXXXXXXXXGOOOOOOOOOOOOOOOOOOOGOOOOOOOOXXXXXXXXXXXGOOOOOOOOOOOOXXXXXXXGOOOOOOOOOOOOOOOOOOXGOOOOOOXXXXXXXXXXXXXGOOOOOOOOOOOXXXXXXXXGOOOOOOOXXXXXXXXXXXXGOOOOOOOOOOXXXXXXXXX,0,256,0
35616,160,0,160,62,118,0,0,278,180,98,GOOOOOOOOOXXXXXXXXXXGOOOOOOOOOOOOOOXXXXXGOOOOOOOOOOOXXXXXXXXGOOOOOOOOOOOOOOOOXXXGOOOOOOXXXXXXXXXXXXXGOOOOOOOOOOOOOOOOOOOGOOOOOOOOXXXXXXXXXXXGOOOOOOOOOOOOXXXXXXXGOOOOOOOOOOOOOOOOOOXGOOOOOOXXXXXXXXXXXXXGOOOOOOOOOOOXXXXXXXXGOOOOOOOXXXXXXXXXXXXGOOOOOOOOOOXXXXXXXXX,0,256,0
35637,160,0,160,58,122,0,0,282,180,102,GOOOOOOOOOXXXXXXXXXXGOOOOOOOOOOOOOOXXXXXGOOOOOOOOOOOXXXXXXXXGOOOOOOOOOOOOOOOOXXXGOOOOOOXXXXXXXXXXXXXGOOOOOOOOOOOOOOOOOOOGOOOOOOOOXXXXXXXXXXXGOOOOOOOOOOOOXXXXXXXGOOOOOOOOOOOOOOOOOOXGOOOOOOXXXXXXXXXXXXXGOOOOOOOOOOOXXXXXXXXGOOOOOOOXXXXXXXXXXXXGOOOOOOOOOOXXXXXXXXX,0,256,0
35658,160,0,160,51,129,0,0,288,183,105,GOOOOOOOOOXXXXXXXXXXGOOOOOOOOOOOOOOXXXXXGOOOOOOOOOOOXXXXXXXXGOOOOOOOOOOOOOOOOXXXGOOOOOOXXXXXXXXXXXXXGOOOOOOOOOOOOOOOOOOOGOOOOOOOOXXXXXXXXXXXGOOOOOOOOOOOOXXXXXXXGOOOOOOOOOOOOOOOOOOXGOOOOOOXXXXXXXXXXXXXGOOOOOOOOOOOXXXXXXXXGOOOOOOOXXXXXXXXXXXXGOOOOOOOOOOXXXXXXXXX,0,256,0
35679,160,0,160,53,127,0,0,287,185,102,GOOOOOOOOOXXXXXXXXXXGOOOOOOOOOOOOOOXXXXXGOOOOOOOOOOOXXXXXXXXGOOOOOOOOOOOOOOOOXXXGOOOOOOXXXXXXXXXXXXXGOOOOOOOOOOOOOOOOOOOGOOOOOOOOXXXXXXXXXXXGOOOOOOOOOOOOXXXXXXXGOOOOOOOOOOOOOOOOOOXGOOOOOOXXXXXXXXXXXXXGOOOOOOOOOOOXXXXXXXXGOOOOOOOXXXXXXXXXXXXGOOOOOOOOOOXXXXXXXXX,0,256,0

35700,160,0,160,56,124,0,0,284,184,100,GOOOOOOOOOXXXXXXXXXXGOOOOOOOOOOOOOOXXXXXGOOOOOOOOOOOXXXXXXXXGOOOOOOOOOOOOOOOOXXXGOOOOOOXXXXXXXXXXXXXGOOOOOOOOOOOOOOOOOOOGOOOOOOOOXXXXXXXXXXXGOOOOOOOOOOOOXXXXXXXGOOOOOOOOOOOOOOOOOOXGOOOOOOXXXXXXXXXXXXXGOOOOOOOOOOOXXXXXXXXGOOOOOOOXXXXXXXXXXXXGOOOOOOOOOOXXXXXXXXX,0,256,0
35721,160,0,160,57,123,0,0,283,183,100,GOOOOOOOOOXXXXXXXXXXGOOOOOOOOOOOOOOXXXXXGOOOOOOOOOOOXXXXXXXXGOOOOOOOOOOOOOOOOXXXGOOOOOOXXXXXXXXXXXXXGOOOOOOOOOOOOOOOOOOOGOOOOOOOOXXXXXXXXXXXGOOOOOOOOOOOOXXXXXXXGOOOOOOOOOOOOOOOOOOXGOOOOOOXXXXXXXXXXXXXGOOOOOOOOOOOXXXXXXXXGOOOOOOOXXXXXXXXXXXXGOOOOOOOOOOXXXXXXXXX,0,256,0
35742,161,1,160,52,127,0,0,288,185,103,GOOOOOOOOOXXXXXXXXXXGOOOOOOOOOOOOOOXXXXXGOOOOOOOOOOOXXXXXXXXGOOOOOOOOOOOOOOOOXXXGOOOOOOAXXXXXXXXXXXXGOOOOOOOOOOOOOOOOOOOGOOOOOOOOXXXXXXXXXXXGOOOOOOOOOOOOXXXXXXXGOOOOOOOOOOOOOOOOOOXGOOOOOOXXXXXXXXXXXXXGOOOOOOOOOOOXXXXXXXXGOOOOOOOXXXXXXXXXXXXGOOOOOOOOOOXXXXXXXXX,0,256,0
35763,161,1,160,57,122,0,0,283,189,94,GOOOOOOOOOXXXXXXXXXXGOOOOOOOOOOOOOOXXXXXGOOOOOOOOOOOXXXXXXXXGOOOOOOOOOOOOOOOOXXXGOOOOOOAXXXXXXXXXXXXGOOOOOOOOOOOOOOOOOOOGOOOOOOOOXXXXXXXXXXXGOOOOOOOOOOOOXXXXXXXGOOOOOOOOOOOOOOOOOOXGOOOOOOXXXXXXXXXXXXXGOOOOOOOOOOOXXXXXXXXGOOOOOOOXXXXXXXXXXXXGOOOOOOOOOOXXXXXXXXX,0,256,0
35784,161,1,160,60,119,0,0,279,187,92,GOOOOOOOOOXXXXXXXXXXGOOOOOOOOOOOOOOXXXXXGOOOOOOOOOOOXXXXXXXXGOOOOOOOOOOOOOOOOXXXGOOOOOOAXXXXXXXXXXXXGOOOOOOOOOOOOOOOOOOOGOOOOOOOOXXXXXXXXXXXGOOOOOOOOOOOOXXXXXXXGOOOOOOOOOOOOOOOOOOXGOOOOOOXXXXXXXXXXXXXGOOOOOOOOOOOXXXXXXXXGOOOOOOOXXXXXXXXXXXXGOOOOOOOOOOXXXXXXXXX,0,256,0

35805,161,1,160,63,116,0,0,276,183,93,GOOOOOOOOOXXXXXXXXXXGOOOOOOOOOOOOOOXXXXXGOOOOOOOOOOOXXXXXXXXGOOOOOOOOOOOOOOOOXXXGOOOOOOAXXXXXXXXXXXXGOOOOOOOOOOOOOOOOOOOGOOOOOOOOXXXXXXXXXXXGOOOOOOOOOOOOXXXXXXXGOOOOOOOOOOOOOOOOOOXGOOOOOOXXXXXXXXXXXXXGOOOOOOOOOOOXXXXXXXXGOOOOOOOXXXXXXXXXXXXGOOOOOOOOOOXXXXXXXXX,0,256,0
35826,161,1,160,63,116,0,0,276,181,95,GOOOOOOOOOXXXXXXXXXXGOOOOOOOOOOOOOOXXXXXGOOOOOOOOOOOXXXXXXXXGOOOOOOOOOOOOOOOOXXXGOOOOOOAXXXXXXXXXXXXGOOOOOOOOOOOOOOOOOOOGOOOOOOOOXXXXXXXXXXXGOOOOOOOOOOOOXXXXXXXGOOOOOOOOOOOOOOOOOOXGOOOOOOXXXXXXXXXXXXXGOOOOOOOOOOOXXXXXXXXGOOOOOOOXXXXXXXXXXXXGOOOOOOOOOOXXXXXXXXX,0,256,0
35847,161,1,160,61,118,0,0,278,182,96,GOOOOOOOOOXXXXXXXXXXGOOOOOOOOOOOOOOXXXXXGOOOOOOOOOOOXXXXXXXXGOOOOOOOOOOOOOOOOXXXGOOOOOOAXXXXXXXXXXXXGOOOOOOOOOOOOOOOOOOOGOOOOOOOOXXXXXXXXXXXGOOOOOOOOOOOOXXXXXXXGOOOOOOOOOOOOOOOOOOXGOOOOOOXXXXXXXXXXXXXGOOOOOOOOOOOXXXXXXXXGOOOOOOOXXXXXXXXXXXXGOOOOOOOOOOXXXXXXXXX,0,256,0
35868,162,2,160,61,117,0,0,277,177,100,GOOOOOOOOOAXXXXXXXXXGOOOOOOOOOOOOOOXXXXXGOOOOOOOOOOOXXXXXXXXGOOOOOOOOOOOOOOOOXXXGOOOOOOAXXXXXXXXXXXXGOOOOOOOOOOOOOOOOOOOGOOOOOOOOXXXXXXXXXXXGOOOOOOOOOOOOXXXXXXXGOOOOOOOOOOOOOOOOOOXGOOOOOOXXXXXXXXXXXXXGOOOOOOOOOOOXXXXXXXXGOOOOOOOXXXXXXXXXXXXGOOOOOOOOOOXXXXXXXXX,0,256,0
35889,162,2,160,55,123,0,0,282,182,100,GOOOOOOOOOAXXXXXXXXXGOOOOOOOOOOOOOOXXXXXGOOOOOOOOOOOXXXXXXXXGOOOOOOOOOOOOOOOOXXXGOOOOOOAXXXXXXXXXXXXGOOOOOOOOOOOOOOOOOOOGOOOOOOOOXXXXXXXXXXXGOOOOOOOOOOOOXXXXXXXGOOOOOOOOOOOOOOOOOOXGOOOOOOXXXXXXXXXXXXXGOOOOOOOOOOOXXXXXXXXGOOOOOOOXXXXXXXXXXXXGOOOOOOOOOOXXXXXXXXX,0,256,0

35910,162,1,161,62,116,0,0,276,177,99,GOOOOOOOOOAXXXXXXXXXGOOOOOOOOOOOOOOXXXXXGOOOOOOOOOOOXXXXXXXXGOOOOOOOOOOOOOOOOXXXGOOOOOOOXXXXXXXXXXXXGOOOOOOOOOOOOOOOOOOOGOOOOOOOOXXXXXXXXXXXGOOOOOOOOOOOOXXXXXXXGOOOOOOOOOOOOOOOOOOXGOOOOOOXXXXXXXXXXXXXGOOOOOOOOOOOXXXXXXXXGOOOOOOOXXXXXXXXXXXXGOOOOOOOOOOXXXXXXXXX,0,256,0
35931,162,1,161,58,120,0,0,280,182,98,GOOOOOOOOOAXXXXXXXXXGOOOOOOOOOOOOOOXXXXXGOOOOOOOOOOOXXXXXXXXGOOOOOOOOOOOOOOOOXXXGOOOOOOOXXXXXXXXXXXXGOOOOOOOOOOOOOOOOOOOGOOOOOOOOXXXXXXXXXXXGOOOOOOOOOOOOXXXXXXXGOOOOOOOOOOOOOOOOOOXGOOOOOOXXXXXXXXXXXXXGOOOOOOOOOOOXXXXXXXXGOOOOOOOXXXXXXXXXXXXGOOOOOOOOOOXXXXXXXXX,0,256,0
35952,162,1,161,59,119,0,0,279,184,95,GOOOOOOOOOAXXXXXXXXXGOOOOOOOOOOOOOOXXXXXGOOOOOOOOOOOXXXXXXXXGOOOOOOOOOOOOOOOOXXXGOOOOOOOXXXXXXXXXXXXGOOOOOOOOOOOOOOOOOOOGOOOOOOOOXXXXXXXXXXXGOOOOOOOOOOOOXXXXXXXGOOOOOOOOOOOOOOOOOOXGOOOOOOXXXXXXXXXXXXXGOOOOOOOOOOOXXXXXXXXGOOOOOOOXXXXXXXXXXXXGOOOOOOOOOOXXXXXXXXX,0,256,0
35973,162,1,161,63,115,0,0,275,178,97,GOOOOOOOOOAXXXXXXXXXGOOOOOOOOOOOOOOXXXXXGOOOOOOOOOOOXXXXXXXXGOOOOOOOOOOOOOOOOXXXGOOOOOOOXXXXXXXXXXXXGOOOOOOOOOOOOOOOOOOOGOOOOOOOOXXXXXXXXXXXGOOOOOOOOOOOOXXXXXXXGOOOOOOOOOOOOOOOOOOXGOOOOOOXXXXXXXXXXXXXGOOOOOOOOOOOXXXXXXXXGOOOOOOOXXXXXXXXXXXXGOOOOOOOOOOXXXXXXXXX,0,256,0
35994,162,0,162,57,121,0,0,281,179,102,GOOOOOOOOOOXXXXXXXXXGOOOOOOOOOOOOOOXXXXXGOOOOOOOOOOOXXXXXXXXGOOOOOOOOOOOOOOOOXXXGOOOOOOOXXXXXXXXXXXXGOOOOOOOOOOOOOOOOOOOGOOOOOOOOXXXXXXXXXXXGOOOOOOOOOOOOXXXXXXXGOOOOOOOOOOOOOOOOOOXGOOOOOOXXXXXXXXXXXXXGOOOOOOOOOOOXXXXXXXXGOOOOOOOXXXXXXXXXXXXGOOOOOOOOOOXXXXXXXXX,0,256,0

36015,162,0,162,56,122,0,0,282,181,101,GOOOOOOOOOOXXXXXXXXXGOOOOOOOOOOOOOOXXXXXGOOOOOOOOOOOXXXXXXXXGOOOOOOOOOOOOOOOOXXXGOOOOOOOXXXXXXXXXXXXGOOOOOOOOOOOOOOOOOOOGOOOOOOOOXXXXXXXXXXXGOOOOOOOOOOOOXXXXXXXGOOOOOOOOOOOOOOOOOOXGOOOOOOXXXXXXXXXXXXXGOOOOOOOOOOOXXXXXXXXGOOOOOOOXXXXXXXXXXXXGOOOOOOOOOOXXXXXXXXX,0,256,0
36036,162,0,162,55,123,0,0,283,180,103,GOOOOOOOOOOXXXXXXXXXGOOOOOOOOOOOOOOXXXXXGOOOOOOOOOOOXXXXXXXXGOOOOOOOOOOOOOOOOXXXGOOOOOOOXXXXXXXXXXXXGOOOOOOOOOOOOOOOOOOOGOOOOOOOOXXXXXXXXXXXGOOOOOOOOOOOOXXXXXXXGOOOOOOOOOOOOOOOOOOXGOOOOOOXXXXXXXXXXXXXGOOOOOOOOOOOXXXXXXXXGOOOOOOOXXXXXXXXXXXXGOOOOOOOOOOXXXXXXXXX,0,256,0
36057,162,0,162,58,120,0,0,280,182,98,GOOOOOOOOOOXXXXXXXXXGOOOOOOOOOOOOOOXXXXXGOOOOOOOOOOOXXXXXXXXGOOOOOOOOOOOOOOOOXXXGOOOOOOOXXXXXXXXXXXXGOOOOOOOOOOOOOOOOOOOGOOOOOOOOXXXXXXXXXXXGOOOOOOOOOOOOXXXXXXXGOOOOOOOOOOOOOOOOOOXGOOOOOOXXXXXXXXXXXXXGOOOOOOOOOOOXXXXXXXXGOOOOOOOXXXXXXXXXXXXGOOOOOOOOOOXXXXXXXXX,0,256,0
36078,162,0,162,59,119,0,0,277,186,91,GOOOOOOOOOOXXXXXXXXXGOOOOOOOOOOOOOOXXXXXGOOOOOOOOOOOXXXXXXXXGOOOOOOOOOOOOOOOOXXXGOOOOOOOXXXXXXXXXXXXGOOOOOOOOOOOOOOOOOOOGOOOOOOOOXXXXXXXXXXXGOOOOOOOOOOOOXXXXXXXGOOOOOOOOOOOOOOOOOOXGOOOOOOXXXXXXXXXXXXXGOOOOOOOOOOOXXXXXXXXGOOOOOOOXXXXXXXXXXXXGOOOOOOOOOOXXXXXXXXX,0,256,0
36099,163,1,162,56,121,0,0,281,187,94,GOOOOOOOOOOXXXXXXXXXGOOOOOOOOOOOOOOXXXXXGOOOOOOOOOOOXXXXXXXXGOOOOOOOOOOOOOOOOXXXGOOOOOOOXXXXXXXXXXXXGOOOOOOOOOOOOOOOOOOOGOOOOOOOOXXXXXXXXXXXGOOOOOOOOOOOOXXXXXXXGOOOOOOOOOOOOOOOOOOXGOOOOOOXXXXXXXXXXXXXGOOOOOOOOOOOAXXXXXXXGOOOOOOOXXXXXXXXXXXXGOOOOOOOOOOXXXXXXXXX,0,256,0

36120,163,1,162,59,118,0,0,278,184,94,GOOOOOOOOOOXXXXXXXXXGOOOOOOOOOOOOOOXXXXXGOOOOOOOOOOOXXXXXXXXGOOOOOOOOOOOOOOOOXXXGOOOOOOOXXXXXXXXXXXXGOOOOOOOOOOOOOOOOOOOGOOOOOOOOXXXXXXXXXXXGOOOOOOOOOOOOXXXXXXXGOOOOOOOOOOOOOOOOOOXGOOOOOOXXXXXXXXXXXXXGOOOOOOOOOOOAXXXXXXXGOOOOOOOXXXXXXXXXXXXGOOOOOOOOOOXXXXXXXXX,0,256,0
36141,163,1,162,59,118,0,0,279,184,95,GOOOOOOOOOOXXXXXXXXXGOOOOOOOOOOOOOOXXXXXGOOOOOOOOOOOXXXXXXXXGOOOOOOOOOOOOOOOOXXXGOOOOOOOXXXXXXXXXXXXGOOOOOOOOOOOOOOOOOOOGOOOOOOOOXXXXXXXXXXXGOOOOOOOOOOOOXXXXXXXGOOOOOOOOOOOOOOOOOOXGOOOOOOXXXXXXXXXXXXXGOOOOOOOOOOOAXXXXXXXGOOOOOOOXXXXXXXXXXXXGOOOOOOOOOOXXXXXXXXX,0,256,0
36162,163,1,162,53,124,0,0,285,186,99,GOOOOOOOOOOXXXXXXXXXGOOOOOOOOOOOOOOXXXXXGOOOOOOOOOOOXXXXXXXXGOOOOOOOOOOOOOOOOXXXGOOOOOOOXXXXXXXXXXXXGOOOOOOOOOOOOOOOOOOOGOOOOOOOOXXXXXXXXXXXGOOOOOOOOOOOOXXXXXXXGOOOOOOOOOOOOOOOOOOXGOOOOOOXXXXXXXXXXXXXGOOOOOOOOOOOAXXXXXXXGOOOOOOOXXXXXXXXXXXXGOOOOOOOOOOXXXXXXXXX,0,256,0
36183,163,1,162,52,125,0,0,286,180,106,GOOOOOOOOOOXXXXXXXXXGOOOOOOOOOOOOOOXXXXXGOOOOOOOOOOOXXXXXXXXGOOOOOOOOOOOOOOOOXXXGOOOOOOOXXXXXXXXXXXXGOOOOOOOOOOOOOOOOOOOGOOOOOOOOXXXXXXXXXXXGOOOOOOOOOOOOXXXXXXXGOOOOOOOOOOOOOOOOOOXGOOOOOOXXXXXXXXXXXXXGOOOOOOOOOOOAXXXXXXXGOOOOOOOXXXXXXXXXXXXGOOOOOOOOOOXXXXXXXXX,0,256,0
36204,163,1,162,55,122,0,0,283,182,101,GOOOOOOOOOOXXXXXXXXXGOOOOOOOOOOOOOOXXXXXGOOOOOOOOOOOXXXXXXXXGOOOOOOOOOOOOOOOOXXXGOOOOOOOXXXXXXXXXXXXGOOOOOOOOOOOOOOOOOOOGOOOOOOOOXXXXXXXXXXXGOOOOOOOOOOOOXXXXXXXGOOOOOOOOOOOOOOOOOOXGOOOOOOXXXXXXXXXXXXXGOOOOOOOOOOOAXXXXXXXGOOOOOOOXXXXXXXXXXXXGOOOOOOOOOOXXXXXXXXX,0,256,0

36225,163,1,162,50,127,0,0,287,183,104,GOOOOOOOOOOXXXXXXXXXGOOOOOOOOOOOOOOXXXXXGOOOOOOOOOOOXXXXXXXXGOOOOOOOOOOOOOOOOXXXGOOOOOOOXXXXXXXXXXXXGOOOOOOOOOOOOOOOOOOOGOOOOOOOOXXXXXXXXXXXGOOOOOOOOOOOOXXXXXXXGOOOOOOOOOOOOOOOOOOXGOOOOOOXXXXXXXXXXXXXGOOOOOOOOOOOAXXXXXXXGOOOOOOOXXXXXXXXXXXXGOOOOOOOOOOXXXXXXXXX,0,256,0
36246,163,1,162,60,117,0,0,277,173,104,GOOOOOOOOOOXXXXXXXXXGOOOOOOOOOOOOOOXXXXXGOOOOOOOOOOOXXXXXXXXGOOOOOOOOOOOOOOOOXXXGOOOOOOOXXXXXXXXXXXXGOOOOOOOOOOOOOOOOOOOGOOOOOOOOXXXXXXXXXXXGOOOOOOOOOOOOXXXXXXXGOOOOOOOOOOOOOOOOOOXGOOOOOOXXXXXXXXXXXXXGOOOOOOOOOOOAXXXXXXXGOOOOOOOXXXXXXXXXXXXGOOOOOOOOOOXXXXXXXXX,0,256,0
36267,163,1,162,55,122,0,0,282,177,105,GOOOOOOOOOOXXXXXXXXXGOOOOOOOOOOOOOOXXXXXGOOOOOOOOOOOXXXXXXXXGOOOOOOOOOOOOOOOOXXXGOOOOOOOXXXXXXXXXXXXGOOOOOOOOOOOOOOOOOOOGOOOOOOOOXXXXXXXXXXXGOOOOOOOOOOOOXXXXXXXGOOOOOOOOOOOOOOOOOOXGOOOOOOXXXXXXXXXXXXXGOOOOOOOOOOOAXXXXXXXGOOOOOOOXXXXXXXXXXXXGOOOOOOOOOOXXXXXXXXX,0,256,0
36288,163,1,162,56,121,0,0,281,180,101,GOOOOOOOOOOXXXXXXXXXGOOOOOOOOOOOOOOXXXXXGOOOOOOOOOOOXXXXXXXXGOOOOOOOOOOOOOOOOXXXGOOOOOOOXXXXXXXXXXXXGOOOOOOOOOOOOOOOOOOOGOOOOOOOOXXXXXXXXXXXGOOOOOOOOOOOOXXXXXXXGOOOOOOOOOOOOOOOOOOXGOOOOOOXXXXXXXXXXXXXGOOOOOOOOOOOAXXXXXXXGOOOOOOOXXXXXXXXXXXXGOOOOOOOOOOXXXXXXXXX,0,256,0
36309,163,1,162,56,121,0,0,280,181,99,GOOOOOOOOOOXXXXXXXXXGOOOOOOOOOOOOOOXXXXXGOOOOOOOOOOOXXXXXXXXGOOOOOOOOOOOOOOOOXXXGOOOOOOOXXXXXXXXXXXXGOOOOOOOOOOOOOOOOOOOGOOOOOOOOXXXXXXXXXXXGOOOOOOOOOOOOXXXXXXXGOOOOOOOOOOOOOOOOOOXGOOOOOOXXXXXXXXXXXXXGOOOOOOOOOOOAXXXXXXXGOOOOOOOXXXXXXXXXXXXGOOOOOOOOOOXXXXXXXXX,0,256,0

36330,164,2,162,52,124,0,0,284,180,104,GOOOOOOOOOOXXXXXXXXXGOOOOOOOOOOOOOOXXXXXGOOOOOOOOOOOXXXXXXXXGOOOOOOOOOOOOOOOOXXXGOOOOOOOXXXXXXXXXXXXGOOOOOOOOOOOOOOOOOOOGOOOOOOOOXXXXXXXXXXXGOOOOOOOOOOOOXXXXXXXGOOOOOOOOOOOOOOOOOOXGOOOOOOXXXXXXXXXXXXXGOOOOOOOOOOOAXXXXXXXGOOOOOOOXXXXXXXXXXXXGOOOOOOOOOOAXXXXXXXX,0,256,0
36351,164,2,162,53,123,0,0,283,184,99,GOOOOOOOOOOXXXXXXXXXGOOOOOOOOOOOOOOXXXXXGOOOOOOOOOOOXXXXXXXXGOOOOOOOOOOOOOOOOXXXGOOOOOOOXXXXXXXXXXXXGOOOOOOOOOOOOOOOOOOOGOOOOOOOOXXXXXXXXXXXGOOOOOOOOOOOOXXXXXXXGOOOOOOOOOOOOOOOOOOXGOOOOOOXXXXXXXXXXXXXGOOOOOOOOOOOAXXXXXXXGOOOOOOOXXXXXXXXXXXXGOOOOOOOOOOAXXXXXXXX,0,256,0
36372,164,2,162,51,125,0,0,285,184,101,GOOOOOOOOOOXXXXXXXXXGOOOOOOOOOOOOOOXXXXXGOOOOOOOOOOOXXXXXXXXGOOOOOOOOOOOOOOOOXXXGOOOOOOOXXXXXXXXXXXXGOOOOOOOOOOOOOOOOOOOGOOOOOOOOXXXXXXXXXXXGOOOOOOOOOOOOXXXXXXXGOOOOOOOOOOOOOOOOOOXGOOOOOOXXXXXXXXXXXXXGOOOOOOOOOOOAXXXXXXXGOOOOOOOXXXXXXXXXXXXGOOOOOOOOOOAXXXXXXXX,0,256,0
36393,164,2,162,52,124,0,0,284,185,99,GOOOOOOOOOOXXXXXXXXXGOOOOOOOOOOOOOOXXXXXGOOOOOOOOOOOXXXXXXXXGOOOOOOOOOOOOOOOOXXXGOOOOOOOXXXXXXXXXXXXGOOOOOOOOOOOOOOOOOOOGOOOOOOOOXXXXXXXXXXXGOOOOOOOOOOOOXXXXXXXGOOOOOOOOOOOOOOOOOOXGOOOOOOXXXXXXXXXXXXXGOOOOOOOOOOOAXXXXXXXGOOOOOOOXXXXXXXXXXXXGOOOOOOOOOOAXXXXXXXX,0,256,0
36414,164,2,162,54,122,0,0,282,180,102,GOOOOOOOOOOXXXXXXXXXGOOOOOOOOOOOOOOXXXXXGOOOOOOOOOOOXXXXXXXXGOOOOOOOOOOOOOOOOXXXGOOOOOOOXXXXXXXXXXXXGOOOOOOOOOOOOOOOOOOOGOOOOOOOOXXXXXXXXXXXGOOOOOOOOOOOOXXXXXXXGOOOOOOOOOOOOOOOOOOXGOOOOOOXXXXXXXXXXXXXGOOOOOOOOOOOAXXXXXXXGOOOOOOOXXXXXXXXXXXXGOOOOOOOOOOAXXXXXXXX,0,256,0

36435,164,2,162,53,123,0,0,283,181,102,GOOOOOOOOOOXXXXXXXXXGOOOOOOOOOOOOOOXXXXXGOOOOOOOOOOOXXXXXXXXGOOOOOOOOOOOOOOOOXXXGOOOOOOOXXXXXXXXXXXXGOOOOOOOOOOOOOOOOOOOGOOOOOOOOXXXXXXXXXXXGOOOOOOOOOOOOXXXXXXXGOOOOOOOOOOOOOOOOOOXGOOOOOOXXXXXXXXXXXXXGOOOOOOOOOOOAXXXXXXXGOOOOOOOXXXXXXXXXXXXGOOOOOOOOOOAXXXXXXXX,0,256,0
36456,164,2,162,54,122,0,0,282,182,100,GOOOOOOOOOOXXXXXXXXXGOOOOOOOOOOOOOOXXXXXGOOOOOOOOOOOXXXXXXXXGOOOOOOOOOOOOOOOOXXXGOOOOOOOXXXXXXXXXXXXGOOOOOOOOOOOOOOOOOOOGOOOOOOOOXXXXXXXXXXXGOOOOOOOOOOOOXXXXXXXGOOOOOOOOOOOOOOOOOOXGOOOOOOXXXXXXXXXXXXXGOOOOOOOOOOOAXXXXXXXGOOOOOOOXXXXXXXXXXXXGOOOOOOOOOOAXXXXXXXX,0,256,0
36477,164,1,163,52,124,0,0,283,186,97,GOOOOOOOOOOXXXXXXXXXGOOOOOOOOOOOOOOXXXXXGOOOOOOOOOOOXXXXXXXXGOOOOOOOOOOOOOOOOXXXGOOOOOOOXXXXXXXXXXXXGOOOOOOOOOOOOOOOOOOOGOOOOOOOOXXXXXXXXXXXGOOOOOOOOOOOOXXXXXXXGOOOOOOOOOOOOOOOOOOXGOOOOOOXXXXXXXXXXXXXGOOOOOOOOOOOOXXXXXXXGOOOOOOOXXXXXXXXXXXXGOOOOOOOOOOAXXXXXXXX,0,256,0
36498,164,1,163,48,128,0,0,288,186,102,GOOOOOOOOOOXXXXXXXXXGOOOOOOOOOOOOOOXXXXXGOOOOOOOOOOOXXXXXXXXGOOOOOOOOOOOOOOOOXXXGOOOOOOOXXXXXXXXXXXXGOOOOOOOOOOOOOOOOOOOGOOOOOOOOXXXXXXXXXXXGOOOOOOOOOOOOXXXXXXXGOOOOOOOOOOOOOOOOOOXGOOOOOOXXXXXXXXXXXXXGOOOOOOOOOOOOXXXXXXXGOOOOOOOXXXXXXXXXXXXGOOOOOOOOOOAXXXXXXXX,0,256,0
36519,164,1,163,49,127,0,0,287,186,101,GOOOOOOOOOOXXXXXXXXXGOOOOOOOOOOOOOOXXXXXGOOOOOOOOOOOXXXXXXXXGOOOOOOOOOOOOOOOOXXXGOOOOOOOXXXXXXXXXXXXGOOOOOOOOOOOOOOOOOOOGOOOOOOOOXXXXXXXXXXXGOOOOOOOOOOOOXXXXXXXGOOOOOOOOOOOOOOOOOOXGOOOOOOXXXXXXXXXXXXXGOOOOOOOOOOOOXXXXXXXGOOOOOOOXXXXXXXXXXXXGOOOOOOOOOOAXXXXXXXX,0,256,0

36540,164,1,163,53,123,0,0,283,186,97,GOOOOOOOOOOXXXXXXXXXGOOOOOOOOOOOOOOXXXXXGOOOOOOOOOOOXXXXXXXXGOOOOOOOOOOOOOOOOXXXGOOOOOOOXXXXXXXXXXXXGOOOOOOOOOOOOOOOOOOOGOOOOOOOOXXXXXXXXXXXGOOOOOOOOOOOOXXXXXXXGOOOOOOOOOOOOOOOOOOXGOOOOOOXXXXXXXXXXXXXGOOOOOOOOOOOOXXXXXXXGOOOOOOOXXXXXXXXXXXXGOOOOOOOOOOAXXXXXXXX,0,256,0
36561,164,1,163,50,126,0,0,286,192,94,GOOOOOOOOOOXXXXXXXXXGOOOOOOOOOOOOOOXXXXXGOOOOOOOOOOOXXXXXXXXGOOOOOOOOOOOOOOOOXXXGOOOOOOOXXXXXXXXXXXXGOOOOOOOOOOOOOOOOOOOGOOOOOOOOXXXXXXXXXXXGOOOOOOOOOOOOXXXXXXXGOOOOOOOOOOOOOOOOOOXGOOOOOOXXXXXXXXXXXXXGOOOOOOOOOOOOXXXXXXXGOOOOOOOXXXXXXXXXXXXGOOOOOOOOOOAXXXXXXXX,0,256,0
36582,164,1,163,59,117,0,0,277,184,93,GOOOOOOOOOOXXXXXXXXXGOOOOOOOOOOOOOOXXXXXGOOOOOOOOOOOXXXXXXXXGOOOOOOOOOOOOOOOOXXXGOOOOOOOXXXXXXXXXXXXGOOOOOOOOOOOOOOOOOOOGOOOOOOOOXXXXXXXXXXXGOOOOOOOOOOOOXXXXXXXGOOOOOOOOOOOOOOOOOOXGOOOOOOXXXXXXXXXXXXXGOOOOOOOOOOOOXXXXXXXGOOOOOOOXXXXXXXXXXXXGOOOOOOOOOOAXXXXXXXX,0,256,0
36603,164,1,163,60,116,0,0,275,184,91,GOOOOOOOOOOXXXXXXXXXGOOOOOOOOOOOOOOXXXXXGOOOOOOOOOOOXXXXXXXXGOOOOOOOOOOOOOOOOXXXGOOOOOOOXXXXXXXXXXXXGOOOOOOOOOOOOOOOOOOOGOOOOOOOOXXXXXXXXXXXGOOOOOOOOOOOOXXXXXXXGOOOOOOOOOOOOOOOOOOXGOOOOOOXXXXXXXXXXXXXGOOOOOOOOOOOOXXXXXXXGOOOOOOOXXXXXXXXXXXXGOOOOOOOOOOAXXXXXXXX,0,256,0
36624,164,1,163,56,120,0,0,280,188,92,GOOOOOOOOOOXXXXXXXXXGOOOOOOOOOOOOOOXXXXXGOOOOOOOOOOOXXXXXXXXGOOOOOOOOOOOOOOOOXXXGOOOOOOOXXXXXXXXXXXXGOOOOOOOOOOOOOOOOOOOGOOOOOOOOXXXXXXXXXXXGOOOOOOOOOOOOXXXXXXXGOOOOOOOOOOOOOOOOOOXGOOOOOOXXXXXXXXXXXXXGOOOOOOOOOOOOXXXXXXXGOOOOOOOXXXXXXXXXXXXGOOOOOOOOOOAXXXXXXXX,0,256,0

36645,164,1,163,54,122,0,0,282,185,97,GOOOOOOOOOOXXXXXXXXXGOOOOOOOOOOOOOOXXXXXGOOOOOOOOOOOXXXXXXXXGOOOOOOOOOOOOOOOOXXXGOOOOOOOXXXXXXXXXXXXGOOOOOOOOOOOOOOOOOOOGOOOOOOOOXXXXXXXXXXXGOOOOOOOOOOOOXXXXXXXGOOOOOOOOOOOOOOOOOOXGOOOOOOXXXXXXXXXXXXXGOOOOOOOOOOOOXXXXXXXGOOOOOOOXXXXXXXXXXXXGOOOOOOOOOOAXXXXXXXX,0,256,0
36666,164,0,164,57,119,0,0,279,183,96,GOOOOOOOOOOXXXXXXXXXGOOOOOOOOOOOOOOXXXXXGOOOOOOOOOOOXXXXXXXXGOOOOOOOOOOOOOOOOXXXGOOOOOOOXXXXXXXXXXXXGOOOOOOOOOOOOOOOOOOOGOOOOOOOOXXXXXXXXXXXGOOOOOOOOOOOOXXXXXXXGOOOOOOOOOOOOOOOOOOXGOOOOOOXXXXXXXXXXXXXGOOOOOOOOOOOOXXXXXXXGOOOOOOOXXXXXXXXXXXXGOOOOOOOOOOOXXXXXXXX,0,256,0
36687,164,0,164,55,121,0,0,281,182,99,GOOOOOOOOOOXXXXXXXXXGOOOOOOOOOOOOOOXXXXXGOOOOOOOOOOOXXXXXXXXGOOOOOOOOOOOOOOOOXXXGOOOOOOOXXXXXXXXXXXXGOOOOOOOOOOOOOOOOOOOGOOOOOOOOXXXXXXXXXXXGOOOOOOOOOOOOXXXXXXXGOOOOOOOOOOOOOOOOOOXGOOOOOOXXXXXXXXXXXXXGOOOOOOOOOOOOXXXXXXXGOOOOOOOXXXXXXXXXXXXGOOOOOOOOOOOXXXXXXXX,0,256,0
36708,164,0,164,56,120,0,0,280,182,98,GOOOOOOOOOOXXXXXXXXXGOOOOOOOOOOOOOOXXXXXGOOOOOOOOOOOXXXXXXXXGOOOOOOOOOOOOOOOOXXXGOOOOOOOXXXXXXXXXXXXGOOOOOOOOOOOOOOOOOOOGOOOOOOOOXXXXXXXXXXXGOOOOOOOOOOOOXXXXXXXGOOOOOOOOOOOOOOOOOOXGOOOOOOXXXXXXXXXXXXXGOOOOOOOOOOOOXXXXXXXGOOOOOOOXXXXXXXXXXXXGOOOOOOOOOOOXXXXXXXX,0,256,0
36729,164,0,164,56,120,0,0,280,185,95,GOOOOOOOOOOXXXXXXXXXGOOOOOOOOOOOOOOXXXXXGOOOOOOOOOOOXXXXXXXXGOOOOOOOOOOOOOOOOXXXGOOOOOOOXXXXXXXXXXXXGOOOOOOOOOOOOOOOOOOOGOOOOOOOOXXXXXXXXXXXGOOOOOOOOOOOOXXXXXXXGOOOOOOOOOOOOOOOOOOXGOOOOOOXXXXXXXXXXXXXGOOOOOOOOOOOOXXXXXXXGOOOOOOOXXXXXXXXXXXXGOOOOOOOOOOOXXXXXXXX,0,256,0

36750,164,0,164,59,117,0,0,277,184,93,GOOOOOOOOOOXXXXXXXXXGOOOOOOOOOOOOOOXXXXXGOOOOOOOOOOOXXXXXXXXGOOOOOOOOOOOOOOOOXXXGOOOOOOOXXXXXXXXXXXXGOOOOOOOOOOOOOOOOOOOGOOOOOOOOXXXXXXXXXXXGOOOOOOOOOOOOXXXXXXXGOOOOOOOOOOOOOOOOOOXGOOOOOOXXXXXXXXXXXXXGOOOOOOOOOOOOXXXXXXXGOOOOOOOXXXXXXXXXXXXGOOOOOOOOOOOXXXXXXXX,0,256,0
36771,164,0,164,62,114,0,0,274,182,92,GOOOOOOOOOOXXXXXXXXXGOOOOOOOOOOOOOOXXXXXGOOOOOOOOOOOXXXXXXXXGOOOOOOOOOOOOOOOOXXXGOOOOOOOXXXXXXXXXXXXGOOOOOOOOOOOOOOOOOOOGOOOOOOOOXXXXXXXXXXXGOOOOOOOOOOOOXXXXXXXGOOOOOOOOOOOOOOOOOOXGOOOOOOXXXXXXXXXXXXXGOOOOOOOOOOOOXXXXXXXGOOOOOOOXXXXXXXXXXXXGOOOOOOOOOOOXXXXXXXX,0,256,0
36792,164,0,164,64,112,0,0,271,185,86,GOOOOOOOOOOXXXXXXXXXGOOOOOOOOOOOOOOXXXXXGOOOOOOOOOOOXXXXXXXXGOOOOOOOOOOOOOOOOXXXGOOOOOOOXXXXXXXXXXXXGOOOOOOOOOOOOOOOOOOOGOOOOOOOOXXXXXXXXXXXGOOOOOOOOOOOOXXXXXXXGOOOOOOOOOOOOOOOOOOXGOOOOOOXXXXXXXXXXXXXGOOOOOOOOOOOOXXXXXXXGOOOOOOOXXXXXXXXXXXXGOOOOOOOOOOOXXXXXXXX,0,256,0
36813,164,0,164,65,111,0,0,271,187,84,GOOOOOOOOOOXXXXXXXXXGOOOOOOOOOOOOOOXXXXXGOOOOOOOOOOOXXXXXXXXGOOOOOOOOOOOOOOOOXXXGOOOOOOOXXXXXXXXXXXXGOOOOOOOOOOOOOOOOOOOGOOOOOOOOXXXXXXXXXXXGOOOOOOOOOOOOXXXXXXXGOOOOOOOOOOOOOOOOOOXGOOOOOOXXXXXXXXXXXXXGOOOOOOOOOOOOXXXXXXXGOOOOOOOXXXXXXXXXXXXGOOOOOOOOOOOXXXXXXXX,0,256,0
36834,164,0,164,62,114,0,0,273,191,82,GOOOOOOOOOOXXXXXXXXXGOOOOOOOOOOOOOOXXXXXGOOOOOOOOOOOXXXXXXXXGOOOOOOOOOOOOOOOOXXXGOOOOOOOXXXXXXXXXXXXGOOOOOOOOOOOOOOOOOOOGOOOOOOOOXXXXXXXXXXXGOOOOOOOOOOOOXXXXXXXGOOOOOOOOOOOOOOOOOOXGOOOOOOXXXXXXXXXXXXXGOOOOOOOOOOOOXXXXXXXGOOOOOOOXXXXXXXXXXXXGOOOOOOOOOOOXXXXXXXX,0,256,0

36855,164,0,164,59,117,0,0,276,194,82,GOOOOOOOOOOXXXXXXXXXGOOOOOOOOOOOOOOXXXXXGOOOOOOOOOOOXXXXXXXXGOOOOOOOOOOOOOOOOXXXGOOOOOOOXXXXXXXXXXXXGOOOOOOOOOOOOOOOOOOOGOOOOOOOOXXXXXXXXXXXGOOOOOOOOOOOOXXXXXXXGOOOOOOOOOOOOOOOOOOXGOOOOOOXXXXXXXXXXXXXGOOOOOOOOOOOOXXXXXXXGOOOOOOOXXXXXXXXXXXXGOOOOOOOOOOOXXXXXXXX,0,256,0
36876,164,0,164,57,119,0,0,278,194,84,GOOOOOOOOOOXXXXXXXXXGOOOOOOOOOOOOOOXXXXXGOOOOOOOOOOOXXXXXXXXGOOOOOOOOOOOOOOOOXXXGOOOOOOOXXXXXXXXXXXXGOOOOOOOOOOOOOOOOOOOGOOOOOOOOXXXXXXXXXXXGOOOOOOOOOOOOXXXXXXXGOOOOOOOOOOOOOOOOOOXGOOOOOOXXXXXXXXXXXXXGOOOOOOOOOOOOXXXXXXXGOOOOOOOXXXXXXXXXXXXGOOOOOOOOOOOXXXXXXXX,0,256,0
36897,164,0,164,57,119,0,0,279,194,85,GOOOOOOOOOOXXXXXXXXXGOOOOOOOOOOOOOOXXXXXGOOOOOOOOOOOXXXXXXXXGOOOOOOOOOOOOOOOOXXXGOOOOOOOXXXXXXXXXXXXGOOOOOOOOOOOOOOOOOOOGOOOOOOOOXXXXXXXXXXXGOOOOOOOOOOOOXXXXXXXGOOOOOOOOOOOOOOOOOOXGOOOOOOXXXXXXXXXXXXXGOOOOOOOOOOOOXXXXXXXGOOOOOOOXXXXXXXXXXXXGOOOOOOOOOOOXXXXXXXX,0,256,0
36918,164,0,164,65,111,0,0,271,189,82,GOOOOOOOOOOXXXXXXXXXGOOOOOOOOOOOOOOXXXXXGOOOOOOOOOOOXXXXXXXXGOOOOOOOOOOOOOOOOXXXGOOOOOOOXXXXXXXXXXXXGOOOOOOOOOOOOOOOOOOOGOOOOOOOOXXXXXXXXXXXGOOOOOOOOOOOOXXXXXXXGOOOOOOOOOOOOOOOOOOXGOOOOOOXXXXXXXXXXXXXGOOOOOOOOOOOOXXXXXXXGOOOOOOOXXXXXXXXXXXXGOOOOOOOOOOOXXXXXXXX,0,256,0
36939,164,0,164,66,110,0,0,270,187,83,GOOOOOOOOOOXXXXXXXXXGOOOOOOOOOOOOOOXXXXXGOOOOOOOOOOOXXXXXXXXGOOOOOOOOOOOOOOOOXXXGOOOOOOOXXXXXXXXXXXXGOOOOOOOOOOOOOOOOOOOGOOOOOOOOXXXXXXXXXXXGOOOOOOOOOOOOXXXXXXXGOOOOOOOOOOOOOOOOOOXGOOOOOOXXXXXXXXXXXXXGOOOOOOOOOOOOXXXXXXXGOOOOOOOXXXXXXXXXXXXGOOOOOOOOOOOXXXXXXXX,0,256,0

36960,164,0,164,64,112,0,0,270,186,84,GOOOOOOOOOOXXXXXXXXXGOOOOOOOOOOOOOOXXXXXGOOOOOOOOOOOXXXXXXXXGOOOOOOOOOOOOOOOOXXXGOOOOOOOXXXXXXXXXXXXGOOOOOOOOOOOOOOOOOOOGOOOOOOOOXXXXXXXXXXXGOOOOOOOOOOOOXXXXXXXGOOOOOOOOOOOOOOOOOOXGOOOOOOXXXXXXXXXXXXXGOOOOOOOOOOOOXXXXXXXGOOOOOOOXXXXXXXXXXXXGOOOOOOOOOOOXXXXXXXX,0,256,0
36981,164,0,164,55,121,0,0,281,185,96,GOOOOOOOOOOXXXXXXXXXGOOOOOOOOOOOOOOXXXXXGOOOOOOOOOOOXXXXXXXXGOOOOOOOOOOOOOOOOXXXGOOOOOOOXXXXXXXXXXXXGOOOOOOOOOOOOOOOOOOOGOOOOOOOOXXXXXXXXXXXGOOOOOOOOOOOOXXXXXXXGOOOOOOOOOOOOOOOOOOXGOOOOOOXXXXXXXXXXXXXGOOOOOOOOOOOOXXXXXXXGOOOOOOOXXXXXXXXXXXXGOOOOOOOOOOOXXXXXXXX,0,256,0
37002,164,0,164,52,124,0,0,283,183,100,GOOOOOOOOOOXXXXXXXXXGOOOOOOOOOOOOOOXXXXXGOOOOOOOOOOOXXXXXXXXGOOOOOOOOOOOOOOOOXXXGOOOOOOOXXXXXXXXXXXXGOOOOOOOOOOOOOOOOOOOGOOOOOOOOXXXXXXXXXXXGOOOOOOOOOOOOXXXXXXXGOOOOOOOOOOOOOOOOOOXGOOOOOOXXXXXXXXXXXXXGOOOOOOOOOOOOXXXXXXXGOOOOOOOXXXXXXXXXXXXGOOOOOOOOOOOXXXXXXXX,0,256,0
37023,164,0,164,52,124,0,0,285,183,102,GOOOOOOOOOOXXXXXXXXXGOOOOOOOOOOOOOOXXXXXGOOOOOOOOOOOXXXXXXXXGOOOOOOOOOOOOOOOOXXXGOOOOOOOXXXXXXXXXXXXGOOOOOOOOOOOOOOOOOOOGOOOOOOOOXXXXXXXXXXXGOOOOOOOOOOOOXXXXXXXGOOOOOOOOOOOOOOOOOOXGOOOOOOXXXXXXXXXXXXXGOOOOOOOOOOOOXXXXXXXGOOOOOOOXXXXXXXXXXXXGOOOOOOOOOOOXXXXXXXX,0,256,0
37044,164,0,164,50,126,0,0,287,179,108,GOOOOOOOOOOXXXXXXXXXGOOOOOOOOOOOOOOXXXXXGOOOOOOOOOOOXXXXXXXXGOOOOOOOOOOOOOOOOXXXGOOOOOOOXXXXXXXXXXXXGOOOOOOOOOOOOOOOOOOOGOOOOOOOOXXXXXXXXXXXGOOOOOOOOOOOOXXXXXXXGOOOOOOOOOOOOOOOOOOXGOOOOOOXXXXXXXXXXXXXGOOOOOOOOOOOOXXXXXXXGOOOOOOOXXXXXXXXXXXXGOOOOOOOOOOOXXXXXXXX,0,256,0

37065,164,0,164,45,131,0,0,292,177,115,GOOOOOOOOOOXXXXXXXXXGOOOOOOOOOOOOOOXXXXXGOOOOOOOOOOOXXXXXXXXGOOOOOOOOOOOOOOOOXXXGOOOOOOOXXXXXXXXXXXXGOOOOOOOOOOOOOOOOOOOGOOOOOOOOXXXXXXXXXXXGOOOOOOOOOOOOXXXXXXXGOOOOOOOOOOOOOOOOOOXGOOOOOOXXXXXXXXXXXXXGOOOOOOOOOOOOXXXXXXXGOOOOOOOXXXXXXXXXXXXGOOOOOOOOOOOXXXXXXXX,0,256,0
37086,164,0,164,48,128,0,0,289,180,109,GOOOOOOOOOOXXXXXXXXXGOOOOOOOOOOOOOOXXXXXGOOOOOOOOOOOXXXXXXXXGOOOOOOOOOOOOOOOOXXXGOOOOOOOXXXXXXXXXXXXGOOOOOOOOOOOOOOOOOOOGOOOOOOOOXXXXXXXXXXXGOOOOOOOOOOOOXXXXXXXGOOOOOOOOOOOOOOOOOOXGOOOOOOXXXXXXXXXXXXXGOOOOOOOOOOOOXXXXXXXGOOOOOOOXXXXXXXXXXXXGOOOOOOOOOOOXXXXXXXX,0,256,0
37107,164,0,164,49,127,0,0,286,179,107,GOOOOOOOOOOXXXXXXXXXGOOOOOOOOOOOOOOXXXXXGOOOOOOOOOOOXXXXXXXXGOOOOOOOOOOOOOOOOXXXGOOOOOOOXXXXXXXXXXXXGOOOOOOOOOOOOOOOOOOOGOOOOOOOOXXXXXXXXXXXGOOOOOOOOOOOOXXXXXXXGOOOOOOOOOOOOOOOOOOXGOOOOOOXXXXXXXXXXXXXGOOOOOOOOOOOOXXXXXXXGOOOOOOOXXXXXXXXXXXXGOOOOOOOOOOOXXXXXXXX,0,256,0
37128,164,0,164,49,127,0,0,287,182,105,GOOOOOOOOOOXXXXXXXXXGOOOOOOOOOOOOOOXXXXXGOOOOOOOOOOOXXXXXXXXGOOOOOOOOOOOOOOOOXXXGOOOOOOOXXXXXXXXXXXXGOOOOOOOOOOOOOOOOOOOGOOOOOOOOXXXXXXXXXXXGOOOOOOOOOOOOXXXXXXXGOOOOOOOOOOOOOOOOOOXGOOOOOOXXXXXXXXXXXXXGOOOOOOOOOOOOXXXXXXXGOOOOOOOXXXXXXXXXXXXGOOOOOOOOOOOXXXXXXXX,0,256,0
37149,164,0,164,50,126,0,0,286,182,104,GOOOOOOOOOOXXXXXXXXXGOOOOOOOOOOOOOOXXXXXGOOOOOOOOOOOXXXXXXXXGOOOOOOOOOOOOOOOOXXXGOOOOOOOXXXXXXXXXXXXGOOOOOOOOOOOOOOOOOOOGOOOOOOOOXXXXXXXXXXXGOOOOOOOOOOOOXXXXXXXGOOOOOOOOOOOOOOOOOOXGOOOOOOXXXXXXXXXXXXXGOOOOOOOOOOOOXXXXXXXGOOOOOOOXXXXXXXXXXXXGOOOOOOOOOOOXXXXXXXX,0,256,0

37170,164,0,164,53,123,0,0,283,186,97,GOOOOOOOOOOXXXXXXXXXGOOOOOOOOOOOOOOXXXXXGOOOOOOOOOOOXXXXXXXXGOOOOOOOOOOOOOOOOXXXGOOOOOOOXXXXXXXXXXXXGOOOOOOOOOOOOOOOOOOOGOOOOOOOOXXXXXXXXXXXGOOOOOOOOOOOOXXXXXXXGOOOOOOOOOOOOOOOOOOXGOOOOOOXXXXXXXXXXXXXGOOOOOOOOOOOOXXXXXXXGOOOOOOOXXXXXXXXXXXXGOOOOOOOOOOOXXXXXXXX,0,256,0
37191,164,0,164,52,124,0,0,284,184,100,GOOOOOOOOOOXXXXXXXXXGOOOOOOOOOOOOOOXXXXXGOOOOOOOOOOOXXXXXXXXGOOOOOOOOOOOOOOOOXXXGOOOOOOOXXXXXXXXXXXXGOOOOOOOOOOOOOOOOOOOGOOOOOOOOXXXXXXXXXXXGOOOOOOOOOOOOXXXXXXXGOOOOOOOOOOOOOOOOOOXGOOOOOOXXXXXXXXXXXXXGOOOOOOOOOOOOXXXXXXXGOOOOOOOXXXXXXXXXXXXGOOOOOOOOOOOXXXXXXXX,0,256,0
37212,164,0,164,53,123,0,0,283,184,99,GOOOOOOOOOOXXXXXXXXXGOOOOOOOOOOOOOOXXXXXGOOOOOOOOOOOXXXXXXXXGOOOOOOOOOOOOOOOOXXXGOOOOOOOXXXXXXXXXXXXGOOOOOOOOOOOOOOOOOOOGOOOOOOOOXXXXXXXXXXXGOOOOOOOOOOOOXXXXXXXGOOOOOOOOOOOOOOOOOOXGOOOOOOXXXXXXXXXXXXXGOOOOOOOOOOOOXXXXXXXGOOOOOOOXXXXXXXXXXXXGOOOOOOOOOOOXXXXXXXX,0,256,0
37233,164,0,164,55,121,0,0,281,186,95,GOOOOOOOOOOXXXXXXXXXGOOOOOOOOOOOOOOXXXXXGOOOOOOOOOOOXXXXXXXXGOOOOOOOOOOOOOOOOXXXGOOOOOOOXXXXXXXXXXXXGOOOOOOOOOOOOOOOOOOOGOOOOOOOOXXXXXXXXXXXGOOOOOOOOOOOOXXXXXXXGOOOOOOOOOOOOOOOOOOXGOOOOOOXXXXXXXXXXXXXGOOOOOOOOOOOOXXXXXXXGOOOOOOOXXXXXXXXXXXXGOOOOOOOOOOOXXXXXXXX,0,256,0
37254,164,0,164,58,118,0,0,278,188,90,GOOOOOOOOOOXXXXXXXXXGOOOOOOOOOOOOOOXXXXXGOOOOOOOOOOOXXXXXXXXGOOOOOOOOOOOOOOOOXXXGOOOOOOOXXXXXXXXXXXXGOOOOOOOOOOOOOOOOOOOGOOOOOOOOXXXXXXXXXXXGOOOOOOOOOOOOXXXXXXXGOOOOOOOOOOOOOOOOOOXGOOOOOOXXXXXXXXXXXXXGOOOOOOOOOOOOXXXXXXXGOOOOOOOXXXXXXXXXXXXGOOOOOOOOOOOXXXXXXXX,0,256,0

37275,165,1,164,58,117,0,0,277,190,87,GOOOOOOOOOOAXXXXXXXXGOOOOOOOOOOOOOOXXXXXGOOOOOOOOOOOXXXXXXXXGOOOOOOOOOOOOOOOOXXXGOOOOOOOXXXXXXXXXXXXGOOOOOOOOOOOOOOOOOOOGOOOOOOOOXXXXXXXXXXXGOOOOOOOOOOOOXXXXXXXGOOOOOOOOOOOOOOOOOOXGOOOOOOXXXXXXXXXXXXXGOOOOOOOOOOOOXXXXXXXGOOOOOOOXXXXXXXXXXXXGOOOOOOOOOOOXXXXXXXX,0,256,0
37296,165,1,164,64,111,0,0,270,185,85,GOOOOOOOOOOAXXXXXXXXGOOOOOOOOOOOOOOXXXXXGOOOOOOOOOOOXXXXXXXXGOOOOOOOOOOOOOOOOXXXGOOOOOOOXXXXXXXXXXXXGOOOOOOOOOOOOOOOOOOOGOOOOOOOOXXXXXXXXXXXGOOOOOOOOOOOOXXXXXXXGOOOOOOOOOOOOOOOOOOXGOOOOOOXXXXXXXXXXXXXGOOOOOOOOOOOOXXXXXXXGOOOOOOOXXXXXXXXXXXXGOOOOOOOOOOOXXXXXXXX,0,256,0
37317,165,1,164,65,110,0,0,270,185,85,GOOOOOOOOOOAXXXXXXXXGOOOOOOOOOOOOOOXXXXXGOOOOOOOOOOOXXXXXXXXGOOOOOOOOOOOOOOOOXXXGOOOOOOOXXXXXXXXXXXXGOOOOOOOOOOOOOOOOOOOGOOOOOOOOXXXXXXXXXXXGOOOOOOOOOOOOXXXXXXXGOOOOOOOOOOOOOOOOOOXGOOOOOOXXXXXXXXXXXXXGOOOOOOOOOOOOXXXXXXXGOOOOOOOXXXXXXXXXXXXGOOOOOOOOOOOXXXXXXXX,0,256,0
37338,165,1,164,65,110,0,0,270,183,87,GOOOOOOOOOOAXXXXXXXXGOOOOOOOOOOOOOOXXXXXGOOOOOOOOOOOXXXXXXXXGOOOOOOOOOOOOOOOOXXXGOOOOOOOXXXXXXXXXXXXGOOOOOOOOOOOOOOOOOOOGOOOOOOOOXXXXXXXXXXXGOOOOOOOOOOOOXXXXXXXGOOOOOOOOOOOOOOOOOOXGOOOOOOXXXXXXXXXXXXXGOOOOOOOOOOOOXXXXXXXGOOOOOOOXXXXXXXXXXXXGOOOOOOOOOOOXXXXXXXX,0,256,0
37359,165,1,164,61,114,0,0,273,185,88,GOOOOOOOOOOAXXXXXXXXGOOOOOOOOOOOOOOXXXXXGOOOOOOOOOOOXXXXXXXXGOOOOOOOOOOOOOOOOXXXGOOOOOOOXXXXXXXXXXXXGOOOOOOOOOOOOOOOOOOOGOOOOOOOOXXXXXXXXXXXGOOOOOOOOOOOOXXXXXXXGOOOOOOOOOOOOOOOOOOXGOOOOOOXXXXXXXXXXXXXGOOOOOOOOOOOOXXXXXXXGOOOOOOOXXXXXXXXXXXXGOOOOOOOOOOOXXXXXXXX,0,256,0

37380,165,1,164,54,121,0,0,279,188,91,GOOOOOOOOOOAXXXXXXXXGOOOOOOOOOOOOOOXXXXXGOOOOOOOOOOOXXXXXXXXGOOOOOOOOOOOOOOOOXXXGOOOOOOOXXXXXXXXXXXXGOOOOOOOOOOOOOOOOOOOGOOOOOOOOXXXXXXXXXXXGOOOOOOOOOOOOXXXXXXXGOOOOOOOOOOOOOOOOOOXGOOOOOOXXXXXXXXXXXXXGOOOOOOOOOOOOXXXXXXXGOOOOOOOXXXXXXXXXXXXGOOOOOOOOOOOXXXXXXXX,0,256,0
37401,165,1,164,56,119,0,0,279,190,89,GOOOOOOOOOOAXXXXXXXXGOOOOOOOOOOOOOOXXXXXGOOOOOOOOOOOXXXXXXXXGOOOOOOOOOOOOOOOOXXXGOOOOOOOXXXXXXXXXXXXGOOOOOOOOOOOOOOOOOOOGOOOOOOOOXXXXXXXXXXXGOOOOOOOOOOOOXXXXXXXGOOOOOOOOOOOOOOOOOOXGOOOOOOXXXXXXXXXXXXXGOOOOOOOOOOOOXXXXXXXGOOOOOOOXXXXXXXXXXXXGOOOOOOOOOOOXXXXXXXX,0,256,0
37422,165,1,164,57,118,0,0,278,190,88,GOOOOOOOOOOAXXXXXXXXGOOOOOOOOOOOOOOXXXXXGOOOOOOOOOOOXXXXXXXXGOOOOOOOOOOOOOOOOXXXGOOOOOOOXXXXXXXXXXXXGOOOOOOOOOOOOOOOOOOOGOOOOOOOOXXXXXXXXXXXGOOOOOOOOOOOOXXXXXXXGOOOOOOOOOOOOOOOOOOXGOOOOOOXXXXXXXXXXXXXGOOOOOOOOOOOOXXXXXXXGOOOOOOOXXXXXXXXXXXXGOOOOOOOOOOOXXXXXXXX,0,256,0
37443,165,1,164,58,117,0,0,277,186,91,GOOOOOOOOOOAXXXXXXXXGOOOOOOOOOOOOOOXXXXXGOOOOOOOOOOOXXXXXXXXGOOOOOOOOOOOOOOOOXXXGOOOOOOOXXXXXXXXXXXXGOOOOOOOOOOOOOOOOOOOGOOOOOOOOXXXXXXXXXXXGOOOOOOOOOOOOXXXXXXXGOOOOOOOOOOOOOOOOOOXGOOOOOOXXXXXXXXXXXXXGOOOOOOOOOOOOXXXXXXXGOOOOOOOXXXXXXXXXXXXGOOOOOOOOOOOXXXXXXXX,0,256,0
37464,165,1,164,57,118,0,0,278,186,92,GOOOOOOOOOOAXXXXXXXXGOOOOOOOOOOOOOOXXXXXGOOOOOOOOOOOXXXXXXXXGOOOOOOOOOOOOOOOOXXXGOOOOOOOXXXXXXXXXXXXGOOOOOOOOOOOOOOOOOOOGOOOOOOOOXXXXXXXXXXXGOOOOOOOOOOOOXXXXXXXGOOOOOOOOOOOOOOOOOOXGOOOOOOXXXXXXXXXXXXXGOOOOOOOOOOOOXXXXXXXGOOOOOOOXXXXXXXXXXXXGOOOOOOOOOOOXXXXXXXX,0,256,0

37485,165,1,164,55,120,0,0,280,187,93,GOOOOOOOOOOAXXXXXXXXGOOOOOOOOOOOOOOXXXXXGOOOOOOOOOOOXXXXXXXXGOOOOOOOOOOOOOOOOXXXGOOOOOOOXXXXXXXXXXXXGOOOOOOOOOOOOOOOOOOOGOOOOOOOOXXXXXXXXXXXGOOOOOOOOOOOOXXXXXXXGOOOOOOOOOOOOOOOOOOXGOOOOOOXXXXXXXXXXXXXGOOOOOOOOOOOOXXXXXXXGOOOOOOOXXXXXXXXXXXXGOOOOOOOOOOOXXXXXXXX,0,256,0
37506,165,1,164,61,114,0,0,274,186,88,GOOOOOOOOOOAXXXXXXXXGOOOOOOOOOOOOOOXXXXXGOOOOOOOOOOOXXXXXXXXGOOOOOOOOOOOOOOOOXXXGOOOOOOOXXXXXXXXXXXXGOOOOOOOOOOOOOOOOOOOGOOOOOOOOXXXXXXXXXXXGOOOOOOOOOOOOXXXXXXXGOOOOOOOOOOOOOOOOOOXGOOOOOOXXXXXXXXXXXXXGOOOOOOOOOOOOXXXXXXXGOOOOOOOXXXXXXXXXXXXGOOOOOOOOOOOXXXXXXXX,0,256,0
37527,165,0,165,58,117,0,0,277,184,93,GOOOOOOOOOOOXXXXXXXXGOOOOOOOOOOOOOOXXXXXGOOOOOOOOOOOXXXXXXXXGOOOOOOOOOOOOOOOOXXXGOOOOOOOXXXXXXXXXXXXGOOOOOOOOOOOOOOOOOOOGOOOOOOOOXXXXXXXXXXXGOOOOOOOOOOOOXXXXXXXGOOOOOOOOOOOOOOOOOOXGOOOOOOXXXXXXXXXXXXXGOOOOOOOOOOOOXXXXXXXGOOOOOOOXXXXXXXXXXXXGOOOOOOOOOOOXXXXXXXX,0,256,0
37548,165,0,165,58,117,0,0,277,187,90,GOOOOOOOOOOOXXXXXXXXGOOOOOOOOOOOOOOXXXXXGOOOOOOOOOOOXXXXXXXXGOOOOOOOOOOOOOOOOXXXGOOOOOOOXXXXXXXXXXXXGOOOOOOOOOOOOOOOOOOOGOOOOOOOOXXXXXXXXXXXGOOOOOOOOOOOOXXXXXXXGOOOOOOOOOOOOOOOOOOXGOOOOOOXXXXXXXXXXXXXGOOOOOOOOOOOOXXXXXXXGOOOOOOOXXXXXXXXXXXXGOOOOOOOOOOOXXXXXXXX,0,256,0
37569,165,0,165,62,113,0,0,273,185,88,GOOOOOOOOOOOXXXXXXXXGOOOOOOOOOOOOOOXXXXXGOOOOOOOOOOOXXXXXXXXGOOOOOOOOOOOOOOOOXXXGOOOOOOOXXXXXXXXXXXXGOOOOOOOOOOOOOOOOOOOGOOOOOOOOXXXXXXXXXXXGOOOOOOOOOOOOXXXXXXXGOOOOOOOOOOOOOOOOOOXGOOOOOOXXXXXXXXXXXXXGOOOOOOOOOOOOXXXXXXXGOOOOOOOXXXXXXXXXXXXGOOOOOOOOOOOXXXXXXXX,0,256,0

37590,165,0,165,65,110,0,0,268,179,89,GOOOOOOOOOOOXXXXXXXXGOOOOOOOOOOOOOOXXXXXGOOOOOOOOOOOXXXXXXXXGOOOOOOOOOOOOOOOOXXXGOOOOOOOXXXXXXXXXXXXGOOOOOOOOOOOOOOOOOOOGOOOOOOOOXXXXXXXXXXXGOOOOOOOOOOOOXXXXXXXGOOOOOOOOOOOOOOOOOOXGOOOOOOXXXXXXXXXXXXXGOOOOOOOOOOOOXXXXXXXGOOOOOOOXXXXXXXXXXXXGOOOOOOOOOOOXXXXXXXX,0,256,0
37611,165,0,165,64,111,0,0,271,184,87,GOOOOOOOOOOOXXXXXXXXGOOOOOOOOOOOOOOXXXXXGOOOOOOOOOOOXXXXXXXXGOOOOOOOOOOOOOOOOXXXGOOOOOOOXXXXXXXXXXXXGOOOOOOOOOOOOOOOOOOOGOOOOOOOOXXXXXXXXXXXGOOOOOOOOOOOOXXXXXXXGOOOOOOOOOOOOOOOOOOXGOOOOOOXXXXXXXXXXXXXGOOOOOOOOOOOOXXXXXXXGOOOOOOOXXXXXXXXXXXXGOOOOOOOOOOOXXXXXXXX,0,256,0
37632,165,0,165,60,115,0,0,275,180,95,GOOOOOOOOOOOXXXXXXXXGOOOOOOOOOOOOOOXXXXXGOOOOOOOOOOOXXXXXXXXGOOOOOOOOOOOOOOOOXXXGOOOOOOOXXXXXXXXXXXXGOOOOOOOOOOOOOOOOOOOGOOOOOOOOXXXXXXXXXXXGOOOOOOOOOOOOXXXXXXXGOOOOOOOOOOOOOOOOOOXGOOOOOOXXXXXXXXXXXXXGOOOOOOOOOOOOXXXXXXXGOOOOOOOXXXXXXXXXXXXGOOOOOOOOOOOXXXXXXXX,0,256,0
37653,165,0,165,56,119,0,0,278,183,95,GOOOOOOOOOOOXXXXXXXXGOOOOOOOOOOOOOOXXXXXGOOOOOOOOOOOXXXXXXXXGOOOOOOOOOOOOOOOOXXXGOOOOOOOXXXXXXXXXXXXGOOOOOOOOOOOOOOOOOOOGOOOOOOOOXXXXXXXXXXXGOOOOOOOOOOOOXXXXXXXGOOOOOOOOOOOOOOOOOOXGOOOOOOXXXXXXXXXXXXXGOOOOOOOOOOOOXXXXXXXGOOOOOOOXXXXXXXXXXXXGOOOOOOOOOOOXXXXXXXX,0,256,0
37674,165,0,165,57,118,0,0,278,185,93,GOOOOOOOOOOOXXXXXXXXGOOOOOOOOOOOOOOXXXXXGOOOOOOOOOOOXXXXXXXXGOOOOOOOOOOOOOOOOXXXGOOOOOOOXXXXXXXXXXXXGOOOOOOOOOOOOOOOOOOOGOOOOOOOOXXXXXXXXXXXGOOOOOOOOOOOOXXXXXXXGOOOOOOOOOOOOOOOOOOXGOOOOOOXXXXXXXXXXXXXGOOOOOOOOOOOOXXXXXXXGOOOOOOOXXXXXXXXXXXXGOOOOOOOOOOOXXXXXXXX,0,256,0

37695,165,0,165,62,113,0,0,273,181,92,GOOOOOOOOOOOXXXXXXXXGOOOOOOOOOOOOOOXXXXXGOOOOOOOOOOOXXXXXXXXGOOOOOOOOOOOOOOOOXXXGOOOOOOOXXXXXXXXXXXXGOOOOOOOOOOOOOOOOOOOGOOOOOOOOXXXXXXXXXXXGOOOOOOOOOOOOXXXXXXXGOOOOOOOOOOOOOOOOOOXGOOOOOOXXXXXXXXXXXXXGOOOOOOOOOOOOXXXXXXXGOOOOOOOXXXXXXXXXXXXGOOOOOOOOOOOXXXXXXXX,0,256,0
37716,165,0,165,60,115,0,0,275,189,86,GOOOOOOOOOOOXXXXXXXXGOOOOOOOOOOOOOOXXXXXGOOOOOOOOOOOXXXXXXXXGOOOOOOOOOOOOOOOOXXXGOOOOOOOXXXXXXXXXXXXGOOOOOOOOOOOOOOOOOOOGOOOOOOOOXXXXXXXXXXXGOOOOOOOOOOOOXXXXXXXGOOOOOOOOOOOOOOOOOOXGOOOOOOXXXXXXXXXXXXXGOOOOOOOOOOOOXXXXXXXGOOOOOOOXXXXXXXXXXXXGOOOOOOOOOOOXXXXXXXX,0,256,0
37737,165,0,165,59,116,0,0,276,187,89,GOOOOOOOOOOOXXXXXXXXGOOOOOOOOOOOOOOXXXXXGOOOOOOOOOOOXXXXXXXXGOOOOOOOOOOOOOOOOXXXGOOOOOOOXXXXXXXXXXXXGOOOOOOOOOOOOOOOOOOOGOOOOOOOOXXXXXXXXXXXGOOOOOOOOOOOOXXXXXXXGOOOOOOOOOOOOOOOOOOXGOOOOOOXXXXXXXXXXXXXGOOOOOOOOOOOOXXXXXXXGOOOOOOOXXXXXXXXXXXXGOOOOOOOOOOOXXXXXXXX,0,256,0
37758,165,0,165,61,114,0,0,274,183,91,GOOOOOOOOOOOXXXXXXXXGOOOOOOOOOOOOOOXXXXXGOOOOOOOOOOOXXXXXXXXGOOOOOOOOOOOOOOOOXXXGOOOOOOOXXXXXXXXXXXXGOOOOOOOOOOOOOOOOOOOGOOOOOOOOXXXXXXXXXXXGOOOOOOOOOOOOXXXXXXXGOOOOOOOOOOOOOOOOOOXGOOOOOOXXXXXXXXXXXXXGOOOOOOOOOOOOXXXXXXXGOOOOOOOXXXXXXXXXXXXGOOOOOOOOOOOXXXXXXXX,0,256,0
37779,165,0,165,63,112,0,0,272,178,94,GOOOOOOOOOOOXXXXXXXXGOOOOOOOOOOOOOOXXXXXGOOOOOOOOOOOXXXXXXXXGOOOOOOOOOOOOOOOOXXXGOOOOOOOXXXXXXXXXXXXGOOOOOOOOOOOOOOOOOOOGOOOOOOOOXXXXXXXXXXXGOOOOOOOOOOOOXXXXXXXGOOOOOOOOOOOOOOOOOOXGOOOOOOXXXXXXXXXXXXXGOOOOOOOOOOOOXXXXXXXGOOOOOOOXXXXXXXXXXXXGOOOOOOOOOOOXXXXXXXX,0,256,0

37800,165,0,165,61,114,0,0,274,181,93,GOOOOOOOOOOOXXXXXXXXGOOOOOOOOOOOOOOXXXXXGOOOOOOOOOOOXXXXXXXXGOOOOOOOOOOOOOOOOXXXGOOOOOOOXXXXXXXXXXXXGOOOOOOOOOOOOOOOOOOOGOOOOOOOOXXXXXXXXXXXGOOOOOOOOOOOOXXXXXXXGOOOOOOOOOOOOOOOOOOXGOOOOOOXXXXXXXXXXXXXGOOOOOOOOOOOOXXXXXXXGOOOOOOOXXXXXXXXXXXXGOOOOOOOOOOOXXXXXXXX,0,256,0
37821,165,0,165,53,122,0,0,281,183,98,GOOOOOOOOOOOXXXXXXXXGOOOOOOOOOOOOOOXXXXXGOOOOOOOOOOOXXXXXXXXGOOOOOOOOOOOOOOOOXXXGOOOOOOOXXXXXXXXXXXXGOOOOOOOOOOOOOOOOOOOGOOOOOOOOXXXXXXXXXXXGOOOOOOOOOOOOXXXXXXXGOOOOOOOOOOOOOOOOOOXGOOOOOOXXXXXXXXXXXXXGOOOOOOOOOOOOXXXXXXXGOOOOOOOXXXXXXXXXXXXGOOOOOOOOOOOXXXXXXXX,0,256,0
37842,165,0,165,55,120,0,0,280,185,95,GOOOOOOOOOOOXXXXXXXXGOOOOOOOOOOOOOOXXXXXGOOOOOOOOOOOXXXXXXXXGOOOOOOOOOOOOOOOOXXXGOOOOOOOXXXXXXXXXXXXGOOOOOOOOOOOOOOOOOOOGOOOOOOOOXXXXXXXXXXXGOOOOOOOOOOOOXXXXXXXGOOOOOOOOOOOOOOOOOOXGOOOOOOXXXXXXXXXXXXXGOOOOOOOOOOOOXXXXXXXGOOOOOOOXXXXXXXXXXXXGOOOOOOOOOOOXXXXXXXX,0,256,0
37863,165,0,165,58,117,0,0,277,184,93,GOOOOOOOOOOOXXXXXXXXGOOOOOOOOOOOOOOXXXXXGOOOOOOOOOOOXXXXXXXXGOOOOOOOOOOOOOOOOXXXGOOOOOOOXXXXXXXXXXXXGOOOOOOOOOOOOOOOOOOOGOOOOOOOOXXXXXXXXXXXGOOOOOOOOOOOOXXXXXXXGOOOOOOOOOOOOOOOOOOXGOOOOOOXXXXXXXXXXXXXGOOOOOOOOOOOOXXXXXXXGOOOOOOOXXXXXXXXXXXXGOOOOOOOOOOOXXXXXXXX,0,256,0
37884,165,0,165,54,121,0,0,281,186,95,GOOOOOOOOOOOXXXXXXXXGOOOOOOOOOOOOOOXXXXXGOOOOOOOOOOOXXXXXXXXGOOOOOOOOOOOOOOOOXXXGOOOOOOOXXXXXXXXXXXXGOOOOOOOOOOOOOOOOOOOGOOOOOOOOXXXXXXXXXXXGOOOOOOOOOOOOXXXXXXXGOOOOOOOOOOOOOOOOOOXGOOOOOOXXXXXXXXXXXXXGOOOOOOOOOOOOXXXXXXXGOOOOOOOXXXXXXXXXXXXGOOOOOOOOOOOXXXXXXXX,0,256,0

37905,165,0,165,59,116,0,0,275,185,90,GOOOOOOOOOOOXXXXXXXXGOOOOOOOOOOOOOOXXXXXGOOOOOOOOOOOXXXXXXXXGOOOOOOOOOOOOOOOOXXXGOOOOOOOXXXXXXXXXXXXGOOOOOOOOOOOOOOOOOOOGOOOOOOOOXXXXXXXXXXXGOOOOOOOOOOOOXXXXXXXGOOOOOOOOOOOOOOOOOOXGOOOOOOXXXXXXXXXXXXXGOOOOOOOOOOOOXXXXXXXGOOOOOOOXXXXXXXXXXXXGOOOOOOOOOOOXXXXXXXX,0,256,0
37926,165,0,165,59,116,0,0,276,187,89,GOOOOOOOOOOOXXXXXXXXGOOOOOOOOOOOOOOXXXXXGOOOOOOOOOOOXXXXXXXXGOOOOOOOOOOOOOOOOXXXGOOOOOOOXXXXXXXXXXXXGOOOOOOOOOOOOOOOOOOOGOOOOOOOOXXXXXXXXXXXGOOOOOOOOOOOOXXXXXXXGOOOOOOOOOOOOOOOOOOXGOOOOOOXXXXXXXXXXXXXGOOOOOOOOOOOOXXXXXXXGOOOOOOOXXXXXXXXXXXXGOOOOOOOOOOOXXXXXXXX,0,256,0
37947,165,0,165,58,117,0,0,276,186,90,GOOOOOOOOOOOXXXXXXXXGOOOOOOOOOOOOOOXXXXXGOOOOOOOOOOOXXXXXXXXGOOOOOOOOOOOOOOOOXXXGOOOOOOOXXXXXXXXXXXXGOOOOOOOOOOOOOOOOOOOGOOOOOOOOXXXXXXXXXXXGOOOOOOOOOOOOXXXXXXXGOOOOOOOOOOOOOOOOOOXGOOOOOOXXXXXXXXXXXXXGOOOOOOOOOOOOXXXXXXXGOOOOOOOXXXXXXXXXXXXGOOOOOOOOOOOXXXXXXXX,0,256,0
37968,165,0,165,61,114,0,0,274,185,89,GOOOOOOOOOOOXXXXXXXXGOOOOOOOOOOOOOOXXXXXGOOOOOOOOOOOXXXXXXXXGOOOOOOOOOOOOOOOOXXXGOOOOOOOXXXXXXXXXXXXGOOOOOOOOOOOOOOOOOOOGOOOOOOOOXXXXXXXXXXXGOOOOOOOOOOOOXXXXXXXGOOOOOOOOOOOOOOOOOOXGOOOOOOXXXXXXXXXXXXXGOOOOOOOOOOOOXXXXXXXGOOOOOOOXXXXXXXXXXXXGOOOOOOOOOOOXXXXXXXX,0,256,0
37989,165,0,165,64,111,0,0,271,183,88,GOOOOOOOOOOOXXXXXXXXGOOOOOOOOOOOOOOXXXXXGOOOOOOOOOOOXXXXXXXXGOOOOOOOOOOOOOOOOXXXGOOOOOOOXXXXXXXXXXXXGOOOOOOOOOOOOOOOOOOOGOOOOOOOOXXXXXXXXXXXGOOOOOOOOOOOOXXXXXXXGOOOOOOOOOOOOOOOOOOXGOOOOOOXXXXXXXXXXXXXGOOOOOOOOOOOOXXXXXXXGOOOOOOOXXXXXXXXXXXXGOOOOOOOOOOOXXXXXXXX,0,256,0

38010,165,0,165,62,113,0,0,273,185,88,GOOOOOOOOOOOXXXXXXXXGOOOOOOOOOOOOOOXXXXXGOOOOOOOOOOOXXXXXXXXGOOOOOOOOOOOOOOOOXXXGOOOOOOOXXXXXXXXXXXXGOOOOOOOOOOOOOOOOOOOGOOOOOOOOXXXXXXXXXXXGOOOOOOOOOOOOXXXXXXXGOOOOOOOOOOOOOOOOOOXGOOOOOOXXXXXXXXXXXXXGOOOOOOOOOOOOXXXXXXXGOOOOOOOXXXXXXXXXXXXGOOOOOOOOOOOXXXXXXXX,0,256,0
38031,165,0,165,60,115,0,0,274,183,91,GOOOOOOOOOOOXXXXXXXXGOOOOOOOOOOOOOOXXXXXGOOOOOOOOOOOXXXXXXXXGOOOOOOOOOOOOOOOOXXXGOOOOOOOXXXXXXXXXXXXGOOOOOOOOOOOOOOOOOOOGOOOOOOOOXXXXXXXXXXXGOOOOOOOOOOOOXXXXXXXGOOOOOOOOOOOOOOOOOOXGOOOOOOXXXXXXXXXXXXXGOOOOOOOOOOOOXXXXXXXGOOOOOOOXXXXXXXXXXXXGOOOOOOOOOOOXXXXXXXX,0,256,0
38052,165,0,165,62,113,0,0,273,181,92,GOOOOOOOOOOOXXXXXXXXGOOOOOOOOOOOOOOXXXXXGOOOOOOOOOOOXXXXXXXXGOOOOOOOOOOOOOOOOXXXGOOOOOOOXXXXXXXXXXXXGOOOOOOOOOOOOOOOOOOOGOOOOOOOOXXXXXXXXXXXGOOOOOOOOOOOOXXXXXXXGOOOOOOOOOOOOOOOOOOXGOOOOOOXXXXXXXXXXXXXGOOOOOOOOOOOOXXXXXXXGOOOOOOOXXXXXXXXXXXXGOOOOOOOOOOOXXXXXXXX,0,256,0
38073,165,0,165,59,116,0,0,275,180,95,GOOOOOOOOOOOXXXXXXXXGOOOOOOOOOOOOOOXXXXXGOOOOOOOOOOOXXXXXXXXGOOOOOOOOOOOOOOOOXXXGOOOOOOOXXXXXXXXXXXXGOOOOOOOOOOOOOOOOOOOGOOOOOOOOXXXXXXXXXXXGOOOOOOOOOOOOXXXXXXXGOOOOOOOOOOOOOOOOOOXGOOOOOOXXXXXXXXXXXXXGOOOOOOOOOOOOXXXXXXXGOOOOOOOXXXXXXXXXXXXGOOOOOOOOOOOXXXXXXXX,0,256,0
38094,165,0,165,59,116,0,0,276,182,94,GOOOOOOOOOOOXXXXXXXXGOOOOOOOOOOOOOOXXXXXGOOOOOOOOOOOXXXXXXXXGOOOOOOOOOOOOOOOOXXXGOOOOOOOXXXXXXXXXXXXGOOOOOOOOOOOOOOOOOOOGOOOOOOOOXXXXXXXXXXXGOOOOOOOOOOOOXXXXXXXGOOOOOOOOOOOOOOOOOOXGOOOOOOXXXXXXXXXXXXXGOOOOOOOOOOOOXXXXXXXGOOOOOOOXXXXXXXXXXXXGOOOOOOOOOOOXXXXXXXX,0,256,0

38115,165,0,165,57,118,0,0,278,184,94,GOOOOOOOOOOOXXXXXXXXGOOOOOOOOOOOOOOXXXXXGOOOOOOOOOOOXXXXXXXXGOOOOOOOOOOOOOOOOXXXGOOOOOOOXXXXXXXXXXXXGOOOOOOOOOOOOOOOOOOOGOOOOOOOOXXXXXXXXXXXGOOOOOOOOOOOOXXXXXXXGOOOOOOOOOOOOOOOOOOXGOOOOOOXXXXXXXXXXXXXGOOOOOOOOOOOOXXXXXXXGOOOOOOOXXXXXXXXXXXXGOOOOOOOOOOOXXXXXXXX,0,256,0
38136,165,0,165,53,122,0,0,282,186,96,GOOOOOOOOOOOXXXXXXXXGOOOOOOOOOOOOOOXXXXXGOOOOOOOOOOOXXXXXXXXGOOOOOOOOOOOOOOOOXXXGOOOOOOOXXXXXXXXXXXXGOOOOOOOOOOOOOOOOOOOGOOOOOOOOXXXXXXXXXXXGOOOOOOOOOOOOXXXXXXXGOOOOOOOOOOOOOOOOOOXGOOOOOOXXXXXXXXXXXXXGOOOOOOOOOOOOXXXXXXXGOOOOOOOXXXXXXXXXXXXGOOOOOOOOOOOXXXXXXXX,0,256,0
38157,165,0,165,54,121,0,0,281,185,96,GOOOOOOOOOOOXXXXXXXXGOOOOOOOOOOOOOOXXXXXGOOOOOOOOOOOXXXXXXXXGOOOOOOOOOOOOOOOOXXXGOOOOOOOXXXXXXXXXXXXGOOOOOOOOOOOOOOOOOOOGOOOOOOOOXXXXXXXXXXXGOOOOOOOOOOOOXXXXXXXGOOOOOOOOOOOOOOOOOOXGOOOOOOXXXXXXXXXXXXXGOOOOOOOOOOOOXXXXXXXGOOOOOOOXXXXXXXXXXXXGOOOOOOOOOOOXXXXXXXX,0,256,0
38178,165,0,165,56,119,0,0,279,183,96,GOOOOOOOOOOOXXXXXXXXGOOOOOOOOOOOOOOXXXXXGOOOOOOOOOOOXXXXXXXXGOOOOOOOOOOOOOOOOXXXGOOOOOOOXXXXXXXXXXXXGOOOOOOOOOOOOOOOOOOOGOOOOOOOOXXXXXXXXXXXGOOOOOOOOOOOOXXXXXXXGOOOOOOOOOOOOOOOOOOXGOOOOOOXXXXXXXXXXXXXGOOOOOOOOOOOOXXXXXXXGOOOOOOOXXXXXXXXXXXXGOOOOOOOOOOOXXXXXXXX,0,256,0
38199,165,0,165,55,120,0,0,280,182,98,GOOOOOOOOOOOXXXXXXXXGOOOOOOOOOOOOOOXXXXXGOOOOOOOOOOOXXXXXXXXGOOOOOOOOOOOOOOOOXXXGOOOOOOOXXXXXXXXXXXXGOOOOOOOOOOOOOOOOOOOGOOOOOOOOXXXXXXXXXXXGOOOOOOOOOOOOXXXXXXXGOOOOOOOOOOOOOOOOOOXGOOOOOOXXXXXXXXXXXXXGOOOOOOOOOOOOXXXXXXXGOOOOOOOXXXXXXXXXXXXGOOOOOOOOOOOXXXXXXXX,0,256,0

38220,165,0,165,57,118,0,0,278,180,98,GOOOOOOOOOOOXXXXXXXXGOOOOOOOOOOOOOOXXXXXGOOOOOOOOOOOXXXXXXXXGOOOOOOOOOOOOOOOOXXXGOOOOOOOXXXXXXXXXXXXGOOOOOOOOOOOOOOOOOOOGOOOOOOOOXXXXXXXXXXXGOOOOOOOOOOOOXXXXXXXGOOOOOOOOOOOOOOOOOOXGOOOOOOXXXXXXXXXXXXXGOOOOOOOOOOOOXXXXXXXGOOOOOOOXXXXXXXXXXXXGOOOOOOOOOOOXXXXXXXX,0,256,0
38241,165,0,165,59,116,0,0,276,181,95,GOOOOOOOOOOOXXXXXXXXGOOOOOOOOOOOOOOXXXXXGOOOOOOOOOOOXXXXXXXXGOOOOOOOOOOOOOOOOXXXGOOOOOOOXXXXXXXXXXXXGOOOOOOOOOOOOOOOOOOOGOOOOOOOOXXXXXXXXXXXGOOOOOOOOOOOOXXXXXXXGOOOOOOOOOOOOOOOOOOXGOOOOOOXXXXXXXXXXXXXGOOOOOOOOOOOOXXXXXXXGOOOOOOOXXXXXXXXXXXXGOOOOOOOOOOOXXXXXXXX,0,256,0
38262,165,0,165,54,121,0,0,281,185,96,GOOOOOOOOOOOXXXXXXXXGOOOOOOOOOOOOOOXXXXXGOOOOOOOOOOOXXXXXXXXGOOOOOOOOOOOOOOOOXXXGOOOOOOOXXXXXXXXXXXXGOOOOOOOOOOOOOOOOOOOGOOOOOOOOXXXXXXXXXXXGOOOOOOOOOOOOXXXXXXXGOOOOOOOOOOOOOOOOOOXGOOOOOOXXXXXXXXXXXXXGOOOOOOOOOOOOXXXXXXXGOOOOOOOXXXXXXXXXXXXGOOOOOOOOOOOXXXXXXXX,0,256,0
38283,165,0,165,52,123,0,0,282,186,96,GOOOOOOOOOOOXXXXXXXXGOOOOOOOOOOOOOOXXXXXGOOOOOOOOOOOXXXXXXXXGOOOOOOOOOOOOOOOOXXXGOOOOOOOXXXXXXXXXXXXGOOOOOOOOOOOOOOOOOOOGOOOOOOOOXXXXXXXXXXXGOOOOOOOOOOOOXXXXXXXGOOOOOOOOOOOOOOOOOOXGOOOOOOXXXXXXXXXXXXXGOOOOOOOOOOOOXXXXXXXGOOOOOOOXXXXXXXXXXXXGOOOOOOOOOOOXXXXXXXX,0,256,0
38304,165,0,165,52,123,0,0,283,188,95,GOOOOOOOOOOOXXXXXXXXGOOOOOOOOOOOOOOXXXXXGOOOOOOOOOOOXXXXXXXXGOOOOOOOOOOOOOOOOXXXGOOOOOOOXXXXXXXXXXXXGOOOOOOOOOOOOOOOOOOOGOOOOOOOOXXXXXXXXXXXGOOOOOOOOOOOOXXXXXXXGOOOOOOOOOOOOOOOOOOXGOOOOOOXXXXXXXXXXXXXGOOOOOOOOOOOOXXXXXXXGOOOOOOOXXXXXXXXXXXXGOOOOOOOOOOOXXXXXXXX,0,256,0

38325,165,0,165,52,123,0,0,283,185,98,GOOOOOOOOOOOXXXXXXXXGOOOOOOOOOOOOOOXXXXXGOOOOOOOOOOOXXXXXXXXGOOOOOOOOOOOOOOOOXXXGOOOOOOOXXXXXXXXXXXXGOOOOOOOOOOOOOOOOOOOGOOOOOOOOXXXXXXXXXXXGOOOOOOOOOOOOXXXXXXXGOOOOOOOOOOOOOOOOOOXGOOOOOOXXXXXXXXXXXXXGOOOOOOOOOOOOXXXXXXXGOOOOOOOXXXXXXXXXXXXGOOOOOOOOOOOXXXXXXXX,0,256,0
38346,165,0,165,52,123,0,0,283,190,93,GOOOOOOOOOOOXXXXXXXXGOOOOOOOOOOOOOOXXXXXGOOOOOOOOOOOXXXXXXXXGOOOOOOOOOOOOOOOOXXXGOOOOOOOXXXXXXXXXXXXGOOOOOOOOOOOOOOOOOOOGOOOOOOOOXXXXXXXXXXXGOOOOOOOOOOOOXXXXXXXGOOOOOOOOOOOOOOOOOOXGOOOOOOXXXXXXXXXXXXXGOOOOOOOOOOOOXXXXXXXGOOOOOOOXXXXXXXXXXXXGOOOOOOOOOOOXXXXXXXX,0,256,0
38367,165,0,165,54,121,0,0,281,193,88,GOOOOOOOOOOOXXXXXXXXGOOOOOOOOOOOOOOXXXXXGOOOOOOOOOOOXXXXXXXXGOOOOOOOOOOOOOOOOXXXGOOOOOOOXXXXXXXXXXXXGOOOOOOOOOOOOOOOOOOOGOOOOOOOOXXXXXXXXXXXGOOOOOOOOOOOOXXXXXXXGOOOOOOOOOOOOOOOOOOXGOOOOOOXXXXXXXXXXXXXGOOOOOOOOOOOOXXXXXXXGOOOOOOOXXXXXXXXXXXXGOOOOOOOOOOOXXXXXXXX,0,256,0
38388,165,0,165,53,122,0,0,282,197,85,GOOOOOOOOOOOXXXXXXXXGOOOOOOOOOOOOOOXXXXXGOOOOOOOOOOOXXXXXXXXGOOOOOOOOOOOOOOOOXXXGOOOOOOOXXXXXXXXXXXXGOOOOOOOOOOOOOOOOOOOGOOOOOOOOXXXXXXXXXXXGOOOOOOOOOOOOXXXXXXXGOOOOOOOOOOOOOOOOOOXGOOOOOOXXXXXXXXXXXXXGOOOOOOOOOOOOXXXXXXXGOOOOOOOXXXXXXXXXXXXGOOOOOOOOOOOXXXXXXXX,0,256,0
38409,165,0,165,61,114,0,0,274,191,83,GOOOOOOOOOOOXXXXXXXXGOOOOOOOOOOOOOOXXXXXGOOOOOOOOOOOXXXXXXXXGOOOOOOOOOOOOOOOOXXXGOOOOOOOXXXXXXXXXXXXGOOOOOOOOOOOOOOOOOOOGOOOOOOOOXXXXXXXXXXXGOOOOOOOOOOOOXXXXXXXGOOOOOOOOOOOOOOOOOOXGOOOOOOXXXXXXXXXXXXXGOOOOOOOOOOOOXXXXXXXGOOOOOOOXXXXXXXXXXXXGOOOOOOOOOOOXXXXXXXX,0,256,0

38430,165,0,165,60,115,0,0,275,195,80,GOOOOOOOOOOOXXXXXXXXGOOOOOOOOOOOOOOXXXXXGOOOOOOOOOOOXXXXXXXXGOOOOOOOOOOOOOOOOXXXGOOOOOOOXXXXXXXXXXXXGOOOOOOOOOOOOOOOOOOOGOOOOOOOOXXXXXXXXXXXGOOOOOOOOOOOOXXXXXXXGOOOOOOOOOOOOOOOOOOXGOOOOOOXXXXXXXXXXXXXGOOOOOOOOOOOOXXXXXXXGOOOOOOOXXXXXXXXXXXXGOOOOOOOOOOOXXXXXXXX,0,256,0
38451,165,0,165,61,114,0,0,272,191,81,GOOOOOOOOOOOXXXXXXXXGOOOOOOOOOOOOOOXXXXXGOOOOOOOOOOOXXXXXXXXGOOOOOOOOOOOOOOOOXXXGOOOOOOOXXXXXXXXXXXXGOOOOOOOOOOOOOOOOOOOGOOOOOOOOXXXXXXXXXXXGOOOOOOOOOOOOXXXXXXXGOOOOOOOOOOOOOOOOOOXGOOOOOOXXXXXXXXXXXXXGOOOOOOOOOOOOXXXXXXXGOOOOOOOXXXXXXXXXXXXGOOOOOOOOOOOXXXXXXXX,0,256,0
38472,165,0,165,58,117,0,0,275,195,80,GOOOOOOOOOOOXXXXXXXXGOOOOOOOOOOOOOOXXXXXGOOOOOOOOOOOXXXXXXXXGOOOOOOOOOOOOOOOOXXXGOOOOOOOXXXXXXXXXXXXGOOOOOOOOOOOOOOOOOOOGOOOOOOOOXXXXXXXXXXXGOOOOOOOOOOOOXXXXXXXGOOOOOOOOOOOOOOOOOOXGOOOOOOXXXXXXXXXXXXXGOOOOOOOOOOOOXXXXXXXGOOOOOOOXXXXXXXXXXXXGOOOOOOOOOOOXXXXXXXX,0,256,0
38493,165,0,165,62,113,0,0,273,189,84,GOOOOOOOOOOOXXXXXXXXGOOOOOOOOOOOOOOXXXXXGOOOOOOOOOOOXXXXXXXXGOOOOOOOOOOOOOOOOXXXGOOOOOOOXXXXXXXXXXXXGOOOOOOOOOOOOOOOOOOOGOOOOOOOOXXXXXXXXXXXGOOOOOOOOOOOOXXXXXXXGOOOOOOOOOOOOOOOOOOXGOOOOOOXXXXXXXXXXXXXGOOOOOOOOOOOOXXXXXXXGOOOOOOOXXXXXXXXXXXXGOOOOOOOOOOOXXXXXXXX,0,256,0
38514,165,0,165,60,115,0,0,273,189,84,GOOOOOOOOOOOXXXXXXXXGOOOOOOOOOOOOOOXXXXXGOOOOOOOOOOOXXXXXXXXGOOOOOOOOOOOOOOOOXXXGOOOOOOOXXXXXXXXXXXXGOOOOOOOOOOOOOOOOOOOGOOOOOOOOXXXXXXXXXXXGOOOOOOOOOOOOXXXXXXXGOOOOOOOOOOOOOOOOOOXGOOOOOOXXXXXXXXXXXXXGOOOOOOOOOOOOXXXXXXXGOOOOOOOXXXXXXXXXXXXGOOOOOOOOOOOXXXXXXXX,0,256,0

38535,165,0,165,59,116,0,0,274,188,86,GOOOOOOOOOOOXXXXXXXXGOOOOOOOOOOOOOOXXXXXGOOOOOOOOOOOXXXXXXXXGOOOOOOOOOOOOOOOOXXXGOOOOOOOXXXXXXXXXXXXGOOOOOOOOOOOOOOOOOOOGOOOOOOOOXXXXXXXXXXXGOOOOOOOOOOOOXXXXXXXGOOOOOOOOOOOOOOOOOOXGOOOOOOXXXXXXXXXXXXXGOOOOOOOOOOOOXXXXXXXGOOOOOOOXXXXXXXXXXXXGOOOOOOOOOOOXXXXXXXX,0,256,0
38556,165,0,165,58,117,0,0,276,186,90,GOOOOOOOOOOOXXXXXXXXGOOOOOOOOOOOOOOXXXXXGOOOOOOOOOOOXXXXXXXXGOOOOOOOOOOOOOOOOXXXGOOOOOOOXXXXXXXXXXXXGOOOOOOOOOOOOOOOOOOOGOOOOOOOOXXXXXXXXXXXGOOOOOOOOOOOOXXXXXXXGOOOOOOOOOOOOOOOOOOXGOOOOOOXXXXXXXXXXXXXGOOOOOOOOOOOOXXXXXXXGOOOOOOOXXXXXXXXXXXXGOOOOOOOOOOOXXXXXXXX,0,256,0
38577,166,1,165,54,120,0,0,278,187,91,GOOOOOOOOOOOXXXXXXXXGOOOOOOOOOOOOOOAXXXXGOOOOOOOOOOOXXXXXXXXGOOOOOOOOOOOOOOOOXXXGOOOOOOOXXXXXXXXXXXXGOOOOOOOOOOOOOOOOOOOGOOOOOOOOXXXXXXXXXXXGOOOOOOOOOOOOXXXXXXXGOOOOOOOOOOOOOOOOOOXGOOOOOOXXXXXXXXXXXXXGOOOOOOOOOOOOXXXXXXXGOOOOOOOXXXXXXXXXXXXGOOOOOOOOOOOXXXXXXXX,0,256,0
38598,166,0,166,57,117,0,0,276,187,89,GOOOOOOOOOOOXXXXXXXXGOOOOOOOOOOOOOOOXXXXGOOOOOOOOOOOXXXXXXXXGOOOOOOOOOOOOOOOOXXXGOOOOOOOXXXXXXXXXXXXGOOOOOOOOOOOOOOOOOOOGOOOOOOOOXXXXXXXXXXXGOOOOOOOOOOOOXXXXXXXGOOOOOOOOOOOOOOOOOOXGOOOOOOXXXXXXXXXXXXXGOOOOOOOOOOOOXXXXXXXGOOOOOOOXXXXXXXXXXXXGOOOOOOOOOOOXXXXXXXX,0,256,0
38619,166,0,166,52,122,0,0,282,187,95,GOOOOOOOOOOOXXXXXXXXGOOOOOOOOOOOOOOOXXXXGOOOOOOOOOOOXXXXXXXXGOOOOOOOOOOOOOOOOXXXGOOOOOOOXXXXXXXXXXXXGOOOOOOOOOOOOOOOOOOOGOOOOOOOOXXXXXXXXXXXGOOOOOOOOOOOOXXXXXXXGOOOOOOOOOOOOOOOOOOXGOOOOOOXXXXXXXXXXXXXGOOOOOOOOOOOOXXXXXXXGOOOOOOOXXXXXXXXXXXXGOOOOOOOOOOOXXXXXXXX,0,256,0

38640,166,0,166,56,118,0,0,278,186,92,GOOOOOOOOOOOXXXXXXXXGOOOOOOOOOOOOOOOXXXXGOOOOOOOOOOOXXXXXXXXGOOOOOOOOOOOOOOOOXXXGOOOOOOOXXXXXXXXXXXXGOOOOOOOOOOOOOOOOOOOGOOOOOOOOXXXXXXXXXXXGOOOOOOOOOOOOXXXXXXXGOOOOOOOOOOOOOOOOOOXGOOOOOOXXXXXXXXXXXXXGOOOOOOOOOOOOXXXXXXXGOOOOOOOXXXXXXXXXXXXGOOOOOOOOOOOXXXXXXXX,0,256,0
38661,166,0,166,61,113,0,0,273,181,92,GOOOOOOOOOOOXXXXXXXXGOOOOOOOOOOOOOOOXXXXGOOOOOOOOOOOXXXXXXXXGOOOOOOOOOOOOOOOOXXXGOOOOOOOXXXXXXXXXXXXGOOOOOOOOOOOOOOOOOOOGOOOOOOOOXXXXXXXXXXXGOOOOOOOOOOOOXXXXXXXGOOOOOOOOOOOOOOOOOOXGOOOOOOXXXXXXXXXXXXXGOOOOOOOOOOOOXXXXXXXGOOOOOOOXXXXXXXXXXXXGOOOOOOOOOOOXXXXXXXX,0,256,0
38682,166,0,166,64,110,0,0,271,182,89,GOOOOOOOOOOOXXXXXXXXGOOOOOOOOOOOOOOOXXXXGOOOOOOOOOOOXXXXXXXXGOOOOOOOOOOOOOOOOXXXGOOOOOOOXXXXXXXXXXXXGOOOOOOOOOOOOOOOOOOOGOOOOOOOOXXXXXXXXXXXGOOOOOOOOOOOOXXXXXXXGOOOOOOOOOOOOOOOOOOXGOOOOOOXXXXXXXXXXXXXGOOOOOOOOOOOOXXXXXXXGOOOOOOOXXXXXXXXXXXXGOOOOOOOOOOOXXXXXXXX,0,256,0
38703,166,0,166,63,111,0,0,272,184,88,GOOOOOOOOOOOXXXXXXXXGOOOOOOOOOOOOOOOXXXXGOOOOOOOOOOOXXXXXXXXGOOOOOOOOOOOOOOOOXXXGOOOOOOOXXXXXXXXXXXXGOOOOOOOOOOOOOOOOOOOGOOOOOOOOXXXXXXXXXXXGOOOOOOOOOOOOXXXXXXXGOOOOOOOOOOOOOOOOOOXGOOOOOOXXXXXXXXXXXXXGOOOOOOOOOOOOXXXXXXXGOOOOOOOXXXXXXXXXXXXGOOOOOOOOOOOXXXXXXXX,0,256,0
38724,166,0,166,63,111,0,0,270,183,87,GOOOOOOOOOOOXXXXXXXXGOOOOOOOOOOOOOOOXXXXGOOOOOOOOOOOXXXXXXXXGOOOOOOOOOOOOOOOOXXXGOOOOOOOXXXXXXXXXXXXGOOOOOOOOOOOOOOOOOOOGOOOOOOOOXXXXXXXXXXXGOOOOOOOOOOOOXXXXXXXGOOOOOOOOOOOOOOOOOOXGOOOOOOXXXXXXXXXXXXXGOOOOOOOOOOOOXXXXXXXGOOOOOOOXXXXXXXXXXXXGOOOOOOOOOOOXXXXXXXX,0,256,0

38745,166,0,166,64,110,0,0,270,188,82,GOOOOOOOOOOOXXXXXXXXGOOOOOOOOOOOOOOOXXXXGOOOOOOOOOOOXXXXXXXXGOOOOOOOOOOOOOOOOXXXGOOOOOOOXXXXXXXXXXXXGOOOOOOOOOOOOOOOOOOOGOOOOOOOOXXXXXXXXXXXGOOOOOOOOOOOOXXXXXXXGOOOOOOOOOOOOOOOOOOXGOOOOOOXXXXXXXXXXXXXGOOOOOOOOOOOOXXXXXXXGOOOOOOOXXXXXXXXXXXXGOOOOOOOOOOOXXXXXXXX,0,256,0
38766,166,0,166,61,113,0,0,273,191,82,GOOOOOOOOOOOXXXXXXXXGOOOOOOOOOOOOOOOXXXXGOOOOOOOOOOOXXXXXXXXGOOOOOOOOOOOOOOOOXXXGOOOOOOOXXXXXXXXXXXXGOOOOOOOOOOOOOOOOOOOGOOOOOOOOXXXXXXXXXXXGOOOOOOOOOOOOXXXXXXXGOOOOOOOOOOOOOOOOOOXGOOOOOOXXXXXXXXXXXXXGOOOOOOOOOOOOXXXXXXXGOOOOOOOXXXXXXXXXXXXGOOOOOOOOOOOXXXXXXXX,0,256,0
38787,166,0,166,67,107,0,0,267,186,81,GOOOOOOOOOOOXXXXXXXXGOOOOOOOOOOOOOOOXXXXGOOOOOOOOOOOXXXXXXXXGOOOOOOOOOOOOOOOOXXXGOOOOOOOXXXXXXXXXXXXGOOOOOOOOOOOOOOOOOOOGOOOOOOOOXXXXXXXXXXXGOOOOOOOOOOOOXXXXXXXGOOOOOOOOOOOOOOOOOOXGOOOOOOXXXXXXXXXXXXXGOOOOOOOOOOOOXXXXXXXGOOOOOOOXXXXXXXXXXXXGOOOOOOOOOOOXXXXXXXX,0,256,0
38808,166,0,166,67,107,0,0,267,184,83,GOOOOOOOOOOOXXXXXXXXGOOOOOOOOOOOOOOOXXXXGOOOOOOOOOOOXXXXXXXXGOOOOOOOOOOOOOOOOXXXGOOOOOOOXXXXXXXXXXXXGOOOOOOOOOOOOOOOOOOOGOOOOOOOOXXXXXXXXXXXGOOOOOOOOOOOOXXXXXXXGOOOOOOOOOOOOOOOOOOXGOOOOOOXXXXXXXXXXXXXGOOOOOOOOOOOOXXXXXXXGOOOOOOOXXXXXXXXXXXXGOOOOOOOOOOOXXXXXXXX,0,256,0
38829,166,0,166,66,108,0,0,268,180,88,GOOOOOOOOOOOXXXXXXXXGOOOOOOOOOOOOOOOXXXXGOOOOOOOOOOOXXXXXXXXGOOOOOOOOOOOOOOOOXXXGOOOOOOOXXXXXXXXXXXXGOOOOOOOOOOOOOOOOOOOGOOOOOOOOXXXXXXXXXXXGOOOOOOOOOOOOXXXXXXXGOOOOOOOOOOOOOOOOOOXGOOOOOOXXXXXXXXXXXXXGOOOOOOOOOOOOXXXXXXXGOOOOOOOXXXXXXXXXXXXGOOOOOOOOOOOXXXXXXXX,0,256,0

38850,166,0,166,60,114,0,0,274,182,92,GOOOOOOOOOOOXXXXXXXXGOOOOOOOOOOOOOOOXXXXGOOOOOOOOOOOXXXXXXXXGOOOOOOOOOOOOOOOOXXXGOOOOOOOXXXXXXXXXXXXGOOOOOOOOOOOOOOOOOOOGOOOOOOOOXXXXXXXXXXXGOOOOOOOOOOOOXXXXXXXGOOOOOOOOOOOOOOOOOOXGOOOOOOXXXXXXXXXXXXXGOOOOOOOOOOOOXXXXXXXGOOOOOOOXXXXXXXXXXXXGOOOOOOOOOOOXXXXXXXX,0,256,0
38871,166,0,166,53,121,0,0,281,191,90,GOOOOOOOOOOOXXXXXXXXGOOOOOOOOOOOOOOOXXXXGOOOOOOOOOOOXXXXXXXXGOOOOOOOOOOOOOOOOXXXGOOOOOOOXXXXXXXXXXXXGOOOOOOOOOOOOOOOOOOOGOOOOOOOOXXXXXXXXXXXGOOOOOOOOOOOOXXXXXXXGOOOOOOOOOOOOOOOOOOXGOOOOOOXXXXXXXXXXXXXGOOOOOOOOOOOOXXXXXXXGOOOOOOOXXXXXXXXXXXXGOOOOOOOOOOOXXXXXXXX,0,256,0
38892,166,0,166,53,121,0,0,281,190,91,GOOOOOOOOOOOXXXXXXXXGOOOOOOOOOOOOOOOXXXXGOOOOOOOOOOOXXXXXXXXGOOOOOOOOOOOOOOOOXXXGOOOOOOOXXXXXXXXXXXXGOOOOOOOOOOOOOOOOOOOGOOOOOOOOXXXXXXXXXXXGOOOOOOOOOOOOXXXXXXXGOOOOOOOOOOOOOOOOOOXGOOOOOOXXXXXXXXXXXXXGOOOOOOOOOOOOXXXXXXXGOOOOOOOXXXXXXXXXXXXGOOOOOOOOOOOXXXXXXXX,0,256,0
38913,166,0,166,57,117,0,0,277,183,94,GOOOOOOOOOOOXXXXXXXXGOOOOOOOOOOOOOOOXXXXGOOOOOOOOOOOXXXXXXXXGOOOOOOOOOOOOOOOOXXXGOOOOOOOXXXXXXXXXXXXGOOOOOOOOOOOOOOOOOOOGOOOOOOOOXXXXXXXXXXXGOOOOOOOOOOOOXXXXXXXGOOOOOOOOOOOOOOOOOOXGOOOOOOXXXXXXXXXXXXXGOOOOOOOOOOOOXXXXXXXGOOOOOOOXXXXXXXXXXXXGOOOOOOOOOOOXXXXXXXX,0,256,0
38934,166,0,166,55,119,0,0,278,184,94,GOOOOOOOOOOOXXXXXXXXGOOOOOOOOOOOOOOOXXXXGOOOOOOOOOOOXXXXXXXXGOOOOOOOOOOOOOOOOXXXGOOOOOOOXXXXXXXXXXXXGOOOOOOOOOOOOOOOOOOOGOOOOOOOOXXXXXXXXXXXGOOOOOOOOOOOOXXXXXXXGOOOOOOOOOOOOOOOOOOXGOOOOOOXXXXXXXXXXXXXGOOOOOOOOOOOOXXXXXXXGOOOOOOOXXXXXXXXXXXXGOOOOOOOOOOOXXXXXXXX,0,256,0

38955,166,0,166,55,119,0,0,279,186,93,GOOOOOOOOOOOXXXXXXXXGOOOOOOOOOOOOOOOXXXXGOOOOOOOOOOOXXXXXXXXGOOOOOOOOOOOOOOOOXXXGOOOOOOOXXXXXXXXXXXXGOOOOOOOOOOOOOOOOOOOGOOOOOOOOXXXXXXXXXXXGOOOOOOOOOOOOXXXXXXXGOOOOOOOOOOOOOOOOOOXGOOOOOOXXXXXXXXXXXXXGOOOOOOOOOOOOXXXXXXXGOOOOOOOXXXXXXXXXXXXGOOOOOOOOOOOXXXXXXXX,0,256,0
38976,166,0,166,54,120,0,0,280,185,95,GOOOOOOOOOOOXXXXXXXXGOOOOOOOOOOOOOOOXXXXGOOOOOOOOOOOXXXXXXXXGOOOOOOOOOOOOOOOOXXXGOOOOOOOXXXXXXXXXXXXGOOOOOOOOOOOOOOOOOOOGOOOOOOOOXXXXXXXXXXXGOOOOOOOOOOOOXXXXXXXGOOOOOOOOOOOOOOOOOOXGOOOOOOXXXXXXXXXXXXXGOOOOOOOOOOOOXXXXXXXGOOOOOOOXXXXXXXXXXXXGOOOOOOOOOOOXXXXXXXX,0,256,0
38997,166,0,166,55,119,0,0,279,181,98,GOOOOOOOOOOOXXXXXXXXGOOOOOOOOOOOOOOOXXXXGOOOOOOOOOOOXXXXXXXXGOOOOOOOOOOOOOOOOXXXGOOOOOOOXXXXXXXXXXXXGOOOOOOOOOOOOOOOOOOOGOOOOOOOOXXXXXXXXXXXGOOOOOOOOOOOOXXXXXXXGOOOOOOOOOOOOOOOOOOXGOOOOOOXXXXXXXXXXXXXGOOOOOOOOOOOOXXXXXXXGOOOOOOOXXXXXXXXXXXXGOOOOOOOOOOOXXXXXXXX,0,256,0
39018,166,0,166,54,120,0,0,280,182,98,GOOOOOOOOOOOXXXXXXXXGOOOOOOOOOOOOOOOXXXXGOOOOOOOOOOOXXXXXXXXGOOOOOOOOOOOOOOOOXXXGOOOOOOOXXXXXXXXXXXXGOOOOOOOOOOOOOOOOOOOGOOOOOOOOXXXXXXXXXXXGOOOOOOOOOOOOXXXXXXXGOOOOOOOOOOOOOOOOOOXGOOOOOOXXXXXXXXXXXXXGOOOOOOOOOOOOXXXXXXXGOOOOOOOXXXXXXXXXXXXGOOOOOOOOOOOXXXXXXXX,0,256,0
39039,166,0,166,56,118,0,0,277,183,94,GOOOOOOOOOOOXXXXXXXXGOOOOOOOOOOOOOOOXXXXGOOOOOOOOOOOXXXXXXXXGOOOOOOOOOOOOOOOOXXXGOOOOOOOXXXXXXXXXXXXGOOOOOOOOOOOOOOOOOOOGOOOOOOOOXXXXXXXXXXXGOOOOOOOOOOOOXXXXXXXGOOOOOOOOOOOOOOOOOOXGOOOOOOXXXXXXXXXXXXXGOOOOOOOOOOOOXXXXXXXGOOOOOOOXXXXXXXXXXXXGOOOOOOOOOOOXXXXXXXX,0,256,0

39060,166,0,166,56,118,0,0,277,187,90,GOOOOOOOOOOOXXXXXXXXGOOOOOOOOOOOOOOOXXXXGOOOOOOOOOOOXXXXXXXXGOOOOOOOOOOOOOOOOXXXGOOOOOOOXXXXXXXXXXXXGOOOOOOOOOOOOOOOOOOOGOOOOOOOOXXXXXXXXXXXGOOOOOOOOOOOOXXXXXXXGOOOOOOOOOOOOOOOOOOXGOOOOOOXXXXXXXXXXXXXGOOOOOOOOOOOOXXXXXXXGOOOOOOOXXXXXXXXXXXXGOOOOOOOOOOOXXXXXXXX,0,256,0
39081,166,0,166,54,120,0,0,279,188,91,GOOOOOOOOOOOXXXXXXXXGOOOOOOOOOOOOOOOXXXXGOOOOOOOOOOOXXXXXXXXGOOOOOOOOOOOOOOOOXXXGOOOOOOOXXXXXXXXXXXXGOOOOOOOOOOOOOOOOOOOGOOOOOOOOXXXXXXXXXXXGOOOOOOOOOOOOXXXXXXXGOOOOOOOOOOOOOOOOOOXGOOOOOOXXXXXXXXXXXXXGOOOOOOOOOOOOXXXXXXXGOOOOOOOXXXXXXXXXXXXGOOOOOOOOOOOXXXXXXXX,0,256,0
39102,166,0,166,58,116,0,0,276,185,91,GOOOOOOOOOOOXXXXXXXXGOOOOOOOOOOOOOOOXXXXGOOOOOOOOOOOXXXXXXXXGOOOOOOOOOOOOOOOOXXXGOOOOOOOXXXXXXXXXXXXGOOOOOOOOOOOOOOOOOOOGOOOOOOOOXXXXXXXXXXXGOOOOOOOOOOOOXXXXXXXGOOOOOOOOOOOOOOOOOOXGOOOOOOXXXXXXXXXXXXXGOOOOOOOOOOOOXXXXXXXGOOOOOOOXXXXXXXXXXXXGOOOOOOOOOOOXXXXXXXX,0,256,0
39123,166,0,166,59,115,0,0,274,181,93,GOOOOOOOOOOOXXXXXXXXGOOOOOOOOOOOOOOOXXXXGOOOOOOOOOOOXXXXXXXXGOOOOOOOOOOOOOOOOXXXGOOOOOOOXXXXXXXXXXXXGOOOOOOOOOOOOOOOOOOOGOOOOOOOOXXXXXXXXXXXGOOOOOOOOOOOOXXXXXXXGOOOOOOOOOOOOOOOOOOXGOOOOOOXXXXXXXXXXXXXGOOOOOOOOOOOOXXXXXXXGOOOOOOOXXXXXXXXXXXXGOOOOOOOOOOOXXXXXXXX,0,256,0
39144,166,0,166,60,114,0,0,274,182,92,GOOOOOOOOOOOXXXXXXXXGOOOOOOOOOOOOOOOXXXXGOOOOOOOOOOOXXXXXXXXGOOOOOOOOOOOOOOOOXXXGOOOOOOOXXXXXXXXXXXXGOOOOOOOOOOOOOOOOOOOGOOOOOOOOXXXXXXXXXXXGOOOOOOOOOOOOXXXXXXXGOOOOOOOOOOOOOOOOOOXGOOOOOOXXXXXXXXXXXXXGOOOOOOOOOOOOXXXXXXXGOOOOOOOXXXXXXXXXXXXGOOOOOOOOOOOXXXXXXXX,0,256,0

39165,166,0,166,58,116,0,0,276,181,95,GOOOOOOOOOOOXXXXXXXXGOOOOOOOOOOOOOOOXXXXGOOOOOOOOOOOXXXXXXXXGOOOOOOOOOOOOOOOOXXXGOOOOOOOXXXXXXXXXXXXGOOOOOOOOOOOOOOOOOOOGOOOOOOOOXXXXXXXXXXXGOOOOOOOOOOOOXXXXXXXGOOOOOOOOOOOOOOOOOOXGOOOOOOXXXXXXXXXXXXXGOOOOOOOOOOOOXXXXXXXGOOOOOOOXXXXXXXXXXXXGOOOOOOOOOOOXXXXXXXX,0,256,0
39186,166,0,166,53,121,0,0,281,189,92,GOOOOOOOOOOOXXXXXXXXGOOOOOOOOOOOOOOOXXXXGOOOOOOOOOOOXXXXXXXXGOOOOOOOOOOOOOOOOXXXGOOOOOOOXXXXXXXXXXXXGOOOOOOOOOOOOOOOOOOOGOOOOOOOOXXXXXXXXXXXGOOOOOOOOOOOOXXXXXXXGOOOOOOOOOOOOOOOOOOXGOOOOOOXXXXXXXXXXXXXGOOOOOOOOOOOOXXXXXXXGOOOOOOOXXXXXXXXXXXXGOOOOOOOOOOOXXXXXXXX,0,256,0
39207,166,0,166,58,116,0,0,276,187,89,GOOOOOOOOOOOXXXXXXXXGOOOOOOOOOOOOOOOXXXXGOOOOOOOOOOOXXXXXXXXGOOOOOOOOOOOOOOOOXXXGOOOOOOOXXXXXXXXXXXXGOOOOOOOOOOOOOOOOOOOGOOOOOOOOXXXXXXXXXXXGOOOOOOOOOOOOXXXXXXXGOOOOOOOOOOOOOOOOOOXGOOOOOOXXXXXXXXXXXXXGOOOOOOOOOOOOXXXXXXXGOOOOOOOXXXXXXXXXXXXGOOOOOOOOOOOXXXXXXXX,0,256,0
39228,166,0,166,57,117,0,0,277,189,88,GOOOOOOOOOOOXXXXXXXXGOOOOOOOOOOOOOOOXXXXGOOOOOOOOOOOXXXXXXXXGOOOOOOOOOOOOOOOOXXXGOOOOOOOXXXXXXXXXXXXGOOOOOOOOOOOOOOOOOOOGOOOOOOOOXXXXXXXXXXXGOOOOOOOOOOOOXXXXXXXGOOOOOOOOOOOOOOOOOOXGOOOOOOXXXXXXXXXXXXXGOOOOOOOOOOOOXXXXXXXGOOOOOOOXXXXXXXXXXXXGOOOOOOOOOOOXXXXXXXX,0,256,0
39249,166,0,166,56,118,0,0,278,189,89,GOOOOOOOOOOOXXXXXXXXGOOOOOOOOOOOOOOOXXXXGOOOOOOOOOOOXXXXXXXXGOOOOOOOOOOOOOOOOXXXGOOOOOOOXXXXXXXXXXXXGOOOOOOOOOOOOOOOOOOOGOOOOOOOOXXXXXXXXXXXGOOOOOOOOOOOOXXXXXXXGOOOOOOOOOOOOOOOOOOXGOOOOOOXXXXXXXXXXXXXGOOOOOOOOOOOOXXXXXXXGOOOOOOOXXXXXXXXXXXXGOOOOOOOOOOOXXXXXXXX,0,256,0

39270,166,0,166,58,116,0,0,276,191,85,GOOOOOOOOOOOXXXXXXXXGOOOOOOOOOOOOOOOXXXXGOOOOOOOOOOOXXXXXXXXGOOOOOOOOOOOOOOOOXXXGOOOOOOOXXXXXXXXXXXXGOOOOOOOOOOOOOOOOOOOGOOOOOOOOXXXXXXXXXXXGOOOOOOOOOOOOXXXXXXXGOOOOOOOOOOOOOOOOOOXGOOOOOOXXXXXXXXXXXXXGOOOOOOOOOOOOXXXXXXXGOOOOOOOXXXXXXXXXXXXGOOOOOOOOOOOXXXXXXXX,0,256,0
39291,166,0,166,64,110,0,0,270,192,78,GOOOOOOOOOOOXXXXXXXXGOOOOOOOOOOOOOOOXXXXGOOOOOOOOOOOXXXXXXXXGOOOOOOOOOOOOOOOOXXXGOOOOOOOXXXXXXXXXXXXGOOOOOOOOOOOOOOOOOOOGOOOOOOOOXXXXXXXXXXXGOOOOOOOOOOOOXXXXXXXGOOOOOOOOOOOOOOOOOOXGOOOOOOXXXXXXXXXXXXXGOOOOOOOOOOOOXXXXXXXGOOOOOOOXXXXXXXXXXXXGOOOOOOOOOOOXXXXXXXX,0,256,0
39312,166,0,166,70,104,0,0,264,182,82,GOOOOOOOOOOOXXXXXXXXGOOOOOOOOOOOOOOOXXXXGOOOOOOOOOOOXXXXXXXXGOOOOOOOOOOOOOOOOXXXGOOOOOOOXXXXXXXXXXXXGOOOOOOOOOOOOOOOOOOOGOOOOOOOOXXXXXXXXXXXGOOOOOOOOOOOOXXXXXXXGOOOOOOOOOOOOOOOOOOXGOOOOOOXXXXXXXXXXXXXGOOOOOOOOOOOOXXXXXXXGOOOOOOOXXXXXXXXXXXXGOOOOOOOOOOOXXXXXXXX,0,256,0
39333,166,0,166,72,102,0,0,262,181,81,GOOOOOOOOOOOXXXXXXXXGOOOOOOOOOOOOOOOXXXXGOOOOOOOOOOOXXXXXXXXGOOOOOOOOOOOOOOOOXXXGOOOOOOOXXXXXXXXXXXXGOOOOOOOOOOOOOOOOOOOGOOOOOOOOXXXXXXXXXXXGOOOOOOOOOOOOXXXXXXXGOOOOOOOOOOOOOOOOOOXGOOOOOOXXXXXXXXXXXXXGOOOOOOOOOOOOXXXXXXXGOOOOOOOXXXXXXXXXXXXGOOOOOOOOOOOXXXXXXXX,0,256,0
39354,166,0,166,64,110,0,0,269,183,86,GOOOOOOOOOOOXXXXXXXXGOOOOOOOOOOOOOOOXXXXGOOOOOOOOOOOXXXXXXXXGOOOOOOOOOOOOOOOOXXXGOOOOOOOXXXXXXXXXXXXGOOOOOOOOOOOOOOOOOOOGOOOOOOOOXXXXXXXXXXXGOOOOOOOOOOOOXXXXXXXGOOOOOOOOOOOOOOOOOOXGOOOOOOXXXXXXXXXXXXXGOOOOOOOOOOOOXXXXXXXGOOOOOOOXXXXXXXXXXXXGOOOOOOOOOOOXXXXXXXX,0,256,0

39375,166,0,166,55,119,0,0,279,187,92,GOOOOOOOOOOOXXXXXXXXGOOOOOOOOOOOOOOOXXXXGOOOOOOOOOOOXXXXXXXXGOOOOOOOOOOOOOOOOXXXGOOOOOOOXXXXXXXXXXXXGOOOOOOOOOOOOOOOOOOOGOOOOOOOOXXXXXXXXXXXGOOOOOOOOOOOOXXXXXXXGOOOOOOOOOOOOOOOOOOXGOOOOOOXXXXXXXXXXXXXGOOOOOOOOOOOOXXXXXXXGOOOOOOOXXXXXXXXXXXXGOOOOOOOOOOOXXXXXXXX,0,256,0
39396,166,0,166,55,119,0,0,279,187,92,GOOOOOOOOOOOXXXXXXXXGOOOOOOOOOOOOOOOXXXXGOOOOOOOOOOOXXXXXXXXGOOOOOOOOOOOOOOOOXXXGOOOOOOOXXXXXXXXXXXXGOOOOOOOOOOOOOOOOOOOGOOOOOOOOXXXXXXXXXXXGOOOOOOOOOOOOXXXXXXXGOOOOOOOOOOOOOOOOOOXGOOOOOOXXXXXXXXXXXXXGOOOOOOOOOOOOXXXXXXXGOOOOOOOXXXXXXXXXXXXGOOOOOOOOOOOXXXXXXXX,0,256,0
39417,166,0,166,58,116,0,0,276,188,88,GOOOOOOOOOOOXXXXXXXXGOOOOOOOOOOOOOOOXXXXGOOOOOOOOOOOXXXXXXXXGOOOOOOOOOOOOOOOOXXXGOOOOOOOXXXXXXXXXXXXGOOOOOOOOOOOOOOOOOOOGOOOOOOOOXXXXXXXXXXXGOOOOOOOOOOOOXXXXXXXGOOOOOOOOOOOOOOOOOOXGOOOOOOXXXXXXXXXXXXXGOOOOOOOOOOOOXXXXXXXGOOOOOOOXXXXXXXXXXXXGOOOOOOOOOOOXXXXXXXX,0,256,0
39438,166,0,166,56,118,0,0,278,183,95,GOOOOOOOOOOOXXXXXXXXGOOOOOOOOOOOOOOOXXXXGOOOOOOOOOOOXXXXXXXXGOOOOOOOOOOOOOOOOXXXGOOOOOOOXXXXXXXXXXXXGOOOOOOOOOOOOOOOOOOOGOOOOOOOOXXXXXXXXXXXGOOOOOOOOOOOOXXXXXXXGOOOOOOOOOOOOOOOOOOXGOOOOOOXXXXXXXXXXXXXGOOOOOOOOOOOOXXXXXXXGOOOOOOOXXXXXXXXXXXXGOOOOOOOOOOOXXXXXXXX,0,256,0
39459,166,0,166,53,121,0,0,281,184,97,GOOOOOOOOOOOXXXXXXXXGOOOOOOOOOOOOOOOXXXXGOOOOOOOOOOOXXXXXXXXGOOOOOOOOOOOOOOOOXXXGOOOOOOOXXXXXXXXXXXXGOOOOOOOOOOOOOOOOOOOGOOOOOOOOXXXXXXXXXXXGOOOOOOOOOOOOXXXXXXXGOOOOOOOOOOOOOOOOOOXGOOOOOOXXXXXXXXXXXXXGOOOOOOOOOOOOXXXXXXXGOOOOOOOXXXXXXXXXXXXGOOOOOOOOOOOXXXXXXXX,0,256,0

39480,166,0,166,52,122,0,0,282,184,98,GOOOOOOOOOOOXXXXXXXXGOOOOOOOOOOOOOOOXXXXGOOOOOOOOOOOXXXXXXXXGOOOOOOOOOOOOOOOOXXXGOOOOOOOXXXXXXXXXXXXGOOOOOOOOOOOOOOOOOOOGOOOOOOOOXXXXXXXXXXXGOOOOOOOOOOOOXXXXXXXGOOOOOOOOOOOOOOOOOOXGOOOOOOXXXXXXXXXXXXXGOOOOOOOOOOOOXXXXXXXGOOOOOOOXXXXXXXXXXXXGOOOOOOOOOOOXXXXXXXX,0,256,0
39501,166,0,166,49,125,0,0,284,184,100,GOOOOOOOOOOOXXXXXXXXGOOOOOOOOOOOOOOOXXXXGOOOOOOOOOOOXXXXXXXXGOOOOOOOOOOOOOOOOXXXGOOOOOOOXXXXXXXXXXXXGOOOOOOOOOOOOOOOOOOOGOOOOOOOOXXXXXXXXXXXGOOOOOOOOOOOOXXXXXXXGOOOOOOOOOOOOOOOOOOXGOOOOOOXXXXXXXXXXXXXGOOOOOOOOOOOOXXXXXXXGOOOOOOOXXXXXXXXXXXXGOOOOOOOOOOOXXXXXXXX,0,256,0
39522,166,0,166,51,123,0,0,283,185,98,GOOOOOOOOOOOXXXXXXXXGOOOOOOOOOOOOOOOXXXXGOOOOOOOOOOOXXXXXXXXGOOOOOOOOOOOOOOOOXXXGOOOOOOOXXXXXXXXXXXXGOOOOOOOOOOOOOOOOOOOGOOOOOOOOXXXXXXXXXXXGOOOOOOOOOOOOXXXXXXXGOOOOOOOOOOOOOOOOOOXGOOOOOOXXXXXXXXXXXXXGOOOOOOOOOOOOXXXXXXXGOOOOOOOXXXXXXXXXXXXGOOOOOOOOOOOXXXXXXXX,0,256,0
39543,166,0,166,47,127,0,0,287,189,98,GOOOOOOOOOOOXXXXXXXXGOOOOOOOOOOOOOOOXXXXGOOOOOOOOOOOXXXXXXXXGOOOOOOOOOOOOOOOOXXXGOOOOOOOXXXXXXXXXXXXGOOOOOOOOOOOOOOOOOOOGOOOOOOOOXXXXXXXXXXXGOOOOOOOOOOOOXXXXXXXGOOOOOOOOOOOOOOOOOOXGOOOOOOXXXXXXXXXXXXXGOOOOOOOOOOOOXXXXXXXGOOOOOOOXXXXXXXXXXXXGOOOOOOOOOOOXXXXXXXX,0,256,0
39564,166,0,166,49,125,0,0,284,188,96,GOOOOOOOOOOOXXXXXXXXGOOOOOOOOOOOOOOOXXXXGOOOOOOOOOOOXXXXXXXXGOOOOOOOOOOOOOOOOXXXGOOOOOOOXXXXXXXXXXXXGOOOOOOOOOOOOOOOOOOOGOOOOOOOOXXXXXXXXXXXGOOOOOOOOOOOOXXXXXXXGOOOOOOOOOOOOOOOOOOXGOOOOOOXXXXXXXXXXXXXGOOOOOOOOOOOOXXXXXXXGOOOOOOOXXXXXXXXXXXXGOOOOOOOOOOOXXXXXXXX,0,256,0

39585,166,0,166,55,119,0,0,279,185,94,GOOOOOOOOOOOXXXXXXXXGOOOOOOOOOOOOOOOXXXXGOOOOOOOOOOOXXXXXXXXGOOOOOOOOOOOOOOOOXXXGOOOOOOOXXXXXXXXXXXXGOOOOOOOOOOOOOOOOOOOGOOOOOOOOXXXXXXXXXXXGOOOOOOOOOOOOXXXXXXXGOOOOOOOOOOOOOOOOOOXGOOOOOOXXXXXXXXXXXXXGOOOOOOOOOOOOXXXXXXXGOOOOOOOXXXXXXXXXXXXGOOOOOOOOOOOXXXXXXXX,0,256,0
39606,166,0,166,51,123,0,0,283,184,99,GOOOOOOOOOOOXXXXXXXXGOOOOOOOOOOOOOOOXXXXGOOOOOOOOOOOXXXXXXXXGOOOOOOOOOOOOOOOOXXXGOOOOOOOXXXXXXXXXXXXGOOOOOOOOOOOOOOOOOOOGOOOOOOOOXXXXXXXXXXXGOOOOOOOOOOOOXXXXXXXGOOOOOOOOOOOOOOOOOOXGOOOOOOXXXXXXXXXXXXXGOOOOOOOOOOOOXXXXXXXGOOOOOOOXXXXXXXXXXXXGOOOOOOOOOOOXXXXXXXX,0,256,0
39627,166,0,166,51,123,0,0,283,186,97,GOOOOOOOOOOOXXXXXXXXGOOOOOOOOOOOOOOOXXXXGOOOOOOOOOOOXXXXXXXXGOOOOOOOOOOOOOOOOXXXGOOOOOOOXXXXXXXXXXXXGOOOOOOOOOOOOOOOOOOOGOOOOOOOOXXXXXXXXXXXGOOOOOOOOOOOOXXXXXXXGOOOOOOOOOOOOOOOOOOXGOOOOOOXXXXXXXXXXXXXGOOOOOOOOOOOOXXXXXXXGOOOOOOOXXXXXXXXXXXXGOOOOOOOOOOOXXXXXXXX,0,256,0
39648,166,0,166,47,127,0,0,286,191,95,GOOOOOOOOOOOXXXXXXXXGOOOOOOOOOOOOOOOXXXXGOOOOOOOOOOOXXXXXXXXGOOOOOOOOOOOOOOOOXXXGOOOOOOOXXXXXXXXXXXXGOOOOOOOOOOOOOOOOOOOGOOOOOOOOXXXXXXXXXXXGOOOOOOOOOOOOXXXXXXXGOOOOOOOOOOOOOOOOOOXGOOOOOOXXXXXXXXXXXXXGOOOOOOOOOOOOXXXXXXXGOOOOOOOXXXXXXXXXXXXGOOOOOOOOOOOXXXXXXXX,0,256,0
39669,166,0,166,52,122,0,0,282,190,92,GOOOOOOOOOOOXXXXXXXXGOOOOOOOOOOOOOOOXXXXGOOOOOOOOOOOXXXXXXXXGOOOOOOOOOOOOOOOOXXXGOOOOOOOXXXXXXXXXXXXGOOOOOOOOOOOOOOOOOOOGOOOOOOOOXXXXXXXXXXXGOOOOOOOOOOOOXXXXXXXGOOOOOOOOOOOOOOOOOOXGOOOOOOXXXXXXXXXXXXXGOOOOOOOOOOOOXXXXXXXGOOOOOOOXXXXXXXXXXXXGOOOOOOOOOOOXXXXXXXX,0,256,0

39690,166,0,166,55,119,0,0,278,189,89,GOOOOOOOOOOOXXXXXXXXGOOOOOOOOOOOOOOOXXXXGOOOOOOOOOOOXXXXXXXXGOOOOOOOOOOOOOOOOXXXGOOOOOOOXXXXXXXXXXXXGOOOOOOOOOOOOOOOOOOOGOOOOOOOOXXXXXXXXXXXGOOOOOOOOOOOOXXXXXXXGOOOOOOOOOOOOOOOOOOXGOOOOOOXXXXXXXXXXXXXGOOOOOOOOOOOOXXXXXXXGOOOOOOOXXXXXXXXXXXXGOOOOOOOOOOOXXXXXXXX,0,256,0
39711,166,0,166,57,117,0,0,278,193,85,GOOOOOOOOOOOXXXXXXXXGOOOOOOOOOOOOOOOXXXXGOOOOOOOOOOOXXXXXXXXGOOOOOOOOOOOOOOOOXXXGOOOOOOOXXXXXXXXXXXXGOOOOOOOOOOOOOOOOOOOGOOOOOOOOXXXXXXXXXXXGOOOOOOOOOOOOXXXXXXXGOOOOOOOOOOOOOOOOOOXGOOOOOOXXXXXXXXXXXXXGOOOOOOOOOOOOXXXXXXXGOOOOOOOXXXXXXXXXXXXGOOOOOOOOOOOXXXXXXXX,0,256,0
39732,166,0,166,63,111,0,0,270,185,85,GOOOOOOOOOOOXXXXXXXXGOOOOOOOOOOOOOOOXXXXGOOOOOOOOOOOXXXXXXXXGOOOOOOOOOOOOOOOOXXXGOOOOOOOXXXXXXXXXXXXGOOOOOOOOOOOOOOOOOOOGOOOOOOOOXXXXXXXXXXXGOOOOOOOOOOOOXXXXXXXGOOOOOOOOOOOOOOOOOOXGOOOOOOXXXXXXXXXXXXXGOOOOOOOOOOOOXXXXXXXGOOOOOOOXXXXXXXXXXXXGOOOOOOOOOOOXXXXXXXX,0,256,0
39753,166,0,166,59,115,0,0,275,191,84,GOOOOOOOOOOOXXXXXXXXGOOOOOOOOOOOOOOOXXXXGOOOOOOOOOOOXXXXXXXXGOOOOOOOOOOOOOOOOXXXGOOOOOOOXXXXXXXXXXXXGOOOOOOOOOOOOOOOOOOOGOOOOOOOOXXXXXXXXXXXGOOOOOOOOOOOOXXXXXXXGOOOOOOOOOOOOOOOOOOXGOOOOOOXXXXXXXXXXXXXGOOOOOOOOOOOOXXXXXXXGOOOOOOOXXXXXXXXXXXXGOOOOOOOOOOOXXXXXXXX,0,256,0
39774,166,0,166,60,114,0,0,274,188,86,GOOOOOOOOOOOXXXXXXXXGOOOOOOOOOOOOOOOXXXXGOOOOOOOOOOOXXXXXXXXGOOOOOOOOOOOOOOOOXXXGOOOOOOOXXXXXXXXXXXXGOOOOOOOOOOOOOOOOOOOGOOOOOOOOXXXXXXXXXXXGOOOOOOOOOOOOXXXXXXXGOOOOOOOOOOOOOOOOOOXGOOOOOOXXXXXXXXXXXXXGOOOOOOOOOOOOXXXXXXXGOOOOOOOXXXXXXXXXXXXGOOOOOOOOOOOXXXXXXXX,0,256,0

39795,166,0,166,65,109,0,0,269,186,83,GOOOOOOOOOOOXXXXXXXXGOOOOOOOOOOOOOOOXXXXGOOOOOOOOOOOXXXXXXXXGOOOOOOOOOOOOOOOOXXXGOOOOOOOXXXXXXXXXXXXGOOOOOOOOOOOOOOOOOOOGOOOOOOOOXXXXXXXXXXXGOOOOOOOOOOOOXXXXXXXGOOOOOOOOOOOOOOOOOOXGOOOOOOXXXXXXXXXXXXXGOOOOOOOOOOOOXXXXXXXGOOOOOOOXXXXXXXXXXXXGOOOOOOOOOOOXXXXXXXX,0,256,0
39816,166,0,166,66,108,0,0,268,181,87,GOOOOOOOOOOOXXXXXXXXGOOOOOOOOOOOOOOOXXXXGOOOOOOOOOOOXXXXXXXXGOOOOOOOOOOOOOOOOXXXGOOOOOOOXXXXXXXXXXXXGOOOOOOOOOOOOOOOOOOOGOOOOOOOOXXXXXXXXXXXGOOOOOOOOOOOOXXXXXXXGOOOOOOOOOOOOOOOOOOXGOOOOOOXXXXXXXXXXXXXGOOOOOOOOOOOOXXXXXXXGOOOOOOOXXXXXXXXXXXXGOOOOOOOOOOOXXXXXXXX,0,256,0
39837,166,0,166,66,108,0,0,268,180,88,GOOOOOOOOOOOXXXXXXXXGOOOOOOOOOOOOOOOXXXXGOOOOOOOOOOOXXXXXXXXGOOOOOOOOOOOOOOOOXXXGOOOOOOOXXXXXXXXXXXXGOOOOOOOOOOOOOOOOOOOGOOOOOOOOXXXXXXXXXXXGOOOOOOOOOOOOXXXXXXXGOOOOOOOOOOOOOOOOOOXGOOOOOOXXXXXXXXXXXXXGOOOOOOOOOOOOXXXXXXXGOOOOOOOXXXXXXXXXXXXGOOOOOOOOOOOXXXXXXXX,0,256,0
39858,166,0,166,59,115,0,0,273,179,94,GOOOOOOOOOOOXXXXXXXXGOOOOOOOOOOOOOOOXXXXGOOOOOOOOOOOXXXXXXXXGOOOOOOOOOOOOOOOOXXXGOOOOOOOXXXXXXXXXXXXGOOOOOOOOOOOOOOOOOOOGOOOOOOOOXXXXXXXXXXXGOOOOOOOOOOOOXXXXXXXGOOOOOOOOOOOOOOOOOOXGOOOOOOXXXXXXXXXXXXXGOOOOOOOOOOOOXXXXXXXGOOOOOOOXXXXXXXXXXXXGOOOOOOOOOOOXXXXXXXX,0,256,0
39879,166,0,166,59,115,0,0,274,179,95,GOOOOOOOOOOOXXXXXXXXGOOOOOOOOOOOOOOOXXXXGOOOOOOOOOOOXXXXXXXXGOOOOOOOOOOOOOOOOXXXGOOOOOOOXXXXXXXXXXXXGOOOOOOOOOOOOOOOOOOOGOOOOOOOOXXXXXXXXXXXGOOOOOOOOOOOOXXXXXXXGOOOOOOOOOOOOOOOOOOXGOOOOOOXXXXXXXXXXXXXGOOOOOOOOOOOOXXXXXXXGOOOOOOOXXXXXXXXXXXXGOOOOOOOOOOOXXXXXXXX,0,256,0

39900,166,0,166,61,113,0,0,271,178,93,GOOOOOOOOOOOXXXXXXXXGOOOOOOOOOOOOOOOXXXXGOOOOOOOOOOOXXXXXXXXGOOOOOOOOOOOOOOOOXXXGOOOOOOOXXXXXXXXXXXXGOOOOOOOOOOOOOOOOOOOGOOOOOOOOXXXXXXXXXXXGOOOOOOOOOOOOXXXXXXXGOOOOOOOOOOOOOOOOOOXGOOOOOOXXXXXXXXXXXXXGOOOOOOOOOOOOXXXXXXXGOOOOOOOXXXXXXXXXXXXGOOOOOOOOOOOXXXXXXXX,0,256,0
39921,166,0,166,60,114,0,0,274,181,93,GOOOOOOOOOOOXXXXXXXXGOOOOOOOOOOOOOOOXXXXGOOOOOOOOOOOXXXXXXXXGOOOOOOOOOOOOOOOOXXXGOOOOOOOXXXXXXXXXXXXGOOOOOOOOOOOOOOOOOOOGOOOOOOOOXXXXXXXXXXXGOOOOOOOOOOOOXXXXXXXGOOOOOOOOOOOOOOOOOOXGOOOOOOXXXXXXXXXXXXXGOOOOOOOOOOOOXXXXXXXGOOOOOOOXXXXXXXXXXXXGOOOOOOOOOOOXXXXXXXX,0,256,0
39942,166,0,166,57,117,0,0,277,184,93,GOOOOOOOOOOOXXXXXXXXGOOOOOOOOOOOOOOOXXXXGOOOOOOOOOOOXXXXXXXXGOOOOOOOOOOOOOOOOXXXGOOOOOOOXXXXXXXXXXXXGOOOOOOOOOOOOOOOOOOOGOOOOOOOOXXXXXXXXXXXGOOOOOOOOOOOOXXXXXXXGOOOOOOOOOOOOOOOOOOXGOOOOOOXXXXXXXXXXXXXGOOOOOOOOOOOOXXXXXXXGOOOOOOOXXXXXXXXXXXXGOOOOOOOOOOOXXXXXXXX,0,256,0
39963,166,0,166,64,110,0,0,270,178,92,GOOOOOOOOOOOXXXXXXXXGOOOOOOOOOOOOOOOXXXXGOOOOOOOOOOOXXXXXXXXGOOOOOOOOOOOOOOOOXXXGOOOOOOOXXXXXXXXXXXXGOOOOOOOOOOOOOOOOOOOGOOOOOOOOXXXXXXXXXXXGOOOOOOOOOOOOXXXXXXXGOOOOOOOOOOOOOOOOOOXGOOOOOOXXXXXXXXXXXXXGOOOOOOOOOOOOXXXXXXXGOOOOOOOXXXXXXXXXXXXGOOOOOOOOOOOXXXXXXXX,0,256,0
39984,166,0,166,58,116,0,0,276,184,92,GOOOOOOOOOOOXXXXXXXXGOOOOOOOOOOOOOOOXXXXGOOOOOOOOOOOXXXXXXXXGOOOOOOOOOOOOOOOOXXXGOOOOOOOXXXXXXXXXXXXGOOOOOOOOOOOOOOOOOOOGOOOOOOOOXXXXXXXXXXXGOOOOOOOOOOOOXXXXXXXGOOOOOOOOOOOOOOOOOOXGOOOOOOXXXXXXXXXXXXXGOOOOOOOOOOOOXXXXXXXGOOOOOOOXXXXXXXXXXXXGOOOOOOOOOOOXXXXXXXX,0,256,0

40005,166,0,166,59,115,0,0,275,185,90,GOOOOOOOOOOOXXXXXXXXGOOOOOOOOOOOOOOOXXXXGOOOOOOOOOOOXXXXXXXXGOOOOOOOOOOOOOOOOXXXGOOOOOOOXXXXXXXXXXXXGOOOOOOOOOOOOOOOOOOOGOOOOOOOOXXXXXXXXXXXGOOOOOOOOOOOOXXXXXXXGOOOOOOOOOOOOOOOOOOXGOOOOOOXXXXXXXXXXXXXGOOOOOOOOOOOOXXXXXXXGOOOOOOOXXXXXXXXXXXXGOOOOOOOOOOOXXXXXXXX,0,256,0
40026,166,0,166,57,117,0,0,277,192,85,GOOOOOOOOOOOXXXXXXXXGOOOOOOOOOOOOOOOXXXXGOOOOOOOOOOOXXXXXXXXGOOOOOOOOOOOOOOOOXXXGOOOOOOOXXXXXXXXXXXXGOOOOOOOOOOOOOOOOOOOGOOOOOOOOXXXXXXXXXXXGOOOOOOOOOOOOXXXXXXXGOOOOOOOOOOOOOOOOOOXGOOOOOOXXXXXXXXXXXXXGOOOOOOOOOOOOXXXXXXXGOOOOOOOXXXXXXXXXXXXGOOOOOOOOOOOXXXXXXXX,0,256,0
40047,166,0,166,57,117,0,0,276,192,84,GOOOOOOOOOOOXXXXXXXXGOOOOOOOOOOOOOOOXXXXGOOOOOOOOOOOXXXXXXXXGOOOOOOOOOOOOOOOOXXXGOOOOOOOXXXXXXXXXXXXGOOOOOOOOOOOOOOOOOOOGOOOOOOOOXXXXXXXXXXXGOOOOOOOOOOOOXXXXXXXGOOOOOOOOOOOOOOOOOOXGOOOOOOXXXXXXXXXXXXXGOOOOOOOOOOOOXXXXXXXGOOOOOOOXXXXXXXXXXXXGOOOOOOOOOOOXXXXXXXX,0,256,0
40068,166,0,166,61,113,0,0,273,188,85,GOOOOOOOOOOOXXXXXXXXGOOOOOOOOOOOOOOOXXXXGOOOOOOOOOOOXXXXXXXXGOOOOOOOOOOOOOOOOXXXGOOOOOOOXXXXXXXXXXXXGOOOOOOOOOOOOOOOOOOOGOOOOOOOOXXXXXXXXXXXGOOOOOOOOOOOOXXXXXXXGOOOOOOOOOOOOOOOOOOXGOOOOOOXXXXXXXXXXXXXGOOOOOOOOOOOOXXXXXXXGOOOOOOOXXXXXXXXXXXXGOOOOOOOOOOOXXXXXXXX,0,256,0
40089,166,0,166,59,115,0,0,274,191,83,GOOOOOOOOOOOXXXXXXXXGOOOOOOOOOOOOOOOXXXXGOOOOOOOOOOOXXXXXXXXGOOOOOOOOOOOOOOOOXXXGOOOOOOOXXXXXXXXXXXXGOOOOOOOOOOOOOOOOOOOGOOOOOOOOXXXXXXXXXXXGOOOOOOOOOOOOXXXXXXXGOOOOOOOOOOOOOOOOOOXGOOOOOOXXXXXXXXXXXXXGOOOOOOOOOOOOXXXXXXXGOOOOOOOXXXXXXXXXXXXGOOOOOOOOOOOXXXXXXXX,0,256,0

40110,166,0,166,51,123,0,0,283,191,92,GOOOOOOOOOOOXXXXXXXXGOOOOOOOOOOOOOOOXXXXGOOOOOOOOOOOXXXXXXXXGOOOOOOOOOOOOOOOOXXXGOOOOOOOXXXXXXXXXXXXGOOOOOOOOOOOOOOOOOOOGOOOOOOOOXXXXXXXXXXXGOOOOOOOOOOOOXXXXXXXGOOOOOOOOOOOOOOOOOOXGOOOOOOXXXXXXXXXXXXXGOOOOOOOOOOOOXXXXXXXGOOOOOOOXXXXXXXXXXXXGOOOOOOOOOOOXXXXXXXX,0,256,0
40131,166,0,166,49,125,0,0,284,194,90,GOOOOOOOOOOOXXXXXXXXGOOOOOOOOOOOOOOOXXXXGOOOOOOOOOOOXXXXXXXXGOOOOOOOOOOOOOOOOXXXGOOOOOOOXXXXXXXXXXXXGOOOOOOOOOOOOOOOOOOOGOOOOOOOOXXXXXXXXXXXGOOOOOOOOOOOOXXXXXXXGOOOOOOOOOOOOOOOOOOXGOOOOOOXXXXXXXXXXXXXGOOOOOOOOOOOOXXXXXXXGOOOOOOOXXXXXXXXXXXXGOOOOOOOOOOOXXXXXXXX,0,256,0
40152,166,0,166,49,125,0,0,284,192,92,GOOOOOOOOOOOXXXXXXXXGOOOOOOOOOOOOOOOXXXXGOOOOOOOOOOOXXXXXXXXGOOOOOOOOOOOOOOOOXXXGOOOOOOOXXXXXXXXXXXXGOOOOOOOOOOOOOOOOOOOGOOOOOOOOXXXXXXXXXXXGOOOOOOOOOOOOXXXXXXXGOOOOOOOOOOOOOOOOOOXGOOOOOOXXXXXXXXXXXXXGOOOOOOOOOOOOXXXXXXXGOOOOOOOXXXXXXXXXXXXGOOOOOOOOOOOXXXXXXXX,0,256,0
40173,166,0,166,51,123,0,0,283,188,95,GOOOOOOOOOOOXXXXXXXXGOOOOOOOOOOOOOOOXXXXGOOOOOOOOOOOXXXXXXXXGOOOOOOOOOOOOOOOOXXXGOOOOOOOXXXXXXXXXXXXGOOOOOOOOOOOOOOOOOOOGOOOOOOOOXXXXXXXXXXXGOOOOOOOOOOOOXXXXXXXGOOOOOOOOOOOOOOOOOOXGOOOOOOXXXXXXXXXXXXXGOOOOOOOOOOOOXXXXXXXGOOOOOOOXXXXXXXXXXXXGOOOOOOOOOOOXXXXXXXX,0,256,0
40194,166,0,166,56,118,0,0,278,187,91,GOOOOOOOOOOOXXXXXXXXGOOOOOOOOOOOOOOOXXXXGOOOOOOOOOOOXXXXXXXXGOOOOOOOOOOOOOOOOXXXGOOOOOOOXXXXXXXXXXXXGOOOOOOOOOOOOOOOOOOOGOOOOOOOOXXXXXXXXXXXGOOOOOOOOOOOOXXXXXXXGOOOOOOOOOOOOOOOOOOXGOOOOOOXXXXXXXXXXXXXGOOOOOOOOOOOOXXXXXXXGOOOOOOOXXXXXXXXXXXXGOOOOOOOOOOOXXXXXXXX,0,256,0

40215,166,0,166,58,116,0,0,276,190,86,GOOOOOOOOOOOXXXXXXXXGOOOOOOOOOOOOOOOXXXXGOOOOOOOOOOOXXXXXXXXGOOOOOOOOOOOOOOOOXXXGOOOOOOOXXXXXXXXXXXXGOOOOOOOOOOOOOOOOOOOGOOOOOOOOXXXXXXXXXXXGOOOOOOOOOOOOXXXXXXXGOOOOOOOOOOOOOOOOOOXGOOOOOOXXXXXXXXXXXXXGOOOOOOOOOOOOXXXXXXXGOOOOOOOXXXXXXXXXXXXGOOOOOOOOOOOXXXXXXXX,0,256,0
40236,166,0,166,62,112,0,0,272,190,82,GOOOOOOOOOOOXXXXXXXXGOOOOOOOOOOOOOOOXXXXGOOOOOOOOOOOXXXXXXXXGOOOOOOOOOOOOOOOOXXXGOOOOOOOXXXXXXXXXXXXGOOOOOOOOOOOOOOOOOOOGOOOOOOOOXXXXXXXXXXXGOOOOOOOOOOOOXXXXXXXGOOOOOOOOOOOOOOOOOOXGOOOOOOXXXXXXXXXXXXXGOOOOOOOOOOOOXXXXXXXGOOOOOOOXXXXXXXXXXXXGOOOOOOOOOOOXXXXXXXX,0,256,0
40257,166,0,166,64,110,0,0,270,188,82,GOOOOOOOOOOOXXXXXXXXGOOOOOOOOOOOOOOOXXXXGOOOOOOOOOOOXXXXXXXXGOOOOOOOOOOOOOOOOXXXGOOOOOOOXXXXXXXXXXXXGOOOOOOOOOOOOOOOOOOOGOOOOOOOOXXXXXXXXXXXGOOOOOOOOOOOOXXXXXXXGOOOOOOOOOOOOOOOOOOXGOOOOOOXXXXXXXXXXXXXGOOOOOOOOOOOOXXXXXXXGOOOOOOOXXXXXXXXXXXXGOOOOOOOOOOOXXXXXXXX,0,256,0
40278,166,0,166,64,110,0,0,270,184,86,GOOOOOOOOOOOXXXXXXXXGOOOOOOOOOOOOOOOXXXXGOOOOOOOOOOOXXXXXXXXGOOOOOOOOOOOOOOOOXXXGOOOOOOOXXXXXXXXXXXXGOOOOOOOOOOOOOOOOOOOGOOOOOOOOXXXXXXXXXXXGOOOOOOOOOOOOXXXXXXXGOOOOOOOOOOOOOOOOOOXGOOOOOOXXXXXXXXXXXXXGOOOOOOOOOOOOXXXXXXXGOOOOOOOXXXXXXXXXXXXGOOOOOOOOOOOXXXXXXXX,0,256,0
40299,166,0,166,60,114,0,0,274,185,89,GOOOOOOOOOOOXXXXXXXXGOOOOOOOOOOOOOOOXXXXGOOOOOOOOOOOXXXXXXXXGOOOOOOOOOOOOOOOOXXXGOOOOOOOXXXXXXXXXXXXGOOOOOOOOOOOOOOOOOOOGOOOOOOOOXXXXXXXXXXXGOOOOOOOOOOOOXXXXXXXGOOOOOOOOOOOOOOOOOOXGOOOOOOXXXXXXXXXXXXXGOOOOOOOOOOOOXXXXXXXGOOOOOOOXXXXXXXXXXXXGOOOOOOOOOOOXXXXXXXX,0,256,0

40320,166,0,166,58,116,0,0,274,182,92,GOOOOOOOOOOOXXXXXXXXGOOOOOOOOOOOOOOOXXXXGOOOOOOOOOOOXXXXXXXXGOOOOOOOOOOOOOOOOXXXGOOOOOOOXXXXXXXXXXXXGOOOOOOOOOOOOOOOOOOOGOOOOOOOOXXXXXXXXXXXGOOOOOOOOOOOOXXXXXXXGOOOOOOOOOOOOOOOOOOXGOOOOOOXXXXXXXXXXXXXGOOOOOOOOOOOOXXXXXXXGOOOOOOOXXXXXXXXXXXXGOOOOOOOOOOOXXXXXXXX,0,256,0
40341,166,0,166,53,121,0,0,280,183,97,GOOOOOOOOOOOXXXXXXXXGOOOOOOOOOOOOOOOXXXXGOOOOOOOOOOOXXXXXXXXGOOOOOOOOOOOOOOOOXXXGOOOOOOOXXXXXXXXXXXXGOOOOOOOOOOOOOOOOOOOGOOOOOOOOXXXXXXXXXXXGOOOOOOOOOOOOXXXXXXXGOOOOOOOOOOOOOOOOOOXGOOOOOOXXXXXXXXXXXXXGOOOOOOOOOOOOXXXXXXXGOOOOOOOXXXXXXXXXXXXGOOOOOOOOOOOXXXXXXXX,0,256,0
40362,166,0,166,56,118,0,0,278,185,93,GOOOOOOOOOOOXXXXXXXXGOOOOOOOOOOOOOOOXXXXGOOOOOOOOOOOXXXXXXXXGOOOOOOOOOOOOOOOOXXXGOOOOOOOXXXXXXXXXXXXGOOOOOOOOOOOOOOOOOOOGOOOOOOOOXXXXXXXXXXXGOOOOOOOOOOOOXXXXXXXGOOOOOOOOOOOOOOOOOOXGOOOOOOXXXXXXXXXXXXXGOOOOOOOOOOOOXXXXXXXGOOOOOOOXXXXXXXXXXXXGOOOOOOOOOOOXXXXXXXX,0,256,0
40383,166,0,166,55,119,0,0,279,188,91,GOOOOOOOOOOOXXXXXXXXGOOOOOOOOOOOOOOOXXXXGOOOOOOOOOOOXXXXXXXXGOOOOOOOOOOOOOOOOXXXGOOOOOOOXXXXXXXXXXXXGOOOOOOOOOOOOOOOOOOOGOOOOOOOOXXXXXXXXXXXGOOOOOOOOOOOOXXXXXXXGOOOOOOOOOOOOOOOOOOXGOOOOOOXXXXXXXXXXXXXGOOOOOOOOOOOOXXXXXXXGOOOOOOOXXXXXXXXXXXXGOOOOOOOOOOOXXXXXXXX,0,256,0
40404,166,0,166,59,115,0,0,275,188,87,GOOOOOOOOOOOXXXXXXXXGOOOOOOOOOOOOOOOXXXXGOOOOOOOOOOOXXXXXXXXGOOOOOOOOOOOOOOOOXXXGOOOOOOOXXXXXXXXXXXXGOOOOOOOOOOOOOOOOOOOGOOOOOOOOXXXXXXXXXXXGOOOOOOOOOOOOXXXXXXXGOOOOOOOOOOOOOOOOOOXGOOOOOOXXXXXXXXXXXXXGOOOOOOOOOOOOXXXXXXXGOOOOOOOXXXXXXXXXXXXGOOOOOOOOOOOXXXXXXXX,0,256,0

40425,166,0,166,56,118,0,0,278,187,91,GOOOOOOOOOOOXXXXXXXXGOOOOOOOOOOOOOOOXXXXGOOOOOOOOOOOXXXXXXXXGOOOOOOOOOOOOOOOOXXXGOOOOOOOXXXXXXXXXXXXGOOOOOOOOOOOOOOOOOOOGOOOOOOOOXXXXXXXXXXXGOOOOOOOOOOOOXXXXXXXGOOOOOOOOOOOOOOOOOOXGOOOOOOXXXXXXXXXXXXXGOOOOOOOOOOOOXXXXXXXGOOOOOOOXXXXXXXXXXXXGOOOOOOOOOOOXXXXXXXX,0,256,0
40446,166,0,166,53,121,0,0,281,190,91,GOOOOOOOOOOOXXXXXXXXGOOOOOOOOOOOOOOOXXXXGOOOOOOOOOOOXXXXXXXXGOOOOOOOOOOOOOOOOXXXGOOOOOOOXXXXXXXXXXXXGOOOOOOOOOOOOOOOOOOOGOOOOOOOOXXXXXXXXXXXGOOOOOOOOOOOOXXXXXXXGOOOOOOOOOOOOOOOOOOXGOOOOOOXXXXXXXXXXXXXGOOOOOOOOOOOOXXXXXXXGOOOOOOOXXXXXXXXXXXXGOOOOOOOOOOOXXXXXXXX,0,256,0
40467,166,0,166,52,122,0,0,282,186,96,GOOOOOOOOOOOXXXXXXXXGOOOOOOOOOOOOOOOXXXXGOOOOOOOOOOOXXXXXXXXGOOOOOOOOOOOOOOOOXXXGOOOOOOOXXXXXXXXXXXXGOOOOOOOOOOOOOOOOOOOGOOOOOOOOXXXXXXXXXXXGOOOOOOOOOOOOXXXXXXXGOOOOOOOOOOOOOOOOOOXGOOOOOOXXXXXXXXXXXXXGOOOOOOOOOOOOXXXXXXXGOOOOOOOXXXXXXXXXXXXGOOOOOOOOOOOXXXXXXXX,0,256,0
40488,166,0,166,53,121,0,0,281,184,97,GOOOOOOOOOOOXXXXXXXXGOOOOOOOOOOOOOOOXXXXGOOOOOOOOOOOXXXXXXXXGOOOOOOOOOOOOOOOOXXXGOOOOOOOXXXXXXXXXXXXGOOOOOOOOOOOOOOOOOOOGOOOOOOOOXXXXXXXXXXXGOOOOOOOOOOOOXXXXXXXGOOOOOOOOOOOOOOOOOOXGOOOOOOXXXXXXXXXXXXXGOOOOOOOOOOOOXXXXXXXGOOOOOOOXXXXXXXXXXXXGOOOOOOOOOOOXXXXXXXX,0,256,0
40509,166,0,166,54,120,0,0,279,187,92,GOOOOOOOOOOOXXXXXXXXGOOOOOOOOOOOOOOOXXXXGOOOOOOOOOOOXXXXXXXXGOOOOOOOOOOOOOOOOXXXGOOOOOOOXXXXXXXXXXXXGOOOOOOOOOOOOOOOOOOOGOOOOOOOOXXXXXXXXXXXGOOOOOOOOOOOOXXXXXXXGOOOOOOOOOOOOOOOOOOXGOOOOOOXXXXXXXXXXXXXGOOOOOOOOOOOOXXXXXXXGOOOOOOOXXXXXXXXXXXXGOOOOOOOOOOOXXXXXXXX,0,256,0

40530,166,0,166,64,110,0,0,270,184,86,GOOOOOOOOOOOXXXXXXXXGOOOOOOOOOOOOOOOXXXXGOOOOOOOOOOOXXXXXXXXGOOOOOOOOOOOOOOOOXXXGOOOOOOOXXXXXXXXXXXXGOOOOOOOOOOOOOOOOOOOGOOOOOOOOXXXXXXXXXXXGOOOOOOOOOOOOXXXXXXXGOOOOOOOOOOOOOOOOOOXGOOOOOOXXXXXXXXXXXXXGOOOOOOOOOOOOXXXXXXXGOOOOOOOXXXXXXXXXXXXGOOOOOOOOOOOXXXXXXXX,0,256,0
40551,166,0,166,61,113,0,0,273,187,86,GOOOOOOOOOOOXXXXXXXXGOOOOOOOOOOOOOOOXXXXGOOOOOOOOOOOXXXXXXXXGOOOOOOOOOOOOOOOOXXXGOOOOOOOXXXXXXXXXXXXGOOOOOOOOOOOOOOOOOOOGOOOOOOOOXXXXXXXXXXXGOOOOOOOOOOOOXXXXXXXGOOOOOOOOOOOOOOOOOOXGOOOOOOXXXXXXXXXXXXXGOOOOOOOOOOOOXXXXXXXGOOOOOOOXXXXXXXXXXXXGOOOOOOOOOOOXXXXXXXX,0,256,0
40572,166,0,166,59,115,0,0,275,185,90,GOOOOOOOOOOOXXXXXXXXGOOOOOOOOOOOOOOOXXXXGOOOOOOOOOOOXXXXXXXXGOOOOOOOOOOOOOOOOXXXGOOOOOOOXXXXXXXXXXXXGOOOOOOOOOOOOOOOOOOOGOOOOOOOOXXXXXXXXXXXGOOOOOOOOOOOOXXXXXXXGOOOOOOOOOOOOOOOOOOXGOOOOOOXXXXXXXXXXXXXGOOOOOOOOOOOOXXXXXXXGOOOOOOOXXXXXXXXXXXXGOOOOOOOOOOOXXXXXXXX,0,256,0
40593,166,0,166,56,118,0,0,277,189,88,GOOOOOOOOOOOXXXXXXXXGOOOOOOOOOOOOOOOXXXXGOOOOOOOOOOOXXXXXXXXGOOOOOOOOOOOOOOOOXXXGOOOOOOOXXXXXXXXXXXXGOOOOOOOOOOOOOOOOOOOGOOOOOOOOXXXXXXXXXXXGOOOOOOOOOOOOXXXXXXXGOOOOOOOOOOOOOOOOOOXGOOOOOOXXXXXXXXXXXXXGOOOOOOOOOOOOXXXXXXXGOOOOOOOXXXXXXXXXXXXGOOOOOOOOOOOXXXXXXXX,0,256,0
40614,166,0,166,57,117,0,0,277,188,89,GOOOOOOOOOOOXXXXXXXXGOOOOOOOOOOOOOOOXXXXGOOOOOOOOOOOXXXXXXXXGOOOOOOOOOOOOOOOOXXXGOOOOOOOXXXXXXXXXXXXGOOOOOOOOOOOOOOOOOOOGOOOOOOOOXXXXXXXXXXXGOOOOOOOOOOOOXXXXXXXGOOOOOOOOOOOOOOOOOOXGOOOOOOXXXXXXXXXXXXXGOOOOOOOOOOOOXXXXXXXGOOOOOOOXXXXXXXXXXXXGOOOOOOOOOOOXXXXXXXX,0,256,0

40635,166,0,166,55,119,0,0,278,191,87,GOOOOOOOOOOOXXXXXXXXGOOOOOOOOOOOOOOOXXXXGOOOOOOOOOOOXXXXXXXXGOOOOOOOOOOOOOOOOXXXGOOOOOOOXXXXXXXXXXXXGOOOOOOOOOOOOOOOOOOOGOOOOOOOOXXXXXXXXXXXGOOOOOOOOOOOOXXXXXXXGOOOOOOOOOOOOOOOOOOXGOOOOOOXXXXXXXXXXXXXGOOOOOOOOOOOOXXXXXXXGOOOOOOOXXXXXXXXXXXXGOOOOOOOOOOOXXXXXXXX,0,256,0
40656,166,0,166,57,117,0,0,276,192,84,GOOOOOOOOOOOXXXXXXXXGOOOOOOOOOOOOOOOXXXXGOOOOOOOOOOOXXXXXXXXGOOOOOOOOOOOOOOOOXXXGOOOOOOOXXXXXXXXXXXXGOOOOOOOOOOOOOOOOOOOGOOOOOOOOXXXXXXXXXXXGOOOOOOOOOOOOXXXXXXXGOOOOOOOOOOOOOOOOOOXGOOOOOOXXXXXXXXXXXXXGOOOOOOOOOOOOXXXXXXXGOOOOOOOXXXXXXXXXXXXGOOOOOOOOOOOXXXXXXXX,0,256,0
40677,166,0,166,58,116,0,0,275,196,79,GOOOOOOOOOOOXXXXXXXXGOOOOOOOOOOOOOOOXXXXGOOOOOOOOOOOXXXXXXXXGOOOOOOOOOOOOOOOOXXXGOOOOOOOXXXXXXXXXXXXGOOOOOOOOOOOOOOOOOOOGOOOOOOOOXXXXXXXXXXXGOOOOOOOOOOOOXXXXXXXGOOOOOOOOOOOOOOOOOOXGOOOOOOXXXXXXXXXXXXXGOOOOOOOOOOOOXXXXXXXGOOOOOOOXXXXXXXXXXXXGOOOOOOOOOOOXXXXXXXX,0,256,0
40698,166,0,166,54,120,0,0,280,196,84,GOOOOOOOOOOOXXXXXXXXGOOOOOOOOOOOOOOOXXXXGOOOOOOOOOOOXXXXXXXXGOOOOOOOOOOOOOOOOXXXGOOOOOOOXXXXXXXXXXXXGOOOOOOOOOOOOOOOOOOOGOOOOOOOOXXXXXXXXXXXGOOOOOOOOOOOOXXXXXXXGOOOOOOOOOOOOOOOOOOXGOOOOOOXXXXXXXXXXXXXGOOOOOOOOOOOOXXXXXXXGOOOOOOOXXXXXXXXXXXXGOOOOOOOOOOOXXXXXXXX,0,256,0
40719,166,0,166,58,116,0,0,275,193,82,GOOOOOOOOOOOXXXXXXXXGOOOOOOOOOOOOOOOXXXXGOOOOOOOOOOOXXXXXXXXGOOOOOOOOOOOOOOOOXXXGOOOOOOOXXXXXXXXXXXXGOOOOOOOOOOOOOOOOOOOGOOOOOOOOXXXXXXXXXXXGOOOOOOOOOOOOXXXXXXXGOOOOOOOOOOOOOOOOOOXGOOOOOOXXXXXXXXXXXXXGOOOOOOOOOOOOXXXXXXXGOOOOOOOXXXXXXXXXXXXGOOOOOOOOOOOXXXXXXXX,0,256,0

40740,166,0,166,57,117,0,0,277,192,85,GOOOOOOOOOOOXXXXXXXXGOOOOOOOOOOOOOOOXXXXGOOOOOOOOOOOXXXXXXXXGOOOOOOOOOOOOOOOOXXXGOOOOOOOXXXXXXXXXXXXGOOOOOOOOOOOOOOOOOOOGOOOOOOOOXXXXXXXXXXXGOOOOOOOOOOOOXXXXXXXGOOOOOOOOOOOOOOOOOOXGOOOOOOXXXXXXXXXXXXXGOOOOOOOOOOOOXXXXXXXGOOOOOOOXXXXXXXXXXXXGOOOOOOOOOOOXXXXXXXX,0,256,0
40761,166,0,166,57,117,0,0,277,190,87,GOOOOOOOOOOOXXXXXXXXGOOOOOOOOOOOOOOOXXXXGOOOOOOOOOOOXXXXXXXXGOOOOOOOOOOOOOOOOXXXGOOOOOOOXXXXXXXXXXXXGOOOOOOOOOOOOOOOOOOOGOOOOOOOOXXXXXXXXXXXGOOOOOOOOOOOOXXXXXXXGOOOOOOOOOOOOOOOOOOXGOOOOOOXXXXXXXXXXXXXGOOOOOOOOOOOOXXXXXXXGOOOOOOOXXXXXXXXXXXXGOOOOOOOOOOOXXXXXXXX,0,256,0
40782,166,0,166,59,115,0,0,275,187,88,GOOOOOOOOOOOXXXXXXXXGOOOOOOOOOOOOOOOXXXXGOOOOOOOOOOOXXXXXXXXGOOOOOOOOOOOOOOOOXXXGOOOOOOOXXXXXXXXXXXXGOOOOOOOOOOOOOOOOOOOGOOOOOOOOXXXXXXXXXXXGOOOOOOOOOOOOXXXXXXXGOOOOOOOOOOOOOOOOOOXGOOOOOOXXXXXXXXXXXXXGOOOOOOOOOOOOXXXXXXXGOOOOOOOXXXXXXXXXXXXGOOOOOOOOOOOXXXXXXXX,0,256,0
40803,166,0,166,54,120,0,0,280,190,90,GOOOOOOOOOOOXXXXXXXXGOOOOOOOOOOOOOOOXXXXGOOOOOOOOOOOXXXXXXXXGOOOOOOOOOOOOOOOOXXXGOOOOOOOXXXXXXXXXXXXGOOOOOOOOOOOOOOOOOOOGOOOOOOOOXXXXXXXXXXXGOOOOOOOOOOOOXXXXXXXGOOOOOOOOOOOOOOOOOOXGOOOOOOXXXXXXXXXXXXXGOOOOOOOOOOOOXXXXXXXGOOOOOOOXXXXXXXXXXXXGOOOOOOOOOOOXXXXXXXX,0,256,0
40824,166,0,166,52,122,0,0,282,191,91,GOOOOOOOOOOOXXXXXXXXGOOOOOOOOOOOOOOOXXXXGOOOOOOOOOOOXXXXXXXXGOOOOOOOOOOOOOOOOXXXGOOOOOOOXXXXXXXXXXXXGOOOOOOOOOOOOOOOOOOOGOOOOOOOOXXXXXXXXXXXGOOOOOOOOOOOOXXXXXXXGOOOOOOOOOOOOOOOOOOXGOOOOOOXXXXXXXXXXXXXGOOOOOOOOOOOOXXXXXXXGOOOOOOOXXXXXXXXXXXXGOOOOOOOOOOOXXXXXXXX,0,256,0

40845,166,0,166,53,121,0,0,281,188,93,GOOOOOOOOOOOXXXXXXXXGOOOOOOOOOOOOOOOXXXXGOOOOOOOOOOOXXXXXXXXGOOOOOOOOOOOOOOOOXXXGOOOOOOOXXXXXXXXXXXXGOOOOOOOOOOOOOOOOOOOGOOOOOOOOXXXXXXXXXXXGOOOOOOOOOOOOXXXXXXXGOOOOOOOOOOOOOOOOOOXGOOOOOOXXXXXXXXXXXXXGOOOOOOOOOOOOXXXXXXXGOOOOOOOXXXXXXXXXXXXGOOOOOOOOOOOXXXXXXXX,0,256,0
40866,166,0,166,52,122,0,0,282,185,97,GOOOOOOOOOOOXXXXXXXXGOOOOOOOOOOOOOOOXXXXGOOOOOOOOOOOXXXXXXXXGOOOOOOOOOOOOOOOOXXXGOOOOOOOXXXXXXXXXXXXGOOOOOOOOOOOOOOOOOOOGOOOOOOOOXXXXXXXXXXXGOOOOOOOOOOOOXXXXXXXGOOOOOOOOOOOOOOOOOOXGOOOOOOXXXXXXXXXXXXXGOOOOOOOOOOOOXXXXXXXGOOOOOOOXXXXXXXXXXXXGOOOOOOOOOOOXXXXXXXX,0,256,0
40887,166,0,166,55,119,0,0,279,183,96,GOOOOOOOOOOOXXXXXXXXGOOOOOOOOOOOOOOOXXXXGOOOOOOOOOOOXXXXXXXXGOOOOOOOOOOOOOOOOXXXGOOOOOOOXXXXXXXXXXXXGOOOOOOOOOOOOOOOOOOOGOOOOOOOOXXXXXXXXXXXGOOOOOOOOOOOOXXXXXXXGOOOOOOOOOOOOOOOOOOXGOOOOOOXXXXXXXXXXXXXGOOOOOOOOOOOOXXXXXXXGOOOOOOOXXXXXXXXXXXXGOOOOOOOOOOOXXXXXXXX,0,256,0
40908,166,0,166,54,120,0,0,280,186,94,GOOOOOOOOOOOXXXXXXXXGOOOOOOOOOOOOOOOXXXXGOOOOOOOOOOOXXXXXXXXGOOOOOOOOOOOOOOOOXXXGOOOOOOOXXXXXXXXXXXXGOOOOOOOOOOOOOOOOOOOGOOOOOOOOXXXXXXXXXXXGOOOOOOOOOOOOXXXXXXXGOOOOOOOOOOOOOOOOOOXGOOOOOOXXXXXXXXXXXXXGOOOOOOOOOOOOXXXXXXXGOOOOOOOXXXXXXXXXXXXGOOOOOOOOOOOXXXXXXXX,0,256,0
40929,166,0,166,55,119,0,0,279,187,92,GOOOOOOOOOOOXXXXXXXXGOOOOOOOOOOOOOOOXXXXGOOOOOOOOOOOXXXXXXXXGOOOOOOOOOOOOOOOOXXXGOOOOOOOXXXXXXXXXXXXGOOOOOOOOOOOOOOOOOOOGOOOOOOOOXXXXXXXXXXXGOOOOOOOOOOOOXXXXXXXGOOOOOOOOOOOOOOOOOOXGOOOOOOXXXXXXXXXXXXXGOOOOOOOOOOOOXXXXXXXGOOOOOOOXXXXXXXXXXXXGOOOOOOOOOOOXXXXXXXX,0,256,0

40950,166,0,166,49,125,0,0,284,191,93,GOOOOOOOOOOOXXXXXXXXGOOOOOOOOOOOOOOOXXXXGOOOOOOOOOOOXXXXXXXXGOOOOOOOOOOOOOOOOXXXGOOOOOOOXXXXXXXXXXXXGOOOOOOOOOOOOOOOOOOOGOOOOOOOOXXXXXXXXXXXGOOOOOOOOOOOOXXXXXXXGOOOOOOOOOOOOOOOOOOXGOOOOOOXXXXXXXXXXXXXGOOOOOOOOOOOOXXXXXXXGOOOOOOOXXXXXXXXXXXXGOOOOOOOOOOOXXXXXXXX,0,256,0
40971,166,0,166,49,125,0,0,285,189,96,GOOOOOOOOOOOXXXXXXXXGOOOOOOOOOOOOOOOXXXXGOOOOOOOOOOOXXXXXXXXGOOOOOOOOOOOOOOOOXXXGOOOOOOOXXXXXXXXXXXXGOOOOOOOOOOOOOOOOOOOGOOOOOOOOXXXXXXXXXXXGOOOOOOOOOOOOXXXXXXXGOOOOOOOOOOOOOOOOOOXGOOOOOOXXXXXXXXXXXXXGOOOOOOOOOOOOXXXXXXXGOOOOOOOXXXXXXXXXXXXGOOOOOOOOOOOXXXXXXXX,0,256,0
40992,167,1,166,49,124,0,0,283,186,97,GOOOOOOOOOOOXXXXXXXXGOOOOOOOOOOOOOOOAXXXGOOOOOOOOOOOXXXXXXXXGOOOOOOOOOOOOOOOOXXXGOOOOOOOXXXXXXXXXXXXGOOOOOOOOOOOOOOOOOOOGOOOOOOOOXXXXXXXXXXXGOOOOOOOOOOOOXXXXXXXGOOOOOOOOOOOOOOOOOOXGOOOOOOXXXXXXXXXXXXXGOOOOOOOOOOOOXXXXXXXGOOOOOOOXXXXXXXXXXXXGOOOOOOOOOOOXXXXXXXX,0,256,0
41013,167,1,166,45,128,0,0,288,183,105,GOOOOOOOOOOOXXXXXXXXGOOOOOOOOOOOOOOOAXXXGOOOOOOOOOOOXXXXXXXXGOOOOOOOOOOOOOOOOXXXGOOOOOOOXXXXXXXXXXXXGOOOOOOOOOOOOOOOOOOOGOOOOOOOOXXXXXXXXXXXGOOOOOOOOOOOOXXXXXXXGOOOOOOOOOOOOOOOOOOXGOOOOOOXXXXXXXXXXXXXGOOOOOOOOOOOOXXXXXXXGOOOOOOOXXXXXXXXXXXXGOOOOOOOOOOOXXXXXXXX,0,256,0
41034,167,1,166,47,126,0,0,286,189,97,GOOOOOOOOOOOXXXXXXXXGOOOOOOOOOOOOOOOAXXXGOOOOOOOOOOOXXXXXXXXGOOOOOOOOOOOOOOOOXXXGOOOOOOOXXXXXXXXXXXXGOOOOOOOOOOOOOOOOOOOGOOOOOOOOXXXXXXXXXXXGOOOOOOOOOOOOXXXXXXXGOOOOOOOOOOOOOOOOOOXGOOOOOOXXXXXXXXXXXXXGOOOOOOOOOOOOXXXXXXXGOOOOOOOXXXXXXXXXXXXGOOOOOOOOOOOXXXXXXXX,0,256,0

41055,167,1,166,50,123,0,0,283,188,95,GOOOOOOOOOOOXXXXXXXXGOOOOOOOOOOOOOOOAXXXGOOOOOOOOOOOXXXXXXXXGOOOOOOOOOOOOOOOOXXXGOOOOOOOXXXXXXXXXXXXGOOOOOOOOOOOOOOOOOOOGOOOOOOOOXXXXXXXXXXXGOOOOOOOOOOOOXXXXXXXGOOOOOOOOOOOOOOOOOOXGOOOOOOXXXXXXXXXXXXXGOOOOOOOOOOOOXXXXXXXGOOOOOOOXXXXXXXXXXXXGOOOOOOOOOOOXXXXXXXX,0,256,0
41076,168,2,166,53,119,0,0,279,185,94,GOOOOOOOOOOOXXXXXXXXGOOOOOOOOOOOOOOOAAXXGOOOOOOOOOOOXXXXXXXXGOOOOOOOOOOOOOOOOXXXGOOOOOOOXXXXXXXXXXXXGOOOOOOOOOOOOOOOOOOOGOOOOOOOOXXXXXXXXXXXGOOOOOOOOOOOOXXXXXXXGOOOOOOOOOOOOOOOOOOXGOOOOOOXXXXXXXXXXXXXGOOOOOOOOOOOOXXXXXXXGOOOOOOOXXXXXXXXXXXXGOOOOOOOOOOOXXXXXXXX,0,256,0
41097,168,2,166,52,120,0,0,280,187,93,GOOOOOOOOOOOXXXXXXXXGOOOOOOOOOOOOOOOAAXXGOOOOOOOOOOOXXXXXXXXGOOOOOOOOOOOOOOOOXXXGOOOOOOOXXXXXXXXXXXXGOOOOOOOOOOOOOOOOOOOGOOOOOOOOXXXXXXXXXXXGOOOOOOOOOOOOXXXXXXXGOOOOOOOOOOOOOOOOOOXGOOOOOOXXXXXXXXXXXXXGOOOOOOOOOOOOXXXXXXXGOOOOOOOXXXXXXXXXXXXGOOOOOOOOOOOXXXXXXXX,0,256,0
41118,168,2,166,51,121,0,0,281,192,89,GOOOOOOOOOOOXXXXXXXXGOOOOOOOOOOOOOOOAAXXGOOOOOOOOOOOXXXXXXXXGOOOOOOOOOOOOOOOOXXXGOOOOOOOXXXXXXXXXXXXGOOOOOOOOOOOOOOOOOOOGOOOOOOOOXXXXXXXXXXXGOOOOOOOOOOOOXXXXXXXGOOOOOOOOOOOOOOOOOOXGOOOOOOXXXXXXXXXXXXXGOOOOOOOOOOOOXXXXXXXGOOOOOOOXXXXXXXXXXXXGOOOOOOOOOOOXXXXXXXX,0,256,0
41139,168,2,166,53,119,0,0,279,190,89,GOOOOOOOOOOOXXXXXXXXGOOOOOOOOOOOOOOOAAXXGOOOOOOOOOOOXXXXXXXXGOOOOOOOOOOOOOOOOXXXGOOOOOOOXXXXXXXXXXXXGOOOOOOOOOOOOOOOOOOOGOOOOOOOOXXXXXXXXXXXGOOOOOOOOOOOOXXXXXXXGOOOOOOOOOOOOOOOOOOXGOOOOOOXXXXXXXXXXXXXGOOOOOOOOOOOOXXXXXXXGOOOOOOOXXXXXXXXXXXXGOOOOOOOOOOOXXXXXXXX,0,256,0

41160,168,1,167,54,118,0,0,278,189,89,GOOOOOOOOOOOXXXXXXXXGOOOOOOOOOOOOOOOOAXXGOOOOOOOOOOOXXXXXXXXGOOOOOOOOOOOOOOOOXXXGOOOOOOOXXXXXXXXXXXXGOOOOOOOOOOOOOOOOOOOGOOOOOOOOXXXXXXXXXXXGOOOOOOOOOOOOXXXXXXXGOOOOOOOOOOOOOOOOOOXGOOOOOOXXXXXXXXXXXXXGOOOOOOOOOOOOXXXXXXXGOOOOOOOXXXXXXXXXXXXGOOOOOOOOOOOXXXXXXXX,0,256,0
41181,168,1,167,52,120,0,0,280,193,87,GOOOOOOOOOOOXXXXXXXXGOOOOOOOOOOOOOOOOAXXGOOOOOOOOOOOXXXXXXXXGOOOOOOOOOOOOOOOOXXXGOOOOOOOXXXXXXXXXXXXGOOOOOOOOOOOOOOOOOOOGOOOOOOOOXXXXXXXXXXXGOOOOOOOOOOOOXXXXXXXGOOOOOOOOOOOOOOOOOOXGOOOOOOXXXXXXXXXXXXXGOOOOOOOOOOOOXXXXXXXGOOOOOOOXXXXXXXXXXXXGOOOOOOOOOOOXXXXXXXX,0,256,0
41202,168,1,167,49,123,0,0,283,188,95,GOOOOOOOOOOOXXXXXXXXGOOOOOOOOOOOOOOOOAXXGOOOOOOOOOOOXXXXXXXXGOOOOOOOOOOOOOOOOXXXGOOOOOOOXXXXXXXXXXXXGOOOOOOOOOOOOOOOOOOOGOOOOOOOOXXXXXXXXXXXGOOOOOOOOOOOOXXXXXXXGOOOOOOOOOOOOOOOOOOXGOOOOOOXXXXXXXXXXXXXGOOOOOOOOOOOOXXXXXXXGOOOOOOOXXXXXXXXXXXXGOOOOOOOOOOOXXXXXXXX,0,256,0
41223,168,1,167,48,124,0,0,284,190,94,GOOOOOOOOOOOXXXXXXXXGOOOOOOOOOOOOOOOOAXXGOOOOOOOOOOOXXXXXXXXGOOOOOOOOOOOOOOOOXXXGOOOOOOOXXXXXXXXXXXXGOOOOOOOOOOOOOOOOOOOGOOOOOOOOXXXXXXXXXXXGOOOOOOOOOOOOXXXXXXXGOOOOOOOOOOOOOOOOOOXGOOOOOOXXXXXXXXXXXXXGOOOOOOOOOOOOXXXXXXXGOOOOOOOXXXXXXXXXXXXGOOOOOOOOOOOXXXXXXXX,0,256,0
41244,168,1,167,47,125,0,0,285,189,96,GOOOOOOOOOOOXXXXXXXXGOOOOOOOOOOOOOOOOAXXGOOOOOOOOOOOXXXXXXXXGOOOOOOOOOOOOOOOOXXXGOOOOOOOXXXXXXXXXXXXGOOOOOOOOOOOOOOOOOOOGOOOOOOOOXXXXXXXXXXXGOOOOOOOOOOOOXXXXXXXGOOOOOOOOOOOOOOOOOOXGOOOOOOXXXXXXXXXXXXXGOOOOOOOOOOOOXXXXXXXGOOOOOOOXXXXXXXXXXXXGOOOOOOOOOOOXXXXXXXX,0,256,0

41265,168,0,168,46,126,0,0,286,190,96,GOOOOOOOOOOOXXXXXXXXGOOOOOOOOOOOOOOOOOXXGOOOOOOOOOOOXXXXXXXXGOOOOOOOOOOOOOOOOXXXGOOOOOOOXXXXXXXXXXXXGOOOOOOOOOOOOOOOOOOOGOOOOOOOOXXXXXXXXXXXGOOOOOOOOOOOOXXXXXXXGOOOOOOOOOOOOOOOOOOXGOOOOOOXXXXXXXXXXXXXGOOOOOOOOOOOOXXXXXXXGOOOOOOOXXXXXXXXXXXXGOOOOOOOOOOOXXXXXXXX,0,256,0
41286,168,0,168,47,125,0,0,284,193,91,GOOOOOOOOOOOXXXXXXXXGOOOOOOOOOOOOOOOOOXXGOOOOOOOOOOOXXXXXXXXGOOOOOOOOOOOOOOOOXXXGOOOOOOOXXXXXXXXXXXXGOOOOOOOOOOOOOOOOOOOGOOOOOOOOXXXXXXXXXXXGOOOOOOOOOOOOXXXXXXXGOOOOOOOOOOOOOOOOOOXGOOOOOOXXXXXXXXXXXXXGOOOOOOOOOOOOXXXXXXXGOOOOOOOXXXXXXXXXXXXGOOOOOOOOOOOXXXXXXXX,0,256,0
41307,168,0,168,46,126,0,0,286,196,90,GOOOOOOOOOOOXXXXXXXXGOOOOOOOOOOOOOOOOOXXGOOOOOOOOOOOXXXXXXXXGOOOOOOOOOOOOOOOOXXXGOOOOOOOXXXXXXXXXXXXGOOOOOOOOOOOOOOOOOOOGOOOOOOOOXXXXXXXXXXXGOOOOOOOOOOOOXXXXXXXGOOOOOOOOOOOOOOOOOOXGOOOOOOXXXXXXXXXXXXXGOOOOOOOOOOOOXXXXXXXGOOOOOOOXXXXXXXXXXXXGOOOOOOOOOOOXXXXXXXX,0,256,0
41328,168,0,168,50,122,0,0,281,193,88,GOOOOOOOOOOOXXXXXXXXGOOOOOOOOOOOOOOOOOXXGOOOOOOOOOOOXXXXXXXXGOOOOOOOOOOOOOOOOXXXGOOOOOOOXXXXXXXXXXXXGOOOOOOOOOOOOOOOOOOOGOOOOOOOOXXXXXXXXXXXGOOOOOOOOOOOOXXXXXXXGOOOOOOOOOOOOOOOOOOXGOOOOOOXXXXXXXXXXXXXGOOOOOOOOOOOOXXXXXXXGOOOOOOOXXXXXXXXXXXXGOOOOOOOOOOOXXXXXXXX,0,256,0
41349,168,0,168,52,120,0,0,279,193,86,GOOOOOOOOOOOXXXXXXXXGOOOOOOOOOOOOOOOOOXXGOOOOOOOOOOOXXXXXXXXGOOOOOOOOOOOOOOOOXXXGOOOOOOOXXXXXXXXXXXXGOOOOOOOOOOOOOOOOOOOGOOOOOOOOXXXXXXXXXXXGOOOOOOOOOOOOXXXXXXXGOOOOOOOOOOOOOOOOOOXGOOOOOOXXXXXXXXXXXXXGOOOOOOOOOOOOXXXXXXXGOOOOOOOXXXXXXXXXXXXGOOOOOOOOOOOXXXXXXXX,0,256,0

41370,168,0,168,52,120,0,0,280,195,85,GOOOOOOOOOOOXXXXXXXXGOOOOOOOOOOOOOOOOOXXGOOOOOOOOOOOXXXXXXXXGOOOOOOOOOOOOOOOOXXXGOOOOOOOXXXXXXXXXXXXGOOOOOOOOOOOOOOOOOOOGOOOOOOOOXXXXXXXXXXXGOOOOOOOOOOOOXXXXXXXGOOOOOOOOOOOOOOOOOOXGOOOOOOXXXXXXXXXXXXXGOOOOOOOOOOOOXXXXXXXGOOOOOOOXXXXXXXXXXXXGOOOOOOOOOOOXXXXXXXX,0,256,0
41391,168,0,168,59,113,0,0,273,190,83,GOOOOOOOOOOOXXXXXXXXGOOOOOOOOOOOOOOOOOXXGOOOOOOOOOOOXXXXXXXXGOOOOOOOOOOOOOOOOXXXGOOOOOOOXXXXXXXXXXXXGOOOOOOOOOOOOOOOOOOOGOOOOOOOOXXXXXXXXXXXGOOOOOOOOOOOOXXXXXXXGOOOOOOOOOOOOOOOOOOXGOOOOOOXXXXXXXXXXXXXGOOOOOOOOOOOOXXXXXXXGOOOOOOOXXXXXXXXXXXXGOOOOOOOOOOOXXXXXXXX,0,256,0
41412,168,0,168,60,112,0,0,272,192,80,GOOOOOOOOOOOXXXXXXXXGOOOOOOOOOOOOOOOOOXXGOOOOOOOOOOOXXXXXXXXGOOOOOOOOOOOOOOOOXXXGOOOOOOOXXXXXXXXXXXXGOOOOOOOOOOOOOOOOOOOGOOOOOOOOXXXXXXXXXXXGOOOOOOOOOOOOXXXXXXXGOOOOOOOOOOOOOOOOOOXGOOOOOOXXXXXXXXXXXXXGOOOOOOOOOOOOXXXXXXXGOOOOOOOXXXXXXXXXXXXGOOOOOOOOOOOXXXXXXXX,0,256,0
41433,168,0,168,62,110,0,0,270,190,80,GOOOOOOOOOOOXXXXXXXXGOOOOOOOOOOOOOOOOOXXGOOOOOOOOOOOXXXXXXXXGOOOOOOOOOOOOOOOOXXXGOOOOOOOXXXXXXXXXXXXGOOOOOOOOOOOOOOOOOOOGOOOOOOOOXXXXXXXXXXXGOOOOOOOOOOOOXXXXXXXGOOOOOOOOOOOOOOOOOOXGOOOOOOXXXXXXXXXXXXXGOOOOOOOOOOOOXXXXXXXGOOOOOOOXXXXXXXXXXXXGOOOOOOOOOOOXXXXXXXX,0,256,0
41454,168,0,168,60,112,0,0,272,191,81,GOOOOOOOOOOOXXXXXXXXGOOOOOOOOOOOOOOOOOXXGOOOOOOOOOOOXXXXXXXXGOOOOOOOOOOOOOOOOXXXGOOOOOOOXXXXXXXXXXXXGOOOOOOOOOOOOOOOOOOOGOOOOOOOOXXXXXXXXXXXGOOOOOOOOOOOOXXXXXXXGOOOOOOOOOOOOOOOOOOXGOOOOOOXXXXXXXXXXXXXGOOOOOOOOOOOOXXXXXXXGOOOOOOOXXXXXXXXXXXXGOOOOOOOOOOOXXXXXXXX,0,256,0

41475,168,0,168,59,113,0,0,273,188,85,GOOOOOOOOOOOXXXXXXXXGOOOOOOOOOOOOOOOOOXXGOOOOOOOOOOOXXXXXXXXGOOOOOOOOOOOOOOOOXXXGOOOOOOOXXXXXXXXXXXXGOOOOOOOOOOOOOOOOOOOGOOOOOOOOXXXXXXXXXXXGOOOOOOOOOOOOXXXXXXXGOOOOOOOOOOOOOOOOOOXGOOOOOOXXXXXXXXXXXXXGOOOOOOOOOOOOXXXXXXXGOOOOOOOXXXXXXXXXXXXGOOOOOOOOOOOXXXXXXXX,0,256,0
41496,168,0,168,57,115,0,0,275,188,87,GOOOOOOOOOOOXXXXXXXXGOOOOOOOOOOOOOOOOOXXGOOOOOOOOOOOXXXXXXXXGOOOOOOOOOOOOOOOOXXXGOOOOOOOXXXXXXXXXXXXGOOOOOOOOOOOOOOOOOOOGOOOOOOOOXXXXXXXXXXXGOOOOOOOOOOOOXXXXXXXGOOOOOOOOOOOOOOOOOOXGOOOOOOXXXXXXXXXXXXXGOOOOOOOOOOOOXXXXXXXGOOOOOOOXXXXXXXXXXXXGOOOOOOOOOOOXXXXXXXX,0,256,0
41517,168,0,168,58,114,0,0,274,188,86,GOOOOOOOOOOOXXXXXXXXGOOOOOOOOOOOOOOOOOXXGOOOOOOOOOOOXXXXXXXXGOOOOOOOOOOOOOOOOXXXGOOOOOOOXXXXXXXXXXXXGOOOOOOOOOOOOOOOOOOOGOOOOOOOOXXXXXXXXXXXGOOOOOOOOOOOOXXXXXXXGOOOOOOOOOOOOOOOOOOXGOOOOOOXXXXXXXXXXXXXGOOOOOOOOOOOOXXXXXXXGOOOOOOOXXXXXXXXXXXXGOOOOOOOOOOOXXXXXXXX,0,256,0
41538,168,0,168,54,118,0,0,278,190,88,GOOOOOOOOOOOXXXXXXXXGOOOOOOOOOOOOOOOOOXXGOOOOOOOOOOOXXXXXXXXGOOOOOOOOOOOOOOOOXXXGOOOOOOOXXXXXXXXXXXXGOOOOOOOOOOOOOOOOOOOGOOOOOOOOXXXXXXXXXXXGOOOOOOOOOOOOXXXXXXXGOOOOOOOOOOOOOOOOOOXGOOOOOOXXXXXXXXXXXXXGOOOOOOOOOOOOXXXXXXXGOOOOOOOXXXXXXXXXXXXGOOOOOOOOOOOXXXXXXXX,0,256,0
41559,168,0,168,51,121,0,0,281,191,90,GOOOOOOOOOOOXXXXXXXXGOOOOOOOOOOOOOOOOOXXGOOOOOOOOOOOXXXXXXXXGOOOOOOOOOOOOOOOOXXXGOOOOOOOXXXXXXXXXXXXGOOOOOOOOOOOOOOOOOOOGOOOOOOOOXXXXXXXXXXXGOOOOOOOOOOOOXXXXXXXGOOOOOOOOOOOOOOOOOOXGOOOOOOXXXXXXXXXXXXXGOOOOOOOOOOOOXXXXXXXGOOOOOOOXXXXXXXXXXXXGOOOOOOOOOOOXXXXXXXX,0,256,0

41580,168,0,168,56,116,0,0,276,190,86,GOOOOOOOOOOOXXXXXXXXGOOOOOOOOOOOOOOOOOXXGOOOOOOOOOOOXXXXXXXXGOOOOOOOOOOOOOOOOXXXGOOOOOOOXXXXXXXXXXXXGOOOOOOOOOOOOOOOOOOOGOOOOOOOOXXXXXXXXXXXGOOOOOOOOOOOOXXXXXXXGOOOOOOOOOOOOOOOOOOXGOOOOOOXXXXXXXXXXXXXGOOOOOOOOOOOOXXXXXXXGOOOOOOOXXXXXXXXXXXXGOOOOOOOOOOOXXXXXXXX,0,256,0
41601,168,0,168,58,114,0,0,274,187,87,GOOOOOOOOOOOXXXXXXXXGOOOOOOOOOOOOOOOOOXXGOOOOOOOOOOOXXXXXXXXGOOOOOOOOOOOOOOOOXXXGOOOOOOOXXXXXXXXXXXXGOOOOOOOOOOOOOOOOOOOGOOOOOOOOXXXXXXXXXXXGOOOOOOOOOOOOXXXXXXXGOOOOOOOOOOOOOOOOOOXGOOOOOOXXXXXXXXXXXXXGOOOOOOOOOOOOXXXXXXXGOOOOOOOXXXXXXXXXXXXGOOOOOOOOOOOXXXXXXXX,0,256,0
41622,168,0,168,62,110,0,0,270,187,83,GOOOOOOOOOOOXXXXXXXXGOOOOOOOOOOOOOOOOOXXGOOOOOOOOOOOXXXXXXXXGOOOOOOOOOOOOOOOOXXXGOOOOOOOXXXXXXXXXXXXGOOOOOOOOOOOOOOOOOOOGOOOOOOOOXXXXXXXXXXXGOOOOOOOOOOOOXXXXXXXGOOOOOOOOOOOOOOOOOOXGOOOOOOXXXXXXXXXXXXXGOOOOOOOOOOOOXXXXXXXGOOOOOOOXXXXXXXXXXXXGOOOOOOOOOOOXXXXXXXX,0,256,0
41643,168,0,168,58,114,0,0,273,188,85,GOOOOOOOOOOOXXXXXXXXGOOOOOOOOOOOOOOOOOXXGOOOOOOOOOOOXXXXXXXXGOOOOOOOOOOOOOOOOXXXGOOOOOOOXXXXXXXXXXXXGOOOOOOOOOOOOOOOOOOOGOOOOOOOOXXXXXXXXXXXGOOOOOOOOOOOOXXXXXXXGOOOOOOOOOOOOOOOOOOXGOOOOOOXXXXXXXXXXXXXGOOOOOOOOOOOOXXXXXXXGOOOOOOOXXXXXXXXXXXXGOOOOOOOOOOOXXXXXXXX,0,256,0
41664,168,0,168,62,110,0,0,270,188,82,GOOOOOOOOOOOXXXXXXXXGOOOOOOOOOOOOOOOOOXXGOOOOOOOOOOOXXXXXXXXGOOOOOOOOOOOOOOOOXXXGOOOOOOOXXXXXXXXXXXXGOOOOOOOOOOOOOOOOOOOGOOOOOOOOXXXXXXXXXXXGOOOOOOOOOOOOXXXXXXXGOOOOOOOOOOOOOOOOOOXGOOOOOOXXXXXXXXXXXXXGOOOOOOOOOOOOXXXXXXXGOOOOOOOXXXXXXXXXXXXGOOOOOOOOOOOXXXXXXXX,0,256,0

41685,168,0,168,59,113,0,0,273,188,85,GOOOOOOOOOOOXXXXXXXXGOOOOOOOOOOOOOOOOOXXGOOOOOOOOOOOXXXXXXXXGOOOOOOOOOOOOOOOOXXXGOOOOOOOXXXXXXXXXXXXGOOOOOOOOOOOOOOOOOOOGOOOOOOOOXXXXXXXXXXXGOOOOOOOOOOOOXXXXXXXGOOOOOOOOOOOOOOOOOOXGOOOOOOXXXXXXXXXXXXXGOOOOOOOOOOOOXXXXXXXGOOOOOOOXXXXXXXXXXXXGOOOOOOOOOOOXXXXXXXX,0,256,0
41706,168,0,168,55,117,0,0,277,188,89,GOOOOOOOOOOOXXXXXXXXGOOOOOOOOOOOOOOOOOXXGOOOOOOOOOOOXXXXXXXXGOOOOOOOOOOOOOOOOXXXGOOOOOOOXXXXXXXXXXXXGOOOOOOOOOOOOOOOOOOOGOOOOOOOOXXXXXXXXXXXGOOOOOOOOOOOOXXXXXXXGOOOOOOOOOOOOOOOOOOXGOOOOOOXXXXXXXXXXXXXGOOOOOOOOOOOOXXXXXXXGOOOOOOOXXXXXXXXXXXXGOOOOOOOOOOOXXXXXXXX,0,256,0
41727,168,0,168,54,118,0,0,278,189,89,GOOOOOOOOOOOXXXXXXXXGOOOOOOOOOOOOOOOOOXXGOOOOOOOOOOOXXXXXXXXGOOOOOOOOOOOOOOOOXXXGOOOOOOOXXXXXXXXXXXXGOOOOOOOOOOOOOOOOOOOGOOOOOOOOXXXXXXXXXXXGOOOOOOOOOOOOXXXXXXXGOOOOOOOOOOOOOOOOOOXGOOOOOOXXXXXXXXXXXXXGOOOOOOOOOOOOXXXXXXXGOOOOOOOXXXXXXXXXXXXGOOOOOOOOOOOXXXXXXXX,0,256,0
41748,168,0,168,51,121,0,0,281,191,90,GOOOOOOOOOOOXXXXXXXXGOOOOOOOOOOOOOOOOOXXGOOOOOOOOOOOXXXXXXXXGOOOOOOOOOOOOOOOOXXXGOOOOOOOXXXXXXXXXXXXGOOOOOOOOOOOOOOOOOOOGOOOOOOOOXXXXXXXXXXXGOOOOOOOOOOOOXXXXXXXGOOOOOOOOOOOOOOOOOOXGOOOOOOXXXXXXXXXXXXXGOOOOOOOOOOOOXXXXXXXGOOOOOOOXXXXXXXXXXXXGOOOOOOOOOOOXXXXXXXX,0,256,0
41769,168,0,168,50,122,0,0,282,192,90,GOOOOOOOOOOOXXXXXXXXGOOOOOOOOOOOOOOOOOXXGOOOOOOOOOOOXXXXXXXXGOOOOOOOOOOOOOOOOXXXGOOOOOOOXXXXXXXXXXXXGOOOOOOOOOOOOOOOOOOOGOOOOOOOOXXXXXXXXXXXGOOOOOOOOOOOOXXXXXXXGOOOOOOOOOOOOOOOOOOXGOOOOOOXXXXXXXXXXXXXGOOOOOOOOOOOOXXXXXXXGOOOOOOOXXXXXXXXXXXXGOOOOOOOOOOOXXXXXXXX,0,256,0

41790,168,0,168,50,122,0,0,282,190,92,GOOOOOOOOOOOXXXXXXXXGOOOOOOOOOOOOOOOOOXXGOOOOOOOOOOOXXXXXXXXGOOOOOOOOOOOOOOOOXXXGOOOOOOOXXXXXXXXXXXXGOOOOOOOOOOOOOOOOOOOGOOOOOOOOXXXXXXXXXXXGOOOOOOOOOOOOXXXXXXXGOOOOOOOOOOOOOOOOOOXGOOOOOOXXXXXXXXXXXXXGOOOOOOOOOOOOXXXXXXXGOOOOOOOXXXXXXXXXXXXGOOOOOOOOOOOXXXXXXXX,0,256,0
41811,168,0,168,53,119,0,0,279,188,91,GOOOOOOOOOOOXXXXXXXXGOOOOOOOOOOOOOOOOOXXGOOOOOOOOOOOXXXXXXXXGOOOOOOOOOOOOOOOOXXXGOOOOOOOXXXXXXXXXXXXGOOOOOOOOOOOOOOOOOOOGOOOOOOOOXXXXXXXXXXXGOOOOOOOOOOOOXXXXXXXGOOOOOOOOOOOOOOOOOOXGOOOOOOXXXXXXXXXXXXXGOOOOOOOOOOOOXXXXXXXGOOOOOOOXXXXXXXXXXXXGOOOOOOOOOOOXXXXXXXX,0,256,0
41832,168,0,168,52,120,0,0,280,193,87,GOOOOOOOOOOOXXXXXXXXGOOOOOOOOOOOOOOOOOXXGOOOOOOOOOOOXXXXXXXXGOOOOOOOOOOOOOOOOXXXGOOOOOOOXXXXXXXXXXXXGOOOOOOOOOOOOOOOOOOOGOOOOOOOOXXXXXXXXXXXGOOOOOOOOOOOOXXXXXXXGOOOOOOOOOOOOOOOOOOXGOOOOOOXXXXXXXXXXXXXGOOOOOOOOOOOOXXXXXXXGOOOOOOOXXXXXXXXXXXXGOOOOOOOOOOOXXXXXXXX,0,256,0
41853,168,0,168,55,117,0,0,277,191,86,GOOOOOOOOOOOXXXXXXXXGOOOOOOOOOOOOOOOOOXXGOOOOOOOOOOOXXXXXXXXGOOOOOOOOOOOOOOOOXXXGOOOOOOOXXXXXXXXXXXXGOOOOOOOOOOOOOOOOOOOGOOOOOOOOXXXXXXXXXXXGOOOOOOOOOOOOXXXXXXXGOOOOOOOOOOOOOOOOOOXGOOOOOOXXXXXXXXXXXXXGOOOOOOOOOOOOXXXXXXXGOOOOOOOXXXXXXXXXXXXGOOOOOOOOOOOXXXXXXXX,0,256,0
41874,168,0,168,58,114,0,0,274,185,89,GOOOOOOOOOOOXXXXXXXXGOOOOOOOOOOOOOOOOOXXGOOOOOOOOOOOXXXXXXXXGOOOOOOOOOOOOOOOOXXXGOOOOOOOXXXXXXXXXXXXGOOOOOOOOOOOOOOOOOOOGOOOOOOOOXXXXXXXXXXXGOOOOOOOOOOOOXXXXXXXGOOOOOOOOOOOOOOOOOOXGOOOOOOXXXXXXXXXXXXXGOOOOOOOOOOOOXXXXXXXGOOOOOOOXXXXXXXXXXXXGOOOOOOOOOOOXXXXXXXX,0,256,0

41895,168,0,168,56,116,0,0,276,190,86,GOOOOOOOOOOOXXXXXXXXGOOOOOOOOOOOOOOOOOXXGOOOOOOOOOOOXXXXXXXXGOOOOOOOOOOOOOOOOXXXGOOOOOOOXXXXXXXXXXXXGOOOOOOOOOOOOOOOOOOOGOOOOOOOOXXXXXXXXXXXGOOOOOOOOOOOOXXXXXXXGOOOOOOOOOOOOOOOOOOXGOOOOOOXXXXXXXXXXXXXGOOOOOOOOOOOOXXXXXXXGOOOOOOOXXXXXXXXXXXXGOOOOOOOOOOOXXXXXXXX,0,256,0
41916,168,0,168,54,118,0,0,278,191,87,GOOOOOOOOOOOXXXXXXXXGOOOOOOOOOOOOOOOOOXXGOOOOOOOOOOOXXXXXXXXGOOOOOOOOOOOOOOOOXXXGOOOOOOOXXXXXXXXXXXXGOOOOOOOOOOOOOOOOOOOGOOOOOOOOXXXXXXXXXXXGOOOOOOOOOOOOXXXXXXXGOOOOOOOOOOOOOOOOOOXGOOOOOOXXXXXXXXXXXXXGOOOOOOOOOOOOXXXXXXXGOOOOOOOXXXXXXXXXXXXGOOOOOOOOOOOXXXXXXXX,0,256,0
41937,168,0,168,53,119,0,0,279,192,87,GOOOOOOOOOOOXXXXXXXXGOOOOOOOOOOOOOOOOOXXGOOOOOOOOOOOXXXXXXXXGOOOOOOOOOOOOOOOOXXXGOOOOOOOXXXXXXXXXXXXGOOOOOOOOOOOOOOOOOOOGOOOOOOOOXXXXXXXXXXXGOOOOOOOOOOOOXXXXXXXGOOOOOOOOOOOOOOOOOOXGOOOOOOXXXXXXXXXXXXXGOOOOOOOOOOOOXXXXXXXGOOOOOOOXXXXXXXXXXXXGOOOOOOOOOOOXXXXXXXX,0,256,0
41958,169,1,168,57,114,0,0,274,192,82,GOOOOOOOOOOOXXXXXXXXGOOOOOOOOOOOOOOOOOXXGOOOOOOOOOOOXXXXXXXXGOOOOOOOOOOOOOOOOXXXGOOOOOOOAXXXXXXXXXXXGOOOOOOOOOOOOOOOOOOOGOOOOOOOOXXXXXXXXXXXGOOOOOOOOOOOOXXXXXXXGOOOOOOOOOOOOOOOOOOXGOOOOOOXXXXXXXXXXXXXGOOOOOOOOOOOOXXXXXXXGOOOOOOOXXXXXXXXXXXXGOOOOOOOOOOOXXXXXXXX,0,256,0
41979,169,1,168,52,119,0,0,279,195,84,GOOOOOOOOOOOXXXXXXXXGOOOOOOOOOOOOOOOOOXXGOOOOOOOOOOOXXXXXXXXGOOOOOOOOOOOOOOOOXXXGOOOOOOOAXXXXXXXXXXXGOOOOOOOOOOOOOOOOOOOGOOOOOOOOXXXXXXXXXXXGOOOOOOOOOOOOXXXXXXXGOOOOOOOOOOOOOOOOOOXGOOOOOOXXXXXXXXXXXXXGOOOOOOOOOOOOXXXXXXXGOOOOOOOXXXXXXXXXXXXGOOOOOOOOOOOXXXXXXXX,0,256,0

42000,169,1,168,51,120,0,0,280,194,86,GOOOOOOOOOOOXXXXXXXXGOOOOOOOOOOOOOOOOOXXGOOOOOOOOOOOXXXXXXXXGOOOOOOOOOOOOOOOOXXXGOOOOOOOAXXXXXXXXXXXGOOOOOOOOOOOOOOOOOOOGOOOOOOOOXXXXXXXXXXXGOOOOOOOOOOOOXXXXXXXGOOOOOOOOOOOOOOOOOOXGOOOOOOXXXXXXXXXXXXXGOOOOOOOOOOOOXXXXXXXGOOOOOOOXXXXXXXXXXXXGOOOOOOOOOOOXXXXXXXX,0,256,0
42021,169,1,168,52,119,0,0,279,191,88,GOOOOOOOOOOOXXXXXXXXGOOOOOOOOOOOOOOOOOXXGOOOOOOOOOOOXXXXXXXXGOOOOOOOOOOOOOOOOXXXGOOOOOOOAXXXXXXXXXXXGOOOOOOOOOOOOOOOOOOOGOOOOOOOOXXXXXXXXXXXGOOOOOOOOOOOOXXXXXXXGOOOOOOOOOOOOOOOOOOXGOOOOOOXXXXXXXXXXXXXGOOOOOOOOOOOOXXXXXXXGOOOOOOOXXXXXXXXXXXXGOOOOOOOOOOOXXXXXXXX,0,256,0
42042,169,1,168,51,120,0,0,279,193,86,GOOOOOOOOOOOXXXXXXXXGOOOOOOOOOOOOOOOOOXXGOOOOOOOOOOOXXXXXXXXGOOOOOOOOOOOOOOOOXXXGOOOOOOOAXXXXXXXXXXXGOOOOOOOOOOOOOOOOOOOGOOOOOOOOXXXXXXXXXXXGOOOOOOOOOOOOXXXXXXXGOOOOOOOOOOOOOOOOOOXGOOOOOOXXXXXXXXXXXXXGOOOOOOOOOOOOXXXXXXXGOOOOOOOXXXXXXXXXXXXGOOOOOOOOOOOXXXXXXXX,0,256,0
42063,170,2,168,50,120,0,0,280,198,82,GOOOOOOOOOOOXXXXXXXXGOOOOOOOOOOOOOOOOOXXGOOOOOOOOOOOXXXXXXXXGOOOOOOOOOOOOOOOOXXXGOOOOOOOAXXXXXXXXXXXGOOOOOOOOOOOOOOOOOOOGOOOOOOOOXXXXXXXXXXXGOOOOOOOOOOOOXXXXXXXGOOOOOOOOOOOOOOOOOOAGOOOOOOXXXXXXXXXXXXXGOOOOOOOOOOOOXXXXXXXGOOOOOOOXXXXXXXXXXXXGOOOOOOOOOOOXXXXXXXX,0,256,0
42084,170,2,168,47,123,0,0,283,199,84,GOOOOOOOOOOOXXXXXXXXGOOOOOOOOOOOOOOOOOXXGOOOOOOOOOOOXXXXXXXXGOOOOOOOOOOOOOOOOXXXGOOOOOOOAXXXXXXXXXXXGOOOOOOOOOOOOOOOOOOOGOOOOOOOOXXXXXXXXXXXGOOOOOOOOOOOOXXXXXXXGOOOOOOOOOOOOOOOOOOAGOOOOOOXXXXXXXXXXXXXGOOOOOOOOOOOOXXXXXXXGOOOOOOOXXXXXXXXXXXXGOOOOOOOOOOOXXXXXXXX,0,256,0

42105,170,2,168,53,117,0,0,277,197,80,GOOOOOOOOOOOXXXXXXXXGOOOOOOOOOOOOOOOOOXXGOOOOOOOOOOOXXXXXXXXGOOOOOOOOOOOOOOOOXXXGOOOOOOOAXXXXXXXXXXXGOOOOOOOOOOOOOOOOOOOGOOOOOOOOXXXXXXXXXXXGOOOOOOOOOOOOXXXXXXXGOOOOOOOOOOOOOOOOOOAGOOOOOOXXXXXXXXXXXXXGOOOOOOOOOOOOXXXXXXXGOOOOOOOXXXXXXXXXXXXGOOOOOOOOOOOXXXXXXXX,0,256,0
42126,170,1,169,57,113,0,0,273,194,79,GOOOOOOOOOOOXXXXXXXXGOOOOOOOOOOOOOOOOOXXGOOOOOOOOOOOXXXXXXXXGOOOOOOOOOOOOOOOOXXXGOOOOOOOOXXXXXXXXXXXGOOOOOOOOOOOOOOOOOOOGOOOOOOOOXXXXXXXXXXXGOOOOOOOOOOOOXXXXXXXGOOOOOOOOOOOOOOOOOOAGOOOOOOXXXXXXXXXXXXXGOOOOOOOOOOOOXXXXXXXGOOOOOOOXXXXXXXXXXXXGOOOOOOOOOOOXXXXXXXX,0,256,0
42147,170,1,169,55,115,0,0,275,192,83,GOOOOOOOOOOOXXXXXXXXGOOOOOOOOOOOOOOOOOXXGOOOOOOOOOOOXXXXXXXXGOOOOOOOOOOOOOOOOXXXGOOOOOOOOXXXXXXXXXXXGOOOOOOOOOOOOOOOOOOOGOOOOOOOOXXXXXXXXXXXGOOOOOOOOOOOOXXXXXXXGOOOOOOOOOOOOOOOOOOAGOOOOOOXXXXXXXXXXXXXGOOOOOOOOOOOOXXXXXXXGOOOOOOOXXXXXXXXXXXXGOOOOOOOOOOOXXXXXXXX,0,256,0
42168,170,1,169,56,114,0,0,273,193,80,GOOOOOOOOOOOXXXXXXXXGOOOOOOOOOOOOOOOOOXXGOOOOOOOOOOOXXXXXXXXGOOOOOOOOOOOOOOOOXXXGOOOOOOOOXXXXXXXXXXXGOOOOOOOOOOOOOOOOOOOGOOOOOOOOXXXXXXXXXXXGOOOOOOOOOOOOXXXXXXXGOOOOOOOOOOOOOOOOOOAGOOOOOOXXXXXXXXXXXXXGOOOOOOOOOOOOXXXXXXXGOOOOOOOXXXXXXXXXXXXGOOOOOOOOOOOXXXXXXXX,0,256,0
42189,170,1,169,62,108,0,0,268,189,79,GOOOOOOOOOOOXXXXXXXXGOOOOOOOOOOOOOOOOOXXGOOOOOOOOOOOXXXXXXXXGOOOOOOOOOOOOOOOOXXXGOOOOOOOOXXXXXXXXXXXGOOOOOOOOOOOOOOOOOOOGOOOOOOOOXXXXXXXXXXXGOOOOOOOOOOOOXXXXXXXGOOOOOOOOOOOOOOOOOOAGOOOOOOXXXXXXXXXXXXXGOOOOOOOOOOOOXXXXXXXGOOOOOOOXXXXXXXXXXXXGOOOOOOOOOOOXXXXXXXX,0,256,0

42210,170,1,169,60,110,0,0,271,192,79,GOOOOOOOOOOOXXXXXXXXGOOOOOOOOOOOOOOOOOXXGOOOOOOOOOOOXXXXXXXXGOOOOOOOOOOOOOOOOXXXGOOOOOOOOXXXXXXXXXXXGOOOOOOOOOOOOOOOOOOOGOOOOOOOOXXXXXXXXXXXGOOOOOOOOOOOOXXXXXXXGOOOOOOOOOOOOOOOOOOAGOOOOOOXXXXXXXXXXXXXGOOOOOOOOOOOOXXXXXXXGOOOOOOOXXXXXXXXXXXXGOOOOOOOOOOOXXXXXXXX,0,256,0
42231,170,1,169,57,113,0,0,273,189,84,GOOOOOOOOOOOXXXXXXXXGOOOOOOOOOOOOOOOOOXXGOOOOOOOOOOOXXXXXXXXGOOOOOOOOOOOOOOOOXXXGOOOOOOOOXXXXXXXXXXXGOOOOOOOOOOOOOOOOOOOGOOOOOOOOXXXXXXXXXXXGOOOOOOOOOOOOXXXXXXXGOOOOOOOOOOOOOOOOOOAGOOOOOOXXXXXXXXXXXXXGOOOOOOOOOOOOXXXXXXXGOOOOOOOXXXXXXXXXXXXGOOOOOOOOOOOXXXXXXXX,0,256,0
42252,170,1,169,53,117,0,0,278,190,88,GOOOOOOOOOOOXXXXXXXXGOOOOOOOOOOOOOOOOOXXGOOOOOOOOOOOXXXXXXXXGOOOOOOOOOOOOOOOOXXXGOOOOOOOOXXXXXXXXXXXGOOOOOOOOOOOOOOOOOOOGOOOOOOOOXXXXXXXXXXXGOOOOOOOOOOOOXXXXXXXGOOOOOOOOOOOOOOOOOOAGOOOOOOXXXXXXXXXXXXXGOOOOOOOOOOOOXXXXXXXGOOOOOOOXXXXXXXXXXXXGOOOOOOOOOOOXXXXXXXX,0,256,0
42273,170,1,169,55,115,0,0,276,188,88,GOOOOOOOOOOOXXXXXXXXGOOOOOOOOOOOOOOOOOXXGOOOOOOOOOOOXXXXXXXXGOOOOOOOOOOOOOOOOXXXGOOOOOOOOXXXXXXXXXXXGOOOOOOOOOOOOOOOOOOOGOOOOOOOOXXXXXXXXXXXGOOOOOOOOOOOOXXXXXXXGOOOOOOOOOOOOOOOOOOAGOOOOOOXXXXXXXXXXXXXGOOOOOOOOOOOOXXXXXXXGOOOOOOOXXXXXXXXXXXXGOOOOOOOOOOOXXXXXXXX,0,256,0
42294,170,1,169,59,111,0,0,272,190,82,GOOOOOOOOOOOXXXXXXXXGOOOOOOOOOOOOOOOOOXXGOOOOOOOOOOOXXXXXXXXGOOOOOOOOOOOOOOOOXXXGOOOOOOOOXXXXXXXXXXXGOOOOOOOOOOOOOOOOOOOGOOOOOOOOXXXXXXXXXXXGOOOOOOOOOOOOXXXXXXXGOOOOOOOOOOOOOOOOOOAGOOOOOOXXXXXXXXXXXXXGOOOOOOOOOOOOXXXXXXXGOOOOOOOXXXXXXXXXXXXGOOOOOOOOOOOXXXXXXXX,0,256,0

42315,170,1,169,57,113,0,0,273,188,85,GOOOOOOOOOOOXXXXXXXXGOOOOOOOOOOOOOOOOOXXGOOOOOOOOOOOXXXXXXXXGOOOOOOOOOOOOOOOOXXXGOOOOOOOOXXXXXXXXXXXGOOOOOOOOOOOOOOOOOOOGOOOOOOOOXXXXXXXXXXXGOOOOOOOOOOOOXXXXXXXGOOOOOOOOOOOOOOOOOOAGOOOOOOXXXXXXXXXXXXXGOOOOOOOOOOOOXXXXXXXGOOOOOOOXXXXXXXXXXXXGOOOOOOOOOOOXXXXXXXX,0,256,0
42336,170,1,169,58,112,0,0,273,187,86,GOOOOOOOOOOOXXXXXXXXGOOOOOOOOOOOOOOOOOXXGOOOOOOOOOOOXXXXXXXXGOOOOOOOOOOOOOOOOXXXGOOOOOOOOXXXXXXXXXXXGOOOOOOOOOOOOOOOOOOOGOOOOOOOOXXXXXXXXXXXGOOOOOOOOOOOOXXXXXXXGOOOOOOOOOOOOOOOOOOAGOOOOOOXXXXXXXXXXXXXGOOOOOOOOOOOOXXXXXXXGOOOOOOOXXXXXXXXXXXXGOOOOOOOOOOOXXXXXXXX,0,256,0
42357,170,0,170,57,113,0,0,273,191,82,GOOOOOOOOOOOXXXXXXXXGOOOOOOOOOOOOOOOOOXXGOOOOOOOOOOOXXXXXXXXGOOOOOOOOOOOOOOOOXXXGOOOOOOOOXXXXXXXXXXXGOOOOOOOOOOOOOOOOOOOGOOOOOOOOXXXXXXXXXXXGOOOOOOOOOOOOXXXXXXXGOOOOOOOOOOOOOOOOOOOGOOOOOOXXXXXXXXXXXXXGOOOOOOOOOOOOXXXXXXXGOOOOOOOXXXXXXXXXXXXGOOOOOOOOOOOXXXXXXXX,0,256,0
42378,170,0,170,56,114,0,0,274,193,81,GOOOOOOOOOOOXXXXXXXXGOOOOOOOOOOOOOOOOOXXGOOOOOOOOOOOXXXXXXXXGOOOOOOOOOOOOOOOOXXXGOOOOOOOOXXXXXXXXXXXGOOOOOOOOOOOOOOOOOOOGOOOOOOOOXXXXXXXXXXXGOOOOOOOOOOOOXXXXXXXGOOOOOOOOOOOOOOOOOOOGOOOOOOXXXXXXXXXXXXXGOOOOOOOOOOOOXXXXXXXGOOOOOOOXXXXXXXXXXXXGOOOOOOOOOOOXXXXXXXX,0,256,0
42399,170,0,170,52,118,0,0,278,195,83,GOOOOOOOOOOOXXXXXXXXGOOOOOOOOOOOOOOOOOXXGOOOOOOOOOOOXXXXXXXXGOOOOOOOOOOOOOOOOXXXGOOOOOOOOXXXXXXXXXXXGOOOOOOOOOOOOOOOOOOOGOOOOOOOOXXXXXXXXXXXGOOOOOOOOOOOOXXXXXXXGOOOOOOOOOOOOOOOOOOOGOOOOOOXXXXXXXXXXXXXGOOOOOOOOOOOOXXXXXXXGOOOOOOOXXXXXXXXXXXXGOOOOOOOOOOOXXXXXXXX,0,256,0

42420,170,0,170,48,122,0,0,282,196,86,GOOOOOOOOOOOXXXXXXXXGOOOOOOOOOOOOOOOOOXXGOOOOOOOOOOOXXXXXXXXGOOOOOOOOOOOOOOOOXXXGOOOOOOOOXXXXXXXXXXXGOOOOOOOOOOOOOOOOOOOGOOOOOOOOXXXXXXXXXXXGOOOOOOOOOOOOXXXXXXXGOOOOOOOOOOOOOOOOOOOGOOOOOOXXXXXXXXXXXXXGOOOOOOOOOOOOXXXXXXXGOOOOOOOXXXXXXXXXXXXGOOOOOOOOOOOXXXXXXXX,0,256,0
42441,170,0,170,48,122,0,0,282,199,83,GOOOOOOOOOOOXXXXXXXXGOOOOOOOOOOOOOOOOOXXGOOOOOOOOOOOXXXXXXXXGOOOOOOOOOOOOOOOOXXXGOOOOOOOOXXXXXXXXXXXGOOOOOOOOOOOOOOOOOOOGOOOOOOOOXXXXXXXXXXXGOOOOOOOOOOOOXXXXXXXGOOOOOOOOOOOOOOOOOOOGOOOOOOXXXXXXXXXXXXXGOOOOOOOOOOOOXXXXXXXGOOOOOOOXXXXXXXXXXXXGOOOOOOOOOOOXXXXXXXX,0,256,0
42462,171,1,170,47,122,0,0,282,199,83,GOOOOOOOOOOOXXXXXXXXGOOOOOOOOOOOOOOOOOXXGOOOOOOOOOOOXXXXXXXXGOOOOOOOOOOOOOOOOXXXGOOOOOOOOAXXXXXXXXXXGOOOOOOOOOOOOOOOOOOOGOOOOOOOOXXXXXXXXXXXGOOOOOOOOOOOOXXXXXXXGOOOOOOOOOOOOOOOOOOOGOOOOOOXXXXXXXXXXXXXGOOOOOOOOOOOOXXXXXXXGOOOOOOOXXXXXXXXXXXXGOOOOOOOOOOOXXXXXXXX,0,256,0
42483,171,1,170,49,120,0,0,279,198,81,GOOOOOOOOOOOXXXXXXXXGOOOOOOOOOOOOOOOOOXXGOOOOOOOOOOOXXXXXXXXGOOOOOOOOOOOOOOOOXXXGOOOOOOOOAXXXXXXXXXXGOOOOOOOOOOOOOOOOOOOGOOOOOOOOXXXXXXXXXXXGOOOOOOOOOOOOXXXXXXXGOOOOOOOOOOOOOOOOOOOGOOOOOOXXXXXXXXXXXXXGOOOOOOOOOOOOXXXXXXXGOOOOOOOXXXXXXXXXXXXGOOOOOOOOOOOXXXXXXXX,0,256,0
42504,171,1,170,53,116,0,0,276,193,83,GOOOOOOOOOOOXXXXXXXXGOOOOOOOOOOOOOOOOOXXGOOOOOOOOOOOXXXXXXXXGOOOOOOOOOOOOOOOOXXXGOOOOOOOOAXXXXXXXXXXGOOOOOOOOOOOOOOOOOOOGOOOOOOOOXXXXXXXXXXXGOOOOOOOOOOOOXXXXXXXGOOOOOOOOOOOOOOOOOOOGOOOOOOXXXXXXXXXXXXXGOOOOOOOOOOOOXXXXXXXGOOOOOOOXXXXXXXXXXXXGOOOOOOOOOOOXXXXXXXX,0,256,0

42525,171,1,170,53,116,0,0,276,194,82,GOOOOOOOOOOOXXXXXXXXGOOOOOOOOOOOOOOOOOXXGOOOOOOOOOOOXXXXXXXXGOOOOOOOOOOOOOOOOXXXGOOOOOOOOAXXXXXXXXXXGOOOOOOOOOOOOOOOOOOOGOOOOOOOOXXXXXXXXXXXGOOOOOOOOOOOOXXXXXXXGOOOOOOOOOOOOOOOOOOOGOOOOOOXXXXXXXXXXXXXGOOOOOOOOOOOOXXXXXXXGOOOOOOOXXXXXXXXXXXXGOOOOOOOOOOOXXXXXXXX,0,256,0
42546,171,1,170,51,118,0,0,278,192,86,GOOOOOOOOOOOXXXXXXXXGOOOOOOOOOOOOOOOOOXXGOOOOOOOOOOOXXXXXXXXGOOOOOOOOOOOOOOOOXXXGOOOOOOOOAXXXXXXXXXXGOOOOOOOOOOOOOOOOOOOGOOOOOOOOXXXXXXXXXXXGOOOOOOOOOOOOXXXXXXXGOOOOOOOOOOOOOOOOOOOGOOOOOOXXXXXXXXXXXXXGOOOOOOOOOOOOXXXXXXXGOOOOOOOXXXXXXXXXXXXGOOOOOOOOOOOXXXXXXXX,0,256,0
42567,172,2,170,51,117,0,0,277,190,87,GOOOOOOOOOOOXXXXXXXXGOOOOOOOOOOOOOOOOOXXGOOOOOOOOOOOXXXXXXXXGOOOOOOOOOOOOOOOOXXXGOOOOOOOOAXXXXXXXXXXGOOOOOOOOOOOOOOOOOOOGOOOOOOOOXXXXXXXXXXXGOOOOOOOOOOOOAXXXXXXGOOOOOOOOOOOOOOOOOOOGOOOOOOXXXXXXXXXXXXXGOOOOOOOOOOOOXXXXXXXGOOOOOOOXXXXXXXXXXXXGOOOOOOOOOOOXXXXXXXX,0,256,0
42588,172,2,170,47,121,0,0,281,192,89,GOOOOOOOOOOOXXXXXXXXGOOOOOOOOOOOOOOOOOXXGOOOOOOOOOOOXXXXXXXXGOOOOOOOOOOOOOOOOXXXGOOOOOOOOAXXXXXXXXXXGOOOOOOOOOOOOOOOOOOOGOOOOOOOOXXXXXXXXXXXGOOOOOOOOOOOOAXXXXXXGOOOOOOOOOOOOOOOOOOOGOOOOOOXXXXXXXXXXXXXGOOOOOOOOOOOOXXXXXXXGOOOOOOOXXXXXXXXXXXXGOOOOOOOOOOOXXXXXXXX,0,256,0
42609,172,2,170,46,122,0,0,282,191,91,GOOOOOOOOOOOXXXXXXXXGOOOOOOOOOOOOOOOOOXXGOOOOOOOOOOOXXXXXXXXGOOOOOOOOOOOOOOOOXXXGOOOOOOOOAXXXXXXXXXXGOOOOOOOOOOOOOOOOOOOGOOOOOOOOXXXXXXXXXXXGOOOOOOOOOOOOAXXXXXXGOOOOOOOOOOOOOOOOOOOGOOOOOOXXXXXXXXXXXXXGOOOOOOOOOOOOXXXXXXXGOOOOOOOXXXXXXXXXXXXGOOOOOOOOOOOXXXXXXXX,0,256,0

42630,172,2,170,45,123,0,0,283,193,90,GOOOOOOOOOOOXXXXXXXXGOOOOOOOOOOOOOOOOOXXGOOOOOOOOOOOXXXXXXXXGOOOOOOOOOOOOOOOOXXXGOOOOOOOOAXXXXXXXXXXGOOOOOOOOOOOOOOOOOOOGOOOOOOOOXXXXXXXXXXXGOOOOOOOOOOOOAXXXXXXGOOOOOOOOOOOOOOOOOOOGOOOOOOXXXXXXXXXXXXXGOOOOOOOOOOOOXXXXXXXGOOOOOOOXXXXXXXXXXXXGOOOOOOOOOOOXXXXXXXX,0,256,0
42651,172,2,170,45,123,0,0,283,192,91,GOOOOOOOOOOOXXXXXXXXGOOOOOOOOOOOOOOOOOXXGOOOOOOOOOOOXXXXXXXXGOOOOOOOOOOOOOOOOXXXGOOOOOOOOAXXXXXXXXXXGOOOOOOOOOOOOOOOOOOOGOOOOOOOOXXXXXXXXXXXGOOOOOOOOOOOOAXXXXXXGOOOOOOOOOOOOOOOOOOOGOOOOOOXXXXXXXXXXXXXGOOOOOOOOOOOOXXXXXXXGOOOOOOOXXXXXXXXXXXXGOOOOOOOOOOOXXXXXXXX,0,256,0
42672,172,2,170,47,121,0,0,281,195,86,GOOOOOOOOOOOXXXXXXXXGOOOOOOOOOOOOOOOOOXXGOOOOOOOOOOOXXXXXXXXGOOOOOOOOOOOOOOOOXXXGOOOOOOOOAXXXXXXXXXXGOOOOOOOOOOOOOOOOOOOGOOOOOOOOXXXXXXXXXXXGOOOOOOOOOOOOAXXXXXXGOOOOOOOOOOOOOOOOOOOGOOOOOOXXXXXXXXXXXXXGOOOOOOOOOOOOXXXXXXXGOOOOOOOXXXXXXXXXXXXGOOOOOOOOOOOXXXXXXXX,0,256,0
42693,172,2,170,53,115,0,0,275,191,84,GOOOOOOOOOOOXXXXXXXXGOOOOOOOOOOOOOOOOOXXGOOOOOOOOOOOXXXXXXXXGOOOOOOOOOOOOOOOOXXXGOOOOOOOOAXXXXXXXXXXGOOOOOOOOOOOOOOOOOOOGOOOOOOOOXXXXXXXXXXXGOOOOOOOOOOOOAXXXXXXGOOOOOOOOOOOOOOOOOOOGOOOOOOXXXXXXXXXXXXXGOOOOOOOOOOOOXXXXXXXGOOOOOOOXXXXXXXXXXXXGOOOOOOOOOOOXXXXXXXX,0,256,0
42714,172,2,170,54,114,0,0,273,192,81,GOOOOOOOOOOOXXXXXXXXGOOOOOOOOOOOOOOOOOXXGOOOOOOOOOOOXXXXXXXXGOOOOOOOOOOOOOOOOXXXGOOOOOOOOAXXXXXXXXXXGOOOOOOOOOOOOOOOOOOOGOOOOOOOOXXXXXXXXXXXGOOOOOOOOOOOOAXXXXXXGOOOOOOOOOOOOOOOOOOOGOOOOOOXXXXXXXXXXXXXGOOOOOOOOOOOOXXXXXXXGOOOOOOOXXXXXXXXXXXXGOOOOOOOOOOOXXXXXXXX,0,256,0

42735,172,1,171,57,111,0,0,271,191,80,GOOOOOOOOOOOXXXXXXXXGOOOOOOOOOOOOOOOOOXXGOOOOOOOOOOOXXXXXXXXGOOOOOOOOOOOOOOOOXXXGOOOOOOOOOXXXXXXXXXXGOOOOOOOOOOOOOOOOOOOGOOOOOOOOXXXXXXXXXXXGOOOOOOOOOOOOAXXXXXXGOOOOOOOOOOOOOOOOOOOGOOOOOOXXXXXXXXXXXXXGOOOOOOOOOOOOXXXXXXXGOOOOOOOXXXXXXXXXXXXGOOOOOOOOOOOXXXXXXXX,0,256,0
42756,172,1,171,55,113,0,0,273,191,82,GOOOOOOOOOOOXXXXXXXXGOOOOOOOOOOOOOOOOOXXGOOOOOOOOOOOXXXXXXXXGOOOOOOOOOOOOOOOOXXXGOOOOOOOOOXXXXXXXXXXGOOOOOOOOOOOOOOOOOOOGOOOOOOOOXXXXXXXXXXXGOOOOOOOOOOOOAXXXXXXGOOOOOOOOOOOOOOOOOOOGOOOOOOXXXXXXXXXXXXXGOOOOOOOOOOOOXXXXXXXGOOOOOOOXXXXXXXXXXXXGOOOOOOOOOOOXXXXXXXX,0,256,0
42777,172,0,172,54,114,0,0,273,194,79,GOOOOOOOOOOOXXXXXXXXGOOOOOOOOOOOOOOOOOXXGOOOOOOOOOOOXXXXXXXXGOOOOOOOOOOOOOOOOXXXGOOOOOOOOOXXXXXXXXXXGOOOOOOOOOOOOOOOOOOOGOOOOOOOOXXXXXXXXXXXGOOOOOOOOOOOOOXXXXXXGOOOOOOOOOOOOOOOOOOOGOOOOOOXXXXXXXXXXXXXGOOOOOOOOOOOOXXXXXXXGOOOOOOOXXXXXXXXXXXXGOOOOOOOOOOOXXXXXXXX,0,256,0
42798,172,0,172,55,113,0,0,272,193,79,GOOOOOOOOOOOXXXXXXXXGOOOOOOOOOOOOOOOOOXXGOOOOOOOOOOOXXXXXXXXGOOOOOOOOOOOOOOOOXXXGOOOOOOOOOXXXXXXXXXXGOOOOOOOOOOOOOOOOOOOGOOOOOOOOXXXXXXXXXXXGOOOOOOOOOOOOOXXXXXXGOOOOOOOOOOOOOOOOOOOGOOOOOOXXXXXXXXXXXXXGOOOOOOOOOOOOXXXXXXXGOOOOOOOXXXXXXXXXXXXGOOOOOOOOOOOXXXXXXXX,0,256,0
42819,172,0,172,53,115,0,0,275,195,80,GOOOOOOOOOOOXXXXXXXXGOOOOOOOOOOOOOOOOOXXGOOOOOOOOOOOXXXXXXXXGOOOOOOOOOOOOOOOOXXXGOOOOOOOOOXXXXXXXXXXGOOOOOOOOOOOOOOOOOOOGOOOOOOOOXXXXXXXXXXXGOOOOOOOOOOOOOXXXXXXGOOOOOOOOOOOOOOOOOOOGOOOOOOXXXXXXXXXXXXXGOOOOOOOOOOOOXXXXXXXGOOOOOOOXXXXXXXXXXXXGOOOOOOOOOOOXXXXXXXX,0,256,0

42840,172,0,172,52,116,0,0,276,194,82,GOOOOOOOOOOOXXXXXXXXGOOOOOOOOOOOOOOOOOXXGOOOOOOOOOOOXXXXXXXXGOOOOOOOOOOOOOOOOXXXGOOOOOOOOOXXXXXXXXXXGOOOOOOOOOOOOOOOOOOOGOOOOOOOOXXXXXXXXXXXGOOOOOOOOOOOOOXXXXXXGOOOOOOOOOOOOOOOOOOOGOOOOOOXXXXXXXXXXXXXGOOOOOOOOOOOOXXXXXXXGOOOOOOOXXXXXXXXXXXXGOOOOOOOOOOOXXXXXXXX,0,256,0
42861,172,0,172,50,118,0,0,277,193,84,GOOOOOOOOOOOXXXXXXXXGOOOOOOOOOOOOOOOOOXXGOOOOOOOOOOOXXXXXXXXGOOOOOOOOOOOOOOOOXXXGOOOOOOOOOXXXXXXXXXXGOOOOOOOOOOOOOOOOOOOGOOOOOOOOXXXXXXXXXXXGOOOOOOOOOOOOOXXXXXXGOOOOOOOOOOOOOOOOOOOGOOOOOOXXXXXXXXXXXXXGOOOOOOOOOOOOXXXXXXXGOOOOOOOXXXXXXXXXXXXGOOOOOOOOOOOXXXXXXXX,0,256,0
42882,172,0,172,55,113,0,0,273,192,81,GOOOOOOOOOOOXXXXXXXXGOOOOOOOOOOOOOOOOOXXGOOOOOOOOOOOXXXXXXXXGOOOOOOOOOOOOOOOOXXXGOOOOOOOOOXXXXXXXXXXGOOOOOOOOOOOOOOOOOOOGOOOOOOOOXXXXXXXXXXXGOOOOOOOOOOOOOXXXXXXGOOOOOOOOOOOOOOOOOOOGOOOOOOXXXXXXXXXXXXXGOOOOOOOOOOOOXXXXXXXGOOOOOOOXXXXXXXXXXXXGOOOOOOOOOOOXXXXXXXX,0,256,0
42903,172,0,172,51,117,0,0,277,193,84,GOOOOOOOOOOOXXXXXXXXGOOOOOOOOOOOOOOOOOXXGOOOOOOOOOOOXXXXXXXXGOOOOOOOOOOOOOOOOXXXGOOOOOOOOOXXXXXXXXXXGOOOOOOOOOOOOOOOOOOOGOOOOOOOOXXXXXXXXXXXGOOOOOOOOOOOOOXXXXXXGOOOOOOOOOOOOOOOOOOOGOOOOOOXXXXXXXXXXXXXGOOOOOOOOOOOOXXXXXXXGOOOOOOOXXXXXXXXXXXXGOOOOOOOOOOOXXXXXXXX,0,256,0
42924,172,0,172,51,117,0,0,277,194,83,GOOOOOOOOOOOXXXXXXXXGOOOOOOOOOOOOOOOOOXXGOOOOOOOOOOOXXXXXXXXGOOOOOOOOOOOOOOOOXXXGOOOOOOOOOXXXXXXXXXXGOOOOOOOOOOOOOOOOOOOGOOOOOOOOXXXXXXXXXXXGOOOOOOOOOOOOOXXXXXXGOOOOOOOOOOOOOOOOOOOGOOOOOOXXXXXXXXXXXXXGOOOOOOOOOOOOXXXXXXXGOOOOOOOXXXXXXXXXXXXGOOOOOOOOOOOXXXXXXXX,0,256,0

42945,172,0,172,50,118,0,0,279,195,84,GOOOOOOOOOOOXXXXXXXXGOOOOOOOOOOOOOOOOOXXGOOOOOOOOOOOXXXXXXXXGOOOOOOOOOOOOOOOOXXXGOOOOOOOOOXXXXXXXXXXGOOOOOOOOOOOOOOOOOOOGOOOOOOOOXXXXXXXXXXXGOOOOOOOOOOOOOXXXXXXGOOOOOOOOOOOOOOOOOOOGOOOOOOXXXXXXXXXXXXXGOOOOOOOOOOOOXXXXXXXGOOOOOOOXXXXXXXXXXXXGOOOOOOOOOOOXXXXXXXX,0,256,0
42966,172,0,172,51,117,0,0,278,195,83,GOOOOOOOOOOOXXXXXXXXGOOOOOOOOOOOOOOOOOXXGOOOOOOOOOOOXXXXXXXXGOOOOOOOOOOOOOOOOXXXGOOOOOOOOOXXXXXXXXXXGOOOOOOOOOOOOOOOOOOOGOOOOOOOOXXXXXXXXXXXGOOOOOOOOOOOOOXXXXXXGOOOOOOOOOOOOOOOOOOOGOOOOOOXXXXXXXXXXXXXGOOOOOOOOOOOOXXXXXXXGOOOOOOOXXXXXXXXXXXXGOOOOOOOOOOOXXXXXXXX,0,256,0
42987,172,0,172,50,118,0,0,279,200,79,GOOOOOOOOOOOXXXXXXXXGOOOOOOOOOOOOOOOOOXXGOOOOOOOOOOOXXXXXXXXGOOOOOOOOOOOOOOOOXXXGOOOOOOOOOXXXXXXXXXXGOOOOOOOOOOOOOOOOOOOGOOOOOOOOXXXXXXXXXXXGOOOOOOOOOOOOOXXXXXXGOOOOOOOOOOOOOOOOOOOGOOOOOOXXXXXXXXXXXXXGOOOOOOOOOOOOXXXXXXXGOOOOOOOXXXXXXXXXXXXGOOOOOOOOOOOXXXXXXXX,0,256,0
43008,172,0,172,49,119,0,0,280,198,82,GOOOOOOOOOOOXXXXXXXXGOOOOOOOOOOOOOOOOOXXGOOOOOOOOOOOXXXXXXXXGOOOOOOOOOOOOOOOOXXXGOOOOOOOOOXXXXXXXXXXGOOOOOOOOOOOOOOOOOOOGOOOOOOOOXXXXXXXXXXXGOOOOOOOOOOOOOXXXXXXGOOOOOOOOOOOOOOOOOOOGOOOOOOXXXXXXXXXXXXXGOOOOOOOOOOOOXXXXXXXGOOOOOOOXXXXXXXXXXXXGOOOOOOOOOOOXXXXXXXX,0,256,0
43029,172,0,172,53,115,0,0,276,194,82,GOOOOOOOOOOOXXXXXXXXGOOOOOOOOOOOOOOOOOXXGOOOOOOOOOOOXXXXXXXXGOOOOOOOOOOOOOOOOXXXGOOOOOOOOOXXXXXXXXXXGOOOOOOOOOOOOOOOOOOOGOOOOOOOOXXXXXXXXXXXGOOOOOOOOOOOOOXXXXXXGOOOOOOOOOOOOOOOOOOOGOOOOOOXXXXXXXXXXXXXGOOOOOOOOOOOOXXXXXXXGOOOOOOOXXXXXXXXXXXXGOOOOOOOOOOOXXXXXXXX,0,256,0

43050,172,0,172,53,115,0,0,276,195,81,GOOOOOOOOOOOXXXXXXXXGOOOOOOOOOOOOOOOOOXXGOOOOOOOOOOOXXXXXXXXGOOOOOOOOOOOOOOOOXXXGOOOOOOOOOXXXXXXXXXXGOOOOOOOOOOOOOOOOOOOGOOOOOOOOXXXXXXXXXXXGOOOOOOOOOOOOOXXXXXXGOOOOOOOOOOOOOOOOOOOGOOOOOOXXXXXXXXXXXXXGOOOOOOOOOOOOXXXXXXXGOOOOOOOXXXXXXXXXXXXGOOOOOOOOOOOXXXXXXXX,0,256,0
43071,172,0,172,53,115,0,0,276,197,79,GOOOOOOOOOOOXXXXXXXXGOOOOOOOOOOOOOOOOOXXGOOOOOOOOOOOXXXXXXXXGOOOOOOOOOOOOOOOOXXXGOOOOOOOOOXXXXXXXXXXGOOOOOOOOOOOOOOOOOOOGOOOOOOOOXXXXXXXXXXXGOOOOOOOOOOOOOXXXXXXGOOOOOOOOOOOOOOOOOOOGOOOOOOXXXXXXXXXXXXXGOOOOOOOOOOOOXXXXXXXGOOOOOOOXXXXXXXXXXXXGOOOOOOOOOOOXXXXXXXX,0,256,0
43092,172,0,172,49,119,0,0,280,196,84,GOOOOOOOOOOOXXXXXXXXGOOOOOOOOOOOOOOOOOXXGOOOOOOOOOOOXXXXXXXXGOOOOOOOOOOOOOOOOXXXGOOOOOOOOOXXXXXXXXXXGOOOOOOOOOOOOOOOOOOOGOOOOOOOOXXXXXXXXXXXGOOOOOOOOOOOOOXXXXXXGOOOOOOOOOOOOOOOOOOOGOOOOOOXXXXXXXXXXXXXGOOOOOOOOOOOOXXXXXXXGOOOOOOOXXXXXXXXXXXXGOOOOOOOOOOOXXXXXXXX,0,256,0
43113,172,0,172,49,119,0,0,280,200,80,GOOOOOOOOOOOXXXXXXXXGOOOOOOOOOOOOOOOOOXXGOOOOOOOOOOOXXXXXXXXGOOOOOOOOOOOOOOOOXXXGOOOOOOOOOXXXXXXXXXXGOOOOOOOOOOOOOOOOOOOGOOOOOOOOXXXXXXXXXXXGOOOOOOOOOOOOOXXXXXXGOOOOOOOOOOOOOOOOOOOGOOOOOOXXXXXXXXXXXXXGOOOOOOOOOOOOXXXXXXXGOOOOOOOXXXXXXXXXXXXGOOOOOOOOOOOXXXXXXXX,0,256,0
43134,172,0,172,52,116,0,0,278,190,88,GOOOOOOOOOOOXXXXXXXXGOOOOOOOOOOOOOOOOOXXGOOOOOOOOOOOXXXXXXXXGOOOOOOOOOOOOOOOOXXXGOOOOOOOOOXXXXXXXXXXGOOOOOOOOOOOOOOOOOOOGOOOOOOOOXXXXXXXXXXXGOOOOOOOOOOOOOXXXXXXGOOOOOOOOOOOOOOOOOOOGOOOOOOXXXXXXXXXXXXXGOOOOOOOOOOOOXXXXXXXGOOOOOOOXXXXXXXXXXXXGOOOOOOOOOOOXXXXXXXX,0,256,0

43155,172,0,172,52,116,0,0,278,194,84,GOOOOOOOOOOOXXXXXXXXGOOOOOOOOOOOOOOOOOXXGOOOOOOOOOOOXXXXXXXXGOOOOOOOOOOOOOOOOXXXGOOOOOOOOOXXXXXXXXXXGOOOOOOOOOOOOOOOOOOOGOOOOOOOOXXXXXXXXXXXGOOOOOOOOOOOOOXXXXXXGOOOOOOOOOOOOOOOOOOOGOOOOOOXXXXXXXXXXXXXGOOOOOOOOOOOOXXXXXXXGOOOOOOOXXXXXXXXXXXXGOOOOOOOOOOOXXXXXXXX,0,256,0
43176,172,0,172,48,120,0,0,282,197,85,GOOOOOOOOOOOXXXXXXXXGOOOOOOOOOOOOOOOOOXXGOOOOOOOOOOOXXXXXXXXGOOOOOOOOOOOOOOOOXXXGOOOOOOOOOXXXXXXXXXXGOOOOOOOOOOOOOOOOOOOGOOOOOOOOXXXXXXXXXXXGOOOOOOOOOOOOOXXXXXXGOOOOOOOOOOOOOOOOOOOGOOOOOOXXXXXXXXXXXXXGOOOOOOOOOOOOXXXXXXXGOOOOOOOXXXXXXXXXXXXGOOOOOOOOOOOXXXXXXXX,0,256,0
43197,172,0,172,50,118,0,0,279,199,80,GOOOOOOOOOOOXXXXXXXXGOOOOOOOOOOOOOOOOOXXGOOOOOOOOOOOXXXXXXXXGOOOOOOOOOOOOOOOOXXXGOOOOOOOOOXXXXXXXXXXGOOOOOOOOOOOOOOOOOOOGOOOOOOOOXXXXXXXXXXXGOOOOOOOOOOOOOXXXXXXGOOOOOOOOOOOOOOOOOOOGOOOOOOXXXXXXXXXXXXXGOOOOOOOOOOOOXXXXXXXGOOOOOOOXXXXXXXXXXXXGOOOOOOOOOOOXXXXXXXX,0,256,0
43218,172,0,172,56,112,0,0,273,196,77,GOOOOOOOOOOOXXXXXXXXGOOOOOOOOOOOOOOOOOXXGOOOOOOOOOOOXXXXXXXXGOOOOOOOOOOOOOOOOXXXGOOOOOOOOOXXXXXXXXXXGOOOOOOOOOOOOOOOOOOOGOOOOOOOOXXXXXXXXXXXGOOOOOOOOOOOOOXXXXXXGOOOOOOOOOOOOOOOOOOOGOOOOOOXXXXXXXXXXXXXGOOOOOOOOOOOOXXXXXXXGOOOOOOOXXXXXXXXXXXXGOOOOOOOOOOOXXXXXXXX,0,256,0
43239,172,0,172,56,112,0,0,274,191,83,GOOOOOOOOOOOXXXXXXXXGOOOOOOOOOOOOOOOOOXXGOOOOOOOOOOOXXXXXXXXGOOOOOOOOOOOOOOOOXXXGOOOOOOOOOXXXXXXXXXXGOOOOOOOOOOOOOOOOOOOGOOOOOOOOXXXXXXXXXXXGOOOOOOOOOOOOOXXXXXXGOOOOOOOOOOOOOOOOOOOGOOOOOOXXXXXXXXXXXXXGOOOOOOOOOOOOXXXXXXXGOOOOOOOXXXXXXXXXXXXGOOOOOOOOOOOXXXXXXXX,0,256,0

43260,172,0,172,52,116,0,0,277,191,86,GOOOOOOOOOOOXXXXXXXXGOOOOOOOOOOOOOOOOOXXGOOOOOOOOOOOXXXXXXXXGOOOOOOOOOOOOOOOOXXXGOOOOOOOOOXXXXXXXXXXGOOOOOOOOOOOOOOOOOOOGOOOOOOOOXXXXXXXXXXXGOOOOOOOOOOOOOXXXXXXGOOOOOOOOOOOOOOOOOOOGOOOOOOXXXXXXXXXXXXXGOOOOOOOOOOOOXXXXXXXGOOOOOOOXXXXXXXXXXXXGOOOOOOOOOOOXXXXXXXX,0,256,0
43281,172,0,172,49,119,0,0,280,195,85,GOOOOOOOOOOOXXXXXXXXGOOOOOOOOOOOOOOOOOXXGOOOOOOOOOOOXXXXXXXXGOOOOOOOOOOOOOOOOXXXGOOOOOOOOOXXXXXXXXXXGOOOOOOOOOOOOOOOOOOOGOOOOOOOOXXXXXXXXXXXGOOOOOOOOOOOOOXXXXXXGOOOOOOOOOOOOOOOOOOOGOOOOOOXXXXXXXXXXXXXGOOOOOOOOOOOOXXXXXXXGOOOOOOOXXXXXXXXXXXXGOOOOOOOOOOOXXXXXXXX,0,256,0
43302,172,0,172,50,118,0,0,278,193,85,GOOOOOOOOOOOXXXXXXXXGOOOOOOOOOOOOOOOOOXXGOOOOOOOOOOOXXXXXXXXGOOOOOOOOOOOOOOOOXXXGOOOOOOOOOXXXXXXXXXXGOOOOOOOOOOOOOOOOOOOGOOOOOOOOXXXXXXXXXXXGOOOOOOOOOOOOOXXXXXXGOOOOOOOOOOOOOOOOOOOGOOOOOOXXXXXXXXXXXXXGOOOOOOOOOOOOXXXXXXXGOOOOOOOXXXXXXXXXXXXGOOOOOOOOOOOXXXXXXXX,0,256,0
43323,172,0,172,55,113,0,0,273,192,81,GOOOOOOOOOOOXXXXXXXXGOOOOOOOOOOOOOOOOOXXGOOOOOOOOOOOXXXXXXXXGOOOOOOOOOOOOOOOOXXXGOOOOOOOOOXXXXXXXXXXGOOOOOOOOOOOOOOOOOOOGOOOOOOOOXXXXXXXXXXXGOOOOOOOOOOOOOXXXXXXGOOOOOOOOOOOOOOOOOOOGOOOOOOXXXXXXXXXXXXXGOOOOOOOOOOOOXXXXXXXGOOOOOOOXXXXXXXXXXXXGOOOOOOOOOOOXXXXXXXX,0,256,0
43344,172,0,172,53,115,0,0,275,190,85,GOOOOOOOOOOOXXXXXXXXGOOOOOOOOOOOOOOOOOXXGOOOOOOOOOOOXXXXXXXXGOOOOOOOOOOOOOOOOXXXGOOOOOOOOOXXXXXXXXXXGOOOOOOOOOOOOOOOOOOOGOOOOOOOOXXXXXXXXXXXGOOOOOOOOOOOOOXXXXXXGOOOOOOOOOOOOOOOOOOOGOOOOOOXXXXXXXXXXXXXGOOOOOOOOOOOOXXXXXXXGOOOOOOOXXXXXXXXXXXXGOOOOOOOOOOOXXXXXXXX,0,256,0

43365,172,0,172,53,115,0,0,275,188,87,GOOOOOOOOOOOXXXXXXXXGOOOOOOOOOOOOOOOOOXXGOOOOOOOOOOOXXXXXXXXGOOOOOOOOOOOOOOOOXXXGOOOOOOOOOXXXXXXXXXXGOOOOOOOOOOOOOOOOOOOGOOOOOOOOXXXXXXXXXXXGOOOOOOOOOOOOOXXXXXXGOOOOOOOOOOOOOOOOOOOGOOOOOOXXXXXXXXXXXXXGOOOOOOOOOOOOXXXXXXXGOOOOOOOXXXXXXXXXXXXGOOOOOOOOOOOXXXXXXXX,0,256,0
43386,172,0,172,56,112,0,0,271,187,84,GOOOOOOOOOOOXXXXXXXXGOOOOOOOOOOOOOOOOOXXGOOOOOOOOOOOXXXXXXXXGOOOOOOOOOOOOOOOOXXXGOOOOOOOOOXXXXXXXXXXGOOOOOOOOOOOOOOOOOOOGOOOOOOOOXXXXXXXXXXXGOOOOOOOOOOOOOXXXXXXGOOOOOOOOOOOOOOOOOOOGOOOOOOXXXXXXXXXXXXXGOOOOOOOOOOOOXXXXXXXGOOOOOOOXXXXXXXXXXXXGOOOOOOOOOOOXXXXXXXX,0,256,0
43407,172,0,172,56,112,0,0,271,188,83,GOOOOOOOOOOOXXXXXXXXGOOOOOOOOOOOOOOOOOXXGOOOOOOOOOOOXXXXXXXXGOOOOOOOOOOOOOOOOXXXGOOOOOOOOOXXXXXXXXXXGOOOOOOOOOOOOOOOOOOOGOOOOOOOOXXXXXXXXXXXGOOOOOOOOOOOOOXXXXXXGOOOOOOOOOOOOOOOOOOOGOOOOOOXXXXXXXXXXXXXGOOOOOOOOOOOOXXXXXXXGOOOOOOOXXXXXXXXXXXXGOOOOOOOOOOOXXXXXXXX,0,256,0
43428,172,0,172,55,113,0,0,273,191,82,GOOOOOOOOOOOXXXXXXXXGOOOOOOOOOOOOOOOOOXXGOOOOOOOOOOOXXXXXXXXGOOOOOOOOOOOOOOOOXXXGOOOOOOOOOXXXXXXXXXXGOOOOOOOOOOOOOOOOOOOGOOOOOOOOXXXXXXXXXXXGOOOOOOOOOOOOOXXXXXXGOOOOOOOOOOOOOOOOOOOGOOOOOOXXXXXXXXXXXXXGOOOOOOOOOOOOXXXXXXXGOOOOOOOXXXXXXXXXXXXGOOOOOOOOOOOXXXXXXXX,0,256,0
43449,172,0,172,51,117,0,0,277,193,84,GOOOOOOOOOOOXXXXXXXXGOOOOOOOOOOOOOOOOOXXGOOOOOOOOOOOXXXXXXXXGOOOOOOOOOOOOOOOOXXXGOOOOOOOOOXXXXXXXXXXGOOOOOOOOOOOOOOOOOOOGOOOOOOOOXXXXXXXXXXXGOOOOOOOOOOOOOXXXXXXGOOOOOOOOOOOOOOOOOOOGOOOOOOXXXXXXXXXXXXXGOOOOOOOOOOOOXXXXXXXGOOOOOOOXXXXXXXXXXXXGOOOOOOOOOOOXXXXXXXX,0,256,0

43470,172,0,172,50,118,0,0,278,193,85,GOOOOOOOOOOOXXXXXXXXGOOOOOOOOOOOOOOOOOXXGOOOOOOOOOOOXXXXXXXXGOOOOOOOOOOOOOOOOXXXGOOOOOOOOOXXXXXXXXXXGOOOOOOOOOOOOOOOOOOOGOOOOOOOOXXXXXXXXXXXGOOOOOOOOOOOOOXXXXXXGOOOOOOOOOOOOOOOOOOOGOOOOOOXXXXXXXXXXXXXGOOOOOOOOOOOOXXXXXXXGOOOOOOOXXXXXXXXXXXXGOOOOOOOOOOOXXXXXXXX,0,256,0
43491,172,0,172,48,120,0,0,279,193,86,GOOOOOOOOOOOXXXXXXXXGOOOOOOOOOOOOOOOOOXXGOOOOOOOOOOOXXXXXXXXGOOOOOOOOOOOOOOOOXXXGOOOOOOOOOXXXXXXXXXXGOOOOOOOOOOOOOOOOOOOGOOOOOOOOXXXXXXXXXXXGOOOOOOOOOOOOOXXXXXXGOOOOOOOOOOOOOOOOOOOGOOOOOOXXXXXXXXXXXXXGOOOOOOOOOOOOXXXXXXXGOOOOOOOXXXXXXXXXXXXGOOOOOOOOOOOXXXXXXXX,0,256,0
43512,172,0,172,51,117,0,0,277,194,83,GOOOOOOOOOOOXXXXXXXXGOOOOOOOOOOOOOOOOOXXGOOOOOOOOOOOXXXXXXXXGOOOOOOOOOOOOOOOOXXXGOOOOOOOOOXXXXXXXXXXGOOOOOOOOOOOOOOOOOOOGOOOOOOOOXXXXXXXXXXXGOOOOOOOOOOOOOXXXXXXGOOOOOOOOOOOOOOOOOOOGOOOOOOXXXXXXXXXXXXXGOOOOOOOOOOOOXXXXXXXGOOOOOOOXXXXXXXXXXXXGOOOOOOOOOOOXXXXXXXX,0,256,0
43533,172,0,172,48,120,0,0,280,196,84,GOOOOOOOOOOOXXXXXXXXGOOOOOOOOOOOOOOOOOXXGOOOOOOOOOOOXXXXXXXXGOOOOOOOOOOOOOOOOXXXGOOOOOOOOOXXXXXXXXXXGOOOOOOOOOOOOOOOOOOOGOOOOOOOOXXXXXXXXXXXGOOOOOOOOOOOOOXXXXXXGOOOOOOOOOOOOOOOOOOOGOOOOOOXXXXXXXXXXXXXGOOOOOOOOOOOOXXXXXXXGOOOOOOOXXXXXXXXXXXXGOOOOOOOOOOOXXXXXXXX,0,256,0
43554,172,0,172,53,115,0,0,275,196,79,GOOOOOOOOOOOXXXXXXXXGOOOOOOOOOOOOOOOOOXXGOOOOOOOOOOOXXXXXXXXGOOOOOOOOOOOOOOOOXXXGOOOOOOOOOXXXXXXXXXXGOOOOOOOOOOOOOOOOOOOGOOOOOOOOXXXXXXXXXXXGOOOOOOOOOOOOOXXXXXXGOOOOOOOOOOOOOOOOOOOGOOOOOOXXXXXXXXXXXXXGOOOOOOOOOOOOXXXXXXXGOOOOOOOXXXXXXXXXXXXGOOOOOOOOOOOXXXXXXXX,0,256,0

43575,172,0,172,56,112,0,0,272,193,79,GOOOOOOOOOOOXXXXXXXXGOOOOOOOOOOOOOOOOOXXGOOOOOOOOOOOXXXXXXXXGOOOOOOOOOOOOOOOOXXXGOOOOOOOOOXXXXXXXXXXGOOOOOOOOOOOOOOOOOOOGOOOOOOOOXXXXXXXXXXXGOOOOOOOOOOOOOXXXXXXGOOOOOOOOOOOOOOOOOOOGOOOOOOXXXXXXXXXXXXXGOOOOOOOOOOOOXXXXXXXGOOOOOOOXXXXXXXXXXXXGOOOOOOOOOOOXXXXXXXX,0,256,0
43596,172,0,172,54,114,0,0,272,192,80,GOOOOOOOOOOOXXXXXXXXGOOOOOOOOOOOOOOOOOXXGOOOOOOOOOOOXXXXXXXXGOOOOOOOOOOOOOOOOXXXGOOOOOOOOOXXXXXXXXXXGOOOOOOOOOOOOOOOOOOOGOOOOOOOOXXXXXXXXXXXGOOOOOOOOOOOOOXXXXXXGOOOOOOOOOOOOOOOOOOOGOOOOOOXXXXXXXXXXXXXGOOOOOOOOOOOOXXXXXXXGOOOOOOOXXXXXXXXXXXXGOOOOOOOOOOOXXXXXXXX,0,256,0
43617,172,0,172,54,114,0,0,273,191,82,GOOOOOOOOOOOXXXXXXXXGOOOOOOOOOOOOOOOOOXXGOOOOOOOOOOOXXXXXXXXGOOOOOOOOOOOOOOOOXXXGOOOOOOOOOXXXXXXXXXXGOOOOOOOOOOOOOOOOOOOGOOOOOOOOXXXXXXXXXXXGOOOOOOOOOOOOOXXXXXXGOOOOOOOOOOOOOOOOOOOGOOOOOOXXXXXXXXXXXXXGOOOOOOOOOOOOXXXXXXXGOOOOOOOXXXXXXXXXXXXGOOOOOOOOOOOXXXXXXXX,0,256,0
43638,172,0,172,53,115,0,0,275,190,85,GOOOOOOOOOOOXXXXXXXXGOOOOOOOOOOOOOOOOOXXGOOOOOOOOOOOXXXXXXXXGOOOOOOOOOOOOOOOOXXXGOOOOOOOOOXXXXXXXXXXGOOOOOOOOOOOOOOOOOOOGOOOOOOOOXXXXXXXXXXXGOOOOOOOOOOOOOXXXXXXGOOOOOOOOOOOOOOOOOOOGOOOOOOXXXXXXXXXXXXXGOOOOOOOOOOOOXXXXXXXGOOOOOOOXXXXXXXXXXXXGOOOOOOOOOOOXXXXXXXX,0,256,0
43659,172,0,172,53,115,0,0,275,193,82,GOOOOOOOOOOOXXXXXXXXGOOOOOOOOOOOOOOOOOXXGOOOOOOOOOOOXXXXXXXXGOOOOOOOOOOOOOOOOXXXGOOOOOOOOOXXXXXXXXXXGOOOOOOOOOOOOOOOOOOOGOOOOOOOOXXXXXXXXXXXGOOOOOOOOOOOOOXXXXXXGOOOOOOOOOOOOOOOOOOOGOOOOOOXXXXXXXXXXXXXGOOOOOOOOOOOOXXXXXXXGOOOOOOOXXXXXXXXXXXXGOOOOOOOOOOOXXXXXXXX,0,256,0

43680,172,0,172,55,113,0,0,273,192,81,GOOOOOOOOOOOXXXXXXXXGOOOOOOOOOOOOOOOOOXXGOOOOOOOOOOOXXXXXXXXGOOOOOOOOOOOOOOOOXXXGOOOOOOOOOXXXXXXXXXXGOOOOOOOOOOOOOOOOOOOGOOOOOOOOXXXXXXXXXXXGOOOOOOOOOOOOOXXXXXXGOOOOOOOOOOOOOOOOOOOGOOOOOOXXXXXXXXXXXXXGOOOOOOOOOOOOXXXXXXXGOOOOOOOXXXXXXXXXXXXGOOOOOOOOOOOXXXXXXXX,0,256,0
43701,172,0,172,51,117,0,0,277,195,82,GOOOOOOOOOOOXXXXXXXXGOOOOOOOOOOOOOOOOOXXGOOOOOOOOOOOXXXXXXXXGOOOOOOOOOOOOOOOOXXXGOOOOOOOOOXXXXXXXXXXGOOOOOOOOOOOOOOOOOOOGOOOOOOOOXXXXXXXXXXXGOOOOOOOOOOOOOXXXXXXGOOOOOOOOOOOOOOOOOOOGOOOOOOXXXXXXXXXXXXXGOOOOOOOOOOOOXXXXXXXGOOOOOOOXXXXXXXXXXXXGOOOOOOOOOOOXXXXXXXX,0,256,0
43722,172,0,172,50,118,0,0,277,197,80,GOOOOOOOOOOOXXXXXXXXGOOOOOOOOOOOOOOOOOXXGOOOOOOOOOOOXXXXXXXXGOOOOOOOOOOOOOOOOXXXGOOOOOOOOOXXXXXXXXXXGOOOOOOOOOOOOOOOOOOOGOOOOOOOOXXXXXXXXXXXGOOOOOOOOOOOOOXXXXXXGOOOOOOOOOOOOOOOOOOOGOOOOOOXXXXXXXXXXXXXGOOOOOOOOOOOOXXXXXXXGOOOOOOOXXXXXXXXXXXXGOOOOOOOOOOOXXXXXXXX,0,256,0
43743,172,0,172,55,113,0,0,272,192,80,GOOOOOOOOOOOXXXXXXXXGOOOOOOOOOOOOOOOOOXXGOOOOOOOOOOOXXXXXXXXGOOOOOOOOOOOOOOOOXXXGOOOOOOOOOXXXXXXXXXXGOOOOOOOOOOOOOOOOOOOGOOOOOOOOXXXXXXXXXXXGOOOOOOOOOOOOOXXXXXXGOOOOOOOOOOOOOOOOOOOGOOOOOOXXXXXXXXXXXXXGOOOOOOOOOOOOXXXXXXXGOOOOOOOXXXXXXXXXXXXGOOOOOOOOOOOXXXXXXXX,0,256,0
43764,172,0,172,46,122,0,0,281,191,90,GOOOOOOOOOOOXXXXXXXXGOOOOOOOOOOOOOOOOOXXGOOOOOOOOOOOXXXXXXXXGOOOOOOOOOOOOOOOOXXXGOOOOOOOOOXXXXXXXXXXGOOOOOOOOOOOOOOOOOOOGOOOOOOOOXXXXXXXXXXXGOOOOOOOOOOOOOXXXXXXGOOOOOOOOOOOOOOOOOOOGOOOOOOXXXXXXXXXXXXXGOOOOOOOOOOOOXXXXXXXGOOOOOOOXXXXXXXXXXXXGOOOOOOOOOOOXXXXXXXX,0,256,0

43785,172,0,172,48,120,0,0,280,193,87,GOOOOOOOOOOOXXXXXXXXGOOOOOOOOOOOOOOOOOXXGOOOOOOOOOOOXXXXXXXXGOOOOOOOOOOOOOOOOXXXGOOOOOOOOOXXXXXXXXXXGOOOOOOOOOOOOOOOOOOOGOOOOOOOOXXXXXXXXXXXGOOOOOOOOOOOOOXXXXXXGOOOOOOOOOOOOOOOOOOOGOOOOOOXXXXXXXXXXXXXGOOOOOOOOOOOOXXXXXXXGOOOOOOOXXXXXXXXXXXXGOOOOOOOOOOOXXXXXXXX,0,256,0
43806,172,0,172,45,123,0,0,283,196,87,GOOOOOOOOOOOXXXXXXXXGOOOOOOOOOOOOOOOOOXXGOOOOOOOOOOOXXXXXXXXGOOOOOOOOOOOOOOOOXXXGOOOOOOOOOXXXXXXXXXXGOOOOOOOOOOOOOOOOOOOGOOOOOOOOXXXXXXXXXXXGOOOOOOOOOOOOOXXXXXXGOOOOOOOOOOOOOOOOOOOGOOOOOOXXXXXXXXXXXXXGOOOOOOOOOOOOXXXXXXXGOOOOOOOXXXXXXXXXXXXGOOOOOOOOOOOXXXXXXXX,0,256,0
43827,172,0,172,41,127,0,0,287,198,89,GOOOOOOOOOOOXXXXXXXXGOOOOOOOOOOOOOOOOOXXGOOOOOOOOOOOXXXXXXXXGOOOOOOOOOOOOOOOOXXXGOOOOOOOOOXXXXXXXXXXGOOOOOOOOOOOOOOOOOOOGOOOOOOOOXXXXXXXXXXXGOOOOOOOOOOOOOXXXXXXGOOOOOOOOOOOOOOOOOOOGOOOOOOXXXXXXXXXXXXXGOOOOOOOOOOOOXXXXXXXGOOOOOOOXXXXXXXXXXXXGOOOOOOOOOOOXXXXXXXX,0,256,0
43848,172,0,172,44,124,0,0,284,198,86,GOOOOOOOOOOOXXXXXXXXGOOOOOOOOOOOOOOOOOXXGOOOOOOOOOOOXXXXXXXXGOOOOOOOOOOOOOOOOXXXGOOOOOOOOOXXXXXXXXXXGOOOOOOOOOOOOOOOOOOOGOOOOOOOOXXXXXXXXXXXGOOOOOOOOOOOOOXXXXXXGOOOOOOOOOOOOOOOOOOOGOOOOOOXXXXXXXXXXXXXGOOOOOOOOOOOOXXXXXXXGOOOOOOOXXXXXXXXXXXXGOOOOOOOOOOOXXXXXXXX,0,256,0
43869,172,0,172,46,122,0,0,282,197,85,GOOOOOOOOOOOXXXXXXXXGOOOOOOOOOOOOOOOOOXXGOOOOOOOOOOOXXXXXXXXGOOOOOOOOOOOOOOOOXXXGOOOOOOOOOXXXXXXXXXXGOOOOOOOOOOOOOOOOOOOGOOOOOOOOXXXXXXXXXXXGOOOOOOOOOOOOOXXXXXXGOOOOOOOOOOOOOOOOOOOGOOOOOOXXXXXXXXXXXXXGOOOOOOOOOOOOXXXXXXXGOOOOOOOXXXXXXXXXXXXGOOOOOOOOOOOXXXXXXXX,0,256,0

43890,172,0,172,46,122,0,0,281,194,87,GOOOOOOOOOOOXXXXXXXXGOOOOOOOOOOOOOOOOOXXGOOOOOOOOOOOXXXXXXXXGOOOOOOOOOOOOOOOOXXXGOOOOOOOOOXXXXXXXXXXGOOOOOOOOOOOOOOOOOOOGOOOOOOOOXXXXXXXXXXXGOOOOOOOOOOOOOXXXXXXGOOOOOOOOOOOOOOOOOOOGOOOOOOXXXXXXXXXXXXXGOOOOOOOOOOOOXXXXXXXGOOOOOOOXXXXXXXXXXXXGOOOOOOOOOOOXXXXXXXX,0,256,0
43911,172,0,172,44,124,0,0,284,194,90,GOOOOOOOOOOOXXXXXXXXGOOOOOOOOOOOOOOOOOXXGOOOOOOOOOOOXXXXXXXXGOOOOOOOOOOOOOOOOXXXGOOOOOOOOOXXXXXXXXXXGOOOOOOOOOOOOOOOOOOOGOOOOOOOOXXXXXXXXXXXGOOOOOOOOOOOOOXXXXXXGOOOOOOOOOOOOOOOOOOOGOOOOOOXXXXXXXXXXXXXGOOOOOOOOOOOOXXXXXXXGOOOOOOOXXXXXXXXXXXXGOOOOOOOOOOOXXXXXXXX,0,256,0
43932,172,0,172,47,121,0,0,281,193,88,GOOOOOOOOOOOXXXXXXXXGOOOOOOOOOOOOOOOOOXXGOOOOOOOOOOOXXXXXXXXGOOOOOOOOOOOOOOOOXXXGOOOOOOOOOXXXXXXXXXXGOOOOOOOOOOOOOOOOOOOGOOOOOOOOXXXXXXXXXXXGOOOOOOOOOOOOOXXXXXXGOOOOOOOOOOOOOOOOOOOGOOOOOOXXXXXXXXXXXXXGOOOOOOOOOOOOXXXXXXXGOOOOOOOXXXXXXXXXXXXGOOOOOOOOOOOXXXXXXXX,0,256,0
43953,172,0,172,48,120,0,0,281,194,87,GOOOOOOOOOOOXXXXXXXXGOOOOOOOOOOOOOOOOOXXGOOOOOOOOOOOXXXXXXXXGOOOOOOOOOOOOOOOOXXXGOOOOOOOOOXXXXXXXXXXGOOOOOOOOOOOOOOOOOOOGOOOOOOOOXXXXXXXXXXXGOOOOOOOOOOOOOXXXXXXGOOOOOOOOOOOOOOOOOOOGOOOOOOXXXXXXXXXXXXXGOOOOOOOOOOOOXXXXXXXGOOOOOOOXXXXXXXXXXXXGOOOOOOOOOOOXXXXXXXX,0,256,0
43974,172,0,172,55,113,0,0,274,187,87,GOOOOOOOOOOOXXXXXXXXGOOOOOOOOOOOOOOOOOXXGOOOOOOOOOOOXXXXXXXXGOOOOOOOOOOOOOOOOXXXGOOOOOOOOOXXXXXXXXXXGOOOOOOOOOOOOOOOOOOOGOOOOOOOOXXXXXXXXXXXGOOOOOOOOOOOOOXXXXXXGOOOOOOOOOOOOOOOOOOOGOOOOOOXXXXXXXXXXXXXGOOOOOOOOOOOOXXXXXXXGOOOOOOOXXXXXXXXXXXXGOOOOOOOOOOOXXXXXXXX,0,256,0

43995,172,0,172,50,118,0,0,278,192,86,GOOOOOOOOOOOXXXXXXXXGOOOOOOOOOOOOOOOOOXXGOOOOOOOOOOOXXXXXXXXGOOOOOOOOOOOOOOOOXXXGOOOOOOOOOXXXXXXXXXXGOOOOOOOOOOOOOOOOOOOGOOOOOOOOXXXXXXXXXXXGOOOOOOOOOOOOOXXXXXXGOOOOOOOOOOOOOOOOOOOGOOOOOOXXXXXXXXXXXXXGOOOOOOOOOOOOXXXXXXXGOOOOOOOXXXXXXXXXXXXGOOOOOOOOOOOXXXXXXXX,0,256,0
44016,172,0,172,51,117,0,0,277,199,78,GOOOOOOOOOOOXXXXXXXXGOOOOOOOOOOOOOOOOOXXGOOOOOOOOOOOXXXXXXXXGOOOOOOOOOOOOOOOOXXXGOOOOOOOOOXXXXXXXXXXGOOOOOOOOOOOOOOOOOOOGOOOOOOOOXXXXXXXXXXXGOOOOOOOOOOOOOXXXXXXGOOOOOOOOOOOOOOOOOOOGOOOOOOXXXXXXXXXXXXXGOOOOOOOOOOOOXXXXXXXGOOOOOOOXXXXXXXXXXXXGOOOOOOOOOOOXXXXXXXX,0,256,0
44037,172,0,172,54,114,0,0,274,196,78,GOOOOOOOOOOOXXXXXXXXGOOOOOOOOOOOOOOOOOXXGOOOOOOOOOOOXXXXXXXXGOOOOOOOOOOOOOOOOXXXGOOOOOOOOOXXXXXXXXXXGOOOOOOOOOOOOOOOOOOOGOOOOOOOOXXXXXXXXXXXGOOOOOOOOOOOOOXXXXXXGOOOOOOOOOOOOOOOOOOOGOOOOOOXXXXXXXXXXXXXGOOOOOOOOOOOOXXXXXXXGOOOOOOOXXXXXXXXXXXXGOOOOOOOOOOOXXXXXXXX,0,256,0
44058,172,0,172,58,110,0,0,270,194,76,GOOOOOOOOOOOXXXXXXXXGOOOOOOOOOOOOOOOOOXXGOOOOOOOOOOOXXXXXXXXGOOOOOOOOOOOOOOOOXXXGOOOOOOOOOXXXXXXXXXXGOOOOOOOOOOOOOOOOOOOGOOOOOOOOXXXXXXXXXXXGOOOOOOOOOOOOOXXXXXXGOOOOOOOOOOOOOOOOOOOGOOOOOOXXXXXXXXXXXXXGOOOOOOOOOOOOXXXXXXXGOOOOOOOXXXXXXXXXXXXGOOOOOOOOOOOXXXXXXXX,0,256,0
44079,172,0,172,56,112,0,0,272,193,79,GOOOOOOOOOOOXXXXXXXXGOOOOOOOOOOOOOOOOOXXGOOOOOOOOOOOXXXXXXXXGOOOOOOOOOOOOOOOOXXXGOOOOOOOOOXXXXXXXXXXGOOOOOOOOOOOOOOOOOOOGOOOOOOOOXXXXXXXXXXXGOOOOOOOOOOOOOXXXXXXGOOOOOOOOOOOOOOOOOOOGOOOOOOXXXXXXXXXXXXXGOOOOOOOOOOOOXXXXXXXGOOOOOOOXXXXXXXXXXXXGOOOOOOOOOOOXXXXXXXX,0,256,0

44100,172,0,172,55,113,0,0,273,195,78,GOOOOOOOOOOOXXXXXXXXGOOOOOOOOOOOOOOOOOXXGOOOOOOOOOOOXXXXXXXXGOOOOOOOOOOOOOOOOXXXGOOOOOOOOOXXXXXXXXXXGOOOOOOOOOOOOOOOOOOOGOOOOOOOOXXXXXXXXXXXGOOOOOOOOOOOOOXXXXXXGOOOOOOOOOOOOOOOOOOOGOOOOOOXXXXXXXXXXXXXGOOOOOOOOOOOOXXXXXXXGOOOOOOOXXXXXXXXXXXXGOOOOOOOOOOOXXXXXXXX,0,256,0
44121,172,0,172,57,111,0,0,270,195,75,GOOOOOOOOOOOXXXXXXXXGOOOOOOOOOOOOOOOOOXXGOOOOOOOOOOOXXXXXXXXGOOOOOOOOOOOOOOOOXXXGOOOOOOOOOXXXXXXXXXXGOOOOOOOOOOOOOOOOOOOGOOOOOOOOXXXXXXXXXXXGOOOOOOOOOOOOOXXXXXXGOOOOOOOOOOOOOOOOOOOGOOOOOOXXXXXXXXXXXXXGOOOOOOOOOOOOXXXXXXXGOOOOOOOXXXXXXXXXXXXGOOOOOOOOOOOXXXXXXXX,0,256,0
44142,172,0,172,53,115,0,0,274,196,78,GOOOOOOOOOOOXXXXXXXXGOOOOOOOOOOOOOOOOOXXGOOOOOOOOOOOXXXXXXXXGOOOOOOOOOOOOOOOOXXXGOOOOOOOOOXXXXXXXXXXGOOOOOOOOOOOOOOOOOOOGOOOOOOOOXXXXXXXXXXXGOOOOOOOOOOOOOXXXXXXGOOOOOOOOOOOOOOOOOOOGOOOOOOXXXXXXXXXXXXXGOOOOOOOOOOOOXXXXXXXGOOOOOOOXXXXXXXXXXXXGOOOOOOOOOOOXXXXXXXX,0,256,0
44163,172,0,172,50,118,0,0,278,195,83,GOOOOOOOOOOOXXXXXXXXGOOOOOOOOOOOOOOOOOXXGOOOOOOOOOOOXXXXXXXXGOOOOOOOOOOOOOOOOXXXGOOOOOOOOOXXXXXXXXXXGOOOOOOOOOOOOOOOOOOOGOOOOOOOOXXXXXXXXXXXGOOOOOOOOOOOOOXXXXXXGOOOOOOOOOOOOOOOOOOOGOOOOOOXXXXXXXXXXXXXGOOOOOOOOOOOOXXXXXXXGOOOOOOOXXXXXXXXXXXXGOOOOOOOOOOOXXXXXXXX,0,256,0
44184,172,0,172,46,122,0,0,282,197,85,GOOOOOOOOOOOXXXXXXXXGOOOOOOOOOOOOOOOOOXXGOOOOOOOOOOOXXXXXXXXGOOOOOOOOOOOOOOOOXXXGOOOOOOOOOXXXXXXXXXXGOOOOOOOOOOOOOOOOOOOGOOOOOOOOXXXXXXXXXXXGOOOOOOOOOOOOOXXXXXXGOOOOOOOOOOOOOOOOOOOGOOOOOOXXXXXXXXXXXXXGOOOOOOOOOOOOXXXXXXXGOOOOOOOXXXXXXXXXXXXGOOOOOOOOOOOXXXXXXXX,0,256,0

44205,172,0,172,48,120,0,0,280,200,80,GOOOOOOOOOOOXXXXXXXXGOOOOOOOOOOOOOOOOOXXGOOOOOOOOOOOXXXXXXXXGOOOOOOOOOOOOOOOOXXXGOOOOOOOOOXXXXXXXXXXGOOOOOOOOOOOOOOOOOOOGOOOOOOOOXXXXXXXXXXXGOOOOOOOOOOOOOXXXXXXGOOOOOOOOOOOOOOOOOOOGOOOOOOXXXXXXXXXXXXXGOOOOOOOOOOOOXXXXXXXGOOOOOOOXXXXXXXXXXXXGOOOOOOOOOOOXXXXXXXX,0,256,0
44226,172,0,172,51,117,0,0,277,197,80,GOOOOOOOOOOOXXXXXXXXGOOOOOOOOOOOOOOOOOXXGOOOOOOOOOOOXXXXXXXXGOOOOOOOOOOOOOOOOXXXGOOOOOOOOOXXXXXXXXXXGOOOOOOOOOOOOOOOOOOOGOOOOOOOOXXXXXXXXXXXGOOOOOOOOOOOOOXXXXXXGOOOOOOOOOOOOOOOOOOOGOOOOOOXXXXXXXXXXXXXGOOOOOOOOOOOOXXXXXXXGOOOOOOOXXXXXXXXXXXXGOOOOOOOOOOOXXXXXXXX,0,256,0
44247,172,0,172,50,118,0,0,278,197,81,GOOOOOOOOOOOXXXXXXXXGOOOOOOOOOOOOOOOOOXXGOOOOOOOOOOOXXXXXXXXGOOOOOOOOOOOOOOOOXXXGOOOOOOOOOXXXXXXXXXXGOOOOOOOOOOOOOOOOOOOGOOOOOOOOXXXXXXXXXXXGOOOOOOOOOOOOOXXXXXXGOOOOOOOOOOOOOOOOOOOGOOOOOOXXXXXXXXXXXXXGOOOOOOOOOOOOXXXXXXXGOOOOOOOXXXXXXXXXXXXGOOOOOOOOOOOXXXXXXXX,0,256,0
44268,172,0,172,44,124,0,0,282,201,81,GOOOOOOOOOOOXXXXXXXXGOOOOOOOOOOOOOOOOOXXGOOOOOOOOOOOXXXXXXXXGOOOOOOOOOOOOOOOOXXXGOOOOOOOOOXXXXXXXXXXGOOOOOOOOOOOOOOOOOOOGOOOOOOOOXXXXXXXXXXXGOOOOOOOOOOOOOXXXXXXGOOOOOOOOOOOOOOOOOOOGOOOOOOXXXXXXXXXXXXXGOOOOOOOOOOOOXXXXXXXGOOOOOOOXXXXXXXXXXXXGOOOOOOOOOOOXXXXXXXX,0,256,0
44289,172,0,172,45,123,0,0,283,201,82,GOOOOOOOOOOOXXXXXXXXGOOOOOOOOOOOOOOOOOXXGOOOOOOOOOOOXXXXXXXXGOOOOOOOOOOOOOOOOXXXGOOOOOOOOOXXXXXXXXXXGOOOOOOOOOOOOOOOOOOOGOOOOOOOOXXXXXXXXXXXGOOOOOOOOOOOOOXXXXXXGOOOOOOOOOOOOOOOOOOOGOOOOOOXXXXXXXXXXXXXGOOOOOOOOOOOOXXXXXXXGOOOOOOOXXXXXXXXXXXXGOOOOOOOOOOOXXXXXXXX,0,256,0

44310,172,0,172,49,119,0,0,279,197,82,GOOOOOOOOOOOXXXXXXXXGOOOOOOOOOOOOOOOOOXXGOOOOOOOOOOOXXXXXXXXGOOOOOOOOOOOOOOOOXXXGOOOOOOOOOXXXXXXXXXXGOOOOOOOOOOOOOOOOOOOGOOOOOOOOXXXXXXXXXXXGOOOOOOOOOOOOOXXXXXXGOOOOOOOOOOOOOOOOOOOGOOOOOOXXXXXXXXXXXXXGOOOOOOOOOOOOXXXXXXXGOOOOOOOXXXXXXXXXXXXGOOOOOOOOOOOXXXXXXXX,0,256,0
44331,172,0,172,53,115,0,0,275,192,83,GOOOOOOOOOOOXXXXXXXXGOOOOOOOOOOOOOOOOOXXGOOOOOOOOOOOXXXXXXXXGOOOOOOOOOOOOOOOOXXXGOOOOOOOOOXXXXXXXXXXGOOOOOOOOOOOOOOOOOOOGOOOOOOOOXXXXXXXXXXXGOOOOOOOOOOOOOXXXXXXGOOOOOOOOOOOOOOOOOOOGOOOOOOXXXXXXXXXXXXXGOOOOOOOOOOOOXXXXXXXGOOOOOOOXXXXXXXXXXXXGOOOOOOOOOOOXXXXXXXX,0,256,0
44352,172,0,172,51,117,0,0,277,194,83,GOOOOOOOOOOOXXXXXXXXGOOOOOOOOOOOOOOOOOXXGOOOOOOOOOOOXXXXXXXXGOOOOOOOOOOOOOOOOXXXGOOOOOOOOOXXXXXXXXXXGOOOOOOOOOOOOOOOOOOOGOOOOOOOOXXXXXXXXXXXGOOOOOOOOOOOOOXXXXXXGOOOOOOOOOOOOOOOOOOOGOOOOOOXXXXXXXXXXXXXGOOOOOOOOOOOOXXXXXXXGOOOOOOOXXXXXXXXXXXXGOOOOOOOOOOOXXXXXXXX,0,256,0
44373,172,0,172,51,117,0,0,275,196,79,GOOOOOOOOOOOXXXXXXXXGOOOOOOOOOOOOOOOOOXXGOOOOOOOOOOOXXXXXXXXGOOOOOOOOOOOOOOOOXXXGOOOOOOOOOXXXXXXXXXXGOOOOOOOOOOOOOOOOOOOGOOOOOOOOXXXXXXXXXXXGOOOOOOOOOOOOOXXXXXXGOOOOOOOOOOOOOOOOOOOGOOOOOOXXXXXXXXXXXXXGOOOOOOOOOOOOXXXXXXXGOOOOOOOXXXXXXXXXXXXGOOOOOOOOOOOXXXXXXXX,0,256,0
44394,172,0,172,51,117,0,0,277,199,78,GOOOOOOOOOOOXXXXXXXXGOOOOOOOOOOOOOOOOOXXGOOOOOOOOOOOXXXXXXXXGOOOOOOOOOOOOOOOOXXXGOOOOOOOOOXXXXXXXXXXGOOOOOOOOOOOOOOOOOOOGOOOOOOOOXXXXXXXXXXXGOOOOOOOOOOOOOXXXXXXGOOOOOOOOOOOOOOOOOOOGOOOOOOXXXXXXXXXXXXXGOOOOOOOOOOOOXXXXXXXGOOOOOOOXXXXXXXXXXXXGOOOOOOOOOOOXXXXXXXX,0,256,0

44415,172,0,172,53,115,0,0,275,197,78,GOOOOOOOOOOOXXXXXXXXGOOOOOOOOOOOOOOOOOXXGOOOOOOOOOOOXXXXXXXXGOOOOOOOOOOOOOOOOXXXGOOOOOOOOOXXXXXXXXXXGOOOOOOOOOOOOOOOOOOOGOOOOOOOOXXXXXXXXXXXGOOOOOOOOOOOOOXXXXXXGOOOOOOOOOOOOOOOOOOOGOOOOOOXXXXXXXXXXXXXGOOOOOOOOOOOOXXXXXXXGOOOOOOOXXXXXXXXXXXXGOOOOOOOOOOOXXXXXXXX,0,256,0
44436,172,0,172,51,117,0,0,277,198,79,GOOOOOOOOOOOXXXXXXXXGOOOOOOOOOOOOOOOOOXXGOOOOOOOOOOOXXXXXXXXGOOOOOOOOOOOOOOOOXXXGOOOOOOOOOXXXXXXXXXXGOOOOOOOOOOOOOOOOOOOGOOOOOOOOXXXXXXXXXXXGOOOOOOOOOOOOOXXXXXXGOOOOOOOOOOOOOOOOOOOGOOOOOOXXXXXXXXXXXXXGOOOOOOOOOOOOXXXXXXXGOOOOOOOXXXXXXXXXXXXGOOOOOOOOOOOXXXXXXXX,0,256,0
44457,172,0,172,52,116,0,0,276,199,77,GOOOOOOOOOOOXXXXXXXXGOOOOOOOOOOOOOOOOOXXGOOOOOOOOOOOXXXXXXXXGOOOOOOOOOOOOOOOOXXXGOOOOOOOOOXXXXXXXXXXGOOOOOOOOOOOOOOOOOOOGOOOOOOOOXXXXXXXXXXXGOOOOOOOOOOOOOXXXXXXGOOOOOOOOOOOOOOOOOOOGOOOOOOXXXXXXXXXXXXXGOOOOOOOOOOOOXXXXXXXGOOOOOOOXXXXXXXXXXXXGOOOOOOOOOOOXXXXXXXX,0,256,0
44478,172,0,172,48,120,0,0,279,199,80,GOOOOOOOOOOOXXXXXXXXGOOOOOOOOOOOOOOOOOXXGOOOOOOOOOOOXXXXXXXXGOOOOOOOOOOOOOOOOXXXGOOOOOOOOOXXXXXXXXXXGOOOOOOOOOOOOOOOOOOOGOOOOOOOOXXXXXXXXXXXGOOOOOOOOOOOOOXXXXXXGOOOOOOOOOOOOOOOOOOOGOOOOOOXXXXXXXXXXXXXGOOOOOOOOOOOOXXXXXXXGOOOOOOOXXXXXXXXXXXXGOOOOOOOOOOOXXXXXXXX,0,256,0
44499,172,0,172,47,121,0,0,281,200,81,GOOOOOOOOOOOXXXXXXXXGOOOOOOOOOOOOOOOOOXXGOOOOOOOOOOOXXXXXXXXGOOOOOOOOOOOOOOOOXXXGOOOOOOOOOXXXXXXXXXXGOOOOOOOOOOOOOOOOOOOGOOOOOOOOXXXXXXXXXXXGOOOOOOOOOOOOOXXXXXXGOOOOOOOOOOOOOOOOOOOGOOOOOOXXXXXXXXXXXXXGOOOOOOOOOOOOXXXXXXXGOOOOOOOXXXXXXXXXXXXGOOOOOOOOOOOXXXXXXXX,0,256,0

44520,172,0,172,44,124,0,0,283,206,77,GOOOOOOOOOOOXXXXXXXXGOOOOOOOOOOOOOOOOOXXGOOOOOOOOOOOXXXXXXXXGOOOOOOOOOOOOOOOOXXXGOOOOOOOOOXXXXXXXXXXGOOOOOOOOOOOOOOOOOOOGOOOOOOOOXXXXXXXXXXXGOOOOOOOOOOOOOXXXXXXGOOOOOOOOOOOOOOOOOOOGOOOOOOXXXXXXXXXXXXXGOOOOOOOOOOOOXXXXXXXGOOOOOOOXXXXXXXXXXXXGOOOOOOOOOOOXXXXXXXX,0,256,0
44541,172,0,172,41,127,0,0,288,206,82,GOOOOOOOOOOOXXXXXXXXGOOOOOOOOOOOOOOOOOXXGOOOOOOOOOOOXXXXXXXXGOOOOOOOOOOOOOOOOXXXGOOOOOOOOOXXXXXXXXXXGOOOOOOOOOOOOOOOOOOOGOOOOOOOOXXXXXXXXXXXGOOOOOOOOOOOOOXXXXXXGOOOOOOOOOOOOOOOOOOOGOOOOOOXXXXXXXXXXXXXGOOOOOOOOOOOOXXXXXXXGOOOOOOOXXXXXXXXXXXXGOOOOOOOOOOOXXXXXXXX,0,256,0
44562,172,0,172,43,125,0,0,286,201,85,GOOOOOOOOOOOXXXXXXXXGOOOOOOOOOOOOOOOOOXXGOOOOOOOOOOOXXXXXXXXGOOOOOOOOOOOOOOOOXXXGOOOOOOOOOXXXXXXXXXXGOOOOOOOOOOOOOOOOOOOGOOOOOOOOXXXXXXXXXXXGOOOOOOOOOOOOOXXXXXXGOOOOOOOOOOOOOOOOOOOGOOOOOOXXXXXXXXXXXXXGOOOOOOOOOOOOXXXXXXXGOOOOOOOXXXXXXXXXXXXGOOOOOOOOOOOXXXXXXXX,0,256,0
44583,172,0,172,44,124,0,0,285,203,82,GOOOOOOOOOOOXXXXXXXXGOOOOOOOOOOOOOOOOOXXGOOOOOOOOOOOXXXXXXXXGOOOOOOOOOOOOOOOOXXXGOOOOOOOOOXXXXXXXXXXGOOOOOOOOOOOOOOOOOOOGOOOOOOOOXXXXXXXXXXXGOOOOOOOOOOOOOXXXXXXGOOOOOOOOOOOOOOOOOOOGOOOOOOXXXXXXXXXXXXXGOOOOOOOOOOOOXXXXXXXGOOOOOOOXXXXXXXXXXXXGOOOOOOOOOOOXXXXXXXX,0,256,0
44604,172,0,172,49,119,0,0,280,203,77,GOOOOOOOOOOOXXXXXXXXGOOOOOOOOOOOOOOOOOXXGOOOOOOOOOOOXXXXXXXXGOOOOOOOOOOOOOOOOXXXGOOOOOOOOOXXXXXXXXXXGOOOOOOOOOOOOOOOOOOOGOOOOOOOOXXXXXXXXXXXGOOOOOOOOOOOOOXXXXXXGOOOOOOOOOOOOOOOOOOOGOOOOOOXXXXXXXXXXXXXGOOOOOOOOOOOOXXXXXXXGOOOOOOOXXXXXXXXXXXXGOOOOOOOOOOOXXXXXXXX,0,256,0

44625,172,0,172,50,118,0,0,279,205,74,GOOOOOOOOOOOXXXXXXXXGOOOOOOOOOOOOOOOOOXXGOOOOOOOOOOOXXXXXXXXGOOOOOOOOOOOOOOOOXXXGOOOOOOOOOXXXXXXXXXXGOOOOOOOOOOOOOOOOOOOGOOOOOOOOXXXXXXXXXXXGOOOOOOOOOOOOOXXXXXXGOOOOOOOOOOOOOOOOOOOGOOOOOOXXXXXXXXXXXXXGOOOOOOOOOOOOXXXXXXXGOOOOOOOXXXXXXXXXXXXGOOOOOOOOOOOXXXXXXXX,0,256,0
44646,172,0,172,49,119,0,0,280,199,81,GOOOOOOOOOOOXXXXXXXXGOOOOOOOOOOOOOOOOOXXGOOOOOOOOOOOXXXXXXXXGOOOOOOOOOOOOOOOOXXXGOOOOOOOOOXXXXXXXXXXGOOOOOOOOOOOOOOOOOOOGOOOOOOOOXXXXXXXXXXXGOOOOOOOOOOOOOXXXXXXGOOOOOOOOOOOOOOOOOOOGOOOOOOXXXXXXXXXXXXXGOOOOOOOOOOOOXXXXXXXGOOOOOOOXXXXXXXXXXXXGOOOOOOOOOOOXXXXXXXX,0,256,0
44667,172,0,172,49,119,0,0,280,199,81,GOOOOOOOOOOOXXXXXXXXGOOOOOOOOOOOOOOOOOXXGOOOOOOOOOOOXXXXXXXXGOOOOOOOOOOOOOOOOXXXGOOOOOOOOOXXXXXXXXXXGOOOOOOOOOOOOOOOOOOOGOOOOOOOOXXXXXXXXXXXGOOOOOOOOOOOOOXXXXXXGOOOOOOOOOOOOOOOOOOOGOOOOOOXXXXXXXXXXXXXGOOOOOOOOOOOOXXXXXXXGOOOOOOOXXXXXXXXXXXXGOOOOOOOOOOOXXXXXXXX,0,256,0
44688,172,0,172,45,123,0,0,284,198,86,GOOOOOOOOOOOXXXXXXXXGOOOOOOOOOOOOOOOOOXXGOOOOOOOOOOOXXXXXXXXGOOOOOOOOOOOOOOOOXXXGOOOOOOOOOXXXXXXXXXXGOOOOOOOOOOOOOOOOOOOGOOOOOOOOXXXXXXXXXXXGOOOOOOOOOOOOOXXXXXXGOOOOOOOOOOOOOOOOOOOGOOOOOOXXXXXXXXXXXXXGOOOOOOOOOOOOXXXXXXXGOOOOOOOXXXXXXXXXXXXGOOOOOOOOOOOXXXXXXXX,0,256,0
44709,172,0,172,41,127,0,0,287,202,85,GOOOOOOOOOOOXXXXXXXXGOOOOOOOOOOOOOOOOOXXGOOOOOOOOOOOXXXXXXXXGOOOOOOOOOOOOOOOOXXXGOOOOOOOOOXXXXXXXXXXGOOOOOOOOOOOOOOOOOOOGOOOOOOOOXXXXXXXXXXXGOOOOOOOOOOOOOXXXXXXGOOOOOOOOOOOOOOOOOOOGOOOOOOXXXXXXXXXXXXXGOOOOOOOOOOOOXXXXXXXGOOOOOOOXXXXXXXXXXXXGOOOOOOOOOOOXXXXXXXX,0,256,0

44730,172,0,172,45,123,0,0,284,200,84,GOOOOOOOOOOOXXXXXXXXGOOOOOOOOOOOOOOOOOXXGOOOOOOOOOOOXXXXXXXXGOOOOOOOOOOOOOOOOXXXGOOOOOOOOOXXXXXXXXXXGOOOOOOOOOOOOOOOOOOOGOOOOOOOOXXXXXXXXXXXGOOOOOOOOOOOOOXXXXXXGOOOOOOOOOOOOOOOOOOOGOOOOOOXXXXXXXXXXXXXGOOOOOOOOOOOOXXXXXXXGOOOOOOOXXXXXXXXXXXXGOOOOOOOOOOOXXXXXXXX,0,256,0
44751,172,0,172,48,120,0,0,281,201,80,GOOOOOOOOOOOXXXXXXXXGOOOOOOOOOOOOOOOOOXXGOOOOOOOOOOOXXXXXXXXGOOOOOOOOOOOOOOOOXXXGOOOOOOOOOXXXXXXXXXXGOOOOOOOOOOOOOOOOOOOGOOOOOOOOXXXXXXXXXXXGOOOOOOOOOOOOOXXXXXXGOOOOOOOOOOOOOOOOOOOGOOOOOOXXXXXXXXXXXXXGOOOOOOOOOOOOXXXXXXXGOOOOOOOXXXXXXXXXXXXGOOOOOOOOOOOXXXXXXXX,0,256,0
44772,172,0,172,50,118,0,0,279,196,83,GOOOOOOOOOOOXXXXXXXXGOOOOOOOOOOOOOOOOOXXGOOOOOOOOOOOXXXXXXXXGOOOOOOOOOOOOOOOOXXXGOOOOOOOOOXXXXXXXXXXGOOOOOOOOOOOOOOOOOOOGOOOOOOOOXXXXXXXXXXXGOOOOOOOOOOOOOXXXXXXGOOOOOOOOOOOOOOOOOOOGOOOOOOXXXXXXXXXXXXXGOOOOOOOOOOOOXXXXXXXGOOOOOOOXXXXXXXXXXXXGOOOOOOOOOOOXXXXXXXX,0,256,0
44793,172,0,172,52,116,0,0,277,195,82,GOOOOOOOOOOOXXXXXXXXGOOOOOOOOOOOOOOOOOXXGOOOOOOOOOOOXXXXXXXXGOOOOOOOOOOOOOOOOXXXGOOOOOOOOOXXXXXXXXXXGOOOOOOOOOOOOOOOOOOOGOOOOOOOOXXXXXXXXXXXGOOOOOOOOOOOOOXXXXXXGOOOOOOOOOOOOOOOOOOOGOOOOOOXXXXXXXXXXXXXGOOOOOOOOOOOOXXXXXXXGOOOOOOOXXXXXXXXXXXXGOOOOOOOOOOOXXXXXXXX,0,256,0
44814,172,0,172,50,118,0,0,279,197,82,GOOOOOOOOOOOXXXXXXXXGOOOOOOOOOOOOOOOOOXXGOOOOOOOOOOOXXXXXXXXGOOOOOOOOOOOOOOOOXXXGOOOOOOOOOXXXXXXXXXXGOOOOOOOOOOOOOOOOOOOGOOOOOOOOXXXXXXXXXXXGOOOOOOOOOOOOOXXXXXXGOOOOOOOOOOOOOOOOOOOGOOOOOOXXXXXXXXXXXXXGOOOOOOOOOOOOXXXXXXXGOOOOOOOXXXXXXXXXXXXGOOOOOOOOOOOXXXXXXXX,0,256,0

44835,172,0,172,50,118,0,0,278,200,78,GOOOOOOOOOOOXXXXXXXXGOOOOOOOOOOOOOOOOOXXGOOOOOOOOOOOXXXXXXXXGOOOOOOOOOOOOOOOOXXXGOOOOOOOOOXXXXXXXXXXGOOOOOOOOOOOOOOOOOOOGOOOOOOOOXXXXXXXXXXXGOOOOOOOOOOOOOXXXXXXGOOOOOOOOOOOOOOOOOOOGOOOOOOXXXXXXXXXXXXXGOOOOOOOOOOOOXXXXXXXGOOOOOOOXXXXXXXXXXXXGOOOOOOOOOOOXXXXXXXX,0,256,0
44856,172,0,172,53,115,0,0,275,197,78,GOOOOOOOOOOOXXXXXXXXGOOOOOOOOOOOOOOOOOXXGOOOOOOOOOOOXXXXXXXXGOOOOOOOOOOOOOOOOXXXGOOOOOOOOOXXXXXXXXXXGOOOOOOOOOOOOOOOOOOOGOOOOOOOOXXXXXXXXXXXGOOOOOOOOOOOOOXXXXXXGOOOOOOOOOOOOOOOOOOOGOOOOOOXXXXXXXXXXXXXGOOOOOOOOOOOOXXXXXXXGOOOOOOOXXXXXXXXXXXXGOOOOOOOOOOOXXXXXXXX,0,256,0
44877,172,0,172,49,119,0,0,279,204,75,GOOOOOOOOOOOXXXXXXXXGOOOOOOOOOOOOOOOOOXXGOOOOOOOOOOOXXXXXXXXGOOOOOOOOOOOOOOOOXXXGOOOOOOOOOXXXXXXXXXXGOOOOOOOOOOOOOOOOOOOGOOOOOOOOXXXXXXXXXXXGOOOOOOOOOOOOOXXXXXXGOOOOOOOOOOOOOOOOOOOGOOOOOOXXXXXXXXXXXXXGOOOOOOOOOOOOXXXXXXXGOOOOOOOXXXXXXXXXXXXGOOOOOOOOOOOXXXXXXXX,0,256,0
44898,172,0,172,51,117,0,0,277,202,75,GOOOOOOOOOOOXXXXXXXXGOOOOOOOOOOOOOOOOOXXGOOOOOOOOOOOXXXXXXXXGOOOOOOOOOOOOOOOOXXXGOOOOOOOOOXXXXXXXXXXGOOOOOOOOOOOOOOOOOOOGOOOOOOOOXXXXXXXXXXXGOOOOOOOOOOOOOXXXXXXGOOOOOOOOOOOOOOOOOOOGOOOOOOXXXXXXXXXXXXXGOOOOOOOOOOOOXXXXXXXGOOOOOOOXXXXXXXXXXXXGOOOOOOOOOOOXXXXXXXX,0,256,0
44919,172,0,172,48,120,0,0,280,203,77,GOOOOOOOOOOOXXXXXXXXGOOOOOOOOOOOOOOOOOXXGOOOOOOOOOOOXXXXXXXXGOOOOOOOOOOOOOOOOXXXGOOOOOOOOOXXXXXXXXXXGOOOOOOOOOOOOOOOOOOOGOOOOOOOOXXXXXXXXXXXGOOOOOOOOOOOOOXXXXXXGOOOOOOOOOOOOOOOOOOOGOOOOOOXXXXXXXXXXXXXGOOOOOOOOOOOOXXXXXXXGOOOOOOOXXXXXXXXXXXXGOOOOOOOOOOOXXXXXXXX,0,256,0

44940,172,0,172,50,118,0,0,278,199,79,GOOOOOOOOOOOXXXXXXXXGOOOOOOOOOOOOOOOOOXXGOOOOOOOOOOOXXXXXXXXGOOOOOOOOOOOOOOOOXXXGOOOOOOOOOXXXXXXXXXXGOOOOOOOOOOOOOOOOOOOGOOOOOOOOXXXXXXXXXXXGOOOOOOOOOOOOOXXXXXXGOOOOOOOOOOOOOOOOOOOGOOOOOOXXXXXXXXXXXXXGOOOOOOOOOOOOXXXXXXXGOOOOOOOXXXXXXXXXXXXGOOOOOOOOOOOXXXXXXXX,0,256,0
44961,172,0,172,52,116,0,0,276,196,80,GOOOOOOOOOOOXXXXXXXXGOOOOOOOOOOOOOOOOOXXGOOOOOOOOOOOXXXXXXXXGOOOOOOOOOOOOOOOOXXXGOOOOOOOOOXXXXXXXXXXGOOOOOOOOOOOOOOOOOOOGOOOOOOOOXXXXXXXXXXXGOOOOOOOOOOOOOXXXXXXGOOOOOOOOOOOOOOOOOOOGOOOOOOXXXXXXXXXXXXXGOOOOOOOOOOOOXXXXXXXGOOOOOOOXXXXXXXXXXXXGOOOOOOOOOOOXXXXXXXX,0,256,0
44982,172,0,172,49,119,0,0,279,199,80,GOOOOOOOOOOOXXXXXXXXGOOOOOOOOOOOOOOOOOXXGOOOOOOOOOOOXXXXXXXXGOOOOOOOOOOOOOOOOXXXGOOOOOOOOOXXXXXXXXXXGOOOOOOOOOOOOOOOOOOOGOOOOOOOOXXXXXXXXXXXGOOOOOOOOOOOOOXXXXXXGOOOOOOOOOOOOOOOOOOOGOOOOOOXXXXXXXXXXXXXGOOOOOOOOOOOOXXXXXXXGOOOOOOOXXXXXXXXXXXXGOOOOOOOOOOOXXXXXXXX,0,256,0
45003,172,0,172,45,123,0,0,283,201,82,GOOOOOOOOOOOXXXXXXXXGOOOOOOOOOOOOOOOOOXXGOOOOOOOOOOOXXXXXXXXGOOOOOOOOOOOOOOOOXXXGOOOOOOOOOXXXXXXXXXXGOOOOOOOOOOOOOOOOOOOGOOOOOOOOXXXXXXXXXXXGOOOOOOOOOOOOOXXXXXXGOOOOOOOOOOOOOOOOOOOGOOOOOOXXXXXXXXXXXXXGOOOOOOOOOOOOXXXXXXXGOOOOOOOXXXXXXXXXXXXGOOOOOOOOOOOXXXXXXXX,0,256,0
45024,172,0,172,47,121,0,0,280,203,77,GOOOOOOOOOOOXXXXXXXXGOOOOOOOOOOOOOOOOOXXGOOOOOOOOOOOXXXXXXXXGOOOOOOOOOOOOOOOOXXXGOOOOOOOOOXXXXXXXXXXGOOOOOOOOOOOOOOOOOOOGOOOOOOOOXXXXXXXXXXXGOOOOOOOOOOOOOXXXXXXGOOOOOOOOOOOOOOOOOOOGOOOOOOXXXXXXXXXXXXXGOOOOOOOOOOOOXXXXXXXGOOOOOOOXXXXXXXXXXXXGOOOOOOOOOOOXXXXXXXX,0,256,0

45045,172,0,172,45,123,0,0,283,200,83,GOOOOOOOOOOOXXXXXXXXGOOOOOOOOOOOOOOOOOXXGOOOOOOOOOOOXXXXXXXXGOOOOOOOOOOOOOOOOXXXGOOOOOOOOOXXXXXXXXXXGOOOOOOOOOOOOOOOOOOOGOOOOOOOOXXXXXXXXXXXGOOOOOOOOOOOOOXXXXXXGOOOOOOOOOOOOOOOOOOOGOOOOOOXXXXXXXXXXXXXGOOOOOOOOOOOOXXXXXXXGOOOOOOOXXXXXXXXXXXXGOOOOOOOOOOOXXXXXXXX,0,256,0
45066,172,0,172,43,125,0,0,285,202,83,GOOOOOOOOOOOXXXXXXXXGOOOOOOOOOOOOOOOOOXXGOOOOOOOOOOOXXXXXXXXGOOOOOOOOOOOOOOOOXXXGOOOOOOOOOXXXXXXXXXXGOOOOOOOOOOOOOOOOOOOGOOOOOOOOXXXXXXXXXXXGOOOOOOOOOOOOOXXXXXXGOOOOOOOOOOOOOOOOOOOGOOOOOOXXXXXXXXXXXXXGOOOOOOOOOOOOXXXXXXXGOOOOOOOXXXXXXXXXXXXGOOOOOOOOOOOXXXXXXXX,0,256,0
45087,172,0,172,49,119,0,0,279,197,82,GOOOOOOOOOOOXXXXXXXXGOOOOOOOOOOOOOOOOOXXGOOOOOOOOOOOXXXXXXXXGOOOOOOOOOOOOOOOOXXXGOOOOOOOOOXXXXXXXXXXGOOOOOOOOOOOOOOOOOOOGOOOOOOOOXXXXXXXXXXXGOOOOOOOOOOOOOXXXXXXGOOOOOOOOOOOOOOOOOOOGOOOOOOXXXXXXXXXXXXXGOOOOOOOOOOOOXXXXXXXGOOOOOOOXXXXXXXXXXXXGOOOOOOOOOOOXXXXXXXX,0,256,0
45108,172,0,172,50,118,0,0,278,198,80,GOOOOOOOOOOOXXXXXXXXGOOOOOOOOOOOOOOOOOXXGOOOOOOOOOOOXXXXXXXXGOOOOOOOOOOOOOOOOXXXGOOOOOOOOOXXXXXXXXXXGOOOOOOOOOOOOOOOOOOOGOOOOOOOOXXXXXXXXXXXGOOOOOOOOOOOOOXXXXXXGOOOOOOOOOOOOOOOOOOOGOOOOOOXXXXXXXXXXXXXGOOOOOOOOOOOOXXXXXXXGOOOOOOOXXXXXXXXXXXXGOOOOOOOOOOOXXXXXXXX,0,256,0
45129,172,0,172,49,119,0,0,280,195,85,GOOOOOOOOOOOXXXXXXXXGOOOOOOOOOOOOOOOOOXXGOOOOOOOOOOOXXXXXXXXGOOOOOOOOOOOOOOOOXXXGOOOOOOOOOXXXXXXXXXXGOOOOOOOOOOOOOOOOOOOGOOOOOOOOXXXXXXXXXXXGOOOOOOOOOOOOOXXXXXXGOOOOOOOOOOOOOOOOOOOGOOOOOOXXXXXXXXXXXXXGOOOOOOOOOOOOXXXXXXXGOOOOOOOXXXXXXXXXXXXGOOOOOOOOOOOXXXXXXXX,0,256,0

45150,172,0,172,45,123,0,0,284,201,83,GOOOOOOOOOOOXXXXXXXXGOOOOOOOOOOOOOOOOOXXGOOOOOOOOOOOXXXXXXXXGOOOOOOOOOOOOOOOOXXXGOOOOOOOOOXXXXXXXXXXGOOOOOOOOOOOOOOOOOOOGOOOOOOOOXXXXXXXXXXXGOOOOOOOOOOOOOXXXXXXGOOOOOOOOOOOOOOOOOOOGOOOOOOXXXXXXXXXXXXXGOOOOOOOOOOOOXXXXXXXGOOOOOOOXXXXXXXXXXXXGOOOOOOOOOOOXXXXXXXX,0,256,0
45171,173,1,172,40,127,0,0,288,202,86,GOOOOOOOOOOOXXXXXXXXGOOOOOOOOOOOOOOOOOAXGOOOOOOOOOOOXXXXXXXXGOOOOOOOOOOOOOOOOXXXGOOOOOOOOOXXXXXXXXXXGOOOOOOOOOOOOOOOOOOOGOOOOOOOOXXXXXXXXXXXGOOOOOOOOOOOOOXXXXXXGOOOOOOOOOOOOOOOOOOOGOOOOOOXXXXXXXXXXXXXGOOOOOOOOOOOOXXXXXXXGOOOOOOOXXXXXXXXXXXXGOOOOOOOOOOOXXXXXXXX,0,256,0
45192,173,1,172,44,123,0,0,284,200,84,GOOOOOOOOOOOXXXXXXXXGOOOOOOOOOOOOOOOOOAXGOOOOOOOOOOOXXXXXXXXGOOOOOOOOOOOOOOOOXXXGOOOOOOOOOXXXXXXXXXXGOOOOOOOOOOOOOOOOOOOGOOOOOOOOXXXXXXXXXXXGOOOOOOOOOOOOOXXXXXXGOOOOOOOOOOOOOOOOOOOGOOOOOOXXXXXXXXXXXXXGOOOOOOOOOOOOXXXXXXXGOOOOOOOXXXXXXXXXXXXGOOOOOOOOOOOXXXXXXXX,0,256,0
45213,173,1,172,48,119,0,0,280,199,81,GOOOOOOOOOOOXXXXXXXXGOOOOOOOOOOOOOOOOOAXGOOOOOOOOOOOXXXXXXXXGOOOOOOOOOOOOOOOOXXXGOOOOOOOOOXXXXXXXXXXGOOOOOOOOOOOOOOOOOOOGOOOOOOOOXXXXXXXXXXXGOOOOOOOOOOOOOXXXXXXGOOOOOOOOOOOOOOOOOOOGOOOOOOXXXXXXXXXXXXXGOOOOOOOOOOOOXXXXXXXGOOOOOOOXXXXXXXXXXXXGOOOOOOOOOOOXXXXXXXX,0,256,0
45234,173,1,172,47,120,0,0,281,202,79,GOOOOOOOOOOOXXXXXXXXGOOOOOOOOOOOOOOOOOAXGOOOOOOOOOOOXXXXXXXXGOOOOOOOOOOOOOOOOXXXGOOOOOOOOOXXXXXXXXXXGOOOOOOOOOOOOOOOOOOOGOOOOOOOOXXXXXXXXXXXGOOOOOOOOOOOOOXXXXXXGOOOOOOOOOOOOOOOOOOOGOOOOOOXXXXXXXXXXXXXGOOOOOOOOOOOOXXXXXXXGOOOOOOOXXXXXXXXXXXXGOOOOOOOOOOOXXXXXXXX,0,256,0

45255,173,1,172,48,119,0,0,280,202,78,GOOOOOOOOOOOXXXXXXXXGOOOOOOOOOOOOOOOOOAXGOOOOOOOOOOOXXXXXXXXGOOOOOOOOOOOOOOOOXXXGOOOOOOOOOXXXXXXXXXXGOOOOOOOOOOOOOOOOOOOGOOOOOOOOXXXXXXXXXXXGOOOOOOOOOOOOOXXXXXXGOOOOOOOOOOOOOOOOOOOGOOOOOOXXXXXXXXXXXXXGOOOOOOOOOOOOXXXXXXXGOOOOOOOXXXXXXXXXXXXGOOOOOOOOOOOXXXXXXXX,0,256,0
45276,173,1,172,46,121,0,0,282,203,79,GOOOOOOOOOOOXXXXXXXXGOOOOOOOOOOOOOOOOOAXGOOOOOOOOOOOXXXXXXXXGOOOOOOOOOOOOOOOOXXXGOOOOOOOOOXXXXXXXXXXGOOOOOOOOOOOOOOOOOOOGOOOOOOOOXXXXXXXXXXXGOOOOOOOOOOOOOXXXXXXGOOOOOOOOOOOOOOOOOOOGOOOOOOXXXXXXXXXXXXXGOOOOOOOOOOOOXXXXXXXGOOOOOOOXXXXXXXXXXXXGOOOOOOOOOOOXXXXXXXX,0,256,0
45297,173,1,172,50,117,0,0,278,200,78,GOOOOOOOOOOOXXXXXXXXGOOOOOOOOOOOOOOOOOAXGOOOOOOOOOOOXXXXXXXXGOOOOOOOOOOOOOOOOXXXGOOOOOOOOOXXXXXXXXXXGOOOOOOOOOOOOOOOOOOOGOOOOOOOOXXXXXXXXXXXGOOOOOOOOOOOOOXXXXXXGOOOOOOOOOOOOOOOOOOOGOOOOOOXXXXXXXXXXXXXGOOOOOOOOOOOOXXXXXXXGOOOOOOOXXXXXXXXXXXXGOOOOOOOOOOOXXXXXXXX,0,256,0
45318,173,1,172,47,120,0,0,281,207,74,GOOOOOOOOOOOXXXXXXXXGOOOOOOOOOOOOOOOOOAXGOOOOOOOOOOOXXXXXXXXGOOOOOOOOOOOOOOOOXXXGOOOOOOOOOXXXXXXXXXXGOOOOOOOOOOOOOOOOOOOGOOOOOOOOXXXXXXXXXXXGOOOOOOOOOOOOOXXXXXXGOOOOOOOOOOOOOOOOOOOGOOOOOOXXXXXXXXXXXXXGOOOOOOOOOOOOXXXXXXXGOOOOOOOXXXXXXXXXXXXGOOOOOOOOOOOXXXXXXXX,0,256,0
45339,173,0,173,45,122,0,0,281,206,75,GOOOOOOOOOOOXXXXXXXXGOOOOOOOOOOOOOOOOOOXGOOOOOOOOOOOXXXXXXXXGOOOOOOOOOOOOOOOOXXXGOOOOOOOOOXXXXXXXXXXGOOOOOOOOOOOOOOOOOOOGOOOOOOOOXXXXXXXXXXXGOOOOOOOOOOOOOXXXXXXGOOOOOOOOOOOOOOOOOOOGOOOOOOXXXXXXXXXXXXXGOOOOOOOOOOOOXXXXXXXGOOOOOOOXXXXXXXXXXXXGOOOOOOOOOOOXXXXXXXX,0,256,0

45360,173,0,173,50,117,0,0,278,208,70,GOOOOOOOOOOOXXXXXXXXGOOOOOOOOOOOOOOOOOOXGOOOOOOOOOOOXXXXXXXXGOOOOOOOOOOOOOOOOXXXGOOOOOOOOOXXXXXXXXXXGOOOOOOOOOOOOOOOOOOOGOOOOOOOOXXXXXXXXXXXGOOOOOOOOOOOOOXXXXXXGOOOOOOOOOOOOOOOOOOOGOOOOOOXXXXXXXXXXXXXGOOOOOOOOOOOOXXXXXXXGOOOOOOOXXXXXXXXXXXXGOOOOOOOOOOOXXXXXXXX,0,256,0
45381,173,0,173,53,114,0,0,275,209,66,GOOOOOOOOOOOXXXXXXXXGOOOOOOOOOOOOOOOOOOXGOOOOOOOOOOOXXXXXXXXGOOOOOOOOOOOOOOOOXXXGOOOOOOOOOXXXXXXXXXXGOOOOOOOOOOOOOOOOOOOGOOOOOOOOXXXXXXXXXXXGOOOOOOOOOOOOOXXXXXXGOOOOOOOOOOOOOOOOOOOGOOOOOOXXXXXXXXXXXXXGOOOOOOOOOOOOXXXXXXXGOOOOOOOXXXXXXXXXXXXGOOOOOOOOOOOXXXXXXXX,0,256,0
45402,173,0,173,54,113,0,0,274,205,69,GOOOOOOOOOOOXXXXXXXXGOOOOOOOOOOOOOOOOOOXGOOOOOOOOOOOXXXXXXXXGOOOOOOOOOOOOOOOOXXXGOOOOOOOOOXXXXXXXXXXGOOOOOOOOOOOOOOOOOOOGOOOOOOOOXXXXXXXXXXXGOOOOOOOOOOOOOXXXXXXGOOOOOOOOOOOOOOOOOOOGOOOOOOXXXXXXXXXXXXXGOOOOOOOOOOOOXXXXXXXGOOOOOOOXXXXXXXXXXXXGOOOOOOOOOOOXXXXXXXX,0,256,0
45423,173,0,173,52,115,0,0,275,204,71,GOOOOOOOOOOOXXXXXXXXGOOOOOOOOOOOOOOOOOOXGOOOOOOOOOOOXXXXXXXXGOOOOOOOOOOOOOOOOXXXGOOOOOOOOOXXXXXXXXXXGOOOOOOOOOOOOOOOOOOOGOOOOOOOOXXXXXXXXXXXGOOOOOOOOOOOOOXXXXXXGOOOOOOOOOOOOOOOOOOOGOOOOOOXXXXXXXXXXXXXGOOOOOOOOOOOOXXXXXXXGOOOOOOOXXXXXXXXXXXXGOOOOOOOOOOOXXXXXXXX,0,256,0
45444,173,0,173,57,110,0,0,271,197,74,GOOOOOOOOOOOXXXXXXXXGOOOOOOOOOOOOOOOOOOXGOOOOOOOOOOOXXXXXXXXGOOOOOOOOOOOOOOOOXXXGOOOOOOOOOXXXXXXXXXXGOOOOOOOOOOOOOOOOOOOGOOOOOOOOXXXXXXXXXXXGOOOOOOOOOOOOOXXXXXXGOOOOOOOOOOOOOOOOOOOGOOOOOOXXXXXXXXXXXXXGOOOOOOOOOOOOXXXXXXXGOOOOOOOXXXXXXXXXXXXGOOOOOOOOOOOXXXXXXXX,0,256,0

45465,173,0,173,56,111,0,0,271,199,72,GOOOOOOOOOOOXXXXXXXXGOOOOOOOOOOOOOOOOOOXGOOOOOOOOOOOXXXXXXXXGOOOOOOOOOOOOOOOOXXXGOOOOOOOOOXXXXXXXXXXGOOOOOOOOOOOOOOOOOOOGOOOOOOOOXXXXXXXXXXXGOOOOOOOOOOOOOXXXXXXGOOOOOOOOOOOOOOOOOOOGOOOOOOXXXXXXXXXXXXXGOOOOOOOOOOOOXXXXXXXGOOOOOOOXXXXXXXXXXXXGOOOOOOOOOOOXXXXXXXX,0,256,0
45486,173,0,173,54,113,0,0,274,199,75,GOOOOOOOOOOOXXXXXXXXGOOOOOOOOOOOOOOOOOOXGOOOOOOOOOOOXXXXXXXXGOOOOOOOOOOOOOOOOXXXGOOOOOOOOOXXXXXXXXXXGOOOOOOOOOOOOOOOOOOOGOOOOOOOOXXXXXXXXXXXGOOOOOOOOOOOOOXXXXXXGOOOOOOOOOOOOOOOOOOOGOOOOOOXXXXXXXXXXXXXGOOOOOOOOOOOOXXXXXXXGOOOOOOOXXXXXXXXXXXXGOOOOOOOOOOOXXXXXXXX,0,256,0
45507,173,0,173,52,115,0,0,276,197,79,GOOOOOOOOOOOXXXXXXXXGOOOOOOOOOOOOOOOOOOXGOOOOOOOOOOOXXXXXXXXGOOOOOOOOOOOOOOOOXXXGOOOOOOOOOXXXXXXXXXXGOOOOOOOOOOOOOOOOOOOGOOOOOOOOXXXXXXXXXXXGOOOOOOOOOOOOOXXXXXXGOOOOOOOOOOOOOOOOOOOGOOOOOOXXXXXXXXXXXXXGOOOOOOOOOOOOXXXXXXXGOOOOOOOXXXXXXXXXXXXGOOOOOOOOOOOXXXXXXXX,0,256,0
45528,173,0,173,51,116,0,0,277,201,76,GOOOOOOOOOOOXXXXXXXXGOOOOOOOOOOOOOOOOOOXGOOOOOOOOOOOXXXXXXXXGOOOOOOOOOOOOOOOOXXXGOOOOOOOOOXXXXXXXXXXGOOOOOOOOOOOOOOOOOOOGOOOOOOOOXXXXXXXXXXXGOOOOOOOOOOOOOXXXXXXGOOOOOOOOOOOOOOOOOOOGOOOOOOXXXXXXXXXXXXXGOOOOOOOOOOOOXXXXXXXGOOOOOOOXXXXXXXXXXXXGOOOOOOOOOOOXXXXXXXX,0,256,0
45549,173,0,173,49,118,0,0,279,201,78,GOOOOOOOOOOOXXXXXXXXGOOOOOOOOOOOOOOOOOOXGOOOOOOOOOOOXXXXXXXXGOOOOOOOOOOOOOOOOXXXGOOOOOOOOOXXXXXXXXXXGOOOOOOOOOOOOOOOOOOOGOOOOOOOOXXXXXXXXXXXGOOOOOOOOOOOOOXXXXXXGOOOOOOOOOOOOOOOOOOOGOOOOOOXXXXXXXXXXXXXGOOOOOOOOOOOOXXXXXXXGOOOOOOOXXXXXXXXXXXXGOOOOOOOOOOOXXXXXXXX,0,256,0

45570,173,0,173,52,115,0,0,276,200,76,GOOOOOOOOOOOXXXXXXXXGOOOOOOOOOOOOOOOOOOXGOOOOOOOOOOOXXXXXXXXGOOOOOOOOOOOOOOOOXXXGOOOOOOOOOXXXXXXXXXXGOOOOOOOOOOOOOOOOOOOGOOOOOOOOXXXXXXXXXXXGOOOOOOOOOOOOOXXXXXXGOOOOOOOOOOOOOOOOOOOGOOOOOOXXXXXXXXXXXXXGOOOOOOOOOOOOXXXXXXXGOOOOOOOXXXXXXXXXXXXGOOOOOOOOOOOXXXXXXXX,0,256,0
45591,173,0,173,51,116,0,0,277,201,76,GOOOOOOOOOOOXXXXXXXXGOOOOOOOOOOOOOOOOOOXGOOOOOOOOOOOXXXXXXXXGOOOOOOOOOOOOOOOOXXXGOOOOOOOOOXXXXXXXXXXGOOOOOOOOOOOOOOOOOOOGOOOOOOOOXXXXXXXXXXXGOOOOOOOOOOOOOXXXXXXGOOOOOOOOOOOOOOOOOOOGOOOOOOXXXXXXXXXXXXXGOOOOOOOOOOOOXXXXXXXGOOOOOOOXXXXXXXXXXXXGOOOOOOOOOOOXXXXXXXX,0,256,0
45612,173,0,173,48,119,0,0,280,201,79,GOOOOOOOOOOOXXXXXXXXGOOOOOOOOOOOOOOOOOOXGOOOOOOOOOOOXXXXXXXXGOOOOOOOOOOOOOOOOXXXGOOOOOOOOOXXXXXXXXXXGOOOOOOOOOOOOOOOOOOOGOOOOOOOOXXXXXXXXXXXGOOOOOOOOOOOOOXXXXXXGOOOOOOOOOOOOOOOOOOOGOOOOOOXXXXXXXXXXXXXGOOOOOOOOOOOOXXXXXXXGOOOOOOOXXXXXXXXXXXXGOOOOOOOOOOOXXXXXXXX,0,256,0
45633,173,0,173,49,118,0,0,278,198,80,GOOOOOOOOOOOXXXXXXXXGOOOOOOOOOOOOOOOOOOXGOOOOOOOOOOOXXXXXXXXGOOOOOOOOOOOOOOOOXXXGOOOOOOOOOXXXXXXXXXXGOOOOOOOOOOOOOOOOOOOGOOOOOOOOXXXXXXXXXXXGOOOOOOOOOOOOOXXXXXXGOOOOOOOOOOOOOOOOOOOGOOOOOOXXXXXXXXXXXXXGOOOOOOOOOOOOXXXXXXXGOOOOOOOXXXXXXXXXXXXGOOOOOOOOOOOXXXXXXXX,0,256,0
45654,173,0,173,50,117,0,0,278,196,82,GOOOOOOOOOOOXXXXXXXXGOOOOOOOOOOOOOOOOOOXGOOOOOOOOOOOXXXXXXXXGOOOOOOOOOOOOOOOOXXXGOOOOOOOOOXXXXXXXXXXGOOOOOOOOOOOOOOOOOOOGOOOOOOOOXXXXXXXXXXXGOOOOOOOOOOOOOXXXXXXGOOOOOOOOOOOOOOOOOOOGOOOOOOXXXXXXXXXXXXXGOOOOOOOOOOOOXXXXXXXGOOOOOOOXXXXXXXXXXXXGOOOOOOOOOOOXXXXXXXX,0,256,0

45675,173,0,173,50,117,0,0,278,200,78,GOOOOOOOOOOOXXXXXXXXGOOOOOOOOOOOOOOOOOOXGOOOOOOOOOOOXXXXXXXXGOOOOOOOOOOOOOOOOXXXGOOOOOOOOOXXXXXXXXXXGOOOOOOOOOOOOOOOOOOOGOOOOOOOOXXXXXXXXXXXGOOOOOOOOOOOOOXXXXXXGOOOOOOOOOOOOOOOOOOOGOOOOOOXXXXXXXXXXXXXGOOOOOOOOOOOOXXXXXXXGOOOOOOOXXXXXXXXXXXXGOOOOOOOOOOOXXXXXXXX,0,256,0
45696,173,0,173,46,121,0,0,282,199,83,GOOOOOOOOOOOXXXXXXXXGOOOOOOOOOOOOOOOOOOXGOOOOOOOOOOOXXXXXXXXGOOOOOOOOOOOOOOOOXXXGOOOOOOOOOXXXXXXXXXXGOOOOOOOOOOOOOOOOOOOGOOOOOOOOXXXXXXXXXXXGOOOOOOOOOOOOOXXXXXXGOOOOOOOOOOOOOOOOOOOGOOOOOOXXXXXXXXXXXXXGOOOOOOOOOOOOXXXXXXXGOOOOOOOXXXXXXXXXXXXGOOOOOOOOOOOXXXXXXXX,0,256,0
45717,173,0,173,41,126,0,0,287,202,85,GOOOOOOOOOOOXXXXXXXXGOOOOOOOOOOOOOOOOOOXGOOOOOOOOOOOXXXXXXXXGOOOOOOOOOOOOOOOOXXXGOOOOOOOOOXXXXXXXXXXGOOOOOOOOOOOOOOOOOOOGOOOOOOOOXXXXXXXXXXXGOOOOOOOOOOOOOXXXXXXGOOOOOOOOOOOOOOOOOOOGOOOOOOXXXXXXXXXXXXXGOOOOOOOOOOOOXXXXXXXGOOOOOOOXXXXXXXXXXXXGOOOOOOOOOOOXXXXXXXX,0,256,0
45738,173,0,173,44,123,0,0,284,200,84,GOOOOOOOOOOOXXXXXXXXGOOOOOOOOOOOOOOOOOOXGOOOOOOOOOOOXXXXXXXXGOOOOOOOOOOOOOOOOXXXGOOOOOOOOOXXXXXXXXXXGOOOOOOOOOOOOOOOOOOOGOOOOOOOOXXXXXXXXXXXGOOOOOOOOOOOOOXXXXXXGOOOOOOOOOOOOOOOOOOOGOOOOOOXXXXXXXXXXXXXGOOOOOOOOOOOOXXXXXXXGOOOOOOOXXXXXXXXXXXXGOOOOOOOOOOOXXXXXXXX,0,256,0
45759,173,0,173,43,124,0,0,285,203,82,GOOOOOOOOOOOXXXXXXXXGOOOOOOOOOOOOOOOOOOXGOOOOOOOOOOOXXXXXXXXGOOOOOOOOOOOOOOOOXXXGOOOOOOOOOXXXXXXXXXXGOOOOOOOOOOOOOOOOOOOGOOOOOOOOXXXXXXXXXXXGOOOOOOOOOOOOOXXXXXXGOOOOOOOOOOOOOOOOOOOGOOOOOOXXXXXXXXXXXXXGOOOOOOOOOOOOXXXXXXXGOOOOOOOXXXXXXXXXXXXGOOOOOOOOOOOXXXXXXXX,0,256,0

45780,173,0,173,43,124,0,0,285,202,83,GOOOOOOOOOOOXXXXXXXXGOOOOOOOOOOOOOOOOOOXGOOOOOOOOOOOXXXXXXXXGOOOOOOOOOOOOOOOOXXXGOOOOOOOOOXXXXXXXXXXGOOOOOOOOOOOOOOOOOOOGOOOOOOOOXXXXXXXXXXXGOOOOOOOOOOOOOXXXXXXGOOOOOOOOOOOOOOOOOOOGOOOOOOXXXXXXXXXXXXXGOOOOOOOOOOOOXXXXXXXGOOOOOOOXXXXXXXXXXXXGOOOOOOOOOOOXXXXXXXX,0,256,0
45801,173,0,173,40,127,0,0,287,201,86,GOOOOOOOOOOOXXXXXXXXGOOOOOOOOOOOOOOOOOOXGOOOOOOOOOOOXXXXXXXXGOOOOOOOOOOOOOOOOXXXGOOOOOOOOOXXXXXXXXXXGOOOOOOOOOOOOOOOOOOOGOOOOOOOOXXXXXXXXXXXGOOOOOOOOOOOOOXXXXXXGOOOOOOOOOOOOOOOOOOOGOOOOOOXXXXXXXXXXXXXGOOOOOOOOOOOOXXXXXXXGOOOOOOOXXXXXXXXXXXXGOOOOOOOOOOOXXXXXXXX,0,256,0
45822,173,0,173,44,123,0,0,284,200,84,GOOOOOOOOOOOXXXXXXXXGOOOOOOOOOOOOOOOOOOXGOOOOOOOOOOOXXXXXXXXGOOOOOOOOOOOOOOOOXXXGOOOOOOOOOXXXXXXXXXXGOOOOOOOOOOOOOOOOOOOGOOOOOOOOXXXXXXXXXXXGOOOOOOOOOOOOOXXXXXXGOOOOOOOOOOOOOOOOOOOGOOOOOOXXXXXXXXXXXXXGOOOOOOOOOOOOXXXXXXXGOOOOOOOXXXXXXXXXXXXGOOOOOOOOOOOXXXXXXXX,0,256,0
45843,173,0,173,38,129,0,0,290,202,88,GOOOOOOOOOOOXXXXXXXXGOOOOOOOOOOOOOOOOOOXGOOOOOOOOOOOXXXXXXXXGOOOOOOOOOOOOOOOOXXXGOOOOOOOOOXXXXXXXXXXGOOOOOOOOOOOOOOOOOOOGOOOOOOOOXXXXXXXXXXXGOOOOOOOOOOOOOXXXXXXGOOOOOOOOOOOOOOOOOOOGOOOOOOXXXXXXXXXXXXXGOOOOOOOOOOOOXXXXXXXGOOOOOOOXXXXXXXXXXXXGOOOOOOOOOOOXXXXXXXX,0,256,0
45864,173,0,173,43,124,0,0,285,206,79,GOOOOOOOOOOOXXXXXXXXGOOOOOOOOOOOOOOOOOOXGOOOOOOOOOOOXXXXXXXXGOOOOOOOOOOOOOOOOXXXGOOOOOOOOOXXXXXXXXXXGOOOOOOOOOOOOOOOOOOOGOOOOOOOOXXXXXXXXXXXGOOOOOOOOOOOOOXXXXXXGOOOOOOOOOOOOOOOOOOOGOOOOOOXXXXXXXXXXXXXGOOOOOOOOOOOOXXXXXXXGOOOOOOOXXXXXXXXXXXXGOOOOOOOOOOOXXXXXXXX,0,256,0

45885,173,0,173,47,120,0,0,281,206,75,GOOOOOOOOOOOXXXXXXXXGOOOOOOOOOOOOOOOOOOXGOOOOOOOOOOOXXXXXXXXGOOOOOOOOOOOOOOOOXXXGOOOOOOOOOXXXXXXXXXXGOOOOOOOOOOOOOOOOOOOGOOOOOOOOXXXXXXXXXXXGOOOOOOOOOOOOOXXXXXXGOOOOOOOOOOOOOOOOOOOGOOOOOOXXXXXXXXXXXXXGOOOOOOOOOOOOXXXXXXXGOOOOOOOXXXXXXXXXXXXGOOOOOOOOOOOXXXXXXXX,0,256,0
45906,173,0,173,48,119,0,0,279,203,76,GOOOOOOOOOOOXXXXXXXXGOOOOOOOOOOOOOOOOOOXGOOOOOOOOOOOXXXXXXXXGOOOOOOOOOOOOOOOOXXXGOOOOOOOOOXXXXXXXXXXGOOOOOOOOOOOOOOOOOOOGOOOOOOOOXXXXXXXXXXXGOOOOOOOOOOOOOXXXXXXGOOOOOOOOOOOOOOOOOOOGOOOOOOXXXXXXXXXXXXXGOOOOOOOOOOOOXXXXXXXGOOOOOOOXXXXXXXXXXXXGOOOOOOOOOOOXXXXXXXX,0,256,0
45927,173,0,173,50,117,0,0,278,197,81,GOOOOOOOOOOOXXXXXXXXGOOOOOOOOOOOOOOOOOOXGOOOOOOOOOOOXXXXXXXXGOOOOOOOOOOOOOOOOXXXGOOOOOOOOOXXXXXXXXXXGOOOOOOOOOOOOOOOOOOOGOOOOOOOOXXXXXXXXXXXGOOOOOOOOOOOOOXXXXXXGOOOOOOOOOOOOOOOOOOOGOOOOOOXXXXXXXXXXXXXGOOOOOOOOOOOOXXXXXXXGOOOOOOOXXXXXXXXXXXXGOOOOOOOOOOOXXXXXXXX,0,256,0
45948,173,0,173,51,116,0,0,278,196,82,GOOOOOOOOOOOXXXXXXXXGOOOOOOOOOOOOOOOOOOXGOOOOOOOOOOOXXXXXXXXGOOOOOOOOOOOOOOOOXXXGOOOOOOOOOXXXXXXXXXXGOOOOOOOOOOOOOOOOOOOGOOOOOOOOXXXXXXXXXXXGOOOOOOOOOOOOOXXXXXXGOOOOOOOOOOOOOOOOOOOGOOOOOOXXXXXXXXXXXXXGOOOOOOOOOOOOXXXXXXXGOOOOOOOXXXXXXXXXXXXGOOOOOOOOOOOXXXXXXXX,0,256,0
45969,173,0,173,48,119,0,0,281,196,85,GOOOOOOOOOOOXXXXXXXXGOOOOOOOOOOOOOOOOOOXGOOOOOOOOOOOXXXXXXXXGOOOOOOOOOOOOOOOOXXXGOOOOOOOOOXXXXXXXXXXGOOOOOOOOOOOOOOOOOOOGOOOOOOOOXXXXXXXXXXXGOOOOOOOOOOOOOXXXXXXGOOOOOOOOOOOOOOOOOOOGOOOOOOXXXXXXXXXXXXXGOOOOOOOOOOOOXXXXXXXGOOOOOOOXXXXXXXXXXXXGOOOOOOOOOOOXXXXXXXX,0,256,0

45990,173,0,173,48,119,0,0,281,201,80,GOOOOOOOOOOOXXXXXXXXGOOOOOOOOOOOOOOOOOOXGOOOOOOOOOOOXXXXXXXXGOOOOOOOOOOOOOOOOXXXGOOOOOOOOOXXXXXXXXXXGOOOOOOOOOOOOOOOOOOOGOOOOOOOOXXXXXXXXXXXGOOOOOOOOOOOOOXXXXXXGOOOOOOOOOOOOOOOOOOOGOOOOOOXXXXXXXXXXXXXGOOOOOOOOOOOOXXXXXXXGOOOOOOOXXXXXXXXXXXXGOOOOOOOOOOOXXXXXXXX,0,256,0
46011,173,0,173,46,121,0,0,283,204,79,GOOOOOOOOOOOXXXXXXXXGOOOOOOOOOOOOOOOOOOXGOOOOOOOOOOOXXXXXXXXGOOOOOOOOOOOOOOOOXXXGOOOOOOOOOXXXXXXXXXXGOOOOOOOOOOOOOOOOOOOGOOOOOOOOXXXXXXXXXXXGOOOOOOOOOOOOOXXXXXXGOOOOOOOOOOOOOOOOOOOGOOOOOOXXXXXXXXXXXXXGOOOOOOOOOOOOXXXXXXXGOOOOOOOXXXXXXXXXXXXGOOOOOOOOOOOXXXXXXXX,0,256,0
46032,173,0,173,52,115,0,0,277,202,75,GOOOOOOOOOOOXXXXXXXXGOOOOOOOOOOOOOOOOOOXGOOOOOOOOOOOXXXXXXXXGOOOOOOOOOOOOOOOOXXXGOOOOOOOOOXXXXXXXXXXGOOOOOOOOOOOOOOOOOOOGOOOOOOOOXXXXXXXXXXXGOOOOOOOOOOOOOXXXXXXGOOOOOOOOOOOOOOOOOOOGOOOOOOXXXXXXXXXXXXXGOOOOOOOOOOOOXXXXXXXGOOOOOOOXXXXXXXXXXXXGOOOOOOOOOOOXXXXXXXX,0,256,0
46053,173,0,173,54,113,0,0,275,199,76,GOOOOOOOOOOOXXXXXXXXGOOOOOOOOOOOOOOOOOOXGOOOOOOOOOOOXXXXXXXXGOOOOOOOOOOOOOOOOXXXGOOOOOOOOOXXXXXXXXXXGOOOOOOOOOOOOOOOOOOOGOOOOOOOOXXXXXXXXXXXGOOOOOOOOOOOOOXXXXXXGOOOOOOOOOOOOOOOOOOOGOOOOOOXXXXXXXXXXXXXGOOOOOOOOOOOOXXXXXXXGOOOOOOOXXXXXXXXXXXXGOOOOOOOOOOOXXXXXXXX,0,256,0
46074,173,0,173,53,114,0,0,276,205,71,GOOOOOOOOOOOXXXXXXXXGOOOOOOOOOOOOOOOOOOXGOOOOOOOOOOOXXXXXXXXGOOOOOOOOOOOOOOOOXXXGOOOOOOOOOXXXXXXXXXXGOOOOOOOOOOOOOOOOOOOGOOOOOOOOXXXXXXXXXXXGOOOOOOOOOOOOOXXXXXXGOOOOOOOOOOOOOOOOOOOGOOOOOOXXXXXXXXXXXXXGOOOOOOOOOOOOXXXXXXXGOOOOOOOXXXXXXXXXXXXGOOOOOOOOOOOXXXXXXXX,0,256,0

46095,173,0,173,52,115,0,0,277,206,71,GOOOOOOOOOOOXXXXXXXXGOOOOOOOOOOOOOOOOOOXGOOOOOOOOOOOXXXXXXXXGOOOOOOOOOOOOOOOOXXXGOOOOOOOOOXXXXXXXXXXGOOOOOOOOOOOOOOOOOOOGOOOOOOOOXXXXXXXXXXXGOOOOOOOOOOOOOXXXXXXGOOOOOOOOOOOOOOOOOOOGOOOOOOXXXXXXXXXXXXXGOOOOOOOOOOOOXXXXXXXGOOOOOOOXXXXXXXXXXXXGOOOOOOOOOOOXXXXXXXX,0,256,0
46116,173,0,173,50,117,0,0,277,205,72,GOOOOOOOOOOOXXXXXXXXGOOOOOOOOOOOOOOOOOOXGOOOOOOOOOOOXXXXXXXXGOOOOOOOOOOOOOOOOXXXGOOOOOOOOOXXXXXXXXXXGOOOOOOOOOOOOOOOOOOOGOOOOOOOOXXXXXXXXXXXGOOOOOOOOOOOOOXXXXXXGOOOOOOOOOOOOOOOOOOOGOOOOOOXXXXXXXXXXXXXGOOOOOOOOOOOOXXXXXXXGOOOOOOOXXXXXXXXXXXXGOOOOOOOOOOOXXXXXXXX,0,256,0
46137,173,0,173,50,117,0,0,278,201,77,GOOOOOOOOOOOXXXXXXXXGOOOOOOOOOOOOOOOOOOXGOOOOOOOOOOOXXXXXXXXGOOOOOOOOOOOOOOOOXXXGOOOOOOOOOXXXXXXXXXXGOOOOOOOOOOOOOOOOOOOGOOOOOOOOXXXXXXXXXXXGOOOOOOOOOOOOOXXXXXXGOOOOOOOOOOOOOOOOOOOGOOOOOOXXXXXXXXXXXXXGOOOOOOOOOOOOXXXXXXXGOOOOOOOXXXXXXXXXXXXGOOOOOOOOOOOXXXXXXXX,0,256,0
46158,173,0,173,42,125,0,0,286,200,86,GOOOOOOOOOOOXXXXXXXXGOOOOOOOOOOOOOOOOOOXGOOOOOOOOOOOXXXXXXXXGOOOOOOOOOOOOOOOOXXXGOOOOOOOOOXXXXXXXXXXGOOOOOOOOOOOOOOOOOOOGOOOOOOOOXXXXXXXXXXXGOOOOOOOOOOOOOXXXXXXGOOOOOOOOOOOOOOOOOOOGOOOOOOXXXXXXXXXXXXXGOOOOOOOOOOOOXXXXXXXGOOOOOOOXXXXXXXXXXXXGOOOOOOOOOOOXXXXXXXX,0,256,0
46179,174,1,173,41,125,0,0,287,201,86,GOOOOOOOOOOOXXXXXXXXGOOOOOOOOOOOOOOOOOOXGOOOOOOOOOOOXXXXXXXXGOOOOOOOOOOOOOOOOAXXGOOOOOOOOOXXXXXXXXXXGOOOOOOOOOOOOOOOOOOOGOOOOOOOOXXXXXXXXXXXGOOOOOOOOOOOOOXXXXXXGOOOOOOOOOOOOOOOOOOOGOOOOOOXXXXXXXXXXXXXGOOOOOOOOOOOOXXXXXXXGOOOOOOOXXXXXXXXXXXXGOOOOOOOOOOOXXXXXXXX,0,256,0

46200,174,1,173,44,122,0,0,283,202,81,GOOOOOOOOOOOXXXXXXXXGOOOOOOOOOOOOOOOOOOXGOOOOOOOOOOOXXXXXXXXGOOOOOOOOOOOOOOOOAXXGOOOOOOOOOXXXXXXXXXXGOOOOOOOOOOOOOOOOOOOGOOOOOOOOXXXXXXXXXXXGOOOOOOOOOOOOOXXXXXXGOOOOOOOOOOOOOOOOOOOGOOOOOOXXXXXXXXXXXXXGOOOOOOOOOOOOXXXXXXXGOOOOOOOXXXXXXXXXXXXGOOOOOOOOOOOXXXXXXXX,0,256,0
46221,174,1,173,43,123,0,0,284,203,81,GOOOOOOOOOOOXXXXXXXXGOOOOOOOOOOOOOOOOOOXGOOOOOOOOOOOXXXXXXXXGOOOOOOOOOOOOOOOOAXXGOOOOOOOOOXXXXXXXXXXGOOOOOOOOOOOOOOOOOOOGOOOOOOOOXXXXXXXXXXXGOOOOOOOOOOOOOXXXXXXGOOOOOOOOOOOOOOOOOOOGOOOOOOXXXXXXXXXXXXXGOOOOOOOOOOOOXXXXXXXGOOOOOOOXXXXXXXXXXXXGOOOOOOOOOOOXXXXXXXX,0,256,0
46242,174,0,174,47,119,0,0,280,199,81,GOOOOOOOOOOOXXXXXXXXGOOOOOOOOOOOOOOOOOOXGOOOOOOOOOOOXXXXXXXXGOOOOOOOOOOOOOOOOOXXGOOOOOOOOOXXXXXXXXXXGOOOOOOOOOOOOOOOOOOOGOOOOOOOOXXXXXXXXXXXGOOOOOOOOOOOOOXXXXXXGOOOOOOOOOOOOOOOOOOOGOOOOOOXXXXXXXXXXXXXGOOOOOOOOOOOOXXXXXXXGOOOOOOOXXXXXXXXXXXXGOOOOOOOOOOOXXXXXXXX,0,256,0
46263,174,0,174,46,120,0,0,281,203,78,GOOOOOOOOOOOXXXXXXXXGOOOOOOOOOOOOOOOOOOXGOOOOOOOOOOOXXXXXXXXGOOOOOOOOOOOOOOOOOXXGOOOOOOOOOXXXXXXXXXXGOOOOOOOOOOOOOOOOOOOGOOOOOOOOXXXXXXXXXXXGOOOOOOOOOOOOOXXXXXXGOOOOOOOOOOOOOOOOOOOGOOOOOOXXXXXXXXXXXXXGOOOOOOOOOOOOXXXXXXXGOOOOOOOXXXXXXXXXXXXGOOOOOOOOOOOXXXXXXXX,0,256,0
46284,174,0,174,45,121,0,0,282,204,78,GOOOOOOOOOOOXXXXXXXXGOOOOOOOOOOOOOOOOOOXGOOOOOOOOOOOXXXXXXXXGOOOOOOOOOOOOOOOOOXXGOOOOOOOOOXXXXXXXXXXGOOOOOOOOOOOOOOOOOOOGOOOOOOOOXXXXXXXXXXXGOOOOOOOOOOOOOXXXXXXGOOOOOOOOOOOOOOOOOOOGOOOOOOXXXXXXXXXXXXXGOOOOOOOOOOOOXXXXXXXGOOOOOOOXXXXXXXXXXXXGOOOOOOOOOOOXXXXXXXX,0,256,0

46305,174,0,174,48,118,0,0,279,200,79,GOOOOOOOOOOOXXXXXXXXGOOOOOOOOOOOOOOOOOOXGOOOOOOOOOOOXXXXXXXXGOOOOOOOOOOOOOOOOOXXGOOOOOOOOOXXXXXXXXXXGOOOOOOOOOOOOOOOOOOOGOOOOOOOOXXXXXXXXXXXGOOOOOOOOOOOOOXXXXXXGOOOOOOOOOOOOOOOOOOOGOOOOOOXXXXXXXXXXXXXGOOOOOOOOOOOOXXXXXXXGOOOOOOOXXXXXXXXXXXXGOOOOOOOOOOOXXXXXXXX,0,256,0
46326,174,0,174,45,121,0,0,282,199,83,GOOOOOOOOOOOXXXXXXXXGOOOOOOOOOOOOOOOOOOXGOOOOOOOOOOOXXXXXXXXGOOOOOOOOOOOOOOOOOXXGOOOOOOOOOXXXXXXXXXXGOOOOOOOOOOOOOOOOOOOGOOOOOOOOXXXXXXXXXXXGOOOOOOOOOOOOOXXXXXXGOOOOOOOOOOOOOOOOOOOGOOOOOOXXXXXXXXXXXXXGOOOOOOOOOOOOXXXXXXXGOOOOOOOXXXXXXXXXXXXGOOOOOOOOOOOXXXXXXXX,0,256,0
46347,174,0,174,45,121,0,0,282,201,81,GOOOOOOOOOOOXXXXXXXXGOOOOOOOOOOOOOOOOOOXGOOOOOOOOOOOXXXXXXXXGOOOOOOOOOOOOOOOOOXXGOOOOOOOOOXXXXXXXXXXGOOOOOOOOOOOOOOOOOOOGOOOOOOOOXXXXXXXXXXXGOOOOOOOOOOOOOXXXXXXGOOOOOOOOOOOOOOOOOOOGOOOOOOXXXXXXXXXXXXXGOOOOOOOOOOOOXXXXXXXGOOOOOOOXXXXXXXXXXXXGOOOOOOOOOOOXXXXXXXX,0,256,0
46368,174,0,174,48,118,0,0,279,197,82,GOOOOOOOOOOOXXXXXXXXGOOOOOOOOOOOOOOOOOOXGOOOOOOOOOOOXXXXXXXXGOOOOOOOOOOOOOOOOOXXGOOOOOOOOOXXXXXXXXXXGOOOOOOOOOOOOOOOOOOOGOOOOOOOOXXXXXXXXXXXGOOOOOOOOOOOOOXXXXXXGOOOOOOOOOOOOOOOOOOOGOOOOOOXXXXXXXXXXXXXGOOOOOOOOOOOOXXXXXXXGOOOOOOOXXXXXXXXXXXXGOOOOOOOOOOOXXXXXXXX,0,256,0
46389,174,0,174,53,113,0,0,274,195,79,GOOOOOOOOOOOXXXXXXXXGOOOOOOOOOOOOOOOOOOXGOOOOOOOOOOOXXXXXXXXGOOOOOOOOOOOOOOOOOXXGOOOOOOOOOXXXXXXXXXXGOOOOOOOOOOOOOOOOOOOGOOOOOOOOXXXXXXXXXXXGOOOOOOOOOOOOOXXXXXXGOOOOOOOOOOOOOOOOOOOGOOOOOOXXXXXXXXXXXXXGOOOOOOOOOOOOXXXXXXXGOOOOOOOXXXXXXXXXXXXGOOOOOOOOOOOXXXXXXXX,0,256,0

46410,174,0,174,50,116,0,0,277,200,77,GOOOOOOOOOOOXXXXXXXXGOOOOOOOOOOOOOOOOOOXGOOOOOOOOOOOXXXXXXXXGOOOOOOOOOOOOOOOOOXXGOOOOOOOOOXXXXXXXXXXGOOOOOOOOOOOOOOOOOOOGOOOOOOOOXXXXXXXXXXXGOOOOOOOOOOOOOXXXXXXGOOOOOOOOOOOOOOOOOOOGOOOOOOXXXXXXXXXXXXXGOOOOOOOOOOOOXXXXXXXGOOOOOOOXXXXXXXXXXXXGOOOOOOOOOOOXXXXXXXX,0,256,0
46431,174,0,174,46,120,0,0,280,203,77,GOOOOOOOOOOOXXXXXXXXGOOOOOOOOOOOOOOOOOOXGOOOOOOOOOOOXXXXXXXXGOOOOOOOOOOOOOOOOOXXGOOOOOOOOOXXXXXXXXXXGOOOOOOOOOOOOOOOOOOOGOOOOOOOOXXXXXXXXXXXGOOOOOOOOOOOOOXXXXXXGOOOOOOOOOOOOOOOOOOOGOOOOOOXXXXXXXXXXXXXGOOOOOOOOOOOOXXXXXXXGOOOOOOOXXXXXXXXXXXXGOOOOOOOOOOOXXXXXXXX,0,256,0
46452,174,0,174,41,125,0,0,286,208,78,GOOOOOOOOOOOXXXXXXXXGOOOOOOOOOOOOOOOOOOXGOOOOOOOOOOOXXXXXXXXGOOOOOOOOOOOOOOOOOXXGOOOOOOOOOXXXXXXXXXXGOOOOOOOOOOOOOOOOOOOGOOOOOOOOXXXXXXXXXXXGOOOOOOOOOOOOOXXXXXXGOOOOOOOOOOOOOOOOOOOGOOOOOOXXXXXXXXXXXXXGOOOOOOOOOOOOXXXXXXXGOOOOOOOXXXXXXXXXXXXGOOOOOOOOOOOXXXXXXXX,0,256,0
46473,174,0,174,43,123,0,0,284,205,79,GOOOOOOOOOOOXXXXXXXXGOOOOOOOOOOOOOOOOOOXGOOOOOOOOOOOXXXXXXXXGOOOOOOOOOOOOOOOOOXXGOOOOOOOOOXXXXXXXXXXGOOOOOOOOOOOOOOOOOOOGOOOOOOOOXXXXXXXXXXXGOOOOOOOOOOOOOXXXXXXGOOOOOOOOOOOOOOOOOOOGOOOOOOXXXXXXXXXXXXXGOOOOOOOOOOOOXXXXXXXGOOOOOOOXXXXXXXXXXXXGOOOOOOOOOOOXXXXXXXX,0,256,0
46494,175,1,174,42,123,0,0,284,203,81,GOOOOOOOOOOOXXXXXXXXGOOOOOOOOOOOOOOOOOOXGOOOOOOOOOOOAXXXXXXXGOOOOOOOOOOOOOOOOOXXGOOOOOOOOOXXXXXXXXXXGOOOOOOOOOOOOOOOOOOOGOOOOOOOOXXXXXXXXXXXGOOOOOOOOOOOOOXXXXXXGOOOOOOOOOOOOOOOOOOOGOOOOOOXXXXXXXXXXXXXGOOOOOOOOOOOOXXXXXXXGOOOOOOOXXXXXXXXXXXXGOOOOOOOOOOOXXXXXXXX,0,256,0

46515,175,1,174,43,122,0,0,283,200,83,GOOOOOOOOOOOXXXXXXXXGOOOOOOOOOOOOOOOOOOXGOOOOOOOOOOOAXXXXXXXGOOOOOOOOOOOOOOOOOXXGOOOOOOOOOXXXXXXXXXXGOOOOOOOOOOOOOOOOOOOGOOOOOOOOXXXXXXXXXXXGOOOOOOOOOOOOOXXXXXXGOOOOOOOOOOOOOOOOOOOGOOOOOOXXXXXXXXXXXXXGOOOOOOOOOOOOXXXXXXXGOOOOOOOXXXXXXXXXXXXGOOOOOOOOOOOXXXXXXXX,0,256,0
46536,175,1,174,41,124,0,0,283,202,81,GOOOOOOOOOOOXXXXXXXXGOOOOOOOOOOOOOOOOOOXGOOOOOOOOOOOAXXXXXXXGOOOOOOOOOOOOOOOOOXXGOOOOOOOOOXXXXXXXXXXGOOOOOOOOOOOOOOOOOOOGOOOOOOOOXXXXXXXXXXXGOOOOOOOOOOOOOXXXXXXGOOOOOOOOOOOOOOOOOOOGOOOOOOXXXXXXXXXXXXXGOOOOOOOOOOOOXXXXXXXGOOOOOOOXXXXXXXXXXXXGOOOOOOOOOOOXXXXXXXX,0,256,0
46557,175,0,175,43,122,0,0,283,201,82,GOOOOOOOOOOOXXXXXXXXGOOOOOOOOOOOOOOOOOOXGOOOOOOOOOOOOXXXXXXXGOOOOOOOOOOOOOOOOOXXGOOOOOOOOOXXXXXXXXXXGOOOOOOOOOOOOOOOOOOOGOOOOOOOOXXXXXXXXXXXGOOOOOOOOOOOOOXXXXXXGOOOOOOOOOOOOOOOOOOOGOOOOOOXXXXXXXXXXXXXGOOOOOOOOOOOOXXXXXXXGOOOOOOOXXXXXXXXXXXXGOOOOOOOOOOOXXXXXXXX,0,256,0
46578,175,0,175,45,120,0,0,281,198,83,GOOOOOOOOOOOXXXXXXXXGOOOOOOOOOOOOOOOOOOXGOOOOOOOOOOOOXXXXXXXGOOOOOOOOOOOOOOOOOXXGOOOOOOOOOXXXXXXXXXXGOOOOOOOOOOOOOOOOOOOGOOOOOOOOXXXXXXXXXXXGOOOOOOOOOOOOOXXXXXXGOOOOOOOOOOOOOOOOOOOGOOOOOOXXXXXXXXXXXXXGOOOOOOOOOOOOXXXXXXXGOOOOOOOXXXXXXXXXXXXGOOOOOOOOOOOXXXXXXXX,0,256,0
46599,175,0,175,40,125,0,0,285,204,81,GOOOOOOOOOOOXXXXXXXXGOOOOOOOOOOOOOOOOOOXGOOOOOOOOOOOOXXXXXXXGOOOOOOOOOOOOOOOOOXXGOOOOOOOOOXXXXXXXXXXGOOOOOOOOOOOOOOOOOOOGOOOOOOOOXXXXXXXXXXXGOOOOOOOOOOOOOXXXXXXGOOOOOOOOOOOOOOOOOOOGOOOOOOXXXXXXXXXXXXXGOOOOOOOOOOOOXXXXXXXGOOOOOOOXXXXXXXXXXXXGOOOOOOOOOOOXXXXXXXX,0,256,0

46620,175,0,175,43,122,0,0,283,202,81,GOOOOOOOOOOOXXXXXXXXGOOOOOOOOOOOOOOOOOOXGOOOOOOOOOOOOXXXXXXXGOOOOOOOOOOOOOOOOOXXGOOOOOOOOOXXXXXXXXXXGOOOOOOOOOOOOOOOOOOOGOOOOOOOOXXXXXXXXXXXGOOOOOOOOOOOOOXXXXXXGOOOOOOOOOOOOOOOOOOOGOOOOOOXXXXXXXXXXXXXGOOOOOOOOOOOOXXXXXXXGOOOOOOOXXXXXXXXXXXXGOOOOOOOOOOOXXXXXXXX,0,256,0
46641,175,0,175,39,126,0,0,287,209,78,GOOOOOOOOOOOXXXXXXXXGOOOOOOOOOOOOOOOOOOXGOOOOOOOOOOOOXXXXXXXGOOOOOOOOOOOOOOOOOXXGOOOOOOOOOXXXXXXXXXXGOOOOOOOOOOOOOOOOOOOGOOOOOOOOXXXXXXXXXXXGOOOOOOOOOOOOOXXXXXXGOOOOOOOOOOOOOOOOOOOGOOOOOOXXXXXXXXXXXXXGOOOOOOOOOOOOXXXXXXXGOOOOOOOXXXXXXXXXXXXGOOOOOOOOOOOXXXXXXXX,0,256,0
46662,175,0,175,39,126,0,0,287,208,79,GOOOOOOOOOOOXXXXXXXXGOOOOOOOOOOOOOOOOOOXGOOOOOOOOOOOOXXXXXXXGOOOOOOOOOOOOOOOOOXXGOOOOOOOOOXXXXXXXXXXGOOOOOOOOOOOOOOOOOOOGOOOOOOOOXXXXXXXXXXXGOOOOOOOOOOOOOXXXXXXGOOOOOOOOOOOOOOOOOOOGOOOOOOXXXXXXXXXXXXXGOOOOOOOOOOOOXXXXXXXGOOOOOOOXXXXXXXXXXXXGOOOOOOOOOOOXXXXXXXX,0,256,0
46683,175,0,175,46,119,0,0,280,203,77,GOOOOOOOOOOOXXXXXXXXGOOOOOOOOOOOOOOOOOOXGOOOOOOOOOOOOXXXXXXXGOOOOOOOOOOOOOOOOOXXGOOOOOOOOOXXXXXXXXXXGOOOOOOOOOOOOOOOOOOOGOOOOOOOOXXXXXXXXXXXGOOOOOOOOOOOOOXXXXXXGOOOOOOOOOOOOOOOOOOOGOOOOOOXXXXXXXXXXXXXGOOOOOOOOOOOOXXXXXXXGOOOOOOOXXXXXXXXXXXXGOOOOOOOOOOOXXXXXXXX,0,256,0
46704,175,0,175,48,117,0,0,278,203,75,GOOOOOOOOOOOXXXXXXXXGOOOOOOOOOOOOOOOOOOXGOOOOOOOOOOOOXXXXXXXGOOOOOOOOOOOOOOOOOXXGOOOOOOOOOXXXXXXXXXXGOOOOOOOOOOOOOOOOOOOGOOOOOOOOXXXXXXXXXXXGOOOOOOOOOOOOOXXXXXXGOOOOOOOOOOOOOOOOOOOGOOOOOOXXXXXXXXXXXXXGOOOOOOOOOOOOXXXXXXXGOOOOOOOXXXXXXXXXXXXGOOOOOOOOOOOXXXXXXXX,0,256,0

46725,175,0,175,45,120,0,0,281,204,77,GOOOOOOOOOOOXXXXXXXXGOOOOOOOOOOOOOOOOOOXGOOOOOOOOOOOOXXXXXXXGOOOOOOOOOOOOOOOOOXXGOOOOOOOOOXXXXXXXXXXGOOOOOOOOOOOOOOOOOOOGOOOOOOOOXXXXXXXXXXXGOOOOOOOOOOOOOXXXXXXGOOOOOOOOOOOOOOOOOOOGOOOOOOXXXXXXXXXXXXXGOOOOOOOOOOOOXXXXXXXGOOOOOOOXXXXXXXXXXXXGOOOOOOOOOOOXXXXXXXX,0,256,0
46746,175,0,175,49,116,0,0,277,202,75,GOOOOOOOOOOOXXXXXXXXGOOOOOOOOOOOOOOOOOOXGOOOOOOOOOOOOXXXXXXXGOOOOOOOOOOOOOOOOOXXGOOOOOOOOOXXXXXXXXXXGOOOOOOOOOOOOOOOOOOOGOOOOOOOOXXXXXXXXXXXGOOOOOOOOOOOOOXXXXXXGOOOOOOOOOOOOOOOOOOOGOOOOOOXXXXXXXXXXXXXGOOOOOOOOOOOOXXXXXXXGOOOOOOOXXXXXXXXXXXXGOOOOOOOOOOOXXXXXXXX,0,256,0
46767,175,0,175,46,119,0,0,280,203,77,GOOOOOOOOOOOXXXXXXXXGOOOOOOOOOOOOOOOOOOXGOOOOOOOOOOOOXXXXXXXGOOOOOOOOOOOOOOOOOXXGOOOOOOOOOXXXXXXXXXXGOOOOOOOOOOOOOOOOOOOGOOOOOOOOXXXXXXXXXXXGOOOOOOOOOOOOOXXXXXXGOOOOOOOOOOOOOOOOOOOGOOOOOOXXXXXXXXXXXXXGOOOOOOOOOOOOXXXXXXXGOOOOOOOXXXXXXXXXXXXGOOOOOOOOOOOXXXXXXXX,0,256,0
46788,175,0,175,50,115,0,0,276,201,75,GOOOOOOOOOOOXXXXXXXXGOOOOOOOOOOOOOOOOOOXGOOOOOOOOOOOOXXXXXXXGOOOOOOOOOOOOOOOOOXXGOOOOOOOOOXXXXXXXXXXGOOOOOOOOOOOOOOOOOOOGOOOOOOOOXXXXXXXXXXXGOOOOOOOOOOOOOXXXXXXGOOOOOOOOOOOOOOOOOOOGOOOOOOXXXXXXXXXXXXXGOOOOOOOOOOOOXXXXXXXGOOOOOOOXXXXXXXXXXXXGOOOOOOOOOOOXXXXXXXX,0,256,0
46809,175,0,175,52,113,0,0,274,202,72,GOOOOOOOOOOOXXXXXXXXGOOOOOOOOOOOOOOOOOOXGOOOOOOOOOOOOXXXXXXXGOOOOOOOOOOOOOOOOOXXGOOOOOOOOOXXXXXXXXXXGOOOOOOOOOOOOOOOOOOOGOOOOOOOOXXXXXXXXXXXGOOOOOOOOOOOOOXXXXXXGOOOOOOOOOOOOOOOOOOOGOOOOOOXXXXXXXXXXXXXGOOOOOOOOOOOOXXXXXXXGOOOOOOOXXXXXXXXXXXXGOOOOOOOOOOOXXXXXXXX,0,256,0

46830,175,0,175,54,111,0,0,272,202,70,GOOOOOOOOOOOXXXXXXXXGOOOOOOOOOOOOOOOOOOXGOOOOOOOOOOOOXXXXXXXGOOOOOOOOOOOOOOOOOXXGOOOOOOOOOXXXXXXXXXXGOOOOOOOOOOOOOOOOOOOGOOOOOOOOXXXXXXXXXXXGOOOOOOOOOOOOOXXXXXXGOOOOOOOOOOOOOOOOOOOGOOOOOOXXXXXXXXXXXXXGOOOOOOOOOOOOXXXXXXXGOOOOOOOXXXXXXXXXXXXGOOOOOOOOOOOXXXXXXXX,0,256,0
46851,175,0,175,52,113,0,0,274,202,72,GOOOOOOOOOOOXXXXXXXXGOOOOOOOOOOOOOOOOOOXGOOOOOOOOOOOOXXXXXXXGOOOOOOOOOOOOOOOOOXXGOOOOOOOOOXXXXXXXXXXGOOOOOOOOOOOOOOOOOOOGOOOOOOOOXXXXXXXXXXXGOOOOOOOOOOOOOXXXXXXGOOOOOOOOOOOOOOOOOOOGOOOOOOXXXXXXXXXXXXXGOOOOOOOOOOOOXXXXXXXGOOOOOOOXXXXXXXXXXXXGOOOOOOOOOOOXXXXXXXX,0,256,0
46872,175,0,175,53,112,0,0,273,203,70,GOOOOOOOOOOOXXXXXXXXGOOOOOOOOOOOOOOOOOOXGOOOOOOOOOOOOXXXXXXXGOOOOOOOOOOOOOOOOOXXGOOOOOOOOOXXXXXXXXXXGOOOOOOOOOOOOOOOOOOOGOOOOOOOOXXXXXXXXXXXGOOOOOOOOOOOOOXXXXXXGOOOOOOOOOOOOOOOOOOOGOOOOOOXXXXXXXXXXXXXGOOOOOOOOOOOOXXXXXXXGOOOOOOOXXXXXXXXXXXXGOOOOOOOOOOOXXXXXXXX,0,256,0
46893,175,0,175,55,110,0,0,271,203,68,GOOOOOOOOOOOXXXXXXXXGOOOOOOOOOOOOOOOOOOXGOOOOOOOOOOOOXXXXXXXGOOOOOOOOOOOOOOOOOXXGOOOOOOOOOXXXXXXXXXXGOOOOOOOOOOOOOOOOOOOGOOOOOOOOXXXXXXXXXXXGOOOOOOOOOOOOOXXXXXXGOOOOOOOOOOOOOOOOOOOGOOOOOOXXXXXXXXXXXXXGOOOOOOOOOOOOXXXXXXXGOOOOOOOXXXXXXXXXXXXGOOOOOOOOOOOXXXXXXXX,0,256,0
46914,175,0,175,49,116,0,0,277,208,69,GOOOOOOOOOOOXXXXXXXXGOOOOOOOOOOOOOOOOOOXGOOOOOOOOOOOOXXXXXXXGOOOOOOOOOOOOOOOOOXXGOOOOOOOOOXXXXXXXXXXGOOOOOOOOOOOOOOOOOOOGOOOOOOOOXXXXXXXXXXXGOOOOOOOOOOOOOXXXXXXGOOOOOOOOOOOOOOOOOOOGOOOOOOXXXXXXXXXXXXXGOOOOOOOOOOOOXXXXXXXGOOOOOOOXXXXXXXXXXXXGOOOOOOOOOOOXXXXXXXX,0,256,0

46935,175,0,175,49,116,0,0,278,202,76,GOOOOOOOOOOOXXXXXXXXGOOOOOOOOOOOOOOOOOOXGOOOOOOOOOOOOXXXXXXXGOOOOOOOOOOOOOOOOOXXGOOOOOOOOOXXXXXXXXXXGOOOOOOOOOOOOOOOOOOOGOOOOOOOOXXXXXXXXXXXGOOOOOOOOOOOOOXXXXXXGOOOOOOOOOOOOOOOOOOOGOOOOOOXXXXXXXXXXXXXGOOOOOOOOOOOOXXXXXXXGOOOOOOOXXXXXXXXXXXXGOOOOOOOOOOOXXXXXXXX,0,256,0
46956,175,0,175,49,116,0,0,278,201,77,GOOOOOOOOOOOXXXXXXXXGOOOOOOOOOOOOOOOOOOXGOOOOOOOOOOOOXXXXXXXGOOOOOOOOOOOOOOOOOXXGOOOOOOOOOXXXXXXXXXXGOOOOOOOOOOOOOOOOOOOGOOOOOOOOXXXXXXXXXXXGOOOOOOOOOOOOOXXXXXXGOOOOOOOOOOOOOOOOOOOGOOOOOOXXXXXXXXXXXXXGOOOOOOOOOOOOXXXXXXXGOOOOOOOXXXXXXXXXXXXGOOOOOOOOOOOXXXXXXXX,0,256,0
46977,175,0,175,49,116,0,0,278,197,81,GOOOOOOOOOOOXXXXXXXXGOOOOOOOOOOOOOOOOOOXGOOOOOOOOOOOOXXXXXXXGOOOOOOOOOOOOOOOOOXXGOOOOOOOOOXXXXXXXXXXGOOOOOOOOOOOOOOOOOOOGOOOOOOOOXXXXXXXXXXXGOOOOOOOOOOOOOXXXXXXGOOOOOOOOOOOOOOOOOOOGOOOOOOXXXXXXXXXXXXXGOOOOOOOOOOOOXXXXXXXGOOOOOOOXXXXXXXXXXXXGOOOOOOOOOOOXXXXXXXX,0,256,0
46998,175,0,175,49,116,0,0,278,202,76,GOOOOOOOOOOOXXXXXXXXGOOOOOOOOOOOOOOOOOOXGOOOOOOOOOOOOXXXXXXXGOOOOOOOOOOOOOOOOOXXGOOOOOOOOOXXXXXXXXXXGOOOOOOOOOOOOOOOOOOOGOOOOOOOOXXXXXXXXXXXGOOOOOOOOOOOOOXXXXXXGOOOOOOOOOOOOOOOOOOOGOOOOOOXXXXXXXXXXXXXGOOOOOOOOOOOOXXXXXXXGOOOOOOOXXXXXXXXXXXXGOOOOOOOOOOOXXXXXXXX,0,256,0
47019,175,0,175,44,121,0,0,283,208,75,GOOOOOOOOOOOXXXXXXXXGOOOOOOOOOOOOOOOOOOXGOOOOOOOOOOOOXXXXXXXGOOOOOOOOOOOOOOOOOXXGOOOOOOOOOXXXXXXXXXXGOOOOOOOOOOOOOOOOOOOGOOOOOOOOXXXXXXXXXXXGOOOOOOOOOOOOOXXXXXXGOOOOOOOOOOOOOOOOOOOGOOOOOOXXXXXXXXXXXXXGOOOOOOOOOOOOXXXXXXXGOOOOOOOXXXXXXXXXXXXGOOOOOOOOOOOXXXXXXXX,0,256,0

47040,175,0,175,45,120,0,0,282,208,74,GOOOOOOOOOOOXXXXXXXXGOOOOOOOOOOOOOOOOOOXGOOOOOOOOOOOOXXXXXXXGOOOOOOOOOOOOOOOOOXXGOOOOOOOOOXXXXXXXXXXGOOOOOOOOOOOOOOOOOOOGOOOOOOOOXXXXXXXXXXXGOOOOOOOOOOOOOXXXXXXGOOOOOOOOOOOOOOOOOOOGOOOOOOXXXXXXXXXXXXXGOOOOOOOOOOOOXXXXXXXGOOOOOOOXXXXXXXXXXXXGOOOOOOOOOOOXXXXXXXX,0,256,0
47061,175,0,175,48,117,0,0,279,204,75,GOOOOOOOOOOOXXXXXXXXGOOOOOOOOOOOOOOOOOOXGOOOOOOOOOOOOXXXXXXXGOOOOOOOOOOOOOOOOOXXGOOOOOOOOOXXXXXXXXXXGOOOOOOOOOOOOOOOOOOOGOOOOOOOOXXXXXXXXXXXGOOOOOOOOOOOOOXXXXXXGOOOOOOOOOOOOOOOOOOOGOOOOOOXXXXXXXXXXXXXGOOOOOOOOOOOOXXXXXXXGOOOOOOOXXXXXXXXXXXXGOOOOOOOOOOOXXXXXXXX,0,256,0
47082,175,0,175,52,113,0,0,275,205,70,GOOOOOOOOOOOXXXXXXXXGOOOOOOOOOOOOOOOOOOXGOOOOOOOOOOOOXXXXXXXGOOOOOOOOOOOOOOOOOXXGOOOOOOOOOXXXXXXXXXXGOOOOOOOOOOOOOOOOOOOGOOOOOOOOXXXXXXXXXXXGOOOOOOOOOOOOOXXXXXXGOOOOOOOOOOOOOOOOOOOGOOOOOOXXXXXXXXXXXXXGOOOOOOOOOOOOXXXXXXXGOOOOOOOXXXXXXXXXXXXGOOOOOOOOOOOXXXXXXXX,0,256,0
47103,175,0,175,56,109,0,0,271,201,70,GOOOOOOOOOOOXXXXXXXXGOOOOOOOOOOOOOOOOOOXGOOOOOOOOOOOOXXXXXXXGOOOOOOOOOOOOOOOOOXXGOOOOOOOOOXXXXXXXXXXGOOOOOOOOOOOOOOOOOOOGOOOOOOOOXXXXXXXXXXXGOOOOOOOOOOOOOXXXXXXGOOOOOOOOOOOOOOOOOOOGOOOOOOXXXXXXXXXXXXXGOOOOOOOOOOOOXXXXXXXGOOOOOOOXXXXXXXXXXXXGOOOOOOOOOOOXXXXXXXX,0,256,0
47124,175,0,175,49,116,0,0,279,205,74,GOOOOOOOOOOOXXXXXXXXGOOOOOOOOOOOOOOOOOOXGOOOOOOOOOOOOXXXXXXXGOOOOOOOOOOOOOOOOOXXGOOOOOOOOOXXXXXXXXXXGOOOOOOOOOOOOOOOOOOOGOOOOOOOOXXXXXXXXXXXGOOOOOOOOOOOOOXXXXXXGOOOOOOOOOOOOOOOOOOOGOOOOOOXXXXXXXXXXXXXGOOOOOOOOOOOOXXXXXXXGOOOOOOOXXXXXXXXXXXXGOOOOOOOOOOOXXXXXXXX,0,256,0

47145,175,0,175,50,115,0,0,278,203,75,GOOOOOOOOOOOXXXXXXXXGOOOOOOOOOOOOOOOOOOXGOOOOOOOOOOOOXXXXXXXGOOOOOOOOOOOOOOOOOXXGOOOOOOOOOXXXXXXXXXXGOOOOOOOOOOOOOOOOOOOGOOOOOOOOXXXXXXXXXXXGOOOOOOOOOOOOOXXXXXXGOOOOOOOOOOOOOOOOOOOGOOOOOOXXXXXXXXXXXXXGOOOOOOOOOOOOXXXXXXXGOOOOOOOXXXXXXXXXXXXGOOOOOOOOOOOXXXXXXXX,0,256,0
47166,175,0,175,53,112,0,0,275,198,77,GOOOOOOOOOOOXXXXXXXXGOOOOOOOOOOOOOOOOOOXGOOOOOOOOOOOOXXXXXXXGOOOOOOOOOOOOOOOOOXXGOOOOOOOOOXXXXXXXXXXGOOOOOOOOOOOOOOOOOOOGOOOOOOOOXXXXXXXXXXXGOOOOOOOOOOOOOXXXXXXGOOOOOOOOOOOOOOOOOOOGOOOOOOXXXXXXXXXXXXXGOOOOOOOOOOOOXXXXXXXGOOOOOOOXXXXXXXXXXXXGOOOOOOOOOOOXXXXXXXX,0,256,0
47187,175,0,175,49,116,0,0,279,201,78,GOOOOOOOOOOOXXXXXXXXGOOOOOOOOOOOOOOOOOOXGOOOOOOOOOOOOXXXXXXXGOOOOOOOOOOOOOOOOOXXGOOOOOOOOOXXXXXXXXXXGOOOOOOOOOOOOOOOOOOOGOOOOOOOOXXXXXXXXXXXGOOOOOOOOOOOOOXXXXXXGOOOOOOOOOOOOOOOOOOOGOOOOOOXXXXXXXXXXXXXGOOOOOOOOOOOOXXXXXXXGOOOOOOOXXXXXXXXXXXXGOOOOOOOOOOOXXXXXXXX,0,256,0
47208,175,0,175,42,123,0,0,285,203,82,GOOOOOOOOOOOXXXXXXXXGOOOOOOOOOOOOOOOOOOXGOOOOOOOOOOOOXXXXXXXGOOOOOOOOOOOOOOOOOXXGOOOOOOOOOXXXXXXXXXXGOOOOOOOOOOOOOOOOOOOGOOOOOOOOXXXXXXXXXXXGOOOOOOOOOOOOOXXXXXXGOOOOOOOOOOOOOOOOOOOGOOOOOOXXXXXXXXXXXXXGOOOOOOOOOOOOXXXXXXXGOOOOOOOXXXXXXXXXXXXGOOOOOOOOOOOXXXXXXXX,0,256,0
47229,175,0,175,45,120,0,0,284,202,82,GOOOOOOOOOOOXXXXXXXXGOOOOOOOOOOOOOOOOOOXGOOOOOOOOOOOOXXXXXXXGOOOOOOOOOOOOOOOOOXXGOOOOOOOOOXXXXXXXXXXGOOOOOOOOOOOOOOOOOOOGOOOOOOOOXXXXXXXXXXXGOOOOOOOOOOOOOXXXXXXGOOOOOOOOOOOOOOOOOOOGOOOOOOXXXXXXXXXXXXXGOOOOOOOOOOOOXXXXXXXGOOOOOOOXXXXXXXXXXXXGOOOOOOOOOOOXXXXXXXX,0,256,0

47250,175,0,175,42,123,0,0,286,204,82,GOOOOOOOOOOOXXXXXXXXGOOOOOOOOOOOOOOOOOOXGOOOOOOOOOOOOXXXXXXXGOOOOOOOOOOOOOOOOOXXGOOOOOOOOOXXXXXXXXXXGOOOOOOOOOOOOOOOOOOOGOOOOOOOOXXXXXXXXXXXGOOOOOOOOOOOOOXXXXXXGOOOOOOOOOOOOOOOOOOOGOOOOOOXXXXXXXXXXXXXGOOOOOOOOOOOOXXXXXXXGOOOOOOOXXXXXXXXXXXXGOOOOOOOOOOOXXXXXXXX,0,256,0
47271,175,0,175,38,127,0,0,289,207,82,GOOOOOOOOOOOXXXXXXXXGOOOOOOOOOOOOOOOOOOXGOOOOOOOOOOOOXXXXXXXGOOOOOOOOOOOOOOOOOXXGOOOOOOOOOXXXXXXXXXXGOOOOOOOOOOOOOOOOOOOGOOOOOOOOXXXXXXXXXXXGOOOOOOOOOOOOOXXXXXXGOOOOOOOOOOOOOOOOOOOGOOOOOOXXXXXXXXXXXXXGOOOOOOOOOOOOXXXXXXXGOOOOOOOXXXXXXXXXXXXGOOOOOOOOOOOXXXXXXXX,0,256,0
47292,175,0,175,43,122,0,0,286,203,83,GOOOOOOOOOOOXXXXXXXXGOOOOOOOOOOOOOOOOOOXGOOOOOOOOOOOOXXXXXXXGOOOOOOOOOOOOOOOOOXXGOOOOOOOOOXXXXXXXXXXGOOOOOOOOOOOOOOOOOOOGOOOOOOOOXXXXXXXXXXXGOOOOOOOOOOOOOXXXXXXGOOOOOOOOOOOOOOOOOOOGOOOOOOXXXXXXXXXXXXXGOOOOOOOOOOOOXXXXXXXGOOOOOOOXXXXXXXXXXXXGOOOOOOOOOOOXXXXXXXX,0,256,0
47313,175,0,175,39,126,0,0,289,202,87,GOOOOOOOOOOOXXXXXXXXGOOOOOOOOOOOOOOOOOOXGOOOOOOOOOOOOXXXXXXXGOOOOOOOOOOOOOOOOOXXGOOOOOOOOOXXXXXXXXXXGOOOOOOOOOOOOOOOOOOOGOOOOOOOOXXXXXXXXXXXGOOOOOOOOOOOOOXXXXXXGOOOOOOOOOOOOOOOOOOOGOOOOOOXXXXXXXXXXXXXGOOOOOOOOOOOOXXXXXXXGOOOOOOOXXXXXXXXXXXXGOOOOOOOOOOOXXXXXXXX,0,256,0
47334,175,0,175,38,127,0,0,290,201,89,GOOOOOOOOOOOXXXXXXXXGOOOOOOOOOOOOOOOOOOXGOOOOOOOOOOOOXXXXXXXGOOOOOOOOOOOOOOOOOXXGOOOOOOOOOXXXXXXXXXXGOOOOOOOOOOOOOOOOOOOGOOOOOOOOXXXXXXXXXXXGOOOOOOOOOOOOOXXXXXXGOOOOOOOOOOOOOOOOOOOGOOOOOOXXXXXXXXXXXXXGOOOOOOOOOOOOXXXXXXXGOOOOOOOXXXXXXXXXXXXGOOOOOOOOOOOXXXXXXXX,0,256,0

47355,175,0,175,39,126,0,0,288,201,87,GOOOOOOOOOOOXXXXXXXXGOOOOOOOOOOOOOOOOOOXGOOOOOOOOOOOOXXXXXXXGOOOOOOOOOOOOOOOOOXXGOOOOOOOOOXXXXXXXXXXGOOOOOOOOOOOOOOOOOOOGOOOOOOOOXXXXXXXXXXXGOOOOOOOOOOOOOXXXXXXGOOOOOOOOOOOOOOOOOOOGOOOOOOXXXXXXXXXXXXXGOOOOOOOOOOOOXXXXXXXGOOOOOOOXXXXXXXXXXXXGOOOOOOOOOOOXXXXXXXX,0,256,0
47376,175,0,175,38,127,0,0,290,203,87,GOOOOOOOOOOOXXXXXXXXGOOOOOOOOOOOOOOOOOOXGOOOOOOOOOOOOXXXXXXXGOOOOOOOOOOOOOOOOOXXGOOOOOOOOOXXXXXXXXXXGOOOOOOOOOOOOOOOOOOOGOOOOOOOOXXXXXXXXXXXGOOOOOOOOOOOOOXXXXXXGOOOOOOOOOOOOOOOOOOOGOOOOOOXXXXXXXXXXXXXGOOOOOOOOOOOOXXXXXXXGOOOOOOOXXXXXXXXXXXXGOOOOOOOOOOOXXXXXXXX,0,256,0
47397,175,0,175,43,122,0,0,285,202,83,GOOOOOOOOOOOXXXXXXXXGOOOOOOOOOOOOOOOOOOXGOOOOOOOOOOOOXXXXXXXGOOOOOOOOOOOOOOOOOXXGOOOOOOOOOXXXXXXXXXXGOOOOOOOOOOOOOOOOOOOGOOOOOOOOXXXXXXXXXXXGOOOOOOOOOOOOOXXXXXXGOOOOOOOOOOOOOOOOOOOGOOOOOOXXXXXXXXXXXXXGOOOOOOOOOOOOXXXXXXXGOOOOOOOXXXXXXXXXXXXGOOOOOOOOOOOXXXXXXXX,0,256,0
47418,175,0,175,46,119,0,0,282,205,77,GOOOOOOOOOOOXXXXXXXXGOOOOOOOOOOOOOOOOOOXGOOOOOOOOOOOOXXXXXXXGOOOOOOOOOOOOOOOOOXXGOOOOOOOOOXXXXXXXXXXGOOOOOOOOOOOOOOOOOOOGOOOOOOOOXXXXXXXXXXXGOOOOOOOOOOOOOXXXXXXGOOOOOOOOOOOOOOOOOOOGOOOOOOXXXXXXXXXXXXXGOOOOOOOOOOOOXXXXXXXGOOOOOOOXXXXXXXXXXXXGOOOOOOOOOOOXXXXXXXX,0,256,0
47439,175,0,175,48,117,0,0,280,204,76,GOOOOOOOOOOOXXXXXXXXGOOOOOOOOOOOOOOOOOOXGOOOOOOOOOOOOXXXXXXXGOOOOOOOOOOOOOOOOOXXGOOOOOOOOOXXXXXXXXXXGOOOOOOOOOOOOOOOOOOOGOOOOOOOOXXXXXXXXXXXGOOOOOOOOOOOOOXXXXXXGOOOOOOOOOOOOOOOOOOOGOOOOOOXXXXXXXXXXXXXGOOOOOOOOOOOOXXXXXXXGOOOOOOOXXXXXXXXXXXXGOOOOOOOOOOOXXXXXXXX,0,256,0

47460,175,0,175,44,121,0,0,283,209,74,GOOOOOOOOOOOXXXXXXXXGOOOOOOOOOOOOOOOOOOXGOOOOOOOOOOOOXXXXXXXGOOOOOOOOOOOOOOOOOXXGOOOOOOOOOXXXXXXXXXXGOOOOOOOOOOOOOOOOOOOGOOOOOOOOXXXXXXXXXXXGOOOOOOOOOOOOOXXXXXXGOOOOOOOOOOOOOOOOOOOGOOOOOOXXXXXXXXXXXXXGOOOOOOOOOOOOXXXXXXXGOOOOOOOXXXXXXXXXXXXGOOOOOOOOOOOXXXXXXXX,0,256,0
47481,175,0,175,43,122,0,0,283,206,77,GOOOOOOOOOOOXXXXXXXXGOOOOOOOOOOOOOOOOOOXGOOOOOOOOOOOOXXXXXXXGOOOOOOOOOOOOOOOOOXXGOOOOOOOOOXXXXXXXXXXGOOOOOOOOOOOOOOOOOOOGOOOOOOOOXXXXXXXXXXXGOOOOOOOOOOOOOXXXXXXGOOOOOOOOOOOOOOOOOOOGOOOOOOXXXXXXXXXXXXXGOOOOOOOOOOOOXXXXXXXGOOOOOOOXXXXXXXXXXXXGOOOOOOOOOOOXXXXXXXX,0,256,0
47502,175,0,175,44,121,0,0,283,205,78,GOOOOOOOOOOOXXXXXXXXGOOOOOOOOOOOOOOOOOOXGOOOOOOOOOOOOXXXXXXXGOOOOOOOOOOOOOOOOOXXGOOOOOOOOOXXXXXXXXXXGOOOOOOOOOOOOOOOOOOOGOOOOOOOOXXXXXXXXXXXGOOOOOOOOOOOOOXXXXXXGOOOOOOOOOOOOOOOOOOOGOOOOOOXXXXXXXXXXXXXGOOOOOOOOOOOOXXXXXXXGOOOOOOOXXXXXXXXXXXXGOOOOOOOOOOOXXXXXXXX,0,256,0
47523,175,0,175,45,120,0,0,282,205,77,GOOOOOOOOOOOXXXXXXXXGOOOOOOOOOOOOOOOOOOXGOOOOOOOOOOOOXXXXXXXGOOOOOOOOOOOOOOOOOXXGOOOOOOOOOXXXXXXXXXXGOOOOOOOOOOOOOOOOOOOGOOOOOOOOXXXXXXXXXXXGOOOOOOOOOOOOOXXXXXXGOOOOOOOOOOOOOOOOOOOGOOOOOOXXXXXXXXXXXXXGOOOOOOOOOOOOXXXXXXXGOOOOOOOXXXXXXXXXXXXGOOOOOOOOOOOXXXXXXXX,0,256,0
47544,175,0,175,47,118,0,0,279,207,72,GOOOOOOOOOOOXXXXXXXXGOOOOOOOOOOOOOOOOOOXGOOOOOOOOOOOOXXXXXXXGOOOOOOOOOOOOOOOOOXXGOOOOOOOOOXXXXXXXXXXGOOOOOOOOOOOOOOOOOOOGOOOOOOOOXXXXXXXXXXXGOOOOOOOOOOOOOXXXXXXGOOOOOOOOOOOOOOOOOOOGOOOOOOXXXXXXXXXXXXXGOOOOOOOOOOOOXXXXXXXGOOOOOOOXXXXXXXXXXXXGOOOOOOOOOOOXXXXXXXX,0,256,0

47565,175,0,175,46,119,0,0,280,209,71,GOOOOOOOOOOOXXXXXXXXGOOOOOOOOOOOOOOOOOOXGOOOOOOOOOOOOXXXXXXXGOOOOOOOOOOOOOOOOOXXGOOOOOOOOOXXXXXXXXXXGOOOOOOOOOOOOOOOOOOOGOOOOOOOOXXXXXXXXXXXGOOOOOOOOOOOOOXXXXXXGOOOOOOOOOOOOOOOOOOOGOOOOOOXXXXXXXXXXXXXGOOOOOOOOOOOOXXXXXXXGOOOOOOOXXXXXXXXXXXXGOOOOOOOOOOOXXXXXXXX,0,256,0
47586,175,0,175,44,121,0,0,282,209,73,GOOOOOOOOOOOXXXXXXXXGOOOOOOOOOOOOOOOOOOXGOOOOOOOOOOOOXXXXXXXGOOOOOOOOOOOOOOOOOXXGOOOOOOOOOXXXXXXXXXXGOOOOOOOOOOOOOOOOOOOGOOOOOOOOXXXXXXXXXXXGOOOOOOOOOOOOOXXXXXXGOOOOOOOOOOOOOOOOOOOGOOOOOOXXXXXXXXXXXXXGOOOOOOOOOOOOXXXXXXXGOOOOOOOXXXXXXXXXXXXGOOOOOOOOOOOXXXXXXXX,0,256,0
47607,175,0,175,41,124,0,0,285,212,73,GOOOOOOOOOOOXXXXXXXXGOOOOOOOOOOOOOOOOOOXGOOOOOOOOOOOOXXXXXXXGOOOOOOOOOOOOOOOOOXXGOOOOOOOOOXXXXXXXXXXGOOOOOOOOOOOOOOOOOOOGOOOOOOOOXXXXXXXXXXXGOOOOOOOOOOOOOXXXXXXGOOOOOOOOOOOOOOOOOOOGOOOOOOXXXXXXXXXXXXXGOOOOOOOOOOOOXXXXXXXGOOOOOOOXXXXXXXXXXXXGOOOOOOOOOOOXXXXXXXX,0,256,0
47628,175,0,175,41,124,0,0,285,210,75,GOOOOOOOOOOOXXXXXXXXGOOOOOOOOOOOOOOOOOOXGOOOOOOOOOOOOXXXXXXXGOOOOOOOOOOOOOOOOOXXGOOOOOOOOOXXXXXXXXXXGOOOOOOOOOOOOOOOOOOOGOOOOOOOOXXXXXXXXXXXGOOOOOOOOOOOOOXXXXXXGOOOOOOOOOOOOOOOOOOOGOOOOOOXXXXXXXXXXXXXGOOOOOOOOOOOOXXXXXXXGOOOOOOOXXXXXXXXXXXXGOOOOOOOOOOOXXXXXXXX,0,256,0
47649,175,0,175,43,122,0,0,282,206,76,GOOOOOOOOOOOXXXXXXXXGOOOOOOOOOOOOOOOOOOXGOOOOOOOOOOOOXXXXXXXGOOOOOOOOOOOOOOOOOXXGOOOOOOOOOXXXXXXXXXXGOOOOOOOOOOOOOOOOOOOGOOOOOOOOXXXXXXXXXXXGOOOOOOOOOOOOOXXXXXXGOOOOOOOOOOOOOOOOOOOGOOOOOOXXXXXXXXXXXXXGOOOOOOOOOOOOXXXXXXXGOOOOOOOXXXXXXXXXXXXGOOOOOOOOOOOXXXXXXXX,0,256,0

47670,175,0,175,49,116,0,0,277,205,72,GOOOOOOOOOOOXXXXXXXXGOOOOOOOOOOOOOOOOOOXGOOOOOOOOOOOOXXXXXXXGOOOOOOOOOOOOOOOOOXXGOOOOOOOOOXXXXXXXXXXGOOOOOOOOOOOOOOOOOOOGOOOOOOOOXXXXXXXXXXXGOOOOOOOOOOOOOXXXXXXGOOOOOOOOOOOOOOOOOOOGOOOOOOXXXXXXXXXXXXXGOOOOOOOOOOOOXXXXXXXGOOOOOOOXXXXXXXXXXXXGOOOOOOOOOOOXXXXXXXX,0,256,0
47691,175,0,175,52,113,0,0,274,206,68,GOOOOOOOOOOOXXXXXXXXGOOOOOOOOOOOOOOOOOOXGOOOOOOOOOOOOXXXXXXXGOOOOOOOOOOOOOOOOOXXGOOOOOOOOOXXXXXXXXXXGOOOOOOOOOOOOOOOOOOOGOOOOOOOOXXXXXXXXXXXGOOOOOOOOOOOOOXXXXXXGOOOOOOOOOOOOOOOOOOOGOOOOOOXXXXXXXXXXXXXGOOOOOOOOOOOOXXXXXXXGOOOOOOOXXXXXXXXXXXXGOOOOOOOOOOOXXXXXXXX,0,256,0
47712,175,0,175,45,120,0,0,280,209,71,GOOOOOOOOOOOXXXXXXXXGOOOOOOOOOOOOOOOOOOXGOOOOOOOOOOOOXXXXXXXGOOOOOOOOOOOOOOOOOXXGOOOOOOOOOXXXXXXXXXXGOOOOOOOOOOOOOOOOOOOGOOOOOOOOXXXXXXXXXXXGOOOOOOOOOOOOOXXXXXXGOOOOOOOOOOOOOOOOOOOGOOOOOOXXXXXXXXXXXXXGOOOOOOOOOOOOXXXXXXXGOOOOOOOXXXXXXXXXXXXGOOOOOOOOOOOXXXXXXXX,0,256,0
47733,175,0,175,51,114,0,0,275,206,69,GOOOOOOOOOOOXXXXXXXXGOOOOOOOOOOOOOOOOOOXGOOOOOOOOOOOOXXXXXXXGOOOOOOOOOOOOOOOOOXXGOOOOOOOOOXXXXXXXXXXGOOOOOOOOOOOOOOOOOOOGOOOOOOOOXXXXXXXXXXXGOOOOOOOOOOOOOXXXXXXGOOOOOOOOOOOOOOOOOOOGOOOOOOXXXXXXXXXXXXXGOOOOOOOOOOOOXXXXXXXGOOOOOOOXXXXXXXXXXXXGOOOOOOOOOOOXXXXXXXX,0,256,0
47754,175,0,175,51,114,0,0,275,203,72,GOOOOOOOOOOOXXXXXXXXGOOOOOOOOOOOOOOOOOOXGOOOOOOOOOOOOXXXXXXXGOOOOOOOOOOOOOOOOOXXGOOOOOOOOOXXXXXXXXXXGOOOOOOOOOOOOOOOOOOOGOOOOOOOOXXXXXXXXXXXGOOOOOOOOOOOOOXXXXXXGOOOOOOOOOOOOOOOOOOOGOOOOOOXXXXXXXXXXXXXGOOOOOOOOOOOOXXXXXXXGOOOOOOOXXXXXXXXXXXXGOOOOOOOOOOOXXXXXXXX,0,256,0

47775,175,0,175,52,113,0,0,274,206,68,GOOOOOOOOOOOXXXXXXXXGOOOOOOOOOOOOOOOOOOXGOOOOOOOOOOOOXXXXXXXGOOOOOOOOOOOOOOOOOXXGOOOOOOOOOXXXXXXXXXXGOOOOOOOOOOOOOOOOOOOGOOOOOOOOXXXXXXXXXXXGOOOOOOOOOOOOOXXXXXXGOOOOOOOOOOOOOOOOOOOGOOOOOOXXXXXXXXXXXXXGOOOOOOOOOOOOXXXXXXXGOOOOOOOXXXXXXXXXXXXGOOOOOOOOOOOXXXXXXXX,0,256,0
47796,175,0,175,52,113,0,0,274,203,71,GOOOOOOOOOOOXXXXXXXXGOOOOOOOOOOOOOOOOOOXGOOOOOOOOOOOOXXXXXXXGOOOOOOOOOOOOOOOOOXXGOOOOOOOOOXXXXXXXXXXGOOOOOOOOOOOOOOOOOOOGOOOOOOOOXXXXXXXXXXXGOOOOOOOOOOOOOXXXXXXGOOOOOOOOOOOOOOOOOOOGOOOOOOXXXXXXXXXXXXXGOOOOOOOOOOOOXXXXXXXGOOOOOOOXXXXXXXXXXXXGOOOOOOOOOOOXXXXXXXX,0,256,0
47817,175,0,175,55,110,0,0,271,201,70,GOOOOOOOOOOOXXXXXXXXGOOOOOOOOOOOOOOOOOOXGOOOOOOOOOOOOXXXXXXXGOOOOOOOOOOOOOOOOOXXGOOOOOOOOOXXXXXXXXXXGOOOOOOOOOOOOOOOOOOOGOOOOOOOOXXXXXXXXXXXGOOOOOOOOOOOOOXXXXXXGOOOOOOOOOOOOOOOOOOOGOOOOOOXXXXXXXXXXXXXGOOOOOOOOOOOOXXXXXXXGOOOOOOOXXXXXXXXXXXXGOOOOOOOOOOOXXXXXXXX,0,256,0
47838,175,0,175,50,115,0,0,276,203,73,GOOOOOOOOOOOXXXXXXXXGOOOOOOOOOOOOOOOOOOXGOOOOOOOOOOOOXXXXXXXGOOOOOOOOOOOOOOOOOXXGOOOOOOOOOXXXXXXXXXXGOOOOOOOOOOOOOOOOOOOGOOOOOOOOXXXXXXXXXXXGOOOOOOOOOOOOOXXXXXXGOOOOOOOOOOOOOOOOOOOGOOOOOOXXXXXXXXXXXXXGOOOOOOOOOOOOXXXXXXXGOOOOOOOXXXXXXXXXXXXGOOOOOOOOOOOXXXXXXXX,0,256,0
47859,175,0,175,47,118,0,0,278,205,73,GOOOOOOOOOOOXXXXXXXXGOOOOOOOOOOOOOOOOOOXGOOOOOOOOOOOOXXXXXXXGOOOOOOOOOOOOOOOOOXXGOOOOOOOOOXXXXXXXXXXGOOOOOOOOOOOOOOOOOOOGOOOOOOOOXXXXXXXXXXXGOOOOOOOOOOOOOXXXXXXGOOOOOOOOOOOOOOOOOOOGOOOOOOXXXXXXXXXXXXXGOOOOOOOOOOOOXXXXXXXGOOOOOOOXXXXXXXXXXXXGOOOOOOOOOOOXXXXXXXX,0,256,0

47880,175,0,175,47,118,0,0,278,202,76,GOOOOOOOOOOOXXXXXXXXGOOOOOOOOOOOOOOOOOOXGOOOOOOOOOOOOXXXXXXXGOOOOOOOOOOOOOOOOOXXGOOOOOOOOOXXXXXXXXXXGOOOOOOOOOOOOOOOOOOOGOOOOOOOOXXXXXXXXXXXGOOOOOOOOOOOOOXXXXXXGOOOOOOOOOOOOOOOOOOOGOOOOOOXXXXXXXXXXXXXGOOOOOOOOOOOOXXXXXXXGOOOOOOOXXXXXXXXXXXXGOOOOOOOOOOOXXXXXXXX,0,256,0
47901,175,0,175,44,121,0,0,281,201,80,GOOOOOOOOOOOXXXXXXXXGOOOOOOOOOOOOOOOOOOXGOOOOOOOOOOOOXXXXXXXGOOOOOOOOOOOOOOOOOXXGOOOOOOOOOXXXXXXXXXXGOOOOOOOOOOOOOOOOOOOGOOOOOOOOXXXXXXXXXXXGOOOOOOOOOOOOOXXXXXXGOOOOOOOOOOOOOOOOOOOGOOOOOOXXXXXXXXXXXXXGOOOOOOOOOOOOXXXXXXXGOOOOOOOXXXXXXXXXXXXGOOOOOOOOOOOXXXXXXXX,0,256,0
47922,175,0,175,44,121,0,0,282,203,79,GOOOOOOOOOOOXXXXXXXXGOOOOOOOOOOOOOOOOOOXGOOOOOOOOOOOOXXXXXXXGOOOOOOOOOOOOOOOOOXXGOOOOOOOOOXXXXXXXXXXGOOOOOOOOOOOOOOOOOOOGOOOOOOOOXXXXXXXXXXXGOOOOOOOOOOOOOXXXXXXGOOOOOOOOOOOOOOOOOOOGOOOOOOXXXXXXXXXXXXXGOOOOOOOOOOOOXXXXXXXGOOOOOOOXXXXXXXXXXXXGOOOOOOOOOOOXXXXXXXX,0,256,0
47943,176,1,175,45,119,0,0,279,204,75,GOOOOOOOOOOOXXXXXXXXGOOOOOOOOOOOOOOOOOOXGOOOOOOOOOOOOXXXXXXXGOOOOOOOOOOOOOOOOOXXGOOOOOOOOOXXXXXXXXXXGOOOOOOOOOOOOOOOOOOOGOOOOOOOOXXXXXXXXXXXGOOOOOOOOOOOOOXXXXXXGOOOOOOOOOOOOOOOOOOOGOOOOOOXXXXXXXXXXXXXGOOOOOOOOOOOOAXXXXXXGOOOOOOOXXXXXXXXXXXXGOOOOOOOOOOOXXXXXXXX,0,256,0
47964,176,1,175,46,118,0,0,279,205,74,GOOOOOOOOOOOXXXXXXXXGOOOOOOOOOOOOOOOOOOXGOOOOOOOOOOOOXXXXXXXGOOOOOOOOOOOOOOOOOXXGOOOOOOOOOXXXXXXXXXXGOOOOOOOOOOOOOOOOOOOGOOOOOOOOXXXXXXXXXXXGOOOOOOOOOOOOOXXXXXXGOOOOOOOOOOOOOOOOOOOGOOOOOOXXXXXXXXXXXXXGOOOOOOOOOOOOAXXXXXXGOOOOOOOXXXXXXXXXXXXGOOOOOOOOOOOXXXXXXXX,0,256,0

47985,176,1,175,47,117,0,0,278,208,70,GOOOOOOOOOOOXXXXXXXXGOOOOOOOOOOOOOOOOOOXGOOOOOOOOOOOOXXXXXXXGOOOOOOOOOOOOOOOOOXXGOOOOOOOOOXXXXXXXXXXGOOOOOOOOOOOOOOOOOOOGOOOOOOOOXXXXXXXXXXXGOOOOOOOOOOOOOXXXXXXGOOOOOOOOOOOOOOOOOOOGOOOOOOXXXXXXXXXXXXXGOOOOOOOOOOOOAXXXXXXGOOOOOOOXXXXXXXXXXXXGOOOOOOOOOOOXXXXXXXX,0,256,0
48006,176,1,175,47,117,0,0,277,209,68,GOOOOOOOOOOOXXXXXXXXGOOOOOOOOOOOOOOOOOOXGOOOOOOOOOOOOXXXXXXXGOOOOOOOOOOOOOOOOOXXGOOOOOOOOOXXXXXXXXXXGOOOOOOOOOOOOOOOOOOOGOOOOOOOOXXXXXXXXXXXGOOOOOOOOOOOOOXXXXXXGOOOOOOOOOOOOOOOOOOOGOOOOOOXXXXXXXXXXXXXGOOOOOOOOOOOOAXXXXXXGOOOOOOOXXXXXXXXXXXXGOOOOOOOOOOOXXXXXXXX,0,256,0
48027,176,1,175,49,115,0,0,276,208,68,GOOOOOOOOOOOXXXXXXXXGOOOOOOOOOOOOOOOOOOXGOOOOOOOOOOOOXXXXXXXGOOOOOOOOOOOOOOOOOXXGOOOOOOOOOXXXXXXXXXXGOOOOOOOOOOOOOOOOOOOGOOOOOOOOXXXXXXXXXXXGOOOOOOOOOOOOOXXXXXXGOOOOOOOOOOOOOOOOOOOGOOOOOOXXXXXXXXXXXXXGOOOOOOOOOOOOAXXXXXXGOOOOOOOXXXXXXXXXXXXGOOOOOOOOOOOXXXXXXXX,0,256,0
48048,176,1,175,51,113,0,0,274,206,68,GOOOOOOOOOOOXXXXXXXXGOOOOOOOOOOOOOOOOOOXGOOOOOOOOOOOOXXXXXXXGOOOOOOOOOOOOOOOOOXXGOOOOOOOOOXXXXXXXXXXGOOOOOOOOOOOOOOOOOOOGOOOOOOOOXXXXXXXXXXXGOOOOOOOOOOOOOXXXXXXGOOOOOOOOOOOOOOOOOOOGOOOOOOXXXXXXXXXXXXXGOOOOOOOOOOOOAXXXXXXGOOOOOOOXXXXXXXXXXXXGOOOOOOOOOOOXXXXXXXX,0,256,0
48069,176,1,175,46,118,0,0,279,206,73,GOOOOOOOOOOOXXXXXXXXGOOOOOOOOOOOOOOOOOOXGOOOOOOOOOOOOXXXXXXXGOOOOOOOOOOOOOOOOOXXGOOOOOOOOOXXXXXXXXXXGOOOOOOOOOOOOOOOOOOOGOOOOOOOOXXXXXXXXXXXGOOOOOOOOOOOOOXXXXXXGOOOOOOOOOOOOOOOOOOOGOOOOOOXXXXXXXXXXXXXGOOOOOOOOOOOOAXXXXXXGOOOOOOOXXXXXXXXXXXXGOOOOOOOOOOOXXXXXXXX,0,256,0

48090,176,1,175,44,120,0,0,281,205,76,GOOOOOOOOOOOXXXXXXXXGOOOOOOOOOOOOOOOOOOXGOOOOOOOOOOOOXXXXXXXGOOOOOOOOOOOOOOOOOXXGOOOOOOOOOXXXXXXXXXXGOOOOOOOOOOOOOOOOOOOGOOOOOOOOXXXXXXXXXXXGOOOOOOOOOOOOOXXXXXXGOOOOOOOOOOOOOOOOOOOGOOOOOOXXXXXXXXXXXXXGOOOOOOOOOOOOAXXXXXXGOOOOOOOXXXXXXXXXXXXGOOOOOOOOOOOXXXXXXXX,0,256,0
48111,176,0,176,47,117,0,0,278,204,74,GOOOOOOOOOOOXXXXXXXXGOOOOOOOOOOOOOOOOOOXGOOOOOOOOOOOOXXXXXXXGOOOOOOOOOOOOOOOOOXXGOOOOOOOOOXXXXXXXXXXGOOOOOOOOOOOOOOOOOOOGOOOOOOOOXXXXXXXXXXXGOOOOOOOOOOOOOXXXXXXGOOOOOOOOOOOOOOOOOOOGOOOOOOXXXXXXXXXXXXXGOOOOOOOOOOOOOXXXXXXGOOOOOOOXXXXXXXXXXXXGOOOOOOOOOOOXXXXXXXX,0,256,0
48132,176,0,176,46,118,0,0,279,199,80,GOOOOOOOOOOOXXXXXXXXGOOOOOOOOOOOOOOOOOOXGOOOOOOOOOOOOXXXXXXXGOOOOOOOOOOOOOOOOOXXGOOOOOOOOOXXXXXXXXXXGOOOOOOOOOOOOOOOOOOOGOOOOOOOOXXXXXXXXXXXGOOOOOOOOOOOOOXXXXXXGOOOOOOOOOOOOOOOOOOOGOOOOOOXXXXXXXXXXXXXGOOOOOOOOOOOOOXXXXXXGOOOOOOOXXXXXXXXXXXXGOOOOOOOOOOOXXXXXXXX,0,256,0
48153,176,0,176,41,123,0,0,283,202,81,GOOOOOOOOOOOXXXXXXXXGOOOOOOOOOOOOOOOOOOXGOOOOOOOOOOOOXXXXXXXGOOOOOOOOOOOOOOOOOXXGOOOOOOOOOXXXXXXXXXXGOOOOOOOOOOOOOOOOOOOGOOOOOOOOXXXXXXXXXXXGOOOOOOOOOOOOOXXXXXXGOOOOOOOOOOOOOOOOOOOGOOOOOOXXXXXXXXXXXXXGOOOOOOOOOOOOOXXXXXXGOOOOOOOXXXXXXXXXXXXGOOOOOOOOOOOXXXXXXXX,0,256,0
48174,176,0,176,45,119,0,0,280,202,78,GOOOOOOOOOOOXXXXXXXXGOOOOOOOOOOOOOOOOOOXGOOOOOOOOOOOOXXXXXXXGOOOOOOOOOOOOOOOOOXXGOOOOOOOOOXXXXXXXXXXGOOOOOOOOOOOOOOOOOOOGOOOOOOOOXXXXXXXXXXXGOOOOOOOOOOOOOXXXXXXGOOOOOOOOOOOOOOOOOOOGOOOOOOXXXXXXXXXXXXXGOOOOOOOOOOOOOXXXXXXGOOOOOOOXXXXXXXXXXXXGOOOOOOOOOOOXXXXXXXX,0,256,0

48195,176,0,176,42,122,0,0,282,205,77,GOOOOOOOOOOOXXXXXXXXGOOOOOOOOOOOOOOOOOOXGOOOOOOOOOOOOXXXXXXXGOOOOOOOOOOOOOOOOOXXGOOOOOOOOOXXXXXXXXXXGOOOOOOOOOOOOOOOOOOOGOOOOOOOOXXXXXXXXXXXGOOOOOOOOOOOOOXXXXXXGOOOOOOOOOOOOOOOOOOOGOOOOOOXXXXXXXXXXXXXGOOOOOOOOOOOOOXXXXXXGOOOOOOOXXXXXXXXXXXXGOOOOOOOOOOOXXXXXXXX,0,256,0
48216,176,0,176,42,122,0,0,282,202,80,GOOOOOOOOOOOXXXXXXXXGOOOOOOOOOOOOOOOOOOXGOOOOOOOOOOOOXXXXXXXGOOOOOOOOOOOOOOOOOXXGOOOOOOOOOXXXXXXXXXXGOOOOOOOOOOOOOOOOOOOGOOOOOOOOXXXXXXXXXXXGOOOOOOOOOOOOOXXXXXXGOOOOOOOOOOOOOOOOOOOGOOOOOOXXXXXXXXXXXXXGOOOOOOOOOOOOOXXXXXXGOOOOOOOXXXXXXXXXXXXGOOOOOOOOOOOXXXXXXXX,0,256,0
48237,176,0,176,42,122,0,0,283,203,80,GOOOOOOOOOOOXXXXXXXXGOOOOOOOOOOOOOOOOOOXGOOOOOOOOOOOOXXXXXXXGOOOOOOOOOOOOOOOOOXXGOOOOOOOOOXXXXXXXXXXGOOOOOOOOOOOOOOOOOOOGOOOOOOOOXXXXXXXXXXXGOOOOOOOOOOOOOXXXXXXGOOOOOOOOOOOOOOOOOOOGOOOOOOXXXXXXXXXXXXXGOOOOOOOOOOOOOXXXXXXGOOOOOOOXXXXXXXXXXXXGOOOOOOOOOOOXXXXXXXX,0,256,0
48258,176,0,176,39,125,0,0,285,203,82,GOOOOOOOOOOOXXXXXXXXGOOOOOOOOOOOOOOOOOOXGOOOOOOOOOOOOXXXXXXXGOOOOOOOOOOOOOOOOOXXGOOOOOOOOOXXXXXXXXXXGOOOOOOOOOOOOOOOOOOOGOOOOOOOOXXXXXXXXXXXGOOOOOOOOOOOOOXXXXXXGOOOOOOOOOOOOOOOOOOOGOOOOOOXXXXXXXXXXXXXGOOOOOOOOOOOOOXXXXXXGOOOOOOOXXXXXXXXXXXXGOOOOOOOOOOOXXXXXXXX,0,256,0
48279,176,0,176,39,125,0,0,286,209,77,GOOOOOOOOOOOXXXXXXXXGOOOOOOOOOOOOOOOOOOXGOOOOOOOOOOOOXXXXXXXGOOOOOOOOOOOOOOOOOXXGOOOOOOOOOXXXXXXXXXXGOOOOOOOOOOOOOOOOOOOGOOOOOOOOXXXXXXXXXXXGOOOOOOOOOOOOOXXXXXXGOOOOOOOOOOOOOOOOOOOGOOOOOOXXXXXXXXXXXXXGOOOOOOOOOOOOOXXXXXXGOOOOOOOXXXXXXXXXXXXGOOOOOOOOOOOXXXXXXXX,0,256,0

48300,176,0,176,42,122,0,0,283,210,73,GOOOOOOOOOOOXXXXXXXXGOOOOOOOOOOOOOOOOOOXGOOOOOOOOOOOOXXXXXXXGOOOOOOOOOOOOOOOOOXXGOOOOOOOOOXXXXXXXXXXGOOOOOOOOOOOOOOOOOOOGOOOOOOOOXXXXXXXXXXXGOOOOOOOOOOOOOXXXXXXGOOOOOOOOOOOOOOOOOOOGOOOOOOXXXXXXXXXXXXXGOOOOOOOOOOOOOXXXXXXGOOOOOOOXXXXXXXXXXXXGOOOOOOOOOOOXXXXXXXX,0,256,0
48321,176,0,176,44,120,0,0,280,212,68,GOOOOOOOOOOOXXXXXXXXGOOOOOOOOOOOOOOOOOOXGOOOOOOOOOOOOXXXXXXXGOOOOOOOOOOOOOOOOOXXGOOOOOOOOOXXXXXXXXXXGOOOOOOOOOOOOOOOOOOOGOOOOOOOOXXXXXXXXXXXGOOOOOOOOOOOOOXXXXXXGOOOOOOOOOOOOOOOOOOOGOOOOOOXXXXXXXXXXXXXGOOOOOOOOOOOOOXXXXXXGOOOOOOOXXXXXXXXXXXXGOOOOOOOOOOOXXXXXXXX,0,256,0
48342,176,0,176,45,119,0,0,280,212,68,GOOOOOOOOOOOXXXXXXXXGOOOOOOOOOOOOOOOOOOXGOOOOOOOOOOOOXXXXXXXGOOOOOOOOOOOOOOOOOXXGOOOOOOOOOXXXXXXXXXXGOOOOOOOOOOOOOOOOOOOGOOOOOOOOXXXXXXXXXXXGOOOOOOOOOOOOOXXXXXXGOOOOOOOOOOOOOOOOOOOGOOOOOOXXXXXXXXXXXXXGOOOOOOOOOOOOOXXXXXXGOOOOOOOXXXXXXXXXXXXGOOOOOOOOOOOXXXXXXXX,0,256,0
48363,176,0,176,43,121,0,0,282,206,76,GOOOOOOOOOOOXXXXXXXXGOOOOOOOOOOOOOOOOOOXGOOOOOOOOOOOOXXXXXXXGOOOOOOOOOOOOOOOOOXXGOOOOOOOOOXXXXXXXXXXGOOOOOOOOOOOOOOOOOOOGOOOOOOOOXXXXXXXXXXXGOOOOOOOOOOOOOXXXXXXGOOOOOOOOOOOOOOOOOOOGOOOOOOXXXXXXXXXXXXXGOOOOOOOOOOOOOXXXXXXGOOOOOOOXXXXXXXXXXXXGOOOOOOOOOOOXXXXXXXX,0,256,0
48384,176,0,176,44,120,0,0,281,204,77,GOOOOOOOOOOOXXXXXXXXGOOOOOOOOOOOOOOOOOOXGOOOOOOOOOOOOXXXXXXXGOOOOOOOOOOOOOOOOOXXGOOOOOOOOOXXXXXXXXXXGOOOOOOOOOOOOOOOOOOOGOOOOOOOOXXXXXXXXXXXGOOOOOOOOOOOOOXXXXXXGOOOOOOOOOOOOOOOOOOOGOOOOOOXXXXXXXXXXXXXGOOOOOOOOOOOOOXXXXXXGOOOOOOOXXXXXXXXXXXXGOOOOOOOOOOOXXXXXXXX,0,256,0

48405,176,0,176,45,119,0,0,280,206,74,GOOOOOOOOOOOXXXXXXXXGOOOOOOOOOOOOOOOOOOXGOOOOOOOOOOOOXXXXXXXGOOOOOOOOOOOOOOOOOXXGOOOOOOOOOXXXXXXXXXXGOOOOOOOOOOOOOOOOOOOGOOOOOOOOXXXXXXXXXXXGOOOOOOOOOOOOOXXXXXXGOOOOOOOOOOOOOOOOOOOGOOOOOOXXXXXXXXXXXXXGOOOOOOOOOOOOOXXXXXXGOOOOOOOXXXXXXXXXXXXGOOOOOOOOOOOXXXXXXXX,0,256,0
48426,176,0,176,45,119,0,0,280,206,74,GOOOOOOOOOOOXXXXXXXXGOOOOOOOOOOOOOOOOOOXGOOOOOOOOOOOOXXXXXXXGOOOOOOOOOOOOOOOOOXXGOOOOOOOOOXXXXXXXXXXGOOOOOOOOOOOOOOOOOOOGOOOOOOOOXXXXXXXXXXXGOOOOOOOOOOOOOXXXXXXGOOOOOOOOOOOOOOOOOOOGOOOOOOXXXXXXXXXXXXXGOOOOOOOOOOOOOXXXXXXGOOOOOOOXXXXXXXXXXXXGOOOOOOOOOOOXXXXXXXX,0,256,0
48447,176,0,176,46,118,0,0,279,206,73,GOOOOOOOOOOOXXXXXXXXGOOOOOOOOOOOOOOOOOOXGOOOOOOOOOOOOXXXXXXXGOOOOOOOOOOOOOOOOOXXGOOOOOOOOOXXXXXXXXXXGOOOOOOOOOOOOOOOOOOOGOOOOOOOOXXXXXXXXXXXGOOOOOOOOOOOOOXXXXXXGOOOOOOOOOOOOOOOOOOOGOOOOOOXXXXXXXXXXXXXGOOOOOOOOOOOOOXXXXXXGOOOOOOOXXXXXXXXXXXXGOOOOOOOOOOOXXXXXXXX,0,256,0
48468,176,0,176,42,122,0,0,282,207,75,GOOOOOOOOOOOXXXXXXXXGOOOOOOOOOOOOOOOOOOXGOOOOOOOOOOOOXXXXXXXGOOOOOOOOOOOOOOOOOXXGOOOOOOOOOXXXXXXXXXXGOOOOOOOOOOOOOOOOOOOGOOOOOOOOXXXXXXXXXXXGOOOOOOOOOOOOOXXXXXXGOOOOOOOOOOOOOOOOOOOGOOOOOOXXXXXXXXXXXXXGOOOOOOOOOOOOOXXXXXXGOOOOOOOXXXXXXXXXXXXGOOOOOOOOOOOXXXXXXXX,0,256,0
48489,176,0,176,41,123,0,0,284,212,72,GOOOOOOOOOOOXXXXXXXXGOOOOOOOOOOOOOOOOOOXGOOOOOOOOOOOOXXXXXXXGOOOOOOOOOOOOOOOOOXXGOOOOOOOOOXXXXXXXXXXGOOOOOOOOOOOOOOOOOOOGOOOOOOOOXXXXXXXXXXXGOOOOOOOOOOOOOXXXXXXGOOOOOOOOOOOOOOOOOOOGOOOOOOXXXXXXXXXXXXXGOOOOOOOOOOOOOXXXXXXGOOOOOOOXXXXXXXXXXXXGOOOOOOOOOOOXXXXXXXX,0,256,0

48510,176,0,176,40,124,0,0,284,209,75,GOOOOOOOOOOOXXXXXXXXGOOOOOOOOOOOOOOOOOOXGOOOOOOOOOOOOXXXXXXXGOOOOOOOOOOOOOOOOOXXGOOOOOOOOOXXXXXXXXXXGOOOOOOOOOOOOOOOOOOOGOOOOOOOOXXXXXXXXXXXGOOOOOOOOOOOOOXXXXXXGOOOOOOOOOOOOOOOOOOOGOOOOOOXXXXXXXXXXXXXGOOOOOOOOOOOOOXXXXXXGOOOOOOOXXXXXXXXXXXXGOOOOOOOOOOOXXXXXXXX,0,256,0
48531,176,0,176,38,126,0,0,287,206,81,GOOOOOOOOOOOXXXXXXXXGOOOOOOOOOOOOOOOOOOXGOOOOOOOOOOOOXXXXXXXGOOOOOOOOOOOOOOOOOXXGOOOOOOOOOXXXXXXXXXXGOOOOOOOOOOOOOOOOOOOGOOOOOOOOXXXXXXXXXXXGOOOOOOOOOOOOOXXXXXXGOOOOOOOOOOOOOOOOOOOGOOOOOOXXXXXXXXXXXXXGOOOOOOOOOOOOOXXXXXXGOOOOOOOXXXXXXXXXXXXGOOOOOOOOOOOXXXXXXXX,0,256,0
48552,176,0,176,37,127,0,0,288,208,80,GOOOOOOOOOOOXXXXXXXXGOOOOOOOOOOOOOOOOOOXGOOOOOOOOOOOOXXXXXXXGOOOOOOOOOOOOOOOOOXXGOOOOOOOOOXXXXXXXXXXGOOOOOOOOOOOOOOOOOOOGOOOOOOOOXXXXXXXXXXXGOOOOOOOOOOOOOXXXXXXGOOOOOOOOOOOOOOOOOOOGOOOOOOXXXXXXXXXXXXXGOOOOOOOOOOOOOXXXXXXGOOOOOOOXXXXXXXXXXXXGOOOOOOOOOOOXXXXXXXX,0,256,0
48573,176,0,176,42,122,0,0,283,204,79,GOOOOOOOOOOOXXXXXXXXGOOOOOOOOOOOOOOOOOOXGOOOOOOOOOOOOXXXXXXXGOOOOOOOOOOOOOOOOOXXGOOOOOOOOOXXXXXXXXXXGOOOOOOOOOOOOOOOOOOOGOOOOOOOOXXXXXXXXXXXGOOOOOOOOOOOOOXXXXXXGOOOOOOOOOOOOOOOOOOOGOOOOOOXXXXXXXXXXXXXGOOOOOOOOOOOOOXXXXXXGOOOOOOOXXXXXXXXXXXXGOOOOOOOOOOOXXXXXXXX,0,256,0
48594,176,0,176,44,120,0,0,281,204,77,GOOOOOOOOOOOXXXXXXXXGOOOOOOOOOOOOOOOOOOXGOOOOOOOOOOOOXXXXXXXGOOOOOOOOOOOOOOOOOXXGOOOOOOOOOXXXXXXXXXXGOOOOOOOOOOOOOOOOOOOGOOOOOOOOXXXXXXXXXXXGOOOOOOOOOOOOOXXXXXXGOOOOOOOOOOOOOOOOOOOGOOOOOOXXXXXXXXXXXXXGOOOOOOOOOOOOOXXXXXXGOOOOOOOXXXXXXXXXXXXGOOOOOOOOOOOXXXXXXXX,0,256,0

48615,176,0,176,44,120,0,0,281,203,78,GOOOOOOOOOOOXXXXXXXXGOOOOOOOOOOOOOOOOOOXGOOOOOOOOOOOOXXXXXXXGOOOOOOOOOOOOOOOOOXXGOOOOOOOOOXXXXXXXXXXGOOOOOOOOOOOOOOOOOOOGOOOOOOOOXXXXXXXXXXXGOOOOOOOOOOOOOXXXXXXGOOOOOOOOOOOOOOOOOOOGOOOOOOXXXXXXXXXXXXXGOOOOOOOOOOOOOXXXXXXGOOOOOOOXXXXXXXXXXXXGOOOOOOOOOOOXXXXXXXX,0,256,0
48636,176,0,176,47,117,0,0,278,206,72,GOOOOOOOOOOOXXXXXXXXGOOOOOOOOOOOOOOOOOOXGOOOOOOOOOOOOXXXXXXXGOOOOOOOOOOOOOOOOOXXGOOOOOOOOOXXXXXXXXXXGOOOOOOOOOOOOOOOOOOOGOOOOOOOOXXXXXXXXXXXGOOOOOOOOOOOOOXXXXXXGOOOOOOOOOOOOOOOOOOOGOOOOOOXXXXXXXXXXXXXGOOOOOOOOOOOOOXXXXXXGOOOOOOOXXXXXXXXXXXXGOOOOOOOOOOOXXXXXXXX,0,256,0
48657,176,0,176,44,120,0,0,281,207,74,GOOOOOOOOOOOXXXXXXXXGOOOOOOOOOOOOOOOOOOXGOOOOOOOOOOOOXXXXXXXGOOOOOOOOOOOOOOOOOXXGOOOOOOOOOXXXXXXXXXXGOOOOOOOOOOOOOOOOOOOGOOOOOOOOXXXXXXXXXXXGOOOOOOOOOOOOOXXXXXXGOOOOOOOOOOOOOOOOOOOGOOOOOOXXXXXXXXXXXXXGOOOOOOOOOOOOOXXXXXXGOOOOOOOXXXXXXXXXXXXGOOOOOOOOOOOXXXXXXXX,0,256,0
48678,176,0,176,41,123,0,0,283,206,77,GOOOOOOOOOOOXXXXXXXXGOOOOOOOOOOOOOOOOOOXGOOOOOOOOOOOOXXXXXXXGOOOOOOOOOOOOOOOOOXXGOOOOOOOOOXXXXXXXXXXGOOOOOOOOOOOOOOOOOOOGOOOOOOOOXXXXXXXXXXXGOOOOOOOOOOOOOXXXXXXGOOOOOOOOOOOOOOOOOOOGOOOOOOXXXXXXXXXXXXXGOOOOOOOOOOOOOXXXXXXGOOOOOOOXXXXXXXXXXXXGOOOOOOOOOOOXXXXXXXX,0,256,0
48699,176,0,176,45,119,0,0,280,207,73,GOOOOOOOOOOOXXXXXXXXGOOOOOOOOOOOOOOOOOOXGOOOOOOOOOOOOXXXXXXXGOOOOOOOOOOOOOOOOOXXGOOOOOOOOOXXXXXXXXXXGOOOOOOOOOOOOOOOOOOOGOOOOOOOOXXXXXXXXXXXGOOOOOOOOOOOOOXXXXXXGOOOOOOOOOOOOOOOOOOOGOOOOOOXXXXXXXXXXXXXGOOOOOOOOOOOOOXXXXXXGOOOOOOOXXXXXXXXXXXXGOOOOOOOOOOOXXXXXXXX,0,256,0

48720,176,0,176,45,119,0,0,279,203,76,GOOOOOOOOOOOXXXXXXXXGOOOOOOOOOOOOOOOOOOXGOOOOOOOOOOOOXXXXXXXGOOOOOOOOOOOOOOOOOXXGOOOOOOOOOXXXXXXXXXXGOOOOOOOOOOOOOOOOOOOGOOOOOOOOXXXXXXXXXXXGOOOOOOOOOOOOOXXXXXXGOOOOOOOOOOOOOOOOOOOGOOOOOOXXXXXXXXXXXXXGOOOOOOOOOOOOOXXXXXXGOOOOOOOXXXXXXXXXXXXGOOOOOOOOOOOXXXXXXXX,0,256,0
48741,176,0,176,46,118,0,0,278,205,73,GOOOOOOOOOOOXXXXXXXXGOOOOOOOOOOOOOOOOOOXGOOOOOOOOOOOOXXXXXXXGOOOOOOOOOOOOOOOOOXXGOOOOOOOOOXXXXXXXXXXGOOOOOOOOOOOOOOOOOOOGOOOOOOOOXXXXXXXXXXXGOOOOOOOOOOOOOXXXXXXGOOOOOOOOOOOOOOOOOOOGOOOOOOXXXXXXXXXXXXXGOOOOOOOOOOOOOXXXXXXGOOOOOOOXXXXXXXXXXXXGOOOOOOOOOOOXXXXXXXX,0,256,0
48762,176,0,176,47,117,0,0,277,205,72,GOOOOOOOOOOOXXXXXXXXGOOOOOOOOOOOOOOOOOOXGOOOOOOOOOOOOXXXXXXXGOOOOOOOOOOOOOOOOOXXGOOOOOOOOOXXXXXXXXXXGOOOOOOOOOOOOOOOOOOOGOOOOOOOOXXXXXXXXXXXGOOOOOOOOOOOOOXXXXXXGOOOOOOOOOOOOOOOOOOOGOOOOOOXXXXXXXXXXXXXGOOOOOOOOOOOOOXXXXXXGOOOOOOOXXXXXXXXXXXXGOOOOOOOOOOOXXXXXXXX,0,256,0
48783,176,0,176,43,121,0,0,281,209,72,GOOOOOOOOOOOXXXXXXXXGOOOOOOOOOOOOOOOOOOXGOOOOOOOOOOOOXXXXXXXGOOOOOOOOOOOOOOOOOXXGOOOOOOOOOXXXXXXXXXXGOOOOOOOOOOOOOOOOOOOGOOOOOOOOXXXXXXXXXXXGOOOOOOOOOOOOOXXXXXXGOOOOOOOOOOOOOOOOOOOGOOOOOOXXXXXXXXXXXXXGOOOOOOOOOOOOOXXXXXXGOOOOOOOXXXXXXXXXXXXGOOOOOOOOOOOXXXXXXXX,0,256,0
48804,176,0,176,43,121,0,0,282,207,75,GOOOOOOOOOOOXXXXXXXXGOOOOOOOOOOOOOOOOOOXGOOOOOOOOOOOOXXXXXXXGOOOOOOOOOOOOOOOOOXXGOOOOOOOOOXXXXXXXXXXGOOOOOOOOOOOOOOOOOOOGOOOOOOOOXXXXXXXXXXXGOOOOOOOOOOOOOXXXXXXGOOOOOOOOOOOOOOOOOOOGOOOOOOXXXXXXXXXXXXXGOOOOOOOOOOOOOXXXXXXGOOOOOOOXXXXXXXXXXXXGOOOOOOOOOOOXXXXXXXX,0,256,0

48825,176,0,176,48,116,0,0,277,202,75,GOOOOOOOOOOOXXXXXXXXGOOOOOOOOOOOOOOOOOOXGOOOOOOOOOOOOXXXXXXXGOOOOOOOOOOOOOOOOOXXGOOOOOOOOOXXXXXXXXXXGOOOOOOOOOOOOOOOOOOOGOOOOOOOOXXXXXXXXXXXGOOOOOOOOOOOOOXXXXXXGOOOOOOOOOOOOOOOOOOOGOOOOOOXXXXXXXXXXXXXGOOOOOOOOOOOOOXXXXXXGOOOOOOOXXXXXXXXXXXXGOOOOOOOOOOOXXXXXXXX,0,256,0
48846,176,0,176,46,118,0,0,279,204,75,GOOOOOOOOOOOXXXXXXXXGOOOOOOOOOOOOOOOOOOXGOOOOOOOOOOOOXXXXXXXGOOOOOOOOOOOOOOOOOXXGOOOOOOOOOXXXXXXXXXXGOOOOOOOOOOOOOOOOOOOGOOOOOOOOXXXXXXXXXXXGOOOOOOOOOOOOOXXXXXXGOOOOOOOOOOOOOOOOOOOGOOOOOOXXXXXXXXXXXXXGOOOOOOOOOOOOOXXXXXXGOOOOOOOXXXXXXXXXXXXGOOOOOOOOOOOXXXXXXXX,0,256,0
48867,176,0,176,45,119,0,0,280,203,77,GOOOOOOOOOOOXXXXXXXXGOOOOOOOOOOOOOOOOOOXGOOOOOOOOOOOOXXXXXXXGOOOOOOOOOOOOOOOOOXXGOOOOOOOOOXXXXXXXXXXGOOOOOOOOOOOOOOOOOOOGOOOOOOOOXXXXXXXXXXXGOOOOOOOOOOOOOXXXXXXGOOOOOOOOOOOOOOOOOOOGOOOOOOXXXXXXXXXXXXXGOOOOOOOOOOOOOXXXXXXGOOOOOOOXXXXXXXXXXXXGOOOOOOOOOOOXXXXXXXX,0,256,0
48888,176,0,176,42,122,0,0,283,205,78,GOOOOOOOOOOOXXXXXXXXGOOOOOOOOOOOOOOOOOOXGOOOOOOOOOOOOXXXXXXXGOOOOOOOOOOOOOOOOOXXGOOOOOOOOOXXXXXXXXXXGOOOOOOOOOOOOOOOOOOOGOOOOOOOOXXXXXXXXXXXGOOOOOOOOOOOOOXXXXXXGOOOOOOOOOOOOOOOOOOOGOOOOOOXXXXXXXXXXXXXGOOOOOOOOOOOOOXXXXXXGOOOOOOOXXXXXXXXXXXXGOOOOOOOOOOOXXXXXXXX,0,256,0
48909,176,0,176,40,124,0,0,284,205,79,GOOOOOOOOOOOXXXXXXXXGOOOOOOOOOOOOOOOOOOXGOOOOOOOOOOOOXXXXXXXGOOOOOOOOOOOOOOOOOXXGOOOOOOOOOXXXXXXXXXXGOOOOOOOOOOOOOOOOOOOGOOOOOOOOXXXXXXXXXXXGOOOOOOOOOOOOOXXXXXXGOOOOOOOOOOOOOOOOOOOGOOOOOOXXXXXXXXXXXXXGOOOOOOOOOOOOOXXXXXXGOOOOOOOXXXXXXXXXXXXGOOOOOOOOOOOXXXXXXXX,0,256,0

48930,176,0,176,43,121,0,0,282,210,72,GOOOOOOOOOOOXXXXXXXXGOOOOOOOOOOOOOOOOOOXGOOOOOOOOOOOOXXXXXXXGOOOOOOOOOOOOOOOOOXXGOOOOOOOOOXXXXXXXXXXGOOOOOOOOOOOOOOOOOOOGOOOOOOOOXXXXXXXXXXXGOOOOOOOOOOOOOXXXXXXGOOOOOOOOOOOOOOOOOOOGOOOOOOXXXXXXXXXXXXXGOOOOOOOOOOOOOXXXXXXGOOOOOOOXXXXXXXXXXXXGOOOOOOOOOOOXXXXXXXX,0,256,0
48951,176,0,176,46,118,0,0,278,207,71,GOOOOOOOOOOOXXXXXXXXGOOOOOOOOOOOOOOOOOOXGOOOOOOOOOOOOXXXXXXXGOOOOOOOOOOOOOOOOOXXGOOOOOOOOOXXXXXXXXXXGOOOOOOOOOOOOOOOOOOOGOOOOOOOOXXXXXXXXXXXGOOOOOOOOOOOOOXXXXXXGOOOOOOOOOOOOOOOOOOOGOOOOOOXXXXXXXXXXXXXGOOOOOOOOOOOOOXXXXXXGOOOOOOOXXXXXXXXXXXXGOOOOOOOOOOOXXXXXXXX,0,256,0
48972,176,0,176,40,124,0,0,284,207,77,GOOOOOOOOOOOXXXXXXXXGOOOOOOOOOOOOOOOOOOXGOOOOOOOOOOOOXXXXXXXGOOOOOOOOOOOOOOOOOXXGOOOOOOOOOXXXXXXXXXXGOOOOOOOOOOOOOOOOOOOGOOOOOOOOXXXXXXXXXXXGOOOOOOOOOOOOOXXXXXXGOOOOOOOOOOOOOOOOOOOGOOOOOOXXXXXXXXXXXXXGOOOOOOOOOOOOOXXXXXXGOOOOOOOXXXXXXXXXXXXGOOOOOOOOOOOXXXXXXXX,0,256,0
48993,176,0,176,39,125,0,0,285,204,81,GOOOOOOOOOOOXXXXXXXXGOOOOOOOOOOOOOOOOOOXGOOOOOOOOOOOOXXXXXXXGOOOOOOOOOOOOOOOOOXXGOOOOOOOOOXXXXXXXXXXGOOOOOOOOOOOOOOOOOOOGOOOOOOOOXXXXXXXXXXXGOOOOOOOOOOOOOXXXXXXGOOOOOOOOOOOOOOOOOOOGOOOOOOXXXXXXXXXXXXXGOOOOOOOOOOOOOXXXXXXGOOOOOOOXXXXXXXXXXXXGOOOOOOOOOOOXXXXXXXX,0,256,0
49014,176,0,176,41,123,0,0,284,203,81,GOOOOOOOOOOOXXXXXXXXGOOOOOOOOOOOOOOOOOOXGOOOOOOOOOOOOXXXXXXXGOOOOOOOOOOOOOOOOOXXGOOOOOOOOOXXXXXXXXXXGOOOOOOOOOOOOOOOOOOOGOOOOOOOOXXXXXXXXXXXGOOOOOOOOOOOOOXXXXXXGOOOOOOOOOOOOOOOOOOOGOOOOOOXXXXXXXXXXXXXGOOOOOOOOOOOOOXXXXXXGOOOOOOOXXXXXXXXXXXXGOOOOOOOOOOOXXXXXXXX,0,256,0

49035,176,0,176,37,127,0,0,288,202,86,GOOOOOOOOOOOXXXXXXXXGOOOOOOOOOOOOOOOOOOXGOOOOOOOOOOOOXXXXXXXGOOOOOOOOOOOOOOOOOXXGOOOOOOOOOXXXXXXXXXXGOOOOOOOOOOOOOOOOOOOGOOOOOOOOXXXXXXXXXXXGOOOOOOOOOOOOOXXXXXXGOOOOOOOOOOOOOOOOOOOGOOOOOOXXXXXXXXXXXXXGOOOOOOOOOOOOOXXXXXXGOOOOOOOXXXXXXXXXXXXGOOOOOOOOOOOXXXXXXXX,0,256,0
49056,176,0,176,38,126,0,0,287,205,82,GOOOOOOOOOOOXXXXXXXXGOOOOOOOOOOOOOOOOOOXGOOOOOOOOOOOOXXXXXXXGOOOOOOOOOOOOOOOOOXXGOOOOOOOOOXXXXXXXXXXGOOOOOOOOOOOOOOOOOOOGOOOOOOOOXXXXXXXXXXXGOOOOOOOOOOOOOXXXXXXGOOOOOOOOOOOOOOOOOOOGOOOOOOXXXXXXXXXXXXXGOOOOOOOOOOOOOXXXXXXGOOOOOOOXXXXXXXXXXXXGOOOOOOOOOOOXXXXXXXX,0,256,0
49077,176,0,176,41,123,0,0,284,201,83,GOOOOOOOOOOOXXXXXXXXGOOOOOOOOOOOOOOOOOOXGOOOOOOOOOOOOXXXXXXXGOOOOOOOOOOOOOOOOOXXGOOOOOOOOOXXXXXXXXXXGOOOOOOOOOOOOOOOOOOOGOOOOOOOOXXXXXXXXXXXGOOOOOOOOOOOOOXXXXXXGOOOOOOOOOOOOOOOOOOOGOOOOOOXXXXXXXXXXXXXGOOOOOOOOOOOOOXXXXXXGOOOOOOOXXXXXXXXXXXXGOOOOOOOOOOOXXXXXXXX,0,256,0
49098,176,0,176,39,125,0,0,286,202,84,GOOOOOOOOOOOXXXXXXXXGOOOOOOOOOOOOOOOOOOXGOOOOOOOOOOOOXXXXXXXGOOOOOOOOOOOOOOOOOXXGOOOOOOOOOXXXXXXXXXXGOOOOOOOOOOOOOOOOOOOGOOOOOOOOXXXXXXXXXXXGOOOOOOOOOOOOOXXXXXXGOOOOOOOOOOOOOOOOOOOGOOOOOOXXXXXXXXXXXXXGOOOOOOOOOOOOOXXXXXXGOOOOOOOXXXXXXXXXXXXGOOOOOOOOOOOXXXXXXXX,0,256,0
49119,176,0,176,38,126,0,0,285,205,80,GOOOOOOOOOOOXXXXXXXXGOOOOOOOOOOOOOOOOOOXGOOOOOOOOOOOOXXXXXXXGOOOOOOOOOOOOOOOOOXXGOOOOOOOOOXXXXXXXXXXGOOOOOOOOOOOOOOOOOOOGOOOOOOOOXXXXXXXXXXXGOOOOOOOOOOOOOXXXXXXGOOOOOOOOOOOOOOOOOOOGOOOOOOXXXXXXXXXXXXXGOOOOOOOOOOOOOXXXXXXGOOOOOOOXXXXXXXXXXXXGOOOOOOOOOOOXXXXXXXX,0,256,0

49140,177,1,176,42,121,0,0,282,206,76,GOOOOOOOOOOOXXXXXXXXGOOOOOOOOOOOOOOOOOOXGOOOOOOOOOOOOXXXXXXXGOOOOOOOOOOOOOOOOOXXGOOOOOOOOOAXXXXXXXXXGOOOOOOOOOOOOOOOOOOOGOOOOOOOOXXXXXXXXXXXGOOOOOOOOOOOOOXXXXXXGOOOOOOOOOOOOOOOOOOOGOOOOOOXXXXXXXXXXXXXGOOOOOOOOOOOOOXXXXXXGOOOOOOOXXXXXXXXXXXXGOOOOOOOOOOOXXXXXXXX,0,256,0
49161,177,1,176,42,121,0,0,282,206,76,GOOOOOOOOOOOXXXXXXXXGOOOOOOOOOOOOOOOOOOXGOOOOOOOOOOOOXXXXXXXGOOOOOOOOOOOOOOOOOXXGOOOOOOOOOAXXXXXXXXXGOOOOOOOOOOOOOOOOOOOGOOOOOOOOXXXXXXXXXXXGOOOOOOOOOOOOOXXXXXXGOOOOOOOOOOOOOOOOOOOGOOOOOOXXXXXXXXXXXXXGOOOOOOOOOOOOOXXXXXXGOOOOOOOXXXXXXXXXXXXGOOOOOOOOOOOXXXXXXXX,0,256,0
49182,177,0,177,41,122,0,0,282,210,72,GOOOOOOOOOOOXXXXXXXXGOOOOOOOOOOOOOOOOOOXGOOOOOOOOOOOOXXXXXXXGOOOOOOOOOOOOOOOOOXXGOOOOOOOOOOXXXXXXXXXGOOOOOOOOOOOOOOOOOOOGOOOOOOOOXXXXXXXXXXXGOOOOOOOOOOOOOXXXXXXGOOOOOOOOOOOOOOOOOOOGOOOOOOXXXXXXXXXXXXXGOOOOOOOOOOOOOXXXXXXGOOOOOOOXXXXXXXXXXXXGOOOOOOOOOOOXXXXXXXX,0,256,0
49203,177,0,177,41,122,0,0,283,205,78,GOOOOOOOOOOOXXXXXXXXGOOOOOOOOOOOOOOOOOOXGOOOOOOOOOOOOXXXXXXXGOOOOOOOOOOOOOOOOOXXGOOOOOOOOOOXXXXXXXXXGOOOOOOOOOOOOOOOOOOOGOOOOOOOOXXXXXXXXXXXGOOOOOOOOOOOOOXXXXXXGOOOOOOOOOOOOOOOOOOOGOOOOOOXXXXXXXXXXXXXGOOOOOOOOOOOOOXXXXXXGOOOOOOOXXXXXXXXXXXXGOOOOOOOOOOOXXXXXXXX,0,256,0
49224,177,0,177,43,120,0,0,282,204,78,GOOOOOOOOOOOXXXXXXXXGOOOOOOOOOOOOOOOOOOXGOOOOOOOOOOOOXXXXXXXGOOOOOOOOOOOOOOOOOXXGOOOOOOOOOOXXXXXXXXXGOOOOOOOOOOOOOOOOOOOGOOOOOOOOXXXXXXXXXXXGOOOOOOOOOOOOOXXXXXXGOOOOOOOOOOOOOOOOOOOGOOOOOOXXXXXXXXXXXXXGOOOOOOOOOOOOOXXXXXXGOOOOOOOXXXXXXXXXXXXGOOOOOOOOOOOXXXXXXXX,0,256,0

49245,177,0,177,42,121,0,0,282,204,78,GOOOOOOOOOOOXXXXXXXXGOOOOOOOOOOOOOOOOOOXGOOOOOOOOOOOOXXXXXXXGOOOOOOOOOOOOOOOOOXXGOOOOOOOOOOXXXXXXXXXGOOOOOOOOOOOOOOOOOOOGOOOOOOOOXXXXXXXXXXXGOOOOOOOOOOOOOXXXXXXGOOOOOOOOOOOOOOOOOOOGOOOOOOXXXXXXXXXXXXXGOOOOOOOOOOOOOXXXXXXGOOOOOOOXXXXXXXXXXXXGOOOOOOOOOOOXXXXXXXX,0,256,0
49266,177,0,177,37,126,0,0,286,208,78,GOOOOOOOOOOOXXXXXXXXGOOOOOOOOOOOOOOOOOOXGOOOOOOOOOOOOXXXXXXXGOOOOOOOOOOOOOOOOOXXGOOOOOOOOOOXXXXXXXXXGOOOOOOOOOOOOOOOOOOOGOOOOOOOOXXXXXXXXXXXGOOOOOOOOOOOOOXXXXXXGOOOOOOOOOOOOOOOOOOOGOOOOOOXXXXXXXXXXXXXGOOOOOOOOOOOOOXXXXXXGOOOOOOOXXXXXXXXXXXXGOOOOOOOOOOOXXXXXXXX,0,256,0
49287,177,0,177,39,124,0,0,285,207,78,GOOOOOOOOOOOXXXXXXXXGOOOOOOOOOOOOOOOOOOXGOOOOOOOOOOOOXXXXXXXGOOOOOOOOOOOOOOOOOXXGOOOOOOOOOOXXXXXXXXXGOOOOOOOOOOOOOOOOOOOGOOOOOOOOXXXXXXXXXXXGOOOOOOOOOOOOOXXXXXXGOOOOOOOOOOOOOOOOOOOGOOOOOOXXXXXXXXXXXXXGOOOOOOOOOOOOOXXXXXXGOOOOOOOXXXXXXXXXXXXGOOOOOOOOOOOXXXXXXXX,0,256,0
49308,177,0,177,38,125,0,0,286,204,82,GOOOOOOOOOOOXXXXXXXXGOOOOOOOOOOOOOOOOOOXGOOOOOOOOOOOOXXXXXXXGOOOOOOOOOOOOOOOOOXXGOOOOOOOOOOXXXXXXXXXGOOOOOOOOOOOOOOOOOOOGOOOOOOOOXXXXXXXXXXXGOOOOOOOOOOOOOXXXXXXGOOOOOOOOOOOOOOOOOOOGOOOOOOXXXXXXXXXXXXXGOOOOOOOOOOOOOXXXXXXGOOOOOOOXXXXXXXXXXXXGOOOOOOOOOOOXXXXXXXX,0,256,0
49329,177,0,177,34,129,0,0,290,204,86,GOOOOOOOOOOOXXXXXXXXGOOOOOOOOOOOOOOOOOOXGOOOOOOOOOOOOXXXXXXXGOOOOOOOOOOOOOOOOOXXGOOOOOOOOOOXXXXXXXXXGOOOOOOOOOOOOOOOOOOOGOOOOOOOOXXXXXXXXXXXGOOOOOOOOOOOOOXXXXXXGOOOOOOOOOOOOOOOOOOOGOOOOOOXXXXXXXXXXXXXGOOOOOOOOOOOOOXXXXXXGOOOOOOOXXXXXXXXXXXXGOOOOOOOOOOOXXXXXXXX,0,256,0

49350,177,0,177,35,128,0,0,289,203,86,GOOOOOOOOOOOXXXXXXXXGOOOOOOOOOOOOOOOOOOXGOOOOOOOOOOOOXXXXXXXGOOOOOOOOOOOOOOOOOXXGOOOOOOOOOOXXXXXXXXXGOOOOOOOOOOOOOOOOOOOGOOOOOOOOXXXXXXXXXXXGOOOOOOOOOOOOOXXXXXXGOOOOOOOOOOOOOOOOOOOGOOOOOOXXXXXXXXXXXXXGOOOOOOOOOOOOOXXXXXXGOOOOOOOXXXXXXXXXXXXGOOOOOOOOOOOXXXXXXXX,0,256,0
49371,177,0,177,39,124,0,0,285,200,85,GOOOOOOOOOOOXXXXXXXXGOOOOOOOOOOOOOOOOOOXGOOOOOOOOOOOOXXXXXXXGOOOOOOOOOOOOOOOOOXXGOOOOOOOOOOXXXXXXXXXGOOOOOOOOOOOOOOOOOOOGOOOOOOOOXXXXXXXXXXXGOOOOOOOOOOOOOXXXXXXGOOOOOOOOOOOOOOOOOOOGOOOOOOXXXXXXXXXXXXXGOOOOOOOOOOOOOXXXXXXGOOOOOOOXXXXXXXXXXXXGOOOOOOOOOOOXXXXXXXX,0,256,0
49392,177,0,177,38,125,0,0,285,200,85,GOOOOOOOOOOOXXXXXXXXGOOOOOOOOOOOOOOOOOOXGOOOOOOOOOOOOXXXXXXXGOOOOOOOOOOOOOOOOOXXGOOOOOOOOOOXXXXXXXXXGOOOOOOOOOOOOOOOOOOOGOOOOOOOOXXXXXXXXXXXGOOOOOOOOOOOOOXXXXXXGOOOOOOOOOOOOOOOOOOOGOOOOOOXXXXXXXXXXXXXGOOOOOOOOOOOOOXXXXXXGOOOOOOOXXXXXXXXXXXXGOOOOOOOOOOOXXXXXXXX,0,256,0
49413,177,0,177,34,129,0,0,289,204,85,GOOOOOOOOOOOXXXXXXXXGOOOOOOOOOOOOOOOOOOXGOOOOOOOOOOOOXXXXXXXGOOOOOOOOOOOOOOOOOXXGOOOOOOOOOOXXXXXXXXXGOOOOOOOOOOOOOOOOOOOGOOOOOOOOXXXXXXXXXXXGOOOOOOOOOOOOOXXXXXXGOOOOOOOOOOOOOOOOOOOGOOOOOOXXXXXXXXXXXXXGOOOOOOOOOOOOOXXXXXXGOOOOOOOXXXXXXXXXXXXGOOOOOOOOOOOXXXXXXXX,0,256,0
49434,177,0,177,37,126,0,0,287,203,84,GOOOOOOOOOOOXXXXXXXXGOOOOOOOOOOOOOOOOOOXGOOOOOOOOOOOOXXXXXXXGOOOOOOOOOOOOOOOOOXXGOOOOOOOOOOXXXXXXXXXGOOOOOOOOOOOOOOOOOOOGOOOOOOOOXXXXXXXXXXXGOOOOOOOOOOOOOXXXXXXGOOOOOOOOOOOOOOOOOOOGOOOOOOXXXXXXXXXXXXXGOOOOOOOOOOOOOXXXXXXGOOOOOOOXXXXXXXXXXXXGOOOOOOOOOOOXXXXXXXX,0,256,0

49455,177,0,177,40,123,0,0,284,201,83,GOOOOOOOOOOOXXXXXXXXGOOOOOOOOOOOOOOOOOOXGOOOOOOOOOOOOXXXXXXXGOOOOOOOOOOOOOOOOOXXGOOOOOOOOOOXXXXXXXXXGOOOOOOOOOOOOOOOOOOOGOOOOOOOOXXXXXXXXXXXGOOOOOOOOOOOOOXXXXXXGOOOOOOOOOOOOOOOOOOOGOOOOOOXXXXXXXXXXXXXGOOOOOOOOOOOOOXXXXXXGOOOOOOOXXXXXXXXXXXXGOOOOOOOOOOOXXXXXXXX,0,256,0
49476,177,0,177,43,120,0,0,281,200,81,GOOOOOOOOOOOXXXXXXXXGOOOOOOOOOOOOOOOOOOXGOOOOOOOOOOOOXXXXXXXGOOOOOOOOOOOOOOOOOXXGOOOOOOOOOOXXXXXXXXXGOOOOOOOOOOOOOOOOOOOGOOOOOOOOXXXXXXXXXXXGOOOOOOOOOOOOOXXXXXXGOOOOOOOOOOOOOOOOOOOGOOOOOOXXXXXXXXXXXXXGOOOOOOOOOOOOOXXXXXXGOOOOOOOXXXXXXXXXXXXGOOOOOOOOOOOXXXXXXXX,0,256,0
49497,177,0,177,46,117,0,0,278,204,74,GOOOOOOOOOOOXXXXXXXXGOOOOOOOOOOOOOOOOOOXGOOOOOOOOOOOOXXXXXXXGOOOOOOOOOOOOOOOOOXXGOOOOOOOOOOXXXXXXXXXGOOOOOOOOOOOOOOOOOOOGOOOOOOOOXXXXXXXXXXXGOOOOOOOOOOOOOXXXXXXGOOOOOOOOOOOOOOOOOOOGOOOOOOXXXXXXXXXXXXXGOOOOOOOOOOOOOXXXXXXGOOOOOOOXXXXXXXXXXXXGOOOOOOOOOOOXXXXXXXX,0,256,0
49518,177,0,177,44,119,0,0,280,203,77,GOOOOOOOOOOOXXXXXXXXGOOOOOOOOOOOOOOOOOOXGOOOOOOOOOOOOXXXXXXXGOOOOOOOOOOOOOOOOOXXGOOOOOOOOOOXXXXXXXXXGOOOOOOOOOOOOOOOOOOOGOOOOOOOOXXXXXXXXXXXGOOOOOOOOOOOOOXXXXXXGOOOOOOOOOOOOOOOOOOOGOOOOOOXXXXXXXXXXXXXGOOOOOOOOOOOOOXXXXXXGOOOOOOOXXXXXXXXXXXXGOOOOOOOOOOOXXXXXXXX,0,256,0
49539,177,0,177,44,119,0,0,280,204,76,GOOOOOOOOOOOXXXXXXXXGOOOOOOOOOOOOOOOOOOXGOOOOOOOOOOOOXXXXXXXGOOOOOOOOOOOOOOOOOXXGOOOOOOOOOOXXXXXXXXXGOOOOOOOOOOOOOOOOOOOGOOOOOOOOXXXXXXXXXXXGOOOOOOOOOOOOOXXXXXXGOOOOOOOOOOOOOOOOOOOGOOOOOOXXXXXXXXXXXXXGOOOOOOOOOOOOOXXXXXXGOOOOOOOXXXXXXXXXXXXGOOOOOOOOOOOXXXXXXXX,0,256,0

49560,177,0,177,42,121,0,0,281,206,75,GOOOOOOOOOOOXXXXXXXXGOOOOOOOOOOOOOOOOOOXGOOOOOOOOOOOOXXXXXXXGOOOOOOOOOOOOOOOOOXXGOOOOOOOOOOXXXXXXXXXGOOOOOOOOOOOOOOOOOOOGOOOOOOOOXXXXXXXXXXXGOOOOOOOOOOOOOXXXXXXGOOOOOOOOOOOOOOOOOOOGOOOOOOXXXXXXXXXXXXXGOOOOOOOOOOOOOXXXXXXGOOOOOOOXXXXXXXXXXXXGOOOOOOOOOOOXXXXXXXX,0,256,0
49581,177,0,177,44,119,0,0,280,209,71,GOOOOOOOOOOOXXXXXXXXGOOOOOOOOOOOOOOOOOOXGOOOOOOOOOOOOXXXXXXXGOOOOOOOOOOOOOOOOOXXGOOOOOOOOOOXXXXXXXXXGOOOOOOOOOOOOOOOOOOOGOOOOOOOOXXXXXXXXXXXGOOOOOOOOOOOOOXXXXXXGOOOOOOOOOOOOOOOOOOOGOOOOOOXXXXXXXXXXXXXGOOOOOOOOOOOOOXXXXXXGOOOOOOOXXXXXXXXXXXXGOOOOOOOOOOOXXXXXXXX,0,256,0
49602,177,0,177,45,118,0,0,278,209,69,GOOOOOOOOOOOXXXXXXXXGOOOOOOOOOOOOOOOOOOXGOOOOOOOOOOOOXXXXXXXGOOOOOOOOOOOOOOOOOXXGOOOOOOOOOOXXXXXXXXXGOOOOOOOOOOOOOOOOOOOGOOOOOOOOXXXXXXXXXXXGOOOOOOOOOOOOOXXXXXXGOOOOOOOOOOOOOOOOOOOGOOOOOOXXXXXXXXXXXXXGOOOOOOOOOOOOOXXXXXXGOOOOOOOXXXXXXXXXXXXGOOOOOOOOOOOXXXXXXXX,0,256,0
49623,177,0,177,42,121,0,0,282,210,72,GOOOOOOOOOOOXXXXXXXXGOOOOOOOOOOOOOOOOOOXGOOOOOOOOOOOOXXXXXXXGOOOOOOOOOOOOOOOOOXXGOOOOOOOOOOXXXXXXXXXGOOOOOOOOOOOOOOOOOOOGOOOOOOOOXXXXXXXXXXXGOOOOOOOOOOOOOXXXXXXGOOOOOOOOOOOOOOOOOOOGOOOOOOXXXXXXXXXXXXXGOOOOOOOOOOOOOXXXXXXGOOOOOOOXXXXXXXXXXXXGOOOOOOOOOOOXXXXXXXX,0,256,0
49644,177,0,177,43,120,0,0,281,208,73,GOOOOOOOOOOOXXXXXXXXGOOOOOOOOOOOOOOOOOOXGOOOOOOOOOOOOXXXXXXXGOOOOOOOOOOOOOOOOOXXGOOOOOOOOOOXXXXXXXXXGOOOOOOOOOOOOOOOOOOOGOOOOOOOOXXXXXXXXXXXGOOOOOOOOOOOOOXXXXXXGOOOOOOOOOOOOOOOOOOOGOOOOOOXXXXXXXXXXXXXGOOOOOOOOOOOOOXXXXXXGOOOOOOOXXXXXXXXXXXXGOOOOOOOOOOOXXXXXXXX,0,256,0

49665,177,0,177,45,118,0,0,279,211,68,GOOOOOOOOOOOXXXXXXXXGOOOOOOOOOOOOOOOOOOXGOOOOOOOOOOOOXXXXXXXGOOOOOOOOOOOOOOOOOXXGOOOOOOOOOOXXXXXXXXXGOOOOOOOOOOOOOOOOOOOGOOOOOOOOXXXXXXXXXXXGOOOOOOOOOOOOOXXXXXXGOOOOOOOOOOOOOOOOOOOGOOOOOOXXXXXXXXXXXXXGOOOOOOOOOOOOOXXXXXXGOOOOOOOXXXXXXXXXXXXGOOOOOOOOOOOXXXXXXXX,0,256,0
49686,177,0,177,44,119,0,0,280,212,68,GOOOOOOOOOOOXXXXXXXXGOOOOOOOOOOOOOOOOOOXGOOOOOOOOOOOOXXXXXXXGOOOOOOOOOOOOOOOOOXXGOOOOOOOOOOXXXXXXXXXGOOOOOOOOOOOOOOOOOOOGOOOOOOOOXXXXXXXXXXXGOOOOOOOOOOOOOXXXXXXGOOOOOOOOOOOOOOOOOOOGOOOOOOXXXXXXXXXXXXXGOOOOOOOOOOOOOXXXXXXGOOOOOOOXXXXXXXXXXXXGOOOOOOOOOOOXXXXXXXX,0,256,0
49707,177,0,177,48,115,0,0,276,209,67,GOOOOOOOOOOOXXXXXXXXGOOOOOOOOOOOOOOOOOOXGOOOOOOOOOOOOXXXXXXXGOOOOOOOOOOOOOOOOOXXGOOOOOOOOOOXXXXXXXXXGOOOOOOOOOOOOOOOOOOOGOOOOOOOOXXXXXXXXXXXGOOOOOOOOOOOOOXXXXXXGOOOOOOOOOOOOOOOOOOOGOOOOOOXXXXXXXXXXXXXGOOOOOOOOOOOOOXXXXXXGOOOOOOOXXXXXXXXXXXXGOOOOOOOOOOOXXXXXXXX,0,256,0
49728,177,0,177,47,116,0,0,277,209,68,GOOOOOOOOOOOXXXXXXXXGOOOOOOOOOOOOOOOOOOXGOOOOOOOOOOOOXXXXXXXGOOOOOOOOOOOOOOOOOXXGOOOOOOOOOOXXXXXXXXXGOOOOOOOOOOOOOOOOOOOGOOOOOOOOXXXXXXXXXXXGOOOOOOOOOOOOOXXXXXXGOOOOOOOOOOOOOOOOOOOGOOOOOOXXXXXXXXXXXXXGOOOOOOOOOOOOOXXXXXXGOOOOOOOXXXXXXXXXXXXGOOOOOOOOOOOXXXXXXXX,0,256,0
49749,177,0,177,47,116,0,0,277,207,70,GOOOOOOOOOOOXXXXXXXXGOOOOOOOOOOOOOOOOOOXGOOOOOOOOOOOOXXXXXXXGOOOOOOOOOOOOOOOOOXXGOOOOOOOOOOXXXXXXXXXGOOOOOOOOOOOOOOOOOOOGOOOOOOOOXXXXXXXXXXXGOOOOOOOOOOOOOXXXXXXGOOOOOOOOOOOOOOOOOOOGOOOOOOXXXXXXXXXXXXXGOOOOOOOOOOOOOXXXXXXGOOOOOOOXXXXXXXXXXXXGOOOOOOOOOOOXXXXXXXX,0,256,0

49770,177,0,177,46,117,0,0,278,211,67,GOOOOOOOOOOOXXXXXXXXGOOOOOOOOOOOOOOOOOOXGOOOOOOOOOOOOXXXXXXXGOOOOOOOOOOOOOOOOOXXGOOOOOOOOOOXXXXXXXXXGOOOOOOOOOOOOOOOOOOOGOOOOOOOOXXXXXXXXXXXGOOOOOOOOOOOOOXXXXXXGOOOOOOOOOOOOOOOOOOOGOOOOOOXXXXXXXXXXXXXGOOOOOOOOOOOOOXXXXXXGOOOOOOOXXXXXXXXXXXXGOOOOOOOOOOOXXXXXXXX,0,256,0
49791,177,0,177,44,119,0,0,279,212,67,GOOOOOOOOOOOXXXXXXXXGOOOOOOOOOOOOOOOOOOXGOOOOOOOOOOOOXXXXXXXGOOOOOOOOOOOOOOOOOXXGOOOOOOOOOOXXXXXXXXXGOOOOOOOOOOOOOOOOOOOGOOOOOOOOXXXXXXXXXXXGOOOOOOOOOOOOOXXXXXXGOOOOOOOOOOOOOOOOOOOGOOOOOOXXXXXXXXXXXXXGOOOOOOOOOOOOOXXXXXXGOOOOOOOXXXXXXXXXXXXGOOOOOOOOOOOXXXXXXXX,0,256,0
49812,177,0,177,48,115,0,0,276,208,68,GOOOOOOOOOOOXXXXXXXXGOOOOOOOOOOOOOOOOOOXGOOOOOOOOOOOOXXXXXXXGOOOOOOOOOOOOOOOOOXXGOOOOOOOOOOXXXXXXXXXGOOOOOOOOOOOOOOOOOOOGOOOOOOOOXXXXXXXXXXXGOOOOOOOOOOOOOXXXXXXGOOOOOOOOOOOOOOOOOOOGOOOOOOXXXXXXXXXXXXXGOOOOOOOOOOOOOXXXXXXGOOOOOOOXXXXXXXXXXXXGOOOOOOOOOOOXXXXXXXX,0,256,0
49833,177,0,177,49,114,0,0,275,209,66,GOOOOOOOOOOOXXXXXXXXGOOOOOOOOOOOOOOOOOOXGOOOOOOOOOOOOXXXXXXXGOOOOOOOOOOOOOOOOOXXGOOOOOOOOOOXXXXXXXXXGOOOOOOOOOOOOOOOOOOOGOOOOOOOOXXXXXXXXXXXGOOOOOOOOOOOOOXXXXXXGOOOOOOOOOOOOOOOOOOOGOOOOOOXXXXXXXXXXXXXGOOOOOOOOOOOOOXXXXXXGOOOOOOOXXXXXXXXXXXXGOOOOOOOOOOOXXXXXXXX,0,256,0
49854,178,1,177,48,114,0,0,275,210,65,GOOOOOOOOOOOXXXXXXXXGOOOOOOOOOOOOOOOOOOXGOOOOOOOOOOOOXXXXXXXGOOOOOOOOOOOOOOOOOXXGOOOOOOOOOOXXXXXXXXXGOOOOOOOOOOOOOOOOOOOGOOOOOOOOXXXXXXXXXXXGOOOOOOOOOOOOOXXXXXXGOOOOOOOOOOOOOOOOOOOGOOOOOOXXXXXXXXXXXXXGOOOOOOOOOOOOOXXXXXXGOOOOOOOAXXXXXXXXXXXGOOOOOOOOOOOXXXXXXXX,0,256,0

49875,178,1,177,49,113,0,0,274,210,64,GOOOOOOOOOOOXXXXXXXXGOOOOOOOOOOOOOOOOOOXGOOOOOOOOOOOOXXXXXXXGOOOOOOOOOOOOOOOOOXXGOOOOOOOOOOXXXXXXXXXGOOOOOOOOOOOOOOOOOOOGOOOOOOOOXXXXXXXXXXXGOOOOOOOOOOOOOXXXXXXGOOOOOOOOOOOOOOOOOOOGOOOOOOXXXXXXXXXXXXXGOOOOOOOOOOOOOXXXXXXGOOOOOOOAXXXXXXXXXXXGOOOOOOOOOOOXXXXXXXX,0,256,0
49896,179,2,177,49,112,0,0,273,213,60,GOOOOOOOOOOOXXXXXXXXGOOOOOOOOOOOOOOOOOOXGOOOOOOOOOOOOXXXXXXXGOOOOOOOOOOOOOOOOOXXGOOOOOOOOOOAXXXXXXXXGOOOOOOOOOOOOOOOOOOOGOOOOOOOOXXXXXXXXXXXGOOOOOOOOOOOOOXXXXXXGOOOOOOOOOOOOOOOOOOOGOOOOOOXXXXXXXXXXXXXGOOOOOOOOOOOOOXXXXXXGOOOOOOOAXXXXXXXXXXXGOOOOOOOOOOOXXXXXXXX,0,256,0
49917,179,1,178,51,110,0,0,271,211,60,GOOOOOOOOOOOXXXXXXXXGOOOOOOOOOOOOOOOOOOXGOOOOOOOOOOOOXXXXXXXGOOOOOOOOOOOOOOOOOXXGOOOOOOOOOOAXXXXXXXXGOOOOOOOOOOOOOOOOOOOGOOOOOOOOXXXXXXXXXXXGOOOOOOOOOOOOOXXXXXXGOOOOOOOOOOOOOOOOOOOGOOOOOOXXXXXXXXXXXXXGOOOOOOOOOOOOOXXXXXXGOOOOOOOOXXXXXXXXXXXGOOOOOOOOOOOXXXXXXXX,0,256,0
49938,179,1,178,48,113,0,0,274,213,61,GOOOOOOOOOOOXXXXXXXXGOOOOOOOOOOOOOOOOOOXGOOOOOOOOOOOOXXXXXXXGOOOOOOOOOOOOOOOOOXXGOOOOOOOOOOAXXXXXXXXGOOOOOOOOOOOOOOOOOOOGOOOOOOOOXXXXXXXXXXXGOOOOOOOOOOOOOXXXXXXGOOOOOOOOOOOOOOOOOOOGOOOOOOXXXXXXXXXXXXXGOOOOOOOOOOOOOXXXXXXGOOOOOOOOXXXXXXXXXXXGOOOOOOOOOOOXXXXXXXX,0,256,0
49959,179,1,178,45,116,0,0,277,211,66,GOOOOOOOOOOOXXXXXXXXGOOOOOOOOOOOOOOOOOOXGOOOOOOOOOOOOXXXXXXXGOOOOOOOOOOOOOOOOOXXGOOOOOOOOOOAXXXXXXXXGOOOOOOOOOOOOOOOOOOOGOOOOOOOOXXXXXXXXXXXGOOOOOOOOOOOOOXXXXXXGOOOOOOOOOOOOOOOOOOOGOOOOOOXXXXXXXXXXXXXGOOOOOOOOOOOOOXXXXXXGOOOOOOOOXXXXXXXXXXXGOOOOOOOOOOOXXXXXXXX,0,256,0

