iterCounter, dimersInMT, activeDimersInMT, inactiveDimersInMT, activeDimersFree,inactiveDimersFree, longestProtoFilament, lengthOfMT, totalGTPs, activeGTPs,inactiveGTPs, mtRepresentation, DeHydro Katanins, Hydro Katanins, Bonded Katanins

21,0,0,0,0,0,0,0,0,0,0,XXXXXXXXXXXXXXXXXXXXXXXXXXXXXXXXXXXXXXXXXXXXXXXXXXXXXXXXXXXXXXXXXXXXXXXXXXXXXXXXXXXXXXXXXXXXXXXXXXXXXXXXXXXXXXXXXXXXXXXXXXXXXXXXXXXXXXXXXXXXXXXXXXXXXXXXXXXXXXXXXXXXXXXXXXXXXXXXXXXXXXXXXXXXXXXXXXXXXXXXXXXXXXXXXXXXXXXXXXXXXXXXXXXXXXXXXXXXXXXXXXXXXXXXXXXXXXXXXXXX,0,0,0
42,0,0,0,0,0,0,0,0,0,0,XXXXXXXXXXXXXXXXXXXXXXXXXXXXXXXXXXXXXXXXXXXXXXXXXXXXXXXXXXXXXXXXXXXXXXXXXXXXXXXXXXXXXXXXXXXXXXXXXXXXXXXXXXXXXXXXXXXXXXXXXXXXXXXXXXXXXXXXXXXXXXXXXXXXXXXXXXXXXXXXXXXXXXXXXXXXXXXXXXXXXXXXXXXXXXXXXXXXXXXXXXXXXXXXXXXXXXXXXXXXXXXXXXXXXXXXXXXXXXXXXXXXXXXXXXXXXXXXXXXX,0,0,0
63,0,0,0,0,0,0,0,0,0,0,XXXXXXXXXXXXXXXXXXXXXXXXXXXXXXXXXXXXXXXXXXXXXXXXXXXXXXXXXXXXXXXXXXXXXXXXXXXXXXXXXXXXXXXXXXXXXXXXXXXXXXXXXXXXXXXXXXXXXXXXXXXXXXXXXXXXXXXXXXXXXXXXXXXXXXXXXXXXXXXXXXXXXXXXXXXXXXXXXXXXXXXXXXXXXXXXXXXXXXXXXXXXXXXXXXXXXXXXXXXXXXXXXXXXXXXXXXXXXXXXXXXXXXXXXXXXXXXXXXXX,0,0,0
84,0,0,0,0,0,0,0,0,0,0,XXXXXXXXXXXXXXXXXXXXXXXXXXXXXXXXXXXXXXXXXXXXXXXXXXXXXXXXXXXXXXXXXXXXXXXXXXXXXXXXXXXXXXXXXXXXXXXXXXXXXXXXXXXXXXXXXXXXXXXXXXXXXXXXXXXXXXXXXXXXXXXXXXXXXXXXXXXXXXXXXXXXXXXXXXXXXXXXXXXXXXXXXXXXXXXXXXXXXXXXXXXXXXXXXXXXXXXXXXXXXXXXXXXXXXXXXXXXXXXXXXXXXXXXXXXXXXXXXXXX,0,0,0

105,0,0,0,0,600,0,0,300,0,300,XXXXXXXXXXXXXXXXXXXXXXXXXXXXXXXXXXXXXXXXXXXXXXXXXXXXXXXXXXXXXXXXXXXXXXXXXXXXXXXXXXXXXXXXXXXXXXXXXXXXXXXXXXXXXXXXXXXXXXXXXXXXXXXXXXXXXXXXXXXXXXXXXXXXXXXXXXXXXXXXXXXXXXXXXXXXXXXXXXXXXXXXXXXXXXXXXXXXXXXXXXXXXXXXXXXXXXXXXXXXXXXXXXXXXXXXXXXXXXXXXXXXXXXXXXXXXXXXXXXX,0,0,0
126,0,0,0,0,600,0,0,300,0,300,XXXXXXXXXXXXXXXXXXXXXXXXXXXXXXXXXXXXXXXXXXXXXXXXXXXXXXXXXXXXXXXXXXXXXXXXXXXXXXXXXXXXXXXXXXXXXXXXXXXXXXXXXXXXXXXXXXXXXXXXXXXXXXXXXXXXXXXXXXXXXXXXXXXXXXXXXXXXXXXXXXXXXXXXXXXXXXXXXXXXXXXXXXXXXXXXXXXXXXXXXXXXXXXXXXXXXXXXXXXXXXXXXXXXXXXXXXXXXXXXXXXXXXXXXXXXXXXXXXXX,0,0,0
147,0,0,0,0,600,0,0,300,0,300,XXXXXXXXXXXXXXXXXXXXXXXXXXXXXXXXXXXXXXXXXXXXXXXXXXXXXXXXXXXXXXXXXXXXXXXXXXXXXXXXXXXXXXXXXXXXXXXXXXXXXXXXXXXXXXXXXXXXXXXXXXXXXXXXXXXXXXXXXXXXXXXXXXXXXXXXXXXXXXXXXXXXXXXXXXXXXXXXXXXXXXXXXXXXXXXXXXXXXXXXXXXXXXXXXXXXXXXXXXXXXXXXXXXXXXXXXXXXXXXXXXXXXXXXXXXXXXXXXXXX,0,0,0
168,0,0,0,0,600,0,0,300,0,300,XXXXXXXXXXXXXXXXXXXXXXXXXXXXXXXXXXXXXXXXXXXXXXXXXXXXXXXXXXXXXXXXXXXXXXXXXXXXXXXXXXXXXXXXXXXXXXXXXXXXXXXXXXXXXXXXXXXXXXXXXXXXXXXXXXXXXXXXXXXXXXXXXXXXXXXXXXXXXXXXXXXXXXXXXXXXXXXXXXXXXXXXXXXXXXXXXXXXXXXXXXXXXXXXXXXXXXXXXXXXXXXXXXXXXXXXXXXXXXXXXXXXXXXXXXXXXXXXXXXX,0,0,0
189,0,0,0,0,600,0,0,300,0,300,XXXXXXXXXXXXXXXXXXXXXXXXXXXXXXXXXXXXXXXXXXXXXXXXXXXXXXXXXXXXXXXXXXXXXXXXXXXXXXXXXXXXXXXXXXXXXXXXXXXXXXXXXXXXXXXXXXXXXXXXXXXXXXXXXXXXXXXXXXXXXXXXXXXXXXXXXXXXXXXXXXXXXXXXXXXXXXXXXXXXXXXXXXXXXXXXXXXXXXXXXXXXXXXXXXXXXXXXXXXXXXXXXXXXXXXXXXXXXXXXXXXXXXXXXXXXXXXXXXXX,0,0,0

210,0,0,0,0,600,0,0,300,0,300,XXXXXXXXXXXXXXXXXXXXXXXXXXXXXXXXXXXXXXXXXXXXXXXXXXXXXXXXXXXXXXXXXXXXXXXXXXXXXXXXXXXXXXXXXXXXXXXXXXXXXXXXXXXXXXXXXXXXXXXXXXXXXXXXXXXXXXXXXXXXXXXXXXXXXXXXXXXXXXXXXXXXXXXXXXXXXXXXXXXXXXXXXXXXXXXXXXXXXXXXXXXXXXXXXXXXXXXXXXXXXXXXXXXXXXXXXXXXXXXXXXXXXXXXXXXXXXXXXXXX,0,0,0
231,0,0,0,0,600,0,0,300,0,300,XXXXXXXXXXXXXXXXXXXXXXXXXXXXXXXXXXXXXXXXXXXXXXXXXXXXXXXXXXXXXXXXXXXXXXXXXXXXXXXXXXXXXXXXXXXXXXXXXXXXXXXXXXXXXXXXXXXXXXXXXXXXXXXXXXXXXXXXXXXXXXXXXXXXXXXXXXXXXXXXXXXXXXXXXXXXXXXXXXXXXXXXXXXXXXXXXXXXXXXXXXXXXXXXXXXXXXXXXXXXXXXXXXXXXXXXXXXXXXXXXXXXXXXXXXXXXXXXXXXX,0,0,0
252,0,0,0,0,600,0,0,300,0,300,XXXXXXXXXXXXXXXXXXXXXXXXXXXXXXXXXXXXXXXXXXXXXXXXXXXXXXXXXXXXXXXXXXXXXXXXXXXXXXXXXXXXXXXXXXXXXXXXXXXXXXXXXXXXXXXXXXXXXXXXXXXXXXXXXXXXXXXXXXXXXXXXXXXXXXXXXXXXXXXXXXXXXXXXXXXXXXXXXXXXXXXXXXXXXXXXXXXXXXXXXXXXXXXXXXXXXXXXXXXXXXXXXXXXXXXXXXXXXXXXXXXXXXXXXXXXXXXXXXXX,0,0,0
273,0,0,0,0,600,0,0,300,0,300,XXXXXXXXXXXXXXXXXXXXXXXXXXXXXXXXXXXXXXXXXXXXXXXXXXXXXXXXXXXXXXXXXXXXXXXXXXXXXXXXXXXXXXXXXXXXXXXXXXXXXXXXXXXXXXXXXXXXXXXXXXXXXXXXXXXXXXXXXXXXXXXXXXXXXXXXXXXXXXXXXXXXXXXXXXXXXXXXXXXXXXXXXXXXXXXXXXXXXXXXXXXXXXXXXXXXXXXXXXXXXXXXXXXXXXXXXXXXXXXXXXXXXXXXXXXXXXXXXXXX,0,0,0
294,0,0,0,0,600,0,0,300,0,300,XXXXXXXXXXXXXXXXXXXXXXXXXXXXXXXXXXXXXXXXXXXXXXXXXXXXXXXXXXXXXXXXXXXXXXXXXXXXXXXXXXXXXXXXXXXXXXXXXXXXXXXXXXXXXXXXXXXXXXXXXXXXXXXXXXXXXXXXXXXXXXXXXXXXXXXXXXXXXXXXXXXXXXXXXXXXXXXXXXXXXXXXXXXXXXXXXXXXXXXXXXXXXXXXXXXXXXXXXXXXXXXXXXXXXXXXXXXXXXXXXXXXXXXXXXXXXXXXXXXX,0,0,0

315,0,0,0,5,595,0,0,295,9,286,XXXXXXXXXXXXXXXXXXXXXXXXXXXXXXXXXXXXXXXXXXXXXXXXXXXXXXXXXXXXXXXXXXXXXXXXXXXXXXXXXXXXXXXXXXXXXXXXXXXXXXXXXXXXXXXXXXXXXXXXXXXXXXXXXXXXXXXXXXXXXXXXXXXXXXXXXXXXXXXXXXXXXXXXXXXXXXXXXXXXXXXXXXXXXXXXXXXXXXXXXXXXXXXXXXXXXXXXXXXXXXXXXXXXXXXXXXXXXXXXXXXXXXXXXXXXXXXXXXXX,0,0,0
336,0,0,0,25,575,0,0,275,11,264,XXXXXXXXXXXXXXXXXXXXXXXXXXXXXXXXXXXXXXXXXXXXXXXXXXXXXXXXXXXXXXXXXXXXXXXXXXXXXXXXXXXXXXXXXXXXXXXXXXXXXXXXXXXXXXXXXXXXXXXXXXXXXXXXXXXXXXXXXXXXXXXXXXXXXXXXXXXXXXXXXXXXXXXXXXXXXXXXXXXXXXXXXXXXXXXXXXXXXXXXXXXXXXXXXXXXXXXXXXXXXXXXXXXXXXXXXXXXXXXXXXXXXXXXXXXXXXXXXXXX,0,0,0
357,0,0,0,48,552,0,0,252,18,234,XXXXXXXXXXXXXXXXXXXXXXXXXXXXXXXXXXXXXXXXXXXXXXXXXXXXXXXXXXXXXXXXXXXXXXXXXXXXXXXXXXXXXXXXXXXXXXXXXXXXXXXXXXXXXXXXXXXXXXXXXXXXXXXXXXXXXXXXXXXXXXXXXXXXXXXXXXXXXXXXXXXXXXXXXXXXXXXXXXXXXXXXXXXXXXXXXXXXXXXXXXXXXXXXXXXXXXXXXXXXXXXXXXXXXXXXXXXXXXXXXXXXXXXXXXXXXXXXXXXX,0,0,0
378,0,0,0,71,529,0,0,229,13,216,XXXXXXXXXXXXXXXXXXXXXXXXXXXXXXXXXXXXXXXXXXXXXXXXXXXXXXXXXXXXXXXXXXXXXXXXXXXXXXXXXXXXXXXXXXXXXXXXXXXXXXXXXXXXXXXXXXXXXXXXXXXXXXXXXXXXXXXXXXXXXXXXXXXXXXXXXXXXXXXXXXXXXXXXXXXXXXXXXXXXXXXXXXXXXXXXXXXXXXXXXXXXXXXXXXXXXXXXXXXXXXXXXXXXXXXXXXXXXXXXXXXXXXXXXXXXXXXXXXXX,0,0,0
399,0,0,0,96,504,0,0,204,12,192,XXXXXXXXXXXXXXXXXXXXXXXXXXXXXXXXXXXXXXXXXXXXXXXXXXXXXXXXXXXXXXXXXXXXXXXXXXXXXXXXXXXXXXXXXXXXXXXXXXXXXXXXXXXXXXXXXXXXXXXXXXXXXXXXXXXXXXXXXXXXXXXXXXXXXXXXXXXXXXXXXXXXXXXXXXXXXXXXXXXXXXXXXXXXXXXXXXXXXXXXXXXXXXXXXXXXXXXXXXXXXXXXXXXXXXXXXXXXXXXXXXXXXXXXXXXXXXXXXXXX,0,0,0

420,1,1,0,117,482,0,0,182,22,160,XXXXXXXXXXXXXXXXXXXXXXXXXXXXXXXXXXXXXXXXXXXXXXXXXXXXXXXXXXXXXXXXXXXXXXXXXXXXXXXXGXXXXXXXXXXXXXXXXXXXXXXXXXXXXXXXXXXXXXXXXXXXXXXXXXXXXXXXXXXXXXXXXXXXXXXXXXXXXXXXXXXXXXXXXXXXXXXXXXXXXXXXXXXXXXXXXXXXXXXXXXXXXXXXXXXXXXXXXXXXXXXXXXXXXXXXXXXXXXXXXXXXXXXXXXXXXXXXXXXX,0,0,0
441,2,2,0,140,458,0,0,158,14,144,XXXXXXXXXXXXXXXXXXXXXXXXXXXXXXXXXXXXXXXXXXXXXXXXXXXXXXXXXXXXXXXXXXXXXXXXXXXXXXXXGXXXXXXXXXXXXXXXXXXXXXXXXXXXXXXXXXXXXXXXXXXXXXXXXXXXXXXXXXXXXXXXXXXXXXXXXXXXXXXXXXXXXXXXXXXXXXXXXXXXXXXXXXXXXXXXXXXXXXXXGXXXXXXXXXXXXXXXXXXXXXXXXXXXXXXXXXXXXXXXXXXXXXXXXXXXXXXXXXXX,0,0,0
462,3,3,0,161,436,0,0,136,13,123,XXXXXXXXXXXXXXXXXXXXXXXXXXXXXXXXXXXXXXXXXXXXXXXXXXXXXXXXXXXXXXXXXXXXXXXXXXXXXXXXGXXXXXXXXXXXXXXXXXXXXXXXXXXXXXXXXXXXXXXXXXXXXXXXXXXXXXXXXXXXXXXXXXXXXXXXXXXXXXXXXXXXXXXXXXXXXXXXXXXXXXXXXXXXXXXXXXXXXXXXGXXXXXXXXXXXXXXXXXXXGXXXXXXXXXXXXXXXXXXXXXXXXXXXXXXXXXXXXXXX,0,0,0
483,3,3,0,178,419,0,0,119,15,104,XXXXXXXXXXXXXXXXXXXXXXXXXXXXXXXXXXXXXXXXXXXXXXXXXXXXXXXXXXXXXXXXXXXXXXXXXXXXXXXXGXXXXXXXXXXXXXXXXXXXXXXXXXXXXXXXXXXXXXXXXXXXXXXXXXXXXXXXXXXXXXXXXXXXXXXXXXXXXXXXXXXXXXXXXXXXXXXXXXXXXXXXXXXXXXXXXXXXXXXXGXXXXXXXXXXXXXXXXXXXGXXXXXXXXXXXXXXXXXXXXXXXXXXXXXXXXXXXXXXX,0,0,0
504,6,6,0,192,402,0,0,102,18,84,GXXXXXXXXXXXXXXXXXXXGXXXXXXXXXXXXXXXXXXXXXXXXXXXXXXXXXXXXXXXXXXXXXXXXXXXXXXXXXXXGXXXXXXXXXXXXXXXXXXXXXXXXXXXXXXXXXXXXXXXXXXXXXXXXXXXXXXXXXXXXXXXXXXXXXXXXXXXXXXXXXXXXXXXXXXXXXXXXXXXXXXXXXXXXXXXXXXXXXXXGXXXXXXXXXXXXXXXXXXXGAXXXXXXXXXXXXXXXXXXXXXXXXXXXXXXXXXXXXXX,0,0,0

525,6,6,0,214,380,0,0,80,21,59,GXXXXXXXXXXXXXXXXXXXGXXXXXXXXXXXXXXXXXXXXXXXXXXXXXXXXXXXXXXXXXXXXXXXXXXXXXXXXXXXGXXXXXXXXXXXXXXXXXXXXXXXXXXXXXXXXXXXXXXXXXXXXXXXXXXXXXXXXXXXXXXXXXXXXXXXXXXXXXXXXXXXXXXXXXXXXXXXXXXXXXXXXXXXXXXXXXXXXXXXGXXXXXXXXXXXXXXXXXXXGAXXXXXXXXXXXXXXXXXXXXXXXXXXXXXXXXXXXXXX,0,0,0
546,10,10,0,222,368,0,0,68,24,44,GXXXXXXXXXXXXXXXXXXXGXXXXXXXXXXXXXXXXXXXXXXXXXXXXXXXXXXXXXXXXXXXXXXXXXXXXXXXXXXXGAXXXXXXXXXXXXXXXXXXXXXXXXXXXXXXXXXXXXXXGXXXXXXXXXXXXXXXXXXXXXXXXXXXXXXXXXXXXXXXXXXXXXXXXXXXXXXXXXXXGXXXXXXXXXXXXXXXXXXXGXXXXXXXXXXXXXXXXXXXGAXXXXXXXXXXXXXXXXXXGXXXXXXXXXXXXXXXXXXX,0,0,0
567,12,12,0,241,347,0,0,46,10,36,GXXXXXXXXXXXXXXXXXXXGXXXXXXXXXXXXXXXXXXXGXXXXXXXXXXXXXXXXXXXGXXXXXXXXXXXXXXXXXXXGAXXXXXXXXXXXXXXXXXXXXXXXXXXXXXXXXXXXXXXGXXXXXXXXXXXXXXXXXXXXXXXXXXXXXXXXXXXXXXXXXXXXXXXXXXXXXXXXXXXGXXXXXXXXXXXXXXXXXXXGXXXXXXXXXXXXXXXXXXXGAXXXXXXXXXXXXXXXXXXGXXXXXXXXXXXXXXXXXXX,0,0,0
588,13,13,0,247,340,0,0,40,21,19,GXXXXXXXXXXXXXXXXXXXGXXXXXXXXXXXXXXXXXXXGXXXXXXXXXXXXXXXXXXXGXXXXXXXXXXXXXXXXXXXGAXXXXXXXXXXXXXXXXXXXXXXXXXXXXXXXXXXXXXXGXXXXXXXXXXXXXXXXXXXXXXXXXXXXXXXXXXXXXXXGXXXXXXXXXXXXXXXXXXXGXXXXXXXXXXXXXXXXXXXGXXXXXXXXXXXXXXXXXXXGAXXXXXXXXXXXXXXXXXXGXXXXXXXXXXXXXXXXXXX,0,0,0
609,14,13,1,262,324,0,0,24,9,15,GXXXXXXXXXXXXXXXXXXXGXXXXXXXXXXXXXXXXXXXGXXXXXXXXXXXXXXXXXXXGXXXXXXXXXXXXXXXXXXXGAXXXXXXXXXXXXXXXXXXGXXXXXXXXXXXXXXXXXXXGXXXXXXXXXXXXXXXXXXXXXXXXXXXXXXXXXXXXXXXGXXXXXXXXXXXXXXXXXXXGXXXXXXXXXXXXXXXXXXXGXXXXXXXXXXXXXXXXXXXGAXXXXXXXXXXXXXXXXXXGXXXXXXXXXXXXXXXXXXX,0,0,0

630,14,12,2,259,327,0,0,27,6,21,GXXXXXXXXXXXXXXXXXXXGXXXXXXXXXXXXXXXXXXXGXXXXXXXXXXXXXXXXXXXGXXXXXXXXXXXXXXXXXXXGOXXXXXXXXXXXXXXXXXXGXXXXXXXXXXXXXXXXXXXGXXXXXXXXXXXXXXXXXXXXXXXXXXXXXXXXXXXXXXXGXXXXXXXXXXXXXXXXXXXGXXXXXXXXXXXXXXXXXXXGXXXXXXXXXXXXXXXXXXXGAXXXXXXXXXXXXXXXXXXGXXXXXXXXXXXXXXXXXXX,0,0,0
651,15,12,3,254,331,0,0,31,2,29,GXXXXXXXXXXXXXXXXXXXGXXXXXXXXXXXXXXXXXXXGXXXXXXXXXXXXXXXXXXXGXXXXXXXXXXXXXXXXXXXGOXXXXXXXXXXXXXXXXXXGXXXXXXXXXXXXXXXXXXXGXXXXXXXXXXXXXXXXXXXGXXXXXXXXXXXXXXXXXXXGXXXXXXXXXXXXXXXXXXXGXXXXXXXXXXXXXXXXXXXGXXXXXXXXXXXXXXXXXXXGAXXXXXXXXXXXXXXXXXXGXXXXXXXXXXXXXXXXXXX,0,0,0
672,15,12,3,246,339,0,0,39,2,37,GXXXXXXXXXXXXXXXXXXXGXXXXXXXXXXXXXXXXXXXGXXXXXXXXXXXXXXXXXXXGXXXXXXXXXXXXXXXXXXXGOXXXXXXXXXXXXXXXXXXGXXXXXXXXXXXXXXXXXXXGXXXXXXXXXXXXXXXXXXXGXXXXXXXXXXXXXXXXXXXGXXXXXXXXXXXXXXXXXXXGXXXXXXXXXXXXXXXXXXXGXXXXXXXXXXXXXXXXXXXGAXXXXXXXXXXXXXXXXXXGXXXXXXXXXXXXXXXXXXX,0,0,0
693,15,11,4,230,355,0,0,54,2,52,GXXXXXXXXXXXXXXXXXXXGXXXXXXXXXXXXXXXXXXXGXXXXXXXXXXXXXXXXXXXGXXXXXXXXXXXXXXXXXXXGOXXXXXXXXXXXXXXXXXXGXXXXXXXXXXXXXXXXXXXGXXXXXXXXXXXXXXXXXXXGXXXXXXXXXXXXXXXXXXXGXXXXXXXXXXXXXXXXXXXGXXXXXXXXXXXXXXXXXXXGXXXXXXXXXXXXXXXXXXXGAXXXXXXXXXXXXXXXXXXGXXXXXXXXXXXXXXXXXXX,0,0,0
714,15,9,6,215,370,0,0,70,2,68,GXXXXXXXXXXXXXXXXXXXGXXXXXXXXXXXXXXXXXXXGXXXXXXXXXXXXXXXXXXXGXXXXXXXXXXXXXXXXXXXGOXXXXXXXXXXXXXXXXXXGXXXXXXXXXXXXXXXXXXXGXXXXXXXXXXXXXXXXXXXGXXXXXXXXXXXXXXXXXXXGXXXXXXXXXXXXXXXXXXXGXXXXXXXXXXXXXXXXXXXGXXXXXXXXXXXXXXXXXXXGAXXXXXXXXXXXXXXXXXXGXXXXXXXXXXXXXXXXXXX,0,0,0

735,16,9,7,207,377,0,0,77,1,76,GXXXXXXXXXXXXXXXXXXXGXXXXXXXXXXXXXXXXXXXGXXXXXXXXXXXXXXXXXXXGAXXXXXXXXXXXXXXXXXXGOXXXXXXXXXXXXXXXXXXGXXXXXXXXXXXXXXXXXXXGXXXXXXXXXXXXXXXXXXXGXXXXXXXXXXXXXXXXXXXGXXXXXXXXXXXXXXXXXXXGXXXXXXXXXXXXXXXXXXXGXXXXXXXXXXXXXXXXXXXGAXXXXXXXXXXXXXXXXXXGXXXXXXXXXXXXXXXXXXX,0,0,0
756,17,8,9,192,391,0,0,88,2,86,GXXXXXXXXXXXXXXXXXXXGXXXXXXXXXXXXXXXXXXXGXXXXXXXXXXXXXXXXXXXGOXXXXXXXXXXXXXXXXXXGOXXXXXXXXXXXXXXXXXXGXXXXXXXXXXXXXXXXXXXGXXXXXXXXXXXXXXXXXXXGXXXXXXXXXXXXXXXXXXXGXXXXXXXXXXXXXXXXXXXGAXXXXXXXXXXXXXXXXXXGXXXXXXXXXXXXXXXXXXXGAXXXXXXXXXXXXXXXXXXGXXXXXXXXXXXXXXXXXXX,0,0,0
777,19,8,11,173,408,0,0,108,2,106,GXXXXXXXXXXXXXXXXXXXGXXXXXXXXXXXXXXXXXXXGXXXXXXXXXXXXXXXXXXXGOXXXXXXXXXXXXXXXXXXGOXXXXXXXXXXXXXXXXXXGXXXXXXXXXXXXXXXXXXXGXXXXXXXXXXXXXXXXXXXGAXXXXXXXXXXXXXXXXXXGXXXXXXXXXXXXXXXXXXXGAAXXXXXXXXXXXXXXXXXGXXXXXXXXXXXXXXXXXXXGOXXXXXXXXXXXXXXXXXXGXXXXXXXXXXXXXXXXXXX,0,0,0
798,19,8,11,161,420,0,0,119,2,117,GXXXXXXXXXXXXXXXXXXXGXXXXXXXXXXXXXXXXXXXGXXXXXXXXXXXXXXXXXXXGOXXXXXXXXXXXXXXXXXXGOXXXXXXXXXXXXXXXXXXGXXXXXXXXXXXXXXXXXXXGXXXXXXXXXXXXXXXXXXXGAXXXXXXXXXXXXXXXXXXGXXXXXXXXXXXXXXXXXXXGAAXXXXXXXXXXXXXXXXXGXXXXXXXXXXXXXXXXXXXGOXXXXXXXXXXXXXXXXXXGXXXXXXXXXXXXXXXXXXX,0,0,0
819,19,7,12,146,435,0,0,135,2,133,GXXXXXXXXXXXXXXXXXXXGXXXXXXXXXXXXXXXXXXXGXXXXXXXXXXXXXXXXXXXGOXXXXXXXXXXXXXXXXXXGOXXXXXXXXXXXXXXXXXXGXXXXXXXXXXXXXXXXXXXGXXXXXXXXXXXXXXXXXXXGAXXXXXXXXXXXXXXXXXXGXXXXXXXXXXXXXXXXXXXGAAXXXXXXXXXXXXXXXXXGXXXXXXXXXXXXXXXXXXXGOXXXXXXXXXXXXXXXXXXGXXXXXXXXXXXXXXXXXXX,0,0,0

840,19,6,13,126,455,0,0,154,2,152,GXXXXXXXXXXXXXXXXXXXGXXXXXXXXXXXXXXXXXXXGXXXXXXXXXXXXXXXXXXXGOXXXXXXXXXXXXXXXXXXGOXXXXXXXXXXXXXXXXXXGXXXXXXXXXXXXXXXXXXXGXXXXXXXXXXXXXXXXXXXGOXXXXXXXXXXXXXXXXXXGXXXXXXXXXXXXXXXXXXXGAAXXXXXXXXXXXXXXXXXGXXXXXXXXXXXXXXXXXXXGOXXXXXXXXXXXXXXXXXXGXXXXXXXXXXXXXXXXXXX,0,0,0
861,19,5,14,110,471,0,0,170,2,168,GXXXXXXXXXXXXXXXXXXXGXXXXXXXXXXXXXXXXXXXGXXXXXXXXXXXXXXXXXXXGOXXXXXXXXXXXXXXXXXXGOXXXXXXXXXXXXXXXXXXGXXXXXXXXXXXXXXXXXXXGXXXXXXXXXXXXXXXXXXXGOXXXXXXXXXXXXXXXXXXGXXXXXXXXXXXXXXXXXXXGOAXXXXXXXXXXXXXXXXXGXXXXXXXXXXXXXXXXXXXGOXXXXXXXXXXXXXXXXXXGXXXXXXXXXXXXXXXXXXX,0,0,0
882,19,5,14,94,487,0,0,187,3,184,GXXXXXXXXXXXXXXXXXXXGXXXXXXXXXXXXXXXXXXXGXXXXXXXXXXXXXXXXXXXGOXXXXXXXXXXXXXXXXXXGOXXXXXXXXXXXXXXXXXXGXXXXXXXXXXXXXXXXXXXGXXXXXXXXXXXXXXXXXXXGOXXXXXXXXXXXXXXXXXXGXXXXXXXXXXXXXXXXXXXGOAXXXXXXXXXXXXXXXXXGXXXXXXXXXXXXXXXXXXXGOXXXXXXXXXXXXXXXXXXGXXXXXXXXXXXXXXXXXXX,0,0,0
903,19,1,18,82,499,0,0,199,2,197,GXXXXXXXXXXXXXXXXXXXGXXXXXXXXXXXXXXXXXXXGXXXXXXXXXXXXXXXXXXXGOXXXXXXXXXXXXXXXXXXGOXXXXXXXXXXXXXXXXXXGXXXXXXXXXXXXXXXXXXXGXXXXXXXXXXXXXXXXXXXGOXXXXXXXXXXXXXXXXXXGXXXXXXXXXXXXXXXXXXXGOOXXXXXXXXXXXXXXXXXGXXXXXXXXXXXXXXXXXXXGOXXXXXXXXXXXXXXXXXXGXXXXXXXXXXXXXXXXXXX,0,0,0
924,19,1,18,70,511,0,0,210,2,208,GXXXXXXXXXXXXXXXXXXXGXXXXXXXXXXXXXXXXXXXGXXXXXXXXXXXXXXXXXXXGOXXXXXXXXXXXXXXXXXXGOXXXXXXXXXXXXXXXXXXGXXXXXXXXXXXXXXXXXXXGXXXXXXXXXXXXXXXXXXXGOXXXXXXXXXXXXXXXXXXGXXXXXXXXXXXXXXXXXXXGOOXXXXXXXXXXXXXXXXXGXXXXXXXXXXXXXXXXXXXGOXXXXXXXXXXXXXXXXXXGXXXXXXXXXXXXXXXXXXX,0,0,0

945,19,1,18,66,515,0,0,216,2,214,GXXXXXXXXXXXXXXXXXXXGXXXXXXXXXXXXXXXXXXXGXXXXXXXXXXXXXXXXXXXGOXXXXXXXXXXXXXXXXXXGOXXXXXXXXXXXXXXXXXXGXXXXXXXXXXXXXXXXXXXGXXXXXXXXXXXXXXXXXXXGOXXXXXXXXXXXXXXXXXXGXXXXXXXXXXXXXXXXXXXGOOXXXXXXXXXXXXXXXXXGXXXXXXXXXXXXXXXXXXXGOXXXXXXXXXXXXXXXXXXGXXXXXXXXXXXXXXXXXXX,0,0,0
966,19,1,18,57,524,0,0,224,5,219,GXXXXXXXXXXXXXXXXXXXGXXXXXXXXXXXXXXXXXXXGXXXXXXXXXXXXXXXXXXXGOXXXXXXXXXXXXXXXXXXGOXXXXXXXXXXXXXXXXXXGXXXXXXXXXXXXXXXXXXXGXXXXXXXXXXXXXXXXXXXGOXXXXXXXXXXXXXXXXXXGXXXXXXXXXXXXXXXXXXXGOOXXXXXXXXXXXXXXXXXGXXXXXXXXXXXXXXXXXXXGOXXXXXXXXXXXXXXXXXXGXXXXXXXXXXXXXXXXXXX,0,0,0
987,19,1,18,53,528,0,0,229,9,220,GXXXXXXXXXXXXXXXXXXXGXXXXXXXXXXXXXXXXXXXGXXXXXXXXXXXXXXXXXXXGOXXXXXXXXXXXXXXXXXXGOXXXXXXXXXXXXXXXXXXGXXXXXXXXXXXXXXXXXXXGXXXXXXXXXXXXXXXXXXXGOXXXXXXXXXXXXXXXXXXGXXXXXXXXXXXXXXXXXXXGOOXXXXXXXXXXXXXXXXXGXXXXXXXXXXXXXXXXXXXGOXXXXXXXXXXXXXXXXXXGXXXXXXXXXXXXXXXXXXX,0,0,0
1008,19,1,18,54,527,0,0,228,7,221,GXXXXXXXXXXXXXXXXXXXGXXXXXXXXXXXXXXXXXXXGXXXXXXXXXXXXXXXXXXXGOXXXXXXXXXXXXXXXXXXGOXXXXXXXXXXXXXXXXXXGXXXXXXXXXXXXXXXXXXXGXXXXXXXXXXXXXXXXXXXGOXXXXXXXXXXXXXXXXXXGXXXXXXXXXXXXXXXXXXXGOOXXXXXXXXXXXXXXXXXGXXXXXXXXXXXXXXXXXXXGOXXXXXXXXXXXXXXXXXXGXXXXXXXXXXXXXXXXXXX,0,0,0
1029,19,1,18,58,523,0,0,224,6,218,GXXXXXXXXXXXXXXXXXXXGXXXXXXXXXXXXXXXXXXXGXXXXXXXXXXXXXXXXXXXGOXXXXXXXXXXXXXXXXXXGOXXXXXXXXXXXXXXXXXXGXXXXXXXXXXXXXXXXXXXGXXXXXXXXXXXXXXXXXXXGOXXXXXXXXXXXXXXXXXXGXXXXXXXXXXXXXXXXXXXGOOXXXXXXXXXXXXXXXXXGXXXXXXXXXXXXXXXXXXXGOXXXXXXXXXXXXXXXXXXGXXXXXXXXXXXXXXXXXXX,0,0,0

1050,19,0,19,59,522,0,0,223,16,207,GXXXXXXXXXXXXXXXXXXXGXXXXXXXXXXXXXXXXXXXGXXXXXXXXXXXXXXXXXXXGOXXXXXXXXXXXXXXXXXXGOXXXXXXXXXXXXXXXXXXGXXXXXXXXXXXXXXXXXXXGXXXXXXXXXXXXXXXXXXXGOXXXXXXXXXXXXXXXXXXGXXXXXXXXXXXXXXXXXXXGOOXXXXXXXXXXXXXXXXXGXXXXXXXXXXXXXXXXXXXGOXXXXXXXXXXXXXXXXXXGXXXXXXXXXXXXXXXXXXX,0,0,0
1071,19,0,19,70,511,0,0,212,5,207,GXXXXXXXXXXXXXXXXXXXGXXXXXXXXXXXXXXXXXXXGXXXXXXXXXXXXXXXXXXXGOXXXXXXXXXXXXXXXXXXGOXXXXXXXXXXXXXXXXXXGXXXXXXXXXXXXXXXXXXXGXXXXXXXXXXXXXXXXXXXGOXXXXXXXXXXXXXXXXXXGXXXXXXXXXXXXXXXXXXXGOOXXXXXXXXXXXXXXXXXGXXXXXXXXXXXXXXXXXXXGOXXXXXXXXXXXXXXXXXXGXXXXXXXXXXXXXXXXXXX,0,0,0
1092,19,0,19,74,507,0,0,208,12,196,GXXXXXXXXXXXXXXXXXXXGXXXXXXXXXXXXXXXXXXXGXXXXXXXXXXXXXXXXXXXGOXXXXXXXXXXXXXXXXXXGOXXXXXXXXXXXXXXXXXXGXXXXXXXXXXXXXXXXXXXGXXXXXXXXXXXXXXXXXXXGOXXXXXXXXXXXXXXXXXXGXXXXXXXXXXXXXXXXXXXGOOXXXXXXXXXXXXXXXXXGXXXXXXXXXXXXXXXXXXXGOXXXXXXXXXXXXXXXXXXGXXXXXXXXXXXXXXXXXXX,0,0,0
1113,19,0,19,90,491,0,0,191,10,181,GXXXXXXXXXXXXXXXXXXXGXXXXXXXXXXXXXXXXXXXGXXXXXXXXXXXXXXXXXXXGOXXXXXXXXXXXXXXXXXXGOXXXXXXXXXXXXXXXXXXGXXXXXXXXXXXXXXXXXXXGXXXXXXXXXXXXXXXXXXXGOXXXXXXXXXXXXXXXXXXGXXXXXXXXXXXXXXXXXXXGOOXXXXXXXXXXXXXXXXXGXXXXXXXXXXXXXXXXXXXGOXXXXXXXXXXXXXXXXXXGXXXXXXXXXXXXXXXXXXX,0,0,0
1134,19,0,19,99,482,0,0,183,10,173,GXXXXXXXXXXXXXXXXXXXGXXXXXXXXXXXXXXXXXXXGXXXXXXXXXXXXXXXXXXXGOXXXXXXXXXXXXXXXXXXGOXXXXXXXXXXXXXXXXXXGXXXXXXXXXXXXXXXXXXXGXXXXXXXXXXXXXXXXXXXGOXXXXXXXXXXXXXXXXXXGXXXXXXXXXXXXXXXXXXXGOOXXXXXXXXXXXXXXXXXGXXXXXXXXXXXXXXXXXXXGOXXXXXXXXXXXXXXXXXXGXXXXXXXXXXXXXXXXXXX,0,0,0

1155,19,0,19,106,475,0,0,176,13,163,GXXXXXXXXXXXXXXXXXXXGXXXXXXXXXXXXXXXXXXXGXXXXXXXXXXXXXXXXXXXGOXXXXXXXXXXXXXXXXXXGOXXXXXXXXXXXXXXXXXXGXXXXXXXXXXXXXXXXXXXGXXXXXXXXXXXXXXXXXXXGOXXXXXXXXXXXXXXXXXXGXXXXXXXXXXXXXXXXXXXGOOXXXXXXXXXXXXXXXXXGXXXXXXXXXXXXXXXXXXXGOXXXXXXXXXXXXXXXXXXGXXXXXXXXXXXXXXXXXXX,0,0,0
1176,19,0,19,116,465,0,0,166,10,156,GXXXXXXXXXXXXXXXXXXXGXXXXXXXXXXXXXXXXXXXGXXXXXXXXXXXXXXXXXXXGOXXXXXXXXXXXXXXXXXXGOXXXXXXXXXXXXXXXXXXGXXXXXXXXXXXXXXXXXXXGXXXXXXXXXXXXXXXXXXXGOXXXXXXXXXXXXXXXXXXGXXXXXXXXXXXXXXXXXXXGOOXXXXXXXXXXXXXXXXXGXXXXXXXXXXXXXXXXXXXGOXXXXXXXXXXXXXXXXXXGXXXXXXXXXXXXXXXXXXX,0,0,0
1197,19,0,19,121,460,0,0,161,9,152,GXXXXXXXXXXXXXXXXXXXGXXXXXXXXXXXXXXXXXXXGXXXXXXXXXXXXXXXXXXXGOXXXXXXXXXXXXXXXXXXGOXXXXXXXXXXXXXXXXXXGXXXXXXXXXXXXXXXXXXXGXXXXXXXXXXXXXXXXXXXGOXXXXXXXXXXXXXXXXXXGXXXXXXXXXXXXXXXXXXXGOOXXXXXXXXXXXXXXXXXGXXXXXXXXXXXXXXXXXXXGOXXXXXXXXXXXXXXXXXXGXXXXXXXXXXXXXXXXXXX,0,0,0
1218,20,1,19,126,454,0,0,155,11,144,GXXXXXXXXXXXXXXXXXXXGXXXXXXXXXXXXXXXXXXXGXXXXXXXXXXXXXXXXXXXGOXXXXXXXXXXXXXXXXXXGOXXXXXXXXXXXXXXXXXXGAXXXXXXXXXXXXXXXXXXGXXXXXXXXXXXXXXXXXXXGOXXXXXXXXXXXXXXXXXXGXXXXXXXXXXXXXXXXXXXGOOXXXXXXXXXXXXXXXXXGXXXXXXXXXXXXXXXXXXXGOXXXXXXXXXXXXXXXXXXGXXXXXXXXXXXXXXXXXXX,0,0,0
1239,20,1,19,130,450,0,0,150,18,132,GXXXXXXXXXXXXXXXXXXXGXXXXXXXXXXXXXXXXXXXGXXXXXXXXXXXXXXXXXXXGOXXXXXXXXXXXXXXXXXXGOXXXXXXXXXXXXXXXXXXGAXXXXXXXXXXXXXXXXXXGXXXXXXXXXXXXXXXXXXXGOXXXXXXXXXXXXXXXXXXGXXXXXXXXXXXXXXXXXXXGOOXXXXXXXXXXXXXXXXXGXXXXXXXXXXXXXXXXXXXGOXXXXXXXXXXXXXXXXXXGXXXXXXXXXXXXXXXXXXX,0,0,0

1260,20,1,19,142,438,0,0,139,12,127,GXXXXXXXXXXXXXXXXXXXGXXXXXXXXXXXXXXXXXXXGXXXXXXXXXXXXXXXXXXXGOXXXXXXXXXXXXXXXXXXGOXXXXXXXXXXXXXXXXXXGAXXXXXXXXXXXXXXXXXXGXXXXXXXXXXXXXXXXXXXGOXXXXXXXXXXXXXXXXXXGXXXXXXXXXXXXXXXXXXXGOOXXXXXXXXXXXXXXXXXGXXXXXXXXXXXXXXXXXXXGOXXXXXXXXXXXXXXXXXXGXXXXXXXXXXXXXXXXXXX,0,0,0
1281,20,1,19,155,425,0,0,126,6,120,GXXXXXXXXXXXXXXXXXXXGXXXXXXXXXXXXXXXXXXXGXXXXXXXXXXXXXXXXXXXGOXXXXXXXXXXXXXXXXXXGOXXXXXXXXXXXXXXXXXXGAXXXXXXXXXXXXXXXXXXGXXXXXXXXXXXXXXXXXXXGOXXXXXXXXXXXXXXXXXXGXXXXXXXXXXXXXXXXXXXGOOXXXXXXXXXXXXXXXXXGXXXXXXXXXXXXXXXXXXXGOXXXXXXXXXXXXXXXXXXGXXXXXXXXXXXXXXXXXXX,0,0,0
1302,20,1,19,153,427,0,0,127,9,118,GXXXXXXXXXXXXXXXXXXXGXXXXXXXXXXXXXXXXXXXGXXXXXXXXXXXXXXXXXXXGOXXXXXXXXXXXXXXXXXXGOXXXXXXXXXXXXXXXXXXGAXXXXXXXXXXXXXXXXXXGXXXXXXXXXXXXXXXXXXXGOXXXXXXXXXXXXXXXXXXGXXXXXXXXXXXXXXXXXXXGOOXXXXXXXXXXXXXXXXXGXXXXXXXXXXXXXXXXXXXGOXXXXXXXXXXXXXXXXXXGXXXXXXXXXXXXXXXXXXX,0,0,0
1323,21,2,19,153,426,0,0,127,8,119,GXXXXXXXXXXXXXXXXXXXGXXXXXXXXXXXXXXXXXXXGXXXXXXXXXXXXXXXXXXXGOXXXXXXXXXXXXXXXXXXGOXXXXXXXXXXXXXXXXXXGAXXXXXXXXXXXXXXXXXXGXXXXXXXXXXXXXXXXXXXGOXXXXXXXXXXXXXXXXXXGXXXXXXXXXXXXXXXXXXXGOOXXXXXXXXXXXXXXXXXGXXXXXXXXXXXXXXXXXXXGOAXXXXXXXXXXXXXXXXXGXXXXXXXXXXXXXXXXXXX,0,0,0
1344,21,2,19,154,425,0,0,127,12,115,GXXXXXXXXXXXXXXXXXXXGXXXXXXXXXXXXXXXXXXXGXXXXXXXXXXXXXXXXXXXGOXXXXXXXXXXXXXXXXXXGOXXXXXXXXXXXXXXXXXXGAXXXXXXXXXXXXXXXXXXGXXXXXXXXXXXXXXXXXXXGOXXXXXXXXXXXXXXXXXXGXXXXXXXXXXXXXXXXXXXGOOXXXXXXXXXXXXXXXXXGXXXXXXXXXXXXXXXXXXXGOAXXXXXXXXXXXXXXXXXGXXXXXXXXXXXXXXXXXXX,0,0,0

1365,21,2,19,150,429,0,0,129,8,121,GXXXXXXXXXXXXXXXXXXXGXXXXXXXXXXXXXXXXXXXGXXXXXXXXXXXXXXXXXXXGOXXXXXXXXXXXXXXXXXXGOXXXXXXXXXXXXXXXXXXGAXXXXXXXXXXXXXXXXXXGXXXXXXXXXXXXXXXXXXXGOXXXXXXXXXXXXXXXXXXGXXXXXXXXXXXXXXXXXXXGOOXXXXXXXXXXXXXXXXXGXXXXXXXXXXXXXXXXXXXGOAXXXXXXXXXXXXXXXXXGXXXXXXXXXXXXXXXXXXX,0,0,0
1386,22,3,19,151,427,0,0,129,6,123,GXXXXXXXXXXXXXXXXXXXGXXXXXXXXXXXXXXXXXXXGXXXXXXXXXXXXXXXXXXXGOXXXXXXXXXXXXXXXXXXGOAXXXXXXXXXXXXXXXXXGAXXXXXXXXXXXXXXXXXXGXXXXXXXXXXXXXXXXXXXGOXXXXXXXXXXXXXXXXXXGXXXXXXXXXXXXXXXXXXXGOOXXXXXXXXXXXXXXXXXGXXXXXXXXXXXXXXXXXXXGOAXXXXXXXXXXXXXXXXXGXXXXXXXXXXXXXXXXXXX,0,0,0
1407,22,3,19,147,431,0,0,132,9,123,GXXXXXXXXXXXXXXXXXXXGXXXXXXXXXXXXXXXXXXXGXXXXXXXXXXXXXXXXXXXGOXXXXXXXXXXXXXXXXXXGOAXXXXXXXXXXXXXXXXXGAXXXXXXXXXXXXXXXXXXGXXXXXXXXXXXXXXXXXXXGOXXXXXXXXXXXXXXXXXXGXXXXXXXXXXXXXXXXXXXGOOXXXXXXXXXXXXXXXXXGXXXXXXXXXXXXXXXXXXXGOAXXXXXXXXXXXXXXXXXGXXXXXXXXXXXXXXXXXXX,0,0,0
1428,22,3,19,148,430,0,0,130,3,127,GXXXXXXXXXXXXXXXXXXXGXXXXXXXXXXXXXXXXXXXGXXXXXXXXXXXXXXXXXXXGOXXXXXXXXXXXXXXXXXXGOAXXXXXXXXXXXXXXXXXGAXXXXXXXXXXXXXXXXXXGXXXXXXXXXXXXXXXXXXXGOXXXXXXXXXXXXXXXXXXGXXXXXXXXXXXXXXXXXXXGOOXXXXXXXXXXXXXXXXXGXXXXXXXXXXXXXXXXXXXGOAXXXXXXXXXXXXXXXXXGXXXXXXXXXXXXXXXXXXX,0,0,0
1449,22,3,19,131,447,0,0,148,8,140,GXXXXXXXXXXXXXXXXXXXGXXXXXXXXXXXXXXXXXXXGXXXXXXXXXXXXXXXXXXXGOXXXXXXXXXXXXXXXXXXGOAXXXXXXXXXXXXXXXXXGAXXXXXXXXXXXXXXXXXXGXXXXXXXXXXXXXXXXXXXGOXXXXXXXXXXXXXXXXXXGXXXXXXXXXXXXXXXXXXXGOOXXXXXXXXXXXXXXXXXGXXXXXXXXXXXXXXXXXXXGOAXXXXXXXXXXXXXXXXXGXXXXXXXXXXXXXXXXXXX,0,0,0

1470,23,3,20,126,451,0,0,151,7,144,GXXXXXXXXXXXXXXXXXXXGXXXXXXXXXXXXXXXXXXXGXXXXXXXXXXXXXXXXXXXGOXXXXXXXXXXXXXXXXXXGOAXXXXXXXXXXXXXXXXXGOAXXXXXXXXXXXXXXXXXGXXXXXXXXXXXXXXXXXXXGOXXXXXXXXXXXXXXXXXXGXXXXXXXXXXXXXXXXXXXGOOXXXXXXXXXXXXXXXXXGXXXXXXXXXXXXXXXXXXXGOAXXXXXXXXXXXXXXXXXGXXXXXXXXXXXXXXXXXXX,0,0,0
1491,23,3,20,117,460,0,0,159,3,156,GXXXXXXXXXXXXXXXXXXXGXXXXXXXXXXXXXXXXXXXGXXXXXXXXXXXXXXXXXXXGOXXXXXXXXXXXXXXXXXXGOAXXXXXXXXXXXXXXXXXGOAXXXXXXXXXXXXXXXXXGXXXXXXXXXXXXXXXXXXXGOXXXXXXXXXXXXXXXXXXGXXXXXXXXXXXXXXXXXXXGOOXXXXXXXXXXXXXXXXXGXXXXXXXXXXXXXXXXXXXGOAXXXXXXXXXXXXXXXXXGXXXXXXXXXXXXXXXXXXX,0,0,0
1512,24,3,21,114,462,0,0,162,3,159,GXXXXXXXXXXXXXXXXXXXGXXXXXXXXXXXXXXXXXXXGXXXXXXXXXXXXXXXXXXXGOXXXXXXXXXXXXXXXXXXGOOXXXXXXXXXXXXXXXXXGOAXXXXXXXXXXXXXXXXXGXXXXXXXXXXXXXXXXXXXGOXXXXXXXXXXXXXXXXXXGXXXXXXXXXXXXXXXXXXXGOOXXXXXXXXXXXXXXXXXGXXXXXXXXXXXXXXXXXXXGOAAXXXXXXXXXXXXXXXXGXXXXXXXXXXXXXXXXXXX,0,0,0
1533,24,3,21,101,475,0,0,174,5,169,GXXXXXXXXXXXXXXXXXXXGXXXXXXXXXXXXXXXXXXXGXXXXXXXXXXXXXXXXXXXGOXXXXXXXXXXXXXXXXXXGOOXXXXXXXXXXXXXXXXXGOAXXXXXXXXXXXXXXXXXGXXXXXXXXXXXXXXXXXXXGOXXXXXXXXXXXXXXXXXXGXXXXXXXXXXXXXXXXXXXGOOXXXXXXXXXXXXXXXXXGXXXXXXXXXXXXXXXXXXXGOAAXXXXXXXXXXXXXXXXGXXXXXXXXXXXXXXXXXXX,0,0,0
1554,25,3,22,97,478,0,0,177,4,173,GXXXXXXXXXXXXXXXXXXXGXXXXXXXXXXXXXXXXXXXGXXXXXXXXXXXXXXXXXXXGOXXXXXXXXXXXXXXXXXXGOOXXXXXXXXXXXXXXXXXGOAAXXXXXXXXXXXXXXXXGXXXXXXXXXXXXXXXXXXXGOXXXXXXXXXXXXXXXXXXGXXXXXXXXXXXXXXXXXXXGOOXXXXXXXXXXXXXXXXXGXXXXXXXXXXXXXXXXXXXGOOAXXXXXXXXXXXXXXXXGXXXXXXXXXXXXXXXXXXX,0,0,0

1575,26,2,24,96,478,0,0,178,3,175,GXXXXXXXXXXXXXXXXXXXGXXXXXXXXXXXXXXXXXXXGXXXXXXXXXXXXXXXXXXXGOXXXXXXXXXXXXXXXXXXGOOXXXXXXXXXXXXXXXXXGOOAXXXXXXXXXXXXXXXXGAXXXXXXXXXXXXXXXXXXGOXXXXXXXXXXXXXXXXXXGXXXXXXXXXXXXXXXXXXXGOOXXXXXXXXXXXXXXXXXGXXXXXXXXXXXXXXXXXXXGOOOXXXXXXXXXXXXXXXXGXXXXXXXXXXXXXXXXXXX,0,0,0
1596,26,2,24,95,479,0,0,178,10,168,GXXXXXXXXXXXXXXXXXXXGXXXXXXXXXXXXXXXXXXXGXXXXXXXXXXXXXXXXXXXGOXXXXXXXXXXXXXXXXXXGOOXXXXXXXXXXXXXXXXXGOOAXXXXXXXXXXXXXXXXGAXXXXXXXXXXXXXXXXXXGOXXXXXXXXXXXXXXXXXXGXXXXXXXXXXXXXXXXXXXGOOXXXXXXXXXXXXXXXXXGXXXXXXXXXXXXXXXXXXXGOOOXXXXXXXXXXXXXXXXGXXXXXXXXXXXXXXXXXXX,0,0,0
1617,26,2,24,95,479,0,0,179,6,173,GXXXXXXXXXXXXXXXXXXXGXXXXXXXXXXXXXXXXXXXGXXXXXXXXXXXXXXXXXXXGOXXXXXXXXXXXXXXXXXXGOOXXXXXXXXXXXXXXXXXGOOAXXXXXXXXXXXXXXXXGAXXXXXXXXXXXXXXXXXXGOXXXXXXXXXXXXXXXXXXGXXXXXXXXXXXXXXXXXXXGOOXXXXXXXXXXXXXXXXXGXXXXXXXXXXXXXXXXXXXGOOOXXXXXXXXXXXXXXXXGXXXXXXXXXXXXXXXXXXX,0,0,0
1638,26,2,24,90,484,0,0,183,11,172,GXXXXXXXXXXXXXXXXXXXGXXXXXXXXXXXXXXXXXXXGXXXXXXXXXXXXXXXXXXXGOXXXXXXXXXXXXXXXXXXGOOXXXXXXXXXXXXXXXXXGOOAXXXXXXXXXXXXXXXXGAXXXXXXXXXXXXXXXXXXGOXXXXXXXXXXXXXXXXXXGXXXXXXXXXXXXXXXXXXXGOOXXXXXXXXXXXXXXXXXGXXXXXXXXXXXXXXXXXXXGOOOXXXXXXXXXXXXXXXXGXXXXXXXXXXXXXXXXXXX,0,0,0
1659,26,2,24,95,479,0,0,179,9,170,GXXXXXXXXXXXXXXXXXXXGXXXXXXXXXXXXXXXXXXXGXXXXXXXXXXXXXXXXXXXGOXXXXXXXXXXXXXXXXXXGOOXXXXXXXXXXXXXXXXXGOOAXXXXXXXXXXXXXXXXGAXXXXXXXXXXXXXXXXXXGOXXXXXXXXXXXXXXXXXXGXXXXXXXXXXXXXXXXXXXGOOXXXXXXXXXXXXXXXXXGXXXXXXXXXXXXXXXXXXXGOOOXXXXXXXXXXXXXXXXGXXXXXXXXXXXXXXXXXXX,0,0,0

1680,26,1,25,100,474,0,0,175,11,164,GXXXXXXXXXXXXXXXXXXXGXXXXXXXXXXXXXXXXXXXGXXXXXXXXXXXXXXXXXXXGOXXXXXXXXXXXXXXXXXXGOOXXXXXXXXXXXXXXXXXGOOOXXXXXXXXXXXXXXXXGAXXXXXXXXXXXXXXXXXXGOXXXXXXXXXXXXXXXXXXGXXXXXXXXXXXXXXXXXXXGOOXXXXXXXXXXXXXXXXXGXXXXXXXXXXXXXXXXXXXGOOOXXXXXXXXXXXXXXXXGXXXXXXXXXXXXXXXXXXX,0,0,0
1701,26,1,25,100,474,0,0,175,10,165,GXXXXXXXXXXXXXXXXXXXGXXXXXXXXXXXXXXXXXXXGXXXXXXXXXXXXXXXXXXXGOXXXXXXXXXXXXXXXXXXGOOXXXXXXXXXXXXXXXXXGOOOXXXXXXXXXXXXXXXXGAXXXXXXXXXXXXXXXXXXGOXXXXXXXXXXXXXXXXXXGXXXXXXXXXXXXXXXXXXXGOOXXXXXXXXXXXXXXXXXGXXXXXXXXXXXXXXXXXXXGOOOXXXXXXXXXXXXXXXXGXXXXXXXXXXXXXXXXXXX,0,0,0
1722,26,1,25,99,475,0,0,176,10,166,GXXXXXXXXXXXXXXXXXXXGXXXXXXXXXXXXXXXXXXXGXXXXXXXXXXXXXXXXXXXGOXXXXXXXXXXXXXXXXXXGOOXXXXXXXXXXXXXXXXXGOOOXXXXXXXXXXXXXXXXGAXXXXXXXXXXXXXXXXXXGOXXXXXXXXXXXXXXXXXXGXXXXXXXXXXXXXXXXXXXGOOXXXXXXXXXXXXXXXXXGXXXXXXXXXXXXXXXXXXXGOOOXXXXXXXXXXXXXXXXGXXXXXXXXXXXXXXXXXXX,0,0,0
1743,26,1,25,100,474,0,0,176,7,169,GXXXXXXXXXXXXXXXXXXXGXXXXXXXXXXXXXXXXXXXGXXXXXXXXXXXXXXXXXXXGOXXXXXXXXXXXXXXXXXXGOOXXXXXXXXXXXXXXXXXGOOOXXXXXXXXXXXXXXXXGAXXXXXXXXXXXXXXXXXXGOXXXXXXXXXXXXXXXXXXGXXXXXXXXXXXXXXXXXXXGOOXXXXXXXXXXXXXXXXXGXXXXXXXXXXXXXXXXXXXGOOOXXXXXXXXXXXXXXXXGXXXXXXXXXXXXXXXXXXX,0,0,0
1764,26,1,25,95,479,0,0,180,9,171,GXXXXXXXXXXXXXXXXXXXGXXXXXXXXXXXXXXXXXXXGXXXXXXXXXXXXXXXXXXXGOXXXXXXXXXXXXXXXXXXGOOXXXXXXXXXXXXXXXXXGOOOXXXXXXXXXXXXXXXXGAXXXXXXXXXXXXXXXXXXGOXXXXXXXXXXXXXXXXXXGXXXXXXXXXXXXXXXXXXXGOOXXXXXXXXXXXXXXXXXGXXXXXXXXXXXXXXXXXXXGOOOXXXXXXXXXXXXXXXXGXXXXXXXXXXXXXXXXXXX,0,0,0

1785,26,1,25,93,481,0,0,182,12,170,GXXXXXXXXXXXXXXXXXXXGXXXXXXXXXXXXXXXXXXXGXXXXXXXXXXXXXXXXXXXGOXXXXXXXXXXXXXXXXXXGOOXXXXXXXXXXXXXXXXXGOOOXXXXXXXXXXXXXXXXGAXXXXXXXXXXXXXXXXXXGOXXXXXXXXXXXXXXXXXXGXXXXXXXXXXXXXXXXXXXGOOXXXXXXXXXXXXXXXXXGXXXXXXXXXXXXXXXXXXXGOOOXXXXXXXXXXXXXXXXGXXXXXXXXXXXXXXXXXXX,0,0,0
1806,26,1,25,97,477,0,0,178,13,165,GXXXXXXXXXXXXXXXXXXXGXXXXXXXXXXXXXXXXXXXGXXXXXXXXXXXXXXXXXXXGOXXXXXXXXXXXXXXXXXXGOOXXXXXXXXXXXXXXXXXGOOOXXXXXXXXXXXXXXXXGAXXXXXXXXXXXXXXXXXXGOXXXXXXXXXXXXXXXXXXGXXXXXXXXXXXXXXXXXXXGOOXXXXXXXXXXXXXXXXXGXXXXXXXXXXXXXXXXXXXGOOOXXXXXXXXXXXXXXXXGXXXXXXXXXXXXXXXXXXX,0,0,0
1827,26,1,25,97,477,0,0,179,8,171,GXXXXXXXXXXXXXXXXXXXGXXXXXXXXXXXXXXXXXXXGXXXXXXXXXXXXXXXXXXXGOXXXXXXXXXXXXXXXXXXGOOXXXXXXXXXXXXXXXXXGOOOXXXXXXXXXXXXXXXXGAXXXXXXXXXXXXXXXXXXGOXXXXXXXXXXXXXXXXXXGXXXXXXXXXXXXXXXXXXXGOOXXXXXXXXXXXXXXXXXGXXXXXXXXXXXXXXXXXXXGOOOXXXXXXXXXXXXXXXXGXXXXXXXXXXXXXXXXXXX,0,0,0
1848,26,1,25,97,477,0,0,179,8,171,GXXXXXXXXXXXXXXXXXXXGXXXXXXXXXXXXXXXXXXXGXXXXXXXXXXXXXXXXXXXGOXXXXXXXXXXXXXXXXXXGOOXXXXXXXXXXXXXXXXXGOOOXXXXXXXXXXXXXXXXGAXXXXXXXXXXXXXXXXXXGOXXXXXXXXXXXXXXXXXXGXXXXXXXXXXXXXXXXXXXGOOXXXXXXXXXXXXXXXXXGXXXXXXXXXXXXXXXXXXXGOOOXXXXXXXXXXXXXXXXGXXXXXXXXXXXXXXXXXXX,0,0,0
1869,26,1,25,105,469,0,0,172,4,168,GXXXXXXXXXXXXXXXXXXXGXXXXXXXXXXXXXXXXXXXGXXXXXXXXXXXXXXXXXXXGOXXXXXXXXXXXXXXXXXXGOOXXXXXXXXXXXXXXXXXGOOOXXXXXXXXXXXXXXXXGAXXXXXXXXXXXXXXXXXXGOXXXXXXXXXXXXXXXXXXGXXXXXXXXXXXXXXXXXXXGOOXXXXXXXXXXXXXXXXXGXXXXXXXXXXXXXXXXXXXGOOOXXXXXXXXXXXXXXXXGXXXXXXXXXXXXXXXXXXX,0,0,0

1890,26,1,25,106,468,0,0,170,13,157,GXXXXXXXXXXXXXXXXXXXGXXXXXXXXXXXXXXXXXXXGXXXXXXXXXXXXXXXXXXXGOXXXXXXXXXXXXXXXXXXGOOXXXXXXXXXXXXXXXXXGOOOXXXXXXXXXXXXXXXXGAXXXXXXXXXXXXXXXXXXGOXXXXXXXXXXXXXXXXXXGXXXXXXXXXXXXXXXXXXXGOOXXXXXXXXXXXXXXXXXGXXXXXXXXXXXXXXXXXXXGOOOXXXXXXXXXXXXXXXXGXXXXXXXXXXXXXXXXXXX,0,0,0
1911,26,1,25,106,468,0,0,170,9,161,GXXXXXXXXXXXXXXXXXXXGXXXXXXXXXXXXXXXXXXXGXXXXXXXXXXXXXXXXXXXGOXXXXXXXXXXXXXXXXXXGOOXXXXXXXXXXXXXXXXXGOOOXXXXXXXXXXXXXXXXGAXXXXXXXXXXXXXXXXXXGOXXXXXXXXXXXXXXXXXXGXXXXXXXXXXXXXXXXXXXGOOXXXXXXXXXXXXXXXXXGXXXXXXXXXXXXXXXXXXXGOOOXXXXXXXXXXXXXXXXGXXXXXXXXXXXXXXXXXXX,0,0,0
1932,26,1,25,108,466,0,0,168,6,162,GXXXXXXXXXXXXXXXXXXXGXXXXXXXXXXXXXXXXXXXGXXXXXXXXXXXXXXXXXXXGOXXXXXXXXXXXXXXXXXXGOOXXXXXXXXXXXXXXXXXGOOOXXXXXXXXXXXXXXXXGAXXXXXXXXXXXXXXXXXXGOXXXXXXXXXXXXXXXXXXGXXXXXXXXXXXXXXXXXXXGOOXXXXXXXXXXXXXXXXXGXXXXXXXXXXXXXXXXXXXGOOOXXXXXXXXXXXXXXXXGXXXXXXXXXXXXXXXXXXX,0,0,0
1953,26,1,25,101,473,0,0,173,9,164,GXXXXXXXXXXXXXXXXXXXGXXXXXXXXXXXXXXXXXXXGXXXXXXXXXXXXXXXXXXXGOXXXXXXXXXXXXXXXXXXGOOXXXXXXXXXXXXXXXXXGOOOXXXXXXXXXXXXXXXXGAXXXXXXXXXXXXXXXXXXGOXXXXXXXXXXXXXXXXXXGXXXXXXXXXXXXXXXXXXXGOOXXXXXXXXXXXXXXXXXGXXXXXXXXXXXXXXXXXXXGOOOXXXXXXXXXXXXXXXXGXXXXXXXXXXXXXXXXXXX,0,0,0
1974,26,1,25,102,472,0,0,173,9,164,GXXXXXXXXXXXXXXXXXXXGXXXXXXXXXXXXXXXXXXXGXXXXXXXXXXXXXXXXXXXGOXXXXXXXXXXXXXXXXXXGOOXXXXXXXXXXXXXXXXXGOOOXXXXXXXXXXXXXXXXGAXXXXXXXXXXXXXXXXXXGOXXXXXXXXXXXXXXXXXXGXXXXXXXXXXXXXXXXXXXGOOXXXXXXXXXXXXXXXXXGXXXXXXXXXXXXXXXXXXXGOOOXXXXXXXXXXXXXXXXGXXXXXXXXXXXXXXXXXXX,0,0,0

1995,26,1,25,107,467,0,0,168,15,153,GXXXXXXXXXXXXXXXXXXXGXXXXXXXXXXXXXXXXXXXGXXXXXXXXXXXXXXXXXXXGOXXXXXXXXXXXXXXXXXXGOOXXXXXXXXXXXXXXXXXGOOOXXXXXXXXXXXXXXXXGAXXXXXXXXXXXXXXXXXXGOXXXXXXXXXXXXXXXXXXGXXXXXXXXXXXXXXXXXXXGOOXXXXXXXXXXXXXXXXXGXXXXXXXXXXXXXXXXXXXGOOOXXXXXXXXXXXXXXXXGXXXXXXXXXXXXXXXXXXX,0,0,0
2016,26,0,26,103,471,0,0,171,7,164,GXXXXXXXXXXXXXXXXXXXGXXXXXXXXXXXXXXXXXXXGXXXXXXXXXXXXXXXXXXXGOXXXXXXXXXXXXXXXXXXGOOXXXXXXXXXXXXXXXXXGOOOXXXXXXXXXXXXXXXXGOXXXXXXXXXXXXXXXXXXGOXXXXXXXXXXXXXXXXXXGXXXXXXXXXXXXXXXXXXXGOOXXXXXXXXXXXXXXXXXGXXXXXXXXXXXXXXXXXXXGOOOXXXXXXXXXXXXXXXXGXXXXXXXXXXXXXXXXXXX,0,0,0
2037,26,0,26,106,468,0,0,169,7,162,GXXXXXXXXXXXXXXXXXXXGXXXXXXXXXXXXXXXXXXXGXXXXXXXXXXXXXXXXXXXGOXXXXXXXXXXXXXXXXXXGOOXXXXXXXXXXXXXXXXXGOOOXXXXXXXXXXXXXXXXGOXXXXXXXXXXXXXXXXXXGOXXXXXXXXXXXXXXXXXXGXXXXXXXXXXXXXXXXXXXGOOXXXXXXXXXXXXXXXXXGXXXXXXXXXXXXXXXXXXXGOOOXXXXXXXXXXXXXXXXGXXXXXXXXXXXXXXXXXXX,0,0,0
2058,26,0,26,105,469,0,0,171,8,163,GXXXXXXXXXXXXXXXXXXXGXXXXXXXXXXXXXXXXXXXGXXXXXXXXXXXXXXXXXXXGOXXXXXXXXXXXXXXXXXXGOOXXXXXXXXXXXXXXXXXGOOOXXXXXXXXXXXXXXXXGOXXXXXXXXXXXXXXXXXXGOXXXXXXXXXXXXXXXXXXGXXXXXXXXXXXXXXXXXXXGOOXXXXXXXXXXXXXXXXXGXXXXXXXXXXXXXXXXXXXGOOOXXXXXXXXXXXXXXXXGXXXXXXXXXXXXXXXXXXX,0,0,0
2079,26,0,26,111,463,0,0,165,10,155,GXXXXXXXXXXXXXXXXXXXGXXXXXXXXXXXXXXXXXXXGXXXXXXXXXXXXXXXXXXXGOXXXXXXXXXXXXXXXXXXGOOXXXXXXXXXXXXXXXXXGOOOXXXXXXXXXXXXXXXXGOXXXXXXXXXXXXXXXXXXGOXXXXXXXXXXXXXXXXXXGXXXXXXXXXXXXXXXXXXXGOOXXXXXXXXXXXXXXXXXGXXXXXXXXXXXXXXXXXXXGOOOXXXXXXXXXXXXXXXXGXXXXXXXXXXXXXXXXXXX,0,0,0

2100,26,0,26,114,460,0,0,161,10,151,GXXXXXXXXXXXXXXXXXXXGXXXXXXXXXXXXXXXXXXXGXXXXXXXXXXXXXXXXXXXGOXXXXXXXXXXXXXXXXXXGOOXXXXXXXXXXXXXXXXXGOOOXXXXXXXXXXXXXXXXGOXXXXXXXXXXXXXXXXXXGOXXXXXXXXXXXXXXXXXXGXXXXXXXXXXXXXXXXXXXGOOXXXXXXXXXXXXXXXXXGXXXXXXXXXXXXXXXXXXXGOOOXXXXXXXXXXXXXXXXGXXXXXXXXXXXXXXXXXXX,0,0,0
2121,26,0,26,109,465,0,0,166,10,156,GXXXXXXXXXXXXXXXXXXXGXXXXXXXXXXXXXXXXXXXGXXXXXXXXXXXXXXXXXXXGOXXXXXXXXXXXXXXXXXXGOOXXXXXXXXXXXXXXXXXGOOOXXXXXXXXXXXXXXXXGOXXXXXXXXXXXXXXXXXXGOXXXXXXXXXXXXXXXXXXGXXXXXXXXXXXXXXXXXXXGOOXXXXXXXXXXXXXXXXXGXXXXXXXXXXXXXXXXXXXGOOOXXXXXXXXXXXXXXXXGXXXXXXXXXXXXXXXXXXX,0,0,0
2142,26,0,26,107,467,0,0,169,7,162,GXXXXXXXXXXXXXXXXXXXGXXXXXXXXXXXXXXXXXXXGXXXXXXXXXXXXXXXXXXXGOXXXXXXXXXXXXXXXXXXGOOXXXXXXXXXXXXXXXXXGOOOXXXXXXXXXXXXXXXXGOXXXXXXXXXXXXXXXXXXGOXXXXXXXXXXXXXXXXXXGXXXXXXXXXXXXXXXXXXXGOOXXXXXXXXXXXXXXXXXGXXXXXXXXXXXXXXXXXXXGOOOXXXXXXXXXXXXXXXXGXXXXXXXXXXXXXXXXXXX,0,0,0
2163,26,0,26,107,467,0,0,169,9,160,GXXXXXXXXXXXXXXXXXXXGXXXXXXXXXXXXXXXXXXXGXXXXXXXXXXXXXXXXXXXGOXXXXXXXXXXXXXXXXXXGOOXXXXXXXXXXXXXXXXXGOOOXXXXXXXXXXXXXXXXGOXXXXXXXXXXXXXXXXXXGOXXXXXXXXXXXXXXXXXXGXXXXXXXXXXXXXXXXXXXGOOXXXXXXXXXXXXXXXXXGXXXXXXXXXXXXXXXXXXXGOOOXXXXXXXXXXXXXXXXGXXXXXXXXXXXXXXXXXXX,0,0,0
2184,26,0,26,109,465,0,0,167,12,155,GXXXXXXXXXXXXXXXXXXXGXXXXXXXXXXXXXXXXXXXGXXXXXXXXXXXXXXXXXXXGOXXXXXXXXXXXXXXXXXXGOOXXXXXXXXXXXXXXXXXGOOOXXXXXXXXXXXXXXXXGOXXXXXXXXXXXXXXXXXXGOXXXXXXXXXXXXXXXXXXGXXXXXXXXXXXXXXXXXXXGOOXXXXXXXXXXXXXXXXXGXXXXXXXXXXXXXXXXXXXGOOOXXXXXXXXXXXXXXXXGXXXXXXXXXXXXXXXXXXX,0,0,0

2205,26,0,26,103,471,0,0,172,10,162,GXXXXXXXXXXXXXXXXXXXGXXXXXXXXXXXXXXXXXXXGXXXXXXXXXXXXXXXXXXXGOXXXXXXXXXXXXXXXXXXGOOXXXXXXXXXXXXXXXXXGOOOXXXXXXXXXXXXXXXXGOXXXXXXXXXXXXXXXXXXGOXXXXXXXXXXXXXXXXXXGXXXXXXXXXXXXXXXXXXXGOOXXXXXXXXXXXXXXXXXGXXXXXXXXXXXXXXXXXXXGOOOXXXXXXXXXXXXXXXXGXXXXXXXXXXXXXXXXXXX,0,0,0
2226,26,0,26,107,467,0,0,167,10,157,GXXXXXXXXXXXXXXXXXXXGXXXXXXXXXXXXXXXXXXXGXXXXXXXXXXXXXXXXXXXGOXXXXXXXXXXXXXXXXXXGOOXXXXXXXXXXXXXXXXXGOOOXXXXXXXXXXXXXXXXGOXXXXXXXXXXXXXXXXXXGOXXXXXXXXXXXXXXXXXXGXXXXXXXXXXXXXXXXXXXGOOXXXXXXXXXXXXXXXXXGXXXXXXXXXXXXXXXXXXXGOOOXXXXXXXXXXXXXXXXGXXXXXXXXXXXXXXXXXXX,0,0,0
2247,26,0,26,107,467,0,0,166,10,156,GXXXXXXXXXXXXXXXXXXXGXXXXXXXXXXXXXXXXXXXGXXXXXXXXXXXXXXXXXXXGOXXXXXXXXXXXXXXXXXXGOOXXXXXXXXXXXXXXXXXGOOOXXXXXXXXXXXXXXXXGOXXXXXXXXXXXXXXXXXXGOXXXXXXXXXXXXXXXXXXGXXXXXXXXXXXXXXXXXXXGOOXXXXXXXXXXXXXXXXXGXXXXXXXXXXXXXXXXXXXGOOOXXXXXXXXXXXXXXXXGXXXXXXXXXXXXXXXXXXX,0,0,0
2268,26,0,26,107,467,0,0,166,14,152,GXXXXXXXXXXXXXXXXXXXGXXXXXXXXXXXXXXXXXXXGXXXXXXXXXXXXXXXXXXXGOXXXXXXXXXXXXXXXXXXGOOXXXXXXXXXXXXXXXXXGOOOXXXXXXXXXXXXXXXXGOXXXXXXXXXXXXXXXXXXGOXXXXXXXXXXXXXXXXXXGXXXXXXXXXXXXXXXXXXXGOOXXXXXXXXXXXXXXXXXGXXXXXXXXXXXXXXXXXXXGOOOXXXXXXXXXXXXXXXXGXXXXXXXXXXXXXXXXXXX,0,0,0
2289,26,0,26,103,471,0,0,170,13,157,GXXXXXXXXXXXXXXXXXXXGXXXXXXXXXXXXXXXXXXXGXXXXXXXXXXXXXXXXXXXGOXXXXXXXXXXXXXXXXXXGOOXXXXXXXXXXXXXXXXXGOOOXXXXXXXXXXXXXXXXGOXXXXXXXXXXXXXXXXXXGOXXXXXXXXXXXXXXXXXXGXXXXXXXXXXXXXXXXXXXGOOXXXXXXXXXXXXXXXXXGXXXXXXXXXXXXXXXXXXXGOOOXXXXXXXXXXXXXXXXGXXXXXXXXXXXXXXXXXXX,0,0,0

2310,26,0,26,100,474,0,0,173,13,160,GXXXXXXXXXXXXXXXXXXXGXXXXXXXXXXXXXXXXXXXGXXXXXXXXXXXXXXXXXXXGOXXXXXXXXXXXXXXXXXXGOOXXXXXXXXXXXXXXXXXGOOOXXXXXXXXXXXXXXXXGOXXXXXXXXXXXXXXXXXXGOXXXXXXXXXXXXXXXXXXGXXXXXXXXXXXXXXXXXXXGOOXXXXXXXXXXXXXXXXXGXXXXXXXXXXXXXXXXXXXGOOOXXXXXXXXXXXXXXXXGXXXXXXXXXXXXXXXXXXX,0,0,0
2331,26,0,26,96,478,0,0,179,13,166,GXXXXXXXXXXXXXXXXXXXGXXXXXXXXXXXXXXXXXXXGXXXXXXXXXXXXXXXXXXXGOXXXXXXXXXXXXXXXXXXGOOXXXXXXXXXXXXXXXXXGOOOXXXXXXXXXXXXXXXXGOXXXXXXXXXXXXXXXXXXGOXXXXXXXXXXXXXXXXXXGXXXXXXXXXXXXXXXXXXXGOOXXXXXXXXXXXXXXXXXGXXXXXXXXXXXXXXXXXXXGOOOXXXXXXXXXXXXXXXXGXXXXXXXXXXXXXXXXXXX,0,0,0
2352,26,0,26,98,476,0,0,176,14,162,GXXXXXXXXXXXXXXXXXXXGXXXXXXXXXXXXXXXXXXXGXXXXXXXXXXXXXXXXXXXGOXXXXXXXXXXXXXXXXXXGOOXXXXXXXXXXXXXXXXXGOOOXXXXXXXXXXXXXXXXGOXXXXXXXXXXXXXXXXXXGOXXXXXXXXXXXXXXXXXXGXXXXXXXXXXXXXXXXXXXGOOXXXXXXXXXXXXXXXXXGXXXXXXXXXXXXXXXXXXXGOOOXXXXXXXXXXXXXXXXGXXXXXXXXXXXXXXXXXXX,0,0,0
2373,26,0,26,98,476,0,0,176,15,161,GXXXXXXXXXXXXXXXXXXXGXXXXXXXXXXXXXXXXXXXGXXXXXXXXXXXXXXXXXXXGOXXXXXXXXXXXXXXXXXXGOOXXXXXXXXXXXXXXXXXGOOOXXXXXXXXXXXXXXXXGOXXXXXXXXXXXXXXXXXXGOXXXXXXXXXXXXXXXXXXGXXXXXXXXXXXXXXXXXXXGOOXXXXXXXXXXXXXXXXXGXXXXXXXXXXXXXXXXXXXGOOOXXXXXXXXXXXXXXXXGXXXXXXXXXXXXXXXXXXX,0,0,0
2394,26,0,26,102,472,0,0,172,12,160,GXXXXXXXXXXXXXXXXXXXGXXXXXXXXXXXXXXXXXXXGXXXXXXXXXXXXXXXXXXXGOXXXXXXXXXXXXXXXXXXGOOXXXXXXXXXXXXXXXXXGOOOXXXXXXXXXXXXXXXXGOXXXXXXXXXXXXXXXXXXGOXXXXXXXXXXXXXXXXXXGXXXXXXXXXXXXXXXXXXXGOOXXXXXXXXXXXXXXXXXGXXXXXXXXXXXXXXXXXXXGOOOXXXXXXXXXXXXXXXXGXXXXXXXXXXXXXXXXXXX,0,0,0

2415,26,0,26,96,478,0,0,178,14,164,GXXXXXXXXXXXXXXXXXXXGXXXXXXXXXXXXXXXXXXXGXXXXXXXXXXXXXXXXXXXGOXXXXXXXXXXXXXXXXXXGOOXXXXXXXXXXXXXXXXXGOOOXXXXXXXXXXXXXXXXGOXXXXXXXXXXXXXXXXXXGOXXXXXXXXXXXXXXXXXXGXXXXXXXXXXXXXXXXXXXGOOXXXXXXXXXXXXXXXXXGXXXXXXXXXXXXXXXXXXXGOOOXXXXXXXXXXXXXXXXGXXXXXXXXXXXXXXXXXXX,0,0,0
2436,26,0,26,94,480,0,0,180,18,162,GXXXXXXXXXXXXXXXXXXXGXXXXXXXXXXXXXXXXXXXGXXXXXXXXXXXXXXXXXXXGOXXXXXXXXXXXXXXXXXXGOOXXXXXXXXXXXXXXXXXGOOOXXXXXXXXXXXXXXXXGOXXXXXXXXXXXXXXXXXXGOXXXXXXXXXXXXXXXXXXGXXXXXXXXXXXXXXXXXXXGOOXXXXXXXXXXXXXXXXXGXXXXXXXXXXXXXXXXXXXGOOOXXXXXXXXXXXXXXXXGXXXXXXXXXXXXXXXXXXX,0,0,0
2457,26,0,26,95,479,0,0,178,12,166,GXXXXXXXXXXXXXXXXXXXGXXXXXXXXXXXXXXXXXXXGXXXXXXXXXXXXXXXXXXXGOXXXXXXXXXXXXXXXXXXGOOXXXXXXXXXXXXXXXXXGOOOXXXXXXXXXXXXXXXXGOXXXXXXXXXXXXXXXXXXGOXXXXXXXXXXXXXXXXXXGXXXXXXXXXXXXXXXXXXXGOOXXXXXXXXXXXXXXXXXGXXXXXXXXXXXXXXXXXXXGOOOXXXXXXXXXXXXXXXXGXXXXXXXXXXXXXXXXXXX,0,0,0
2478,26,0,26,92,482,0,0,181,13,168,GXXXXXXXXXXXXXXXXXXXGXXXXXXXXXXXXXXXXXXXGXXXXXXXXXXXXXXXXXXXGOXXXXXXXXXXXXXXXXXXGOOXXXXXXXXXXXXXXXXXGOOOXXXXXXXXXXXXXXXXGOXXXXXXXXXXXXXXXXXXGOXXXXXXXXXXXXXXXXXXGXXXXXXXXXXXXXXXXXXXGOOXXXXXXXXXXXXXXXXXGXXXXXXXXXXXXXXXXXXXGOOOXXXXXXXXXXXXXXXXGXXXXXXXXXXXXXXXXXXX,0,0,0
2499,27,1,26,88,485,0,0,186,16,170,GXXXXXXXXXXXXXXXXXXXGXXXXXXXXXXXXXXXXXXXGXXXXXXXXXXXXXXXXXXXGOXXXXXXXXXXXXXXXXXXGOOXXXXXXXXXXXXXXXXXGOOOXXXXXXXXXXXXXXXXGOXXXXXXXXXXXXXXXXXXGOXXXXXXXXXXXXXXXXXXGXXXXXXXXXXXXXXXXXXXGOOXXXXXXXXXXXXXXXXXGXXXXXXXXXXXXXXXXXXXGOOOAXXXXXXXXXXXXXXXGXXXXXXXXXXXXXXXXXXX,0,0,0

2520,27,1,26,95,478,0,0,179,13,166,GXXXXXXXXXXXXXXXXXXXGXXXXXXXXXXXXXXXXXXXGXXXXXXXXXXXXXXXXXXXGOXXXXXXXXXXXXXXXXXXGOOXXXXXXXXXXXXXXXXXGOOOXXXXXXXXXXXXXXXXGOXXXXXXXXXXXXXXXXXXGOXXXXXXXXXXXXXXXXXXGXXXXXXXXXXXXXXXXXXXGOOXXXXXXXXXXXXXXXXXGXXXXXXXXXXXXXXXXXXXGOOOAXXXXXXXXXXXXXXXGXXXXXXXXXXXXXXXXXXX,0,0,0
2541,27,1,26,92,481,0,0,181,13,168,GXXXXXXXXXXXXXXXXXXXGXXXXXXXXXXXXXXXXXXXGXXXXXXXXXXXXXXXXXXXGOXXXXXXXXXXXXXXXXXXGOOXXXXXXXXXXXXXXXXXGOOOXXXXXXXXXXXXXXXXGOXXXXXXXXXXXXXXXXXXGOXXXXXXXXXXXXXXXXXXGXXXXXXXXXXXXXXXXXXXGOOXXXXXXXXXXXXXXXXXGXXXXXXXXXXXXXXXXXXXGOOOAXXXXXXXXXXXXXXXGXXXXXXXXXXXXXXXXXXX,0,0,0
2562,27,1,26,91,482,0,0,182,15,167,GXXXXXXXXXXXXXXXXXXXGXXXXXXXXXXXXXXXXXXXGXXXXXXXXXXXXXXXXXXXGOXXXXXXXXXXXXXXXXXXGOOXXXXXXXXXXXXXXXXXGOOOXXXXXXXXXXXXXXXXGOXXXXXXXXXXXXXXXXXXGOXXXXXXXXXXXXXXXXXXGXXXXXXXXXXXXXXXXXXXGOOXXXXXXXXXXXXXXXXXGXXXXXXXXXXXXXXXXXXXGOOOAXXXXXXXXXXXXXXXGXXXXXXXXXXXXXXXXXXX,0,0,0
2583,27,0,27,89,484,0,0,184,11,173,GXXXXXXXXXXXXXXXXXXXGXXXXXXXXXXXXXXXXXXXGXXXXXXXXXXXXXXXXXXXGOXXXXXXXXXXXXXXXXXXGOOXXXXXXXXXXXXXXXXXGOOOXXXXXXXXXXXXXXXXGOXXXXXXXXXXXXXXXXXXGOXXXXXXXXXXXXXXXXXXGXXXXXXXXXXXXXXXXXXXGOOXXXXXXXXXXXXXXXXXGXXXXXXXXXXXXXXXXXXXGOOOOXXXXXXXXXXXXXXXGXXXXXXXXXXXXXXXXXXX,0,0,0
2604,27,0,27,90,483,0,0,185,17,168,GXXXXXXXXXXXXXXXXXXXGXXXXXXXXXXXXXXXXXXXGXXXXXXXXXXXXXXXXXXXGOXXXXXXXXXXXXXXXXXXGOOXXXXXXXXXXXXXXXXXGOOOXXXXXXXXXXXXXXXXGOXXXXXXXXXXXXXXXXXXGOXXXXXXXXXXXXXXXXXXGXXXXXXXXXXXXXXXXXXXGOOXXXXXXXXXXXXXXXXXGXXXXXXXXXXXXXXXXXXXGOOOOXXXXXXXXXXXXXXXGXXXXXXXXXXXXXXXXXXX,0,0,0

2625,27,0,27,92,481,0,0,182,15,167,GXXXXXXXXXXXXXXXXXXXGXXXXXXXXXXXXXXXXXXXGXXXXXXXXXXXXXXXXXXXGOXXXXXXXXXXXXXXXXXXGOOXXXXXXXXXXXXXXXXXGOOOXXXXXXXXXXXXXXXXGOXXXXXXXXXXXXXXXXXXGOXXXXXXXXXXXXXXXXXXGXXXXXXXXXXXXXXXXXXXGOOXXXXXXXXXXXXXXXXXGXXXXXXXXXXXXXXXXXXXGOOOOXXXXXXXXXXXXXXXGXXXXXXXXXXXXXXXXXXX,0,0,0
2646,27,0,27,90,483,0,0,185,15,170,GXXXXXXXXXXXXXXXXXXXGXXXXXXXXXXXXXXXXXXXGXXXXXXXXXXXXXXXXXXXGOXXXXXXXXXXXXXXXXXXGOOXXXXXXXXXXXXXXXXXGOOOXXXXXXXXXXXXXXXXGOXXXXXXXXXXXXXXXXXXGOXXXXXXXXXXXXXXXXXXGXXXXXXXXXXXXXXXXXXXGOOXXXXXXXXXXXXXXXXXGXXXXXXXXXXXXXXXXXXXGOOOOXXXXXXXXXXXXXXXGXXXXXXXXXXXXXXXXXXX,0,0,0
2667,27,0,27,89,484,0,0,185,16,169,GXXXXXXXXXXXXXXXXXXXGXXXXXXXXXXXXXXXXXXXGXXXXXXXXXXXXXXXXXXXGOXXXXXXXXXXXXXXXXXXGOOXXXXXXXXXXXXXXXXXGOOOXXXXXXXXXXXXXXXXGOXXXXXXXXXXXXXXXXXXGOXXXXXXXXXXXXXXXXXXGXXXXXXXXXXXXXXXXXXXGOOXXXXXXXXXXXXXXXXXGXXXXXXXXXXXXXXXXXXXGOOOOXXXXXXXXXXXXXXXGXXXXXXXXXXXXXXXXXXX,0,0,0
2688,27,0,27,94,479,0,0,180,18,162,GXXXXXXXXXXXXXXXXXXXGXXXXXXXXXXXXXXXXXXXGXXXXXXXXXXXXXXXXXXXGOXXXXXXXXXXXXXXXXXXGOOXXXXXXXXXXXXXXXXXGOOOXXXXXXXXXXXXXXXXGOXXXXXXXXXXXXXXXXXXGOXXXXXXXXXXXXXXXXXXGXXXXXXXXXXXXXXXXXXXGOOXXXXXXXXXXXXXXXXXGXXXXXXXXXXXXXXXXXXXGOOOOXXXXXXXXXXXXXXXGXXXXXXXXXXXXXXXXXXX,0,0,0
2709,27,0,27,88,485,0,0,184,20,164,GXXXXXXXXXXXXXXXXXXXGXXXXXXXXXXXXXXXXXXXGXXXXXXXXXXXXXXXXXXXGOXXXXXXXXXXXXXXXXXXGOOXXXXXXXXXXXXXXXXXGOOOXXXXXXXXXXXXXXXXGOXXXXXXXXXXXXXXXXXXGOXXXXXXXXXXXXXXXXXXGXXXXXXXXXXXXXXXXXXXGOOXXXXXXXXXXXXXXXXXGXXXXXXXXXXXXXXXXXXXGOOOOXXXXXXXXXXXXXXXGXXXXXXXXXXXXXXXXXXX,0,0,0

2730,27,0,27,91,482,0,0,183,14,169,GXXXXXXXXXXXXXXXXXXXGXXXXXXXXXXXXXXXXXXXGXXXXXXXXXXXXXXXXXXXGOXXXXXXXXXXXXXXXXXXGOOXXXXXXXXXXXXXXXXXGOOOXXXXXXXXXXXXXXXXGOXXXXXXXXXXXXXXXXXXGOXXXXXXXXXXXXXXXXXXGXXXXXXXXXXXXXXXXXXXGOOXXXXXXXXXXXXXXXXXGXXXXXXXXXXXXXXXXXXXGOOOOXXXXXXXXXXXXXXXGXXXXXXXXXXXXXXXXXXX,0,0,0
2751,28,1,27,88,484,0,0,188,14,174,GAXXXXXXXXXXXXXXXXXXGXXXXXXXXXXXXXXXXXXXGXXXXXXXXXXXXXXXXXXXGOXXXXXXXXXXXXXXXXXXGOOXXXXXXXXXXXXXXXXXGOOOXXXXXXXXXXXXXXXXGOXXXXXXXXXXXXXXXXXXGOXXXXXXXXXXXXXXXXXXGXXXXXXXXXXXXXXXXXXXGOOXXXXXXXXXXXXXXXXXGXXXXXXXXXXXXXXXXXXXGOOOOXXXXXXXXXXXXXXXGXXXXXXXXXXXXXXXXXXX,0,0,0
2772,28,1,27,85,487,0,0,189,13,176,GAXXXXXXXXXXXXXXXXXXGXXXXXXXXXXXXXXXXXXXGXXXXXXXXXXXXXXXXXXXGOXXXXXXXXXXXXXXXXXXGOOXXXXXXXXXXXXXXXXXGOOOXXXXXXXXXXXXXXXXGOXXXXXXXXXXXXXXXXXXGOXXXXXXXXXXXXXXXXXXGXXXXXXXXXXXXXXXXXXXGOOXXXXXXXXXXXXXXXXXGXXXXXXXXXXXXXXXXXXXGOOOOXXXXXXXXXXXXXXXGXXXXXXXXXXXXXXXXXXX,0,0,0
2793,28,1,27,86,486,0,0,190,18,172,GAXXXXXXXXXXXXXXXXXXGXXXXXXXXXXXXXXXXXXXGXXXXXXXXXXXXXXXXXXXGOXXXXXXXXXXXXXXXXXXGOOXXXXXXXXXXXXXXXXXGOOOXXXXXXXXXXXXXXXXGOXXXXXXXXXXXXXXXXXXGOXXXXXXXXXXXXXXXXXXGXXXXXXXXXXXXXXXXXXXGOOXXXXXXXXXXXXXXXXXGXXXXXXXXXXXXXXXXXXXGOOOOXXXXXXXXXXXXXXXGXXXXXXXXXXXXXXXXXXX,0,0,0
2814,29,2,27,87,484,0,0,189,15,174,GAXXXXXXXXXXXXXXXXXXGXXXXXXXXXXXXXXXXXXXGXXXXXXXXXXXXXXXXXXXGOXXXXXXXXXXXXXXXXXXGOOXXXXXXXXXXXXXXXXXGOOOAXXXXXXXXXXXXXXXGOXXXXXXXXXXXXXXXXXXGOXXXXXXXXXXXXXXXXXXGXXXXXXXXXXXXXXXXXXXGOOXXXXXXXXXXXXXXXXXGXXXXXXXXXXXXXXXXXXXGOOOOXXXXXXXXXXXXXXXGXXXXXXXXXXXXXXXXXXX,0,0,0

2835,29,2,27,94,477,0,0,182,11,171,GAXXXXXXXXXXXXXXXXXXGXXXXXXXXXXXXXXXXXXXGXXXXXXXXXXXXXXXXXXXGOXXXXXXXXXXXXXXXXXXGOOXXXXXXXXXXXXXXXXXGOOOAXXXXXXXXXXXXXXXGOXXXXXXXXXXXXXXXXXXGOXXXXXXXXXXXXXXXXXXGXXXXXXXXXXXXXXXXXXXGOOXXXXXXXXXXXXXXXXXGXXXXXXXXXXXXXXXXXXXGOOOOXXXXXXXXXXXXXXXGXXXXXXXXXXXXXXXXXXX,0,0,0
2856,29,2,27,89,482,0,0,186,21,165,GAXXXXXXXXXXXXXXXXXXGXXXXXXXXXXXXXXXXXXXGXXXXXXXXXXXXXXXXXXXGOXXXXXXXXXXXXXXXXXXGOOXXXXXXXXXXXXXXXXXGOOOAXXXXXXXXXXXXXXXGOXXXXXXXXXXXXXXXXXXGOXXXXXXXXXXXXXXXXXXGXXXXXXXXXXXXXXXXXXXGOOXXXXXXXXXXXXXXXXXGXXXXXXXXXXXXXXXXXXXGOOOOXXXXXXXXXXXXXXXGXXXXXXXXXXXXXXXXXXX,0,0,0
2877,29,1,28,102,469,0,0,173,17,156,GOXXXXXXXXXXXXXXXXXXGXXXXXXXXXXXXXXXXXXXGXXXXXXXXXXXXXXXXXXXGOXXXXXXXXXXXXXXXXXXGOOXXXXXXXXXXXXXXXXXGOOOAXXXXXXXXXXXXXXXGOXXXXXXXXXXXXXXXXXXGOXXXXXXXXXXXXXXXXXXGXXXXXXXXXXXXXXXXXXXGOOXXXXXXXXXXXXXXXXXGXXXXXXXXXXXXXXXXXXXGOOOOXXXXXXXXXXXXXXXGXXXXXXXXXXXXXXXXXXX,0,0,0
2898,29,0,29,93,478,0,0,180,20,160,GOXXXXXXXXXXXXXXXXXXGXXXXXXXXXXXXXXXXXXXGXXXXXXXXXXXXXXXXXXXGOXXXXXXXXXXXXXXXXXXGOOXXXXXXXXXXXXXXXXXGOOOOXXXXXXXXXXXXXXXGOXXXXXXXXXXXXXXXXXXGOXXXXXXXXXXXXXXXXXXGXXXXXXXXXXXXXXXXXXXGOOXXXXXXXXXXXXXXXXXGXXXXXXXXXXXXXXXXXXXGOOOOXXXXXXXXXXXXXXXGXXXXXXXXXXXXXXXXXXX,0,0,0
2919,29,0,29,101,470,0,0,173,13,160,GOXXXXXXXXXXXXXXXXXXGXXXXXXXXXXXXXXXXXXXGXXXXXXXXXXXXXXXXXXXGOXXXXXXXXXXXXXXXXXXGOOXXXXXXXXXXXXXXXXXGOOOOXXXXXXXXXXXXXXXGOXXXXXXXXXXXXXXXXXXGOXXXXXXXXXXXXXXXXXXGXXXXXXXXXXXXXXXXXXXGOOXXXXXXXXXXXXXXXXXGXXXXXXXXXXXXXXXXXXXGOOOOXXXXXXXXXXXXXXXGXXXXXXXXXXXXXXXXXXX,0,0,0

2940,29,0,29,101,470,0,0,173,17,156,GOXXXXXXXXXXXXXXXXXXGXXXXXXXXXXXXXXXXXXXGXXXXXXXXXXXXXXXXXXXGOXXXXXXXXXXXXXXXXXXGOOXXXXXXXXXXXXXXXXXGOOOOXXXXXXXXXXXXXXXGOXXXXXXXXXXXXXXXXXXGOXXXXXXXXXXXXXXXXXXGXXXXXXXXXXXXXXXXXXXGOOXXXXXXXXXXXXXXXXXGXXXXXXXXXXXXXXXXXXXGOOOOXXXXXXXXXXXXXXXGXXXXXXXXXXXXXXXXXXX,0,0,0
2961,29,0,29,104,467,0,0,170,19,151,GOXXXXXXXXXXXXXXXXXXGXXXXXXXXXXXXXXXXXXXGXXXXXXXXXXXXXXXXXXXGOXXXXXXXXXXXXXXXXXXGOOXXXXXXXXXXXXXXXXXGOOOOXXXXXXXXXXXXXXXGOXXXXXXXXXXXXXXXXXXGOXXXXXXXXXXXXXXXXXXGXXXXXXXXXXXXXXXXXXXGOOXXXXXXXXXXXXXXXXXGXXXXXXXXXXXXXXXXXXXGOOOOXXXXXXXXXXXXXXXGXXXXXXXXXXXXXXXXXXX,0,0,0
2982,29,0,29,102,469,0,0,171,19,152,GOXXXXXXXXXXXXXXXXXXGXXXXXXXXXXXXXXXXXXXGXXXXXXXXXXXXXXXXXXXGOXXXXXXXXXXXXXXXXXXGOOXXXXXXXXXXXXXXXXXGOOOOXXXXXXXXXXXXXXXGOXXXXXXXXXXXXXXXXXXGOXXXXXXXXXXXXXXXXXXGXXXXXXXXXXXXXXXXXXXGOOXXXXXXXXXXXXXXXXXGXXXXXXXXXXXXXXXXXXXGOOOOXXXXXXXXXXXXXXXGXXXXXXXXXXXXXXXXXXX,0,0,0
3003,29,0,29,102,469,0,0,172,15,157,GOXXXXXXXXXXXXXXXXXXGXXXXXXXXXXXXXXXXXXXGXXXXXXXXXXXXXXXXXXXGOXXXXXXXXXXXXXXXXXXGOOXXXXXXXXXXXXXXXXXGOOOOXXXXXXXXXXXXXXXGOXXXXXXXXXXXXXXXXXXGOXXXXXXXXXXXXXXXXXXGXXXXXXXXXXXXXXXXXXXGOOXXXXXXXXXXXXXXXXXGXXXXXXXXXXXXXXXXXXXGOOOOXXXXXXXXXXXXXXXGXXXXXXXXXXXXXXXXXXX,0,0,0
3024,29,0,29,97,474,0,0,177,19,158,GOXXXXXXXXXXXXXXXXXXGXXXXXXXXXXXXXXXXXXXGXXXXXXXXXXXXXXXXXXXGOXXXXXXXXXXXXXXXXXXGOOXXXXXXXXXXXXXXXXXGOOOOXXXXXXXXXXXXXXXGOXXXXXXXXXXXXXXXXXXGOXXXXXXXXXXXXXXXXXXGXXXXXXXXXXXXXXXXXXXGOOXXXXXXXXXXXXXXXXXGXXXXXXXXXXXXXXXXXXXGOOOOXXXXXXXXXXXXXXXGXXXXXXXXXXXXXXXXXXX,0,0,0

3045,29,0,29,97,474,0,0,176,21,155,GOXXXXXXXXXXXXXXXXXXGXXXXXXXXXXXXXXXXXXXGXXXXXXXXXXXXXXXXXXXGOXXXXXXXXXXXXXXXXXXGOOXXXXXXXXXXXXXXXXXGOOOOXXXXXXXXXXXXXXXGOXXXXXXXXXXXXXXXXXXGOXXXXXXXXXXXXXXXXXXGXXXXXXXXXXXXXXXXXXXGOOXXXXXXXXXXXXXXXXXGXXXXXXXXXXXXXXXXXXXGOOOOXXXXXXXXXXXXXXXGXXXXXXXXXXXXXXXXXXX,0,0,0
3066,29,0,29,94,477,0,0,180,17,163,GOXXXXXXXXXXXXXXXXXXGXXXXXXXXXXXXXXXXXXXGXXXXXXXXXXXXXXXXXXXGOXXXXXXXXXXXXXXXXXXGOOXXXXXXXXXXXXXXXXXGOOOOXXXXXXXXXXXXXXXGOXXXXXXXXXXXXXXXXXXGOXXXXXXXXXXXXXXXXXXGXXXXXXXXXXXXXXXXXXXGOOXXXXXXXXXXXXXXXXXGXXXXXXXXXXXXXXXXXXXGOOOOXXXXXXXXXXXXXXXGXXXXXXXXXXXXXXXXXXX,0,0,0
3087,30,1,29,86,484,0,0,185,18,167,GOXXXXXXXXXXXXXXXXXXGXXXXXXXXXXXXXXXXXXXGXXXXXXXXXXXXXXXXXXXGOXXXXXXXXXXXXXXXXXXGOOXXXXXXXXXXXXXXXXXGOOOOXXXXXXXXXXXXXXXGOXXXXXXXXXXXXXXXXXXGOXXXXXXXXXXXXXXXXXXGXXXXXXXXXXXXXXXXXXXGOOXXXXXXXXXXXXXXXXXGAXXXXXXXXXXXXXXXXXXGOOOOXXXXXXXXXXXXXXXGXXXXXXXXXXXXXXXXXXX,0,0,0
3108,30,1,29,85,485,0,0,188,20,168,GOXXXXXXXXXXXXXXXXXXGXXXXXXXXXXXXXXXXXXXGXXXXXXXXXXXXXXXXXXXGOXXXXXXXXXXXXXXXXXXGOOXXXXXXXXXXXXXXXXXGOOOOXXXXXXXXXXXXXXXGOXXXXXXXXXXXXXXXXXXGOXXXXXXXXXXXXXXXXXXGXXXXXXXXXXXXXXXXXXXGOOXXXXXXXXXXXXXXXXXGAXXXXXXXXXXXXXXXXXXGOOOOXXXXXXXXXXXXXXXGXXXXXXXXXXXXXXXXXXX,0,0,0
3129,30,1,29,88,482,0,0,184,18,166,GOXXXXXXXXXXXXXXXXXXGXXXXXXXXXXXXXXXXXXXGXXXXXXXXXXXXXXXXXXXGOXXXXXXXXXXXXXXXXXXGOOXXXXXXXXXXXXXXXXXGOOOOXXXXXXXXXXXXXXXGOXXXXXXXXXXXXXXXXXXGOXXXXXXXXXXXXXXXXXXGXXXXXXXXXXXXXXXXXXXGOOXXXXXXXXXXXXXXXXXGAXXXXXXXXXXXXXXXXXXGOOOOXXXXXXXXXXXXXXXGXXXXXXXXXXXXXXXXXXX,0,0,0

3150,30,0,30,86,484,0,0,186,27,159,GOXXXXXXXXXXXXXXXXXXGXXXXXXXXXXXXXXXXXXXGXXXXXXXXXXXXXXXXXXXGOXXXXXXXXXXXXXXXXXXGOOXXXXXXXXXXXXXXXXXGOOOOXXXXXXXXXXXXXXXGOXXXXXXXXXXXXXXXXXXGOXXXXXXXXXXXXXXXXXXGXXXXXXXXXXXXXXXXXXXGOOXXXXXXXXXXXXXXXXXGOXXXXXXXXXXXXXXXXXXGOOOOXXXXXXXXXXXXXXXGXXXXXXXXXXXXXXXXXXX,0,0,0
3171,30,0,30,97,473,0,0,175,18,157,GOXXXXXXXXXXXXXXXXXXGXXXXXXXXXXXXXXXXXXXGXXXXXXXXXXXXXXXXXXXGOXXXXXXXXXXXXXXXXXXGOOXXXXXXXXXXXXXXXXXGOOOOXXXXXXXXXXXXXXXGOXXXXXXXXXXXXXXXXXXGOXXXXXXXXXXXXXXXXXXGXXXXXXXXXXXXXXXXXXXGOOXXXXXXXXXXXXXXXXXGOXXXXXXXXXXXXXXXXXXGOOOOXXXXXXXXXXXXXXXGXXXXXXXXXXXXXXXXXXX,0,0,0
3192,30,0,30,97,473,0,0,175,20,155,GOXXXXXXXXXXXXXXXXXXGXXXXXXXXXXXXXXXXXXXGXXXXXXXXXXXXXXXXXXXGOXXXXXXXXXXXXXXXXXXGOOXXXXXXXXXXXXXXXXXGOOOOXXXXXXXXXXXXXXXGOXXXXXXXXXXXXXXXXXXGOXXXXXXXXXXXXXXXXXXGXXXXXXXXXXXXXXXXXXXGOOXXXXXXXXXXXXXXXXXGOXXXXXXXXXXXXXXXXXXGOOOOXXXXXXXXXXXXXXXGXXXXXXXXXXXXXXXXXXX,0,0,0
3213,30,0,30,97,473,0,0,172,20,152,GOXXXXXXXXXXXXXXXXXXGXXXXXXXXXXXXXXXXXXXGXXXXXXXXXXXXXXXXXXXGOXXXXXXXXXXXXXXXXXXGOOXXXXXXXXXXXXXXXXXGOOOOXXXXXXXXXXXXXXXGOXXXXXXXXXXXXXXXXXXGOXXXXXXXXXXXXXXXXXXGXXXXXXXXXXXXXXXXXXXGOOXXXXXXXXXXXXXXXXXGOXXXXXXXXXXXXXXXXXXGOOOOXXXXXXXXXXXXXXXGXXXXXXXXXXXXXXXXXXX,0,0,0
3234,30,0,30,97,473,0,0,174,19,155,GOXXXXXXXXXXXXXXXXXXGXXXXXXXXXXXXXXXXXXXGXXXXXXXXXXXXXXXXXXXGOXXXXXXXXXXXXXXXXXXGOOXXXXXXXXXXXXXXXXXGOOOOXXXXXXXXXXXXXXXGOXXXXXXXXXXXXXXXXXXGOXXXXXXXXXXXXXXXXXXGXXXXXXXXXXXXXXXXXXXGOOXXXXXXXXXXXXXXXXXGOXXXXXXXXXXXXXXXXXXGOOOOXXXXXXXXXXXXXXXGXXXXXXXXXXXXXXXXXXX,0,0,0

3255,30,0,30,99,471,0,0,172,22,150,GOXXXXXXXXXXXXXXXXXXGXXXXXXXXXXXXXXXXXXXGXXXXXXXXXXXXXXXXXXXGOXXXXXXXXXXXXXXXXXXGOOXXXXXXXXXXXXXXXXXGOOOOXXXXXXXXXXXXXXXGOXXXXXXXXXXXXXXXXXXGOXXXXXXXXXXXXXXXXXXGXXXXXXXXXXXXXXXXXXXGOOXXXXXXXXXXXXXXXXXGOXXXXXXXXXXXXXXXXXXGOOOOXXXXXXXXXXXXXXXGXXXXXXXXXXXXXXXXXXX,0,0,0
3276,30,0,30,100,470,0,0,171,20,151,GOXXXXXXXXXXXXXXXXXXGXXXXXXXXXXXXXXXXXXXGXXXXXXXXXXXXXXXXXXXGOXXXXXXXXXXXXXXXXXXGOOXXXXXXXXXXXXXXXXXGOOOOXXXXXXXXXXXXXXXGOXXXXXXXXXXXXXXXXXXGOXXXXXXXXXXXXXXXXXXGXXXXXXXXXXXXXXXXXXXGOOXXXXXXXXXXXXXXXXXGOXXXXXXXXXXXXXXXXXXGOOOOXXXXXXXXXXXXXXXGXXXXXXXXXXXXXXXXXXX,0,0,0
3297,30,0,30,101,469,0,0,171,19,152,GOXXXXXXXXXXXXXXXXXXGXXXXXXXXXXXXXXXXXXXGXXXXXXXXXXXXXXXXXXXGOXXXXXXXXXXXXXXXXXXGOOXXXXXXXXXXXXXXXXXGOOOOXXXXXXXXXXXXXXXGOXXXXXXXXXXXXXXXXXXGOXXXXXXXXXXXXXXXXXXGXXXXXXXXXXXXXXXXXXXGOOXXXXXXXXXXXXXXXXXGOXXXXXXXXXXXXXXXXXXGOOOOXXXXXXXXXXXXXXXGXXXXXXXXXXXXXXXXXXX,0,0,0
3318,30,0,30,97,473,0,0,175,19,156,GOXXXXXXXXXXXXXXXXXXGXXXXXXXXXXXXXXXXXXXGXXXXXXXXXXXXXXXXXXXGOXXXXXXXXXXXXXXXXXXGOOXXXXXXXXXXXXXXXXXGOOOOXXXXXXXXXXXXXXXGOXXXXXXXXXXXXXXXXXXGOXXXXXXXXXXXXXXXXXXGXXXXXXXXXXXXXXXXXXXGOOXXXXXXXXXXXXXXXXXGOXXXXXXXXXXXXXXXXXXGOOOOXXXXXXXXXXXXXXXGXXXXXXXXXXXXXXXXXXX,0,0,0
3339,30,0,30,96,474,0,0,176,16,160,GOXXXXXXXXXXXXXXXXXXGXXXXXXXXXXXXXXXXXXXGXXXXXXXXXXXXXXXXXXXGOXXXXXXXXXXXXXXXXXXGOOXXXXXXXXXXXXXXXXXGOOOOXXXXXXXXXXXXXXXGOXXXXXXXXXXXXXXXXXXGOXXXXXXXXXXXXXXXXXXGXXXXXXXXXXXXXXXXXXXGOOXXXXXXXXXXXXXXXXXGOXXXXXXXXXXXXXXXXXXGOOOOXXXXXXXXXXXXXXXGXXXXXXXXXXXXXXXXXXX,0,0,0

3360,30,0,30,95,475,0,0,176,17,159,GOXXXXXXXXXXXXXXXXXXGXXXXXXXXXXXXXXXXXXXGXXXXXXXXXXXXXXXXXXXGOXXXXXXXXXXXXXXXXXXGOOXXXXXXXXXXXXXXXXXGOOOOXXXXXXXXXXXXXXXGOXXXXXXXXXXXXXXXXXXGOXXXXXXXXXXXXXXXXXXGXXXXXXXXXXXXXXXXXXXGOOXXXXXXXXXXXXXXXXXGOXXXXXXXXXXXXXXXXXXGOOOOXXXXXXXXXXXXXXXGXXXXXXXXXXXXXXXXXXX,0,0,0
3381,30,0,30,95,475,0,0,177,19,158,GOXXXXXXXXXXXXXXXXXXGXXXXXXXXXXXXXXXXXXXGXXXXXXXXXXXXXXXXXXXGOXXXXXXXXXXXXXXXXXXGOOXXXXXXXXXXXXXXXXXGOOOOXXXXXXXXXXXXXXXGOXXXXXXXXXXXXXXXXXXGOXXXXXXXXXXXXXXXXXXGXXXXXXXXXXXXXXXXXXXGOOXXXXXXXXXXXXXXXXXGOXXXXXXXXXXXXXXXXXXGOOOOXXXXXXXXXXXXXXXGXXXXXXXXXXXXXXXXXXX,0,0,0
3402,31,1,30,85,484,0,0,185,20,165,GOXXXXXXXXXXXXXXXXXXGXXXXXXXXXXXXXXXXXXXGXXXXXXXXXXXXXXXXXXXGOXXXXXXXXXXXXXXXXXXGOOAXXXXXXXXXXXXXXXXGOOOOXXXXXXXXXXXXXXXGOXXXXXXXXXXXXXXXXXXGOXXXXXXXXXXXXXXXXXXGXXXXXXXXXXXXXXXXXXXGOOXXXXXXXXXXXXXXXXXGOXXXXXXXXXXXXXXXXXXGOOOOXXXXXXXXXXXXXXXGXXXXXXXXXXXXXXXXXXX,0,0,0
3423,31,1,30,88,481,0,0,183,18,165,GOXXXXXXXXXXXXXXXXXXGXXXXXXXXXXXXXXXXXXXGXXXXXXXXXXXXXXXXXXXGOXXXXXXXXXXXXXXXXXXGOOAXXXXXXXXXXXXXXXXGOOOOXXXXXXXXXXXXXXXGOXXXXXXXXXXXXXXXXXXGOXXXXXXXXXXXXXXXXXXGXXXXXXXXXXXXXXXXXXXGOOXXXXXXXXXXXXXXXXXGOXXXXXXXXXXXXXXXXXXGOOOOXXXXXXXXXXXXXXXGXXXXXXXXXXXXXXXXXXX,0,0,0
3444,31,1,30,84,485,0,0,185,20,165,GOXXXXXXXXXXXXXXXXXXGXXXXXXXXXXXXXXXXXXXGXXXXXXXXXXXXXXXXXXXGOXXXXXXXXXXXXXXXXXXGOOAXXXXXXXXXXXXXXXXGOOOOXXXXXXXXXXXXXXXGOXXXXXXXXXXXXXXXXXXGOXXXXXXXXXXXXXXXXXXGXXXXXXXXXXXXXXXXXXXGOOXXXXXXXXXXXXXXXXXGOXXXXXXXXXXXXXXXXXXGOOOOXXXXXXXXXXXXXXXGXXXXXXXXXXXXXXXXXXX,0,0,0

3465,31,1,30,83,486,0,0,187,17,170,GOXXXXXXXXXXXXXXXXXXGXXXXXXXXXXXXXXXXXXXGXXXXXXXXXXXXXXXXXXXGOXXXXXXXXXXXXXXXXXXGOOAXXXXXXXXXXXXXXXXGOOOOXXXXXXXXXXXXXXXGOXXXXXXXXXXXXXXXXXXGOXXXXXXXXXXXXXXXXXXGXXXXXXXXXXXXXXXXXXXGOOXXXXXXXXXXXXXXXXXGOXXXXXXXXXXXXXXXXXXGOOOOXXXXXXXXXXXXXXXGXXXXXXXXXXXXXXXXXXX,0,0,0
3486,31,0,31,87,482,0,0,183,19,164,GOXXXXXXXXXXXXXXXXXXGXXXXXXXXXXXXXXXXXXXGXXXXXXXXXXXXXXXXXXXGOXXXXXXXXXXXXXXXXXXGOOOXXXXXXXXXXXXXXXXGOOOOXXXXXXXXXXXXXXXGOXXXXXXXXXXXXXXXXXXGOXXXXXXXXXXXXXXXXXXGXXXXXXXXXXXXXXXXXXXGOOXXXXXXXXXXXXXXXXXGOXXXXXXXXXXXXXXXXXXGOOOOXXXXXXXXXXXXXXXGXXXXXXXXXXXXXXXXXXX,0,0,0
3507,31,0,31,90,479,0,0,180,20,160,GOXXXXXXXXXXXXXXXXXXGXXXXXXXXXXXXXXXXXXXGXXXXXXXXXXXXXXXXXXXGOXXXXXXXXXXXXXXXXXXGOOOXXXXXXXXXXXXXXXXGOOOOXXXXXXXXXXXXXXXGOXXXXXXXXXXXXXXXXXXGOXXXXXXXXXXXXXXXXXXGXXXXXXXXXXXXXXXXXXXGOOXXXXXXXXXXXXXXXXXGOXXXXXXXXXXXXXXXXXXGOOOOXXXXXXXXXXXXXXXGXXXXXXXXXXXXXXXXXXX,0,0,0
3528,31,0,31,96,473,0,0,174,20,154,GOXXXXXXXXXXXXXXXXXXGXXXXXXXXXXXXXXXXXXXGXXXXXXXXXXXXXXXXXXXGOXXXXXXXXXXXXXXXXXXGOOOXXXXXXXXXXXXXXXXGOOOOXXXXXXXXXXXXXXXGOXXXXXXXXXXXXXXXXXXGOXXXXXXXXXXXXXXXXXXGXXXXXXXXXXXXXXXXXXXGOOXXXXXXXXXXXXXXXXXGOXXXXXXXXXXXXXXXXXXGOOOOXXXXXXXXXXXXXXXGXXXXXXXXXXXXXXXXXXX,0,0,0
3549,31,0,31,95,474,0,0,175,23,152,GOXXXXXXXXXXXXXXXXXXGXXXXXXXXXXXXXXXXXXXGXXXXXXXXXXXXXXXXXXXGOXXXXXXXXXXXXXXXXXXGOOOXXXXXXXXXXXXXXXXGOOOOXXXXXXXXXXXXXXXGOXXXXXXXXXXXXXXXXXXGOXXXXXXXXXXXXXXXXXXGXXXXXXXXXXXXXXXXXXXGOOXXXXXXXXXXXXXXXXXGOXXXXXXXXXXXXXXXXXXGOOOOXXXXXXXXXXXXXXXGXXXXXXXXXXXXXXXXXXX,0,0,0

3570,31,0,31,96,473,0,0,175,23,152,GOXXXXXXXXXXXXXXXXXXGXXXXXXXXXXXXXXXXXXXGXXXXXXXXXXXXXXXXXXXGOXXXXXXXXXXXXXXXXXXGOOOXXXXXXXXXXXXXXXXGOOOOXXXXXXXXXXXXXXXGOXXXXXXXXXXXXXXXXXXGOXXXXXXXXXXXXXXXXXXGXXXXXXXXXXXXXXXXXXXGOOXXXXXXXXXXXXXXXXXGOXXXXXXXXXXXXXXXXXXGOOOOXXXXXXXXXXXXXXXGXXXXXXXXXXXXXXXXXXX,0,0,0
3591,31,0,31,102,467,0,0,169,14,155,GOXXXXXXXXXXXXXXXXXXGXXXXXXXXXXXXXXXXXXXGXXXXXXXXXXXXXXXXXXXGOXXXXXXXXXXXXXXXXXXGOOOXXXXXXXXXXXXXXXXGOOOOXXXXXXXXXXXXXXXGOXXXXXXXXXXXXXXXXXXGOXXXXXXXXXXXXXXXXXXGXXXXXXXXXXXXXXXXXXXGOOXXXXXXXXXXXXXXXXXGOXXXXXXXXXXXXXXXXXXGOOOOXXXXXXXXXXXXXXXGXXXXXXXXXXXXXXXXXXX,0,0,0
3612,31,0,31,100,469,0,0,171,21,150,GOXXXXXXXXXXXXXXXXXXGXXXXXXXXXXXXXXXXXXXGXXXXXXXXXXXXXXXXXXXGOXXXXXXXXXXXXXXXXXXGOOOXXXXXXXXXXXXXXXXGOOOOXXXXXXXXXXXXXXXGOXXXXXXXXXXXXXXXXXXGOXXXXXXXXXXXXXXXXXXGXXXXXXXXXXXXXXXXXXXGOOXXXXXXXXXXXXXXXXXGOXXXXXXXXXXXXXXXXXXGOOOOXXXXXXXXXXXXXXXGXXXXXXXXXXXXXXXXXXX,0,0,0
3633,31,0,31,98,471,0,0,173,16,157,GOXXXXXXXXXXXXXXXXXXGXXXXXXXXXXXXXXXXXXXGXXXXXXXXXXXXXXXXXXXGOXXXXXXXXXXXXXXXXXXGOOOXXXXXXXXXXXXXXXXGOOOOXXXXXXXXXXXXXXXGOXXXXXXXXXXXXXXXXXXGOXXXXXXXXXXXXXXXXXXGXXXXXXXXXXXXXXXXXXXGOOXXXXXXXXXXXXXXXXXGOXXXXXXXXXXXXXXXXXXGOOOOXXXXXXXXXXXXXXXGXXXXXXXXXXXXXXXXXXX,0,0,0
3654,31,0,31,99,470,0,0,172,22,150,GOXXXXXXXXXXXXXXXXXXGXXXXXXXXXXXXXXXXXXXGXXXXXXXXXXXXXXXXXXXGOXXXXXXXXXXXXXXXXXXGOOOXXXXXXXXXXXXXXXXGOOOOXXXXXXXXXXXXXXXGOXXXXXXXXXXXXXXXXXXGOXXXXXXXXXXXXXXXXXXGXXXXXXXXXXXXXXXXXXXGOOXXXXXXXXXXXXXXXXXGOXXXXXXXXXXXXXXXXXXGOOOOXXXXXXXXXXXXXXXGXXXXXXXXXXXXXXXXXXX,0,0,0

3675,31,0,31,95,474,0,0,176,19,157,GOXXXXXXXXXXXXXXXXXXGXXXXXXXXXXXXXXXXXXXGXXXXXXXXXXXXXXXXXXXGOXXXXXXXXXXXXXXXXXXGOOOXXXXXXXXXXXXXXXXGOOOOXXXXXXXXXXXXXXXGOXXXXXXXXXXXXXXXXXXGOXXXXXXXXXXXXXXXXXXGXXXXXXXXXXXXXXXXXXXGOOXXXXXXXXXXXXXXXXXGOXXXXXXXXXXXXXXXXXXGOOOOXXXXXXXXXXXXXXXGXXXXXXXXXXXXXXXXXXX,0,0,0
3696,31,0,31,97,472,0,0,175,22,153,GOXXXXXXXXXXXXXXXXXXGXXXXXXXXXXXXXXXXXXXGXXXXXXXXXXXXXXXXXXXGOXXXXXXXXXXXXXXXXXXGOOOXXXXXXXXXXXXXXXXGOOOOXXXXXXXXXXXXXXXGOXXXXXXXXXXXXXXXXXXGOXXXXXXXXXXXXXXXXXXGXXXXXXXXXXXXXXXXXXXGOOXXXXXXXXXXXXXXXXXGOXXXXXXXXXXXXXXXXXXGOOOOXXXXXXXXXXXXXXXGXXXXXXXXXXXXXXXXXXX,0,0,0
3717,31,0,31,95,474,0,0,176,18,158,GOXXXXXXXXXXXXXXXXXXGXXXXXXXXXXXXXXXXXXXGXXXXXXXXXXXXXXXXXXXGOXXXXXXXXXXXXXXXXXXGOOOXXXXXXXXXXXXXXXXGOOOOXXXXXXXXXXXXXXXGOXXXXXXXXXXXXXXXXXXGOXXXXXXXXXXXXXXXXXXGXXXXXXXXXXXXXXXXXXXGOOXXXXXXXXXXXXXXXXXGOXXXXXXXXXXXXXXXXXXGOOOOXXXXXXXXXXXXXXXGXXXXXXXXXXXXXXXXXXX,0,0,0
3738,31,0,31,89,480,0,0,182,21,161,GOXXXXXXXXXXXXXXXXXXGXXXXXXXXXXXXXXXXXXXGXXXXXXXXXXXXXXXXXXXGOXXXXXXXXXXXXXXXXXXGOOOXXXXXXXXXXXXXXXXGOOOOXXXXXXXXXXXXXXXGOXXXXXXXXXXXXXXXXXXGOXXXXXXXXXXXXXXXXXXGXXXXXXXXXXXXXXXXXXXGOOXXXXXXXXXXXXXXXXXGOXXXXXXXXXXXXXXXXXXGOOOOXXXXXXXXXXXXXXXGXXXXXXXXXXXXXXXXXXX,0,0,0
3759,31,0,31,90,479,0,0,181,21,160,GOXXXXXXXXXXXXXXXXXXGXXXXXXXXXXXXXXXXXXXGXXXXXXXXXXXXXXXXXXXGOXXXXXXXXXXXXXXXXXXGOOOXXXXXXXXXXXXXXXXGOOOOXXXXXXXXXXXXXXXGOXXXXXXXXXXXXXXXXXXGOXXXXXXXXXXXXXXXXXXGXXXXXXXXXXXXXXXXXXXGOOXXXXXXXXXXXXXXXXXGOXXXXXXXXXXXXXXXXXXGOOOOXXXXXXXXXXXXXXXGXXXXXXXXXXXXXXXXXXX,0,0,0

3780,31,0,31,87,482,0,0,183,18,165,GOXXXXXXXXXXXXXXXXXXGXXXXXXXXXXXXXXXXXXXGXXXXXXXXXXXXXXXXXXXGOXXXXXXXXXXXXXXXXXXGOOOXXXXXXXXXXXXXXXXGOOOOXXXXXXXXXXXXXXXGOXXXXXXXXXXXXXXXXXXGOXXXXXXXXXXXXXXXXXXGXXXXXXXXXXXXXXXXXXXGOOXXXXXXXXXXXXXXXXXGOXXXXXXXXXXXXXXXXXXGOOOOXXXXXXXXXXXXXXXGXXXXXXXXXXXXXXXXXXX,0,0,0
3801,31,0,31,83,486,0,0,187,20,167,GOXXXXXXXXXXXXXXXXXXGXXXXXXXXXXXXXXXXXXXGXXXXXXXXXXXXXXXXXXXGOXXXXXXXXXXXXXXXXXXGOOOXXXXXXXXXXXXXXXXGOOOOXXXXXXXXXXXXXXXGOXXXXXXXXXXXXXXXXXXGOXXXXXXXXXXXXXXXXXXGXXXXXXXXXXXXXXXXXXXGOOXXXXXXXXXXXXXXXXXGOXXXXXXXXXXXXXXXXXXGOOOOXXXXXXXXXXXXXXXGXXXXXXXXXXXXXXXXXXX,0,0,0
3822,31,0,31,82,487,0,0,187,20,167,GOXXXXXXXXXXXXXXXXXXGXXXXXXXXXXXXXXXXXXXGXXXXXXXXXXXXXXXXXXXGOXXXXXXXXXXXXXXXXXXGOOOXXXXXXXXXXXXXXXXGOOOOXXXXXXXXXXXXXXXGOXXXXXXXXXXXXXXXXXXGOXXXXXXXXXXXXXXXXXXGXXXXXXXXXXXXXXXXXXXGOOXXXXXXXXXXXXXXXXXGOXXXXXXXXXXXXXXXXXXGOOOOXXXXXXXXXXXXXXXGXXXXXXXXXXXXXXXXXXX,0,0,0
3843,31,0,31,84,485,0,0,186,20,166,GOXXXXXXXXXXXXXXXXXXGXXXXXXXXXXXXXXXXXXXGXXXXXXXXXXXXXXXXXXXGOXXXXXXXXXXXXXXXXXXGOOOXXXXXXXXXXXXXXXXGOOOOXXXXXXXXXXXXXXXGOXXXXXXXXXXXXXXXXXXGOXXXXXXXXXXXXXXXXXXGXXXXXXXXXXXXXXXXXXXGOOXXXXXXXXXXXXXXXXXGOXXXXXXXXXXXXXXXXXXGOOOOXXXXXXXXXXXXXXXGXXXXXXXXXXXXXXXXXXX,0,0,0
3864,31,0,31,87,482,0,0,183,25,158,GOXXXXXXXXXXXXXXXXXXGXXXXXXXXXXXXXXXXXXXGXXXXXXXXXXXXXXXXXXXGOXXXXXXXXXXXXXXXXXXGOOOXXXXXXXXXXXXXXXXGOOOOXXXXXXXXXXXXXXXGOXXXXXXXXXXXXXXXXXXGOXXXXXXXXXXXXXXXXXXGXXXXXXXXXXXXXXXXXXXGOOXXXXXXXXXXXXXXXXXGOXXXXXXXXXXXXXXXXXXGOOOOXXXXXXXXXXXXXXXGXXXXXXXXXXXXXXXXXXX,0,0,0

3885,31,0,31,89,480,0,0,181,25,156,GOXXXXXXXXXXXXXXXXXXGXXXXXXXXXXXXXXXXXXXGXXXXXXXXXXXXXXXXXXXGOXXXXXXXXXXXXXXXXXXGOOOXXXXXXXXXXXXXXXXGOOOOXXXXXXXXXXXXXXXGOXXXXXXXXXXXXXXXXXXGOXXXXXXXXXXXXXXXXXXGXXXXXXXXXXXXXXXXXXXGOOXXXXXXXXXXXXXXXXXGOXXXXXXXXXXXXXXXXXXGOOOOXXXXXXXXXXXXXXXGXXXXXXXXXXXXXXXXXXX,0,0,0
3906,32,1,31,96,472,0,0,173,19,154,GOXXXXXXXXXXXXXXXXXXGXXXXXXXXXXXXXXXXXXXGXXXXXXXXXXXXXXXXXXXGOXXXXXXXXXXXXXXXXXXGOOOXXXXXXXXXXXXXXXXGOOOOXXXXXXXXXXXXXXXGOXXXXXXXXXXXXXXXXXXGOXXXXXXXXXXXXXXXXXXGXXXXXXXXXXXXXXXXXXXGOOXXXXXXXXXXXXXXXXXGOAXXXXXXXXXXXXXXXXXGOOOOXXXXXXXXXXXXXXXGXXXXXXXXXXXXXXXXXXX,0,0,0
3927,33,2,31,98,469,0,0,172,23,149,GOAXXXXXXXXXXXXXXXXXGXXXXXXXXXXXXXXXXXXXGXXXXXXXXXXXXXXXXXXXGOXXXXXXXXXXXXXXXXXXGOOOXXXXXXXXXXXXXXXXGOOOOXXXXXXXXXXXXXXXGOXXXXXXXXXXXXXXXXXXGOXXXXXXXXXXXXXXXXXXGXXXXXXXXXXXXXXXXXXXGOOXXXXXXXXXXXXXXXXXGOAXXXXXXXXXXXXXXXXXGOOOOXXXXXXXXXXXXXXXGXXXXXXXXXXXXXXXXXXX,0,0,0
3948,33,2,31,102,465,0,0,168,25,143,GOAXXXXXXXXXXXXXXXXXGXXXXXXXXXXXXXXXXXXXGXXXXXXXXXXXXXXXXXXXGOXXXXXXXXXXXXXXXXXXGOOOXXXXXXXXXXXXXXXXGOOOOXXXXXXXXXXXXXXXGOXXXXXXXXXXXXXXXXXXGOXXXXXXXXXXXXXXXXXXGXXXXXXXXXXXXXXXXXXXGOOXXXXXXXXXXXXXXXXXGOAXXXXXXXXXXXXXXXXXGOOOOXXXXXXXXXXXXXXXGXXXXXXXXXXXXXXXXXXX,0,0,0
3969,33,2,31,101,466,0,0,169,21,148,GOAXXXXXXXXXXXXXXXXXGXXXXXXXXXXXXXXXXXXXGXXXXXXXXXXXXXXXXXXXGOXXXXXXXXXXXXXXXXXXGOOOXXXXXXXXXXXXXXXXGOOOOXXXXXXXXXXXXXXXGOXXXXXXXXXXXXXXXXXXGOXXXXXXXXXXXXXXXXXXGXXXXXXXXXXXXXXXXXXXGOOXXXXXXXXXXXXXXXXXGOAXXXXXXXXXXXXXXXXXGOOOOXXXXXXXXXXXXXXXGXXXXXXXXXXXXXXXXXXX,0,0,0

3990,33,1,32,99,468,0,0,171,20,151,GOAXXXXXXXXXXXXXXXXXGXXXXXXXXXXXXXXXXXXXGXXXXXXXXXXXXXXXXXXXGOXXXXXXXXXXXXXXXXXXGOOOXXXXXXXXXXXXXXXXGOOOOXXXXXXXXXXXXXXXGOXXXXXXXXXXXXXXXXXXGOXXXXXXXXXXXXXXXXXXGXXXXXXXXXXXXXXXXXXXGOOXXXXXXXXXXXXXXXXXGOOXXXXXXXXXXXXXXXXXGOOOOXXXXXXXXXXXXXXXGXXXXXXXXXXXXXXXXXXX,0,0,0
4011,33,1,32,98,469,0,0,172,18,154,GOAXXXXXXXXXXXXXXXXXGXXXXXXXXXXXXXXXXXXXGXXXXXXXXXXXXXXXXXXXGOXXXXXXXXXXXXXXXXXXGOOOXXXXXXXXXXXXXXXXGOOOOXXXXXXXXXXXXXXXGOXXXXXXXXXXXXXXXXXXGOXXXXXXXXXXXXXXXXXXGXXXXXXXXXXXXXXXXXXXGOOXXXXXXXXXXXXXXXXXGOOXXXXXXXXXXXXXXXXXGOOOOXXXXXXXXXXXXXXXGXXXXXXXXXXXXXXXXXXX,0,0,0
4032,33,1,32,99,468,0,0,171,19,152,GOAXXXXXXXXXXXXXXXXXGXXXXXXXXXXXXXXXXXXXGXXXXXXXXXXXXXXXXXXXGOXXXXXXXXXXXXXXXXXXGOOOXXXXXXXXXXXXXXXXGOOOOXXXXXXXXXXXXXXXGOXXXXXXXXXXXXXXXXXXGOXXXXXXXXXXXXXXXXXXGXXXXXXXXXXXXXXXXXXXGOOXXXXXXXXXXXXXXXXXGOOXXXXXXXXXXXXXXXXXGOOOOXXXXXXXXXXXXXXXGXXXXXXXXXXXXXXXXXXX,0,0,0
4053,33,1,32,96,471,0,0,175,23,152,GOAXXXXXXXXXXXXXXXXXGXXXXXXXXXXXXXXXXXXXGXXXXXXXXXXXXXXXXXXXGOXXXXXXXXXXXXXXXXXXGOOOXXXXXXXXXXXXXXXXGOOOOXXXXXXXXXXXXXXXGOXXXXXXXXXXXXXXXXXXGOXXXXXXXXXXXXXXXXXXGXXXXXXXXXXXXXXXXXXXGOOXXXXXXXXXXXXXXXXXGOOXXXXXXXXXXXXXXXXXGOOOOXXXXXXXXXXXXXXXGXXXXXXXXXXXXXXXXXXX,0,0,0
4074,33,1,32,93,474,0,0,177,19,158,GOAXXXXXXXXXXXXXXXXXGXXXXXXXXXXXXXXXXXXXGXXXXXXXXXXXXXXXXXXXGOXXXXXXXXXXXXXXXXXXGOOOXXXXXXXXXXXXXXXXGOOOOXXXXXXXXXXXXXXXGOXXXXXXXXXXXXXXXXXXGOXXXXXXXXXXXXXXXXXXGXXXXXXXXXXXXXXXXXXXGOOXXXXXXXXXXXXXXXXXGOOXXXXXXXXXXXXXXXXXGOOOOXXXXXXXXXXXXXXXGXXXXXXXXXXXXXXXXXXX,0,0,0

4095,33,1,32,94,473,0,0,177,15,162,GOAXXXXXXXXXXXXXXXXXGXXXXXXXXXXXXXXXXXXXGXXXXXXXXXXXXXXXXXXXGOXXXXXXXXXXXXXXXXXXGOOOXXXXXXXXXXXXXXXXGOOOOXXXXXXXXXXXXXXXGOXXXXXXXXXXXXXXXXXXGOXXXXXXXXXXXXXXXXXXGXXXXXXXXXXXXXXXXXXXGOOXXXXXXXXXXXXXXXXXGOOXXXXXXXXXXXXXXXXXGOOOOXXXXXXXXXXXXXXXGXXXXXXXXXXXXXXXXXXX,0,0,0
4116,33,1,32,90,477,0,0,181,17,164,GOAXXXXXXXXXXXXXXXXXGXXXXXXXXXXXXXXXXXXXGXXXXXXXXXXXXXXXXXXXGOXXXXXXXXXXXXXXXXXXGOOOXXXXXXXXXXXXXXXXGOOOOXXXXXXXXXXXXXXXGOXXXXXXXXXXXXXXXXXXGOXXXXXXXXXXXXXXXXXXGXXXXXXXXXXXXXXXXXXXGOOXXXXXXXXXXXXXXXXXGOOXXXXXXXXXXXXXXXXXGOOOOXXXXXXXXXXXXXXXGXXXXXXXXXXXXXXXXXXX,0,0,0
4137,33,1,32,90,477,0,0,181,20,161,GOAXXXXXXXXXXXXXXXXXGXXXXXXXXXXXXXXXXXXXGXXXXXXXXXXXXXXXXXXXGOXXXXXXXXXXXXXXXXXXGOOOXXXXXXXXXXXXXXXXGOOOOXXXXXXXXXXXXXXXGOXXXXXXXXXXXXXXXXXXGOXXXXXXXXXXXXXXXXXXGXXXXXXXXXXXXXXXXXXXGOOXXXXXXXXXXXXXXXXXGOOXXXXXXXXXXXXXXXXXGOOOOXXXXXXXXXXXXXXXGXXXXXXXXXXXXXXXXXXX,0,0,0
4158,33,0,33,85,482,0,0,186,18,168,GOOXXXXXXXXXXXXXXXXXGXXXXXXXXXXXXXXXXXXXGXXXXXXXXXXXXXXXXXXXGOXXXXXXXXXXXXXXXXXXGOOOXXXXXXXXXXXXXXXXGOOOOXXXXXXXXXXXXXXXGOXXXXXXXXXXXXXXXXXXGOXXXXXXXXXXXXXXXXXXGXXXXXXXXXXXXXXXXXXXGOOXXXXXXXXXXXXXXXXXGOOXXXXXXXXXXXXXXXXXGOOOOXXXXXXXXXXXXXXXGXXXXXXXXXXXXXXXXXXX,0,0,0
4179,33,0,33,85,482,0,0,185,16,169,GOOXXXXXXXXXXXXXXXXXGXXXXXXXXXXXXXXXXXXXGXXXXXXXXXXXXXXXXXXXGOXXXXXXXXXXXXXXXXXXGOOOXXXXXXXXXXXXXXXXGOOOOXXXXXXXXXXXXXXXGOXXXXXXXXXXXXXXXXXXGOXXXXXXXXXXXXXXXXXXGXXXXXXXXXXXXXXXXXXXGOOXXXXXXXXXXXXXXXXXGOOXXXXXXXXXXXXXXXXXGOOOOXXXXXXXXXXXXXXXGXXXXXXXXXXXXXXXXXXX,0,0,0

4200,33,0,33,79,488,0,0,192,19,173,GOOXXXXXXXXXXXXXXXXXGXXXXXXXXXXXXXXXXXXXGXXXXXXXXXXXXXXXXXXXGOXXXXXXXXXXXXXXXXXXGOOOXXXXXXXXXXXXXXXXGOOOOXXXXXXXXXXXXXXXGOXXXXXXXXXXXXXXXXXXGOXXXXXXXXXXXXXXXXXXGXXXXXXXXXXXXXXXXXXXGOOXXXXXXXXXXXXXXXXXGOOXXXXXXXXXXXXXXXXXGOOOOXXXXXXXXXXXXXXXGXXXXXXXXXXXXXXXXXXX,0,0,0
4221,33,0,33,76,491,0,0,195,20,175,GOOXXXXXXXXXXXXXXXXXGXXXXXXXXXXXXXXXXXXXGXXXXXXXXXXXXXXXXXXXGOXXXXXXXXXXXXXXXXXXGOOOXXXXXXXXXXXXXXXXGOOOOXXXXXXXXXXXXXXXGOXXXXXXXXXXXXXXXXXXGOXXXXXXXXXXXXXXXXXXGXXXXXXXXXXXXXXXXXXXGOOXXXXXXXXXXXXXXXXXGOOXXXXXXXXXXXXXXXXXGOOOOXXXXXXXXXXXXXXXGXXXXXXXXXXXXXXXXXXX,0,0,0
4242,33,0,33,77,490,0,0,192,22,170,GOOXXXXXXXXXXXXXXXXXGXXXXXXXXXXXXXXXXXXXGXXXXXXXXXXXXXXXXXXXGOXXXXXXXXXXXXXXXXXXGOOOXXXXXXXXXXXXXXXXGOOOOXXXXXXXXXXXXXXXGOXXXXXXXXXXXXXXXXXXGOXXXXXXXXXXXXXXXXXXGXXXXXXXXXXXXXXXXXXXGOOXXXXXXXXXXXXXXXXXGOOXXXXXXXXXXXXXXXXXGOOOOXXXXXXXXXXXXXXXGXXXXXXXXXXXXXXXXXXX,0,0,0
4263,34,1,33,81,485,0,0,190,21,169,GOOXXXXXXXXXXXXXXXXXGXXXXXXXXXXXXXXXXXXXGXXXXXXXXXXXXXXXXXXXGOXXXXXXXXXXXXXXXXXXGOOOAXXXXXXXXXXXXXXXGOOOOXXXXXXXXXXXXXXXGOXXXXXXXXXXXXXXXXXXGOXXXXXXXXXXXXXXXXXXGXXXXXXXXXXXXXXXXXXXGOOXXXXXXXXXXXXXXXXXGOOXXXXXXXXXXXXXXXXXGOOOOXXXXXXXXXXXXXXXGXXXXXXXXXXXXXXXXXXX,0,0,0
4284,34,0,34,80,486,0,0,190,21,169,GOOXXXXXXXXXXXXXXXXXGXXXXXXXXXXXXXXXXXXXGXXXXXXXXXXXXXXXXXXXGOXXXXXXXXXXXXXXXXXXGOOOOXXXXXXXXXXXXXXXGOOOOXXXXXXXXXXXXXXXGOXXXXXXXXXXXXXXXXXXGOXXXXXXXXXXXXXXXXXXGXXXXXXXXXXXXXXXXXXXGOOXXXXXXXXXXXXXXXXXGOOXXXXXXXXXXXXXXXXXGOOOOXXXXXXXXXXXXXXXGXXXXXXXXXXXXXXXXXXX,0,0,0

4305,34,0,34,79,487,0,0,190,18,172,GOOXXXXXXXXXXXXXXXXXGXXXXXXXXXXXXXXXXXXXGXXXXXXXXXXXXXXXXXXXGOXXXXXXXXXXXXXXXXXXGOOOOXXXXXXXXXXXXXXXGOOOOXXXXXXXXXXXXXXXGOXXXXXXXXXXXXXXXXXXGOXXXXXXXXXXXXXXXXXXGXXXXXXXXXXXXXXXXXXXGOOXXXXXXXXXXXXXXXXXGOOXXXXXXXXXXXXXXXXXGOOOOXXXXXXXXXXXXXXXGXXXXXXXXXXXXXXXXXXX,0,0,0
4326,34,0,34,72,494,0,0,195,23,172,GOOXXXXXXXXXXXXXXXXXGXXXXXXXXXXXXXXXXXXXGXXXXXXXXXXXXXXXXXXXGOXXXXXXXXXXXXXXXXXXGOOOOXXXXXXXXXXXXXXXGOOOOXXXXXXXXXXXXXXXGOXXXXXXXXXXXXXXXXXXGOXXXXXXXXXXXXXXXXXXGXXXXXXXXXXXXXXXXXXXGOOXXXXXXXXXXXXXXXXXGOOXXXXXXXXXXXXXXXXXGOOOOXXXXXXXXXXXXXXXGXXXXXXXXXXXXXXXXXXX,0,0,0
4347,34,0,34,73,493,0,0,195,23,172,GOOXXXXXXXXXXXXXXXXXGXXXXXXXXXXXXXXXXXXXGXXXXXXXXXXXXXXXXXXXGOXXXXXXXXXXXXXXXXXXGOOOOXXXXXXXXXXXXXXXGOOOOXXXXXXXXXXXXXXXGOXXXXXXXXXXXXXXXXXXGOXXXXXXXXXXXXXXXXXXGXXXXXXXXXXXXXXXXXXXGOOXXXXXXXXXXXXXXXXXGOOXXXXXXXXXXXXXXXXXGOOOOXXXXXXXXXXXXXXXGXXXXXXXXXXXXXXXXXXX,0,0,0
4368,34,0,34,77,489,0,0,191,19,172,GOOXXXXXXXXXXXXXXXXXGXXXXXXXXXXXXXXXXXXXGXXXXXXXXXXXXXXXXXXXGOXXXXXXXXXXXXXXXXXXGOOOOXXXXXXXXXXXXXXXGOOOOXXXXXXXXXXXXXXXGOXXXXXXXXXXXXXXXXXXGOXXXXXXXXXXXXXXXXXXGXXXXXXXXXXXXXXXXXXXGOOXXXXXXXXXXXXXXXXXGOOXXXXXXXXXXXXXXXXXGOOOOXXXXXXXXXXXXXXXGXXXXXXXXXXXXXXXXXXX,0,0,0
4389,34,0,34,76,490,0,0,192,23,169,GOOXXXXXXXXXXXXXXXXXGXXXXXXXXXXXXXXXXXXXGXXXXXXXXXXXXXXXXXXXGOXXXXXXXXXXXXXXXXXXGOOOOXXXXXXXXXXXXXXXGOOOOXXXXXXXXXXXXXXXGOXXXXXXXXXXXXXXXXXXGOXXXXXXXXXXXXXXXXXXGXXXXXXXXXXXXXXXXXXXGOOXXXXXXXXXXXXXXXXXGOOXXXXXXXXXXXXXXXXXGOOOOXXXXXXXXXXXXXXXGXXXXXXXXXXXXXXXXXXX,0,0,0

4410,34,0,34,77,489,0,0,191,24,167,GOOXXXXXXXXXXXXXXXXXGXXXXXXXXXXXXXXXXXXXGXXXXXXXXXXXXXXXXXXXGOXXXXXXXXXXXXXXXXXXGOOOOXXXXXXXXXXXXXXXGOOOOXXXXXXXXXXXXXXXGOXXXXXXXXXXXXXXXXXXGOXXXXXXXXXXXXXXXXXXGXXXXXXXXXXXXXXXXXXXGOOXXXXXXXXXXXXXXXXXGOOXXXXXXXXXXXXXXXXXGOOOOXXXXXXXXXXXXXXXGXXXXXXXXXXXXXXXXXXX,0,0,0
4431,34,0,34,83,483,0,0,186,24,162,GOOXXXXXXXXXXXXXXXXXGXXXXXXXXXXXXXXXXXXXGXXXXXXXXXXXXXXXXXXXGOXXXXXXXXXXXXXXXXXXGOOOOXXXXXXXXXXXXXXXGOOOOXXXXXXXXXXXXXXXGOXXXXXXXXXXXXXXXXXXGOXXXXXXXXXXXXXXXXXXGXXXXXXXXXXXXXXXXXXXGOOXXXXXXXXXXXXXXXXXGOOXXXXXXXXXXXXXXXXXGOOOOXXXXXXXXXXXXXXXGXXXXXXXXXXXXXXXXXXX,0,0,0
4452,34,0,34,86,480,0,0,183,22,161,GOOXXXXXXXXXXXXXXXXXGXXXXXXXXXXXXXXXXXXXGXXXXXXXXXXXXXXXXXXXGOXXXXXXXXXXXXXXXXXXGOOOOXXXXXXXXXXXXXXXGOOOOXXXXXXXXXXXXXXXGOXXXXXXXXXXXXXXXXXXGOXXXXXXXXXXXXXXXXXXGXXXXXXXXXXXXXXXXXXXGOOXXXXXXXXXXXXXXXXXGOOXXXXXXXXXXXXXXXXXGOOOOXXXXXXXXXXXXXXXGXXXXXXXXXXXXXXXXXXX,0,0,0
4473,34,0,34,87,479,0,0,182,23,159,GOOXXXXXXXXXXXXXXXXXGXXXXXXXXXXXXXXXXXXXGXXXXXXXXXXXXXXXXXXXGOXXXXXXXXXXXXXXXXXXGOOOOXXXXXXXXXXXXXXXGOOOOXXXXXXXXXXXXXXXGOXXXXXXXXXXXXXXXXXXGOXXXXXXXXXXXXXXXXXXGXXXXXXXXXXXXXXXXXXXGOOXXXXXXXXXXXXXXXXXGOOXXXXXXXXXXXXXXXXXGOOOOXXXXXXXXXXXXXXXGXXXXXXXXXXXXXXXXXXX,0,0,0
4494,35,1,34,84,481,0,0,185,24,161,GOOXXXXXXXXXXXXXXXXXGXXXXXXXXXXXXXXXXXXXGXXXXXXXXXXXXXXXXXXXGOAXXXXXXXXXXXXXXXXXGOOOOXXXXXXXXXXXXXXXGOOOOXXXXXXXXXXXXXXXGOXXXXXXXXXXXXXXXXXXGOXXXXXXXXXXXXXXXXXXGXXXXXXXXXXXXXXXXXXXGOOXXXXXXXXXXXXXXXXXGOOXXXXXXXXXXXXXXXXXGOOOOXXXXXXXXXXXXXXXGXXXXXXXXXXXXXXXXXXX,0,0,0

4515,35,0,35,80,485,0,0,188,21,167,GOOXXXXXXXXXXXXXXXXXGXXXXXXXXXXXXXXXXXXXGXXXXXXXXXXXXXXXXXXXGOOXXXXXXXXXXXXXXXXXGOOOOXXXXXXXXXXXXXXXGOOOOXXXXXXXXXXXXXXXGOXXXXXXXXXXXXXXXXXXGOXXXXXXXXXXXXXXXXXXGXXXXXXXXXXXXXXXXXXXGOOXXXXXXXXXXXXXXXXXGOOXXXXXXXXXXXXXXXXXGOOOOXXXXXXXXXXXXXXXGXXXXXXXXXXXXXXXXXXX,0,0,0
4536,35,0,35,85,480,0,0,184,22,162,GOOXXXXXXXXXXXXXXXXXGXXXXXXXXXXXXXXXXXXXGXXXXXXXXXXXXXXXXXXXGOOXXXXXXXXXXXXXXXXXGOOOOXXXXXXXXXXXXXXXGOOOOXXXXXXXXXXXXXXXGOXXXXXXXXXXXXXXXXXXGOXXXXXXXXXXXXXXXXXXGXXXXXXXXXXXXXXXXXXXGOOXXXXXXXXXXXXXXXXXGOOXXXXXXXXXXXXXXXXXGOOOOXXXXXXXXXXXXXXXGXXXXXXXXXXXXXXXXXXX,0,0,0
4557,35,0,35,90,475,0,0,177,25,152,GOOXXXXXXXXXXXXXXXXXGXXXXXXXXXXXXXXXXXXXGXXXXXXXXXXXXXXXXXXXGOOXXXXXXXXXXXXXXXXXGOOOOXXXXXXXXXXXXXXXGOOOOXXXXXXXXXXXXXXXGOXXXXXXXXXXXXXXXXXXGOXXXXXXXXXXXXXXXXXXGXXXXXXXXXXXXXXXXXXXGOOXXXXXXXXXXXXXXXXXGOOXXXXXXXXXXXXXXXXXGOOOOXXXXXXXXXXXXXXXGXXXXXXXXXXXXXXXXXXX,0,0,0
4578,35,0,35,89,476,0,0,178,27,151,GOOXXXXXXXXXXXXXXXXXGXXXXXXXXXXXXXXXXXXXGXXXXXXXXXXXXXXXXXXXGOOXXXXXXXXXXXXXXXXXGOOOOXXXXXXXXXXXXXXXGOOOOXXXXXXXXXXXXXXXGOXXXXXXXXXXXXXXXXXXGOXXXXXXXXXXXXXXXXXXGXXXXXXXXXXXXXXXXXXXGOOXXXXXXXXXXXXXXXXXGOOXXXXXXXXXXXXXXXXXGOOOOXXXXXXXXXXXXXXXGXXXXXXXXXXXXXXXXXXX,0,0,0
4599,36,1,35,88,476,0,0,176,23,153,GOOXXXXXXXXXXXXXXXXXGXXXXXXXXXXXXXXXXXXXGXXXXXXXXXXXXXXXXXXXGOOXXXXXXXXXXXXXXXXXGOOOOXXXXXXXXXXXXXXXGOOOOXXXXXXXXXXXXXXXGOXXXXXXXXXXXXXXXXXXGOXXXXXXXXXXXXXXXXXXGXXXXXXXXXXXXXXXXXXXGOOXXXXXXXXXXXXXXXXXGOOAXXXXXXXXXXXXXXXXGOOOOXXXXXXXXXXXXXXXGXXXXXXXXXXXXXXXXXXX,0,0,0

4620,36,1,35,86,478,0,0,179,21,158,GOOXXXXXXXXXXXXXXXXXGXXXXXXXXXXXXXXXXXXXGXXXXXXXXXXXXXXXXXXXGOOXXXXXXXXXXXXXXXXXGOOOOXXXXXXXXXXXXXXXGOOOOXXXXXXXXXXXXXXXGOXXXXXXXXXXXXXXXXXXGOXXXXXXXXXXXXXXXXXXGXXXXXXXXXXXXXXXXXXXGOOXXXXXXXXXXXXXXXXXGOOAXXXXXXXXXXXXXXXXGOOOOXXXXXXXXXXXXXXXGXXXXXXXXXXXXXXXXXXX,0,0,0
4641,36,0,36,77,487,0,0,186,21,165,GOOXXXXXXXXXXXXXXXXXGXXXXXXXXXXXXXXXXXXXGXXXXXXXXXXXXXXXXXXXGOOXXXXXXXXXXXXXXXXXGOOOOXXXXXXXXXXXXXXXGOOOOXXXXXXXXXXXXXXXGOXXXXXXXXXXXXXXXXXXGOXXXXXXXXXXXXXXXXXXGXXXXXXXXXXXXXXXXXXXGOOXXXXXXXXXXXXXXXXXGOOOXXXXXXXXXXXXXXXXGOOOOXXXXXXXXXXXXXXXGXXXXXXXXXXXXXXXXXXX,0,0,0
4662,36,0,36,83,481,0,0,183,18,165,GOOXXXXXXXXXXXXXXXXXGXXXXXXXXXXXXXXXXXXXGXXXXXXXXXXXXXXXXXXXGOOXXXXXXXXXXXXXXXXXGOOOOXXXXXXXXXXXXXXXGOOOOXXXXXXXXXXXXXXXGOXXXXXXXXXXXXXXXXXXGOXXXXXXXXXXXXXXXXXXGXXXXXXXXXXXXXXXXXXXGOOXXXXXXXXXXXXXXXXXGOOOXXXXXXXXXXXXXXXXGOOOOXXXXXXXXXXXXXXXGXXXXXXXXXXXXXXXXXXX,0,0,0
4683,36,0,36,82,482,0,0,184,21,163,GOOXXXXXXXXXXXXXXXXXGXXXXXXXXXXXXXXXXXXXGXXXXXXXXXXXXXXXXXXXGOOXXXXXXXXXXXXXXXXXGOOOOXXXXXXXXXXXXXXXGOOOOXXXXXXXXXXXXXXXGOXXXXXXXXXXXXXXXXXXGOXXXXXXXXXXXXXXXXXXGXXXXXXXXXXXXXXXXXXXGOOXXXXXXXXXXXXXXXXXGOOOXXXXXXXXXXXXXXXXGOOOOXXXXXXXXXXXXXXXGXXXXXXXXXXXXXXXXXXX,0,0,0
4704,36,0,36,85,479,0,0,181,24,157,GOOXXXXXXXXXXXXXXXXXGXXXXXXXXXXXXXXXXXXXGXXXXXXXXXXXXXXXXXXXGOOXXXXXXXXXXXXXXXXXGOOOOXXXXXXXXXXXXXXXGOOOOXXXXXXXXXXXXXXXGOXXXXXXXXXXXXXXXXXXGOXXXXXXXXXXXXXXXXXXGXXXXXXXXXXXXXXXXXXXGOOXXXXXXXXXXXXXXXXXGOOOXXXXXXXXXXXXXXXXGOOOOXXXXXXXXXXXXXXXGXXXXXXXXXXXXXXXXXXX,0,0,0

4725,36,0,36,92,472,0,0,173,19,154,GOOXXXXXXXXXXXXXXXXXGXXXXXXXXXXXXXXXXXXXGXXXXXXXXXXXXXXXXXXXGOOXXXXXXXXXXXXXXXXXGOOOOXXXXXXXXXXXXXXXGOOOOXXXXXXXXXXXXXXXGOXXXXXXXXXXXXXXXXXXGOXXXXXXXXXXXXXXXXXXGXXXXXXXXXXXXXXXXXXXGOOXXXXXXXXXXXXXXXXXGOOOXXXXXXXXXXXXXXXXGOOOOXXXXXXXXXXXXXXXGXXXXXXXXXXXXXXXXXXX,0,0,0
4746,36,0,36,90,474,0,0,176,23,153,GOOXXXXXXXXXXXXXXXXXGXXXXXXXXXXXXXXXXXXXGXXXXXXXXXXXXXXXXXXXGOOXXXXXXXXXXXXXXXXXGOOOOXXXXXXXXXXXXXXXGOOOOXXXXXXXXXXXXXXXGOXXXXXXXXXXXXXXXXXXGOXXXXXXXXXXXXXXXXXXGXXXXXXXXXXXXXXXXXXXGOOXXXXXXXXXXXXXXXXXGOOOXXXXXXXXXXXXXXXXGOOOOXXXXXXXXXXXXXXXGXXXXXXXXXXXXXXXXXXX,0,0,0
4767,36,0,36,85,479,0,0,180,30,150,GOOXXXXXXXXXXXXXXXXXGXXXXXXXXXXXXXXXXXXXGXXXXXXXXXXXXXXXXXXXGOOXXXXXXXXXXXXXXXXXGOOOOXXXXXXXXXXXXXXXGOOOOXXXXXXXXXXXXXXXGOXXXXXXXXXXXXXXXXXXGOXXXXXXXXXXXXXXXXXXGXXXXXXXXXXXXXXXXXXXGOOXXXXXXXXXXXXXXXXXGOOOXXXXXXXXXXXXXXXXGOOOOXXXXXXXXXXXXXXXGXXXXXXXXXXXXXXXXXXX,0,0,0
4788,36,0,36,91,473,0,0,175,26,149,GOOXXXXXXXXXXXXXXXXXGXXXXXXXXXXXXXXXXXXXGXXXXXXXXXXXXXXXXXXXGOOXXXXXXXXXXXXXXXXXGOOOOXXXXXXXXXXXXXXXGOOOOXXXXXXXXXXXXXXXGOXXXXXXXXXXXXXXXXXXGOXXXXXXXXXXXXXXXXXXGXXXXXXXXXXXXXXXXXXXGOOXXXXXXXXXXXXXXXXXGOOOXXXXXXXXXXXXXXXXGOOOOXXXXXXXXXXXXXXXGXXXXXXXXXXXXXXXXXXX,0,0,0
4809,36,0,36,89,475,0,0,177,29,148,GOOXXXXXXXXXXXXXXXXXGXXXXXXXXXXXXXXXXXXXGXXXXXXXXXXXXXXXXXXXGOOXXXXXXXXXXXXXXXXXGOOOOXXXXXXXXXXXXXXXGOOOOXXXXXXXXXXXXXXXGOXXXXXXXXXXXXXXXXXXGOXXXXXXXXXXXXXXXXXXGXXXXXXXXXXXXXXXXXXXGOOXXXXXXXXXXXXXXXXXGOOOXXXXXXXXXXXXXXXXGOOOOXXXXXXXXXXXXXXXGXXXXXXXXXXXXXXXXXXX,0,0,0

4830,36,0,36,93,471,0,0,172,29,143,GOOXXXXXXXXXXXXXXXXXGXXXXXXXXXXXXXXXXXXXGXXXXXXXXXXXXXXXXXXXGOOXXXXXXXXXXXXXXXXXGOOOOXXXXXXXXXXXXXXXGOOOOXXXXXXXXXXXXXXXGOXXXXXXXXXXXXXXXXXXGOXXXXXXXXXXXXXXXXXXGXXXXXXXXXXXXXXXXXXXGOOXXXXXXXXXXXXXXXXXGOOOXXXXXXXXXXXXXXXXGOOOOXXXXXXXXXXXXXXXGXXXXXXXXXXXXXXXXXXX,0,0,0
4851,36,0,36,92,472,0,0,174,31,143,GOOXXXXXXXXXXXXXXXXXGXXXXXXXXXXXXXXXXXXXGXXXXXXXXXXXXXXXXXXXGOOXXXXXXXXXXXXXXXXXGOOOOXXXXXXXXXXXXXXXGOOOOXXXXXXXXXXXXXXXGOXXXXXXXXXXXXXXXXXXGOXXXXXXXXXXXXXXXXXXGXXXXXXXXXXXXXXXXXXXGOOXXXXXXXXXXXXXXXXXGOOOXXXXXXXXXXXXXXXXGOOOOXXXXXXXXXXXXXXXGXXXXXXXXXXXXXXXXXXX,0,0,0
4872,36,0,36,103,461,0,0,163,26,137,GOOXXXXXXXXXXXXXXXXXGXXXXXXXXXXXXXXXXXXXGXXXXXXXXXXXXXXXXXXXGOOXXXXXXXXXXXXXXXXXGOOOOXXXXXXXXXXXXXXXGOOOOXXXXXXXXXXXXXXXGOXXXXXXXXXXXXXXXXXXGOXXXXXXXXXXXXXXXXXXGXXXXXXXXXXXXXXXXXXXGOOXXXXXXXXXXXXXXXXXGOOOXXXXXXXXXXXXXXXXGOOOOXXXXXXXXXXXXXXXGXXXXXXXXXXXXXXXXXXX,0,0,0
4893,36,0,36,102,462,0,0,164,28,136,GOOXXXXXXXXXXXXXXXXXGXXXXXXXXXXXXXXXXXXXGXXXXXXXXXXXXXXXXXXXGOOXXXXXXXXXXXXXXXXXGOOOOXXXXXXXXXXXXXXXGOOOOXXXXXXXXXXXXXXXGOXXXXXXXXXXXXXXXXXXGOXXXXXXXXXXXXXXXXXXGXXXXXXXXXXXXXXXXXXXGOOXXXXXXXXXXXXXXXXXGOOOXXXXXXXXXXXXXXXXGOOOOXXXXXXXXXXXXXXXGXXXXXXXXXXXXXXXXXXX,0,0,0
4914,36,0,36,99,465,0,0,167,26,141,GOOXXXXXXXXXXXXXXXXXGXXXXXXXXXXXXXXXXXXXGXXXXXXXXXXXXXXXXXXXGOOXXXXXXXXXXXXXXXXXGOOOOXXXXXXXXXXXXXXXGOOOOXXXXXXXXXXXXXXXGOXXXXXXXXXXXXXXXXXXGOXXXXXXXXXXXXXXXXXXGXXXXXXXXXXXXXXXXXXXGOOXXXXXXXXXXXXXXXXXGOOOXXXXXXXXXXXXXXXXGOOOOXXXXXXXXXXXXXXXGXXXXXXXXXXXXXXXXXXX,0,0,0

4935,36,0,36,90,474,0,0,175,26,149,GOOXXXXXXXXXXXXXXXXXGXXXXXXXXXXXXXXXXXXXGXXXXXXXXXXXXXXXXXXXGOOXXXXXXXXXXXXXXXXXGOOOOXXXXXXXXXXXXXXXGOOOOXXXXXXXXXXXXXXXGOXXXXXXXXXXXXXXXXXXGOXXXXXXXXXXXXXXXXXXGXXXXXXXXXXXXXXXXXXXGOOXXXXXXXXXXXXXXXXXGOOOXXXXXXXXXXXXXXXXGOOOOXXXXXXXXXXXXXXXGXXXXXXXXXXXXXXXXXXX,0,0,0
4956,36,0,36,90,474,0,0,176,33,143,GOOXXXXXXXXXXXXXXXXXGXXXXXXXXXXXXXXXXXXXGXXXXXXXXXXXXXXXXXXXGOOXXXXXXXXXXXXXXXXXGOOOOXXXXXXXXXXXXXXXGOOOOXXXXXXXXXXXXXXXGOXXXXXXXXXXXXXXXXXXGOXXXXXXXXXXXXXXXXXXGXXXXXXXXXXXXXXXXXXXGOOXXXXXXXXXXXXXXXXXGOOOXXXXXXXXXXXXXXXXGOOOOXXXXXXXXXXXXXXXGXXXXXXXXXXXXXXXXXXX,0,0,0
4977,36,0,36,95,469,0,0,170,28,142,GOOXXXXXXXXXXXXXXXXXGXXXXXXXXXXXXXXXXXXXGXXXXXXXXXXXXXXXXXXXGOOXXXXXXXXXXXXXXXXXGOOOOXXXXXXXXXXXXXXXGOOOOXXXXXXXXXXXXXXXGOXXXXXXXXXXXXXXXXXXGOXXXXXXXXXXXXXXXXXXGXXXXXXXXXXXXXXXXXXXGOOXXXXXXXXXXXXXXXXXGOOOXXXXXXXXXXXXXXXXGOOOOXXXXXXXXXXXXXXXGXXXXXXXXXXXXXXXXXXX,0,0,0
4998,36,0,36,94,470,0,0,172,22,150,GOOXXXXXXXXXXXXXXXXXGXXXXXXXXXXXXXXXXXXXGXXXXXXXXXXXXXXXXXXXGOOXXXXXXXXXXXXXXXXXGOOOOXXXXXXXXXXXXXXXGOOOOXXXXXXXXXXXXXXXGOXXXXXXXXXXXXXXXXXXGOXXXXXXXXXXXXXXXXXXGXXXXXXXXXXXXXXXXXXXGOOXXXXXXXXXXXXXXXXXGOOOXXXXXXXXXXXXXXXXGOOOOXXXXXXXXXXXXXXXGXXXXXXXXXXXXXXXXXXX,0,0,0
5019,36,0,36,85,479,0,0,181,26,155,GOOXXXXXXXXXXXXXXXXXGXXXXXXXXXXXXXXXXXXXGXXXXXXXXXXXXXXXXXXXGOOXXXXXXXXXXXXXXXXXGOOOOXXXXXXXXXXXXXXXGOOOOXXXXXXXXXXXXXXXGOXXXXXXXXXXXXXXXXXXGOXXXXXXXXXXXXXXXXXXGXXXXXXXXXXXXXXXXXXXGOOXXXXXXXXXXXXXXXXXGOOOXXXXXXXXXXXXXXXXGOOOOXXXXXXXXXXXXXXXGXXXXXXXXXXXXXXXXXXX,0,0,0

5040,36,0,36,85,479,0,0,182,26,156,GOOXXXXXXXXXXXXXXXXXGXXXXXXXXXXXXXXXXXXXGXXXXXXXXXXXXXXXXXXXGOOXXXXXXXXXXXXXXXXXGOOOOXXXXXXXXXXXXXXXGOOOOXXXXXXXXXXXXXXXGOXXXXXXXXXXXXXXXXXXGOXXXXXXXXXXXXXXXXXXGXXXXXXXXXXXXXXXXXXXGOOXXXXXXXXXXXXXXXXXGOOOXXXXXXXXXXXXXXXXGOOOOXXXXXXXXXXXXXXXGXXXXXXXXXXXXXXXXXXX,0,0,0
5061,36,0,36,80,484,0,0,187,26,161,GOOXXXXXXXXXXXXXXXXXGXXXXXXXXXXXXXXXXXXXGXXXXXXXXXXXXXXXXXXXGOOXXXXXXXXXXXXXXXXXGOOOOXXXXXXXXXXXXXXXGOOOOXXXXXXXXXXXXXXXGOXXXXXXXXXXXXXXXXXXGOXXXXXXXXXXXXXXXXXXGXXXXXXXXXXXXXXXXXXXGOOXXXXXXXXXXXXXXXXXGOOOXXXXXXXXXXXXXXXXGOOOOXXXXXXXXXXXXXXXGXXXXXXXXXXXXXXXXXXX,0,0,0
5082,36,0,36,81,483,0,0,185,20,165,GOOXXXXXXXXXXXXXXXXXGXXXXXXXXXXXXXXXXXXXGXXXXXXXXXXXXXXXXXXXGOOXXXXXXXXXXXXXXXXXGOOOOXXXXXXXXXXXXXXXGOOOOXXXXXXXXXXXXXXXGOXXXXXXXXXXXXXXXXXXGOXXXXXXXXXXXXXXXXXXGXXXXXXXXXXXXXXXXXXXGOOXXXXXXXXXXXXXXXXXGOOOXXXXXXXXXXXXXXXXGOOOOXXXXXXXXXXXXXXXGXXXXXXXXXXXXXXXXXXX,0,0,0
5103,36,0,36,75,489,0,0,192,22,170,GOOXXXXXXXXXXXXXXXXXGXXXXXXXXXXXXXXXXXXXGXXXXXXXXXXXXXXXXXXXGOOXXXXXXXXXXXXXXXXXGOOOOXXXXXXXXXXXXXXXGOOOOXXXXXXXXXXXXXXXGOXXXXXXXXXXXXXXXXXXGOXXXXXXXXXXXXXXXXXXGXXXXXXXXXXXXXXXXXXXGOOXXXXXXXXXXXXXXXXXGOOOXXXXXXXXXXXXXXXXGOOOOXXXXXXXXXXXXXXXGXXXXXXXXXXXXXXXXXXX,0,0,0
5124,36,0,36,78,486,0,0,189,27,162,GOOXXXXXXXXXXXXXXXXXGXXXXXXXXXXXXXXXXXXXGXXXXXXXXXXXXXXXXXXXGOOXXXXXXXXXXXXXXXXXGOOOOXXXXXXXXXXXXXXXGOOOOXXXXXXXXXXXXXXXGOXXXXXXXXXXXXXXXXXXGOXXXXXXXXXXXXXXXXXXGXXXXXXXXXXXXXXXXXXXGOOXXXXXXXXXXXXXXXXXGOOOXXXXXXXXXXXXXXXXGOOOOXXXXXXXXXXXXXXXGXXXXXXXXXXXXXXXXXXX,0,0,0

5145,36,0,36,77,487,0,0,188,32,156,GOOXXXXXXXXXXXXXXXXXGXXXXXXXXXXXXXXXXXXXGXXXXXXXXXXXXXXXXXXXGOOXXXXXXXXXXXXXXXXXGOOOOXXXXXXXXXXXXXXXGOOOOXXXXXXXXXXXXXXXGOXXXXXXXXXXXXXXXXXXGOXXXXXXXXXXXXXXXXXXGXXXXXXXXXXXXXXXXXXXGOOXXXXXXXXXXXXXXXXXGOOOXXXXXXXXXXXXXXXXGOOOOXXXXXXXXXXXXXXXGXXXXXXXXXXXXXXXXXXX,0,0,0
5166,36,0,36,81,483,0,0,185,23,162,GOOXXXXXXXXXXXXXXXXXGXXXXXXXXXXXXXXXXXXXGXXXXXXXXXXXXXXXXXXXGOOXXXXXXXXXXXXXXXXXGOOOOXXXXXXXXXXXXXXXGOOOOXXXXXXXXXXXXXXXGOXXXXXXXXXXXXXXXXXXGOXXXXXXXXXXXXXXXXXXGXXXXXXXXXXXXXXXXXXXGOOXXXXXXXXXXXXXXXXXGOOOXXXXXXXXXXXXXXXXGOOOOXXXXXXXXXXXXXXXGXXXXXXXXXXXXXXXXXXX,0,0,0
5187,36,0,36,72,492,0,0,194,24,170,GOOXXXXXXXXXXXXXXXXXGXXXXXXXXXXXXXXXXXXXGXXXXXXXXXXXXXXXXXXXGOOXXXXXXXXXXXXXXXXXGOOOOXXXXXXXXXXXXXXXGOOOOXXXXXXXXXXXXXXXGOXXXXXXXXXXXXXXXXXXGOXXXXXXXXXXXXXXXXXXGXXXXXXXXXXXXXXXXXXXGOOXXXXXXXXXXXXXXXXXGOOOXXXXXXXXXXXXXXXXGOOOOXXXXXXXXXXXXXXXGXXXXXXXXXXXXXXXXXXX,0,0,0
5208,36,0,36,73,491,0,0,193,27,166,GOOXXXXXXXXXXXXXXXXXGXXXXXXXXXXXXXXXXXXXGXXXXXXXXXXXXXXXXXXXGOOXXXXXXXXXXXXXXXXXGOOOOXXXXXXXXXXXXXXXGOOOOXXXXXXXXXXXXXXXGOXXXXXXXXXXXXXXXXXXGOXXXXXXXXXXXXXXXXXXGXXXXXXXXXXXXXXXXXXXGOOXXXXXXXXXXXXXXXXXGOOOXXXXXXXXXXXXXXXXGOOOOXXXXXXXXXXXXXXXGXXXXXXXXXXXXXXXXXXX,0,0,0
5229,36,0,36,81,483,0,0,185,24,161,GOOXXXXXXXXXXXXXXXXXGXXXXXXXXXXXXXXXXXXXGXXXXXXXXXXXXXXXXXXXGOOXXXXXXXXXXXXXXXXXGOOOOXXXXXXXXXXXXXXXGOOOOXXXXXXXXXXXXXXXGOXXXXXXXXXXXXXXXXXXGOXXXXXXXXXXXXXXXXXXGXXXXXXXXXXXXXXXXXXXGOOXXXXXXXXXXXXXXXXXGOOOXXXXXXXXXXXXXXXXGOOOOXXXXXXXXXXXXXXXGXXXXXXXXXXXXXXXXXXX,0,0,0

5250,36,0,36,85,479,0,0,181,25,156,GOOXXXXXXXXXXXXXXXXXGXXXXXXXXXXXXXXXXXXXGXXXXXXXXXXXXXXXXXXXGOOXXXXXXXXXXXXXXXXXGOOOOXXXXXXXXXXXXXXXGOOOOXXXXXXXXXXXXXXXGOXXXXXXXXXXXXXXXXXXGOXXXXXXXXXXXXXXXXXXGXXXXXXXXXXXXXXXXXXXGOOXXXXXXXXXXXXXXXXXGOOOXXXXXXXXXXXXXXXXGOOOOXXXXXXXXXXXXXXXGXXXXXXXXXXXXXXXXXXX,0,0,0
5271,36,0,36,90,474,0,0,176,19,157,GOOXXXXXXXXXXXXXXXXXGXXXXXXXXXXXXXXXXXXXGXXXXXXXXXXXXXXXXXXXGOOXXXXXXXXXXXXXXXXXGOOOOXXXXXXXXXXXXXXXGOOOOXXXXXXXXXXXXXXXGOXXXXXXXXXXXXXXXXXXGOXXXXXXXXXXXXXXXXXXGXXXXXXXXXXXXXXXXXXXGOOXXXXXXXXXXXXXXXXXGOOOXXXXXXXXXXXXXXXXGOOOOXXXXXXXXXXXXXXXGXXXXXXXXXXXXXXXXXXX,0,0,0
5292,36,0,36,93,471,0,0,174,24,150,GOOXXXXXXXXXXXXXXXXXGXXXXXXXXXXXXXXXXXXXGXXXXXXXXXXXXXXXXXXXGOOXXXXXXXXXXXXXXXXXGOOOOXXXXXXXXXXXXXXXGOOOOXXXXXXXXXXXXXXXGOXXXXXXXXXXXXXXXXXXGOXXXXXXXXXXXXXXXXXXGXXXXXXXXXXXXXXXXXXXGOOXXXXXXXXXXXXXXXXXGOOOXXXXXXXXXXXXXXXXGOOOOXXXXXXXXXXXXXXXGXXXXXXXXXXXXXXXXXXX,0,0,0
5313,36,0,36,98,466,0,0,168,25,143,GOOXXXXXXXXXXXXXXXXXGXXXXXXXXXXXXXXXXXXXGXXXXXXXXXXXXXXXXXXXGOOXXXXXXXXXXXXXXXXXGOOOOXXXXXXXXXXXXXXXGOOOOXXXXXXXXXXXXXXXGOXXXXXXXXXXXXXXXXXXGOXXXXXXXXXXXXXXXXXXGXXXXXXXXXXXXXXXXXXXGOOXXXXXXXXXXXXXXXXXGOOOXXXXXXXXXXXXXXXXGOOOOXXXXXXXXXXXXXXXGXXXXXXXXXXXXXXXXXXX,0,0,0
5334,36,0,36,94,470,0,0,173,27,146,GOOXXXXXXXXXXXXXXXXXGXXXXXXXXXXXXXXXXXXXGXXXXXXXXXXXXXXXXXXXGOOXXXXXXXXXXXXXXXXXGOOOOXXXXXXXXXXXXXXXGOOOOXXXXXXXXXXXXXXXGOXXXXXXXXXXXXXXXXXXGOXXXXXXXXXXXXXXXXXXGXXXXXXXXXXXXXXXXXXXGOOXXXXXXXXXXXXXXXXXGOOOXXXXXXXXXXXXXXXXGOOOOXXXXXXXXXXXXXXXGXXXXXXXXXXXXXXXXXXX,0,0,0

5355,36,0,36,97,467,0,0,169,22,147,GOOXXXXXXXXXXXXXXXXXGXXXXXXXXXXXXXXXXXXXGXXXXXXXXXXXXXXXXXXXGOOXXXXXXXXXXXXXXXXXGOOOOXXXXXXXXXXXXXXXGOOOOXXXXXXXXXXXXXXXGOXXXXXXXXXXXXXXXXXXGOXXXXXXXXXXXXXXXXXXGXXXXXXXXXXXXXXXXXXXGOOXXXXXXXXXXXXXXXXXGOOOXXXXXXXXXXXXXXXXGOOOOXXXXXXXXXXXXXXXGXXXXXXXXXXXXXXXXXXX,0,0,0
5376,36,0,36,92,472,0,0,174,26,148,GOOXXXXXXXXXXXXXXXXXGXXXXXXXXXXXXXXXXXXXGXXXXXXXXXXXXXXXXXXXGOOXXXXXXXXXXXXXXXXXGOOOOXXXXXXXXXXXXXXXGOOOOXXXXXXXXXXXXXXXGOXXXXXXXXXXXXXXXXXXGOXXXXXXXXXXXXXXXXXXGXXXXXXXXXXXXXXXXXXXGOOXXXXXXXXXXXXXXXXXGOOOXXXXXXXXXXXXXXXXGOOOOXXXXXXXXXXXXXXXGXXXXXXXXXXXXXXXXXXX,0,0,0
5397,36,0,36,90,474,0,0,176,26,150,GOOXXXXXXXXXXXXXXXXXGXXXXXXXXXXXXXXXXXXXGXXXXXXXXXXXXXXXXXXXGOOXXXXXXXXXXXXXXXXXGOOOOXXXXXXXXXXXXXXXGOOOOXXXXXXXXXXXXXXXGOXXXXXXXXXXXXXXXXXXGOXXXXXXXXXXXXXXXXXXGXXXXXXXXXXXXXXXXXXXGOOXXXXXXXXXXXXXXXXXGOOOXXXXXXXXXXXXXXXXGOOOOXXXXXXXXXXXXXXXGXXXXXXXXXXXXXXXXXXX,0,0,0
5418,36,0,36,90,474,0,0,174,23,151,GOOXXXXXXXXXXXXXXXXXGXXXXXXXXXXXXXXXXXXXGXXXXXXXXXXXXXXXXXXXGOOXXXXXXXXXXXXXXXXXGOOOOXXXXXXXXXXXXXXXGOOOOXXXXXXXXXXXXXXXGOXXXXXXXXXXXXXXXXXXGOXXXXXXXXXXXXXXXXXXGXXXXXXXXXXXXXXXXXXXGOOXXXXXXXXXXXXXXXXXGOOOXXXXXXXXXXXXXXXXGOOOOXXXXXXXXXXXXXXXGXXXXXXXXXXXXXXXXXXX,0,0,0
5439,36,0,36,91,473,0,0,174,30,144,GOOXXXXXXXXXXXXXXXXXGXXXXXXXXXXXXXXXXXXXGXXXXXXXXXXXXXXXXXXXGOOXXXXXXXXXXXXXXXXXGOOOOXXXXXXXXXXXXXXXGOOOOXXXXXXXXXXXXXXXGOXXXXXXXXXXXXXXXXXXGOXXXXXXXXXXXXXXXXXXGXXXXXXXXXXXXXXXXXXXGOOXXXXXXXXXXXXXXXXXGOOOXXXXXXXXXXXXXXXXGOOOOXXXXXXXXXXXXXXXGXXXXXXXXXXXXXXXXXXX,0,0,0

5460,36,0,36,90,474,0,0,174,27,147,GOOXXXXXXXXXXXXXXXXXGXXXXXXXXXXXXXXXXXXXGXXXXXXXXXXXXXXXXXXXGOOXXXXXXXXXXXXXXXXXGOOOOXXXXXXXXXXXXXXXGOOOOXXXXXXXXXXXXXXXGOXXXXXXXXXXXXXXXXXXGOXXXXXXXXXXXXXXXXXXGXXXXXXXXXXXXXXXXXXXGOOXXXXXXXXXXXXXXXXXGOOOXXXXXXXXXXXXXXXXGOOOOXXXXXXXXXXXXXXXGXXXXXXXXXXXXXXXXXXX,0,0,0
5481,36,0,36,89,475,0,0,176,27,149,GOOXXXXXXXXXXXXXXXXXGXXXXXXXXXXXXXXXXXXXGXXXXXXXXXXXXXXXXXXXGOOXXXXXXXXXXXXXXXXXGOOOOXXXXXXXXXXXXXXXGOOOOXXXXXXXXXXXXXXXGOXXXXXXXXXXXXXXXXXXGOXXXXXXXXXXXXXXXXXXGXXXXXXXXXXXXXXXXXXXGOOXXXXXXXXXXXXXXXXXGOOOXXXXXXXXXXXXXXXXGOOOOXXXXXXXXXXXXXXXGXXXXXXXXXXXXXXXXXXX,0,0,0
5502,36,0,36,89,475,0,0,176,26,150,GOOXXXXXXXXXXXXXXXXXGXXXXXXXXXXXXXXXXXXXGXXXXXXXXXXXXXXXXXXXGOOXXXXXXXXXXXXXXXXXGOOOOXXXXXXXXXXXXXXXGOOOOXXXXXXXXXXXXXXXGOXXXXXXXXXXXXXXXXXXGOXXXXXXXXXXXXXXXXXXGXXXXXXXXXXXXXXXXXXXGOOXXXXXXXXXXXXXXXXXGOOOXXXXXXXXXXXXXXXXGOOOOXXXXXXXXXXXXXXXGXXXXXXXXXXXXXXXXXXX,0,0,0
5523,36,0,36,90,474,0,0,176,22,154,GOOXXXXXXXXXXXXXXXXXGXXXXXXXXXXXXXXXXXXXGXXXXXXXXXXXXXXXXXXXGOOXXXXXXXXXXXXXXXXXGOOOOXXXXXXXXXXXXXXXGOOOOXXXXXXXXXXXXXXXGOXXXXXXXXXXXXXXXXXXGOXXXXXXXXXXXXXXXXXXGXXXXXXXXXXXXXXXXXXXGOOXXXXXXXXXXXXXXXXXGOOOXXXXXXXXXXXXXXXXGOOOOXXXXXXXXXXXXXXXGXXXXXXXXXXXXXXXXXXX,0,0,0
5544,36,0,36,86,478,0,0,179,25,154,GOOXXXXXXXXXXXXXXXXXGXXXXXXXXXXXXXXXXXXXGXXXXXXXXXXXXXXXXXXXGOOXXXXXXXXXXXXXXXXXGOOOOXXXXXXXXXXXXXXXGOOOOXXXXXXXXXXXXXXXGOXXXXXXXXXXXXXXXXXXGOXXXXXXXXXXXXXXXXXXGXXXXXXXXXXXXXXXXXXXGOOXXXXXXXXXXXXXXXXXGOOOXXXXXXXXXXXXXXXXGOOOOXXXXXXXXXXXXXXXGXXXXXXXXXXXXXXXXXXX,0,0,0

5565,36,0,36,82,482,0,0,183,29,154,GOOXXXXXXXXXXXXXXXXXGXXXXXXXXXXXXXXXXXXXGXXXXXXXXXXXXXXXXXXXGOOXXXXXXXXXXXXXXXXXGOOOOXXXXXXXXXXXXXXXGOOOOXXXXXXXXXXXXXXXGOXXXXXXXXXXXXXXXXXXGOXXXXXXXXXXXXXXXXXXGXXXXXXXXXXXXXXXXXXXGOOXXXXXXXXXXXXXXXXXGOOOXXXXXXXXXXXXXXXXGOOOOXXXXXXXXXXXXXXXGXXXXXXXXXXXXXXXXXXX,0,0,0
5586,36,0,36,81,483,0,0,184,26,158,GOOXXXXXXXXXXXXXXXXXGXXXXXXXXXXXXXXXXXXXGXXXXXXXXXXXXXXXXXXXGOOXXXXXXXXXXXXXXXXXGOOOOXXXXXXXXXXXXXXXGOOOOXXXXXXXXXXXXXXXGOXXXXXXXXXXXXXXXXXXGOXXXXXXXXXXXXXXXXXXGXXXXXXXXXXXXXXXXXXXGOOXXXXXXXXXXXXXXXXXGOOOXXXXXXXXXXXXXXXXGOOOOXXXXXXXXXXXXXXXGXXXXXXXXXXXXXXXXXXX,0,0,0
5607,36,0,36,81,483,0,0,185,30,155,GOOXXXXXXXXXXXXXXXXXGXXXXXXXXXXXXXXXXXXXGXXXXXXXXXXXXXXXXXXXGOOXXXXXXXXXXXXXXXXXGOOOOXXXXXXXXXXXXXXXGOOOOXXXXXXXXXXXXXXXGOXXXXXXXXXXXXXXXXXXGOXXXXXXXXXXXXXXXXXXGXXXXXXXXXXXXXXXXXXXGOOXXXXXXXXXXXXXXXXXGOOOXXXXXXXXXXXXXXXXGOOOOXXXXXXXXXXXXXXXGXXXXXXXXXXXXXXXXXXX,0,0,0
5628,36,0,36,85,479,0,0,181,26,155,GOOXXXXXXXXXXXXXXXXXGXXXXXXXXXXXXXXXXXXXGXXXXXXXXXXXXXXXXXXXGOOXXXXXXXXXXXXXXXXXGOOOOXXXXXXXXXXXXXXXGOOOOXXXXXXXXXXXXXXXGOXXXXXXXXXXXXXXXXXXGOXXXXXXXXXXXXXXXXXXGXXXXXXXXXXXXXXXXXXXGOOXXXXXXXXXXXXXXXXXGOOOXXXXXXXXXXXXXXXXGOOOOXXXXXXXXXXXXXXXGXXXXXXXXXXXXXXXXXXX,0,0,0
5649,36,0,36,83,481,0,0,183,26,157,GOOXXXXXXXXXXXXXXXXXGXXXXXXXXXXXXXXXXXXXGXXXXXXXXXXXXXXXXXXXGOOXXXXXXXXXXXXXXXXXGOOOOXXXXXXXXXXXXXXXGOOOOXXXXXXXXXXXXXXXGOXXXXXXXXXXXXXXXXXXGOXXXXXXXXXXXXXXXXXXGXXXXXXXXXXXXXXXXXXXGOOXXXXXXXXXXXXXXXXXGOOOXXXXXXXXXXXXXXXXGOOOOXXXXXXXXXXXXXXXGXXXXXXXXXXXXXXXXXXX,0,0,0

5670,36,0,36,83,481,0,0,182,30,152,GOOXXXXXXXXXXXXXXXXXGXXXXXXXXXXXXXXXXXXXGXXXXXXXXXXXXXXXXXXXGOOXXXXXXXXXXXXXXXXXGOOOOXXXXXXXXXXXXXXXGOOOOXXXXXXXXXXXXXXXGOXXXXXXXXXXXXXXXXXXGOXXXXXXXXXXXXXXXXXXGXXXXXXXXXXXXXXXXXXXGOOXXXXXXXXXXXXXXXXXGOOOXXXXXXXXXXXXXXXXGOOOOXXXXXXXXXXXXXXXGXXXXXXXXXXXXXXXXXXX,0,0,0
5691,36,0,36,84,480,0,0,183,35,148,GOOXXXXXXXXXXXXXXXXXGXXXXXXXXXXXXXXXXXXXGXXXXXXXXXXXXXXXXXXXGOOXXXXXXXXXXXXXXXXXGOOOOXXXXXXXXXXXXXXXGOOOOXXXXXXXXXXXXXXXGOXXXXXXXXXXXXXXXXXXGOXXXXXXXXXXXXXXXXXXGXXXXXXXXXXXXXXXXXXXGOOXXXXXXXXXXXXXXXXXGOOOXXXXXXXXXXXXXXXXGOOOOXXXXXXXXXXXXXXXGXXXXXXXXXXXXXXXXXXX,0,0,0
5712,36,0,36,91,473,0,0,176,29,147,GOOXXXXXXXXXXXXXXXXXGXXXXXXXXXXXXXXXXXXXGXXXXXXXXXXXXXXXXXXXGOOXXXXXXXXXXXXXXXXXGOOOOXXXXXXXXXXXXXXXGOOOOXXXXXXXXXXXXXXXGOXXXXXXXXXXXXXXXXXXGOXXXXXXXXXXXXXXXXXXGXXXXXXXXXXXXXXXXXXXGOOXXXXXXXXXXXXXXXXXGOOOXXXXXXXXXXXXXXXXGOOOOXXXXXXXXXXXXXXXGXXXXXXXXXXXXXXXXXXX,0,0,0
5733,36,0,36,90,474,0,0,176,29,147,GOOXXXXXXXXXXXXXXXXXGXXXXXXXXXXXXXXXXXXXGXXXXXXXXXXXXXXXXXXXGOOXXXXXXXXXXXXXXXXXGOOOOXXXXXXXXXXXXXXXGOOOOXXXXXXXXXXXXXXXGOXXXXXXXXXXXXXXXXXXGOXXXXXXXXXXXXXXXXXXGXXXXXXXXXXXXXXXXXXXGOOXXXXXXXXXXXXXXXXXGOOOXXXXXXXXXXXXXXXXGOOOOXXXXXXXXXXXXXXXGXXXXXXXXXXXXXXXXXXX,0,0,0
5754,36,0,36,86,478,0,0,181,28,153,GOOXXXXXXXXXXXXXXXXXGXXXXXXXXXXXXXXXXXXXGXXXXXXXXXXXXXXXXXXXGOOXXXXXXXXXXXXXXXXXGOOOOXXXXXXXXXXXXXXXGOOOOXXXXXXXXXXXXXXXGOXXXXXXXXXXXXXXXXXXGOXXXXXXXXXXXXXXXXXXGXXXXXXXXXXXXXXXXXXXGOOXXXXXXXXXXXXXXXXXGOOOXXXXXXXXXXXXXXXXGOOOOXXXXXXXXXXXXXXXGXXXXXXXXXXXXXXXXXXX,0,0,0

5775,36,0,36,83,481,0,0,183,23,160,GOOXXXXXXXXXXXXXXXXXGXXXXXXXXXXXXXXXXXXXGXXXXXXXXXXXXXXXXXXXGOOXXXXXXXXXXXXXXXXXGOOOOXXXXXXXXXXXXXXXGOOOOXXXXXXXXXXXXXXXGOXXXXXXXXXXXXXXXXXXGOXXXXXXXXXXXXXXXXXXGXXXXXXXXXXXXXXXXXXXGOOXXXXXXXXXXXXXXXXXGOOOXXXXXXXXXXXXXXXXGOOOOXXXXXXXXXXXXXXXGXXXXXXXXXXXXXXXXXXX,0,0,0
5796,36,0,36,80,484,0,0,185,32,153,GOOXXXXXXXXXXXXXXXXXGXXXXXXXXXXXXXXXXXXXGXXXXXXXXXXXXXXXXXXXGOOXXXXXXXXXXXXXXXXXGOOOOXXXXXXXXXXXXXXXGOOOOXXXXXXXXXXXXXXXGOXXXXXXXXXXXXXXXXXXGOXXXXXXXXXXXXXXXXXXGXXXXXXXXXXXXXXXXXXXGOOXXXXXXXXXXXXXXXXXGOOOXXXXXXXXXXXXXXXXGOOOOXXXXXXXXXXXXXXXGXXXXXXXXXXXXXXXXXXX,0,0,0
5817,36,0,36,84,480,0,0,181,30,151,GOOXXXXXXXXXXXXXXXXXGXXXXXXXXXXXXXXXXXXXGXXXXXXXXXXXXXXXXXXXGOOXXXXXXXXXXXXXXXXXGOOOOXXXXXXXXXXXXXXXGOOOOXXXXXXXXXXXXXXXGOXXXXXXXXXXXXXXXXXXGOXXXXXXXXXXXXXXXXXXGXXXXXXXXXXXXXXXXXXXGOOXXXXXXXXXXXXXXXXXGOOOXXXXXXXXXXXXXXXXGOOOOXXXXXXXXXXXXXXXGXXXXXXXXXXXXXXXXXXX,0,0,0
5838,36,0,36,86,478,0,0,177,27,150,GOOXXXXXXXXXXXXXXXXXGXXXXXXXXXXXXXXXXXXXGXXXXXXXXXXXXXXXXXXXGOOXXXXXXXXXXXXXXXXXGOOOOXXXXXXXXXXXXXXXGOOOOXXXXXXXXXXXXXXXGOXXXXXXXXXXXXXXXXXXGOXXXXXXXXXXXXXXXXXXGXXXXXXXXXXXXXXXXXXXGOOXXXXXXXXXXXXXXXXXGOOOXXXXXXXXXXXXXXXXGOOOOXXXXXXXXXXXXXXXGXXXXXXXXXXXXXXXXXXX,0,0,0
5859,36,0,36,83,481,0,0,182,27,155,GOOXXXXXXXXXXXXXXXXXGXXXXXXXXXXXXXXXXXXXGXXXXXXXXXXXXXXXXXXXGOOXXXXXXXXXXXXXXXXXGOOOOXXXXXXXXXXXXXXXGOOOOXXXXXXXXXXXXXXXGOXXXXXXXXXXXXXXXXXXGOXXXXXXXXXXXXXXXXXXGXXXXXXXXXXXXXXXXXXXGOOXXXXXXXXXXXXXXXXXGOOOXXXXXXXXXXXXXXXXGOOOOXXXXXXXXXXXXXXXGXXXXXXXXXXXXXXXXXXX,0,0,0

5880,37,1,36,82,481,0,0,182,29,153,GOOXXXXXXXXXXXXXXXXXGAXXXXXXXXXXXXXXXXXXGXXXXXXXXXXXXXXXXXXXGOOXXXXXXXXXXXXXXXXXGOOOOXXXXXXXXXXXXXXXGOOOOXXXXXXXXXXXXXXXGOXXXXXXXXXXXXXXXXXXGOXXXXXXXXXXXXXXXXXXGXXXXXXXXXXXXXXXXXXXGOOXXXXXXXXXXXXXXXXXGOOOXXXXXXXXXXXXXXXXGOOOOXXXXXXXXXXXXXXXGXXXXXXXXXXXXXXXXXXX,0,0,0
5901,37,1,36,82,481,0,0,183,29,154,GOOXXXXXXXXXXXXXXXXXGAXXXXXXXXXXXXXXXXXXGXXXXXXXXXXXXXXXXXXXGOOXXXXXXXXXXXXXXXXXGOOOOXXXXXXXXXXXXXXXGOOOOXXXXXXXXXXXXXXXGOXXXXXXXXXXXXXXXXXXGOXXXXXXXXXXXXXXXXXXGXXXXXXXXXXXXXXXXXXXGOOXXXXXXXXXXXXXXXXXGOOOXXXXXXXXXXXXXXXXGOOOOXXXXXXXXXXXXXXXGXXXXXXXXXXXXXXXXXXX,0,0,0
5922,37,1,36,76,487,0,0,189,33,156,GOOXXXXXXXXXXXXXXXXXGAXXXXXXXXXXXXXXXXXXGXXXXXXXXXXXXXXXXXXXGOOXXXXXXXXXXXXXXXXXGOOOOXXXXXXXXXXXXXXXGOOOOXXXXXXXXXXXXXXXGOXXXXXXXXXXXXXXXXXXGOXXXXXXXXXXXXXXXXXXGXXXXXXXXXXXXXXXXXXXGOOXXXXXXXXXXXXXXXXXGOOOXXXXXXXXXXXXXXXXGOOOOXXXXXXXXXXXXXXXGXXXXXXXXXXXXXXXXXXX,0,0,0
5943,37,1,36,79,484,0,0,187,29,158,GOOXXXXXXXXXXXXXXXXXGAXXXXXXXXXXXXXXXXXXGXXXXXXXXXXXXXXXXXXXGOOXXXXXXXXXXXXXXXXXGOOOOXXXXXXXXXXXXXXXGOOOOXXXXXXXXXXXXXXXGOXXXXXXXXXXXXXXXXXXGOXXXXXXXXXXXXXXXXXXGXXXXXXXXXXXXXXXXXXXGOOXXXXXXXXXXXXXXXXXGOOOXXXXXXXXXXXXXXXXGOOOOXXXXXXXXXXXXXXXGXXXXXXXXXXXXXXXXXXX,0,0,0
5964,37,0,37,77,486,0,0,187,31,156,GOOXXXXXXXXXXXXXXXXXGOXXXXXXXXXXXXXXXXXXGXXXXXXXXXXXXXXXXXXXGOOXXXXXXXXXXXXXXXXXGOOOOXXXXXXXXXXXXXXXGOOOOXXXXXXXXXXXXXXXGOXXXXXXXXXXXXXXXXXXGOXXXXXXXXXXXXXXXXXXGXXXXXXXXXXXXXXXXXXXGOOXXXXXXXXXXXXXXXXXGOOOXXXXXXXXXXXXXXXXGOOOOXXXXXXXXXXXXXXXGXXXXXXXXXXXXXXXXXXX,0,0,0

5985,37,0,37,80,483,0,0,184,29,155,GOOXXXXXXXXXXXXXXXXXGOXXXXXXXXXXXXXXXXXXGXXXXXXXXXXXXXXXXXXXGOOXXXXXXXXXXXXXXXXXGOOOOXXXXXXXXXXXXXXXGOOOOXXXXXXXXXXXXXXXGOXXXXXXXXXXXXXXXXXXGOXXXXXXXXXXXXXXXXXXGXXXXXXXXXXXXXXXXXXXGOOXXXXXXXXXXXXXXXXXGOOOXXXXXXXXXXXXXXXXGOOOOXXXXXXXXXXXXXXXGXXXXXXXXXXXXXXXXXXX,0,0,0
6006,37,0,37,76,487,0,0,189,26,163,GOOXXXXXXXXXXXXXXXXXGOXXXXXXXXXXXXXXXXXXGXXXXXXXXXXXXXXXXXXXGOOXXXXXXXXXXXXXXXXXGOOOOXXXXXXXXXXXXXXXGOOOOXXXXXXXXXXXXXXXGOXXXXXXXXXXXXXXXXXXGOXXXXXXXXXXXXXXXXXXGXXXXXXXXXXXXXXXXXXXGOOXXXXXXXXXXXXXXXXXGOOOXXXXXXXXXXXXXXXXGOOOOXXXXXXXXXXXXXXXGXXXXXXXXXXXXXXXXXXX,0,0,0
6027,37,0,37,81,482,0,0,184,24,160,GOOXXXXXXXXXXXXXXXXXGOXXXXXXXXXXXXXXXXXXGXXXXXXXXXXXXXXXXXXXGOOXXXXXXXXXXXXXXXXXGOOOOXXXXXXXXXXXXXXXGOOOOXXXXXXXXXXXXXXXGOXXXXXXXXXXXXXXXXXXGOXXXXXXXXXXXXXXXXXXGXXXXXXXXXXXXXXXXXXXGOOXXXXXXXXXXXXXXXXXGOOOXXXXXXXXXXXXXXXXGOOOOXXXXXXXXXXXXXXXGXXXXXXXXXXXXXXXXXXX,0,0,0
6048,37,0,37,83,480,0,0,182,30,152,GOOXXXXXXXXXXXXXXXXXGOXXXXXXXXXXXXXXXXXXGXXXXXXXXXXXXXXXXXXXGOOXXXXXXXXXXXXXXXXXGOOOOXXXXXXXXXXXXXXXGOOOOXXXXXXXXXXXXXXXGOXXXXXXXXXXXXXXXXXXGOXXXXXXXXXXXXXXXXXXGXXXXXXXXXXXXXXXXXXXGOOXXXXXXXXXXXXXXXXXGOOOXXXXXXXXXXXXXXXXGOOOOXXXXXXXXXXXXXXXGXXXXXXXXXXXXXXXXXXX,0,0,0
6069,37,0,37,84,479,0,0,181,31,150,GOOXXXXXXXXXXXXXXXXXGOXXXXXXXXXXXXXXXXXXGXXXXXXXXXXXXXXXXXXXGOOXXXXXXXXXXXXXXXXXGOOOOXXXXXXXXXXXXXXXGOOOOXXXXXXXXXXXXXXXGOXXXXXXXXXXXXXXXXXXGOXXXXXXXXXXXXXXXXXXGXXXXXXXXXXXXXXXXXXXGOOXXXXXXXXXXXXXXXXXGOOOXXXXXXXXXXXXXXXXGOOOOXXXXXXXXXXXXXXXGXXXXXXXXXXXXXXXXXXX,0,0,0

6090,37,0,37,85,478,0,0,179,30,149,GOOXXXXXXXXXXXXXXXXXGOXXXXXXXXXXXXXXXXXXGXXXXXXXXXXXXXXXXXXXGOOXXXXXXXXXXXXXXXXXGOOOOXXXXXXXXXXXXXXXGOOOOXXXXXXXXXXXXXXXGOXXXXXXXXXXXXXXXXXXGOXXXXXXXXXXXXXXXXXXGXXXXXXXXXXXXXXXXXXXGOOXXXXXXXXXXXXXXXXXGOOOXXXXXXXXXXXXXXXXGOOOOXXXXXXXXXXXXXXXGXXXXXXXXXXXXXXXXXXX,0,0,0
6111,37,0,37,88,475,0,0,176,26,150,GOOXXXXXXXXXXXXXXXXXGOXXXXXXXXXXXXXXXXXXGXXXXXXXXXXXXXXXXXXXGOOXXXXXXXXXXXXXXXXXGOOOOXXXXXXXXXXXXXXXGOOOOXXXXXXXXXXXXXXXGOXXXXXXXXXXXXXXXXXXGOXXXXXXXXXXXXXXXXXXGXXXXXXXXXXXXXXXXXXXGOOXXXXXXXXXXXXXXXXXGOOOXXXXXXXXXXXXXXXXGOOOOXXXXXXXXXXXXXXXGXXXXXXXXXXXXXXXXXXX,0,0,0
6132,37,0,37,89,474,0,0,175,26,149,GOOXXXXXXXXXXXXXXXXXGOXXXXXXXXXXXXXXXXXXGXXXXXXXXXXXXXXXXXXXGOOXXXXXXXXXXXXXXXXXGOOOOXXXXXXXXXXXXXXXGOOOOXXXXXXXXXXXXXXXGOXXXXXXXXXXXXXXXXXXGOXXXXXXXXXXXXXXXXXXGXXXXXXXXXXXXXXXXXXXGOOXXXXXXXXXXXXXXXXXGOOOXXXXXXXXXXXXXXXXGOOOOXXXXXXXXXXXXXXXGXXXXXXXXXXXXXXXXXXX,0,0,0
6153,38,1,37,80,482,0,0,182,28,154,GOOXXXXXXXXXXXXXXXXXGOXXXXXXXXXXXXXXXXXXGXXXXXXXXXXXXXXXXXXXGOOXXXXXXXXXXXXXXXXXGOOOOXXXXXXXXXXXXXXXGOOOOAXXXXXXXXXXXXXXGOXXXXXXXXXXXXXXXXXXGOXXXXXXXXXXXXXXXXXXGXXXXXXXXXXXXXXXXXXXGOOXXXXXXXXXXXXXXXXXGOOOXXXXXXXXXXXXXXXXGOOOOXXXXXXXXXXXXXXXGXXXXXXXXXXXXXXXXXXX,0,0,0
6174,38,1,37,83,479,0,0,180,25,155,GOOXXXXXXXXXXXXXXXXXGOXXXXXXXXXXXXXXXXXXGXXXXXXXXXXXXXXXXXXXGOOXXXXXXXXXXXXXXXXXGOOOOXXXXXXXXXXXXXXXGOOOOAXXXXXXXXXXXXXXGOXXXXXXXXXXXXXXXXXXGOXXXXXXXXXXXXXXXXXXGXXXXXXXXXXXXXXXXXXXGOOXXXXXXXXXXXXXXXXXGOOOXXXXXXXXXXXXXXXXGOOOOXXXXXXXXXXXXXXXGXXXXXXXXXXXXXXXXXXX,0,0,0

6195,38,1,37,74,488,0,0,189,30,159,GOOXXXXXXXXXXXXXXXXXGOXXXXXXXXXXXXXXXXXXGXXXXXXXXXXXXXXXXXXXGOOXXXXXXXXXXXXXXXXXGOOOOXXXXXXXXXXXXXXXGOOOOAXXXXXXXXXXXXXXGOXXXXXXXXXXXXXXXXXXGOXXXXXXXXXXXXXXXXXXGXXXXXXXXXXXXXXXXXXXGOOXXXXXXXXXXXXXXXXXGOOOXXXXXXXXXXXXXXXXGOOOOXXXXXXXXXXXXXXXGXXXXXXXXXXXXXXXXXXX,0,0,0
6216,38,1,37,81,481,0,0,182,39,143,GOOXXXXXXXXXXXXXXXXXGOXXXXXXXXXXXXXXXXXXGXXXXXXXXXXXXXXXXXXXGOOXXXXXXXXXXXXXXXXXGOOOOXXXXXXXXXXXXXXXGOOOOAXXXXXXXXXXXXXXGOXXXXXXXXXXXXXXXXXXGOXXXXXXXXXXXXXXXXXXGXXXXXXXXXXXXXXXXXXXGOOXXXXXXXXXXXXXXXXXGOOOXXXXXXXXXXXXXXXXGOOOOXXXXXXXXXXXXXXXGXXXXXXXXXXXXXXXXXXX,0,0,0
6237,38,1,37,85,477,0,0,178,33,145,GOOXXXXXXXXXXXXXXXXXGOXXXXXXXXXXXXXXXXXXGXXXXXXXXXXXXXXXXXXXGOOXXXXXXXXXXXXXXXXXGOOOOXXXXXXXXXXXXXXXGOOOOAXXXXXXXXXXXXXXGOXXXXXXXXXXXXXXXXXXGOXXXXXXXXXXXXXXXXXXGXXXXXXXXXXXXXXXXXXXGOOXXXXXXXXXXXXXXXXXGOOOXXXXXXXXXXXXXXXXGOOOOXXXXXXXXXXXXXXXGXXXXXXXXXXXXXXXXXXX,0,0,0
6258,38,0,38,89,473,0,0,175,25,150,GOOXXXXXXXXXXXXXXXXXGOXXXXXXXXXXXXXXXXXXGXXXXXXXXXXXXXXXXXXXGOOXXXXXXXXXXXXXXXXXGOOOOXXXXXXXXXXXXXXXGOOOOOXXXXXXXXXXXXXXGOXXXXXXXXXXXXXXXXXXGOXXXXXXXXXXXXXXXXXXGXXXXXXXXXXXXXXXXXXXGOOXXXXXXXXXXXXXXXXXGOOOXXXXXXXXXXXXXXXXGOOOOXXXXXXXXXXXXXXXGXXXXXXXXXXXXXXXXXXX,0,0,0
6279,39,1,38,82,479,0,0,180,26,154,GOOXXXXXXXXXXXXXXXXXGOXXXXXXXXXXXXXXXXXXGXXXXXXXXXXXXXXXXXXXGOOXXXXXXXXXXXXXXXXXGOOOOXXXXXXXXXXXXXXXGOOOOOXXXXXXXXXXXXXXGOXXXXXXXXXXXXXXXXXXGOXXXXXXXXXXXXXXXXXXGAXXXXXXXXXXXXXXXXXXGOOXXXXXXXXXXXXXXXXXGOOOXXXXXXXXXXXXXXXXGOOOOXXXXXXXXXXXXXXXGXXXXXXXXXXXXXXXXXXX,0,0,0

6300,39,1,38,83,478,0,0,180,29,151,GOOXXXXXXXXXXXXXXXXXGOXXXXXXXXXXXXXXXXXXGXXXXXXXXXXXXXXXXXXXGOOXXXXXXXXXXXXXXXXXGOOOOXXXXXXXXXXXXXXXGOOOOOXXXXXXXXXXXXXXGOXXXXXXXXXXXXXXXXXXGOXXXXXXXXXXXXXXXXXXGAXXXXXXXXXXXXXXXXXXGOOXXXXXXXXXXXXXXXXXGOOOXXXXXXXXXXXXXXXXGOOOOXXXXXXXXXXXXXXXGXXXXXXXXXXXXXXXXXXX,0,0,0
6321,39,1,38,87,474,0,0,175,26,149,GOOXXXXXXXXXXXXXXXXXGOXXXXXXXXXXXXXXXXXXGXXXXXXXXXXXXXXXXXXXGOOXXXXXXXXXXXXXXXXXGOOOOXXXXXXXXXXXXXXXGOOOOOXXXXXXXXXXXXXXGOXXXXXXXXXXXXXXXXXXGOXXXXXXXXXXXXXXXXXXGAXXXXXXXXXXXXXXXXXXGOOXXXXXXXXXXXXXXXXXGOOOXXXXXXXXXXXXXXXXGOOOOXXXXXXXXXXXXXXXGXXXXXXXXXXXXXXXXXXX,0,0,0
6342,39,1,38,79,482,0,0,182,31,151,GOOXXXXXXXXXXXXXXXXXGOXXXXXXXXXXXXXXXXXXGXXXXXXXXXXXXXXXXXXXGOOXXXXXXXXXXXXXXXXXGOOOOXXXXXXXXXXXXXXXGOOOOOXXXXXXXXXXXXXXGOXXXXXXXXXXXXXXXXXXGOXXXXXXXXXXXXXXXXXXGAXXXXXXXXXXXXXXXXXXGOOXXXXXXXXXXXXXXXXXGOOOXXXXXXXXXXXXXXXXGOOOOXXXXXXXXXXXXXXXGXXXXXXXXXXXXXXXXXXX,0,0,0
6363,39,1,38,83,478,0,0,179,27,152,GOOXXXXXXXXXXXXXXXXXGOXXXXXXXXXXXXXXXXXXGXXXXXXXXXXXXXXXXXXXGOOXXXXXXXXXXXXXXXXXGOOOOXXXXXXXXXXXXXXXGOOOOOXXXXXXXXXXXXXXGOXXXXXXXXXXXXXXXXXXGOXXXXXXXXXXXXXXXXXXGAXXXXXXXXXXXXXXXXXXGOOXXXXXXXXXXXXXXXXXGOOOXXXXXXXXXXXXXXXXGOOOOXXXXXXXXXXXXXXXGXXXXXXXXXXXXXXXXXXX,0,0,0
6384,39,1,38,83,478,0,0,179,32,147,GOOXXXXXXXXXXXXXXXXXGOXXXXXXXXXXXXXXXXXXGXXXXXXXXXXXXXXXXXXXGOOXXXXXXXXXXXXXXXXXGOOOOXXXXXXXXXXXXXXXGOOOOOXXXXXXXXXXXXXXGOXXXXXXXXXXXXXXXXXXGOXXXXXXXXXXXXXXXXXXGAXXXXXXXXXXXXXXXXXXGOOXXXXXXXXXXXXXXXXXGOOOXXXXXXXXXXXXXXXXGOOOOXXXXXXXXXXXXXXXGXXXXXXXXXXXXXXXXXXX,0,0,0

6405,39,1,38,84,477,0,0,179,29,150,GOOXXXXXXXXXXXXXXXXXGOXXXXXXXXXXXXXXXXXXGXXXXXXXXXXXXXXXXXXXGOOXXXXXXXXXXXXXXXXXGOOOOXXXXXXXXXXXXXXXGOOOOOXXXXXXXXXXXXXXGOXXXXXXXXXXXXXXXXXXGOXXXXXXXXXXXXXXXXXXGAXXXXXXXXXXXXXXXXXXGOOXXXXXXXXXXXXXXXXXGOOOXXXXXXXXXXXXXXXXGOOOOXXXXXXXXXXXXXXXGXXXXXXXXXXXXXXXXXXX,0,0,0
6426,39,1,38,80,481,0,0,183,30,153,GOOXXXXXXXXXXXXXXXXXGOXXXXXXXXXXXXXXXXXXGXXXXXXXXXXXXXXXXXXXGOOXXXXXXXXXXXXXXXXXGOOOOXXXXXXXXXXXXXXXGOOOOOXXXXXXXXXXXXXXGOXXXXXXXXXXXXXXXXXXGOXXXXXXXXXXXXXXXXXXGAXXXXXXXXXXXXXXXXXXGOOXXXXXXXXXXXXXXXXXGOOOXXXXXXXXXXXXXXXXGOOOOXXXXXXXXXXXXXXXGXXXXXXXXXXXXXXXXXXX,0,0,0
6447,39,0,39,84,477,0,0,179,30,149,GOOXXXXXXXXXXXXXXXXXGOXXXXXXXXXXXXXXXXXXGXXXXXXXXXXXXXXXXXXXGOOXXXXXXXXXXXXXXXXXGOOOOXXXXXXXXXXXXXXXGOOOOOXXXXXXXXXXXXXXGOXXXXXXXXXXXXXXXXXXGOXXXXXXXXXXXXXXXXXXGOXXXXXXXXXXXXXXXXXXGOOXXXXXXXXXXXXXXXXXGOOOXXXXXXXXXXXXXXXXGOOOOXXXXXXXXXXXXXXXGXXXXXXXXXXXXXXXXXXX,0,0,0
6468,39,0,39,84,477,0,0,179,27,152,GOOXXXXXXXXXXXXXXXXXGOXXXXXXXXXXXXXXXXXXGXXXXXXXXXXXXXXXXXXXGOOXXXXXXXXXXXXXXXXXGOOOOXXXXXXXXXXXXXXXGOOOOOXXXXXXXXXXXXXXGOXXXXXXXXXXXXXXXXXXGOXXXXXXXXXXXXXXXXXXGOXXXXXXXXXXXXXXXXXXGOOXXXXXXXXXXXXXXXXXGOOOXXXXXXXXXXXXXXXXGOOOOXXXXXXXXXXXXXXXGXXXXXXXXXXXXXXXXXXX,0,0,0
6489,39,0,39,81,480,0,0,182,32,150,GOOXXXXXXXXXXXXXXXXXGOXXXXXXXXXXXXXXXXXXGXXXXXXXXXXXXXXXXXXXGOOXXXXXXXXXXXXXXXXXGOOOOXXXXXXXXXXXXXXXGOOOOOXXXXXXXXXXXXXXGOXXXXXXXXXXXXXXXXXXGOXXXXXXXXXXXXXXXXXXGOXXXXXXXXXXXXXXXXXXGOOXXXXXXXXXXXXXXXXXGOOOXXXXXXXXXXXXXXXXGOOOOXXXXXXXXXXXXXXXGXXXXXXXXXXXXXXXXXXX,0,0,0

6510,39,0,39,78,483,0,0,185,35,150,GOOXXXXXXXXXXXXXXXXXGOXXXXXXXXXXXXXXXXXXGXXXXXXXXXXXXXXXXXXXGOOXXXXXXXXXXXXXXXXXGOOOOXXXXXXXXXXXXXXXGOOOOOXXXXXXXXXXXXXXGOXXXXXXXXXXXXXXXXXXGOXXXXXXXXXXXXXXXXXXGOXXXXXXXXXXXXXXXXXXGOOXXXXXXXXXXXXXXXXXGOOOXXXXXXXXXXXXXXXXGOOOOXXXXXXXXXXXXXXXGXXXXXXXXXXXXXXXXXXX,0,0,0
6531,39,0,39,80,481,0,0,181,30,151,GOOXXXXXXXXXXXXXXXXXGOXXXXXXXXXXXXXXXXXXGXXXXXXXXXXXXXXXXXXXGOOXXXXXXXXXXXXXXXXXGOOOOXXXXXXXXXXXXXXXGOOOOOXXXXXXXXXXXXXXGOXXXXXXXXXXXXXXXXXXGOXXXXXXXXXXXXXXXXXXGOXXXXXXXXXXXXXXXXXXGOOXXXXXXXXXXXXXXXXXGOOOXXXXXXXXXXXXXXXXGOOOOXXXXXXXXXXXXXXXGXXXXXXXXXXXXXXXXXXX,0,0,0
6552,39,0,39,80,481,0,0,182,26,156,GOOXXXXXXXXXXXXXXXXXGOXXXXXXXXXXXXXXXXXXGXXXXXXXXXXXXXXXXXXXGOOXXXXXXXXXXXXXXXXXGOOOOXXXXXXXXXXXXXXXGOOOOOXXXXXXXXXXXXXXGOXXXXXXXXXXXXXXXXXXGOXXXXXXXXXXXXXXXXXXGOXXXXXXXXXXXXXXXXXXGOOXXXXXXXXXXXXXXXXXGOOOXXXXXXXXXXXXXXXXGOOOOXXXXXXXXXXXXXXXGXXXXXXXXXXXXXXXXXXX,0,0,0
6573,39,0,39,74,487,0,0,187,28,159,GOOXXXXXXXXXXXXXXXXXGOXXXXXXXXXXXXXXXXXXGXXXXXXXXXXXXXXXXXXXGOOXXXXXXXXXXXXXXXXXGOOOOXXXXXXXXXXXXXXXGOOOOOXXXXXXXXXXXXXXGOXXXXXXXXXXXXXXXXXXGOXXXXXXXXXXXXXXXXXXGOXXXXXXXXXXXXXXXXXXGOOXXXXXXXXXXXXXXXXXGOOOXXXXXXXXXXXXXXXXGOOOOXXXXXXXXXXXXXXXGXXXXXXXXXXXXXXXXXXX,0,0,0
6594,39,0,39,80,481,0,0,182,31,151,GOOXXXXXXXXXXXXXXXXXGOXXXXXXXXXXXXXXXXXXGXXXXXXXXXXXXXXXXXXXGOOXXXXXXXXXXXXXXXXXGOOOOXXXXXXXXXXXXXXXGOOOOOXXXXXXXXXXXXXXGOXXXXXXXXXXXXXXXXXXGOXXXXXXXXXXXXXXXXXXGOXXXXXXXXXXXXXXXXXXGOOXXXXXXXXXXXXXXXXXGOOOXXXXXXXXXXXXXXXXGOOOOXXXXXXXXXXXXXXXGXXXXXXXXXXXXXXXXXXX,0,0,0

6615,40,1,39,80,480,0,0,180,33,147,GOOXXXXXXXXXXXXXXXXXGOXXXXXXXXXXXXXXXXXXGXXXXXXXXXXXXXXXXXXXGOOXXXXXXXXXXXXXXXXXGOOOOXXXXXXXXXXXXXXXGOOOOOXXXXXXXXXXXXXXGOAXXXXXXXXXXXXXXXXXGOXXXXXXXXXXXXXXXXXXGOXXXXXXXXXXXXXXXXXXGOOXXXXXXXXXXXXXXXXXGOOOXXXXXXXXXXXXXXXXGOOOOXXXXXXXXXXXXXXXGXXXXXXXXXXXXXXXXXXX,0,0,0
6636,40,1,39,81,479,0,0,180,31,149,GOOXXXXXXXXXXXXXXXXXGOXXXXXXXXXXXXXXXXXXGXXXXXXXXXXXXXXXXXXXGOOXXXXXXXXXXXXXXXXXGOOOOXXXXXXXXXXXXXXXGOOOOOXXXXXXXXXXXXXXGOAXXXXXXXXXXXXXXXXXGOXXXXXXXXXXXXXXXXXXGOXXXXXXXXXXXXXXXXXXGOOXXXXXXXXXXXXXXXXXGOOOXXXXXXXXXXXXXXXXGOOOOXXXXXXXXXXXXXXXGXXXXXXXXXXXXXXXXXXX,0,0,0
6657,40,0,40,87,473,0,0,174,30,144,GOOXXXXXXXXXXXXXXXXXGOXXXXXXXXXXXXXXXXXXGXXXXXXXXXXXXXXXXXXXGOOXXXXXXXXXXXXXXXXXGOOOOXXXXXXXXXXXXXXXGOOOOOXXXXXXXXXXXXXXGOOXXXXXXXXXXXXXXXXXGOXXXXXXXXXXXXXXXXXXGOXXXXXXXXXXXXXXXXXXGOOXXXXXXXXXXXXXXXXXGOOOXXXXXXXXXXXXXXXXGOOOOXXXXXXXXXXXXXXXGXXXXXXXXXXXXXXXXXXX,0,0,0
6678,40,0,40,89,471,0,0,172,33,139,GOOXXXXXXXXXXXXXXXXXGOXXXXXXXXXXXXXXXXXXGXXXXXXXXXXXXXXXXXXXGOOXXXXXXXXXXXXXXXXXGOOOOXXXXXXXXXXXXXXXGOOOOOXXXXXXXXXXXXXXGOOXXXXXXXXXXXXXXXXXGOXXXXXXXXXXXXXXXXXXGOXXXXXXXXXXXXXXXXXXGOOXXXXXXXXXXXXXXXXXGOOOXXXXXXXXXXXXXXXXGOOOOXXXXXXXXXXXXXXXGXXXXXXXXXXXXXXXXXXX,0,0,0
6699,40,0,40,88,472,0,0,173,30,143,GOOXXXXXXXXXXXXXXXXXGOXXXXXXXXXXXXXXXXXXGXXXXXXXXXXXXXXXXXXXGOOXXXXXXXXXXXXXXXXXGOOOOXXXXXXXXXXXXXXXGOOOOOXXXXXXXXXXXXXXGOOXXXXXXXXXXXXXXXXXGOXXXXXXXXXXXXXXXXXXGOXXXXXXXXXXXXXXXXXXGOOXXXXXXXXXXXXXXXXXGOOOXXXXXXXXXXXXXXXXGOOOOXXXXXXXXXXXXXXXGXXXXXXXXXXXXXXXXXXX,0,0,0

6720,40,0,40,92,468,0,0,170,32,138,GOOXXXXXXXXXXXXXXXXXGOXXXXXXXXXXXXXXXXXXGXXXXXXXXXXXXXXXXXXXGOOXXXXXXXXXXXXXXXXXGOOOOXXXXXXXXXXXXXXXGOOOOOXXXXXXXXXXXXXXGOOXXXXXXXXXXXXXXXXXGOXXXXXXXXXXXXXXXXXXGOXXXXXXXXXXXXXXXXXXGOOXXXXXXXXXXXXXXXXXGOOOXXXXXXXXXXXXXXXXGOOOOXXXXXXXXXXXXXXXGXXXXXXXXXXXXXXXXXXX,0,0,0
6741,41,1,40,91,468,0,0,169,30,139,GOOXXXXXXXXXXXXXXXXXGOXXXXXXXXXXXXXXXXXXGXXXXXXXXXXXXXXXXXXXGOOXXXXXXXXXXXXXXXXXGOOOOXXXXXXXXXXXXXXXGOOOOOXXXXXXXXXXXXXXGOOXXXXXXXXXXXXXXXXXGOXXXXXXXXXXXXXXXXXXGOAXXXXXXXXXXXXXXXXXGOOXXXXXXXXXXXXXXXXXGOOOXXXXXXXXXXXXXXXXGOOOOXXXXXXXXXXXXXXXGXXXXXXXXXXXXXXXXXXX,0,0,0
6762,41,1,40,88,471,0,0,172,30,142,GOOXXXXXXXXXXXXXXXXXGOXXXXXXXXXXXXXXXXXXGXXXXXXXXXXXXXXXXXXXGOOXXXXXXXXXXXXXXXXXGOOOOXXXXXXXXXXXXXXXGOOOOOXXXXXXXXXXXXXXGOOXXXXXXXXXXXXXXXXXGOXXXXXXXXXXXXXXXXXXGOAXXXXXXXXXXXXXXXXXGOOXXXXXXXXXXXXXXXXXGOOOXXXXXXXXXXXXXXXXGOOOOXXXXXXXXXXXXXXXGXXXXXXXXXXXXXXXXXXX,0,0,0
6783,41,0,41,83,476,0,0,178,30,148,GOOXXXXXXXXXXXXXXXXXGOXXXXXXXXXXXXXXXXXXGXXXXXXXXXXXXXXXXXXXGOOXXXXXXXXXXXXXXXXXGOOOOXXXXXXXXXXXXXXXGOOOOOXXXXXXXXXXXXXXGOOXXXXXXXXXXXXXXXXXGOXXXXXXXXXXXXXXXXXXGOOXXXXXXXXXXXXXXXXXGOOXXXXXXXXXXXXXXXXXGOOOXXXXXXXXXXXXXXXXGOOOOXXXXXXXXXXXXXXXGXXXXXXXXXXXXXXXXXXX,0,0,0
6804,41,0,41,86,473,0,0,173,30,143,GOOXXXXXXXXXXXXXXXXXGOXXXXXXXXXXXXXXXXXXGXXXXXXXXXXXXXXXXXXXGOOXXXXXXXXXXXXXXXXXGOOOOXXXXXXXXXXXXXXXGOOOOOXXXXXXXXXXXXXXGOOXXXXXXXXXXXXXXXXXGOXXXXXXXXXXXXXXXXXXGOOXXXXXXXXXXXXXXXXXGOOXXXXXXXXXXXXXXXXXGOOOXXXXXXXXXXXXXXXXGOOOOXXXXXXXXXXXXXXXGXXXXXXXXXXXXXXXXXXX,0,0,0

6825,41,0,41,85,474,0,0,176,28,148,GOOXXXXXXXXXXXXXXXXXGOXXXXXXXXXXXXXXXXXXGXXXXXXXXXXXXXXXXXXXGOOXXXXXXXXXXXXXXXXXGOOOOXXXXXXXXXXXXXXXGOOOOOXXXXXXXXXXXXXXGOOXXXXXXXXXXXXXXXXXGOXXXXXXXXXXXXXXXXXXGOOXXXXXXXXXXXXXXXXXGOOXXXXXXXXXXXXXXXXXGOOOXXXXXXXXXXXXXXXXGOOOOXXXXXXXXXXXXXXXGXXXXXXXXXXXXXXXXXXX,0,0,0
6846,41,0,41,80,479,0,0,181,30,151,GOOXXXXXXXXXXXXXXXXXGOXXXXXXXXXXXXXXXXXXGXXXXXXXXXXXXXXXXXXXGOOXXXXXXXXXXXXXXXXXGOOOOXXXXXXXXXXXXXXXGOOOOOXXXXXXXXXXXXXXGOOXXXXXXXXXXXXXXXXXGOXXXXXXXXXXXXXXXXXXGOOXXXXXXXXXXXXXXXXXGOOXXXXXXXXXXXXXXXXXGOOOXXXXXXXXXXXXXXXXGOOOOXXXXXXXXXXXXXXXGXXXXXXXXXXXXXXXXXXX,0,0,0
6867,41,0,41,85,474,0,0,175,26,149,GOOXXXXXXXXXXXXXXXXXGOXXXXXXXXXXXXXXXXXXGXXXXXXXXXXXXXXXXXXXGOOXXXXXXXXXXXXXXXXXGOOOOXXXXXXXXXXXXXXXGOOOOOXXXXXXXXXXXXXXGOOXXXXXXXXXXXXXXXXXGOXXXXXXXXXXXXXXXXXXGOOXXXXXXXXXXXXXXXXXGOOXXXXXXXXXXXXXXXXXGOOOXXXXXXXXXXXXXXXXGOOOOXXXXXXXXXXXXXXXGXXXXXXXXXXXXXXXXXXX,0,0,0
6888,42,1,41,83,475,0,0,178,32,146,GOOXXXXXXXXXXXXXXXXXGOXXXXXXXXXXXXXXXXXXGXXXXXXXXXXXXXXXXXXXGOOXXXXXXXXXXXXXXXXXGOOOOXXXXXXXXXXXXXXXGOOOOOXXXXXXXXXXXXXXGOOXXXXXXXXXXXXXXXXXGOXXXXXXXXXXXXXXXXXXGOOXXXXXXXXXXXXXXXXXGOOXXXXXXXXXXXXXXXXXGOOOXXXXXXXXXXXXXXXXGOOOOXXXXXXXXXXXXXXXGAXXXXXXXXXXXXXXXXXX,0,0,0
6909,43,0,43,81,476,0,0,178,29,149,GOOXXXXXXXXXXXXXXXXXGOXXXXXXXXXXXXXXXXXXGOXXXXXXXXXXXXXXXXXXGOOXXXXXXXXXXXXXXXXXGOOOOXXXXXXXXXXXXXXXGOOOOOXXXXXXXXXXXXXXGOOXXXXXXXXXXXXXXXXXGOXXXXXXXXXXXXXXXXXXGOOXXXXXXXXXXXXXXXXXGOOXXXXXXXXXXXXXXXXXGOOOXXXXXXXXXXXXXXXXGOOOOXXXXXXXXXXXXXXXGOXXXXXXXXXXXXXXXXXX,0,0,0

6930,43,0,43,78,479,0,0,181,32,149,GOOXXXXXXXXXXXXXXXXXGOXXXXXXXXXXXXXXXXXXGOXXXXXXXXXXXXXXXXXXGOOXXXXXXXXXXXXXXXXXGOOOOXXXXXXXXXXXXXXXGOOOOOXXXXXXXXXXXXXXGOOXXXXXXXXXXXXXXXXXGOXXXXXXXXXXXXXXXXXXGOOXXXXXXXXXXXXXXXXXGOOXXXXXXXXXXXXXXXXXGOOOXXXXXXXXXXXXXXXXGOOOOXXXXXXXXXXXXXXXGOXXXXXXXXXXXXXXXXXX,0,0,0
6951,43,0,43,79,478,0,0,180,37,143,GOOXXXXXXXXXXXXXXXXXGOXXXXXXXXXXXXXXXXXXGOXXXXXXXXXXXXXXXXXXGOOXXXXXXXXXXXXXXXXXGOOOOXXXXXXXXXXXXXXXGOOOOOXXXXXXXXXXXXXXGOOXXXXXXXXXXXXXXXXXGOXXXXXXXXXXXXXXXXXXGOOXXXXXXXXXXXXXXXXXGOOXXXXXXXXXXXXXXXXXGOOOXXXXXXXXXXXXXXXXGOOOOXXXXXXXXXXXXXXXGOXXXXXXXXXXXXXXXXXX,0,0,0
6972,43,0,43,78,479,0,0,181,34,147,GOOXXXXXXXXXXXXXXXXXGOXXXXXXXXXXXXXXXXXXGOXXXXXXXXXXXXXXXXXXGOOXXXXXXXXXXXXXXXXXGOOOOXXXXXXXXXXXXXXXGOOOOOXXXXXXXXXXXXXXGOOXXXXXXXXXXXXXXXXXGOXXXXXXXXXXXXXXXXXXGOOXXXXXXXXXXXXXXXXXGOOXXXXXXXXXXXXXXXXXGOOOXXXXXXXXXXXXXXXXGOOOOXXXXXXXXXXXXXXXGOXXXXXXXXXXXXXXXXXX,0,0,0
6993,43,0,43,76,481,0,0,185,30,155,GOOXXXXXXXXXXXXXXXXXGOXXXXXXXXXXXXXXXXXXGOXXXXXXXXXXXXXXXXXXGOOXXXXXXXXXXXXXXXXXGOOOOXXXXXXXXXXXXXXXGOOOOOXXXXXXXXXXXXXXGOOXXXXXXXXXXXXXXXXXGOXXXXXXXXXXXXXXXXXXGOOXXXXXXXXXXXXXXXXXGOOXXXXXXXXXXXXXXXXXGOOOXXXXXXXXXXXXXXXXGOOOOXXXXXXXXXXXXXXXGOXXXXXXXXXXXXXXXXXX,0,0,0
7014,43,0,43,78,479,0,0,183,33,150,GOOXXXXXXXXXXXXXXXXXGOXXXXXXXXXXXXXXXXXXGOXXXXXXXXXXXXXXXXXXGOOXXXXXXXXXXXXXXXXXGOOOOXXXXXXXXXXXXXXXGOOOOOXXXXXXXXXXXXXXGOOXXXXXXXXXXXXXXXXXGOXXXXXXXXXXXXXXXXXXGOOXXXXXXXXXXXXXXXXXGOOXXXXXXXXXXXXXXXXXGOOOXXXXXXXXXXXXXXXXGOOOOXXXXXXXXXXXXXXXGOXXXXXXXXXXXXXXXXXX,0,0,0

7035,43,0,43,79,478,0,0,181,33,148,GOOXXXXXXXXXXXXXXXXXGOXXXXXXXXXXXXXXXXXXGOXXXXXXXXXXXXXXXXXXGOOXXXXXXXXXXXXXXXXXGOOOOXXXXXXXXXXXXXXXGOOOOOXXXXXXXXXXXXXXGOOXXXXXXXXXXXXXXXXXGOXXXXXXXXXXXXXXXXXXGOOXXXXXXXXXXXXXXXXXGOOXXXXXXXXXXXXXXXXXGOOOXXXXXXXXXXXXXXXXGOOOOXXXXXXXXXXXXXXXGOXXXXXXXXXXXXXXXXXX,0,0,0
7056,43,0,43,83,474,0,0,179,32,147,GOOXXXXXXXXXXXXXXXXXGOXXXXXXXXXXXXXXXXXXGOXXXXXXXXXXXXXXXXXXGOOXXXXXXXXXXXXXXXXXGOOOOXXXXXXXXXXXXXXXGOOOOOXXXXXXXXXXXXXXGOOXXXXXXXXXXXXXXXXXGOXXXXXXXXXXXXXXXXXXGOOXXXXXXXXXXXXXXXXXGOOXXXXXXXXXXXXXXXXXGOOOXXXXXXXXXXXXXXXXGOOOOXXXXXXXXXXXXXXXGOXXXXXXXXXXXXXXXXXX,0,0,0
7077,43,0,43,89,468,0,0,172,32,140,GOOXXXXXXXXXXXXXXXXXGOXXXXXXXXXXXXXXXXXXGOXXXXXXXXXXXXXXXXXXGOOXXXXXXXXXXXXXXXXXGOOOOXXXXXXXXXXXXXXXGOOOOOXXXXXXXXXXXXXXGOOXXXXXXXXXXXXXXXXXGOXXXXXXXXXXXXXXXXXXGOOXXXXXXXXXXXXXXXXXGOOXXXXXXXXXXXXXXXXXGOOOXXXXXXXXXXXXXXXXGOOOOXXXXXXXXXXXXXXXGOXXXXXXXXXXXXXXXXXX,0,0,0
7098,43,0,43,83,474,0,0,178,31,147,GOOXXXXXXXXXXXXXXXXXGOXXXXXXXXXXXXXXXXXXGOXXXXXXXXXXXXXXXXXXGOOXXXXXXXXXXXXXXXXXGOOOOXXXXXXXXXXXXXXXGOOOOOXXXXXXXXXXXXXXGOOXXXXXXXXXXXXXXXXXGOXXXXXXXXXXXXXXXXXXGOOXXXXXXXXXXXXXXXXXGOOXXXXXXXXXXXXXXXXXGOOOXXXXXXXXXXXXXXXXGOOOOXXXXXXXXXXXXXXXGOXXXXXXXXXXXXXXXXXX,0,0,0
7119,43,0,43,77,480,0,0,183,37,146,GOOXXXXXXXXXXXXXXXXXGOXXXXXXXXXXXXXXXXXXGOXXXXXXXXXXXXXXXXXXGOOXXXXXXXXXXXXXXXXXGOOOOXXXXXXXXXXXXXXXGOOOOOXXXXXXXXXXXXXXGOOXXXXXXXXXXXXXXXXXGOXXXXXXXXXXXXXXXXXXGOOXXXXXXXXXXXXXXXXXGOOXXXXXXXXXXXXXXXXXGOOOXXXXXXXXXXXXXXXXGOOOOXXXXXXXXXXXXXXXGOXXXXXXXXXXXXXXXXXX,0,0,0

7140,44,1,43,81,475,0,0,178,33,145,GOOXXXXXXXXXXXXXXXXXGOXXXXXXXXXXXXXXXXXXGOXXXXXXXXXXXXXXXXXXGOOXXXXXXXXXXXXXXXXXGOOOOXXXXXXXXXXXXXXXGOOOOOXXXXXXXXXXXXXXGOOXXXXXXXXXXXXXXXXXGOXXXXXXXXXXXXXXXXXXGOOXXXXXXXXXXXXXXXXXGOOXXXXXXXXXXXXXXXXXGOOOAXXXXXXXXXXXXXXXGOOOOXXXXXXXXXXXXXXXGOXXXXXXXXXXXXXXXXXX,0,0,0
7161,44,1,43,86,470,0,0,172,31,141,GOOXXXXXXXXXXXXXXXXXGOXXXXXXXXXXXXXXXXXXGOXXXXXXXXXXXXXXXXXXGOOXXXXXXXXXXXXXXXXXGOOOOXXXXXXXXXXXXXXXGOOOOOXXXXXXXXXXXXXXGOOXXXXXXXXXXXXXXXXXGOXXXXXXXXXXXXXXXXXXGOOXXXXXXXXXXXXXXXXXGOOXXXXXXXXXXXXXXXXXGOOOAXXXXXXXXXXXXXXXGOOOOXXXXXXXXXXXXXXXGOXXXXXXXXXXXXXXXXXX,0,0,0
7182,44,0,44,90,466,0,0,168,32,136,GOOXXXXXXXXXXXXXXXXXGOXXXXXXXXXXXXXXXXXXGOXXXXXXXXXXXXXXXXXXGOOXXXXXXXXXXXXXXXXXGOOOOXXXXXXXXXXXXXXXGOOOOOXXXXXXXXXXXXXXGOOXXXXXXXXXXXXXXXXXGOXXXXXXXXXXXXXXXXXXGOOXXXXXXXXXXXXXXXXXGOOXXXXXXXXXXXXXXXXXGOOOOXXXXXXXXXXXXXXXGOOOOXXXXXXXXXXXXXXXGOXXXXXXXXXXXXXXXXXX,0,0,0
7203,44,0,44,85,471,0,0,172,34,138,GOOXXXXXXXXXXXXXXXXXGOXXXXXXXXXXXXXXXXXXGOXXXXXXXXXXXXXXXXXXGOOXXXXXXXXXXXXXXXXXGOOOOXXXXXXXXXXXXXXXGOOOOOXXXXXXXXXXXXXXGOOXXXXXXXXXXXXXXXXXGOXXXXXXXXXXXXXXXXXXGOOXXXXXXXXXXXXXXXXXGOOXXXXXXXXXXXXXXXXXGOOOOXXXXXXXXXXXXXXXGOOOOXXXXXXXXXXXXXXXGOXXXXXXXXXXXXXXXXXX,0,0,0
7224,44,0,44,80,476,0,0,177,33,144,GOOXXXXXXXXXXXXXXXXXGOXXXXXXXXXXXXXXXXXXGOXXXXXXXXXXXXXXXXXXGOOXXXXXXXXXXXXXXXXXGOOOOXXXXXXXXXXXXXXXGOOOOOXXXXXXXXXXXXXXGOOXXXXXXXXXXXXXXXXXGOXXXXXXXXXXXXXXXXXXGOOXXXXXXXXXXXXXXXXXGOOXXXXXXXXXXXXXXXXXGOOOOXXXXXXXXXXXXXXXGOOOOXXXXXXXXXXXXXXXGOXXXXXXXXXXXXXXXXXX,0,0,0

7245,44,0,44,84,472,0,0,175,33,142,GOOXXXXXXXXXXXXXXXXXGOXXXXXXXXXXXXXXXXXXGOXXXXXXXXXXXXXXXXXXGOOXXXXXXXXXXXXXXXXXGOOOOXXXXXXXXXXXXXXXGOOOOOXXXXXXXXXXXXXXGOOXXXXXXXXXXXXXXXXXGOXXXXXXXXXXXXXXXXXXGOOXXXXXXXXXXXXXXXXXGOOXXXXXXXXXXXXXXXXXGOOOOXXXXXXXXXXXXXXXGOOOOXXXXXXXXXXXXXXXGOXXXXXXXXXXXXXXXXXX,0,0,0
7266,45,1,44,84,471,0,0,173,35,138,GOOXXXXXXXXXXXXXXXXXGOXXXXXXXXXXXXXXXXXXGOXXXXXXXXXXXXXXXXXXGOOXXXXXXXXXXXXXXXXXGOOOOXXXXXXXXXXXXXXXGOOOOOXXXXXXXXXXXXXXGOOAXXXXXXXXXXXXXXXXGOXXXXXXXXXXXXXXXXXXGOOXXXXXXXXXXXXXXXXXGOOXXXXXXXXXXXXXXXXXGOOOOXXXXXXXXXXXXXXXGOOOOXXXXXXXXXXXXXXXGOXXXXXXXXXXXXXXXXXX,0,0,0
7287,45,1,44,89,466,0,0,168,33,135,GOOXXXXXXXXXXXXXXXXXGOXXXXXXXXXXXXXXXXXXGOXXXXXXXXXXXXXXXXXXGOOXXXXXXXXXXXXXXXXXGOOOOXXXXXXXXXXXXXXXGOOOOOXXXXXXXXXXXXXXGOOAXXXXXXXXXXXXXXXXGOXXXXXXXXXXXXXXXXXXGOOXXXXXXXXXXXXXXXXXGOOXXXXXXXXXXXXXXXXXGOOOOXXXXXXXXXXXXXXXGOOOOXXXXXXXXXXXXXXXGOXXXXXXXXXXXXXXXXXX,0,0,0
7308,46,2,44,82,472,0,0,172,31,141,GOOXXXXXXXXXXXXXXXXXGOXXXXXXXXXXXXXXXXXXGOXXXXXXXXXXXXXXXXXXGOOXXXXXXXXXXXXXXXXXGOOOOXXXXXXXXXXXXXXXGOOOOOXXXXXXXXXXXXXXGOOAXXXXXXXXXXXXXXXXGOXXXXXXXXXXXXXXXXXXGOOXXXXXXXXXXXXXXXXXGOOXXXXXXXXXXXXXXXXXGOOOOXXXXXXXXXXXXXXXGOOOOAXXXXXXXXXXXXXXGOXXXXXXXXXXXXXXXXXX,0,0,0
7329,46,2,44,84,470,0,0,171,30,141,GOOXXXXXXXXXXXXXXXXXGOXXXXXXXXXXXXXXXXXXGOXXXXXXXXXXXXXXXXXXGOOXXXXXXXXXXXXXXXXXGOOOOXXXXXXXXXXXXXXXGOOOOOXXXXXXXXXXXXXXGOOAXXXXXXXXXXXXXXXXGOXXXXXXXXXXXXXXXXXXGOOXXXXXXXXXXXXXXXXXGOOXXXXXXXXXXXXXXXXXGOOOOXXXXXXXXXXXXXXXGOOOOAXXXXXXXXXXXXXXGOXXXXXXXXXXXXXXXXXX,0,0,0

7350,46,2,44,79,475,0,0,176,32,144,GOOXXXXXXXXXXXXXXXXXGOXXXXXXXXXXXXXXXXXXGOXXXXXXXXXXXXXXXXXXGOOXXXXXXXXXXXXXXXXXGOOOOXXXXXXXXXXXXXXXGOOOOOXXXXXXXXXXXXXXGOOAXXXXXXXXXXXXXXXXGOXXXXXXXXXXXXXXXXXXGOOXXXXXXXXXXXXXXXXXGOOXXXXXXXXXXXXXXXXXGOOOOXXXXXXXXXXXXXXXGOOOOAXXXXXXXXXXXXXXGOXXXXXXXXXXXXXXXXXX,0,0,0
7371,46,1,45,85,469,0,0,169,32,137,GOOXXXXXXXXXXXXXXXXXGOXXXXXXXXXXXXXXXXXXGOXXXXXXXXXXXXXXXXXXGOOXXXXXXXXXXXXXXXXXGOOOOXXXXXXXXXXXXXXXGOOOOOXXXXXXXXXXXXXXGOOOXXXXXXXXXXXXXXXXGOXXXXXXXXXXXXXXXXXXGOOXXXXXXXXXXXXXXXXXGOOXXXXXXXXXXXXXXXXXGOOOOXXXXXXXXXXXXXXXGOOOOAXXXXXXXXXXXXXXGOXXXXXXXXXXXXXXXXXX,0,0,0
7392,46,1,45,81,473,0,0,172,28,144,GOOXXXXXXXXXXXXXXXXXGOXXXXXXXXXXXXXXXXXXGOXXXXXXXXXXXXXXXXXXGOOXXXXXXXXXXXXXXXXXGOOOOXXXXXXXXXXXXXXXGOOOOOXXXXXXXXXXXXXXGOOOXXXXXXXXXXXXXXXXGOXXXXXXXXXXXXXXXXXXGOOXXXXXXXXXXXXXXXXXGOOXXXXXXXXXXXXXXXXXGOOOOXXXXXXXXXXXXXXXGOOOOAXXXXXXXXXXXXXXGOXXXXXXXXXXXXXXXXXX,0,0,0
7413,46,1,45,76,478,0,0,179,31,148,GOOXXXXXXXXXXXXXXXXXGOXXXXXXXXXXXXXXXXXXGOXXXXXXXXXXXXXXXXXXGOOXXXXXXXXXXXXXXXXXGOOOOXXXXXXXXXXXXXXXGOOOOOXXXXXXXXXXXXXXGOOOXXXXXXXXXXXXXXXXGOXXXXXXXXXXXXXXXXXXGOOXXXXXXXXXXXXXXXXXGOOXXXXXXXXXXXXXXXXXGOOOOXXXXXXXXXXXXXXXGOOOOAXXXXXXXXXXXXXXGOXXXXXXXXXXXXXXXXXX,0,0,0
7434,46,1,45,75,479,0,0,180,32,148,GOOXXXXXXXXXXXXXXXXXGOXXXXXXXXXXXXXXXXXXGOXXXXXXXXXXXXXXXXXXGOOXXXXXXXXXXXXXXXXXGOOOOXXXXXXXXXXXXXXXGOOOOOXXXXXXXXXXXXXXGOOOXXXXXXXXXXXXXXXXGOXXXXXXXXXXXXXXXXXXGOOXXXXXXXXXXXXXXXXXGOOXXXXXXXXXXXXXXXXXGOOOOXXXXXXXXXXXXXXXGOOOOAXXXXXXXXXXXXXXGOXXXXXXXXXXXXXXXXXX,0,0,0

7455,46,0,46,75,479,0,0,180,32,148,GOOXXXXXXXXXXXXXXXXXGOXXXXXXXXXXXXXXXXXXGOXXXXXXXXXXXXXXXXXXGOOXXXXXXXXXXXXXXXXXGOOOOXXXXXXXXXXXXXXXGOOOOOXXXXXXXXXXXXXXGOOOXXXXXXXXXXXXXXXXGOXXXXXXXXXXXXXXXXXXGOOXXXXXXXXXXXXXXXXXGOOXXXXXXXXXXXXXXXXXGOOOOXXXXXXXXXXXXXXXGOOOOOXXXXXXXXXXXXXXGOXXXXXXXXXXXXXXXXXX,0,0,0
7476,47,1,46,73,480,0,0,181,29,152,GOOXXXXXXXXXXXXXXXXXGOXXXXXXXXXXXXXXXXXXGOXXXXXXXXXXXXXXXXXXGOOXXXXXXXXXXXXXXXXXGOOOOXXXXXXXXXXXXXXXGOOOOOXXXXXXXXXXXXXXGOOOXXXXXXXXXXXXXXXXGOXXXXXXXXXXXXXXXXXXGOOXXXXXXXXXXXXXXXXXGOOXXXXXXXXXXXXXXXXXGOOOOXXXXXXXXXXXXXXXGOOOOOAXXXXXXXXXXXXXGOXXXXXXXXXXXXXXXXXX,0,0,0
7497,48,2,46,73,479,0,0,180,36,144,GOOXXXXXXXXXXXXXXXXXGOXXXXXXXXXXXXXXXXXXGOXXXXXXXXXXXXXXXXXXGOOXXXXXXXXXXXXXXXXXGOOOOAXXXXXXXXXXXXXXGOOOOOXXXXXXXXXXXXXXGOOOXXXXXXXXXXXXXXXXGOXXXXXXXXXXXXXXXXXXGOOXXXXXXXXXXXXXXXXXGOOXXXXXXXXXXXXXXXXXGOOOOXXXXXXXXXXXXXXXGOOOOOAXXXXXXXXXXXXXGOXXXXXXXXXXXXXXXXXX,0,0,0
7518,48,1,47,84,468,0,0,168,34,134,GOOXXXXXXXXXXXXXXXXXGOXXXXXXXXXXXXXXXXXXGOXXXXXXXXXXXXXXXXXXGOOXXXXXXXXXXXXXXXXXGOOOOAXXXXXXXXXXXXXXGOOOOOXXXXXXXXXXXXXXGOOOXXXXXXXXXXXXXXXXGOXXXXXXXXXXXXXXXXXXGOOXXXXXXXXXXXXXXXXXGOOXXXXXXXXXXXXXXXXXGOOOOXXXXXXXXXXXXXXXGOOOOOOXXXXXXXXXXXXXGOXXXXXXXXXXXXXXXXXX,0,0,0
7539,48,1,47,88,464,0,0,163,31,132,GOOXXXXXXXXXXXXXXXXXGOXXXXXXXXXXXXXXXXXXGOXXXXXXXXXXXXXXXXXXGOOXXXXXXXXXXXXXXXXXGOOOOAXXXXXXXXXXXXXXGOOOOOXXXXXXXXXXXXXXGOOOXXXXXXXXXXXXXXXXGOXXXXXXXXXXXXXXXXXXGOOXXXXXXXXXXXXXXXXXGOOXXXXXXXXXXXXXXXXXGOOOOXXXXXXXXXXXXXXXGOOOOOOXXXXXXXXXXXXXGOXXXXXXXXXXXXXXXXXX,0,0,0

7560,49,2,47,82,469,0,0,168,30,138,GOOAXXXXXXXXXXXXXXXXGOXXXXXXXXXXXXXXXXXXGOXXXXXXXXXXXXXXXXXXGOOXXXXXXXXXXXXXXXXXGOOOOAXXXXXXXXXXXXXXGOOOOOXXXXXXXXXXXXXXGOOOXXXXXXXXXXXXXXXXGOXXXXXXXXXXXXXXXXXXGOOXXXXXXXXXXXXXXXXXGOOXXXXXXXXXXXXXXXXXGOOOOXXXXXXXXXXXXXXXGOOOOOOXXXXXXXXXXXXXGOXXXXXXXXXXXXXXXXXX,0,0,0
7581,49,2,47,80,471,0,0,173,32,141,GOOAXXXXXXXXXXXXXXXXGOXXXXXXXXXXXXXXXXXXGOXXXXXXXXXXXXXXXXXXGOOXXXXXXXXXXXXXXXXXGOOOOAXXXXXXXXXXXXXXGOOOOOXXXXXXXXXXXXXXGOOOXXXXXXXXXXXXXXXXGOXXXXXXXXXXXXXXXXXXGOOXXXXXXXXXXXXXXXXXGOOXXXXXXXXXXXXXXXXXGOOOOXXXXXXXXXXXXXXXGOOOOOOXXXXXXXXXXXXXGOXXXXXXXXXXXXXXXXXX,0,0,0
7602,49,2,47,85,466,0,0,168,28,140,GOOAXXXXXXXXXXXXXXXXGOXXXXXXXXXXXXXXXXXXGOXXXXXXXXXXXXXXXXXXGOOXXXXXXXXXXXXXXXXXGOOOOAXXXXXXXXXXXXXXGOOOOOXXXXXXXXXXXXXXGOOOXXXXXXXXXXXXXXXXGOXXXXXXXXXXXXXXXXXXGOOXXXXXXXXXXXXXXXXXGOOXXXXXXXXXXXXXXXXXGOOOOXXXXXXXXXXXXXXXGOOOOOOXXXXXXXXXXXXXGOXXXXXXXXXXXXXXXXXX,0,0,0
7623,50,2,48,76,474,0,0,174,33,141,GOOAAXXXXXXXXXXXXXXXGOXXXXXXXXXXXXXXXXXXGOXXXXXXXXXXXXXXXXXXGOOXXXXXXXXXXXXXXXXXGOOOOOXXXXXXXXXXXXXXGOOOOOXXXXXXXXXXXXXXGOOOXXXXXXXXXXXXXXXXGOXXXXXXXXXXXXXXXXXXGOOXXXXXXXXXXXXXXXXXGOOXXXXXXXXXXXXXXXXXGOOOOXXXXXXXXXXXXXXXGOOOOOOXXXXXXXXXXXXXGOXXXXXXXXXXXXXXXXXX,0,0,0
7644,50,2,48,77,473,0,0,175,27,148,GOOAAXXXXXXXXXXXXXXXGOXXXXXXXXXXXXXXXXXXGOXXXXXXXXXXXXXXXXXXGOOXXXXXXXXXXXXXXXXXGOOOOOXXXXXXXXXXXXXXGOOOOOXXXXXXXXXXXXXXGOOOXXXXXXXXXXXXXXXXGOXXXXXXXXXXXXXXXXXXGOOXXXXXXXXXXXXXXXXXGOOXXXXXXXXXXXXXXXXXGOOOOXXXXXXXXXXXXXXXGOOOOOOXXXXXXXXXXXXXGOXXXXXXXXXXXXXXXXXX,0,0,0

7665,50,2,48,73,477,0,0,177,35,142,GOOAAXXXXXXXXXXXXXXXGOXXXXXXXXXXXXXXXXXXGOXXXXXXXXXXXXXXXXXXGOOXXXXXXXXXXXXXXXXXGOOOOOXXXXXXXXXXXXXXGOOOOOXXXXXXXXXXXXXXGOOOXXXXXXXXXXXXXXXXGOXXXXXXXXXXXXXXXXXXGOOXXXXXXXXXXXXXXXXXGOOXXXXXXXXXXXXXXXXXGOOOOXXXXXXXXXXXXXXXGOOOOOOXXXXXXXXXXXXXGOXXXXXXXXXXXXXXXXXX,0,0,0
7686,50,2,48,75,475,0,0,175,34,141,GOOAAXXXXXXXXXXXXXXXGOXXXXXXXXXXXXXXXXXXGOXXXXXXXXXXXXXXXXXXGOOXXXXXXXXXXXXXXXXXGOOOOOXXXXXXXXXXXXXXGOOOOOXXXXXXXXXXXXXXGOOOXXXXXXXXXXXXXXXXGOXXXXXXXXXXXXXXXXXXGOOXXXXXXXXXXXXXXXXXGOOXXXXXXXXXXXXXXXXXGOOOOXXXXXXXXXXXXXXXGOOOOOOXXXXXXXXXXXXXGOXXXXXXXXXXXXXXXXXX,0,0,0
7707,50,2,48,75,475,0,0,176,34,142,GOOAAXXXXXXXXXXXXXXXGOXXXXXXXXXXXXXXXXXXGOXXXXXXXXXXXXXXXXXXGOOXXXXXXXXXXXXXXXXXGOOOOOXXXXXXXXXXXXXXGOOOOOXXXXXXXXXXXXXXGOOOXXXXXXXXXXXXXXXXGOXXXXXXXXXXXXXXXXXXGOOXXXXXXXXXXXXXXXXXGOOXXXXXXXXXXXXXXXXXGOOOOXXXXXXXXXXXXXXXGOOOOOOXXXXXXXXXXXXXGOXXXXXXXXXXXXXXXXXX,0,0,0
7728,50,2,48,76,474,0,0,175,32,143,GOOAAXXXXXXXXXXXXXXXGOXXXXXXXXXXXXXXXXXXGOXXXXXXXXXXXXXXXXXXGOOXXXXXXXXXXXXXXXXXGOOOOOXXXXXXXXXXXXXXGOOOOOXXXXXXXXXXXXXXGOOOXXXXXXXXXXXXXXXXGOXXXXXXXXXXXXXXXXXXGOOXXXXXXXXXXXXXXXXXGOOXXXXXXXXXXXXXXXXXGOOOOXXXXXXXXXXXXXXXGOOOOOOXXXXXXXXXXXXXGOXXXXXXXXXXXXXXXXXX,0,0,0
7749,50,1,49,73,477,0,0,176,33,143,GOOOAXXXXXXXXXXXXXXXGOXXXXXXXXXXXXXXXXXXGOXXXXXXXXXXXXXXXXXXGOOXXXXXXXXXXXXXXXXXGOOOOOXXXXXXXXXXXXXXGOOOOOXXXXXXXXXXXXXXGOOOXXXXXXXXXXXXXXXXGOXXXXXXXXXXXXXXXXXXGOOXXXXXXXXXXXXXXXXXGOOXXXXXXXXXXXXXXXXXGOOOOXXXXXXXXXXXXXXXGOOOOOOXXXXXXXXXXXXXGOXXXXXXXXXXXXXXXXXX,0,0,0

7770,50,1,49,75,475,0,0,177,35,142,GOOOAXXXXXXXXXXXXXXXGOXXXXXXXXXXXXXXXXXXGOXXXXXXXXXXXXXXXXXXGOOXXXXXXXXXXXXXXXXXGOOOOOXXXXXXXXXXXXXXGOOOOOXXXXXXXXXXXXXXGOOOXXXXXXXXXXXXXXXXGOXXXXXXXXXXXXXXXXXXGOOXXXXXXXXXXXXXXXXXGOOXXXXXXXXXXXXXXXXXGOOOOXXXXXXXXXXXXXXXGOOOOOOXXXXXXXXXXXXXGOXXXXXXXXXXXXXXXXXX,0,0,0
7791,50,0,50,76,474,0,0,177,32,145,GOOOOXXXXXXXXXXXXXXXGOXXXXXXXXXXXXXXXXXXGOXXXXXXXXXXXXXXXXXXGOOXXXXXXXXXXXXXXXXXGOOOOOXXXXXXXXXXXXXXGOOOOOXXXXXXXXXXXXXXGOOOXXXXXXXXXXXXXXXXGOXXXXXXXXXXXXXXXXXXGOOXXXXXXXXXXXXXXXXXGOOXXXXXXXXXXXXXXXXXGOOOOXXXXXXXXXXXXXXXGOOOOOOXXXXXXXXXXXXXGOXXXXXXXXXXXXXXXXXX,0,0,0
7812,52,2,50,67,481,0,0,183,32,151,GOOOOAXXXXXXXXXXXXXXGOXXXXXXXXXXXXXXXXXXGOXXXXXXXXXXXXXXXXXXGOOXXXXXXXXXXXXXXXXXGOOOOOXXXXXXXXXXXXXXGOOOOOXXXXXXXXXXXXXXGOOOXXXXXXXXXXXXXXXXGOXXXXXXXXXXXXXXXXXXGOOXXXXXXXXXXXXXXXXXGOOXXXXXXXXXXXXXXXXXGOOOOXXXXXXXXXXXXXXXGOOOOOOAXXXXXXXXXXXXGOXXXXXXXXXXXXXXXXXX,0,0,0
7833,52,2,50,64,484,0,0,186,40,146,GOOOOAXXXXXXXXXXXXXXGOXXXXXXXXXXXXXXXXXXGOXXXXXXXXXXXXXXXXXXGOOXXXXXXXXXXXXXXXXXGOOOOOXXXXXXXXXXXXXXGOOOOOXXXXXXXXXXXXXXGOOOXXXXXXXXXXXXXXXXGOXXXXXXXXXXXXXXXXXXGOOXXXXXXXXXXXXXXXXXGOOXXXXXXXXXXXXXXXXXGOOOOXXXXXXXXXXXXXXXGOOOOOOAXXXXXXXXXXXXGOXXXXXXXXXXXXXXXXXX,0,0,0
7854,52,2,50,67,481,0,0,184,39,145,GOOOOAXXXXXXXXXXXXXXGOXXXXXXXXXXXXXXXXXXGOXXXXXXXXXXXXXXXXXXGOOXXXXXXXXXXXXXXXXXGOOOOOXXXXXXXXXXXXXXGOOOOOXXXXXXXXXXXXXXGOOOXXXXXXXXXXXXXXXXGOXXXXXXXXXXXXXXXXXXGOOXXXXXXXXXXXXXXXXXGOOXXXXXXXXXXXXXXXXXGOOOOXXXXXXXXXXXXXXXGOOOOOOAXXXXXXXXXXXXGOXXXXXXXXXXXXXXXXXX,0,0,0

7875,52,2,50,80,468,0,0,171,33,138,GOOOOAXXXXXXXXXXXXXXGOXXXXXXXXXXXXXXXXXXGOXXXXXXXXXXXXXXXXXXGOOXXXXXXXXXXXXXXXXXGOOOOOXXXXXXXXXXXXXXGOOOOOXXXXXXXXXXXXXXGOOOXXXXXXXXXXXXXXXXGOXXXXXXXXXXXXXXXXXXGOOXXXXXXXXXXXXXXXXXGOOXXXXXXXXXXXXXXXXXGOOOOXXXXXXXXXXXXXXXGOOOOOOAXXXXXXXXXXXXGOXXXXXXXXXXXXXXXXXX,0,0,0
7896,52,2,50,75,473,0,0,175,33,142,GOOOOAXXXXXXXXXXXXXXGOXXXXXXXXXXXXXXXXXXGOXXXXXXXXXXXXXXXXXXGOOXXXXXXXXXXXXXXXXXGOOOOOXXXXXXXXXXXXXXGOOOOOXXXXXXXXXXXXXXGOOOXXXXXXXXXXXXXXXXGOXXXXXXXXXXXXXXXXXXGOOXXXXXXXXXXXXXXXXXGOOXXXXXXXXXXXXXXXXXGOOOOXXXXXXXXXXXXXXXGOOOOOOAXXXXXXXXXXXXGOXXXXXXXXXXXXXXXXXX,0,0,0
7917,52,2,50,75,473,0,0,174,35,139,GOOOOAXXXXXXXXXXXXXXGOXXXXXXXXXXXXXXXXXXGOXXXXXXXXXXXXXXXXXXGOOXXXXXXXXXXXXXXXXXGOOOOOXXXXXXXXXXXXXXGOOOOOXXXXXXXXXXXXXXGOOOXXXXXXXXXXXXXXXXGOXXXXXXXXXXXXXXXXXXGOOXXXXXXXXXXXXXXXXXGOOXXXXXXXXXXXXXXXXXGOOOOXXXXXXXXXXXXXXXGOOOOOOAXXXXXXXXXXXXGOXXXXXXXXXXXXXXXXXX,0,0,0
7938,52,1,51,80,468,0,0,170,33,137,GOOOOAXXXXXXXXXXXXXXGOXXXXXXXXXXXXXXXXXXGOXXXXXXXXXXXXXXXXXXGOOXXXXXXXXXXXXXXXXXGOOOOOXXXXXXXXXXXXXXGOOOOOXXXXXXXXXXXXXXGOOOXXXXXXXXXXXXXXXXGOXXXXXXXXXXXXXXXXXXGOOXXXXXXXXXXXXXXXXXGOOXXXXXXXXXXXXXXXXXGOOOOXXXXXXXXXXXXXXXGOOOOOOOXXXXXXXXXXXXGOXXXXXXXXXXXXXXXXXX,0,0,0
7959,52,1,51,77,471,0,0,172,34,138,GOOOOAXXXXXXXXXXXXXXGOXXXXXXXXXXXXXXXXXXGOXXXXXXXXXXXXXXXXXXGOOXXXXXXXXXXXXXXXXXGOOOOOXXXXXXXXXXXXXXGOOOOOXXXXXXXXXXXXXXGOOOXXXXXXXXXXXXXXXXGOXXXXXXXXXXXXXXXXXXGOOXXXXXXXXXXXXXXXXXGOOXXXXXXXXXXXXXXXXXGOOOOXXXXXXXXXXXXXXXGOOOOOOOXXXXXXXXXXXXGOXXXXXXXXXXXXXXXXXX,0,0,0

7980,52,1,51,81,467,0,0,168,32,136,GOOOOAXXXXXXXXXXXXXXGOXXXXXXXXXXXXXXXXXXGOXXXXXXXXXXXXXXXXXXGOOXXXXXXXXXXXXXXXXXGOOOOOXXXXXXXXXXXXXXGOOOOOXXXXXXXXXXXXXXGOOOXXXXXXXXXXXXXXXXGOXXXXXXXXXXXXXXXXXXGOOXXXXXXXXXXXXXXXXXGOOXXXXXXXXXXXXXXXXXGOOOOXXXXXXXXXXXXXXXGOOOOOOOXXXXXXXXXXXXGOXXXXXXXXXXXXXXXXXX,0,0,0
8001,53,2,51,79,468,0,0,169,38,131,GOOOOAXXXXXXXXXXXXXXGOXXXXXXXXXXXXXXXXXXGOXXXXXXXXXXXXXXXXXXGOOXXXXXXXXXXXXXXXXXGOOOOOXXXXXXXXXXXXXXGOOOOOXXXXXXXXXXXXXXGOOOAXXXXXXXXXXXXXXXGOXXXXXXXXXXXXXXXXXXGOOXXXXXXXXXXXXXXXXXGOOXXXXXXXXXXXXXXXXXGOOOOXXXXXXXXXXXXXXXGOOOOOOOXXXXXXXXXXXXGOXXXXXXXXXXXXXXXXXX,0,0,0
8022,53,2,51,83,464,0,0,166,35,131,GOOOOAXXXXXXXXXXXXXXGOXXXXXXXXXXXXXXXXXXGOXXXXXXXXXXXXXXXXXXGOOXXXXXXXXXXXXXXXXXGOOOOOXXXXXXXXXXXXXXGOOOOOXXXXXXXXXXXXXXGOOOAXXXXXXXXXXXXXXXGOXXXXXXXXXXXXXXXXXXGOOXXXXXXXXXXXXXXXXXGOOXXXXXXXXXXXXXXXXXGOOOOXXXXXXXXXXXXXXXGOOOOOOOXXXXXXXXXXXXGOXXXXXXXXXXXXXXXXXX,0,0,0
8043,53,2,51,84,463,0,0,164,37,127,GOOOOAXXXXXXXXXXXXXXGOXXXXXXXXXXXXXXXXXXGOXXXXXXXXXXXXXXXXXXGOOXXXXXXXXXXXXXXXXXGOOOOOXXXXXXXXXXXXXXGOOOOOXXXXXXXXXXXXXXGOOOAXXXXXXXXXXXXXXXGOXXXXXXXXXXXXXXXXXXGOOXXXXXXXXXXXXXXXXXGOOXXXXXXXXXXXXXXXXXGOOOOXXXXXXXXXXXXXXXGOOOOOOOXXXXXXXXXXXXGOXXXXXXXXXXXXXXXXXX,0,0,0
8064,53,2,51,89,458,0,0,160,32,128,GOOOOAXXXXXXXXXXXXXXGOXXXXXXXXXXXXXXXXXXGOXXXXXXXXXXXXXXXXXXGOOXXXXXXXXXXXXXXXXXGOOOOOXXXXXXXXXXXXXXGOOOOOXXXXXXXXXXXXXXGOOOAXXXXXXXXXXXXXXXGOXXXXXXXXXXXXXXXXXXGOOXXXXXXXXXXXXXXXXXGOOXXXXXXXXXXXXXXXXXGOOOOXXXXXXXXXXXXXXXGOOOOOOOXXXXXXXXXXXXGOXXXXXXXXXXXXXXXXXX,0,0,0

8085,53,2,51,81,466,0,0,167,35,132,GOOOOAXXXXXXXXXXXXXXGOXXXXXXXXXXXXXXXXXXGOXXXXXXXXXXXXXXXXXXGOOXXXXXXXXXXXXXXXXXGOOOOOXXXXXXXXXXXXXXGOOOOOXXXXXXXXXXXXXXGOOOAXXXXXXXXXXXXXXXGOXXXXXXXXXXXXXXXXXXGOOXXXXXXXXXXXXXXXXXGOOXXXXXXXXXXXXXXXXXGOOOOXXXXXXXXXXXXXXXGOOOOOOOXXXXXXXXXXXXGOXXXXXXXXXXXXXXXXXX,0,0,0
8106,53,2,51,85,462,0,0,164,33,131,GOOOOAXXXXXXXXXXXXXXGOXXXXXXXXXXXXXXXXXXGOXXXXXXXXXXXXXXXXXXGOOXXXXXXXXXXXXXXXXXGOOOOOXXXXXXXXXXXXXXGOOOOOXXXXXXXXXXXXXXGOOOAXXXXXXXXXXXXXXXGOXXXXXXXXXXXXXXXXXXGOOXXXXXXXXXXXXXXXXXGOOXXXXXXXXXXXXXXXXXGOOOOXXXXXXXXXXXXXXXGOOOOOOOXXXXXXXXXXXXGOXXXXXXXXXXXXXXXXXX,0,0,0
8127,53,1,52,82,465,0,0,167,34,133,GOOOOOXXXXXXXXXXXXXXGOXXXXXXXXXXXXXXXXXXGOXXXXXXXXXXXXXXXXXXGOOXXXXXXXXXXXXXXXXXGOOOOOXXXXXXXXXXXXXXGOOOOOXXXXXXXXXXXXXXGOOOAXXXXXXXXXXXXXXXGOXXXXXXXXXXXXXXXXXXGOOXXXXXXXXXXXXXXXXXGOOXXXXXXXXXXXXXXXXXGOOOOXXXXXXXXXXXXXXXGOOOOOOOXXXXXXXXXXXXGOXXXXXXXXXXXXXXXXXX,0,0,0
8148,53,1,52,85,462,0,0,164,35,129,GOOOOOXXXXXXXXXXXXXXGOXXXXXXXXXXXXXXXXXXGOXXXXXXXXXXXXXXXXXXGOOXXXXXXXXXXXXXXXXXGOOOOOXXXXXXXXXXXXXXGOOOOOXXXXXXXXXXXXXXGOOOAXXXXXXXXXXXXXXXGOXXXXXXXXXXXXXXXXXXGOOXXXXXXXXXXXXXXXXXGOOXXXXXXXXXXXXXXXXXGOOOOXXXXXXXXXXXXXXXGOOOOOOOXXXXXXXXXXXXGOXXXXXXXXXXXXXXXXXX,0,0,0
8169,53,1,52,87,460,0,0,163,40,123,GOOOOOXXXXXXXXXXXXXXGOXXXXXXXXXXXXXXXXXXGOXXXXXXXXXXXXXXXXXXGOOXXXXXXXXXXXXXXXXXGOOOOOXXXXXXXXXXXXXXGOOOOOXXXXXXXXXXXXXXGOOOAXXXXXXXXXXXXXXXGOXXXXXXXXXXXXXXXXXXGOOXXXXXXXXXXXXXXXXXGOOXXXXXXXXXXXXXXXXXGOOOOXXXXXXXXXXXXXXXGOOOOOOOXXXXXXXXXXXXGOXXXXXXXXXXXXXXXXXX,0,0,0

8190,53,1,52,84,463,0,0,164,36,128,GOOOOOXXXXXXXXXXXXXXGOXXXXXXXXXXXXXXXXXXGOXXXXXXXXXXXXXXXXXXGOOXXXXXXXXXXXXXXXXXGOOOOOXXXXXXXXXXXXXXGOOOOOXXXXXXXXXXXXXXGOOOAXXXXXXXXXXXXXXXGOXXXXXXXXXXXXXXXXXXGOOXXXXXXXXXXXXXXXXXGOOXXXXXXXXXXXXXXXXXGOOOOXXXXXXXXXXXXXXXGOOOOOOOXXXXXXXXXXXXGOXXXXXXXXXXXXXXXXXX,0,0,0
8211,53,1,52,86,461,0,0,162,33,129,GOOOOOXXXXXXXXXXXXXXGOXXXXXXXXXXXXXXXXXXGOXXXXXXXXXXXXXXXXXXGOOXXXXXXXXXXXXXXXXXGOOOOOXXXXXXXXXXXXXXGOOOOOXXXXXXXXXXXXXXGOOOAXXXXXXXXXXXXXXXGOXXXXXXXXXXXXXXXXXXGOOXXXXXXXXXXXXXXXXXGOOXXXXXXXXXXXXXXXXXGOOOOXXXXXXXXXXXXXXXGOOOOOOOXXXXXXXXXXXXGOXXXXXXXXXXXXXXXXXX,0,0,0
8232,53,0,53,85,462,0,0,165,31,134,GOOOOOXXXXXXXXXXXXXXGOXXXXXXXXXXXXXXXXXXGOXXXXXXXXXXXXXXXXXXGOOXXXXXXXXXXXXXXXXXGOOOOOXXXXXXXXXXXXXXGOOOOOXXXXXXXXXXXXXXGOOOOXXXXXXXXXXXXXXXGOXXXXXXXXXXXXXXXXXXGOOXXXXXXXXXXXXXXXXXGOOXXXXXXXXXXXXXXXXXGOOOOXXXXXXXXXXXXXXXGOOOOOOOXXXXXXXXXXXXGOXXXXXXXXXXXXXXXXXX,0,0,0
8253,53,0,53,79,468,0,0,170,37,133,GOOOOOXXXXXXXXXXXXXXGOXXXXXXXXXXXXXXXXXXGOXXXXXXXXXXXXXXXXXXGOOXXXXXXXXXXXXXXXXXGOOOOOXXXXXXXXXXXXXXGOOOOOXXXXXXXXXXXXXXGOOOOXXXXXXXXXXXXXXXGOXXXXXXXXXXXXXXXXXXGOOXXXXXXXXXXXXXXXXXGOOXXXXXXXXXXXXXXXXXGOOOOXXXXXXXXXXXXXXXGOOOOOOOXXXXXXXXXXXXGOXXXXXXXXXXXXXXXXXX,0,0,0
8274,53,0,53,78,469,0,0,171,34,137,GOOOOOXXXXXXXXXXXXXXGOXXXXXXXXXXXXXXXXXXGOXXXXXXXXXXXXXXXXXXGOOXXXXXXXXXXXXXXXXXGOOOOOXXXXXXXXXXXXXXGOOOOOXXXXXXXXXXXXXXGOOOOXXXXXXXXXXXXXXXGOXXXXXXXXXXXXXXXXXXGOOXXXXXXXXXXXXXXXXXGOOXXXXXXXXXXXXXXXXXGOOOOXXXXXXXXXXXXXXXGOOOOOOOXXXXXXXXXXXXGOXXXXXXXXXXXXXXXXXX,0,0,0

8295,53,0,53,78,469,0,0,170,31,139,GOOOOOXXXXXXXXXXXXXXGOXXXXXXXXXXXXXXXXXXGOXXXXXXXXXXXXXXXXXXGOOXXXXXXXXXXXXXXXXXGOOOOOXXXXXXXXXXXXXXGOOOOOXXXXXXXXXXXXXXGOOOOXXXXXXXXXXXXXXXGOXXXXXXXXXXXXXXXXXXGOOXXXXXXXXXXXXXXXXXGOOXXXXXXXXXXXXXXXXXGOOOOXXXXXXXXXXXXXXXGOOOOOOOXXXXXXXXXXXXGOXXXXXXXXXXXXXXXXXX,0,0,0
8316,53,0,53,74,473,0,0,175,38,137,GOOOOOXXXXXXXXXXXXXXGOXXXXXXXXXXXXXXXXXXGOXXXXXXXXXXXXXXXXXXGOOXXXXXXXXXXXXXXXXXGOOOOOXXXXXXXXXXXXXXGOOOOOXXXXXXXXXXXXXXGOOOOXXXXXXXXXXXXXXXGOXXXXXXXXXXXXXXXXXXGOOXXXXXXXXXXXXXXXXXGOOXXXXXXXXXXXXXXXXXGOOOOXXXXXXXXXXXXXXXGOOOOOOOXXXXXXXXXXXXGOXXXXXXXXXXXXXXXXXX,0,0,0
8337,53,0,53,76,471,0,0,174,36,138,GOOOOOXXXXXXXXXXXXXXGOXXXXXXXXXXXXXXXXXXGOXXXXXXXXXXXXXXXXXXGOOXXXXXXXXXXXXXXXXXGOOOOOXXXXXXXXXXXXXXGOOOOOXXXXXXXXXXXXXXGOOOOXXXXXXXXXXXXXXXGOXXXXXXXXXXXXXXXXXXGOOXXXXXXXXXXXXXXXXXGOOXXXXXXXXXXXXXXXXXGOOOOXXXXXXXXXXXXXXXGOOOOOOOXXXXXXXXXXXXGOXXXXXXXXXXXXXXXXXX,0,0,0
8358,53,0,53,75,472,0,0,174,35,139,GOOOOOXXXXXXXXXXXXXXGOXXXXXXXXXXXXXXXXXXGOXXXXXXXXXXXXXXXXXXGOOXXXXXXXXXXXXXXXXXGOOOOOXXXXXXXXXXXXXXGOOOOOXXXXXXXXXXXXXXGOOOOXXXXXXXXXXXXXXXGOXXXXXXXXXXXXXXXXXXGOOXXXXXXXXXXXXXXXXXGOOXXXXXXXXXXXXXXXXXGOOOOXXXXXXXXXXXXXXXGOOOOOOOXXXXXXXXXXXXGOXXXXXXXXXXXXXXXXXX,0,0,0
8379,53,0,53,70,477,0,0,179,33,146,GOOOOOXXXXXXXXXXXXXXGOXXXXXXXXXXXXXXXXXXGOXXXXXXXXXXXXXXXXXXGOOXXXXXXXXXXXXXXXXXGOOOOOXXXXXXXXXXXXXXGOOOOOXXXXXXXXXXXXXXGOOOOXXXXXXXXXXXXXXXGOXXXXXXXXXXXXXXXXXXGOOXXXXXXXXXXXXXXXXXGOOXXXXXXXXXXXXXXXXXGOOOOXXXXXXXXXXXXXXXGOOOOOOOXXXXXXXXXXXXGOXXXXXXXXXXXXXXXXXX,0,0,0

8400,53,0,53,70,477,0,0,181,40,141,GOOOOOXXXXXXXXXXXXXXGOXXXXXXXXXXXXXXXXXXGOXXXXXXXXXXXXXXXXXXGOOXXXXXXXXXXXXXXXXXGOOOOOXXXXXXXXXXXXXXGOOOOOXXXXXXXXXXXXXXGOOOOXXXXXXXXXXXXXXXGOXXXXXXXXXXXXXXXXXXGOOXXXXXXXXXXXXXXXXXGOOXXXXXXXXXXXXXXXXXGOOOOXXXXXXXXXXXXXXXGOOOOOOOXXXXXXXXXXXXGOXXXXXXXXXXXXXXXXXX,0,0,0
8421,53,0,53,72,475,0,0,180,41,139,GOOOOOXXXXXXXXXXXXXXGOXXXXXXXXXXXXXXXXXXGOXXXXXXXXXXXXXXXXXXGOOXXXXXXXXXXXXXXXXXGOOOOOXXXXXXXXXXXXXXGOOOOOXXXXXXXXXXXXXXGOOOOXXXXXXXXXXXXXXXGOXXXXXXXXXXXXXXXXXXGOOXXXXXXXXXXXXXXXXXGOOXXXXXXXXXXXXXXXXXGOOOOXXXXXXXXXXXXXXXGOOOOOOOXXXXXXXXXXXXGOXXXXXXXXXXXXXXXXXX,0,0,0
8442,53,0,53,73,474,0,0,179,36,143,GOOOOOXXXXXXXXXXXXXXGOXXXXXXXXXXXXXXXXXXGOXXXXXXXXXXXXXXXXXXGOOXXXXXXXXXXXXXXXXXGOOOOOXXXXXXXXXXXXXXGOOOOOXXXXXXXXXXXXXXGOOOOXXXXXXXXXXXXXXXGOXXXXXXXXXXXXXXXXXXGOOXXXXXXXXXXXXXXXXXGOOXXXXXXXXXXXXXXXXXGOOOOXXXXXXXXXXXXXXXGOOOOOOOXXXXXXXXXXXXGOXXXXXXXXXXXXXXXXXX,0,0,0
8463,53,0,53,72,475,0,0,178,37,141,GOOOOOXXXXXXXXXXXXXXGOXXXXXXXXXXXXXXXXXXGOXXXXXXXXXXXXXXXXXXGOOXXXXXXXXXXXXXXXXXGOOOOOXXXXXXXXXXXXXXGOOOOOXXXXXXXXXXXXXXGOOOOXXXXXXXXXXXXXXXGOXXXXXXXXXXXXXXXXXXGOOXXXXXXXXXXXXXXXXXGOOXXXXXXXXXXXXXXXXXGOOOOXXXXXXXXXXXXXXXGOOOOOOOXXXXXXXXXXXXGOXXXXXXXXXXXXXXXXXX,0,0,0
8484,53,0,53,80,467,0,0,171,34,137,GOOOOOXXXXXXXXXXXXXXGOXXXXXXXXXXXXXXXXXXGOXXXXXXXXXXXXXXXXXXGOOXXXXXXXXXXXXXXXXXGOOOOOXXXXXXXXXXXXXXGOOOOOXXXXXXXXXXXXXXGOOOOXXXXXXXXXXXXXXXGOXXXXXXXXXXXXXXXXXXGOOXXXXXXXXXXXXXXXXXGOOXXXXXXXXXXXXXXXXXGOOOOXXXXXXXXXXXXXXXGOOOOOOOXXXXXXXXXXXXGOXXXXXXXXXXXXXXXXXX,0,0,0

8505,53,0,53,68,479,0,0,183,40,143,GOOOOOXXXXXXXXXXXXXXGOXXXXXXXXXXXXXXXXXXGOXXXXXXXXXXXXXXXXXXGOOXXXXXXXXXXXXXXXXXGOOOOOXXXXXXXXXXXXXXGOOOOOXXXXXXXXXXXXXXGOOOOXXXXXXXXXXXXXXXGOXXXXXXXXXXXXXXXXXXGOOXXXXXXXXXXXXXXXXXGOOXXXXXXXXXXXXXXXXXGOOOOXXXXXXXXXXXXXXXGOOOOOOOXXXXXXXXXXXXGOXXXXXXXXXXXXXXXXXX,0,0,0
8526,53,0,53,73,474,0,0,178,37,141,GOOOOOXXXXXXXXXXXXXXGOXXXXXXXXXXXXXXXXXXGOXXXXXXXXXXXXXXXXXXGOOXXXXXXXXXXXXXXXXXGOOOOOXXXXXXXXXXXXXXGOOOOOXXXXXXXXXXXXXXGOOOOXXXXXXXXXXXXXXXGOXXXXXXXXXXXXXXXXXXGOOXXXXXXXXXXXXXXXXXGOOXXXXXXXXXXXXXXXXXGOOOOXXXXXXXXXXXXXXXGOOOOOOOXXXXXXXXXXXXGOXXXXXXXXXXXXXXXXXX,0,0,0
8547,53,0,53,72,475,0,0,178,37,141,GOOOOOXXXXXXXXXXXXXXGOXXXXXXXXXXXXXXXXXXGOXXXXXXXXXXXXXXXXXXGOOXXXXXXXXXXXXXXXXXGOOOOOXXXXXXXXXXXXXXGOOOOOXXXXXXXXXXXXXXGOOOOXXXXXXXXXXXXXXXGOXXXXXXXXXXXXXXXXXXGOOXXXXXXXXXXXXXXXXXGOOXXXXXXXXXXXXXXXXXGOOOOXXXXXXXXXXXXXXXGOOOOOOOXXXXXXXXXXXXGOXXXXXXXXXXXXXXXXXX,0,0,0
8568,53,0,53,74,473,0,0,177,36,141,GOOOOOXXXXXXXXXXXXXXGOXXXXXXXXXXXXXXXXXXGOXXXXXXXXXXXXXXXXXXGOOXXXXXXXXXXXXXXXXXGOOOOOXXXXXXXXXXXXXXGOOOOOXXXXXXXXXXXXXXGOOOOXXXXXXXXXXXXXXXGOXXXXXXXXXXXXXXXXXXGOOXXXXXXXXXXXXXXXXXGOOXXXXXXXXXXXXXXXXXGOOOOXXXXXXXXXXXXXXXGOOOOOOOXXXXXXXXXXXXGOXXXXXXXXXXXXXXXXXX,0,0,0
8589,53,0,53,74,473,0,0,177,36,141,GOOOOOXXXXXXXXXXXXXXGOXXXXXXXXXXXXXXXXXXGOXXXXXXXXXXXXXXXXXXGOOXXXXXXXXXXXXXXXXXGOOOOOXXXXXXXXXXXXXXGOOOOOXXXXXXXXXXXXXXGOOOOXXXXXXXXXXXXXXXGOXXXXXXXXXXXXXXXXXXGOOXXXXXXXXXXXXXXXXXGOOXXXXXXXXXXXXXXXXXGOOOOXXXXXXXXXXXXXXXGOOOOOOOXXXXXXXXXXXXGOXXXXXXXXXXXXXXXXXX,0,0,0

8610,53,0,53,75,472,0,0,176,39,137,GOOOOOXXXXXXXXXXXXXXGOXXXXXXXXXXXXXXXXXXGOXXXXXXXXXXXXXXXXXXGOOXXXXXXXXXXXXXXXXXGOOOOOXXXXXXXXXXXXXXGOOOOOXXXXXXXXXXXXXXGOOOOXXXXXXXXXXXXXXXGOXXXXXXXXXXXXXXXXXXGOOXXXXXXXXXXXXXXXXXGOOXXXXXXXXXXXXXXXXXGOOOOXXXXXXXXXXXXXXXGOOOOOOOXXXXXXXXXXXXGOXXXXXXXXXXXXXXXXXX,0,0,0
8631,54,1,53,79,467,0,0,171,32,139,GOOOOOXXXXXXXXXXXXXXGOAXXXXXXXXXXXXXXXXXGOXXXXXXXXXXXXXXXXXXGOOXXXXXXXXXXXXXXXXXGOOOOOXXXXXXXXXXXXXXGOOOOOXXXXXXXXXXXXXXGOOOOXXXXXXXXXXXXXXXGOXXXXXXXXXXXXXXXXXXGOOXXXXXXXXXXXXXXXXXGOOXXXXXXXXXXXXXXXXXGOOOOXXXXXXXXXXXXXXXGOOOOOOOXXXXXXXXXXXXGOXXXXXXXXXXXXXXXXXX,0,0,0
8652,54,1,53,82,464,0,0,168,35,133,GOOOOOXXXXXXXXXXXXXXGOAXXXXXXXXXXXXXXXXXGOXXXXXXXXXXXXXXXXXXGOOXXXXXXXXXXXXXXXXXGOOOOOXXXXXXXXXXXXXXGOOOOOXXXXXXXXXXXXXXGOOOOXXXXXXXXXXXXXXXGOXXXXXXXXXXXXXXXXXXGOOXXXXXXXXXXXXXXXXXGOOXXXXXXXXXXXXXXXXXGOOOOXXXXXXXXXXXXXXXGOOOOOOOXXXXXXXXXXXXGOXXXXXXXXXXXXXXXXXX,0,0,0
8673,54,1,53,80,466,0,0,169,41,128,GOOOOOXXXXXXXXXXXXXXGOAXXXXXXXXXXXXXXXXXGOXXXXXXXXXXXXXXXXXXGOOXXXXXXXXXXXXXXXXXGOOOOOXXXXXXXXXXXXXXGOOOOOXXXXXXXXXXXXXXGOOOOXXXXXXXXXXXXXXXGOXXXXXXXXXXXXXXXXXXGOOXXXXXXXXXXXXXXXXXGOOXXXXXXXXXXXXXXXXXGOOOOXXXXXXXXXXXXXXXGOOOOOOOXXXXXXXXXXXXGOXXXXXXXXXXXXXXXXXX,0,0,0
8694,54,1,53,86,460,0,0,163,43,120,GOOOOOXXXXXXXXXXXXXXGOAXXXXXXXXXXXXXXXXXGOXXXXXXXXXXXXXXXXXXGOOXXXXXXXXXXXXXXXXXGOOOOOXXXXXXXXXXXXXXGOOOOOXXXXXXXXXXXXXXGOOOOXXXXXXXXXXXXXXXGOXXXXXXXXXXXXXXXXXXGOOXXXXXXXXXXXXXXXXXGOOXXXXXXXXXXXXXXXXXGOOOOXXXXXXXXXXXXXXXGOOOOOOOXXXXXXXXXXXXGOXXXXXXXXXXXXXXXXXX,0,0,0

8715,54,1,53,90,456,0,0,158,36,122,GOOOOOXXXXXXXXXXXXXXGOAXXXXXXXXXXXXXXXXXGOXXXXXXXXXXXXXXXXXXGOOXXXXXXXXXXXXXXXXXGOOOOOXXXXXXXXXXXXXXGOOOOOXXXXXXXXXXXXXXGOOOOXXXXXXXXXXXXXXXGOXXXXXXXXXXXXXXXXXXGOOXXXXXXXXXXXXXXXXXGOOXXXXXXXXXXXXXXXXXGOOOOXXXXXXXXXXXXXXXGOOOOOOOXXXXXXXXXXXXGOXXXXXXXXXXXXXXXXXX,0,0,0
8736,54,1,53,94,452,0,0,155,37,118,GOOOOOXXXXXXXXXXXXXXGOAXXXXXXXXXXXXXXXXXGOXXXXXXXXXXXXXXXXXXGOOXXXXXXXXXXXXXXXXXGOOOOOXXXXXXXXXXXXXXGOOOOOXXXXXXXXXXXXXXGOOOOXXXXXXXXXXXXXXXGOXXXXXXXXXXXXXXXXXXGOOXXXXXXXXXXXXXXXXXGOOXXXXXXXXXXXXXXXXXGOOOOXXXXXXXXXXXXXXXGOOOOOOOXXXXXXXXXXXXGOXXXXXXXXXXXXXXXXXX,0,0,0
8757,54,1,53,93,453,0,0,156,34,122,GOOOOOXXXXXXXXXXXXXXGOAXXXXXXXXXXXXXXXXXGOXXXXXXXXXXXXXXXXXXGOOXXXXXXXXXXXXXXXXXGOOOOOXXXXXXXXXXXXXXGOOOOOXXXXXXXXXXXXXXGOOOOXXXXXXXXXXXXXXXGOXXXXXXXXXXXXXXXXXXGOOXXXXXXXXXXXXXXXXXGOOXXXXXXXXXXXXXXXXXGOOOOXXXXXXXXXXXXXXXGOOOOOOOXXXXXXXXXXXXGOXXXXXXXXXXXXXXXXXX,0,0,0
8778,55,2,53,91,454,0,0,157,34,123,GOOOOOXXXXXXXXXXXXXXGOAXXXXXXXXXXXXXXXXXGOXXXXXXXXXXXXXXXXXXGOOXXXXXXXXXXXXXXXXXGOOOOOXXXXXXXXXXXXXXGOOOOOXXXXXXXXXXXXXXGOOOOXXXXXXXXXXXXXXXGOAXXXXXXXXXXXXXXXXXGOOXXXXXXXXXXXXXXXXXGOOXXXXXXXXXXXXXXXXXGOOOOXXXXXXXXXXXXXXXGOOOOOOOXXXXXXXXXXXXGOXXXXXXXXXXXXXXXXXX,0,0,0
8799,55,2,53,88,457,0,0,160,34,126,GOOOOOXXXXXXXXXXXXXXGOAXXXXXXXXXXXXXXXXXGOXXXXXXXXXXXXXXXXXXGOOXXXXXXXXXXXXXXXXXGOOOOOXXXXXXXXXXXXXXGOOOOOXXXXXXXXXXXXXXGOOOOXXXXXXXXXXXXXXXGOAXXXXXXXXXXXXXXXXXGOOXXXXXXXXXXXXXXXXXGOOXXXXXXXXXXXXXXXXXGOOOOXXXXXXXXXXXXXXXGOOOOOOOXXXXXXXXXXXXGOXXXXXXXXXXXXXXXXXX,0,0,0

8820,55,2,53,83,462,0,0,165,38,127,GOOOOOXXXXXXXXXXXXXXGOAXXXXXXXXXXXXXXXXXGOXXXXXXXXXXXXXXXXXXGOOXXXXXXXXXXXXXXXXXGOOOOOXXXXXXXXXXXXXXGOOOOOXXXXXXXXXXXXXXGOOOOXXXXXXXXXXXXXXXGOAXXXXXXXXXXXXXXXXXGOOXXXXXXXXXXXXXXXXXGOOXXXXXXXXXXXXXXXXXGOOOOXXXXXXXXXXXXXXXGOOOOOOOXXXXXXXXXXXXGOXXXXXXXXXXXXXXXXXX,0,0,0
8841,56,2,54,73,471,0,0,174,38,136,GOOOOOXXXXXXXXXXXXXXGOOXXXXXXXXXXXXXXXXXGOAXXXXXXXXXXXXXXXXXGOOXXXXXXXXXXXXXXXXXGOOOOOXXXXXXXXXXXXXXGOOOOOXXXXXXXXXXXXXXGOOOOXXXXXXXXXXXXXXXGOAXXXXXXXXXXXXXXXXXGOOXXXXXXXXXXXXXXXXXGOOXXXXXXXXXXXXXXXXXGOOOOXXXXXXXXXXXXXXXGOOOOOOOXXXXXXXXXXXXGOXXXXXXXXXXXXXXXXXX,0,0,0
8862,56,1,55,76,468,0,0,169,34,135,GOOOOOXXXXXXXXXXXXXXGOOXXXXXXXXXXXXXXXXXGOAXXXXXXXXXXXXXXXXXGOOXXXXXXXXXXXXXXXXXGOOOOOXXXXXXXXXXXXXXGOOOOOXXXXXXXXXXXXXXGOOOOXXXXXXXXXXXXXXXGOOXXXXXXXXXXXXXXXXXGOOXXXXXXXXXXXXXXXXXGOOXXXXXXXXXXXXXXXXXGOOOOXXXXXXXXXXXXXXXGOOOOOOOXXXXXXXXXXXXGOXXXXXXXXXXXXXXXXXX,0,0,0
8883,56,0,56,75,469,0,0,171,35,136,GOOOOOXXXXXXXXXXXXXXGOOXXXXXXXXXXXXXXXXXGOOXXXXXXXXXXXXXXXXXGOOXXXXXXXXXXXXXXXXXGOOOOOXXXXXXXXXXXXXXGOOOOOXXXXXXXXXXXXXXGOOOOXXXXXXXXXXXXXXXGOOXXXXXXXXXXXXXXXXXGOOXXXXXXXXXXXXXXXXXGOOXXXXXXXXXXXXXXXXXGOOOOXXXXXXXXXXXXXXXGOOOOOOOXXXXXXXXXXXXGOXXXXXXXXXXXXXXXXXX,0,0,0
8904,56,0,56,76,468,0,0,167,32,135,GOOOOOXXXXXXXXXXXXXXGOOXXXXXXXXXXXXXXXXXGOOXXXXXXXXXXXXXXXXXGOOXXXXXXXXXXXXXXXXXGOOOOOXXXXXXXXXXXXXXGOOOOOXXXXXXXXXXXXXXGOOOOXXXXXXXXXXXXXXXGOOXXXXXXXXXXXXXXXXXGOOXXXXXXXXXXXXXXXXXGOOXXXXXXXXXXXXXXXXXGOOOOXXXXXXXXXXXXXXXGOOOOOOOXXXXXXXXXXXXGOXXXXXXXXXXXXXXXXXX,0,0,0

8925,56,0,56,70,474,0,0,175,34,141,GOOOOOXXXXXXXXXXXXXXGOOXXXXXXXXXXXXXXXXXGOOXXXXXXXXXXXXXXXXXGOOXXXXXXXXXXXXXXXXXGOOOOOXXXXXXXXXXXXXXGOOOOOXXXXXXXXXXXXXXGOOOOXXXXXXXXXXXXXXXGOOXXXXXXXXXXXXXXXXXGOOXXXXXXXXXXXXXXXXXGOOXXXXXXXXXXXXXXXXXGOOOOXXXXXXXXXXXXXXXGOOOOOOOXXXXXXXXXXXXGOXXXXXXXXXXXXXXXXXX,0,0,0
8946,56,0,56,67,477,0,0,178,36,142,GOOOOOXXXXXXXXXXXXXXGOOXXXXXXXXXXXXXXXXXGOOXXXXXXXXXXXXXXXXXGOOXXXXXXXXXXXXXXXXXGOOOOOXXXXXXXXXXXXXXGOOOOOXXXXXXXXXXXXXXGOOOOXXXXXXXXXXXXXXXGOOXXXXXXXXXXXXXXXXXGOOXXXXXXXXXXXXXXXXXGOOXXXXXXXXXXXXXXXXXGOOOOXXXXXXXXXXXXXXXGOOOOOOOXXXXXXXXXXXXGOXXXXXXXXXXXXXXXXXX,0,0,0
8967,56,0,56,68,476,0,0,177,36,141,GOOOOOXXXXXXXXXXXXXXGOOXXXXXXXXXXXXXXXXXGOOXXXXXXXXXXXXXXXXXGOOXXXXXXXXXXXXXXXXXGOOOOOXXXXXXXXXXXXXXGOOOOOXXXXXXXXXXXXXXGOOOOXXXXXXXXXXXXXXXGOOXXXXXXXXXXXXXXXXXGOOXXXXXXXXXXXXXXXXXGOOXXXXXXXXXXXXXXXXXGOOOOXXXXXXXXXXXXXXXGOOOOOOOXXXXXXXXXXXXGOXXXXXXXXXXXXXXXXXX,0,0,0
8988,56,0,56,66,478,0,0,179,39,140,GOOOOOXXXXXXXXXXXXXXGOOXXXXXXXXXXXXXXXXXGOOXXXXXXXXXXXXXXXXXGOOXXXXXXXXXXXXXXXXXGOOOOOXXXXXXXXXXXXXXGOOOOOXXXXXXXXXXXXXXGOOOOXXXXXXXXXXXXXXXGOOXXXXXXXXXXXXXXXXXGOOXXXXXXXXXXXXXXXXXGOOXXXXXXXXXXXXXXXXXGOOOOXXXXXXXXXXXXXXXGOOOOOOOXXXXXXXXXXXXGOXXXXXXXXXXXXXXXXXX,0,0,0
9009,56,0,56,67,477,0,0,178,34,144,GOOOOOXXXXXXXXXXXXXXGOOXXXXXXXXXXXXXXXXXGOOXXXXXXXXXXXXXXXXXGOOXXXXXXXXXXXXXXXXXGOOOOOXXXXXXXXXXXXXXGOOOOOXXXXXXXXXXXXXXGOOOOXXXXXXXXXXXXXXXGOOXXXXXXXXXXXXXXXXXGOOXXXXXXXXXXXXXXXXXGOOXXXXXXXXXXXXXXXXXGOOOOXXXXXXXXXXXXXXXGOOOOOOOXXXXXXXXXXXXGOXXXXXXXXXXXXXXXXXX,0,0,0

9030,56,0,56,67,477,0,0,179,37,142,GOOOOOXXXXXXXXXXXXXXGOOXXXXXXXXXXXXXXXXXGOOXXXXXXXXXXXXXXXXXGOOXXXXXXXXXXXXXXXXXGOOOOOXXXXXXXXXXXXXXGOOOOOXXXXXXXXXXXXXXGOOOOXXXXXXXXXXXXXXXGOOXXXXXXXXXXXXXXXXXGOOXXXXXXXXXXXXXXXXXGOOXXXXXXXXXXXXXXXXXGOOOOXXXXXXXXXXXXXXXGOOOOOOOXXXXXXXXXXXXGOXXXXXXXXXXXXXXXXXX,0,0,0
9051,56,0,56,69,475,0,0,177,37,140,GOOOOOXXXXXXXXXXXXXXGOOXXXXXXXXXXXXXXXXXGOOXXXXXXXXXXXXXXXXXGOOXXXXXXXXXXXXXXXXXGOOOOOXXXXXXXXXXXXXXGOOOOOXXXXXXXXXXXXXXGOOOOXXXXXXXXXXXXXXXGOOXXXXXXXXXXXXXXXXXGOOXXXXXXXXXXXXXXXXXGOOXXXXXXXXXXXXXXXXXGOOOOXXXXXXXXXXXXXXXGOOOOOOOXXXXXXXXXXXXGOXXXXXXXXXXXXXXXXXX,0,0,0
9072,56,0,56,73,471,0,0,173,36,137,GOOOOOXXXXXXXXXXXXXXGOOXXXXXXXXXXXXXXXXXGOOXXXXXXXXXXXXXXXXXGOOXXXXXXXXXXXXXXXXXGOOOOOXXXXXXXXXXXXXXGOOOOOXXXXXXXXXXXXXXGOOOOXXXXXXXXXXXXXXXGOOXXXXXXXXXXXXXXXXXGOOXXXXXXXXXXXXXXXXXGOOXXXXXXXXXXXXXXXXXGOOOOXXXXXXXXXXXXXXXGOOOOOOOXXXXXXXXXXXXGOXXXXXXXXXXXXXXXXXX,0,0,0
9093,56,0,56,78,466,0,0,168,35,133,GOOOOOXXXXXXXXXXXXXXGOOXXXXXXXXXXXXXXXXXGOOXXXXXXXXXXXXXXXXXGOOXXXXXXXXXXXXXXXXXGOOOOOXXXXXXXXXXXXXXGOOOOOXXXXXXXXXXXXXXGOOOOXXXXXXXXXXXXXXXGOOXXXXXXXXXXXXXXXXXGOOXXXXXXXXXXXXXXXXXGOOXXXXXXXXXXXXXXXXXGOOOOXXXXXXXXXXXXXXXGOOOOOOOXXXXXXXXXXXXGOXXXXXXXXXXXXXXXXXX,0,0,0
9114,56,0,56,79,465,0,0,167,32,135,GOOOOOXXXXXXXXXXXXXXGOOXXXXXXXXXXXXXXXXXGOOXXXXXXXXXXXXXXXXXGOOXXXXXXXXXXXXXXXXXGOOOOOXXXXXXXXXXXXXXGOOOOOXXXXXXXXXXXXXXGOOOOXXXXXXXXXXXXXXXGOOXXXXXXXXXXXXXXXXXGOOXXXXXXXXXXXXXXXXXGOOXXXXXXXXXXXXXXXXXGOOOOXXXXXXXXXXXXXXXGOOOOOOOXXXXXXXXXXXXGOXXXXXXXXXXXXXXXXXX,0,0,0

9135,56,0,56,73,471,0,0,173,36,137,GOOOOOXXXXXXXXXXXXXXGOOXXXXXXXXXXXXXXXXXGOOXXXXXXXXXXXXXXXXXGOOXXXXXXXXXXXXXXXXXGOOOOOXXXXXXXXXXXXXXGOOOOOXXXXXXXXXXXXXXGOOOOXXXXXXXXXXXXXXXGOOXXXXXXXXXXXXXXXXXGOOXXXXXXXXXXXXXXXXXGOOXXXXXXXXXXXXXXXXXGOOOOXXXXXXXXXXXXXXXGOOOOOOOXXXXXXXXXXXXGOXXXXXXXXXXXXXXXXXX,0,0,0
9156,56,0,56,67,477,0,0,179,43,136,GOOOOOXXXXXXXXXXXXXXGOOXXXXXXXXXXXXXXXXXGOOXXXXXXXXXXXXXXXXXGOOXXXXXXXXXXXXXXXXXGOOOOOXXXXXXXXXXXXXXGOOOOOXXXXXXXXXXXXXXGOOOOXXXXXXXXXXXXXXXGOOXXXXXXXXXXXXXXXXXGOOXXXXXXXXXXXXXXXXXGOOXXXXXXXXXXXXXXXXXGOOOOXXXXXXXXXXXXXXXGOOOOOOOXXXXXXXXXXXXGOXXXXXXXXXXXXXXXXXX,0,0,0
9177,56,0,56,62,482,0,0,183,40,143,GOOOOOXXXXXXXXXXXXXXGOOXXXXXXXXXXXXXXXXXGOOXXXXXXXXXXXXXXXXXGOOXXXXXXXXXXXXXXXXXGOOOOOXXXXXXXXXXXXXXGOOOOOXXXXXXXXXXXXXXGOOOOXXXXXXXXXXXXXXXGOOXXXXXXXXXXXXXXXXXGOOXXXXXXXXXXXXXXXXXGOOXXXXXXXXXXXXXXXXXGOOOOXXXXXXXXXXXXXXXGOOOOOOOXXXXXXXXXXXXGOXXXXXXXXXXXXXXXXXX,0,0,0
9198,56,0,56,68,476,0,0,177,37,140,GOOOOOXXXXXXXXXXXXXXGOOXXXXXXXXXXXXXXXXXGOOXXXXXXXXXXXXXXXXXGOOXXXXXXXXXXXXXXXXXGOOOOOXXXXXXXXXXXXXXGOOOOOXXXXXXXXXXXXXXGOOOOXXXXXXXXXXXXXXXGOOXXXXXXXXXXXXXXXXXGOOXXXXXXXXXXXXXXXXXGOOXXXXXXXXXXXXXXXXXGOOOOXXXXXXXXXXXXXXXGOOOOOOOXXXXXXXXXXXXGOXXXXXXXXXXXXXXXXXX,0,0,0
9219,56,0,56,69,475,0,0,177,39,138,GOOOOOXXXXXXXXXXXXXXGOOXXXXXXXXXXXXXXXXXGOOXXXXXXXXXXXXXXXXXGOOXXXXXXXXXXXXXXXXXGOOOOOXXXXXXXXXXXXXXGOOOOOXXXXXXXXXXXXXXGOOOOXXXXXXXXXXXXXXXGOOXXXXXXXXXXXXXXXXXGOOXXXXXXXXXXXXXXXXXGOOXXXXXXXXXXXXXXXXXGOOOOXXXXXXXXXXXXXXXGOOOOOOOXXXXXXXXXXXXGOXXXXXXXXXXXXXXXXXX,0,0,0

9240,56,0,56,75,469,0,0,172,36,136,GOOOOOXXXXXXXXXXXXXXGOOXXXXXXXXXXXXXXXXXGOOXXXXXXXXXXXXXXXXXGOOXXXXXXXXXXXXXXXXXGOOOOOXXXXXXXXXXXXXXGOOOOOXXXXXXXXXXXXXXGOOOOXXXXXXXXXXXXXXXGOOXXXXXXXXXXXXXXXXXGOOXXXXXXXXXXXXXXXXXGOOXXXXXXXXXXXXXXXXXGOOOOXXXXXXXXXXXXXXXGOOOOOOOXXXXXXXXXXXXGOXXXXXXXXXXXXXXXXXX,0,0,0
9261,56,0,56,79,465,0,0,167,40,127,GOOOOOXXXXXXXXXXXXXXGOOXXXXXXXXXXXXXXXXXGOOXXXXXXXXXXXXXXXXXGOOXXXXXXXXXXXXXXXXXGOOOOOXXXXXXXXXXXXXXGOOOOOXXXXXXXXXXXXXXGOOOOXXXXXXXXXXXXXXXGOOXXXXXXXXXXXXXXXXXGOOXXXXXXXXXXXXXXXXXGOOXXXXXXXXXXXXXXXXXGOOOOXXXXXXXXXXXXXXXGOOOOOOOXXXXXXXXXXXXGOXXXXXXXXXXXXXXXXXX,0,0,0
9282,56,0,56,84,460,0,0,164,43,121,GOOOOOXXXXXXXXXXXXXXGOOXXXXXXXXXXXXXXXXXGOOXXXXXXXXXXXXXXXXXGOOXXXXXXXXXXXXXXXXXGOOOOOXXXXXXXXXXXXXXGOOOOOXXXXXXXXXXXXXXGOOOOXXXXXXXXXXXXXXXGOOXXXXXXXXXXXXXXXXXGOOXXXXXXXXXXXXXXXXXGOOXXXXXXXXXXXXXXXXXGOOOOXXXXXXXXXXXXXXXGOOOOOOOXXXXXXXXXXXXGOXXXXXXXXXXXXXXXXXX,0,0,0
9303,56,0,56,87,457,0,0,160,37,123,GOOOOOXXXXXXXXXXXXXXGOOXXXXXXXXXXXXXXXXXGOOXXXXXXXXXXXXXXXXXGOOXXXXXXXXXXXXXXXXXGOOOOOXXXXXXXXXXXXXXGOOOOOXXXXXXXXXXXXXXGOOOOXXXXXXXXXXXXXXXGOOXXXXXXXXXXXXXXXXXGOOXXXXXXXXXXXXXXXXXGOOXXXXXXXXXXXXXXXXXGOOOOXXXXXXXXXXXXXXXGOOOOOOOXXXXXXXXXXXXGOXXXXXXXXXXXXXXXXXX,0,0,0
9324,56,0,56,89,455,0,0,158,36,122,GOOOOOXXXXXXXXXXXXXXGOOXXXXXXXXXXXXXXXXXGOOXXXXXXXXXXXXXXXXXGOOXXXXXXXXXXXXXXXXXGOOOOOXXXXXXXXXXXXXXGOOOOOXXXXXXXXXXXXXXGOOOOXXXXXXXXXXXXXXXGOOXXXXXXXXXXXXXXXXXGOOXXXXXXXXXXXXXXXXXGOOXXXXXXXXXXXXXXXXXGOOOOXXXXXXXXXXXXXXXGOOOOOOOXXXXXXXXXXXXGOXXXXXXXXXXXXXXXXXX,0,0,0

9345,56,0,56,90,454,0,0,157,37,120,GOOOOOXXXXXXXXXXXXXXGOOXXXXXXXXXXXXXXXXXGOOXXXXXXXXXXXXXXXXXGOOXXXXXXXXXXXXXXXXXGOOOOOXXXXXXXXXXXXXXGOOOOOXXXXXXXXXXXXXXGOOOOXXXXXXXXXXXXXXXGOOXXXXXXXXXXXXXXXXXGOOXXXXXXXXXXXXXXXXXGOOXXXXXXXXXXXXXXXXXGOOOOXXXXXXXXXXXXXXXGOOOOOOOXXXXXXXXXXXXGOXXXXXXXXXXXXXXXXXX,0,0,0
9366,56,0,56,84,460,0,0,163,36,127,GOOOOOXXXXXXXXXXXXXXGOOXXXXXXXXXXXXXXXXXGOOXXXXXXXXXXXXXXXXXGOOXXXXXXXXXXXXXXXXXGOOOOOXXXXXXXXXXXXXXGOOOOOXXXXXXXXXXXXXXGOOOOXXXXXXXXXXXXXXXGOOXXXXXXXXXXXXXXXXXGOOXXXXXXXXXXXXXXXXXGOOXXXXXXXXXXXXXXXXXGOOOOXXXXXXXXXXXXXXXGOOOOOOOXXXXXXXXXXXXGOXXXXXXXXXXXXXXXXXX,0,0,0
9387,56,0,56,82,462,0,0,165,41,124,GOOOOOXXXXXXXXXXXXXXGOOXXXXXXXXXXXXXXXXXGOOXXXXXXXXXXXXXXXXXGOOXXXXXXXXXXXXXXXXXGOOOOOXXXXXXXXXXXXXXGOOOOOXXXXXXXXXXXXXXGOOOOXXXXXXXXXXXXXXXGOOXXXXXXXXXXXXXXXXXGOOXXXXXXXXXXXXXXXXXGOOXXXXXXXXXXXXXXXXXGOOOOXXXXXXXXXXXXXXXGOOOOOOOXXXXXXXXXXXXGOXXXXXXXXXXXXXXXXXX,0,0,0
9408,56,0,56,81,463,0,0,165,39,126,GOOOOOXXXXXXXXXXXXXXGOOXXXXXXXXXXXXXXXXXGOOXXXXXXXXXXXXXXXXXGOOXXXXXXXXXXXXXXXXXGOOOOOXXXXXXXXXXXXXXGOOOOOXXXXXXXXXXXXXXGOOOOXXXXXXXXXXXXXXXGOOXXXXXXXXXXXXXXXXXGOOXXXXXXXXXXXXXXXXXGOOXXXXXXXXXXXXXXXXXGOOOOXXXXXXXXXXXXXXXGOOOOOOOXXXXXXXXXXXXGOXXXXXXXXXXXXXXXXXX,0,0,0
9429,57,1,56,73,470,0,0,171,39,132,GOOOOOXXXXXXXXXXXXXXGOOAXXXXXXXXXXXXXXXXGOOXXXXXXXXXXXXXXXXXGOOXXXXXXXXXXXXXXXXXGOOOOOXXXXXXXXXXXXXXGOOOOOXXXXXXXXXXXXXXGOOOOXXXXXXXXXXXXXXXGOOXXXXXXXXXXXXXXXXXGOOXXXXXXXXXXXXXXXXXGOOXXXXXXXXXXXXXXXXXGOOOOXXXXXXXXXXXXXXXGOOOOOOOXXXXXXXXXXXXGOXXXXXXXXXXXXXXXXXX,0,0,0

9450,57,1,56,81,462,0,0,162,41,121,GOOOOOXXXXXXXXXXXXXXGOOAXXXXXXXXXXXXXXXXGOOXXXXXXXXXXXXXXXXXGOOXXXXXXXXXXXXXXXXXGOOOOOXXXXXXXXXXXXXXGOOOOOXXXXXXXXXXXXXXGOOOOXXXXXXXXXXXXXXXGOOXXXXXXXXXXXXXXXXXGOOXXXXXXXXXXXXXXXXXGOOXXXXXXXXXXXXXXXXXGOOOOXXXXXXXXXXXXXXXGOOOOOOOXXXXXXXXXXXXGOXXXXXXXXXXXXXXXXXX,0,0,0
9471,57,1,56,80,463,0,0,164,36,128,GOOOOOXXXXXXXXXXXXXXGOOAXXXXXXXXXXXXXXXXGOOXXXXXXXXXXXXXXXXXGOOXXXXXXXXXXXXXXXXXGOOOOOXXXXXXXXXXXXXXGOOOOOXXXXXXXXXXXXXXGOOOOXXXXXXXXXXXXXXXGOOXXXXXXXXXXXXXXXXXGOOXXXXXXXXXXXXXXXXXGOOXXXXXXXXXXXXXXXXXGOOOOXXXXXXXXXXXXXXXGOOOOOOOXXXXXXXXXXXXGOXXXXXXXXXXXXXXXXXX,0,0,0
9492,57,1,56,76,467,0,0,168,40,128,GOOOOOXXXXXXXXXXXXXXGOOAXXXXXXXXXXXXXXXXGOOXXXXXXXXXXXXXXXXXGOOXXXXXXXXXXXXXXXXXGOOOOOXXXXXXXXXXXXXXGOOOOOXXXXXXXXXXXXXXGOOOOXXXXXXXXXXXXXXXGOOXXXXXXXXXXXXXXXXXGOOXXXXXXXXXXXXXXXXXGOOXXXXXXXXXXXXXXXXXGOOOOXXXXXXXXXXXXXXXGOOOOOOOXXXXXXXXXXXXGOXXXXXXXXXXXXXXXXXX,0,0,0
9513,57,1,56,73,470,0,0,171,40,131,GOOOOOXXXXXXXXXXXXXXGOOAXXXXXXXXXXXXXXXXGOOXXXXXXXXXXXXXXXXXGOOXXXXXXXXXXXXXXXXXGOOOOOXXXXXXXXXXXXXXGOOOOOXXXXXXXXXXXXXXGOOOOXXXXXXXXXXXXXXXGOOXXXXXXXXXXXXXXXXXGOOXXXXXXXXXXXXXXXXXGOOXXXXXXXXXXXXXXXXXGOOOOXXXXXXXXXXXXXXXGOOOOOOOXXXXXXXXXXXXGOXXXXXXXXXXXXXXXXXX,0,0,0
9534,58,2,56,70,472,0,0,173,39,134,GOOOOOXXXXXXXXXXXXXXGOOAXXXXXXXXXXXXXXXXGOOXXXXXXXXXXXXXXXXXGOOXXXXXXXXXXXXXXXXXGOOOOOXXXXXXXXXXXXXXGOOOOOXXXXXXXXXXXXXXGOOOOXXXXXXXXXXXXXXXGOOXXXXXXXXXXXXXXXXXGOOAXXXXXXXXXXXXXXXXGOOXXXXXXXXXXXXXXXXXGOOOOXXXXXXXXXXXXXXXGOOOOOOOXXXXXXXXXXXXGOXXXXXXXXXXXXXXXXXX,0,0,0

9555,58,2,56,62,480,0,0,181,37,144,GOOOOOXXXXXXXXXXXXXXGOOAXXXXXXXXXXXXXXXXGOOXXXXXXXXXXXXXXXXXGOOXXXXXXXXXXXXXXXXXGOOOOOXXXXXXXXXXXXXXGOOOOOXXXXXXXXXXXXXXGOOOOXXXXXXXXXXXXXXXGOOXXXXXXXXXXXXXXXXXGOOAXXXXXXXXXXXXXXXXGOOXXXXXXXXXXXXXXXXXGOOOOXXXXXXXXXXXXXXXGOOOOOOOXXXXXXXXXXXXGOXXXXXXXXXXXXXXXXXX,0,0,0
9576,58,1,57,62,480,0,0,181,40,141,GOOOOOXXXXXXXXXXXXXXGOOAXXXXXXXXXXXXXXXXGOOXXXXXXXXXXXXXXXXXGOOXXXXXXXXXXXXXXXXXGOOOOOXXXXXXXXXXXXXXGOOOOOXXXXXXXXXXXXXXGOOOOXXXXXXXXXXXXXXXGOOXXXXXXXXXXXXXXXXXGOOOXXXXXXXXXXXXXXXXGOOXXXXXXXXXXXXXXXXXGOOOOXXXXXXXXXXXXXXXGOOOOOOOXXXXXXXXXXXXGOXXXXXXXXXXXXXXXXXX,0,0,0
9597,58,1,57,65,477,0,0,178,35,143,GOOOOOXXXXXXXXXXXXXXGOOAXXXXXXXXXXXXXXXXGOOXXXXXXXXXXXXXXXXXGOOXXXXXXXXXXXXXXXXXGOOOOOXXXXXXXXXXXXXXGOOOOOXXXXXXXXXXXXXXGOOOOXXXXXXXXXXXXXXXGOOXXXXXXXXXXXXXXXXXGOOOXXXXXXXXXXXXXXXXGOOXXXXXXXXXXXXXXXXXGOOOOXXXXXXXXXXXXXXXGOOOOOOOXXXXXXXXXXXXGOXXXXXXXXXXXXXXXXXX,0,0,0
9618,58,1,57,64,478,0,0,179,36,143,GOOOOOXXXXXXXXXXXXXXGOOAXXXXXXXXXXXXXXXXGOOXXXXXXXXXXXXXXXXXGOOXXXXXXXXXXXXXXXXXGOOOOOXXXXXXXXXXXXXXGOOOOOXXXXXXXXXXXXXXGOOOOXXXXXXXXXXXXXXXGOOXXXXXXXXXXXXXXXXXGOOOXXXXXXXXXXXXXXXXGOOXXXXXXXXXXXXXXXXXGOOOOXXXXXXXXXXXXXXXGOOOOOOOXXXXXXXXXXXXGOXXXXXXXXXXXXXXXXXX,0,0,0
9639,58,1,57,61,481,0,0,183,39,144,GOOOOOXXXXXXXXXXXXXXGOOAXXXXXXXXXXXXXXXXGOOXXXXXXXXXXXXXXXXXGOOXXXXXXXXXXXXXXXXXGOOOOOXXXXXXXXXXXXXXGOOOOOXXXXXXXXXXXXXXGOOOOXXXXXXXXXXXXXXXGOOXXXXXXXXXXXXXXXXXGOOOXXXXXXXXXXXXXXXXGOOXXXXXXXXXXXXXXXXXGOOOOXXXXXXXXXXXXXXXGOOOOOOOXXXXXXXXXXXXGOXXXXXXXXXXXXXXXXXX,0,0,0

9660,58,1,57,65,477,0,0,179,35,144,GOOOOOXXXXXXXXXXXXXXGOOAXXXXXXXXXXXXXXXXGOOXXXXXXXXXXXXXXXXXGOOXXXXXXXXXXXXXXXXXGOOOOOXXXXXXXXXXXXXXGOOOOOXXXXXXXXXXXXXXGOOOOXXXXXXXXXXXXXXXGOOXXXXXXXXXXXXXXXXXGOOOXXXXXXXXXXXXXXXXGOOXXXXXXXXXXXXXXXXXGOOOOXXXXXXXXXXXXXXXGOOOOOOOXXXXXXXXXXXXGOXXXXXXXXXXXXXXXXXX,0,0,0
9681,58,1,57,66,476,0,0,178,41,137,GOOOOOXXXXXXXXXXXXXXGOOAXXXXXXXXXXXXXXXXGOOXXXXXXXXXXXXXXXXXGOOXXXXXXXXXXXXXXXXXGOOOOOXXXXXXXXXXXXXXGOOOOOXXXXXXXXXXXXXXGOOOOXXXXXXXXXXXXXXXGOOXXXXXXXXXXXXXXXXXGOOOXXXXXXXXXXXXXXXXGOOXXXXXXXXXXXXXXXXXGOOOOXXXXXXXXXXXXXXXGOOOOOOOXXXXXXXXXXXXGOXXXXXXXXXXXXXXXXXX,0,0,0
9702,58,1,57,68,474,0,0,176,37,139,GOOOOOXXXXXXXXXXXXXXGOOAXXXXXXXXXXXXXXXXGOOXXXXXXXXXXXXXXXXXGOOXXXXXXXXXXXXXXXXXGOOOOOXXXXXXXXXXXXXXGOOOOOXXXXXXXXXXXXXXGOOOOXXXXXXXXXXXXXXXGOOXXXXXXXXXXXXXXXXXGOOOXXXXXXXXXXXXXXXXGOOXXXXXXXXXXXXXXXXXGOOOOXXXXXXXXXXXXXXXGOOOOOOOXXXXXXXXXXXXGOXXXXXXXXXXXXXXXXXX,0,0,0
9723,58,1,57,69,473,0,0,175,41,134,GOOOOOXXXXXXXXXXXXXXGOOAXXXXXXXXXXXXXXXXGOOXXXXXXXXXXXXXXXXXGOOXXXXXXXXXXXXXXXXXGOOOOOXXXXXXXXXXXXXXGOOOOOXXXXXXXXXXXXXXGOOOOXXXXXXXXXXXXXXXGOOXXXXXXXXXXXXXXXXXGOOOXXXXXXXXXXXXXXXXGOOXXXXXXXXXXXXXXXXXGOOOOXXXXXXXXXXXXXXXGOOOOOOOXXXXXXXXXXXXGOXXXXXXXXXXXXXXXXXX,0,0,0
9744,58,1,57,76,466,0,0,168,35,133,GOOOOOXXXXXXXXXXXXXXGOOAXXXXXXXXXXXXXXXXGOOXXXXXXXXXXXXXXXXXGOOXXXXXXXXXXXXXXXXXGOOOOOXXXXXXXXXXXXXXGOOOOOXXXXXXXXXXXXXXGOOOOXXXXXXXXXXXXXXXGOOXXXXXXXXXXXXXXXXXGOOOXXXXXXXXXXXXXXXXGOOXXXXXXXXXXXXXXXXXGOOOOXXXXXXXXXXXXXXXGOOOOOOOXXXXXXXXXXXXGOXXXXXXXXXXXXXXXXXX,0,0,0

9765,58,0,58,74,468,0,0,171,40,131,GOOOOOXXXXXXXXXXXXXXGOOOXXXXXXXXXXXXXXXXGOOXXXXXXXXXXXXXXXXXGOOXXXXXXXXXXXXXXXXXGOOOOOXXXXXXXXXXXXXXGOOOOOXXXXXXXXXXXXXXGOOOOXXXXXXXXXXXXXXXGOOXXXXXXXXXXXXXXXXXGOOOXXXXXXXXXXXXXXXXGOOXXXXXXXXXXXXXXXXXGOOOOXXXXXXXXXXXXXXXGOOOOOOOXXXXXXXXXXXXGOXXXXXXXXXXXXXXXXXX,0,0,0
9786,58,0,58,74,468,0,0,171,37,134,GOOOOOXXXXXXXXXXXXXXGOOOXXXXXXXXXXXXXXXXGOOXXXXXXXXXXXXXXXXXGOOXXXXXXXXXXXXXXXXXGOOOOOXXXXXXXXXXXXXXGOOOOOXXXXXXXXXXXXXXGOOOOXXXXXXXXXXXXXXXGOOXXXXXXXXXXXXXXXXXGOOOXXXXXXXXXXXXXXXXGOOXXXXXXXXXXXXXXXXXGOOOOXXXXXXXXXXXXXXXGOOOOOOOXXXXXXXXXXXXGOXXXXXXXXXXXXXXXXXX,0,0,0
9807,58,0,58,73,469,0,0,171,44,127,GOOOOOXXXXXXXXXXXXXXGOOOXXXXXXXXXXXXXXXXGOOXXXXXXXXXXXXXXXXXGOOXXXXXXXXXXXXXXXXXGOOOOOXXXXXXXXXXXXXXGOOOOOXXXXXXXXXXXXXXGOOOOXXXXXXXXXXXXXXXGOOXXXXXXXXXXXXXXXXXGOOOXXXXXXXXXXXXXXXXGOOXXXXXXXXXXXXXXXXXGOOOOXXXXXXXXXXXXXXXGOOOOOOOXXXXXXXXXXXXGOXXXXXXXXXXXXXXXXXX,0,0,0
9828,58,0,58,70,472,0,0,174,43,131,GOOOOOXXXXXXXXXXXXXXGOOOXXXXXXXXXXXXXXXXGOOXXXXXXXXXXXXXXXXXGOOXXXXXXXXXXXXXXXXXGOOOOOXXXXXXXXXXXXXXGOOOOOXXXXXXXXXXXXXXGOOOOXXXXXXXXXXXXXXXGOOXXXXXXXXXXXXXXXXXGOOOXXXXXXXXXXXXXXXXGOOXXXXXXXXXXXXXXXXXGOOOOXXXXXXXXXXXXXXXGOOOOOOOXXXXXXXXXXXXGOXXXXXXXXXXXXXXXXXX,0,0,0
9849,58,0,58,74,468,0,0,170,42,128,GOOOOOXXXXXXXXXXXXXXGOOOXXXXXXXXXXXXXXXXGOOXXXXXXXXXXXXXXXXXGOOXXXXXXXXXXXXXXXXXGOOOOOXXXXXXXXXXXXXXGOOOOOXXXXXXXXXXXXXXGOOOOXXXXXXXXXXXXXXXGOOXXXXXXXXXXXXXXXXXGOOOXXXXXXXXXXXXXXXXGOOXXXXXXXXXXXXXXXXXGOOOOXXXXXXXXXXXXXXXGOOOOOOOXXXXXXXXXXXXGOXXXXXXXXXXXXXXXXXX,0,0,0

9870,58,0,58,72,470,0,0,170,38,132,GOOOOOXXXXXXXXXXXXXXGOOOXXXXXXXXXXXXXXXXGOOXXXXXXXXXXXXXXXXXGOOXXXXXXXXXXXXXXXXXGOOOOOXXXXXXXXXXXXXXGOOOOOXXXXXXXXXXXXXXGOOOOXXXXXXXXXXXXXXXGOOXXXXXXXXXXXXXXXXXGOOOXXXXXXXXXXXXXXXXGOOXXXXXXXXXXXXXXXXXGOOOOXXXXXXXXXXXXXXXGOOOOOOOXXXXXXXXXXXXGOXXXXXXXXXXXXXXXXXX,0,0,0
9891,58,0,58,76,466,0,0,167,38,129,GOOOOOXXXXXXXXXXXXXXGOOOXXXXXXXXXXXXXXXXGOOXXXXXXXXXXXXXXXXXGOOXXXXXXXXXXXXXXXXXGOOOOOXXXXXXXXXXXXXXGOOOOOXXXXXXXXXXXXXXGOOOOXXXXXXXXXXXXXXXGOOXXXXXXXXXXXXXXXXXGOOOXXXXXXXXXXXXXXXXGOOXXXXXXXXXXXXXXXXXGOOOOXXXXXXXXXXXXXXXGOOOOOOOXXXXXXXXXXXXGOXXXXXXXXXXXXXXXXXX,0,0,0
9912,58,0,58,77,465,0,0,166,42,124,GOOOOOXXXXXXXXXXXXXXGOOOXXXXXXXXXXXXXXXXGOOXXXXXXXXXXXXXXXXXGOOXXXXXXXXXXXXXXXXXGOOOOOXXXXXXXXXXXXXXGOOOOOXXXXXXXXXXXXXXGOOOOXXXXXXXXXXXXXXXGOOXXXXXXXXXXXXXXXXXGOOOXXXXXXXXXXXXXXXXGOOXXXXXXXXXXXXXXXXXGOOOOXXXXXXXXXXXXXXXGOOOOOOOXXXXXXXXXXXXGOXXXXXXXXXXXXXXXXXX,0,0,0
9933,58,0,58,76,466,0,0,168,43,125,GOOOOOXXXXXXXXXXXXXXGOOOXXXXXXXXXXXXXXXXGOOXXXXXXXXXXXXXXXXXGOOXXXXXXXXXXXXXXXXXGOOOOOXXXXXXXXXXXXXXGOOOOOXXXXXXXXXXXXXXGOOOOXXXXXXXXXXXXXXXGOOXXXXXXXXXXXXXXXXXGOOOXXXXXXXXXXXXXXXXGOOXXXXXXXXXXXXXXXXXGOOOOXXXXXXXXXXXXXXXGOOOOOOOXXXXXXXXXXXXGOXXXXXXXXXXXXXXXXXX,0,0,0
9954,58,0,58,81,461,0,0,165,41,124,GOOOOOXXXXXXXXXXXXXXGOOOXXXXXXXXXXXXXXXXGOOXXXXXXXXXXXXXXXXXGOOXXXXXXXXXXXXXXXXXGOOOOOXXXXXXXXXXXXXXGOOOOOXXXXXXXXXXXXXXGOOOOXXXXXXXXXXXXXXXGOOXXXXXXXXXXXXXXXXXGOOOXXXXXXXXXXXXXXXXGOOXXXXXXXXXXXXXXXXXGOOOOXXXXXXXXXXXXXXXGOOOOOOOXXXXXXXXXXXXGOXXXXXXXXXXXXXXXXXX,0,0,0

9975,58,0,58,83,459,0,0,162,45,117,GOOOOOXXXXXXXXXXXXXXGOOOXXXXXXXXXXXXXXXXGOOXXXXXXXXXXXXXXXXXGOOXXXXXXXXXXXXXXXXXGOOOOOXXXXXXXXXXXXXXGOOOOOXXXXXXXXXXXXXXGOOOOXXXXXXXXXXXXXXXGOOXXXXXXXXXXXXXXXXXGOOOXXXXXXXXXXXXXXXXGOOXXXXXXXXXXXXXXXXXGOOOOXXXXXXXXXXXXXXXGOOOOOOOXXXXXXXXXXXXGOXXXXXXXXXXXXXXXXXX,0,0,0
9996,58,0,58,83,459,0,0,162,38,124,GOOOOOXXXXXXXXXXXXXXGOOOXXXXXXXXXXXXXXXXGOOXXXXXXXXXXXXXXXXXGOOXXXXXXXXXXXXXXXXXGOOOOOXXXXXXXXXXXXXXGOOOOOXXXXXXXXXXXXXXGOOOOXXXXXXXXXXXXXXXGOOXXXXXXXXXXXXXXXXXGOOOXXXXXXXXXXXXXXXXGOOXXXXXXXXXXXXXXXXXGOOOOXXXXXXXXXXXXXXXGOOOOOOOXXXXXXXXXXXXGOXXXXXXXXXXXXXXXXXX,0,0,0
10017,58,0,58,80,462,0,0,166,39,127,GOOOOOXXXXXXXXXXXXXXGOOOXXXXXXXXXXXXXXXXGOOXXXXXXXXXXXXXXXXXGOOXXXXXXXXXXXXXXXXXGOOOOOXXXXXXXXXXXXXXGOOOOOXXXXXXXXXXXXXXGOOOOXXXXXXXXXXXXXXXGOOXXXXXXXXXXXXXXXXXGOOOXXXXXXXXXXXXXXXXGOOXXXXXXXXXXXXXXXXXGOOOOXXXXXXXXXXXXXXXGOOOOOOOXXXXXXXXXXXXGOXXXXXXXXXXXXXXXXXX,0,0,0
10038,58,0,58,81,461,0,0,165,38,127,GOOOOOXXXXXXXXXXXXXXGOOOXXXXXXXXXXXXXXXXGOOXXXXXXXXXXXXXXXXXGOOXXXXXXXXXXXXXXXXXGOOOOOXXXXXXXXXXXXXXGOOOOOXXXXXXXXXXXXXXGOOOOXXXXXXXXXXXXXXXGOOXXXXXXXXXXXXXXXXXGOOOXXXXXXXXXXXXXXXXGOOXXXXXXXXXXXXXXXXXGOOOOXXXXXXXXXXXXXXXGOOOOOOOXXXXXXXXXXXXGOXXXXXXXXXXXXXXXXXX,0,0,0
10059,59,1,58,75,466,0,0,170,41,129,GOOOOOXXXXXXXXXXXXXXGOOOAXXXXXXXXXXXXXXXGOOXXXXXXXXXXXXXXXXXGOOXXXXXXXXXXXXXXXXXGOOOOOXXXXXXXXXXXXXXGOOOOOXXXXXXXXXXXXXXGOOOOXXXXXXXXXXXXXXXGOOXXXXXXXXXXXXXXXXXGOOOXXXXXXXXXXXXXXXXGOOXXXXXXXXXXXXXXXXXGOOOOXXXXXXXXXXXXXXXGOOOOOOOXXXXXXXXXXXXGOXXXXXXXXXXXXXXXXXX,0,0,0

10080,59,1,58,73,468,0,0,171,43,128,GOOOOOXXXXXXXXXXXXXXGOOOAXXXXXXXXXXXXXXXGOOXXXXXXXXXXXXXXXXXGOOXXXXXXXXXXXXXXXXXGOOOOOXXXXXXXXXXXXXXGOOOOOXXXXXXXXXXXXXXGOOOOXXXXXXXXXXXXXXXGOOXXXXXXXXXXXXXXXXXGOOOXXXXXXXXXXXXXXXXGOOXXXXXXXXXXXXXXXXXGOOOOXXXXXXXXXXXXXXXGOOOOOOOXXXXXXXXXXXXGOXXXXXXXXXXXXXXXXXX,0,0,0
10101,59,1,58,77,464,0,0,167,42,125,GOOOOOXXXXXXXXXXXXXXGOOOAXXXXXXXXXXXXXXXGOOXXXXXXXXXXXXXXXXXGOOXXXXXXXXXXXXXXXXXGOOOOOXXXXXXXXXXXXXXGOOOOOXXXXXXXXXXXXXXGOOOOXXXXXXXXXXXXXXXGOOXXXXXXXXXXXXXXXXXGOOOXXXXXXXXXXXXXXXXGOOXXXXXXXXXXXXXXXXXGOOOOXXXXXXXXXXXXXXXGOOOOOOOXXXXXXXXXXXXGOXXXXXXXXXXXXXXXXXX,0,0,0
10122,59,1,58,84,457,0,0,160,36,124,GOOOOOXXXXXXXXXXXXXXGOOOAXXXXXXXXXXXXXXXGOOXXXXXXXXXXXXXXXXXGOOXXXXXXXXXXXXXXXXXGOOOOOXXXXXXXXXXXXXXGOOOOOXXXXXXXXXXXXXXGOOOOXXXXXXXXXXXXXXXGOOXXXXXXXXXXXXXXXXXGOOOXXXXXXXXXXXXXXXXGOOXXXXXXXXXXXXXXXXXGOOOOXXXXXXXXXXXXXXXGOOOOOOOXXXXXXXXXXXXGOXXXXXXXXXXXXXXXXXX,0,0,0
10143,59,1,58,86,455,0,0,156,40,116,GOOOOOXXXXXXXXXXXXXXGOOOAXXXXXXXXXXXXXXXGOOXXXXXXXXXXXXXXXXXGOOXXXXXXXXXXXXXXXXXGOOOOOXXXXXXXXXXXXXXGOOOOOXXXXXXXXXXXXXXGOOOOXXXXXXXXXXXXXXXGOOXXXXXXXXXXXXXXXXXGOOOXXXXXXXXXXXXXXXXGOOXXXXXXXXXXXXXXXXXGOOOOXXXXXXXXXXXXXXXGOOOOOOOXXXXXXXXXXXXGOXXXXXXXXXXXXXXXXXX,0,0,0
10164,59,1,58,88,453,0,0,153,40,113,GOOOOOXXXXXXXXXXXXXXGOOOAXXXXXXXXXXXXXXXGOOXXXXXXXXXXXXXXXXXGOOXXXXXXXXXXXXXXXXXGOOOOOXXXXXXXXXXXXXXGOOOOOXXXXXXXXXXXXXXGOOOOXXXXXXXXXXXXXXXGOOXXXXXXXXXXXXXXXXXGOOOXXXXXXXXXXXXXXXXGOOXXXXXXXXXXXXXXXXXGOOOOXXXXXXXXXXXXXXXGOOOOOOOXXXXXXXXXXXXGOXXXXXXXXXXXXXXXXXX,0,0,0

10185,59,1,58,79,462,0,0,164,38,126,GOOOOOXXXXXXXXXXXXXXGOOOAXXXXXXXXXXXXXXXGOOXXXXXXXXXXXXXXXXXGOOXXXXXXXXXXXXXXXXXGOOOOOXXXXXXXXXXXXXXGOOOOOXXXXXXXXXXXXXXGOOOOXXXXXXXXXXXXXXXGOOXXXXXXXXXXXXXXXXXGOOOXXXXXXXXXXXXXXXXGOOXXXXXXXXXXXXXXXXXGOOOOXXXXXXXXXXXXXXXGOOOOOOOXXXXXXXXXXXXGOXXXXXXXXXXXXXXXXXX,0,0,0
10206,59,1,58,78,463,0,0,164,41,123,GOOOOOXXXXXXXXXXXXXXGOOOAXXXXXXXXXXXXXXXGOOXXXXXXXXXXXXXXXXXGOOXXXXXXXXXXXXXXXXXGOOOOOXXXXXXXXXXXXXXGOOOOOXXXXXXXXXXXXXXGOOOOXXXXXXXXXXXXXXXGOOXXXXXXXXXXXXXXXXXGOOOXXXXXXXXXXXXXXXXGOOXXXXXXXXXXXXXXXXXGOOOOXXXXXXXXXXXXXXXGOOOOOOOXXXXXXXXXXXXGOXXXXXXXXXXXXXXXXXX,0,0,0
10227,59,1,58,83,458,0,0,157,36,121,GOOOOOXXXXXXXXXXXXXXGOOOAXXXXXXXXXXXXXXXGOOXXXXXXXXXXXXXXXXXGOOXXXXXXXXXXXXXXXXXGOOOOOXXXXXXXXXXXXXXGOOOOOXXXXXXXXXXXXXXGOOOOXXXXXXXXXXXXXXXGOOXXXXXXXXXXXXXXXXXGOOOXXXXXXXXXXXXXXXXGOOXXXXXXXXXXXXXXXXXGOOOOXXXXXXXXXXXXXXXGOOOOOOOXXXXXXXXXXXXGOXXXXXXXXXXXXXXXXXX,0,0,0
10248,59,1,58,83,458,0,0,159,40,119,GOOOOOXXXXXXXXXXXXXXGOOOAXXXXXXXXXXXXXXXGOOXXXXXXXXXXXXXXXXXGOOXXXXXXXXXXXXXXXXXGOOOOOXXXXXXXXXXXXXXGOOOOOXXXXXXXXXXXXXXGOOOOXXXXXXXXXXXXXXXGOOXXXXXXXXXXXXXXXXXGOOOXXXXXXXXXXXXXXXXGOOXXXXXXXXXXXXXXXXXGOOOOXXXXXXXXXXXXXXXGOOOOOOOXXXXXXXXXXXXGOXXXXXXXXXXXXXXXXXX,0,0,0
10269,59,1,58,80,461,0,0,162,37,125,GOOOOOXXXXXXXXXXXXXXGOOOAXXXXXXXXXXXXXXXGOOXXXXXXXXXXXXXXXXXGOOXXXXXXXXXXXXXXXXXGOOOOOXXXXXXXXXXXXXXGOOOOOXXXXXXXXXXXXXXGOOOOXXXXXXXXXXXXXXXGOOXXXXXXXXXXXXXXXXXGOOOXXXXXXXXXXXXXXXXGOOXXXXXXXXXXXXXXXXXGOOOOXXXXXXXXXXXXXXXGOOOOOOOXXXXXXXXXXXXGOXXXXXXXXXXXXXXXXXX,0,0,0

10290,59,0,59,76,465,0,0,165,38,127,GOOOOOXXXXXXXXXXXXXXGOOOOXXXXXXXXXXXXXXXGOOXXXXXXXXXXXXXXXXXGOOXXXXXXXXXXXXXXXXXGOOOOOXXXXXXXXXXXXXXGOOOOOXXXXXXXXXXXXXXGOOOOXXXXXXXXXXXXXXXGOOXXXXXXXXXXXXXXXXXGOOOXXXXXXXXXXXXXXXXGOOXXXXXXXXXXXXXXXXXGOOOOXXXXXXXXXXXXXXXGOOOOOOOXXXXXXXXXXXXGOXXXXXXXXXXXXXXXXXX,0,0,0
10311,59,0,59,75,466,0,0,167,40,127,GOOOOOXXXXXXXXXXXXXXGOOOOXXXXXXXXXXXXXXXGOOXXXXXXXXXXXXXXXXXGOOXXXXXXXXXXXXXXXXXGOOOOOXXXXXXXXXXXXXXGOOOOOXXXXXXXXXXXXXXGOOOOXXXXXXXXXXXXXXXGOOXXXXXXXXXXXXXXXXXGOOOXXXXXXXXXXXXXXXXGOOXXXXXXXXXXXXXXXXXGOOOOXXXXXXXXXXXXXXXGOOOOOOOXXXXXXXXXXXXGOXXXXXXXXXXXXXXXXXX,0,0,0
10332,59,0,59,73,468,0,0,169,41,128,GOOOOOXXXXXXXXXXXXXXGOOOOXXXXXXXXXXXXXXXGOOXXXXXXXXXXXXXXXXXGOOXXXXXXXXXXXXXXXXXGOOOOOXXXXXXXXXXXXXXGOOOOOXXXXXXXXXXXXXXGOOOOXXXXXXXXXXXXXXXGOOXXXXXXXXXXXXXXXXXGOOOXXXXXXXXXXXXXXXXGOOXXXXXXXXXXXXXXXXXGOOOOXXXXXXXXXXXXXXXGOOOOOOOXXXXXXXXXXXXGOXXXXXXXXXXXXXXXXXX,0,0,0
10353,59,0,59,74,467,0,0,167,38,129,GOOOOOXXXXXXXXXXXXXXGOOOOXXXXXXXXXXXXXXXGOOXXXXXXXXXXXXXXXXXGOOXXXXXXXXXXXXXXXXXGOOOOOXXXXXXXXXXXXXXGOOOOOXXXXXXXXXXXXXXGOOOOXXXXXXXXXXXXXXXGOOXXXXXXXXXXXXXXXXXGOOOXXXXXXXXXXXXXXXXGOOXXXXXXXXXXXXXXXXXGOOOOXXXXXXXXXXXXXXXGOOOOOOOXXXXXXXXXXXXGOXXXXXXXXXXXXXXXXXX,0,0,0
10374,59,0,59,71,470,0,0,170,39,131,GOOOOOXXXXXXXXXXXXXXGOOOOXXXXXXXXXXXXXXXGOOXXXXXXXXXXXXXXXXXGOOXXXXXXXXXXXXXXXXXGOOOOOXXXXXXXXXXXXXXGOOOOOXXXXXXXXXXXXXXGOOOOXXXXXXXXXXXXXXXGOOXXXXXXXXXXXXXXXXXGOOOXXXXXXXXXXXXXXXXGOOXXXXXXXXXXXXXXXXXGOOOOXXXXXXXXXXXXXXXGOOOOOOOXXXXXXXXXXXXGOXXXXXXXXXXXXXXXXXX,0,0,0

10395,59,0,59,68,473,0,0,173,40,133,GOOOOOXXXXXXXXXXXXXXGOOOOXXXXXXXXXXXXXXXGOOXXXXXXXXXXXXXXXXXGOOXXXXXXXXXXXXXXXXXGOOOOOXXXXXXXXXXXXXXGOOOOOXXXXXXXXXXXXXXGOOOOXXXXXXXXXXXXXXXGOOXXXXXXXXXXXXXXXXXGOOOXXXXXXXXXXXXXXXXGOOXXXXXXXXXXXXXXXXXGOOOOXXXXXXXXXXXXXXXGOOOOOOOXXXXXXXXXXXXGOXXXXXXXXXXXXXXXXXX,0,0,0
10416,59,0,59,64,477,0,0,178,42,136,GOOOOOXXXXXXXXXXXXXXGOOOOXXXXXXXXXXXXXXXGOOXXXXXXXXXXXXXXXXXGOOXXXXXXXXXXXXXXXXXGOOOOOXXXXXXXXXXXXXXGOOOOOXXXXXXXXXXXXXXGOOOOXXXXXXXXXXXXXXXGOOXXXXXXXXXXXXXXXXXGOOOXXXXXXXXXXXXXXXXGOOXXXXXXXXXXXXXXXXXGOOOOXXXXXXXXXXXXXXXGOOOOOOOXXXXXXXXXXXXGOXXXXXXXXXXXXXXXXXX,0,0,0
10437,59,0,59,70,471,0,0,172,39,133,GOOOOOXXXXXXXXXXXXXXGOOOOXXXXXXXXXXXXXXXGOOXXXXXXXXXXXXXXXXXGOOXXXXXXXXXXXXXXXXXGOOOOOXXXXXXXXXXXXXXGOOOOOXXXXXXXXXXXXXXGOOOOXXXXXXXXXXXXXXXGOOXXXXXXXXXXXXXXXXXGOOOXXXXXXXXXXXXXXXXGOOXXXXXXXXXXXXXXXXXGOOOOXXXXXXXXXXXXXXXGOOOOOOOXXXXXXXXXXXXGOXXXXXXXXXXXXXXXXXX,0,0,0
10458,59,0,59,75,466,0,0,168,42,126,GOOOOOXXXXXXXXXXXXXXGOOOOXXXXXXXXXXXXXXXGOOXXXXXXXXXXXXXXXXXGOOXXXXXXXXXXXXXXXXXGOOOOOXXXXXXXXXXXXXXGOOOOOXXXXXXXXXXXXXXGOOOOXXXXXXXXXXXXXXXGOOXXXXXXXXXXXXXXXXXGOOOXXXXXXXXXXXXXXXXGOOXXXXXXXXXXXXXXXXXGOOOOXXXXXXXXXXXXXXXGOOOOOOOXXXXXXXXXXXXGOXXXXXXXXXXXXXXXXXX,0,0,0
10479,59,0,59,75,466,0,0,166,38,128,GOOOOOXXXXXXXXXXXXXXGOOOOXXXXXXXXXXXXXXXGOOXXXXXXXXXXXXXXXXXGOOXXXXXXXXXXXXXXXXXGOOOOOXXXXXXXXXXXXXXGOOOOOXXXXXXXXXXXXXXGOOOOXXXXXXXXXXXXXXXGOOXXXXXXXXXXXXXXXXXGOOOXXXXXXXXXXXXXXXXGOOXXXXXXXXXXXXXXXXXGOOOOXXXXXXXXXXXXXXXGOOOOOOOXXXXXXXXXXXXGOXXXXXXXXXXXXXXXXXX,0,0,0

10500,59,0,59,73,468,0,0,169,42,127,GOOOOOXXXXXXXXXXXXXXGOOOOXXXXXXXXXXXXXXXGOOXXXXXXXXXXXXXXXXXGOOXXXXXXXXXXXXXXXXXGOOOOOXXXXXXXXXXXXXXGOOOOOXXXXXXXXXXXXXXGOOOOXXXXXXXXXXXXXXXGOOXXXXXXXXXXXXXXXXXGOOOXXXXXXXXXXXXXXXXGOOXXXXXXXXXXXXXXXXXGOOOOXXXXXXXXXXXXXXXGOOOOOOOXXXXXXXXXXXXGOXXXXXXXXXXXXXXXXXX,0,0,0
10521,59,0,59,76,465,0,0,166,37,129,GOOOOOXXXXXXXXXXXXXXGOOOOXXXXXXXXXXXXXXXGOOXXXXXXXXXXXXXXXXXGOOXXXXXXXXXXXXXXXXXGOOOOOXXXXXXXXXXXXXXGOOOOOXXXXXXXXXXXXXXGOOOOXXXXXXXXXXXXXXXGOOXXXXXXXXXXXXXXXXXGOOOXXXXXXXXXXXXXXXXGOOXXXXXXXXXXXXXXXXXGOOOOXXXXXXXXXXXXXXXGOOOOOOOXXXXXXXXXXXXGOXXXXXXXXXXXXXXXXXX,0,0,0
10542,59,0,59,73,468,0,0,169,40,129,GOOOOOXXXXXXXXXXXXXXGOOOOXXXXXXXXXXXXXXXGOOXXXXXXXXXXXXXXXXXGOOXXXXXXXXXXXXXXXXXGOOOOOXXXXXXXXXXXXXXGOOOOOXXXXXXXXXXXXXXGOOOOXXXXXXXXXXXXXXXGOOXXXXXXXXXXXXXXXXXGOOOXXXXXXXXXXXXXXXXGOOXXXXXXXXXXXXXXXXXGOOOOXXXXXXXXXXXXXXXGOOOOOOOXXXXXXXXXXXXGOXXXXXXXXXXXXXXXXXX,0,0,0
10563,59,0,59,75,466,0,0,166,41,125,GOOOOOXXXXXXXXXXXXXXGOOOOXXXXXXXXXXXXXXXGOOXXXXXXXXXXXXXXXXXGOOXXXXXXXXXXXXXXXXXGOOOOOXXXXXXXXXXXXXXGOOOOOXXXXXXXXXXXXXXGOOOOXXXXXXXXXXXXXXXGOOXXXXXXXXXXXXXXXXXGOOOXXXXXXXXXXXXXXXXGOOXXXXXXXXXXXXXXXXXGOOOOXXXXXXXXXXXXXXXGOOOOOOOXXXXXXXXXXXXGOXXXXXXXXXXXXXXXXXX,0,0,0
10584,59,0,59,75,466,0,0,169,40,129,GOOOOOXXXXXXXXXXXXXXGOOOOXXXXXXXXXXXXXXXGOOXXXXXXXXXXXXXXXXXGOOXXXXXXXXXXXXXXXXXGOOOOOXXXXXXXXXXXXXXGOOOOOXXXXXXXXXXXXXXGOOOOXXXXXXXXXXXXXXXGOOXXXXXXXXXXXXXXXXXGOOOXXXXXXXXXXXXXXXXGOOXXXXXXXXXXXXXXXXXGOOOOXXXXXXXXXXXXXXXGOOOOOOOXXXXXXXXXXXXGOXXXXXXXXXXXXXXXXXX,0,0,0

10605,59,0,59,71,470,0,0,173,45,128,GOOOOOXXXXXXXXXXXXXXGOOOOXXXXXXXXXXXXXXXGOOXXXXXXXXXXXXXXXXXGOOXXXXXXXXXXXXXXXXXGOOOOOXXXXXXXXXXXXXXGOOOOOXXXXXXXXXXXXXXGOOOOXXXXXXXXXXXXXXXGOOXXXXXXXXXXXXXXXXXGOOOXXXXXXXXXXXXXXXXGOOXXXXXXXXXXXXXXXXXGOOOOXXXXXXXXXXXXXXXGOOOOOOOXXXXXXXXXXXXGOXXXXXXXXXXXXXXXXXX,0,0,0
10626,59,0,59,73,468,0,0,171,42,129,GOOOOOXXXXXXXXXXXXXXGOOOOXXXXXXXXXXXXXXXGOOXXXXXXXXXXXXXXXXXGOOXXXXXXXXXXXXXXXXXGOOOOOXXXXXXXXXXXXXXGOOOOOXXXXXXXXXXXXXXGOOOOXXXXXXXXXXXXXXXGOOXXXXXXXXXXXXXXXXXGOOOXXXXXXXXXXXXXXXXGOOXXXXXXXXXXXXXXXXXGOOOOXXXXXXXXXXXXXXXGOOOOOOOXXXXXXXXXXXXGOXXXXXXXXXXXXXXXXXX,0,0,0
10647,59,0,59,77,464,0,0,166,37,129,GOOOOOXXXXXXXXXXXXXXGOOOOXXXXXXXXXXXXXXXGOOXXXXXXXXXXXXXXXXXGOOXXXXXXXXXXXXXXXXXGOOOOOXXXXXXXXXXXXXXGOOOOOXXXXXXXXXXXXXXGOOOOXXXXXXXXXXXXXXXGOOXXXXXXXXXXXXXXXXXGOOOXXXXXXXXXXXXXXXXGOOXXXXXXXXXXXXXXXXXGOOOOXXXXXXXXXXXXXXXGOOOOOOOXXXXXXXXXXXXGOXXXXXXXXXXXXXXXXXX,0,0,0
10668,59,0,59,77,464,0,0,166,39,127,GOOOOOXXXXXXXXXXXXXXGOOOOXXXXXXXXXXXXXXXGOOXXXXXXXXXXXXXXXXXGOOXXXXXXXXXXXXXXXXXGOOOOOXXXXXXXXXXXXXXGOOOOOXXXXXXXXXXXXXXGOOOOXXXXXXXXXXXXXXXGOOXXXXXXXXXXXXXXXXXGOOOXXXXXXXXXXXXXXXXGOOXXXXXXXXXXXXXXXXXGOOOOXXXXXXXXXXXXXXXGOOOOOOOXXXXXXXXXXXXGOXXXXXXXXXXXXXXXXXX,0,0,0
10689,59,0,59,75,466,0,0,168,38,130,GOOOOOXXXXXXXXXXXXXXGOOOOXXXXXXXXXXXXXXXGOOXXXXXXXXXXXXXXXXXGOOXXXXXXXXXXXXXXXXXGOOOOOXXXXXXXXXXXXXXGOOOOOXXXXXXXXXXXXXXGOOOOXXXXXXXXXXXXXXXGOOXXXXXXXXXXXXXXXXXGOOOXXXXXXXXXXXXXXXXGOOXXXXXXXXXXXXXXXXXGOOOOXXXXXXXXXXXXXXXGOOOOOOOXXXXXXXXXXXXGOXXXXXXXXXXXXXXXXXX,0,0,0

10710,59,0,59,74,467,0,0,170,38,132,GOOOOOXXXXXXXXXXXXXXGOOOOXXXXXXXXXXXXXXXGOOXXXXXXXXXXXXXXXXXGOOXXXXXXXXXXXXXXXXXGOOOOOXXXXXXXXXXXXXXGOOOOOXXXXXXXXXXXXXXGOOOOXXXXXXXXXXXXXXXGOOXXXXXXXXXXXXXXXXXGOOOXXXXXXXXXXXXXXXXGOOXXXXXXXXXXXXXXXXXGOOOOXXXXXXXXXXXXXXXGOOOOOOOXXXXXXXXXXXXGOXXXXXXXXXXXXXXXXXX,0,0,0
10731,59,0,59,74,467,0,0,169,39,130,GOOOOOXXXXXXXXXXXXXXGOOOOXXXXXXXXXXXXXXXGOOXXXXXXXXXXXXXXXXXGOOXXXXXXXXXXXXXXXXXGOOOOOXXXXXXXXXXXXXXGOOOOOXXXXXXXXXXXXXXGOOOOXXXXXXXXXXXXXXXGOOXXXXXXXXXXXXXXXXXGOOOXXXXXXXXXXXXXXXXGOOXXXXXXXXXXXXXXXXXGOOOOXXXXXXXXXXXXXXXGOOOOOOOXXXXXXXXXXXXGOXXXXXXXXXXXXXXXXXX,0,0,0
10752,59,0,59,72,469,0,0,171,37,134,GOOOOOXXXXXXXXXXXXXXGOOOOXXXXXXXXXXXXXXXGOOXXXXXXXXXXXXXXXXXGOOXXXXXXXXXXXXXXXXXGOOOOOXXXXXXXXXXXXXXGOOOOOXXXXXXXXXXXXXXGOOOOXXXXXXXXXXXXXXXGOOXXXXXXXXXXXXXXXXXGOOOXXXXXXXXXXXXXXXXGOOXXXXXXXXXXXXXXXXXGOOOOXXXXXXXXXXXXXXXGOOOOOOOXXXXXXXXXXXXGOXXXXXXXXXXXXXXXXXX,0,0,0
10773,59,0,59,73,468,0,0,170,39,131,GOOOOOXXXXXXXXXXXXXXGOOOOXXXXXXXXXXXXXXXGOOXXXXXXXXXXXXXXXXXGOOXXXXXXXXXXXXXXXXXGOOOOOXXXXXXXXXXXXXXGOOOOOXXXXXXXXXXXXXXGOOOOXXXXXXXXXXXXXXXGOOXXXXXXXXXXXXXXXXXGOOOXXXXXXXXXXXXXXXXGOOXXXXXXXXXXXXXXXXXGOOOOXXXXXXXXXXXXXXXGOOOOOOOXXXXXXXXXXXXGOXXXXXXXXXXXXXXXXXX,0,0,0
10794,59,0,59,67,474,0,0,176,43,133,GOOOOOXXXXXXXXXXXXXXGOOOOXXXXXXXXXXXXXXXGOOXXXXXXXXXXXXXXXXXGOOXXXXXXXXXXXXXXXXXGOOOOOXXXXXXXXXXXXXXGOOOOOXXXXXXXXXXXXXXGOOOOXXXXXXXXXXXXXXXGOOXXXXXXXXXXXXXXXXXGOOOXXXXXXXXXXXXXXXXGOOXXXXXXXXXXXXXXXXXGOOOOXXXXXXXXXXXXXXXGOOOOOOOXXXXXXXXXXXXGOXXXXXXXXXXXXXXXXXX,0,0,0

10815,60,1,59,66,474,0,0,177,43,134,GOOOOOXXXXXXXXXXXXXXGOOOOXXXXXXXXXXXXXXXGOOXXXXXXXXXXXXXXXXXGOOXXXXXXXXXXXXXXXXXGOOOOOXXXXXXXXXXXXXXGOOOOOAXXXXXXXXXXXXXGOOOOXXXXXXXXXXXXXXXGOOXXXXXXXXXXXXXXXXXGOOOXXXXXXXXXXXXXXXXGOOXXXXXXXXXXXXXXXXXGOOOOXXXXXXXXXXXXXXXGOOOOOOOXXXXXXXXXXXXGOXXXXXXXXXXXXXXXXXX,0,0,0
10836,60,1,59,68,472,0,0,175,41,134,GOOOOOXXXXXXXXXXXXXXGOOOOXXXXXXXXXXXXXXXGOOXXXXXXXXXXXXXXXXXGOOXXXXXXXXXXXXXXXXXGOOOOOXXXXXXXXXXXXXXGOOOOOAXXXXXXXXXXXXXGOOOOXXXXXXXXXXXXXXXGOOXXXXXXXXXXXXXXXXXGOOOXXXXXXXXXXXXXXXXGOOXXXXXXXXXXXXXXXXXGOOOOXXXXXXXXXXXXXXXGOOOOOOOXXXXXXXXXXXXGOXXXXXXXXXXXXXXXXXX,0,0,0
10857,60,1,59,73,467,0,0,170,39,131,GOOOOOXXXXXXXXXXXXXXGOOOOXXXXXXXXXXXXXXXGOOXXXXXXXXXXXXXXXXXGOOXXXXXXXXXXXXXXXXXGOOOOOXXXXXXXXXXXXXXGOOOOOAXXXXXXXXXXXXXGOOOOXXXXXXXXXXXXXXXGOOXXXXXXXXXXXXXXXXXGOOOXXXXXXXXXXXXXXXXGOOXXXXXXXXXXXXXXXXXGOOOOXXXXXXXXXXXXXXXGOOOOOOOXXXXXXXXXXXXGOXXXXXXXXXXXXXXXXXX,0,0,0
10878,60,1,59,71,469,0,0,172,40,132,GOOOOOXXXXXXXXXXXXXXGOOOOXXXXXXXXXXXXXXXGOOXXXXXXXXXXXXXXXXXGOOXXXXXXXXXXXXXXXXXGOOOOOXXXXXXXXXXXXXXGOOOOOAXXXXXXXXXXXXXGOOOOXXXXXXXXXXXXXXXGOOXXXXXXXXXXXXXXXXXGOOOXXXXXXXXXXXXXXXXGOOXXXXXXXXXXXXXXXXXGOOOOXXXXXXXXXXXXXXXGOOOOOOOXXXXXXXXXXXXGOXXXXXXXXXXXXXXXXXX,0,0,0
10899,60,0,60,70,470,0,0,172,41,131,GOOOOOXXXXXXXXXXXXXXGOOOOXXXXXXXXXXXXXXXGOOXXXXXXXXXXXXXXXXXGOOXXXXXXXXXXXXXXXXXGOOOOOXXXXXXXXXXXXXXGOOOOOOXXXXXXXXXXXXXGOOOOXXXXXXXXXXXXXXXGOOXXXXXXXXXXXXXXXXXGOOOXXXXXXXXXXXXXXXXGOOXXXXXXXXXXXXXXXXXGOOOOXXXXXXXXXXXXXXXGOOOOOOOXXXXXXXXXXXXGOXXXXXXXXXXXXXXXXXX,0,0,0

10920,60,0,60,77,463,0,0,165,38,127,GOOOOOXXXXXXXXXXXXXXGOOOOXXXXXXXXXXXXXXXGOOXXXXXXXXXXXXXXXXXGOOXXXXXXXXXXXXXXXXXGOOOOOXXXXXXXXXXXXXXGOOOOOOXXXXXXXXXXXXXGOOOOXXXXXXXXXXXXXXXGOOXXXXXXXXXXXXXXXXXGOOOXXXXXXXXXXXXXXXXGOOXXXXXXXXXXXXXXXXXGOOOOXXXXXXXXXXXXXXXGOOOOOOOXXXXXXXXXXXXGOXXXXXXXXXXXXXXXXXX,0,0,0
10941,60,0,60,73,467,0,0,169,37,132,GOOOOOXXXXXXXXXXXXXXGOOOOXXXXXXXXXXXXXXXGOOXXXXXXXXXXXXXXXXXGOOXXXXXXXXXXXXXXXXXGOOOOOXXXXXXXXXXXXXXGOOOOOOXXXXXXXXXXXXXGOOOOXXXXXXXXXXXXXXXGOOXXXXXXXXXXXXXXXXXGOOOXXXXXXXXXXXXXXXXGOOXXXXXXXXXXXXXXXXXGOOOOXXXXXXXXXXXXXXXGOOOOOOOXXXXXXXXXXXXGOXXXXXXXXXXXXXXXXXX,0,0,0
10962,60,0,60,70,470,0,0,172,37,135,GOOOOOXXXXXXXXXXXXXXGOOOOXXXXXXXXXXXXXXXGOOXXXXXXXXXXXXXXXXXGOOXXXXXXXXXXXXXXXXXGOOOOOXXXXXXXXXXXXXXGOOOOOOXXXXXXXXXXXXXGOOOOXXXXXXXXXXXXXXXGOOXXXXXXXXXXXXXXXXXGOOOXXXXXXXXXXXXXXXXGOOXXXXXXXXXXXXXXXXXGOOOOXXXXXXXXXXXXXXXGOOOOOOOXXXXXXXXXXXXGOXXXXXXXXXXXXXXXXXX,0,0,0
10983,60,0,60,68,472,0,0,174,41,133,GOOOOOXXXXXXXXXXXXXXGOOOOXXXXXXXXXXXXXXXGOOXXXXXXXXXXXXXXXXXGOOXXXXXXXXXXXXXXXXXGOOOOOXXXXXXXXXXXXXXGOOOOOOXXXXXXXXXXXXXGOOOOXXXXXXXXXXXXXXXGOOXXXXXXXXXXXXXXXXXGOOOXXXXXXXXXXXXXXXXGOOXXXXXXXXXXXXXXXXXGOOOOXXXXXXXXXXXXXXXGOOOOOOOXXXXXXXXXXXXGOXXXXXXXXXXXXXXXXXX,0,0,0
11004,60,0,60,66,474,0,0,176,47,129,GOOOOOXXXXXXXXXXXXXXGOOOOXXXXXXXXXXXXXXXGOOXXXXXXXXXXXXXXXXXGOOXXXXXXXXXXXXXXXXXGOOOOOXXXXXXXXXXXXXXGOOOOOOXXXXXXXXXXXXXGOOOOXXXXXXXXXXXXXXXGOOXXXXXXXXXXXXXXXXXGOOOXXXXXXXXXXXXXXXXGOOXXXXXXXXXXXXXXXXXGOOOOXXXXXXXXXXXXXXXGOOOOOOOXXXXXXXXXXXXGOXXXXXXXXXXXXXXXXXX,0,0,0

11025,60,0,60,71,469,0,0,169,42,127,GOOOOOXXXXXXXXXXXXXXGOOOOXXXXXXXXXXXXXXXGOOXXXXXXXXXXXXXXXXXGOOXXXXXXXXXXXXXXXXXGOOOOOXXXXXXXXXXXXXXGOOOOOOXXXXXXXXXXXXXGOOOOXXXXXXXXXXXXXXXGOOXXXXXXXXXXXXXXXXXGOOOXXXXXXXXXXXXXXXXGOOXXXXXXXXXXXXXXXXXGOOOOXXXXXXXXXXXXXXXGOOOOOOOXXXXXXXXXXXXGOXXXXXXXXXXXXXXXXXX,0,0,0
11046,61,1,60,75,464,0,0,166,40,126,GOOOOOXXXXXXXXXXXXXXGOOOOXXXXXXXXXXXXXXXGOOXXXXXXXXXXXXXXXXXGOOXXXXXXXXXXXXXXXXXGOOOOOXXXXXXXXXXXXXXGOOOOOOXXXXXXXXXXXXXGOOOOXXXXXXXXXXXXXXXGOOXXXXXXXXXXXXXXXXXGOOOXXXXXXXXXXXXXXXXGOOXXXXXXXXXXXXXXXXXGOOOOAXXXXXXXXXXXXXXGOOOOOOOXXXXXXXXXXXXGOXXXXXXXXXXXXXXXXXX,0,0,0
11067,61,1,60,71,468,0,0,169,37,132,GOOOOOXXXXXXXXXXXXXXGOOOOXXXXXXXXXXXXXXXGOOXXXXXXXXXXXXXXXXXGOOXXXXXXXXXXXXXXXXXGOOOOOXXXXXXXXXXXXXXGOOOOOOXXXXXXXXXXXXXGOOOOXXXXXXXXXXXXXXXGOOXXXXXXXXXXXXXXXXXGOOOXXXXXXXXXXXXXXXXGOOXXXXXXXXXXXXXXXXXGOOOOAXXXXXXXXXXXXXXGOOOOOOOXXXXXXXXXXXXGOXXXXXXXXXXXXXXXXXX,0,0,0
11088,61,1,60,68,471,0,0,173,39,134,GOOOOOXXXXXXXXXXXXXXGOOOOXXXXXXXXXXXXXXXGOOXXXXXXXXXXXXXXXXXGOOXXXXXXXXXXXXXXXXXGOOOOOXXXXXXXXXXXXXXGOOOOOOXXXXXXXXXXXXXGOOOOXXXXXXXXXXXXXXXGOOXXXXXXXXXXXXXXXXXGOOOXXXXXXXXXXXXXXXXGOOXXXXXXXXXXXXXXXXXGOOOOAXXXXXXXXXXXXXXGOOOOOOOXXXXXXXXXXXXGOXXXXXXXXXXXXXXXXXX,0,0,0
11109,61,1,60,69,470,0,0,173,39,134,GOOOOOXXXXXXXXXXXXXXGOOOOXXXXXXXXXXXXXXXGOOXXXXXXXXXXXXXXXXXGOOXXXXXXXXXXXXXXXXXGOOOOOXXXXXXXXXXXXXXGOOOOOOXXXXXXXXXXXXXGOOOOXXXXXXXXXXXXXXXGOOXXXXXXXXXXXXXXXXXGOOOXXXXXXXXXXXXXXXXGOOXXXXXXXXXXXXXXXXXGOOOOAXXXXXXXXXXXXXXGOOOOOOOXXXXXXXXXXXXGOXXXXXXXXXXXXXXXXXX,0,0,0

11130,61,1,60,67,472,0,0,175,37,138,GOOOOOXXXXXXXXXXXXXXGOOOOXXXXXXXXXXXXXXXGOOXXXXXXXXXXXXXXXXXGOOXXXXXXXXXXXXXXXXXGOOOOOXXXXXXXXXXXXXXGOOOOOOXXXXXXXXXXXXXGOOOOXXXXXXXXXXXXXXXGOOXXXXXXXXXXXXXXXXXGOOOXXXXXXXXXXXXXXXXGOOXXXXXXXXXXXXXXXXXGOOOOAXXXXXXXXXXXXXXGOOOOOOOXXXXXXXXXXXXGOXXXXXXXXXXXXXXXXXX,0,0,0
11151,61,1,60,61,478,0,0,182,40,142,GOOOOOXXXXXXXXXXXXXXGOOOOXXXXXXXXXXXXXXXGOOXXXXXXXXXXXXXXXXXGOOXXXXXXXXXXXXXXXXXGOOOOOXXXXXXXXXXXXXXGOOOOOOXXXXXXXXXXXXXGOOOOXXXXXXXXXXXXXXXGOOXXXXXXXXXXXXXXXXXGOOOXXXXXXXXXXXXXXXXGOOXXXXXXXXXXXXXXXXXGOOOOAXXXXXXXXXXXXXXGOOOOOOOXXXXXXXXXXXXGOXXXXXXXXXXXXXXXXXX,0,0,0
11172,61,1,60,71,468,0,0,172,39,133,GOOOOOXXXXXXXXXXXXXXGOOOOXXXXXXXXXXXXXXXGOOXXXXXXXXXXXXXXXXXGOOXXXXXXXXXXXXXXXXXGOOOOOXXXXXXXXXXXXXXGOOOOOOXXXXXXXXXXXXXGOOOOXXXXXXXXXXXXXXXGOOXXXXXXXXXXXXXXXXXGOOOXXXXXXXXXXXXXXXXGOOXXXXXXXXXXXXXXXXXGOOOOAXXXXXXXXXXXXXXGOOOOOOOXXXXXXXXXXXXGOXXXXXXXXXXXXXXXXXX,0,0,0
11193,61,1,60,69,470,0,0,174,40,134,GOOOOOXXXXXXXXXXXXXXGOOOOXXXXXXXXXXXXXXXGOOXXXXXXXXXXXXXXXXXGOOXXXXXXXXXXXXXXXXXGOOOOOXXXXXXXXXXXXXXGOOOOOOXXXXXXXXXXXXXGOOOOXXXXXXXXXXXXXXXGOOXXXXXXXXXXXXXXXXXGOOOXXXXXXXXXXXXXXXXGOOXXXXXXXXXXXXXXXXXGOOOOAXXXXXXXXXXXXXXGOOOOOOOXXXXXXXXXXXXGOXXXXXXXXXXXXXXXXXX,0,0,0
11214,61,1,60,66,473,0,0,177,41,136,GOOOOOXXXXXXXXXXXXXXGOOOOXXXXXXXXXXXXXXXGOOXXXXXXXXXXXXXXXXXGOOXXXXXXXXXXXXXXXXXGOOOOOXXXXXXXXXXXXXXGOOOOOOXXXXXXXXXXXXXGOOOOXXXXXXXXXXXXXXXGOOXXXXXXXXXXXXXXXXXGOOOXXXXXXXXXXXXXXXXGOOXXXXXXXXXXXXXXXXXGOOOOAXXXXXXXXXXXXXXGOOOOOOOXXXXXXXXXXXXGOXXXXXXXXXXXXXXXXXX,0,0,0

11235,61,1,60,67,472,0,0,174,41,133,GOOOOOXXXXXXXXXXXXXXGOOOOXXXXXXXXXXXXXXXGOOXXXXXXXXXXXXXXXXXGOOXXXXXXXXXXXXXXXXXGOOOOOXXXXXXXXXXXXXXGOOOOOOXXXXXXXXXXXXXGOOOOXXXXXXXXXXXXXXXGOOXXXXXXXXXXXXXXXXXGOOOXXXXXXXXXXXXXXXXGOOXXXXXXXXXXXXXXXXXGOOOOAXXXXXXXXXXXXXXGOOOOOOOXXXXXXXXXXXXGOXXXXXXXXXXXXXXXXXX,0,0,0
11256,62,2,60,67,471,0,0,173,42,131,GOOOOOAXXXXXXXXXXXXXGOOOOXXXXXXXXXXXXXXXGOOXXXXXXXXXXXXXXXXXGOOXXXXXXXXXXXXXXXXXGOOOOOXXXXXXXXXXXXXXGOOOOOOXXXXXXXXXXXXXGOOOOXXXXXXXXXXXXXXXGOOXXXXXXXXXXXXXXXXXGOOOXXXXXXXXXXXXXXXXGOOXXXXXXXXXXXXXXXXXGOOOOAXXXXXXXXXXXXXXGOOOOOOOXXXXXXXXXXXXGOXXXXXXXXXXXXXXXXXX,0,0,0
11277,62,2,60,74,464,0,0,165,41,124,GOOOOOAXXXXXXXXXXXXXGOOOOXXXXXXXXXXXXXXXGOOXXXXXXXXXXXXXXXXXGOOXXXXXXXXXXXXXXXXXGOOOOOXXXXXXXXXXXXXXGOOOOOOXXXXXXXXXXXXXGOOOOXXXXXXXXXXXXXXXGOOXXXXXXXXXXXXXXXXXGOOOXXXXXXXXXXXXXXXXGOOXXXXXXXXXXXXXXXXXGOOOOAXXXXXXXXXXXXXXGOOOOOOOXXXXXXXXXXXXGOXXXXXXXXXXXXXXXXXX,0,0,0
11298,62,2,60,78,460,0,0,163,40,123,GOOOOOAXXXXXXXXXXXXXGOOOOXXXXXXXXXXXXXXXGOOXXXXXXXXXXXXXXXXXGOOXXXXXXXXXXXXXXXXXGOOOOOXXXXXXXXXXXXXXGOOOOOOXXXXXXXXXXXXXGOOOOXXXXXXXXXXXXXXXGOOXXXXXXXXXXXXXXXXXGOOOXXXXXXXXXXXXXXXXGOOXXXXXXXXXXXXXXXXXGOOOOAXXXXXXXXXXXXXXGOOOOOOOXXXXXXXXXXXXGOXXXXXXXXXXXXXXXXXX,0,0,0
11319,62,2,60,78,460,0,0,161,41,120,GOOOOOAXXXXXXXXXXXXXGOOOOXXXXXXXXXXXXXXXGOOXXXXXXXXXXXXXXXXXGOOXXXXXXXXXXXXXXXXXGOOOOOXXXXXXXXXXXXXXGOOOOOOXXXXXXXXXXXXXGOOOOXXXXXXXXXXXXXXXGOOXXXXXXXXXXXXXXXXXGOOOXXXXXXXXXXXXXXXXGOOXXXXXXXXXXXXXXXXXGOOOOAXXXXXXXXXXXXXXGOOOOOOOXXXXXXXXXXXXGOXXXXXXXXXXXXXXXXXX,0,0,0

11340,62,2,60,81,457,0,0,159,41,118,GOOOOOAXXXXXXXXXXXXXGOOOOXXXXXXXXXXXXXXXGOOXXXXXXXXXXXXXXXXXGOOXXXXXXXXXXXXXXXXXGOOOOOXXXXXXXXXXXXXXGOOOOOOXXXXXXXXXXXXXGOOOOXXXXXXXXXXXXXXXGOOXXXXXXXXXXXXXXXXXGOOOXXXXXXXXXXXXXXXXGOOXXXXXXXXXXXXXXXXXGOOOOAXXXXXXXXXXXXXXGOOOOOOOXXXXXXXXXXXXGOXXXXXXXXXXXXXXXXXX,0,0,0
11361,62,2,60,80,458,0,0,159,39,120,GOOOOOAXXXXXXXXXXXXXGOOOOXXXXXXXXXXXXXXXGOOXXXXXXXXXXXXXXXXXGOOXXXXXXXXXXXXXXXXXGOOOOOXXXXXXXXXXXXXXGOOOOOOXXXXXXXXXXXXXGOOOOXXXXXXXXXXXXXXXGOOXXXXXXXXXXXXXXXXXGOOOXXXXXXXXXXXXXXXXGOOXXXXXXXXXXXXXXXXXGOOOOAXXXXXXXXXXXXXXGOOOOOOOXXXXXXXXXXXXGOXXXXXXXXXXXXXXXXXX,0,0,0
11382,62,2,60,77,461,0,0,163,39,124,GOOOOOAXXXXXXXXXXXXXGOOOOXXXXXXXXXXXXXXXGOOXXXXXXXXXXXXXXXXXGOOXXXXXXXXXXXXXXXXXGOOOOOXXXXXXXXXXXXXXGOOOOOOXXXXXXXXXXXXXGOOOOXXXXXXXXXXXXXXXGOOXXXXXXXXXXXXXXXXXGOOOXXXXXXXXXXXXXXXXGOOXXXXXXXXXXXXXXXXXGOOOOAXXXXXXXXXXXXXXGOOOOOOOXXXXXXXXXXXXGOXXXXXXXXXXXXXXXXXX,0,0,0
11403,62,2,60,74,464,0,0,166,42,124,GOOOOOAXXXXXXXXXXXXXGOOOOXXXXXXXXXXXXXXXGOOXXXXXXXXXXXXXXXXXGOOXXXXXXXXXXXXXXXXXGOOOOOXXXXXXXXXXXXXXGOOOOOOXXXXXXXXXXXXXGOOOOXXXXXXXXXXXXXXXGOOXXXXXXXXXXXXXXXXXGOOOXXXXXXXXXXXXXXXXGOOXXXXXXXXXXXXXXXXXGOOOOAXXXXXXXXXXXXXXGOOOOOOOXXXXXXXXXXXXGOXXXXXXXXXXXXXXXXXX,0,0,0
11424,62,2,60,69,469,0,0,170,39,131,GOOOOOAXXXXXXXXXXXXXGOOOOXXXXXXXXXXXXXXXGOOXXXXXXXXXXXXXXXXXGOOXXXXXXXXXXXXXXXXXGOOOOOXXXXXXXXXXXXXXGOOOOOOXXXXXXXXXXXXXGOOOOXXXXXXXXXXXXXXXGOOXXXXXXXXXXXXXXXXXGOOOXXXXXXXXXXXXXXXXGOOXXXXXXXXXXXXXXXXXGOOOOAXXXXXXXXXXXXXXGOOOOOOOXXXXXXXXXXXXGOXXXXXXXXXXXXXXXXXX,0,0,0

11445,62,2,60,67,471,0,0,172,41,131,GOOOOOAXXXXXXXXXXXXXGOOOOXXXXXXXXXXXXXXXGOOXXXXXXXXXXXXXXXXXGOOXXXXXXXXXXXXXXXXXGOOOOOXXXXXXXXXXXXXXGOOOOOOXXXXXXXXXXXXXGOOOOXXXXXXXXXXXXXXXGOOXXXXXXXXXXXXXXXXXGOOOXXXXXXXXXXXXXXXXGOOXXXXXXXXXXXXXXXXXGOOOOAXXXXXXXXXXXXXXGOOOOOOOXXXXXXXXXXXXGOXXXXXXXXXXXXXXXXXX,0,0,0
11466,62,1,61,70,468,0,0,170,43,127,GOOOOOAXXXXXXXXXXXXXGOOOOXXXXXXXXXXXXXXXGOOXXXXXXXXXXXXXXXXXGOOXXXXXXXXXXXXXXXXXGOOOOOXXXXXXXXXXXXXXGOOOOOOXXXXXXXXXXXXXGOOOOXXXXXXXXXXXXXXXGOOXXXXXXXXXXXXXXXXXGOOOXXXXXXXXXXXXXXXXGOOXXXXXXXXXXXXXXXXXGOOOOOXXXXXXXXXXXXXXGOOOOOOOXXXXXXXXXXXXGOXXXXXXXXXXXXXXXXXX,0,0,0
11487,62,0,62,74,464,0,0,166,43,123,GOOOOOOXXXXXXXXXXXXXGOOOOXXXXXXXXXXXXXXXGOOXXXXXXXXXXXXXXXXXGOOXXXXXXXXXXXXXXXXXGOOOOOXXXXXXXXXXXXXXGOOOOOOXXXXXXXXXXXXXGOOOOXXXXXXXXXXXXXXXGOOXXXXXXXXXXXXXXXXXGOOOXXXXXXXXXXXXXXXXGOOXXXXXXXXXXXXXXXXXGOOOOOXXXXXXXXXXXXXXGOOOOOOOXXXXXXXXXXXXGOXXXXXXXXXXXXXXXXXX,0,0,0
11508,62,0,62,69,469,0,0,171,42,129,GOOOOOOXXXXXXXXXXXXXGOOOOXXXXXXXXXXXXXXXGOOXXXXXXXXXXXXXXXXXGOOXXXXXXXXXXXXXXXXXGOOOOOXXXXXXXXXXXXXXGOOOOOOXXXXXXXXXXXXXGOOOOXXXXXXXXXXXXXXXGOOXXXXXXXXXXXXXXXXXGOOOXXXXXXXXXXXXXXXXGOOXXXXXXXXXXXXXXXXXGOOOOOXXXXXXXXXXXXXXGOOOOOOOXXXXXXXXXXXXGOXXXXXXXXXXXXXXXXXX,0,0,0
11529,62,0,62,66,472,0,0,174,43,131,GOOOOOOXXXXXXXXXXXXXGOOOOXXXXXXXXXXXXXXXGOOXXXXXXXXXXXXXXXXXGOOXXXXXXXXXXXXXXXXXGOOOOOXXXXXXXXXXXXXXGOOOOOOXXXXXXXXXXXXXGOOOOXXXXXXXXXXXXXXXGOOXXXXXXXXXXXXXXXXXGOOOXXXXXXXXXXXXXXXXGOOXXXXXXXXXXXXXXXXXGOOOOOXXXXXXXXXXXXXXGOOOOOOOXXXXXXXXXXXXGOXXXXXXXXXXXXXXXXXX,0,0,0

11550,62,0,62,68,470,0,0,172,41,131,GOOOOOOXXXXXXXXXXXXXGOOOOXXXXXXXXXXXXXXXGOOXXXXXXXXXXXXXXXXXGOOXXXXXXXXXXXXXXXXXGOOOOOXXXXXXXXXXXXXXGOOOOOOXXXXXXXXXXXXXGOOOOXXXXXXXXXXXXXXXGOOXXXXXXXXXXXXXXXXXGOOOXXXXXXXXXXXXXXXXGOOXXXXXXXXXXXXXXXXXGOOOOOXXXXXXXXXXXXXXGOOOOOOOXXXXXXXXXXXXGOXXXXXXXXXXXXXXXXXX,0,0,0
11571,62,0,62,64,474,0,0,175,39,136,GOOOOOOXXXXXXXXXXXXXGOOOOXXXXXXXXXXXXXXXGOOXXXXXXXXXXXXXXXXXGOOXXXXXXXXXXXXXXXXXGOOOOOXXXXXXXXXXXXXXGOOOOOOXXXXXXXXXXXXXGOOOOXXXXXXXXXXXXXXXGOOXXXXXXXXXXXXXXXXXGOOOXXXXXXXXXXXXXXXXGOOXXXXXXXXXXXXXXXXXGOOOOOXXXXXXXXXXXXXXGOOOOOOOXXXXXXXXXXXXGOXXXXXXXXXXXXXXXXXX,0,0,0
11592,62,0,62,64,474,0,0,175,45,130,GOOOOOOXXXXXXXXXXXXXGOOOOXXXXXXXXXXXXXXXGOOXXXXXXXXXXXXXXXXXGOOXXXXXXXXXXXXXXXXXGOOOOOXXXXXXXXXXXXXXGOOOOOOXXXXXXXXXXXXXGOOOOXXXXXXXXXXXXXXXGOOXXXXXXXXXXXXXXXXXGOOOXXXXXXXXXXXXXXXXGOOXXXXXXXXXXXXXXXXXGOOOOOXXXXXXXXXXXXXXGOOOOOOOXXXXXXXXXXXXGOXXXXXXXXXXXXXXXXXX,0,0,0
11613,63,1,62,64,473,0,0,172,39,133,GOOOOOOXXXXXXXXXXXXXGOOOOAXXXXXXXXXXXXXXGOOXXXXXXXXXXXXXXXXXGOOXXXXXXXXXXXXXXXXXGOOOOOXXXXXXXXXXXXXXGOOOOOOXXXXXXXXXXXXXGOOOOXXXXXXXXXXXXXXXGOOXXXXXXXXXXXXXXXXXGOOOXXXXXXXXXXXXXXXXGOOXXXXXXXXXXXXXXXXXGOOOOOXXXXXXXXXXXXXXGOOOOOOOXXXXXXXXXXXXGOXXXXXXXXXXXXXXXXXX,0,0,0
11634,63,1,62,65,472,0,0,173,42,131,GOOOOOOXXXXXXXXXXXXXGOOOOAXXXXXXXXXXXXXXGOOXXXXXXXXXXXXXXXXXGOOXXXXXXXXXXXXXXXXXGOOOOOXXXXXXXXXXXXXXGOOOOOOXXXXXXXXXXXXXGOOOOXXXXXXXXXXXXXXXGOOXXXXXXXXXXXXXXXXXGOOOXXXXXXXXXXXXXXXXGOOXXXXXXXXXXXXXXXXXGOOOOOXXXXXXXXXXXXXXGOOOOOOOXXXXXXXXXXXXGOXXXXXXXXXXXXXXXXXX,0,0,0

11655,63,1,62,65,472,0,0,172,42,130,GOOOOOOXXXXXXXXXXXXXGOOOOAXXXXXXXXXXXXXXGOOXXXXXXXXXXXXXXXXXGOOXXXXXXXXXXXXXXXXXGOOOOOXXXXXXXXXXXXXXGOOOOOOXXXXXXXXXXXXXGOOOOXXXXXXXXXXXXXXXGOOXXXXXXXXXXXXXXXXXGOOOXXXXXXXXXXXXXXXXGOOXXXXXXXXXXXXXXXXXGOOOOOXXXXXXXXXXXXXXGOOOOOOOXXXXXXXXXXXXGOXXXXXXXXXXXXXXXXXX,0,0,0
11676,63,0,63,66,471,0,0,171,45,126,GOOOOOOXXXXXXXXXXXXXGOOOOOXXXXXXXXXXXXXXGOOXXXXXXXXXXXXXXXXXGOOXXXXXXXXXXXXXXXXXGOOOOOXXXXXXXXXXXXXXGOOOOOOXXXXXXXXXXXXXGOOOOXXXXXXXXXXXXXXXGOOXXXXXXXXXXXXXXXXXGOOOXXXXXXXXXXXXXXXXGOOXXXXXXXXXXXXXXXXXGOOOOOXXXXXXXXXXXXXXGOOOOOOOXXXXXXXXXXXXGOXXXXXXXXXXXXXXXXXX,0,0,0
11697,63,0,63,66,471,0,0,170,43,127,GOOOOOOXXXXXXXXXXXXXGOOOOOXXXXXXXXXXXXXXGOOXXXXXXXXXXXXXXXXXGOOXXXXXXXXXXXXXXXXXGOOOOOXXXXXXXXXXXXXXGOOOOOOXXXXXXXXXXXXXGOOOOXXXXXXXXXXXXXXXGOOXXXXXXXXXXXXXXXXXGOOOXXXXXXXXXXXXXXXXGOOXXXXXXXXXXXXXXXXXGOOOOOXXXXXXXXXXXXXXGOOOOOOOXXXXXXXXXXXXGOXXXXXXXXXXXXXXXXXX,0,0,0
11718,63,0,63,63,474,0,0,174,44,130,GOOOOOOXXXXXXXXXXXXXGOOOOOXXXXXXXXXXXXXXGOOXXXXXXXXXXXXXXXXXGOOXXXXXXXXXXXXXXXXXGOOOOOXXXXXXXXXXXXXXGOOOOOOXXXXXXXXXXXXXGOOOOXXXXXXXXXXXXXXXGOOXXXXXXXXXXXXXXXXXGOOOXXXXXXXXXXXXXXXXGOOXXXXXXXXXXXXXXXXXGOOOOOXXXXXXXXXXXXXXGOOOOOOOXXXXXXXXXXXXGOXXXXXXXXXXXXXXXXXX,0,0,0
11739,64,1,63,62,474,0,0,175,44,131,GOOOOOOXXXXXXXXXXXXXGOOOOOXXXXXXXXXXXXXXGOOXXXXXXXXXXXXXXXXXGOOXXXXXXXXXXXXXXXXXGOOOOOXXXXXXXXXXXXXXGOOOOOOXXXXXXXXXXXXXGOOOOXXXXXXXXXXXXXXXGOOXXXXXXXXXXXXXXXXXGOOOAXXXXXXXXXXXXXXXGOOXXXXXXXXXXXXXXXXXGOOOOOXXXXXXXXXXXXXXGOOOOOOOXXXXXXXXXXXXGOXXXXXXXXXXXXXXXXXX,0,0,0

11760,64,1,63,59,477,0,0,178,43,135,GOOOOOOXXXXXXXXXXXXXGOOOOOXXXXXXXXXXXXXXGOOXXXXXXXXXXXXXXXXXGOOXXXXXXXXXXXXXXXXXGOOOOOXXXXXXXXXXXXXXGOOOOOOXXXXXXXXXXXXXGOOOOXXXXXXXXXXXXXXXGOOXXXXXXXXXXXXXXXXXGOOOAXXXXXXXXXXXXXXXGOOXXXXXXXXXXXXXXXXXGOOOOOXXXXXXXXXXXXXXGOOOOOOOXXXXXXXXXXXXGOXXXXXXXXXXXXXXXXXX,0,0,0
11781,64,1,63,58,478,0,0,179,46,133,GOOOOOOXXXXXXXXXXXXXGOOOOOXXXXXXXXXXXXXXGOOXXXXXXXXXXXXXXXXXGOOXXXXXXXXXXXXXXXXXGOOOOOXXXXXXXXXXXXXXGOOOOOOXXXXXXXXXXXXXGOOOOXXXXXXXXXXXXXXXGOOXXXXXXXXXXXXXXXXXGOOOAXXXXXXXXXXXXXXXGOOXXXXXXXXXXXXXXXXXGOOOOOXXXXXXXXXXXXXXGOOOOOOOXXXXXXXXXXXXGOXXXXXXXXXXXXXXXXXX,0,0,0
11802,64,1,63,58,478,0,0,179,45,134,GOOOOOOXXXXXXXXXXXXXGOOOOOXXXXXXXXXXXXXXGOOXXXXXXXXXXXXXXXXXGOOXXXXXXXXXXXXXXXXXGOOOOOXXXXXXXXXXXXXXGOOOOOOXXXXXXXXXXXXXGOOOOXXXXXXXXXXXXXXXGOOXXXXXXXXXXXXXXXXXGOOOAXXXXXXXXXXXXXXXGOOXXXXXXXXXXXXXXXXXGOOOOOXXXXXXXXXXXXXXGOOOOOOOXXXXXXXXXXXXGOXXXXXXXXXXXXXXXXXX,0,0,0
11823,64,1,63,63,473,0,0,175,42,133,GOOOOOOXXXXXXXXXXXXXGOOOOOXXXXXXXXXXXXXXGOOXXXXXXXXXXXXXXXXXGOOXXXXXXXXXXXXXXXXXGOOOOOXXXXXXXXXXXXXXGOOOOOOXXXXXXXXXXXXXGOOOOXXXXXXXXXXXXXXXGOOXXXXXXXXXXXXXXXXXGOOOAXXXXXXXXXXXXXXXGOOXXXXXXXXXXXXXXXXXGOOOOOXXXXXXXXXXXXXXGOOOOOOOXXXXXXXXXXXXGOXXXXXXXXXXXXXXXXXX,0,0,0
11844,64,1,63,65,471,0,0,174,41,133,GOOOOOOXXXXXXXXXXXXXGOOOOOXXXXXXXXXXXXXXGOOXXXXXXXXXXXXXXXXXGOOXXXXXXXXXXXXXXXXXGOOOOOXXXXXXXXXXXXXXGOOOOOOXXXXXXXXXXXXXGOOOOXXXXXXXXXXXXXXXGOOXXXXXXXXXXXXXXXXXGOOOAXXXXXXXXXXXXXXXGOOXXXXXXXXXXXXXXXXXGOOOOOXXXXXXXXXXXXXXGOOOOOOOXXXXXXXXXXXXGOXXXXXXXXXXXXXXXXXX,0,0,0

11865,64,1,63,69,467,0,0,170,41,129,GOOOOOOXXXXXXXXXXXXXGOOOOOXXXXXXXXXXXXXXGOOXXXXXXXXXXXXXXXXXGOOXXXXXXXXXXXXXXXXXGOOOOOXXXXXXXXXXXXXXGOOOOOOXXXXXXXXXXXXXGOOOOXXXXXXXXXXXXXXXGOOXXXXXXXXXXXXXXXXXGOOOAXXXXXXXXXXXXXXXGOOXXXXXXXXXXXXXXXXXGOOOOOXXXXXXXXXXXXXXGOOOOOOOXXXXXXXXXXXXGOXXXXXXXXXXXXXXXXXX,0,0,0
11886,64,1,63,72,464,0,0,167,39,128,GOOOOOOXXXXXXXXXXXXXGOOOOOXXXXXXXXXXXXXXGOOXXXXXXXXXXXXXXXXXGOOXXXXXXXXXXXXXXXXXGOOOOOXXXXXXXXXXXXXXGOOOOOOXXXXXXXXXXXXXGOOOOXXXXXXXXXXXXXXXGOOXXXXXXXXXXXXXXXXXGOOOAXXXXXXXXXXXXXXXGOOXXXXXXXXXXXXXXXXXGOOOOOXXXXXXXXXXXXXXGOOOOOOOXXXXXXXXXXXXGOXXXXXXXXXXXXXXXXXX,0,0,0
11907,65,2,63,70,465,0,0,168,42,126,GOOOOOOXXXXXXXXXXXXXGOOOOOXXXXXXXXXXXXXXGOOXXXXXXXXXXXXXXXXXGOOXXXXXXXXXXXXXXXXXGOOOOOXXXXXXXXXXXXXXGOOOOOOXXXXXXXXXXXXXGOOOOAXXXXXXXXXXXXXXGOOXXXXXXXXXXXXXXXXXGOOOAXXXXXXXXXXXXXXXGOOXXXXXXXXXXXXXXXXXGOOOOOXXXXXXXXXXXXXXGOOOOOOOXXXXXXXXXXXXGOXXXXXXXXXXXXXXXXXX,0,0,0
11928,65,2,63,72,463,0,0,167,41,126,GOOOOOOXXXXXXXXXXXXXGOOOOOXXXXXXXXXXXXXXGOOXXXXXXXXXXXXXXXXXGOOXXXXXXXXXXXXXXXXXGOOOOOXXXXXXXXXXXXXXGOOOOOOXXXXXXXXXXXXXGOOOOAXXXXXXXXXXXXXXGOOXXXXXXXXXXXXXXXXXGOOOAXXXXXXXXXXXXXXXGOOXXXXXXXXXXXXXXXXXGOOOOOXXXXXXXXXXXXXXGOOOOOOOXXXXXXXXXXXXGOXXXXXXXXXXXXXXXXXX,0,0,0
11949,66,3,63,75,459,0,0,161,42,119,GOOOOOOXXXXXXXXXXXXXGOOOOOXXXXXXXXXXXXXXGOOXXXXXXXXXXXXXXXXXGOOXXXXXXXXXXXXXXXXXGOOOOOXXXXXXXXXXXXXXGOOOOOOXXXXXXXXXXXXXGOOOOAXXXXXXXXXXXXXXGOOXXXXXXXXXXXXXXXXXGOOOAXXXXXXXXXXXXXXXGOOXXXXXXXXXXXXXXXXXGOOOOOAXXXXXXXXXXXXXGOOOOOOOXXXXXXXXXXXXGOXXXXXXXXXXXXXXXXXX,0,0,0

11970,66,3,63,78,456,0,0,159,43,116,GOOOOOOXXXXXXXXXXXXXGOOOOOXXXXXXXXXXXXXXGOOXXXXXXXXXXXXXXXXXGOOXXXXXXXXXXXXXXXXXGOOOOOXXXXXXXXXXXXXXGOOOOOOXXXXXXXXXXXXXGOOOOAXXXXXXXXXXXXXXGOOXXXXXXXXXXXXXXXXXGOOOAXXXXXXXXXXXXXXXGOOXXXXXXXXXXXXXXXXXGOOOOOAXXXXXXXXXXXXXGOOOOOOOXXXXXXXXXXXXGOXXXXXXXXXXXXXXXXXX,0,0,0
11991,66,3,63,83,451,0,0,154,42,112,GOOOOOOXXXXXXXXXXXXXGOOOOOXXXXXXXXXXXXXXGOOXXXXXXXXXXXXXXXXXGOOXXXXXXXXXXXXXXXXXGOOOOOXXXXXXXXXXXXXXGOOOOOOXXXXXXXXXXXXXGOOOOAXXXXXXXXXXXXXXGOOXXXXXXXXXXXXXXXXXGOOOAXXXXXXXXXXXXXXXGOOXXXXXXXXXXXXXXXXXGOOOOOAXXXXXXXXXXXXXGOOOOOOOXXXXXXXXXXXXGOXXXXXXXXXXXXXXXXXX,0,0,0
12012,66,3,63,83,451,0,0,155,43,112,GOOOOOOXXXXXXXXXXXXXGOOOOOXXXXXXXXXXXXXXGOOXXXXXXXXXXXXXXXXXGOOXXXXXXXXXXXXXXXXXGOOOOOXXXXXXXXXXXXXXGOOOOOOXXXXXXXXXXXXXGOOOOAXXXXXXXXXXXXXXGOOXXXXXXXXXXXXXXXXXGOOOAXXXXXXXXXXXXXXXGOOXXXXXXXXXXXXXXXXXGOOOOOAXXXXXXXXXXXXXGOOOOOOOXXXXXXXXXXXXGOXXXXXXXXXXXXXXXXXX,0,0,0
12033,66,3,63,87,447,0,0,151,39,112,GOOOOOOXXXXXXXXXXXXXGOOOOOXXXXXXXXXXXXXXGOOXXXXXXXXXXXXXXXXXGOOXXXXXXXXXXXXXXXXXGOOOOOXXXXXXXXXXXXXXGOOOOOOXXXXXXXXXXXXXGOOOOAXXXXXXXXXXXXXXGOOXXXXXXXXXXXXXXXXXGOOOAXXXXXXXXXXXXXXXGOOXXXXXXXXXXXXXXXXXGOOOOOAXXXXXXXXXXXXXGOOOOOOOXXXXXXXXXXXXGOXXXXXXXXXXXXXXXXXX,0,0,0
12054,66,2,64,82,452,0,0,156,41,115,GOOOOOOXXXXXXXXXXXXXGOOOOOXXXXXXXXXXXXXXGOOXXXXXXXXXXXXXXXXXGOOXXXXXXXXXXXXXXXXXGOOOOOXXXXXXXXXXXXXXGOOOOOOXXXXXXXXXXXXXGOOOOOXXXXXXXXXXXXXXGOOXXXXXXXXXXXXXXXXXGOOOAXXXXXXXXXXXXXXXGOOXXXXXXXXXXXXXXXXXGOOOOOAXXXXXXXXXXXXXGOOOOOOOXXXXXXXXXXXXGOXXXXXXXXXXXXXXXXXX,0,0,0

12075,67,3,64,80,453,0,0,155,41,114,GOOOOOOXXXXXXXXXXXXXGOOOOOXXXXXXXXXXXXXXGOOXXXXXXXXXXXXXXXXXGOOAXXXXXXXXXXXXXXXXGOOOOOXXXXXXXXXXXXXXGOOOOOOXXXXXXXXXXXXXGOOOOOXXXXXXXXXXXXXXGOOXXXXXXXXXXXXXXXXXGOOOAXXXXXXXXXXXXXXXGOOXXXXXXXXXXXXXXXXXGOOOOOAXXXXXXXXXXXXXGOOOOOOOXXXXXXXXXXXXGOXXXXXXXXXXXXXXXXXX,0,0,0
12096,67,3,64,81,452,0,0,156,42,114,GOOOOOOXXXXXXXXXXXXXGOOOOOXXXXXXXXXXXXXXGOOXXXXXXXXXXXXXXXXXGOOAXXXXXXXXXXXXXXXXGOOOOOXXXXXXXXXXXXXXGOOOOOOXXXXXXXXXXXXXGOOOOOXXXXXXXXXXXXXXGOOXXXXXXXXXXXXXXXXXGOOOAXXXXXXXXXXXXXXXGOOXXXXXXXXXXXXXXXXXGOOOOOAXXXXXXXXXXXXXGOOOOOOOXXXXXXXXXXXXGOXXXXXXXXXXXXXXXXXX,0,0,0
12117,67,2,65,80,453,0,0,155,41,114,GOOOOOOXXXXXXXXXXXXXGOOOOOXXXXXXXXXXXXXXGOOXXXXXXXXXXXXXXXXXGOOAXXXXXXXXXXXXXXXXGOOOOOXXXXXXXXXXXXXXGOOOOOOXXXXXXXXXXXXXGOOOOOXXXXXXXXXXXXXXGOOXXXXXXXXXXXXXXXXXGOOOAXXXXXXXXXXXXXXXGOOXXXXXXXXXXXXXXXXXGOOOOOOXXXXXXXXXXXXXGOOOOOOOXXXXXXXXXXXXGOXXXXXXXXXXXXXXXXXX,0,0,0
12138,67,1,66,82,451,0,0,154,37,117,GOOOOOOXXXXXXXXXXXXXGOOOOOXXXXXXXXXXXXXXGOOXXXXXXXXXXXXXXXXXGOOAXXXXXXXXXXXXXXXXGOOOOOXXXXXXXXXXXXXXGOOOOOOXXXXXXXXXXXXXGOOOOOXXXXXXXXXXXXXXGOOXXXXXXXXXXXXXXXXXGOOOOXXXXXXXXXXXXXXXGOOXXXXXXXXXXXXXXXXXGOOOOOOXXXXXXXXXXXXXGOOOOOOOXXXXXXXXXXXXGOXXXXXXXXXXXXXXXXXX,0,0,0
12159,67,1,66,80,453,0,0,155,40,115,GOOOOOOXXXXXXXXXXXXXGOOOOOXXXXXXXXXXXXXXGOOXXXXXXXXXXXXXXXXXGOOAXXXXXXXXXXXXXXXXGOOOOOXXXXXXXXXXXXXXGOOOOOOXXXXXXXXXXXXXGOOOOOXXXXXXXXXXXXXXGOOXXXXXXXXXXXXXXXXXGOOOOXXXXXXXXXXXXXXXGOOXXXXXXXXXXXXXXXXXGOOOOOOXXXXXXXXXXXXXGOOOOOOOXXXXXXXXXXXXGOXXXXXXXXXXXXXXXXXX,0,0,0

12180,68,1,67,76,456,0,0,157,43,114,GOOOOOOXXXXXXXXXXXXXGOOOOOXXXXXXXXXXXXXXGOOXXXXXXXXXXXXXXXXXGOOOXXXXXXXXXXXXXXXXGOOOOOXXXXXXXXXXXXXXGOOOOOOXXXXXXXXXXXXXGOOOOOXXXXXXXXXXXXXXGOOXXXXXXXXXXXXXXXXXGOOOOXXXXXXXXXXXXXXXGOOXXXXXXXXXXXXXXXXXGOOOOOOAXXXXXXXXXXXXGOOOOOOOXXXXXXXXXXXXGOXXXXXXXXXXXXXXXXXX,0,0,0
12201,68,1,67,75,457,0,0,159,45,114,GOOOOOOXXXXXXXXXXXXXGOOOOOXXXXXXXXXXXXXXGOOXXXXXXXXXXXXXXXXXGOOOXXXXXXXXXXXXXXXXGOOOOOXXXXXXXXXXXXXXGOOOOOOXXXXXXXXXXXXXGOOOOOXXXXXXXXXXXXXXGOOXXXXXXXXXXXXXXXXXGOOOOXXXXXXXXXXXXXXXGOOXXXXXXXXXXXXXXXXXGOOOOOOAXXXXXXXXXXXXGOOOOOOOXXXXXXXXXXXXGOXXXXXXXXXXXXXXXXXX,0,0,0
12222,68,1,67,71,461,0,0,163,44,119,GOOOOOOXXXXXXXXXXXXXGOOOOOXXXXXXXXXXXXXXGOOXXXXXXXXXXXXXXXXXGOOOXXXXXXXXXXXXXXXXGOOOOOXXXXXXXXXXXXXXGOOOOOOXXXXXXXXXXXXXGOOOOOXXXXXXXXXXXXXXGOOXXXXXXXXXXXXXXXXXGOOOOXXXXXXXXXXXXXXXGOOXXXXXXXXXXXXXXXXXGOOOOOOAXXXXXXXXXXXXGOOOOOOOXXXXXXXXXXXXGOXXXXXXXXXXXXXXXXXX,0,0,0
12243,68,1,67,68,464,0,0,165,43,122,GOOOOOOXXXXXXXXXXXXXGOOOOOXXXXXXXXXXXXXXGOOXXXXXXXXXXXXXXXXXGOOOXXXXXXXXXXXXXXXXGOOOOOXXXXXXXXXXXXXXGOOOOOOXXXXXXXXXXXXXGOOOOOXXXXXXXXXXXXXXGOOXXXXXXXXXXXXXXXXXGOOOOXXXXXXXXXXXXXXXGOOXXXXXXXXXXXXXXXXXGOOOOOOAXXXXXXXXXXXXGOOOOOOOXXXXXXXXXXXXGOXXXXXXXXXXXXXXXXXX,0,0,0
12264,69,1,68,67,464,0,0,166,45,121,GOOOOOOXXXXXXXXXXXXXGOOOOOXXXXXXXXXXXXXXGOOXXXXXXXXXXXXXXXXXGOOOOXXXXXXXXXXXXXXXGOOOOOXXXXXXXXXXXXXXGOOOOOOXXXXXXXXXXXXXGOOOOOXXXXXXXXXXXXXXGOOXXXXXXXXXXXXXXXXXGOOOOXXXXXXXXXXXXXXXGOOXXXXXXXXXXXXXXXXXGOOOOOOAXXXXXXXXXXXXGOOOOOOOXXXXXXXXXXXXGOXXXXXXXXXXXXXXXXXX,0,0,0

12285,69,1,68,69,462,0,0,165,41,124,GOOOOOOXXXXXXXXXXXXXGOOOOOXXXXXXXXXXXXXXGOOXXXXXXXXXXXXXXXXXGOOOOXXXXXXXXXXXXXXXGOOOOOXXXXXXXXXXXXXXGOOOOOOXXXXXXXXXXXXXGOOOOOXXXXXXXXXXXXXXGOOXXXXXXXXXXXXXXXXXGOOOOXXXXXXXXXXXXXXXGOOXXXXXXXXXXXXXXXXXGOOOOOOAXXXXXXXXXXXXGOOOOOOOXXXXXXXXXXXXGOXXXXXXXXXXXXXXXXXX,0,0,0
12306,69,1,68,69,462,0,0,165,42,123,GOOOOOOXXXXXXXXXXXXXGOOOOOXXXXXXXXXXXXXXGOOXXXXXXXXXXXXXXXXXGOOOOXXXXXXXXXXXXXXXGOOOOOXXXXXXXXXXXXXXGOOOOOOXXXXXXXXXXXXXGOOOOOXXXXXXXXXXXXXXGOOXXXXXXXXXXXXXXXXXGOOOOXXXXXXXXXXXXXXXGOOXXXXXXXXXXXXXXXXXGOOOOOOAXXXXXXXXXXXXGOOOOOOOXXXXXXXXXXXXGOXXXXXXXXXXXXXXXXXX,0,0,0
12327,69,0,69,63,468,0,0,171,42,129,GOOOOOOXXXXXXXXXXXXXGOOOOOXXXXXXXXXXXXXXGOOXXXXXXXXXXXXXXXXXGOOOOXXXXXXXXXXXXXXXGOOOOOXXXXXXXXXXXXXXGOOOOOOXXXXXXXXXXXXXGOOOOOXXXXXXXXXXXXXXGOOXXXXXXXXXXXXXXXXXGOOOOXXXXXXXXXXXXXXXGOOXXXXXXXXXXXXXXXXXGOOOOOOOXXXXXXXXXXXXGOOOOOOOXXXXXXXXXXXXGOXXXXXXXXXXXXXXXXXX,0,0,0
12348,69,0,69,66,465,0,0,167,40,127,GOOOOOOXXXXXXXXXXXXXGOOOOOXXXXXXXXXXXXXXGOOXXXXXXXXXXXXXXXXXGOOOOXXXXXXXXXXXXXXXGOOOOOXXXXXXXXXXXXXXGOOOOOOXXXXXXXXXXXXXGOOOOOXXXXXXXXXXXXXXGOOXXXXXXXXXXXXXXXXXGOOOOXXXXXXXXXXXXXXXGOOXXXXXXXXXXXXXXXXXGOOOOOOOXXXXXXXXXXXXGOOOOOOOXXXXXXXXXXXXGOXXXXXXXXXXXXXXXXXX,0,0,0
12369,69,0,69,61,470,0,0,173,41,132,GOOOOOOXXXXXXXXXXXXXGOOOOOXXXXXXXXXXXXXXGOOXXXXXXXXXXXXXXXXXGOOOOXXXXXXXXXXXXXXXGOOOOOXXXXXXXXXXXXXXGOOOOOOXXXXXXXXXXXXXGOOOOOXXXXXXXXXXXXXXGOOXXXXXXXXXXXXXXXXXGOOOOXXXXXXXXXXXXXXXGOOXXXXXXXXXXXXXXXXXGOOOOOOOXXXXXXXXXXXXGOOOOOOOXXXXXXXXXXXXGOXXXXXXXXXXXXXXXXXX,0,0,0

12390,69,0,69,64,467,0,0,170,43,127,GOOOOOOXXXXXXXXXXXXXGOOOOOXXXXXXXXXXXXXXGOOXXXXXXXXXXXXXXXXXGOOOOXXXXXXXXXXXXXXXGOOOOOXXXXXXXXXXXXXXGOOOOOOXXXXXXXXXXXXXGOOOOOXXXXXXXXXXXXXXGOOXXXXXXXXXXXXXXXXXGOOOOXXXXXXXXXXXXXXXGOOXXXXXXXXXXXXXXXXXGOOOOOOOXXXXXXXXXXXXGOOOOOOOXXXXXXXXXXXXGOXXXXXXXXXXXXXXXXXX,0,0,0
12411,69,0,69,57,474,0,0,179,41,138,GOOOOOOXXXXXXXXXXXXXGOOOOOXXXXXXXXXXXXXXGOOXXXXXXXXXXXXXXXXXGOOOOXXXXXXXXXXXXXXXGOOOOOXXXXXXXXXXXXXXGOOOOOOXXXXXXXXXXXXXGOOOOOXXXXXXXXXXXXXXGOOXXXXXXXXXXXXXXXXXGOOOOXXXXXXXXXXXXXXXGOOXXXXXXXXXXXXXXXXXGOOOOOOOXXXXXXXXXXXXGOOOOOOOXXXXXXXXXXXXGOXXXXXXXXXXXXXXXXXX,0,0,0
12432,69,0,69,55,476,0,0,180,43,137,GOOOOOOXXXXXXXXXXXXXGOOOOOXXXXXXXXXXXXXXGOOXXXXXXXXXXXXXXXXXGOOOOXXXXXXXXXXXXXXXGOOOOOXXXXXXXXXXXXXXGOOOOOOXXXXXXXXXXXXXGOOOOOXXXXXXXXXXXXXXGOOXXXXXXXXXXXXXXXXXGOOOOXXXXXXXXXXXXXXXGOOXXXXXXXXXXXXXXXXXGOOOOOOOXXXXXXXXXXXXGOOOOOOOXXXXXXXXXXXXGOXXXXXXXXXXXXXXXXXX,0,0,0
12453,69,0,69,54,477,0,0,182,41,141,GOOOOOOXXXXXXXXXXXXXGOOOOOXXXXXXXXXXXXXXGOOXXXXXXXXXXXXXXXXXGOOOOXXXXXXXXXXXXXXXGOOOOOXXXXXXXXXXXXXXGOOOOOOXXXXXXXXXXXXXGOOOOOXXXXXXXXXXXXXXGOOXXXXXXXXXXXXXXXXXGOOOOXXXXXXXXXXXXXXXGOOXXXXXXXXXXXXXXXXXGOOOOOOOXXXXXXXXXXXXGOOOOOOOXXXXXXXXXXXXGOXXXXXXXXXXXXXXXXXX,0,0,0
12474,69,0,69,56,475,0,0,179,43,136,GOOOOOOXXXXXXXXXXXXXGOOOOOXXXXXXXXXXXXXXGOOXXXXXXXXXXXXXXXXXGOOOOXXXXXXXXXXXXXXXGOOOOOXXXXXXXXXXXXXXGOOOOOOXXXXXXXXXXXXXGOOOOOXXXXXXXXXXXXXXGOOXXXXXXXXXXXXXXXXXGOOOOXXXXXXXXXXXXXXXGOOXXXXXXXXXXXXXXXXXGOOOOOOOXXXXXXXXXXXXGOOOOOOOXXXXXXXXXXXXGOXXXXXXXXXXXXXXXXXX,0,0,0

12495,69,0,69,60,471,0,0,175,47,128,GOOOOOOXXXXXXXXXXXXXGOOOOOXXXXXXXXXXXXXXGOOXXXXXXXXXXXXXXXXXGOOOOXXXXXXXXXXXXXXXGOOOOOXXXXXXXXXXXXXXGOOOOOOXXXXXXXXXXXXXGOOOOOXXXXXXXXXXXXXXGOOXXXXXXXXXXXXXXXXXGOOOOXXXXXXXXXXXXXXXGOOXXXXXXXXXXXXXXXXXGOOOOOOOXXXXXXXXXXXXGOOOOOOOXXXXXXXXXXXXGOXXXXXXXXXXXXXXXXXX,0,0,0
12516,69,0,69,61,470,0,0,174,44,130,GOOOOOOXXXXXXXXXXXXXGOOOOOXXXXXXXXXXXXXXGOOXXXXXXXXXXXXXXXXXGOOOOXXXXXXXXXXXXXXXGOOOOOXXXXXXXXXXXXXXGOOOOOOXXXXXXXXXXXXXGOOOOOXXXXXXXXXXXXXXGOOXXXXXXXXXXXXXXXXXGOOOOXXXXXXXXXXXXXXXGOOXXXXXXXXXXXXXXXXXGOOOOOOOXXXXXXXXXXXXGOOOOOOOXXXXXXXXXXXXGOXXXXXXXXXXXXXXXXXX,0,0,0
12537,69,0,69,64,467,0,0,173,44,129,GOOOOOOXXXXXXXXXXXXXGOOOOOXXXXXXXXXXXXXXGOOXXXXXXXXXXXXXXXXXGOOOOXXXXXXXXXXXXXXXGOOOOOXXXXXXXXXXXXXXGOOOOOOXXXXXXXXXXXXXGOOOOOXXXXXXXXXXXXXXGOOXXXXXXXXXXXXXXXXXGOOOOXXXXXXXXXXXXXXXGOOXXXXXXXXXXXXXXXXXGOOOOOOOXXXXXXXXXXXXGOOOOOOOXXXXXXXXXXXXGOXXXXXXXXXXXXXXXXXX,0,0,0
12558,69,0,69,64,467,0,0,173,42,131,GOOOOOOXXXXXXXXXXXXXGOOOOOXXXXXXXXXXXXXXGOOXXXXXXXXXXXXXXXXXGOOOOXXXXXXXXXXXXXXXGOOOOOXXXXXXXXXXXXXXGOOOOOOXXXXXXXXXXXXXGOOOOOXXXXXXXXXXXXXXGOOXXXXXXXXXXXXXXXXXGOOOOXXXXXXXXXXXXXXXGOOXXXXXXXXXXXXXXXXXGOOOOOOOXXXXXXXXXXXXGOOOOOOOXXXXXXXXXXXXGOXXXXXXXXXXXXXXXXXX,0,0,0
12579,69,0,69,73,458,0,0,162,46,116,GOOOOOOXXXXXXXXXXXXXGOOOOOXXXXXXXXXXXXXXGOOXXXXXXXXXXXXXXXXXGOOOOXXXXXXXXXXXXXXXGOOOOOXXXXXXXXXXXXXXGOOOOOOXXXXXXXXXXXXXGOOOOOXXXXXXXXXXXXXXGOOXXXXXXXXXXXXXXXXXGOOOOXXXXXXXXXXXXXXXGOOXXXXXXXXXXXXXXXXXGOOOOOOOXXXXXXXXXXXXGOOOOOOOXXXXXXXXXXXXGOXXXXXXXXXXXXXXXXXX,0,0,0

12600,69,0,69,74,457,0,0,161,46,115,GOOOOOOXXXXXXXXXXXXXGOOOOOXXXXXXXXXXXXXXGOOXXXXXXXXXXXXXXXXXGOOOOXXXXXXXXXXXXXXXGOOOOOXXXXXXXXXXXXXXGOOOOOOXXXXXXXXXXXXXGOOOOOXXXXXXXXXXXXXXGOOXXXXXXXXXXXXXXXXXGOOOOXXXXXXXXXXXXXXXGOOXXXXXXXXXXXXXXXXXGOOOOOOOXXXXXXXXXXXXGOOOOOOOXXXXXXXXXXXXGOXXXXXXXXXXXXXXXXXX,0,0,0
12621,69,0,69,79,452,0,0,156,41,115,GOOOOOOXXXXXXXXXXXXXGOOOOOXXXXXXXXXXXXXXGOOXXXXXXXXXXXXXXXXXGOOOOXXXXXXXXXXXXXXXGOOOOOXXXXXXXXXXXXXXGOOOOOOXXXXXXXXXXXXXGOOOOOXXXXXXXXXXXXXXGOOXXXXXXXXXXXXXXXXXGOOOOXXXXXXXXXXXXXXXGOOXXXXXXXXXXXXXXXXXGOOOOOOOXXXXXXXXXXXXGOOOOOOOXXXXXXXXXXXXGOXXXXXXXXXXXXXXXXXX,0,0,0
12642,69,0,69,72,459,0,0,163,44,119,GOOOOOOXXXXXXXXXXXXXGOOOOOXXXXXXXXXXXXXXGOOXXXXXXXXXXXXXXXXXGOOOOXXXXXXXXXXXXXXXGOOOOOXXXXXXXXXXXXXXGOOOOOOXXXXXXXXXXXXXGOOOOOXXXXXXXXXXXXXXGOOXXXXXXXXXXXXXXXXXGOOOOXXXXXXXXXXXXXXXGOOXXXXXXXXXXXXXXXXXGOOOOOOOXXXXXXXXXXXXGOOOOOOOXXXXXXXXXXXXGOXXXXXXXXXXXXXXXXXX,0,0,0
12663,69,0,69,74,457,0,0,162,43,119,GOOOOOOXXXXXXXXXXXXXGOOOOOXXXXXXXXXXXXXXGOOXXXXXXXXXXXXXXXXXGOOOOXXXXXXXXXXXXXXXGOOOOOXXXXXXXXXXXXXXGOOOOOOXXXXXXXXXXXXXGOOOOOXXXXXXXXXXXXXXGOOXXXXXXXXXXXXXXXXXGOOOOXXXXXXXXXXXXXXXGOOXXXXXXXXXXXXXXXXXGOOOOOOOXXXXXXXXXXXXGOOOOOOOXXXXXXXXXXXXGOXXXXXXXXXXXXXXXXXX,0,0,0
12684,69,0,69,79,452,0,0,155,44,111,GOOOOOOXXXXXXXXXXXXXGOOOOOXXXXXXXXXXXXXXGOOXXXXXXXXXXXXXXXXXGOOOOXXXXXXXXXXXXXXXGOOOOOXXXXXXXXXXXXXXGOOOOOOXXXXXXXXXXXXXGOOOOOXXXXXXXXXXXXXXGOOXXXXXXXXXXXXXXXXXGOOOOXXXXXXXXXXXXXXXGOOXXXXXXXXXXXXXXXXXGOOOOOOOXXXXXXXXXXXXGOOOOOOOXXXXXXXXXXXXGOXXXXXXXXXXXXXXXXXX,0,0,0

12705,69,0,69,75,456,0,0,160,43,117,GOOOOOOXXXXXXXXXXXXXGOOOOOXXXXXXXXXXXXXXGOOXXXXXXXXXXXXXXXXXGOOOOXXXXXXXXXXXXXXXGOOOOOXXXXXXXXXXXXXXGOOOOOOXXXXXXXXXXXXXGOOOOOXXXXXXXXXXXXXXGOOXXXXXXXXXXXXXXXXXGOOOOXXXXXXXXXXXXXXXGOOXXXXXXXXXXXXXXXXXGOOOOOOOXXXXXXXXXXXXGOOOOOOOXXXXXXXXXXXXGOXXXXXXXXXXXXXXXXXX,0,0,0
12726,70,0,70,74,456,0,0,160,40,120,GOOOOOOXXXXXXXXXXXXXGOOOOOXXXXXXXXXXXXXXGOOXXXXXXXXXXXXXXXXXGOOOOXXXXXXXXXXXXXXXGOOOOOXXXXXXXXXXXXXXGOOOOOOXXXXXXXXXXXXXGOOOOOXXXXXXXXXXXXXXGOOXXXXXXXXXXXXXXXXXGOOOOOXXXXXXXXXXXXXXGOOXXXXXXXXXXXXXXXXXGOOOOOOOXXXXXXXXXXXXGOOOOOOOXXXXXXXXXXXXGOXXXXXXXXXXXXXXXXXX,0,0,0
12747,70,0,70,69,461,0,0,164,42,122,GOOOOOOXXXXXXXXXXXXXGOOOOOXXXXXXXXXXXXXXGOOXXXXXXXXXXXXXXXXXGOOOOXXXXXXXXXXXXXXXGOOOOOXXXXXXXXXXXXXXGOOOOOOXXXXXXXXXXXXXGOOOOOXXXXXXXXXXXXXXGOOXXXXXXXXXXXXXXXXXGOOOOOXXXXXXXXXXXXXXGOOXXXXXXXXXXXXXXXXXGOOOOOOOXXXXXXXXXXXXGOOOOOOOXXXXXXXXXXXXGOXXXXXXXXXXXXXXXXXX,0,0,0
12768,70,0,70,70,460,0,0,161,44,117,GOOOOOOXXXXXXXXXXXXXGOOOOOXXXXXXXXXXXXXXGOOXXXXXXXXXXXXXXXXXGOOOOXXXXXXXXXXXXXXXGOOOOOXXXXXXXXXXXXXXGOOOOOOXXXXXXXXXXXXXGOOOOOXXXXXXXXXXXXXXGOOXXXXXXXXXXXXXXXXXGOOOOOXXXXXXXXXXXXXXGOOXXXXXXXXXXXXXXXXXGOOOOOOOXXXXXXXXXXXXGOOOOOOOXXXXXXXXXXXXGOXXXXXXXXXXXXXXXXXX,0,0,0
12789,70,0,70,69,461,0,0,165,45,120,GOOOOOOXXXXXXXXXXXXXGOOOOOXXXXXXXXXXXXXXGOOXXXXXXXXXXXXXXXXXGOOOOXXXXXXXXXXXXXXXGOOOOOXXXXXXXXXXXXXXGOOOOOOXXXXXXXXXXXXXGOOOOOXXXXXXXXXXXXXXGOOXXXXXXXXXXXXXXXXXGOOOOOXXXXXXXXXXXXXXGOOXXXXXXXXXXXXXXXXXGOOOOOOOXXXXXXXXXXXXGOOOOOOOXXXXXXXXXXXXGOXXXXXXXXXXXXXXXXXX,0,0,0

12810,70,0,70,71,459,0,0,163,41,122,GOOOOOOXXXXXXXXXXXXXGOOOOOXXXXXXXXXXXXXXGOOXXXXXXXXXXXXXXXXXGOOOOXXXXXXXXXXXXXXXGOOOOOXXXXXXXXXXXXXXGOOOOOOXXXXXXXXXXXXXGOOOOOXXXXXXXXXXXXXXGOOXXXXXXXXXXXXXXXXXGOOOOOXXXXXXXXXXXXXXGOOXXXXXXXXXXXXXXXXXGOOOOOOOXXXXXXXXXXXXGOOOOOOOXXXXXXXXXXXXGOXXXXXXXXXXXXXXXXXX,0,0,0
12831,70,0,70,68,462,0,0,166,43,123,GOOOOOOXXXXXXXXXXXXXGOOOOOXXXXXXXXXXXXXXGOOXXXXXXXXXXXXXXXXXGOOOOXXXXXXXXXXXXXXXGOOOOOXXXXXXXXXXXXXXGOOOOOOXXXXXXXXXXXXXGOOOOOXXXXXXXXXXXXXXGOOXXXXXXXXXXXXXXXXXGOOOOOXXXXXXXXXXXXXXGOOXXXXXXXXXXXXXXXXXGOOOOOOOXXXXXXXXXXXXGOOOOOOOXXXXXXXXXXXXGOXXXXXXXXXXXXXXXXXX,0,0,0
12852,70,0,70,71,459,0,0,163,43,120,GOOOOOOXXXXXXXXXXXXXGOOOOOXXXXXXXXXXXXXXGOOXXXXXXXXXXXXXXXXXGOOOOXXXXXXXXXXXXXXXGOOOOOXXXXXXXXXXXXXXGOOOOOOXXXXXXXXXXXXXGOOOOOXXXXXXXXXXXXXXGOOXXXXXXXXXXXXXXXXXGOOOOOXXXXXXXXXXXXXXGOOXXXXXXXXXXXXXXXXXGOOOOOOOXXXXXXXXXXXXGOOOOOOOXXXXXXXXXXXXGOXXXXXXXXXXXXXXXXXX,0,0,0
12873,70,0,70,71,459,0,0,162,42,120,GOOOOOOXXXXXXXXXXXXXGOOOOOXXXXXXXXXXXXXXGOOXXXXXXXXXXXXXXXXXGOOOOXXXXXXXXXXXXXXXGOOOOOXXXXXXXXXXXXXXGOOOOOOXXXXXXXXXXXXXGOOOOOXXXXXXXXXXXXXXGOOXXXXXXXXXXXXXXXXXGOOOOOXXXXXXXXXXXXXXGOOXXXXXXXXXXXXXXXXXGOOOOOOOXXXXXXXXXXXXGOOOOOOOXXXXXXXXXXXXGOXXXXXXXXXXXXXXXXXX,0,0,0
12894,70,0,70,70,460,0,0,164,44,120,GOOOOOOXXXXXXXXXXXXXGOOOOOXXXXXXXXXXXXXXGOOXXXXXXXXXXXXXXXXXGOOOOXXXXXXXXXXXXXXXGOOOOOXXXXXXXXXXXXXXGOOOOOOXXXXXXXXXXXXXGOOOOOXXXXXXXXXXXXXXGOOXXXXXXXXXXXXXXXXXGOOOOOXXXXXXXXXXXXXXGOOXXXXXXXXXXXXXXXXXGOOOOOOOXXXXXXXXXXXXGOOOOOOOXXXXXXXXXXXXGOXXXXXXXXXXXXXXXXXX,0,0,0

12915,70,0,70,68,462,0,0,166,43,123,GOOOOOOXXXXXXXXXXXXXGOOOOOXXXXXXXXXXXXXXGOOXXXXXXXXXXXXXXXXXGOOOOXXXXXXXXXXXXXXXGOOOOOXXXXXXXXXXXXXXGOOOOOOXXXXXXXXXXXXXGOOOOOXXXXXXXXXXXXXXGOOXXXXXXXXXXXXXXXXXGOOOOOXXXXXXXXXXXXXXGOOXXXXXXXXXXXXXXXXXGOOOOOOOXXXXXXXXXXXXGOOOOOOOXXXXXXXXXXXXGOXXXXXXXXXXXXXXXXXX,0,0,0
12936,70,0,70,64,466,0,0,170,40,130,GOOOOOOXXXXXXXXXXXXXGOOOOOXXXXXXXXXXXXXXGOOXXXXXXXXXXXXXXXXXGOOOOXXXXXXXXXXXXXXXGOOOOOXXXXXXXXXXXXXXGOOOOOOXXXXXXXXXXXXXGOOOOOXXXXXXXXXXXXXXGOOXXXXXXXXXXXXXXXXXGOOOOOXXXXXXXXXXXXXXGOOXXXXXXXXXXXXXXXXXGOOOOOOOXXXXXXXXXXXXGOOOOOOOXXXXXXXXXXXXGOXXXXXXXXXXXXXXXXXX,0,0,0
12957,70,0,70,59,471,0,0,174,41,133,GOOOOOOXXXXXXXXXXXXXGOOOOOXXXXXXXXXXXXXXGOOXXXXXXXXXXXXXXXXXGOOOOXXXXXXXXXXXXXXXGOOOOOXXXXXXXXXXXXXXGOOOOOOXXXXXXXXXXXXXGOOOOOXXXXXXXXXXXXXXGOOXXXXXXXXXXXXXXXXXGOOOOOXXXXXXXXXXXXXXGOOXXXXXXXXXXXXXXXXXGOOOOOOOXXXXXXXXXXXXGOOOOOOOXXXXXXXXXXXXGOXXXXXXXXXXXXXXXXXX,0,0,0
12978,70,0,70,64,466,0,0,169,43,126,GOOOOOOXXXXXXXXXXXXXGOOOOOXXXXXXXXXXXXXXGOOXXXXXXXXXXXXXXXXXGOOOOXXXXXXXXXXXXXXXGOOOOOXXXXXXXXXXXXXXGOOOOOOXXXXXXXXXXXXXGOOOOOXXXXXXXXXXXXXXGOOXXXXXXXXXXXXXXXXXGOOOOOXXXXXXXXXXXXXXGOOXXXXXXXXXXXXXXXXXGOOOOOOOXXXXXXXXXXXXGOOOOOOOXXXXXXXXXXXXGOXXXXXXXXXXXXXXXXXX,0,0,0
12999,70,0,70,65,465,0,0,169,40,129,GOOOOOOXXXXXXXXXXXXXGOOOOOXXXXXXXXXXXXXXGOOXXXXXXXXXXXXXXXXXGOOOOXXXXXXXXXXXXXXXGOOOOOXXXXXXXXXXXXXXGOOOOOOXXXXXXXXXXXXXGOOOOOXXXXXXXXXXXXXXGOOXXXXXXXXXXXXXXXXXGOOOOOXXXXXXXXXXXXXXGOOXXXXXXXXXXXXXXXXXGOOOOOOOXXXXXXXXXXXXGOOOOOOOXXXXXXXXXXXXGOXXXXXXXXXXXXXXXXXX,0,0,0

13020,70,0,70,62,468,0,0,172,42,130,GOOOOOOXXXXXXXXXXXXXGOOOOOXXXXXXXXXXXXXXGOOXXXXXXXXXXXXXXXXXGOOOOXXXXXXXXXXXXXXXGOOOOOXXXXXXXXXXXXXXGOOOOOOXXXXXXXXXXXXXGOOOOOXXXXXXXXXXXXXXGOOXXXXXXXXXXXXXXXXXGOOOOOXXXXXXXXXXXXXXGOOXXXXXXXXXXXXXXXXXGOOOOOOOXXXXXXXXXXXXGOOOOOOOXXXXXXXXXXXXGOXXXXXXXXXXXXXXXXXX,0,0,0
13041,70,0,70,61,469,0,0,173,52,121,GOOOOOOXXXXXXXXXXXXXGOOOOOXXXXXXXXXXXXXXGOOXXXXXXXXXXXXXXXXXGOOOOXXXXXXXXXXXXXXXGOOOOOXXXXXXXXXXXXXXGOOOOOOXXXXXXXXXXXXXGOOOOOXXXXXXXXXXXXXXGOOXXXXXXXXXXXXXXXXXGOOOOOXXXXXXXXXXXXXXGOOXXXXXXXXXXXXXXXXXGOOOOOOOXXXXXXXXXXXXGOOOOOOOXXXXXXXXXXXXGOXXXXXXXXXXXXXXXXXX,0,0,0
13062,70,0,70,64,466,0,0,170,45,125,GOOOOOOXXXXXXXXXXXXXGOOOOOXXXXXXXXXXXXXXGOOXXXXXXXXXXXXXXXXXGOOOOXXXXXXXXXXXXXXXGOOOOOXXXXXXXXXXXXXXGOOOOOOXXXXXXXXXXXXXGOOOOOXXXXXXXXXXXXXXGOOXXXXXXXXXXXXXXXXXGOOOOOXXXXXXXXXXXXXXGOOXXXXXXXXXXXXXXXXXGOOOOOOOXXXXXXXXXXXXGOOOOOOOXXXXXXXXXXXXGOXXXXXXXXXXXXXXXXXX,0,0,0
13083,70,0,70,60,470,0,0,174,42,132,GOOOOOOXXXXXXXXXXXXXGOOOOOXXXXXXXXXXXXXXGOOXXXXXXXXXXXXXXXXXGOOOOXXXXXXXXXXXXXXXGOOOOOXXXXXXXXXXXXXXGOOOOOOXXXXXXXXXXXXXGOOOOOXXXXXXXXXXXXXXGOOXXXXXXXXXXXXXXXXXGOOOOOXXXXXXXXXXXXXXGOOXXXXXXXXXXXXXXXXXGOOOOOOOXXXXXXXXXXXXGOOOOOOOXXXXXXXXXXXXGOXXXXXXXXXXXXXXXXXX,0,0,0
13104,70,0,70,59,471,0,0,175,45,130,GOOOOOOXXXXXXXXXXXXXGOOOOOXXXXXXXXXXXXXXGOOXXXXXXXXXXXXXXXXXGOOOOXXXXXXXXXXXXXXXGOOOOOXXXXXXXXXXXXXXGOOOOOOXXXXXXXXXXXXXGOOOOOXXXXXXXXXXXXXXGOOXXXXXXXXXXXXXXXXXGOOOOOXXXXXXXXXXXXXXGOOXXXXXXXXXXXXXXXXXGOOOOOOOXXXXXXXXXXXXGOOOOOOOXXXXXXXXXXXXGOXXXXXXXXXXXXXXXXXX,0,0,0

13125,70,0,70,57,473,0,0,177,51,126,GOOOOOOXXXXXXXXXXXXXGOOOOOXXXXXXXXXXXXXXGOOXXXXXXXXXXXXXXXXXGOOOOXXXXXXXXXXXXXXXGOOOOOXXXXXXXXXXXXXXGOOOOOOXXXXXXXXXXXXXGOOOOOXXXXXXXXXXXXXXGOOXXXXXXXXXXXXXXXXXGOOOOOXXXXXXXXXXXXXXGOOXXXXXXXXXXXXXXXXXGOOOOOOOXXXXXXXXXXXXGOOOOOOOXXXXXXXXXXXXGOXXXXXXXXXXXXXXXXXX,0,0,0
13146,70,0,70,58,472,0,0,176,51,125,GOOOOOOXXXXXXXXXXXXXGOOOOOXXXXXXXXXXXXXXGOOXXXXXXXXXXXXXXXXXGOOOOXXXXXXXXXXXXXXXGOOOOOXXXXXXXXXXXXXXGOOOOOOXXXXXXXXXXXXXGOOOOOXXXXXXXXXXXXXXGOOXXXXXXXXXXXXXXXXXGOOOOOXXXXXXXXXXXXXXGOOXXXXXXXXXXXXXXXXXGOOOOOOOXXXXXXXXXXXXGOOOOOOOXXXXXXXXXXXXGOXXXXXXXXXXXXXXXXXX,0,0,0
13167,70,0,70,64,466,0,0,170,46,124,GOOOOOOXXXXXXXXXXXXXGOOOOOXXXXXXXXXXXXXXGOOXXXXXXXXXXXXXXXXXGOOOOXXXXXXXXXXXXXXXGOOOOOXXXXXXXXXXXXXXGOOOOOOXXXXXXXXXXXXXGOOOOOXXXXXXXXXXXXXXGOOXXXXXXXXXXXXXXXXXGOOOOOXXXXXXXXXXXXXXGOOXXXXXXXXXXXXXXXXXGOOOOOOOXXXXXXXXXXXXGOOOOOOOXXXXXXXXXXXXGOXXXXXXXXXXXXXXXXXX,0,0,0
13188,70,0,70,69,461,0,0,164,42,122,GOOOOOOXXXXXXXXXXXXXGOOOOOXXXXXXXXXXXXXXGOOXXXXXXXXXXXXXXXXXGOOOOXXXXXXXXXXXXXXXGOOOOOXXXXXXXXXXXXXXGOOOOOOXXXXXXXXXXXXXGOOOOOXXXXXXXXXXXXXXGOOXXXXXXXXXXXXXXXXXGOOOOOXXXXXXXXXXXXXXGOOXXXXXXXXXXXXXXXXXGOOOOOOOXXXXXXXXXXXXGOOOOOOOXXXXXXXXXXXXGOXXXXXXXXXXXXXXXXXX,0,0,0
13209,70,0,70,71,459,0,0,160,44,116,GOOOOOOXXXXXXXXXXXXXGOOOOOXXXXXXXXXXXXXXGOOXXXXXXXXXXXXXXXXXGOOOOXXXXXXXXXXXXXXXGOOOOOXXXXXXXXXXXXXXGOOOOOOXXXXXXXXXXXXXGOOOOOXXXXXXXXXXXXXXGOOXXXXXXXXXXXXXXXXXGOOOOOXXXXXXXXXXXXXXGOOXXXXXXXXXXXXXXXXXGOOOOOOOXXXXXXXXXXXXGOOOOOOOXXXXXXXXXXXXGOXXXXXXXXXXXXXXXXXX,0,0,0

13230,70,0,70,74,456,0,0,160,44,116,GOOOOOOXXXXXXXXXXXXXGOOOOOXXXXXXXXXXXXXXGOOXXXXXXXXXXXXXXXXXGOOOOXXXXXXXXXXXXXXXGOOOOOXXXXXXXXXXXXXXGOOOOOOXXXXXXXXXXXXXGOOOOOXXXXXXXXXXXXXXGOOXXXXXXXXXXXXXXXXXGOOOOOXXXXXXXXXXXXXXGOOXXXXXXXXXXXXXXXXXGOOOOOOOXXXXXXXXXXXXGOOOOOOOXXXXXXXXXXXXGOXXXXXXXXXXXXXXXXXX,0,0,0
13251,70,0,70,72,458,0,0,162,43,119,GOOOOOOXXXXXXXXXXXXXGOOOOOXXXXXXXXXXXXXXGOOXXXXXXXXXXXXXXXXXGOOOOXXXXXXXXXXXXXXXGOOOOOXXXXXXXXXXXXXXGOOOOOOXXXXXXXXXXXXXGOOOOOXXXXXXXXXXXXXXGOOXXXXXXXXXXXXXXXXXGOOOOOXXXXXXXXXXXXXXGOOXXXXXXXXXXXXXXXXXGOOOOOOOXXXXXXXXXXXXGOOOOOOOXXXXXXXXXXXXGOXXXXXXXXXXXXXXXXXX,0,0,0
13272,71,1,70,73,456,0,0,159,47,112,GOOOOOOXXXXXXXXXXXXXGOOOOOXXXXXXXXXXXXXXGOOAXXXXXXXXXXXXXXXXGOOOOXXXXXXXXXXXXXXXGOOOOOXXXXXXXXXXXXXXGOOOOOOXXXXXXXXXXXXXGOOOOOXXXXXXXXXXXXXXGOOXXXXXXXXXXXXXXXXXGOOOOOXXXXXXXXXXXXXXGOOXXXXXXXXXXXXXXXXXGOOOOOOOXXXXXXXXXXXXGOOOOOOOXXXXXXXXXXXXGOXXXXXXXXXXXXXXXXXX,0,0,0
13293,72,2,70,72,456,0,0,159,45,114,GOOOOOOXXXXXXXXXXXXXGOOOOOXXXXXXXXXXXXXXGOOAXXXXXXXXXXXXXXXXGOOOOXXXXXXXXXXXXXXXGOOOOOXXXXXXXXXXXXXXGOOOOOOXXXXXXXXXXXXXGOOOOOXXXXXXXXXXXXXXGOOXXXXXXXXXXXXXXXXXGOOOOOXXXXXXXXXXXXXXGOOXXXXXXXXXXXXXXXXXGOOOOOOOAXXXXXXXXXXXGOOOOOOOXXXXXXXXXXXXGOXXXXXXXXXXXXXXXXXX,0,0,0
13314,72,2,70,76,452,0,0,155,39,116,GOOOOOOXXXXXXXXXXXXXGOOOOOXXXXXXXXXXXXXXGOOAXXXXXXXXXXXXXXXXGOOOOXXXXXXXXXXXXXXXGOOOOOXXXXXXXXXXXXXXGOOOOOOXXXXXXXXXXXXXGOOOOOXXXXXXXXXXXXXXGOOXXXXXXXXXXXXXXXXXGOOOOOXXXXXXXXXXXXXXGOOXXXXXXXXXXXXXXXXXGOOOOOOOAXXXXXXXXXXXGOOOOOOOXXXXXXXXXXXXGOXXXXXXXXXXXXXXXXXX,0,0,0

13335,72,2,70,68,460,0,0,162,46,116,GOOOOOOXXXXXXXXXXXXXGOOOOOXXXXXXXXXXXXXXGOOAXXXXXXXXXXXXXXXXGOOOOXXXXXXXXXXXXXXXGOOOOOXXXXXXXXXXXXXXGOOOOOOXXXXXXXXXXXXXGOOOOOXXXXXXXXXXXXXXGOOXXXXXXXXXXXXXXXXXGOOOOOXXXXXXXXXXXXXXGOOXXXXXXXXXXXXXXXXXGOOOOOOOAXXXXXXXXXXXGOOOOOOOXXXXXXXXXXXXGOXXXXXXXXXXXXXXXXXX,0,0,0
13356,72,2,70,70,458,0,0,161,46,115,GOOOOOOXXXXXXXXXXXXXGOOOOOXXXXXXXXXXXXXXGOOAXXXXXXXXXXXXXXXXGOOOOXXXXXXXXXXXXXXXGOOOOOXXXXXXXXXXXXXXGOOOOOOXXXXXXXXXXXXXGOOOOOXXXXXXXXXXXXXXGOOXXXXXXXXXXXXXXXXXGOOOOOXXXXXXXXXXXXXXGOOXXXXXXXXXXXXXXXXXGOOOOOOOAXXXXXXXXXXXGOOOOOOOXXXXXXXXXXXXGOXXXXXXXXXXXXXXXXXX,0,0,0
13377,72,2,70,68,460,0,0,163,50,113,GOOOOOOXXXXXXXXXXXXXGOOOOOXXXXXXXXXXXXXXGOOAXXXXXXXXXXXXXXXXGOOOOXXXXXXXXXXXXXXXGOOOOOXXXXXXXXXXXXXXGOOOOOOXXXXXXXXXXXXXGOOOOOXXXXXXXXXXXXXXGOOXXXXXXXXXXXXXXXXXGOOOOOXXXXXXXXXXXXXXGOOXXXXXXXXXXXXXXXXXGOOOOOOOAXXXXXXXXXXXGOOOOOOOXXXXXXXXXXXXGOXXXXXXXXXXXXXXXXXX,0,0,0
13398,72,2,70,65,463,0,0,165,52,113,GOOOOOOXXXXXXXXXXXXXGOOOOOXXXXXXXXXXXXXXGOOAXXXXXXXXXXXXXXXXGOOOOXXXXXXXXXXXXXXXGOOOOOXXXXXXXXXXXXXXGOOOOOOXXXXXXXXXXXXXGOOOOOXXXXXXXXXXXXXXGOOXXXXXXXXXXXXXXXXXGOOOOOXXXXXXXXXXXXXXGOOXXXXXXXXXXXXXXXXXGOOOOOOOAXXXXXXXXXXXGOOOOOOOXXXXXXXXXXXXGOXXXXXXXXXXXXXXXXXX,0,0,0
13419,72,1,71,69,459,0,0,162,48,114,GOOOOOOXXXXXXXXXXXXXGOOOOOXXXXXXXXXXXXXXGOOOXXXXXXXXXXXXXXXXGOOOOXXXXXXXXXXXXXXXGOOOOOXXXXXXXXXXXXXXGOOOOOOXXXXXXXXXXXXXGOOOOOXXXXXXXXXXXXXXGOOXXXXXXXXXXXXXXXXXGOOOOOXXXXXXXXXXXXXXGOOXXXXXXXXXXXXXXXXXGOOOOOOOAXXXXXXXXXXXGOOOOOOOXXXXXXXXXXXXGOXXXXXXXXXXXXXXXXXX,0,0,0

13440,72,1,71,70,458,0,0,160,43,117,GOOOOOOXXXXXXXXXXXXXGOOOOOXXXXXXXXXXXXXXGOOOXXXXXXXXXXXXXXXXGOOOOXXXXXXXXXXXXXXXGOOOOOXXXXXXXXXXXXXXGOOOOOOXXXXXXXXXXXXXGOOOOOXXXXXXXXXXXXXXGOOXXXXXXXXXXXXXXXXXGOOOOOXXXXXXXXXXXXXXGOOXXXXXXXXXXXXXXXXXGOOOOOOOAXXXXXXXXXXXGOOOOOOOXXXXXXXXXXXXGOXXXXXXXXXXXXXXXXXX,0,0,0
13461,72,1,71,66,462,0,0,165,46,119,GOOOOOOXXXXXXXXXXXXXGOOOOOXXXXXXXXXXXXXXGOOOXXXXXXXXXXXXXXXXGOOOOXXXXXXXXXXXXXXXGOOOOOXXXXXXXXXXXXXXGOOOOOOXXXXXXXXXXXXXGOOOOOXXXXXXXXXXXXXXGOOXXXXXXXXXXXXXXXXXGOOOOOXXXXXXXXXXXXXXGOOXXXXXXXXXXXXXXXXXGOOOOOOOAXXXXXXXXXXXGOOOOOOOXXXXXXXXXXXXGOXXXXXXXXXXXXXXXXXX,0,0,0
13482,72,1,71,66,462,0,0,165,45,120,GOOOOOOXXXXXXXXXXXXXGOOOOOXXXXXXXXXXXXXXGOOOXXXXXXXXXXXXXXXXGOOOOXXXXXXXXXXXXXXXGOOOOOXXXXXXXXXXXXXXGOOOOOOXXXXXXXXXXXXXGOOOOOXXXXXXXXXXXXXXGOOXXXXXXXXXXXXXXXXXGOOOOOXXXXXXXXXXXXXXGOOXXXXXXXXXXXXXXXXXGOOOOOOOAXXXXXXXXXXXGOOOOOOOXXXXXXXXXXXXGOXXXXXXXXXXXXXXXXXX,0,0,0
13503,72,1,71,65,463,0,0,165,46,119,GOOOOOOXXXXXXXXXXXXXGOOOOOXXXXXXXXXXXXXXGOOOXXXXXXXXXXXXXXXXGOOOOXXXXXXXXXXXXXXXGOOOOOXXXXXXXXXXXXXXGOOOOOOXXXXXXXXXXXXXGOOOOOXXXXXXXXXXXXXXGOOXXXXXXXXXXXXXXXXXGOOOOOXXXXXXXXXXXXXXGOOXXXXXXXXXXXXXXXXXGOOOOOOOAXXXXXXXXXXXGOOOOOOOXXXXXXXXXXXXGOXXXXXXXXXXXXXXXXXX,0,0,0
13524,72,1,71,65,463,0,0,167,52,115,GOOOOOOXXXXXXXXXXXXXGOOOOOXXXXXXXXXXXXXXGOOOXXXXXXXXXXXXXXXXGOOOOXXXXXXXXXXXXXXXGOOOOOXXXXXXXXXXXXXXGOOOOOOXXXXXXXXXXXXXGOOOOOXXXXXXXXXXXXXXGOOXXXXXXXXXXXXXXXXXGOOOOOXXXXXXXXXXXXXXGOOXXXXXXXXXXXXXXXXXGOOOOOOOAXXXXXXXXXXXGOOOOOOOXXXXXXXXXXXXGOXXXXXXXXXXXXXXXXXX,0,0,0

13545,72,0,72,72,456,0,0,159,48,111,GOOOOOOXXXXXXXXXXXXXGOOOOOXXXXXXXXXXXXXXGOOOXXXXXXXXXXXXXXXXGOOOOXXXXXXXXXXXXXXXGOOOOOXXXXXXXXXXXXXXGOOOOOOXXXXXXXXXXXXXGOOOOOXXXXXXXXXXXXXXGOOXXXXXXXXXXXXXXXXXGOOOOOXXXXXXXXXXXXXXGOOXXXXXXXXXXXXXXXXXGOOOOOOOOXXXXXXXXXXXGOOOOOOOXXXXXXXXXXXXGOXXXXXXXXXXXXXXXXXX,0,0,0
13566,72,0,72,65,463,0,0,167,49,118,GOOOOOOXXXXXXXXXXXXXGOOOOOXXXXXXXXXXXXXXGOOOXXXXXXXXXXXXXXXXGOOOOXXXXXXXXXXXXXXXGOOOOOXXXXXXXXXXXXXXGOOOOOOXXXXXXXXXXXXXGOOOOOXXXXXXXXXXXXXXGOOXXXXXXXXXXXXXXXXXGOOOOOXXXXXXXXXXXXXXGOOXXXXXXXXXXXXXXXXXGOOOOOOOOXXXXXXXXXXXGOOOOOOOXXXXXXXXXXXXGOXXXXXXXXXXXXXXXXXX,0,0,0
13587,72,0,72,62,466,0,0,170,48,122,GOOOOOOXXXXXXXXXXXXXGOOOOOXXXXXXXXXXXXXXGOOOXXXXXXXXXXXXXXXXGOOOOXXXXXXXXXXXXXXXGOOOOOXXXXXXXXXXXXXXGOOOOOOXXXXXXXXXXXXXGOOOOOXXXXXXXXXXXXXXGOOXXXXXXXXXXXXXXXXXGOOOOOXXXXXXXXXXXXXXGOOXXXXXXXXXXXXXXXXXGOOOOOOOOXXXXXXXXXXXGOOOOOOOXXXXXXXXXXXXGOXXXXXXXXXXXXXXXXXX,0,0,0
13608,72,0,72,64,464,0,0,167,48,119,GOOOOOOXXXXXXXXXXXXXGOOOOOXXXXXXXXXXXXXXGOOOXXXXXXXXXXXXXXXXGOOOOXXXXXXXXXXXXXXXGOOOOOXXXXXXXXXXXXXXGOOOOOOXXXXXXXXXXXXXGOOOOOXXXXXXXXXXXXXXGOOXXXXXXXXXXXXXXXXXGOOOOOXXXXXXXXXXXXXXGOOXXXXXXXXXXXXXXXXXGOOOOOOOOXXXXXXXXXXXGOOOOOOOXXXXXXXXXXXXGOXXXXXXXXXXXXXXXXXX,0,0,0
13629,73,1,72,60,467,0,0,171,49,122,GOOOOOOXXXXXXXXXXXXXGOOOOOXXXXXXXXXXXXXXGOOOXXXXXXXXXXXXXXXXGOOOOXXXXXXXXXXXXXXXGOOOOOXXXXXXXXXXXXXXGOOOOOOXXXXXXXXXXXXXGOOOOOXXXXXXXXXXXXXXGOOXXXXXXXXXXXXXXXXXGOOOOOXXXXXXXXXXXXXXGOOXXXXXXXXXXXXXXXXXGOOOOOOOOXXXXXXXXXXXGOOOOOOOAXXXXXXXXXXXGOXXXXXXXXXXXXXXXXXX,0,0,0

13650,73,1,72,62,465,0,0,168,49,119,GOOOOOOXXXXXXXXXXXXXGOOOOOXXXXXXXXXXXXXXGOOOXXXXXXXXXXXXXXXXGOOOOXXXXXXXXXXXXXXXGOOOOOXXXXXXXXXXXXXXGOOOOOOXXXXXXXXXXXXXGOOOOOXXXXXXXXXXXXXXGOOXXXXXXXXXXXXXXXXXGOOOOOXXXXXXXXXXXXXXGOOXXXXXXXXXXXXXXXXXGOOOOOOOOXXXXXXXXXXXGOOOOOOOAXXXXXXXXXXXGOXXXXXXXXXXXXXXXXXX,0,0,0
13671,73,1,72,68,459,0,0,161,46,115,GOOOOOOXXXXXXXXXXXXXGOOOOOXXXXXXXXXXXXXXGOOOXXXXXXXXXXXXXXXXGOOOOXXXXXXXXXXXXXXXGOOOOOXXXXXXXXXXXXXXGOOOOOOXXXXXXXXXXXXXGOOOOOXXXXXXXXXXXXXXGOOXXXXXXXXXXXXXXXXXGOOOOOXXXXXXXXXXXXXXGOOXXXXXXXXXXXXXXXXXGOOOOOOOOXXXXXXXXXXXGOOOOOOOAXXXXXXXXXXXGOXXXXXXXXXXXXXXXXXX,0,0,0
13692,73,1,72,65,462,0,0,167,54,113,GOOOOOOXXXXXXXXXXXXXGOOOOOXXXXXXXXXXXXXXGOOOXXXXXXXXXXXXXXXXGOOOOXXXXXXXXXXXXXXXGOOOOOXXXXXXXXXXXXXXGOOOOOOXXXXXXXXXXXXXGOOOOOXXXXXXXXXXXXXXGOOXXXXXXXXXXXXXXXXXGOOOOOXXXXXXXXXXXXXXGOOXXXXXXXXXXXXXXXXXGOOOOOOOOXXXXXXXXXXXGOOOOOOOAXXXXXXXXXXXGOXXXXXXXXXXXXXXXXXX,0,0,0
13713,73,1,72,67,460,0,0,165,50,115,GOOOOOOXXXXXXXXXXXXXGOOOOOXXXXXXXXXXXXXXGOOOXXXXXXXXXXXXXXXXGOOOOXXXXXXXXXXXXXXXGOOOOOXXXXXXXXXXXXXXGOOOOOOXXXXXXXXXXXXXGOOOOOXXXXXXXXXXXXXXGOOXXXXXXXXXXXXXXXXXGOOOOOXXXXXXXXXXXXXXGOOXXXXXXXXXXXXXXXXXGOOOOOOOOXXXXXXXXXXXGOOOOOOOAXXXXXXXXXXXGOXXXXXXXXXXXXXXXXXX,0,0,0
13734,73,1,72,64,463,0,0,168,51,117,GOOOOOOXXXXXXXXXXXXXGOOOOOXXXXXXXXXXXXXXGOOOXXXXXXXXXXXXXXXXGOOOOXXXXXXXXXXXXXXXGOOOOOXXXXXXXXXXXXXXGOOOOOOXXXXXXXXXXXXXGOOOOOXXXXXXXXXXXXXXGOOXXXXXXXXXXXXXXXXXGOOOOOXXXXXXXXXXXXXXGOOXXXXXXXXXXXXXXXXXGOOOOOOOOXXXXXXXXXXXGOOOOOOOAXXXXXXXXXXXGOXXXXXXXXXXXXXXXXXX,0,0,0

13755,73,1,72,62,465,0,0,170,49,121,GOOOOOOXXXXXXXXXXXXXGOOOOOXXXXXXXXXXXXXXGOOOXXXXXXXXXXXXXXXXGOOOOXXXXXXXXXXXXXXXGOOOOOXXXXXXXXXXXXXXGOOOOOOXXXXXXXXXXXXXGOOOOOXXXXXXXXXXXXXXGOOXXXXXXXXXXXXXXXXXGOOOOOXXXXXXXXXXXXXXGOOXXXXXXXXXXXXXXXXXGOOOOOOOOXXXXXXXXXXXGOOOOOOOAXXXXXXXXXXXGOXXXXXXXXXXXXXXXXXX,0,0,0
13776,73,1,72,64,463,0,0,168,50,118,GOOOOOOXXXXXXXXXXXXXGOOOOOXXXXXXXXXXXXXXGOOOXXXXXXXXXXXXXXXXGOOOOXXXXXXXXXXXXXXXGOOOOOXXXXXXXXXXXXXXGOOOOOOXXXXXXXXXXXXXGOOOOOXXXXXXXXXXXXXXGOOXXXXXXXXXXXXXXXXXGOOOOOXXXXXXXXXXXXXXGOOXXXXXXXXXXXXXXXXXGOOOOOOOOXXXXXXXXXXXGOOOOOOOAXXXXXXXXXXXGOXXXXXXXXXXXXXXXXXX,0,0,0
13797,73,1,72,66,461,0,0,166,48,118,GOOOOOOXXXXXXXXXXXXXGOOOOOXXXXXXXXXXXXXXGOOOXXXXXXXXXXXXXXXXGOOOOXXXXXXXXXXXXXXXGOOOOOXXXXXXXXXXXXXXGOOOOOOXXXXXXXXXXXXXGOOOOOXXXXXXXXXXXXXXGOOXXXXXXXXXXXXXXXXXGOOOOOXXXXXXXXXXXXXXGOOXXXXXXXXXXXXXXXXXGOOOOOOOOXXXXXXXXXXXGOOOOOOOAXXXXXXXXXXXGOXXXXXXXXXXXXXXXXXX,0,0,0
13818,73,1,72,61,466,0,0,172,49,123,GOOOOOOXXXXXXXXXXXXXGOOOOOXXXXXXXXXXXXXXGOOOXXXXXXXXXXXXXXXXGOOOOXXXXXXXXXXXXXXXGOOOOOXXXXXXXXXXXXXXGOOOOOOXXXXXXXXXXXXXGOOOOOXXXXXXXXXXXXXXGOOXXXXXXXXXXXXXXXXXGOOOOOXXXXXXXXXXXXXXGOOXXXXXXXXXXXXXXXXXGOOOOOOOOXXXXXXXXXXXGOOOOOOOAXXXXXXXXXXXGOXXXXXXXXXXXXXXXXXX,0,0,0
13839,73,1,72,64,463,0,0,169,47,122,GOOOOOOXXXXXXXXXXXXXGOOOOOXXXXXXXXXXXXXXGOOOXXXXXXXXXXXXXXXXGOOOOXXXXXXXXXXXXXXXGOOOOOXXXXXXXXXXXXXXGOOOOOOXXXXXXXXXXXXXGOOOOOXXXXXXXXXXXXXXGOOXXXXXXXXXXXXXXXXXGOOOOOXXXXXXXXXXXXXXGOOXXXXXXXXXXXXXXXXXGOOOOOOOOXXXXXXXXXXXGOOOOOOOAXXXXXXXXXXXGOXXXXXXXXXXXXXXXXXX,0,0,0

13860,73,1,72,69,458,0,0,164,49,115,GOOOOOOXXXXXXXXXXXXXGOOOOOXXXXXXXXXXXXXXGOOOXXXXXXXXXXXXXXXXGOOOOXXXXXXXXXXXXXXXGOOOOOXXXXXXXXXXXXXXGOOOOOOXXXXXXXXXXXXXGOOOOOXXXXXXXXXXXXXXGOOXXXXXXXXXXXXXXXXXGOOOOOXXXXXXXXXXXXXXGOOXXXXXXXXXXXXXXXXXGOOOOOOOOXXXXXXXXXXXGOOOOOOOAXXXXXXXXXXXGOXXXXXXXXXXXXXXXXXX,0,0,0
13881,73,1,72,73,454,0,0,160,47,113,GOOOOOOXXXXXXXXXXXXXGOOOOOXXXXXXXXXXXXXXGOOOXXXXXXXXXXXXXXXXGOOOOXXXXXXXXXXXXXXXGOOOOOXXXXXXXXXXXXXXGOOOOOOXXXXXXXXXXXXXGOOOOOXXXXXXXXXXXXXXGOOXXXXXXXXXXXXXXXXXGOOOOOXXXXXXXXXXXXXXGOOXXXXXXXXXXXXXXXXXGOOOOOOOOXXXXXXXXXXXGOOOOOOOAXXXXXXXXXXXGOXXXXXXXXXXXXXXXXXX,0,0,0
13902,73,1,72,68,459,0,0,165,47,118,GOOOOOOXXXXXXXXXXXXXGOOOOOXXXXXXXXXXXXXXGOOOXXXXXXXXXXXXXXXXGOOOOXXXXXXXXXXXXXXXGOOOOOXXXXXXXXXXXXXXGOOOOOOXXXXXXXXXXXXXGOOOOOXXXXXXXXXXXXXXGOOXXXXXXXXXXXXXXXXXGOOOOOXXXXXXXXXXXXXXGOOXXXXXXXXXXXXXXXXXGOOOOOOOOXXXXXXXXXXXGOOOOOOOAXXXXXXXXXXXGOXXXXXXXXXXXXXXXXXX,0,0,0
13923,73,0,73,66,461,0,0,167,48,119,GOOOOOOXXXXXXXXXXXXXGOOOOOXXXXXXXXXXXXXXGOOOXXXXXXXXXXXXXXXXGOOOOXXXXXXXXXXXXXXXGOOOOOXXXXXXXXXXXXXXGOOOOOOXXXXXXXXXXXXXGOOOOOXXXXXXXXXXXXXXGOOXXXXXXXXXXXXXXXXXGOOOOOXXXXXXXXXXXXXXGOOXXXXXXXXXXXXXXXXXGOOOOOOOOXXXXXXXXXXXGOOOOOOOOXXXXXXXXXXXGOXXXXXXXXXXXXXXXXXX,0,0,0
13944,73,0,73,65,462,0,0,167,48,119,GOOOOOOXXXXXXXXXXXXXGOOOOOXXXXXXXXXXXXXXGOOOXXXXXXXXXXXXXXXXGOOOOXXXXXXXXXXXXXXXGOOOOOXXXXXXXXXXXXXXGOOOOOOXXXXXXXXXXXXXGOOOOOXXXXXXXXXXXXXXGOOXXXXXXXXXXXXXXXXXGOOOOOXXXXXXXXXXXXXXGOOXXXXXXXXXXXXXXXXXGOOOOOOOOXXXXXXXXXXXGOOOOOOOOXXXXXXXXXXXGOXXXXXXXXXXXXXXXXXX,0,0,0

13965,73,0,73,65,462,0,0,168,52,116,GOOOOOOXXXXXXXXXXXXXGOOOOOXXXXXXXXXXXXXXGOOOXXXXXXXXXXXXXXXXGOOOOXXXXXXXXXXXXXXXGOOOOOXXXXXXXXXXXXXXGOOOOOOXXXXXXXXXXXXXGOOOOOXXXXXXXXXXXXXXGOOXXXXXXXXXXXXXXXXXGOOOOOXXXXXXXXXXXXXXGOOXXXXXXXXXXXXXXXXXGOOOOOOOOXXXXXXXXXXXGOOOOOOOOXXXXXXXXXXXGOXXXXXXXXXXXXXXXXXX,0,0,0
13986,73,0,73,60,467,0,0,173,49,124,GOOOOOOXXXXXXXXXXXXXGOOOOOXXXXXXXXXXXXXXGOOOXXXXXXXXXXXXXXXXGOOOOXXXXXXXXXXXXXXXGOOOOOXXXXXXXXXXXXXXGOOOOOOXXXXXXXXXXXXXGOOOOOXXXXXXXXXXXXXXGOOXXXXXXXXXXXXXXXXXGOOOOOXXXXXXXXXXXXXXGOOXXXXXXXXXXXXXXXXXGOOOOOOOOXXXXXXXXXXXGOOOOOOOOXXXXXXXXXXXGOXXXXXXXXXXXXXXXXXX,0,0,0
14007,73,0,73,61,466,0,0,172,48,124,GOOOOOOXXXXXXXXXXXXXGOOOOOXXXXXXXXXXXXXXGOOOXXXXXXXXXXXXXXXXGOOOOXXXXXXXXXXXXXXXGOOOOOXXXXXXXXXXXXXXGOOOOOOXXXXXXXXXXXXXGOOOOOXXXXXXXXXXXXXXGOOXXXXXXXXXXXXXXXXXGOOOOOXXXXXXXXXXXXXXGOOXXXXXXXXXXXXXXXXXGOOOOOOOOXXXXXXXXXXXGOOOOOOOOXXXXXXXXXXXGOXXXXXXXXXXXXXXXXXX,0,0,0
14028,73,0,73,49,478,0,0,184,50,134,GOOOOOOXXXXXXXXXXXXXGOOOOOXXXXXXXXXXXXXXGOOOXXXXXXXXXXXXXXXXGOOOOXXXXXXXXXXXXXXXGOOOOOXXXXXXXXXXXXXXGOOOOOOXXXXXXXXXXXXXGOOOOOXXXXXXXXXXXXXXGOOXXXXXXXXXXXXXXXXXGOOOOOXXXXXXXXXXXXXXGOOXXXXXXXXXXXXXXXXXGOOOOOOOOXXXXXXXXXXXGOOOOOOOOXXXXXXXXXXXGOXXXXXXXXXXXXXXXXXX,0,0,0
14049,73,0,73,53,474,0,0,179,48,131,GOOOOOOXXXXXXXXXXXXXGOOOOOXXXXXXXXXXXXXXGOOOXXXXXXXXXXXXXXXXGOOOOXXXXXXXXXXXXXXXGOOOOOXXXXXXXXXXXXXXGOOOOOOXXXXXXXXXXXXXGOOOOOXXXXXXXXXXXXXXGOOXXXXXXXXXXXXXXXXXGOOOOOXXXXXXXXXXXXXXGOOXXXXXXXXXXXXXXXXXGOOOOOOOOXXXXXXXXXXXGOOOOOOOOXXXXXXXXXXXGOXXXXXXXXXXXXXXXXXX,0,0,0

14070,73,0,73,50,477,0,0,183,49,134,GOOOOOOXXXXXXXXXXXXXGOOOOOXXXXXXXXXXXXXXGOOOXXXXXXXXXXXXXXXXGOOOOXXXXXXXXXXXXXXXGOOOOOXXXXXXXXXXXXXXGOOOOOOXXXXXXXXXXXXXGOOOOOXXXXXXXXXXXXXXGOOXXXXXXXXXXXXXXXXXGOOOOOXXXXXXXXXXXXXXGOOXXXXXXXXXXXXXXXXXGOOOOOOOOXXXXXXXXXXXGOOOOOOOOXXXXXXXXXXXGOXXXXXXXXXXXXXXXXXX,0,0,0
14091,73,0,73,51,476,0,0,182,52,130,GOOOOOOXXXXXXXXXXXXXGOOOOOXXXXXXXXXXXXXXGOOOXXXXXXXXXXXXXXXXGOOOOXXXXXXXXXXXXXXXGOOOOOXXXXXXXXXXXXXXGOOOOOOXXXXXXXXXXXXXGOOOOOXXXXXXXXXXXXXXGOOXXXXXXXXXXXXXXXXXGOOOOOXXXXXXXXXXXXXXGOOXXXXXXXXXXXXXXXXXGOOOOOOOOXXXXXXXXXXXGOOOOOOOOXXXXXXXXXXXGOXXXXXXXXXXXXXXXXXX,0,0,0
14112,73,0,73,58,469,0,0,175,52,123,GOOOOOOXXXXXXXXXXXXXGOOOOOXXXXXXXXXXXXXXGOOOXXXXXXXXXXXXXXXXGOOOOXXXXXXXXXXXXXXXGOOOOOXXXXXXXXXXXXXXGOOOOOOXXXXXXXXXXXXXGOOOOOXXXXXXXXXXXXXXGOOXXXXXXXXXXXXXXXXXGOOOOOXXXXXXXXXXXXXXGOOXXXXXXXXXXXXXXXXXGOOOOOOOOXXXXXXXXXXXGOOOOOOOOXXXXXXXXXXXGOXXXXXXXXXXXXXXXXXX,0,0,0
14133,73,0,73,63,464,0,0,169,49,120,GOOOOOOXXXXXXXXXXXXXGOOOOOXXXXXXXXXXXXXXGOOOXXXXXXXXXXXXXXXXGOOOOXXXXXXXXXXXXXXXGOOOOOXXXXXXXXXXXXXXGOOOOOOXXXXXXXXXXXXXGOOOOOXXXXXXXXXXXXXXGOOXXXXXXXXXXXXXXXXXGOOOOOXXXXXXXXXXXXXXGOOXXXXXXXXXXXXXXXXXGOOOOOOOOXXXXXXXXXXXGOOOOOOOOXXXXXXXXXXXGOXXXXXXXXXXXXXXXXXX,0,0,0
14154,73,0,73,61,466,0,0,171,49,122,GOOOOOOXXXXXXXXXXXXXGOOOOOXXXXXXXXXXXXXXGOOOXXXXXXXXXXXXXXXXGOOOOXXXXXXXXXXXXXXXGOOOOOXXXXXXXXXXXXXXGOOOOOOXXXXXXXXXXXXXGOOOOOXXXXXXXXXXXXXXGOOXXXXXXXXXXXXXXXXXGOOOOOXXXXXXXXXXXXXXGOOXXXXXXXXXXXXXXXXXGOOOOOOOOXXXXXXXXXXXGOOOOOOOOXXXXXXXXXXXGOXXXXXXXXXXXXXXXXXX,0,0,0

14175,73,0,73,58,469,0,0,173,46,127,GOOOOOOXXXXXXXXXXXXXGOOOOOXXXXXXXXXXXXXXGOOOXXXXXXXXXXXXXXXXGOOOOXXXXXXXXXXXXXXXGOOOOOXXXXXXXXXXXXXXGOOOOOOXXXXXXXXXXXXXGOOOOOXXXXXXXXXXXXXXGOOXXXXXXXXXXXXXXXXXGOOOOOXXXXXXXXXXXXXXGOOXXXXXXXXXXXXXXXXXGOOOOOOOOXXXXXXXXXXXGOOOOOOOOXXXXXXXXXXXGOXXXXXXXXXXXXXXXXXX,0,0,0
14196,73,0,73,60,467,0,0,171,48,123,GOOOOOOXXXXXXXXXXXXXGOOOOOXXXXXXXXXXXXXXGOOOXXXXXXXXXXXXXXXXGOOOOXXXXXXXXXXXXXXXGOOOOOXXXXXXXXXXXXXXGOOOOOOXXXXXXXXXXXXXGOOOOOXXXXXXXXXXXXXXGOOXXXXXXXXXXXXXXXXXGOOOOOXXXXXXXXXXXXXXGOOXXXXXXXXXXXXXXXXXGOOOOOOOOXXXXXXXXXXXGOOOOOOOOXXXXXXXXXXXGOXXXXXXXXXXXXXXXXXX,0,0,0
14217,73,0,73,62,465,0,0,171,50,121,GOOOOOOXXXXXXXXXXXXXGOOOOOXXXXXXXXXXXXXXGOOOXXXXXXXXXXXXXXXXGOOOOXXXXXXXXXXXXXXXGOOOOOXXXXXXXXXXXXXXGOOOOOOXXXXXXXXXXXXXGOOOOOXXXXXXXXXXXXXXGOOXXXXXXXXXXXXXXXXXGOOOOOXXXXXXXXXXXXXXGOOXXXXXXXXXXXXXXXXXGOOOOOOOOXXXXXXXXXXXGOOOOOOOOXXXXXXXXXXXGOXXXXXXXXXXXXXXXXXX,0,0,0
14238,73,0,73,64,463,0,0,168,49,119,GOOOOOOXXXXXXXXXXXXXGOOOOOXXXXXXXXXXXXXXGOOOXXXXXXXXXXXXXXXXGOOOOXXXXXXXXXXXXXXXGOOOOOXXXXXXXXXXXXXXGOOOOOOXXXXXXXXXXXXXGOOOOOXXXXXXXXXXXXXXGOOXXXXXXXXXXXXXXXXXGOOOOOXXXXXXXXXXXXXXGOOXXXXXXXXXXXXXXXXXGOOOOOOOOXXXXXXXXXXXGOOOOOOOOXXXXXXXXXXXGOXXXXXXXXXXXXXXXXXX,0,0,0
14259,73,0,73,66,461,0,0,165,47,118,GOOOOOOXXXXXXXXXXXXXGOOOOOXXXXXXXXXXXXXXGOOOXXXXXXXXXXXXXXXXGOOOOXXXXXXXXXXXXXXXGOOOOOXXXXXXXXXXXXXXGOOOOOOXXXXXXXXXXXXXGOOOOOXXXXXXXXXXXXXXGOOXXXXXXXXXXXXXXXXXGOOOOOXXXXXXXXXXXXXXGOOXXXXXXXXXXXXXXXXXGOOOOOOOOXXXXXXXXXXXGOOOOOOOOXXXXXXXXXXXGOXXXXXXXXXXXXXXXXXX,0,0,0

14280,73,0,73,70,457,0,0,161,48,113,GOOOOOOXXXXXXXXXXXXXGOOOOOXXXXXXXXXXXXXXGOOOXXXXXXXXXXXXXXXXGOOOOXXXXXXXXXXXXXXXGOOOOOXXXXXXXXXXXXXXGOOOOOOXXXXXXXXXXXXXGOOOOOXXXXXXXXXXXXXXGOOXXXXXXXXXXXXXXXXXGOOOOOXXXXXXXXXXXXXXGOOXXXXXXXXXXXXXXXXXGOOOOOOOOXXXXXXXXXXXGOOOOOOOOXXXXXXXXXXXGOXXXXXXXXXXXXXXXXXX,0,0,0
14301,73,0,73,69,458,0,0,161,52,109,GOOOOOOXXXXXXXXXXXXXGOOOOOXXXXXXXXXXXXXXGOOOXXXXXXXXXXXXXXXXGOOOOXXXXXXXXXXXXXXXGOOOOOXXXXXXXXXXXXXXGOOOOOOXXXXXXXXXXXXXGOOOOOXXXXXXXXXXXXXXGOOXXXXXXXXXXXXXXXXXGOOOOOXXXXXXXXXXXXXXGOOXXXXXXXXXXXXXXXXXGOOOOOOOOXXXXXXXXXXXGOOOOOOOOXXXXXXXXXXXGOXXXXXXXXXXXXXXXXXX,0,0,0
14322,73,0,73,73,454,0,0,157,49,108,GOOOOOOXXXXXXXXXXXXXGOOOOOXXXXXXXXXXXXXXGOOOXXXXXXXXXXXXXXXXGOOOOXXXXXXXXXXXXXXXGOOOOOXXXXXXXXXXXXXXGOOOOOOXXXXXXXXXXXXXGOOOOOXXXXXXXXXXXXXXGOOXXXXXXXXXXXXXXXXXGOOOOOXXXXXXXXXXXXXXGOOXXXXXXXXXXXXXXXXXGOOOOOOOOXXXXXXXXXXXGOOOOOOOOXXXXXXXXXXXGOXXXXXXXXXXXXXXXXXX,0,0,0
14343,73,0,73,66,461,0,0,164,49,115,GOOOOOOXXXXXXXXXXXXXGOOOOOXXXXXXXXXXXXXXGOOOXXXXXXXXXXXXXXXXGOOOOXXXXXXXXXXXXXXXGOOOOOXXXXXXXXXXXXXXGOOOOOOXXXXXXXXXXXXXGOOOOOXXXXXXXXXXXXXXGOOXXXXXXXXXXXXXXXXXGOOOOOXXXXXXXXXXXXXXGOOXXXXXXXXXXXXXXXXXGOOOOOOOOXXXXXXXXXXXGOOOOOOOOXXXXXXXXXXXGOXXXXXXXXXXXXXXXXXX,0,0,0
14364,73,0,73,67,460,0,0,162,45,117,GOOOOOOXXXXXXXXXXXXXGOOOOOXXXXXXXXXXXXXXGOOOXXXXXXXXXXXXXXXXGOOOOXXXXXXXXXXXXXXXGOOOOOXXXXXXXXXXXXXXGOOOOOOXXXXXXXXXXXXXGOOOOOXXXXXXXXXXXXXXGOOXXXXXXXXXXXXXXXXXGOOOOOXXXXXXXXXXXXXXGOOXXXXXXXXXXXXXXXXXGOOOOOOOOXXXXXXXXXXXGOOOOOOOOXXXXXXXXXXXGOXXXXXXXXXXXXXXXXXX,0,0,0

14385,74,1,73,60,466,0,0,167,48,119,GOOOOOOXXXXXXXXXXXXXGOOOOOXXXXXXXXXXXXXXGOOOXXXXXXXXXXXXXXXXGOOOOXXXXXXXXXXXXXXXGOOOOOXXXXXXXXXXXXXXGOOOOOOXXXXXXXXXXXXXGOOOOOXXXXXXXXXXXXXXGOOXXXXXXXXXXXXXXXXXGOOOOOAXXXXXXXXXXXXXGOOXXXXXXXXXXXXXXXXXGOOOOOOOOXXXXXXXXXXXGOOOOOOOOXXXXXXXXXXXGOXXXXXXXXXXXXXXXXXX,0,0,0
14406,74,1,73,68,458,0,0,161,49,112,GOOOOOOXXXXXXXXXXXXXGOOOOOXXXXXXXXXXXXXXGOOOXXXXXXXXXXXXXXXXGOOOOXXXXXXXXXXXXXXXGOOOOOXXXXXXXXXXXXXXGOOOOOOXXXXXXXXXXXXXGOOOOOXXXXXXXXXXXXXXGOOXXXXXXXXXXXXXXXXXGOOOOOAXXXXXXXXXXXXXGOOXXXXXXXXXXXXXXXXXGOOOOOOOOXXXXXXXXXXXGOOOOOOOOXXXXXXXXXXXGOXXXXXXXXXXXXXXXXXX,0,0,0
14427,74,1,73,63,463,0,0,166,46,120,GOOOOOOXXXXXXXXXXXXXGOOOOOXXXXXXXXXXXXXXGOOOXXXXXXXXXXXXXXXXGOOOOXXXXXXXXXXXXXXXGOOOOOXXXXXXXXXXXXXXGOOOOOOXXXXXXXXXXXXXGOOOOOXXXXXXXXXXXXXXGOOXXXXXXXXXXXXXXXXXGOOOOOAXXXXXXXXXXXXXGOOXXXXXXXXXXXXXXXXXGOOOOOOOOXXXXXXXXXXXGOOOOOOOOXXXXXXXXXXXGOXXXXXXXXXXXXXXXXXX,0,0,0
14448,74,1,73,65,461,0,0,163,49,114,GOOOOOOXXXXXXXXXXXXXGOOOOOXXXXXXXXXXXXXXGOOOXXXXXXXXXXXXXXXXGOOOOXXXXXXXXXXXXXXXGOOOOOXXXXXXXXXXXXXXGOOOOOOXXXXXXXXXXXXXGOOOOOXXXXXXXXXXXXXXGOOXXXXXXXXXXXXXXXXXGOOOOOAXXXXXXXXXXXXXGOOXXXXXXXXXXXXXXXXXGOOOOOOOOXXXXXXXXXXXGOOOOOOOOXXXXXXXXXXXGOXXXXXXXXXXXXXXXXXX,0,0,0
14469,74,1,73,63,463,0,0,165,51,114,GOOOOOOXXXXXXXXXXXXXGOOOOOXXXXXXXXXXXXXXGOOOXXXXXXXXXXXXXXXXGOOOOXXXXXXXXXXXXXXXGOOOOOXXXXXXXXXXXXXXGOOOOOOXXXXXXXXXXXXXGOOOOOXXXXXXXXXXXXXXGOOXXXXXXXXXXXXXXXXXGOOOOOAXXXXXXXXXXXXXGOOXXXXXXXXXXXXXXXXXGOOOOOOOOXXXXXXXXXXXGOOOOOOOOXXXXXXXXXXXGOXXXXXXXXXXXXXXXXXX,0,0,0

14490,74,1,73,62,464,0,0,165,50,115,GOOOOOOXXXXXXXXXXXXXGOOOOOXXXXXXXXXXXXXXGOOOXXXXXXXXXXXXXXXXGOOOOXXXXXXXXXXXXXXXGOOOOOXXXXXXXXXXXXXXGOOOOOOXXXXXXXXXXXXXGOOOOOXXXXXXXXXXXXXXGOOXXXXXXXXXXXXXXXXXGOOOOOAXXXXXXXXXXXXXGOOXXXXXXXXXXXXXXXXXGOOOOOOOOXXXXXXXXXXXGOOOOOOOOXXXXXXXXXXXGOXXXXXXXXXXXXXXXXXX,0,0,0
14511,74,1,73,59,467,0,0,170,49,121,GOOOOOOXXXXXXXXXXXXXGOOOOOXXXXXXXXXXXXXXGOOOXXXXXXXXXXXXXXXXGOOOOXXXXXXXXXXXXXXXGOOOOOXXXXXXXXXXXXXXGOOOOOOXXXXXXXXXXXXXGOOOOOXXXXXXXXXXXXXXGOOXXXXXXXXXXXXXXXXXGOOOOOAXXXXXXXXXXXXXGOOXXXXXXXXXXXXXXXXXGOOOOOOOOXXXXXXXXXXXGOOOOOOOOXXXXXXXXXXXGOXXXXXXXXXXXXXXXXXX,0,0,0
14532,74,1,73,62,464,0,0,167,48,119,GOOOOOOXXXXXXXXXXXXXGOOOOOXXXXXXXXXXXXXXGOOOXXXXXXXXXXXXXXXXGOOOOXXXXXXXXXXXXXXXGOOOOOXXXXXXXXXXXXXXGOOOOOOXXXXXXXXXXXXXGOOOOOXXXXXXXXXXXXXXGOOXXXXXXXXXXXXXXXXXGOOOOOAXXXXXXXXXXXXXGOOXXXXXXXXXXXXXXXXXGOOOOOOOOXXXXXXXXXXXGOOOOOOOOXXXXXXXXXXXGOXXXXXXXXXXXXXXXXXX,0,0,0
14553,74,1,73,57,469,0,0,170,53,117,GOOOOOOXXXXXXXXXXXXXGOOOOOXXXXXXXXXXXXXXGOOOXXXXXXXXXXXXXXXXGOOOOXXXXXXXXXXXXXXXGOOOOOXXXXXXXXXXXXXXGOOOOOOXXXXXXXXXXXXXGOOOOOXXXXXXXXXXXXXXGOOXXXXXXXXXXXXXXXXXGOOOOOAXXXXXXXXXXXXXGOOXXXXXXXXXXXXXXXXXGOOOOOOOOXXXXXXXXXXXGOOOOOOOOXXXXXXXXXXXGOXXXXXXXXXXXXXXXXXX,0,0,0
14574,74,0,74,61,465,0,0,167,51,116,GOOOOOOXXXXXXXXXXXXXGOOOOOXXXXXXXXXXXXXXGOOOXXXXXXXXXXXXXXXXGOOOOXXXXXXXXXXXXXXXGOOOOOXXXXXXXXXXXXXXGOOOOOOXXXXXXXXXXXXXGOOOOOXXXXXXXXXXXXXXGOOXXXXXXXXXXXXXXXXXGOOOOOOXXXXXXXXXXXXXGOOXXXXXXXXXXXXXXXXXGOOOOOOOOXXXXXXXXXXXGOOOOOOOOXXXXXXXXXXXGOXXXXXXXXXXXXXXXXXX,0,0,0

14595,74,0,74,62,464,0,0,166,47,119,GOOOOOOXXXXXXXXXXXXXGOOOOOXXXXXXXXXXXXXXGOOOXXXXXXXXXXXXXXXXGOOOOXXXXXXXXXXXXXXXGOOOOOXXXXXXXXXXXXXXGOOOOOOXXXXXXXXXXXXXGOOOOOXXXXXXXXXXXXXXGOOXXXXXXXXXXXXXXXXXGOOOOOOXXXXXXXXXXXXXGOOXXXXXXXXXXXXXXXXXGOOOOOOOOXXXXXXXXXXXGOOOOOOOOXXXXXXXXXXXGOXXXXXXXXXXXXXXXXXX,0,0,0
14616,74,0,74,62,464,0,0,168,47,121,GOOOOOOXXXXXXXXXXXXXGOOOOOXXXXXXXXXXXXXXGOOOXXXXXXXXXXXXXXXXGOOOOXXXXXXXXXXXXXXXGOOOOOXXXXXXXXXXXXXXGOOOOOOXXXXXXXXXXXXXGOOOOOXXXXXXXXXXXXXXGOOXXXXXXXXXXXXXXXXXGOOOOOOXXXXXXXXXXXXXGOOXXXXXXXXXXXXXXXXXGOOOOOOOOXXXXXXXXXXXGOOOOOOOOXXXXXXXXXXXGOXXXXXXXXXXXXXXXXXX,0,0,0
14637,76,2,74,60,464,0,0,166,50,116,GOOOOOOXXXXXXXXXXXXXGOOOOOAXXXXXXXXXXXXXGOOOAXXXXXXXXXXXXXXXGOOOOXXXXXXXXXXXXXXXGOOOOOXXXXXXXXXXXXXXGOOOOOOXXXXXXXXXXXXXGOOOOOXXXXXXXXXXXXXXGOOXXXXXXXXXXXXXXXXXGOOOOOOXXXXXXXXXXXXXGOOXXXXXXXXXXXXXXXXXGOOOOOOOOXXXXXXXXXXXGOOOOOOOOXXXXXXXXXXXGOXXXXXXXXXXXXXXXXXX,0,0,0
14658,76,2,74,61,463,0,0,165,50,115,GOOOOOOXXXXXXXXXXXXXGOOOOOAXXXXXXXXXXXXXGOOOAXXXXXXXXXXXXXXXGOOOOXXXXXXXXXXXXXXXGOOOOOXXXXXXXXXXXXXXGOOOOOOXXXXXXXXXXXXXGOOOOOXXXXXXXXXXXXXXGOOXXXXXXXXXXXXXXXXXGOOOOOOXXXXXXXXXXXXXGOOXXXXXXXXXXXXXXXXXGOOOOOOOOXXXXXXXXXXXGOOOOOOOOXXXXXXXXXXXGOXXXXXXXXXXXXXXXXXX,0,0,0
14679,76,1,75,64,460,0,0,162,47,115,GOOOOOOXXXXXXXXXXXXXGOOOOOOXXXXXXXXXXXXXGOOOAXXXXXXXXXXXXXXXGOOOOXXXXXXXXXXXXXXXGOOOOOXXXXXXXXXXXXXXGOOOOOOXXXXXXXXXXXXXGOOOOOXXXXXXXXXXXXXXGOOXXXXXXXXXXXXXXXXXGOOOOOOXXXXXXXXXXXXXGOOXXXXXXXXXXXXXXXXXGOOOOOOOOXXXXXXXXXXXGOOOOOOOOXXXXXXXXXXXGOXXXXXXXXXXXXXXXXXX,0,0,0

14700,76,1,75,59,465,0,0,167,47,120,GOOOOOOXXXXXXXXXXXXXGOOOOOOXXXXXXXXXXXXXGOOOAXXXXXXXXXXXXXXXGOOOOXXXXXXXXXXXXXXXGOOOOOXXXXXXXXXXXXXXGOOOOOOXXXXXXXXXXXXXGOOOOOXXXXXXXXXXXXXXGOOXXXXXXXXXXXXXXXXXGOOOOOOXXXXXXXXXXXXXGOOXXXXXXXXXXXXXXXXXGOOOOOOOOXXXXXXXXXXXGOOOOOOOOXXXXXXXXXXXGOXXXXXXXXXXXXXXXXXX,0,0,0
14721,76,1,75,58,466,0,0,169,46,123,GOOOOOOXXXXXXXXXXXXXGOOOOOOXXXXXXXXXXXXXGOOOAXXXXXXXXXXXXXXXGOOOOXXXXXXXXXXXXXXXGOOOOOXXXXXXXXXXXXXXGOOOOOOXXXXXXXXXXXXXGOOOOOXXXXXXXXXXXXXXGOOXXXXXXXXXXXXXXXXXGOOOOOOXXXXXXXXXXXXXGOOXXXXXXXXXXXXXXXXXGOOOOOOOOXXXXXXXXXXXGOOOOOOOOXXXXXXXXXXXGOXXXXXXXXXXXXXXXXXX,0,0,0
14742,76,0,76,63,461,0,0,163,50,113,GOOOOOOXXXXXXXXXXXXXGOOOOOOXXXXXXXXXXXXXGOOOOXXXXXXXXXXXXXXXGOOOOXXXXXXXXXXXXXXXGOOOOOXXXXXXXXXXXXXXGOOOOOOXXXXXXXXXXXXXGOOOOOXXXXXXXXXXXXXXGOOXXXXXXXXXXXXXXXXXGOOOOOOXXXXXXXXXXXXXGOOXXXXXXXXXXXXXXXXXGOOOOOOOOXXXXXXXXXXXGOOOOOOOOXXXXXXXXXXXGOXXXXXXXXXXXXXXXXXX,0,0,0
14763,76,0,76,61,463,0,0,165,49,116,GOOOOOOXXXXXXXXXXXXXGOOOOOOXXXXXXXXXXXXXGOOOOXXXXXXXXXXXXXXXGOOOOXXXXXXXXXXXXXXXGOOOOOXXXXXXXXXXXXXXGOOOOOOXXXXXXXXXXXXXGOOOOOXXXXXXXXXXXXXXGOOXXXXXXXXXXXXXXXXXGOOOOOOXXXXXXXXXXXXXGOOXXXXXXXXXXXXXXXXXGOOOOOOOOXXXXXXXXXXXGOOOOOOOOXXXXXXXXXXXGOXXXXXXXXXXXXXXXXXX,0,0,0
14784,76,0,76,60,464,0,0,166,49,117,GOOOOOOXXXXXXXXXXXXXGOOOOOOXXXXXXXXXXXXXGOOOOXXXXXXXXXXXXXXXGOOOOXXXXXXXXXXXXXXXGOOOOOXXXXXXXXXXXXXXGOOOOOOXXXXXXXXXXXXXGOOOOOXXXXXXXXXXXXXXGOOXXXXXXXXXXXXXXXXXGOOOOOOXXXXXXXXXXXXXGOOXXXXXXXXXXXXXXXXXGOOOOOOOOXXXXXXXXXXXGOOOOOOOOXXXXXXXXXXXGOXXXXXXXXXXXXXXXXXX,0,0,0

14805,76,0,76,66,458,0,0,161,48,113,GOOOOOOXXXXXXXXXXXXXGOOOOOOXXXXXXXXXXXXXGOOOOXXXXXXXXXXXXXXXGOOOOXXXXXXXXXXXXXXXGOOOOOXXXXXXXXXXXXXXGOOOOOOXXXXXXXXXXXXXGOOOOOXXXXXXXXXXXXXXGOOXXXXXXXXXXXXXXXXXGOOOOOOXXXXXXXXXXXXXGOOXXXXXXXXXXXXXXXXXGOOOOOOOOXXXXXXXXXXXGOOOOOOOOXXXXXXXXXXXGOXXXXXXXXXXXXXXXXXX,0,0,0
14826,76,0,76,63,461,0,0,163,52,111,GOOOOOOXXXXXXXXXXXXXGOOOOOOXXXXXXXXXXXXXGOOOOXXXXXXXXXXXXXXXGOOOOXXXXXXXXXXXXXXXGOOOOOXXXXXXXXXXXXXXGOOOOOOXXXXXXXXXXXXXGOOOOOXXXXXXXXXXXXXXGOOXXXXXXXXXXXXXXXXXGOOOOOOXXXXXXXXXXXXXGOOXXXXXXXXXXXXXXXXXGOOOOOOOOXXXXXXXXXXXGOOOOOOOOXXXXXXXXXXXGOXXXXXXXXXXXXXXXXXX,0,0,0
14847,76,0,76,70,454,0,0,157,49,108,GOOOOOOXXXXXXXXXXXXXGOOOOOOXXXXXXXXXXXXXGOOOOXXXXXXXXXXXXXXXGOOOOXXXXXXXXXXXXXXXGOOOOOXXXXXXXXXXXXXXGOOOOOOXXXXXXXXXXXXXGOOOOOXXXXXXXXXXXXXXGOOXXXXXXXXXXXXXXXXXGOOOOOOXXXXXXXXXXXXXGOOXXXXXXXXXXXXXXXXXGOOOOOOOOXXXXXXXXXXXGOOOOOOOOXXXXXXXXXXXGOXXXXXXXXXXXXXXXXXX,0,0,0
14868,76,0,76,71,453,0,0,156,52,104,GOOOOOOXXXXXXXXXXXXXGOOOOOOXXXXXXXXXXXXXGOOOOXXXXXXXXXXXXXXXGOOOOXXXXXXXXXXXXXXXGOOOOOXXXXXXXXXXXXXXGOOOOOOXXXXXXXXXXXXXGOOOOOXXXXXXXXXXXXXXGOOXXXXXXXXXXXXXXXXXGOOOOOOXXXXXXXXXXXXXGOOXXXXXXXXXXXXXXXXXGOOOOOOOOXXXXXXXXXXXGOOOOOOOOXXXXXXXXXXXGOXXXXXXXXXXXXXXXXXX,0,0,0
14889,76,0,76,63,461,0,0,163,49,114,GOOOOOOXXXXXXXXXXXXXGOOOOOOXXXXXXXXXXXXXGOOOOXXXXXXXXXXXXXXXGOOOOXXXXXXXXXXXXXXXGOOOOOXXXXXXXXXXXXXXGOOOOOOXXXXXXXXXXXXXGOOOOOXXXXXXXXXXXXXXGOOXXXXXXXXXXXXXXXXXGOOOOOOXXXXXXXXXXXXXGOOXXXXXXXXXXXXXXXXXGOOOOOOOOXXXXXXXXXXXGOOOOOOOOXXXXXXXXXXXGOXXXXXXXXXXXXXXXXXX,0,0,0

14910,76,0,76,64,460,0,0,164,48,116,GOOOOOOXXXXXXXXXXXXXGOOOOOOXXXXXXXXXXXXXGOOOOXXXXXXXXXXXXXXXGOOOOXXXXXXXXXXXXXXXGOOOOOXXXXXXXXXXXXXXGOOOOOOXXXXXXXXXXXXXGOOOOOXXXXXXXXXXXXXXGOOXXXXXXXXXXXXXXXXXGOOOOOOXXXXXXXXXXXXXGOOXXXXXXXXXXXXXXXXXGOOOOOOOOXXXXXXXXXXXGOOOOOOOOXXXXXXXXXXXGOXXXXXXXXXXXXXXXXXX,0,0,0
14931,76,0,76,63,461,0,0,165,49,116,GOOOOOOXXXXXXXXXXXXXGOOOOOOXXXXXXXXXXXXXGOOOOXXXXXXXXXXXXXXXGOOOOXXXXXXXXXXXXXXXGOOOOOXXXXXXXXXXXXXXGOOOOOOXXXXXXXXXXXXXGOOOOOXXXXXXXXXXXXXXGOOXXXXXXXXXXXXXXXXXGOOOOOOXXXXXXXXXXXXXGOOXXXXXXXXXXXXXXXXXGOOOOOOOOXXXXXXXXXXXGOOOOOOOOXXXXXXXXXXXGOXXXXXXXXXXXXXXXXXX,0,0,0
14952,76,0,76,68,456,0,0,160,49,111,GOOOOOOXXXXXXXXXXXXXGOOOOOOXXXXXXXXXXXXXGOOOOXXXXXXXXXXXXXXXGOOOOXXXXXXXXXXXXXXXGOOOOOXXXXXXXXXXXXXXGOOOOOOXXXXXXXXXXXXXGOOOOOXXXXXXXXXXXXXXGOOXXXXXXXXXXXXXXXXXGOOOOOOXXXXXXXXXXXXXGOOXXXXXXXXXXXXXXXXXGOOOOOOOOXXXXXXXXXXXGOOOOOOOOXXXXXXXXXXXGOXXXXXXXXXXXXXXXXXX,0,0,0
14973,76,0,76,72,452,0,0,157,46,111,GOOOOOOXXXXXXXXXXXXXGOOOOOOXXXXXXXXXXXXXGOOOOXXXXXXXXXXXXXXXGOOOOXXXXXXXXXXXXXXXGOOOOOXXXXXXXXXXXXXXGOOOOOOXXXXXXXXXXXXXGOOOOOXXXXXXXXXXXXXXGOOXXXXXXXXXXXXXXXXXGOOOOOOXXXXXXXXXXXXXGOOXXXXXXXXXXXXXXXXXGOOOOOOOOXXXXXXXXXXXGOOOOOOOOXXXXXXXXXXXGOXXXXXXXXXXXXXXXXXX,0,0,0
14994,76,0,76,66,458,0,0,162,44,118,GOOOOOOXXXXXXXXXXXXXGOOOOOOXXXXXXXXXXXXXGOOOOXXXXXXXXXXXXXXXGOOOOXXXXXXXXXXXXXXXGOOOOOXXXXXXXXXXXXXXGOOOOOOXXXXXXXXXXXXXGOOOOOXXXXXXXXXXXXXXGOOXXXXXXXXXXXXXXXXXGOOOOOOXXXXXXXXXXXXXGOOXXXXXXXXXXXXXXXXXGOOOOOOOOXXXXXXXXXXXGOOOOOOOOXXXXXXXXXXXGOXXXXXXXXXXXXXXXXXX,0,0,0

15015,76,0,76,63,461,0,0,165,43,122,GOOOOOOXXXXXXXXXXXXXGOOOOOOXXXXXXXXXXXXXGOOOOXXXXXXXXXXXXXXXGOOOOXXXXXXXXXXXXXXXGOOOOOXXXXXXXXXXXXXXGOOOOOOXXXXXXXXXXXXXGOOOOOXXXXXXXXXXXXXXGOOXXXXXXXXXXXXXXXXXGOOOOOOXXXXXXXXXXXXXGOOXXXXXXXXXXXXXXXXXGOOOOOOOOXXXXXXXXXXXGOOOOOOOOXXXXXXXXXXXGOXXXXXXXXXXXXXXXXXX,0,0,0
15036,76,0,76,61,463,0,0,168,47,121,GOOOOOOXXXXXXXXXXXXXGOOOOOOXXXXXXXXXXXXXGOOOOXXXXXXXXXXXXXXXGOOOOXXXXXXXXXXXXXXXGOOOOOXXXXXXXXXXXXXXGOOOOOOXXXXXXXXXXXXXGOOOOOXXXXXXXXXXXXXXGOOXXXXXXXXXXXXXXXXXGOOOOOOXXXXXXXXXXXXXGOOXXXXXXXXXXXXXXXXXGOOOOOOOOXXXXXXXXXXXGOOOOOOOOXXXXXXXXXXXGOXXXXXXXXXXXXXXXXXX,0,0,0
15057,76,0,76,60,464,0,0,169,48,121,GOOOOOOXXXXXXXXXXXXXGOOOOOOXXXXXXXXXXXXXGOOOOXXXXXXXXXXXXXXXGOOOOXXXXXXXXXXXXXXXGOOOOOXXXXXXXXXXXXXXGOOOOOOXXXXXXXXXXXXXGOOOOOXXXXXXXXXXXXXXGOOXXXXXXXXXXXXXXXXXGOOOOOOXXXXXXXXXXXXXGOOXXXXXXXXXXXXXXXXXGOOOOOOOOXXXXXXXXXXXGOOOOOOOOXXXXXXXXXXXGOXXXXXXXXXXXXXXXXXX,0,0,0
15078,76,0,76,64,460,0,0,164,46,118,GOOOOOOXXXXXXXXXXXXXGOOOOOOXXXXXXXXXXXXXGOOOOXXXXXXXXXXXXXXXGOOOOXXXXXXXXXXXXXXXGOOOOOXXXXXXXXXXXXXXGOOOOOOXXXXXXXXXXXXXGOOOOOXXXXXXXXXXXXXXGOOXXXXXXXXXXXXXXXXXGOOOOOOXXXXXXXXXXXXXGOOXXXXXXXXXXXXXXXXXGOOOOOOOOXXXXXXXXXXXGOOOOOOOOXXXXXXXXXXXGOXXXXXXXXXXXXXXXXXX,0,0,0
15099,76,0,76,60,464,0,0,168,47,121,GOOOOOOXXXXXXXXXXXXXGOOOOOOXXXXXXXXXXXXXGOOOOXXXXXXXXXXXXXXXGOOOOXXXXXXXXXXXXXXXGOOOOOXXXXXXXXXXXXXXGOOOOOOXXXXXXXXXXXXXGOOOOOXXXXXXXXXXXXXXGOOXXXXXXXXXXXXXXXXXGOOOOOOXXXXXXXXXXXXXGOOXXXXXXXXXXXXXXXXXGOOOOOOOOXXXXXXXXXXXGOOOOOOOOXXXXXXXXXXXGOXXXXXXXXXXXXXXXXXX,0,0,0

15120,76,0,76,59,465,0,0,168,52,116,GOOOOOOXXXXXXXXXXXXXGOOOOOOXXXXXXXXXXXXXGOOOOXXXXXXXXXXXXXXXGOOOOXXXXXXXXXXXXXXXGOOOOOXXXXXXXXXXXXXXGOOOOOOXXXXXXXXXXXXXGOOOOOXXXXXXXXXXXXXXGOOXXXXXXXXXXXXXXXXXGOOOOOOXXXXXXXXXXXXXGOOXXXXXXXXXXXXXXXXXGOOOOOOOOXXXXXXXXXXXGOOOOOOOOXXXXXXXXXXXGOXXXXXXXXXXXXXXXXXX,0,0,0
15141,76,0,76,66,458,0,0,162,49,113,GOOOOOOXXXXXXXXXXXXXGOOOOOOXXXXXXXXXXXXXGOOOOXXXXXXXXXXXXXXXGOOOOXXXXXXXXXXXXXXXGOOOOOXXXXXXXXXXXXXXGOOOOOOXXXXXXXXXXXXXGOOOOOXXXXXXXXXXXXXXGOOXXXXXXXXXXXXXXXXXGOOOOOOXXXXXXXXXXXXXGOOXXXXXXXXXXXXXXXXXGOOOOOOOOXXXXXXXXXXXGOOOOOOOOXXXXXXXXXXXGOXXXXXXXXXXXXXXXXXX,0,0,0
15162,76,0,76,63,461,0,0,164,49,115,GOOOOOOXXXXXXXXXXXXXGOOOOOOXXXXXXXXXXXXXGOOOOXXXXXXXXXXXXXXXGOOOOXXXXXXXXXXXXXXXGOOOOOXXXXXXXXXXXXXXGOOOOOOXXXXXXXXXXXXXGOOOOOXXXXXXXXXXXXXXGOOXXXXXXXXXXXXXXXXXGOOOOOOXXXXXXXXXXXXXGOOXXXXXXXXXXXXXXXXXGOOOOOOOOXXXXXXXXXXXGOOOOOOOOXXXXXXXXXXXGOXXXXXXXXXXXXXXXXXX,0,0,0
15183,76,0,76,57,467,0,0,171,50,121,GOOOOOOXXXXXXXXXXXXXGOOOOOOXXXXXXXXXXXXXGOOOOXXXXXXXXXXXXXXXGOOOOXXXXXXXXXXXXXXXGOOOOOXXXXXXXXXXXXXXGOOOOOOXXXXXXXXXXXXXGOOOOOXXXXXXXXXXXXXXGOOXXXXXXXXXXXXXXXXXGOOOOOOXXXXXXXXXXXXXGOOXXXXXXXXXXXXXXXXXGOOOOOOOOXXXXXXXXXXXGOOOOOOOOXXXXXXXXXXXGOXXXXXXXXXXXXXXXXXX,0,0,0
15204,76,0,76,60,464,0,0,168,50,118,GOOOOOOXXXXXXXXXXXXXGOOOOOOXXXXXXXXXXXXXGOOOOXXXXXXXXXXXXXXXGOOOOXXXXXXXXXXXXXXXGOOOOOXXXXXXXXXXXXXXGOOOOOOXXXXXXXXXXXXXGOOOOOXXXXXXXXXXXXXXGOOXXXXXXXXXXXXXXXXXGOOOOOOXXXXXXXXXXXXXGOOXXXXXXXXXXXXXXXXXGOOOOOOOOXXXXXXXXXXXGOOOOOOOOXXXXXXXXXXXGOXXXXXXXXXXXXXXXXXX,0,0,0

15225,76,0,76,57,467,0,0,172,55,117,GOOOOOOXXXXXXXXXXXXXGOOOOOOXXXXXXXXXXXXXGOOOOXXXXXXXXXXXXXXXGOOOOXXXXXXXXXXXXXXXGOOOOOXXXXXXXXXXXXXXGOOOOOOXXXXXXXXXXXXXGOOOOOXXXXXXXXXXXXXXGOOXXXXXXXXXXXXXXXXXGOOOOOOXXXXXXXXXXXXXGOOXXXXXXXXXXXXXXXXXGOOOOOOOOXXXXXXXXXXXGOOOOOOOOXXXXXXXXXXXGOXXXXXXXXXXXXXXXXXX,0,0,0
15246,76,0,76,58,466,0,0,170,53,117,GOOOOOOXXXXXXXXXXXXXGOOOOOOXXXXXXXXXXXXXGOOOOXXXXXXXXXXXXXXXGOOOOXXXXXXXXXXXXXXXGOOOOOXXXXXXXXXXXXXXGOOOOOOXXXXXXXXXXXXXGOOOOOXXXXXXXXXXXXXXGOOXXXXXXXXXXXXXXXXXGOOOOOOXXXXXXXXXXXXXGOOXXXXXXXXXXXXXXXXXGOOOOOOOOXXXXXXXXXXXGOOOOOOOOXXXXXXXXXXXGOXXXXXXXXXXXXXXXXXX,0,0,0
15267,76,0,76,59,465,0,0,169,48,121,GOOOOOOXXXXXXXXXXXXXGOOOOOOXXXXXXXXXXXXXGOOOOXXXXXXXXXXXXXXXGOOOOXXXXXXXXXXXXXXXGOOOOOXXXXXXXXXXXXXXGOOOOOOXXXXXXXXXXXXXGOOOOOXXXXXXXXXXXXXXGOOXXXXXXXXXXXXXXXXXGOOOOOOXXXXXXXXXXXXXGOOXXXXXXXXXXXXXXXXXGOOOOOOOOXXXXXXXXXXXGOOOOOOOOXXXXXXXXXXXGOXXXXXXXXXXXXXXXXXX,0,0,0
15288,76,0,76,56,468,0,0,172,49,123,GOOOOOOXXXXXXXXXXXXXGOOOOOOXXXXXXXXXXXXXGOOOOXXXXXXXXXXXXXXXGOOOOXXXXXXXXXXXXXXXGOOOOOXXXXXXXXXXXXXXGOOOOOOXXXXXXXXXXXXXGOOOOOXXXXXXXXXXXXXXGOOXXXXXXXXXXXXXXXXXGOOOOOOXXXXXXXXXXXXXGOOXXXXXXXXXXXXXXXXXGOOOOOOOOXXXXXXXXXXXGOOOOOOOOXXXXXXXXXXXGOXXXXXXXXXXXXXXXXXX,0,0,0
15309,76,0,76,52,472,0,0,176,52,124,GOOOOOOXXXXXXXXXXXXXGOOOOOOXXXXXXXXXXXXXGOOOOXXXXXXXXXXXXXXXGOOOOXXXXXXXXXXXXXXXGOOOOOXXXXXXXXXXXXXXGOOOOOOXXXXXXXXXXXXXGOOOOOXXXXXXXXXXXXXXGOOXXXXXXXXXXXXXXXXXGOOOOOOXXXXXXXXXXXXXGOOXXXXXXXXXXXXXXXXXGOOOOOOOOXXXXXXXXXXXGOOOOOOOOXXXXXXXXXXXGOXXXXXXXXXXXXXXXXXX,0,0,0

15330,76,0,76,52,472,0,0,177,50,127,GOOOOOOXXXXXXXXXXXXXGOOOOOOXXXXXXXXXXXXXGOOOOXXXXXXXXXXXXXXXGOOOOXXXXXXXXXXXXXXXGOOOOOXXXXXXXXXXXXXXGOOOOOOXXXXXXXXXXXXXGOOOOOXXXXXXXXXXXXXXGOOXXXXXXXXXXXXXXXXXGOOOOOOXXXXXXXXXXXXXGOOXXXXXXXXXXXXXXXXXGOOOOOOOOXXXXXXXXXXXGOOOOOOOOXXXXXXXXXXXGOXXXXXXXXXXXXXXXXXX,0,0,0
15351,76,0,76,53,471,0,0,176,52,124,GOOOOOOXXXXXXXXXXXXXGOOOOOOXXXXXXXXXXXXXGOOOOXXXXXXXXXXXXXXXGOOOOXXXXXXXXXXXXXXXGOOOOOXXXXXXXXXXXXXXGOOOOOOXXXXXXXXXXXXXGOOOOOXXXXXXXXXXXXXXGOOXXXXXXXXXXXXXXXXXGOOOOOOXXXXXXXXXXXXXGOOXXXXXXXXXXXXXXXXXGOOOOOOOOXXXXXXXXXXXGOOOOOOOOXXXXXXXXXXXGOXXXXXXXXXXXXXXXXXX,0,0,0
15372,76,0,76,53,471,0,0,174,52,122,GOOOOOOXXXXXXXXXXXXXGOOOOOOXXXXXXXXXXXXXGOOOOXXXXXXXXXXXXXXXGOOOOXXXXXXXXXXXXXXXGOOOOOXXXXXXXXXXXXXXGOOOOOOXXXXXXXXXXXXXGOOOOOXXXXXXXXXXXXXXGOOXXXXXXXXXXXXXXXXXGOOOOOOXXXXXXXXXXXXXGOOXXXXXXXXXXXXXXXXXGOOOOOOOOXXXXXXXXXXXGOOOOOOOOXXXXXXXXXXXGOXXXXXXXXXXXXXXXXXX,0,0,0
15393,76,0,76,54,470,0,0,174,52,122,GOOOOOOXXXXXXXXXXXXXGOOOOOOXXXXXXXXXXXXXGOOOOXXXXXXXXXXXXXXXGOOOOXXXXXXXXXXXXXXXGOOOOOXXXXXXXXXXXXXXGOOOOOOXXXXXXXXXXXXXGOOOOOXXXXXXXXXXXXXXGOOXXXXXXXXXXXXXXXXXGOOOOOOXXXXXXXXXXXXXGOOXXXXXXXXXXXXXXXXXGOOOOOOOOXXXXXXXXXXXGOOOOOOOOXXXXXXXXXXXGOXXXXXXXXXXXXXXXXXX,0,0,0
15414,76,0,76,48,476,0,0,179,51,128,GOOOOOOXXXXXXXXXXXXXGOOOOOOXXXXXXXXXXXXXGOOOOXXXXXXXXXXXXXXXGOOOOXXXXXXXXXXXXXXXGOOOOOXXXXXXXXXXXXXXGOOOOOOXXXXXXXXXXXXXGOOOOOXXXXXXXXXXXXXXGOOXXXXXXXXXXXXXXXXXGOOOOOOXXXXXXXXXXXXXGOOXXXXXXXXXXXXXXXXXGOOOOOOOOXXXXXXXXXXXGOOOOOOOOXXXXXXXXXXXGOXXXXXXXXXXXXXXXXXX,0,0,0

15435,76,0,76,51,473,0,0,175,51,124,GOOOOOOXXXXXXXXXXXXXGOOOOOOXXXXXXXXXXXXXGOOOOXXXXXXXXXXXXXXXGOOOOXXXXXXXXXXXXXXXGOOOOOXXXXXXXXXXXXXXGOOOOOOXXXXXXXXXXXXXGOOOOOXXXXXXXXXXXXXXGOOXXXXXXXXXXXXXXXXXGOOOOOOXXXXXXXXXXXXXGOOXXXXXXXXXXXXXXXXXGOOOOOOOOXXXXXXXXXXXGOOOOOOOOXXXXXXXXXXXGOXXXXXXXXXXXXXXXXXX,0,0,0
15456,76,0,76,47,477,0,0,181,53,128,GOOOOOOXXXXXXXXXXXXXGOOOOOOXXXXXXXXXXXXXGOOOOXXXXXXXXXXXXXXXGOOOOXXXXXXXXXXXXXXXGOOOOOXXXXXXXXXXXXXXGOOOOOOXXXXXXXXXXXXXGOOOOOXXXXXXXXXXXXXXGOOXXXXXXXXXXXXXXXXXGOOOOOOXXXXXXXXXXXXXGOOXXXXXXXXXXXXXXXXXGOOOOOOOOXXXXXXXXXXXGOOOOOOOOXXXXXXXXXXXGOXXXXXXXXXXXXXXXXXX,0,0,0
15477,76,0,76,50,474,0,0,176,50,126,GOOOOOOXXXXXXXXXXXXXGOOOOOOXXXXXXXXXXXXXGOOOOXXXXXXXXXXXXXXXGOOOOXXXXXXXXXXXXXXXGOOOOOXXXXXXXXXXXXXXGOOOOOOXXXXXXXXXXXXXGOOOOOXXXXXXXXXXXXXXGOOXXXXXXXXXXXXXXXXXGOOOOOOXXXXXXXXXXXXXGOOXXXXXXXXXXXXXXXXXGOOOOOOOOXXXXXXXXXXXGOOOOOOOOXXXXXXXXXXXGOXXXXXXXXXXXXXXXXXX,0,0,0
15498,76,0,76,50,474,0,0,177,51,126,GOOOOOOXXXXXXXXXXXXXGOOOOOOXXXXXXXXXXXXXGOOOOXXXXXXXXXXXXXXXGOOOOXXXXXXXXXXXXXXXGOOOOOXXXXXXXXXXXXXXGOOOOOOXXXXXXXXXXXXXGOOOOOXXXXXXXXXXXXXXGOOXXXXXXXXXXXXXXXXXGOOOOOOXXXXXXXXXXXXXGOOXXXXXXXXXXXXXXXXXGOOOOOOOOXXXXXXXXXXXGOOOOOOOOXXXXXXXXXXXGOXXXXXXXXXXXXXXXXXX,0,0,0
15519,76,0,76,52,472,0,0,175,56,119,GOOOOOOXXXXXXXXXXXXXGOOOOOOXXXXXXXXXXXXXGOOOOXXXXXXXXXXXXXXXGOOOOXXXXXXXXXXXXXXXGOOOOOXXXXXXXXXXXXXXGOOOOOOXXXXXXXXXXXXXGOOOOOXXXXXXXXXXXXXXGOOXXXXXXXXXXXXXXXXXGOOOOOOXXXXXXXXXXXXXGOOXXXXXXXXXXXXXXXXXGOOOOOOOOXXXXXXXXXXXGOOOOOOOOXXXXXXXXXXXGOXXXXXXXXXXXXXXXXXX,0,0,0

15540,76,0,76,63,461,0,0,164,49,115,GOOOOOOXXXXXXXXXXXXXGOOOOOOXXXXXXXXXXXXXGOOOOXXXXXXXXXXXXXXXGOOOOXXXXXXXXXXXXXXXGOOOOOXXXXXXXXXXXXXXGOOOOOOXXXXXXXXXXXXXGOOOOOXXXXXXXXXXXXXXGOOXXXXXXXXXXXXXXXXXGOOOOOOXXXXXXXXXXXXXGOOXXXXXXXXXXXXXXXXXGOOOOOOOOXXXXXXXXXXXGOOOOOOOOXXXXXXXXXXXGOXXXXXXXXXXXXXXXXXX,0,0,0
15561,76,0,76,64,460,0,0,163,54,109,GOOOOOOXXXXXXXXXXXXXGOOOOOOXXXXXXXXXXXXXGOOOOXXXXXXXXXXXXXXXGOOOOXXXXXXXXXXXXXXXGOOOOOXXXXXXXXXXXXXXGOOOOOOXXXXXXXXXXXXXGOOOOOXXXXXXXXXXXXXXGOOXXXXXXXXXXXXXXXXXGOOOOOOXXXXXXXXXXXXXGOOXXXXXXXXXXXXXXXXXGOOOOOOOOXXXXXXXXXXXGOOOOOOOOXXXXXXXXXXXGOXXXXXXXXXXXXXXXXXX,0,0,0
15582,76,0,76,68,456,0,0,158,47,111,GOOOOOOXXXXXXXXXXXXXGOOOOOOXXXXXXXXXXXXXGOOOOXXXXXXXXXXXXXXXGOOOOXXXXXXXXXXXXXXXGOOOOOXXXXXXXXXXXXXXGOOOOOOXXXXXXXXXXXXXGOOOOOXXXXXXXXXXXXXXGOOXXXXXXXXXXXXXXXXXGOOOOOOXXXXXXXXXXXXXGOOXXXXXXXXXXXXXXXXXGOOOOOOOOXXXXXXXXXXXGOOOOOOOOXXXXXXXXXXXGOXXXXXXXXXXXXXXXXXX,0,0,0
15603,76,0,76,70,454,0,0,157,52,105,GOOOOOOXXXXXXXXXXXXXGOOOOOOXXXXXXXXXXXXXGOOOOXXXXXXXXXXXXXXXGOOOOXXXXXXXXXXXXXXXGOOOOOXXXXXXXXXXXXXXGOOOOOOXXXXXXXXXXXXXGOOOOOXXXXXXXXXXXXXXGOOXXXXXXXXXXXXXXXXXGOOOOOOXXXXXXXXXXXXXGOOXXXXXXXXXXXXXXXXXGOOOOOOOOXXXXXXXXXXXGOOOOOOOOXXXXXXXXXXXGOXXXXXXXXXXXXXXXXXX,0,0,0
15624,76,0,76,79,445,0,0,149,48,101,GOOOOOOXXXXXXXXXXXXXGOOOOOOXXXXXXXXXXXXXGOOOOXXXXXXXXXXXXXXXGOOOOXXXXXXXXXXXXXXXGOOOOOXXXXXXXXXXXXXXGOOOOOOXXXXXXXXXXXXXGOOOOOXXXXXXXXXXXXXXGOOXXXXXXXXXXXXXXXXXGOOOOOOXXXXXXXXXXXXXGOOXXXXXXXXXXXXXXXXXGOOOOOOOOXXXXXXXXXXXGOOOOOOOOXXXXXXXXXXXGOXXXXXXXXXXXXXXXXXX,0,0,0

15645,76,0,76,77,447,0,0,151,49,102,GOOOOOOXXXXXXXXXXXXXGOOOOOOXXXXXXXXXXXXXGOOOOXXXXXXXXXXXXXXXGOOOOXXXXXXXXXXXXXXXGOOOOOXXXXXXXXXXXXXXGOOOOOOXXXXXXXXXXXXXGOOOOOXXXXXXXXXXXXXXGOOXXXXXXXXXXXXXXXXXGOOOOOOXXXXXXXXXXXXXGOOXXXXXXXXXXXXXXXXXGOOOOOOOOXXXXXXXXXXXGOOOOOOOOXXXXXXXXXXXGOXXXXXXXXXXXXXXXXXX,0,0,0
15666,76,0,76,73,451,0,0,152,54,98,GOOOOOOXXXXXXXXXXXXXGOOOOOOXXXXXXXXXXXXXGOOOOXXXXXXXXXXXXXXXGOOOOXXXXXXXXXXXXXXXGOOOOOXXXXXXXXXXXXXXGOOOOOOXXXXXXXXXXXXXGOOOOOXXXXXXXXXXXXXXGOOXXXXXXXXXXXXXXXXXGOOOOOOXXXXXXXXXXXXXGOOXXXXXXXXXXXXXXXXXGOOOOOOOOXXXXXXXXXXXGOOOOOOOOXXXXXXXXXXXGOXXXXXXXXXXXXXXXXXX,0,0,0
15687,76,0,76,78,446,0,0,150,49,101,GOOOOOOXXXXXXXXXXXXXGOOOOOOXXXXXXXXXXXXXGOOOOXXXXXXXXXXXXXXXGOOOOXXXXXXXXXXXXXXXGOOOOOXXXXXXXXXXXXXXGOOOOOOXXXXXXXXXXXXXGOOOOOXXXXXXXXXXXXXXGOOXXXXXXXXXXXXXXXXXGOOOOOOXXXXXXXXXXXXXGOOXXXXXXXXXXXXXXXXXGOOOOOOOOXXXXXXXXXXXGOOOOOOOOXXXXXXXXXXXGOXXXXXXXXXXXXXXXXXX,0,0,0
15708,76,0,76,77,447,0,0,151,55,96,GOOOOOOXXXXXXXXXXXXXGOOOOOOXXXXXXXXXXXXXGOOOOXXXXXXXXXXXXXXXGOOOOXXXXXXXXXXXXXXXGOOOOOXXXXXXXXXXXXXXGOOOOOOXXXXXXXXXXXXXGOOOOOXXXXXXXXXXXXXXGOOXXXXXXXXXXXXXXXXXGOOOOOOXXXXXXXXXXXXXGOOXXXXXXXXXXXXXXXXXGOOOOOOOOXXXXXXXXXXXGOOOOOOOOXXXXXXXXXXXGOXXXXXXXXXXXXXXXXXX,0,0,0
15729,77,1,76,82,441,0,0,144,51,93,GOOOOOOXXXXXXXXXXXXXGOOOOOOXXXXXXXXXXXXXGOOOOXXXXXXXXXXXXXXXGOOOOXXXXXXXXXXXXXXXGOOOOOXXXXXXXXXXXXXXGOOOOOOXXXXXXXXXXXXXGOOOOOAXXXXXXXXXXXXXGOOXXXXXXXXXXXXXXXXXGOOOOOOXXXXXXXXXXXXXGOOXXXXXXXXXXXXXXXXXGOOOOOOOOXXXXXXXXXXXGOOOOOOOOXXXXXXXXXXXGOXXXXXXXXXXXXXXXXXX,0,0,0

15750,77,0,77,83,440,0,0,143,51,92,GOOOOOOXXXXXXXXXXXXXGOOOOOOXXXXXXXXXXXXXGOOOOXXXXXXXXXXXXXXXGOOOOXXXXXXXXXXXXXXXGOOOOOXXXXXXXXXXXXXXGOOOOOOXXXXXXXXXXXXXGOOOOOOXXXXXXXXXXXXXGOOXXXXXXXXXXXXXXXXXGOOOOOOXXXXXXXXXXXXXGOOXXXXXXXXXXXXXXXXXGOOOOOOOOXXXXXXXXXXXGOOOOOOOOXXXXXXXXXXXGOXXXXXXXXXXXXXXXXXX,0,0,0
15771,77,0,77,74,449,0,0,153,53,100,GOOOOOOXXXXXXXXXXXXXGOOOOOOXXXXXXXXXXXXXGOOOOXXXXXXXXXXXXXXXGOOOOXXXXXXXXXXXXXXXGOOOOOXXXXXXXXXXXXXXGOOOOOOXXXXXXXXXXXXXGOOOOOOXXXXXXXXXXXXXGOOXXXXXXXXXXXXXXXXXGOOOOOOXXXXXXXXXXXXXGOOXXXXXXXXXXXXXXXXXGOOOOOOOOXXXXXXXXXXXGOOOOOOOOXXXXXXXXXXXGOXXXXXXXXXXXXXXXXXX,0,0,0
15792,78,1,77,72,450,0,0,154,57,97,GOOOOOOAXXXXXXXXXXXXGOOOOOOXXXXXXXXXXXXXGOOOOXXXXXXXXXXXXXXXGOOOOXXXXXXXXXXXXXXXGOOOOOXXXXXXXXXXXXXXGOOOOOOXXXXXXXXXXXXXGOOOOOOXXXXXXXXXXXXXGOOXXXXXXXXXXXXXXXXXGOOOOOOXXXXXXXXXXXXXGOOXXXXXXXXXXXXXXXXXGOOOOOOOOXXXXXXXXXXXGOOOOOOOOXXXXXXXXXXXGOXXXXXXXXXXXXXXXXXX,0,0,0
15813,78,1,77,77,445,0,0,150,52,98,GOOOOOOAXXXXXXXXXXXXGOOOOOOXXXXXXXXXXXXXGOOOOXXXXXXXXXXXXXXXGOOOOXXXXXXXXXXXXXXXGOOOOOXXXXXXXXXXXXXXGOOOOOOXXXXXXXXXXXXXGOOOOOOXXXXXXXXXXXXXGOOXXXXXXXXXXXXXXXXXGOOOOOOXXXXXXXXXXXXXGOOXXXXXXXXXXXXXXXXXGOOOOOOOOXXXXXXXXXXXGOOOOOOOOXXXXXXXXXXXGOXXXXXXXXXXXXXXXXXX,0,0,0
15834,78,1,77,72,450,0,0,154,50,104,GOOOOOOAXXXXXXXXXXXXGOOOOOOXXXXXXXXXXXXXGOOOOXXXXXXXXXXXXXXXGOOOOXXXXXXXXXXXXXXXGOOOOOXXXXXXXXXXXXXXGOOOOOOXXXXXXXXXXXXXGOOOOOOXXXXXXXXXXXXXGOOXXXXXXXXXXXXXXXXXGOOOOOOXXXXXXXXXXXXXGOOXXXXXXXXXXXXXXXXXGOOOOOOOOXXXXXXXXXXXGOOOOOOOOXXXXXXXXXXXGOXXXXXXXXXXXXXXXXXX,0,0,0

15855,78,1,77,63,459,0,0,164,47,117,GOOOOOOAXXXXXXXXXXXXGOOOOOOXXXXXXXXXXXXXGOOOOXXXXXXXXXXXXXXXGOOOOXXXXXXXXXXXXXXXGOOOOOXXXXXXXXXXXXXXGOOOOOOXXXXXXXXXXXXXGOOOOOOXXXXXXXXXXXXXGOOXXXXXXXXXXXXXXXXXGOOOOOOXXXXXXXXXXXXXGOOXXXXXXXXXXXXXXXXXGOOOOOOOOXXXXXXXXXXXGOOOOOOOOXXXXXXXXXXXGOXXXXXXXXXXXXXXXXXX,0,0,0
15876,78,1,77,60,462,0,0,167,50,117,GOOOOOOAXXXXXXXXXXXXGOOOOOOXXXXXXXXXXXXXGOOOOXXXXXXXXXXXXXXXGOOOOXXXXXXXXXXXXXXXGOOOOOXXXXXXXXXXXXXXGOOOOOOXXXXXXXXXXXXXGOOOOOOXXXXXXXXXXXXXGOOXXXXXXXXXXXXXXXXXGOOOOOOXXXXXXXXXXXXXGOOXXXXXXXXXXXXXXXXXGOOOOOOOOXXXXXXXXXXXGOOOOOOOOXXXXXXXXXXXGOXXXXXXXXXXXXXXXXXX,0,0,0
15897,78,1,77,57,465,0,0,169,50,119,GOOOOOOAXXXXXXXXXXXXGOOOOOOXXXXXXXXXXXXXGOOOOXXXXXXXXXXXXXXXGOOOOXXXXXXXXXXXXXXXGOOOOOXXXXXXXXXXXXXXGOOOOOOXXXXXXXXXXXXXGOOOOOOXXXXXXXXXXXXXGOOXXXXXXXXXXXXXXXXXGOOOOOOXXXXXXXXXXXXXGOOXXXXXXXXXXXXXXXXXGOOOOOOOOXXXXXXXXXXXGOOOOOOOOXXXXXXXXXXXGOXXXXXXXXXXXXXXXXXX,0,0,0
15918,78,1,77,54,468,0,0,173,48,125,GOOOOOOAXXXXXXXXXXXXGOOOOOOXXXXXXXXXXXXXGOOOOXXXXXXXXXXXXXXXGOOOOXXXXXXXXXXXXXXXGOOOOOXXXXXXXXXXXXXXGOOOOOOXXXXXXXXXXXXXGOOOOOOXXXXXXXXXXXXXGOOXXXXXXXXXXXXXXXXXGOOOOOOXXXXXXXXXXXXXGOOXXXXXXXXXXXXXXXXXGOOOOOOOOXXXXXXXXXXXGOOOOOOOOXXXXXXXXXXXGOXXXXXXXXXXXXXXXXXX,0,0,0
15939,78,1,77,46,476,0,0,181,52,129,GOOOOOOAXXXXXXXXXXXXGOOOOOOXXXXXXXXXXXXXGOOOOXXXXXXXXXXXXXXXGOOOOXXXXXXXXXXXXXXXGOOOOOXXXXXXXXXXXXXXGOOOOOOXXXXXXXXXXXXXGOOOOOOXXXXXXXXXXXXXGOOXXXXXXXXXXXXXXXXXGOOOOOOXXXXXXXXXXXXXGOOXXXXXXXXXXXXXXXXXGOOOOOOOOXXXXXXXXXXXGOOOOOOOOXXXXXXXXXXXGOXXXXXXXXXXXXXXXXXX,0,0,0

15960,78,1,77,48,474,0,0,178,47,131,GOOOOOOAXXXXXXXXXXXXGOOOOOOXXXXXXXXXXXXXGOOOOXXXXXXXXXXXXXXXGOOOOXXXXXXXXXXXXXXXGOOOOOXXXXXXXXXXXXXXGOOOOOOXXXXXXXXXXXXXGOOOOOOXXXXXXXXXXXXXGOOXXXXXXXXXXXXXXXXXGOOOOOOXXXXXXXXXXXXXGOOXXXXXXXXXXXXXXXXXGOOOOOOOOXXXXXXXXXXXGOOOOOOOOXXXXXXXXXXXGOXXXXXXXXXXXXXXXXXX,0,0,0
15981,78,1,77,49,473,0,0,176,49,127,GOOOOOOAXXXXXXXXXXXXGOOOOOOXXXXXXXXXXXXXGOOOOXXXXXXXXXXXXXXXGOOOOXXXXXXXXXXXXXXXGOOOOOXXXXXXXXXXXXXXGOOOOOOXXXXXXXXXXXXXGOOOOOOXXXXXXXXXXXXXGOOXXXXXXXXXXXXXXXXXGOOOOOOXXXXXXXXXXXXXGOOXXXXXXXXXXXXXXXXXGOOOOOOOOXXXXXXXXXXXGOOOOOOOOXXXXXXXXXXXGOXXXXXXXXXXXXXXXXXX,0,0,0
16002,78,1,77,45,477,0,0,181,50,131,GOOOOOOAXXXXXXXXXXXXGOOOOOOXXXXXXXXXXXXXGOOOOXXXXXXXXXXXXXXXGOOOOXXXXXXXXXXXXXXXGOOOOOXXXXXXXXXXXXXXGOOOOOOXXXXXXXXXXXXXGOOOOOOXXXXXXXXXXXXXGOOXXXXXXXXXXXXXXXXXGOOOOOOXXXXXXXXXXXXXGOOXXXXXXXXXXXXXXXXXGOOOOOOOOXXXXXXXXXXXGOOOOOOOOXXXXXXXXXXXGOXXXXXXXXXXXXXXXXXX,0,0,0
16023,78,1,77,44,478,0,0,182,47,135,GOOOOOOAXXXXXXXXXXXXGOOOOOOXXXXXXXXXXXXXGOOOOXXXXXXXXXXXXXXXGOOOOXXXXXXXXXXXXXXXGOOOOOXXXXXXXXXXXXXXGOOOOOOXXXXXXXXXXXXXGOOOOOOXXXXXXXXXXXXXGOOXXXXXXXXXXXXXXXXXGOOOOOOXXXXXXXXXXXXXGOOXXXXXXXXXXXXXXXXXGOOOOOOOOXXXXXXXXXXXGOOOOOOOOXXXXXXXXXXXGOXXXXXXXXXXXXXXXXXX,0,0,0
16044,78,0,78,42,480,0,0,184,47,137,GOOOOOOOXXXXXXXXXXXXGOOOOOOXXXXXXXXXXXXXGOOOOXXXXXXXXXXXXXXXGOOOOXXXXXXXXXXXXXXXGOOOOOXXXXXXXXXXXXXXGOOOOOOXXXXXXXXXXXXXGOOOOOOXXXXXXXXXXXXXGOOXXXXXXXXXXXXXXXXXGOOOOOOXXXXXXXXXXXXXGOOXXXXXXXXXXXXXXXXXGOOOOOOOOXXXXXXXXXXXGOOOOOOOOXXXXXXXXXXXGOXXXXXXXXXXXXXXXXXX,0,0,0

16065,78,0,78,43,479,0,0,182,52,130,GOOOOOOOXXXXXXXXXXXXGOOOOOOXXXXXXXXXXXXXGOOOOXXXXXXXXXXXXXXXGOOOOXXXXXXXXXXXXXXXGOOOOOXXXXXXXXXXXXXXGOOOOOOXXXXXXXXXXXXXGOOOOOOXXXXXXXXXXXXXGOOXXXXXXXXXXXXXXXXXGOOOOOOXXXXXXXXXXXXXGOOXXXXXXXXXXXXXXXXXGOOOOOOOOXXXXXXXXXXXGOOOOOOOOXXXXXXXXXXXGOXXXXXXXXXXXXXXXXXX,0,0,0
16086,78,0,78,49,473,0,0,175,51,124,GOOOOOOOXXXXXXXXXXXXGOOOOOOXXXXXXXXXXXXXGOOOOXXXXXXXXXXXXXXXGOOOOXXXXXXXXXXXXXXXGOOOOOXXXXXXXXXXXXXXGOOOOOOXXXXXXXXXXXXXGOOOOOOXXXXXXXXXXXXXGOOXXXXXXXXXXXXXXXXXGOOOOOOXXXXXXXXXXXXXGOOXXXXXXXXXXXXXXXXXGOOOOOOOOXXXXXXXXXXXGOOOOOOOOXXXXXXXXXXXGOXXXXXXXXXXXXXXXXXX,0,0,0
16107,78,0,78,50,472,0,0,176,53,123,GOOOOOOOXXXXXXXXXXXXGOOOOOOXXXXXXXXXXXXXGOOOOXXXXXXXXXXXXXXXGOOOOXXXXXXXXXXXXXXXGOOOOOXXXXXXXXXXXXXXGOOOOOOXXXXXXXXXXXXXGOOOOOOXXXXXXXXXXXXXGOOXXXXXXXXXXXXXXXXXGOOOOOOXXXXXXXXXXXXXGOOXXXXXXXXXXXXXXXXXGOOOOOOOOXXXXXXXXXXXGOOOOOOOOXXXXXXXXXXXGOXXXXXXXXXXXXXXXXXX,0,0,0
16128,78,0,78,63,459,0,0,163,53,110,GOOOOOOOXXXXXXXXXXXXGOOOOOOXXXXXXXXXXXXXGOOOOXXXXXXXXXXXXXXXGOOOOXXXXXXXXXXXXXXXGOOOOOXXXXXXXXXXXXXXGOOOOOOXXXXXXXXXXXXXGOOOOOOXXXXXXXXXXXXXGOOXXXXXXXXXXXXXXXXXGOOOOOOXXXXXXXXXXXXXGOOXXXXXXXXXXXXXXXXXGOOOOOOOOXXXXXXXXXXXGOOOOOOOOXXXXXXXXXXXGOXXXXXXXXXXXXXXXXXX,0,0,0
16149,80,2,78,72,448,0,0,152,52,100,GOOOOOOOXXXXXXXXXXXXGOOOOOOXXXXXXXXXXXXXGOOOOXXXXXXXXXXXXXXXGOOOOXXXXXXXXXXXXXXXGOOOOOXXXXXXXXXXXXXXGOOOOOOXXXXXXXXXXXXXGOOOOOOXXXXXXXXXXXXXGOOXXXXXXXXXXXXXXXXXGOOOOOOXXXXXXXXXXXXXGOOAXXXXXXXXXXXXXXXXGOOOOOOOOXXXXXXXXXXXGOOOOOOOOXXXXXXXXXXXGOAXXXXXXXXXXXXXXXXX,0,0,0

16170,80,2,78,69,451,0,0,155,53,102,GOOOOOOOXXXXXXXXXXXXGOOOOOOXXXXXXXXXXXXXGOOOOXXXXXXXXXXXXXXXGOOOOXXXXXXXXXXXXXXXGOOOOOXXXXXXXXXXXXXXGOOOOOOXXXXXXXXXXXXXGOOOOOOXXXXXXXXXXXXXGOOXXXXXXXXXXXXXXXXXGOOOOOOXXXXXXXXXXXXXGOOAXXXXXXXXXXXXXXXXGOOOOOOOOXXXXXXXXXXXGOOOOOOOOXXXXXXXXXXXGOAXXXXXXXXXXXXXXXXX,0,0,0
16191,80,2,78,73,447,0,0,151,51,100,GOOOOOOOXXXXXXXXXXXXGOOOOOOXXXXXXXXXXXXXGOOOOXXXXXXXXXXXXXXXGOOOOXXXXXXXXXXXXXXXGOOOOOXXXXXXXXXXXXXXGOOOOOOXXXXXXXXXXXXXGOOOOOOXXXXXXXXXXXXXGOOXXXXXXXXXXXXXXXXXGOOOOOOXXXXXXXXXXXXXGOOAXXXXXXXXXXXXXXXXGOOOOOOOOXXXXXXXXXXXGOOOOOOOOXXXXXXXXXXXGOAXXXXXXXXXXXXXXXXX,0,0,0
16212,80,1,79,72,448,0,0,151,51,100,GOOOOOOOXXXXXXXXXXXXGOOOOOOXXXXXXXXXXXXXGOOOOXXXXXXXXXXXXXXXGOOOOXXXXXXXXXXXXXXXGOOOOOXXXXXXXXXXXXXXGOOOOOOXXXXXXXXXXXXXGOOOOOOXXXXXXXXXXXXXGOOXXXXXXXXXXXXXXXXXGOOOOOOXXXXXXXXXXXXXGOOOXXXXXXXXXXXXXXXXGOOOOOOOOXXXXXXXXXXXGOOOOOOOOXXXXXXXXXXXGOAXXXXXXXXXXXXXXXXX,0,0,0
16233,80,1,79,76,444,0,0,147,52,95,GOOOOOOOXXXXXXXXXXXXGOOOOOOXXXXXXXXXXXXXGOOOOXXXXXXXXXXXXXXXGOOOOXXXXXXXXXXXXXXXGOOOOOXXXXXXXXXXXXXXGOOOOOOXXXXXXXXXXXXXGOOOOOOXXXXXXXXXXXXXGOOXXXXXXXXXXXXXXXXXGOOOOOOXXXXXXXXXXXXXGOOOXXXXXXXXXXXXXXXXGOOOOOOOOXXXXXXXXXXXGOOOOOOOOXXXXXXXXXXXGOAXXXXXXXXXXXXXXXXX,0,0,0
16254,80,1,79,80,440,0,0,143,52,91,GOOOOOOOXXXXXXXXXXXXGOOOOOOXXXXXXXXXXXXXGOOOOXXXXXXXXXXXXXXXGOOOOXXXXXXXXXXXXXXXGOOOOOXXXXXXXXXXXXXXGOOOOOOXXXXXXXXXXXXXGOOOOOOXXXXXXXXXXXXXGOOXXXXXXXXXXXXXXXXXGOOOOOOXXXXXXXXXXXXXGOOOXXXXXXXXXXXXXXXXGOOOOOOOOXXXXXXXXXXXGOOOOOOOOXXXXXXXXXXXGOAXXXXXXXXXXXXXXXXX,0,0,0

16275,80,0,80,78,442,0,0,145,54,91,GOOOOOOOXXXXXXXXXXXXGOOOOOOXXXXXXXXXXXXXGOOOOXXXXXXXXXXXXXXXGOOOOXXXXXXXXXXXXXXXGOOOOOXXXXXXXXXXXXXXGOOOOOOXXXXXXXXXXXXXGOOOOOOXXXXXXXXXXXXXGOOXXXXXXXXXXXXXXXXXGOOOOOOXXXXXXXXXXXXXGOOOXXXXXXXXXXXXXXXXGOOOOOOOOXXXXXXXXXXXGOOOOOOOOXXXXXXXXXXXGOOXXXXXXXXXXXXXXXXX,0,0,0
16296,80,0,80,77,443,0,0,146,51,95,GOOOOOOOXXXXXXXXXXXXGOOOOOOXXXXXXXXXXXXXGOOOOXXXXXXXXXXXXXXXGOOOOXXXXXXXXXXXXXXXGOOOOOXXXXXXXXXXXXXXGOOOOOOXXXXXXXXXXXXXGOOOOOOXXXXXXXXXXXXXGOOXXXXXXXXXXXXXXXXXGOOOOOOXXXXXXXXXXXXXGOOOXXXXXXXXXXXXXXXXGOOOOOOOOXXXXXXXXXXXGOOOOOOOOXXXXXXXXXXXGOOXXXXXXXXXXXXXXXXX,0,0,0
16317,80,0,80,79,441,0,0,144,55,89,GOOOOOOOXXXXXXXXXXXXGOOOOOOXXXXXXXXXXXXXGOOOOXXXXXXXXXXXXXXXGOOOOXXXXXXXXXXXXXXXGOOOOOXXXXXXXXXXXXXXGOOOOOOXXXXXXXXXXXXXGOOOOOOXXXXXXXXXXXXXGOOXXXXXXXXXXXXXXXXXGOOOOOOXXXXXXXXXXXXXGOOOXXXXXXXXXXXXXXXXGOOOOOOOOXXXXXXXXXXXGOOOOOOOOXXXXXXXXXXXGOOXXXXXXXXXXXXXXXXX,0,0,0
16338,81,1,80,81,438,0,0,141,50,91,GOOOOOOOXXXXXXXXXXXXGOOOOOOXXXXXXXXXXXXXGOOOOXXXXXXXXXXXXXXXGOOOOXXXXXXXXXXXXXXXGOOOOOXXXXXXXXXXXXXXGOOOOOOXXXXXXXXXXXXXGOOOOOOAXXXXXXXXXXXXGOOXXXXXXXXXXXXXXXXXGOOOOOOXXXXXXXXXXXXXGOOOXXXXXXXXXXXXXXXXGOOOOOOOOXXXXXXXXXXXGOOOOOOOOXXXXXXXXXXXGOOXXXXXXXXXXXXXXXXX,0,0,0
16359,81,1,80,77,442,0,0,144,55,89,GOOOOOOOXXXXXXXXXXXXGOOOOOOXXXXXXXXXXXXXGOOOOXXXXXXXXXXXXXXXGOOOOXXXXXXXXXXXXXXXGOOOOOXXXXXXXXXXXXXXGOOOOOOXXXXXXXXXXXXXGOOOOOOAXXXXXXXXXXXXGOOXXXXXXXXXXXXXXXXXGOOOOOOXXXXXXXXXXXXXGOOOXXXXXXXXXXXXXXXXGOOOOOOOOXXXXXXXXXXXGOOOOOOOOXXXXXXXXXXXGOOXXXXXXXXXXXXXXXXX,0,0,0

16380,81,1,80,80,439,0,0,142,50,92,GOOOOOOOXXXXXXXXXXXXGOOOOOOXXXXXXXXXXXXXGOOOOXXXXXXXXXXXXXXXGOOOOXXXXXXXXXXXXXXXGOOOOOXXXXXXXXXXXXXXGOOOOOOXXXXXXXXXXXXXGOOOOOOAXXXXXXXXXXXXGOOXXXXXXXXXXXXXXXXXGOOOOOOXXXXXXXXXXXXXGOOOXXXXXXXXXXXXXXXXGOOOOOOOOXXXXXXXXXXXGOOOOOOOOXXXXXXXXXXXGOOXXXXXXXXXXXXXXXXX,0,0,0
16401,81,1,80,80,439,0,0,142,50,92,GOOOOOOOXXXXXXXXXXXXGOOOOOOXXXXXXXXXXXXXGOOOOXXXXXXXXXXXXXXXGOOOOXXXXXXXXXXXXXXXGOOOOOXXXXXXXXXXXXXXGOOOOOOXXXXXXXXXXXXXGOOOOOOAXXXXXXXXXXXXGOOXXXXXXXXXXXXXXXXXGOOOOOOXXXXXXXXXXXXXGOOOXXXXXXXXXXXXXXXXGOOOOOOOOXXXXXXXXXXXGOOOOOOOOXXXXXXXXXXXGOOXXXXXXXXXXXXXXXXX,0,0,0
16422,81,1,80,76,443,0,0,145,52,93,GOOOOOOOXXXXXXXXXXXXGOOOOOOXXXXXXXXXXXXXGOOOOXXXXXXXXXXXXXXXGOOOOXXXXXXXXXXXXXXXGOOOOOXXXXXXXXXXXXXXGOOOOOOXXXXXXXXXXXXXGOOOOOOAXXXXXXXXXXXXGOOXXXXXXXXXXXXXXXXXGOOOOOOXXXXXXXXXXXXXGOOOXXXXXXXXXXXXXXXXGOOOOOOOOXXXXXXXXXXXGOOOOOOOOXXXXXXXXXXXGOOXXXXXXXXXXXXXXXXX,0,0,0
16443,81,0,81,75,444,0,0,146,50,96,GOOOOOOOXXXXXXXXXXXXGOOOOOOXXXXXXXXXXXXXGOOOOXXXXXXXXXXXXXXXGOOOOXXXXXXXXXXXXXXXGOOOOOXXXXXXXXXXXXXXGOOOOOOXXXXXXXXXXXXXGOOOOOOOXXXXXXXXXXXXGOOXXXXXXXXXXXXXXXXXGOOOOOOXXXXXXXXXXXXXGOOOXXXXXXXXXXXXXXXXGOOOOOOOOXXXXXXXXXXXGOOOOOOOOXXXXXXXXXXXGOOXXXXXXXXXXXXXXXXX,0,0,0
16464,81,0,81,73,446,0,0,149,53,96,GOOOOOOOXXXXXXXXXXXXGOOOOOOXXXXXXXXXXXXXGOOOOXXXXXXXXXXXXXXXGOOOOXXXXXXXXXXXXXXXGOOOOOXXXXXXXXXXXXXXGOOOOOOXXXXXXXXXXXXXGOOOOOOOXXXXXXXXXXXXGOOXXXXXXXXXXXXXXXXXGOOOOOOXXXXXXXXXXXXXGOOOXXXXXXXXXXXXXXXXGOOOOOOOOXXXXXXXXXXXGOOOOOOOOXXXXXXXXXXXGOOXXXXXXXXXXXXXXXXX,0,0,0

16485,81,0,81,70,449,0,0,153,54,99,GOOOOOOOXXXXXXXXXXXXGOOOOOOXXXXXXXXXXXXXGOOOOXXXXXXXXXXXXXXXGOOOOXXXXXXXXXXXXXXXGOOOOOXXXXXXXXXXXXXXGOOOOOOXXXXXXXXXXXXXGOOOOOOOXXXXXXXXXXXXGOOXXXXXXXXXXXXXXXXXGOOOOOOXXXXXXXXXXXXXGOOOXXXXXXXXXXXXXXXXGOOOOOOOOXXXXXXXXXXXGOOOOOOOOXXXXXXXXXXXGOOXXXXXXXXXXXXXXXXX,0,0,0
16506,81,0,81,70,449,0,0,153,53,100,GOOOOOOOXXXXXXXXXXXXGOOOOOOXXXXXXXXXXXXXGOOOOXXXXXXXXXXXXXXXGOOOOXXXXXXXXXXXXXXXGOOOOOXXXXXXXXXXXXXXGOOOOOOXXXXXXXXXXXXXGOOOOOOOXXXXXXXXXXXXGOOXXXXXXXXXXXXXXXXXGOOOOOOXXXXXXXXXXXXXGOOOXXXXXXXXXXXXXXXXGOOOOOOOOXXXXXXXXXXXGOOOOOOOOXXXXXXXXXXXGOOXXXXXXXXXXXXXXXXX,0,0,0
16527,82,0,82,70,448,0,0,152,51,101,GOOOOOOOXXXXXXXXXXXXGOOOOOOXXXXXXXXXXXXXGOOOOXXXXXXXXXXXXXXXGOOOOXXXXXXXXXXXXXXXGOOOOOXXXXXXXXXXXXXXGOOOOOOOXXXXXXXXXXXXGOOOOOOOXXXXXXXXXXXXGOOXXXXXXXXXXXXXXXXXGOOOOOOXXXXXXXXXXXXXGOOOXXXXXXXXXXXXXXXXGOOOOOOOOXXXXXXXXXXXGOOOOOOOOXXXXXXXXXXXGOOXXXXXXXXXXXXXXXXX,0,0,0
16548,82,0,82,68,450,0,0,153,49,104,GOOOOOOOXXXXXXXXXXXXGOOOOOOXXXXXXXXXXXXXGOOOOXXXXXXXXXXXXXXXGOOOOXXXXXXXXXXXXXXXGOOOOOXXXXXXXXXXXXXXGOOOOOOOXXXXXXXXXXXXGOOOOOOOXXXXXXXXXXXXGOOXXXXXXXXXXXXXXXXXGOOOOOOXXXXXXXXXXXXXGOOOXXXXXXXXXXXXXXXXGOOOOOOOOXXXXXXXXXXXGOOOOOOOOXXXXXXXXXXXGOOXXXXXXXXXXXXXXXXX,0,0,0
16569,82,0,82,68,450,0,0,152,49,103,GOOOOOOOXXXXXXXXXXXXGOOOOOOXXXXXXXXXXXXXGOOOOXXXXXXXXXXXXXXXGOOOOXXXXXXXXXXXXXXXGOOOOOXXXXXXXXXXXXXXGOOOOOOOXXXXXXXXXXXXGOOOOOOOXXXXXXXXXXXXGOOXXXXXXXXXXXXXXXXXGOOOOOOXXXXXXXXXXXXXGOOOXXXXXXXXXXXXXXXXGOOOOOOOOXXXXXXXXXXXGOOOOOOOOXXXXXXXXXXXGOOXXXXXXXXXXXXXXXXX,0,0,0

16590,82,0,82,58,460,0,0,163,48,115,GOOOOOOOXXXXXXXXXXXXGOOOOOOXXXXXXXXXXXXXGOOOOXXXXXXXXXXXXXXXGOOOOXXXXXXXXXXXXXXXGOOOOOXXXXXXXXXXXXXXGOOOOOOOXXXXXXXXXXXXGOOOOOOOXXXXXXXXXXXXGOOXXXXXXXXXXXXXXXXXGOOOOOOXXXXXXXXXXXXXGOOOXXXXXXXXXXXXXXXXGOOOOOOOOXXXXXXXXXXXGOOOOOOOOXXXXXXXXXXXGOOXXXXXXXXXXXXXXXXX,0,0,0
16611,82,0,82,55,463,0,0,166,48,118,GOOOOOOOXXXXXXXXXXXXGOOOOOOXXXXXXXXXXXXXGOOOOXXXXXXXXXXXXXXXGOOOOXXXXXXXXXXXXXXXGOOOOOXXXXXXXXXXXXXXGOOOOOOOXXXXXXXXXXXXGOOOOOOOXXXXXXXXXXXXGOOXXXXXXXXXXXXXXXXXGOOOOOOXXXXXXXXXXXXXGOOOXXXXXXXXXXXXXXXXGOOOOOOOOXXXXXXXXXXXGOOOOOOOOXXXXXXXXXXXGOOXXXXXXXXXXXXXXXXX,0,0,0
16632,82,0,82,53,465,0,0,169,48,121,GOOOOOOOXXXXXXXXXXXXGOOOOOOXXXXXXXXXXXXXGOOOOXXXXXXXXXXXXXXXGOOOOXXXXXXXXXXXXXXXGOOOOOXXXXXXXXXXXXXXGOOOOOOOXXXXXXXXXXXXGOOOOOOOXXXXXXXXXXXXGOOXXXXXXXXXXXXXXXXXGOOOOOOXXXXXXXXXXXXXGOOOXXXXXXXXXXXXXXXXGOOOOOOOOXXXXXXXXXXXGOOOOOOOOXXXXXXXXXXXGOOXXXXXXXXXXXXXXXXX,0,0,0
16653,82,0,82,50,468,0,0,172,49,123,GOOOOOOOXXXXXXXXXXXXGOOOOOOXXXXXXXXXXXXXGOOOOXXXXXXXXXXXXXXXGOOOOXXXXXXXXXXXXXXXGOOOOOXXXXXXXXXXXXXXGOOOOOOOXXXXXXXXXXXXGOOOOOOOXXXXXXXXXXXXGOOXXXXXXXXXXXXXXXXXGOOOOOOXXXXXXXXXXXXXGOOOXXXXXXXXXXXXXXXXGOOOOOOOOXXXXXXXXXXXGOOOOOOOOXXXXXXXXXXXGOOXXXXXXXXXXXXXXXXX,0,0,0
16674,82,0,82,48,470,0,0,174,51,123,GOOOOOOOXXXXXXXXXXXXGOOOOOOXXXXXXXXXXXXXGOOOOXXXXXXXXXXXXXXXGOOOOXXXXXXXXXXXXXXXGOOOOOXXXXXXXXXXXXXXGOOOOOOOXXXXXXXXXXXXGOOOOOOOXXXXXXXXXXXXGOOXXXXXXXXXXXXXXXXXGOOOOOOXXXXXXXXXXXXXGOOOXXXXXXXXXXXXXXXXGOOOOOOOOXXXXXXXXXXXGOOOOOOOOXXXXXXXXXXXGOOXXXXXXXXXXXXXXXXX,0,0,0

16695,83,1,82,49,468,0,0,172,53,119,GOOOOOOOXXXXXXXXXXXXGOOOOOOXXXXXXXXXXXXXGOOOOXXXXXXXXXXXXXXXGOOOOXXXXXXXXXXXXXXXGOOOOOXXXXXXXXXXXXXXGOOOOOOOXXXXXXXXXXXXGOOOOOOOXXXXXXXXXXXXGOOXXXXXXXXXXXXXXXXXGOOOOOOXXXXXXXXXXXXXGOOOXXXXXXXXXXXXXXXXGOOOOOOOOXXXXXXXXXXXGOOOOOOOOAXXXXXXXXXXGOOXXXXXXXXXXXXXXXXX,0,0,0
16716,83,1,82,51,466,0,0,170,52,118,GOOOOOOOXXXXXXXXXXXXGOOOOOOXXXXXXXXXXXXXGOOOOXXXXXXXXXXXXXXXGOOOOXXXXXXXXXXXXXXXGOOOOOXXXXXXXXXXXXXXGOOOOOOOXXXXXXXXXXXXGOOOOOOOXXXXXXXXXXXXGOOXXXXXXXXXXXXXXXXXGOOOOOOXXXXXXXXXXXXXGOOOXXXXXXXXXXXXXXXXGOOOOOOOOXXXXXXXXXXXGOOOOOOOOAXXXXXXXXXXGOOXXXXXXXXXXXXXXXXX,0,0,0
16737,83,1,82,51,466,0,0,170,53,117,GOOOOOOOXXXXXXXXXXXXGOOOOOOXXXXXXXXXXXXXGOOOOXXXXXXXXXXXXXXXGOOOOXXXXXXXXXXXXXXXGOOOOOXXXXXXXXXXXXXXGOOOOOOOXXXXXXXXXXXXGOOOOOOOXXXXXXXXXXXXGOOXXXXXXXXXXXXXXXXXGOOOOOOXXXXXXXXXXXXXGOOOXXXXXXXXXXXXXXXXGOOOOOOOOXXXXXXXXXXXGOOOOOOOOAXXXXXXXXXXGOOXXXXXXXXXXXXXXXXX,0,0,0
16758,83,1,82,50,467,0,0,172,52,120,GOOOOOOOXXXXXXXXXXXXGOOOOOOXXXXXXXXXXXXXGOOOOXXXXXXXXXXXXXXXGOOOOXXXXXXXXXXXXXXXGOOOOOXXXXXXXXXXXXXXGOOOOOOOXXXXXXXXXXXXGOOOOOOOXXXXXXXXXXXXGOOXXXXXXXXXXXXXXXXXGOOOOOOXXXXXXXXXXXXXGOOOXXXXXXXXXXXXXXXXGOOOOOOOOXXXXXXXXXXXGOOOOOOOOAXXXXXXXXXXGOOXXXXXXXXXXXXXXXXX,0,0,0
16779,83,1,82,52,465,0,0,171,52,119,GOOOOOOOXXXXXXXXXXXXGOOOOOOXXXXXXXXXXXXXGOOOOXXXXXXXXXXXXXXXGOOOOXXXXXXXXXXXXXXXGOOOOOXXXXXXXXXXXXXXGOOOOOOOXXXXXXXXXXXXGOOOOOOOXXXXXXXXXXXXGOOXXXXXXXXXXXXXXXXXGOOOOOOXXXXXXXXXXXXXGOOOXXXXXXXXXXXXXXXXGOOOOOOOOXXXXXXXXXXXGOOOOOOOOAXXXXXXXXXXGOOXXXXXXXXXXXXXXXXX,0,0,0

16800,83,1,82,51,466,0,0,171,52,119,GOOOOOOOXXXXXXXXXXXXGOOOOOOXXXXXXXXXXXXXGOOOOXXXXXXXXXXXXXXXGOOOOXXXXXXXXXXXXXXXGOOOOOXXXXXXXXXXXXXXGOOOOOOOXXXXXXXXXXXXGOOOOOOOXXXXXXXXXXXXGOOXXXXXXXXXXXXXXXXXGOOOOOOXXXXXXXXXXXXXGOOOXXXXXXXXXXXXXXXXGOOOOOOOOXXXXXXXXXXXGOOOOOOOOAXXXXXXXXXXGOOXXXXXXXXXXXXXXXXX,0,0,0
16821,83,0,83,52,465,0,0,170,54,116,GOOOOOOOXXXXXXXXXXXXGOOOOOOXXXXXXXXXXXXXGOOOOXXXXXXXXXXXXXXXGOOOOXXXXXXXXXXXXXXXGOOOOOXXXXXXXXXXXXXXGOOOOOOOXXXXXXXXXXXXGOOOOOOOXXXXXXXXXXXXGOOXXXXXXXXXXXXXXXXXGOOOOOOXXXXXXXXXXXXXGOOOXXXXXXXXXXXXXXXXGOOOOOOOOXXXXXXXXXXXGOOOOOOOOOXXXXXXXXXXGOOXXXXXXXXXXXXXXXXX,0,0,0
16842,83,0,83,51,466,0,0,170,55,115,GOOOOOOOXXXXXXXXXXXXGOOOOOOXXXXXXXXXXXXXGOOOOXXXXXXXXXXXXXXXGOOOOXXXXXXXXXXXXXXXGOOOOOXXXXXXXXXXXXXXGOOOOOOOXXXXXXXXXXXXGOOOOOOOXXXXXXXXXXXXGOOXXXXXXXXXXXXXXXXXGOOOOOOXXXXXXXXXXXXXGOOOXXXXXXXXXXXXXXXXGOOOOOOOOXXXXXXXXXXXGOOOOOOOOOXXXXXXXXXXGOOXXXXXXXXXXXXXXXXX,0,0,0
16863,83,0,83,45,472,0,0,176,56,120,GOOOOOOOXXXXXXXXXXXXGOOOOOOXXXXXXXXXXXXXGOOOOXXXXXXXXXXXXXXXGOOOOXXXXXXXXXXXXXXXGOOOOOXXXXXXXXXXXXXXGOOOOOOOXXXXXXXXXXXXGOOOOOOOXXXXXXXXXXXXGOOXXXXXXXXXXXXXXXXXGOOOOOOXXXXXXXXXXXXXGOOOXXXXXXXXXXXXXXXXGOOOOOOOOXXXXXXXXXXXGOOOOOOOOOXXXXXXXXXXGOOXXXXXXXXXXXXXXXXX,0,0,0
16884,83,0,83,50,467,0,0,170,51,119,GOOOOOOOXXXXXXXXXXXXGOOOOOOXXXXXXXXXXXXXGOOOOXXXXXXXXXXXXXXXGOOOOXXXXXXXXXXXXXXXGOOOOOXXXXXXXXXXXXXXGOOOOOOOXXXXXXXXXXXXGOOOOOOOXXXXXXXXXXXXGOOXXXXXXXXXXXXXXXXXGOOOOOOXXXXXXXXXXXXXGOOOXXXXXXXXXXXXXXXXGOOOOOOOOXXXXXXXXXXXGOOOOOOOOOXXXXXXXXXXGOOXXXXXXXXXXXXXXXXX,0,0,0

16905,83,0,83,48,469,0,0,171,54,117,GOOOOOOOXXXXXXXXXXXXGOOOOOOXXXXXXXXXXXXXGOOOOXXXXXXXXXXXXXXXGOOOOXXXXXXXXXXXXXXXGOOOOOXXXXXXXXXXXXXXGOOOOOOOXXXXXXXXXXXXGOOOOOOOXXXXXXXXXXXXGOOXXXXXXXXXXXXXXXXXGOOOOOOXXXXXXXXXXXXXGOOOXXXXXXXXXXXXXXXXGOOOOOOOOXXXXXXXXXXXGOOOOOOOOOXXXXXXXXXXGOOXXXXXXXXXXXXXXXXX,0,0,0
16926,83,0,83,51,466,0,0,169,51,118,GOOOOOOOXXXXXXXXXXXXGOOOOOOXXXXXXXXXXXXXGOOOOXXXXXXXXXXXXXXXGOOOOXXXXXXXXXXXXXXXGOOOOOXXXXXXXXXXXXXXGOOOOOOOXXXXXXXXXXXXGOOOOOOOXXXXXXXXXXXXGOOXXXXXXXXXXXXXXXXXGOOOOOOXXXXXXXXXXXXXGOOOXXXXXXXXXXXXXXXXGOOOOOOOOXXXXXXXXXXXGOOOOOOOOOXXXXXXXXXXGOOXXXXXXXXXXXXXXXXX,0,0,0
16947,83,0,83,47,470,0,0,173,55,118,GOOOOOOOXXXXXXXXXXXXGOOOOOOXXXXXXXXXXXXXGOOOOXXXXXXXXXXXXXXXGOOOOXXXXXXXXXXXXXXXGOOOOOXXXXXXXXXXXXXXGOOOOOOOXXXXXXXXXXXXGOOOOOOOXXXXXXXXXXXXGOOXXXXXXXXXXXXXXXXXGOOOOOOXXXXXXXXXXXXXGOOOXXXXXXXXXXXXXXXXGOOOOOOOOXXXXXXXXXXXGOOOOOOOOOXXXXXXXXXXGOOXXXXXXXXXXXXXXXXX,0,0,0
16968,83,0,83,49,468,0,0,171,59,112,GOOOOOOOXXXXXXXXXXXXGOOOOOOXXXXXXXXXXXXXGOOOOXXXXXXXXXXXXXXXGOOOOXXXXXXXXXXXXXXXGOOOOOXXXXXXXXXXXXXXGOOOOOOOXXXXXXXXXXXXGOOOOOOOXXXXXXXXXXXXGOOXXXXXXXXXXXXXXXXXGOOOOOOXXXXXXXXXXXXXGOOOXXXXXXXXXXXXXXXXGOOOOOOOOXXXXXXXXXXXGOOOOOOOOOXXXXXXXXXXGOOXXXXXXXXXXXXXXXXX,0,0,0
16989,83,0,83,61,456,0,0,160,54,106,GOOOOOOOXXXXXXXXXXXXGOOOOOOXXXXXXXXXXXXXGOOOOXXXXXXXXXXXXXXXGOOOOXXXXXXXXXXXXXXXGOOOOOXXXXXXXXXXXXXXGOOOOOOOXXXXXXXXXXXXGOOOOOOOXXXXXXXXXXXXGOOXXXXXXXXXXXXXXXXXGOOOOOOXXXXXXXXXXXXXGOOOXXXXXXXXXXXXXXXXGOOOOOOOOXXXXXXXXXXXGOOOOOOOOOXXXXXXXXXXGOOXXXXXXXXXXXXXXXXX,0,0,0

17010,83,0,83,64,453,0,0,157,61,96,GOOOOOOOXXXXXXXXXXXXGOOOOOOXXXXXXXXXXXXXGOOOOXXXXXXXXXXXXXXXGOOOOXXXXXXXXXXXXXXXGOOOOOXXXXXXXXXXXXXXGOOOOOOOXXXXXXXXXXXXGOOOOOOOXXXXXXXXXXXXGOOXXXXXXXXXXXXXXXXXGOOOOOOXXXXXXXXXXXXXGOOOXXXXXXXXXXXXXXXXGOOOOOOOOXXXXXXXXXXXGOOOOOOOOOXXXXXXXXXXGOOXXXXXXXXXXXXXXXXX,0,0,0
17031,83,0,83,68,449,0,0,154,52,102,GOOOOOOOXXXXXXXXXXXXGOOOOOOXXXXXXXXXXXXXGOOOOXXXXXXXXXXXXXXXGOOOOXXXXXXXXXXXXXXXGOOOOOXXXXXXXXXXXXXXGOOOOOOOXXXXXXXXXXXXGOOOOOOOXXXXXXXXXXXXGOOXXXXXXXXXXXXXXXXXGOOOOOOXXXXXXXXXXXXXGOOOXXXXXXXXXXXXXXXXGOOOOOOOOXXXXXXXXXXXGOOOOOOOOOXXXXXXXXXXGOOXXXXXXXXXXXXXXXXX,0,0,0
17052,83,0,83,66,451,0,0,157,53,104,GOOOOOOOXXXXXXXXXXXXGOOOOOOXXXXXXXXXXXXXGOOOOXXXXXXXXXXXXXXXGOOOOXXXXXXXXXXXXXXXGOOOOOXXXXXXXXXXXXXXGOOOOOOOXXXXXXXXXXXXGOOOOOOOXXXXXXXXXXXXGOOXXXXXXXXXXXXXXXXXGOOOOOOXXXXXXXXXXXXXGOOOXXXXXXXXXXXXXXXXGOOOOOOOOXXXXXXXXXXXGOOOOOOOOOXXXXXXXXXXGOOXXXXXXXXXXXXXXXXX,0,0,0
17073,83,0,83,73,444,0,0,152,55,97,GOOOOOOOXXXXXXXXXXXXGOOOOOOXXXXXXXXXXXXXGOOOOXXXXXXXXXXXXXXXGOOOOXXXXXXXXXXXXXXXGOOOOOXXXXXXXXXXXXXXGOOOOOOOXXXXXXXXXXXXGOOOOOOOXXXXXXXXXXXXGOOXXXXXXXXXXXXXXXXXGOOOOOOXXXXXXXXXXXXXGOOOXXXXXXXXXXXXXXXXGOOOOOOOOXXXXXXXXXXXGOOOOOOOOOXXXXXXXXXXGOOXXXXXXXXXXXXXXXXX,0,0,0
17094,83,0,83,70,447,0,0,155,58,97,GOOOOOOOXXXXXXXXXXXXGOOOOOOXXXXXXXXXXXXXGOOOOXXXXXXXXXXXXXXXGOOOOXXXXXXXXXXXXXXXGOOOOOXXXXXXXXXXXXXXGOOOOOOOXXXXXXXXXXXXGOOOOOOOXXXXXXXXXXXXGOOXXXXXXXXXXXXXXXXXGOOOOOOXXXXXXXXXXXXXGOOOXXXXXXXXXXXXXXXXGOOOOOOOOXXXXXXXXXXXGOOOOOOOOOXXXXXXXXXXGOOXXXXXXXXXXXXXXXXX,0,0,0

17115,83,0,83,72,445,0,0,152,57,95,GOOOOOOOXXXXXXXXXXXXGOOOOOOXXXXXXXXXXXXXGOOOOXXXXXXXXXXXXXXXGOOOOXXXXXXXXXXXXXXXGOOOOOXXXXXXXXXXXXXXGOOOOOOOXXXXXXXXXXXXGOOOOOOOXXXXXXXXXXXXGOOXXXXXXXXXXXXXXXXXGOOOOOOXXXXXXXXXXXXXGOOOXXXXXXXXXXXXXXXXGOOOOOOOOXXXXXXXXXXXGOOOOOOOOOXXXXXXXXXXGOOXXXXXXXXXXXXXXXXX,0,0,0
17136,83,0,83,72,445,0,0,151,54,97,GOOOOOOOXXXXXXXXXXXXGOOOOOOXXXXXXXXXXXXXGOOOOXXXXXXXXXXXXXXXGOOOOXXXXXXXXXXXXXXXGOOOOOXXXXXXXXXXXXXXGOOOOOOOXXXXXXXXXXXXGOOOOOOOXXXXXXXXXXXXGOOXXXXXXXXXXXXXXXXXGOOOOOOXXXXXXXXXXXXXGOOOXXXXXXXXXXXXXXXXGOOOOOOOOXXXXXXXXXXXGOOOOOOOOOXXXXXXXXXXGOOXXXXXXXXXXXXXXXXX,0,0,0
17157,83,0,83,71,446,0,0,153,55,98,GOOOOOOOXXXXXXXXXXXXGOOOOOOXXXXXXXXXXXXXGOOOOXXXXXXXXXXXXXXXGOOOOXXXXXXXXXXXXXXXGOOOOOXXXXXXXXXXXXXXGOOOOOOOXXXXXXXXXXXXGOOOOOOOXXXXXXXXXXXXGOOXXXXXXXXXXXXXXXXXGOOOOOOXXXXXXXXXXXXXGOOOXXXXXXXXXXXXXXXXGOOOOOOOOXXXXXXXXXXXGOOOOOOOOOXXXXXXXXXXGOOXXXXXXXXXXXXXXXXX,0,0,0
17178,83,0,83,69,448,0,0,155,53,102,GOOOOOOOXXXXXXXXXXXXGOOOOOOXXXXXXXXXXXXXGOOOOXXXXXXXXXXXXXXXGOOOOXXXXXXXXXXXXXXXGOOOOOXXXXXXXXXXXXXXGOOOOOOOXXXXXXXXXXXXGOOOOOOOXXXXXXXXXXXXGOOXXXXXXXXXXXXXXXXXGOOOOOOXXXXXXXXXXXXXGOOOXXXXXXXXXXXXXXXXGOOOOOOOOXXXXXXXXXXXGOOOOOOOOOXXXXXXXXXXGOOXXXXXXXXXXXXXXXXX,0,0,0
17199,83,0,83,63,454,0,0,160,55,105,GOOOOOOOXXXXXXXXXXXXGOOOOOOXXXXXXXXXXXXXGOOOOXXXXXXXXXXXXXXXGOOOOXXXXXXXXXXXXXXXGOOOOOXXXXXXXXXXXXXXGOOOOOOOXXXXXXXXXXXXGOOOOOOOXXXXXXXXXXXXGOOXXXXXXXXXXXXXXXXXGOOOOOOXXXXXXXXXXXXXGOOOXXXXXXXXXXXXXXXXGOOOOOOOOXXXXXXXXXXXGOOOOOOOOOXXXXXXXXXXGOOXXXXXXXXXXXXXXXXX,0,0,0

17220,83,0,83,62,455,0,0,161,55,106,GOOOOOOOXXXXXXXXXXXXGOOOOOOXXXXXXXXXXXXXGOOOOXXXXXXXXXXXXXXXGOOOOXXXXXXXXXXXXXXXGOOOOOXXXXXXXXXXXXXXGOOOOOOOXXXXXXXXXXXXGOOOOOOOXXXXXXXXXXXXGOOXXXXXXXXXXXXXXXXXGOOOOOOXXXXXXXXXXXXXGOOOXXXXXXXXXXXXXXXXGOOOOOOOOXXXXXXXXXXXGOOOOOOOOOXXXXXXXXXXGOOXXXXXXXXXXXXXXXXX,0,0,0
17241,83,0,83,60,457,0,0,163,52,111,GOOOOOOOXXXXXXXXXXXXGOOOOOOXXXXXXXXXXXXXGOOOOXXXXXXXXXXXXXXXGOOOOXXXXXXXXXXXXXXXGOOOOOXXXXXXXXXXXXXXGOOOOOOOXXXXXXXXXXXXGOOOOOOOXXXXXXXXXXXXGOOXXXXXXXXXXXXXXXXXGOOOOOOXXXXXXXXXXXXXGOOOXXXXXXXXXXXXXXXXGOOOOOOOOXXXXXXXXXXXGOOOOOOOOOXXXXXXXXXXGOOXXXXXXXXXXXXXXXXX,0,0,0
17262,83,0,83,58,459,0,0,165,54,111,GOOOOOOOXXXXXXXXXXXXGOOOOOOXXXXXXXXXXXXXGOOOOXXXXXXXXXXXXXXXGOOOOXXXXXXXXXXXXXXXGOOOOOXXXXXXXXXXXXXXGOOOOOOOXXXXXXXXXXXXGOOOOOOOXXXXXXXXXXXXGOOXXXXXXXXXXXXXXXXXGOOOOOOXXXXXXXXXXXXXGOOOXXXXXXXXXXXXXXXXGOOOOOOOOXXXXXXXXXXXGOOOOOOOOOXXXXXXXXXXGOOXXXXXXXXXXXXXXXXX,0,0,0
17283,83,0,83,59,458,0,0,164,57,107,GOOOOOOOXXXXXXXXXXXXGOOOOOOXXXXXXXXXXXXXGOOOOXXXXXXXXXXXXXXXGOOOOXXXXXXXXXXXXXXXGOOOOOXXXXXXXXXXXXXXGOOOOOOOXXXXXXXXXXXXGOOOOOOOXXXXXXXXXXXXGOOXXXXXXXXXXXXXXXXXGOOOOOOXXXXXXXXXXXXXGOOOXXXXXXXXXXXXXXXXGOOOOOOOOXXXXXXXXXXXGOOOOOOOOOXXXXXXXXXXGOOXXXXXXXXXXXXXXXXX,0,0,0
17304,83,0,83,57,460,0,0,166,57,109,GOOOOOOOXXXXXXXXXXXXGOOOOOOXXXXXXXXXXXXXGOOOOXXXXXXXXXXXXXXXGOOOOXXXXXXXXXXXXXXXGOOOOOXXXXXXXXXXXXXXGOOOOOOOXXXXXXXXXXXXGOOOOOOOXXXXXXXXXXXXGOOXXXXXXXXXXXXXXXXXGOOOOOOXXXXXXXXXXXXXGOOOXXXXXXXXXXXXXXXXGOOOOOOOOXXXXXXXXXXXGOOOOOOOOOXXXXXXXXXXGOOXXXXXXXXXXXXXXXXX,0,0,0

17325,83,0,83,61,456,0,0,161,54,107,GOOOOOOOXXXXXXXXXXXXGOOOOOOXXXXXXXXXXXXXGOOOOXXXXXXXXXXXXXXXGOOOOXXXXXXXXXXXXXXXGOOOOOXXXXXXXXXXXXXXGOOOOOOOXXXXXXXXXXXXGOOOOOOOXXXXXXXXXXXXGOOXXXXXXXXXXXXXXXXXGOOOOOOXXXXXXXXXXXXXGOOOXXXXXXXXXXXXXXXXGOOOOOOOOXXXXXXXXXXXGOOOOOOOOOXXXXXXXXXXGOOXXXXXXXXXXXXXXXXX,0,0,0
17346,83,0,83,58,459,0,0,164,52,112,GOOOOOOOXXXXXXXXXXXXGOOOOOOXXXXXXXXXXXXXGOOOOXXXXXXXXXXXXXXXGOOOOXXXXXXXXXXXXXXXGOOOOOXXXXXXXXXXXXXXGOOOOOOOXXXXXXXXXXXXGOOOOOOOXXXXXXXXXXXXGOOXXXXXXXXXXXXXXXXXGOOOOOOXXXXXXXXXXXXXGOOOXXXXXXXXXXXXXXXXGOOOOOOOOXXXXXXXXXXXGOOOOOOOOOXXXXXXXXXXGOOXXXXXXXXXXXXXXXXX,0,0,0
17367,83,0,83,58,459,0,0,163,53,110,GOOOOOOOXXXXXXXXXXXXGOOOOOOXXXXXXXXXXXXXGOOOOXXXXXXXXXXXXXXXGOOOOXXXXXXXXXXXXXXXGOOOOOXXXXXXXXXXXXXXGOOOOOOOXXXXXXXXXXXXGOOOOOOOXXXXXXXXXXXXGOOXXXXXXXXXXXXXXXXXGOOOOOOXXXXXXXXXXXXXGOOOXXXXXXXXXXXXXXXXGOOOOOOOOXXXXXXXXXXXGOOOOOOOOOXXXXXXXXXXGOOXXXXXXXXXXXXXXXXX,0,0,0
17388,83,0,83,59,458,0,0,162,53,109,GOOOOOOOXXXXXXXXXXXXGOOOOOOXXXXXXXXXXXXXGOOOOXXXXXXXXXXXXXXXGOOOOXXXXXXXXXXXXXXXGOOOOOXXXXXXXXXXXXXXGOOOOOOOXXXXXXXXXXXXGOOOOOOOXXXXXXXXXXXXGOOXXXXXXXXXXXXXXXXXGOOOOOOXXXXXXXXXXXXXGOOOXXXXXXXXXXXXXXXXGOOOOOOOOXXXXXXXXXXXGOOOOOOOOOXXXXXXXXXXGOOXXXXXXXXXXXXXXXXX,0,0,0
17409,83,0,83,59,458,0,0,162,55,107,GOOOOOOOXXXXXXXXXXXXGOOOOOOXXXXXXXXXXXXXGOOOOXXXXXXXXXXXXXXXGOOOOXXXXXXXXXXXXXXXGOOOOOXXXXXXXXXXXXXXGOOOOOOOXXXXXXXXXXXXGOOOOOOOXXXXXXXXXXXXGOOXXXXXXXXXXXXXXXXXGOOOOOOXXXXXXXXXXXXXGOOOXXXXXXXXXXXXXXXXGOOOOOOOOXXXXXXXXXXXGOOOOOOOOOXXXXXXXXXXGOOXXXXXXXXXXXXXXXXX,0,0,0

17430,83,0,83,62,455,0,0,159,55,104,GOOOOOOOXXXXXXXXXXXXGOOOOOOXXXXXXXXXXXXXGOOOOXXXXXXXXXXXXXXXGOOOOXXXXXXXXXXXXXXXGOOOOOXXXXXXXXXXXXXXGOOOOOOOXXXXXXXXXXXXGOOOOOOOXXXXXXXXXXXXGOOXXXXXXXXXXXXXXXXXGOOOOOOXXXXXXXXXXXXXGOOOXXXXXXXXXXXXXXXXGOOOOOOOOXXXXXXXXXXXGOOOOOOOOOXXXXXXXXXXGOOXXXXXXXXXXXXXXXXX,0,0,0
17451,83,0,83,60,457,0,0,159,56,103,GOOOOOOOXXXXXXXXXXXXGOOOOOOXXXXXXXXXXXXXGOOOOXXXXXXXXXXXXXXXGOOOOXXXXXXXXXXXXXXXGOOOOOXXXXXXXXXXXXXXGOOOOOOOXXXXXXXXXXXXGOOOOOOOXXXXXXXXXXXXGOOXXXXXXXXXXXXXXXXXGOOOOOOXXXXXXXXXXXXXGOOOXXXXXXXXXXXXXXXXGOOOOOOOOXXXXXXXXXXXGOOOOOOOOOXXXXXXXXXXGOOXXXXXXXXXXXXXXXXX,0,0,0
17472,83,0,83,61,456,0,0,160,55,105,GOOOOOOOXXXXXXXXXXXXGOOOOOOXXXXXXXXXXXXXGOOOOXXXXXXXXXXXXXXXGOOOOXXXXXXXXXXXXXXXGOOOOOXXXXXXXXXXXXXXGOOOOOOOXXXXXXXXXXXXGOOOOOOOXXXXXXXXXXXXGOOXXXXXXXXXXXXXXXXXGOOOOOOXXXXXXXXXXXXXGOOOXXXXXXXXXXXXXXXXGOOOOOOOOXXXXXXXXXXXGOOOOOOOOOXXXXXXXXXXGOOXXXXXXXXXXXXXXXXX,0,0,0
17493,83,0,83,60,457,0,0,161,56,105,GOOOOOOOXXXXXXXXXXXXGOOOOOOXXXXXXXXXXXXXGOOOOXXXXXXXXXXXXXXXGOOOOXXXXXXXXXXXXXXXGOOOOOXXXXXXXXXXXXXXGOOOOOOOXXXXXXXXXXXXGOOOOOOOXXXXXXXXXXXXGOOXXXXXXXXXXXXXXXXXGOOOOOOXXXXXXXXXXXXXGOOOXXXXXXXXXXXXXXXXGOOOOOOOOXXXXXXXXXXXGOOOOOOOOOXXXXXXXXXXGOOXXXXXXXXXXXXXXXXX,0,0,0
17514,83,0,83,64,453,0,0,157,52,105,GOOOOOOOXXXXXXXXXXXXGOOOOOOXXXXXXXXXXXXXGOOOOXXXXXXXXXXXXXXXGOOOOXXXXXXXXXXXXXXXGOOOOOXXXXXXXXXXXXXXGOOOOOOOXXXXXXXXXXXXGOOOOOOOXXXXXXXXXXXXGOOXXXXXXXXXXXXXXXXXGOOOOOOXXXXXXXXXXXXXGOOOXXXXXXXXXXXXXXXXGOOOOOOOOXXXXXXXXXXXGOOOOOOOOOXXXXXXXXXXGOOXXXXXXXXXXXXXXXXX,0,0,0

17535,83,0,83,60,457,0,0,160,53,107,GOOOOOOOXXXXXXXXXXXXGOOOOOOXXXXXXXXXXXXXGOOOOXXXXXXXXXXXXXXXGOOOOXXXXXXXXXXXXXXXGOOOOOXXXXXXXXXXXXXXGOOOOOOOXXXXXXXXXXXXGOOOOOOOXXXXXXXXXXXXGOOXXXXXXXXXXXXXXXXXGOOOOOOXXXXXXXXXXXXXGOOOXXXXXXXXXXXXXXXXGOOOOOOOOXXXXXXXXXXXGOOOOOOOOOXXXXXXXXXXGOOXXXXXXXXXXXXXXXXX,0,0,0
17556,83,0,83,63,454,0,0,159,55,104,GOOOOOOOXXXXXXXXXXXXGOOOOOOXXXXXXXXXXXXXGOOOOXXXXXXXXXXXXXXXGOOOOXXXXXXXXXXXXXXXGOOOOOXXXXXXXXXXXXXXGOOOOOOOXXXXXXXXXXXXGOOOOOOOXXXXXXXXXXXXGOOXXXXXXXXXXXXXXXXXGOOOOOOXXXXXXXXXXXXXGOOOXXXXXXXXXXXXXXXXGOOOOOOOOXXXXXXXXXXXGOOOOOOOOOXXXXXXXXXXGOOXXXXXXXXXXXXXXXXX,0,0,0
17577,83,0,83,65,452,0,0,157,58,99,GOOOOOOOXXXXXXXXXXXXGOOOOOOXXXXXXXXXXXXXGOOOOXXXXXXXXXXXXXXXGOOOOXXXXXXXXXXXXXXXGOOOOOXXXXXXXXXXXXXXGOOOOOOOXXXXXXXXXXXXGOOOOOOOXXXXXXXXXXXXGOOXXXXXXXXXXXXXXXXXGOOOOOOXXXXXXXXXXXXXGOOOXXXXXXXXXXXXXXXXGOOOOOOOOXXXXXXXXXXXGOOOOOOOOOXXXXXXXXXXGOOXXXXXXXXXXXXXXXXX,0,0,0
17598,83,0,83,72,445,0,0,150,56,94,GOOOOOOOXXXXXXXXXXXXGOOOOOOXXXXXXXXXXXXXGOOOOXXXXXXXXXXXXXXXGOOOOXXXXXXXXXXXXXXXGOOOOOXXXXXXXXXXXXXXGOOOOOOOXXXXXXXXXXXXGOOOOOOOXXXXXXXXXXXXGOOXXXXXXXXXXXXXXXXXGOOOOOOXXXXXXXXXXXXXGOOOXXXXXXXXXXXXXXXXGOOOOOOOOXXXXXXXXXXXGOOOOOOOOOXXXXXXXXXXGOOXXXXXXXXXXXXXXXXX,0,0,0
17619,83,0,83,72,445,0,0,151,53,98,GOOOOOOOXXXXXXXXXXXXGOOOOOOXXXXXXXXXXXXXGOOOOXXXXXXXXXXXXXXXGOOOOXXXXXXXXXXXXXXXGOOOOOXXXXXXXXXXXXXXGOOOOOOOXXXXXXXXXXXXGOOOOOOOXXXXXXXXXXXXGOOXXXXXXXXXXXXXXXXXGOOOOOOXXXXXXXXXXXXXGOOOXXXXXXXXXXXXXXXXGOOOOOOOOXXXXXXXXXXXGOOOOOOOOOXXXXXXXXXXGOOXXXXXXXXXXXXXXXXX,0,0,0

17640,83,0,83,63,454,0,0,160,54,106,GOOOOOOOXXXXXXXXXXXXGOOOOOOXXXXXXXXXXXXXGOOOOXXXXXXXXXXXXXXXGOOOOXXXXXXXXXXXXXXXGOOOOOXXXXXXXXXXXXXXGOOOOOOOXXXXXXXXXXXXGOOOOOOOXXXXXXXXXXXXGOOXXXXXXXXXXXXXXXXXGOOOOOOXXXXXXXXXXXXXGOOOXXXXXXXXXXXXXXXXGOOOOOOOOXXXXXXXXXXXGOOOOOOOOOXXXXXXXXXXGOOXXXXXXXXXXXXXXXXX,0,0,0
17661,83,0,83,63,454,0,0,160,52,108,GOOOOOOOXXXXXXXXXXXXGOOOOOOXXXXXXXXXXXXXGOOOOXXXXXXXXXXXXXXXGOOOOXXXXXXXXXXXXXXXGOOOOOXXXXXXXXXXXXXXGOOOOOOOXXXXXXXXXXXXGOOOOOOOXXXXXXXXXXXXGOOXXXXXXXXXXXXXXXXXGOOOOOOXXXXXXXXXXXXXGOOOXXXXXXXXXXXXXXXXGOOOOOOOOXXXXXXXXXXXGOOOOOOOOOXXXXXXXXXXGOOXXXXXXXXXXXXXXXXX,0,0,0
17682,83,0,83,54,463,0,0,168,57,111,GOOOOOOOXXXXXXXXXXXXGOOOOOOXXXXXXXXXXXXXGOOOOXXXXXXXXXXXXXXXGOOOOXXXXXXXXXXXXXXXGOOOOOXXXXXXXXXXXXXXGOOOOOOOXXXXXXXXXXXXGOOOOOOOXXXXXXXXXXXXGOOXXXXXXXXXXXXXXXXXGOOOOOOXXXXXXXXXXXXXGOOOXXXXXXXXXXXXXXXXGOOOOOOOOXXXXXXXXXXXGOOOOOOOOOXXXXXXXXXXGOOXXXXXXXXXXXXXXXXX,0,0,0
17703,83,0,83,63,454,0,0,161,53,108,GOOOOOOOXXXXXXXXXXXXGOOOOOOXXXXXXXXXXXXXGOOOOXXXXXXXXXXXXXXXGOOOOXXXXXXXXXXXXXXXGOOOOOXXXXXXXXXXXXXXGOOOOOOOXXXXXXXXXXXXGOOOOOOOXXXXXXXXXXXXGOOXXXXXXXXXXXXXXXXXGOOOOOOXXXXXXXXXXXXXGOOOXXXXXXXXXXXXXXXXGOOOOOOOOXXXXXXXXXXXGOOOOOOOOOXXXXXXXXXXGOOXXXXXXXXXXXXXXXXX,0,0,0
17724,83,0,83,60,457,0,0,162,57,105,GOOOOOOOXXXXXXXXXXXXGOOOOOOXXXXXXXXXXXXXGOOOOXXXXXXXXXXXXXXXGOOOOXXXXXXXXXXXXXXXGOOOOOXXXXXXXXXXXXXXGOOOOOOOXXXXXXXXXXXXGOOOOOOOXXXXXXXXXXXXGOOXXXXXXXXXXXXXXXXXGOOOOOOXXXXXXXXXXXXXGOOOXXXXXXXXXXXXXXXXGOOOOOOOOXXXXXXXXXXXGOOOOOOOOOXXXXXXXXXXGOOXXXXXXXXXXXXXXXXX,0,0,0

17745,83,0,83,62,455,0,0,162,54,108,GOOOOOOOXXXXXXXXXXXXGOOOOOOXXXXXXXXXXXXXGOOOOXXXXXXXXXXXXXXXGOOOOXXXXXXXXXXXXXXXGOOOOOXXXXXXXXXXXXXXGOOOOOOOXXXXXXXXXXXXGOOOOOOOXXXXXXXXXXXXGOOXXXXXXXXXXXXXXXXXGOOOOOOXXXXXXXXXXXXXGOOOXXXXXXXXXXXXXXXXGOOOOOOOOXXXXXXXXXXXGOOOOOOOOOXXXXXXXXXXGOOXXXXXXXXXXXXXXXXX,0,0,0
17766,83,0,83,61,456,0,0,162,54,108,GOOOOOOOXXXXXXXXXXXXGOOOOOOXXXXXXXXXXXXXGOOOOXXXXXXXXXXXXXXXGOOOOXXXXXXXXXXXXXXXGOOOOOXXXXXXXXXXXXXXGOOOOOOOXXXXXXXXXXXXGOOOOOOOXXXXXXXXXXXXGOOXXXXXXXXXXXXXXXXXGOOOOOOXXXXXXXXXXXXXGOOOXXXXXXXXXXXXXXXXGOOOOOOOOXXXXXXXXXXXGOOOOOOOOOXXXXXXXXXXGOOXXXXXXXXXXXXXXXXX,0,0,0
17787,83,0,83,57,460,0,0,166,53,113,GOOOOOOOXXXXXXXXXXXXGOOOOOOXXXXXXXXXXXXXGOOOOXXXXXXXXXXXXXXXGOOOOXXXXXXXXXXXXXXXGOOOOOXXXXXXXXXXXXXXGOOOOOOOXXXXXXXXXXXXGOOOOOOOXXXXXXXXXXXXGOOXXXXXXXXXXXXXXXXXGOOOOOOXXXXXXXXXXXXXGOOOXXXXXXXXXXXXXXXXGOOOOOOOOXXXXXXXXXXXGOOOOOOOOOXXXXXXXXXXGOOXXXXXXXXXXXXXXXXX,0,0,0
17808,83,0,83,57,460,0,0,165,54,111,GOOOOOOOXXXXXXXXXXXXGOOOOOOXXXXXXXXXXXXXGOOOOXXXXXXXXXXXXXXXGOOOOXXXXXXXXXXXXXXXGOOOOOXXXXXXXXXXXXXXGOOOOOOOXXXXXXXXXXXXGOOOOOOOXXXXXXXXXXXXGOOXXXXXXXXXXXXXXXXXGOOOOOOXXXXXXXXXXXXXGOOOXXXXXXXXXXXXXXXXGOOOOOOOOXXXXXXXXXXXGOOOOOOOOOXXXXXXXXXXGOOXXXXXXXXXXXXXXXXX,0,0,0
17829,83,0,83,52,465,0,0,169,53,116,GOOOOOOOXXXXXXXXXXXXGOOOOOOXXXXXXXXXXXXXGOOOOXXXXXXXXXXXXXXXGOOOOXXXXXXXXXXXXXXXGOOOOOXXXXXXXXXXXXXXGOOOOOOOXXXXXXXXXXXXGOOOOOOOXXXXXXXXXXXXGOOXXXXXXXXXXXXXXXXXGOOOOOOXXXXXXXXXXXXXGOOOXXXXXXXXXXXXXXXXGOOOOOOOOXXXXXXXXXXXGOOOOOOOOOXXXXXXXXXXGOOXXXXXXXXXXXXXXXXX,0,0,0

17850,83,0,83,52,465,0,0,170,59,111,GOOOOOOOXXXXXXXXXXXXGOOOOOOXXXXXXXXXXXXXGOOOOXXXXXXXXXXXXXXXGOOOOXXXXXXXXXXXXXXXGOOOOOXXXXXXXXXXXXXXGOOOOOOOXXXXXXXXXXXXGOOOOOOOXXXXXXXXXXXXGOOXXXXXXXXXXXXXXXXXGOOOOOOXXXXXXXXXXXXXGOOOXXXXXXXXXXXXXXXXGOOOOOOOOXXXXXXXXXXXGOOOOOOOOOXXXXXXXXXXGOOXXXXXXXXXXXXXXXXX,0,0,0
17871,83,0,83,54,463,0,0,168,56,112,GOOOOOOOXXXXXXXXXXXXGOOOOOOXXXXXXXXXXXXXGOOOOXXXXXXXXXXXXXXXGOOOOXXXXXXXXXXXXXXXGOOOOOXXXXXXXXXXXXXXGOOOOOOOXXXXXXXXXXXXGOOOOOOOXXXXXXXXXXXXGOOXXXXXXXXXXXXXXXXXGOOOOOOXXXXXXXXXXXXXGOOOXXXXXXXXXXXXXXXXGOOOOOOOOXXXXXXXXXXXGOOOOOOOOOXXXXXXXXXXGOOXXXXXXXXXXXXXXXXX,0,0,0
17892,83,0,83,51,466,0,0,171,57,114,GOOOOOOOXXXXXXXXXXXXGOOOOOOXXXXXXXXXXXXXGOOOOXXXXXXXXXXXXXXXGOOOOXXXXXXXXXXXXXXXGOOOOOXXXXXXXXXXXXXXGOOOOOOOXXXXXXXXXXXXGOOOOOOOXXXXXXXXXXXXGOOXXXXXXXXXXXXXXXXXGOOOOOOXXXXXXXXXXXXXGOOOXXXXXXXXXXXXXXXXGOOOOOOOOXXXXXXXXXXXGOOOOOOOOOXXXXXXXXXXGOOXXXXXXXXXXXXXXXXX,0,0,0
17913,83,0,83,57,460,0,0,165,57,108,GOOOOOOOXXXXXXXXXXXXGOOOOOOXXXXXXXXXXXXXGOOOOXXXXXXXXXXXXXXXGOOOOXXXXXXXXXXXXXXXGOOOOOXXXXXXXXXXXXXXGOOOOOOOXXXXXXXXXXXXGOOOOOOOXXXXXXXXXXXXGOOXXXXXXXXXXXXXXXXXGOOOOOOXXXXXXXXXXXXXGOOOXXXXXXXXXXXXXXXXGOOOOOOOOXXXXXXXXXXXGOOOOOOOOOXXXXXXXXXXGOOXXXXXXXXXXXXXXXXX,0,0,0
17934,83,0,83,60,457,0,0,163,54,109,GOOOOOOOXXXXXXXXXXXXGOOOOOOXXXXXXXXXXXXXGOOOOXXXXXXXXXXXXXXXGOOOOXXXXXXXXXXXXXXXGOOOOOXXXXXXXXXXXXXXGOOOOOOOXXXXXXXXXXXXGOOOOOOOXXXXXXXXXXXXGOOXXXXXXXXXXXXXXXXXGOOOOOOXXXXXXXXXXXXXGOOOXXXXXXXXXXXXXXXXGOOOOOOOOXXXXXXXXXXXGOOOOOOOOOXXXXXXXXXXGOOXXXXXXXXXXXXXXXXX,0,0,0

17955,83,0,83,61,456,0,0,161,54,107,GOOOOOOOXXXXXXXXXXXXGOOOOOOXXXXXXXXXXXXXGOOOOXXXXXXXXXXXXXXXGOOOOXXXXXXXXXXXXXXXGOOOOOXXXXXXXXXXXXXXGOOOOOOOXXXXXXXXXXXXGOOOOOOOXXXXXXXXXXXXGOOXXXXXXXXXXXXXXXXXGOOOOOOXXXXXXXXXXXXXGOOOXXXXXXXXXXXXXXXXGOOOOOOOOXXXXXXXXXXXGOOOOOOOOOXXXXXXXXXXGOOXXXXXXXXXXXXXXXXX,0,0,0
17976,83,0,83,58,459,0,0,163,57,106,GOOOOOOOXXXXXXXXXXXXGOOOOOOXXXXXXXXXXXXXGOOOOXXXXXXXXXXXXXXXGOOOOXXXXXXXXXXXXXXXGOOOOOXXXXXXXXXXXXXXGOOOOOOOXXXXXXXXXXXXGOOOOOOOXXXXXXXXXXXXGOOXXXXXXXXXXXXXXXXXGOOOOOOXXXXXXXXXXXXXGOOOXXXXXXXXXXXXXXXXGOOOOOOOOXXXXXXXXXXXGOOOOOOOOOXXXXXXXXXXGOOXXXXXXXXXXXXXXXXX,0,0,0
17997,83,0,83,60,457,0,0,163,58,105,GOOOOOOOXXXXXXXXXXXXGOOOOOOXXXXXXXXXXXXXGOOOOXXXXXXXXXXXXXXXGOOOOXXXXXXXXXXXXXXXGOOOOOXXXXXXXXXXXXXXGOOOOOOOXXXXXXXXXXXXGOOOOOOOXXXXXXXXXXXXGOOXXXXXXXXXXXXXXXXXGOOOOOOXXXXXXXXXXXXXGOOOXXXXXXXXXXXXXXXXGOOOOOOOOXXXXXXXXXXXGOOOOOOOOOXXXXXXXXXXGOOXXXXXXXXXXXXXXXXX,0,0,0
18018,83,0,83,61,456,0,0,162,58,104,GOOOOOOOXXXXXXXXXXXXGOOOOOOXXXXXXXXXXXXXGOOOOXXXXXXXXXXXXXXXGOOOOXXXXXXXXXXXXXXXGOOOOOXXXXXXXXXXXXXXGOOOOOOOXXXXXXXXXXXXGOOOOOOOXXXXXXXXXXXXGOOXXXXXXXXXXXXXXXXXGOOOOOOXXXXXXXXXXXXXGOOOXXXXXXXXXXXXXXXXGOOOOOOOOXXXXXXXXXXXGOOOOOOOOOXXXXXXXXXXGOOXXXXXXXXXXXXXXXXX,0,0,0
18039,83,0,83,64,453,0,0,159,55,104,GOOOOOOOXXXXXXXXXXXXGOOOOOOXXXXXXXXXXXXXGOOOOXXXXXXXXXXXXXXXGOOOOXXXXXXXXXXXXXXXGOOOOOXXXXXXXXXXXXXXGOOOOOOOXXXXXXXXXXXXGOOOOOOOXXXXXXXXXXXXGOOXXXXXXXXXXXXXXXXXGOOOOOOXXXXXXXXXXXXXGOOOXXXXXXXXXXXXXXXXGOOOOOOOOXXXXXXXXXXXGOOOOOOOOOXXXXXXXXXXGOOXXXXXXXXXXXXXXXXX,0,0,0

18060,83,0,83,65,452,0,0,158,58,100,GOOOOOOOXXXXXXXXXXXXGOOOOOOXXXXXXXXXXXXXGOOOOXXXXXXXXXXXXXXXGOOOOXXXXXXXXXXXXXXXGOOOOOXXXXXXXXXXXXXXGOOOOOOOXXXXXXXXXXXXGOOOOOOOXXXXXXXXXXXXGOOXXXXXXXXXXXXXXXXXGOOOOOOXXXXXXXXXXXXXGOOOXXXXXXXXXXXXXXXXGOOOOOOOOXXXXXXXXXXXGOOOOOOOOOXXXXXXXXXXGOOXXXXXXXXXXXXXXXXX,0,0,0
18081,83,0,83,61,456,0,0,162,57,105,GOOOOOOOXXXXXXXXXXXXGOOOOOOXXXXXXXXXXXXXGOOOOXXXXXXXXXXXXXXXGOOOOXXXXXXXXXXXXXXXGOOOOOXXXXXXXXXXXXXXGOOOOOOOXXXXXXXXXXXXGOOOOOOOXXXXXXXXXXXXGOOXXXXXXXXXXXXXXXXXGOOOOOOXXXXXXXXXXXXXGOOOXXXXXXXXXXXXXXXXGOOOOOOOOXXXXXXXXXXXGOOOOOOOOOXXXXXXXXXXGOOXXXXXXXXXXXXXXXXX,0,0,0
18102,83,0,83,66,451,0,0,156,57,99,GOOOOOOOXXXXXXXXXXXXGOOOOOOXXXXXXXXXXXXXGOOOOXXXXXXXXXXXXXXXGOOOOXXXXXXXXXXXXXXXGOOOOOXXXXXXXXXXXXXXGOOOOOOOXXXXXXXXXXXXGOOOOOOOXXXXXXXXXXXXGOOXXXXXXXXXXXXXXXXXGOOOOOOXXXXXXXXXXXXXGOOOXXXXXXXXXXXXXXXXGOOOOOOOOXXXXXXXXXXXGOOOOOOOOOXXXXXXXXXXGOOXXXXXXXXXXXXXXXXX,0,0,0
18123,83,0,83,67,450,0,0,156,55,101,GOOOOOOOXXXXXXXXXXXXGOOOOOOXXXXXXXXXXXXXGOOOOXXXXXXXXXXXXXXXGOOOOXXXXXXXXXXXXXXXGOOOOOXXXXXXXXXXXXXXGOOOOOOOXXXXXXXXXXXXGOOOOOOOXXXXXXXXXXXXGOOXXXXXXXXXXXXXXXXXGOOOOOOXXXXXXXXXXXXXGOOOXXXXXXXXXXXXXXXXGOOOOOOOOXXXXXXXXXXXGOOOOOOOOOXXXXXXXXXXGOOXXXXXXXXXXXXXXXXX,0,0,0
18144,83,0,83,64,453,0,0,158,56,102,GOOOOOOOXXXXXXXXXXXXGOOOOOOXXXXXXXXXXXXXGOOOOXXXXXXXXXXXXXXXGOOOOXXXXXXXXXXXXXXXGOOOOOXXXXXXXXXXXXXXGOOOOOOOXXXXXXXXXXXXGOOOOOOOXXXXXXXXXXXXGOOXXXXXXXXXXXXXXXXXGOOOOOOXXXXXXXXXXXXXGOOOXXXXXXXXXXXXXXXXGOOOOOOOOXXXXXXXXXXXGOOOOOOOOOXXXXXXXXXXGOOXXXXXXXXXXXXXXXXX,0,0,0

18165,83,0,83,60,457,0,0,163,54,109,GOOOOOOOXXXXXXXXXXXXGOOOOOOXXXXXXXXXXXXXGOOOOXXXXXXXXXXXXXXXGOOOOXXXXXXXXXXXXXXXGOOOOOXXXXXXXXXXXXXXGOOOOOOOXXXXXXXXXXXXGOOOOOOOXXXXXXXXXXXXGOOXXXXXXXXXXXXXXXXXGOOOOOOXXXXXXXXXXXXXGOOOXXXXXXXXXXXXXXXXGOOOOOOOOXXXXXXXXXXXGOOOOOOOOOXXXXXXXXXXGOOXXXXXXXXXXXXXXXXX,0,0,0
18186,83,0,83,59,458,0,0,164,56,108,GOOOOOOOXXXXXXXXXXXXGOOOOOOXXXXXXXXXXXXXGOOOOXXXXXXXXXXXXXXXGOOOOXXXXXXXXXXXXXXXGOOOOOXXXXXXXXXXXXXXGOOOOOOOXXXXXXXXXXXXGOOOOOOOXXXXXXXXXXXXGOOXXXXXXXXXXXXXXXXXGOOOOOOXXXXXXXXXXXXXGOOOXXXXXXXXXXXXXXXXGOOOOOOOOXXXXXXXXXXXGOOOOOOOOOXXXXXXXXXXGOOXXXXXXXXXXXXXXXXX,0,0,0
18207,83,0,83,62,455,0,0,161,54,107,GOOOOOOOXXXXXXXXXXXXGOOOOOOXXXXXXXXXXXXXGOOOOXXXXXXXXXXXXXXXGOOOOXXXXXXXXXXXXXXXGOOOOOXXXXXXXXXXXXXXGOOOOOOOXXXXXXXXXXXXGOOOOOOOXXXXXXXXXXXXGOOXXXXXXXXXXXXXXXXXGOOOOOOXXXXXXXXXXXXXGOOOXXXXXXXXXXXXXXXXGOOOOOOOOXXXXXXXXXXXGOOOOOOOOOXXXXXXXXXXGOOXXXXXXXXXXXXXXXXX,0,0,0
18228,83,0,83,61,456,0,0,160,51,109,GOOOOOOOXXXXXXXXXXXXGOOOOOOXXXXXXXXXXXXXGOOOOXXXXXXXXXXXXXXXGOOOOXXXXXXXXXXXXXXXGOOOOOXXXXXXXXXXXXXXGOOOOOOOXXXXXXXXXXXXGOOOOOOOXXXXXXXXXXXXGOOXXXXXXXXXXXXXXXXXGOOOOOOXXXXXXXXXXXXXGOOOXXXXXXXXXXXXXXXXGOOOOOOOOXXXXXXXXXXXGOOOOOOOOOXXXXXXXXXXGOOXXXXXXXXXXXXXXXXX,0,0,0
18249,83,0,83,60,457,0,0,161,52,109,GOOOOOOOXXXXXXXXXXXXGOOOOOOXXXXXXXXXXXXXGOOOOXXXXXXXXXXXXXXXGOOOOXXXXXXXXXXXXXXXGOOOOOXXXXXXXXXXXXXXGOOOOOOOXXXXXXXXXXXXGOOOOOOOXXXXXXXXXXXXGOOXXXXXXXXXXXXXXXXXGOOOOOOXXXXXXXXXXXXXGOOOXXXXXXXXXXXXXXXXGOOOOOOOOXXXXXXXXXXXGOOOOOOOOOXXXXXXXXXXGOOXXXXXXXXXXXXXXXXX,0,0,0

18270,83,0,83,58,459,0,0,164,50,114,GOOOOOOOXXXXXXXXXXXXGOOOOOOXXXXXXXXXXXXXGOOOOXXXXXXXXXXXXXXXGOOOOXXXXXXXXXXXXXXXGOOOOOXXXXXXXXXXXXXXGOOOOOOOXXXXXXXXXXXXGOOOOOOOXXXXXXXXXXXXGOOXXXXXXXXXXXXXXXXXGOOOOOOXXXXXXXXXXXXXGOOOXXXXXXXXXXXXXXXXGOOOOOOOOXXXXXXXXXXXGOOOOOOOOOXXXXXXXXXXGOOXXXXXXXXXXXXXXXXX,0,0,0
18291,83,0,83,54,463,0,0,168,52,116,GOOOOOOOXXXXXXXXXXXXGOOOOOOXXXXXXXXXXXXXGOOOOXXXXXXXXXXXXXXXGOOOOXXXXXXXXXXXXXXXGOOOOOXXXXXXXXXXXXXXGOOOOOOOXXXXXXXXXXXXGOOOOOOOXXXXXXXXXXXXGOOXXXXXXXXXXXXXXXXXGOOOOOOXXXXXXXXXXXXXGOOOXXXXXXXXXXXXXXXXGOOOOOOOOXXXXXXXXXXXGOOOOOOOOOXXXXXXXXXXGOOXXXXXXXXXXXXXXXXX,0,0,0
18312,83,0,83,50,467,0,0,173,53,120,GOOOOOOOXXXXXXXXXXXXGOOOOOOXXXXXXXXXXXXXGOOOOXXXXXXXXXXXXXXXGOOOOXXXXXXXXXXXXXXXGOOOOOXXXXXXXXXXXXXXGOOOOOOOXXXXXXXXXXXXGOOOOOOOXXXXXXXXXXXXGOOXXXXXXXXXXXXXXXXXGOOOOOOXXXXXXXXXXXXXGOOOXXXXXXXXXXXXXXXXGOOOOOOOOXXXXXXXXXXXGOOOOOOOOOXXXXXXXXXXGOOXXXXXXXXXXXXXXXXX,0,0,0
18333,83,0,83,49,468,0,0,174,58,116,GOOOOOOOXXXXXXXXXXXXGOOOOOOXXXXXXXXXXXXXGOOOOXXXXXXXXXXXXXXXGOOOOXXXXXXXXXXXXXXXGOOOOOXXXXXXXXXXXXXXGOOOOOOOXXXXXXXXXXXXGOOOOOOOXXXXXXXXXXXXGOOXXXXXXXXXXXXXXXXXGOOOOOOXXXXXXXXXXXXXGOOOXXXXXXXXXXXXXXXXGOOOOOOOOXXXXXXXXXXXGOOOOOOOOOXXXXXXXXXXGOOXXXXXXXXXXXXXXXXX,0,0,0
18354,83,0,83,48,469,0,0,174,53,121,GOOOOOOOXXXXXXXXXXXXGOOOOOOXXXXXXXXXXXXXGOOOOXXXXXXXXXXXXXXXGOOOOXXXXXXXXXXXXXXXGOOOOOXXXXXXXXXXXXXXGOOOOOOOXXXXXXXXXXXXGOOOOOOOXXXXXXXXXXXXGOOXXXXXXXXXXXXXXXXXGOOOOOOXXXXXXXXXXXXXGOOOXXXXXXXXXXXXXXXXGOOOOOOOOXXXXXXXXXXXGOOOOOOOOOXXXXXXXXXXGOOXXXXXXXXXXXXXXXXX,0,0,0

18375,83,0,83,44,473,0,0,178,52,126,GOOOOOOOXXXXXXXXXXXXGOOOOOOXXXXXXXXXXXXXGOOOOXXXXXXXXXXXXXXXGOOOOXXXXXXXXXXXXXXXGOOOOOXXXXXXXXXXXXXXGOOOOOOOXXXXXXXXXXXXGOOOOOOOXXXXXXXXXXXXGOOXXXXXXXXXXXXXXXXXGOOOOOOXXXXXXXXXXXXXGOOOXXXXXXXXXXXXXXXXGOOOOOOOOXXXXXXXXXXXGOOOOOOOOOXXXXXXXXXXGOOXXXXXXXXXXXXXXXXX,0,0,0
18396,83,0,83,43,474,0,0,177,54,123,GOOOOOOOXXXXXXXXXXXXGOOOOOOXXXXXXXXXXXXXGOOOOXXXXXXXXXXXXXXXGOOOOXXXXXXXXXXXXXXXGOOOOOXXXXXXXXXXXXXXGOOOOOOOXXXXXXXXXXXXGOOOOOOOXXXXXXXXXXXXGOOXXXXXXXXXXXXXXXXXGOOOOOOXXXXXXXXXXXXXGOOOXXXXXXXXXXXXXXXXGOOOOOOOOXXXXXXXXXXXGOOOOOOOOOXXXXXXXXXXGOOXXXXXXXXXXXXXXXXX,0,0,0
18417,83,0,83,40,477,0,0,182,57,125,GOOOOOOOXXXXXXXXXXXXGOOOOOOXXXXXXXXXXXXXGOOOOXXXXXXXXXXXXXXXGOOOOXXXXXXXXXXXXXXXGOOOOOXXXXXXXXXXXXXXGOOOOOOOXXXXXXXXXXXXGOOOOOOOXXXXXXXXXXXXGOOXXXXXXXXXXXXXXXXXGOOOOOOXXXXXXXXXXXXXGOOOXXXXXXXXXXXXXXXXGOOOOOOOOXXXXXXXXXXXGOOOOOOOOOXXXXXXXXXXGOOXXXXXXXXXXXXXXXXX,0,0,0
18438,83,0,83,45,472,0,0,177,54,123,GOOOOOOOXXXXXXXXXXXXGOOOOOOXXXXXXXXXXXXXGOOOOXXXXXXXXXXXXXXXGOOOOXXXXXXXXXXXXXXXGOOOOOXXXXXXXXXXXXXXGOOOOOOOXXXXXXXXXXXXGOOOOOOOXXXXXXXXXXXXGOOXXXXXXXXXXXXXXXXXGOOOOOOXXXXXXXXXXXXXGOOOXXXXXXXXXXXXXXXXGOOOOOOOOXXXXXXXXXXXGOOOOOOOOOXXXXXXXXXXGOOXXXXXXXXXXXXXXXXX,0,0,0
18459,83,0,83,43,474,0,0,179,52,127,GOOOOOOOXXXXXXXXXXXXGOOOOOOXXXXXXXXXXXXXGOOOOXXXXXXXXXXXXXXXGOOOOXXXXXXXXXXXXXXXGOOOOOXXXXXXXXXXXXXXGOOOOOOOXXXXXXXXXXXXGOOOOOOOXXXXXXXXXXXXGOOXXXXXXXXXXXXXXXXXGOOOOOOXXXXXXXXXXXXXGOOOXXXXXXXXXXXXXXXXGOOOOOOOOXXXXXXXXXXXGOOOOOOOOOXXXXXXXXXXGOOXXXXXXXXXXXXXXXXX,0,0,0

18480,83,0,83,45,472,0,0,177,59,118,GOOOOOOOXXXXXXXXXXXXGOOOOOOXXXXXXXXXXXXXGOOOOXXXXXXXXXXXXXXXGOOOOXXXXXXXXXXXXXXXGOOOOOXXXXXXXXXXXXXXGOOOOOOOXXXXXXXXXXXXGOOOOOOOXXXXXXXXXXXXGOOXXXXXXXXXXXXXXXXXGOOOOOOXXXXXXXXXXXXXGOOOXXXXXXXXXXXXXXXXGOOOOOOOOXXXXXXXXXXXGOOOOOOOOOXXXXXXXXXXGOOXXXXXXXXXXXXXXXXX,0,0,0
18501,83,0,83,52,465,0,0,170,54,116,GOOOOOOOXXXXXXXXXXXXGOOOOOOXXXXXXXXXXXXXGOOOOXXXXXXXXXXXXXXXGOOOOXXXXXXXXXXXXXXXGOOOOOXXXXXXXXXXXXXXGOOOOOOOXXXXXXXXXXXXGOOOOOOOXXXXXXXXXXXXGOOXXXXXXXXXXXXXXXXXGOOOOOOXXXXXXXXXXXXXGOOOXXXXXXXXXXXXXXXXGOOOOOOOOXXXXXXXXXXXGOOOOOOOOOXXXXXXXXXXGOOXXXXXXXXXXXXXXXXX,0,0,0
18522,83,0,83,53,464,0,0,169,57,112,GOOOOOOOXXXXXXXXXXXXGOOOOOOXXXXXXXXXXXXXGOOOOXXXXXXXXXXXXXXXGOOOOXXXXXXXXXXXXXXXGOOOOOXXXXXXXXXXXXXXGOOOOOOOXXXXXXXXXXXXGOOOOOOOXXXXXXXXXXXXGOOXXXXXXXXXXXXXXXXXGOOOOOOXXXXXXXXXXXXXGOOOXXXXXXXXXXXXXXXXGOOOOOOOOXXXXXXXXXXXGOOOOOOOOOXXXXXXXXXXGOOXXXXXXXXXXXXXXXXX,0,0,0
18543,83,0,83,62,455,0,0,160,53,107,GOOOOOOOXXXXXXXXXXXXGOOOOOOXXXXXXXXXXXXXGOOOOXXXXXXXXXXXXXXXGOOOOXXXXXXXXXXXXXXXGOOOOOXXXXXXXXXXXXXXGOOOOOOOXXXXXXXXXXXXGOOOOOOOXXXXXXXXXXXXGOOXXXXXXXXXXXXXXXXXGOOOOOOXXXXXXXXXXXXXGOOOXXXXXXXXXXXXXXXXGOOOOOOOOXXXXXXXXXXXGOOOOOOOOOXXXXXXXXXXGOOXXXXXXXXXXXXXXXXX,0,0,0
18564,83,0,83,61,456,0,0,160,54,106,GOOOOOOOXXXXXXXXXXXXGOOOOOOXXXXXXXXXXXXXGOOOOXXXXXXXXXXXXXXXGOOOOXXXXXXXXXXXXXXXGOOOOOXXXXXXXXXXXXXXGOOOOOOOXXXXXXXXXXXXGOOOOOOOXXXXXXXXXXXXGOOXXXXXXXXXXXXXXXXXGOOOOOOXXXXXXXXXXXXXGOOOXXXXXXXXXXXXXXXXGOOOOOOOOXXXXXXXXXXXGOOOOOOOOOXXXXXXXXXXGOOXXXXXXXXXXXXXXXXX,0,0,0

18585,83,0,83,64,453,0,0,158,55,103,GOOOOOOOXXXXXXXXXXXXGOOOOOOXXXXXXXXXXXXXGOOOOXXXXXXXXXXXXXXXGOOOOXXXXXXXXXXXXXXXGOOOOOXXXXXXXXXXXXXXGOOOOOOOXXXXXXXXXXXXGOOOOOOOXXXXXXXXXXXXGOOXXXXXXXXXXXXXXXXXGOOOOOOXXXXXXXXXXXXXGOOOXXXXXXXXXXXXXXXXGOOOOOOOOXXXXXXXXXXXGOOOOOOOOOXXXXXXXXXXGOOXXXXXXXXXXXXXXXXX,0,0,0
18606,83,0,83,64,453,0,0,158,55,103,GOOOOOOOXXXXXXXXXXXXGOOOOOOXXXXXXXXXXXXXGOOOOXXXXXXXXXXXXXXXGOOOOXXXXXXXXXXXXXXXGOOOOOXXXXXXXXXXXXXXGOOOOOOOXXXXXXXXXXXXGOOOOOOOXXXXXXXXXXXXGOOXXXXXXXXXXXXXXXXXGOOOOOOXXXXXXXXXXXXXGOOOXXXXXXXXXXXXXXXXGOOOOOOOOXXXXXXXXXXXGOOOOOOOOOXXXXXXXXXXGOOXXXXXXXXXXXXXXXXX,0,0,0
18627,83,0,83,57,460,0,0,165,57,108,GOOOOOOOXXXXXXXXXXXXGOOOOOOXXXXXXXXXXXXXGOOOOXXXXXXXXXXXXXXXGOOOOXXXXXXXXXXXXXXXGOOOOOXXXXXXXXXXXXXXGOOOOOOOXXXXXXXXXXXXGOOOOOOOXXXXXXXXXXXXGOOXXXXXXXXXXXXXXXXXGOOOOOOXXXXXXXXXXXXXGOOOXXXXXXXXXXXXXXXXGOOOOOOOOXXXXXXXXXXXGOOOOOOOOOXXXXXXXXXXGOOXXXXXXXXXXXXXXXXX,0,0,0
18648,83,0,83,59,458,0,0,163,56,107,GOOOOOOOXXXXXXXXXXXXGOOOOOOXXXXXXXXXXXXXGOOOOXXXXXXXXXXXXXXXGOOOOXXXXXXXXXXXXXXXGOOOOOXXXXXXXXXXXXXXGOOOOOOOXXXXXXXXXXXXGOOOOOOOXXXXXXXXXXXXGOOXXXXXXXXXXXXXXXXXGOOOOOOXXXXXXXXXXXXXGOOOXXXXXXXXXXXXXXXXGOOOOOOOOXXXXXXXXXXXGOOOOOOOOOXXXXXXXXXXGOOXXXXXXXXXXXXXXXXX,0,0,0
18669,83,0,83,63,454,0,0,159,53,106,GOOOOOOOXXXXXXXXXXXXGOOOOOOXXXXXXXXXXXXXGOOOOXXXXXXXXXXXXXXXGOOOOXXXXXXXXXXXXXXXGOOOOOXXXXXXXXXXXXXXGOOOOOOOXXXXXXXXXXXXGOOOOOOOXXXXXXXXXXXXGOOXXXXXXXXXXXXXXXXXGOOOOOOXXXXXXXXXXXXXGOOOXXXXXXXXXXXXXXXXGOOOOOOOOXXXXXXXXXXXGOOOOOOOOOXXXXXXXXXXGOOXXXXXXXXXXXXXXXXX,0,0,0

18690,83,0,83,67,450,0,0,155,57,98,GOOOOOOOXXXXXXXXXXXXGOOOOOOXXXXXXXXXXXXXGOOOOXXXXXXXXXXXXXXXGOOOOXXXXXXXXXXXXXXXGOOOOOXXXXXXXXXXXXXXGOOOOOOOXXXXXXXXXXXXGOOOOOOOXXXXXXXXXXXXGOOXXXXXXXXXXXXXXXXXGOOOOOOXXXXXXXXXXXXXGOOOXXXXXXXXXXXXXXXXGOOOOOOOOXXXXXXXXXXXGOOOOOOOOOXXXXXXXXXXGOOXXXXXXXXXXXXXXXXX,0,0,0
18711,83,0,83,64,453,0,0,157,58,99,GOOOOOOOXXXXXXXXXXXXGOOOOOOXXXXXXXXXXXXXGOOOOXXXXXXXXXXXXXXXGOOOOXXXXXXXXXXXXXXXGOOOOOXXXXXXXXXXXXXXGOOOOOOOXXXXXXXXXXXXGOOOOOOOXXXXXXXXXXXXGOOXXXXXXXXXXXXXXXXXGOOOOOOXXXXXXXXXXXXXGOOOXXXXXXXXXXXXXXXXGOOOOOOOOXXXXXXXXXXXGOOOOOOOOOXXXXXXXXXXGOOXXXXXXXXXXXXXXXXX,0,0,0
18732,83,0,83,66,451,0,0,155,53,102,GOOOOOOOXXXXXXXXXXXXGOOOOOOXXXXXXXXXXXXXGOOOOXXXXXXXXXXXXXXXGOOOOXXXXXXXXXXXXXXXGOOOOOXXXXXXXXXXXXXXGOOOOOOOXXXXXXXXXXXXGOOOOOOOXXXXXXXXXXXXGOOXXXXXXXXXXXXXXXXXGOOOOOOXXXXXXXXXXXXXGOOOXXXXXXXXXXXXXXXXGOOOOOOOOXXXXXXXXXXXGOOOOOOOOOXXXXXXXXXXGOOXXXXXXXXXXXXXXXXX,0,0,0
18753,83,0,83,63,454,0,0,159,55,104,GOOOOOOOXXXXXXXXXXXXGOOOOOOXXXXXXXXXXXXXGOOOOXXXXXXXXXXXXXXXGOOOOXXXXXXXXXXXXXXXGOOOOOXXXXXXXXXXXXXXGOOOOOOOXXXXXXXXXXXXGOOOOOOOXXXXXXXXXXXXGOOXXXXXXXXXXXXXXXXXGOOOOOOXXXXXXXXXXXXXGOOOXXXXXXXXXXXXXXXXGOOOOOOOOXXXXXXXXXXXGOOOOOOOOOXXXXXXXXXXGOOXXXXXXXXXXXXXXXXX,0,0,0
18774,83,0,83,60,457,0,0,162,61,101,GOOOOOOOXXXXXXXXXXXXGOOOOOOXXXXXXXXXXXXXGOOOOXXXXXXXXXXXXXXXGOOOOXXXXXXXXXXXXXXXGOOOOOXXXXXXXXXXXXXXGOOOOOOOXXXXXXXXXXXXGOOOOOOOXXXXXXXXXXXXGOOXXXXXXXXXXXXXXXXXGOOOOOOXXXXXXXXXXXXXGOOOXXXXXXXXXXXXXXXXGOOOOOOOOXXXXXXXXXXXGOOOOOOOOOXXXXXXXXXXGOOXXXXXXXXXXXXXXXXX,0,0,0

18795,83,0,83,61,456,0,0,161,59,102,GOOOOOOOXXXXXXXXXXXXGOOOOOOXXXXXXXXXXXXXGOOOOXXXXXXXXXXXXXXXGOOOOXXXXXXXXXXXXXXXGOOOOOXXXXXXXXXXXXXXGOOOOOOOXXXXXXXXXXXXGOOOOOOOXXXXXXXXXXXXGOOXXXXXXXXXXXXXXXXXGOOOOOOXXXXXXXXXXXXXGOOOXXXXXXXXXXXXXXXXGOOOOOOOOXXXXXXXXXXXGOOOOOOOOOXXXXXXXXXXGOOXXXXXXXXXXXXXXXXX,0,0,0
18816,83,0,83,62,455,0,0,159,59,100,GOOOOOOOXXXXXXXXXXXXGOOOOOOXXXXXXXXXXXXXGOOOOXXXXXXXXXXXXXXXGOOOOXXXXXXXXXXXXXXXGOOOOOXXXXXXXXXXXXXXGOOOOOOOXXXXXXXXXXXXGOOOOOOOXXXXXXXXXXXXGOOXXXXXXXXXXXXXXXXXGOOOOOOXXXXXXXXXXXXXGOOOXXXXXXXXXXXXXXXXGOOOOOOOOXXXXXXXXXXXGOOOOOOOOOXXXXXXXXXXGOOXXXXXXXXXXXXXXXXX,0,0,0
18837,83,0,83,64,453,0,0,158,57,101,GOOOOOOOXXXXXXXXXXXXGOOOOOOXXXXXXXXXXXXXGOOOOXXXXXXXXXXXXXXXGOOOOXXXXXXXXXXXXXXXGOOOOOXXXXXXXXXXXXXXGOOOOOOOXXXXXXXXXXXXGOOOOOOOXXXXXXXXXXXXGOOXXXXXXXXXXXXXXXXXGOOOOOOXXXXXXXXXXXXXGOOOXXXXXXXXXXXXXXXXGOOOOOOOOXXXXXXXXXXXGOOOOOOOOOXXXXXXXXXXGOOXXXXXXXXXXXXXXXXX,0,0,0
18858,83,0,83,62,455,0,0,160,59,101,GOOOOOOOXXXXXXXXXXXXGOOOOOOXXXXXXXXXXXXXGOOOOXXXXXXXXXXXXXXXGOOOOXXXXXXXXXXXXXXXGOOOOOXXXXXXXXXXXXXXGOOOOOOOXXXXXXXXXXXXGOOOOOOOXXXXXXXXXXXXGOOXXXXXXXXXXXXXXXXXGOOOOOOXXXXXXXXXXXXXGOOOXXXXXXXXXXXXXXXXGOOOOOOOOXXXXXXXXXXXGOOOOOOOOOXXXXXXXXXXGOOXXXXXXXXXXXXXXXXX,0,0,0
18879,83,0,83,60,457,0,0,162,59,103,GOOOOOOOXXXXXXXXXXXXGOOOOOOXXXXXXXXXXXXXGOOOOXXXXXXXXXXXXXXXGOOOOXXXXXXXXXXXXXXXGOOOOOXXXXXXXXXXXXXXGOOOOOOOXXXXXXXXXXXXGOOOOOOOXXXXXXXXXXXXGOOXXXXXXXXXXXXXXXXXGOOOOOOXXXXXXXXXXXXXGOOOXXXXXXXXXXXXXXXXGOOOOOOOOXXXXXXXXXXXGOOOOOOOOOXXXXXXXXXXGOOXXXXXXXXXXXXXXXXX,0,0,0

18900,83,0,83,60,457,0,0,162,56,106,GOOOOOOOXXXXXXXXXXXXGOOOOOOXXXXXXXXXXXXXGOOOOXXXXXXXXXXXXXXXGOOOOXXXXXXXXXXXXXXXGOOOOOXXXXXXXXXXXXXXGOOOOOOOXXXXXXXXXXXXGOOOOOOOXXXXXXXXXXXXGOOXXXXXXXXXXXXXXXXXGOOOOOOXXXXXXXXXXXXXGOOOXXXXXXXXXXXXXXXXGOOOOOOOOXXXXXXXXXXXGOOOOOOOOOXXXXXXXXXXGOOXXXXXXXXXXXXXXXXX,0,0,0
18921,83,0,83,59,458,0,0,163,56,107,GOOOOOOOXXXXXXXXXXXXGOOOOOOXXXXXXXXXXXXXGOOOOXXXXXXXXXXXXXXXGOOOOXXXXXXXXXXXXXXXGOOOOOXXXXXXXXXXXXXXGOOOOOOOXXXXXXXXXXXXGOOOOOOOXXXXXXXXXXXXGOOXXXXXXXXXXXXXXXXXGOOOOOOXXXXXXXXXXXXXGOOOXXXXXXXXXXXXXXXXGOOOOOOOOXXXXXXXXXXXGOOOOOOOOOXXXXXXXXXXGOOXXXXXXXXXXXXXXXXX,0,0,0
18942,85,2,83,54,461,0,0,166,57,109,GOOOOOOOAXXXXXXXXXXXGOOOOOOXXXXXXXXXXXXXGOOOOXXXXXXXXXXXXXXXGOOOOXXXXXXXXXXXXXXXGOOOOOXXXXXXXXXXXXXXGOOOOOOOXXXXXXXXXXXXGOOOOOOOXXXXXXXXXXXXGOOXXXXXXXXXXXXXXXXXGOOOOOOAXXXXXXXXXXXXGOOOXXXXXXXXXXXXXXXXGOOOOOOOOXXXXXXXXXXXGOOOOOOOOOXXXXXXXXXXGOOXXXXXXXXXXXXXXXXX,0,0,0
18963,85,2,83,56,459,0,0,164,55,109,GOOOOOOOAXXXXXXXXXXXGOOOOOOXXXXXXXXXXXXXGOOOOXXXXXXXXXXXXXXXGOOOOXXXXXXXXXXXXXXXGOOOOOXXXXXXXXXXXXXXGOOOOOOOXXXXXXXXXXXXGOOOOOOOXXXXXXXXXXXXGOOXXXXXXXXXXXXXXXXXGOOOOOOAXXXXXXXXXXXXGOOOXXXXXXXXXXXXXXXXGOOOOOOOOXXXXXXXXXXXGOOOOOOOOOXXXXXXXXXXGOOXXXXXXXXXXXXXXXXX,0,0,0
18984,85,2,83,49,466,0,0,171,56,115,GOOOOOOOAXXXXXXXXXXXGOOOOOOXXXXXXXXXXXXXGOOOOXXXXXXXXXXXXXXXGOOOOXXXXXXXXXXXXXXXGOOOOOXXXXXXXXXXXXXXGOOOOOOOXXXXXXXXXXXXGOOOOOOOXXXXXXXXXXXXGOOXXXXXXXXXXXXXXXXXGOOOOOOAXXXXXXXXXXXXGOOOXXXXXXXXXXXXXXXXGOOOOOOOOXXXXXXXXXXXGOOOOOOOOOXXXXXXXXXXGOOXXXXXXXXXXXXXXXXX,0,0,0

19005,85,2,83,49,466,0,0,171,58,113,GOOOOOOOAXXXXXXXXXXXGOOOOOOXXXXXXXXXXXXXGOOOOXXXXXXXXXXXXXXXGOOOOXXXXXXXXXXXXXXXGOOOOOXXXXXXXXXXXXXXGOOOOOOOXXXXXXXXXXXXGOOOOOOOXXXXXXXXXXXXGOOXXXXXXXXXXXXXXXXXGOOOOOOAXXXXXXXXXXXXGOOOXXXXXXXXXXXXXXXXGOOOOOOOOXXXXXXXXXXXGOOOOOOOOOXXXXXXXXXXGOOXXXXXXXXXXXXXXXXX,0,0,0
19026,85,2,83,50,465,0,0,169,57,112,GOOOOOOOAXXXXXXXXXXXGOOOOOOXXXXXXXXXXXXXGOOOOXXXXXXXXXXXXXXXGOOOOXXXXXXXXXXXXXXXGOOOOOXXXXXXXXXXXXXXGOOOOOOOXXXXXXXXXXXXGOOOOOOOXXXXXXXXXXXXGOOXXXXXXXXXXXXXXXXXGOOOOOOAXXXXXXXXXXXXGOOOXXXXXXXXXXXXXXXXGOOOOOOOOXXXXXXXXXXXGOOOOOOOOOXXXXXXXXXXGOOXXXXXXXXXXXXXXXXX,0,0,0
19047,85,2,83,54,461,0,0,164,60,104,GOOOOOOOAXXXXXXXXXXXGOOOOOOXXXXXXXXXXXXXGOOOOXXXXXXXXXXXXXXXGOOOOXXXXXXXXXXXXXXXGOOOOOXXXXXXXXXXXXXXGOOOOOOOXXXXXXXXXXXXGOOOOOOOXXXXXXXXXXXXGOOXXXXXXXXXXXXXXXXXGOOOOOOAXXXXXXXXXXXXGOOOXXXXXXXXXXXXXXXXGOOOOOOOOXXXXXXXXXXXGOOOOOOOOOXXXXXXXXXXGOOXXXXXXXXXXXXXXXXX,0,0,0
19068,85,1,84,54,461,0,0,164,57,107,GOOOOOOOAXXXXXXXXXXXGOOOOOOXXXXXXXXXXXXXGOOOOXXXXXXXXXXXXXXXGOOOOXXXXXXXXXXXXXXXGOOOOOXXXXXXXXXXXXXXGOOOOOOOXXXXXXXXXXXXGOOOOOOOXXXXXXXXXXXXGOOXXXXXXXXXXXXXXXXXGOOOOOOOXXXXXXXXXXXXGOOOXXXXXXXXXXXXXXXXGOOOOOOOOXXXXXXXXXXXGOOOOOOOOOXXXXXXXXXXGOOXXXXXXXXXXXXXXXXX,0,0,0
19089,85,1,84,49,466,0,0,168,62,106,GOOOOOOOAXXXXXXXXXXXGOOOOOOXXXXXXXXXXXXXGOOOOXXXXXXXXXXXXXXXGOOOOXXXXXXXXXXXXXXXGOOOOOXXXXXXXXXXXXXXGOOOOOOOXXXXXXXXXXXXGOOOOOOOXXXXXXXXXXXXGOOXXXXXXXXXXXXXXXXXGOOOOOOOXXXXXXXXXXXXGOOOXXXXXXXXXXXXXXXXGOOOOOOOOXXXXXXXXXXXGOOOOOOOOOXXXXXXXXXXGOOXXXXXXXXXXXXXXXXX,0,0,0

19110,86,2,84,52,462,0,0,166,59,107,GOOOOOOOAXXXXXXXXXXXGOOOOOOXXXXXXXXXXXXXGOOOOXXXXXXXXXXXXXXXGOOOOAXXXXXXXXXXXXXXGOOOOOXXXXXXXXXXXXXXGOOOOOOOXXXXXXXXXXXXGOOOOOOOXXXXXXXXXXXXGOOXXXXXXXXXXXXXXXXXGOOOOOOOXXXXXXXXXXXXGOOOXXXXXXXXXXXXXXXXGOOOOOOOOXXXXXXXXXXXGOOOOOOOOOXXXXXXXXXXGOOXXXXXXXXXXXXXXXXX,0,0,0
19131,87,3,84,49,464,0,0,169,59,110,GOOOOOOOAXXXXXXXXXXXGOOOOOOXXXXXXXXXXXXXGOOOOXXXXXXXXXXXXXXXGOOOOAXXXXXXXXXXXXXXGOOOOOXXXXXXXXXXXXXXGOOOOOOOAXXXXXXXXXXXGOOOOOOOXXXXXXXXXXXXGOOXXXXXXXXXXXXXXXXXGOOOOOOOXXXXXXXXXXXXGOOOXXXXXXXXXXXXXXXXGOOOOOOOOXXXXXXXXXXXGOOOOOOOOOXXXXXXXXXXGOOXXXXXXXXXXXXXXXXX,0,0,0
19152,87,3,84,48,465,0,0,170,60,110,GOOOOOOOAXXXXXXXXXXXGOOOOOOXXXXXXXXXXXXXGOOOOXXXXXXXXXXXXXXXGOOOOAXXXXXXXXXXXXXXGOOOOOXXXXXXXXXXXXXXGOOOOOOOAXXXXXXXXXXXGOOOOOOOXXXXXXXXXXXXGOOXXXXXXXXXXXXXXXXXGOOOOOOOXXXXXXXXXXXXGOOOXXXXXXXXXXXXXXXXGOOOOOOOOXXXXXXXXXXXGOOOOOOOOOXXXXXXXXXXGOOXXXXXXXXXXXXXXXXX,0,0,0
19173,87,3,84,48,465,0,0,170,62,108,GOOOOOOOAXXXXXXXXXXXGOOOOOOXXXXXXXXXXXXXGOOOOXXXXXXXXXXXXXXXGOOOOAXXXXXXXXXXXXXXGOOOOOXXXXXXXXXXXXXXGOOOOOOOAXXXXXXXXXXXGOOOOOOOXXXXXXXXXXXXGOOXXXXXXXXXXXXXXXXXGOOOOOOOXXXXXXXXXXXXGOOOXXXXXXXXXXXXXXXXGOOOOOOOOXXXXXXXXXXXGOOOOOOOOOXXXXXXXXXXGOOXXXXXXXXXXXXXXXXX,0,0,0
19194,87,2,85,52,461,0,0,166,66,100,GOOOOOOOOXXXXXXXXXXXGOOOOOOXXXXXXXXXXXXXGOOOOXXXXXXXXXXXXXXXGOOOOAXXXXXXXXXXXXXXGOOOOOXXXXXXXXXXXXXXGOOOOOOOAXXXXXXXXXXXGOOOOOOOXXXXXXXXXXXXGOOXXXXXXXXXXXXXXXXXGOOOOOOOXXXXXXXXXXXXGOOOXXXXXXXXXXXXXXXXGOOOOOOOOXXXXXXXXXXXGOOOOOOOOOXXXXXXXXXXGOOXXXXXXXXXXXXXXXXX,0,0,0

19215,87,2,85,55,458,0,0,164,65,99,GOOOOOOOOXXXXXXXXXXXGOOOOOOXXXXXXXXXXXXXGOOOOXXXXXXXXXXXXXXXGOOOOAXXXXXXXXXXXXXXGOOOOOXXXXXXXXXXXXXXGOOOOOOOAXXXXXXXXXXXGOOOOOOOXXXXXXXXXXXXGOOXXXXXXXXXXXXXXXXXGOOOOOOOXXXXXXXXXXXXGOOOXXXXXXXXXXXXXXXXGOOOOOOOOXXXXXXXXXXXGOOOOOOOOOXXXXXXXXXXGOOXXXXXXXXXXXXXXXXX,0,0,0
19236,87,1,86,55,458,0,0,164,65,99,GOOOOOOOOXXXXXXXXXXXGOOOOOOXXXXXXXXXXXXXGOOOOXXXXXXXXXXXXXXXGOOOOOXXXXXXXXXXXXXXGOOOOOXXXXXXXXXXXXXXGOOOOOOOAXXXXXXXXXXXGOOOOOOOXXXXXXXXXXXXGOOXXXXXXXXXXXXXXXXXGOOOOOOOXXXXXXXXXXXXGOOOXXXXXXXXXXXXXXXXGOOOOOOOOXXXXXXXXXXXGOOOOOOOOOXXXXXXXXXXGOOXXXXXXXXXXXXXXXXX,0,0,0
19257,87,1,86,61,452,0,0,158,63,95,GOOOOOOOOXXXXXXXXXXXGOOOOOOXXXXXXXXXXXXXGOOOOXXXXXXXXXXXXXXXGOOOOOXXXXXXXXXXXXXXGOOOOOXXXXXXXXXXXXXXGOOOOOOOAXXXXXXXXXXXGOOOOOOOXXXXXXXXXXXXGOOXXXXXXXXXXXXXXXXXGOOOOOOOXXXXXXXXXXXXGOOOXXXXXXXXXXXXXXXXGOOOOOOOOXXXXXXXXXXXGOOOOOOOOOXXXXXXXXXXGOOXXXXXXXXXXXXXXXXX,0,0,0
19278,87,1,86,57,456,0,0,160,64,96,GOOOOOOOOXXXXXXXXXXXGOOOOOOXXXXXXXXXXXXXGOOOOXXXXXXXXXXXXXXXGOOOOOXXXXXXXXXXXXXXGOOOOOXXXXXXXXXXXXXXGOOOOOOOAXXXXXXXXXXXGOOOOOOOXXXXXXXXXXXXGOOXXXXXXXXXXXXXXXXXGOOOOOOOXXXXXXXXXXXXGOOOXXXXXXXXXXXXXXXXGOOOOOOOOXXXXXXXXXXXGOOOOOOOOOXXXXXXXXXXGOOXXXXXXXXXXXXXXXXX,0,0,0
19299,87,1,86,61,452,0,0,159,62,97,GOOOOOOOOXXXXXXXXXXXGOOOOOOXXXXXXXXXXXXXGOOOOXXXXXXXXXXXXXXXGOOOOOXXXXXXXXXXXXXXGOOOOOXXXXXXXXXXXXXXGOOOOOOOAXXXXXXXXXXXGOOOOOOOXXXXXXXXXXXXGOOXXXXXXXXXXXXXXXXXGOOOOOOOXXXXXXXXXXXXGOOOXXXXXXXXXXXXXXXXGOOOOOOOOXXXXXXXXXXXGOOOOOOOOOXXXXXXXXXXGOOXXXXXXXXXXXXXXXXX,0,0,0

19320,88,2,86,64,448,0,0,155,59,96,GOOOOOOOOAXXXXXXXXXXGOOOOOOXXXXXXXXXXXXXGOOOOXXXXXXXXXXXXXXXGOOOOOXXXXXXXXXXXXXXGOOOOOXXXXXXXXXXXXXXGOOOOOOOAXXXXXXXXXXXGOOOOOOOXXXXXXXXXXXXGOOXXXXXXXXXXXXXXXXXGOOOOOOOXXXXXXXXXXXXGOOOXXXXXXXXXXXXXXXXGOOOOOOOOXXXXXXXXXXXGOOOOOOOOOXXXXXXXXXXGOOXXXXXXXXXXXXXXXXX,0,0,0
19341,88,2,86,61,451,0,0,156,63,93,GOOOOOOOOAXXXXXXXXXXGOOOOOOXXXXXXXXXXXXXGOOOOXXXXXXXXXXXXXXXGOOOOOXXXXXXXXXXXXXXGOOOOOXXXXXXXXXXXXXXGOOOOOOOAXXXXXXXXXXXGOOOOOOOXXXXXXXXXXXXGOOXXXXXXXXXXXXXXXXXGOOOOOOOXXXXXXXXXXXXGOOOXXXXXXXXXXXXXXXXGOOOOOOOOXXXXXXXXXXXGOOOOOOOOOXXXXXXXXXXGOOXXXXXXXXXXXXXXXXX,0,0,0
19362,88,2,86,60,452,0,0,159,64,95,GOOOOOOOOAXXXXXXXXXXGOOOOOOXXXXXXXXXXXXXGOOOOXXXXXXXXXXXXXXXGOOOOOXXXXXXXXXXXXXXGOOOOOXXXXXXXXXXXXXXGOOOOOOOAXXXXXXXXXXXGOOOOOOOXXXXXXXXXXXXGOOXXXXXXXXXXXXXXXXXGOOOOOOOXXXXXXXXXXXXGOOOXXXXXXXXXXXXXXXXGOOOOOOOOXXXXXXXXXXXGOOOOOOOOOXXXXXXXXXXGOOXXXXXXXXXXXXXXXXX,0,0,0
19383,88,1,87,56,456,0,0,163,63,100,GOOOOOOOOAXXXXXXXXXXGOOOOOOXXXXXXXXXXXXXGOOOOXXXXXXXXXXXXXXXGOOOOOXXXXXXXXXXXXXXGOOOOOXXXXXXXXXXXXXXGOOOOOOOOXXXXXXXXXXXGOOOOOOOXXXXXXXXXXXXGOOXXXXXXXXXXXXXXXXXGOOOOOOOXXXXXXXXXXXXGOOOXXXXXXXXXXXXXXXXGOOOOOOOOXXXXXXXXXXXGOOOOOOOOOXXXXXXXXXXGOOXXXXXXXXXXXXXXXXX,0,0,0
19404,88,1,87,57,455,0,0,163,60,103,GOOOOOOOOAXXXXXXXXXXGOOOOOOXXXXXXXXXXXXXGOOOOXXXXXXXXXXXXXXXGOOOOOXXXXXXXXXXXXXXGOOOOOXXXXXXXXXXXXXXGOOOOOOOOXXXXXXXXXXXGOOOOOOOXXXXXXXXXXXXGOOXXXXXXXXXXXXXXXXXGOOOOOOOXXXXXXXXXXXXGOOOXXXXXXXXXXXXXXXXGOOOOOOOOXXXXXXXXXXXGOOOOOOOOOXXXXXXXXXXGOOXXXXXXXXXXXXXXXXX,0,0,0

19425,88,1,87,54,458,0,0,166,61,105,GOOOOOOOOAXXXXXXXXXXGOOOOOOXXXXXXXXXXXXXGOOOOXXXXXXXXXXXXXXXGOOOOOXXXXXXXXXXXXXXGOOOOOXXXXXXXXXXXXXXGOOOOOOOOXXXXXXXXXXXGOOOOOOOXXXXXXXXXXXXGOOXXXXXXXXXXXXXXXXXGOOOOOOOXXXXXXXXXXXXGOOOXXXXXXXXXXXXXXXXGOOOOOOOOXXXXXXXXXXXGOOOOOOOOOXXXXXXXXXXGOOXXXXXXXXXXXXXXXXX,0,0,0
19446,88,1,87,54,458,0,0,165,61,104,GOOOOOOOOAXXXXXXXXXXGOOOOOOXXXXXXXXXXXXXGOOOOXXXXXXXXXXXXXXXGOOOOOXXXXXXXXXXXXXXGOOOOOXXXXXXXXXXXXXXGOOOOOOOOXXXXXXXXXXXGOOOOOOOXXXXXXXXXXXXGOOXXXXXXXXXXXXXXXXXGOOOOOOOXXXXXXXXXXXXGOOOXXXXXXXXXXXXXXXXGOOOOOOOOXXXXXXXXXXXGOOOOOOOOOXXXXXXXXXXGOOXXXXXXXXXXXXXXXXX,0,0,0
19467,88,0,88,53,459,0,0,166,64,102,GOOOOOOOOOXXXXXXXXXXGOOOOOOXXXXXXXXXXXXXGOOOOXXXXXXXXXXXXXXXGOOOOOXXXXXXXXXXXXXXGOOOOOXXXXXXXXXXXXXXGOOOOOOOOXXXXXXXXXXXGOOOOOOOXXXXXXXXXXXXGOOXXXXXXXXXXXXXXXXXGOOOOOOOXXXXXXXXXXXXGOOOXXXXXXXXXXXXXXXXGOOOOOOOOXXXXXXXXXXXGOOOOOOOOOXXXXXXXXXXGOOXXXXXXXXXXXXXXXXX,0,0,0
19488,88,0,88,62,450,0,0,157,61,96,GOOOOOOOOOXXXXXXXXXXGOOOOOOXXXXXXXXXXXXXGOOOOXXXXXXXXXXXXXXXGOOOOOXXXXXXXXXXXXXXGOOOOOXXXXXXXXXXXXXXGOOOOOOOOXXXXXXXXXXXGOOOOOOOXXXXXXXXXXXXGOOXXXXXXXXXXXXXXXXXGOOOOOOOXXXXXXXXXXXXGOOOXXXXXXXXXXXXXXXXGOOOOOOOOXXXXXXXXXXXGOOOOOOOOOXXXXXXXXXXGOOXXXXXXXXXXXXXXXXX,0,0,0
19509,88,0,88,50,462,0,0,170,70,100,GOOOOOOOOOXXXXXXXXXXGOOOOOOXXXXXXXXXXXXXGOOOOXXXXXXXXXXXXXXXGOOOOOXXXXXXXXXXXXXXGOOOOOXXXXXXXXXXXXXXGOOOOOOOOXXXXXXXXXXXGOOOOOOOXXXXXXXXXXXXGOOXXXXXXXXXXXXXXXXXGOOOOOOOXXXXXXXXXXXXGOOOXXXXXXXXXXXXXXXXGOOOOOOOOXXXXXXXXXXXGOOOOOOOOOXXXXXXXXXXGOOXXXXXXXXXXXXXXXXX,0,0,0

19530,88,0,88,52,460,0,0,168,72,96,GOOOOOOOOOXXXXXXXXXXGOOOOOOXXXXXXXXXXXXXGOOOOXXXXXXXXXXXXXXXGOOOOOXXXXXXXXXXXXXXGOOOOOXXXXXXXXXXXXXXGOOOOOOOOXXXXXXXXXXXGOOOOOOOXXXXXXXXXXXXGOOXXXXXXXXXXXXXXXXXGOOOOOOOXXXXXXXXXXXXGOOOXXXXXXXXXXXXXXXXGOOOOOOOOXXXXXXXXXXXGOOOOOOOOOXXXXXXXXXXGOOXXXXXXXXXXXXXXXXX,0,0,0
19551,88,0,88,58,454,0,0,162,65,97,GOOOOOOOOOXXXXXXXXXXGOOOOOOXXXXXXXXXXXXXGOOOOXXXXXXXXXXXXXXXGOOOOOXXXXXXXXXXXXXXGOOOOOXXXXXXXXXXXXXXGOOOOOOOOXXXXXXXXXXXGOOOOOOOXXXXXXXXXXXXGOOXXXXXXXXXXXXXXXXXGOOOOOOOXXXXXXXXXXXXGOOOXXXXXXXXXXXXXXXXGOOOOOOOOXXXXXXXXXXXGOOOOOOOOOXXXXXXXXXXGOOXXXXXXXXXXXXXXXXX,0,0,0
19572,88,0,88,52,460,0,0,167,63,104,GOOOOOOOOOXXXXXXXXXXGOOOOOOXXXXXXXXXXXXXGOOOOXXXXXXXXXXXXXXXGOOOOOXXXXXXXXXXXXXXGOOOOOXXXXXXXXXXXXXXGOOOOOOOOXXXXXXXXXXXGOOOOOOOXXXXXXXXXXXXGOOXXXXXXXXXXXXXXXXXGOOOOOOOXXXXXXXXXXXXGOOOXXXXXXXXXXXXXXXXGOOOOOOOOXXXXXXXXXXXGOOOOOOOOOXXXXXXXXXXGOOXXXXXXXXXXXXXXXXX,0,0,0
19593,88,0,88,54,458,0,0,167,65,102,GOOOOOOOOOXXXXXXXXXXGOOOOOOXXXXXXXXXXXXXGOOOOXXXXXXXXXXXXXXXGOOOOOXXXXXXXXXXXXXXGOOOOOXXXXXXXXXXXXXXGOOOOOOOOXXXXXXXXXXXGOOOOOOOXXXXXXXXXXXXGOOXXXXXXXXXXXXXXXXXGOOOOOOOXXXXXXXXXXXXGOOOXXXXXXXXXXXXXXXXGOOOOOOOOXXXXXXXXXXXGOOOOOOOOOXXXXXXXXXXGOOXXXXXXXXXXXXXXXXX,0,0,0
19614,88,0,88,53,459,0,0,166,64,102,GOOOOOOOOOXXXXXXXXXXGOOOOOOXXXXXXXXXXXXXGOOOOXXXXXXXXXXXXXXXGOOOOOXXXXXXXXXXXXXXGOOOOOXXXXXXXXXXXXXXGOOOOOOOOXXXXXXXXXXXGOOOOOOOXXXXXXXXXXXXGOOXXXXXXXXXXXXXXXXXGOOOOOOOXXXXXXXXXXXXGOOOXXXXXXXXXXXXXXXXGOOOOOOOOXXXXXXXXXXXGOOOOOOOOOXXXXXXXXXXGOOXXXXXXXXXXXXXXXXX,0,0,0

19635,88,0,88,51,461,0,0,167,62,105,GOOOOOOOOOXXXXXXXXXXGOOOOOOXXXXXXXXXXXXXGOOOOXXXXXXXXXXXXXXXGOOOOOXXXXXXXXXXXXXXGOOOOOXXXXXXXXXXXXXXGOOOOOOOOXXXXXXXXXXXGOOOOOOOXXXXXXXXXXXXGOOXXXXXXXXXXXXXXXXXGOOOOOOOXXXXXXXXXXXXGOOOXXXXXXXXXXXXXXXXGOOOOOOOOXXXXXXXXXXXGOOOOOOOOOXXXXXXXXXXGOOXXXXXXXXXXXXXXXXX,0,0,0
19656,88,0,88,50,462,0,0,167,62,105,GOOOOOOOOOXXXXXXXXXXGOOOOOOXXXXXXXXXXXXXGOOOOXXXXXXXXXXXXXXXGOOOOOXXXXXXXXXXXXXXGOOOOOXXXXXXXXXXXXXXGOOOOOOOOXXXXXXXXXXXGOOOOOOOXXXXXXXXXXXXGOOXXXXXXXXXXXXXXXXXGOOOOOOOXXXXXXXXXXXXGOOOXXXXXXXXXXXXXXXXGOOOOOOOOXXXXXXXXXXXGOOOOOOOOOXXXXXXXXXXGOOXXXXXXXXXXXXXXXXX,0,0,0
19677,88,0,88,53,459,0,0,165,64,101,GOOOOOOOOOXXXXXXXXXXGOOOOOOXXXXXXXXXXXXXGOOOOXXXXXXXXXXXXXXXGOOOOOXXXXXXXXXXXXXXGOOOOOXXXXXXXXXXXXXXGOOOOOOOOXXXXXXXXXXXGOOOOOOOXXXXXXXXXXXXGOOXXXXXXXXXXXXXXXXXGOOOOOOOXXXXXXXXXXXXGOOOXXXXXXXXXXXXXXXXGOOOOOOOOXXXXXXXXXXXGOOOOOOOOOXXXXXXXXXXGOOXXXXXXXXXXXXXXXXX,0,0,0
19698,88,0,88,49,463,0,0,167,66,101,GOOOOOOOOOXXXXXXXXXXGOOOOOOXXXXXXXXXXXXXGOOOOXXXXXXXXXXXXXXXGOOOOOXXXXXXXXXXXXXXGOOOOOXXXXXXXXXXXXXXGOOOOOOOOXXXXXXXXXXXGOOOOOOOXXXXXXXXXXXXGOOXXXXXXXXXXXXXXXXXGOOOOOOOXXXXXXXXXXXXGOOOXXXXXXXXXXXXXXXXGOOOOOOOOXXXXXXXXXXXGOOOOOOOOOXXXXXXXXXXGOOXXXXXXXXXXXXXXXXX,0,0,0
19719,88,0,88,47,465,0,0,170,67,103,GOOOOOOOOOXXXXXXXXXXGOOOOOOXXXXXXXXXXXXXGOOOOXXXXXXXXXXXXXXXGOOOOOXXXXXXXXXXXXXXGOOOOOXXXXXXXXXXXXXXGOOOOOOOOXXXXXXXXXXXGOOOOOOOXXXXXXXXXXXXGOOXXXXXXXXXXXXXXXXXGOOOOOOOXXXXXXXXXXXXGOOOXXXXXXXXXXXXXXXXGOOOOOOOOXXXXXXXXXXXGOOOOOOOOOXXXXXXXXXXGOOXXXXXXXXXXXXXXXXX,0,0,0

19740,88,0,88,47,465,0,0,170,65,105,GOOOOOOOOOXXXXXXXXXXGOOOOOOXXXXXXXXXXXXXGOOOOXXXXXXXXXXXXXXXGOOOOOXXXXXXXXXXXXXXGOOOOOXXXXXXXXXXXXXXGOOOOOOOOXXXXXXXXXXXGOOOOOOOXXXXXXXXXXXXGOOXXXXXXXXXXXXXXXXXGOOOOOOOXXXXXXXXXXXXGOOOXXXXXXXXXXXXXXXXGOOOOOOOOXXXXXXXXXXXGOOOOOOOOOXXXXXXXXXXGOOXXXXXXXXXXXXXXXXX,0,0,0
19761,88,0,88,44,468,0,0,173,62,111,GOOOOOOOOOXXXXXXXXXXGOOOOOOXXXXXXXXXXXXXGOOOOXXXXXXXXXXXXXXXGOOOOOXXXXXXXXXXXXXXGOOOOOXXXXXXXXXXXXXXGOOOOOOOOXXXXXXXXXXXGOOOOOOOXXXXXXXXXXXXGOOXXXXXXXXXXXXXXXXXGOOOOOOOXXXXXXXXXXXXGOOOXXXXXXXXXXXXXXXXGOOOOOOOOXXXXXXXXXXXGOOOOOOOOOXXXXXXXXXXGOOXXXXXXXXXXXXXXXXX,0,0,0
19782,88,0,88,45,467,0,0,171,64,107,GOOOOOOOOOXXXXXXXXXXGOOOOOOXXXXXXXXXXXXXGOOOOXXXXXXXXXXXXXXXGOOOOOXXXXXXXXXXXXXXGOOOOOXXXXXXXXXXXXXXGOOOOOOOOXXXXXXXXXXXGOOOOOOOXXXXXXXXXXXXGOOXXXXXXXXXXXXXXXXXGOOOOOOOXXXXXXXXXXXXGOOOXXXXXXXXXXXXXXXXGOOOOOOOOXXXXXXXXXXXGOOOOOOOOOXXXXXXXXXXGOOXXXXXXXXXXXXXXXXX,0,0,0
19803,88,0,88,46,466,0,0,170,65,105,GOOOOOOOOOXXXXXXXXXXGOOOOOOXXXXXXXXXXXXXGOOOOXXXXXXXXXXXXXXXGOOOOOXXXXXXXXXXXXXXGOOOOOXXXXXXXXXXXXXXGOOOOOOOOXXXXXXXXXXXGOOOOOOOXXXXXXXXXXXXGOOXXXXXXXXXXXXXXXXXGOOOOOOOXXXXXXXXXXXXGOOOXXXXXXXXXXXXXXXXGOOOOOOOOXXXXXXXXXXXGOOOOOOOOOXXXXXXXXXXGOOXXXXXXXXXXXXXXXXX,0,0,0
19824,88,0,88,47,465,0,0,170,66,104,GOOOOOOOOOXXXXXXXXXXGOOOOOOXXXXXXXXXXXXXGOOOOXXXXXXXXXXXXXXXGOOOOOXXXXXXXXXXXXXXGOOOOOXXXXXXXXXXXXXXGOOOOOOOOXXXXXXXXXXXGOOOOOOOXXXXXXXXXXXXGOOXXXXXXXXXXXXXXXXXGOOOOOOOXXXXXXXXXXXXGOOOXXXXXXXXXXXXXXXXGOOOOOOOOXXXXXXXXXXXGOOOOOOOOOXXXXXXXXXXGOOXXXXXXXXXXXXXXXXX,0,0,0

19845,88,0,88,51,461,0,0,166,69,97,GOOOOOOOOOXXXXXXXXXXGOOOOOOXXXXXXXXXXXXXGOOOOXXXXXXXXXXXXXXXGOOOOOXXXXXXXXXXXXXXGOOOOOXXXXXXXXXXXXXXGOOOOOOOOXXXXXXXXXXXGOOOOOOOXXXXXXXXXXXXGOOXXXXXXXXXXXXXXXXXGOOOOOOOXXXXXXXXXXXXGOOOXXXXXXXXXXXXXXXXGOOOOOOOOXXXXXXXXXXXGOOOOOOOOOXXXXXXXXXXGOOXXXXXXXXXXXXXXXXX,0,0,0
19866,88,0,88,54,458,0,0,162,67,95,GOOOOOOOOOXXXXXXXXXXGOOOOOOXXXXXXXXXXXXXGOOOOXXXXXXXXXXXXXXXGOOOOOXXXXXXXXXXXXXXGOOOOOXXXXXXXXXXXXXXGOOOOOOOOXXXXXXXXXXXGOOOOOOOXXXXXXXXXXXXGOOXXXXXXXXXXXXXXXXXGOOOOOOOXXXXXXXXXXXXGOOOXXXXXXXXXXXXXXXXGOOOOOOOOXXXXXXXXXXXGOOOOOOOOOXXXXXXXXXXGOOXXXXXXXXXXXXXXXXX,0,0,0
19887,88,0,88,51,461,0,0,166,70,96,GOOOOOOOOOXXXXXXXXXXGOOOOOOXXXXXXXXXXXXXGOOOOXXXXXXXXXXXXXXXGOOOOOXXXXXXXXXXXXXXGOOOOOXXXXXXXXXXXXXXGOOOOOOOOXXXXXXXXXXXGOOOOOOOXXXXXXXXXXXXGOOXXXXXXXXXXXXXXXXXGOOOOOOOXXXXXXXXXXXXGOOOXXXXXXXXXXXXXXXXGOOOOOOOOXXXXXXXXXXXGOOOOOOOOOXXXXXXXXXXGOOXXXXXXXXXXXXXXXXX,0,0,0
19908,88,0,88,52,460,0,0,165,68,97,GOOOOOOOOOXXXXXXXXXXGOOOOOOXXXXXXXXXXXXXGOOOOXXXXXXXXXXXXXXXGOOOOOXXXXXXXXXXXXXXGOOOOOXXXXXXXXXXXXXXGOOOOOOOOXXXXXXXXXXXGOOOOOOOXXXXXXXXXXXXGOOXXXXXXXXXXXXXXXXXGOOOOOOOXXXXXXXXXXXXGOOOXXXXXXXXXXXXXXXXGOOOOOOOOXXXXXXXXXXXGOOOOOOOOOXXXXXXXXXXGOOXXXXXXXXXXXXXXXXX,0,0,0
19929,88,0,88,54,458,0,0,163,65,98,GOOOOOOOOOXXXXXXXXXXGOOOOOOXXXXXXXXXXXXXGOOOOXXXXXXXXXXXXXXXGOOOOOXXXXXXXXXXXXXXGOOOOOXXXXXXXXXXXXXXGOOOOOOOOXXXXXXXXXXXGOOOOOOOXXXXXXXXXXXXGOOXXXXXXXXXXXXXXXXXGOOOOOOOXXXXXXXXXXXXGOOOXXXXXXXXXXXXXXXXGOOOOOOOOXXXXXXXXXXXGOOOOOOOOOXXXXXXXXXXGOOXXXXXXXXXXXXXXXXX,0,0,0

19950,88,0,88,51,461,0,0,165,61,104,GOOOOOOOOOXXXXXXXXXXGOOOOOOXXXXXXXXXXXXXGOOOOXXXXXXXXXXXXXXXGOOOOOXXXXXXXXXXXXXXGOOOOOXXXXXXXXXXXXXXGOOOOOOOOXXXXXXXXXXXGOOOOOOOXXXXXXXXXXXXGOOXXXXXXXXXXXXXXXXXGOOOOOOOXXXXXXXXXXXXGOOOXXXXXXXXXXXXXXXXGOOOOOOOOXXXXXXXXXXXGOOOOOOOOOXXXXXXXXXXGOOXXXXXXXXXXXXXXXXX,0,0,0
19971,88,0,88,46,466,0,0,170,68,102,GOOOOOOOOOXXXXXXXXXXGOOOOOOXXXXXXXXXXXXXGOOOOXXXXXXXXXXXXXXXGOOOOOXXXXXXXXXXXXXXGOOOOOXXXXXXXXXXXXXXGOOOOOOOOXXXXXXXXXXXGOOOOOOOXXXXXXXXXXXXGOOXXXXXXXXXXXXXXXXXGOOOOOOOXXXXXXXXXXXXGOOOXXXXXXXXXXXXXXXXGOOOOOOOOXXXXXXXXXXXGOOOOOOOOOXXXXXXXXXXGOOXXXXXXXXXXXXXXXXX,0,0,0
19992,88,0,88,55,457,0,0,160,64,96,GOOOOOOOOOXXXXXXXXXXGOOOOOOXXXXXXXXXXXXXGOOOOXXXXXXXXXXXXXXXGOOOOOXXXXXXXXXXXXXXGOOOOOXXXXXXXXXXXXXXGOOOOOOOOXXXXXXXXXXXGOOOOOOOXXXXXXXXXXXXGOOXXXXXXXXXXXXXXXXXGOOOOOOOXXXXXXXXXXXXGOOOXXXXXXXXXXXXXXXXGOOOOOOOOXXXXXXXXXXXGOOOOOOOOOXXXXXXXXXXGOOXXXXXXXXXXXXXXXXX,0,0,0
20013,88,0,88,57,455,0,0,159,64,95,GOOOOOOOOOXXXXXXXXXXGOOOOOOXXXXXXXXXXXXXGOOOOXXXXXXXXXXXXXXXGOOOOOXXXXXXXXXXXXXXGOOOOOXXXXXXXXXXXXXXGOOOOOOOOXXXXXXXXXXXGOOOOOOOXXXXXXXXXXXXGOOXXXXXXXXXXXXXXXXXGOOOOOOOXXXXXXXXXXXXGOOOXXXXXXXXXXXXXXXXGOOOOOOOOXXXXXXXXXXXGOOOOOOOOOXXXXXXXXXXGOOXXXXXXXXXXXXXXXXX,0,0,0
20034,88,0,88,57,455,0,0,159,64,95,GOOOOOOOOOXXXXXXXXXXGOOOOOOXXXXXXXXXXXXXGOOOOXXXXXXXXXXXXXXXGOOOOOXXXXXXXXXXXXXXGOOOOOXXXXXXXXXXXXXXGOOOOOOOOXXXXXXXXXXXGOOOOOOOXXXXXXXXXXXXGOOXXXXXXXXXXXXXXXXXGOOOOOOOXXXXXXXXXXXXGOOOXXXXXXXXXXXXXXXXGOOOOOOOOXXXXXXXXXXXGOOOOOOOOOXXXXXXXXXXGOOXXXXXXXXXXXXXXXXX,0,0,0

20055,88,0,88,57,455,0,0,159,67,92,GOOOOOOOOOXXXXXXXXXXGOOOOOOXXXXXXXXXXXXXGOOOOXXXXXXXXXXXXXXXGOOOOOXXXXXXXXXXXXXXGOOOOOXXXXXXXXXXXXXXGOOOOOOOOXXXXXXXXXXXGOOOOOOOXXXXXXXXXXXXGOOXXXXXXXXXXXXXXXXXGOOOOOOOXXXXXXXXXXXXGOOOXXXXXXXXXXXXXXXXGOOOOOOOOXXXXXXXXXXXGOOOOOOOOOXXXXXXXXXXGOOXXXXXXXXXXXXXXXXX,0,0,0
20076,88,0,88,58,454,0,0,159,70,89,GOOOOOOOOOXXXXXXXXXXGOOOOOOXXXXXXXXXXXXXGOOOOXXXXXXXXXXXXXXXGOOOOOXXXXXXXXXXXXXXGOOOOOXXXXXXXXXXXXXXGOOOOOOOOXXXXXXXXXXXGOOOOOOOXXXXXXXXXXXXGOOXXXXXXXXXXXXXXXXXGOOOOOOOXXXXXXXXXXXXGOOOXXXXXXXXXXXXXXXXGOOOOOOOOXXXXXXXXXXXGOOOOOOOOOXXXXXXXXXXGOOXXXXXXXXXXXXXXXXX,0,0,0
20097,88,0,88,60,452,0,0,158,66,92,GOOOOOOOOOXXXXXXXXXXGOOOOOOXXXXXXXXXXXXXGOOOOXXXXXXXXXXXXXXXGOOOOOXXXXXXXXXXXXXXGOOOOOXXXXXXXXXXXXXXGOOOOOOOOXXXXXXXXXXXGOOOOOOOXXXXXXXXXXXXGOOXXXXXXXXXXXXXXXXXGOOOOOOOXXXXXXXXXXXXGOOOXXXXXXXXXXXXXXXXGOOOOOOOOXXXXXXXXXXXGOOOOOOOOOXXXXXXXXXXGOOXXXXXXXXXXXXXXXXX,0,0,0
20118,88,0,88,56,456,0,0,161,68,93,GOOOOOOOOOXXXXXXXXXXGOOOOOOXXXXXXXXXXXXXGOOOOXXXXXXXXXXXXXXXGOOOOOXXXXXXXXXXXXXXGOOOOOXXXXXXXXXXXXXXGOOOOOOOOXXXXXXXXXXXGOOOOOOOXXXXXXXXXXXXGOOXXXXXXXXXXXXXXXXXGOOOOOOOXXXXXXXXXXXXGOOOXXXXXXXXXXXXXXXXGOOOOOOOOXXXXXXXXXXXGOOOOOOOOOXXXXXXXXXXGOOXXXXXXXXXXXXXXXXX,0,0,0
20139,88,0,88,55,457,0,0,163,69,94,GOOOOOOOOOXXXXXXXXXXGOOOOOOXXXXXXXXXXXXXGOOOOXXXXXXXXXXXXXXXGOOOOOXXXXXXXXXXXXXXGOOOOOXXXXXXXXXXXXXXGOOOOOOOOXXXXXXXXXXXGOOOOOOOXXXXXXXXXXXXGOOXXXXXXXXXXXXXXXXXGOOOOOOOXXXXXXXXXXXXGOOOXXXXXXXXXXXXXXXXGOOOOOOOOXXXXXXXXXXXGOOOOOOOOOXXXXXXXXXXGOOXXXXXXXXXXXXXXXXX,0,0,0

20160,89,1,88,52,459,0,0,163,65,98,GOOOOOOOOOAXXXXXXXXXGOOOOOOXXXXXXXXXXXXXGOOOOXXXXXXXXXXXXXXXGOOOOOXXXXXXXXXXXXXXGOOOOOXXXXXXXXXXXXXXGOOOOOOOOXXXXXXXXXXXGOOOOOOOXXXXXXXXXXXXGOOXXXXXXXXXXXXXXXXXGOOOOOOOXXXXXXXXXXXXGOOOXXXXXXXXXXXXXXXXGOOOOOOOOXXXXXXXXXXXGOOOOOOOOOXXXXXXXXXXGOOXXXXXXXXXXXXXXXXX,0,0,0
20181,90,2,88,51,459,0,0,163,64,99,GOOOOOOOOOAXXXXXXXXXGOOOOOOXXXXXXXXXXXXXGOOOOAXXXXXXXXXXXXXXGOOOOOXXXXXXXXXXXXXXGOOOOOXXXXXXXXXXXXXXGOOOOOOOOXXXXXXXXXXXGOOOOOOOXXXXXXXXXXXXGOOXXXXXXXXXXXXXXXXXGOOOOOOOXXXXXXXXXXXXGOOOXXXXXXXXXXXXXXXXGOOOOOOOOXXXXXXXXXXXGOOOOOOOOOXXXXXXXXXXGOOXXXXXXXXXXXXXXXXX,0,0,0
20202,90,2,88,57,453,0,0,158,62,96,GOOOOOOOOOAXXXXXXXXXGOOOOOOXXXXXXXXXXXXXGOOOOAXXXXXXXXXXXXXXGOOOOOXXXXXXXXXXXXXXGOOOOOXXXXXXXXXXXXXXGOOOOOOOOXXXXXXXXXXXGOOOOOOOXXXXXXXXXXXXGOOXXXXXXXXXXXXXXXXXGOOOOOOOXXXXXXXXXXXXGOOOXXXXXXXXXXXXXXXXGOOOOOOOOXXXXXXXXXXXGOOOOOOOOOXXXXXXXXXXGOOXXXXXXXXXXXXXXXXX,0,0,0
20223,90,2,88,54,456,0,0,161,66,95,GOOOOOOOOOAXXXXXXXXXGOOOOOOXXXXXXXXXXXXXGOOOOAXXXXXXXXXXXXXXGOOOOOXXXXXXXXXXXXXXGOOOOOXXXXXXXXXXXXXXGOOOOOOOOXXXXXXXXXXXGOOOOOOOXXXXXXXXXXXXGOOXXXXXXXXXXXXXXXXXGOOOOOOOXXXXXXXXXXXXGOOOXXXXXXXXXXXXXXXXGOOOOOOOOXXXXXXXXXXXGOOOOOOOOOXXXXXXXXXXGOOXXXXXXXXXXXXXXXXX,0,0,0
20244,90,2,88,50,460,0,0,163,65,98,GOOOOOOOOOAXXXXXXXXXGOOOOOOXXXXXXXXXXXXXGOOOOAXXXXXXXXXXXXXXGOOOOOXXXXXXXXXXXXXXGOOOOOXXXXXXXXXXXXXXGOOOOOOOOXXXXXXXXXXXGOOOOOOOXXXXXXXXXXXXGOOXXXXXXXXXXXXXXXXXGOOOOOOOXXXXXXXXXXXXGOOOXXXXXXXXXXXXXXXXGOOOOOOOOXXXXXXXXXXXGOOOOOOOOOXXXXXXXXXXGOOXXXXXXXXXXXXXXXXX,0,0,0

20265,90,2,88,48,462,0,0,166,62,104,GOOOOOOOOOAXXXXXXXXXGOOOOOOXXXXXXXXXXXXXGOOOOAXXXXXXXXXXXXXXGOOOOOXXXXXXXXXXXXXXGOOOOOXXXXXXXXXXXXXXGOOOOOOOOXXXXXXXXXXXGOOOOOOOXXXXXXXXXXXXGOOXXXXXXXXXXXXXXXXXGOOOOOOOXXXXXXXXXXXXGOOOXXXXXXXXXXXXXXXXGOOOOOOOOXXXXXXXXXXXGOOOOOOOOOXXXXXXXXXXGOOXXXXXXXXXXXXXXXXX,0,0,0
20286,90,2,88,49,461,0,0,165,64,101,GOOOOOOOOOAXXXXXXXXXGOOOOOOXXXXXXXXXXXXXGOOOOAXXXXXXXXXXXXXXGOOOOOXXXXXXXXXXXXXXGOOOOOXXXXXXXXXXXXXXGOOOOOOOOXXXXXXXXXXXGOOOOOOOXXXXXXXXXXXXGOOXXXXXXXXXXXXXXXXXGOOOOOOOXXXXXXXXXXXXGOOOXXXXXXXXXXXXXXXXGOOOOOOOOXXXXXXXXXXXGOOOOOOOOOXXXXXXXXXXGOOXXXXXXXXXXXXXXXXX,0,0,0
20307,90,2,88,49,461,0,0,166,65,101,GOOOOOOOOOAXXXXXXXXXGOOOOOOXXXXXXXXXXXXXGOOOOAXXXXXXXXXXXXXXGOOOOOXXXXXXXXXXXXXXGOOOOOXXXXXXXXXXXXXXGOOOOOOOOXXXXXXXXXXXGOOOOOOOXXXXXXXXXXXXGOOXXXXXXXXXXXXXXXXXGOOOOOOOXXXXXXXXXXXXGOOOXXXXXXXXXXXXXXXXGOOOOOOOOXXXXXXXXXXXGOOOOOOOOOXXXXXXXXXXGOOXXXXXXXXXXXXXXXXX,0,0,0
20328,90,1,89,48,462,0,0,167,64,103,GOOOOOOOOOOXXXXXXXXXGOOOOOOXXXXXXXXXXXXXGOOOOAXXXXXXXXXXXXXXGOOOOOXXXXXXXXXXXXXXGOOOOOXXXXXXXXXXXXXXGOOOOOOOOXXXXXXXXXXXGOOOOOOOXXXXXXXXXXXXGOOXXXXXXXXXXXXXXXXXGOOOOOOOXXXXXXXXXXXXGOOOXXXXXXXXXXXXXXXXGOOOOOOOOXXXXXXXXXXXGOOOOOOOOOXXXXXXXXXXGOOXXXXXXXXXXXXXXXXX,0,0,0
20349,90,0,90,47,463,0,0,168,68,100,GOOOOOOOOOOXXXXXXXXXGOOOOOOXXXXXXXXXXXXXGOOOOOXXXXXXXXXXXXXXGOOOOOXXXXXXXXXXXXXXGOOOOOXXXXXXXXXXXXXXGOOOOOOOOXXXXXXXXXXXGOOOOOOOXXXXXXXXXXXXGOOXXXXXXXXXXXXXXXXXGOOOOOOOXXXXXXXXXXXXGOOOXXXXXXXXXXXXXXXXGOOOOOOOOXXXXXXXXXXXGOOOOOOOOOXXXXXXXXXXGOOXXXXXXXXXXXXXXXXX,0,0,0

20370,90,0,90,54,456,0,0,161,66,95,GOOOOOOOOOOXXXXXXXXXGOOOOOOXXXXXXXXXXXXXGOOOOOXXXXXXXXXXXXXXGOOOOOXXXXXXXXXXXXXXGOOOOOXXXXXXXXXXXXXXGOOOOOOOOXXXXXXXXXXXGOOOOOOOXXXXXXXXXXXXGOOXXXXXXXXXXXXXXXXXGOOOOOOOXXXXXXXXXXXXGOOOXXXXXXXXXXXXXXXXGOOOOOOOOXXXXXXXXXXXGOOOOOOOOOXXXXXXXXXXGOOXXXXXXXXXXXXXXXXX,0,0,0
20391,90,0,90,55,455,0,0,160,63,97,GOOOOOOOOOOXXXXXXXXXGOOOOOOXXXXXXXXXXXXXGOOOOOXXXXXXXXXXXXXXGOOOOOXXXXXXXXXXXXXXGOOOOOXXXXXXXXXXXXXXGOOOOOOOOXXXXXXXXXXXGOOOOOOOXXXXXXXXXXXXGOOXXXXXXXXXXXXXXXXXGOOOOOOOXXXXXXXXXXXXGOOOXXXXXXXXXXXXXXXXGOOOOOOOOXXXXXXXXXXXGOOOOOOOOOXXXXXXXXXXGOOXXXXXXXXXXXXXXXXX,0,0,0
20412,90,0,90,54,456,0,0,163,66,97,GOOOOOOOOOOXXXXXXXXXGOOOOOOXXXXXXXXXXXXXGOOOOOXXXXXXXXXXXXXXGOOOOOXXXXXXXXXXXXXXGOOOOOXXXXXXXXXXXXXXGOOOOOOOOXXXXXXXXXXXGOOOOOOOXXXXXXXXXXXXGOOXXXXXXXXXXXXXXXXXGOOOOOOOXXXXXXXXXXXXGOOOXXXXXXXXXXXXXXXXGOOOOOOOOXXXXXXXXXXXGOOOOOOOOOXXXXXXXXXXGOOXXXXXXXXXXXXXXXXX,0,0,0
20433,90,0,90,54,456,0,0,162,63,99,GOOOOOOOOOOXXXXXXXXXGOOOOOOXXXXXXXXXXXXXGOOOOOXXXXXXXXXXXXXXGOOOOOXXXXXXXXXXXXXXGOOOOOXXXXXXXXXXXXXXGOOOOOOOOXXXXXXXXXXXGOOOOOOOXXXXXXXXXXXXGOOXXXXXXXXXXXXXXXXXGOOOOOOOXXXXXXXXXXXXGOOOXXXXXXXXXXXXXXXXGOOOOOOOOXXXXXXXXXXXGOOOOOOOOOXXXXXXXXXXGOOXXXXXXXXXXXXXXXXX,0,0,0
20454,90,0,90,55,455,0,0,161,67,94,GOOOOOOOOOOXXXXXXXXXGOOOOOOXXXXXXXXXXXXXGOOOOOXXXXXXXXXXXXXXGOOOOOXXXXXXXXXXXXXXGOOOOOXXXXXXXXXXXXXXGOOOOOOOOXXXXXXXXXXXGOOOOOOOXXXXXXXXXXXXGOOXXXXXXXXXXXXXXXXXGOOOOOOOXXXXXXXXXXXXGOOOXXXXXXXXXXXXXXXXGOOOOOOOOXXXXXXXXXXXGOOOOOOOOOXXXXXXXXXXGOOXXXXXXXXXXXXXXXXX,0,0,0

20475,90,0,90,53,457,0,0,162,67,95,GOOOOOOOOOOXXXXXXXXXGOOOOOOXXXXXXXXXXXXXGOOOOOXXXXXXXXXXXXXXGOOOOOXXXXXXXXXXXXXXGOOOOOXXXXXXXXXXXXXXGOOOOOOOOXXXXXXXXXXXGOOOOOOOXXXXXXXXXXXXGOOXXXXXXXXXXXXXXXXXGOOOOOOOXXXXXXXXXXXXGOOOXXXXXXXXXXXXXXXXGOOOOOOOOXXXXXXXXXXXGOOOOOOOOOXXXXXXXXXXGOOXXXXXXXXXXXXXXXXX,0,0,0
20496,90,0,90,60,450,0,0,155,63,92,GOOOOOOOOOOXXXXXXXXXGOOOOOOXXXXXXXXXXXXXGOOOOOXXXXXXXXXXXXXXGOOOOOXXXXXXXXXXXXXXGOOOOOXXXXXXXXXXXXXXGOOOOOOOOXXXXXXXXXXXGOOOOOOOXXXXXXXXXXXXGOOXXXXXXXXXXXXXXXXXGOOOOOOOXXXXXXXXXXXXGOOOXXXXXXXXXXXXXXXXGOOOOOOOOXXXXXXXXXXXGOOOOOOOOOXXXXXXXXXXGOOXXXXXXXXXXXXXXXXX,0,0,0
20517,90,0,90,56,454,0,0,159,64,95,GOOOOOOOOOOXXXXXXXXXGOOOOOOXXXXXXXXXXXXXGOOOOOXXXXXXXXXXXXXXGOOOOOXXXXXXXXXXXXXXGOOOOOXXXXXXXXXXXXXXGOOOOOOOOXXXXXXXXXXXGOOOOOOOXXXXXXXXXXXXGOOXXXXXXXXXXXXXXXXXGOOOOOOOXXXXXXXXXXXXGOOOXXXXXXXXXXXXXXXXGOOOOOOOOXXXXXXXXXXXGOOOOOOOOOXXXXXXXXXXGOOXXXXXXXXXXXXXXXXX,0,0,0
20538,90,0,90,57,453,0,0,158,63,95,GOOOOOOOOOOXXXXXXXXXGOOOOOOXXXXXXXXXXXXXGOOOOOXXXXXXXXXXXXXXGOOOOOXXXXXXXXXXXXXXGOOOOOXXXXXXXXXXXXXXGOOOOOOOOXXXXXXXXXXXGOOOOOOOXXXXXXXXXXXXGOOXXXXXXXXXXXXXXXXXGOOOOOOOXXXXXXXXXXXXGOOOXXXXXXXXXXXXXXXXGOOOOOOOOXXXXXXXXXXXGOOOOOOOOOXXXXXXXXXXGOOXXXXXXXXXXXXXXXXX,0,0,0
20559,90,0,90,57,453,0,0,158,60,98,GOOOOOOOOOOXXXXXXXXXGOOOOOOXXXXXXXXXXXXXGOOOOOXXXXXXXXXXXXXXGOOOOOXXXXXXXXXXXXXXGOOOOOXXXXXXXXXXXXXXGOOOOOOOOXXXXXXXXXXXGOOOOOOOXXXXXXXXXXXXGOOXXXXXXXXXXXXXXXXXGOOOOOOOXXXXXXXXXXXXGOOOXXXXXXXXXXXXXXXXGOOOOOOOOXXXXXXXXXXXGOOOOOOOOOXXXXXXXXXXGOOXXXXXXXXXXXXXXXXX,0,0,0

20580,90,0,90,53,457,0,0,163,63,100,GOOOOOOOOOOXXXXXXXXXGOOOOOOXXXXXXXXXXXXXGOOOOOXXXXXXXXXXXXXXGOOOOOXXXXXXXXXXXXXXGOOOOOXXXXXXXXXXXXXXGOOOOOOOOXXXXXXXXXXXGOOOOOOOXXXXXXXXXXXXGOOXXXXXXXXXXXXXXXXXGOOOOOOOXXXXXXXXXXXXGOOOXXXXXXXXXXXXXXXXGOOOOOOOOXXXXXXXXXXXGOOOOOOOOOXXXXXXXXXXGOOXXXXXXXXXXXXXXXXX,0,0,0
20601,90,0,90,54,456,0,0,162,65,97,GOOOOOOOOOOXXXXXXXXXGOOOOOOXXXXXXXXXXXXXGOOOOOXXXXXXXXXXXXXXGOOOOOXXXXXXXXXXXXXXGOOOOOXXXXXXXXXXXXXXGOOOOOOOOXXXXXXXXXXXGOOOOOOOXXXXXXXXXXXXGOOXXXXXXXXXXXXXXXXXGOOOOOOOXXXXXXXXXXXXGOOOXXXXXXXXXXXXXXXXGOOOOOOOOXXXXXXXXXXXGOOOOOOOOOXXXXXXXXXXGOOXXXXXXXXXXXXXXXXX,0,0,0
20622,90,0,90,57,453,0,0,160,63,97,GOOOOOOOOOOXXXXXXXXXGOOOOOOXXXXXXXXXXXXXGOOOOOXXXXXXXXXXXXXXGOOOOOXXXXXXXXXXXXXXGOOOOOXXXXXXXXXXXXXXGOOOOOOOOXXXXXXXXXXXGOOOOOOOXXXXXXXXXXXXGOOXXXXXXXXXXXXXXXXXGOOOOOOOXXXXXXXXXXXXGOOOXXXXXXXXXXXXXXXXGOOOOOOOOXXXXXXXXXXXGOOOOOOOOOXXXXXXXXXXGOOXXXXXXXXXXXXXXXXX,0,0,0
20643,90,0,90,56,454,0,0,159,66,93,GOOOOOOOOOOXXXXXXXXXGOOOOOOXXXXXXXXXXXXXGOOOOOXXXXXXXXXXXXXXGOOOOOXXXXXXXXXXXXXXGOOOOOXXXXXXXXXXXXXXGOOOOOOOOXXXXXXXXXXXGOOOOOOOXXXXXXXXXXXXGOOXXXXXXXXXXXXXXXXXGOOOOOOOXXXXXXXXXXXXGOOOXXXXXXXXXXXXXXXXGOOOOOOOOXXXXXXXXXXXGOOOOOOOOOXXXXXXXXXXGOOXXXXXXXXXXXXXXXXX,0,0,0
20664,91,1,90,56,453,0,0,158,69,89,GOOOOOOOOOOAXXXXXXXXGOOOOOOXXXXXXXXXXXXXGOOOOOXXXXXXXXXXXXXXGOOOOOXXXXXXXXXXXXXXGOOOOOXXXXXXXXXXXXXXGOOOOOOOOXXXXXXXXXXXGOOOOOOOXXXXXXXXXXXXGOOXXXXXXXXXXXXXXXXXGOOOOOOOXXXXXXXXXXXXGOOOXXXXXXXXXXXXXXXXGOOOOOOOOXXXXXXXXXXXGOOOOOOOOOXXXXXXXXXXGOOXXXXXXXXXXXXXXXXX,0,0,0

20685,91,1,90,59,450,0,0,154,67,87,GOOOOOOOOOOAXXXXXXXXGOOOOOOXXXXXXXXXXXXXGOOOOOXXXXXXXXXXXXXXGOOOOOXXXXXXXXXXXXXXGOOOOOXXXXXXXXXXXXXXGOOOOOOOOXXXXXXXXXXXGOOOOOOOXXXXXXXXXXXXGOOXXXXXXXXXXXXXXXXXGOOOOOOOXXXXXXXXXXXXGOOOXXXXXXXXXXXXXXXXGOOOOOOOOXXXXXXXXXXXGOOOOOOOOOXXXXXXXXXXGOOXXXXXXXXXXXXXXXXX,0,0,0
20706,91,0,91,61,448,0,0,153,64,89,GOOOOOOOOOOOXXXXXXXXGOOOOOOXXXXXXXXXXXXXGOOOOOXXXXXXXXXXXXXXGOOOOOXXXXXXXXXXXXXXGOOOOOXXXXXXXXXXXXXXGOOOOOOOOXXXXXXXXXXXGOOOOOOOXXXXXXXXXXXXGOOXXXXXXXXXXXXXXXXXGOOOOOOOXXXXXXXXXXXXGOOOXXXXXXXXXXXXXXXXGOOOOOOOOXXXXXXXXXXXGOOOOOOOOOXXXXXXXXXXGOOXXXXXXXXXXXXXXXXX,0,0,0
20727,91,0,91,58,451,0,0,156,68,88,GOOOOOOOOOOOXXXXXXXXGOOOOOOXXXXXXXXXXXXXGOOOOOXXXXXXXXXXXXXXGOOOOOXXXXXXXXXXXXXXGOOOOOXXXXXXXXXXXXXXGOOOOOOOOXXXXXXXXXXXGOOOOOOOXXXXXXXXXXXXGOOXXXXXXXXXXXXXXXXXGOOOOOOOXXXXXXXXXXXXGOOOXXXXXXXXXXXXXXXXGOOOOOOOOXXXXXXXXXXXGOOOOOOOOOXXXXXXXXXXGOOXXXXXXXXXXXXXXXXX,0,0,0
20748,92,1,91,58,450,0,0,154,63,91,GOOOOOOOOOOOXXXXXXXXGOOOOOOXXXXXXXXXXXXXGOOOOOXXXXXXXXXXXXXXGOOOOOXXXXXXXXXXXXXXGOOOOOXXXXXXXXXXXXXXGOOOOOOOOXXXXXXXXXXXGOOOOOOOXXXXXXXXXXXXGOOXXXXXXXXXXXXXXXXXGOOOOOOOXXXXXXXXXXXXGOOOXXXXXXXXXXXXXXXXGOOOOOOOOXXXXXXXXXXXGOOOOOOOOOXXXXXXXXXXGOOAXXXXXXXXXXXXXXXX,0,0,0
20769,92,1,91,61,447,0,0,151,63,88,GOOOOOOOOOOOXXXXXXXXGOOOOOOXXXXXXXXXXXXXGOOOOOXXXXXXXXXXXXXXGOOOOOXXXXXXXXXXXXXXGOOOOOXXXXXXXXXXXXXXGOOOOOOOOXXXXXXXXXXXGOOOOOOOXXXXXXXXXXXXGOOXXXXXXXXXXXXXXXXXGOOOOOOOXXXXXXXXXXXXGOOOXXXXXXXXXXXXXXXXGOOOOOOOOXXXXXXXXXXXGOOOOOOOOOXXXXXXXXXXGOOAXXXXXXXXXXXXXXXX,0,0,0

20790,92,1,91,58,450,0,0,153,64,89,GOOOOOOOOOOOXXXXXXXXGOOOOOOXXXXXXXXXXXXXGOOOOOXXXXXXXXXXXXXXGOOOOOXXXXXXXXXXXXXXGOOOOOXXXXXXXXXXXXXXGOOOOOOOOXXXXXXXXXXXGOOOOOOOXXXXXXXXXXXXGOOXXXXXXXXXXXXXXXXXGOOOOOOOXXXXXXXXXXXXGOOOXXXXXXXXXXXXXXXXGOOOOOOOOXXXXXXXXXXXGOOOOOOOOOXXXXXXXXXXGOOAXXXXXXXXXXXXXXXX,0,0,0
20811,92,1,91,59,449,0,0,154,63,91,GOOOOOOOOOOOXXXXXXXXGOOOOOOXXXXXXXXXXXXXGOOOOOXXXXXXXXXXXXXXGOOOOOXXXXXXXXXXXXXXGOOOOOXXXXXXXXXXXXXXGOOOOOOOOXXXXXXXXXXXGOOOOOOOXXXXXXXXXXXXGOOXXXXXXXXXXXXXXXXXGOOOOOOOXXXXXXXXXXXXGOOOXXXXXXXXXXXXXXXXGOOOOOOOOXXXXXXXXXXXGOOOOOOOOOXXXXXXXXXXGOOAXXXXXXXXXXXXXXXX,0,0,0
20832,92,1,91,60,448,0,0,152,60,92,GOOOOOOOOOOOXXXXXXXXGOOOOOOXXXXXXXXXXXXXGOOOOOXXXXXXXXXXXXXXGOOOOOXXXXXXXXXXXXXXGOOOOOXXXXXXXXXXXXXXGOOOOOOOOXXXXXXXXXXXGOOOOOOOXXXXXXXXXXXXGOOXXXXXXXXXXXXXXXXXGOOOOOOOXXXXXXXXXXXXGOOOXXXXXXXXXXXXXXXXGOOOOOOOOXXXXXXXXXXXGOOOOOOOOOXXXXXXXXXXGOOAXXXXXXXXXXXXXXXX,0,0,0
20853,92,1,91,63,445,0,0,150,68,82,GOOOOOOOOOOOXXXXXXXXGOOOOOOXXXXXXXXXXXXXGOOOOOXXXXXXXXXXXXXXGOOOOOXXXXXXXXXXXXXXGOOOOOXXXXXXXXXXXXXXGOOOOOOOOXXXXXXXXXXXGOOOOOOOXXXXXXXXXXXXGOOXXXXXXXXXXXXXXXXXGOOOOOOOXXXXXXXXXXXXGOOOXXXXXXXXXXXXXXXXGOOOOOOOOXXXXXXXXXXXGOOOOOOOOOXXXXXXXXXXGOOAXXXXXXXXXXXXXXXX,0,0,0
20874,92,1,91,65,443,0,0,148,63,85,GOOOOOOOOOOOXXXXXXXXGOOOOOOXXXXXXXXXXXXXGOOOOOXXXXXXXXXXXXXXGOOOOOXXXXXXXXXXXXXXGOOOOOXXXXXXXXXXXXXXGOOOOOOOOXXXXXXXXXXXGOOOOOOOXXXXXXXXXXXXGOOXXXXXXXXXXXXXXXXXGOOOOOOOXXXXXXXXXXXXGOOOXXXXXXXXXXXXXXXXGOOOOOOOOXXXXXXXXXXXGOOOOOOOOOXXXXXXXXXXGOOAXXXXXXXXXXXXXXXX,0,0,0

20895,92,1,91,58,450,0,0,155,63,92,GOOOOOOOOOOOXXXXXXXXGOOOOOOXXXXXXXXXXXXXGOOOOOXXXXXXXXXXXXXXGOOOOOXXXXXXXXXXXXXXGOOOOOXXXXXXXXXXXXXXGOOOOOOOOXXXXXXXXXXXGOOOOOOOXXXXXXXXXXXXGOOXXXXXXXXXXXXXXXXXGOOOOOOOXXXXXXXXXXXXGOOOXXXXXXXXXXXXXXXXGOOOOOOOOXXXXXXXXXXXGOOOOOOOOOXXXXXXXXXXGOOAXXXXXXXXXXXXXXXX,0,0,0
20916,92,1,91,57,451,0,0,156,66,90,GOOOOOOOOOOOXXXXXXXXGOOOOOOXXXXXXXXXXXXXGOOOOOXXXXXXXXXXXXXXGOOOOOXXXXXXXXXXXXXXGOOOOOXXXXXXXXXXXXXXGOOOOOOOOXXXXXXXXXXXGOOOOOOOXXXXXXXXXXXXGOOXXXXXXXXXXXXXXXXXGOOOOOOOXXXXXXXXXXXXGOOOXXXXXXXXXXXXXXXXGOOOOOOOOXXXXXXXXXXXGOOOOOOOOOXXXXXXXXXXGOOAXXXXXXXXXXXXXXXX,0,0,0
20937,92,1,91,58,450,0,0,155,64,91,GOOOOOOOOOOOXXXXXXXXGOOOOOOXXXXXXXXXXXXXGOOOOOXXXXXXXXXXXXXXGOOOOOXXXXXXXXXXXXXXGOOOOOXXXXXXXXXXXXXXGOOOOOOOOXXXXXXXXXXXGOOOOOOOXXXXXXXXXXXXGOOXXXXXXXXXXXXXXXXXGOOOOOOOXXXXXXXXXXXXGOOOXXXXXXXXXXXXXXXXGOOOOOOOOXXXXXXXXXXXGOOOOOOOOOXXXXXXXXXXGOOAXXXXXXXXXXXXXXXX,0,0,0
20958,92,1,91,58,450,0,0,153,63,90,GOOOOOOOOOOOXXXXXXXXGOOOOOOXXXXXXXXXXXXXGOOOOOXXXXXXXXXXXXXXGOOOOOXXXXXXXXXXXXXXGOOOOOXXXXXXXXXXXXXXGOOOOOOOOXXXXXXXXXXXGOOOOOOOXXXXXXXXXXXXGOOXXXXXXXXXXXXXXXXXGOOOOOOOXXXXXXXXXXXXGOOOXXXXXXXXXXXXXXXXGOOOOOOOOXXXXXXXXXXXGOOOOOOOOOXXXXXXXXXXGOOAXXXXXXXXXXXXXXXX,0,0,0
20979,92,1,91,51,457,0,0,163,62,101,GOOOOOOOOOOOXXXXXXXXGOOOOOOXXXXXXXXXXXXXGOOOOOXXXXXXXXXXXXXXGOOOOOXXXXXXXXXXXXXXGOOOOOXXXXXXXXXXXXXXGOOOOOOOOXXXXXXXXXXXGOOOOOOOXXXXXXXXXXXXGOOXXXXXXXXXXXXXXXXXGOOOOOOOXXXXXXXXXXXXGOOOXXXXXXXXXXXXXXXXGOOOOOOOOXXXXXXXXXXXGOOOOOOOOOXXXXXXXXXXGOOAXXXXXXXXXXXXXXXX,0,0,0

21000,92,1,91,52,456,0,0,162,70,92,GOOOOOOOOOOOXXXXXXXXGOOOOOOXXXXXXXXXXXXXGOOOOOXXXXXXXXXXXXXXGOOOOOXXXXXXXXXXXXXXGOOOOOXXXXXXXXXXXXXXGOOOOOOOOXXXXXXXXXXXGOOOOOOOXXXXXXXXXXXXGOOXXXXXXXXXXXXXXXXXGOOOOOOOXXXXXXXXXXXXGOOOXXXXXXXXXXXXXXXXGOOOOOOOOXXXXXXXXXXXGOOOOOOOOOXXXXXXXXXXGOOAXXXXXXXXXXXXXXXX,0,0,0
21021,92,0,92,55,453,0,0,160,67,93,GOOOOOOOOOOOXXXXXXXXGOOOOOOXXXXXXXXXXXXXGOOOOOXXXXXXXXXXXXXXGOOOOOXXXXXXXXXXXXXXGOOOOOXXXXXXXXXXXXXXGOOOOOOOOXXXXXXXXXXXGOOOOOOOXXXXXXXXXXXXGOOXXXXXXXXXXXXXXXXXGOOOOOOOXXXXXXXXXXXXGOOOXXXXXXXXXXXXXXXXGOOOOOOOOXXXXXXXXXXXGOOOOOOOOOXXXXXXXXXXGOOOXXXXXXXXXXXXXXXX,0,0,0
21042,92,0,92,54,454,0,0,160,64,96,GOOOOOOOOOOOXXXXXXXXGOOOOOOXXXXXXXXXXXXXGOOOOOXXXXXXXXXXXXXXGOOOOOXXXXXXXXXXXXXXGOOOOOXXXXXXXXXXXXXXGOOOOOOOOXXXXXXXXXXXGOOOOOOOXXXXXXXXXXXXGOOXXXXXXXXXXXXXXXXXGOOOOOOOXXXXXXXXXXXXGOOOXXXXXXXXXXXXXXXXGOOOOOOOOXXXXXXXXXXXGOOOOOOOOOXXXXXXXXXXGOOOXXXXXXXXXXXXXXXX,0,0,0
21063,92,0,92,55,453,0,0,159,62,97,GOOOOOOOOOOOXXXXXXXXGOOOOOOXXXXXXXXXXXXXGOOOOOXXXXXXXXXXXXXXGOOOOOXXXXXXXXXXXXXXGOOOOOXXXXXXXXXXXXXXGOOOOOOOOXXXXXXXXXXXGOOOOOOOXXXXXXXXXXXXGOOXXXXXXXXXXXXXXXXXGOOOOOOOXXXXXXXXXXXXGOOOXXXXXXXXXXXXXXXXGOOOOOOOOXXXXXXXXXXXGOOOOOOOOOXXXXXXXXXXGOOOXXXXXXXXXXXXXXXX,0,0,0
21084,92,0,92,55,453,0,0,159,62,97,GOOOOOOOOOOOXXXXXXXXGOOOOOOXXXXXXXXXXXXXGOOOOOXXXXXXXXXXXXXXGOOOOOXXXXXXXXXXXXXXGOOOOOXXXXXXXXXXXXXXGOOOOOOOOXXXXXXXXXXXGOOOOOOOXXXXXXXXXXXXGOOXXXXXXXXXXXXXXXXXGOOOOOOOXXXXXXXXXXXXGOOOXXXXXXXXXXXXXXXXGOOOOOOOOXXXXXXXXXXXGOOOOOOOOOXXXXXXXXXXGOOOXXXXXXXXXXXXXXXX,0,0,0

21105,92,0,92,50,458,0,0,163,64,99,GOOOOOOOOOOOXXXXXXXXGOOOOOOXXXXXXXXXXXXXGOOOOOXXXXXXXXXXXXXXGOOOOOXXXXXXXXXXXXXXGOOOOOXXXXXXXXXXXXXXGOOOOOOOOXXXXXXXXXXXGOOOOOOOXXXXXXXXXXXXGOOXXXXXXXXXXXXXXXXXGOOOOOOOXXXXXXXXXXXXGOOOXXXXXXXXXXXXXXXXGOOOOOOOOXXXXXXXXXXXGOOOOOOOOOXXXXXXXXXXGOOOXXXXXXXXXXXXXXXX,0,0,0
21126,92,0,92,53,455,0,0,160,64,96,GOOOOOOOOOOOXXXXXXXXGOOOOOOXXXXXXXXXXXXXGOOOOOXXXXXXXXXXXXXXGOOOOOXXXXXXXXXXXXXXGOOOOOXXXXXXXXXXXXXXGOOOOOOOOXXXXXXXXXXXGOOOOOOOXXXXXXXXXXXXGOOXXXXXXXXXXXXXXXXXGOOOOOOOXXXXXXXXXXXXGOOOXXXXXXXXXXXXXXXXGOOOOOOOOXXXXXXXXXXXGOOOOOOOOOXXXXXXXXXXGOOOXXXXXXXXXXXXXXXX,0,0,0
21147,92,0,92,51,457,0,0,162,63,99,GOOOOOOOOOOOXXXXXXXXGOOOOOOXXXXXXXXXXXXXGOOOOOXXXXXXXXXXXXXXGOOOOOXXXXXXXXXXXXXXGOOOOOXXXXXXXXXXXXXXGOOOOOOOOXXXXXXXXXXXGOOOOOOOXXXXXXXXXXXXGOOXXXXXXXXXXXXXXXXXGOOOOOOOXXXXXXXXXXXXGOOOXXXXXXXXXXXXXXXXGOOOOOOOOXXXXXXXXXXXGOOOOOOOOOXXXXXXXXXXGOOOXXXXXXXXXXXXXXXX,0,0,0
21168,92,0,92,55,453,0,0,159,65,94,GOOOOOOOOOOOXXXXXXXXGOOOOOOXXXXXXXXXXXXXGOOOOOXXXXXXXXXXXXXXGOOOOOXXXXXXXXXXXXXXGOOOOOXXXXXXXXXXXXXXGOOOOOOOOXXXXXXXXXXXGOOOOOOOXXXXXXXXXXXXGOOXXXXXXXXXXXXXXXXXGOOOOOOOXXXXXXXXXXXXGOOOXXXXXXXXXXXXXXXXGOOOOOOOOXXXXXXXXXXXGOOOOOOOOOXXXXXXXXXXGOOOXXXXXXXXXXXXXXXX,0,0,0
21189,92,0,92,52,456,0,0,162,66,96,GOOOOOOOOOOOXXXXXXXXGOOOOOOXXXXXXXXXXXXXGOOOOOXXXXXXXXXXXXXXGOOOOOXXXXXXXXXXXXXXGOOOOOXXXXXXXXXXXXXXGOOOOOOOOXXXXXXXXXXXGOOOOOOOXXXXXXXXXXXXGOOXXXXXXXXXXXXXXXXXGOOOOOOOXXXXXXXXXXXXGOOOXXXXXXXXXXXXXXXXGOOOOOOOOXXXXXXXXXXXGOOOOOOOOOXXXXXXXXXXGOOOXXXXXXXXXXXXXXXX,0,0,0

21210,92,0,92,49,459,0,0,163,66,97,GOOOOOOOOOOOXXXXXXXXGOOOOOOXXXXXXXXXXXXXGOOOOOXXXXXXXXXXXXXXGOOOOOXXXXXXXXXXXXXXGOOOOOXXXXXXXXXXXXXXGOOOOOOOOXXXXXXXXXXXGOOOOOOOXXXXXXXXXXXXGOOXXXXXXXXXXXXXXXXXGOOOOOOOXXXXXXXXXXXXGOOOXXXXXXXXXXXXXXXXGOOOOOOOOXXXXXXXXXXXGOOOOOOOOOXXXXXXXXXXGOOOXXXXXXXXXXXXXXXX,0,0,0
21231,92,0,92,51,457,0,0,163,64,99,GOOOOOOOOOOOXXXXXXXXGOOOOOOXXXXXXXXXXXXXGOOOOOXXXXXXXXXXXXXXGOOOOOXXXXXXXXXXXXXXGOOOOOXXXXXXXXXXXXXXGOOOOOOOOXXXXXXXXXXXGOOOOOOOXXXXXXXXXXXXGOOXXXXXXXXXXXXXXXXXGOOOOOOOXXXXXXXXXXXXGOOOXXXXXXXXXXXXXXXXGOOOOOOOOXXXXXXXXXXXGOOOOOOOOOXXXXXXXXXXGOOOXXXXXXXXXXXXXXXX,0,0,0
21252,92,0,92,53,455,0,0,160,64,96,GOOOOOOOOOOOXXXXXXXXGOOOOOOXXXXXXXXXXXXXGOOOOOXXXXXXXXXXXXXXGOOOOOXXXXXXXXXXXXXXGOOOOOXXXXXXXXXXXXXXGOOOOOOOOXXXXXXXXXXXGOOOOOOOXXXXXXXXXXXXGOOXXXXXXXXXXXXXXXXXGOOOOOOOXXXXXXXXXXXXGOOOXXXXXXXXXXXXXXXXGOOOOOOOOXXXXXXXXXXXGOOOOOOOOOXXXXXXXXXXGOOOXXXXXXXXXXXXXXXX,0,0,0
21273,92,0,92,51,457,0,0,163,65,98,GOOOOOOOOOOOXXXXXXXXGOOOOOOXXXXXXXXXXXXXGOOOOOXXXXXXXXXXXXXXGOOOOOXXXXXXXXXXXXXXGOOOOOXXXXXXXXXXXXXXGOOOOOOOOXXXXXXXXXXXGOOOOOOOXXXXXXXXXXXXGOOXXXXXXXXXXXXXXXXXGOOOOOOOXXXXXXXXXXXXGOOOXXXXXXXXXXXXXXXXGOOOOOOOOXXXXXXXXXXXGOOOOOOOOOXXXXXXXXXXGOOOXXXXXXXXXXXXXXXX,0,0,0
21294,92,0,92,54,454,0,0,159,66,93,GOOOOOOOOOOOXXXXXXXXGOOOOOOXXXXXXXXXXXXXGOOOOOXXXXXXXXXXXXXXGOOOOOXXXXXXXXXXXXXXGOOOOOXXXXXXXXXXXXXXGOOOOOOOOXXXXXXXXXXXGOOOOOOOXXXXXXXXXXXXGOOXXXXXXXXXXXXXXXXXGOOOOOOOXXXXXXXXXXXXGOOOXXXXXXXXXXXXXXXXGOOOOOOOOXXXXXXXXXXXGOOOOOOOOOXXXXXXXXXXGOOOXXXXXXXXXXXXXXXX,0,0,0

21315,92,0,92,53,455,0,0,160,66,94,GOOOOOOOOOOOXXXXXXXXGOOOOOOXXXXXXXXXXXXXGOOOOOXXXXXXXXXXXXXXGOOOOOXXXXXXXXXXXXXXGOOOOOXXXXXXXXXXXXXXGOOOOOOOOXXXXXXXXXXXGOOOOOOOXXXXXXXXXXXXGOOXXXXXXXXXXXXXXXXXGOOOOOOOXXXXXXXXXXXXGOOOXXXXXXXXXXXXXXXXGOOOOOOOOXXXXXXXXXXXGOOOOOOOOOXXXXXXXXXXGOOOXXXXXXXXXXXXXXXX,0,0,0
21336,92,0,92,52,456,0,0,161,65,96,GOOOOOOOOOOOXXXXXXXXGOOOOOOXXXXXXXXXXXXXGOOOOOXXXXXXXXXXXXXXGOOOOOXXXXXXXXXXXXXXGOOOOOXXXXXXXXXXXXXXGOOOOOOOOXXXXXXXXXXXGOOOOOOOXXXXXXXXXXXXGOOXXXXXXXXXXXXXXXXXGOOOOOOOXXXXXXXXXXXXGOOOXXXXXXXXXXXXXXXXGOOOOOOOOXXXXXXXXXXXGOOOOOOOOOXXXXXXXXXXGOOOXXXXXXXXXXXXXXXX,0,0,0
21357,92,0,92,49,459,0,0,162,69,93,GOOOOOOOOOOOXXXXXXXXGOOOOOOXXXXXXXXXXXXXGOOOOOXXXXXXXXXXXXXXGOOOOOXXXXXXXXXXXXXXGOOOOOXXXXXXXXXXXXXXGOOOOOOOOXXXXXXXXXXXGOOOOOOOXXXXXXXXXXXXGOOXXXXXXXXXXXXXXXXXGOOOOOOOXXXXXXXXXXXXGOOOXXXXXXXXXXXXXXXXGOOOOOOOOXXXXXXXXXXXGOOOOOOOOOXXXXXXXXXXGOOOXXXXXXXXXXXXXXXX,0,0,0
21378,92,0,92,55,453,0,0,156,67,89,GOOOOOOOOOOOXXXXXXXXGOOOOOOXXXXXXXXXXXXXGOOOOOXXXXXXXXXXXXXXGOOOOOXXXXXXXXXXXXXXGOOOOOXXXXXXXXXXXXXXGOOOOOOOOXXXXXXXXXXXGOOOOOOOXXXXXXXXXXXXGOOXXXXXXXXXXXXXXXXXGOOOOOOOXXXXXXXXXXXXGOOOXXXXXXXXXXXXXXXXGOOOOOOOOXXXXXXXXXXXGOOOOOOOOOXXXXXXXXXXGOOOXXXXXXXXXXXXXXXX,0,0,0
21399,92,0,92,52,456,0,0,160,65,95,GOOOOOOOOOOOXXXXXXXXGOOOOOOXXXXXXXXXXXXXGOOOOOXXXXXXXXXXXXXXGOOOOOXXXXXXXXXXXXXXGOOOOOXXXXXXXXXXXXXXGOOOOOOOOXXXXXXXXXXXGOOOOOOOXXXXXXXXXXXXGOOXXXXXXXXXXXXXXXXXGOOOOOOOXXXXXXXXXXXXGOOOXXXXXXXXXXXXXXXXGOOOOOOOOXXXXXXXXXXXGOOOOOOOOOXXXXXXXXXXGOOOXXXXXXXXXXXXXXXX,0,0,0

21420,92,0,92,52,456,0,0,160,66,94,GOOOOOOOOOOOXXXXXXXXGOOOOOOXXXXXXXXXXXXXGOOOOOXXXXXXXXXXXXXXGOOOOOXXXXXXXXXXXXXXGOOOOOXXXXXXXXXXXXXXGOOOOOOOOXXXXXXXXXXXGOOOOOOOXXXXXXXXXXXXGOOXXXXXXXXXXXXXXXXXGOOOOOOOXXXXXXXXXXXXGOOOXXXXXXXXXXXXXXXXGOOOOOOOOXXXXXXXXXXXGOOOOOOOOOXXXXXXXXXXGOOOXXXXXXXXXXXXXXXX,0,0,0
21441,92,0,92,53,455,0,0,159,66,93,GOOOOOOOOOOOXXXXXXXXGOOOOOOXXXXXXXXXXXXXGOOOOOXXXXXXXXXXXXXXGOOOOOXXXXXXXXXXXXXXGOOOOOXXXXXXXXXXXXXXGOOOOOOOOXXXXXXXXXXXGOOOOOOOXXXXXXXXXXXXGOOXXXXXXXXXXXXXXXXXGOOOOOOOXXXXXXXXXXXXGOOOXXXXXXXXXXXXXXXXGOOOOOOOOXXXXXXXXXXXGOOOOOOOOOXXXXXXXXXXGOOOXXXXXXXXXXXXXXXX,0,0,0
21462,92,0,92,58,450,0,0,154,69,85,GOOOOOOOOOOOXXXXXXXXGOOOOOOXXXXXXXXXXXXXGOOOOOXXXXXXXXXXXXXXGOOOOOXXXXXXXXXXXXXXGOOOOOXXXXXXXXXXXXXXGOOOOOOOOXXXXXXXXXXXGOOOOOOOXXXXXXXXXXXXGOOXXXXXXXXXXXXXXXXXGOOOOOOOXXXXXXXXXXXXGOOOXXXXXXXXXXXXXXXXGOOOOOOOOXXXXXXXXXXXGOOOOOOOOOXXXXXXXXXXGOOOXXXXXXXXXXXXXXXX,0,0,0
21483,92,0,92,56,452,0,0,156,64,92,GOOOOOOOOOOOXXXXXXXXGOOOOOOXXXXXXXXXXXXXGOOOOOXXXXXXXXXXXXXXGOOOOOXXXXXXXXXXXXXXGOOOOOXXXXXXXXXXXXXXGOOOOOOOOXXXXXXXXXXXGOOOOOOOXXXXXXXXXXXXGOOXXXXXXXXXXXXXXXXXGOOOOOOOXXXXXXXXXXXXGOOOXXXXXXXXXXXXXXXXGOOOOOOOOXXXXXXXXXXXGOOOOOOOOOXXXXXXXXXXGOOOXXXXXXXXXXXXXXXX,0,0,0
21504,92,0,92,57,451,0,0,155,67,88,GOOOOOOOOOOOXXXXXXXXGOOOOOOXXXXXXXXXXXXXGOOOOOXXXXXXXXXXXXXXGOOOOOXXXXXXXXXXXXXXGOOOOOXXXXXXXXXXXXXXGOOOOOOOOXXXXXXXXXXXGOOOOOOOXXXXXXXXXXXXGOOXXXXXXXXXXXXXXXXXGOOOOOOOXXXXXXXXXXXXGOOOXXXXXXXXXXXXXXXXGOOOOOOOOXXXXXXXXXXXGOOOOOOOOOXXXXXXXXXXGOOOXXXXXXXXXXXXXXXX,0,0,0

21525,92,0,92,59,449,0,0,154,69,85,GOOOOOOOOOOOXXXXXXXXGOOOOOOXXXXXXXXXXXXXGOOOOOXXXXXXXXXXXXXXGOOOOOXXXXXXXXXXXXXXGOOOOOXXXXXXXXXXXXXXGOOOOOOOOXXXXXXXXXXXGOOOOOOOXXXXXXXXXXXXGOOXXXXXXXXXXXXXXXXXGOOOOOOOXXXXXXXXXXXXGOOOXXXXXXXXXXXXXXXXGOOOOOOOOXXXXXXXXXXXGOOOOOOOOOXXXXXXXXXXGOOOXXXXXXXXXXXXXXXX,0,0,0
21546,92,0,92,62,446,0,0,152,64,88,GOOOOOOOOOOOXXXXXXXXGOOOOOOXXXXXXXXXXXXXGOOOOOXXXXXXXXXXXXXXGOOOOOXXXXXXXXXXXXXXGOOOOOXXXXXXXXXXXXXXGOOOOOOOOXXXXXXXXXXXGOOOOOOOXXXXXXXXXXXXGOOXXXXXXXXXXXXXXXXXGOOOOOOOXXXXXXXXXXXXGOOOXXXXXXXXXXXXXXXXGOOOOOOOOXXXXXXXXXXXGOOOOOOOOOXXXXXXXXXXGOOOXXXXXXXXXXXXXXXX,0,0,0
21567,93,1,92,52,455,0,0,160,64,96,GOOOOOOOOOOOXXXXXXXXGOOOOOOXXXXXXXXXXXXXGOOOOOXXXXXXXXXXXXXXGOOOOOXXXXXXXXXXXXXXGOOOOOXXXXXXXXXXXXXXGOOOOOOOOXXXXXXXXXXXGOOOOOOOXXXXXXXXXXXXGOOXXXXXXXXXXXXXXXXXGOOOOOOOXXXXXXXXXXXXGOOOXXXXXXXXXXXXXXXXGOOOOOOOOXXXXXXXXXXXGOOOOOOOOOAXXXXXXXXXGOOOXXXXXXXXXXXXXXXX,0,0,0
21588,93,1,92,51,456,0,0,161,63,98,GOOOOOOOOOOOXXXXXXXXGOOOOOOXXXXXXXXXXXXXGOOOOOXXXXXXXXXXXXXXGOOOOOXXXXXXXXXXXXXXGOOOOOXXXXXXXXXXXXXXGOOOOOOOOXXXXXXXXXXXGOOOOOOOXXXXXXXXXXXXGOOXXXXXXXXXXXXXXXXXGOOOOOOOXXXXXXXXXXXXGOOOXXXXXXXXXXXXXXXXGOOOOOOOOXXXXXXXXXXXGOOOOOOOOOAXXXXXXXXXGOOOXXXXXXXXXXXXXXXX,0,0,0
21609,93,0,93,52,455,0,0,159,62,97,GOOOOOOOOOOOXXXXXXXXGOOOOOOXXXXXXXXXXXXXGOOOOOXXXXXXXXXXXXXXGOOOOOXXXXXXXXXXXXXXGOOOOOXXXXXXXXXXXXXXGOOOOOOOOXXXXXXXXXXXGOOOOOOOXXXXXXXXXXXXGOOXXXXXXXXXXXXXXXXXGOOOOOOOXXXXXXXXXXXXGOOOXXXXXXXXXXXXXXXXGOOOOOOOOXXXXXXXXXXXGOOOOOOOOOOXXXXXXXXXGOOOXXXXXXXXXXXXXXXX,0,0,0

21630,93,0,93,49,458,0,0,161,68,93,GOOOOOOOOOOOXXXXXXXXGOOOOOOXXXXXXXXXXXXXGOOOOOXXXXXXXXXXXXXXGOOOOOXXXXXXXXXXXXXXGOOOOOXXXXXXXXXXXXXXGOOOOOOOOXXXXXXXXXXXGOOOOOOOXXXXXXXXXXXXGOOXXXXXXXXXXXXXXXXXGOOOOOOOXXXXXXXXXXXXGOOOXXXXXXXXXXXXXXXXGOOOOOOOOXXXXXXXXXXXGOOOOOOOOOOXXXXXXXXXGOOOXXXXXXXXXXXXXXXX,0,0,0
21651,93,0,93,57,450,0,0,155,66,89,GOOOOOOOOOOOXXXXXXXXGOOOOOOXXXXXXXXXXXXXGOOOOOXXXXXXXXXXXXXXGOOOOOXXXXXXXXXXXXXXGOOOOOXXXXXXXXXXXXXXGOOOOOOOOXXXXXXXXXXXGOOOOOOOXXXXXXXXXXXXGOOXXXXXXXXXXXXXXXXXGOOOOOOOXXXXXXXXXXXXGOOOXXXXXXXXXXXXXXXXGOOOOOOOOXXXXXXXXXXXGOOOOOOOOOOXXXXXXXXXGOOOXXXXXXXXXXXXXXXX,0,0,0
21672,93,0,93,55,452,0,0,157,63,94,GOOOOOOOOOOOXXXXXXXXGOOOOOOXXXXXXXXXXXXXGOOOOOXXXXXXXXXXXXXXGOOOOOXXXXXXXXXXXXXXGOOOOOXXXXXXXXXXXXXXGOOOOOOOOXXXXXXXXXXXGOOOOOOOXXXXXXXXXXXXGOOXXXXXXXXXXXXXXXXXGOOOOOOOXXXXXXXXXXXXGOOOXXXXXXXXXXXXXXXXGOOOOOOOOXXXXXXXXXXXGOOOOOOOOOOXXXXXXXXXGOOOXXXXXXXXXXXXXXXX,0,0,0
21693,93,0,93,54,453,0,0,158,63,95,GOOOOOOOOOOOXXXXXXXXGOOOOOOXXXXXXXXXXXXXGOOOOOXXXXXXXXXXXXXXGOOOOOXXXXXXXXXXXXXXGOOOOOXXXXXXXXXXXXXXGOOOOOOOOXXXXXXXXXXXGOOOOOOOXXXXXXXXXXXXGOOXXXXXXXXXXXXXXXXXGOOOOOOOXXXXXXXXXXXXGOOOXXXXXXXXXXXXXXXXGOOOOOOOOXXXXXXXXXXXGOOOOOOOOOOXXXXXXXXXGOOOXXXXXXXXXXXXXXXX,0,0,0
21714,93,0,93,54,453,0,0,159,62,97,GOOOOOOOOOOOXXXXXXXXGOOOOOOXXXXXXXXXXXXXGOOOOOXXXXXXXXXXXXXXGOOOOOXXXXXXXXXXXXXXGOOOOOXXXXXXXXXXXXXXGOOOOOOOOXXXXXXXXXXXGOOOOOOOXXXXXXXXXXXXGOOXXXXXXXXXXXXXXXXXGOOOOOOOXXXXXXXXXXXXGOOOXXXXXXXXXXXXXXXXGOOOOOOOOXXXXXXXXXXXGOOOOOOOOOOXXXXXXXXXGOOOXXXXXXXXXXXXXXXX,0,0,0

21735,93,0,93,51,456,0,0,163,63,100,GOOOOOOOOOOOXXXXXXXXGOOOOOOXXXXXXXXXXXXXGOOOOOXXXXXXXXXXXXXXGOOOOOXXXXXXXXXXXXXXGOOOOOXXXXXXXXXXXXXXGOOOOOOOOXXXXXXXXXXXGOOOOOOOXXXXXXXXXXXXGOOXXXXXXXXXXXXXXXXXGOOOOOOOXXXXXXXXXXXXGOOOXXXXXXXXXXXXXXXXGOOOOOOOOXXXXXXXXXXXGOOOOOOOOOOXXXXXXXXXGOOOXXXXXXXXXXXXXXXX,0,0,0
21756,93,0,93,48,459,0,0,165,64,101,GOOOOOOOOOOOXXXXXXXXGOOOOOOXXXXXXXXXXXXXGOOOOOXXXXXXXXXXXXXXGOOOOOXXXXXXXXXXXXXXGOOOOOXXXXXXXXXXXXXXGOOOOOOOOXXXXXXXXXXXGOOOOOOOXXXXXXXXXXXXGOOXXXXXXXXXXXXXXXXXGOOOOOOOXXXXXXXXXXXXGOOOXXXXXXXXXXXXXXXXGOOOOOOOOXXXXXXXXXXXGOOOOOOOOOOXXXXXXXXXGOOOXXXXXXXXXXXXXXXX,0,0,0
21777,93,0,93,51,456,0,0,164,64,100,GOOOOOOOOOOOXXXXXXXXGOOOOOOXXXXXXXXXXXXXGOOOOOXXXXXXXXXXXXXXGOOOOOXXXXXXXXXXXXXXGOOOOOXXXXXXXXXXXXXXGOOOOOOOOXXXXXXXXXXXGOOOOOOOXXXXXXXXXXXXGOOXXXXXXXXXXXXXXXXXGOOOOOOOXXXXXXXXXXXXGOOOXXXXXXXXXXXXXXXXGOOOOOOOOXXXXXXXXXXXGOOOOOOOOOOXXXXXXXXXGOOOXXXXXXXXXXXXXXXX,0,0,0
21798,93,0,93,53,454,0,0,163,65,98,GOOOOOOOOOOOXXXXXXXXGOOOOOOXXXXXXXXXXXXXGOOOOOXXXXXXXXXXXXXXGOOOOOXXXXXXXXXXXXXXGOOOOOXXXXXXXXXXXXXXGOOOOOOOOXXXXXXXXXXXGOOOOOOOXXXXXXXXXXXXGOOXXXXXXXXXXXXXXXXXGOOOOOOOXXXXXXXXXXXXGOOOXXXXXXXXXXXXXXXXGOOOOOOOOXXXXXXXXXXXGOOOOOOOOOOXXXXXXXXXGOOOXXXXXXXXXXXXXXXX,0,0,0
21819,93,0,93,56,451,0,0,160,66,94,GOOOOOOOOOOOXXXXXXXXGOOOOOOXXXXXXXXXXXXXGOOOOOXXXXXXXXXXXXXXGOOOOOXXXXXXXXXXXXXXGOOOOOXXXXXXXXXXXXXXGOOOOOOOOXXXXXXXXXXXGOOOOOOOXXXXXXXXXXXXGOOXXXXXXXXXXXXXXXXXGOOOOOOOXXXXXXXXXXXXGOOOXXXXXXXXXXXXXXXXGOOOOOOOOXXXXXXXXXXXGOOOOOOOOOOXXXXXXXXXGOOOXXXXXXXXXXXXXXXX,0,0,0

21840,93,0,93,50,457,0,0,163,65,98,GOOOOOOOOOOOXXXXXXXXGOOOOOOXXXXXXXXXXXXXGOOOOOXXXXXXXXXXXXXXGOOOOOXXXXXXXXXXXXXXGOOOOOXXXXXXXXXXXXXXGOOOOOOOOXXXXXXXXXXXGOOOOOOOXXXXXXXXXXXXGOOXXXXXXXXXXXXXXXXXGOOOOOOOXXXXXXXXXXXXGOOOXXXXXXXXXXXXXXXXGOOOOOOOOXXXXXXXXXXXGOOOOOOOOOOXXXXXXXXXGOOOXXXXXXXXXXXXXXXX,0,0,0
21861,93,0,93,47,460,0,0,166,64,102,GOOOOOOOOOOOXXXXXXXXGOOOOOOXXXXXXXXXXXXXGOOOOOXXXXXXXXXXXXXXGOOOOOXXXXXXXXXXXXXXGOOOOOXXXXXXXXXXXXXXGOOOOOOOOXXXXXXXXXXXGOOOOOOOXXXXXXXXXXXXGOOXXXXXXXXXXXXXXXXXGOOOOOOOXXXXXXXXXXXXGOOOXXXXXXXXXXXXXXXXGOOOOOOOOXXXXXXXXXXXGOOOOOOOOOOXXXXXXXXXGOOOXXXXXXXXXXXXXXXX,0,0,0
21882,93,0,93,42,465,0,0,169,68,101,GOOOOOOOOOOOXXXXXXXXGOOOOOOXXXXXXXXXXXXXGOOOOOXXXXXXXXXXXXXXGOOOOOXXXXXXXXXXXXXXGOOOOOXXXXXXXXXXXXXXGOOOOOOOOXXXXXXXXXXXGOOOOOOOXXXXXXXXXXXXGOOXXXXXXXXXXXXXXXXXGOOOOOOOXXXXXXXXXXXXGOOOXXXXXXXXXXXXXXXXGOOOOOOOOXXXXXXXXXXXGOOOOOOOOOOXXXXXXXXXGOOOXXXXXXXXXXXXXXXX,0,0,0
21903,93,0,93,44,463,0,0,168,68,100,GOOOOOOOOOOOXXXXXXXXGOOOOOOXXXXXXXXXXXXXGOOOOOXXXXXXXXXXXXXXGOOOOOXXXXXXXXXXXXXXGOOOOOXXXXXXXXXXXXXXGOOOOOOOOXXXXXXXXXXXGOOOOOOOXXXXXXXXXXXXGOOXXXXXXXXXXXXXXXXXGOOOOOOOXXXXXXXXXXXXGOOOXXXXXXXXXXXXXXXXGOOOOOOOOXXXXXXXXXXXGOOOOOOOOOOXXXXXXXXXGOOOXXXXXXXXXXXXXXXX,0,0,0
21924,93,0,93,49,458,0,0,163,65,98,GOOOOOOOOOOOXXXXXXXXGOOOOOOXXXXXXXXXXXXXGOOOOOXXXXXXXXXXXXXXGOOOOOXXXXXXXXXXXXXXGOOOOOXXXXXXXXXXXXXXGOOOOOOOOXXXXXXXXXXXGOOOOOOOXXXXXXXXXXXXGOOXXXXXXXXXXXXXXXXXGOOOOOOOXXXXXXXXXXXXGOOOXXXXXXXXXXXXXXXXGOOOOOOOOXXXXXXXXXXXGOOOOOOOOOOXXXXXXXXXGOOOXXXXXXXXXXXXXXXX,0,0,0

21945,93,0,93,49,458,0,0,165,67,98,GOOOOOOOOOOOXXXXXXXXGOOOOOOXXXXXXXXXXXXXGOOOOOXXXXXXXXXXXXXXGOOOOOXXXXXXXXXXXXXXGOOOOOXXXXXXXXXXXXXXGOOOOOOOOXXXXXXXXXXXGOOOOOOOXXXXXXXXXXXXGOOXXXXXXXXXXXXXXXXXGOOOOOOOXXXXXXXXXXXXGOOOXXXXXXXXXXXXXXXXGOOOOOOOOXXXXXXXXXXXGOOOOOOOOOOXXXXXXXXXGOOOXXXXXXXXXXXXXXXX,0,0,0
21966,93,0,93,52,455,0,0,162,66,96,GOOOOOOOOOOOXXXXXXXXGOOOOOOXXXXXXXXXXXXXGOOOOOXXXXXXXXXXXXXXGOOOOOXXXXXXXXXXXXXXGOOOOOXXXXXXXXXXXXXXGOOOOOOOOXXXXXXXXXXXGOOOOOOOXXXXXXXXXXXXGOOXXXXXXXXXXXXXXXXXGOOOOOOOXXXXXXXXXXXXGOOOXXXXXXXXXXXXXXXXGOOOOOOOOXXXXXXXXXXXGOOOOOOOOOOXXXXXXXXXGOOOXXXXXXXXXXXXXXXX,0,0,0
21987,93,0,93,52,455,0,0,162,70,92,GOOOOOOOOOOOXXXXXXXXGOOOOOOXXXXXXXXXXXXXGOOOOOXXXXXXXXXXXXXXGOOOOOXXXXXXXXXXXXXXGOOOOOXXXXXXXXXXXXXXGOOOOOOOOXXXXXXXXXXXGOOOOOOOXXXXXXXXXXXXGOOXXXXXXXXXXXXXXXXXGOOOOOOOXXXXXXXXXXXXGOOOXXXXXXXXXXXXXXXXGOOOOOOOOXXXXXXXXXXXGOOOOOOOOOOXXXXXXXXXGOOOXXXXXXXXXXXXXXXX,0,0,0
22008,94,1,93,55,451,0,0,158,71,87,GOOOOOOOOOOOXXXXXXXXGOOOOOOXXXXXXXXXXXXXGOOOOOXXXXXXXXXXXXXXGOOOOOXXXXXXXXXXXXXXGOOOOOXXXXXXXXXXXXXXGOOOOOOOOAXXXXXXXXXXGOOOOOOOXXXXXXXXXXXXGOOXXXXXXXXXXXXXXXXXGOOOOOOOXXXXXXXXXXXXGOOOXXXXXXXXXXXXXXXXGOOOOOOOOXXXXXXXXXXXGOOOOOOOOOOXXXXXXXXXGOOOXXXXXXXXXXXXXXXX,0,0,0
22029,94,1,93,55,451,0,0,157,67,90,GOOOOOOOOOOOXXXXXXXXGOOOOOOXXXXXXXXXXXXXGOOOOOXXXXXXXXXXXXXXGOOOOOXXXXXXXXXXXXXXGOOOOOXXXXXXXXXXXXXXGOOOOOOOOAXXXXXXXXXXGOOOOOOOXXXXXXXXXXXXGOOXXXXXXXXXXXXXXXXXGOOOOOOOXXXXXXXXXXXXGOOOXXXXXXXXXXXXXXXXGOOOOOOOOXXXXXXXXXXXGOOOOOOOOOOXXXXXXXXXGOOOXXXXXXXXXXXXXXXX,0,0,0

22050,94,0,94,59,447,0,0,151,64,87,GOOOOOOOOOOOXXXXXXXXGOOOOOOXXXXXXXXXXXXXGOOOOOXXXXXXXXXXXXXXGOOOOOXXXXXXXXXXXXXXGOOOOOXXXXXXXXXXXXXXGOOOOOOOOOXXXXXXXXXXGOOOOOOOXXXXXXXXXXXXGOOXXXXXXXXXXXXXXXXXGOOOOOOOXXXXXXXXXXXXGOOOXXXXXXXXXXXXXXXXGOOOOOOOOXXXXXXXXXXXGOOOOOOOOOOXXXXXXXXXGOOOXXXXXXXXXXXXXXXX,0,0,0
22071,94,0,94,53,453,0,0,159,69,90,GOOOOOOOOOOOXXXXXXXXGOOOOOOXXXXXXXXXXXXXGOOOOOXXXXXXXXXXXXXXGOOOOOXXXXXXXXXXXXXXGOOOOOXXXXXXXXXXXXXXGOOOOOOOOOXXXXXXXXXXGOOOOOOOXXXXXXXXXXXXGOOXXXXXXXXXXXXXXXXXGOOOOOOOXXXXXXXXXXXXGOOOXXXXXXXXXXXXXXXXGOOOOOOOOXXXXXXXXXXXGOOOOOOOOOOXXXXXXXXXGOOOXXXXXXXXXXXXXXXX,0,0,0
22092,94,0,94,59,447,0,0,152,65,87,GOOOOOOOOOOOXXXXXXXXGOOOOOOXXXXXXXXXXXXXGOOOOOXXXXXXXXXXXXXXGOOOOOXXXXXXXXXXXXXXGOOOOOXXXXXXXXXXXXXXGOOOOOOOOOXXXXXXXXXXGOOOOOOOXXXXXXXXXXXXGOOXXXXXXXXXXXXXXXXXGOOOOOOOXXXXXXXXXXXXGOOOXXXXXXXXXXXXXXXXGOOOOOOOOXXXXXXXXXXXGOOOOOOOOOOXXXXXXXXXGOOOXXXXXXXXXXXXXXXX,0,0,0
22113,94,0,94,55,451,0,0,157,67,90,GOOOOOOOOOOOXXXXXXXXGOOOOOOXXXXXXXXXXXXXGOOOOOXXXXXXXXXXXXXXGOOOOOXXXXXXXXXXXXXXGOOOOOXXXXXXXXXXXXXXGOOOOOOOOOXXXXXXXXXXGOOOOOOOXXXXXXXXXXXXGOOXXXXXXXXXXXXXXXXXGOOOOOOOXXXXXXXXXXXXGOOOXXXXXXXXXXXXXXXXGOOOOOOOOXXXXXXXXXXXGOOOOOOOOOOXXXXXXXXXGOOOXXXXXXXXXXXXXXXX,0,0,0
22134,94,0,94,55,451,0,0,156,67,89,GOOOOOOOOOOOXXXXXXXXGOOOOOOXXXXXXXXXXXXXGOOOOOXXXXXXXXXXXXXXGOOOOOXXXXXXXXXXXXXXGOOOOOXXXXXXXXXXXXXXGOOOOOOOOOXXXXXXXXXXGOOOOOOOXXXXXXXXXXXXGOOXXXXXXXXXXXXXXXXXGOOOOOOOXXXXXXXXXXXXGOOOXXXXXXXXXXXXXXXXGOOOOOOOOXXXXXXXXXXXGOOOOOOOOOOXXXXXXXXXGOOOXXXXXXXXXXXXXXXX,0,0,0

22155,94,0,94,57,449,0,0,154,64,90,GOOOOOOOOOOOXXXXXXXXGOOOOOOXXXXXXXXXXXXXGOOOOOXXXXXXXXXXXXXXGOOOOOXXXXXXXXXXXXXXGOOOOOXXXXXXXXXXXXXXGOOOOOOOOOXXXXXXXXXXGOOOOOOOXXXXXXXXXXXXGOOXXXXXXXXXXXXXXXXXGOOOOOOOXXXXXXXXXXXXGOOOXXXXXXXXXXXXXXXXGOOOOOOOOXXXXXXXXXXXGOOOOOOOOOOXXXXXXXXXGOOOXXXXXXXXXXXXXXXX,0,0,0
22176,94,0,94,54,452,0,0,157,68,89,GOOOOOOOOOOOXXXXXXXXGOOOOOOXXXXXXXXXXXXXGOOOOOXXXXXXXXXXXXXXGOOOOOXXXXXXXXXXXXXXGOOOOOXXXXXXXXXXXXXXGOOOOOOOOOXXXXXXXXXXGOOOOOOOXXXXXXXXXXXXGOOXXXXXXXXXXXXXXXXXGOOOOOOOXXXXXXXXXXXXGOOOXXXXXXXXXXXXXXXXGOOOOOOOOXXXXXXXXXXXGOOOOOOOOOOXXXXXXXXXGOOOXXXXXXXXXXXXXXXX,0,0,0
22197,94,0,94,50,456,0,0,161,70,91,GOOOOOOOOOOOXXXXXXXXGOOOOOOXXXXXXXXXXXXXGOOOOOXXXXXXXXXXXXXXGOOOOOXXXXXXXXXXXXXXGOOOOOXXXXXXXXXXXXXXGOOOOOOOOOXXXXXXXXXXGOOOOOOOXXXXXXXXXXXXGOOXXXXXXXXXXXXXXXXXGOOOOOOOXXXXXXXXXXXXGOOOXXXXXXXXXXXXXXXXGOOOOOOOOXXXXXXXXXXXGOOOOOOOOOOXXXXXXXXXGOOOXXXXXXXXXXXXXXXX,0,0,0
22218,94,0,94,52,454,0,0,159,72,87,GOOOOOOOOOOOXXXXXXXXGOOOOOOXXXXXXXXXXXXXGOOOOOXXXXXXXXXXXXXXGOOOOOXXXXXXXXXXXXXXGOOOOOXXXXXXXXXXXXXXGOOOOOOOOOXXXXXXXXXXGOOOOOOOXXXXXXXXXXXXGOOXXXXXXXXXXXXXXXXXGOOOOOOOXXXXXXXXXXXXGOOOXXXXXXXXXXXXXXXXGOOOOOOOOXXXXXXXXXXXGOOOOOOOOOOXXXXXXXXXGOOOXXXXXXXXXXXXXXXX,0,0,0
22239,94,0,94,57,449,0,0,154,65,89,GOOOOOOOOOOOXXXXXXXXGOOOOOOXXXXXXXXXXXXXGOOOOOXXXXXXXXXXXXXXGOOOOOXXXXXXXXXXXXXXGOOOOOXXXXXXXXXXXXXXGOOOOOOOOOXXXXXXXXXXGOOOOOOOXXXXXXXXXXXXGOOXXXXXXXXXXXXXXXXXGOOOOOOOXXXXXXXXXXXXGOOOXXXXXXXXXXXXXXXXGOOOOOOOOXXXXXXXXXXXGOOOOOOOOOOXXXXXXXXXGOOOXXXXXXXXXXXXXXXX,0,0,0

22260,94,0,94,48,458,0,0,164,69,95,GOOOOOOOOOOOXXXXXXXXGOOOOOOXXXXXXXXXXXXXGOOOOOXXXXXXXXXXXXXXGOOOOOXXXXXXXXXXXXXXGOOOOOXXXXXXXXXXXXXXGOOOOOOOOOXXXXXXXXXXGOOOOOOOXXXXXXXXXXXXGOOXXXXXXXXXXXXXXXXXGOOOOOOOXXXXXXXXXXXXGOOOXXXXXXXXXXXXXXXXGOOOOOOOOXXXXXXXXXXXGOOOOOOOOOOXXXXXXXXXGOOOXXXXXXXXXXXXXXXX,0,0,0
22281,94,0,94,46,460,0,0,166,68,98,GOOOOOOOOOOOXXXXXXXXGOOOOOOXXXXXXXXXXXXXGOOOOOXXXXXXXXXXXXXXGOOOOOXXXXXXXXXXXXXXGOOOOOXXXXXXXXXXXXXXGOOOOOOOOOXXXXXXXXXXGOOOOOOOXXXXXXXXXXXXGOOXXXXXXXXXXXXXXXXXGOOOOOOOXXXXXXXXXXXXGOOOXXXXXXXXXXXXXXXXGOOOOOOOOXXXXXXXXXXXGOOOOOOOOOOXXXXXXXXXGOOOXXXXXXXXXXXXXXXX,0,0,0
22302,94,0,94,45,461,0,0,167,69,98,GOOOOOOOOOOOXXXXXXXXGOOOOOOXXXXXXXXXXXXXGOOOOOXXXXXXXXXXXXXXGOOOOOXXXXXXXXXXXXXXGOOOOOXXXXXXXXXXXXXXGOOOOOOOOOXXXXXXXXXXGOOOOOOOXXXXXXXXXXXXGOOXXXXXXXXXXXXXXXXXGOOOOOOOXXXXXXXXXXXXGOOOXXXXXXXXXXXXXXXXGOOOOOOOOXXXXXXXXXXXGOOOOOOOOOOXXXXXXXXXGOOOXXXXXXXXXXXXXXXX,0,0,0
22323,94,0,94,49,457,0,0,162,70,92,GOOOOOOOOOOOXXXXXXXXGOOOOOOXXXXXXXXXXXXXGOOOOOXXXXXXXXXXXXXXGOOOOOXXXXXXXXXXXXXXGOOOOOXXXXXXXXXXXXXXGOOOOOOOOOXXXXXXXXXXGOOOOOOOXXXXXXXXXXXXGOOXXXXXXXXXXXXXXXXXGOOOOOOOXXXXXXXXXXXXGOOOXXXXXXXXXXXXXXXXGOOOOOOOOXXXXXXXXXXXGOOOOOOOOOOXXXXXXXXXGOOOXXXXXXXXXXXXXXXX,0,0,0
22344,94,0,94,48,458,0,0,163,69,94,GOOOOOOOOOOOXXXXXXXXGOOOOOOXXXXXXXXXXXXXGOOOOOXXXXXXXXXXXXXXGOOOOOXXXXXXXXXXXXXXGOOOOOXXXXXXXXXXXXXXGOOOOOOOOOXXXXXXXXXXGOOOOOOOXXXXXXXXXXXXGOOXXXXXXXXXXXXXXXXXGOOOOOOOXXXXXXXXXXXXGOOOXXXXXXXXXXXXXXXXGOOOOOOOOXXXXXXXXXXXGOOOOOOOOOOXXXXXXXXXGOOOXXXXXXXXXXXXXXXX,0,0,0

22365,94,0,94,46,460,0,0,166,70,96,GOOOOOOOOOOOXXXXXXXXGOOOOOOXXXXXXXXXXXXXGOOOOOXXXXXXXXXXXXXXGOOOOOXXXXXXXXXXXXXXGOOOOOXXXXXXXXXXXXXXGOOOOOOOOOXXXXXXXXXXGOOOOOOOXXXXXXXXXXXXGOOXXXXXXXXXXXXXXXXXGOOOOOOOXXXXXXXXXXXXGOOOXXXXXXXXXXXXXXXXGOOOOOOOOXXXXXXXXXXXGOOOOOOOOOOXXXXXXXXXGOOOXXXXXXXXXXXXXXXX,0,0,0
22386,94,0,94,46,460,0,0,165,68,97,GOOOOOOOOOOOXXXXXXXXGOOOOOOXXXXXXXXXXXXXGOOOOOXXXXXXXXXXXXXXGOOOOOXXXXXXXXXXXXXXGOOOOOXXXXXXXXXXXXXXGOOOOOOOOOXXXXXXXXXXGOOOOOOOXXXXXXXXXXXXGOOXXXXXXXXXXXXXXXXXGOOOOOOOXXXXXXXXXXXXGOOOXXXXXXXXXXXXXXXXGOOOOOOOOXXXXXXXXXXXGOOOOOOOOOOXXXXXXXXXGOOOXXXXXXXXXXXXXXXX,0,0,0
22407,94,0,94,45,461,0,0,167,71,96,GOOOOOOOOOOOXXXXXXXXGOOOOOOXXXXXXXXXXXXXGOOOOOXXXXXXXXXXXXXXGOOOOOXXXXXXXXXXXXXXGOOOOOXXXXXXXXXXXXXXGOOOOOOOOOXXXXXXXXXXGOOOOOOOXXXXXXXXXXXXGOOXXXXXXXXXXXXXXXXXGOOOOOOOXXXXXXXXXXXXGOOOXXXXXXXXXXXXXXXXGOOOOOOOOXXXXXXXXXXXGOOOOOOOOOOXXXXXXXXXGOOOXXXXXXXXXXXXXXXX,0,0,0
22428,94,0,94,49,457,0,0,163,68,95,GOOOOOOOOOOOXXXXXXXXGOOOOOOXXXXXXXXXXXXXGOOOOOXXXXXXXXXXXXXXGOOOOOXXXXXXXXXXXXXXGOOOOOXXXXXXXXXXXXXXGOOOOOOOOOXXXXXXXXXXGOOOOOOOXXXXXXXXXXXXGOOXXXXXXXXXXXXXXXXXGOOOOOOOXXXXXXXXXXXXGOOOXXXXXXXXXXXXXXXXGOOOOOOOOXXXXXXXXXXXGOOOOOOOOOOXXXXXXXXXGOOOXXXXXXXXXXXXXXXX,0,0,0
22449,94,0,94,49,457,0,0,163,68,95,GOOOOOOOOOOOXXXXXXXXGOOOOOOXXXXXXXXXXXXXGOOOOOXXXXXXXXXXXXXXGOOOOOXXXXXXXXXXXXXXGOOOOOXXXXXXXXXXXXXXGOOOOOOOOOXXXXXXXXXXGOOOOOOOXXXXXXXXXXXXGOOXXXXXXXXXXXXXXXXXGOOOOOOOXXXXXXXXXXXXGOOOXXXXXXXXXXXXXXXXGOOOOOOOOXXXXXXXXXXXGOOOOOOOOOOXXXXXXXXXGOOOXXXXXXXXXXXXXXXX,0,0,0

22470,94,0,94,47,459,0,0,165,72,93,GOOOOOOOOOOOXXXXXXXXGOOOOOOXXXXXXXXXXXXXGOOOOOXXXXXXXXXXXXXXGOOOOOXXXXXXXXXXXXXXGOOOOOXXXXXXXXXXXXXXGOOOOOOOOOXXXXXXXXXXGOOOOOOOXXXXXXXXXXXXGOOXXXXXXXXXXXXXXXXXGOOOOOOOXXXXXXXXXXXXGOOOXXXXXXXXXXXXXXXXGOOOOOOOOXXXXXXXXXXXGOOOOOOOOOOXXXXXXXXXGOOOXXXXXXXXXXXXXXXX,0,0,0
22491,94,0,94,54,452,0,0,157,67,90,GOOOOOOOOOOOXXXXXXXXGOOOOOOXXXXXXXXXXXXXGOOOOOXXXXXXXXXXXXXXGOOOOOXXXXXXXXXXXXXXGOOOOOXXXXXXXXXXXXXXGOOOOOOOOOXXXXXXXXXXGOOOOOOOXXXXXXXXXXXXGOOXXXXXXXXXXXXXXXXXGOOOOOOOXXXXXXXXXXXXGOOOXXXXXXXXXXXXXXXXGOOOOOOOOXXXXXXXXXXXGOOOOOOOOOOXXXXXXXXXGOOOXXXXXXXXXXXXXXXX,0,0,0
22512,94,0,94,48,458,0,0,163,67,96,GOOOOOOOOOOOXXXXXXXXGOOOOOOXXXXXXXXXXXXXGOOOOOXXXXXXXXXXXXXXGOOOOOXXXXXXXXXXXXXXGOOOOOXXXXXXXXXXXXXXGOOOOOOOOOXXXXXXXXXXGOOOOOOOXXXXXXXXXXXXGOOXXXXXXXXXXXXXXXXXGOOOOOOOXXXXXXXXXXXXGOOOXXXXXXXXXXXXXXXXGOOOOOOOOXXXXXXXXXXXGOOOOOOOOOOXXXXXXXXXGOOOXXXXXXXXXXXXXXXX,0,0,0
22533,94,0,94,48,458,0,0,163,68,95,GOOOOOOOOOOOXXXXXXXXGOOOOOOXXXXXXXXXXXXXGOOOOOXXXXXXXXXXXXXXGOOOOOXXXXXXXXXXXXXXGOOOOOXXXXXXXXXXXXXXGOOOOOOOOOXXXXXXXXXXGOOOOOOOXXXXXXXXXXXXGOOXXXXXXXXXXXXXXXXXGOOOOOOOXXXXXXXXXXXXGOOOXXXXXXXXXXXXXXXXGOOOOOOOOXXXXXXXXXXXGOOOOOOOOOOXXXXXXXXXGOOOXXXXXXXXXXXXXXXX,0,0,0
22554,94,0,94,47,459,0,0,163,69,94,GOOOOOOOOOOOXXXXXXXXGOOOOOOXXXXXXXXXXXXXGOOOOOXXXXXXXXXXXXXXGOOOOOXXXXXXXXXXXXXXGOOOOOXXXXXXXXXXXXXXGOOOOOOOOOXXXXXXXXXXGOOOOOOOXXXXXXXXXXXXGOOXXXXXXXXXXXXXXXXXGOOOOOOOXXXXXXXXXXXXGOOOXXXXXXXXXXXXXXXXGOOOOOOOOXXXXXXXXXXXGOOOOOOOOOOXXXXXXXXXGOOOXXXXXXXXXXXXXXXX,0,0,0

22575,94,0,94,51,455,0,0,160,67,93,GOOOOOOOOOOOXXXXXXXXGOOOOOOXXXXXXXXXXXXXGOOOOOXXXXXXXXXXXXXXGOOOOOXXXXXXXXXXXXXXGOOOOOXXXXXXXXXXXXXXGOOOOOOOOOXXXXXXXXXXGOOOOOOOXXXXXXXXXXXXGOOXXXXXXXXXXXXXXXXXGOOOOOOOXXXXXXXXXXXXGOOOXXXXXXXXXXXXXXXXGOOOOOOOOXXXXXXXXXXXGOOOOOOOOOOXXXXXXXXXGOOOXXXXXXXXXXXXXXXX,0,0,0
22596,94,0,94,50,456,0,0,160,70,90,GOOOOOOOOOOOXXXXXXXXGOOOOOOXXXXXXXXXXXXXGOOOOOXXXXXXXXXXXXXXGOOOOOXXXXXXXXXXXXXXGOOOOOXXXXXXXXXXXXXXGOOOOOOOOOXXXXXXXXXXGOOOOOOOXXXXXXXXXXXXGOOXXXXXXXXXXXXXXXXXGOOOOOOOXXXXXXXXXXXXGOOOXXXXXXXXXXXXXXXXGOOOOOOOOXXXXXXXXXXXGOOOOOOOOOOXXXXXXXXXGOOOXXXXXXXXXXXXXXXX,0,0,0
22617,94,0,94,51,455,0,0,159,73,86,GOOOOOOOOOOOXXXXXXXXGOOOOOOXXXXXXXXXXXXXGOOOOOXXXXXXXXXXXXXXGOOOOOXXXXXXXXXXXXXXGOOOOOXXXXXXXXXXXXXXGOOOOOOOOOXXXXXXXXXXGOOOOOOOXXXXXXXXXXXXGOOXXXXXXXXXXXXXXXXXGOOOOOOOXXXXXXXXXXXXGOOOXXXXXXXXXXXXXXXXGOOOOOOOOXXXXXXXXXXXGOOOOOOOOOOXXXXXXXXXGOOOXXXXXXXXXXXXXXXX,0,0,0
22638,94,0,94,45,461,0,0,166,71,95,GOOOOOOOOOOOXXXXXXXXGOOOOOOXXXXXXXXXXXXXGOOOOOXXXXXXXXXXXXXXGOOOOOXXXXXXXXXXXXXXGOOOOOXXXXXXXXXXXXXXGOOOOOOOOOXXXXXXXXXXGOOOOOOOXXXXXXXXXXXXGOOXXXXXXXXXXXXXXXXXGOOOOOOOXXXXXXXXXXXXGOOOXXXXXXXXXXXXXXXXGOOOOOOOOXXXXXXXXXXXGOOOOOOOOOOXXXXXXXXXGOOOXXXXXXXXXXXXXXXX,0,0,0
22659,94,0,94,48,458,0,0,162,69,93,GOOOOOOOOOOOXXXXXXXXGOOOOOOXXXXXXXXXXXXXGOOOOOXXXXXXXXXXXXXXGOOOOOXXXXXXXXXXXXXXGOOOOOXXXXXXXXXXXXXXGOOOOOOOOOXXXXXXXXXXGOOOOOOOXXXXXXXXXXXXGOOXXXXXXXXXXXXXXXXXGOOOOOOOXXXXXXXXXXXXGOOOXXXXXXXXXXXXXXXXGOOOOOOOOXXXXXXXXXXXGOOOOOOOOOOXXXXXXXXXGOOOXXXXXXXXXXXXXXXX,0,0,0

22680,94,0,94,50,456,0,0,160,71,89,GOOOOOOOOOOOXXXXXXXXGOOOOOOXXXXXXXXXXXXXGOOOOOXXXXXXXXXXXXXXGOOOOOXXXXXXXXXXXXXXGOOOOOXXXXXXXXXXXXXXGOOOOOOOOOXXXXXXXXXXGOOOOOOOXXXXXXXXXXXXGOOXXXXXXXXXXXXXXXXXGOOOOOOOXXXXXXXXXXXXGOOOXXXXXXXXXXXXXXXXGOOOOOOOOXXXXXXXXXXXGOOOOOOOOOOXXXXXXXXXGOOOXXXXXXXXXXXXXXXX,0,0,0
22701,94,0,94,56,450,0,0,155,74,81,GOOOOOOOOOOOXXXXXXXXGOOOOOOXXXXXXXXXXXXXGOOOOOXXXXXXXXXXXXXXGOOOOOXXXXXXXXXXXXXXGOOOOOXXXXXXXXXXXXXXGOOOOOOOOOXXXXXXXXXXGOOOOOOOXXXXXXXXXXXXGOOXXXXXXXXXXXXXXXXXGOOOOOOOXXXXXXXXXXXXGOOOXXXXXXXXXXXXXXXXGOOOOOOOOXXXXXXXXXXXGOOOOOOOOOOXXXXXXXXXGOOOXXXXXXXXXXXXXXXX,0,0,0
22722,94,0,94,56,450,0,0,155,69,86,GOOOOOOOOOOOXXXXXXXXGOOOOOOXXXXXXXXXXXXXGOOOOOXXXXXXXXXXXXXXGOOOOOXXXXXXXXXXXXXXGOOOOOXXXXXXXXXXXXXXGOOOOOOOOOXXXXXXXXXXGOOOOOOOXXXXXXXXXXXXGOOXXXXXXXXXXXXXXXXXGOOOOOOOXXXXXXXXXXXXGOOOXXXXXXXXXXXXXXXXGOOOOOOOOXXXXXXXXXXXGOOOOOOOOOOXXXXXXXXXGOOOXXXXXXXXXXXXXXXX,0,0,0
22743,94,0,94,57,449,0,0,155,68,87,GOOOOOOOOOOOXXXXXXXXGOOOOOOXXXXXXXXXXXXXGOOOOOXXXXXXXXXXXXXXGOOOOOXXXXXXXXXXXXXXGOOOOOXXXXXXXXXXXXXXGOOOOOOOOOXXXXXXXXXXGOOOOOOOXXXXXXXXXXXXGOOXXXXXXXXXXXXXXXXXGOOOOOOOXXXXXXXXXXXXGOOOXXXXXXXXXXXXXXXXGOOOOOOOOXXXXXXXXXXXGOOOOOOOOOOXXXXXXXXXGOOOXXXXXXXXXXXXXXXX,0,0,0
22764,94,0,94,51,455,0,0,160,68,92,GOOOOOOOOOOOXXXXXXXXGOOOOOOXXXXXXXXXXXXXGOOOOOXXXXXXXXXXXXXXGOOOOOXXXXXXXXXXXXXXGOOOOOXXXXXXXXXXXXXXGOOOOOOOOOXXXXXXXXXXGOOOOOOOXXXXXXXXXXXXGOOXXXXXXXXXXXXXXXXXGOOOOOOOXXXXXXXXXXXXGOOOXXXXXXXXXXXXXXXXGOOOOOOOOXXXXXXXXXXXGOOOOOOOOOOXXXXXXXXXGOOOXXXXXXXXXXXXXXXX,0,0,0

22785,95,1,94,50,455,0,0,161,70,91,GOOOOOOOOOOOXXXXXXXXGOOOOOOXXXXXXXXXXXXXGOOOOOXXXXXXXXXXXXXXGOOOOOXXXXXXXXXXXXXXGOOOOOAXXXXXXXXXXXXXGOOOOOOOOOXXXXXXXXXXGOOOOOOOXXXXXXXXXXXXGOOXXXXXXXXXXXXXXXXXGOOOOOOOXXXXXXXXXXXXGOOOXXXXXXXXXXXXXXXXGOOOOOOOOXXXXXXXXXXXGOOOOOOOOOOXXXXXXXXXGOOOXXXXXXXXXXXXXXXX,0,0,0
22806,95,1,94,53,452,0,0,157,67,90,GOOOOOOOOOOOXXXXXXXXGOOOOOOXXXXXXXXXXXXXGOOOOOXXXXXXXXXXXXXXGOOOOOXXXXXXXXXXXXXXGOOOOOAXXXXXXXXXXXXXGOOOOOOOOOXXXXXXXXXXGOOOOOOOXXXXXXXXXXXXGOOXXXXXXXXXXXXXXXXXGOOOOOOOXXXXXXXXXXXXGOOOXXXXXXXXXXXXXXXXGOOOOOOOOXXXXXXXXXXXGOOOOOOOOOOXXXXXXXXXGOOOXXXXXXXXXXXXXXXX,0,0,0
22827,95,0,95,54,451,0,0,157,70,87,GOOOOOOOOOOOXXXXXXXXGOOOOOOXXXXXXXXXXXXXGOOOOOXXXXXXXXXXXXXXGOOOOOXXXXXXXXXXXXXXGOOOOOOXXXXXXXXXXXXXGOOOOOOOOOXXXXXXXXXXGOOOOOOOXXXXXXXXXXXXGOOXXXXXXXXXXXXXXXXXGOOOOOOOXXXXXXXXXXXXGOOOXXXXXXXXXXXXXXXXGOOOOOOOOXXXXXXXXXXXGOOOOOOOOOOXXXXXXXXXGOOOXXXXXXXXXXXXXXXX,0,0,0
22848,95,0,95,58,447,0,0,153,65,88,GOOOOOOOOOOOXXXXXXXXGOOOOOOXXXXXXXXXXXXXGOOOOOXXXXXXXXXXXXXXGOOOOOXXXXXXXXXXXXXXGOOOOOOXXXXXXXXXXXXXGOOOOOOOOOXXXXXXXXXXGOOOOOOOXXXXXXXXXXXXGOOXXXXXXXXXXXXXXXXXGOOOOOOOXXXXXXXXXXXXGOOOXXXXXXXXXXXXXXXXGOOOOOOOOXXXXXXXXXXXGOOOOOOOOOOXXXXXXXXXGOOOXXXXXXXXXXXXXXXX,0,0,0
22869,95,0,95,58,447,0,0,153,71,82,GOOOOOOOOOOOXXXXXXXXGOOOOOOXXXXXXXXXXXXXGOOOOOXXXXXXXXXXXXXXGOOOOOXXXXXXXXXXXXXXGOOOOOOXXXXXXXXXXXXXGOOOOOOOOOXXXXXXXXXXGOOOOOOOXXXXXXXXXXXXGOOXXXXXXXXXXXXXXXXXGOOOOOOOXXXXXXXXXXXXGOOOXXXXXXXXXXXXXXXXGOOOOOOOOXXXXXXXXXXXGOOOOOOOOOOXXXXXXXXXGOOOXXXXXXXXXXXXXXXX,0,0,0

22890,95,0,95,55,450,0,0,156,72,84,GOOOOOOOOOOOXXXXXXXXGOOOOOOXXXXXXXXXXXXXGOOOOOXXXXXXXXXXXXXXGOOOOOXXXXXXXXXXXXXXGOOOOOOXXXXXXXXXXXXXGOOOOOOOOOXXXXXXXXXXGOOOOOOOXXXXXXXXXXXXGOOXXXXXXXXXXXXXXXXXGOOOOOOOXXXXXXXXXXXXGOOOXXXXXXXXXXXXXXXXGOOOOOOOOXXXXXXXXXXXGOOOOOOOOOOXXXXXXXXXGOOOXXXXXXXXXXXXXXXX,0,0,0
22911,95,0,95,57,448,0,0,155,68,87,GOOOOOOOOOOOXXXXXXXXGOOOOOOXXXXXXXXXXXXXGOOOOOXXXXXXXXXXXXXXGOOOOOXXXXXXXXXXXXXXGOOOOOOXXXXXXXXXXXXXGOOOOOOOOOXXXXXXXXXXGOOOOOOOXXXXXXXXXXXXGOOXXXXXXXXXXXXXXXXXGOOOOOOOXXXXXXXXXXXXGOOOXXXXXXXXXXXXXXXXGOOOOOOOOXXXXXXXXXXXGOOOOOOOOOOXXXXXXXXXGOOOXXXXXXXXXXXXXXXX,0,0,0
22932,95,0,95,54,451,0,0,157,67,90,GOOOOOOOOOOOXXXXXXXXGOOOOOOXXXXXXXXXXXXXGOOOOOXXXXXXXXXXXXXXGOOOOOXXXXXXXXXXXXXXGOOOOOOXXXXXXXXXXXXXGOOOOOOOOOXXXXXXXXXXGOOOOOOOXXXXXXXXXXXXGOOXXXXXXXXXXXXXXXXXGOOOOOOOXXXXXXXXXXXXGOOOXXXXXXXXXXXXXXXXGOOOOOOOOXXXXXXXXXXXGOOOOOOOOOOXXXXXXXXXGOOOXXXXXXXXXXXXXXXX,0,0,0
22953,95,0,95,49,456,0,0,161,73,88,GOOOOOOOOOOOXXXXXXXXGOOOOOOXXXXXXXXXXXXXGOOOOOXXXXXXXXXXXXXXGOOOOOXXXXXXXXXXXXXXGOOOOOOXXXXXXXXXXXXXGOOOOOOOOOXXXXXXXXXXGOOOOOOOXXXXXXXXXXXXGOOXXXXXXXXXXXXXXXXXGOOOOOOOXXXXXXXXXXXXGOOOXXXXXXXXXXXXXXXXGOOOOOOOOXXXXXXXXXXXGOOOOOOOOOOXXXXXXXXXGOOOXXXXXXXXXXXXXXXX,0,0,0
22974,95,0,95,52,453,0,0,159,69,90,GOOOOOOOOOOOXXXXXXXXGOOOOOOXXXXXXXXXXXXXGOOOOOXXXXXXXXXXXXXXGOOOOOXXXXXXXXXXXXXXGOOOOOOXXXXXXXXXXXXXGOOOOOOOOOXXXXXXXXXXGOOOOOOOXXXXXXXXXXXXGOOXXXXXXXXXXXXXXXXXGOOOOOOOXXXXXXXXXXXXGOOOXXXXXXXXXXXXXXXXGOOOOOOOOXXXXXXXXXXXGOOOOOOOOOOXXXXXXXXXGOOOXXXXXXXXXXXXXXXX,0,0,0

22995,95,0,95,47,458,0,0,164,73,91,GOOOOOOOOOOOXXXXXXXXGOOOOOOXXXXXXXXXXXXXGOOOOOXXXXXXXXXXXXXXGOOOOOXXXXXXXXXXXXXXGOOOOOOXXXXXXXXXXXXXGOOOOOOOOOXXXXXXXXXXGOOOOOOOXXXXXXXXXXXXGOOXXXXXXXXXXXXXXXXXGOOOOOOOXXXXXXXXXXXXGOOOXXXXXXXXXXXXXXXXGOOOOOOOOXXXXXXXXXXXGOOOOOOOOOOXXXXXXXXXGOOOXXXXXXXXXXXXXXXX,0,0,0
23016,95,0,95,51,454,0,0,159,69,90,GOOOOOOOOOOOXXXXXXXXGOOOOOOXXXXXXXXXXXXXGOOOOOXXXXXXXXXXXXXXGOOOOOXXXXXXXXXXXXXXGOOOOOOXXXXXXXXXXXXXGOOOOOOOOOXXXXXXXXXXGOOOOOOOXXXXXXXXXXXXGOOXXXXXXXXXXXXXXXXXGOOOOOOOXXXXXXXXXXXXGOOOXXXXXXXXXXXXXXXXGOOOOOOOOXXXXXXXXXXXGOOOOOOOOOOXXXXXXXXXGOOOXXXXXXXXXXXXXXXX,0,0,0
23037,95,0,95,50,455,0,0,161,69,92,GOOOOOOOOOOOXXXXXXXXGOOOOOOXXXXXXXXXXXXXGOOOOOXXXXXXXXXXXXXXGOOOOOXXXXXXXXXXXXXXGOOOOOOXXXXXXXXXXXXXGOOOOOOOOOXXXXXXXXXXGOOOOOOOXXXXXXXXXXXXGOOXXXXXXXXXXXXXXXXXGOOOOOOOXXXXXXXXXXXXGOOOXXXXXXXXXXXXXXXXGOOOOOOOOXXXXXXXXXXXGOOOOOOOOOOXXXXXXXXXGOOOXXXXXXXXXXXXXXXX,0,0,0
23058,95,0,95,44,461,0,0,167,71,96,GOOOOOOOOOOOXXXXXXXXGOOOOOOXXXXXXXXXXXXXGOOOOOXXXXXXXXXXXXXXGOOOOOXXXXXXXXXXXXXXGOOOOOOXXXXXXXXXXXXXGOOOOOOOOOXXXXXXXXXXGOOOOOOOXXXXXXXXXXXXGOOXXXXXXXXXXXXXXXXXGOOOOOOOXXXXXXXXXXXXGOOOXXXXXXXXXXXXXXXXGOOOOOOOOXXXXXXXXXXXGOOOOOOOOOOXXXXXXXXXGOOOXXXXXXXXXXXXXXXX,0,0,0
23079,95,0,95,41,464,0,0,169,71,98,GOOOOOOOOOOOXXXXXXXXGOOOOOOXXXXXXXXXXXXXGOOOOOXXXXXXXXXXXXXXGOOOOOXXXXXXXXXXXXXXGOOOOOOXXXXXXXXXXXXXGOOOOOOOOOXXXXXXXXXXGOOOOOOOXXXXXXXXXXXXGOOXXXXXXXXXXXXXXXXXGOOOOOOOXXXXXXXXXXXXGOOOXXXXXXXXXXXXXXXXGOOOOOOOOXXXXXXXXXXXGOOOOOOOOOOXXXXXXXXXGOOOXXXXXXXXXXXXXXXX,0,0,0

23100,95,0,95,37,468,0,0,173,73,100,GOOOOOOOOOOOXXXXXXXXGOOOOOOXXXXXXXXXXXXXGOOOOOXXXXXXXXXXXXXXGOOOOOXXXXXXXXXXXXXXGOOOOOOXXXXXXXXXXXXXGOOOOOOOOOXXXXXXXXXXGOOOOOOOXXXXXXXXXXXXGOOXXXXXXXXXXXXXXXXXGOOOOOOOXXXXXXXXXXXXGOOOXXXXXXXXXXXXXXXXGOOOOOOOOXXXXXXXXXXXGOOOOOOOOOOXXXXXXXXXGOOOXXXXXXXXXXXXXXXX,0,0,0
23121,95,0,95,43,462,0,0,167,71,96,GOOOOOOOOOOOXXXXXXXXGOOOOOOXXXXXXXXXXXXXGOOOOOXXXXXXXXXXXXXXGOOOOOXXXXXXXXXXXXXXGOOOOOOXXXXXXXXXXXXXGOOOOOOOOOXXXXXXXXXXGOOOOOOOXXXXXXXXXXXXGOOXXXXXXXXXXXXXXXXXGOOOOOOOXXXXXXXXXXXXGOOOXXXXXXXXXXXXXXXXGOOOOOOOOXXXXXXXXXXXGOOOOOOOOOOXXXXXXXXXGOOOXXXXXXXXXXXXXXXX,0,0,0
23142,95,0,95,46,459,0,0,165,70,95,GOOOOOOOOOOOXXXXXXXXGOOOOOOXXXXXXXXXXXXXGOOOOOXXXXXXXXXXXXXXGOOOOOXXXXXXXXXXXXXXGOOOOOOXXXXXXXXXXXXXGOOOOOOOOOXXXXXXXXXXGOOOOOOOXXXXXXXXXXXXGOOXXXXXXXXXXXXXXXXXGOOOOOOOXXXXXXXXXXXXGOOOXXXXXXXXXXXXXXXXGOOOOOOOOXXXXXXXXXXXGOOOOOOOOOOXXXXXXXXXGOOOXXXXXXXXXXXXXXXX,0,0,0
23163,95,0,95,44,461,0,0,167,74,93,GOOOOOOOOOOOXXXXXXXXGOOOOOOXXXXXXXXXXXXXGOOOOOXXXXXXXXXXXXXXGOOOOOXXXXXXXXXXXXXXGOOOOOOXXXXXXXXXXXXXGOOOOOOOOOXXXXXXXXXXGOOOOOOOXXXXXXXXXXXXGOOXXXXXXXXXXXXXXXXXGOOOOOOOXXXXXXXXXXXXGOOOXXXXXXXXXXXXXXXXGOOOOOOOOXXXXXXXXXXXGOOOOOOOOOOXXXXXXXXXGOOOXXXXXXXXXXXXXXXX,0,0,0
23184,95,0,95,50,455,0,0,161,74,87,GOOOOOOOOOOOXXXXXXXXGOOOOOOXXXXXXXXXXXXXGOOOOOXXXXXXXXXXXXXXGOOOOOXXXXXXXXXXXXXXGOOOOOOXXXXXXXXXXXXXGOOOOOOOOOXXXXXXXXXXGOOOOOOOXXXXXXXXXXXXGOOXXXXXXXXXXXXXXXXXGOOOOOOOXXXXXXXXXXXXGOOOXXXXXXXXXXXXXXXXGOOOOOOOOXXXXXXXXXXXGOOOOOOOOOOXXXXXXXXXGOOOXXXXXXXXXXXXXXXX,0,0,0

23205,95,0,95,57,448,0,0,154,70,84,GOOOOOOOOOOOXXXXXXXXGOOOOOOXXXXXXXXXXXXXGOOOOOXXXXXXXXXXXXXXGOOOOOXXXXXXXXXXXXXXGOOOOOOXXXXXXXXXXXXXGOOOOOOOOOXXXXXXXXXXGOOOOOOOXXXXXXXXXXXXGOOXXXXXXXXXXXXXXXXXGOOOOOOOXXXXXXXXXXXXGOOOXXXXXXXXXXXXXXXXGOOOOOOOOXXXXXXXXXXXGOOOOOOOOOOXXXXXXXXXGOOOXXXXXXXXXXXXXXXX,0,0,0
23226,95,0,95,58,447,0,0,154,67,87,GOOOOOOOOOOOXXXXXXXXGOOOOOOXXXXXXXXXXXXXGOOOOOXXXXXXXXXXXXXXGOOOOOXXXXXXXXXXXXXXGOOOOOOXXXXXXXXXXXXXGOOOOOOOOOXXXXXXXXXXGOOOOOOOXXXXXXXXXXXXGOOXXXXXXXXXXXXXXXXXGOOOOOOOXXXXXXXXXXXXGOOOXXXXXXXXXXXXXXXXGOOOOOOOOXXXXXXXXXXXGOOOOOOOOOOXXXXXXXXXGOOOXXXXXXXXXXXXXXXX,0,0,0
23247,95,0,95,54,451,0,0,158,72,86,GOOOOOOOOOOOXXXXXXXXGOOOOOOXXXXXXXXXXXXXGOOOOOXXXXXXXXXXXXXXGOOOOOXXXXXXXXXXXXXXGOOOOOOXXXXXXXXXXXXXGOOOOOOOOOXXXXXXXXXXGOOOOOOOXXXXXXXXXXXXGOOXXXXXXXXXXXXXXXXXGOOOOOOOXXXXXXXXXXXXGOOOXXXXXXXXXXXXXXXXGOOOOOOOOXXXXXXXXXXXGOOOOOOOOOOXXXXXXXXXGOOOXXXXXXXXXXXXXXXX,0,0,0
23268,95,0,95,58,447,0,0,154,71,83,GOOOOOOOOOOOXXXXXXXXGOOOOOOXXXXXXXXXXXXXGOOOOOXXXXXXXXXXXXXXGOOOOOXXXXXXXXXXXXXXGOOOOOOXXXXXXXXXXXXXGOOOOOOOOOXXXXXXXXXXGOOOOOOOXXXXXXXXXXXXGOOXXXXXXXXXXXXXXXXXGOOOOOOOXXXXXXXXXXXXGOOOXXXXXXXXXXXXXXXXGOOOOOOOOXXXXXXXXXXXGOOOOOOOOOOXXXXXXXXXGOOOXXXXXXXXXXXXXXXX,0,0,0
23289,95,0,95,53,452,0,0,159,70,89,GOOOOOOOOOOOXXXXXXXXGOOOOOOXXXXXXXXXXXXXGOOOOOXXXXXXXXXXXXXXGOOOOOXXXXXXXXXXXXXXGOOOOOOXXXXXXXXXXXXXGOOOOOOOOOXXXXXXXXXXGOOOOOOOXXXXXXXXXXXXGOOXXXXXXXXXXXXXXXXXGOOOOOOOXXXXXXXXXXXXGOOOXXXXXXXXXXXXXXXXGOOOOOOOOXXXXXXXXXXXGOOOOOOOOOOXXXXXXXXXGOOOXXXXXXXXXXXXXXXX,0,0,0

23310,95,0,95,55,450,0,0,156,72,84,GOOOOOOOOOOOXXXXXXXXGOOOOOOXXXXXXXXXXXXXGOOOOOXXXXXXXXXXXXXXGOOOOOXXXXXXXXXXXXXXGOOOOOOXXXXXXXXXXXXXGOOOOOOOOOXXXXXXXXXXGOOOOOOOXXXXXXXXXXXXGOOXXXXXXXXXXXXXXXXXGOOOOOOOXXXXXXXXXXXXGOOOXXXXXXXXXXXXXXXXGOOOOOOOOXXXXXXXXXXXGOOOOOOOOOOXXXXXXXXXGOOOXXXXXXXXXXXXXXXX,0,0,0
23331,95,0,95,55,450,0,0,156,70,86,GOOOOOOOOOOOXXXXXXXXGOOOOOOXXXXXXXXXXXXXGOOOOOXXXXXXXXXXXXXXGOOOOOXXXXXXXXXXXXXXGOOOOOOXXXXXXXXXXXXXGOOOOOOOOOXXXXXXXXXXGOOOOOOOXXXXXXXXXXXXGOOXXXXXXXXXXXXXXXXXGOOOOOOOXXXXXXXXXXXXGOOOXXXXXXXXXXXXXXXXGOOOOOOOOXXXXXXXXXXXGOOOOOOOOOOXXXXXXXXXGOOOXXXXXXXXXXXXXXXX,0,0,0
23352,95,0,95,51,454,0,0,160,72,88,GOOOOOOOOOOOXXXXXXXXGOOOOOOXXXXXXXXXXXXXGOOOOOXXXXXXXXXXXXXXGOOOOOXXXXXXXXXXXXXXGOOOOOOXXXXXXXXXXXXXGOOOOOOOOOXXXXXXXXXXGOOOOOOOXXXXXXXXXXXXGOOXXXXXXXXXXXXXXXXXGOOOOOOOXXXXXXXXXXXXGOOOXXXXXXXXXXXXXXXXGOOOOOOOOXXXXXXXXXXXGOOOOOOOOOOXXXXXXXXXGOOOXXXXXXXXXXXXXXXX,0,0,0
23373,95,0,95,53,452,0,0,157,67,90,GOOOOOOOOOOOXXXXXXXXGOOOOOOXXXXXXXXXXXXXGOOOOOXXXXXXXXXXXXXXGOOOOOXXXXXXXXXXXXXXGOOOOOOXXXXXXXXXXXXXGOOOOOOOOOXXXXXXXXXXGOOOOOOOXXXXXXXXXXXXGOOXXXXXXXXXXXXXXXXXGOOOOOOOXXXXXXXXXXXXGOOOXXXXXXXXXXXXXXXXGOOOOOOOOXXXXXXXXXXXGOOOOOOOOOOXXXXXXXXXGOOOXXXXXXXXXXXXXXXX,0,0,0
23394,95,0,95,51,454,0,0,160,72,88,GOOOOOOOOOOOXXXXXXXXGOOOOOOXXXXXXXXXXXXXGOOOOOXXXXXXXXXXXXXXGOOOOOXXXXXXXXXXXXXXGOOOOOOXXXXXXXXXXXXXGOOOOOOOOOXXXXXXXXXXGOOOOOOOXXXXXXXXXXXXGOOXXXXXXXXXXXXXXXXXGOOOOOOOXXXXXXXXXXXXGOOOXXXXXXXXXXXXXXXXGOOOOOOOOXXXXXXXXXXXGOOOOOOOOOOXXXXXXXXXGOOOXXXXXXXXXXXXXXXX,0,0,0

23415,95,0,95,47,458,0,0,163,75,88,GOOOOOOOOOOOXXXXXXXXGOOOOOOXXXXXXXXXXXXXGOOOOOXXXXXXXXXXXXXXGOOOOOXXXXXXXXXXXXXXGOOOOOOXXXXXXXXXXXXXGOOOOOOOOOXXXXXXXXXXGOOOOOOOXXXXXXXXXXXXGOOXXXXXXXXXXXXXXXXXGOOOOOOOXXXXXXXXXXXXGOOOXXXXXXXXXXXXXXXXGOOOOOOOOXXXXXXXXXXXGOOOOOOOOOOXXXXXXXXXGOOOXXXXXXXXXXXXXXXX,0,0,0
23436,95,0,95,49,456,0,0,162,75,87,GOOOOOOOOOOOXXXXXXXXGOOOOOOXXXXXXXXXXXXXGOOOOOXXXXXXXXXXXXXXGOOOOOXXXXXXXXXXXXXXGOOOOOOXXXXXXXXXXXXXGOOOOOOOOOXXXXXXXXXXGOOOOOOOXXXXXXXXXXXXGOOXXXXXXXXXXXXXXXXXGOOOOOOOXXXXXXXXXXXXGOOOXXXXXXXXXXXXXXXXGOOOOOOOOXXXXXXXXXXXGOOOOOOOOOOXXXXXXXXXGOOOXXXXXXXXXXXXXXXX,0,0,0
23457,95,0,95,51,454,0,0,159,70,89,GOOOOOOOOOOOXXXXXXXXGOOOOOOXXXXXXXXXXXXXGOOOOOXXXXXXXXXXXXXXGOOOOOXXXXXXXXXXXXXXGOOOOOOXXXXXXXXXXXXXGOOOOOOOOOXXXXXXXXXXGOOOOOOOXXXXXXXXXXXXGOOXXXXXXXXXXXXXXXXXGOOOOOOOXXXXXXXXXXXXGOOOXXXXXXXXXXXXXXXXGOOOOOOOOXXXXXXXXXXXGOOOOOOOOOOXXXXXXXXXGOOOXXXXXXXXXXXXXXXX,0,0,0
23478,95,0,95,48,457,0,0,163,70,93,GOOOOOOOOOOOXXXXXXXXGOOOOOOXXXXXXXXXXXXXGOOOOOXXXXXXXXXXXXXXGOOOOOXXXXXXXXXXXXXXGOOOOOOXXXXXXXXXXXXXGOOOOOOOOOXXXXXXXXXXGOOOOOOOXXXXXXXXXXXXGOOXXXXXXXXXXXXXXXXXGOOOOOOOXXXXXXXXXXXXGOOOXXXXXXXXXXXXXXXXGOOOOOOOOXXXXXXXXXXXGOOOOOOOOOOXXXXXXXXXGOOOXXXXXXXXXXXXXXXX,0,0,0
23499,95,0,95,46,459,0,0,165,69,96,GOOOOOOOOOOOXXXXXXXXGOOOOOOXXXXXXXXXXXXXGOOOOOXXXXXXXXXXXXXXGOOOOOXXXXXXXXXXXXXXGOOOOOOXXXXXXXXXXXXXGOOOOOOOOOXXXXXXXXXXGOOOOOOOXXXXXXXXXXXXGOOXXXXXXXXXXXXXXXXXGOOOOOOOXXXXXXXXXXXXGOOOXXXXXXXXXXXXXXXXGOOOOOOOOXXXXXXXXXXXGOOOOOOOOOOXXXXXXXXXGOOOXXXXXXXXXXXXXXXX,0,0,0

23520,95,0,95,45,460,0,0,166,74,92,GOOOOOOOOOOOXXXXXXXXGOOOOOOXXXXXXXXXXXXXGOOOOOXXXXXXXXXXXXXXGOOOOOXXXXXXXXXXXXXXGOOOOOOXXXXXXXXXXXXXGOOOOOOOOOXXXXXXXXXXGOOOOOOOXXXXXXXXXXXXGOOXXXXXXXXXXXXXXXXXGOOOOOOOXXXXXXXXXXXXGOOOXXXXXXXXXXXXXXXXGOOOOOOOOXXXXXXXXXXXGOOOOOOOOOOXXXXXXXXXGOOOXXXXXXXXXXXXXXXX,0,0,0
23541,95,0,95,46,459,0,0,165,70,95,GOOOOOOOOOOOXXXXXXXXGOOOOOOXXXXXXXXXXXXXGOOOOOXXXXXXXXXXXXXXGOOOOOXXXXXXXXXXXXXXGOOOOOOXXXXXXXXXXXXXGOOOOOOOOOXXXXXXXXXXGOOOOOOOXXXXXXXXXXXXGOOXXXXXXXXXXXXXXXXXGOOOOOOOXXXXXXXXXXXXGOOOXXXXXXXXXXXXXXXXGOOOOOOOOXXXXXXXXXXXGOOOOOOOOOOXXXXXXXXXGOOOXXXXXXXXXXXXXXXX,0,0,0
23562,95,0,95,46,459,0,0,165,73,92,GOOOOOOOOOOOXXXXXXXXGOOOOOOXXXXXXXXXXXXXGOOOOOXXXXXXXXXXXXXXGOOOOOXXXXXXXXXXXXXXGOOOOOOXXXXXXXXXXXXXGOOOOOOOOOXXXXXXXXXXGOOOOOOOXXXXXXXXXXXXGOOXXXXXXXXXXXXXXXXXGOOOOOOOXXXXXXXXXXXXGOOOXXXXXXXXXXXXXXXXGOOOOOOOOXXXXXXXXXXXGOOOOOOOOOOXXXXXXXXXGOOOXXXXXXXXXXXXXXXX,0,0,0
23583,95,0,95,52,453,0,0,158,70,88,GOOOOOOOOOOOXXXXXXXXGOOOOOOXXXXXXXXXXXXXGOOOOOXXXXXXXXXXXXXXGOOOOOXXXXXXXXXXXXXXGOOOOOOXXXXXXXXXXXXXGOOOOOOOOOXXXXXXXXXXGOOOOOOOXXXXXXXXXXXXGOOXXXXXXXXXXXXXXXXXGOOOOOOOXXXXXXXXXXXXGOOOXXXXXXXXXXXXXXXXGOOOOOOOOXXXXXXXXXXXGOOOOOOOOOOXXXXXXXXXGOOOXXXXXXXXXXXXXXXX,0,0,0
23604,95,0,95,48,457,0,0,163,68,95,GOOOOOOOOOOOXXXXXXXXGOOOOOOXXXXXXXXXXXXXGOOOOOXXXXXXXXXXXXXXGOOOOOXXXXXXXXXXXXXXGOOOOOOXXXXXXXXXXXXXGOOOOOOOOOXXXXXXXXXXGOOOOOOOXXXXXXXXXXXXGOOXXXXXXXXXXXXXXXXXGOOOOOOOXXXXXXXXXXXXGOOOXXXXXXXXXXXXXXXXGOOOOOOOOXXXXXXXXXXXGOOOOOOOOOOXXXXXXXXXGOOOXXXXXXXXXXXXXXXX,0,0,0

23625,95,0,95,47,458,0,0,163,70,93,GOOOOOOOOOOOXXXXXXXXGOOOOOOXXXXXXXXXXXXXGOOOOOXXXXXXXXXXXXXXGOOOOOXXXXXXXXXXXXXXGOOOOOOXXXXXXXXXXXXXGOOOOOOOOOXXXXXXXXXXGOOOOOOOXXXXXXXXXXXXGOOXXXXXXXXXXXXXXXXXGOOOOOOOXXXXXXXXXXXXGOOOXXXXXXXXXXXXXXXXGOOOOOOOOXXXXXXXXXXXGOOOOOOOOOOXXXXXXXXXGOOOXXXXXXXXXXXXXXXX,0,0,0
23646,95,0,95,45,460,0,0,163,70,93,GOOOOOOOOOOOXXXXXXXXGOOOOOOXXXXXXXXXXXXXGOOOOOXXXXXXXXXXXXXXGOOOOOXXXXXXXXXXXXXXGOOOOOOXXXXXXXXXXXXXGOOOOOOOOOXXXXXXXXXXGOOOOOOOXXXXXXXXXXXXGOOXXXXXXXXXXXXXXXXXGOOOOOOOXXXXXXXXXXXXGOOOXXXXXXXXXXXXXXXXGOOOOOOOOXXXXXXXXXXXGOOOOOOOOOOXXXXXXXXXGOOOXXXXXXXXXXXXXXXX,0,0,0
23667,95,0,95,45,460,0,0,165,69,96,GOOOOOOOOOOOXXXXXXXXGOOOOOOXXXXXXXXXXXXXGOOOOOXXXXXXXXXXXXXXGOOOOOXXXXXXXXXXXXXXGOOOOOOXXXXXXXXXXXXXGOOOOOOOOOXXXXXXXXXXGOOOOOOOXXXXXXXXXXXXGOOXXXXXXXXXXXXXXXXXGOOOOOOOXXXXXXXXXXXXGOOOXXXXXXXXXXXXXXXXGOOOOOOOOXXXXXXXXXXXGOOOOOOOOOOXXXXXXXXXGOOOXXXXXXXXXXXXXXXX,0,0,0
23688,95,0,95,44,461,0,0,166,70,96,GOOOOOOOOOOOXXXXXXXXGOOOOOOXXXXXXXXXXXXXGOOOOOXXXXXXXXXXXXXXGOOOOOXXXXXXXXXXXXXXGOOOOOOXXXXXXXXXXXXXGOOOOOOOOOXXXXXXXXXXGOOOOOOOXXXXXXXXXXXXGOOXXXXXXXXXXXXXXXXXGOOOOOOOXXXXXXXXXXXXGOOOXXXXXXXXXXXXXXXXGOOOOOOOOXXXXXXXXXXXGOOOOOOOOOOXXXXXXXXXGOOOXXXXXXXXXXXXXXXX,0,0,0
23709,95,0,95,45,460,0,0,165,70,95,GOOOOOOOOOOOXXXXXXXXGOOOOOOXXXXXXXXXXXXXGOOOOOXXXXXXXXXXXXXXGOOOOOXXXXXXXXXXXXXXGOOOOOOXXXXXXXXXXXXXGOOOOOOOOOXXXXXXXXXXGOOOOOOOXXXXXXXXXXXXGOOXXXXXXXXXXXXXXXXXGOOOOOOOXXXXXXXXXXXXGOOOXXXXXXXXXXXXXXXXGOOOOOOOOXXXXXXXXXXXGOOOOOOOOOOXXXXXXXXXGOOOXXXXXXXXXXXXXXXX,0,0,0

23730,95,0,95,46,459,0,0,164,72,92,GOOOOOOOOOOOXXXXXXXXGOOOOOOXXXXXXXXXXXXXGOOOOOXXXXXXXXXXXXXXGOOOOOXXXXXXXXXXXXXXGOOOOOOXXXXXXXXXXXXXGOOOOOOOOOXXXXXXXXXXGOOOOOOOXXXXXXXXXXXXGOOXXXXXXXXXXXXXXXXXGOOOOOOOXXXXXXXXXXXXGOOOXXXXXXXXXXXXXXXXGOOOOOOOOXXXXXXXXXXXGOOOOOOOOOOXXXXXXXXXGOOOXXXXXXXXXXXXXXXX,0,0,0
23751,95,0,95,50,455,0,0,159,72,87,GOOOOOOOOOOOXXXXXXXXGOOOOOOXXXXXXXXXXXXXGOOOOOXXXXXXXXXXXXXXGOOOOOXXXXXXXXXXXXXXGOOOOOOXXXXXXXXXXXXXGOOOOOOOOOXXXXXXXXXXGOOOOOOOXXXXXXXXXXXXGOOXXXXXXXXXXXXXXXXXGOOOOOOOXXXXXXXXXXXXGOOOXXXXXXXXXXXXXXXXGOOOOOOOOXXXXXXXXXXXGOOOOOOOOOOXXXXXXXXXGOOOXXXXXXXXXXXXXXXX,0,0,0
23772,95,0,95,52,453,0,0,158,71,87,GOOOOOOOOOOOXXXXXXXXGOOOOOOXXXXXXXXXXXXXGOOOOOXXXXXXXXXXXXXXGOOOOOXXXXXXXXXXXXXXGOOOOOOXXXXXXXXXXXXXGOOOOOOOOOXXXXXXXXXXGOOOOOOOXXXXXXXXXXXXGOOXXXXXXXXXXXXXXXXXGOOOOOOOXXXXXXXXXXXXGOOOXXXXXXXXXXXXXXXXGOOOOOOOOXXXXXXXXXXXGOOOOOOOOOOXXXXXXXXXGOOOXXXXXXXXXXXXXXXX,0,0,0
23793,95,0,95,51,454,0,0,158,68,90,GOOOOOOOOOOOXXXXXXXXGOOOOOOXXXXXXXXXXXXXGOOOOOXXXXXXXXXXXXXXGOOOOOXXXXXXXXXXXXXXGOOOOOOXXXXXXXXXXXXXGOOOOOOOOOXXXXXXXXXXGOOOOOOOXXXXXXXXXXXXGOOXXXXXXXXXXXXXXXXXGOOOOOOOXXXXXXXXXXXXGOOOXXXXXXXXXXXXXXXXGOOOOOOOOXXXXXXXXXXXGOOOOOOOOOOXXXXXXXXXGOOOXXXXXXXXXXXXXXXX,0,0,0
23814,95,0,95,53,452,0,0,158,73,85,GOOOOOOOOOOOXXXXXXXXGOOOOOOXXXXXXXXXXXXXGOOOOOXXXXXXXXXXXXXXGOOOOOXXXXXXXXXXXXXXGOOOOOOXXXXXXXXXXXXXGOOOOOOOOOXXXXXXXXXXGOOOOOOOXXXXXXXXXXXXGOOXXXXXXXXXXXXXXXXXGOOOOOOOXXXXXXXXXXXXGOOOXXXXXXXXXXXXXXXXGOOOOOOOOXXXXXXXXXXXGOOOOOOOOOOXXXXXXXXXGOOOXXXXXXXXXXXXXXXX,0,0,0

23835,95,0,95,54,451,0,0,158,73,85,GOOOOOOOOOOOXXXXXXXXGOOOOOOXXXXXXXXXXXXXGOOOOOXXXXXXXXXXXXXXGOOOOOXXXXXXXXXXXXXXGOOOOOOXXXXXXXXXXXXXGOOOOOOOOOXXXXXXXXXXGOOOOOOOXXXXXXXXXXXXGOOXXXXXXXXXXXXXXXXXGOOOOOOOXXXXXXXXXXXXGOOOXXXXXXXXXXXXXXXXGOOOOOOOOXXXXXXXXXXXGOOOOOOOOOOXXXXXXXXXGOOOXXXXXXXXXXXXXXXX,0,0,0
23856,95,0,95,57,448,0,0,155,70,85,GOOOOOOOOOOOXXXXXXXXGOOOOOOXXXXXXXXXXXXXGOOOOOXXXXXXXXXXXXXXGOOOOOXXXXXXXXXXXXXXGOOOOOOXXXXXXXXXXXXXGOOOOOOOOOXXXXXXXXXXGOOOOOOOXXXXXXXXXXXXGOOXXXXXXXXXXXXXXXXXGOOOOOOOXXXXXXXXXXXXGOOOXXXXXXXXXXXXXXXXGOOOOOOOOXXXXXXXXXXXGOOOOOOOOOOXXXXXXXXXGOOOXXXXXXXXXXXXXXXX,0,0,0
23877,95,0,95,52,453,0,0,160,75,85,GOOOOOOOOOOOXXXXXXXXGOOOOOOXXXXXXXXXXXXXGOOOOOXXXXXXXXXXXXXXGOOOOOXXXXXXXXXXXXXXGOOOOOOXXXXXXXXXXXXXGOOOOOOOOOXXXXXXXXXXGOOOOOOOXXXXXXXXXXXXGOOXXXXXXXXXXXXXXXXXGOOOOOOOXXXXXXXXXXXXGOOOXXXXXXXXXXXXXXXXGOOOOOOOOXXXXXXXXXXXGOOOOOOOOOOXXXXXXXXXGOOOXXXXXXXXXXXXXXXX,0,0,0
23898,95,0,95,54,451,0,0,158,74,84,GOOOOOOOOOOOXXXXXXXXGOOOOOOXXXXXXXXXXXXXGOOOOOXXXXXXXXXXXXXXGOOOOOXXXXXXXXXXXXXXGOOOOOOXXXXXXXXXXXXXGOOOOOOOOOXXXXXXXXXXGOOOOOOOXXXXXXXXXXXXGOOXXXXXXXXXXXXXXXXXGOOOOOOOXXXXXXXXXXXXGOOOXXXXXXXXXXXXXXXXGOOOOOOOOXXXXXXXXXXXGOOOOOOOOOOXXXXXXXXXGOOOXXXXXXXXXXXXXXXX,0,0,0
23919,95,0,95,53,452,0,0,158,71,87,GOOOOOOOOOOOXXXXXXXXGOOOOOOXXXXXXXXXXXXXGOOOOOXXXXXXXXXXXXXXGOOOOOXXXXXXXXXXXXXXGOOOOOOXXXXXXXXXXXXXGOOOOOOOOOXXXXXXXXXXGOOOOOOOXXXXXXXXXXXXGOOXXXXXXXXXXXXXXXXXGOOOOOOOXXXXXXXXXXXXGOOOXXXXXXXXXXXXXXXXGOOOOOOOOXXXXXXXXXXXGOOOOOOOOOOXXXXXXXXXGOOOXXXXXXXXXXXXXXXX,0,0,0

23940,95,0,95,54,451,0,0,155,73,82,GOOOOOOOOOOOXXXXXXXXGOOOOOOXXXXXXXXXXXXXGOOOOOXXXXXXXXXXXXXXGOOOOOXXXXXXXXXXXXXXGOOOOOOXXXXXXXXXXXXXGOOOOOOOOOXXXXXXXXXXGOOOOOOOXXXXXXXXXXXXGOOXXXXXXXXXXXXXXXXXGOOOOOOOXXXXXXXXXXXXGOOOXXXXXXXXXXXXXXXXGOOOOOOOOXXXXXXXXXXXGOOOOOOOOOOXXXXXXXXXGOOOXXXXXXXXXXXXXXXX,0,0,0
23961,95,0,95,53,452,0,0,157,70,87,GOOOOOOOOOOOXXXXXXXXGOOOOOOXXXXXXXXXXXXXGOOOOOXXXXXXXXXXXXXXGOOOOOXXXXXXXXXXXXXXGOOOOOOXXXXXXXXXXXXXGOOOOOOOOOXXXXXXXXXXGOOOOOOOXXXXXXXXXXXXGOOXXXXXXXXXXXXXXXXXGOOOOOOOXXXXXXXXXXXXGOOOXXXXXXXXXXXXXXXXGOOOOOOOOXXXXXXXXXXXGOOOOOOOOOOXXXXXXXXXGOOOXXXXXXXXXXXXXXXX,0,0,0
23982,95,0,95,48,457,0,0,161,71,90,GOOOOOOOOOOOXXXXXXXXGOOOOOOXXXXXXXXXXXXXGOOOOOXXXXXXXXXXXXXXGOOOOOXXXXXXXXXXXXXXGOOOOOOXXXXXXXXXXXXXGOOOOOOOOOXXXXXXXXXXGOOOOOOOXXXXXXXXXXXXGOOXXXXXXXXXXXXXXXXXGOOOOOOOXXXXXXXXXXXXGOOOXXXXXXXXXXXXXXXXGOOOOOOOOXXXXXXXXXXXGOOOOOOOOOOXXXXXXXXXGOOOXXXXXXXXXXXXXXXX,0,0,0
24003,96,1,95,48,456,0,0,160,71,89,GOOOOOOOOOOOXXXXXXXXGOOOOOOXXXXXXXXXXXXXGOOOOOXXXXXXXXXXXXXXGOOOOOAXXXXXXXXXXXXXGOOOOOOXXXXXXXXXXXXXGOOOOOOOOOXXXXXXXXXXGOOOOOOOXXXXXXXXXXXXGOOXXXXXXXXXXXXXXXXXGOOOOOOOXXXXXXXXXXXXGOOOXXXXXXXXXXXXXXXXGOOOOOOOOXXXXXXXXXXXGOOOOOOOOOOXXXXXXXXXGOOOXXXXXXXXXXXXXXXX,0,0,0
24024,96,1,95,54,450,0,0,156,69,87,GOOOOOOOOOOOXXXXXXXXGOOOOOOXXXXXXXXXXXXXGOOOOOXXXXXXXXXXXXXXGOOOOOAXXXXXXXXXXXXXGOOOOOOXXXXXXXXXXXXXGOOOOOOOOOXXXXXXXXXXGOOOOOOOXXXXXXXXXXXXGOOXXXXXXXXXXXXXXXXXGOOOOOOOXXXXXXXXXXXXGOOOXXXXXXXXXXXXXXXXGOOOOOOOOXXXXXXXXXXXGOOOOOOOOOOXXXXXXXXXGOOOXXXXXXXXXXXXXXXX,0,0,0

24045,96,1,95,49,455,0,0,161,71,90,GOOOOOOOOOOOXXXXXXXXGOOOOOOXXXXXXXXXXXXXGOOOOOXXXXXXXXXXXXXXGOOOOOAXXXXXXXXXXXXXGOOOOOOXXXXXXXXXXXXXGOOOOOOOOOXXXXXXXXXXGOOOOOOOXXXXXXXXXXXXGOOXXXXXXXXXXXXXXXXXGOOOOOOOXXXXXXXXXXXXGOOOXXXXXXXXXXXXXXXXGOOOOOOOOXXXXXXXXXXXGOOOOOOOOOOXXXXXXXXXGOOOXXXXXXXXXXXXXXXX,0,0,0
24066,96,1,95,51,453,0,0,159,73,86,GOOOOOOOOOOOXXXXXXXXGOOOOOOXXXXXXXXXXXXXGOOOOOXXXXXXXXXXXXXXGOOOOOAXXXXXXXXXXXXXGOOOOOOXXXXXXXXXXXXXGOOOOOOOOOXXXXXXXXXXGOOOOOOOXXXXXXXXXXXXGOOXXXXXXXXXXXXXXXXXGOOOOOOOXXXXXXXXXXXXGOOOXXXXXXXXXXXXXXXXGOOOOOOOOXXXXXXXXXXXGOOOOOOOOOOXXXXXXXXXGOOOXXXXXXXXXXXXXXXX,0,0,0
24087,96,1,95,54,450,0,0,156,72,84,GOOOOOOOOOOOXXXXXXXXGOOOOOOXXXXXXXXXXXXXGOOOOOXXXXXXXXXXXXXXGOOOOOAXXXXXXXXXXXXXGOOOOOOXXXXXXXXXXXXXGOOOOOOOOOXXXXXXXXXXGOOOOOOOXXXXXXXXXXXXGOOXXXXXXXXXXXXXXXXXGOOOOOOOXXXXXXXXXXXXGOOOXXXXXXXXXXXXXXXXGOOOOOOOOXXXXXXXXXXXGOOOOOOOOOOXXXXXXXXXGOOOXXXXXXXXXXXXXXXX,0,0,0
24108,96,0,96,56,448,0,0,154,70,84,GOOOOOOOOOOOXXXXXXXXGOOOOOOXXXXXXXXXXXXXGOOOOOXXXXXXXXXXXXXXGOOOOOOXXXXXXXXXXXXXGOOOOOOXXXXXXXXXXXXXGOOOOOOOOOXXXXXXXXXXGOOOOOOOXXXXXXXXXXXXGOOXXXXXXXXXXXXXXXXXGOOOOOOOXXXXXXXXXXXXGOOOXXXXXXXXXXXXXXXXGOOOOOOOOXXXXXXXXXXXGOOOOOOOOOOXXXXXXXXXGOOOXXXXXXXXXXXXXXXX,0,0,0
24129,96,0,96,54,450,0,0,155,72,83,GOOOOOOOOOOOXXXXXXXXGOOOOOOXXXXXXXXXXXXXGOOOOOXXXXXXXXXXXXXXGOOOOOOXXXXXXXXXXXXXGOOOOOOXXXXXXXXXXXXXGOOOOOOOOOXXXXXXXXXXGOOOOOOOXXXXXXXXXXXXGOOXXXXXXXXXXXXXXXXXGOOOOOOOXXXXXXXXXXXXGOOOXXXXXXXXXXXXXXXXGOOOOOOOOXXXXXXXXXXXGOOOOOOOOOOXXXXXXXXXGOOOXXXXXXXXXXXXXXXX,0,0,0

24150,96,0,96,53,451,0,0,157,75,82,GOOOOOOOOOOOXXXXXXXXGOOOOOOXXXXXXXXXXXXXGOOOOOXXXXXXXXXXXXXXGOOOOOOXXXXXXXXXXXXXGOOOOOOXXXXXXXXXXXXXGOOOOOOOOOXXXXXXXXXXGOOOOOOOXXXXXXXXXXXXGOOXXXXXXXXXXXXXXXXXGOOOOOOOXXXXXXXXXXXXGOOOXXXXXXXXXXXXXXXXGOOOOOOOOXXXXXXXXXXXGOOOOOOOOOOXXXXXXXXXGOOOXXXXXXXXXXXXXXXX,0,0,0
24171,96,0,96,53,451,0,0,157,70,87,GOOOOOOOOOOOXXXXXXXXGOOOOOOXXXXXXXXXXXXXGOOOOOXXXXXXXXXXXXXXGOOOOOOXXXXXXXXXXXXXGOOOOOOXXXXXXXXXXXXXGOOOOOOOOOXXXXXXXXXXGOOOOOOOXXXXXXXXXXXXGOOXXXXXXXXXXXXXXXXXGOOOOOOOXXXXXXXXXXXXGOOOXXXXXXXXXXXXXXXXGOOOOOOOOXXXXXXXXXXXGOOOOOOOOOOXXXXXXXXXGOOOXXXXXXXXXXXXXXXX,0,0,0
24192,96,0,96,52,452,0,0,159,69,90,GOOOOOOOOOOOXXXXXXXXGOOOOOOXXXXXXXXXXXXXGOOOOOXXXXXXXXXXXXXXGOOOOOOXXXXXXXXXXXXXGOOOOOOXXXXXXXXXXXXXGOOOOOOOOOXXXXXXXXXXGOOOOOOOXXXXXXXXXXXXGOOXXXXXXXXXXXXXXXXXGOOOOOOOXXXXXXXXXXXXGOOOXXXXXXXXXXXXXXXXGOOOOOOOOXXXXXXXXXXXGOOOOOOOOOOXXXXXXXXXGOOOXXXXXXXXXXXXXXXX,0,0,0
24213,96,0,96,49,455,0,0,161,70,91,GOOOOOOOOOOOXXXXXXXXGOOOOOOXXXXXXXXXXXXXGOOOOOXXXXXXXXXXXXXXGOOOOOOXXXXXXXXXXXXXGOOOOOOXXXXXXXXXXXXXGOOOOOOOOOXXXXXXXXXXGOOOOOOOXXXXXXXXXXXXGOOXXXXXXXXXXXXXXXXXGOOOOOOOXXXXXXXXXXXXGOOOXXXXXXXXXXXXXXXXGOOOOOOOOXXXXXXXXXXXGOOOOOOOOOOXXXXXXXXXGOOOXXXXXXXXXXXXXXXX,0,0,0
24234,96,0,96,48,456,0,0,162,73,89,GOOOOOOOOOOOXXXXXXXXGOOOOOOXXXXXXXXXXXXXGOOOOOXXXXXXXXXXXXXXGOOOOOOXXXXXXXXXXXXXGOOOOOOXXXXXXXXXXXXXGOOOOOOOOOXXXXXXXXXXGOOOOOOOXXXXXXXXXXXXGOOXXXXXXXXXXXXXXXXXGOOOOOOOXXXXXXXXXXXXGOOOXXXXXXXXXXXXXXXXGOOOOOOOOXXXXXXXXXXXGOOOOOOOOOOXXXXXXXXXGOOOXXXXXXXXXXXXXXXX,0,0,0

24255,96,0,96,50,454,0,0,161,76,85,GOOOOOOOOOOOXXXXXXXXGOOOOOOXXXXXXXXXXXXXGOOOOOXXXXXXXXXXXXXXGOOOOOOXXXXXXXXXXXXXGOOOOOOXXXXXXXXXXXXXGOOOOOOOOOXXXXXXXXXXGOOOOOOOXXXXXXXXXXXXGOOXXXXXXXXXXXXXXXXXGOOOOOOOXXXXXXXXXXXXGOOOXXXXXXXXXXXXXXXXGOOOOOOOOXXXXXXXXXXXGOOOOOOOOOOXXXXXXXXXGOOOXXXXXXXXXXXXXXXX,0,0,0
24276,96,0,96,51,453,0,0,159,75,84,GOOOOOOOOOOOXXXXXXXXGOOOOOOXXXXXXXXXXXXXGOOOOOXXXXXXXXXXXXXXGOOOOOOXXXXXXXXXXXXXGOOOOOOXXXXXXXXXXXXXGOOOOOOOOOXXXXXXXXXXGOOOOOOOXXXXXXXXXXXXGOOXXXXXXXXXXXXXXXXXGOOOOOOOXXXXXXXXXXXXGOOOXXXXXXXXXXXXXXXXGOOOOOOOOXXXXXXXXXXXGOOOOOOOOOOXXXXXXXXXGOOOXXXXXXXXXXXXXXXX,0,0,0
24297,96,0,96,51,453,0,0,160,73,87,GOOOOOOOOOOOXXXXXXXXGOOOOOOXXXXXXXXXXXXXGOOOOOXXXXXXXXXXXXXXGOOOOOOXXXXXXXXXXXXXGOOOOOOXXXXXXXXXXXXXGOOOOOOOOOXXXXXXXXXXGOOOOOOOXXXXXXXXXXXXGOOXXXXXXXXXXXXXXXXXGOOOOOOOXXXXXXXXXXXXGOOOXXXXXXXXXXXXXXXXGOOOOOOOOXXXXXXXXXXXGOOOOOOOOOOXXXXXXXXXGOOOXXXXXXXXXXXXXXXX,0,0,0
24318,96,0,96,48,456,0,0,164,73,91,GOOOOOOOOOOOXXXXXXXXGOOOOOOXXXXXXXXXXXXXGOOOOOXXXXXXXXXXXXXXGOOOOOOXXXXXXXXXXXXXGOOOOOOXXXXXXXXXXXXXGOOOOOOOOOXXXXXXXXXXGOOOOOOOXXXXXXXXXXXXGOOXXXXXXXXXXXXXXXXXGOOOOOOOXXXXXXXXXXXXGOOOXXXXXXXXXXXXXXXXGOOOOOOOOXXXXXXXXXXXGOOOOOOOOOOXXXXXXXXXGOOOXXXXXXXXXXXXXXXX,0,0,0
24339,96,0,96,49,455,0,0,161,74,87,GOOOOOOOOOOOXXXXXXXXGOOOOOOXXXXXXXXXXXXXGOOOOOXXXXXXXXXXXXXXGOOOOOOXXXXXXXXXXXXXGOOOOOOXXXXXXXXXXXXXGOOOOOOOOOXXXXXXXXXXGOOOOOOOXXXXXXXXXXXXGOOXXXXXXXXXXXXXXXXXGOOOOOOOXXXXXXXXXXXXGOOOXXXXXXXXXXXXXXXXGOOOOOOOOXXXXXXXXXXXGOOOOOOOOOOXXXXXXXXXGOOOXXXXXXXXXXXXXXXX,0,0,0

24360,96,0,96,49,455,0,0,161,74,87,GOOOOOOOOOOOXXXXXXXXGOOOOOOXXXXXXXXXXXXXGOOOOOXXXXXXXXXXXXXXGOOOOOOXXXXXXXXXXXXXGOOOOOOXXXXXXXXXXXXXGOOOOOOOOOXXXXXXXXXXGOOOOOOOXXXXXXXXXXXXGOOXXXXXXXXXXXXXXXXXGOOOOOOOXXXXXXXXXXXXGOOOXXXXXXXXXXXXXXXXGOOOOOOOOXXXXXXXXXXXGOOOOOOOOOOXXXXXXXXXGOOOXXXXXXXXXXXXXXXX,0,0,0
24381,96,0,96,56,448,0,0,154,73,81,GOOOOOOOOOOOXXXXXXXXGOOOOOOXXXXXXXXXXXXXGOOOOOXXXXXXXXXXXXXXGOOOOOOXXXXXXXXXXXXXGOOOOOOXXXXXXXXXXXXXGOOOOOOOOOXXXXXXXXXXGOOOOOOOXXXXXXXXXXXXGOOXXXXXXXXXXXXXXXXXGOOOOOOOXXXXXXXXXXXXGOOOXXXXXXXXXXXXXXXXGOOOOOOOOXXXXXXXXXXXGOOOOOOOOOOXXXXXXXXXGOOOXXXXXXXXXXXXXXXX,0,0,0
24402,96,0,96,48,456,0,0,161,73,88,GOOOOOOOOOOOXXXXXXXXGOOOOOOXXXXXXXXXXXXXGOOOOOXXXXXXXXXXXXXXGOOOOOOXXXXXXXXXXXXXGOOOOOOXXXXXXXXXXXXXGOOOOOOOOOXXXXXXXXXXGOOOOOOOXXXXXXXXXXXXGOOXXXXXXXXXXXXXXXXXGOOOOOOOXXXXXXXXXXXXGOOOXXXXXXXXXXXXXXXXGOOOOOOOOXXXXXXXXXXXGOOOOOOOOOOXXXXXXXXXGOOOXXXXXXXXXXXXXXXX,0,0,0
24423,96,0,96,50,454,0,0,159,72,87,GOOOOOOOOOOOXXXXXXXXGOOOOOOXXXXXXXXXXXXXGOOOOOXXXXXXXXXXXXXXGOOOOOOXXXXXXXXXXXXXGOOOOOOXXXXXXXXXXXXXGOOOOOOOOOXXXXXXXXXXGOOOOOOOXXXXXXXXXXXXGOOXXXXXXXXXXXXXXXXXGOOOOOOOXXXXXXXXXXXXGOOOXXXXXXXXXXXXXXXXGOOOOOOOOXXXXXXXXXXXGOOOOOOOOOOXXXXXXXXXGOOOXXXXXXXXXXXXXXXX,0,0,0
24444,96,0,96,50,454,0,0,160,71,89,GOOOOOOOOOOOXXXXXXXXGOOOOOOXXXXXXXXXXXXXGOOOOOXXXXXXXXXXXXXXGOOOOOOXXXXXXXXXXXXXGOOOOOOXXXXXXXXXXXXXGOOOOOOOOOXXXXXXXXXXGOOOOOOOXXXXXXXXXXXXGOOXXXXXXXXXXXXXXXXXGOOOOOOOXXXXXXXXXXXXGOOOXXXXXXXXXXXXXXXXGOOOOOOOOXXXXXXXXXXXGOOOOOOOOOOXXXXXXXXXGOOOXXXXXXXXXXXXXXXX,0,0,0

24465,96,0,96,46,458,0,0,164,71,93,GOOOOOOOOOOOXXXXXXXXGOOOOOOXXXXXXXXXXXXXGOOOOOXXXXXXXXXXXXXXGOOOOOOXXXXXXXXXXXXXGOOOOOOXXXXXXXXXXXXXGOOOOOOOOOXXXXXXXXXXGOOOOOOOXXXXXXXXXXXXGOOXXXXXXXXXXXXXXXXXGOOOOOOOXXXXXXXXXXXXGOOOXXXXXXXXXXXXXXXXGOOOOOOOOXXXXXXXXXXXGOOOOOOOOOOXXXXXXXXXGOOOXXXXXXXXXXXXXXXX,0,0,0
24486,96,0,96,46,458,0,0,164,69,95,GOOOOOOOOOOOXXXXXXXXGOOOOOOXXXXXXXXXXXXXGOOOOOXXXXXXXXXXXXXXGOOOOOOXXXXXXXXXXXXXGOOOOOOXXXXXXXXXXXXXGOOOOOOOOOXXXXXXXXXXGOOOOOOOXXXXXXXXXXXXGOOXXXXXXXXXXXXXXXXXGOOOOOOOXXXXXXXXXXXXGOOOXXXXXXXXXXXXXXXXGOOOOOOOOXXXXXXXXXXXGOOOOOOOOOOXXXXXXXXXGOOOXXXXXXXXXXXXXXXX,0,0,0
24507,96,0,96,45,459,0,0,165,69,96,GOOOOOOOOOOOXXXXXXXXGOOOOOOXXXXXXXXXXXXXGOOOOOXXXXXXXXXXXXXXGOOOOOOXXXXXXXXXXXXXGOOOOOOXXXXXXXXXXXXXGOOOOOOOOOXXXXXXXXXXGOOOOOOOXXXXXXXXXXXXGOOXXXXXXXXXXXXXXXXXGOOOOOOOXXXXXXXXXXXXGOOOXXXXXXXXXXXXXXXXGOOOOOOOOXXXXXXXXXXXGOOOOOOOOOOXXXXXXXXXGOOOXXXXXXXXXXXXXXXX,0,0,0
24528,96,0,96,42,462,0,0,168,75,93,GOOOOOOOOOOOXXXXXXXXGOOOOOOXXXXXXXXXXXXXGOOOOOXXXXXXXXXXXXXXGOOOOOOXXXXXXXXXXXXXGOOOOOOXXXXXXXXXXXXXGOOOOOOOOOXXXXXXXXXXGOOOOOOOXXXXXXXXXXXXGOOXXXXXXXXXXXXXXXXXGOOOOOOOXXXXXXXXXXXXGOOOXXXXXXXXXXXXXXXXGOOOOOOOOXXXXXXXXXXXGOOOOOOOOOOXXXXXXXXXGOOOXXXXXXXXXXXXXXXX,0,0,0
24549,97,1,96,40,463,0,0,169,75,94,GOOOOOOOOOOOXXXXXXXXGOOOOOOAXXXXXXXXXXXXGOOOOOXXXXXXXXXXXXXXGOOOOOOXXXXXXXXXXXXXGOOOOOOXXXXXXXXXXXXXGOOOOOOOOOXXXXXXXXXXGOOOOOOOXXXXXXXXXXXXGOOXXXXXXXXXXXXXXXXXGOOOOOOOXXXXXXXXXXXXGOOOXXXXXXXXXXXXXXXXGOOOOOOOOXXXXXXXXXXXGOOOOOOOOOOXXXXXXXXXGOOOXXXXXXXXXXXXXXXX,0,0,0

24570,97,1,96,41,462,0,0,168,71,97,GOOOOOOOOOOOXXXXXXXXGOOOOOOAXXXXXXXXXXXXGOOOOOXXXXXXXXXXXXXXGOOOOOOXXXXXXXXXXXXXGOOOOOOXXXXXXXXXXXXXGOOOOOOOOOXXXXXXXXXXGOOOOOOOXXXXXXXXXXXXGOOXXXXXXXXXXXXXXXXXGOOOOOOOXXXXXXXXXXXXGOOOXXXXXXXXXXXXXXXXGOOOOOOOOXXXXXXXXXXXGOOOOOOOOOOXXXXXXXXXGOOOXXXXXXXXXXXXXXXX,0,0,0
24591,97,1,96,37,466,0,0,172,70,102,GOOOOOOOOOOOXXXXXXXXGOOOOOOAXXXXXXXXXXXXGOOOOOXXXXXXXXXXXXXXGOOOOOOXXXXXXXXXXXXXGOOOOOOXXXXXXXXXXXXXGOOOOOOOOOXXXXXXXXXXGOOOOOOOXXXXXXXXXXXXGOOXXXXXXXXXXXXXXXXXGOOOOOOOXXXXXXXXXXXXGOOOXXXXXXXXXXXXXXXXGOOOOOOOOXXXXXXXXXXXGOOOOOOOOOOXXXXXXXXXGOOOXXXXXXXXXXXXXXXX,0,0,0
24612,97,1,96,40,463,0,0,170,74,96,GOOOOOOOOOOOXXXXXXXXGOOOOOOAXXXXXXXXXXXXGOOOOOXXXXXXXXXXXXXXGOOOOOOXXXXXXXXXXXXXGOOOOOOXXXXXXXXXXXXXGOOOOOOOOOXXXXXXXXXXGOOOOOOOXXXXXXXXXXXXGOOXXXXXXXXXXXXXXXXXGOOOOOOOXXXXXXXXXXXXGOOOXXXXXXXXXXXXXXXXGOOOOOOOOXXXXXXXXXXXGOOOOOOOOOOXXXXXXXXXGOOOXXXXXXXXXXXXXXXX,0,0,0
24633,97,1,96,40,463,0,0,169,74,95,GOOOOOOOOOOOXXXXXXXXGOOOOOOAXXXXXXXXXXXXGOOOOOXXXXXXXXXXXXXXGOOOOOOXXXXXXXXXXXXXGOOOOOOXXXXXXXXXXXXXGOOOOOOOOOXXXXXXXXXXGOOOOOOOXXXXXXXXXXXXGOOXXXXXXXXXXXXXXXXXGOOOOOOOXXXXXXXXXXXXGOOOXXXXXXXXXXXXXXXXGOOOOOOOOXXXXXXXXXXXGOOOOOOOOOOXXXXXXXXXGOOOXXXXXXXXXXXXXXXX,0,0,0
24654,97,1,96,43,460,0,0,166,71,95,GOOOOOOOOOOOXXXXXXXXGOOOOOOAXXXXXXXXXXXXGOOOOOXXXXXXXXXXXXXXGOOOOOOXXXXXXXXXXXXXGOOOOOOXXXXXXXXXXXXXGOOOOOOOOOXXXXXXXXXXGOOOOOOOXXXXXXXXXXXXGOOXXXXXXXXXXXXXXXXXGOOOOOOOXXXXXXXXXXXXGOOOXXXXXXXXXXXXXXXXGOOOOOOOOXXXXXXXXXXXGOOOOOOOOOOXXXXXXXXXGOOOXXXXXXXXXXXXXXXX,0,0,0

24675,97,0,97,41,462,0,0,168,74,94,GOOOOOOOOOOOXXXXXXXXGOOOOOOOXXXXXXXXXXXXGOOOOOXXXXXXXXXXXXXXGOOOOOOXXXXXXXXXXXXXGOOOOOOXXXXXXXXXXXXXGOOOOOOOOOXXXXXXXXXXGOOOOOOOXXXXXXXXXXXXGOOXXXXXXXXXXXXXXXXXGOOOOOOOXXXXXXXXXXXXGOOOXXXXXXXXXXXXXXXXGOOOOOOOOXXXXXXXXXXXGOOOOOOOOOOXXXXXXXXXGOOOXXXXXXXXXXXXXXXX,0,0,0
24696,97,0,97,45,458,0,0,164,73,91,GOOOOOOOOOOOXXXXXXXXGOOOOOOOXXXXXXXXXXXXGOOOOOXXXXXXXXXXXXXXGOOOOOOXXXXXXXXXXXXXGOOOOOOXXXXXXXXXXXXXGOOOOOOOOOXXXXXXXXXXGOOOOOOOXXXXXXXXXXXXGOOXXXXXXXXXXXXXXXXXGOOOOOOOXXXXXXXXXXXXGOOOXXXXXXXXXXXXXXXXGOOOOOOOOXXXXXXXXXXXGOOOOOOOOOOXXXXXXXXXGOOOXXXXXXXXXXXXXXXX,0,0,0
24717,97,0,97,46,457,0,0,163,70,93,GOOOOOOOOOOOXXXXXXXXGOOOOOOOXXXXXXXXXXXXGOOOOOXXXXXXXXXXXXXXGOOOOOOXXXXXXXXXXXXXGOOOOOOXXXXXXXXXXXXXGOOOOOOOOOXXXXXXXXXXGOOOOOOOXXXXXXXXXXXXGOOXXXXXXXXXXXXXXXXXGOOOOOOOXXXXXXXXXXXXGOOOXXXXXXXXXXXXXXXXGOOOOOOOOXXXXXXXXXXXGOOOOOOOOOOXXXXXXXXXGOOOXXXXXXXXXXXXXXXX,0,0,0
24738,97,0,97,39,464,0,0,170,73,97,GOOOOOOOOOOOXXXXXXXXGOOOOOOOXXXXXXXXXXXXGOOOOOXXXXXXXXXXXXXXGOOOOOOXXXXXXXXXXXXXGOOOOOOXXXXXXXXXXXXXGOOOOOOOOOXXXXXXXXXXGOOOOOOOXXXXXXXXXXXXGOOXXXXXXXXXXXXXXXXXGOOOOOOOXXXXXXXXXXXXGOOOXXXXXXXXXXXXXXXXGOOOOOOOOXXXXXXXXXXXGOOOOOOOOOOXXXXXXXXXGOOOXXXXXXXXXXXXXXXX,0,0,0
24759,97,0,97,42,461,0,0,166,73,93,GOOOOOOOOOOOXXXXXXXXGOOOOOOOXXXXXXXXXXXXGOOOOOXXXXXXXXXXXXXXGOOOOOOXXXXXXXXXXXXXGOOOOOOXXXXXXXXXXXXXGOOOOOOOOOXXXXXXXXXXGOOOOOOOXXXXXXXXXXXXGOOXXXXXXXXXXXXXXXXXGOOOOOOOXXXXXXXXXXXXGOOOXXXXXXXXXXXXXXXXGOOOOOOOOXXXXXXXXXXXGOOOOOOOOOOXXXXXXXXXGOOOXXXXXXXXXXXXXXXX,0,0,0

24780,97,0,97,43,460,0,0,166,74,92,GOOOOOOOOOOOXXXXXXXXGOOOOOOOXXXXXXXXXXXXGOOOOOXXXXXXXXXXXXXXGOOOOOOXXXXXXXXXXXXXGOOOOOOXXXXXXXXXXXXXGOOOOOOOOOXXXXXXXXXXGOOOOOOOXXXXXXXXXXXXGOOXXXXXXXXXXXXXXXXXGOOOOOOOXXXXXXXXXXXXGOOOXXXXXXXXXXXXXXXXGOOOOOOOOXXXXXXXXXXXGOOOOOOOOOOXXXXXXXXXGOOOXXXXXXXXXXXXXXXX,0,0,0
24801,97,0,97,41,462,0,0,168,74,94,GOOOOOOOOOOOXXXXXXXXGOOOOOOOXXXXXXXXXXXXGOOOOOXXXXXXXXXXXXXXGOOOOOOXXXXXXXXXXXXXGOOOOOOXXXXXXXXXXXXXGOOOOOOOOOXXXXXXXXXXGOOOOOOOXXXXXXXXXXXXGOOXXXXXXXXXXXXXXXXXGOOOOOOOXXXXXXXXXXXXGOOOXXXXXXXXXXXXXXXXGOOOOOOOOXXXXXXXXXXXGOOOOOOOOOOXXXXXXXXXGOOOXXXXXXXXXXXXXXXX,0,0,0
24822,97,0,97,47,456,0,0,162,71,91,GOOOOOOOOOOOXXXXXXXXGOOOOOOOXXXXXXXXXXXXGOOOOOXXXXXXXXXXXXXXGOOOOOOXXXXXXXXXXXXXGOOOOOOXXXXXXXXXXXXXGOOOOOOOOOXXXXXXXXXXGOOOOOOOXXXXXXXXXXXXGOOXXXXXXXXXXXXXXXXXGOOOOOOOXXXXXXXXXXXXGOOOXXXXXXXXXXXXXXXXGOOOOOOOOXXXXXXXXXXXGOOOOOOOOOOXXXXXXXXXGOOOXXXXXXXXXXXXXXXX,0,0,0
24843,98,1,97,49,453,0,0,159,71,88,GOOOOOOOOOOOXXXXXXXXGOOOOOOOXXXXXXXXXXXXGOOOOOXXXXXXXXXXXXXXGOOOOOOXXXXXXXXXXXXXGOOOOOOXXXXXXXXXXXXXGOOOOOOOOOXXXXXXXXXXGOOOOOOOXXXXXXXXXXXXGOOXXXXXXXXXXXXXXXXXGOOOOOOOXXXXXXXXXXXXGOOOXXXXXXXXXXXXXXXXGOOOOOOOOXXXXXXXXXXXGOOOOOOOOOOAXXXXXXXXGOOOXXXXXXXXXXXXXXXX,0,0,0
24864,98,0,98,49,453,0,0,159,71,88,GOOOOOOOOOOOXXXXXXXXGOOOOOOOXXXXXXXXXXXXGOOOOOXXXXXXXXXXXXXXGOOOOOOXXXXXXXXXXXXXGOOOOOOXXXXXXXXXXXXXGOOOOOOOOOXXXXXXXXXXGOOOOOOOXXXXXXXXXXXXGOOXXXXXXXXXXXXXXXXXGOOOOOOOXXXXXXXXXXXXGOOOXXXXXXXXXXXXXXXXGOOOOOOOOXXXXXXXXXXXGOOOOOOOOOOOXXXXXXXXGOOOXXXXXXXXXXXXXXXX,0,0,0

24885,98,0,98,45,457,0,0,162,74,88,GOOOOOOOOOOOXXXXXXXXGOOOOOOOXXXXXXXXXXXXGOOOOOXXXXXXXXXXXXXXGOOOOOOXXXXXXXXXXXXXGOOOOOOXXXXXXXXXXXXXGOOOOOOOOOXXXXXXXXXXGOOOOOOOXXXXXXXXXXXXGOOXXXXXXXXXXXXXXXXXGOOOOOOOXXXXXXXXXXXXGOOOXXXXXXXXXXXXXXXXGOOOOOOOOXXXXXXXXXXXGOOOOOOOOOOOXXXXXXXXGOOOXXXXXXXXXXXXXXXX,0,0,0
24906,98,0,98,47,455,0,0,160,75,85,GOOOOOOOOOOOXXXXXXXXGOOOOOOOXXXXXXXXXXXXGOOOOOXXXXXXXXXXXXXXGOOOOOOXXXXXXXXXXXXXGOOOOOOXXXXXXXXXXXXXGOOOOOOOOOXXXXXXXXXXGOOOOOOOXXXXXXXXXXXXGOOXXXXXXXXXXXXXXXXXGOOOOOOOXXXXXXXXXXXXGOOOXXXXXXXXXXXXXXXXGOOOOOOOOXXXXXXXXXXXGOOOOOOOOOOOXXXXXXXXGOOOXXXXXXXXXXXXXXXX,0,0,0
24927,98,0,98,51,451,0,0,157,73,84,GOOOOOOOOOOOXXXXXXXXGOOOOOOOXXXXXXXXXXXXGOOOOOXXXXXXXXXXXXXXGOOOOOOXXXXXXXXXXXXXGOOOOOOXXXXXXXXXXXXXGOOOOOOOOOXXXXXXXXXXGOOOOOOOXXXXXXXXXXXXGOOXXXXXXXXXXXXXXXXXGOOOOOOOXXXXXXXXXXXXGOOOXXXXXXXXXXXXXXXXGOOOOOOOOXXXXXXXXXXXGOOOOOOOOOOOXXXXXXXXGOOOXXXXXXXXXXXXXXXX,0,0,0
24948,98,0,98,49,453,0,0,158,74,84,GOOOOOOOOOOOXXXXXXXXGOOOOOOOXXXXXXXXXXXXGOOOOOXXXXXXXXXXXXXXGOOOOOOXXXXXXXXXXXXXGOOOOOOXXXXXXXXXXXXXGOOOOOOOOOXXXXXXXXXXGOOOOOOOXXXXXXXXXXXXGOOXXXXXXXXXXXXXXXXXGOOOOOOOXXXXXXXXXXXXGOOOXXXXXXXXXXXXXXXXGOOOOOOOOXXXXXXXXXXXGOOOOOOOOOOOXXXXXXXXGOOOXXXXXXXXXXXXXXXX,0,0,0
24969,99,1,98,50,451,0,0,157,79,78,GOOOOOOOOOOOXXXXXXXXGOOOOOOOXXXXXXXXXXXXGOOOOOXXXXXXXXXXXXXXGOOOOOOXXXXXXXXXXXXXGOOOOOOXXXXXXXXXXXXXGOOOOOOOOOAXXXXXXXXXGOOOOOOOXXXXXXXXXXXXGOOXXXXXXXXXXXXXXXXXGOOOOOOOXXXXXXXXXXXXGOOOXXXXXXXXXXXXXXXXGOOOOOOOOXXXXXXXXXXXGOOOOOOOOOOOXXXXXXXXGOOOXXXXXXXXXXXXXXXX,0,0,0

24990,99,1,98,51,450,0,0,156,77,79,GOOOOOOOOOOOXXXXXXXXGOOOOOOOXXXXXXXXXXXXGOOOOOXXXXXXXXXXXXXXGOOOOOOXXXXXXXXXXXXXGOOOOOOXXXXXXXXXXXXXGOOOOOOOOOAXXXXXXXXXGOOOOOOOXXXXXXXXXXXXGOOXXXXXXXXXXXXXXXXXGOOOOOOOXXXXXXXXXXXXGOOOXXXXXXXXXXXXXXXXGOOOOOOOOXXXXXXXXXXXGOOOOOOOOOOOXXXXXXXXGOOOXXXXXXXXXXXXXXXX,0,0,0
25011,99,0,99,54,447,0,0,153,76,77,GOOOOOOOOOOOXXXXXXXXGOOOOOOOXXXXXXXXXXXXGOOOOOXXXXXXXXXXXXXXGOOOOOOXXXXXXXXXXXXXGOOOOOOXXXXXXXXXXXXXGOOOOOOOOOOXXXXXXXXXGOOOOOOOXXXXXXXXXXXXGOOXXXXXXXXXXXXXXXXXGOOOOOOOXXXXXXXXXXXXGOOOXXXXXXXXXXXXXXXXGOOOOOOOOXXXXXXXXXXXGOOOOOOOOOOOXXXXXXXXGOOOXXXXXXXXXXXXXXXX,0,0,0
25032,99,0,99,53,448,0,0,155,78,77,GOOOOOOOOOOOXXXXXXXXGOOOOOOOXXXXXXXXXXXXGOOOOOXXXXXXXXXXXXXXGOOOOOOXXXXXXXXXXXXXGOOOOOOXXXXXXXXXXXXXGOOOOOOOOOOXXXXXXXXXGOOOOOOOXXXXXXXXXXXXGOOXXXXXXXXXXXXXXXXXGOOOOOOOXXXXXXXXXXXXGOOOXXXXXXXXXXXXXXXXGOOOOOOOOXXXXXXXXXXXGOOOOOOOOOOOXXXXXXXXGOOOXXXXXXXXXXXXXXXX,0,0,0
25053,99,0,99,58,443,0,0,149,75,74,GOOOOOOOOOOOXXXXXXXXGOOOOOOOXXXXXXXXXXXXGOOOOOXXXXXXXXXXXXXXGOOOOOOXXXXXXXXXXXXXGOOOOOOXXXXXXXXXXXXXGOOOOOOOOOOXXXXXXXXXGOOOOOOOXXXXXXXXXXXXGOOXXXXXXXXXXXXXXXXXGOOOOOOOXXXXXXXXXXXXGOOOXXXXXXXXXXXXXXXXGOOOOOOOOXXXXXXXXXXXGOOOOOOOOOOOXXXXXXXXGOOOXXXXXXXXXXXXXXXX,0,0,0
25074,99,0,99,59,442,0,0,148,78,70,GOOOOOOOOOOOXXXXXXXXGOOOOOOOXXXXXXXXXXXXGOOOOOXXXXXXXXXXXXXXGOOOOOOXXXXXXXXXXXXXGOOOOOOXXXXXXXXXXXXXGOOOOOOOOOOXXXXXXXXXGOOOOOOOXXXXXXXXXXXXGOOXXXXXXXXXXXXXXXXXGOOOOOOOXXXXXXXXXXXXGOOOXXXXXXXXXXXXXXXXGOOOOOOOOXXXXXXXXXXXGOOOOOOOOOOOXXXXXXXXGOOOXXXXXXXXXXXXXXXX,0,0,0

25095,99,0,99,58,443,0,0,149,79,70,GOOOOOOOOOOOXXXXXXXXGOOOOOOOXXXXXXXXXXXXGOOOOOXXXXXXXXXXXXXXGOOOOOOXXXXXXXXXXXXXGOOOOOOXXXXXXXXXXXXXGOOOOOOOOOOXXXXXXXXXGOOOOOOOXXXXXXXXXXXXGOOXXXXXXXXXXXXXXXXXGOOOOOOOXXXXXXXXXXXXGOOOXXXXXXXXXXXXXXXXGOOOOOOOOXXXXXXXXXXXGOOOOOOOOOOOXXXXXXXXGOOOXXXXXXXXXXXXXXXX,0,0,0
25116,99,0,99,60,441,0,0,147,74,73,GOOOOOOOOOOOXXXXXXXXGOOOOOOOXXXXXXXXXXXXGOOOOOXXXXXXXXXXXXXXGOOOOOOXXXXXXXXXXXXXGOOOOOOXXXXXXXXXXXXXGOOOOOOOOOOXXXXXXXXXGOOOOOOOXXXXXXXXXXXXGOOXXXXXXXXXXXXXXXXXGOOOOOOOXXXXXXXXXXXXGOOOXXXXXXXXXXXXXXXXGOOOOOOOOXXXXXXXXXXXGOOOOOOOOOOOXXXXXXXXGOOOXXXXXXXXXXXXXXXX,0,0,0
25137,99,0,99,55,446,0,0,152,75,77,GOOOOOOOOOOOXXXXXXXXGOOOOOOOXXXXXXXXXXXXGOOOOOXXXXXXXXXXXXXXGOOOOOOXXXXXXXXXXXXXGOOOOOOXXXXXXXXXXXXXGOOOOOOOOOOXXXXXXXXXGOOOOOOOXXXXXXXXXXXXGOOXXXXXXXXXXXXXXXXXGOOOOOOOXXXXXXXXXXXXGOOOXXXXXXXXXXXXXXXXGOOOOOOOOXXXXXXXXXXXGOOOOOOOOOOOXXXXXXXXGOOOXXXXXXXXXXXXXXXX,0,0,0
25158,99,0,99,55,446,0,0,152,75,77,GOOOOOOOOOOOXXXXXXXXGOOOOOOOXXXXXXXXXXXXGOOOOOXXXXXXXXXXXXXXGOOOOOOXXXXXXXXXXXXXGOOOOOOXXXXXXXXXXXXXGOOOOOOOOOOXXXXXXXXXGOOOOOOOXXXXXXXXXXXXGOOXXXXXXXXXXXXXXXXXGOOOOOOOXXXXXXXXXXXXGOOOXXXXXXXXXXXXXXXXGOOOOOOOOXXXXXXXXXXXGOOOOOOOOOOOXXXXXXXXGOOOXXXXXXXXXXXXXXXX,0,0,0
25179,99,0,99,57,444,0,0,150,76,74,GOOOOOOOOOOOXXXXXXXXGOOOOOOOXXXXXXXXXXXXGOOOOOXXXXXXXXXXXXXXGOOOOOOXXXXXXXXXXXXXGOOOOOOXXXXXXXXXXXXXGOOOOOOOOOOXXXXXXXXXGOOOOOOOXXXXXXXXXXXXGOOXXXXXXXXXXXXXXXXXGOOOOOOOXXXXXXXXXXXXGOOOXXXXXXXXXXXXXXXXGOOOOOOOOXXXXXXXXXXXGOOOOOOOOOOOXXXXXXXXGOOOXXXXXXXXXXXXXXXX,0,0,0

25200,99,0,99,56,445,0,0,151,75,76,GOOOOOOOOOOOXXXXXXXXGOOOOOOOXXXXXXXXXXXXGOOOOOXXXXXXXXXXXXXXGOOOOOOXXXXXXXXXXXXXGOOOOOOXXXXXXXXXXXXXGOOOOOOOOOOXXXXXXXXXGOOOOOOOXXXXXXXXXXXXGOOXXXXXXXXXXXXXXXXXGOOOOOOOXXXXXXXXXXXXGOOOXXXXXXXXXXXXXXXXGOOOOOOOOXXXXXXXXXXXGOOOOOOOOOOOXXXXXXXXGOOOXXXXXXXXXXXXXXXX,0,0,0
25221,99,0,99,55,446,0,0,152,74,78,GOOOOOOOOOOOXXXXXXXXGOOOOOOOXXXXXXXXXXXXGOOOOOXXXXXXXXXXXXXXGOOOOOOXXXXXXXXXXXXXGOOOOOOXXXXXXXXXXXXXGOOOOOOOOOOXXXXXXXXXGOOOOOOOXXXXXXXXXXXXGOOXXXXXXXXXXXXXXXXXGOOOOOOOXXXXXXXXXXXXGOOOXXXXXXXXXXXXXXXXGOOOOOOOOXXXXXXXXXXXGOOOOOOOOOOOXXXXXXXXGOOOXXXXXXXXXXXXXXXX,0,0,0
25242,99,0,99,48,453,0,0,159,73,86,GOOOOOOOOOOOXXXXXXXXGOOOOOOOXXXXXXXXXXXXGOOOOOXXXXXXXXXXXXXXGOOOOOOXXXXXXXXXXXXXGOOOOOOXXXXXXXXXXXXXGOOOOOOOOOOXXXXXXXXXGOOOOOOOXXXXXXXXXXXXGOOXXXXXXXXXXXXXXXXXGOOOOOOOXXXXXXXXXXXXGOOOXXXXXXXXXXXXXXXXGOOOOOOOOXXXXXXXXXXXGOOOOOOOOOOOXXXXXXXXGOOOXXXXXXXXXXXXXXXX,0,0,0
25263,99,0,99,40,461,0,0,167,75,92,GOOOOOOOOOOOXXXXXXXXGOOOOOOOXXXXXXXXXXXXGOOOOOXXXXXXXXXXXXXXGOOOOOOXXXXXXXXXXXXXGOOOOOOXXXXXXXXXXXXXGOOOOOOOOOOXXXXXXXXXGOOOOOOOXXXXXXXXXXXXGOOXXXXXXXXXXXXXXXXXGOOOOOOOXXXXXXXXXXXXGOOOXXXXXXXXXXXXXXXXGOOOOOOOOXXXXXXXXXXXGOOOOOOOOOOOXXXXXXXXGOOOXXXXXXXXXXXXXXXX,0,0,0
25284,99,0,99,46,455,0,0,162,74,88,GOOOOOOOOOOOXXXXXXXXGOOOOOOOXXXXXXXXXXXXGOOOOOXXXXXXXXXXXXXXGOOOOOOXXXXXXXXXXXXXGOOOOOOXXXXXXXXXXXXXGOOOOOOOOOOXXXXXXXXXGOOOOOOOXXXXXXXXXXXXGOOXXXXXXXXXXXXXXXXXGOOOOOOOXXXXXXXXXXXXGOOOXXXXXXXXXXXXXXXXGOOOOOOOOXXXXXXXXXXXGOOOOOOOOOOOXXXXXXXXGOOOXXXXXXXXXXXXXXXX,0,0,0

25305,99,0,99,48,453,0,0,160,74,86,GOOOOOOOOOOOXXXXXXXXGOOOOOOOXXXXXXXXXXXXGOOOOOXXXXXXXXXXXXXXGOOOOOOXXXXXXXXXXXXXGOOOOOOXXXXXXXXXXXXXGOOOOOOOOOOXXXXXXXXXGOOOOOOOXXXXXXXXXXXXGOOXXXXXXXXXXXXXXXXXGOOOOOOOXXXXXXXXXXXXGOOOXXXXXXXXXXXXXXXXGOOOOOOOOXXXXXXXXXXXGOOOOOOOOOOOXXXXXXXXGOOOXXXXXXXXXXXXXXXX,0,0,0
25326,99,0,99,47,454,0,0,161,74,87,GOOOOOOOOOOOXXXXXXXXGOOOOOOOXXXXXXXXXXXXGOOOOOXXXXXXXXXXXXXXGOOOOOOXXXXXXXXXXXXXGOOOOOOXXXXXXXXXXXXXGOOOOOOOOOOXXXXXXXXXGOOOOOOOXXXXXXXXXXXXGOOXXXXXXXXXXXXXXXXXGOOOOOOOXXXXXXXXXXXXGOOOXXXXXXXXXXXXXXXXGOOOOOOOOXXXXXXXXXXXGOOOOOOOOOOOXXXXXXXXGOOOXXXXXXXXXXXXXXXX,0,0,0
25347,99,0,99,49,452,0,0,158,74,84,GOOOOOOOOOOOXXXXXXXXGOOOOOOOXXXXXXXXXXXXGOOOOOXXXXXXXXXXXXXXGOOOOOOXXXXXXXXXXXXXGOOOOOOXXXXXXXXXXXXXGOOOOOOOOOOXXXXXXXXXGOOOOOOOXXXXXXXXXXXXGOOXXXXXXXXXXXXXXXXXGOOOOOOOXXXXXXXXXXXXGOOOXXXXXXXXXXXXXXXXGOOOOOOOOXXXXXXXXXXXGOOOOOOOOOOOXXXXXXXXGOOOXXXXXXXXXXXXXXXX,0,0,0
25368,99,0,99,44,457,0,0,163,78,85,GOOOOOOOOOOOXXXXXXXXGOOOOOOOXXXXXXXXXXXXGOOOOOXXXXXXXXXXXXXXGOOOOOOXXXXXXXXXXXXXGOOOOOOXXXXXXXXXXXXXGOOOOOOOOOOXXXXXXXXXGOOOOOOOXXXXXXXXXXXXGOOXXXXXXXXXXXXXXXXXGOOOOOOOXXXXXXXXXXXXGOOOXXXXXXXXXXXXXXXXGOOOOOOOOXXXXXXXXXXXGOOOOOOOOOOOXXXXXXXXGOOOXXXXXXXXXXXXXXXX,0,0,0
25389,99,0,99,43,458,0,0,164,77,87,GOOOOOOOOOOOXXXXXXXXGOOOOOOOXXXXXXXXXXXXGOOOOOXXXXXXXXXXXXXXGOOOOOOXXXXXXXXXXXXXGOOOOOOXXXXXXXXXXXXXGOOOOOOOOOOXXXXXXXXXGOOOOOOOXXXXXXXXXXXXGOOXXXXXXXXXXXXXXXXXGOOOOOOOXXXXXXXXXXXXGOOOXXXXXXXXXXXXXXXXGOOOOOOOOXXXXXXXXXXXGOOOOOOOOOOOXXXXXXXXGOOOXXXXXXXXXXXXXXXX,0,0,0

25410,99,0,99,48,453,0,0,159,78,81,GOOOOOOOOOOOXXXXXXXXGOOOOOOOXXXXXXXXXXXXGOOOOOXXXXXXXXXXXXXXGOOOOOOXXXXXXXXXXXXXGOOOOOOXXXXXXXXXXXXXGOOOOOOOOOOXXXXXXXXXGOOOOOOOXXXXXXXXXXXXGOOXXXXXXXXXXXXXXXXXGOOOOOOOXXXXXXXXXXXXGOOOXXXXXXXXXXXXXXXXGOOOOOOOOXXXXXXXXXXXGOOOOOOOOOOOXXXXXXXXGOOOXXXXXXXXXXXXXXXX,0,0,0
25431,99,0,99,47,454,0,0,161,81,80,GOOOOOOOOOOOXXXXXXXXGOOOOOOOXXXXXXXXXXXXGOOOOOXXXXXXXXXXXXXXGOOOOOOXXXXXXXXXXXXXGOOOOOOXXXXXXXXXXXXXGOOOOOOOOOOXXXXXXXXXGOOOOOOOXXXXXXXXXXXXGOOXXXXXXXXXXXXXXXXXGOOOOOOOXXXXXXXXXXXXGOOOXXXXXXXXXXXXXXXXGOOOOOOOOXXXXXXXXXXXGOOOOOOOOOOOXXXXXXXXGOOOXXXXXXXXXXXXXXXX,0,0,0
25452,100,1,99,48,452,0,0,159,77,82,GOOOOOOOOOOOXXXXXXXXGOOOOOOOXXXXXXXXXXXXGOOOOOXXXXXXXXXXXXXXGOOOOOOAXXXXXXXXXXXXGOOOOOOXXXXXXXXXXXXXGOOOOOOOOOOXXXXXXXXXGOOOOOOOXXXXXXXXXXXXGOOXXXXXXXXXXXXXXXXXGOOOOOOOXXXXXXXXXXXXGOOOXXXXXXXXXXXXXXXXGOOOOOOOOXXXXXXXXXXXGOOOOOOOOOOOXXXXXXXXGOOOXXXXXXXXXXXXXXXX,0,0,0
25473,100,1,99,47,453,0,0,160,74,86,GOOOOOOOOOOOXXXXXXXXGOOOOOOOXXXXXXXXXXXXGOOOOOXXXXXXXXXXXXXXGOOOOOOAXXXXXXXXXXXXGOOOOOOXXXXXXXXXXXXXGOOOOOOOOOOXXXXXXXXXGOOOOOOOXXXXXXXXXXXXGOOXXXXXXXXXXXXXXXXXGOOOOOOOXXXXXXXXXXXXGOOOXXXXXXXXXXXXXXXXGOOOOOOOOXXXXXXXXXXXGOOOOOOOOOOOXXXXXXXXGOOOXXXXXXXXXXXXXXXX,0,0,0
25494,100,1,99,48,452,0,0,159,75,84,GOOOOOOOOOOOXXXXXXXXGOOOOOOOXXXXXXXXXXXXGOOOOOXXXXXXXXXXXXXXGOOOOOOAXXXXXXXXXXXXGOOOOOOXXXXXXXXXXXXXGOOOOOOOOOOXXXXXXXXXGOOOOOOOXXXXXXXXXXXXGOOXXXXXXXXXXXXXXXXXGOOOOOOOXXXXXXXXXXXXGOOOXXXXXXXXXXXXXXXXGOOOOOOOOXXXXXXXXXXXGOOOOOOOOOOOXXXXXXXXGOOOXXXXXXXXXXXXXXXX,0,0,0

25515,100,0,100,43,457,0,0,163,75,88,GOOOOOOOOOOOXXXXXXXXGOOOOOOOXXXXXXXXXXXXGOOOOOXXXXXXXXXXXXXXGOOOOOOOXXXXXXXXXXXXGOOOOOOXXXXXXXXXXXXXGOOOOOOOOOOXXXXXXXXXGOOOOOOOXXXXXXXXXXXXGOOXXXXXXXXXXXXXXXXXGOOOOOOOXXXXXXXXXXXXGOOOXXXXXXXXXXXXXXXXGOOOOOOOOXXXXXXXXXXXGOOOOOOOOOOOXXXXXXXXGOOOXXXXXXXXXXXXXXXX,0,0,0
25536,100,0,100,40,460,0,0,166,74,92,GOOOOOOOOOOOXXXXXXXXGOOOOOOOXXXXXXXXXXXXGOOOOOXXXXXXXXXXXXXXGOOOOOOOXXXXXXXXXXXXGOOOOOOXXXXXXXXXXXXXGOOOOOOOOOOXXXXXXXXXGOOOOOOOXXXXXXXXXXXXGOOXXXXXXXXXXXXXXXXXGOOOOOOOXXXXXXXXXXXXGOOOXXXXXXXXXXXXXXXXGOOOOOOOOXXXXXXXXXXXGOOOOOOOOOOOXXXXXXXXGOOOXXXXXXXXXXXXXXXX,0,0,0
25557,100,0,100,43,457,0,0,163,76,87,GOOOOOOOOOOOXXXXXXXXGOOOOOOOXXXXXXXXXXXXGOOOOOXXXXXXXXXXXXXXGOOOOOOOXXXXXXXXXXXXGOOOOOOXXXXXXXXXXXXXGOOOOOOOOOOXXXXXXXXXGOOOOOOOXXXXXXXXXXXXGOOXXXXXXXXXXXXXXXXXGOOOOOOOXXXXXXXXXXXXGOOOXXXXXXXXXXXXXXXXGOOOOOOOOXXXXXXXXXXXGOOOOOOOOOOOXXXXXXXXGOOOXXXXXXXXXXXXXXXX,0,0,0
25578,100,0,100,45,455,0,0,161,77,84,GOOOOOOOOOOOXXXXXXXXGOOOOOOOXXXXXXXXXXXXGOOOOOXXXXXXXXXXXXXXGOOOOOOOXXXXXXXXXXXXGOOOOOOXXXXXXXXXXXXXGOOOOOOOOOOXXXXXXXXXGOOOOOOOXXXXXXXXXXXXGOOXXXXXXXXXXXXXXXXXGOOOOOOOXXXXXXXXXXXXGOOOXXXXXXXXXXXXXXXXGOOOOOOOOXXXXXXXXXXXGOOOOOOOOOOOXXXXXXXXGOOOXXXXXXXXXXXXXXXX,0,0,0
25599,100,0,100,49,451,0,0,157,77,80,GOOOOOOOOOOOXXXXXXXXGOOOOOOOXXXXXXXXXXXXGOOOOOXXXXXXXXXXXXXXGOOOOOOOXXXXXXXXXXXXGOOOOOOXXXXXXXXXXXXXGOOOOOOOOOOXXXXXXXXXGOOOOOOOXXXXXXXXXXXXGOOXXXXXXXXXXXXXXXXXGOOOOOOOXXXXXXXXXXXXGOOOXXXXXXXXXXXXXXXXGOOOOOOOOXXXXXXXXXXXGOOOOOOOOOOOXXXXXXXXGOOOXXXXXXXXXXXXXXXX,0,0,0

25620,100,0,100,46,454,0,0,160,81,79,GOOOOOOOOOOOXXXXXXXXGOOOOOOOXXXXXXXXXXXXGOOOOOXXXXXXXXXXXXXXGOOOOOOOXXXXXXXXXXXXGOOOOOOXXXXXXXXXXXXXGOOOOOOOOOOXXXXXXXXXGOOOOOOOXXXXXXXXXXXXGOOXXXXXXXXXXXXXXXXXGOOOOOOOXXXXXXXXXXXXGOOOXXXXXXXXXXXXXXXXGOOOOOOOOXXXXXXXXXXXGOOOOOOOOOOOXXXXXXXXGOOOXXXXXXXXXXXXXXXX,0,0,0
25641,100,0,100,49,451,0,0,157,76,81,GOOOOOOOOOOOXXXXXXXXGOOOOOOOXXXXXXXXXXXXGOOOOOXXXXXXXXXXXXXXGOOOOOOOXXXXXXXXXXXXGOOOOOOXXXXXXXXXXXXXGOOOOOOOOOOXXXXXXXXXGOOOOOOOXXXXXXXXXXXXGOOXXXXXXXXXXXXXXXXXGOOOOOOOXXXXXXXXXXXXGOOOXXXXXXXXXXXXXXXXGOOOOOOOOXXXXXXXXXXXGOOOOOOOOOOOXXXXXXXXGOOOXXXXXXXXXXXXXXXX,0,0,0
25662,100,0,100,51,449,0,0,155,75,80,GOOOOOOOOOOOXXXXXXXXGOOOOOOOXXXXXXXXXXXXGOOOOOXXXXXXXXXXXXXXGOOOOOOOXXXXXXXXXXXXGOOOOOOXXXXXXXXXXXXXGOOOOOOOOOOXXXXXXXXXGOOOOOOOXXXXXXXXXXXXGOOXXXXXXXXXXXXXXXXXGOOOOOOOXXXXXXXXXXXXGOOOXXXXXXXXXXXXXXXXGOOOOOOOOXXXXXXXXXXXGOOOOOOOOOOOXXXXXXXXGOOOXXXXXXXXXXXXXXXX,0,0,0
25683,100,0,100,51,449,0,0,156,72,84,GOOOOOOOOOOOXXXXXXXXGOOOOOOOXXXXXXXXXXXXGOOOOOXXXXXXXXXXXXXXGOOOOOOOXXXXXXXXXXXXGOOOOOOXXXXXXXXXXXXXGOOOOOOOOOOXXXXXXXXXGOOOOOOOXXXXXXXXXXXXGOOXXXXXXXXXXXXXXXXXGOOOOOOOXXXXXXXXXXXXGOOOXXXXXXXXXXXXXXXXGOOOOOOOOXXXXXXXXXXXGOOOOOOOOOOOXXXXXXXXGOOOXXXXXXXXXXXXXXXX,0,0,0
25704,100,0,100,49,451,0,0,157,74,83,GOOOOOOOOOOOXXXXXXXXGOOOOOOOXXXXXXXXXXXXGOOOOOXXXXXXXXXXXXXXGOOOOOOOXXXXXXXXXXXXGOOOOOOXXXXXXXXXXXXXGOOOOOOOOOOXXXXXXXXXGOOOOOOOXXXXXXXXXXXXGOOXXXXXXXXXXXXXXXXXGOOOOOOOXXXXXXXXXXXXGOOOXXXXXXXXXXXXXXXXGOOOOOOOOXXXXXXXXXXXGOOOOOOOOOOOXXXXXXXXGOOOXXXXXXXXXXXXXXXX,0,0,0

25725,100,0,100,46,454,0,0,161,73,88,GOOOOOOOOOOOXXXXXXXXGOOOOOOOXXXXXXXXXXXXGOOOOOXXXXXXXXXXXXXXGOOOOOOOXXXXXXXXXXXXGOOOOOOXXXXXXXXXXXXXGOOOOOOOOOOXXXXXXXXXGOOOOOOOXXXXXXXXXXXXGOOXXXXXXXXXXXXXXXXXGOOOOOOOXXXXXXXXXXXXGOOOXXXXXXXXXXXXXXXXGOOOOOOOOXXXXXXXXXXXGOOOOOOOOOOOXXXXXXXXGOOOXXXXXXXXXXXXXXXX,0,0,0
25746,100,0,100,47,453,0,0,161,74,87,GOOOOOOOOOOOXXXXXXXXGOOOOOOOXXXXXXXXXXXXGOOOOOXXXXXXXXXXXXXXGOOOOOOOXXXXXXXXXXXXGOOOOOOXXXXXXXXXXXXXGOOOOOOOOOOXXXXXXXXXGOOOOOOOXXXXXXXXXXXXGOOXXXXXXXXXXXXXXXXXGOOOOOOOXXXXXXXXXXXXGOOOXXXXXXXXXXXXXXXXGOOOOOOOOXXXXXXXXXXXGOOOOOOOOOOOXXXXXXXXGOOOXXXXXXXXXXXXXXXX,0,0,0
25767,100,0,100,45,455,0,0,163,74,89,GOOOOOOOOOOOXXXXXXXXGOOOOOOOXXXXXXXXXXXXGOOOOOXXXXXXXXXXXXXXGOOOOOOOXXXXXXXXXXXXGOOOOOOXXXXXXXXXXXXXGOOOOOOOOOOXXXXXXXXXGOOOOOOOXXXXXXXXXXXXGOOXXXXXXXXXXXXXXXXXGOOOOOOOXXXXXXXXXXXXGOOOXXXXXXXXXXXXXXXXGOOOOOOOOXXXXXXXXXXXGOOOOOOOOOOOXXXXXXXXGOOOXXXXXXXXXXXXXXXX,0,0,0
25788,100,0,100,41,459,0,0,166,76,90,GOOOOOOOOOOOXXXXXXXXGOOOOOOOXXXXXXXXXXXXGOOOOOXXXXXXXXXXXXXXGOOOOOOOXXXXXXXXXXXXGOOOOOOXXXXXXXXXXXXXGOOOOOOOOOOXXXXXXXXXGOOOOOOOXXXXXXXXXXXXGOOXXXXXXXXXXXXXXXXXGOOOOOOOXXXXXXXXXXXXGOOOXXXXXXXXXXXXXXXXGOOOOOOOOXXXXXXXXXXXGOOOOOOOOOOOXXXXXXXXGOOOXXXXXXXXXXXXXXXX,0,0,0
25809,100,0,100,40,460,0,0,168,74,94,GOOOOOOOOOOOXXXXXXXXGOOOOOOOXXXXXXXXXXXXGOOOOOXXXXXXXXXXXXXXGOOOOOOOXXXXXXXXXXXXGOOOOOOXXXXXXXXXXXXXGOOOOOOOOOOXXXXXXXXXGOOOOOOOXXXXXXXXXXXXGOOXXXXXXXXXXXXXXXXXGOOOOOOOXXXXXXXXXXXXGOOOXXXXXXXXXXXXXXXXGOOOOOOOOXXXXXXXXXXXGOOOOOOOOOOOXXXXXXXXGOOOXXXXXXXXXXXXXXXX,0,0,0

25830,100,0,100,36,464,0,0,172,75,97,GOOOOOOOOOOOXXXXXXXXGOOOOOOOXXXXXXXXXXXXGOOOOOXXXXXXXXXXXXXXGOOOOOOOXXXXXXXXXXXXGOOOOOOXXXXXXXXXXXXXGOOOOOOOOOOXXXXXXXXXGOOOOOOOXXXXXXXXXXXXGOOXXXXXXXXXXXXXXXXXGOOOOOOOXXXXXXXXXXXXGOOOXXXXXXXXXXXXXXXXGOOOOOOOOXXXXXXXXXXXGOOOOOOOOOOOXXXXXXXXGOOOXXXXXXXXXXXXXXXX,0,0,0
25851,100,0,100,38,462,0,0,169,77,92,GOOOOOOOOOOOXXXXXXXXGOOOOOOOXXXXXXXXXXXXGOOOOOXXXXXXXXXXXXXXGOOOOOOOXXXXXXXXXXXXGOOOOOOXXXXXXXXXXXXXGOOOOOOOOOOXXXXXXXXXGOOOOOOOXXXXXXXXXXXXGOOXXXXXXXXXXXXXXXXXGOOOOOOOXXXXXXXXXXXXGOOOXXXXXXXXXXXXXXXXGOOOOOOOOXXXXXXXXXXXGOOOOOOOOOOOXXXXXXXXGOOOXXXXXXXXXXXXXXXX,0,0,0
25872,100,0,100,42,458,0,0,166,75,91,GOOOOOOOOOOOXXXXXXXXGOOOOOOOXXXXXXXXXXXXGOOOOOXXXXXXXXXXXXXXGOOOOOOOXXXXXXXXXXXXGOOOOOOXXXXXXXXXXXXXGOOOOOOOOOOXXXXXXXXXGOOOOOOOXXXXXXXXXXXXGOOXXXXXXXXXXXXXXXXXGOOOOOOOXXXXXXXXXXXXGOOOXXXXXXXXXXXXXXXXGOOOOOOOOXXXXXXXXXXXGOOOOOOOOOOOXXXXXXXXGOOOXXXXXXXXXXXXXXXX,0,0,0
25893,100,0,100,39,461,0,0,170,77,93,GOOOOOOOOOOOXXXXXXXXGOOOOOOOXXXXXXXXXXXXGOOOOOXXXXXXXXXXXXXXGOOOOOOOXXXXXXXXXXXXGOOOOOOXXXXXXXXXXXXXGOOOOOOOOOOXXXXXXXXXGOOOOOOOXXXXXXXXXXXXGOOXXXXXXXXXXXXXXXXXGOOOOOOOXXXXXXXXXXXXGOOOXXXXXXXXXXXXXXXXGOOOOOOOOXXXXXXXXXXXGOOOOOOOOOOOXXXXXXXXGOOOXXXXXXXXXXXXXXXX,0,0,0
25914,100,0,100,44,456,0,0,165,80,85,GOOOOOOOOOOOXXXXXXXXGOOOOOOOXXXXXXXXXXXXGOOOOOXXXXXXXXXXXXXXGOOOOOOOXXXXXXXXXXXXGOOOOOOXXXXXXXXXXXXXGOOOOOOOOOOXXXXXXXXXGOOOOOOOXXXXXXXXXXXXGOOXXXXXXXXXXXXXXXXXGOOOOOOOXXXXXXXXXXXXGOOOXXXXXXXXXXXXXXXXGOOOOOOOOXXXXXXXXXXXGOOOOOOOOOOOXXXXXXXXGOOOXXXXXXXXXXXXXXXX,0,0,0

25935,100,0,100,46,454,0,0,162,78,84,GOOOOOOOOOOOXXXXXXXXGOOOOOOOXXXXXXXXXXXXGOOOOOXXXXXXXXXXXXXXGOOOOOOOXXXXXXXXXXXXGOOOOOOXXXXXXXXXXXXXGOOOOOOOOOOXXXXXXXXXGOOOOOOOXXXXXXXXXXXXGOOXXXXXXXXXXXXXXXXXGOOOOOOOXXXXXXXXXXXXGOOOXXXXXXXXXXXXXXXXGOOOOOOOOXXXXXXXXXXXGOOOOOOOOOOOXXXXXXXXGOOOXXXXXXXXXXXXXXXX,0,0,0
25956,100,0,100,46,454,0,0,163,77,86,GOOOOOOOOOOOXXXXXXXXGOOOOOOOXXXXXXXXXXXXGOOOOOXXXXXXXXXXXXXXGOOOOOOOXXXXXXXXXXXXGOOOOOOXXXXXXXXXXXXXGOOOOOOOOOOXXXXXXXXXGOOOOOOOXXXXXXXXXXXXGOOXXXXXXXXXXXXXXXXXGOOOOOOOXXXXXXXXXXXXGOOOXXXXXXXXXXXXXXXXGOOOOOOOOXXXXXXXXXXXGOOOOOOOOOOOXXXXXXXXGOOOXXXXXXXXXXXXXXXX,0,0,0
25977,100,0,100,39,461,0,0,170,77,93,GOOOOOOOOOOOXXXXXXXXGOOOOOOOXXXXXXXXXXXXGOOOOOXXXXXXXXXXXXXXGOOOOOOOXXXXXXXXXXXXGOOOOOOXXXXXXXXXXXXXGOOOOOOOOOOXXXXXXXXXGOOOOOOOXXXXXXXXXXXXGOOXXXXXXXXXXXXXXXXXGOOOOOOOXXXXXXXXXXXXGOOOXXXXXXXXXXXXXXXXGOOOOOOOOXXXXXXXXXXXGOOOOOOOOOOOXXXXXXXXGOOOXXXXXXXXXXXXXXXX,0,0,0
25998,100,0,100,43,457,0,0,166,78,88,GOOOOOOOOOOOXXXXXXXXGOOOOOOOXXXXXXXXXXXXGOOOOOXXXXXXXXXXXXXXGOOOOOOOXXXXXXXXXXXXGOOOOOOXXXXXXXXXXXXXGOOOOOOOOOOXXXXXXXXXGOOOOOOOXXXXXXXXXXXXGOOXXXXXXXXXXXXXXXXXGOOOOOOOXXXXXXXXXXXXGOOOXXXXXXXXXXXXXXXXGOOOOOOOOXXXXXXXXXXXGOOOOOOOOOOOXXXXXXXXGOOOXXXXXXXXXXXXXXXX,0,0,0
26019,100,0,100,40,460,0,0,166,79,87,GOOOOOOOOOOOXXXXXXXXGOOOOOOOXXXXXXXXXXXXGOOOOOXXXXXXXXXXXXXXGOOOOOOOXXXXXXXXXXXXGOOOOOOXXXXXXXXXXXXXGOOOOOOOOOOXXXXXXXXXGOOOOOOOXXXXXXXXXXXXGOOXXXXXXXXXXXXXXXXXGOOOOOOOXXXXXXXXXXXXGOOOXXXXXXXXXXXXXXXXGOOOOOOOOXXXXXXXXXXXGOOOOOOOOOOOXXXXXXXXGOOOXXXXXXXXXXXXXXXX,0,0,0

26040,100,0,100,41,459,0,0,165,77,88,GOOOOOOOOOOOXXXXXXXXGOOOOOOOXXXXXXXXXXXXGOOOOOXXXXXXXXXXXXXXGOOOOOOOXXXXXXXXXXXXGOOOOOOXXXXXXXXXXXXXGOOOOOOOOOOXXXXXXXXXGOOOOOOOXXXXXXXXXXXXGOOXXXXXXXXXXXXXXXXXGOOOOOOOXXXXXXXXXXXXGOOOXXXXXXXXXXXXXXXXGOOOOOOOOXXXXXXXXXXXGOOOOOOOOOOOXXXXXXXXGOOOXXXXXXXXXXXXXXXX,0,0,0
26061,100,0,100,41,459,0,0,164,78,86,GOOOOOOOOOOOXXXXXXXXGOOOOOOOXXXXXXXXXXXXGOOOOOXXXXXXXXXXXXXXGOOOOOOOXXXXXXXXXXXXGOOOOOOXXXXXXXXXXXXXGOOOOOOOOOOXXXXXXXXXGOOOOOOOXXXXXXXXXXXXGOOXXXXXXXXXXXXXXXXXGOOOOOOOXXXXXXXXXXXXGOOOXXXXXXXXXXXXXXXXGOOOOOOOOXXXXXXXXXXXGOOOOOOOOOOOXXXXXXXXGOOOXXXXXXXXXXXXXXXX,0,0,0
26082,100,0,100,44,456,0,0,162,78,84,GOOOOOOOOOOOXXXXXXXXGOOOOOOOXXXXXXXXXXXXGOOOOOXXXXXXXXXXXXXXGOOOOOOOXXXXXXXXXXXXGOOOOOOXXXXXXXXXXXXXGOOOOOOOOOOXXXXXXXXXGOOOOOOOXXXXXXXXXXXXGOOXXXXXXXXXXXXXXXXXGOOOOOOOXXXXXXXXXXXXGOOOXXXXXXXXXXXXXXXXGOOOOOOOOXXXXXXXXXXXGOOOOOOOOOOOXXXXXXXXGOOOXXXXXXXXXXXXXXXX,0,0,0
26103,100,0,100,46,454,0,0,160,77,83,GOOOOOOOOOOOXXXXXXXXGOOOOOOOXXXXXXXXXXXXGOOOOOXXXXXXXXXXXXXXGOOOOOOOXXXXXXXXXXXXGOOOOOOXXXXXXXXXXXXXGOOOOOOOOOOXXXXXXXXXGOOOOOOOXXXXXXXXXXXXGOOXXXXXXXXXXXXXXXXXGOOOOOOOXXXXXXXXXXXXGOOOXXXXXXXXXXXXXXXXGOOOOOOOOXXXXXXXXXXXGOOOOOOOOOOOXXXXXXXXGOOOXXXXXXXXXXXXXXXX,0,0,0
26124,100,0,100,41,459,0,0,166,78,88,GOOOOOOOOOOOXXXXXXXXGOOOOOOOXXXXXXXXXXXXGOOOOOXXXXXXXXXXXXXXGOOOOOOOXXXXXXXXXXXXGOOOOOOXXXXXXXXXXXXXGOOOOOOOOOOXXXXXXXXXGOOOOOOOXXXXXXXXXXXXGOOXXXXXXXXXXXXXXXXXGOOOOOOOXXXXXXXXXXXXGOOOXXXXXXXXXXXXXXXXGOOOOOOOOXXXXXXXXXXXGOOOOOOOOOOOXXXXXXXXGOOOXXXXXXXXXXXXXXXX,0,0,0

26145,100,0,100,41,459,0,0,167,78,89,GOOOOOOOOOOOXXXXXXXXGOOOOOOOXXXXXXXXXXXXGOOOOOXXXXXXXXXXXXXXGOOOOOOOXXXXXXXXXXXXGOOOOOOXXXXXXXXXXXXXGOOOOOOOOOOXXXXXXXXXGOOOOOOOXXXXXXXXXXXXGOOXXXXXXXXXXXXXXXXXGOOOOOOOXXXXXXXXXXXXGOOOXXXXXXXXXXXXXXXXGOOOOOOOOXXXXXXXXXXXGOOOOOOOOOOOXXXXXXXXGOOOXXXXXXXXXXXXXXXX,0,0,0
26166,100,0,100,41,459,0,0,167,78,89,GOOOOOOOOOOOXXXXXXXXGOOOOOOOXXXXXXXXXXXXGOOOOOXXXXXXXXXXXXXXGOOOOOOOXXXXXXXXXXXXGOOOOOOXXXXXXXXXXXXXGOOOOOOOOOOXXXXXXXXXGOOOOOOOXXXXXXXXXXXXGOOXXXXXXXXXXXXXXXXXGOOOOOOOXXXXXXXXXXXXGOOOXXXXXXXXXXXXXXXXGOOOOOOOOXXXXXXXXXXXGOOOOOOOOOOOXXXXXXXXGOOOXXXXXXXXXXXXXXXX,0,0,0
26187,100,0,100,41,459,0,0,167,81,86,GOOOOOOOOOOOXXXXXXXXGOOOOOOOXXXXXXXXXXXXGOOOOOXXXXXXXXXXXXXXGOOOOOOOXXXXXXXXXXXXGOOOOOOXXXXXXXXXXXXXGOOOOOOOOOOXXXXXXXXXGOOOOOOOXXXXXXXXXXXXGOOXXXXXXXXXXXXXXXXXGOOOOOOOXXXXXXXXXXXXGOOOXXXXXXXXXXXXXXXXGOOOOOOOOXXXXXXXXXXXGOOOOOOOOOOOXXXXXXXXGOOOXXXXXXXXXXXXXXXX,0,0,0
26208,100,0,100,41,459,0,0,167,79,88,GOOOOOOOOOOOXXXXXXXXGOOOOOOOXXXXXXXXXXXXGOOOOOXXXXXXXXXXXXXXGOOOOOOOXXXXXXXXXXXXGOOOOOOXXXXXXXXXXXXXGOOOOOOOOOOXXXXXXXXXGOOOOOOOXXXXXXXXXXXXGOOXXXXXXXXXXXXXXXXXGOOOOOOOXXXXXXXXXXXXGOOOXXXXXXXXXXXXXXXXGOOOOOOOOXXXXXXXXXXXGOOOOOOOOOOOXXXXXXXXGOOOXXXXXXXXXXXXXXXX,0,0,0
26229,100,0,100,43,457,0,0,165,78,87,GOOOOOOOOOOOXXXXXXXXGOOOOOOOXXXXXXXXXXXXGOOOOOXXXXXXXXXXXXXXGOOOOOOOXXXXXXXXXXXXGOOOOOOXXXXXXXXXXXXXGOOOOOOOOOOXXXXXXXXXGOOOOOOOXXXXXXXXXXXXGOOXXXXXXXXXXXXXXXXXGOOOOOOOXXXXXXXXXXXXGOOOXXXXXXXXXXXXXXXXGOOOOOOOOXXXXXXXXXXXGOOOOOOOOOOOXXXXXXXXGOOOXXXXXXXXXXXXXXXX,0,0,0

26250,100,0,100,45,455,0,0,163,78,85,GOOOOOOOOOOOXXXXXXXXGOOOOOOOXXXXXXXXXXXXGOOOOOXXXXXXXXXXXXXXGOOOOOOOXXXXXXXXXXXXGOOOOOOXXXXXXXXXXXXXGOOOOOOOOOOXXXXXXXXXGOOOOOOOXXXXXXXXXXXXGOOXXXXXXXXXXXXXXXXXGOOOOOOOXXXXXXXXXXXXGOOOXXXXXXXXXXXXXXXXGOOOOOOOOXXXXXXXXXXXGOOOOOOOOOOOXXXXXXXXGOOOXXXXXXXXXXXXXXXX,0,0,0
26271,100,0,100,48,452,0,0,161,84,77,GOOOOOOOOOOOXXXXXXXXGOOOOOOOXXXXXXXXXXXXGOOOOOXXXXXXXXXXXXXXGOOOOOOOXXXXXXXXXXXXGOOOOOOXXXXXXXXXXXXXGOOOOOOOOOOXXXXXXXXXGOOOOOOOXXXXXXXXXXXXGOOXXXXXXXXXXXXXXXXXGOOOOOOOXXXXXXXXXXXXGOOOXXXXXXXXXXXXXXXXGOOOOOOOOXXXXXXXXXXXGOOOOOOOOOOOXXXXXXXXGOOOXXXXXXXXXXXXXXXX,0,0,0
26292,100,0,100,48,452,0,0,160,84,76,GOOOOOOOOOOOXXXXXXXXGOOOOOOOXXXXXXXXXXXXGOOOOOXXXXXXXXXXXXXXGOOOOOOOXXXXXXXXXXXXGOOOOOOXXXXXXXXXXXXXGOOOOOOOOOOXXXXXXXXXGOOOOOOOXXXXXXXXXXXXGOOXXXXXXXXXXXXXXXXXGOOOOOOOXXXXXXXXXXXXGOOOXXXXXXXXXXXXXXXXGOOOOOOOOXXXXXXXXXXXGOOOOOOOOOOOXXXXXXXXGOOOXXXXXXXXXXXXXXXX,0,0,0
26313,100,0,100,51,449,0,0,157,80,77,GOOOOOOOOOOOXXXXXXXXGOOOOOOOXXXXXXXXXXXXGOOOOOXXXXXXXXXXXXXXGOOOOOOOXXXXXXXXXXXXGOOOOOOXXXXXXXXXXXXXGOOOOOOOOOOXXXXXXXXXGOOOOOOOXXXXXXXXXXXXGOOXXXXXXXXXXXXXXXXXGOOOOOOOXXXXXXXXXXXXGOOOXXXXXXXXXXXXXXXXGOOOOOOOOXXXXXXXXXXXGOOOOOOOOOOOXXXXXXXXGOOOXXXXXXXXXXXXXXXX,0,0,0
26334,100,0,100,47,453,0,0,160,82,78,GOOOOOOOOOOOXXXXXXXXGOOOOOOOXXXXXXXXXXXXGOOOOOXXXXXXXXXXXXXXGOOOOOOOXXXXXXXXXXXXGOOOOOOXXXXXXXXXXXXXGOOOOOOOOOOXXXXXXXXXGOOOOOOOXXXXXXXXXXXXGOOXXXXXXXXXXXXXXXXXGOOOOOOOXXXXXXXXXXXXGOOOXXXXXXXXXXXXXXXXGOOOOOOOOXXXXXXXXXXXGOOOOOOOOOOOXXXXXXXXGOOOXXXXXXXXXXXXXXXX,0,0,0

26355,100,0,100,48,452,0,0,159,79,80,GOOOOOOOOOOOXXXXXXXXGOOOOOOOXXXXXXXXXXXXGOOOOOXXXXXXXXXXXXXXGOOOOOOOXXXXXXXXXXXXGOOOOOOXXXXXXXXXXXXXGOOOOOOOOOOXXXXXXXXXGOOOOOOOXXXXXXXXXXXXGOOXXXXXXXXXXXXXXXXXGOOOOOOOXXXXXXXXXXXXGOOOXXXXXXXXXXXXXXXXGOOOOOOOOXXXXXXXXXXXGOOOOOOOOOOOXXXXXXXXGOOOXXXXXXXXXXXXXXXX,0,0,0
26376,100,0,100,50,450,0,0,157,78,79,GOOOOOOOOOOOXXXXXXXXGOOOOOOOXXXXXXXXXXXXGOOOOOXXXXXXXXXXXXXXGOOOOOOOXXXXXXXXXXXXGOOOOOOXXXXXXXXXXXXXGOOOOOOOOOOXXXXXXXXXGOOOOOOOXXXXXXXXXXXXGOOXXXXXXXXXXXXXXXXXGOOOOOOOXXXXXXXXXXXXGOOOXXXXXXXXXXXXXXXXGOOOOOOOOXXXXXXXXXXXGOOOOOOOOOOOXXXXXXXXGOOOXXXXXXXXXXXXXXXX,0,0,0
26397,100,0,100,50,450,0,0,156,79,77,GOOOOOOOOOOOXXXXXXXXGOOOOOOOXXXXXXXXXXXXGOOOOOXXXXXXXXXXXXXXGOOOOOOOXXXXXXXXXXXXGOOOOOOXXXXXXXXXXXXXGOOOOOOOOOOXXXXXXXXXGOOOOOOOXXXXXXXXXXXXGOOXXXXXXXXXXXXXXXXXGOOOOOOOXXXXXXXXXXXXGOOOXXXXXXXXXXXXXXXXGOOOOOOOOXXXXXXXXXXXGOOOOOOOOOOOXXXXXXXXGOOOXXXXXXXXXXXXXXXX,0,0,0
26418,100,0,100,43,457,0,0,164,81,83,GOOOOOOOOOOOXXXXXXXXGOOOOOOOXXXXXXXXXXXXGOOOOOXXXXXXXXXXXXXXGOOOOOOOXXXXXXXXXXXXGOOOOOOXXXXXXXXXXXXXGOOOOOOOOOOXXXXXXXXXGOOOOOOOXXXXXXXXXXXXGOOXXXXXXXXXXXXXXXXXGOOOOOOOXXXXXXXXXXXXGOOOXXXXXXXXXXXXXXXXGOOOOOOOOXXXXXXXXXXXGOOOOOOOOOOOXXXXXXXXGOOOXXXXXXXXXXXXXXXX,0,0,0
26439,100,0,100,45,455,0,0,162,79,83,GOOOOOOOOOOOXXXXXXXXGOOOOOOOXXXXXXXXXXXXGOOOOOXXXXXXXXXXXXXXGOOOOOOOXXXXXXXXXXXXGOOOOOOXXXXXXXXXXXXXGOOOOOOOOOOXXXXXXXXXGOOOOOOOXXXXXXXXXXXXGOOXXXXXXXXXXXXXXXXXGOOOOOOOXXXXXXXXXXXXGOOOXXXXXXXXXXXXXXXXGOOOOOOOOXXXXXXXXXXXGOOOOOOOOOOOXXXXXXXXGOOOXXXXXXXXXXXXXXXX,0,0,0

26460,100,0,100,45,455,0,0,162,78,84,GOOOOOOOOOOOXXXXXXXXGOOOOOOOXXXXXXXXXXXXGOOOOOXXXXXXXXXXXXXXGOOOOOOOXXXXXXXXXXXXGOOOOOOXXXXXXXXXXXXXGOOOOOOOOOOXXXXXXXXXGOOOOOOOXXXXXXXXXXXXGOOXXXXXXXXXXXXXXXXXGOOOOOOOXXXXXXXXXXXXGOOOXXXXXXXXXXXXXXXXGOOOOOOOOXXXXXXXXXXXGOOOOOOOOOOOXXXXXXXXGOOOXXXXXXXXXXXXXXXX,0,0,0
26481,100,0,100,45,455,0,0,163,80,83,GOOOOOOOOOOOXXXXXXXXGOOOOOOOXXXXXXXXXXXXGOOOOOXXXXXXXXXXXXXXGOOOOOOOXXXXXXXXXXXXGOOOOOOXXXXXXXXXXXXXGOOOOOOOOOOXXXXXXXXXGOOOOOOOXXXXXXXXXXXXGOOXXXXXXXXXXXXXXXXXGOOOOOOOXXXXXXXXXXXXGOOOXXXXXXXXXXXXXXXXGOOOOOOOOXXXXXXXXXXXGOOOOOOOOOOOXXXXXXXXGOOOXXXXXXXXXXXXXXXX,0,0,0
26502,100,0,100,43,457,0,0,165,80,85,GOOOOOOOOOOOXXXXXXXXGOOOOOOOXXXXXXXXXXXXGOOOOOXXXXXXXXXXXXXXGOOOOOOOXXXXXXXXXXXXGOOOOOOXXXXXXXXXXXXXGOOOOOOOOOOXXXXXXXXXGOOOOOOOXXXXXXXXXXXXGOOXXXXXXXXXXXXXXXXXGOOOOOOOXXXXXXXXXXXXGOOOXXXXXXXXXXXXXXXXGOOOOOOOOXXXXXXXXXXXGOOOOOOOOOOOXXXXXXXXGOOOXXXXXXXXXXXXXXXX,0,0,0
26523,100,0,100,44,456,0,0,164,82,82,GOOOOOOOOOOOXXXXXXXXGOOOOOOOXXXXXXXXXXXXGOOOOOXXXXXXXXXXXXXXGOOOOOOOXXXXXXXXXXXXGOOOOOOXXXXXXXXXXXXXGOOOOOOOOOOXXXXXXXXXGOOOOOOOXXXXXXXXXXXXGOOXXXXXXXXXXXXXXXXXGOOOOOOOXXXXXXXXXXXXGOOOXXXXXXXXXXXXXXXXGOOOOOOOOXXXXXXXXXXXGOOOOOOOOOOOXXXXXXXXGOOOXXXXXXXXXXXXXXXX,0,0,0
26544,100,0,100,44,456,0,0,164,80,84,GOOOOOOOOOOOXXXXXXXXGOOOOOOOXXXXXXXXXXXXGOOOOOXXXXXXXXXXXXXXGOOOOOOOXXXXXXXXXXXXGOOOOOOXXXXXXXXXXXXXGOOOOOOOOOOXXXXXXXXXGOOOOOOOXXXXXXXXXXXXGOOXXXXXXXXXXXXXXXXXGOOOOOOOXXXXXXXXXXXXGOOOXXXXXXXXXXXXXXXXGOOOOOOOOXXXXXXXXXXXGOOOOOOOOOOOXXXXXXXXGOOOXXXXXXXXXXXXXXXX,0,0,0

26565,100,0,100,41,459,0,0,168,79,89,GOOOOOOOOOOOXXXXXXXXGOOOOOOOXXXXXXXXXXXXGOOOOOXXXXXXXXXXXXXXGOOOOOOOXXXXXXXXXXXXGOOOOOOXXXXXXXXXXXXXGOOOOOOOOOOXXXXXXXXXGOOOOOOOXXXXXXXXXXXXGOOXXXXXXXXXXXXXXXXXGOOOOOOOXXXXXXXXXXXXGOOOXXXXXXXXXXXXXXXXGOOOOOOOOXXXXXXXXXXXGOOOOOOOOOOOXXXXXXXXGOOOXXXXXXXXXXXXXXXX,0,0,0
26586,100,0,100,39,461,0,0,170,82,88,GOOOOOOOOOOOXXXXXXXXGOOOOOOOXXXXXXXXXXXXGOOOOOXXXXXXXXXXXXXXGOOOOOOOXXXXXXXXXXXXGOOOOOOXXXXXXXXXXXXXGOOOOOOOOOOXXXXXXXXXGOOOOOOOXXXXXXXXXXXXGOOXXXXXXXXXXXXXXXXXGOOOOOOOXXXXXXXXXXXXGOOOXXXXXXXXXXXXXXXXGOOOOOOOOXXXXXXXXXXXGOOOOOOOOOOOXXXXXXXXGOOOXXXXXXXXXXXXXXXX,0,0,0
26607,100,0,100,42,458,0,0,167,83,84,GOOOOOOOOOOOXXXXXXXXGOOOOOOOXXXXXXXXXXXXGOOOOOXXXXXXXXXXXXXXGOOOOOOOXXXXXXXXXXXXGOOOOOOXXXXXXXXXXXXXGOOOOOOOOOOXXXXXXXXXGOOOOOOOXXXXXXXXXXXXGOOXXXXXXXXXXXXXXXXXGOOOOOOOXXXXXXXXXXXXGOOOXXXXXXXXXXXXXXXXGOOOOOOOOXXXXXXXXXXXGOOOOOOOOOOOXXXXXXXXGOOOXXXXXXXXXXXXXXXX,0,0,0
26628,100,0,100,43,457,0,0,164,78,86,GOOOOOOOOOOOXXXXXXXXGOOOOOOOXXXXXXXXXXXXGOOOOOXXXXXXXXXXXXXXGOOOOOOOXXXXXXXXXXXXGOOOOOOXXXXXXXXXXXXXGOOOOOOOOOOXXXXXXXXXGOOOOOOOXXXXXXXXXXXXGOOXXXXXXXXXXXXXXXXXGOOOOOOOXXXXXXXXXXXXGOOOXXXXXXXXXXXXXXXXGOOOOOOOOXXXXXXXXXXXGOOOOOOOOOOOXXXXXXXXGOOOXXXXXXXXXXXXXXXX,0,0,0
26649,100,0,100,38,462,0,0,168,78,90,GOOOOOOOOOOOXXXXXXXXGOOOOOOOXXXXXXXXXXXXGOOOOOXXXXXXXXXXXXXXGOOOOOOOXXXXXXXXXXXXGOOOOOOXXXXXXXXXXXXXGOOOOOOOOOOXXXXXXXXXGOOOOOOOXXXXXXXXXXXXGOOXXXXXXXXXXXXXXXXXGOOOOOOOXXXXXXXXXXXXGOOOXXXXXXXXXXXXXXXXGOOOOOOOOXXXXXXXXXXXGOOOOOOOOOOOXXXXXXXXGOOOXXXXXXXXXXXXXXXX,0,0,0

26670,100,0,100,38,462,0,0,169,82,87,GOOOOOOOOOOOXXXXXXXXGOOOOOOOXXXXXXXXXXXXGOOOOOXXXXXXXXXXXXXXGOOOOOOOXXXXXXXXXXXXGOOOOOOXXXXXXXXXXXXXGOOOOOOOOOOXXXXXXXXXGOOOOOOOXXXXXXXXXXXXGOOXXXXXXXXXXXXXXXXXGOOOOOOOXXXXXXXXXXXXGOOOXXXXXXXXXXXXXXXXGOOOOOOOOXXXXXXXXXXXGOOOOOOOOOOOXXXXXXXXGOOOXXXXXXXXXXXXXXXX,0,0,0
26691,100,0,100,38,462,0,0,169,81,88,GOOOOOOOOOOOXXXXXXXXGOOOOOOOXXXXXXXXXXXXGOOOOOXXXXXXXXXXXXXXGOOOOOOOXXXXXXXXXXXXGOOOOOOXXXXXXXXXXXXXGOOOOOOOOOOXXXXXXXXXGOOOOOOOXXXXXXXXXXXXGOOXXXXXXXXXXXXXXXXXGOOOOOOOXXXXXXXXXXXXGOOOXXXXXXXXXXXXXXXXGOOOOOOOOXXXXXXXXXXXGOOOOOOOOOOOXXXXXXXXGOOOXXXXXXXXXXXXXXXX,0,0,0
26712,100,0,100,42,458,0,0,164,81,83,GOOOOOOOOOOOXXXXXXXXGOOOOOOOXXXXXXXXXXXXGOOOOOXXXXXXXXXXXXXXGOOOOOOOXXXXXXXXXXXXGOOOOOOXXXXXXXXXXXXXGOOOOOOOOOOXXXXXXXXXGOOOOOOOXXXXXXXXXXXXGOOXXXXXXXXXXXXXXXXXGOOOOOOOXXXXXXXXXXXXGOOOXXXXXXXXXXXXXXXXGOOOOOOOOXXXXXXXXXXXGOOOOOOOOOOOXXXXXXXXGOOOXXXXXXXXXXXXXXXX,0,0,0
26733,100,0,100,45,455,0,0,163,78,85,GOOOOOOOOOOOXXXXXXXXGOOOOOOOXXXXXXXXXXXXGOOOOOXXXXXXXXXXXXXXGOOOOOOOXXXXXXXXXXXXGOOOOOOXXXXXXXXXXXXXGOOOOOOOOOOXXXXXXXXXGOOOOOOOXXXXXXXXXXXXGOOXXXXXXXXXXXXXXXXXGOOOOOOOXXXXXXXXXXXXGOOOXXXXXXXXXXXXXXXXGOOOOOOOOXXXXXXXXXXXGOOOOOOOOOOOXXXXXXXXGOOOXXXXXXXXXXXXXXXX,0,0,0
26754,100,0,100,43,457,0,0,164,80,84,GOOOOOOOOOOOXXXXXXXXGOOOOOOOXXXXXXXXXXXXGOOOOOXXXXXXXXXXXXXXGOOOOOOOXXXXXXXXXXXXGOOOOOOXXXXXXXXXXXXXGOOOOOOOOOOXXXXXXXXXGOOOOOOOXXXXXXXXXXXXGOOXXXXXXXXXXXXXXXXXGOOOOOOOXXXXXXXXXXXXGOOOXXXXXXXXXXXXXXXXGOOOOOOOOXXXXXXXXXXXGOOOOOOOOOOOXXXXXXXXGOOOXXXXXXXXXXXXXXXX,0,0,0

26775,100,0,100,39,461,0,0,168,82,86,GOOOOOOOOOOOXXXXXXXXGOOOOOOOXXXXXXXXXXXXGOOOOOXXXXXXXXXXXXXXGOOOOOOOXXXXXXXXXXXXGOOOOOOXXXXXXXXXXXXXGOOOOOOOOOOXXXXXXXXXGOOOOOOOXXXXXXXXXXXXGOOXXXXXXXXXXXXXXXXXGOOOOOOOXXXXXXXXXXXXGOOOXXXXXXXXXXXXXXXXGOOOOOOOOXXXXXXXXXXXGOOOOOOOOOOOXXXXXXXXGOOOXXXXXXXXXXXXXXXX,0,0,0
26796,100,0,100,42,458,0,0,165,79,86,GOOOOOOOOOOOXXXXXXXXGOOOOOOOXXXXXXXXXXXXGOOOOOXXXXXXXXXXXXXXGOOOOOOOXXXXXXXXXXXXGOOOOOOXXXXXXXXXXXXXGOOOOOOOOOOXXXXXXXXXGOOOOOOOXXXXXXXXXXXXGOOXXXXXXXXXXXXXXXXXGOOOOOOOXXXXXXXXXXXXGOOOXXXXXXXXXXXXXXXXGOOOOOOOOXXXXXXXXXXXGOOOOOOOOOOOXXXXXXXXGOOOXXXXXXXXXXXXXXXX,0,0,0
26817,100,0,100,46,454,0,0,162,77,85,GOOOOOOOOOOOXXXXXXXXGOOOOOOOXXXXXXXXXXXXGOOOOOXXXXXXXXXXXXXXGOOOOOOOXXXXXXXXXXXXGOOOOOOXXXXXXXXXXXXXGOOOOOOOOOOXXXXXXXXXGOOOOOOOXXXXXXXXXXXXGOOXXXXXXXXXXXXXXXXXGOOOOOOOXXXXXXXXXXXXGOOOXXXXXXXXXXXXXXXXGOOOOOOOOXXXXXXXXXXXGOOOOOOOOOOOXXXXXXXXGOOOXXXXXXXXXXXXXXXX,0,0,0
26838,100,0,100,43,457,0,0,165,82,83,GOOOOOOOOOOOXXXXXXXXGOOOOOOOXXXXXXXXXXXXGOOOOOXXXXXXXXXXXXXXGOOOOOOOXXXXXXXXXXXXGOOOOOOXXXXXXXXXXXXXGOOOOOOOOOOXXXXXXXXXGOOOOOOOXXXXXXXXXXXXGOOXXXXXXXXXXXXXXXXXGOOOOOOOXXXXXXXXXXXXGOOOXXXXXXXXXXXXXXXXGOOOOOOOOXXXXXXXXXXXGOOOOOOOOOOOXXXXXXXXGOOOXXXXXXXXXXXXXXXX,0,0,0
26859,100,0,100,42,458,0,0,166,82,84,GOOOOOOOOOOOXXXXXXXXGOOOOOOOXXXXXXXXXXXXGOOOOOXXXXXXXXXXXXXXGOOOOOOOXXXXXXXXXXXXGOOOOOOXXXXXXXXXXXXXGOOOOOOOOOOXXXXXXXXXGOOOOOOOXXXXXXXXXXXXGOOXXXXXXXXXXXXXXXXXGOOOOOOOXXXXXXXXXXXXGOOOXXXXXXXXXXXXXXXXGOOOOOOOOXXXXXXXXXXXGOOOOOOOOOOOXXXXXXXXGOOOXXXXXXXXXXXXXXXX,0,0,0

26880,100,0,100,44,456,0,0,164,79,85,GOOOOOOOOOOOXXXXXXXXGOOOOOOOXXXXXXXXXXXXGOOOOOXXXXXXXXXXXXXXGOOOOOOOXXXXXXXXXXXXGOOOOOOXXXXXXXXXXXXXGOOOOOOOOOOXXXXXXXXXGOOOOOOOXXXXXXXXXXXXGOOXXXXXXXXXXXXXXXXXGOOOOOOOXXXXXXXXXXXXGOOOXXXXXXXXXXXXXXXXGOOOOOOOOXXXXXXXXXXXGOOOOOOOOOOOXXXXXXXXGOOOXXXXXXXXXXXXXXXX,0,0,0
26901,100,0,100,43,457,0,0,165,81,84,GOOOOOOOOOOOXXXXXXXXGOOOOOOOXXXXXXXXXXXXGOOOOOXXXXXXXXXXXXXXGOOOOOOOXXXXXXXXXXXXGOOOOOOXXXXXXXXXXXXXGOOOOOOOOOOXXXXXXXXXGOOOOOOOXXXXXXXXXXXXGOOXXXXXXXXXXXXXXXXXGOOOOOOOXXXXXXXXXXXXGOOOXXXXXXXXXXXXXXXXGOOOOOOOOXXXXXXXXXXXGOOOOOOOOOOOXXXXXXXXGOOOXXXXXXXXXXXXXXXX,0,0,0
26922,100,0,100,44,456,0,0,164,81,83,GOOOOOOOOOOOXXXXXXXXGOOOOOOOXXXXXXXXXXXXGOOOOOXXXXXXXXXXXXXXGOOOOOOOXXXXXXXXXXXXGOOOOOOXXXXXXXXXXXXXGOOOOOOOOOOXXXXXXXXXGOOOOOOOXXXXXXXXXXXXGOOXXXXXXXXXXXXXXXXXGOOOOOOOXXXXXXXXXXXXGOOOXXXXXXXXXXXXXXXXGOOOOOOOOXXXXXXXXXXXGOOOOOOOOOOOXXXXXXXXGOOOXXXXXXXXXXXXXXXX,0,0,0
26943,100,0,100,41,459,0,0,167,82,85,GOOOOOOOOOOOXXXXXXXXGOOOOOOOXXXXXXXXXXXXGOOOOOXXXXXXXXXXXXXXGOOOOOOOXXXXXXXXXXXXGOOOOOOXXXXXXXXXXXXXGOOOOOOOOOOXXXXXXXXXGOOOOOOOXXXXXXXXXXXXGOOXXXXXXXXXXXXXXXXXGOOOOOOOXXXXXXXXXXXXGOOOXXXXXXXXXXXXXXXXGOOOOOOOOXXXXXXXXXXXGOOOOOOOOOOOXXXXXXXXGOOOXXXXXXXXXXXXXXXX,0,0,0
26964,100,0,100,40,460,0,0,168,80,88,GOOOOOOOOOOOXXXXXXXXGOOOOOOOXXXXXXXXXXXXGOOOOOXXXXXXXXXXXXXXGOOOOOOOXXXXXXXXXXXXGOOOOOOXXXXXXXXXXXXXGOOOOOOOOOOXXXXXXXXXGOOOOOOOXXXXXXXXXXXXGOOXXXXXXXXXXXXXXXXXGOOOOOOOXXXXXXXXXXXXGOOOXXXXXXXXXXXXXXXXGOOOOOOOOXXXXXXXXXXXGOOOOOOOOOOOXXXXXXXXGOOOXXXXXXXXXXXXXXXX,0,0,0

26985,100,0,100,42,458,0,0,164,81,83,GOOOOOOOOOOOXXXXXXXXGOOOOOOOXXXXXXXXXXXXGOOOOOXXXXXXXXXXXXXXGOOOOOOOXXXXXXXXXXXXGOOOOOOXXXXXXXXXXXXXGOOOOOOOOOOXXXXXXXXXGOOOOOOOXXXXXXXXXXXXGOOXXXXXXXXXXXXXXXXXGOOOOOOOXXXXXXXXXXXXGOOOXXXXXXXXXXXXXXXXGOOOOOOOOXXXXXXXXXXXGOOOOOOOOOOOXXXXXXXXGOOOXXXXXXXXXXXXXXXX,0,0,0
27006,101,1,100,42,457,0,0,162,79,83,GOOOOOOOOOOOXXXXXXXXGOOOOOOOXXXXXXXXXXXXGOOOOOXXXXXXXXXXXXXXGOOOOOOOXXXXXXXXXXXXGOOOOOOXXXXXXXXXXXXXGOOOOOOOOOOXXXXXXXXXGOOOOOOOXXXXXXXXXXXXGOOXXXXXXXXXXXXXXXXXGOOOOOOOXXXXXXXXXXXXGOOOXXXXXXXXXXXXXXXXGOOOOOOOOAXXXXXXXXXXGOOOOOOOOOOOXXXXXXXXGOOOXXXXXXXXXXXXXXXX,0,0,0
27027,101,1,100,47,452,0,0,158,79,79,GOOOOOOOOOOOXXXXXXXXGOOOOOOOXXXXXXXXXXXXGOOOOOXXXXXXXXXXXXXXGOOOOOOOXXXXXXXXXXXXGOOOOOOXXXXXXXXXXXXXGOOOOOOOOOOXXXXXXXXXGOOOOOOOXXXXXXXXXXXXGOOXXXXXXXXXXXXXXXXXGOOOOOOOXXXXXXXXXXXXGOOOXXXXXXXXXXXXXXXXGOOOOOOOOAXXXXXXXXXXGOOOOOOOOOOOXXXXXXXXGOOOXXXXXXXXXXXXXXXX,0,0,0
27048,101,1,100,48,451,0,0,156,79,77,GOOOOOOOOOOOXXXXXXXXGOOOOOOOXXXXXXXXXXXXGOOOOOXXXXXXXXXXXXXXGOOOOOOOXXXXXXXXXXXXGOOOOOOXXXXXXXXXXXXXGOOOOOOOOOOXXXXXXXXXGOOOOOOOXXXXXXXXXXXXGOOXXXXXXXXXXXXXXXXXGOOOOOOOXXXXXXXXXXXXGOOOXXXXXXXXXXXXXXXXGOOOOOOOOAXXXXXXXXXXGOOOOOOOOOOOXXXXXXXXGOOOXXXXXXXXXXXXXXXX,0,0,0
27069,101,1,100,46,453,0,0,159,77,82,GOOOOOOOOOOOXXXXXXXXGOOOOOOOXXXXXXXXXXXXGOOOOOXXXXXXXXXXXXXXGOOOOOOOXXXXXXXXXXXXGOOOOOOXXXXXXXXXXXXXGOOOOOOOOOOXXXXXXXXXGOOOOOOOXXXXXXXXXXXXGOOXXXXXXXXXXXXXXXXXGOOOOOOOXXXXXXXXXXXXGOOOXXXXXXXXXXXXXXXXGOOOOOOOOAXXXXXXXXXXGOOOOOOOOOOOXXXXXXXXGOOOXXXXXXXXXXXXXXXX,0,0,0

27090,101,1,100,45,454,0,0,160,79,81,GOOOOOOOOOOOXXXXXXXXGOOOOOOOXXXXXXXXXXXXGOOOOOXXXXXXXXXXXXXXGOOOOOOOXXXXXXXXXXXXGOOOOOOXXXXXXXXXXXXXGOOOOOOOOOOXXXXXXXXXGOOOOOOOXXXXXXXXXXXXGOOXXXXXXXXXXXXXXXXXGOOOOOOOXXXXXXXXXXXXGOOOXXXXXXXXXXXXXXXXGOOOOOOOOAXXXXXXXXXXGOOOOOOOOOOOXXXXXXXXGOOOXXXXXXXXXXXXXXXX,0,0,0
27111,101,1,100,45,454,0,0,161,80,81,GOOOOOOOOOOOXXXXXXXXGOOOOOOOXXXXXXXXXXXXGOOOOOXXXXXXXXXXXXXXGOOOOOOOXXXXXXXXXXXXGOOOOOOXXXXXXXXXXXXXGOOOOOOOOOOXXXXXXXXXGOOOOOOOXXXXXXXXXXXXGOOXXXXXXXXXXXXXXXXXGOOOOOOOXXXXXXXXXXXXGOOOXXXXXXXXXXXXXXXXGOOOOOOOOAXXXXXXXXXXGOOOOOOOOOOOXXXXXXXXGOOOXXXXXXXXXXXXXXXX,0,0,0
27132,101,1,100,45,454,0,0,161,80,81,GOOOOOOOOOOOXXXXXXXXGOOOOOOOXXXXXXXXXXXXGOOOOOXXXXXXXXXXXXXXGOOOOOOOXXXXXXXXXXXXGOOOOOOXXXXXXXXXXXXXGOOOOOOOOOOXXXXXXXXXGOOOOOOOXXXXXXXXXXXXGOOXXXXXXXXXXXXXXXXXGOOOOOOOXXXXXXXXXXXXGOOOXXXXXXXXXXXXXXXXGOOOOOOOOAXXXXXXXXXXGOOOOOOOOOOOXXXXXXXXGOOOXXXXXXXXXXXXXXXX,0,0,0
27153,101,1,100,43,456,0,0,163,78,85,GOOOOOOOOOOOXXXXXXXXGOOOOOOOXXXXXXXXXXXXGOOOOOXXXXXXXXXXXXXXGOOOOOOOXXXXXXXXXXXXGOOOOOOXXXXXXXXXXXXXGOOOOOOOOOOXXXXXXXXXGOOOOOOOXXXXXXXXXXXXGOOXXXXXXXXXXXXXXXXXGOOOOOOOXXXXXXXXXXXXGOOOXXXXXXXXXXXXXXXXGOOOOOOOOAXXXXXXXXXXGOOOOOOOOOOOXXXXXXXXGOOOXXXXXXXXXXXXXXXX,0,0,0
27174,101,1,100,47,452,0,0,161,82,79,GOOOOOOOOOOOXXXXXXXXGOOOOOOOXXXXXXXXXXXXGOOOOOXXXXXXXXXXXXXXGOOOOOOOXXXXXXXXXXXXGOOOOOOXXXXXXXXXXXXXGOOOOOOOOOOXXXXXXXXXGOOOOOOOXXXXXXXXXXXXGOOXXXXXXXXXXXXXXXXXGOOOOOOOXXXXXXXXXXXXGOOOXXXXXXXXXXXXXXXXGOOOOOOOOAXXXXXXXXXXGOOOOOOOOOOOXXXXXXXXGOOOXXXXXXXXXXXXXXXX,0,0,0

27195,101,1,100,47,452,0,0,161,81,80,GOOOOOOOOOOOXXXXXXXXGOOOOOOOXXXXXXXXXXXXGOOOOOXXXXXXXXXXXXXXGOOOOOOOXXXXXXXXXXXXGOOOOOOXXXXXXXXXXXXXGOOOOOOOOOOXXXXXXXXXGOOOOOOOXXXXXXXXXXXXGOOXXXXXXXXXXXXXXXXXGOOOOOOOXXXXXXXXXXXXGOOOXXXXXXXXXXXXXXXXGOOOOOOOOAXXXXXXXXXXGOOOOOOOOOOOXXXXXXXXGOOOXXXXXXXXXXXXXXXX,0,0,0
27216,101,0,101,47,452,0,0,161,81,80,GOOOOOOOOOOOXXXXXXXXGOOOOOOOXXXXXXXXXXXXGOOOOOXXXXXXXXXXXXXXGOOOOOOOXXXXXXXXXXXXGOOOOOOXXXXXXXXXXXXXGOOOOOOOOOOXXXXXXXXXGOOOOOOOXXXXXXXXXXXXGOOXXXXXXXXXXXXXXXXXGOOOOOOOXXXXXXXXXXXXGOOOXXXXXXXXXXXXXXXXGOOOOOOOOOXXXXXXXXXXGOOOOOOOOOOOXXXXXXXXGOOOXXXXXXXXXXXXXXXX,0,0,0
27237,101,0,101,50,449,0,0,159,83,76,GOOOOOOOOOOOXXXXXXXXGOOOOOOOXXXXXXXXXXXXGOOOOOXXXXXXXXXXXXXXGOOOOOOOXXXXXXXXXXXXGOOOOOOXXXXXXXXXXXXXGOOOOOOOOOOXXXXXXXXXGOOOOOOOXXXXXXXXXXXXGOOXXXXXXXXXXXXXXXXXGOOOOOOOXXXXXXXXXXXXGOOOXXXXXXXXXXXXXXXXGOOOOOOOOOXXXXXXXXXXGOOOOOOOOOOOXXXXXXXXGOOOXXXXXXXXXXXXXXXX,0,0,0
27258,101,0,101,48,451,0,0,159,80,79,GOOOOOOOOOOOXXXXXXXXGOOOOOOOXXXXXXXXXXXXGOOOOOXXXXXXXXXXXXXXGOOOOOOOXXXXXXXXXXXXGOOOOOOXXXXXXXXXXXXXGOOOOOOOOOOXXXXXXXXXGOOOOOOOXXXXXXXXXXXXGOOXXXXXXXXXXXXXXXXXGOOOOOOOXXXXXXXXXXXXGOOOXXXXXXXXXXXXXXXXGOOOOOOOOOXXXXXXXXXXGOOOOOOOOOOOXXXXXXXXGOOOXXXXXXXXXXXXXXXX,0,0,0
27279,101,0,101,44,455,0,0,161,83,78,GOOOOOOOOOOOXXXXXXXXGOOOOOOOXXXXXXXXXXXXGOOOOOXXXXXXXXXXXXXXGOOOOOOOXXXXXXXXXXXXGOOOOOOXXXXXXXXXXXXXGOOOOOOOOOOXXXXXXXXXGOOOOOOOXXXXXXXXXXXXGOOXXXXXXXXXXXXXXXXXGOOOOOOOXXXXXXXXXXXXGOOOXXXXXXXXXXXXXXXXGOOOOOOOOOXXXXXXXXXXGOOOOOOOOOOOXXXXXXXXGOOOXXXXXXXXXXXXXXXX,0,0,0

27300,101,0,101,44,455,0,0,163,82,81,GOOOOOOOOOOOXXXXXXXXGOOOOOOOXXXXXXXXXXXXGOOOOOXXXXXXXXXXXXXXGOOOOOOOXXXXXXXXXXXXGOOOOOOXXXXXXXXXXXXXGOOOOOOOOOOXXXXXXXXXGOOOOOOOXXXXXXXXXXXXGOOXXXXXXXXXXXXXXXXXGOOOOOOOXXXXXXXXXXXXGOOOXXXXXXXXXXXXXXXXGOOOOOOOOOXXXXXXXXXXGOOOOOOOOOOOXXXXXXXXGOOOXXXXXXXXXXXXXXXX,0,0,0
27321,101,0,101,44,455,0,0,163,85,78,GOOOOOOOOOOOXXXXXXXXGOOOOOOOXXXXXXXXXXXXGOOOOOXXXXXXXXXXXXXXGOOOOOOOXXXXXXXXXXXXGOOOOOOXXXXXXXXXXXXXGOOOOOOOOOOXXXXXXXXXGOOOOOOOXXXXXXXXXXXXGOOXXXXXXXXXXXXXXXXXGOOOOOOOXXXXXXXXXXXXGOOOXXXXXXXXXXXXXXXXGOOOOOOOOOXXXXXXXXXXGOOOOOOOOOOOXXXXXXXXGOOOXXXXXXXXXXXXXXXX,0,0,0
27342,101,0,101,51,448,0,0,156,81,75,GOOOOOOOOOOOXXXXXXXXGOOOOOOOXXXXXXXXXXXXGOOOOOXXXXXXXXXXXXXXGOOOOOOOXXXXXXXXXXXXGOOOOOOXXXXXXXXXXXXXGOOOOOOOOOOXXXXXXXXXGOOOOOOOXXXXXXXXXXXXGOOXXXXXXXXXXXXXXXXXGOOOOOOOXXXXXXXXXXXXGOOOXXXXXXXXXXXXXXXXGOOOOOOOOOXXXXXXXXXXGOOOOOOOOOOOXXXXXXXXGOOOXXXXXXXXXXXXXXXX,0,0,0
27363,101,0,101,53,446,0,0,154,82,72,GOOOOOOOOOOOXXXXXXXXGOOOOOOOXXXXXXXXXXXXGOOOOOXXXXXXXXXXXXXXGOOOOOOOXXXXXXXXXXXXGOOOOOOXXXXXXXXXXXXXGOOOOOOOOOOXXXXXXXXXGOOOOOOOXXXXXXXXXXXXGOOXXXXXXXXXXXXXXXXXGOOOOOOOXXXXXXXXXXXXGOOOXXXXXXXXXXXXXXXXGOOOOOOOOOXXXXXXXXXXGOOOOOOOOOOOXXXXXXXXGOOOXXXXXXXXXXXXXXXX,0,0,0
27384,101,0,101,56,443,0,0,151,78,73,GOOOOOOOOOOOXXXXXXXXGOOOOOOOXXXXXXXXXXXXGOOOOOXXXXXXXXXXXXXXGOOOOOOOXXXXXXXXXXXXGOOOOOOXXXXXXXXXXXXXGOOOOOOOOOOXXXXXXXXXGOOOOOOOXXXXXXXXXXXXGOOXXXXXXXXXXXXXXXXXGOOOOOOOXXXXXXXXXXXXGOOOXXXXXXXXXXXXXXXXGOOOOOOOOOXXXXXXXXXXGOOOOOOOOOOOXXXXXXXXGOOOXXXXXXXXXXXXXXXX,0,0,0

27405,102,1,101,46,452,0,0,159,77,82,GOOOOOOOOOOOXXXXXXXXGOOOOOOOXXXXXXXXXXXXGOOOOOXXXXXXXXXXXXXXGOOOOOOOAXXXXXXXXXXXGOOOOOOXXXXXXXXXXXXXGOOOOOOOOOOXXXXXXXXXGOOOOOOOXXXXXXXXXXXXGOOXXXXXXXXXXXXXXXXXGOOOOOOOXXXXXXXXXXXXGOOOXXXXXXXXXXXXXXXXGOOOOOOOOOXXXXXXXXXXGOOOOOOOOOOOXXXXXXXXGOOOXXXXXXXXXXXXXXXX,0,0,0
27426,102,1,101,42,456,0,0,162,79,83,GOOOOOOOOOOOXXXXXXXXGOOOOOOOXXXXXXXXXXXXGOOOOOXXXXXXXXXXXXXXGOOOOOOOAXXXXXXXXXXXGOOOOOOXXXXXXXXXXXXXGOOOOOOOOOOXXXXXXXXXGOOOOOOOXXXXXXXXXXXXGOOXXXXXXXXXXXXXXXXXGOOOOOOOXXXXXXXXXXXXGOOOXXXXXXXXXXXXXXXXGOOOOOOOOOXXXXXXXXXXGOOOOOOOOOOOXXXXXXXXGOOOXXXXXXXXXXXXXXXX,0,0,0
27447,102,1,101,35,463,0,0,168,81,87,GOOOOOOOOOOOXXXXXXXXGOOOOOOOXXXXXXXXXXXXGOOOOOXXXXXXXXXXXXXXGOOOOOOOAXXXXXXXXXXXGOOOOOOXXXXXXXXXXXXXGOOOOOOOOOOXXXXXXXXXGOOOOOOOXXXXXXXXXXXXGOOXXXXXXXXXXXXXXXXXGOOOOOOOXXXXXXXXXXXXGOOOXXXXXXXXXXXXXXXXGOOOOOOOOOXXXXXXXXXXGOOOOOOOOOOOXXXXXXXXGOOOXXXXXXXXXXXXXXXX,0,0,0
27468,102,1,101,37,461,0,0,167,79,88,GOOOOOOOOOOOXXXXXXXXGOOOOOOOXXXXXXXXXXXXGOOOOOXXXXXXXXXXXXXXGOOOOOOOAXXXXXXXXXXXGOOOOOOXXXXXXXXXXXXXGOOOOOOOOOOXXXXXXXXXGOOOOOOOXXXXXXXXXXXXGOOXXXXXXXXXXXXXXXXXGOOOOOOOXXXXXXXXXXXXGOOOXXXXXXXXXXXXXXXXGOOOOOOOOOXXXXXXXXXXGOOOOOOOOOOOXXXXXXXXGOOOXXXXXXXXXXXXXXXX,0,0,0
27489,102,1,101,39,459,0,0,165,79,86,GOOOOOOOOOOOXXXXXXXXGOOOOOOOXXXXXXXXXXXXGOOOOOXXXXXXXXXXXXXXGOOOOOOOAXXXXXXXXXXXGOOOOOOXXXXXXXXXXXXXGOOOOOOOOOOXXXXXXXXXGOOOOOOOXXXXXXXXXXXXGOOXXXXXXXXXXXXXXXXXGOOOOOOOXXXXXXXXXXXXGOOOXXXXXXXXXXXXXXXXGOOOOOOOOOXXXXXXXXXXGOOOOOOOOOOOXXXXXXXXGOOOXXXXXXXXXXXXXXXX,0,0,0

27510,102,1,101,39,459,0,0,165,79,86,GOOOOOOOOOOOXXXXXXXXGOOOOOOOXXXXXXXXXXXXGOOOOOXXXXXXXXXXXXXXGOOOOOOOAXXXXXXXXXXXGOOOOOOXXXXXXXXXXXXXGOOOOOOOOOOXXXXXXXXXGOOOOOOOXXXXXXXXXXXXGOOXXXXXXXXXXXXXXXXXGOOOOOOOXXXXXXXXXXXXGOOOXXXXXXXXXXXXXXXXGOOOOOOOOOXXXXXXXXXXGOOOOOOOOOOOXXXXXXXXGOOOXXXXXXXXXXXXXXXX,0,0,0
27531,102,1,101,40,458,0,0,167,79,88,GOOOOOOOOOOOXXXXXXXXGOOOOOOOXXXXXXXXXXXXGOOOOOXXXXXXXXXXXXXXGOOOOOOOAXXXXXXXXXXXGOOOOOOXXXXXXXXXXXXXGOOOOOOOOOOXXXXXXXXXGOOOOOOOXXXXXXXXXXXXGOOXXXXXXXXXXXXXXXXXGOOOOOOOXXXXXXXXXXXXGOOOXXXXXXXXXXXXXXXXGOOOOOOOOOXXXXXXXXXXGOOOOOOOOOOOXXXXXXXXGOOOXXXXXXXXXXXXXXXX,0,0,0
27552,102,1,101,43,455,0,0,163,84,79,GOOOOOOOOOOOXXXXXXXXGOOOOOOOXXXXXXXXXXXXGOOOOOXXXXXXXXXXXXXXGOOOOOOOAXXXXXXXXXXXGOOOOOOXXXXXXXXXXXXXGOOOOOOOOOOXXXXXXXXXGOOOOOOOXXXXXXXXXXXXGOOXXXXXXXXXXXXXXXXXGOOOOOOOXXXXXXXXXXXXGOOOXXXXXXXXXXXXXXXXGOOOOOOOOOXXXXXXXXXXGOOOOOOOOOOOXXXXXXXXGOOOXXXXXXXXXXXXXXXX,0,0,0
27573,102,1,101,49,449,0,0,158,79,79,GOOOOOOOOOOOXXXXXXXXGOOOOOOOXXXXXXXXXXXXGOOOOOXXXXXXXXXXXXXXGOOOOOOOAXXXXXXXXXXXGOOOOOOXXXXXXXXXXXXXGOOOOOOOOOOXXXXXXXXXGOOOOOOOXXXXXXXXXXXXGOOXXXXXXXXXXXXXXXXXGOOOOOOOXXXXXXXXXXXXGOOOXXXXXXXXXXXXXXXXGOOOOOOOOOXXXXXXXXXXGOOOOOOOOOOOXXXXXXXXGOOOXXXXXXXXXXXXXXXX,0,0,0
27594,102,1,101,51,447,0,0,156,77,79,GOOOOOOOOOOOXXXXXXXXGOOOOOOOXXXXXXXXXXXXGOOOOOXXXXXXXXXXXXXXGOOOOOOOAXXXXXXXXXXXGOOOOOOXXXXXXXXXXXXXGOOOOOOOOOOXXXXXXXXXGOOOOOOOXXXXXXXXXXXXGOOXXXXXXXXXXXXXXXXXGOOOOOOOXXXXXXXXXXXXGOOOXXXXXXXXXXXXXXXXGOOOOOOOOOXXXXXXXXXXGOOOOOOOOOOOXXXXXXXXGOOOXXXXXXXXXXXXXXXX,0,0,0

27615,102,1,101,49,449,0,0,158,79,79,GOOOOOOOOOOOXXXXXXXXGOOOOOOOXXXXXXXXXXXXGOOOOOXXXXXXXXXXXXXXGOOOOOOOAXXXXXXXXXXXGOOOOOOXXXXXXXXXXXXXGOOOOOOOOOOXXXXXXXXXGOOOOOOOXXXXXXXXXXXXGOOXXXXXXXXXXXXXXXXXGOOOOOOOXXXXXXXXXXXXGOOOXXXXXXXXXXXXXXXXGOOOOOOOOOXXXXXXXXXXGOOOOOOOOOOOXXXXXXXXGOOOXXXXXXXXXXXXXXXX,0,0,0
27636,102,0,102,47,451,0,0,160,83,77,GOOOOOOOOOOOXXXXXXXXGOOOOOOOXXXXXXXXXXXXGOOOOOXXXXXXXXXXXXXXGOOOOOOOOXXXXXXXXXXXGOOOOOOXXXXXXXXXXXXXGOOOOOOOOOOXXXXXXXXXGOOOOOOOXXXXXXXXXXXXGOOXXXXXXXXXXXXXXXXXGOOOOOOOXXXXXXXXXXXXGOOOXXXXXXXXXXXXXXXXGOOOOOOOOOXXXXXXXXXXGOOOOOOOOOOOXXXXXXXXGOOOXXXXXXXXXXXXXXXX,0,0,0
27657,102,0,102,42,456,0,0,166,84,82,GOOOOOOOOOOOXXXXXXXXGOOOOOOOXXXXXXXXXXXXGOOOOOXXXXXXXXXXXXXXGOOOOOOOOXXXXXXXXXXXGOOOOOOXXXXXXXXXXXXXGOOOOOOOOOOXXXXXXXXXGOOOOOOOXXXXXXXXXXXXGOOXXXXXXXXXXXXXXXXXGOOOOOOOXXXXXXXXXXXXGOOOXXXXXXXXXXXXXXXXGOOOOOOOOOXXXXXXXXXXGOOOOOOOOOOOXXXXXXXXGOOOXXXXXXXXXXXXXXXX,0,0,0
27678,102,0,102,44,454,0,0,163,84,79,GOOOOOOOOOOOXXXXXXXXGOOOOOOOXXXXXXXXXXXXGOOOOOXXXXXXXXXXXXXXGOOOOOOOOXXXXXXXXXXXGOOOOOOXXXXXXXXXXXXXGOOOOOOOOOOXXXXXXXXXGOOOOOOOXXXXXXXXXXXXGOOXXXXXXXXXXXXXXXXXGOOOOOOOXXXXXXXXXXXXGOOOXXXXXXXXXXXXXXXXGOOOOOOOOOXXXXXXXXXXGOOOOOOOOOOOXXXXXXXXGOOOXXXXXXXXXXXXXXXX,0,0,0
27699,102,0,102,48,450,0,0,159,83,76,GOOOOOOOOOOOXXXXXXXXGOOOOOOOXXXXXXXXXXXXGOOOOOXXXXXXXXXXXXXXGOOOOOOOOXXXXXXXXXXXGOOOOOOXXXXXXXXXXXXXGOOOOOOOOOOXXXXXXXXXGOOOOOOOXXXXXXXXXXXXGOOXXXXXXXXXXXXXXXXXGOOOOOOOXXXXXXXXXXXXGOOOXXXXXXXXXXXXXXXXGOOOOOOOOOXXXXXXXXXXGOOOOOOOOOOOXXXXXXXXGOOOXXXXXXXXXXXXXXXX,0,0,0

27720,102,0,102,50,448,0,0,158,82,76,GOOOOOOOOOOOXXXXXXXXGOOOOOOOXXXXXXXXXXXXGOOOOOXXXXXXXXXXXXXXGOOOOOOOOXXXXXXXXXXXGOOOOOOXXXXXXXXXXXXXGOOOOOOOOOOXXXXXXXXXGOOOOOOOXXXXXXXXXXXXGOOXXXXXXXXXXXXXXXXXGOOOOOOOXXXXXXXXXXXXGOOOXXXXXXXXXXXXXXXXGOOOOOOOOOXXXXXXXXXXGOOOOOOOOOOOXXXXXXXXGOOOXXXXXXXXXXXXXXXX,0,0,0
27741,102,0,102,53,445,0,0,154,82,72,GOOOOOOOOOOOXXXXXXXXGOOOOOOOXXXXXXXXXXXXGOOOOOXXXXXXXXXXXXXXGOOOOOOOOXXXXXXXXXXXGOOOOOOXXXXXXXXXXXXXGOOOOOOOOOOXXXXXXXXXGOOOOOOOXXXXXXXXXXXXGOOXXXXXXXXXXXXXXXXXGOOOOOOOXXXXXXXXXXXXGOOOXXXXXXXXXXXXXXXXGOOOOOOOOOXXXXXXXXXXGOOOOOOOOOOOXXXXXXXXGOOOXXXXXXXXXXXXXXXX,0,0,0
27762,102,0,102,53,445,0,0,155,82,73,GOOOOOOOOOOOXXXXXXXXGOOOOOOOXXXXXXXXXXXXGOOOOOXXXXXXXXXXXXXXGOOOOOOOOXXXXXXXXXXXGOOOOOOXXXXXXXXXXXXXGOOOOOOOOOOXXXXXXXXXGOOOOOOOXXXXXXXXXXXXGOOXXXXXXXXXXXXXXXXXGOOOOOOOXXXXXXXXXXXXGOOOXXXXXXXXXXXXXXXXGOOOOOOOOOXXXXXXXXXXGOOOOOOOOOOOXXXXXXXXGOOOXXXXXXXXXXXXXXXX,0,0,0
27783,102,0,102,53,445,0,0,152,81,71,GOOOOOOOOOOOXXXXXXXXGOOOOOOOXXXXXXXXXXXXGOOOOOXXXXXXXXXXXXXXGOOOOOOOOXXXXXXXXXXXGOOOOOOXXXXXXXXXXXXXGOOOOOOOOOOXXXXXXXXXGOOOOOOOXXXXXXXXXXXXGOOXXXXXXXXXXXXXXXXXGOOOOOOOXXXXXXXXXXXXGOOOXXXXXXXXXXXXXXXXGOOOOOOOOOXXXXXXXXXXGOOOOOOOOOOOXXXXXXXXGOOOXXXXXXXXXXXXXXXX,0,0,0
27804,102,0,102,55,443,0,0,151,79,72,GOOOOOOOOOOOXXXXXXXXGOOOOOOOXXXXXXXXXXXXGOOOOOXXXXXXXXXXXXXXGOOOOOOOOXXXXXXXXXXXGOOOOOOXXXXXXXXXXXXXGOOOOOOOOOOXXXXXXXXXGOOOOOOOXXXXXXXXXXXXGOOXXXXXXXXXXXXXXXXXGOOOOOOOXXXXXXXXXXXXGOOOXXXXXXXXXXXXXXXXGOOOOOOOOOXXXXXXXXXXGOOOOOOOOOOOXXXXXXXXGOOOXXXXXXXXXXXXXXXX,0,0,0

27825,102,0,102,52,446,0,0,154,78,76,GOOOOOOOOOOOXXXXXXXXGOOOOOOOXXXXXXXXXXXXGOOOOOXXXXXXXXXXXXXXGOOOOOOOOXXXXXXXXXXXGOOOOOOXXXXXXXXXXXXXGOOOOOOOOOOXXXXXXXXXGOOOOOOOXXXXXXXXXXXXGOOXXXXXXXXXXXXXXXXXGOOOOOOOXXXXXXXXXXXXGOOOXXXXXXXXXXXXXXXXGOOOOOOOOOXXXXXXXXXXGOOOOOOOOOOOXXXXXXXXGOOOXXXXXXXXXXXXXXXX,0,0,0
27846,102,0,102,46,452,0,0,159,79,80,GOOOOOOOOOOOXXXXXXXXGOOOOOOOXXXXXXXXXXXXGOOOOOXXXXXXXXXXXXXXGOOOOOOOOXXXXXXXXXXXGOOOOOOXXXXXXXXXXXXXGOOOOOOOOOOXXXXXXXXXGOOOOOOOXXXXXXXXXXXXGOOXXXXXXXXXXXXXXXXXGOOOOOOOXXXXXXXXXXXXGOOOXXXXXXXXXXXXXXXXGOOOOOOOOOXXXXXXXXXXGOOOOOOOOOOOXXXXXXXXGOOOXXXXXXXXXXXXXXXX,0,0,0
27867,102,0,102,48,450,0,0,157,81,76,GOOOOOOOOOOOXXXXXXXXGOOOOOOOXXXXXXXXXXXXGOOOOOXXXXXXXXXXXXXXGOOOOOOOOXXXXXXXXXXXGOOOOOOXXXXXXXXXXXXXGOOOOOOOOOOXXXXXXXXXGOOOOOOOXXXXXXXXXXXXGOOXXXXXXXXXXXXXXXXXGOOOOOOOXXXXXXXXXXXXGOOOXXXXXXXXXXXXXXXXGOOOOOOOOOXXXXXXXXXXGOOOOOOOOOOOXXXXXXXXGOOOXXXXXXXXXXXXXXXX,0,0,0
27888,102,0,102,52,446,0,0,153,81,72,GOOOOOOOOOOOXXXXXXXXGOOOOOOOXXXXXXXXXXXXGOOOOOXXXXXXXXXXXXXXGOOOOOOOOXXXXXXXXXXXGOOOOOOXXXXXXXXXXXXXGOOOOOOOOOOXXXXXXXXXGOOOOOOOXXXXXXXXXXXXGOOXXXXXXXXXXXXXXXXXGOOOOOOOXXXXXXXXXXXXGOOOXXXXXXXXXXXXXXXXGOOOOOOOOOXXXXXXXXXXGOOOOOOOOOOOXXXXXXXXGOOOXXXXXXXXXXXXXXXX,0,0,0
27909,102,0,102,47,451,0,0,158,80,78,GOOOOOOOOOOOXXXXXXXXGOOOOOOOXXXXXXXXXXXXGOOOOOXXXXXXXXXXXXXXGOOOOOOOOXXXXXXXXXXXGOOOOOOXXXXXXXXXXXXXGOOOOOOOOOOXXXXXXXXXGOOOOOOOXXXXXXXXXXXXGOOXXXXXXXXXXXXXXXXXGOOOOOOOXXXXXXXXXXXXGOOOXXXXXXXXXXXXXXXXGOOOOOOOOOXXXXXXXXXXGOOOOOOOOOOOXXXXXXXXGOOOXXXXXXXXXXXXXXXX,0,0,0

27930,102,0,102,47,451,0,0,157,81,76,GOOOOOOOOOOOXXXXXXXXGOOOOOOOXXXXXXXXXXXXGOOOOOXXXXXXXXXXXXXXGOOOOOOOOXXXXXXXXXXXGOOOOOOXXXXXXXXXXXXXGOOOOOOOOOOXXXXXXXXXGOOOOOOOXXXXXXXXXXXXGOOXXXXXXXXXXXXXXXXXGOOOOOOOXXXXXXXXXXXXGOOOXXXXXXXXXXXXXXXXGOOOOOOOOOXXXXXXXXXXGOOOOOOOOOOOXXXXXXXXGOOOXXXXXXXXXXXXXXXX,0,0,0
27951,102,0,102,48,450,0,0,156,81,75,GOOOOOOOOOOOXXXXXXXXGOOOOOOOXXXXXXXXXXXXGOOOOOXXXXXXXXXXXXXXGOOOOOOOOXXXXXXXXXXXGOOOOOOXXXXXXXXXXXXXGOOOOOOOOOOXXXXXXXXXGOOOOOOOXXXXXXXXXXXXGOOXXXXXXXXXXXXXXXXXGOOOOOOOXXXXXXXXXXXXGOOOXXXXXXXXXXXXXXXXGOOOOOOOOOXXXXXXXXXXGOOOOOOOOOOOXXXXXXXXGOOOXXXXXXXXXXXXXXXX,0,0,0
27972,103,1,102,40,457,0,0,163,78,85,GOOOOOOOOOOOXXXXXXXXGOOOOOOOXXXXXXXXXXXXGOOOOOXXXXXXXXXXXXXXGOOOOOOOOXXXXXXXXXXXGOOOOOOXXXXXXXXXXXXXGOOOOOOOOOOAXXXXXXXXGOOOOOOOXXXXXXXXXXXXGOOXXXXXXXXXXXXXXXXXGOOOOOOOXXXXXXXXXXXXGOOOXXXXXXXXXXXXXXXXGOOOOOOOOOXXXXXXXXXXGOOOOOOOOOOOXXXXXXXXGOOOXXXXXXXXXXXXXXXX,0,0,0
27993,103,1,102,37,460,0,0,166,80,86,GOOOOOOOOOOOXXXXXXXXGOOOOOOOXXXXXXXXXXXXGOOOOOXXXXXXXXXXXXXXGOOOOOOOOXXXXXXXXXXXGOOOOOOXXXXXXXXXXXXXGOOOOOOOOOOAXXXXXXXXGOOOOOOOXXXXXXXXXXXXGOOXXXXXXXXXXXXXXXXXGOOOOOOOXXXXXXXXXXXXGOOOXXXXXXXXXXXXXXXXGOOOOOOOOOXXXXXXXXXXGOOOOOOOOOOOXXXXXXXXGOOOXXXXXXXXXXXXXXXX,0,0,0
28014,104,2,102,37,459,0,0,165,79,86,GOOOOOOOOOOOXXXXXXXXGOOOOOOOAXXXXXXXXXXXGOOOOOXXXXXXXXXXXXXXGOOOOOOOOXXXXXXXXXXXGOOOOOOXXXXXXXXXXXXXGOOOOOOOOOOAXXXXXXXXGOOOOOOOXXXXXXXXXXXXGOOXXXXXXXXXXXXXXXXXGOOOOOOOXXXXXXXXXXXXGOOOXXXXXXXXXXXXXXXXGOOOOOOOOOXXXXXXXXXXGOOOOOOOOOOOXXXXXXXXGOOOXXXXXXXXXXXXXXXX,0,0,0

28035,104,2,102,35,461,0,0,166,80,86,GOOOOOOOOOOOXXXXXXXXGOOOOOOOAXXXXXXXXXXXGOOOOOXXXXXXXXXXXXXXGOOOOOOOOXXXXXXXXXXXGOOOOOOXXXXXXXXXXXXXGOOOOOOOOOOAXXXXXXXXGOOOOOOOXXXXXXXXXXXXGOOXXXXXXXXXXXXXXXXXGOOOOOOOXXXXXXXXXXXXGOOOXXXXXXXXXXXXXXXXGOOOOOOOOOXXXXXXXXXXGOOOOOOOOOOOXXXXXXXXGOOOXXXXXXXXXXXXXXXX,0,0,0
28056,104,1,103,35,461,0,0,167,82,85,GOOOOOOOOOOOXXXXXXXXGOOOOOOOAXXXXXXXXXXXGOOOOOXXXXXXXXXXXXXXGOOOOOOOOXXXXXXXXXXXGOOOOOOXXXXXXXXXXXXXGOOOOOOOOOOOXXXXXXXXGOOOOOOOXXXXXXXXXXXXGOOXXXXXXXXXXXXXXXXXGOOOOOOOXXXXXXXXXXXXGOOOXXXXXXXXXXXXXXXXGOOOOOOOOOXXXXXXXXXXGOOOOOOOOOOOXXXXXXXXGOOOXXXXXXXXXXXXXXXX,0,0,0
28077,104,1,103,39,457,0,0,163,81,82,GOOOOOOOOOOOXXXXXXXXGOOOOOOOAXXXXXXXXXXXGOOOOOXXXXXXXXXXXXXXGOOOOOOOOXXXXXXXXXXXGOOOOOOXXXXXXXXXXXXXGOOOOOOOOOOOXXXXXXXXGOOOOOOOXXXXXXXXXXXXGOOXXXXXXXXXXXXXXXXXGOOOOOOOXXXXXXXXXXXXGOOOXXXXXXXXXXXXXXXXGOOOOOOOOOXXXXXXXXXXGOOOOOOOOOOOXXXXXXXXGOOOXXXXXXXXXXXXXXXX,0,0,0
28098,104,1,103,39,457,0,0,163,77,86,GOOOOOOOOOOOXXXXXXXXGOOOOOOOAXXXXXXXXXXXGOOOOOXXXXXXXXXXXXXXGOOOOOOOOXXXXXXXXXXXGOOOOOOXXXXXXXXXXXXXGOOOOOOOOOOOXXXXXXXXGOOOOOOOXXXXXXXXXXXXGOOXXXXXXXXXXXXXXXXXGOOOOOOOXXXXXXXXXXXXGOOOXXXXXXXXXXXXXXXXGOOOOOOOOOXXXXXXXXXXGOOOOOOOOOOOXXXXXXXXGOOOXXXXXXXXXXXXXXXX,0,0,0
28119,104,1,103,39,457,0,0,163,77,86,GOOOOOOOOOOOXXXXXXXXGOOOOOOOAXXXXXXXXXXXGOOOOOXXXXXXXXXXXXXXGOOOOOOOOXXXXXXXXXXXGOOOOOOXXXXXXXXXXXXXGOOOOOOOOOOOXXXXXXXXGOOOOOOOXXXXXXXXXXXXGOOXXXXXXXXXXXXXXXXXGOOOOOOOXXXXXXXXXXXXGOOOXXXXXXXXXXXXXXXXGOOOOOOOOOXXXXXXXXXXGOOOOOOOOOOOXXXXXXXXGOOOXXXXXXXXXXXXXXXX,0,0,0

28140,104,1,103,36,460,0,0,166,79,87,GOOOOOOOOOOOXXXXXXXXGOOOOOOOAXXXXXXXXXXXGOOOOOXXXXXXXXXXXXXXGOOOOOOOOXXXXXXXXXXXGOOOOOOXXXXXXXXXXXXXGOOOOOOOOOOOXXXXXXXXGOOOOOOOXXXXXXXXXXXXGOOXXXXXXXXXXXXXXXXXGOOOOOOOXXXXXXXXXXXXGOOOXXXXXXXXXXXXXXXXGOOOOOOOOOXXXXXXXXXXGOOOOOOOOOOOXXXXXXXXGOOOXXXXXXXXXXXXXXXX,0,0,0
28161,104,1,103,36,460,0,0,167,80,87,GOOOOOOOOOOOXXXXXXXXGOOOOOOOAXXXXXXXXXXXGOOOOOXXXXXXXXXXXXXXGOOOOOOOOXXXXXXXXXXXGOOOOOOXXXXXXXXXXXXXGOOOOOOOOOOOXXXXXXXXGOOOOOOOXXXXXXXXXXXXGOOXXXXXXXXXXXXXXXXXGOOOOOOOXXXXXXXXXXXXGOOOXXXXXXXXXXXXXXXXGOOOOOOOOOXXXXXXXXXXGOOOOOOOOOOOXXXXXXXXGOOOXXXXXXXXXXXXXXXX,0,0,0
28182,104,1,103,35,461,0,0,168,81,87,GOOOOOOOOOOOXXXXXXXXGOOOOOOOAXXXXXXXXXXXGOOOOOXXXXXXXXXXXXXXGOOOOOOOOXXXXXXXXXXXGOOOOOOXXXXXXXXXXXXXGOOOOOOOOOOOXXXXXXXXGOOOOOOOXXXXXXXXXXXXGOOXXXXXXXXXXXXXXXXXGOOOOOOOXXXXXXXXXXXXGOOOXXXXXXXXXXXXXXXXGOOOOOOOOOXXXXXXXXXXGOOOOOOOOOOOXXXXXXXXGOOOXXXXXXXXXXXXXXXX,0,0,0
28203,104,1,103,38,458,0,0,165,83,82,GOOOOOOOOOOOXXXXXXXXGOOOOOOOAXXXXXXXXXXXGOOOOOXXXXXXXXXXXXXXGOOOOOOOOXXXXXXXXXXXGOOOOOOXXXXXXXXXXXXXGOOOOOOOOOOOXXXXXXXXGOOOOOOOXXXXXXXXXXXXGOOXXXXXXXXXXXXXXXXXGOOOOOOOXXXXXXXXXXXXGOOOXXXXXXXXXXXXXXXXGOOOOOOOOOXXXXXXXXXXGOOOOOOOOOOOXXXXXXXXGOOOXXXXXXXXXXXXXXXX,0,0,0
28224,104,1,103,39,457,0,0,163,82,81,GOOOOOOOOOOOXXXXXXXXGOOOOOOOAXXXXXXXXXXXGOOOOOXXXXXXXXXXXXXXGOOOOOOOOXXXXXXXXXXXGOOOOOOXXXXXXXXXXXXXGOOOOOOOOOOOXXXXXXXXGOOOOOOOXXXXXXXXXXXXGOOXXXXXXXXXXXXXXXXXGOOOOOOOXXXXXXXXXXXXGOOOXXXXXXXXXXXXXXXXGOOOOOOOOOXXXXXXXXXXGOOOOOOOOOOOXXXXXXXXGOOOXXXXXXXXXXXXXXXX,0,0,0

28245,104,1,103,38,458,0,0,165,80,85,GOOOOOOOOOOOXXXXXXXXGOOOOOOOAXXXXXXXXXXXGOOOOOXXXXXXXXXXXXXXGOOOOOOOOXXXXXXXXXXXGOOOOOOXXXXXXXXXXXXXGOOOOOOOOOOOXXXXXXXXGOOOOOOOXXXXXXXXXXXXGOOXXXXXXXXXXXXXXXXXGOOOOOOOXXXXXXXXXXXXGOOOXXXXXXXXXXXXXXXXGOOOOOOOOOXXXXXXXXXXGOOOOOOOOOOOXXXXXXXXGOOOXXXXXXXXXXXXXXXX,0,0,0
28266,104,1,103,36,460,0,0,165,80,85,GOOOOOOOOOOOXXXXXXXXGOOOOOOOAXXXXXXXXXXXGOOOOOXXXXXXXXXXXXXXGOOOOOOOOXXXXXXXXXXXGOOOOOOXXXXXXXXXXXXXGOOOOOOOOOOOXXXXXXXXGOOOOOOOXXXXXXXXXXXXGOOXXXXXXXXXXXXXXXXXGOOOOOOOXXXXXXXXXXXXGOOOXXXXXXXXXXXXXXXXGOOOOOOOOOXXXXXXXXXXGOOOOOOOOOOOXXXXXXXXGOOOXXXXXXXXXXXXXXXX,0,0,0
28287,104,1,103,39,457,0,0,163,79,84,GOOOOOOOOOOOXXXXXXXXGOOOOOOOAXXXXXXXXXXXGOOOOOXXXXXXXXXXXXXXGOOOOOOOOXXXXXXXXXXXGOOOOOOXXXXXXXXXXXXXGOOOOOOOOOOOXXXXXXXXGOOOOOOOXXXXXXXXXXXXGOOXXXXXXXXXXXXXXXXXGOOOOOOOXXXXXXXXXXXXGOOOXXXXXXXXXXXXXXXXGOOOOOOOOOXXXXXXXXXXGOOOOOOOOOOOXXXXXXXXGOOOXXXXXXXXXXXXXXXX,0,0,0
28308,104,0,104,40,456,0,0,162,82,80,GOOOOOOOOOOOXXXXXXXXGOOOOOOOOXXXXXXXXXXXGOOOOOXXXXXXXXXXXXXXGOOOOOOOOXXXXXXXXXXXGOOOOOOXXXXXXXXXXXXXGOOOOOOOOOOOXXXXXXXXGOOOOOOOXXXXXXXXXXXXGOOXXXXXXXXXXXXXXXXXGOOOOOOOXXXXXXXXXXXXGOOOXXXXXXXXXXXXXXXXGOOOOOOOOOXXXXXXXXXXGOOOOOOOOOOOXXXXXXXXGOOOXXXXXXXXXXXXXXXX,0,0,0
28329,104,0,104,37,459,0,0,165,84,81,GOOOOOOOOOOOXXXXXXXXGOOOOOOOOXXXXXXXXXXXGOOOOOXXXXXXXXXXXXXXGOOOOOOOOXXXXXXXXXXXGOOOOOOXXXXXXXXXXXXXGOOOOOOOOOOOXXXXXXXXGOOOOOOOXXXXXXXXXXXXGOOXXXXXXXXXXXXXXXXXGOOOOOOOXXXXXXXXXXXXGOOOXXXXXXXXXXXXXXXXGOOOOOOOOOXXXXXXXXXXGOOOOOOOOOOOXXXXXXXXGOOOXXXXXXXXXXXXXXXX,0,0,0

28350,104,0,104,38,458,0,0,164,80,84,GOOOOOOOOOOOXXXXXXXXGOOOOOOOOXXXXXXXXXXXGOOOOOXXXXXXXXXXXXXXGOOOOOOOOXXXXXXXXXXXGOOOOOOXXXXXXXXXXXXXGOOOOOOOOOOOXXXXXXXXGOOOOOOOXXXXXXXXXXXXGOOXXXXXXXXXXXXXXXXXGOOOOOOOXXXXXXXXXXXXGOOOXXXXXXXXXXXXXXXXGOOOOOOOOOXXXXXXXXXXGOOOOOOOOOOOXXXXXXXXGOOOXXXXXXXXXXXXXXXX,0,0,0
28371,104,0,104,39,457,0,0,163,81,82,GOOOOOOOOOOOXXXXXXXXGOOOOOOOOXXXXXXXXXXXGOOOOOXXXXXXXXXXXXXXGOOOOOOOOXXXXXXXXXXXGOOOOOOXXXXXXXXXXXXXGOOOOOOOOOOOXXXXXXXXGOOOOOOOXXXXXXXXXXXXGOOXXXXXXXXXXXXXXXXXGOOOOOOOXXXXXXXXXXXXGOOOXXXXXXXXXXXXXXXXGOOOOOOOOOXXXXXXXXXXGOOOOOOOOOOOXXXXXXXXGOOOXXXXXXXXXXXXXXXX,0,0,0
28392,104,0,104,42,454,0,0,160,81,79,GOOOOOOOOOOOXXXXXXXXGOOOOOOOOXXXXXXXXXXXGOOOOOXXXXXXXXXXXXXXGOOOOOOOOXXXXXXXXXXXGOOOOOOXXXXXXXXXXXXXGOOOOOOOOOOOXXXXXXXXGOOOOOOOXXXXXXXXXXXXGOOXXXXXXXXXXXXXXXXXGOOOOOOOXXXXXXXXXXXXGOOOXXXXXXXXXXXXXXXXGOOOOOOOOOXXXXXXXXXXGOOOOOOOOOOOXXXXXXXXGOOOXXXXXXXXXXXXXXXX,0,0,0
28413,104,0,104,36,460,0,0,166,85,81,GOOOOOOOOOOOXXXXXXXXGOOOOOOOOXXXXXXXXXXXGOOOOOXXXXXXXXXXXXXXGOOOOOOOOXXXXXXXXXXXGOOOOOOXXXXXXXXXXXXXGOOOOOOOOOOOXXXXXXXXGOOOOOOOXXXXXXXXXXXXGOOXXXXXXXXXXXXXXXXXGOOOOOOOXXXXXXXXXXXXGOOOXXXXXXXXXXXXXXXXGOOOOOOOOOXXXXXXXXXXGOOOOOOOOOOOXXXXXXXXGOOOXXXXXXXXXXXXXXXX,0,0,0
28434,104,0,104,40,456,0,0,162,81,81,GOOOOOOOOOOOXXXXXXXXGOOOOOOOOXXXXXXXXXXXGOOOOOXXXXXXXXXXXXXXGOOOOOOOOXXXXXXXXXXXGOOOOOOXXXXXXXXXXXXXGOOOOOOOOOOOXXXXXXXXGOOOOOOOXXXXXXXXXXXXGOOXXXXXXXXXXXXXXXXXGOOOOOOOXXXXXXXXXXXXGOOOXXXXXXXXXXXXXXXXGOOOOOOOOOXXXXXXXXXXGOOOOOOOOOOOXXXXXXXXGOOOXXXXXXXXXXXXXXXX,0,0,0

28455,104,0,104,43,453,0,0,160,80,80,GOOOOOOOOOOOXXXXXXXXGOOOOOOOOXXXXXXXXXXXGOOOOOXXXXXXXXXXXXXXGOOOOOOOOXXXXXXXXXXXGOOOOOOXXXXXXXXXXXXXGOOOOOOOOOOOXXXXXXXXGOOOOOOOXXXXXXXXXXXXGOOXXXXXXXXXXXXXXXXXGOOOOOOOXXXXXXXXXXXXGOOOXXXXXXXXXXXXXXXXGOOOOOOOOOXXXXXXXXXXGOOOOOOOOOOOXXXXXXXXGOOOXXXXXXXXXXXXXXXX,0,0,0
28476,104,0,104,41,455,0,0,161,80,81,GOOOOOOOOOOOXXXXXXXXGOOOOOOOOXXXXXXXXXXXGOOOOOXXXXXXXXXXXXXXGOOOOOOOOXXXXXXXXXXXGOOOOOOXXXXXXXXXXXXXGOOOOOOOOOOOXXXXXXXXGOOOOOOOXXXXXXXXXXXXGOOXXXXXXXXXXXXXXXXXGOOOOOOOXXXXXXXXXXXXGOOOXXXXXXXXXXXXXXXXGOOOOOOOOOXXXXXXXXXXGOOOOOOOOOOOXXXXXXXXGOOOXXXXXXXXXXXXXXXX,0,0,0
28497,104,0,104,41,455,0,0,162,80,82,GOOOOOOOOOOOXXXXXXXXGOOOOOOOOXXXXXXXXXXXGOOOOOXXXXXXXXXXXXXXGOOOOOOOOXXXXXXXXXXXGOOOOOOXXXXXXXXXXXXXGOOOOOOOOOOOXXXXXXXXGOOOOOOOXXXXXXXXXXXXGOOXXXXXXXXXXXXXXXXXGOOOOOOOXXXXXXXXXXXXGOOOXXXXXXXXXXXXXXXXGOOOOOOOOOXXXXXXXXXXGOOOOOOOOOOOXXXXXXXXGOOOXXXXXXXXXXXXXXXX,0,0,0
28518,105,1,104,40,455,0,0,161,81,80,GOOOOOOOOOOOXXXXXXXXGOOOOOOOOXXXXXXXXXXXGOOOOOXXXXXXXXXXXXXXGOOOOOOOOXXXXXXXXXXXGOOOOOOXXXXXXXXXXXXXGOOOOOOOOOOOXXXXXXXXGOOOOOOOXXXXXXXXXXXXGOOXXXXXXXXXXXXXXXXXGOOOOOOOXXXXXXXXXXXXGOOOXXXXXXXXXXXXXXXXGOOOOOOOOOAXXXXXXXXXGOOOOOOOOOOOXXXXXXXXGOOOXXXXXXXXXXXXXXXX,0,0,0
28539,105,1,104,43,452,0,0,159,84,75,GOOOOOOOOOOOXXXXXXXXGOOOOOOOOXXXXXXXXXXXGOOOOOXXXXXXXXXXXXXXGOOOOOOOOXXXXXXXXXXXGOOOOOOXXXXXXXXXXXXXGOOOOOOOOOOOXXXXXXXXGOOOOOOOXXXXXXXXXXXXGOOXXXXXXXXXXXXXXXXXGOOOOOOOXXXXXXXXXXXXGOOOXXXXXXXXXXXXXXXXGOOOOOOOOOAXXXXXXXXXGOOOOOOOOOOOXXXXXXXXGOOOXXXXXXXXXXXXXXXX,0,0,0

28560,105,1,104,44,451,0,0,159,82,77,GOOOOOOOOOOOXXXXXXXXGOOOOOOOOXXXXXXXXXXXGOOOOOXXXXXXXXXXXXXXGOOOOOOOOXXXXXXXXXXXGOOOOOOXXXXXXXXXXXXXGOOOOOOOOOOOXXXXXXXXGOOOOOOOXXXXXXXXXXXXGOOXXXXXXXXXXXXXXXXXGOOOOOOOXXXXXXXXXXXXGOOOXXXXXXXXXXXXXXXXGOOOOOOOOOAXXXXXXXXXGOOOOOOOOOOOXXXXXXXXGOOOXXXXXXXXXXXXXXXX,0,0,0
28581,106,2,104,43,451,0,0,159,82,77,GOOOOOOOOOOOXXXXXXXXGOOOOOOOOXXXXXXXXXXXGOOOOOXXXXXXXXXXXXXXGOOOOOOOOXXXXXXXXXXXGOOOOOOXXXXXXXXXXXXXGOOOOOOOOOOOXXXXXXXXGOOOOOOOXXXXXXXXXXXXGOOXXXXXXXXXXXXXXXXXGOOOOOOOAXXXXXXXXXXXGOOOXXXXXXXXXXXXXXXXGOOOOOOOOOAXXXXXXXXXGOOOOOOOOOOOXXXXXXXXGOOOXXXXXXXXXXXXXXXX,0,0,0
28602,106,2,104,48,446,0,0,153,83,70,GOOOOOOOOOOOXXXXXXXXGOOOOOOOOXXXXXXXXXXXGOOOOOXXXXXXXXXXXXXXGOOOOOOOOXXXXXXXXXXXGOOOOOOXXXXXXXXXXXXXGOOOOOOOOOOOXXXXXXXXGOOOOOOOXXXXXXXXXXXXGOOXXXXXXXXXXXXXXXXXGOOOOOOOAXXXXXXXXXXXGOOOXXXXXXXXXXXXXXXXGOOOOOOOOOAXXXXXXXXXGOOOOOOOOOOOXXXXXXXXGOOOXXXXXXXXXXXXXXXX,0,0,0
28623,106,2,104,54,440,0,0,148,86,62,GOOOOOOOOOOOXXXXXXXXGOOOOOOOOXXXXXXXXXXXGOOOOOXXXXXXXXXXXXXXGOOOOOOOOXXXXXXXXXXXGOOOOOOXXXXXXXXXXXXXGOOOOOOOOOOOXXXXXXXXGOOOOOOOXXXXXXXXXXXXGOOXXXXXXXXXXXXXXXXXGOOOOOOOAXXXXXXXXXXXGOOOXXXXXXXXXXXXXXXXGOOOOOOOOOAXXXXXXXXXGOOOOOOOOOOOXXXXXXXXGOOOXXXXXXXXXXXXXXXX,0,0,0
28644,106,2,104,52,442,0,0,150,83,67,GOOOOOOOOOOOXXXXXXXXGOOOOOOOOXXXXXXXXXXXGOOOOOXXXXXXXXXXXXXXGOOOOOOOOXXXXXXXXXXXGOOOOOOXXXXXXXXXXXXXGOOOOOOOOOOOXXXXXXXXGOOOOOOOXXXXXXXXXXXXGOOXXXXXXXXXXXXXXXXXGOOOOOOOAXXXXXXXXXXXGOOOXXXXXXXXXXXXXXXXGOOOOOOOOOAXXXXXXXXXGOOOOOOOOOOOXXXXXXXXGOOOXXXXXXXXXXXXXXXX,0,0,0

28665,106,2,104,50,444,0,0,152,82,70,GOOOOOOOOOOOXXXXXXXXGOOOOOOOOXXXXXXXXXXXGOOOOOXXXXXXXXXXXXXXGOOOOOOOOXXXXXXXXXXXGOOOOOOXXXXXXXXXXXXXGOOOOOOOOOOOXXXXXXXXGOOOOOOOXXXXXXXXXXXXGOOXXXXXXXXXXXXXXXXXGOOOOOOOAXXXXXXXXXXXGOOOXXXXXXXXXXXXXXXXGOOOOOOOOOAXXXXXXXXXGOOOOOOOOOOOXXXXXXXXGOOOXXXXXXXXXXXXXXXX,0,0,0
28686,106,2,104,47,447,0,0,152,85,67,GOOOOOOOOOOOXXXXXXXXGOOOOOOOOXXXXXXXXXXXGOOOOOXXXXXXXXXXXXXXGOOOOOOOOXXXXXXXXXXXGOOOOOOXXXXXXXXXXXXXGOOOOOOOOOOOXXXXXXXXGOOOOOOOXXXXXXXXXXXXGOOXXXXXXXXXXXXXXXXXGOOOOOOOAXXXXXXXXXXXGOOOXXXXXXXXXXXXXXXXGOOOOOOOOOAXXXXXXXXXGOOOOOOOOOOOXXXXXXXXGOOOXXXXXXXXXXXXXXXX,0,0,0
28707,106,1,105,47,447,0,0,154,81,73,GOOOOOOOOOOOXXXXXXXXGOOOOOOOOXXXXXXXXXXXGOOOOOXXXXXXXXXXXXXXGOOOOOOOOXXXXXXXXXXXGOOOOOOXXXXXXXXXXXXXGOOOOOOOOOOOXXXXXXXXGOOOOOOOXXXXXXXXXXXXGOOXXXXXXXXXXXXXXXXXGOOOOOOOAXXXXXXXXXXXGOOOXXXXXXXXXXXXXXXXGOOOOOOOOOOXXXXXXXXXGOOOOOOOOOOOXXXXXXXXGOOOXXXXXXXXXXXXXXXX,0,0,0
28728,106,0,106,44,450,0,0,156,84,72,GOOOOOOOOOOOXXXXXXXXGOOOOOOOOXXXXXXXXXXXGOOOOOXXXXXXXXXXXXXXGOOOOOOOOXXXXXXXXXXXGOOOOOOXXXXXXXXXXXXXGOOOOOOOOOOOXXXXXXXXGOOOOOOOXXXXXXXXXXXXGOOXXXXXXXXXXXXXXXXXGOOOOOOOOXXXXXXXXXXXGOOOXXXXXXXXXXXXXXXXGOOOOOOOOOOXXXXXXXXXGOOOOOOOOOOOXXXXXXXXGOOOXXXXXXXXXXXXXXXX,0,0,0
28749,106,0,106,46,448,0,0,154,82,72,GOOOOOOOOOOOXXXXXXXXGOOOOOOOOXXXXXXXXXXXGOOOOOXXXXXXXXXXXXXXGOOOOOOOOXXXXXXXXXXXGOOOOOOXXXXXXXXXXXXXGOOOOOOOOOOOXXXXXXXXGOOOOOOOXXXXXXXXXXXXGOOXXXXXXXXXXXXXXXXXGOOOOOOOOXXXXXXXXXXXGOOOXXXXXXXXXXXXXXXXGOOOOOOOOOOXXXXXXXXXGOOOOOOOOOOOXXXXXXXXGOOOXXXXXXXXXXXXXXXX,0,0,0

28770,106,0,106,45,449,0,0,156,81,75,GOOOOOOOOOOOXXXXXXXXGOOOOOOOOXXXXXXXXXXXGOOOOOXXXXXXXXXXXXXXGOOOOOOOOXXXXXXXXXXXGOOOOOOXXXXXXXXXXXXXGOOOOOOOOOOOXXXXXXXXGOOOOOOOXXXXXXXXXXXXGOOXXXXXXXXXXXXXXXXXGOOOOOOOOXXXXXXXXXXXGOOOXXXXXXXXXXXXXXXXGOOOOOOOOOOXXXXXXXXXGOOOOOOOOOOOXXXXXXXXGOOOXXXXXXXXXXXXXXXX,0,0,0
28791,106,0,106,48,446,0,0,153,80,73,GOOOOOOOOOOOXXXXXXXXGOOOOOOOOXXXXXXXXXXXGOOOOOXXXXXXXXXXXXXXGOOOOOOOOXXXXXXXXXXXGOOOOOOXXXXXXXXXXXXXGOOOOOOOOOOOXXXXXXXXGOOOOOOOXXXXXXXXXXXXGOOXXXXXXXXXXXXXXXXXGOOOOOOOOXXXXXXXXXXXGOOOXXXXXXXXXXXXXXXXGOOOOOOOOOOXXXXXXXXXGOOOOOOOOOOOXXXXXXXXGOOOXXXXXXXXXXXXXXXX,0,0,0
28812,106,0,106,44,450,0,0,157,79,78,GOOOOOOOOOOOXXXXXXXXGOOOOOOOOXXXXXXXXXXXGOOOOOXXXXXXXXXXXXXXGOOOOOOOOXXXXXXXXXXXGOOOOOOXXXXXXXXXXXXXGOOOOOOOOOOOXXXXXXXXGOOOOOOOXXXXXXXXXXXXGOOXXXXXXXXXXXXXXXXXGOOOOOOOOXXXXXXXXXXXGOOOXXXXXXXXXXXXXXXXGOOOOOOOOOOXXXXXXXXXGOOOOOOOOOOOXXXXXXXXGOOOXXXXXXXXXXXXXXXX,0,0,0
28833,106,0,106,46,448,0,0,156,80,76,GOOOOOOOOOOOXXXXXXXXGOOOOOOOOXXXXXXXXXXXGOOOOOXXXXXXXXXXXXXXGOOOOOOOOXXXXXXXXXXXGOOOOOOXXXXXXXXXXXXXGOOOOOOOOOOOXXXXXXXXGOOOOOOOXXXXXXXXXXXXGOOXXXXXXXXXXXXXXXXXGOOOOOOOOXXXXXXXXXXXGOOOXXXXXXXXXXXXXXXXGOOOOOOOOOOXXXXXXXXXGOOOOOOOOOOOXXXXXXXXGOOOXXXXXXXXXXXXXXXX,0,0,0
28854,106,0,106,47,447,0,0,155,79,76,GOOOOOOOOOOOXXXXXXXXGOOOOOOOOXXXXXXXXXXXGOOOOOXXXXXXXXXXXXXXGOOOOOOOOXXXXXXXXXXXGOOOOOOXXXXXXXXXXXXXGOOOOOOOOOOOXXXXXXXXGOOOOOOOXXXXXXXXXXXXGOOXXXXXXXXXXXXXXXXXGOOOOOOOOXXXXXXXXXXXGOOOXXXXXXXXXXXXXXXXGOOOOOOOOOOXXXXXXXXXGOOOOOOOOOOOXXXXXXXXGOOOXXXXXXXXXXXXXXXX,0,0,0

28875,106,0,106,46,448,0,0,155,78,77,GOOOOOOOOOOOXXXXXXXXGOOOOOOOOXXXXXXXXXXXGOOOOOXXXXXXXXXXXXXXGOOOOOOOOXXXXXXXXXXXGOOOOOOXXXXXXXXXXXXXGOOOOOOOOOOOXXXXXXXXGOOOOOOOXXXXXXXXXXXXGOOXXXXXXXXXXXXXXXXXGOOOOOOOOXXXXXXXXXXXGOOOXXXXXXXXXXXXXXXXGOOOOOOOOOOXXXXXXXXXGOOOOOOOOOOOXXXXXXXXGOOOXXXXXXXXXXXXXXXX,0,0,0
28896,106,0,106,43,451,0,0,159,81,78,GOOOOOOOOOOOXXXXXXXXGOOOOOOOOXXXXXXXXXXXGOOOOOXXXXXXXXXXXXXXGOOOOOOOOXXXXXXXXXXXGOOOOOOXXXXXXXXXXXXXGOOOOOOOOOOOXXXXXXXXGOOOOOOOXXXXXXXXXXXXGOOXXXXXXXXXXXXXXXXXGOOOOOOOOXXXXXXXXXXXGOOOXXXXXXXXXXXXXXXXGOOOOOOOOOOXXXXXXXXXGOOOOOOOOOOOXXXXXXXXGOOOXXXXXXXXXXXXXXXX,0,0,0
28917,106,0,106,44,450,0,0,157,81,76,GOOOOOOOOOOOXXXXXXXXGOOOOOOOOXXXXXXXXXXXGOOOOOXXXXXXXXXXXXXXGOOOOOOOOXXXXXXXXXXXGOOOOOOXXXXXXXXXXXXXGOOOOOOOOOOOXXXXXXXXGOOOOOOOXXXXXXXXXXXXGOOXXXXXXXXXXXXXXXXXGOOOOOOOOXXXXXXXXXXXGOOOXXXXXXXXXXXXXXXXGOOOOOOOOOOXXXXXXXXXGOOOOOOOOOOOXXXXXXXXGOOOXXXXXXXXXXXXXXXX,0,0,0
28938,106,0,106,47,447,0,0,154,79,75,GOOOOOOOOOOOXXXXXXXXGOOOOOOOOXXXXXXXXXXXGOOOOOXXXXXXXXXXXXXXGOOOOOOOOXXXXXXXXXXXGOOOOOOXXXXXXXXXXXXXGOOOOOOOOOOOXXXXXXXXGOOOOOOOXXXXXXXXXXXXGOOXXXXXXXXXXXXXXXXXGOOOOOOOOXXXXXXXXXXXGOOOXXXXXXXXXXXXXXXXGOOOOOOOOOOXXXXXXXXXGOOOOOOOOOOOXXXXXXXXGOOOXXXXXXXXXXXXXXXX,0,0,0
28959,106,0,106,42,452,0,0,159,80,79,GOOOOOOOOOOOXXXXXXXXGOOOOOOOOXXXXXXXXXXXGOOOOOXXXXXXXXXXXXXXGOOOOOOOOXXXXXXXXXXXGOOOOOOXXXXXXXXXXXXXGOOOOOOOOOOOXXXXXXXXGOOOOOOOXXXXXXXXXXXXGOOXXXXXXXXXXXXXXXXXGOOOOOOOOXXXXXXXXXXXGOOOXXXXXXXXXXXXXXXXGOOOOOOOOOOXXXXXXXXXGOOOOOOOOOOOXXXXXXXXGOOOXXXXXXXXXXXXXXXX,0,0,0

28980,106,0,106,42,452,0,0,159,82,77,GOOOOOOOOOOOXXXXXXXXGOOOOOOOOXXXXXXXXXXXGOOOOOXXXXXXXXXXXXXXGOOOOOOOOXXXXXXXXXXXGOOOOOOXXXXXXXXXXXXXGOOOOOOOOOOOXXXXXXXXGOOOOOOOXXXXXXXXXXXXGOOXXXXXXXXXXXXXXXXXGOOOOOOOOXXXXXXXXXXXGOOOXXXXXXXXXXXXXXXXGOOOOOOOOOOXXXXXXXXXGOOOOOOOOOOOXXXXXXXXGOOOXXXXXXXXXXXXXXXX,0,0,0
29001,106,0,106,39,455,0,0,162,81,81,GOOOOOOOOOOOXXXXXXXXGOOOOOOOOXXXXXXXXXXXGOOOOOXXXXXXXXXXXXXXGOOOOOOOOXXXXXXXXXXXGOOOOOOXXXXXXXXXXXXXGOOOOOOOOOOOXXXXXXXXGOOOOOOOXXXXXXXXXXXXGOOXXXXXXXXXXXXXXXXXGOOOOOOOOXXXXXXXXXXXGOOOXXXXXXXXXXXXXXXXGOOOOOOOOOOXXXXXXXXXGOOOOOOOOOOOXXXXXXXXGOOOXXXXXXXXXXXXXXXX,0,0,0
29022,106,0,106,41,453,0,0,160,82,78,GOOOOOOOOOOOXXXXXXXXGOOOOOOOOXXXXXXXXXXXGOOOOOXXXXXXXXXXXXXXGOOOOOOOOXXXXXXXXXXXGOOOOOOXXXXXXXXXXXXXGOOOOOOOOOOOXXXXXXXXGOOOOOOOXXXXXXXXXXXXGOOXXXXXXXXXXXXXXXXXGOOOOOOOOXXXXXXXXXXXGOOOXXXXXXXXXXXXXXXXGOOOOOOOOOOXXXXXXXXXGOOOOOOOOOOOXXXXXXXXGOOOXXXXXXXXXXXXXXXX,0,0,0
29043,106,0,106,41,453,0,0,160,81,79,GOOOOOOOOOOOXXXXXXXXGOOOOOOOOXXXXXXXXXXXGOOOOOXXXXXXXXXXXXXXGOOOOOOOOXXXXXXXXXXXGOOOOOOXXXXXXXXXXXXXGOOOOOOOOOOOXXXXXXXXGOOOOOOOXXXXXXXXXXXXGOOXXXXXXXXXXXXXXXXXGOOOOOOOOXXXXXXXXXXXGOOOXXXXXXXXXXXXXXXXGOOOOOOOOOOXXXXXXXXXGOOOOOOOOOOOXXXXXXXXGOOOXXXXXXXXXXXXXXXX,0,0,0
29064,106,0,106,42,452,0,0,159,81,78,GOOOOOOOOOOOXXXXXXXXGOOOOOOOOXXXXXXXXXXXGOOOOOXXXXXXXXXXXXXXGOOOOOOOOXXXXXXXXXXXGOOOOOOXXXXXXXXXXXXXGOOOOOOOOOOOXXXXXXXXGOOOOOOOXXXXXXXXXXXXGOOXXXXXXXXXXXXXXXXXGOOOOOOOOXXXXXXXXXXXGOOOXXXXXXXXXXXXXXXXGOOOOOOOOOOXXXXXXXXXGOOOOOOOOOOOXXXXXXXXGOOOXXXXXXXXXXXXXXXX,0,0,0

29085,106,0,106,44,450,0,0,157,85,72,GOOOOOOOOOOOXXXXXXXXGOOOOOOOOXXXXXXXXXXXGOOOOOXXXXXXXXXXXXXXGOOOOOOOOXXXXXXXXXXXGOOOOOOXXXXXXXXXXXXXGOOOOOOOOOOOXXXXXXXXGOOOOOOOXXXXXXXXXXXXGOOXXXXXXXXXXXXXXXXXGOOOOOOOOXXXXXXXXXXXGOOOXXXXXXXXXXXXXXXXGOOOOOOOOOOXXXXXXXXXGOOOOOOOOOOOXXXXXXXXGOOOXXXXXXXXXXXXXXXX,0,0,0
29106,106,0,106,39,455,0,0,162,81,81,GOOOOOOOOOOOXXXXXXXXGOOOOOOOOXXXXXXXXXXXGOOOOOXXXXXXXXXXXXXXGOOOOOOOOXXXXXXXXXXXGOOOOOOXXXXXXXXXXXXXGOOOOOOOOOOOXXXXXXXXGOOOOOOOXXXXXXXXXXXXGOOXXXXXXXXXXXXXXXXXGOOOOOOOOXXXXXXXXXXXGOOOXXXXXXXXXXXXXXXXGOOOOOOOOOOXXXXXXXXXGOOOOOOOOOOOXXXXXXXXGOOOXXXXXXXXXXXXXXXX,0,0,0
29127,106,0,106,41,453,0,0,159,79,80,GOOOOOOOOOOOXXXXXXXXGOOOOOOOOXXXXXXXXXXXGOOOOOXXXXXXXXXXXXXXGOOOOOOOOXXXXXXXXXXXGOOOOOOXXXXXXXXXXXXXGOOOOOOOOOOOXXXXXXXXGOOOOOOOXXXXXXXXXXXXGOOXXXXXXXXXXXXXXXXXGOOOOOOOOXXXXXXXXXXXGOOOXXXXXXXXXXXXXXXXGOOOOOOOOOOXXXXXXXXXGOOOOOOOOOOOXXXXXXXXGOOOXXXXXXXXXXXXXXXX,0,0,0
29148,106,0,106,38,456,0,0,162,80,82,GOOOOOOOOOOOXXXXXXXXGOOOOOOOOXXXXXXXXXXXGOOOOOXXXXXXXXXXXXXXGOOOOOOOOXXXXXXXXXXXGOOOOOOXXXXXXXXXXXXXGOOOOOOOOOOOXXXXXXXXGOOOOOOOXXXXXXXXXXXXGOOXXXXXXXXXXXXXXXXXGOOOOOOOOXXXXXXXXXXXGOOOXXXXXXXXXXXXXXXXGOOOOOOOOOOXXXXXXXXXGOOOOOOOOOOOXXXXXXXXGOOOXXXXXXXXXXXXXXXX,0,0,0
29169,106,0,106,37,457,0,0,162,79,83,GOOOOOOOOOOOXXXXXXXXGOOOOOOOOXXXXXXXXXXXGOOOOOXXXXXXXXXXXXXXGOOOOOOOOXXXXXXXXXXXGOOOOOOXXXXXXXXXXXXXGOOOOOOOOOOOXXXXXXXXGOOOOOOOXXXXXXXXXXXXGOOXXXXXXXXXXXXXXXXXGOOOOOOOOXXXXXXXXXXXGOOOXXXXXXXXXXXXXXXXGOOOOOOOOOOXXXXXXXXXGOOOOOOOOOOOXXXXXXXXGOOOXXXXXXXXXXXXXXXX,0,0,0

29190,106,0,106,35,459,0,0,164,80,84,GOOOOOOOOOOOXXXXXXXXGOOOOOOOOXXXXXXXXXXXGOOOOOXXXXXXXXXXXXXXGOOOOOOOOXXXXXXXXXXXGOOOOOOXXXXXXXXXXXXXGOOOOOOOOOOOXXXXXXXXGOOOOOOOXXXXXXXXXXXXGOOXXXXXXXXXXXXXXXXXGOOOOOOOOXXXXXXXXXXXGOOOXXXXXXXXXXXXXXXXGOOOOOOOOOOXXXXXXXXXGOOOOOOOOOOOXXXXXXXXGOOOXXXXXXXXXXXXXXXX,0,0,0
29211,106,0,106,36,458,0,0,164,81,83,GOOOOOOOOOOOXXXXXXXXGOOOOOOOOXXXXXXXXXXXGOOOOOXXXXXXXXXXXXXXGOOOOOOOOXXXXXXXXXXXGOOOOOOXXXXXXXXXXXXXGOOOOOOOOOOOXXXXXXXXGOOOOOOOXXXXXXXXXXXXGOOXXXXXXXXXXXXXXXXXGOOOOOOOOXXXXXXXXXXXGOOOXXXXXXXXXXXXXXXXGOOOOOOOOOOXXXXXXXXXGOOOOOOOOOOOXXXXXXXXGOOOXXXXXXXXXXXXXXXX,0,0,0
29232,106,0,106,38,456,0,0,162,81,81,GOOOOOOOOOOOXXXXXXXXGOOOOOOOOXXXXXXXXXXXGOOOOOXXXXXXXXXXXXXXGOOOOOOOOXXXXXXXXXXXGOOOOOOXXXXXXXXXXXXXGOOOOOOOOOOOXXXXXXXXGOOOOOOOXXXXXXXXXXXXGOOXXXXXXXXXXXXXXXXXGOOOOOOOOXXXXXXXXXXXGOOOXXXXXXXXXXXXXXXXGOOOOOOOOOOXXXXXXXXXGOOOOOOOOOOOXXXXXXXXGOOOXXXXXXXXXXXXXXXX,0,0,0
29253,106,0,106,39,455,0,0,161,85,76,GOOOOOOOOOOOXXXXXXXXGOOOOOOOOXXXXXXXXXXXGOOOOOXXXXXXXXXXXXXXGOOOOOOOOXXXXXXXXXXXGOOOOOOXXXXXXXXXXXXXGOOOOOOOOOOOXXXXXXXXGOOOOOOOXXXXXXXXXXXXGOOXXXXXXXXXXXXXXXXXGOOOOOOOOXXXXXXXXXXXGOOOXXXXXXXXXXXXXXXXGOOOOOOOOOOXXXXXXXXXGOOOOOOOOOOOXXXXXXXXGOOOXXXXXXXXXXXXXXXX,0,0,0
29274,106,0,106,40,454,0,0,160,85,75,GOOOOOOOOOOOXXXXXXXXGOOOOOOOOXXXXXXXXXXXGOOOOOXXXXXXXXXXXXXXGOOOOOOOOXXXXXXXXXXXGOOOOOOXXXXXXXXXXXXXGOOOOOOOOOOOXXXXXXXXGOOOOOOOXXXXXXXXXXXXGOOXXXXXXXXXXXXXXXXXGOOOOOOOOXXXXXXXXXXXGOOOXXXXXXXXXXXXXXXXGOOOOOOOOOOXXXXXXXXXGOOOOOOOOOOOXXXXXXXXGOOOXXXXXXXXXXXXXXXX,0,0,0

29295,106,0,106,39,455,0,0,161,84,77,GOOOOOOOOOOOXXXXXXXXGOOOOOOOOXXXXXXXXXXXGOOOOOXXXXXXXXXXXXXXGOOOOOOOOXXXXXXXXXXXGOOOOOOXXXXXXXXXXXXXGOOOOOOOOOOOXXXXXXXXGOOOOOOOXXXXXXXXXXXXGOOXXXXXXXXXXXXXXXXXGOOOOOOOOXXXXXXXXXXXGOOOXXXXXXXXXXXXXXXXGOOOOOOOOOOXXXXXXXXXGOOOOOOOOOOOXXXXXXXXGOOOXXXXXXXXXXXXXXXX,0,0,0
29316,106,0,106,43,451,0,0,157,80,77,GOOOOOOOOOOOXXXXXXXXGOOOOOOOOXXXXXXXXXXXGOOOOOXXXXXXXXXXXXXXGOOOOOOOOXXXXXXXXXXXGOOOOOOXXXXXXXXXXXXXGOOOOOOOOOOOXXXXXXXXGOOOOOOOXXXXXXXXXXXXGOOXXXXXXXXXXXXXXXXXGOOOOOOOOXXXXXXXXXXXGOOOXXXXXXXXXXXXXXXXGOOOOOOOOOOXXXXXXXXXGOOOOOOOOOOOXXXXXXXXGOOOXXXXXXXXXXXXXXXX,0,0,0
29337,106,0,106,42,452,0,0,159,82,77,GOOOOOOOOOOOXXXXXXXXGOOOOOOOOXXXXXXXXXXXGOOOOOXXXXXXXXXXXXXXGOOOOOOOOXXXXXXXXXXXGOOOOOOXXXXXXXXXXXXXGOOOOOOOOOOOXXXXXXXXGOOOOOOOXXXXXXXXXXXXGOOXXXXXXXXXXXXXXXXXGOOOOOOOOXXXXXXXXXXXGOOOXXXXXXXXXXXXXXXXGOOOOOOOOOOXXXXXXXXXGOOOOOOOOOOOXXXXXXXXGOOOXXXXXXXXXXXXXXXX,0,0,0
29358,106,0,106,45,449,0,0,156,81,75,GOOOOOOOOOOOXXXXXXXXGOOOOOOOOXXXXXXXXXXXGOOOOOXXXXXXXXXXXXXXGOOOOOOOOXXXXXXXXXXXGOOOOOOXXXXXXXXXXXXXGOOOOOOOOOOOXXXXXXXXGOOOOOOOXXXXXXXXXXXXGOOXXXXXXXXXXXXXXXXXGOOOOOOOOXXXXXXXXXXXGOOOXXXXXXXXXXXXXXXXGOOOOOOOOOOXXXXXXXXXGOOOOOOOOOOOXXXXXXXXGOOOXXXXXXXXXXXXXXXX,0,0,0
29379,106,0,106,41,453,0,0,160,80,80,GOOOOOOOOOOOXXXXXXXXGOOOOOOOOXXXXXXXXXXXGOOOOOXXXXXXXXXXXXXXGOOOOOOOOXXXXXXXXXXXGOOOOOOXXXXXXXXXXXXXGOOOOOOOOOOOXXXXXXXXGOOOOOOOXXXXXXXXXXXXGOOXXXXXXXXXXXXXXXXXGOOOOOOOOXXXXXXXXXXXGOOOXXXXXXXXXXXXXXXXGOOOOOOOOOOXXXXXXXXXGOOOOOOOOOOOXXXXXXXXGOOOXXXXXXXXXXXXXXXX,0,0,0

29400,106,0,106,42,452,0,0,160,80,80,GOOOOOOOOOOOXXXXXXXXGOOOOOOOOXXXXXXXXXXXGOOOOOXXXXXXXXXXXXXXGOOOOOOOOXXXXXXXXXXXGOOOOOOXXXXXXXXXXXXXGOOOOOOOOOOOXXXXXXXXGOOOOOOOXXXXXXXXXXXXGOOXXXXXXXXXXXXXXXXXGOOOOOOOOXXXXXXXXXXXGOOOXXXXXXXXXXXXXXXXGOOOOOOOOOOXXXXXXXXXGOOOOOOOOOOOXXXXXXXXGOOOXXXXXXXXXXXXXXXX,0,0,0
29421,106,0,106,41,453,0,0,160,82,78,GOOOOOOOOOOOXXXXXXXXGOOOOOOOOXXXXXXXXXXXGOOOOOXXXXXXXXXXXXXXGOOOOOOOOXXXXXXXXXXXGOOOOOOXXXXXXXXXXXXXGOOOOOOOOOOOXXXXXXXXGOOOOOOOXXXXXXXXXXXXGOOXXXXXXXXXXXXXXXXXGOOOOOOOOXXXXXXXXXXXGOOOXXXXXXXXXXXXXXXXGOOOOOOOOOOXXXXXXXXXGOOOOOOOOOOOXXXXXXXXGOOOXXXXXXXXXXXXXXXX,0,0,0
29442,106,0,106,42,452,0,0,160,81,79,GOOOOOOOOOOOXXXXXXXXGOOOOOOOOXXXXXXXXXXXGOOOOOXXXXXXXXXXXXXXGOOOOOOOOXXXXXXXXXXXGOOOOOOXXXXXXXXXXXXXGOOOOOOOOOOOXXXXXXXXGOOOOOOOXXXXXXXXXXXXGOOXXXXXXXXXXXXXXXXXGOOOOOOOOXXXXXXXXXXXGOOOXXXXXXXXXXXXXXXXGOOOOOOOOOOXXXXXXXXXGOOOOOOOOOOOXXXXXXXXGOOOXXXXXXXXXXXXXXXX,0,0,0
29463,106,0,106,41,453,0,0,161,80,81,GOOOOOOOOOOOXXXXXXXXGOOOOOOOOXXXXXXXXXXXGOOOOOXXXXXXXXXXXXXXGOOOOOOOOXXXXXXXXXXXGOOOOOOXXXXXXXXXXXXXGOOOOOOOOOOOXXXXXXXXGOOOOOOOXXXXXXXXXXXXGOOXXXXXXXXXXXXXXXXXGOOOOOOOOXXXXXXXXXXXGOOOXXXXXXXXXXXXXXXXGOOOOOOOOOOXXXXXXXXXGOOOOOOOOOOOXXXXXXXXGOOOXXXXXXXXXXXXXXXX,0,0,0
29484,106,0,106,38,456,0,0,164,84,80,GOOOOOOOOOOOXXXXXXXXGOOOOOOOOXXXXXXXXXXXGOOOOOXXXXXXXXXXXXXXGOOOOOOOOXXXXXXXXXXXGOOOOOOXXXXXXXXXXXXXGOOOOOOOOOOOXXXXXXXXGOOOOOOOXXXXXXXXXXXXGOOXXXXXXXXXXXXXXXXXGOOOOOOOOXXXXXXXXXXXGOOOXXXXXXXXXXXXXXXXGOOOOOOOOOOXXXXXXXXXGOOOOOOOOOOOXXXXXXXXGOOOXXXXXXXXXXXXXXXX,0,0,0

29505,106,0,106,38,456,0,0,164,81,83,GOOOOOOOOOOOXXXXXXXXGOOOOOOOOXXXXXXXXXXXGOOOOOXXXXXXXXXXXXXXGOOOOOOOOXXXXXXXXXXXGOOOOOOXXXXXXXXXXXXXGOOOOOOOOOOOXXXXXXXXGOOOOOOOXXXXXXXXXXXXGOOXXXXXXXXXXXXXXXXXGOOOOOOOOXXXXXXXXXXXGOOOXXXXXXXXXXXXXXXXGOOOOOOOOOOXXXXXXXXXGOOOOOOOOOOOXXXXXXXXGOOOXXXXXXXXXXXXXXXX,0,0,0
29526,106,0,106,43,451,0,0,159,81,78,GOOOOOOOOOOOXXXXXXXXGOOOOOOOOXXXXXXXXXXXGOOOOOXXXXXXXXXXXXXXGOOOOOOOOXXXXXXXXXXXGOOOOOOXXXXXXXXXXXXXGOOOOOOOOOOOXXXXXXXXGOOOOOOOXXXXXXXXXXXXGOOXXXXXXXXXXXXXXXXXGOOOOOOOOXXXXXXXXXXXGOOOXXXXXXXXXXXXXXXXGOOOOOOOOOOXXXXXXXXXGOOOOOOOOOOOXXXXXXXXGOOOXXXXXXXXXXXXXXXX,0,0,0
29547,106,0,106,41,453,0,0,161,81,80,GOOOOOOOOOOOXXXXXXXXGOOOOOOOOXXXXXXXXXXXGOOOOOXXXXXXXXXXXXXXGOOOOOOOOXXXXXXXXXXXGOOOOOOXXXXXXXXXXXXXGOOOOOOOOOOOXXXXXXXXGOOOOOOOXXXXXXXXXXXXGOOXXXXXXXXXXXXXXXXXGOOOOOOOOXXXXXXXXXXXGOOOXXXXXXXXXXXXXXXXGOOOOOOOOOOXXXXXXXXXGOOOOOOOOOOOXXXXXXXXGOOOXXXXXXXXXXXXXXXX,0,0,0
29568,106,0,106,41,453,0,0,160,82,78,GOOOOOOOOOOOXXXXXXXXGOOOOOOOOXXXXXXXXXXXGOOOOOXXXXXXXXXXXXXXGOOOOOOOOXXXXXXXXXXXGOOOOOOXXXXXXXXXXXXXGOOOOOOOOOOOXXXXXXXXGOOOOOOOXXXXXXXXXXXXGOOXXXXXXXXXXXXXXXXXGOOOOOOOOXXXXXXXXXXXGOOOXXXXXXXXXXXXXXXXGOOOOOOOOOOXXXXXXXXXGOOOOOOOOOOOXXXXXXXXGOOOXXXXXXXXXXXXXXXX,0,0,0
29589,106,0,106,44,450,0,0,157,85,72,GOOOOOOOOOOOXXXXXXXXGOOOOOOOOXXXXXXXXXXXGOOOOOXXXXXXXXXXXXXXGOOOOOOOOXXXXXXXXXXXGOOOOOOXXXXXXXXXXXXXGOOOOOOOOOOOXXXXXXXXGOOOOOOOXXXXXXXXXXXXGOOXXXXXXXXXXXXXXXXXGOOOOOOOOXXXXXXXXXXXGOOOXXXXXXXXXXXXXXXXGOOOOOOOOOOXXXXXXXXXGOOOOOOOOOOOXXXXXXXXGOOOXXXXXXXXXXXXXXXX,0,0,0

29610,106,0,106,44,450,0,0,157,82,75,GOOOOOOOOOOOXXXXXXXXGOOOOOOOOXXXXXXXXXXXGOOOOOXXXXXXXXXXXXXXGOOOOOOOOXXXXXXXXXXXGOOOOOOXXXXXXXXXXXXXGOOOOOOOOOOOXXXXXXXXGOOOOOOOXXXXXXXXXXXXGOOXXXXXXXXXXXXXXXXXGOOOOOOOOXXXXXXXXXXXGOOOXXXXXXXXXXXXXXXXGOOOOOOOOOOXXXXXXXXXGOOOOOOOOOOOXXXXXXXXGOOOXXXXXXXXXXXXXXXX,0,0,0
29631,106,0,106,41,453,0,0,160,86,74,GOOOOOOOOOOOXXXXXXXXGOOOOOOOOXXXXXXXXXXXGOOOOOXXXXXXXXXXXXXXGOOOOOOOOXXXXXXXXXXXGOOOOOOXXXXXXXXXXXXXGOOOOOOOOOOOXXXXXXXXGOOOOOOOXXXXXXXXXXXXGOOXXXXXXXXXXXXXXXXXGOOOOOOOOXXXXXXXXXXXGOOOXXXXXXXXXXXXXXXXGOOOOOOOOOOXXXXXXXXXGOOOOOOOOOOOXXXXXXXXGOOOXXXXXXXXXXXXXXXX,0,0,0
29652,106,0,106,42,452,0,0,160,84,76,GOOOOOOOOOOOXXXXXXXXGOOOOOOOOXXXXXXXXXXXGOOOOOXXXXXXXXXXXXXXGOOOOOOOOXXXXXXXXXXXGOOOOOOXXXXXXXXXXXXXGOOOOOOOOOOOXXXXXXXXGOOOOOOOXXXXXXXXXXXXGOOXXXXXXXXXXXXXXXXXGOOOOOOOOXXXXXXXXXXXGOOOXXXXXXXXXXXXXXXXGOOOOOOOOOOXXXXXXXXXGOOOOOOOOOOOXXXXXXXXGOOOXXXXXXXXXXXXXXXX,0,0,0
29673,106,0,106,43,451,0,0,159,82,77,GOOOOOOOOOOOXXXXXXXXGOOOOOOOOXXXXXXXXXXXGOOOOOXXXXXXXXXXXXXXGOOOOOOOOXXXXXXXXXXXGOOOOOOXXXXXXXXXXXXXGOOOOOOOOOOOXXXXXXXXGOOOOOOOXXXXXXXXXXXXGOOXXXXXXXXXXXXXXXXXGOOOOOOOOXXXXXXXXXXXGOOOXXXXXXXXXXXXXXXXGOOOOOOOOOOXXXXXXXXXGOOOOOOOOOOOXXXXXXXXGOOOXXXXXXXXXXXXXXXX,0,0,0
29694,106,0,106,45,449,0,0,157,81,76,GOOOOOOOOOOOXXXXXXXXGOOOOOOOOXXXXXXXXXXXGOOOOOXXXXXXXXXXXXXXGOOOOOOOOXXXXXXXXXXXGOOOOOOXXXXXXXXXXXXXGOOOOOOOOOOOXXXXXXXXGOOOOOOOXXXXXXXXXXXXGOOXXXXXXXXXXXXXXXXXGOOOOOOOOXXXXXXXXXXXGOOOXXXXXXXXXXXXXXXXGOOOOOOOOOOXXXXXXXXXGOOOOOOOOOOOXXXXXXXXGOOOXXXXXXXXXXXXXXXX,0,0,0

29715,106,0,106,45,449,0,0,157,79,78,GOOOOOOOOOOOXXXXXXXXGOOOOOOOOXXXXXXXXXXXGOOOOOXXXXXXXXXXXXXXGOOOOOOOOXXXXXXXXXXXGOOOOOOXXXXXXXXXXXXXGOOOOOOOOOOOXXXXXXXXGOOOOOOOXXXXXXXXXXXXGOOXXXXXXXXXXXXXXXXXGOOOOOOOOXXXXXXXXXXXGOOOXXXXXXXXXXXXXXXXGOOOOOOOOOOXXXXXXXXXGOOOOOOOOOOOXXXXXXXXGOOOXXXXXXXXXXXXXXXX,0,0,0
29736,106,0,106,44,450,0,0,157,83,74,GOOOOOOOOOOOXXXXXXXXGOOOOOOOOXXXXXXXXXXXGOOOOOXXXXXXXXXXXXXXGOOOOOOOOXXXXXXXXXXXGOOOOOOXXXXXXXXXXXXXGOOOOOOOOOOOXXXXXXXXGOOOOOOOXXXXXXXXXXXXGOOXXXXXXXXXXXXXXXXXGOOOOOOOOXXXXXXXXXXXGOOOXXXXXXXXXXXXXXXXGOOOOOOOOOOXXXXXXXXXGOOOOOOOOOOOXXXXXXXXGOOOXXXXXXXXXXXXXXXX,0,0,0
29757,106,0,106,40,454,0,0,160,86,74,GOOOOOOOOOOOXXXXXXXXGOOOOOOOOXXXXXXXXXXXGOOOOOXXXXXXXXXXXXXXGOOOOOOOOXXXXXXXXXXXGOOOOOOXXXXXXXXXXXXXGOOOOOOOOOOOXXXXXXXXGOOOOOOOXXXXXXXXXXXXGOOXXXXXXXXXXXXXXXXXGOOOOOOOOXXXXXXXXXXXGOOOXXXXXXXXXXXXXXXXGOOOOOOOOOOXXXXXXXXXGOOOOOOOOOOOXXXXXXXXGOOOXXXXXXXXXXXXXXXX,0,0,0
29778,106,0,106,43,451,0,0,158,83,75,GOOOOOOOOOOOXXXXXXXXGOOOOOOOOXXXXXXXXXXXGOOOOOXXXXXXXXXXXXXXGOOOOOOOOXXXXXXXXXXXGOOOOOOXXXXXXXXXXXXXGOOOOOOOOOOOXXXXXXXXGOOOOOOOXXXXXXXXXXXXGOOXXXXXXXXXXXXXXXXXGOOOOOOOOXXXXXXXXXXXGOOOXXXXXXXXXXXXXXXXGOOOOOOOOOOXXXXXXXXXGOOOOOOOOOOOXXXXXXXXGOOOXXXXXXXXXXXXXXXX,0,0,0
29799,106,0,106,47,447,0,0,155,83,72,GOOOOOOOOOOOXXXXXXXXGOOOOOOOOXXXXXXXXXXXGOOOOOXXXXXXXXXXXXXXGOOOOOOOOXXXXXXXXXXXGOOOOOOXXXXXXXXXXXXXGOOOOOOOOOOOXXXXXXXXGOOOOOOOXXXXXXXXXXXXGOOXXXXXXXXXXXXXXXXXGOOOOOOOOXXXXXXXXXXXGOOOXXXXXXXXXXXXXXXXGOOOOOOOOOOXXXXXXXXXGOOOOOOOOOOOXXXXXXXXGOOOXXXXXXXXXXXXXXXX,0,0,0

29820,106,0,106,47,447,0,0,155,81,74,GOOOOOOOOOOOXXXXXXXXGOOOOOOOOXXXXXXXXXXXGOOOOOXXXXXXXXXXXXXXGOOOOOOOOXXXXXXXXXXXGOOOOOOXXXXXXXXXXXXXGOOOOOOOOOOOXXXXXXXXGOOOOOOOXXXXXXXXXXXXGOOXXXXXXXXXXXXXXXXXGOOOOOOOOXXXXXXXXXXXGOOOXXXXXXXXXXXXXXXXGOOOOOOOOOOXXXXXXXXXGOOOOOOOOOOOXXXXXXXXGOOOXXXXXXXXXXXXXXXX,0,0,0
29841,106,0,106,42,452,0,0,161,82,79,GOOOOOOOOOOOXXXXXXXXGOOOOOOOOXXXXXXXXXXXGOOOOOXXXXXXXXXXXXXXGOOOOOOOOXXXXXXXXXXXGOOOOOOXXXXXXXXXXXXXGOOOOOOOOOOOXXXXXXXXGOOOOOOOXXXXXXXXXXXXGOOXXXXXXXXXXXXXXXXXGOOOOOOOOXXXXXXXXXXXGOOOXXXXXXXXXXXXXXXXGOOOOOOOOOOXXXXXXXXXGOOOOOOOOOOOXXXXXXXXGOOOXXXXXXXXXXXXXXXX,0,0,0
29862,106,0,106,44,450,0,0,157,84,73,GOOOOOOOOOOOXXXXXXXXGOOOOOOOOXXXXXXXXXXXGOOOOOXXXXXXXXXXXXXXGOOOOOOOOXXXXXXXXXXXGOOOOOOXXXXXXXXXXXXXGOOOOOOOOOOOXXXXXXXXGOOOOOOOXXXXXXXXXXXXGOOXXXXXXXXXXXXXXXXXGOOOOOOOOXXXXXXXXXXXGOOOXXXXXXXXXXXXXXXXGOOOOOOOOOOXXXXXXXXXGOOOOOOOOOOOXXXXXXXXGOOOXXXXXXXXXXXXXXXX,0,0,0
29883,106,0,106,44,450,0,0,157,82,75,GOOOOOOOOOOOXXXXXXXXGOOOOOOOOXXXXXXXXXXXGOOOOOXXXXXXXXXXXXXXGOOOOOOOOXXXXXXXXXXXGOOOOOOXXXXXXXXXXXXXGOOOOOOOOOOOXXXXXXXXGOOOOOOOXXXXXXXXXXXXGOOXXXXXXXXXXXXXXXXXGOOOOOOOOXXXXXXXXXXXGOOOXXXXXXXXXXXXXXXXGOOOOOOOOOOXXXXXXXXXGOOOOOOOOOOOXXXXXXXXGOOOXXXXXXXXXXXXXXXX,0,0,0
29904,106,0,106,44,450,0,0,158,80,78,GOOOOOOOOOOOXXXXXXXXGOOOOOOOOXXXXXXXXXXXGOOOOOXXXXXXXXXXXXXXGOOOOOOOOXXXXXXXXXXXGOOOOOOXXXXXXXXXXXXXGOOOOOOOOOOOXXXXXXXXGOOOOOOOXXXXXXXXXXXXGOOXXXXXXXXXXXXXXXXXGOOOOOOOOXXXXXXXXXXXGOOOXXXXXXXXXXXXXXXXGOOOOOOOOOOXXXXXXXXXGOOOOOOOOOOOXXXXXXXXGOOOXXXXXXXXXXXXXXXX,0,0,0

29925,107,1,106,42,451,0,0,159,80,79,GOOOOOOOOOOOXXXXXXXXGOOOOOOOOXXXXXXXXXXXGOOOOOXXXXXXXXXXXXXXGOOOOOOOOXXXXXXXXXXXGOOOOOOXXXXXXXXXXXXXGOOOOOOOOOOOXXXXXXXXGOOOOOOOXXXXXXXXXXXXGOOXXXXXXXXXXXXXXXXXGOOOOOOOOXXXXXXXXXXXGOOOXXXXXXXXXXXXXXXXGOOOOOOOOOOAXXXXXXXXGOOOOOOOOOOOXXXXXXXXGOOOXXXXXXXXXXXXXXXX,0,0,0
29946,107,1,106,42,451,0,0,159,80,79,GOOOOOOOOOOOXXXXXXXXGOOOOOOOOXXXXXXXXXXXGOOOOOXXXXXXXXXXXXXXGOOOOOOOOXXXXXXXXXXXGOOOOOOXXXXXXXXXXXXXGOOOOOOOOOOOXXXXXXXXGOOOOOOOXXXXXXXXXXXXGOOXXXXXXXXXXXXXXXXXGOOOOOOOOXXXXXXXXXXXGOOOXXXXXXXXXXXXXXXXGOOOOOOOOOOAXXXXXXXXGOOOOOOOOOOOXXXXXXXXGOOOXXXXXXXXXXXXXXXX,0,0,0
29967,107,1,106,40,453,0,0,162,81,81,GOOOOOOOOOOOXXXXXXXXGOOOOOOOOXXXXXXXXXXXGOOOOOXXXXXXXXXXXXXXGOOOOOOOOXXXXXXXXXXXGOOOOOOXXXXXXXXXXXXXGOOOOOOOOOOOXXXXXXXXGOOOOOOOXXXXXXXXXXXXGOOXXXXXXXXXXXXXXXXXGOOOOOOOOXXXXXXXXXXXGOOOXXXXXXXXXXXXXXXXGOOOOOOOOOOAXXXXXXXXGOOOOOOOOOOOXXXXXXXXGOOOXXXXXXXXXXXXXXXX,0,0,0
29988,107,0,107,39,454,0,0,163,83,80,GOOOOOOOOOOOXXXXXXXXGOOOOOOOOXXXXXXXXXXXGOOOOOXXXXXXXXXXXXXXGOOOOOOOOXXXXXXXXXXXGOOOOOOXXXXXXXXXXXXXGOOOOOOOOOOOXXXXXXXXGOOOOOOOXXXXXXXXXXXXGOOXXXXXXXXXXXXXXXXXGOOOOOOOOXXXXXXXXXXXGOOOXXXXXXXXXXXXXXXXGOOOOOOOOOOOXXXXXXXXGOOOOOOOOOOOXXXXXXXXGOOOXXXXXXXXXXXXXXXX,0,0,0
30009,107,0,107,42,451,0,0,161,80,81,GOOOOOOOOOOOXXXXXXXXGOOOOOOOOXXXXXXXXXXXGOOOOOXXXXXXXXXXXXXXGOOOOOOOOXXXXXXXXXXXGOOOOOOXXXXXXXXXXXXXGOOOOOOOOOOOXXXXXXXXGOOOOOOOXXXXXXXXXXXXGOOXXXXXXXXXXXXXXXXXGOOOOOOOOXXXXXXXXXXXGOOOXXXXXXXXXXXXXXXXGOOOOOOOOOOOXXXXXXXXGOOOOOOOOOOOXXXXXXXXGOOOXXXXXXXXXXXXXXXX,0,0,0

30030,107,0,107,35,458,0,0,168,82,86,GOOOOOOOOOOOXXXXXXXXGOOOOOOOOXXXXXXXXXXXGOOOOOXXXXXXXXXXXXXXGOOOOOOOOXXXXXXXXXXXGOOOOOOXXXXXXXXXXXXXGOOOOOOOOOOOXXXXXXXXGOOOOOOOXXXXXXXXXXXXGOOXXXXXXXXXXXXXXXXXGOOOOOOOOXXXXXXXXXXXGOOOXXXXXXXXXXXXXXXXGOOOOOOOOOOOXXXXXXXXGOOOOOOOOOOOXXXXXXXXGOOOXXXXXXXXXXXXXXXX,0,0,0
30051,107,0,107,36,457,0,0,167,80,87,GOOOOOOOOOOOXXXXXXXXGOOOOOOOOXXXXXXXXXXXGOOOOOXXXXXXXXXXXXXXGOOOOOOOOXXXXXXXXXXXGOOOOOOXXXXXXXXXXXXXGOOOOOOOOOOOXXXXXXXXGOOOOOOOXXXXXXXXXXXXGOOXXXXXXXXXXXXXXXXXGOOOOOOOOXXXXXXXXXXXGOOOXXXXXXXXXXXXXXXXGOOOOOOOOOOOXXXXXXXXGOOOOOOOOOOOXXXXXXXXGOOOXXXXXXXXXXXXXXXX,0,0,0
30072,107,0,107,33,460,0,0,170,85,85,GOOOOOOOOOOOXXXXXXXXGOOOOOOOOXXXXXXXXXXXGOOOOOXXXXXXXXXXXXXXGOOOOOOOOXXXXXXXXXXXGOOOOOOXXXXXXXXXXXXXGOOOOOOOOOOOXXXXXXXXGOOOOOOOXXXXXXXXXXXXGOOXXXXXXXXXXXXXXXXXGOOOOOOOOXXXXXXXXXXXGOOOXXXXXXXXXXXXXXXXGOOOOOOOOOOOXXXXXXXXGOOOOOOOOOOOXXXXXXXXGOOOXXXXXXXXXXXXXXXX,0,0,0
30093,107,0,107,36,457,0,0,167,85,82,GOOOOOOOOOOOXXXXXXXXGOOOOOOOOXXXXXXXXXXXGOOOOOXXXXXXXXXXXXXXGOOOOOOOOXXXXXXXXXXXGOOOOOOXXXXXXXXXXXXXGOOOOOOOOOOOXXXXXXXXGOOOOOOOXXXXXXXXXXXXGOOXXXXXXXXXXXXXXXXXGOOOOOOOOXXXXXXXXXXXGOOOXXXXXXXXXXXXXXXXGOOOOOOOOOOOXXXXXXXXGOOOOOOOOOOOXXXXXXXXGOOOXXXXXXXXXXXXXXXX,0,0,0
30114,107,0,107,36,457,0,0,167,84,83,GOOOOOOOOOOOXXXXXXXXGOOOOOOOOXXXXXXXXXXXGOOOOOXXXXXXXXXXXXXXGOOOOOOOOXXXXXXXXXXXGOOOOOOXXXXXXXXXXXXXGOOOOOOOOOOOXXXXXXXXGOOOOOOOXXXXXXXXXXXXGOOXXXXXXXXXXXXXXXXXGOOOOOOOOXXXXXXXXXXXGOOOXXXXXXXXXXXXXXXXGOOOOOOOOOOOXXXXXXXXGOOOOOOOOOOOXXXXXXXXGOOOXXXXXXXXXXXXXXXX,0,0,0

30135,107,0,107,36,457,0,0,167,82,85,GOOOOOOOOOOOXXXXXXXXGOOOOOOOOXXXXXXXXXXXGOOOOOXXXXXXXXXXXXXXGOOOOOOOOXXXXXXXXXXXGOOOOOOXXXXXXXXXXXXXGOOOOOOOOOOOXXXXXXXXGOOOOOOOXXXXXXXXXXXXGOOXXXXXXXXXXXXXXXXXGOOOOOOOOXXXXXXXXXXXGOOOXXXXXXXXXXXXXXXXGOOOOOOOOOOOXXXXXXXXGOOOOOOOOOOOXXXXXXXXGOOOXXXXXXXXXXXXXXXX,0,0,0
30156,107,0,107,38,455,0,0,166,80,86,GOOOOOOOOOOOXXXXXXXXGOOOOOOOOXXXXXXXXXXXGOOOOOXXXXXXXXXXXXXXGOOOOOOOOXXXXXXXXXXXGOOOOOOXXXXXXXXXXXXXGOOOOOOOOOOOXXXXXXXXGOOOOOOOXXXXXXXXXXXXGOOXXXXXXXXXXXXXXXXXGOOOOOOOOXXXXXXXXXXXGOOOXXXXXXXXXXXXXXXXGOOOOOOOOOOOXXXXXXXXGOOOOOOOOOOOXXXXXXXXGOOOXXXXXXXXXXXXXXXX,0,0,0
30177,107,0,107,37,456,0,0,166,82,84,GOOOOOOOOOOOXXXXXXXXGOOOOOOOOXXXXXXXXXXXGOOOOOXXXXXXXXXXXXXXGOOOOOOOOXXXXXXXXXXXGOOOOOOXXXXXXXXXXXXXGOOOOOOOOOOOXXXXXXXXGOOOOOOOXXXXXXXXXXXXGOOXXXXXXXXXXXXXXXXXGOOOOOOOOXXXXXXXXXXXGOOOXXXXXXXXXXXXXXXXGOOOOOOOOOOOXXXXXXXXGOOOOOOOOOOOXXXXXXXXGOOOXXXXXXXXXXXXXXXX,0,0,0
30198,107,0,107,37,456,0,0,166,82,84,GOOOOOOOOOOOXXXXXXXXGOOOOOOOOXXXXXXXXXXXGOOOOOXXXXXXXXXXXXXXGOOOOOOOOXXXXXXXXXXXGOOOOOOXXXXXXXXXXXXXGOOOOOOOOOOOXXXXXXXXGOOOOOOOXXXXXXXXXXXXGOOXXXXXXXXXXXXXXXXXGOOOOOOOOXXXXXXXXXXXGOOOXXXXXXXXXXXXXXXXGOOOOOOOOOOOXXXXXXXXGOOOOOOOOOOOXXXXXXXXGOOOXXXXXXXXXXXXXXXX,0,0,0
30219,107,0,107,39,454,0,0,163,83,80,GOOOOOOOOOOOXXXXXXXXGOOOOOOOOXXXXXXXXXXXGOOOOOXXXXXXXXXXXXXXGOOOOOOOOXXXXXXXXXXXGOOOOOOXXXXXXXXXXXXXGOOOOOOOOOOOXXXXXXXXGOOOOOOOXXXXXXXXXXXXGOOXXXXXXXXXXXXXXXXXGOOOOOOOOXXXXXXXXXXXGOOOXXXXXXXXXXXXXXXXGOOOOOOOOOOOXXXXXXXXGOOOOOOOOOOOXXXXXXXXGOOOXXXXXXXXXXXXXXXX,0,0,0

30240,108,1,107,42,450,0,0,160,83,77,GOOOOOOOOOOOXXXXXXXXGOOOOOOOOXXXXXXXXXXXGOOOOOXXXXXXXXXXXXXXGOOOOOOOOXXXXXXXXXXXGOOOOOOXXXXXXXXXXXXXGOOOOOOOOOOOXXXXXXXXGOOOOOOOXXXXXXXXXXXXGOOXXXXXXXXXXXXXXXXXGOOOOOOOOXXXXXXXXXXXGOOOAXXXXXXXXXXXXXXXGOOOOOOOOOOOXXXXXXXXGOOOOOOOOOOOXXXXXXXXGOOOXXXXXXXXXXXXXXXX,0,0,0
30261,108,1,107,44,448,0,0,157,81,76,GOOOOOOOOOOOXXXXXXXXGOOOOOOOOXXXXXXXXXXXGOOOOOXXXXXXXXXXXXXXGOOOOOOOOXXXXXXXXXXXGOOOOOOXXXXXXXXXXXXXGOOOOOOOOOOOXXXXXXXXGOOOOOOOXXXXXXXXXXXXGOOXXXXXXXXXXXXXXXXXGOOOOOOOOXXXXXXXXXXXGOOOAXXXXXXXXXXXXXXXGOOOOOOOOOOOXXXXXXXXGOOOOOOOOOOOXXXXXXXXGOOOXXXXXXXXXXXXXXXX,0,0,0
30282,108,1,107,45,447,0,0,156,83,73,GOOOOOOOOOOOXXXXXXXXGOOOOOOOOXXXXXXXXXXXGOOOOOXXXXXXXXXXXXXXGOOOOOOOOXXXXXXXXXXXGOOOOOOXXXXXXXXXXXXXGOOOOOOOOOOOXXXXXXXXGOOOOOOOXXXXXXXXXXXXGOOXXXXXXXXXXXXXXXXXGOOOOOOOOXXXXXXXXXXXGOOOAXXXXXXXXXXXXXXXGOOOOOOOOOOOXXXXXXXXGOOOOOOOOOOOXXXXXXXXGOOOXXXXXXXXXXXXXXXX,0,0,0
30303,108,1,107,43,449,0,0,157,84,73,GOOOOOOOOOOOXXXXXXXXGOOOOOOOOXXXXXXXXXXXGOOOOOXXXXXXXXXXXXXXGOOOOOOOOXXXXXXXXXXXGOOOOOOXXXXXXXXXXXXXGOOOOOOOOOOOXXXXXXXXGOOOOOOOXXXXXXXXXXXXGOOXXXXXXXXXXXXXXXXXGOOOOOOOOXXXXXXXXXXXGOOOAXXXXXXXXXXXXXXXGOOOOOOOOOOOXXXXXXXXGOOOOOOOOOOOXXXXXXXXGOOOXXXXXXXXXXXXXXXX,0,0,0
30324,108,1,107,45,447,0,0,155,85,70,GOOOOOOOOOOOXXXXXXXXGOOOOOOOOXXXXXXXXXXXGOOOOOXXXXXXXXXXXXXXGOOOOOOOOXXXXXXXXXXXGOOOOOOXXXXXXXXXXXXXGOOOOOOOOOOOXXXXXXXXGOOOOOOOXXXXXXXXXXXXGOOXXXXXXXXXXXXXXXXXGOOOOOOOOXXXXXXXXXXXGOOOAXXXXXXXXXXXXXXXGOOOOOOOOOOOXXXXXXXXGOOOOOOOOOOOXXXXXXXXGOOOXXXXXXXXXXXXXXXX,0,0,0

30345,108,1,107,48,444,0,0,151,84,67,GOOOOOOOOOOOXXXXXXXXGOOOOOOOOXXXXXXXXXXXGOOOOOXXXXXXXXXXXXXXGOOOOOOOOXXXXXXXXXXXGOOOOOOXXXXXXXXXXXXXGOOOOOOOOOOOXXXXXXXXGOOOOOOOXXXXXXXXXXXXGOOXXXXXXXXXXXXXXXXXGOOOOOOOOXXXXXXXXXXXGOOOAXXXXXXXXXXXXXXXGOOOOOOOOOOOXXXXXXXXGOOOOOOOOOOOXXXXXXXXGOOOXXXXXXXXXXXXXXXX,0,0,0
30366,108,1,107,51,441,0,0,148,83,65,GOOOOOOOOOOOXXXXXXXXGOOOOOOOOXXXXXXXXXXXGOOOOOXXXXXXXXXXXXXXGOOOOOOOOXXXXXXXXXXXGOOOOOOXXXXXXXXXXXXXGOOOOOOOOOOOXXXXXXXXGOOOOOOOXXXXXXXXXXXXGOOXXXXXXXXXXXXXXXXXGOOOOOOOOXXXXXXXXXXXGOOOAXXXXXXXXXXXXXXXGOOOOOOOOOOOXXXXXXXXGOOOOOOOOOOOXXXXXXXXGOOOXXXXXXXXXXXXXXXX,0,0,0
30387,108,0,108,52,440,0,0,148,82,66,GOOOOOOOOOOOXXXXXXXXGOOOOOOOOXXXXXXXXXXXGOOOOOXXXXXXXXXXXXXXGOOOOOOOOXXXXXXXXXXXGOOOOOOXXXXXXXXXXXXXGOOOOOOOOOOOXXXXXXXXGOOOOOOOXXXXXXXXXXXXGOOXXXXXXXXXXXXXXXXXGOOOOOOOOXXXXXXXXXXXGOOOOXXXXXXXXXXXXXXXGOOOOOOOOOOOXXXXXXXXGOOOOOOOOOOOXXXXXXXXGOOOXXXXXXXXXXXXXXXX,0,0,0
30408,108,0,108,49,443,0,0,151,81,70,GOOOOOOOOOOOXXXXXXXXGOOOOOOOOXXXXXXXXXXXGOOOOOXXXXXXXXXXXXXXGOOOOOOOOXXXXXXXXXXXGOOOOOOXXXXXXXXXXXXXGOOOOOOOOOOOXXXXXXXXGOOOOOOOXXXXXXXXXXXXGOOXXXXXXXXXXXXXXXXXGOOOOOOOOXXXXXXXXXXXGOOOOXXXXXXXXXXXXXXXGOOOOOOOOOOOXXXXXXXXGOOOOOOOOOOOXXXXXXXXGOOOXXXXXXXXXXXXXXXX,0,0,0
30429,108,0,108,46,446,0,0,152,81,71,GOOOOOOOOOOOXXXXXXXXGOOOOOOOOXXXXXXXXXXXGOOOOOXXXXXXXXXXXXXXGOOOOOOOOXXXXXXXXXXXGOOOOOOXXXXXXXXXXXXXGOOOOOOOOOOOXXXXXXXXGOOOOOOOXXXXXXXXXXXXGOOXXXXXXXXXXXXXXXXXGOOOOOOOOXXXXXXXXXXXGOOOOXXXXXXXXXXXXXXXGOOOOOOOOOOOXXXXXXXXGOOOOOOOOOOOXXXXXXXXGOOOXXXXXXXXXXXXXXXX,0,0,0

30450,108,0,108,43,449,0,0,155,85,70,GOOOOOOOOOOOXXXXXXXXGOOOOOOOOXXXXXXXXXXXGOOOOOXXXXXXXXXXXXXXGOOOOOOOOXXXXXXXXXXXGOOOOOOXXXXXXXXXXXXXGOOOOOOOOOOOXXXXXXXXGOOOOOOOXXXXXXXXXXXXGOOXXXXXXXXXXXXXXXXXGOOOOOOOOXXXXXXXXXXXGOOOOXXXXXXXXXXXXXXXGOOOOOOOOOOOXXXXXXXXGOOOOOOOOOOOXXXXXXXXGOOOXXXXXXXXXXXXXXXX,0,0,0
30471,108,0,108,41,451,0,0,158,82,76,GOOOOOOOOOOOXXXXXXXXGOOOOOOOOXXXXXXXXXXXGOOOOOXXXXXXXXXXXXXXGOOOOOOOOXXXXXXXXXXXGOOOOOOXXXXXXXXXXXXXGOOOOOOOOOOOXXXXXXXXGOOOOOOOXXXXXXXXXXXXGOOXXXXXXXXXXXXXXXXXGOOOOOOOOXXXXXXXXXXXGOOOOXXXXXXXXXXXXXXXGOOOOOOOOOOOXXXXXXXXGOOOOOOOOOOOXXXXXXXXGOOOXXXXXXXXXXXXXXXX,0,0,0
30492,108,0,108,38,454,0,0,162,85,77,GOOOOOOOOOOOXXXXXXXXGOOOOOOOOXXXXXXXXXXXGOOOOOXXXXXXXXXXXXXXGOOOOOOOOXXXXXXXXXXXGOOOOOOXXXXXXXXXXXXXGOOOOOOOOOOOXXXXXXXXGOOOOOOOXXXXXXXXXXXXGOOXXXXXXXXXXXXXXXXXGOOOOOOOOXXXXXXXXXXXGOOOOXXXXXXXXXXXXXXXGOOOOOOOOOOOXXXXXXXXGOOOOOOOOOOOXXXXXXXXGOOOXXXXXXXXXXXXXXXX,0,0,0
30513,108,0,108,37,455,0,0,163,84,79,GOOOOOOOOOOOXXXXXXXXGOOOOOOOOXXXXXXXXXXXGOOOOOXXXXXXXXXXXXXXGOOOOOOOOXXXXXXXXXXXGOOOOOOXXXXXXXXXXXXXGOOOOOOOOOOOXXXXXXXXGOOOOOOOXXXXXXXXXXXXGOOXXXXXXXXXXXXXXXXXGOOOOOOOOXXXXXXXXXXXGOOOOXXXXXXXXXXXXXXXGOOOOOOOOOOOXXXXXXXXGOOOOOOOOOOOXXXXXXXXGOOOXXXXXXXXXXXXXXXX,0,0,0
30534,108,0,108,37,455,0,0,163,82,81,GOOOOOOOOOOOXXXXXXXXGOOOOOOOOXXXXXXXXXXXGOOOOOXXXXXXXXXXXXXXGOOOOOOOOXXXXXXXXXXXGOOOOOOXXXXXXXXXXXXXGOOOOOOOOOOOXXXXXXXXGOOOOOOOXXXXXXXXXXXXGOOXXXXXXXXXXXXXXXXXGOOOOOOOOXXXXXXXXXXXGOOOOXXXXXXXXXXXXXXXGOOOOOOOOOOOXXXXXXXXGOOOOOOOOOOOXXXXXXXXGOOOXXXXXXXXXXXXXXXX,0,0,0

30555,108,0,108,38,454,0,0,162,86,76,GOOOOOOOOOOOXXXXXXXXGOOOOOOOOXXXXXXXXXXXGOOOOOXXXXXXXXXXXXXXGOOOOOOOOXXXXXXXXXXXGOOOOOOXXXXXXXXXXXXXGOOOOOOOOOOOXXXXXXXXGOOOOOOOXXXXXXXXXXXXGOOXXXXXXXXXXXXXXXXXGOOOOOOOOXXXXXXXXXXXGOOOOXXXXXXXXXXXXXXXGOOOOOOOOOOOXXXXXXXXGOOOOOOOOOOOXXXXXXXXGOOOXXXXXXXXXXXXXXXX,0,0,0
30576,108,0,108,43,449,0,0,157,84,73,GOOOOOOOOOOOXXXXXXXXGOOOOOOOOXXXXXXXXXXXGOOOOOXXXXXXXXXXXXXXGOOOOOOOOXXXXXXXXXXXGOOOOOOXXXXXXXXXXXXXGOOOOOOOOOOOXXXXXXXXGOOOOOOOXXXXXXXXXXXXGOOXXXXXXXXXXXXXXXXXGOOOOOOOOXXXXXXXXXXXGOOOOXXXXXXXXXXXXXXXGOOOOOOOOOOOXXXXXXXXGOOOOOOOOOOOXXXXXXXXGOOOXXXXXXXXXXXXXXXX,0,0,0
30597,108,0,108,47,445,0,0,153,82,71,GOOOOOOOOOOOXXXXXXXXGOOOOOOOOXXXXXXXXXXXGOOOOOXXXXXXXXXXXXXXGOOOOOOOOXXXXXXXXXXXGOOOOOOXXXXXXXXXXXXXGOOOOOOOOOOOXXXXXXXXGOOOOOOOXXXXXXXXXXXXGOOXXXXXXXXXXXXXXXXXGOOOOOOOOXXXXXXXXXXXGOOOOXXXXXXXXXXXXXXXGOOOOOOOOOOOXXXXXXXXGOOOOOOOOOOOXXXXXXXXGOOOXXXXXXXXXXXXXXXX,0,0,0
30618,109,1,108,46,445,0,0,153,84,69,GOOOOOOOOOOOXXXXXXXXGOOOOOOOOXXXXXXXXXXXGOOOOOXXXXXXXXXXXXXXGOOOOOOOOXXXXXXXXXXXGOOOOOOXXXXXXXXXXXXXGOOOOOOOOOOOXXXXXXXXGOOOOOOOXXXXXXXXXXXXGOOXXXXXXXXXXXXXXXXXGOOOOOOOOXXXXXXXXXXXGOOOOXXXXXXXXXXXXXXXGOOOOOOOOOOOXXXXXXXXGOOOOOOOOOOOAXXXXXXXGOOOXXXXXXXXXXXXXXXX,0,0,0
30639,109,1,108,46,445,0,0,153,84,69,GOOOOOOOOOOOXXXXXXXXGOOOOOOOOXXXXXXXXXXXGOOOOOXXXXXXXXXXXXXXGOOOOOOOOXXXXXXXXXXXGOOOOOOXXXXXXXXXXXXXGOOOOOOOOOOOXXXXXXXXGOOOOOOOXXXXXXXXXXXXGOOXXXXXXXXXXXXXXXXXGOOOOOOOOXXXXXXXXXXXGOOOOXXXXXXXXXXXXXXXGOOOOOOOOOOOXXXXXXXXGOOOOOOOOOOOAXXXXXXXGOOOXXXXXXXXXXXXXXXX,0,0,0

30660,109,1,108,43,448,0,0,155,82,73,GOOOOOOOOOOOXXXXXXXXGOOOOOOOOXXXXXXXXXXXGOOOOOXXXXXXXXXXXXXXGOOOOOOOOXXXXXXXXXXXGOOOOOOXXXXXXXXXXXXXGOOOOOOOOOOOXXXXXXXXGOOOOOOOXXXXXXXXXXXXGOOXXXXXXXXXXXXXXXXXGOOOOOOOOXXXXXXXXXXXGOOOOXXXXXXXXXXXXXXXGOOOOOOOOOOOXXXXXXXXGOOOOOOOOOOOAXXXXXXXGOOOXXXXXXXXXXXXXXXX,0,0,0
30681,109,1,108,38,453,0,0,160,81,79,GOOOOOOOOOOOXXXXXXXXGOOOOOOOOXXXXXXXXXXXGOOOOOXXXXXXXXXXXXXXGOOOOOOOOXXXXXXXXXXXGOOOOOOXXXXXXXXXXXXXGOOOOOOOOOOOXXXXXXXXGOOOOOOOXXXXXXXXXXXXGOOXXXXXXXXXXXXXXXXXGOOOOOOOOXXXXXXXXXXXGOOOOXXXXXXXXXXXXXXXGOOOOOOOOOOOXXXXXXXXGOOOOOOOOOOOAXXXXXXXGOOOXXXXXXXXXXXXXXXX,0,0,0
30702,109,0,109,39,452,0,0,159,83,76,GOOOOOOOOOOOXXXXXXXXGOOOOOOOOXXXXXXXXXXXGOOOOOXXXXXXXXXXXXXXGOOOOOOOOXXXXXXXXXXXGOOOOOOXXXXXXXXXXXXXGOOOOOOOOOOOXXXXXXXXGOOOOOOOXXXXXXXXXXXXGOOXXXXXXXXXXXXXXXXXGOOOOOOOOXXXXXXXXXXXGOOOOXXXXXXXXXXXXXXXGOOOOOOOOOOOXXXXXXXXGOOOOOOOOOOOOXXXXXXXGOOOXXXXXXXXXXXXXXXX,0,0,0
30723,110,1,109,38,452,0,0,159,84,75,GOOOOOOOOOOOXXXXXXXXGOOOOOOOOXXXXXXXXXXXGOOOOOXXXXXXXXXXXXXXGOOOOOOOOXXXXXXXXXXXGOOOOOOXXXXXXXXXXXXXGOOOOOOOOOOOXXXXXXXXGOOOOOOOAXXXXXXXXXXXGOOXXXXXXXXXXXXXXXXXGOOOOOOOOXXXXXXXXXXXGOOOOXXXXXXXXXXXXXXXGOOOOOOOOOOOXXXXXXXXGOOOOOOOOOOOOXXXXXXXGOOOXXXXXXXXXXXXXXXX,0,0,0
30744,110,1,109,39,451,0,0,158,84,74,GOOOOOOOOOOOXXXXXXXXGOOOOOOOOXXXXXXXXXXXGOOOOOXXXXXXXXXXXXXXGOOOOOOOOXXXXXXXXXXXGOOOOOOXXXXXXXXXXXXXGOOOOOOOOOOOXXXXXXXXGOOOOOOOAXXXXXXXXXXXGOOXXXXXXXXXXXXXXXXXGOOOOOOOOXXXXXXXXXXXGOOOOXXXXXXXXXXXXXXXGOOOOOOOOOOOXXXXXXXXGOOOOOOOOOOOOXXXXXXXGOOOXXXXXXXXXXXXXXXX,0,0,0

30765,110,1,109,42,448,0,0,155,82,73,GOOOOOOOOOOOXXXXXXXXGOOOOOOOOXXXXXXXXXXXGOOOOOXXXXXXXXXXXXXXGOOOOOOOOXXXXXXXXXXXGOOOOOOXXXXXXXXXXXXXGOOOOOOOOOOOXXXXXXXXGOOOOOOOAXXXXXXXXXXXGOOXXXXXXXXXXXXXXXXXGOOOOOOOOXXXXXXXXXXXGOOOOXXXXXXXXXXXXXXXGOOOOOOOOOOOXXXXXXXXGOOOOOOOOOOOOXXXXXXXGOOOXXXXXXXXXXXXXXXX,0,0,0
30786,110,1,109,39,451,0,0,158,82,76,GOOOOOOOOOOOXXXXXXXXGOOOOOOOOXXXXXXXXXXXGOOOOOXXXXXXXXXXXXXXGOOOOOOOOXXXXXXXXXXXGOOOOOOXXXXXXXXXXXXXGOOOOOOOOOOOXXXXXXXXGOOOOOOOAXXXXXXXXXXXGOOXXXXXXXXXXXXXXXXXGOOOOOOOOXXXXXXXXXXXGOOOOXXXXXXXXXXXXXXXGOOOOOOOOOOOXXXXXXXXGOOOOOOOOOOOOXXXXXXXGOOOXXXXXXXXXXXXXXXX,0,0,0
30807,110,1,109,39,451,0,0,158,82,76,GOOOOOOOOOOOXXXXXXXXGOOOOOOOOXXXXXXXXXXXGOOOOOXXXXXXXXXXXXXXGOOOOOOOOXXXXXXXXXXXGOOOOOOXXXXXXXXXXXXXGOOOOOOOOOOOXXXXXXXXGOOOOOOOAXXXXXXXXXXXGOOXXXXXXXXXXXXXXXXXGOOOOOOOOXXXXXXXXXXXGOOOOXXXXXXXXXXXXXXXGOOOOOOOOOOOXXXXXXXXGOOOOOOOOOOOOXXXXXXXGOOOXXXXXXXXXXXXXXXX,0,0,0
30828,110,1,109,36,454,0,0,161,87,74,GOOOOOOOOOOOXXXXXXXXGOOOOOOOOXXXXXXXXXXXGOOOOOXXXXXXXXXXXXXXGOOOOOOOOXXXXXXXXXXXGOOOOOOXXXXXXXXXXXXXGOOOOOOOOOOOXXXXXXXXGOOOOOOOAXXXXXXXXXXXGOOXXXXXXXXXXXXXXXXXGOOOOOOOOXXXXXXXXXXXGOOOOXXXXXXXXXXXXXXXGOOOOOOOOOOOXXXXXXXXGOOOOOOOOOOOOXXXXXXXGOOOXXXXXXXXXXXXXXXX,0,0,0
30849,110,1,109,39,451,0,0,157,82,75,GOOOOOOOOOOOXXXXXXXXGOOOOOOOOXXXXXXXXXXXGOOOOOXXXXXXXXXXXXXXGOOOOOOOOXXXXXXXXXXXGOOOOOOXXXXXXXXXXXXXGOOOOOOOOOOOXXXXXXXXGOOOOOOOAXXXXXXXXXXXGOOXXXXXXXXXXXXXXXXXGOOOOOOOOXXXXXXXXXXXGOOOOXXXXXXXXXXXXXXXGOOOOOOOOOOOXXXXXXXXGOOOOOOOOOOOOXXXXXXXGOOOXXXXXXXXXXXXXXXX,0,0,0

30870,110,1,109,40,450,0,0,157,85,72,GOOOOOOOOOOOXXXXXXXXGOOOOOOOOXXXXXXXXXXXGOOOOOXXXXXXXXXXXXXXGOOOOOOOOXXXXXXXXXXXGOOOOOOXXXXXXXXXXXXXGOOOOOOOOOOOXXXXXXXXGOOOOOOOAXXXXXXXXXXXGOOXXXXXXXXXXXXXXXXXGOOOOOOOOXXXXXXXXXXXGOOOOXXXXXXXXXXXXXXXGOOOOOOOOOOOXXXXXXXXGOOOOOOOOOOOOXXXXXXXGOOOXXXXXXXXXXXXXXXX,0,0,0
30891,110,1,109,37,453,0,0,160,87,73,GOOOOOOOOOOOXXXXXXXXGOOOOOOOOXXXXXXXXXXXGOOOOOXXXXXXXXXXXXXXGOOOOOOOOXXXXXXXXXXXGOOOOOOXXXXXXXXXXXXXGOOOOOOOOOOOXXXXXXXXGOOOOOOOAXXXXXXXXXXXGOOXXXXXXXXXXXXXXXXXGOOOOOOOOXXXXXXXXXXXGOOOOXXXXXXXXXXXXXXXGOOOOOOOOOOOXXXXXXXXGOOOOOOOOOOOOXXXXXXXGOOOXXXXXXXXXXXXXXXX,0,0,0
30912,110,1,109,38,452,0,0,159,84,75,GOOOOOOOOOOOXXXXXXXXGOOOOOOOOXXXXXXXXXXXGOOOOOXXXXXXXXXXXXXXGOOOOOOOOXXXXXXXXXXXGOOOOOOXXXXXXXXXXXXXGOOOOOOOOOOOXXXXXXXXGOOOOOOOAXXXXXXXXXXXGOOXXXXXXXXXXXXXXXXXGOOOOOOOOXXXXXXXXXXXGOOOOXXXXXXXXXXXXXXXGOOOOOOOOOOOXXXXXXXXGOOOOOOOOOOOOXXXXXXXGOOOXXXXXXXXXXXXXXXX,0,0,0
30933,110,1,109,39,451,0,0,158,83,75,GOOOOOOOOOOOXXXXXXXXGOOOOOOOOXXXXXXXXXXXGOOOOOXXXXXXXXXXXXXXGOOOOOOOOXXXXXXXXXXXGOOOOOOXXXXXXXXXXXXXGOOOOOOOOOOOXXXXXXXXGOOOOOOOAXXXXXXXXXXXGOOXXXXXXXXXXXXXXXXXGOOOOOOOOXXXXXXXXXXXGOOOOXXXXXXXXXXXXXXXGOOOOOOOOOOOXXXXXXXXGOOOOOOOOOOOOXXXXXXXGOOOXXXXXXXXXXXXXXXX,0,0,0
30954,111,2,109,35,454,0,0,161,82,79,GOOOOOOOOOOOXXXXXXXXGOOOOOOOOXXXXXXXXXXXGOOOOOXXXXXXXXXXXXXXGOOOOOOOOXXXXXXXXXXXGOOOOOOXXXXXXXXXXXXXGOOOOOOOOOOOXXXXXXXXGOOOOOOOAXXXXXXXXXXXGOOXXXXXXXXXXXXXXXXXGOOOOOOOOXXXXXXXXXXXGOOOOXXXXXXXXXXXXXXXGOOOOOOOOOOOXXXXXXXXGOOOOOOOOOOOOAXXXXXXGOOOXXXXXXXXXXXXXXXX,0,0,0

30975,111,2,109,34,455,0,0,163,87,76,GOOOOOOOOOOOXXXXXXXXGOOOOOOOOXXXXXXXXXXXGOOOOOXXXXXXXXXXXXXXGOOOOOOOOXXXXXXXXXXXGOOOOOOXXXXXXXXXXXXXGOOOOOOOOOOOXXXXXXXXGOOOOOOOAXXXXXXXXXXXGOOXXXXXXXXXXXXXXXXXGOOOOOOOOXXXXXXXXXXXGOOOOXXXXXXXXXXXXXXXGOOOOOOOOOOOXXXXXXXXGOOOOOOOOOOOOAXXXXXXGOOOXXXXXXXXXXXXXXXX,0,0,0
30996,111,1,110,39,450,0,0,158,84,74,GOOOOOOOOOOOXXXXXXXXGOOOOOOOOXXXXXXXXXXXGOOOOOXXXXXXXXXXXXXXGOOOOOOOOXXXXXXXXXXXGOOOOOOXXXXXXXXXXXXXGOOOOOOOOOOOXXXXXXXXGOOOOOOOOXXXXXXXXXXXGOOXXXXXXXXXXXXXXXXXGOOOOOOOOXXXXXXXXXXXGOOOOXXXXXXXXXXXXXXXGOOOOOOOOOOOXXXXXXXXGOOOOOOOOOOOOAXXXXXXGOOOXXXXXXXXXXXXXXXX,0,0,0
31017,111,1,110,37,452,0,0,159,86,73,GOOOOOOOOOOOXXXXXXXXGOOOOOOOOXXXXXXXXXXXGOOOOOXXXXXXXXXXXXXXGOOOOOOOOXXXXXXXXXXXGOOOOOOXXXXXXXXXXXXXGOOOOOOOOOOOXXXXXXXXGOOOOOOOOXXXXXXXXXXXGOOXXXXXXXXXXXXXXXXXGOOOOOOOOXXXXXXXXXXXGOOOOXXXXXXXXXXXXXXXGOOOOOOOOOOOXXXXXXXXGOOOOOOOOOOOOAXXXXXXGOOOXXXXXXXXXXXXXXXX,0,0,0
31038,111,1,110,42,447,0,0,155,84,71,GOOOOOOOOOOOXXXXXXXXGOOOOOOOOXXXXXXXXXXXGOOOOOXXXXXXXXXXXXXXGOOOOOOOOXXXXXXXXXXXGOOOOOOXXXXXXXXXXXXXGOOOOOOOOOOOXXXXXXXXGOOOOOOOOXXXXXXXXXXXGOOXXXXXXXXXXXXXXXXXGOOOOOOOOXXXXXXXXXXXGOOOOXXXXXXXXXXXXXXXGOOOOOOOOOOOXXXXXXXXGOOOOOOOOOOOOAXXXXXXGOOOXXXXXXXXXXXXXXXX,0,0,0
31059,111,1,110,41,448,0,0,155,86,69,GOOOOOOOOOOOXXXXXXXXGOOOOOOOOXXXXXXXXXXXGOOOOOXXXXXXXXXXXXXXGOOOOOOOOXXXXXXXXXXXGOOOOOOXXXXXXXXXXXXXGOOOOOOOOOOOXXXXXXXXGOOOOOOOOXXXXXXXXXXXGOOXXXXXXXXXXXXXXXXXGOOOOOOOOXXXXXXXXXXXGOOOOXXXXXXXXXXXXXXXGOOOOOOOOOOOXXXXXXXXGOOOOOOOOOOOOAXXXXXXGOOOXXXXXXXXXXXXXXXX,0,0,0

31080,111,1,110,40,449,0,0,156,82,74,GOOOOOOOOOOOXXXXXXXXGOOOOOOOOXXXXXXXXXXXGOOOOOXXXXXXXXXXXXXXGOOOOOOOOXXXXXXXXXXXGOOOOOOXXXXXXXXXXXXXGOOOOOOOOOOOXXXXXXXXGOOOOOOOOXXXXXXXXXXXGOOXXXXXXXXXXXXXXXXXGOOOOOOOOXXXXXXXXXXXGOOOOXXXXXXXXXXXXXXXGOOOOOOOOOOOXXXXXXXXGOOOOOOOOOOOOAXXXXXXGOOOXXXXXXXXXXXXXXXX,0,0,0
31101,111,0,111,36,453,0,0,159,86,73,GOOOOOOOOOOOXXXXXXXXGOOOOOOOOXXXXXXXXXXXGOOOOOXXXXXXXXXXXXXXGOOOOOOOOXXXXXXXXXXXGOOOOOOXXXXXXXXXXXXXGOOOOOOOOOOOXXXXXXXXGOOOOOOOOXXXXXXXXXXXGOOXXXXXXXXXXXXXXXXXGOOOOOOOOXXXXXXXXXXXGOOOOXXXXXXXXXXXXXXXGOOOOOOOOOOOXXXXXXXXGOOOOOOOOOOOOOXXXXXXGOOOXXXXXXXXXXXXXXXX,0,0,0
31122,111,0,111,38,451,0,0,159,87,72,GOOOOOOOOOOOXXXXXXXXGOOOOOOOOXXXXXXXXXXXGOOOOOXXXXXXXXXXXXXXGOOOOOOOOXXXXXXXXXXXGOOOOOOXXXXXXXXXXXXXGOOOOOOOOOOOXXXXXXXXGOOOOOOOOXXXXXXXXXXXGOOXXXXXXXXXXXXXXXXXGOOOOOOOOXXXXXXXXXXXGOOOOXXXXXXXXXXXXXXXGOOOOOOOOOOOXXXXXXXXGOOOOOOOOOOOOOXXXXXXGOOOXXXXXXXXXXXXXXXX,0,0,0
31143,111,0,111,37,452,0,0,160,85,75,GOOOOOOOOOOOXXXXXXXXGOOOOOOOOXXXXXXXXXXXGOOOOOXXXXXXXXXXXXXXGOOOOOOOOXXXXXXXXXXXGOOOOOOXXXXXXXXXXXXXGOOOOOOOOOOOXXXXXXXXGOOOOOOOOXXXXXXXXXXXGOOXXXXXXXXXXXXXXXXXGOOOOOOOOXXXXXXXXXXXGOOOOXXXXXXXXXXXXXXXGOOOOOOOOOOOXXXXXXXXGOOOOOOOOOOOOOXXXXXXGOOOXXXXXXXXXXXXXXXX,0,0,0
31164,111,0,111,39,450,0,0,158,82,76,GOOOOOOOOOOOXXXXXXXXGOOOOOOOOXXXXXXXXXXXGOOOOOXXXXXXXXXXXXXXGOOOOOOOOXXXXXXXXXXXGOOOOOOXXXXXXXXXXXXXGOOOOOOOOOOOXXXXXXXXGOOOOOOOOXXXXXXXXXXXGOOXXXXXXXXXXXXXXXXXGOOOOOOOOXXXXXXXXXXXGOOOOXXXXXXXXXXXXXXXGOOOOOOOOOOOXXXXXXXXGOOOOOOOOOOOOOXXXXXXGOOOXXXXXXXXXXXXXXXX,0,0,0

31185,111,0,111,39,450,0,0,158,82,76,GOOOOOOOOOOOXXXXXXXXGOOOOOOOOXXXXXXXXXXXGOOOOOXXXXXXXXXXXXXXGOOOOOOOOXXXXXXXXXXXGOOOOOOXXXXXXXXXXXXXGOOOOOOOOOOOXXXXXXXXGOOOOOOOOXXXXXXXXXXXGOOXXXXXXXXXXXXXXXXXGOOOOOOOOXXXXXXXXXXXGOOOOXXXXXXXXXXXXXXXGOOOOOOOOOOOXXXXXXXXGOOOOOOOOOOOOOXXXXXXGOOOXXXXXXXXXXXXXXXX,0,0,0
31206,111,0,111,36,453,0,0,160,82,78,GOOOOOOOOOOOXXXXXXXXGOOOOOOOOXXXXXXXXXXXGOOOOOXXXXXXXXXXXXXXGOOOOOOOOXXXXXXXXXXXGOOOOOOXXXXXXXXXXXXXGOOOOOOOOOOOXXXXXXXXGOOOOOOOOXXXXXXXXXXXGOOXXXXXXXXXXXXXXXXXGOOOOOOOOXXXXXXXXXXXGOOOOXXXXXXXXXXXXXXXGOOOOOOOOOOOXXXXXXXXGOOOOOOOOOOOOOXXXXXXGOOOXXXXXXXXXXXXXXXX,0,0,0
31227,111,0,111,34,455,0,0,163,88,75,GOOOOOOOOOOOXXXXXXXXGOOOOOOOOXXXXXXXXXXXGOOOOOXXXXXXXXXXXXXXGOOOOOOOOXXXXXXXXXXXGOOOOOOXXXXXXXXXXXXXGOOOOOOOOOOOXXXXXXXXGOOOOOOOOXXXXXXXXXXXGOOXXXXXXXXXXXXXXXXXGOOOOOOOOXXXXXXXXXXXGOOOOXXXXXXXXXXXXXXXGOOOOOOOOOOOXXXXXXXXGOOOOOOOOOOOOOXXXXXXGOOOXXXXXXXXXXXXXXXX,0,0,0
31248,111,0,111,40,449,0,0,157,86,71,GOOOOOOOOOOOXXXXXXXXGOOOOOOOOXXXXXXXXXXXGOOOOOXXXXXXXXXXXXXXGOOOOOOOOXXXXXXXXXXXGOOOOOOXXXXXXXXXXXXXGOOOOOOOOOOOXXXXXXXXGOOOOOOOOXXXXXXXXXXXGOOXXXXXXXXXXXXXXXXXGOOOOOOOOXXXXXXXXXXXGOOOOXXXXXXXXXXXXXXXGOOOOOOOOOOOXXXXXXXXGOOOOOOOOOOOOOXXXXXXGOOOXXXXXXXXXXXXXXXX,0,0,0
31269,111,0,111,43,446,0,0,154,84,70,GOOOOOOOOOOOXXXXXXXXGOOOOOOOOXXXXXXXXXXXGOOOOOXXXXXXXXXXXXXXGOOOOOOOOXXXXXXXXXXXGOOOOOOXXXXXXXXXXXXXGOOOOOOOOOOOXXXXXXXXGOOOOOOOOXXXXXXXXXXXGOOXXXXXXXXXXXXXXXXXGOOOOOOOOXXXXXXXXXXXGOOOOXXXXXXXXXXXXXXXGOOOOOOOOOOOXXXXXXXXGOOOOOOOOOOOOOXXXXXXGOOOXXXXXXXXXXXXXXXX,0,0,0

31290,111,0,111,41,448,0,0,155,86,69,GOOOOOOOOOOOXXXXXXXXGOOOOOOOOXXXXXXXXXXXGOOOOOXXXXXXXXXXXXXXGOOOOOOOOXXXXXXXXXXXGOOOOOOXXXXXXXXXXXXXGOOOOOOOOOOOXXXXXXXXGOOOOOOOOXXXXXXXXXXXGOOXXXXXXXXXXXXXXXXXGOOOOOOOOXXXXXXXXXXXGOOOOXXXXXXXXXXXXXXXGOOOOOOOOOOOXXXXXXXXGOOOOOOOOOOOOOXXXXXXGOOOXXXXXXXXXXXXXXXX,0,0,0
31311,111,0,111,44,445,0,0,152,86,66,GOOOOOOOOOOOXXXXXXXXGOOOOOOOOXXXXXXXXXXXGOOOOOXXXXXXXXXXXXXXGOOOOOOOOXXXXXXXXXXXGOOOOOOXXXXXXXXXXXXXGOOOOOOOOOOOXXXXXXXXGOOOOOOOOXXXXXXXXXXXGOOXXXXXXXXXXXXXXXXXGOOOOOOOOXXXXXXXXXXXGOOOOXXXXXXXXXXXXXXXGOOOOOOOOOOOXXXXXXXXGOOOOOOOOOOOOOXXXXXXGOOOXXXXXXXXXXXXXXXX,0,0,0
31332,111,0,111,43,446,0,0,153,87,66,GOOOOOOOOOOOXXXXXXXXGOOOOOOOOXXXXXXXXXXXGOOOOOXXXXXXXXXXXXXXGOOOOOOOOXXXXXXXXXXXGOOOOOOXXXXXXXXXXXXXGOOOOOOOOOOOXXXXXXXXGOOOOOOOOXXXXXXXXXXXGOOXXXXXXXXXXXXXXXXXGOOOOOOOOXXXXXXXXXXXGOOOOXXXXXXXXXXXXXXXGOOOOOOOOOOOXXXXXXXXGOOOOOOOOOOOOOXXXXXXGOOOXXXXXXXXXXXXXXXX,0,0,0
31353,111,0,111,43,446,0,0,153,86,67,GOOOOOOOOOOOXXXXXXXXGOOOOOOOOXXXXXXXXXXXGOOOOOXXXXXXXXXXXXXXGOOOOOOOOXXXXXXXXXXXGOOOOOOXXXXXXXXXXXXXGOOOOOOOOOOOXXXXXXXXGOOOOOOOOXXXXXXXXXXXGOOXXXXXXXXXXXXXXXXXGOOOOOOOOXXXXXXXXXXXGOOOOXXXXXXXXXXXXXXXGOOOOOOOOOOOXXXXXXXXGOOOOOOOOOOOOOXXXXXXGOOOXXXXXXXXXXXXXXXX,0,0,0
31374,111,0,111,45,444,0,0,151,84,67,GOOOOOOOOOOOXXXXXXXXGOOOOOOOOXXXXXXXXXXXGOOOOOXXXXXXXXXXXXXXGOOOOOOOOXXXXXXXXXXXGOOOOOOXXXXXXXXXXXXXGOOOOOOOOOOOXXXXXXXXGOOOOOOOOXXXXXXXXXXXGOOXXXXXXXXXXXXXXXXXGOOOOOOOOXXXXXXXXXXXGOOOOXXXXXXXXXXXXXXXGOOOOOOOOOOOXXXXXXXXGOOOOOOOOOOOOOXXXXXXGOOOXXXXXXXXXXXXXXXX,0,0,0

31395,111,0,111,44,445,0,0,152,86,66,GOOOOOOOOOOOXXXXXXXXGOOOOOOOOXXXXXXXXXXXGOOOOOXXXXXXXXXXXXXXGOOOOOOOOXXXXXXXXXXXGOOOOOOXXXXXXXXXXXXXGOOOOOOOOOOOXXXXXXXXGOOOOOOOOXXXXXXXXXXXGOOXXXXXXXXXXXXXXXXXGOOOOOOOOXXXXXXXXXXXGOOOOXXXXXXXXXXXXXXXGOOOOOOOOOOOXXXXXXXXGOOOOOOOOOOOOOXXXXXXGOOOXXXXXXXXXXXXXXXX,0,0,0
31416,111,0,111,44,445,0,0,151,85,66,GOOOOOOOOOOOXXXXXXXXGOOOOOOOOXXXXXXXXXXXGOOOOOXXXXXXXXXXXXXXGOOOOOOOOXXXXXXXXXXXGOOOOOOXXXXXXXXXXXXXGOOOOOOOOOOOXXXXXXXXGOOOOOOOOXXXXXXXXXXXGOOXXXXXXXXXXXXXXXXXGOOOOOOOOXXXXXXXXXXXGOOOOXXXXXXXXXXXXXXXGOOOOOOOOOOOXXXXXXXXGOOOOOOOOOOOOOXXXXXXGOOOXXXXXXXXXXXXXXXX,0,0,0
31437,111,0,111,46,443,0,0,151,83,68,GOOOOOOOOOOOXXXXXXXXGOOOOOOOOXXXXXXXXXXXGOOOOOXXXXXXXXXXXXXXGOOOOOOOOXXXXXXXXXXXGOOOOOOXXXXXXXXXXXXXGOOOOOOOOOOOXXXXXXXXGOOOOOOOOXXXXXXXXXXXGOOXXXXXXXXXXXXXXXXXGOOOOOOOOXXXXXXXXXXXGOOOOXXXXXXXXXXXXXXXGOOOOOOOOOOOXXXXXXXXGOOOOOOOOOOOOOXXXXXXGOOOXXXXXXXXXXXXXXXX,0,0,0
31458,111,0,111,44,445,0,0,153,84,69,GOOOOOOOOOOOXXXXXXXXGOOOOOOOOXXXXXXXXXXXGOOOOOXXXXXXXXXXXXXXGOOOOOOOOXXXXXXXXXXXGOOOOOOXXXXXXXXXXXXXGOOOOOOOOOOOXXXXXXXXGOOOOOOOOXXXXXXXXXXXGOOXXXXXXXXXXXXXXXXXGOOOOOOOOXXXXXXXXXXXGOOOOXXXXXXXXXXXXXXXGOOOOOOOOOOOXXXXXXXXGOOOOOOOOOOOOOXXXXXXGOOOXXXXXXXXXXXXXXXX,0,0,0
31479,111,0,111,45,444,0,0,151,82,69,GOOOOOOOOOOOXXXXXXXXGOOOOOOOOXXXXXXXXXXXGOOOOOXXXXXXXXXXXXXXGOOOOOOOOXXXXXXXXXXXGOOOOOOXXXXXXXXXXXXXGOOOOOOOOOOOXXXXXXXXGOOOOOOOOXXXXXXXXXXXGOOXXXXXXXXXXXXXXXXXGOOOOOOOOXXXXXXXXXXXGOOOOXXXXXXXXXXXXXXXGOOOOOOOOOOOXXXXXXXXGOOOOOOOOOOOOOXXXXXXGOOOXXXXXXXXXXXXXXXX,0,0,0

31500,111,0,111,43,446,0,0,154,85,69,GOOOOOOOOOOOXXXXXXXXGOOOOOOOOXXXXXXXXXXXGOOOOOXXXXXXXXXXXXXXGOOOOOOOOXXXXXXXXXXXGOOOOOOXXXXXXXXXXXXXGOOOOOOOOOOOXXXXXXXXGOOOOOOOOXXXXXXXXXXXGOOXXXXXXXXXXXXXXXXXGOOOOOOOOXXXXXXXXXXXGOOOOXXXXXXXXXXXXXXXGOOOOOOOOOOOXXXXXXXXGOOOOOOOOOOOOOXXXXXXGOOOXXXXXXXXXXXXXXXX,0,0,0
31521,111,0,111,43,446,0,0,153,84,69,GOOOOOOOOOOOXXXXXXXXGOOOOOOOOXXXXXXXXXXXGOOOOOXXXXXXXXXXXXXXGOOOOOOOOXXXXXXXXXXXGOOOOOOXXXXXXXXXXXXXGOOOOOOOOOOOXXXXXXXXGOOOOOOOOXXXXXXXXXXXGOOXXXXXXXXXXXXXXXXXGOOOOOOOOXXXXXXXXXXXGOOOOXXXXXXXXXXXXXXXGOOOOOOOOOOOXXXXXXXXGOOOOOOOOOOOOOXXXXXXGOOOXXXXXXXXXXXXXXXX,0,0,0
31542,111,0,111,40,449,0,0,156,82,74,GOOOOOOOOOOOXXXXXXXXGOOOOOOOOXXXXXXXXXXXGOOOOOXXXXXXXXXXXXXXGOOOOOOOOXXXXXXXXXXXGOOOOOOXXXXXXXXXXXXXGOOOOOOOOOOOXXXXXXXXGOOOOOOOOXXXXXXXXXXXGOOXXXXXXXXXXXXXXXXXGOOOOOOOOXXXXXXXXXXXGOOOOXXXXXXXXXXXXXXXGOOOOOOOOOOOXXXXXXXXGOOOOOOOOOOOOOXXXXXXGOOOXXXXXXXXXXXXXXXX,0,0,0
31563,111,0,111,39,450,0,0,157,86,71,GOOOOOOOOOOOXXXXXXXXGOOOOOOOOXXXXXXXXXXXGOOOOOXXXXXXXXXXXXXXGOOOOOOOOXXXXXXXXXXXGOOOOOOXXXXXXXXXXXXXGOOOOOOOOOOOXXXXXXXXGOOOOOOOOXXXXXXXXXXXGOOXXXXXXXXXXXXXXXXXGOOOOOOOOXXXXXXXXXXXGOOOOXXXXXXXXXXXXXXXGOOOOOOOOOOOXXXXXXXXGOOOOOOOOOOOOOXXXXXXGOOOXXXXXXXXXXXXXXXX,0,0,0
31584,111,0,111,42,447,0,0,154,87,67,GOOOOOOOOOOOXXXXXXXXGOOOOOOOOXXXXXXXXXXXGOOOOOXXXXXXXXXXXXXXGOOOOOOOOXXXXXXXXXXXGOOOOOOXXXXXXXXXXXXXGOOOOOOOOOOOXXXXXXXXGOOOOOOOOXXXXXXXXXXXGOOXXXXXXXXXXXXXXXXXGOOOOOOOOXXXXXXXXXXXGOOOOXXXXXXXXXXXXXXXGOOOOOOOOOOOXXXXXXXXGOOOOOOOOOOOOOXXXXXXGOOOXXXXXXXXXXXXXXXX,0,0,0

31605,111,0,111,46,443,0,0,150,85,65,GOOOOOOOOOOOXXXXXXXXGOOOOOOOOXXXXXXXXXXXGOOOOOXXXXXXXXXXXXXXGOOOOOOOOXXXXXXXXXXXGOOOOOOXXXXXXXXXXXXXGOOOOOOOOOOOXXXXXXXXGOOOOOOOOXXXXXXXXXXXGOOXXXXXXXXXXXXXXXXXGOOOOOOOOXXXXXXXXXXXGOOOOXXXXXXXXXXXXXXXGOOOOOOOOOOOXXXXXXXXGOOOOOOOOOOOOOXXXXXXGOOOXXXXXXXXXXXXXXXX,0,0,0
31626,112,1,111,46,442,0,0,149,83,66,GOOOOOOOOOOOXXXXXXXXGOOOOOOOOXXXXXXXXXXXGOOOOOXXXXXXXXXXXXXXGOOOOOOOOXXXXXXXXXXXGOOOOOOXXXXXXXXXXXXXGOOOOOOOOOOOXXXXXXXXGOOOOOOOOXXXXXXXXXXXGOOXXXXXXXXXXXXXXXXXGOOOOOOOOAXXXXXXXXXXGOOOOXXXXXXXXXXXXXXXGOOOOOOOOOOOXXXXXXXXGOOOOOOOOOOOOOXXXXXXGOOOXXXXXXXXXXXXXXXX,0,0,0
31647,112,1,111,45,443,0,0,150,84,66,GOOOOOOOOOOOXXXXXXXXGOOOOOOOOXXXXXXXXXXXGOOOOOXXXXXXXXXXXXXXGOOOOOOOOXXXXXXXXXXXGOOOOOOXXXXXXXXXXXXXGOOOOOOOOOOOXXXXXXXXGOOOOOOOOXXXXXXXXXXXGOOXXXXXXXXXXXXXXXXXGOOOOOOOOAXXXXXXXXXXGOOOOXXXXXXXXXXXXXXXGOOOOOOOOOOOXXXXXXXXGOOOOOOOOOOOOOXXXXXXGOOOXXXXXXXXXXXXXXXX,0,0,0
31668,112,1,111,44,444,0,0,151,82,69,GOOOOOOOOOOOXXXXXXXXGOOOOOOOOXXXXXXXXXXXGOOOOOXXXXXXXXXXXXXXGOOOOOOOOXXXXXXXXXXXGOOOOOOXXXXXXXXXXXXXGOOOOOOOOOOOXXXXXXXXGOOOOOOOOXXXXXXXXXXXGOOXXXXXXXXXXXXXXXXXGOOOOOOOOAXXXXXXXXXXGOOOOXXXXXXXXXXXXXXXGOOOOOOOOOOOXXXXXXXXGOOOOOOOOOOOOOXXXXXXGOOOXXXXXXXXXXXXXXXX,0,0,0
31689,112,1,111,46,442,0,0,149,83,66,GOOOOOOOOOOOXXXXXXXXGOOOOOOOOXXXXXXXXXXXGOOOOOXXXXXXXXXXXXXXGOOOOOOOOXXXXXXXXXXXGOOOOOOXXXXXXXXXXXXXGOOOOOOOOOOOXXXXXXXXGOOOOOOOOXXXXXXXXXXXGOOXXXXXXXXXXXXXXXXXGOOOOOOOOAXXXXXXXXXXGOOOOXXXXXXXXXXXXXXXGOOOOOOOOOOOXXXXXXXXGOOOOOOOOOOOOOXXXXXXGOOOXXXXXXXXXXXXXXXX,0,0,0

31710,112,1,111,43,445,0,0,150,83,67,GOOOOOOOOOOOXXXXXXXXGOOOOOOOOXXXXXXXXXXXGOOOOOXXXXXXXXXXXXXXGOOOOOOOOXXXXXXXXXXXGOOOOOOXXXXXXXXXXXXXGOOOOOOOOOOOXXXXXXXXGOOOOOOOOXXXXXXXXXXXGOOXXXXXXXXXXXXXXXXXGOOOOOOOOAXXXXXXXXXXGOOOOXXXXXXXXXXXXXXXGOOOOOOOOOOOXXXXXXXXGOOOOOOOOOOOOOXXXXXXGOOOXXXXXXXXXXXXXXXX,0,0,0
31731,113,0,113,42,445,0,0,152,84,68,GOOOOOOOOOOOXXXXXXXXGOOOOOOOOXXXXXXXXXXXGOOOOOXXXXXXXXXXXXXXGOOOOOOOOXXXXXXXXXXXGOOOOOOXXXXXXXXXXXXXGOOOOOOOOOOOXXXXXXXXGOOOOOOOOXXXXXXXXXXXGOOXXXXXXXXXXXXXXXXXGOOOOOOOOOXXXXXXXXXXGOOOOXXXXXXXXXXXXXXXGOOOOOOOOOOOXXXXXXXXGOOOOOOOOOOOOOXXXXXXGOOOOXXXXXXXXXXXXXXX,0,0,0
31752,113,0,113,48,439,0,0,146,83,63,GOOOOOOOOOOOXXXXXXXXGOOOOOOOOXXXXXXXXXXXGOOOOOXXXXXXXXXXXXXXGOOOOOOOOXXXXXXXXXXXGOOOOOOXXXXXXXXXXXXXGOOOOOOOOOOOXXXXXXXXGOOOOOOOOXXXXXXXXXXXGOOXXXXXXXXXXXXXXXXXGOOOOOOOOOXXXXXXXXXXGOOOOXXXXXXXXXXXXXXXGOOOOOOOOOOOXXXXXXXXGOOOOOOOOOOOOOXXXXXXGOOOOXXXXXXXXXXXXXXX,0,0,0
31773,113,0,113,46,441,0,0,149,84,65,GOOOOOOOOOOOXXXXXXXXGOOOOOOOOXXXXXXXXXXXGOOOOOXXXXXXXXXXXXXXGOOOOOOOOXXXXXXXXXXXGOOOOOOXXXXXXXXXXXXXGOOOOOOOOOOOXXXXXXXXGOOOOOOOOXXXXXXXXXXXGOOXXXXXXXXXXXXXXXXXGOOOOOOOOOXXXXXXXXXXGOOOOXXXXXXXXXXXXXXXGOOOOOOOOOOOXXXXXXXXGOOOOOOOOOOOOOXXXXXXGOOOOXXXXXXXXXXXXXXX,0,0,0
31794,113,0,113,47,440,0,0,148,81,67,GOOOOOOOOOOOXXXXXXXXGOOOOOOOOXXXXXXXXXXXGOOOOOXXXXXXXXXXXXXXGOOOOOOOOXXXXXXXXXXXGOOOOOOXXXXXXXXXXXXXGOOOOOOOOOOOXXXXXXXXGOOOOOOOOXXXXXXXXXXXGOOXXXXXXXXXXXXXXXXXGOOOOOOOOOXXXXXXXXXXGOOOOXXXXXXXXXXXXXXXGOOOOOOOOOOOXXXXXXXXGOOOOOOOOOOOOOXXXXXXGOOOOXXXXXXXXXXXXXXX,0,0,0

31815,113,0,113,40,447,0,0,155,82,73,GOOOOOOOOOOOXXXXXXXXGOOOOOOOOXXXXXXXXXXXGOOOOOXXXXXXXXXXXXXXGOOOOOOOOXXXXXXXXXXXGOOOOOOXXXXXXXXXXXXXGOOOOOOOOOOOXXXXXXXXGOOOOOOOOXXXXXXXXXXXGOOXXXXXXXXXXXXXXXXXGOOOOOOOOOXXXXXXXXXXGOOOOXXXXXXXXXXXXXXXGOOOOOOOOOOOXXXXXXXXGOOOOOOOOOOOOOXXXXXXGOOOOXXXXXXXXXXXXXXX,0,0,0
31836,113,0,113,39,448,0,0,156,85,71,GOOOOOOOOOOOXXXXXXXXGOOOOOOOOXXXXXXXXXXXGOOOOOXXXXXXXXXXXXXXGOOOOOOOOXXXXXXXXXXXGOOOOOOXXXXXXXXXXXXXGOOOOOOOOOOOXXXXXXXXGOOOOOOOOXXXXXXXXXXXGOOXXXXXXXXXXXXXXXXXGOOOOOOOOOXXXXXXXXXXGOOOOXXXXXXXXXXXXXXXGOOOOOOOOOOOXXXXXXXXGOOOOOOOOOOOOOXXXXXXGOOOOXXXXXXXXXXXXXXX,0,0,0
31857,113,0,113,41,446,0,0,153,83,70,GOOOOOOOOOOOXXXXXXXXGOOOOOOOOXXXXXXXXXXXGOOOOOXXXXXXXXXXXXXXGOOOOOOOOXXXXXXXXXXXGOOOOOOXXXXXXXXXXXXXGOOOOOOOOOOOXXXXXXXXGOOOOOOOOXXXXXXXXXXXGOOXXXXXXXXXXXXXXXXXGOOOOOOOOOXXXXXXXXXXGOOOOXXXXXXXXXXXXXXXGOOOOOOOOOOOXXXXXXXXGOOOOOOOOOOOOOXXXXXXGOOOOXXXXXXXXXXXXXXX,0,0,0
31878,113,0,113,38,449,0,0,156,87,69,GOOOOOOOOOOOXXXXXXXXGOOOOOOOOXXXXXXXXXXXGOOOOOXXXXXXXXXXXXXXGOOOOOOOOXXXXXXXXXXXGOOOOOOXXXXXXXXXXXXXGOOOOOOOOOOOXXXXXXXXGOOOOOOOOXXXXXXXXXXXGOOXXXXXXXXXXXXXXXXXGOOOOOOOOOXXXXXXXXXXGOOOOXXXXXXXXXXXXXXXGOOOOOOOOOOOXXXXXXXXGOOOOOOOOOOOOOXXXXXXGOOOOXXXXXXXXXXXXXXX,0,0,0
31899,113,0,113,36,451,0,0,160,84,76,GOOOOOOOOOOOXXXXXXXXGOOOOOOOOXXXXXXXXXXXGOOOOOXXXXXXXXXXXXXXGOOOOOOOOXXXXXXXXXXXGOOOOOOXXXXXXXXXXXXXGOOOOOOOOOOOXXXXXXXXGOOOOOOOOXXXXXXXXXXXGOOXXXXXXXXXXXXXXXXXGOOOOOOOOOXXXXXXXXXXGOOOOXXXXXXXXXXXXXXXGOOOOOOOOOOOXXXXXXXXGOOOOOOOOOOOOOXXXXXXGOOOOXXXXXXXXXXXXXXX,0,0,0

31920,113,0,113,37,450,0,0,160,86,74,GOOOOOOOOOOOXXXXXXXXGOOOOOOOOXXXXXXXXXXXGOOOOOXXXXXXXXXXXXXXGOOOOOOOOXXXXXXXXXXXGOOOOOOXXXXXXXXXXXXXGOOOOOOOOOOOXXXXXXXXGOOOOOOOOXXXXXXXXXXXGOOXXXXXXXXXXXXXXXXXGOOOOOOOOOXXXXXXXXXXGOOOOXXXXXXXXXXXXXXXGOOOOOOOOOOOXXXXXXXXGOOOOOOOOOOOOOXXXXXXGOOOOXXXXXXXXXXXXXXX,0,0,0
31941,114,1,113,37,449,0,0,159,85,74,GOOOOOOOOOOOXXXXXXXXGOOOOOOOOXXXXXXXXXXXGOOOOOXXXXXXXXXXXXXXGOOOOOOOOXXXXXXXXXXXGOOOOOOXXXXXXXXXXXXXGOOOOOOOOOOOXXXXXXXXGOOOOOOOOXXXXXXXXXXXGOOXXXXXXXXXXXXXXXXXGOOOOOOOOOXXXXXXXXXXGOOOOXXXXXXXXXXXXXXXGOOOOOOOOOOOAXXXXXXXGOOOOOOOOOOOOOXXXXXXGOOOOXXXXXXXXXXXXXXX,0,0,0
31962,114,1,113,40,446,0,0,156,84,72,GOOOOOOOOOOOXXXXXXXXGOOOOOOOOXXXXXXXXXXXGOOOOOXXXXXXXXXXXXXXGOOOOOOOOXXXXXXXXXXXGOOOOOOXXXXXXXXXXXXXGOOOOOOOOOOOXXXXXXXXGOOOOOOOOXXXXXXXXXXXGOOXXXXXXXXXXXXXXXXXGOOOOOOOOOXXXXXXXXXXGOOOOXXXXXXXXXXXXXXXGOOOOOOOOOOOAXXXXXXXGOOOOOOOOOOOOOXXXXXXGOOOOXXXXXXXXXXXXXXX,0,0,0
31983,115,2,113,38,447,0,0,157,85,72,GOOOOOOOOOOOXXXXXXXXGOOOOOOOOXXXXXXXXXXXGOOOOOXXXXXXXXXXXXXXGOOOOOOOOXXXXXXXXXXXGOOOOOOXXXXXXXXXXXXXGOOOOOOOOOOOXXXXXXXXGOOOOOOOOXXXXXXXXXXXGOOXXXXXXXXXXXXXXXXXGOOOOOOOOOAXXXXXXXXXGOOOOXXXXXXXXXXXXXXXGOOOOOOOOOOOAXXXXXXXGOOOOOOOOOOOOOXXXXXXGOOOOXXXXXXXXXXXXXXX,0,0,0
32004,115,2,113,42,443,0,0,154,87,67,GOOOOOOOOOOOXXXXXXXXGOOOOOOOOXXXXXXXXXXXGOOOOOXXXXXXXXXXXXXXGOOOOOOOOXXXXXXXXXXXGOOOOOOXXXXXXXXXXXXXGOOOOOOOOOOOXXXXXXXXGOOOOOOOOXXXXXXXXXXXGOOXXXXXXXXXXXXXXXXXGOOOOOOOOOAXXXXXXXXXGOOOOXXXXXXXXXXXXXXXGOOOOOOOOOOOAXXXXXXXGOOOOOOOOOOOOOXXXXXXGOOOOXXXXXXXXXXXXXXX,0,0,0

32025,115,2,113,39,446,0,0,157,84,73,GOOOOOOOOOOOXXXXXXXXGOOOOOOOOXXXXXXXXXXXGOOOOOXXXXXXXXXXXXXXGOOOOOOOOXXXXXXXXXXXGOOOOOOXXXXXXXXXXXXXGOOOOOOOOOOOXXXXXXXXGOOOOOOOOXXXXXXXXXXXGOOXXXXXXXXXXXXXXXXXGOOOOOOOOOAXXXXXXXXXGOOOOXXXXXXXXXXXXXXXGOOOOOOOOOOOAXXXXXXXGOOOOOOOOOOOOOXXXXXXGOOOOXXXXXXXXXXXXXXX,0,0,0
32046,115,1,114,40,445,0,0,156,85,71,GOOOOOOOOOOOXXXXXXXXGOOOOOOOOXXXXXXXXXXXGOOOOOXXXXXXXXXXXXXXGOOOOOOOOXXXXXXXXXXXGOOOOOOXXXXXXXXXXXXXGOOOOOOOOOOOXXXXXXXXGOOOOOOOOXXXXXXXXXXXGOOXXXXXXXXXXXXXXXXXGOOOOOOOOOAXXXXXXXXXGOOOOXXXXXXXXXXXXXXXGOOOOOOOOOOOOXXXXXXXGOOOOOOOOOOOOOXXXXXXGOOOOXXXXXXXXXXXXXXX,0,0,0
32067,115,0,115,41,444,0,0,154,84,70,GOOOOOOOOOOOXXXXXXXXGOOOOOOOOXXXXXXXXXXXGOOOOOXXXXXXXXXXXXXXGOOOOOOOOXXXXXXXXXXXGOOOOOOXXXXXXXXXXXXXGOOOOOOOOOOOXXXXXXXXGOOOOOOOOXXXXXXXXXXXGOOXXXXXXXXXXXXXXXXXGOOOOOOOOOOXXXXXXXXXGOOOOXXXXXXXXXXXXXXXGOOOOOOOOOOOOXXXXXXXGOOOOOOOOOOOOOXXXXXXGOOOOXXXXXXXXXXXXXXX,0,0,0
32088,115,0,115,35,450,0,0,160,85,75,GOOOOOOOOOOOXXXXXXXXGOOOOOOOOXXXXXXXXXXXGOOOOOXXXXXXXXXXXXXXGOOOOOOOOXXXXXXXXXXXGOOOOOOXXXXXXXXXXXXXGOOOOOOOOOOOXXXXXXXXGOOOOOOOOXXXXXXXXXXXGOOXXXXXXXXXXXXXXXXXGOOOOOOOOOOXXXXXXXXXGOOOOXXXXXXXXXXXXXXXGOOOOOOOOOOOOXXXXXXXGOOOOOOOOOOOOOXXXXXXGOOOOXXXXXXXXXXXXXXX,0,0,0
32109,115,0,115,29,456,0,0,165,87,78,GOOOOOOOOOOOXXXXXXXXGOOOOOOOOXXXXXXXXXXXGOOOOOXXXXXXXXXXXXXXGOOOOOOOOXXXXXXXXXXXGOOOOOOXXXXXXXXXXXXXGOOOOOOOOOOOXXXXXXXXGOOOOOOOOXXXXXXXXXXXGOOXXXXXXXXXXXXXXXXXGOOOOOOOOOOXXXXXXXXXGOOOOXXXXXXXXXXXXXXXGOOOOOOOOOOOOXXXXXXXGOOOOOOOOOOOOOXXXXXXGOOOOXXXXXXXXXXXXXXX,0,0,0

32130,115,0,115,30,455,0,0,163,84,79,GOOOOOOOOOOOXXXXXXXXGOOOOOOOOXXXXXXXXXXXGOOOOOXXXXXXXXXXXXXXGOOOOOOOOXXXXXXXXXXXGOOOOOOXXXXXXXXXXXXXGOOOOOOOOOOOXXXXXXXXGOOOOOOOOXXXXXXXXXXXGOOXXXXXXXXXXXXXXXXXGOOOOOOOOOOXXXXXXXXXGOOOOXXXXXXXXXXXXXXXGOOOOOOOOOOOOXXXXXXXGOOOOOOOOOOOOOXXXXXXGOOOOXXXXXXXXXXXXXXX,0,0,0
32151,115,0,115,30,455,0,0,164,85,79,GOOOOOOOOOOOXXXXXXXXGOOOOOOOOXXXXXXXXXXXGOOOOOXXXXXXXXXXXXXXGOOOOOOOOXXXXXXXXXXXGOOOOOOXXXXXXXXXXXXXGOOOOOOOOOOOXXXXXXXXGOOOOOOOOXXXXXXXXXXXGOOXXXXXXXXXXXXXXXXXGOOOOOOOOOOXXXXXXXXXGOOOOXXXXXXXXXXXXXXXGOOOOOOOOOOOOXXXXXXXGOOOOOOOOOOOOOXXXXXXGOOOOXXXXXXXXXXXXXXX,0,0,0
32172,115,0,115,31,454,0,0,163,87,76,GOOOOOOOOOOOXXXXXXXXGOOOOOOOOXXXXXXXXXXXGOOOOOXXXXXXXXXXXXXXGOOOOOOOOXXXXXXXXXXXGOOOOOOXXXXXXXXXXXXXGOOOOOOOOOOOXXXXXXXXGOOOOOOOOXXXXXXXXXXXGOOXXXXXXXXXXXXXXXXXGOOOOOOOOOOXXXXXXXXXGOOOOXXXXXXXXXXXXXXXGOOOOOOOOOOOOXXXXXXXGOOOOOOOOOOOOOXXXXXXGOOOOXXXXXXXXXXXXXXX,0,0,0
32193,115,0,115,37,448,0,0,157,85,72,GOOOOOOOOOOOXXXXXXXXGOOOOOOOOXXXXXXXXXXXGOOOOOXXXXXXXXXXXXXXGOOOOOOOOXXXXXXXXXXXGOOOOOOXXXXXXXXXXXXXGOOOOOOOOOOOXXXXXXXXGOOOOOOOOXXXXXXXXXXXGOOXXXXXXXXXXXXXXXXXGOOOOOOOOOOXXXXXXXXXGOOOOXXXXXXXXXXXXXXXGOOOOOOOOOOOOXXXXXXXGOOOOOOOOOOOOOXXXXXXGOOOOXXXXXXXXXXXXXXX,0,0,0
32214,115,0,115,35,450,0,0,159,86,73,GOOOOOOOOOOOXXXXXXXXGOOOOOOOOXXXXXXXXXXXGOOOOOXXXXXXXXXXXXXXGOOOOOOOOXXXXXXXXXXXGOOOOOOXXXXXXXXXXXXXGOOOOOOOOOOOXXXXXXXXGOOOOOOOOXXXXXXXXXXXGOOXXXXXXXXXXXXXXXXXGOOOOOOOOOOXXXXXXXXXGOOOOXXXXXXXXXXXXXXXGOOOOOOOOOOOOXXXXXXXGOOOOOOOOOOOOOXXXXXXGOOOOXXXXXXXXXXXXXXX,0,0,0

32235,115,0,115,38,447,0,0,156,88,68,GOOOOOOOOOOOXXXXXXXXGOOOOOOOOXXXXXXXXXXXGOOOOOXXXXXXXXXXXXXXGOOOOOOOOXXXXXXXXXXXGOOOOOOXXXXXXXXXXXXXGOOOOOOOOOOOXXXXXXXXGOOOOOOOOXXXXXXXXXXXGOOXXXXXXXXXXXXXXXXXGOOOOOOOOOOXXXXXXXXXGOOOOXXXXXXXXXXXXXXXGOOOOOOOOOOOOXXXXXXXGOOOOOOOOOOOOOXXXXXXGOOOOXXXXXXXXXXXXXXX,0,0,0
32256,115,0,115,38,447,0,0,156,91,65,GOOOOOOOOOOOXXXXXXXXGOOOOOOOOXXXXXXXXXXXGOOOOOXXXXXXXXXXXXXXGOOOOOOOOXXXXXXXXXXXGOOOOOOXXXXXXXXXXXXXGOOOOOOOOOOOXXXXXXXXGOOOOOOOOXXXXXXXXXXXGOOXXXXXXXXXXXXXXXXXGOOOOOOOOOOXXXXXXXXXGOOOOXXXXXXXXXXXXXXXGOOOOOOOOOOOOXXXXXXXGOOOOOOOOOOOOOXXXXXXGOOOOXXXXXXXXXXXXXXX,0,0,0
32277,115,0,115,40,445,0,0,154,88,66,GOOOOOOOOOOOXXXXXXXXGOOOOOOOOXXXXXXXXXXXGOOOOOXXXXXXXXXXXXXXGOOOOOOOOXXXXXXXXXXXGOOOOOOXXXXXXXXXXXXXGOOOOOOOOOOOXXXXXXXXGOOOOOOOOXXXXXXXXXXXGOOXXXXXXXXXXXXXXXXXGOOOOOOOOOOXXXXXXXXXGOOOOXXXXXXXXXXXXXXXGOOOOOOOOOOOOXXXXXXXGOOOOOOOOOOOOOXXXXXXGOOOOXXXXXXXXXXXXXXX,0,0,0
32298,115,0,115,44,441,0,0,150,85,65,GOOOOOOOOOOOXXXXXXXXGOOOOOOOOXXXXXXXXXXXGOOOOOXXXXXXXXXXXXXXGOOOOOOOOXXXXXXXXXXXGOOOOOOXXXXXXXXXXXXXGOOOOOOOOOOOXXXXXXXXGOOOOOOOOXXXXXXXXXXXGOOXXXXXXXXXXXXXXXXXGOOOOOOOOOOXXXXXXXXXGOOOOXXXXXXXXXXXXXXXGOOOOOOOOOOOOXXXXXXXGOOOOOOOOOOOOOXXXXXXGOOOOXXXXXXXXXXXXXXX,0,0,0
32319,115,0,115,45,440,0,0,148,85,63,GOOOOOOOOOOOXXXXXXXXGOOOOOOOOXXXXXXXXXXXGOOOOOXXXXXXXXXXXXXXGOOOOOOOOXXXXXXXXXXXGOOOOOOXXXXXXXXXXXXXGOOOOOOOOOOOXXXXXXXXGOOOOOOOOXXXXXXXXXXXGOOXXXXXXXXXXXXXXXXXGOOOOOOOOOOXXXXXXXXXGOOOOXXXXXXXXXXXXXXXGOOOOOOOOOOOOXXXXXXXGOOOOOOOOOOOOOXXXXXXGOOOOXXXXXXXXXXXXXXX,0,0,0

32340,115,0,115,47,438,0,0,146,85,61,GOOOOOOOOOOOXXXXXXXXGOOOOOOOOXXXXXXXXXXXGOOOOOXXXXXXXXXXXXXXGOOOOOOOOXXXXXXXXXXXGOOOOOOXXXXXXXXXXXXXGOOOOOOOOOOOXXXXXXXXGOOOOOOOOXXXXXXXXXXXGOOXXXXXXXXXXXXXXXXXGOOOOOOOOOOXXXXXXXXXGOOOOXXXXXXXXXXXXXXXGOOOOOOOOOOOOXXXXXXXGOOOOOOOOOOOOOXXXXXXGOOOOXXXXXXXXXXXXXXX,0,0,0
32361,115,0,115,48,437,0,0,145,85,60,GOOOOOOOOOOOXXXXXXXXGOOOOOOOOXXXXXXXXXXXGOOOOOXXXXXXXXXXXXXXGOOOOOOOOXXXXXXXXXXXGOOOOOOXXXXXXXXXXXXXGOOOOOOOOOOOXXXXXXXXGOOOOOOOOXXXXXXXXXXXGOOXXXXXXXXXXXXXXXXXGOOOOOOOOOOXXXXXXXXXGOOOOXXXXXXXXXXXXXXXGOOOOOOOOOOOOXXXXXXXGOOOOOOOOOOOOOXXXXXXGOOOOXXXXXXXXXXXXXXX,0,0,0
32382,115,0,115,43,442,0,0,150,89,61,GOOOOOOOOOOOXXXXXXXXGOOOOOOOOXXXXXXXXXXXGOOOOOXXXXXXXXXXXXXXGOOOOOOOOXXXXXXXXXXXGOOOOOOXXXXXXXXXXXXXGOOOOOOOOOOOXXXXXXXXGOOOOOOOOXXXXXXXXXXXGOOXXXXXXXXXXXXXXXXXGOOOOOOOOOOXXXXXXXXXGOOOOXXXXXXXXXXXXXXXGOOOOOOOOOOOOXXXXXXXGOOOOOOOOOOOOOXXXXXXGOOOOXXXXXXXXXXXXXXX,0,0,0
32403,115,0,115,45,440,0,0,147,89,58,GOOOOOOOOOOOXXXXXXXXGOOOOOOOOXXXXXXXXXXXGOOOOOXXXXXXXXXXXXXXGOOOOOOOOXXXXXXXXXXXGOOOOOOXXXXXXXXXXXXXGOOOOOOOOOOOXXXXXXXXGOOOOOOOOXXXXXXXXXXXGOOXXXXXXXXXXXXXXXXXGOOOOOOOOOOXXXXXXXXXGOOOOXXXXXXXXXXXXXXXGOOOOOOOOOOOOXXXXXXXGOOOOOOOOOOOOOXXXXXXGOOOOXXXXXXXXXXXXXXX,0,0,0
32424,115,0,115,47,438,0,0,146,85,61,GOOOOOOOOOOOXXXXXXXXGOOOOOOOOXXXXXXXXXXXGOOOOOXXXXXXXXXXXXXXGOOOOOOOOXXXXXXXXXXXGOOOOOOXXXXXXXXXXXXXGOOOOOOOOOOOXXXXXXXXGOOOOOOOOXXXXXXXXXXXGOOXXXXXXXXXXXXXXXXXGOOOOOOOOOOXXXXXXXXXGOOOOXXXXXXXXXXXXXXXGOOOOOOOOOOOOXXXXXXXGOOOOOOOOOOOOOXXXXXXGOOOOXXXXXXXXXXXXXXX,0,0,0

32445,115,0,115,41,444,0,0,152,83,69,GOOOOOOOOOOOXXXXXXXXGOOOOOOOOXXXXXXXXXXXGOOOOOXXXXXXXXXXXXXXGOOOOOOOOXXXXXXXXXXXGOOOOOOXXXXXXXXXXXXXGOOOOOOOOOOOXXXXXXXXGOOOOOOOOXXXXXXXXXXXGOOXXXXXXXXXXXXXXXXXGOOOOOOOOOOXXXXXXXXXGOOOOXXXXXXXXXXXXXXXGOOOOOOOOOOOOXXXXXXXGOOOOOOOOOOOOOXXXXXXGOOOOXXXXXXXXXXXXXXX,0,0,0
32466,115,0,115,35,450,0,0,159,85,74,GOOOOOOOOOOOXXXXXXXXGOOOOOOOOXXXXXXXXXXXGOOOOOXXXXXXXXXXXXXXGOOOOOOOOXXXXXXXXXXXGOOOOOOXXXXXXXXXXXXXGOOOOOOOOOOOXXXXXXXXGOOOOOOOOXXXXXXXXXXXGOOXXXXXXXXXXXXXXXXXGOOOOOOOOOOXXXXXXXXXGOOOOXXXXXXXXXXXXXXXGOOOOOOOOOOOOXXXXXXXGOOOOOOOOOOOOOXXXXXXGOOOOXXXXXXXXXXXXXXX,0,0,0
32487,115,0,115,31,454,0,0,163,85,78,GOOOOOOOOOOOXXXXXXXXGOOOOOOOOXXXXXXXXXXXGOOOOOXXXXXXXXXXXXXXGOOOOOOOOXXXXXXXXXXXGOOOOOOXXXXXXXXXXXXXGOOOOOOOOOOOXXXXXXXXGOOOOOOOOXXXXXXXXXXXGOOXXXXXXXXXXXXXXXXXGOOOOOOOOOOXXXXXXXXXGOOOOXXXXXXXXXXXXXXXGOOOOOOOOOOOOXXXXXXXGOOOOOOOOOOOOOXXXXXXGOOOOXXXXXXXXXXXXXXX,0,0,0
32508,115,0,115,30,455,0,0,164,87,77,GOOOOOOOOOOOXXXXXXXXGOOOOOOOOXXXXXXXXXXXGOOOOOXXXXXXXXXXXXXXGOOOOOOOOXXXXXXXXXXXGOOOOOOXXXXXXXXXXXXXGOOOOOOOOOOOXXXXXXXXGOOOOOOOOXXXXXXXXXXXGOOXXXXXXXXXXXXXXXXXGOOOOOOOOOOXXXXXXXXXGOOOOXXXXXXXXXXXXXXXGOOOOOOOOOOOOXXXXXXXGOOOOOOOOOOOOOXXXXXXGOOOOXXXXXXXXXXXXXXX,0,0,0
32529,116,1,115,30,454,0,0,162,85,77,GOOOOOOOOOOOXXXXXXXXGOOOOOOOOXXXXXXXXXXXGOOOOOXXXXXXXXXXXXXXGOOOOOOOOXXXXXXXXXXXGOOOOOOXXXXXXXXXXXXXGOOOOOOOOOOOXXXXXXXXGOOOOOOOOXXXXXXXXXXXGOOXXXXXXXXXXXXXXXXXGOOOOOOOOOOXXXXXXXXXGOOOOXXXXXXXXXXXXXXXGOOOOOOOOOOOOXXXXXXXGOOOOOOOOOOOOOXXXXXXGOOOOAXXXXXXXXXXXXXX,0,0,0

32550,116,0,116,31,453,0,0,162,88,74,GOOOOOOOOOOOXXXXXXXXGOOOOOOOOXXXXXXXXXXXGOOOOOXXXXXXXXXXXXXXGOOOOOOOOXXXXXXXXXXXGOOOOOOXXXXXXXXXXXXXGOOOOOOOOOOOXXXXXXXXGOOOOOOOOXXXXXXXXXXXGOOXXXXXXXXXXXXXXXXXGOOOOOOOOOOXXXXXXXXXGOOOOXXXXXXXXXXXXXXXGOOOOOOOOOOOOXXXXXXXGOOOOOOOOOOOOOXXXXXXGOOOOOXXXXXXXXXXXXXX,0,0,0
32571,116,0,116,38,446,0,0,155,87,68,GOOOOOOOOOOOXXXXXXXXGOOOOOOOOXXXXXXXXXXXGOOOOOXXXXXXXXXXXXXXGOOOOOOOOXXXXXXXXXXXGOOOOOOXXXXXXXXXXXXXGOOOOOOOOOOOXXXXXXXXGOOOOOOOOXXXXXXXXXXXGOOXXXXXXXXXXXXXXXXXGOOOOOOOOOOXXXXXXXXXGOOOOXXXXXXXXXXXXXXXGOOOOOOOOOOOOXXXXXXXGOOOOOOOOOOOOOXXXXXXGOOOOOXXXXXXXXXXXXXX,0,0,0
32592,116,0,116,34,450,0,0,158,88,70,GOOOOOOOOOOOXXXXXXXXGOOOOOOOOXXXXXXXXXXXGOOOOOXXXXXXXXXXXXXXGOOOOOOOOXXXXXXXXXXXGOOOOOOXXXXXXXXXXXXXGOOOOOOOOOOOXXXXXXXXGOOOOOOOOXXXXXXXXXXXGOOXXXXXXXXXXXXXXXXXGOOOOOOOOOOXXXXXXXXXGOOOOXXXXXXXXXXXXXXXGOOOOOOOOOOOOXXXXXXXGOOOOOOOOOOOOOXXXXXXGOOOOOXXXXXXXXXXXXXX,0,0,0
32613,116,0,116,35,449,0,0,156,85,71,GOOOOOOOOOOOXXXXXXXXGOOOOOOOOXXXXXXXXXXXGOOOOOXXXXXXXXXXXXXXGOOOOOOOOXXXXXXXXXXXGOOOOOOXXXXXXXXXXXXXGOOOOOOOOOOOXXXXXXXXGOOOOOOOOXXXXXXXXXXXGOOXXXXXXXXXXXXXXXXXGOOOOOOOOOOXXXXXXXXXGOOOOXXXXXXXXXXXXXXXGOOOOOOOOOOOOXXXXXXXGOOOOOOOOOOOOOXXXXXXGOOOOOXXXXXXXXXXXXXX,0,0,0
32634,116,0,116,30,454,0,0,162,87,75,GOOOOOOOOOOOXXXXXXXXGOOOOOOOOXXXXXXXXXXXGOOOOOXXXXXXXXXXXXXXGOOOOOOOOXXXXXXXXXXXGOOOOOOXXXXXXXXXXXXXGOOOOOOOOOOOXXXXXXXXGOOOOOOOOXXXXXXXXXXXGOOXXXXXXXXXXXXXXXXXGOOOOOOOOOOXXXXXXXXXGOOOOXXXXXXXXXXXXXXXGOOOOOOOOOOOOXXXXXXXGOOOOOOOOOOOOOXXXXXXGOOOOOXXXXXXXXXXXXXX,0,0,0

32655,116,0,116,28,456,0,0,164,86,78,GOOOOOOOOOOOXXXXXXXXGOOOOOOOOXXXXXXXXXXXGOOOOOXXXXXXXXXXXXXXGOOOOOOOOXXXXXXXXXXXGOOOOOOXXXXXXXXXXXXXGOOOOOOOOOOOXXXXXXXXGOOOOOOOOXXXXXXXXXXXGOOXXXXXXXXXXXXXXXXXGOOOOOOOOOOXXXXXXXXXGOOOOXXXXXXXXXXXXXXXGOOOOOOOOOOOOXXXXXXXGOOOOOOOOOOOOOXXXXXXGOOOOOXXXXXXXXXXXXXX,0,0,0
32676,116,0,116,27,457,0,0,164,85,79,GOOOOOOOOOOOXXXXXXXXGOOOOOOOOXXXXXXXXXXXGOOOOOXXXXXXXXXXXXXXGOOOOOOOOXXXXXXXXXXXGOOOOOOXXXXXXXXXXXXXGOOOOOOOOOOOXXXXXXXXGOOOOOOOOXXXXXXXXXXXGOOXXXXXXXXXXXXXXXXXGOOOOOOOOOOXXXXXXXXXGOOOOXXXXXXXXXXXXXXXGOOOOOOOOOOOOXXXXXXXGOOOOOOOOOOOOOXXXXXXGOOOOOXXXXXXXXXXXXXX,0,0,0
32697,116,0,116,28,456,0,0,164,89,75,GOOOOOOOOOOOXXXXXXXXGOOOOOOOOXXXXXXXXXXXGOOOOOXXXXXXXXXXXXXXGOOOOOOOOXXXXXXXXXXXGOOOOOOXXXXXXXXXXXXXGOOOOOOOOOOOXXXXXXXXGOOOOOOOOXXXXXXXXXXXGOOXXXXXXXXXXXXXXXXXGOOOOOOOOOOXXXXXXXXXGOOOOXXXXXXXXXXXXXXXGOOOOOOOOOOOOXXXXXXXGOOOOOOOOOOOOOXXXXXXGOOOOOXXXXXXXXXXXXXX,0,0,0
32718,116,0,116,30,454,0,0,162,93,69,GOOOOOOOOOOOXXXXXXXXGOOOOOOOOXXXXXXXXXXXGOOOOOXXXXXXXXXXXXXXGOOOOOOOOXXXXXXXXXXXGOOOOOOXXXXXXXXXXXXXGOOOOOOOOOOOXXXXXXXXGOOOOOOOOXXXXXXXXXXXGOOXXXXXXXXXXXXXXXXXGOOOOOOOOOOXXXXXXXXXGOOOOXXXXXXXXXXXXXXXGOOOOOOOOOOOOXXXXXXXGOOOOOOOOOOOOOXXXXXXGOOOOOXXXXXXXXXXXXXX,0,0,0
32739,116,0,116,33,451,0,0,159,89,70,GOOOOOOOOOOOXXXXXXXXGOOOOOOOOXXXXXXXXXXXGOOOOOXXXXXXXXXXXXXXGOOOOOOOOXXXXXXXXXXXGOOOOOOXXXXXXXXXXXXXGOOOOOOOOOOOXXXXXXXXGOOOOOOOOXXXXXXXXXXXGOOXXXXXXXXXXXXXXXXXGOOOOOOOOOOXXXXXXXXXGOOOOXXXXXXXXXXXXXXXGOOOOOOOOOOOOXXXXXXXGOOOOOOOOOOOOOXXXXXXGOOOOOXXXXXXXXXXXXXX,0,0,0

32760,116,0,116,38,446,0,0,154,88,66,GOOOOOOOOOOOXXXXXXXXGOOOOOOOOXXXXXXXXXXXGOOOOOXXXXXXXXXXXXXXGOOOOOOOOXXXXXXXXXXXGOOOOOOXXXXXXXXXXXXXGOOOOOOOOOOOXXXXXXXXGOOOOOOOOXXXXXXXXXXXGOOXXXXXXXXXXXXXXXXXGOOOOOOOOOOXXXXXXXXXGOOOOXXXXXXXXXXXXXXXGOOOOOOOOOOOOXXXXXXXGOOOOOOOOOOOOOXXXXXXGOOOOOXXXXXXXXXXXXXX,0,0,0
32781,116,0,116,40,444,0,0,152,87,65,GOOOOOOOOOOOXXXXXXXXGOOOOOOOOXXXXXXXXXXXGOOOOOXXXXXXXXXXXXXXGOOOOOOOOXXXXXXXXXXXGOOOOOOXXXXXXXXXXXXXGOOOOOOOOOOOXXXXXXXXGOOOOOOOOXXXXXXXXXXXGOOXXXXXXXXXXXXXXXXXGOOOOOOOOOOXXXXXXXXXGOOOOXXXXXXXXXXXXXXXGOOOOOOOOOOOOXXXXXXXGOOOOOOOOOOOOOXXXXXXGOOOOOXXXXXXXXXXXXXX,0,0,0
32802,116,0,116,41,443,0,0,152,89,63,GOOOOOOOOOOOXXXXXXXXGOOOOOOOOXXXXXXXXXXXGOOOOOXXXXXXXXXXXXXXGOOOOOOOOXXXXXXXXXXXGOOOOOOXXXXXXXXXXXXXGOOOOOOOOOOOXXXXXXXXGOOOOOOOOXXXXXXXXXXXGOOXXXXXXXXXXXXXXXXXGOOOOOOOOOOXXXXXXXXXGOOOOXXXXXXXXXXXXXXXGOOOOOOOOOOOOXXXXXXXGOOOOOOOOOOOOOXXXXXXGOOOOOXXXXXXXXXXXXXX,0,0,0
32823,116,0,116,38,446,0,0,154,90,64,GOOOOOOOOOOOXXXXXXXXGOOOOOOOOXXXXXXXXXXXGOOOOOXXXXXXXXXXXXXXGOOOOOOOOXXXXXXXXXXXGOOOOOOXXXXXXXXXXXXXGOOOOOOOOOOOXXXXXXXXGOOOOOOOOXXXXXXXXXXXGOOXXXXXXXXXXXXXXXXXGOOOOOOOOOOXXXXXXXXXGOOOOXXXXXXXXXXXXXXXGOOOOOOOOOOOOXXXXXXXGOOOOOOOOOOOOOXXXXXXGOOOOOXXXXXXXXXXXXXX,0,0,0
32844,116,0,116,39,445,0,0,153,89,64,GOOOOOOOOOOOXXXXXXXXGOOOOOOOOXXXXXXXXXXXGOOOOOXXXXXXXXXXXXXXGOOOOOOOOXXXXXXXXXXXGOOOOOOXXXXXXXXXXXXXGOOOOOOOOOOOXXXXXXXXGOOOOOOOOXXXXXXXXXXXGOOXXXXXXXXXXXXXXXXXGOOOOOOOOOOXXXXXXXXXGOOOOXXXXXXXXXXXXXXXGOOOOOOOOOOOOXXXXXXXGOOOOOOOOOOOOOXXXXXXGOOOOOXXXXXXXXXXXXXX,0,0,0

32865,116,0,116,38,446,0,0,153,87,66,GOOOOOOOOOOOXXXXXXXXGOOOOOOOOXXXXXXXXXXXGOOOOOXXXXXXXXXXXXXXGOOOOOOOOXXXXXXXXXXXGOOOOOOXXXXXXXXXXXXXGOOOOOOOOOOOXXXXXXXXGOOOOOOOOXXXXXXXXXXXGOOXXXXXXXXXXXXXXXXXGOOOOOOOOOOXXXXXXXXXGOOOOXXXXXXXXXXXXXXXGOOOOOOOOOOOOXXXXXXXGOOOOOOOOOOOOOXXXXXXGOOOOOXXXXXXXXXXXXXX,0,0,0
32886,116,0,116,40,444,0,0,152,86,66,GOOOOOOOOOOOXXXXXXXXGOOOOOOOOXXXXXXXXXXXGOOOOOXXXXXXXXXXXXXXGOOOOOOOOXXXXXXXXXXXGOOOOOOXXXXXXXXXXXXXGOOOOOOOOOOOXXXXXXXXGOOOOOOOOXXXXXXXXXXXGOOXXXXXXXXXXXXXXXXXGOOOOOOOOOOXXXXXXXXXGOOOOXXXXXXXXXXXXXXXGOOOOOOOOOOOOXXXXXXXGOOOOOOOOOOOOOXXXXXXGOOOOOXXXXXXXXXXXXXX,0,0,0
32907,116,0,116,39,445,0,0,153,87,66,GOOOOOOOOOOOXXXXXXXXGOOOOOOOOXXXXXXXXXXXGOOOOOXXXXXXXXXXXXXXGOOOOOOOOXXXXXXXXXXXGOOOOOOXXXXXXXXXXXXXGOOOOOOOOOOOXXXXXXXXGOOOOOOOOXXXXXXXXXXXGOOXXXXXXXXXXXXXXXXXGOOOOOOOOOOXXXXXXXXXGOOOOXXXXXXXXXXXXXXXGOOOOOOOOOOOOXXXXXXXGOOOOOOOOOOOOOXXXXXXGOOOOOXXXXXXXXXXXXXX,0,0,0
32928,116,0,116,39,445,0,0,153,85,68,GOOOOOOOOOOOXXXXXXXXGOOOOOOOOXXXXXXXXXXXGOOOOOXXXXXXXXXXXXXXGOOOOOOOOXXXXXXXXXXXGOOOOOOXXXXXXXXXXXXXGOOOOOOOOOOOXXXXXXXXGOOOOOOOOXXXXXXXXXXXGOOXXXXXXXXXXXXXXXXXGOOOOOOOOOOXXXXXXXXXGOOOOXXXXXXXXXXXXXXXGOOOOOOOOOOOOXXXXXXXGOOOOOOOOOOOOOXXXXXXGOOOOOXXXXXXXXXXXXXX,0,0,0
32949,116,0,116,37,447,0,0,154,86,68,GOOOOOOOOOOOXXXXXXXXGOOOOOOOOXXXXXXXXXXXGOOOOOXXXXXXXXXXXXXXGOOOOOOOOXXXXXXXXXXXGOOOOOOXXXXXXXXXXXXXGOOOOOOOOOOOXXXXXXXXGOOOOOOOOXXXXXXXXXXXGOOXXXXXXXXXXXXXXXXXGOOOOOOOOOOXXXXXXXXXGOOOOXXXXXXXXXXXXXXXGOOOOOOOOOOOOXXXXXXXGOOOOOOOOOOOOOXXXXXXGOOOOOXXXXXXXXXXXXXX,0,0,0

32970,116,0,116,37,447,0,0,154,88,66,GOOOOOOOOOOOXXXXXXXXGOOOOOOOOXXXXXXXXXXXGOOOOOXXXXXXXXXXXXXXGOOOOOOOOXXXXXXXXXXXGOOOOOOXXXXXXXXXXXXXGOOOOOOOOOOOXXXXXXXXGOOOOOOOOXXXXXXXXXXXGOOXXXXXXXXXXXXXXXXXGOOOOOOOOOOXXXXXXXXXGOOOOXXXXXXXXXXXXXXXGOOOOOOOOOOOOXXXXXXXGOOOOOOOOOOOOOXXXXXXGOOOOOXXXXXXXXXXXXXX,0,0,0
32991,116,0,116,36,448,0,0,157,89,68,GOOOOOOOOOOOXXXXXXXXGOOOOOOOOXXXXXXXXXXXGOOOOOXXXXXXXXXXXXXXGOOOOOOOOXXXXXXXXXXXGOOOOOOXXXXXXXXXXXXXGOOOOOOOOOOOXXXXXXXXGOOOOOOOOXXXXXXXXXXXGOOXXXXXXXXXXXXXXXXXGOOOOOOOOOOXXXXXXXXXGOOOOXXXXXXXXXXXXXXXGOOOOOOOOOOOOXXXXXXXGOOOOOOOOOOOOOXXXXXXGOOOOOXXXXXXXXXXXXXX,0,0,0
33012,116,0,116,37,447,0,0,156,86,70,GOOOOOOOOOOOXXXXXXXXGOOOOOOOOXXXXXXXXXXXGOOOOOXXXXXXXXXXXXXXGOOOOOOOOXXXXXXXXXXXGOOOOOOXXXXXXXXXXXXXGOOOOOOOOOOOXXXXXXXXGOOOOOOOOXXXXXXXXXXXGOOXXXXXXXXXXXXXXXXXGOOOOOOOOOOXXXXXXXXXGOOOOXXXXXXXXXXXXXXXGOOOOOOOOOOOOXXXXXXXGOOOOOOOOOOOOOXXXXXXGOOOOOXXXXXXXXXXXXXX,0,0,0
33033,116,0,116,36,448,0,0,157,88,69,GOOOOOOOOOOOXXXXXXXXGOOOOOOOOXXXXXXXXXXXGOOOOOXXXXXXXXXXXXXXGOOOOOOOOXXXXXXXXXXXGOOOOOOXXXXXXXXXXXXXGOOOOOOOOOOOXXXXXXXXGOOOOOOOOXXXXXXXXXXXGOOXXXXXXXXXXXXXXXXXGOOOOOOOOOOXXXXXXXXXGOOOOXXXXXXXXXXXXXXXGOOOOOOOOOOOOXXXXXXXGOOOOOOOOOOOOOXXXXXXGOOOOOXXXXXXXXXXXXXX,0,0,0
33054,116,0,116,36,448,0,0,156,87,69,GOOOOOOOOOOOXXXXXXXXGOOOOOOOOXXXXXXXXXXXGOOOOOXXXXXXXXXXXXXXGOOOOOOOOXXXXXXXXXXXGOOOOOOXXXXXXXXXXXXXGOOOOOOOOOOOXXXXXXXXGOOOOOOOOXXXXXXXXXXXGOOXXXXXXXXXXXXXXXXXGOOOOOOOOOOXXXXXXXXXGOOOOXXXXXXXXXXXXXXXGOOOOOOOOOOOOXXXXXXXGOOOOOOOOOOOOOXXXXXXGOOOOOXXXXXXXXXXXXXX,0,0,0

33075,116,0,116,37,447,0,0,156,88,68,GOOOOOOOOOOOXXXXXXXXGOOOOOOOOXXXXXXXXXXXGOOOOOXXXXXXXXXXXXXXGOOOOOOOOXXXXXXXXXXXGOOOOOOXXXXXXXXXXXXXGOOOOOOOOOOOXXXXXXXXGOOOOOOOOXXXXXXXXXXXGOOXXXXXXXXXXXXXXXXXGOOOOOOOOOOXXXXXXXXXGOOOOXXXXXXXXXXXXXXXGOOOOOOOOOOOOXXXXXXXGOOOOOOOOOOOOOXXXXXXGOOOOOXXXXXXXXXXXXXX,0,0,0
33096,116,0,116,39,445,0,0,154,87,67,GOOOOOOOOOOOXXXXXXXXGOOOOOOOOXXXXXXXXXXXGOOOOOXXXXXXXXXXXXXXGOOOOOOOOXXXXXXXXXXXGOOOOOOXXXXXXXXXXXXXGOOOOOOOOOOOXXXXXXXXGOOOOOOOOXXXXXXXXXXXGOOXXXXXXXXXXXXXXXXXGOOOOOOOOOOXXXXXXXXXGOOOOXXXXXXXXXXXXXXXGOOOOOOOOOOOOXXXXXXXGOOOOOOOOOOOOOXXXXXXGOOOOOXXXXXXXXXXXXXX,0,0,0
33117,116,0,116,36,448,0,0,157,89,68,GOOOOOOOOOOOXXXXXXXXGOOOOOOOOXXXXXXXXXXXGOOOOOXXXXXXXXXXXXXXGOOOOOOOOXXXXXXXXXXXGOOOOOOXXXXXXXXXXXXXGOOOOOOOOOOOXXXXXXXXGOOOOOOOOXXXXXXXXXXXGOOXXXXXXXXXXXXXXXXXGOOOOOOOOOOXXXXXXXXXGOOOOXXXXXXXXXXXXXXXGOOOOOOOOOOOOXXXXXXXGOOOOOOOOOOOOOXXXXXXGOOOOOXXXXXXXXXXXXXX,0,0,0
33138,116,0,116,38,446,0,0,153,88,65,GOOOOOOOOOOOXXXXXXXXGOOOOOOOOXXXXXXXXXXXGOOOOOXXXXXXXXXXXXXXGOOOOOOOOXXXXXXXXXXXGOOOOOOXXXXXXXXXXXXXGOOOOOOOOOOOXXXXXXXXGOOOOOOOOXXXXXXXXXXXGOOXXXXXXXXXXXXXXXXXGOOOOOOOOOOXXXXXXXXXGOOOOXXXXXXXXXXXXXXXGOOOOOOOOOOOOXXXXXXXGOOOOOOOOOOOOOXXXXXXGOOOOOXXXXXXXXXXXXXX,0,0,0
33159,116,0,116,38,446,0,0,153,86,67,GOOOOOOOOOOOXXXXXXXXGOOOOOOOOXXXXXXXXXXXGOOOOOXXXXXXXXXXXXXXGOOOOOOOOXXXXXXXXXXXGOOOOOOXXXXXXXXXXXXXGOOOOOOOOOOOXXXXXXXXGOOOOOOOOXXXXXXXXXXXGOOXXXXXXXXXXXXXXXXXGOOOOOOOOOOXXXXXXXXXGOOOOXXXXXXXXXXXXXXXGOOOOOOOOOOOOXXXXXXXGOOOOOOOOOOOOOXXXXXXGOOOOOXXXXXXXXXXXXXX,0,0,0

33180,116,0,116,34,450,0,0,157,85,72,GOOOOOOOOOOOXXXXXXXXGOOOOOOOOXXXXXXXXXXXGOOOOOXXXXXXXXXXXXXXGOOOOOOOOXXXXXXXXXXXGOOOOOOXXXXXXXXXXXXXGOOOOOOOOOOOXXXXXXXXGOOOOOOOOXXXXXXXXXXXGOOXXXXXXXXXXXXXXXXXGOOOOOOOOOOXXXXXXXXXGOOOOXXXXXXXXXXXXXXXGOOOOOOOOOOOOXXXXXXXGOOOOOOOOOOOOOXXXXXXGOOOOOXXXXXXXXXXXXXX,0,0,0
33201,116,0,116,32,452,0,0,158,87,71,GOOOOOOOOOOOXXXXXXXXGOOOOOOOOXXXXXXXXXXXGOOOOOXXXXXXXXXXXXXXGOOOOOOOOXXXXXXXXXXXGOOOOOOXXXXXXXXXXXXXGOOOOOOOOOOOXXXXXXXXGOOOOOOOOXXXXXXXXXXXGOOXXXXXXXXXXXXXXXXXGOOOOOOOOOOXXXXXXXXXGOOOOXXXXXXXXXXXXXXXGOOOOOOOOOOOOXXXXXXXGOOOOOOOOOOOOOXXXXXXGOOOOOXXXXXXXXXXXXXX,0,0,0
33222,116,0,116,31,453,0,0,161,87,74,GOOOOOOOOOOOXXXXXXXXGOOOOOOOOXXXXXXXXXXXGOOOOOXXXXXXXXXXXXXXGOOOOOOOOXXXXXXXXXXXGOOOOOOXXXXXXXXXXXXXGOOOOOOOOOOOXXXXXXXXGOOOOOOOOXXXXXXXXXXXGOOXXXXXXXXXXXXXXXXXGOOOOOOOOOOXXXXXXXXXGOOOOXXXXXXXXXXXXXXXGOOOOOOOOOOOOXXXXXXXGOOOOOOOOOOOOOXXXXXXGOOOOOXXXXXXXXXXXXXX,0,0,0
33243,116,0,116,35,449,0,0,157,85,72,GOOOOOOOOOOOXXXXXXXXGOOOOOOOOXXXXXXXXXXXGOOOOOXXXXXXXXXXXXXXGOOOOOOOOXXXXXXXXXXXGOOOOOOXXXXXXXXXXXXXGOOOOOOOOOOOXXXXXXXXGOOOOOOOOXXXXXXXXXXXGOOXXXXXXXXXXXXXXXXXGOOOOOOOOOOXXXXXXXXXGOOOOXXXXXXXXXXXXXXXGOOOOOOOOOOOOXXXXXXXGOOOOOOOOOOOOOXXXXXXGOOOOOXXXXXXXXXXXXXX,0,0,0
33264,116,0,116,35,449,0,0,158,87,71,GOOOOOOOOOOOXXXXXXXXGOOOOOOOOXXXXXXXXXXXGOOOOOXXXXXXXXXXXXXXGOOOOOOOOXXXXXXXXXXXGOOOOOOXXXXXXXXXXXXXGOOOOOOOOOOOXXXXXXXXGOOOOOOOOXXXXXXXXXXXGOOXXXXXXXXXXXXXXXXXGOOOOOOOOOOXXXXXXXXXGOOOOXXXXXXXXXXXXXXXGOOOOOOOOOOOOXXXXXXXGOOOOOOOOOOOOOXXXXXXGOOOOOXXXXXXXXXXXXXX,0,0,0

33285,116,0,116,33,451,0,0,159,87,72,GOOOOOOOOOOOXXXXXXXXGOOOOOOOOXXXXXXXXXXXGOOOOOXXXXXXXXXXXXXXGOOOOOOOOXXXXXXXXXXXGOOOOOOXXXXXXXXXXXXXGOOOOOOOOOOOXXXXXXXXGOOOOOOOOXXXXXXXXXXXGOOXXXXXXXXXXXXXXXXXGOOOOOOOOOOXXXXXXXXXGOOOOXXXXXXXXXXXXXXXGOOOOOOOOOOOOXXXXXXXGOOOOOOOOOOOOOXXXXXXGOOOOOXXXXXXXXXXXXXX,0,0,0
33306,116,0,116,29,455,0,0,165,88,77,GOOOOOOOOOOOXXXXXXXXGOOOOOOOOXXXXXXXXXXXGOOOOOXXXXXXXXXXXXXXGOOOOOOOOXXXXXXXXXXXGOOOOOOXXXXXXXXXXXXXGOOOOOOOOOOOXXXXXXXXGOOOOOOOOXXXXXXXXXXXGOOXXXXXXXXXXXXXXXXXGOOOOOOOOOOXXXXXXXXXGOOOOXXXXXXXXXXXXXXXGOOOOOOOOOOOOXXXXXXXGOOOOOOOOOOOOOXXXXXXGOOOOOXXXXXXXXXXXXXX,0,0,0
33327,116,0,116,31,453,0,0,163,87,76,GOOOOOOOOOOOXXXXXXXXGOOOOOOOOXXXXXXXXXXXGOOOOOXXXXXXXXXXXXXXGOOOOOOOOXXXXXXXXXXXGOOOOOOXXXXXXXXXXXXXGOOOOOOOOOOOXXXXXXXXGOOOOOOOOXXXXXXXXXXXGOOXXXXXXXXXXXXXXXXXGOOOOOOOOOOXXXXXXXXXGOOOOXXXXXXXXXXXXXXXGOOOOOOOOOOOOXXXXXXXGOOOOOOOOOOOOOXXXXXXGOOOOOXXXXXXXXXXXXXX,0,0,0
33348,116,0,116,35,449,0,0,159,86,73,GOOOOOOOOOOOXXXXXXXXGOOOOOOOOXXXXXXXXXXXGOOOOOXXXXXXXXXXXXXXGOOOOOOOOXXXXXXXXXXXGOOOOOOXXXXXXXXXXXXXGOOOOOOOOOOOXXXXXXXXGOOOOOOOOXXXXXXXXXXXGOOXXXXXXXXXXXXXXXXXGOOOOOOOOOOXXXXXXXXXGOOOOXXXXXXXXXXXXXXXGOOOOOOOOOOOOXXXXXXXGOOOOOOOOOOOOOXXXXXXGOOOOOXXXXXXXXXXXXXX,0,0,0
33369,116,0,116,35,449,0,0,158,84,74,GOOOOOOOOOOOXXXXXXXXGOOOOOOOOXXXXXXXXXXXGOOOOOXXXXXXXXXXXXXXGOOOOOOOOXXXXXXXXXXXGOOOOOOXXXXXXXXXXXXXGOOOOOOOOOOOXXXXXXXXGOOOOOOOOXXXXXXXXXXXGOOXXXXXXXXXXXXXXXXXGOOOOOOOOOOXXXXXXXXXGOOOOXXXXXXXXXXXXXXXGOOOOOOOOOOOOXXXXXXXGOOOOOOOOOOOOOXXXXXXGOOOOOXXXXXXXXXXXXXX,0,0,0

33390,116,0,116,33,451,0,0,159,86,73,GOOOOOOOOOOOXXXXXXXXGOOOOOOOOXXXXXXXXXXXGOOOOOXXXXXXXXXXXXXXGOOOOOOOOXXXXXXXXXXXGOOOOOOXXXXXXXXXXXXXGOOOOOOOOOOOXXXXXXXXGOOOOOOOOXXXXXXXXXXXGOOXXXXXXXXXXXXXXXXXGOOOOOOOOOOXXXXXXXXXGOOOOXXXXXXXXXXXXXXXGOOOOOOOOOOOOXXXXXXXGOOOOOOOOOOOOOXXXXXXGOOOOOXXXXXXXXXXXXXX,0,0,0
33411,116,0,116,35,449,0,0,158,88,70,GOOOOOOOOOOOXXXXXXXXGOOOOOOOOXXXXXXXXXXXGOOOOOXXXXXXXXXXXXXXGOOOOOOOOXXXXXXXXXXXGOOOOOOXXXXXXXXXXXXXGOOOOOOOOOOOXXXXXXXXGOOOOOOOOXXXXXXXXXXXGOOXXXXXXXXXXXXXXXXXGOOOOOOOOOOXXXXXXXXXGOOOOXXXXXXXXXXXXXXXGOOOOOOOOOOOOXXXXXXXGOOOOOOOOOOOOOXXXXXXGOOOOOXXXXXXXXXXXXXX,0,0,0
33432,117,1,116,37,446,0,0,155,91,64,GOOOOOOOOOOOAXXXXXXXGOOOOOOOOXXXXXXXXXXXGOOOOOXXXXXXXXXXXXXXGOOOOOOOOXXXXXXXXXXXGOOOOOOXXXXXXXXXXXXXGOOOOOOOOOOOXXXXXXXXGOOOOOOOOXXXXXXXXXXXGOOXXXXXXXXXXXXXXXXXGOOOOOOOOOOXXXXXXXXXGOOOOXXXXXXXXXXXXXXXGOOOOOOOOOOOOXXXXXXXGOOOOOOOOOOOOOXXXXXXGOOOOOXXXXXXXXXXXXXX,0,0,0
33453,117,1,116,39,444,0,0,153,92,61,GOOOOOOOOOOOAXXXXXXXGOOOOOOOOXXXXXXXXXXXGOOOOOXXXXXXXXXXXXXXGOOOOOOOOXXXXXXXXXXXGOOOOOOXXXXXXXXXXXXXGOOOOOOOOOOOXXXXXXXXGOOOOOOOOXXXXXXXXXXXGOOXXXXXXXXXXXXXXXXXGOOOOOOOOOOXXXXXXXXXGOOOOXXXXXXXXXXXXXXXGOOOOOOOOOOOOXXXXXXXGOOOOOOOOOOOOOXXXXXXGOOOOOXXXXXXXXXXXXXX,0,0,0
33474,117,1,116,37,446,0,0,155,92,63,GOOOOOOOOOOOAXXXXXXXGOOOOOOOOXXXXXXXXXXXGOOOOOXXXXXXXXXXXXXXGOOOOOOOOXXXXXXXXXXXGOOOOOOXXXXXXXXXXXXXGOOOOOOOOOOOXXXXXXXXGOOOOOOOOXXXXXXXXXXXGOOXXXXXXXXXXXXXXXXXGOOOOOOOOOOXXXXXXXXXGOOOOXXXXXXXXXXXXXXXGOOOOOOOOOOOOXXXXXXXGOOOOOOOOOOOOOXXXXXXGOOOOOXXXXXXXXXXXXXX,0,0,0

33495,117,1,116,34,449,0,0,157,93,64,GOOOOOOOOOOOAXXXXXXXGOOOOOOOOXXXXXXXXXXXGOOOOOXXXXXXXXXXXXXXGOOOOOOOOXXXXXXXXXXXGOOOOOOXXXXXXXXXXXXXGOOOOOOOOOOOXXXXXXXXGOOOOOOOOXXXXXXXXXXXGOOXXXXXXXXXXXXXXXXXGOOOOOOOOOOXXXXXXXXXGOOOOXXXXXXXXXXXXXXXGOOOOOOOOOOOOXXXXXXXGOOOOOOOOOOOOOXXXXXXGOOOOOXXXXXXXXXXXXXX,0,0,0
33516,117,0,117,37,446,0,0,156,88,68,GOOOOOOOOOOOOXXXXXXXGOOOOOOOOXXXXXXXXXXXGOOOOOXXXXXXXXXXXXXXGOOOOOOOOXXXXXXXXXXXGOOOOOOXXXXXXXXXXXXXGOOOOOOOOOOOXXXXXXXXGOOOOOOOOXXXXXXXXXXXGOOXXXXXXXXXXXXXXXXXGOOOOOOOOOOXXXXXXXXXGOOOOXXXXXXXXXXXXXXXGOOOOOOOOOOOOXXXXXXXGOOOOOOOOOOOOOXXXXXXGOOOOOXXXXXXXXXXXXXX,0,0,0
33537,117,0,117,36,447,0,0,157,89,68,GOOOOOOOOOOOOXXXXXXXGOOOOOOOOXXXXXXXXXXXGOOOOOXXXXXXXXXXXXXXGOOOOOOOOXXXXXXXXXXXGOOOOOOXXXXXXXXXXXXXGOOOOOOOOOOOXXXXXXXXGOOOOOOOOXXXXXXXXXXXGOOXXXXXXXXXXXXXXXXXGOOOOOOOOOOXXXXXXXXXGOOOOXXXXXXXXXXXXXXXGOOOOOOOOOOOOXXXXXXXGOOOOOOOOOOOOOXXXXXXGOOOOOXXXXXXXXXXXXXX,0,0,0
33558,117,0,117,38,445,0,0,155,87,68,GOOOOOOOOOOOOXXXXXXXGOOOOOOOOXXXXXXXXXXXGOOOOOXXXXXXXXXXXXXXGOOOOOOOOXXXXXXXXXXXGOOOOOOXXXXXXXXXXXXXGOOOOOOOOOOOXXXXXXXXGOOOOOOOOXXXXXXXXXXXGOOXXXXXXXXXXXXXXXXXGOOOOOOOOOOXXXXXXXXXGOOOOXXXXXXXXXXXXXXXGOOOOOOOOOOOOXXXXXXXGOOOOOOOOOOOOOXXXXXXGOOOOOXXXXXXXXXXXXXX,0,0,0
33579,117,0,117,38,445,0,0,155,88,67,GOOOOOOOOOOOOXXXXXXXGOOOOOOOOXXXXXXXXXXXGOOOOOXXXXXXXXXXXXXXGOOOOOOOOXXXXXXXXXXXGOOOOOOXXXXXXXXXXXXXGOOOOOOOOOOOXXXXXXXXGOOOOOOOOXXXXXXXXXXXGOOXXXXXXXXXXXXXXXXXGOOOOOOOOOOXXXXXXXXXGOOOOXXXXXXXXXXXXXXXGOOOOOOOOOOOOXXXXXXXGOOOOOOOOOOOOOXXXXXXGOOOOOXXXXXXXXXXXXXX,0,0,0

33600,117,0,117,40,443,0,0,152,89,63,GOOOOOOOOOOOOXXXXXXXGOOOOOOOOXXXXXXXXXXXGOOOOOXXXXXXXXXXXXXXGOOOOOOOOXXXXXXXXXXXGOOOOOOXXXXXXXXXXXXXGOOOOOOOOOOOXXXXXXXXGOOOOOOOOXXXXXXXXXXXGOOXXXXXXXXXXXXXXXXXGOOOOOOOOOOXXXXXXXXXGOOOOXXXXXXXXXXXXXXXGOOOOOOOOOOOOXXXXXXXGOOOOOOOOOOOOOXXXXXXGOOOOOXXXXXXXXXXXXXX,0,0,0
33621,117,0,117,41,442,0,0,151,85,66,GOOOOOOOOOOOOXXXXXXXGOOOOOOOOXXXXXXXXXXXGOOOOOXXXXXXXXXXXXXXGOOOOOOOOXXXXXXXXXXXGOOOOOOXXXXXXXXXXXXXGOOOOOOOOOOOXXXXXXXXGOOOOOOOOXXXXXXXXXXXGOOXXXXXXXXXXXXXXXXXGOOOOOOOOOOXXXXXXXXXGOOOOXXXXXXXXXXXXXXXGOOOOOOOOOOOOXXXXXXXGOOOOOOOOOOOOOXXXXXXGOOOOOXXXXXXXXXXXXXX,0,0,0
33642,117,0,117,38,445,0,0,153,84,69,GOOOOOOOOOOOOXXXXXXXGOOOOOOOOXXXXXXXXXXXGOOOOOXXXXXXXXXXXXXXGOOOOOOOOXXXXXXXXXXXGOOOOOOXXXXXXXXXXXXXGOOOOOOOOOOOXXXXXXXXGOOOOOOOOXXXXXXXXXXXGOOXXXXXXXXXXXXXXXXXGOOOOOOOOOOXXXXXXXXXGOOOOXXXXXXXXXXXXXXXGOOOOOOOOOOOOXXXXXXXGOOOOOOOOOOOOOXXXXXXGOOOOOXXXXXXXXXXXXXX,0,0,0
33663,117,0,117,33,450,0,0,158,85,73,GOOOOOOOOOOOOXXXXXXXGOOOOOOOOXXXXXXXXXXXGOOOOOXXXXXXXXXXXXXXGOOOOOOOOXXXXXXXXXXXGOOOOOOXXXXXXXXXXXXXGOOOOOOOOOOOXXXXXXXXGOOOOOOOOXXXXXXXXXXXGOOXXXXXXXXXXXXXXXXXGOOOOOOOOOOXXXXXXXXXGOOOOXXXXXXXXXXXXXXXGOOOOOOOOOOOOXXXXXXXGOOOOOOOOOOOOOXXXXXXGOOOOOXXXXXXXXXXXXXX,0,0,0
33684,117,0,117,30,453,0,0,161,88,73,GOOOOOOOOOOOOXXXXXXXGOOOOOOOOXXXXXXXXXXXGOOOOOXXXXXXXXXXXXXXGOOOOOOOOXXXXXXXXXXXGOOOOOOXXXXXXXXXXXXXGOOOOOOOOOOOXXXXXXXXGOOOOOOOOXXXXXXXXXXXGOOXXXXXXXXXXXXXXXXXGOOOOOOOOOOXXXXXXXXXGOOOOXXXXXXXXXXXXXXXGOOOOOOOOOOOOXXXXXXXGOOOOOOOOOOOOOXXXXXXGOOOOOXXXXXXXXXXXXXX,0,0,0

33705,117,0,117,27,456,0,0,164,90,74,GOOOOOOOOOOOOXXXXXXXGOOOOOOOOXXXXXXXXXXXGOOOOOXXXXXXXXXXXXXXGOOOOOOOOXXXXXXXXXXXGOOOOOOXXXXXXXXXXXXXGOOOOOOOOOOOXXXXXXXXGOOOOOOOOXXXXXXXXXXXGOOXXXXXXXXXXXXXXXXXGOOOOOOOOOOXXXXXXXXXGOOOOXXXXXXXXXXXXXXXGOOOOOOOOOOOOXXXXXXXGOOOOOOOOOOOOOXXXXXXGOOOOOXXXXXXXXXXXXXX,0,0,0
33726,117,0,117,30,453,0,0,161,86,75,GOOOOOOOOOOOOXXXXXXXGOOOOOOOOXXXXXXXXXXXGOOOOOXXXXXXXXXXXXXXGOOOOOOOOXXXXXXXXXXXGOOOOOOXXXXXXXXXXXXXGOOOOOOOOOOOXXXXXXXXGOOOOOOOOXXXXXXXXXXXGOOXXXXXXXXXXXXXXXXXGOOOOOOOOOOXXXXXXXXXGOOOOXXXXXXXXXXXXXXXGOOOOOOOOOOOOXXXXXXXGOOOOOOOOOOOOOXXXXXXGOOOOOXXXXXXXXXXXXXX,0,0,0
33747,117,0,117,32,451,0,0,159,89,70,GOOOOOOOOOOOOXXXXXXXGOOOOOOOOXXXXXXXXXXXGOOOOOXXXXXXXXXXXXXXGOOOOOOOOXXXXXXXXXXXGOOOOOOXXXXXXXXXXXXXGOOOOOOOOOOOXXXXXXXXGOOOOOOOOXXXXXXXXXXXGOOXXXXXXXXXXXXXXXXXGOOOOOOOOOOXXXXXXXXXGOOOOXXXXXXXXXXXXXXXGOOOOOOOOOOOOXXXXXXXGOOOOOOOOOOOOOXXXXXXGOOOOOXXXXXXXXXXXXXX,0,0,0
33768,117,0,117,34,449,0,0,156,87,69,GOOOOOOOOOOOOXXXXXXXGOOOOOOOOXXXXXXXXXXXGOOOOOXXXXXXXXXXXXXXGOOOOOOOOXXXXXXXXXXXGOOOOOOXXXXXXXXXXXXXGOOOOOOOOOOOXXXXXXXXGOOOOOOOOXXXXXXXXXXXGOOXXXXXXXXXXXXXXXXXGOOOOOOOOOOXXXXXXXXXGOOOOXXXXXXXXXXXXXXXGOOOOOOOOOOOOXXXXXXXGOOOOOOOOOOOOOXXXXXXGOOOOOXXXXXXXXXXXXXX,0,0,0
33789,117,0,117,34,449,0,0,157,87,70,GOOOOOOOOOOOOXXXXXXXGOOOOOOOOXXXXXXXXXXXGOOOOOXXXXXXXXXXXXXXGOOOOOOOOXXXXXXXXXXXGOOOOOOXXXXXXXXXXXXXGOOOOOOOOOOOXXXXXXXXGOOOOOOOOXXXXXXXXXXXGOOXXXXXXXXXXXXXXXXXGOOOOOOOOOOXXXXXXXXXGOOOOXXXXXXXXXXXXXXXGOOOOOOOOOOOOXXXXXXXGOOOOOOOOOOOOOXXXXXXGOOOOOXXXXXXXXXXXXXX,0,0,0

33810,117,0,117,33,450,0,0,157,87,70,GOOOOOOOOOOOOXXXXXXXGOOOOOOOOXXXXXXXXXXXGOOOOOXXXXXXXXXXXXXXGOOOOOOOOXXXXXXXXXXXGOOOOOOXXXXXXXXXXXXXGOOOOOOOOOOOXXXXXXXXGOOOOOOOOXXXXXXXXXXXGOOXXXXXXXXXXXXXXXXXGOOOOOOOOOOXXXXXXXXXGOOOOXXXXXXXXXXXXXXXGOOOOOOOOOOOOXXXXXXXGOOOOOOOOOOOOOXXXXXXGOOOOOXXXXXXXXXXXXXX,0,0,0
33831,117,0,117,36,447,0,0,155,85,70,GOOOOOOOOOOOOXXXXXXXGOOOOOOOOXXXXXXXXXXXGOOOOOXXXXXXXXXXXXXXGOOOOOOOOXXXXXXXXXXXGOOOOOOXXXXXXXXXXXXXGOOOOOOOOOOOXXXXXXXXGOOOOOOOOXXXXXXXXXXXGOOXXXXXXXXXXXXXXXXXGOOOOOOOOOOXXXXXXXXXGOOOOXXXXXXXXXXXXXXXGOOOOOOOOOOOOXXXXXXXGOOOOOOOOOOOOOXXXXXXGOOOOOXXXXXXXXXXXXXX,0,0,0
33852,117,0,117,34,449,0,0,156,87,69,GOOOOOOOOOOOOXXXXXXXGOOOOOOOOXXXXXXXXXXXGOOOOOXXXXXXXXXXXXXXGOOOOOOOOXXXXXXXXXXXGOOOOOOXXXXXXXXXXXXXGOOOOOOOOOOOXXXXXXXXGOOOOOOOOXXXXXXXXXXXGOOXXXXXXXXXXXXXXXXXGOOOOOOOOOOXXXXXXXXXGOOOOXXXXXXXXXXXXXXXGOOOOOOOOOOOOXXXXXXXGOOOOOOOOOOOOOXXXXXXGOOOOOXXXXXXXXXXXXXX,0,0,0
33873,117,0,117,34,449,0,0,157,86,71,GOOOOOOOOOOOOXXXXXXXGOOOOOOOOXXXXXXXXXXXGOOOOOXXXXXXXXXXXXXXGOOOOOOOOXXXXXXXXXXXGOOOOOOXXXXXXXXXXXXXGOOOOOOOOOOOXXXXXXXXGOOOOOOOOXXXXXXXXXXXGOOXXXXXXXXXXXXXXXXXGOOOOOOOOOOXXXXXXXXXGOOOOXXXXXXXXXXXXXXXGOOOOOOOOOOOOXXXXXXXGOOOOOOOOOOOOOXXXXXXGOOOOOXXXXXXXXXXXXXX,0,0,0
33894,117,0,117,35,448,0,0,156,88,68,GOOOOOOOOOOOOXXXXXXXGOOOOOOOOXXXXXXXXXXXGOOOOOXXXXXXXXXXXXXXGOOOOOOOOXXXXXXXXXXXGOOOOOOXXXXXXXXXXXXXGOOOOOOOOOOOXXXXXXXXGOOOOOOOOXXXXXXXXXXXGOOXXXXXXXXXXXXXXXXXGOOOOOOOOOOXXXXXXXXXGOOOOXXXXXXXXXXXXXXXGOOOOOOOOOOOOXXXXXXXGOOOOOOOOOOOOOXXXXXXGOOOOOXXXXXXXXXXXXXX,0,0,0

33915,117,0,117,33,450,0,0,158,89,69,GOOOOOOOOOOOOXXXXXXXGOOOOOOOOXXXXXXXXXXXGOOOOOXXXXXXXXXXXXXXGOOOOOOOOXXXXXXXXXXXGOOOOOOXXXXXXXXXXXXXGOOOOOOOOOOOXXXXXXXXGOOOOOOOOXXXXXXXXXXXGOOXXXXXXXXXXXXXXXXXGOOOOOOOOOOXXXXXXXXXGOOOOXXXXXXXXXXXXXXXGOOOOOOOOOOOOXXXXXXXGOOOOOOOOOOOOOXXXXXXGOOOOOXXXXXXXXXXXXXX,0,0,0
33936,117,0,117,34,449,0,0,156,90,66,GOOOOOOOOOOOOXXXXXXXGOOOOOOOOXXXXXXXXXXXGOOOOOXXXXXXXXXXXXXXGOOOOOOOOXXXXXXXXXXXGOOOOOOXXXXXXXXXXXXXGOOOOOOOOOOOXXXXXXXXGOOOOOOOOXXXXXXXXXXXGOOXXXXXXXXXXXXXXXXXGOOOOOOOOOOXXXXXXXXXGOOOOXXXXXXXXXXXXXXXGOOOOOOOOOOOOXXXXXXXGOOOOOOOOOOOOOXXXXXXGOOOOOXXXXXXXXXXXXXX,0,0,0
33957,117,0,117,35,448,0,0,156,89,67,GOOOOOOOOOOOOXXXXXXXGOOOOOOOOXXXXXXXXXXXGOOOOOXXXXXXXXXXXXXXGOOOOOOOOXXXXXXXXXXXGOOOOOOXXXXXXXXXXXXXGOOOOOOOOOOOXXXXXXXXGOOOOOOOOXXXXXXXXXXXGOOXXXXXXXXXXXXXXXXXGOOOOOOOOOOXXXXXXXXXGOOOOXXXXXXXXXXXXXXXGOOOOOOOOOOOOXXXXXXXGOOOOOOOOOOOOOXXXXXXGOOOOOXXXXXXXXXXXXXX,0,0,0
33978,117,0,117,38,445,0,0,153,87,66,GOOOOOOOOOOOOXXXXXXXGOOOOOOOOXXXXXXXXXXXGOOOOOXXXXXXXXXXXXXXGOOOOOOOOXXXXXXXXXXXGOOOOOOXXXXXXXXXXXXXGOOOOOOOOOOOXXXXXXXXGOOOOOOOOXXXXXXXXXXXGOOXXXXXXXXXXXXXXXXXGOOOOOOOOOOXXXXXXXXXGOOOOXXXXXXXXXXXXXXXGOOOOOOOOOOOOXXXXXXXGOOOOOOOOOOOOOXXXXXXGOOOOOXXXXXXXXXXXXXX,0,0,0
33999,117,0,117,36,447,0,0,155,87,68,GOOOOOOOOOOOOXXXXXXXGOOOOOOOOXXXXXXXXXXXGOOOOOXXXXXXXXXXXXXXGOOOOOOOOXXXXXXXXXXXGOOOOOOXXXXXXXXXXXXXGOOOOOOOOOOOXXXXXXXXGOOOOOOOOXXXXXXXXXXXGOOXXXXXXXXXXXXXXXXXGOOOOOOOOOOXXXXXXXXXGOOOOXXXXXXXXXXXXXXXGOOOOOOOOOOOOXXXXXXXGOOOOOOOOOOOOOXXXXXXGOOOOOXXXXXXXXXXXXXX,0,0,0

34020,117,0,117,33,450,0,0,158,87,71,GOOOOOOOOOOOOXXXXXXXGOOOOOOOOXXXXXXXXXXXGOOOOOXXXXXXXXXXXXXXGOOOOOOOOXXXXXXXXXXXGOOOOOOXXXXXXXXXXXXXGOOOOOOOOOOOXXXXXXXXGOOOOOOOOXXXXXXXXXXXGOOXXXXXXXXXXXXXXXXXGOOOOOOOOOOXXXXXXXXXGOOOOXXXXXXXXXXXXXXXGOOOOOOOOOOOOXXXXXXXGOOOOOOOOOOOOOXXXXXXGOOOOOXXXXXXXXXXXXXX,0,0,0
34041,117,0,117,32,451,0,0,159,88,71,GOOOOOOOOOOOOXXXXXXXGOOOOOOOOXXXXXXXXXXXGOOOOOXXXXXXXXXXXXXXGOOOOOOOOXXXXXXXXXXXGOOOOOOXXXXXXXXXXXXXGOOOOOOOOOOOXXXXXXXXGOOOOOOOOXXXXXXXXXXXGOOXXXXXXXXXXXXXXXXXGOOOOOOOOOOXXXXXXXXXGOOOOXXXXXXXXXXXXXXXGOOOOOOOOOOOOXXXXXXXGOOOOOOOOOOOOOXXXXXXGOOOOOXXXXXXXXXXXXXX,0,0,0
34062,117,0,117,37,446,0,0,154,91,63,GOOOOOOOOOOOOXXXXXXXGOOOOOOOOXXXXXXXXXXXGOOOOOXXXXXXXXXXXXXXGOOOOOOOOXXXXXXXXXXXGOOOOOOXXXXXXXXXXXXXGOOOOOOOOOOOXXXXXXXXGOOOOOOOOXXXXXXXXXXXGOOXXXXXXXXXXXXXXXXXGOOOOOOOOOOXXXXXXXXXGOOOOXXXXXXXXXXXXXXXGOOOOOOOOOOOOXXXXXXXGOOOOOOOOOOOOOXXXXXXGOOOOOXXXXXXXXXXXXXX,0,0,0
34083,117,0,117,35,448,0,0,155,93,62,GOOOOOOOOOOOOXXXXXXXGOOOOOOOOXXXXXXXXXXXGOOOOOXXXXXXXXXXXXXXGOOOOOOOOXXXXXXXXXXXGOOOOOOXXXXXXXXXXXXXGOOOOOOOOOOOXXXXXXXXGOOOOOOOOXXXXXXXXXXXGOOXXXXXXXXXXXXXXXXXGOOOOOOOOOOXXXXXXXXXGOOOOXXXXXXXXXXXXXXXGOOOOOOOOOOOOXXXXXXXGOOOOOOOOOOOOOXXXXXXGOOOOOXXXXXXXXXXXXXX,0,0,0
34104,117,0,117,36,447,0,0,155,90,65,GOOOOOOOOOOOOXXXXXXXGOOOOOOOOXXXXXXXXXXXGOOOOOXXXXXXXXXXXXXXGOOOOOOOOXXXXXXXXXXXGOOOOOOXXXXXXXXXXXXXGOOOOOOOOOOOXXXXXXXXGOOOOOOOOXXXXXXXXXXXGOOXXXXXXXXXXXXXXXXXGOOOOOOOOOOXXXXXXXXXGOOOOXXXXXXXXXXXXXXXGOOOOOOOOOOOOXXXXXXXGOOOOOOOOOOOOOXXXXXXGOOOOOXXXXXXXXXXXXXX,0,0,0

34125,117,0,117,35,448,0,0,156,89,67,GOOOOOOOOOOOOXXXXXXXGOOOOOOOOXXXXXXXXXXXGOOOOOXXXXXXXXXXXXXXGOOOOOOOOXXXXXXXXXXXGOOOOOOXXXXXXXXXXXXXGOOOOOOOOOOOXXXXXXXXGOOOOOOOOXXXXXXXXXXXGOOXXXXXXXXXXXXXXXXXGOOOOOOOOOOXXXXXXXXXGOOOOXXXXXXXXXXXXXXXGOOOOOOOOOOOOXXXXXXXGOOOOOOOOOOOOOXXXXXXGOOOOOXXXXXXXXXXXXXX,0,0,0
34146,117,0,117,35,448,0,0,156,89,67,GOOOOOOOOOOOOXXXXXXXGOOOOOOOOXXXXXXXXXXXGOOOOOXXXXXXXXXXXXXXGOOOOOOOOXXXXXXXXXXXGOOOOOOXXXXXXXXXXXXXGOOOOOOOOOOOXXXXXXXXGOOOOOOOOXXXXXXXXXXXGOOXXXXXXXXXXXXXXXXXGOOOOOOOOOOXXXXXXXXXGOOOOXXXXXXXXXXXXXXXGOOOOOOOOOOOOXXXXXXXGOOOOOOOOOOOOOXXXXXXGOOOOOXXXXXXXXXXXXXX,0,0,0
34167,117,0,117,38,445,0,0,153,90,63,GOOOOOOOOOOOOXXXXXXXGOOOOOOOOXXXXXXXXXXXGOOOOOXXXXXXXXXXXXXXGOOOOOOOOXXXXXXXXXXXGOOOOOOXXXXXXXXXXXXXGOOOOOOOOOOOXXXXXXXXGOOOOOOOOXXXXXXXXXXXGOOXXXXXXXXXXXXXXXXXGOOOOOOOOOOXXXXXXXXXGOOOOXXXXXXXXXXXXXXXGOOOOOOOOOOOOXXXXXXXGOOOOOOOOOOOOOXXXXXXGOOOOOXXXXXXXXXXXXXX,0,0,0
34188,117,0,117,42,441,0,0,149,89,60,GOOOOOOOOOOOOXXXXXXXGOOOOOOOOXXXXXXXXXXXGOOOOOXXXXXXXXXXXXXXGOOOOOOOOXXXXXXXXXXXGOOOOOOXXXXXXXXXXXXXGOOOOOOOOOOOXXXXXXXXGOOOOOOOOXXXXXXXXXXXGOOXXXXXXXXXXXXXXXXXGOOOOOOOOOOXXXXXXXXXGOOOOXXXXXXXXXXXXXXXGOOOOOOOOOOOOXXXXXXXGOOOOOOOOOOOOOXXXXXXGOOOOOXXXXXXXXXXXXXX,0,0,0
34209,117,0,117,41,442,0,0,151,88,63,GOOOOOOOOOOOOXXXXXXXGOOOOOOOOXXXXXXXXXXXGOOOOOXXXXXXXXXXXXXXGOOOOOOOOXXXXXXXXXXXGOOOOOOXXXXXXXXXXXXXGOOOOOOOOOOOXXXXXXXXGOOOOOOOOXXXXXXXXXXXGOOXXXXXXXXXXXXXXXXXGOOOOOOOOOOXXXXXXXXXGOOOOXXXXXXXXXXXXXXXGOOOOOOOOOOOOXXXXXXXGOOOOOOOOOOOOOXXXXXXGOOOOOXXXXXXXXXXXXXX,0,0,0

34230,117,0,117,40,443,0,0,153,87,66,GOOOOOOOOOOOOXXXXXXXGOOOOOOOOXXXXXXXXXXXGOOOOOXXXXXXXXXXXXXXGOOOOOOOOXXXXXXXXXXXGOOOOOOXXXXXXXXXXXXXGOOOOOOOOOOOXXXXXXXXGOOOOOOOOXXXXXXXXXXXGOOXXXXXXXXXXXXXXXXXGOOOOOOOOOOXXXXXXXXXGOOOOXXXXXXXXXXXXXXXGOOOOOOOOOOOOXXXXXXXGOOOOOOOOOOOOOXXXXXXGOOOOOXXXXXXXXXXXXXX,0,0,0
34251,117,0,117,39,444,0,0,154,88,66,GOOOOOOOOOOOOXXXXXXXGOOOOOOOOXXXXXXXXXXXGOOOOOXXXXXXXXXXXXXXGOOOOOOOOXXXXXXXXXXXGOOOOOOXXXXXXXXXXXXXGOOOOOOOOOOOXXXXXXXXGOOOOOOOOXXXXXXXXXXXGOOXXXXXXXXXXXXXXXXXGOOOOOOOOOOXXXXXXXXXGOOOOXXXXXXXXXXXXXXXGOOOOOOOOOOOOXXXXXXXGOOOOOOOOOOOOOXXXXXXGOOOOOXXXXXXXXXXXXXX,0,0,0
34272,117,0,117,35,448,0,0,158,88,70,GOOOOOOOOOOOOXXXXXXXGOOOOOOOOXXXXXXXXXXXGOOOOOXXXXXXXXXXXXXXGOOOOOOOOXXXXXXXXXXXGOOOOOOXXXXXXXXXXXXXGOOOOOOOOOOOXXXXXXXXGOOOOOOOOXXXXXXXXXXXGOOXXXXXXXXXXXXXXXXXGOOOOOOOOOOXXXXXXXXXGOOOOXXXXXXXXXXXXXXXGOOOOOOOOOOOOXXXXXXXGOOOOOOOOOOOOOXXXXXXGOOOOOXXXXXXXXXXXXXX,0,0,0
34293,117,0,117,33,450,0,0,160,89,71,GOOOOOOOOOOOOXXXXXXXGOOOOOOOOXXXXXXXXXXXGOOOOOXXXXXXXXXXXXXXGOOOOOOOOXXXXXXXXXXXGOOOOOOXXXXXXXXXXXXXGOOOOOOOOOOOXXXXXXXXGOOOOOOOOXXXXXXXXXXXGOOXXXXXXXXXXXXXXXXXGOOOOOOOOOOXXXXXXXXXGOOOOXXXXXXXXXXXXXXXGOOOOOOOOOOOOXXXXXXXGOOOOOOOOOOOOOXXXXXXGOOOOOXXXXXXXXXXXXXX,0,0,0
34314,117,0,117,33,450,0,0,161,88,73,GOOOOOOOOOOOOXXXXXXXGOOOOOOOOXXXXXXXXXXXGOOOOOXXXXXXXXXXXXXXGOOOOOOOOXXXXXXXXXXXGOOOOOOXXXXXXXXXXXXXGOOOOOOOOOOOXXXXXXXXGOOOOOOOOXXXXXXXXXXXGOOXXXXXXXXXXXXXXXXXGOOOOOOOOOOXXXXXXXXXGOOOOXXXXXXXXXXXXXXXGOOOOOOOOOOOOXXXXXXXGOOOOOOOOOOOOOXXXXXXGOOOOOXXXXXXXXXXXXXX,0,0,0

34335,117,0,117,30,453,0,0,163,89,74,GOOOOOOOOOOOOXXXXXXXGOOOOOOOOXXXXXXXXXXXGOOOOOXXXXXXXXXXXXXXGOOOOOOOOXXXXXXXXXXXGOOOOOOXXXXXXXXXXXXXGOOOOOOOOOOOXXXXXXXXGOOOOOOOOXXXXXXXXXXXGOOXXXXXXXXXXXXXXXXXGOOOOOOOOOOXXXXXXXXXGOOOOXXXXXXXXXXXXXXXGOOOOOOOOOOOOXXXXXXXGOOOOOOOOOOOOOXXXXXXGOOOOOXXXXXXXXXXXXXX,0,0,0
34356,117,0,117,30,453,0,0,163,92,71,GOOOOOOOOOOOOXXXXXXXGOOOOOOOOXXXXXXXXXXXGOOOOOXXXXXXXXXXXXXXGOOOOOOOOXXXXXXXXXXXGOOOOOOXXXXXXXXXXXXXGOOOOOOOOOOOXXXXXXXXGOOOOOOOOXXXXXXXXXXXGOOXXXXXXXXXXXXXXXXXGOOOOOOOOOOXXXXXXXXXGOOOOXXXXXXXXXXXXXXXGOOOOOOOOOOOOXXXXXXXGOOOOOOOOOOOOOXXXXXXGOOOOOXXXXXXXXXXXXXX,0,0,0
34377,117,0,117,33,450,0,0,160,95,65,GOOOOOOOOOOOOXXXXXXXGOOOOOOOOXXXXXXXXXXXGOOOOOXXXXXXXXXXXXXXGOOOOOOOOXXXXXXXXXXXGOOOOOOXXXXXXXXXXXXXGOOOOOOOOOOOXXXXXXXXGOOOOOOOOXXXXXXXXXXXGOOXXXXXXXXXXXXXXXXXGOOOOOOOOOOXXXXXXXXXGOOOOXXXXXXXXXXXXXXXGOOOOOOOOOOOOXXXXXXXGOOOOOOOOOOOOOXXXXXXGOOOOOXXXXXXXXXXXXXX,0,0,0
34398,117,0,117,38,445,0,0,155,91,64,GOOOOOOOOOOOOXXXXXXXGOOOOOOOOXXXXXXXXXXXGOOOOOXXXXXXXXXXXXXXGOOOOOOOOXXXXXXXXXXXGOOOOOOXXXXXXXXXXXXXGOOOOOOOOOOOXXXXXXXXGOOOOOOOOXXXXXXXXXXXGOOXXXXXXXXXXXXXXXXXGOOOOOOOOOOXXXXXXXXXGOOOOXXXXXXXXXXXXXXXGOOOOOOOOOOOOXXXXXXXGOOOOOOOOOOOOOXXXXXXGOOOOOXXXXXXXXXXXXXX,0,0,0
34419,117,0,117,40,443,0,0,153,92,61,GOOOOOOOOOOOOXXXXXXXGOOOOOOOOXXXXXXXXXXXGOOOOOXXXXXXXXXXXXXXGOOOOOOOOXXXXXXXXXXXGOOOOOOXXXXXXXXXXXXXGOOOOOOOOOOOXXXXXXXXGOOOOOOOOXXXXXXXXXXXGOOXXXXXXXXXXXXXXXXXGOOOOOOOOOOXXXXXXXXXGOOOOXXXXXXXXXXXXXXXGOOOOOOOOOOOOXXXXXXXGOOOOOOOOOOOOOXXXXXXGOOOOOXXXXXXXXXXXXXX,0,0,0

34440,117,0,117,43,440,0,0,150,88,62,GOOOOOOOOOOOOXXXXXXXGOOOOOOOOXXXXXXXXXXXGOOOOOXXXXXXXXXXXXXXGOOOOOOOOXXXXXXXXXXXGOOOOOOXXXXXXXXXXXXXGOOOOOOOOOOOXXXXXXXXGOOOOOOOOXXXXXXXXXXXGOOXXXXXXXXXXXXXXXXXGOOOOOOOOOOXXXXXXXXXGOOOOXXXXXXXXXXXXXXXGOOOOOOOOOOOOXXXXXXXGOOOOOOOOOOOOOXXXXXXGOOOOOXXXXXXXXXXXXXX,0,0,0
34461,117,0,117,41,442,0,0,152,90,62,GOOOOOOOOOOOOXXXXXXXGOOOOOOOOXXXXXXXXXXXGOOOOOXXXXXXXXXXXXXXGOOOOOOOOXXXXXXXXXXXGOOOOOOXXXXXXXXXXXXXGOOOOOOOOOOOXXXXXXXXGOOOOOOOOXXXXXXXXXXXGOOXXXXXXXXXXXXXXXXXGOOOOOOOOOOXXXXXXXXXGOOOOXXXXXXXXXXXXXXXGOOOOOOOOOOOOXXXXXXXGOOOOOOOOOOOOOXXXXXXGOOOOOXXXXXXXXXXXXXX,0,0,0
34482,117,0,117,38,445,0,0,155,87,68,GOOOOOOOOOOOOXXXXXXXGOOOOOOOOXXXXXXXXXXXGOOOOOXXXXXXXXXXXXXXGOOOOOOOOXXXXXXXXXXXGOOOOOOXXXXXXXXXXXXXGOOOOOOOOOOOXXXXXXXXGOOOOOOOOXXXXXXXXXXXGOOXXXXXXXXXXXXXXXXXGOOOOOOOOOOXXXXXXXXXGOOOOXXXXXXXXXXXXXXXGOOOOOOOOOOOOXXXXXXXGOOOOOOOOOOOOOXXXXXXGOOOOOXXXXXXXXXXXXXX,0,0,0
34503,117,0,117,36,447,0,0,157,89,68,GOOOOOOOOOOOOXXXXXXXGOOOOOOOOXXXXXXXXXXXGOOOOOXXXXXXXXXXXXXXGOOOOOOOOXXXXXXXXXXXGOOOOOOXXXXXXXXXXXXXGOOOOOOOOOOOXXXXXXXXGOOOOOOOOXXXXXXXXXXXGOOXXXXXXXXXXXXXXXXXGOOOOOOOOOOXXXXXXXXXGOOOOXXXXXXXXXXXXXXXGOOOOOOOOOOOOXXXXXXXGOOOOOOOOOOOOOXXXXXXGOOOOOXXXXXXXXXXXXXX,0,0,0
34524,117,0,117,36,447,0,0,157,87,70,GOOOOOOOOOOOOXXXXXXXGOOOOOOOOXXXXXXXXXXXGOOOOOXXXXXXXXXXXXXXGOOOOOOOOXXXXXXXXXXXGOOOOOOXXXXXXXXXXXXXGOOOOOOOOOOOXXXXXXXXGOOOOOOOOXXXXXXXXXXXGOOXXXXXXXXXXXXXXXXXGOOOOOOOOOOXXXXXXXXXGOOOOXXXXXXXXXXXXXXXGOOOOOOOOOOOOXXXXXXXGOOOOOOOOOOOOOXXXXXXGOOOOOXXXXXXXXXXXXXX,0,0,0

34545,117,0,117,35,448,0,0,158,90,68,GOOOOOOOOOOOOXXXXXXXGOOOOOOOOXXXXXXXXXXXGOOOOOXXXXXXXXXXXXXXGOOOOOOOOXXXXXXXXXXXGOOOOOOXXXXXXXXXXXXXGOOOOOOOOOOOXXXXXXXXGOOOOOOOOXXXXXXXXXXXGOOXXXXXXXXXXXXXXXXXGOOOOOOOOOOXXXXXXXXXGOOOOXXXXXXXXXXXXXXXGOOOOOOOOOOOOXXXXXXXGOOOOOOOOOOOOOXXXXXXGOOOOOXXXXXXXXXXXXXX,0,0,0
34566,117,0,117,33,450,0,0,160,90,70,GOOOOOOOOOOOOXXXXXXXGOOOOOOOOXXXXXXXXXXXGOOOOOXXXXXXXXXXXXXXGOOOOOOOOXXXXXXXXXXXGOOOOOOXXXXXXXXXXXXXGOOOOOOOOOOOXXXXXXXXGOOOOOOOOXXXXXXXXXXXGOOXXXXXXXXXXXXXXXXXGOOOOOOOOOOXXXXXXXXXGOOOOXXXXXXXXXXXXXXXGOOOOOOOOOOOOXXXXXXXGOOOOOOOOOOOOOXXXXXXGOOOOOXXXXXXXXXXXXXX,0,0,0
34587,117,0,117,34,449,0,0,159,89,70,GOOOOOOOOOOOOXXXXXXXGOOOOOOOOXXXXXXXXXXXGOOOOOXXXXXXXXXXXXXXGOOOOOOOOXXXXXXXXXXXGOOOOOOXXXXXXXXXXXXXGOOOOOOOOOOOXXXXXXXXGOOOOOOOOXXXXXXXXXXXGOOXXXXXXXXXXXXXXXXXGOOOOOOOOOOXXXXXXXXXGOOOOXXXXXXXXXXXXXXXGOOOOOOOOOOOOXXXXXXXGOOOOOOOOOOOOOXXXXXXGOOOOOXXXXXXXXXXXXXX,0,0,0
34608,117,0,117,38,445,0,0,156,88,68,GOOOOOOOOOOOOXXXXXXXGOOOOOOOOXXXXXXXXXXXGOOOOOXXXXXXXXXXXXXXGOOOOOOOOXXXXXXXXXXXGOOOOOOXXXXXXXXXXXXXGOOOOOOOOOOOXXXXXXXXGOOOOOOOOXXXXXXXXXXXGOOXXXXXXXXXXXXXXXXXGOOOOOOOOOOXXXXXXXXXGOOOOXXXXXXXXXXXXXXXGOOOOOOOOOOOOXXXXXXXGOOOOOOOOOOOOOXXXXXXGOOOOOXXXXXXXXXXXXXX,0,0,0
34629,117,0,117,39,444,0,0,156,91,65,GOOOOOOOOOOOOXXXXXXXGOOOOOOOOXXXXXXXXXXXGOOOOOXXXXXXXXXXXXXXGOOOOOOOOXXXXXXXXXXXGOOOOOOXXXXXXXXXXXXXGOOOOOOOOOOOXXXXXXXXGOOOOOOOOXXXXXXXXXXXGOOXXXXXXXXXXXXXXXXXGOOOOOOOOOOXXXXXXXXXGOOOOXXXXXXXXXXXXXXXGOOOOOOOOOOOOXXXXXXXGOOOOOOOOOOOOOXXXXXXGOOOOOXXXXXXXXXXXXXX,0,0,0

34650,117,0,117,41,442,0,0,154,88,66,GOOOOOOOOOOOOXXXXXXXGOOOOOOOOXXXXXXXXXXXGOOOOOXXXXXXXXXXXXXXGOOOOOOOOXXXXXXXXXXXGOOOOOOXXXXXXXXXXXXXGOOOOOOOOOOOXXXXXXXXGOOOOOOOOXXXXXXXXXXXGOOXXXXXXXXXXXXXXXXXGOOOOOOOOOOXXXXXXXXXGOOOOXXXXXXXXXXXXXXXGOOOOOOOOOOOOXXXXXXXGOOOOOOOOOOOOOXXXXXXGOOOOOXXXXXXXXXXXXXX,0,0,0
34671,117,0,117,43,440,0,0,151,89,62,GOOOOOOOOOOOOXXXXXXXGOOOOOOOOXXXXXXXXXXXGOOOOOXXXXXXXXXXXXXXGOOOOOOOOXXXXXXXXXXXGOOOOOOXXXXXXXXXXXXXGOOOOOOOOOOOXXXXXXXXGOOOOOOOOXXXXXXXXXXXGOOXXXXXXXXXXXXXXXXXGOOOOOOOOOOXXXXXXXXXGOOOOXXXXXXXXXXXXXXXGOOOOOOOOOOOOXXXXXXXGOOOOOOOOOOOOOXXXXXXGOOOOOXXXXXXXXXXXXXX,0,0,0
34692,117,0,117,39,444,0,0,153,93,60,GOOOOOOOOOOOOXXXXXXXGOOOOOOOOXXXXXXXXXXXGOOOOOXXXXXXXXXXXXXXGOOOOOOOOXXXXXXXXXXXGOOOOOOXXXXXXXXXXXXXGOOOOOOOOOOOXXXXXXXXGOOOOOOOOXXXXXXXXXXXGOOXXXXXXXXXXXXXXXXXGOOOOOOOOOOXXXXXXXXXGOOOOXXXXXXXXXXXXXXXGOOOOOOOOOOOOXXXXXXXGOOOOOOOOOOOOOXXXXXXGOOOOOXXXXXXXXXXXXXX,0,0,0
34713,117,0,117,39,444,0,0,153,91,62,GOOOOOOOOOOOOXXXXXXXGOOOOOOOOXXXXXXXXXXXGOOOOOXXXXXXXXXXXXXXGOOOOOOOOXXXXXXXXXXXGOOOOOOXXXXXXXXXXXXXGOOOOOOOOOOOXXXXXXXXGOOOOOOOOXXXXXXXXXXXGOOXXXXXXXXXXXXXXXXXGOOOOOOOOOOXXXXXXXXXGOOOOXXXXXXXXXXXXXXXGOOOOOOOOOOOOXXXXXXXGOOOOOOOOOOOOOXXXXXXGOOOOOXXXXXXXXXXXXXX,0,0,0
34734,117,0,117,36,447,0,0,156,89,67,GOOOOOOOOOOOOXXXXXXXGOOOOOOOOXXXXXXXXXXXGOOOOOXXXXXXXXXXXXXXGOOOOOOOOXXXXXXXXXXXGOOOOOOXXXXXXXXXXXXXGOOOOOOOOOOOXXXXXXXXGOOOOOOOOXXXXXXXXXXXGOOXXXXXXXXXXXXXXXXXGOOOOOOOOOOXXXXXXXXXGOOOOXXXXXXXXXXXXXXXGOOOOOOOOOOOOXXXXXXXGOOOOOOOOOOOOOXXXXXXGOOOOOXXXXXXXXXXXXXX,0,0,0

34755,117,0,117,35,448,0,0,157,91,66,GOOOOOOOOOOOOXXXXXXXGOOOOOOOOXXXXXXXXXXXGOOOOOXXXXXXXXXXXXXXGOOOOOOOOXXXXXXXXXXXGOOOOOOXXXXXXXXXXXXXGOOOOOOOOOOOXXXXXXXXGOOOOOOOOXXXXXXXXXXXGOOXXXXXXXXXXXXXXXXXGOOOOOOOOOOXXXXXXXXXGOOOOXXXXXXXXXXXXXXXGOOOOOOOOOOOOXXXXXXXGOOOOOOOOOOOOOXXXXXXGOOOOOXXXXXXXXXXXXXX,0,0,0
34776,117,0,117,36,447,0,0,156,88,68,GOOOOOOOOOOOOXXXXXXXGOOOOOOOOXXXXXXXXXXXGOOOOOXXXXXXXXXXXXXXGOOOOOOOOXXXXXXXXXXXGOOOOOOXXXXXXXXXXXXXGOOOOOOOOOOOXXXXXXXXGOOOOOOOOXXXXXXXXXXXGOOXXXXXXXXXXXXXXXXXGOOOOOOOOOOXXXXXXXXXGOOOOXXXXXXXXXXXXXXXGOOOOOOOOOOOOXXXXXXXGOOOOOOOOOOOOOXXXXXXGOOOOOXXXXXXXXXXXXXX,0,0,0
34797,117,0,117,35,448,0,0,157,92,65,GOOOOOOOOOOOOXXXXXXXGOOOOOOOOXXXXXXXXXXXGOOOOOXXXXXXXXXXXXXXGOOOOOOOOXXXXXXXXXXXGOOOOOOXXXXXXXXXXXXXGOOOOOOOOOOOXXXXXXXXGOOOOOOOOXXXXXXXXXXXGOOXXXXXXXXXXXXXXXXXGOOOOOOOOOOXXXXXXXXXGOOOOXXXXXXXXXXXXXXXGOOOOOOOOOOOOXXXXXXXGOOOOOOOOOOOOOXXXXXXGOOOOOXXXXXXXXXXXXXX,0,0,0
34818,117,0,117,36,447,0,0,157,93,64,GOOOOOOOOOOOOXXXXXXXGOOOOOOOOXXXXXXXXXXXGOOOOOXXXXXXXXXXXXXXGOOOOOOOOXXXXXXXXXXXGOOOOOOXXXXXXXXXXXXXGOOOOOOOOOOOXXXXXXXXGOOOOOOOOXXXXXXXXXXXGOOXXXXXXXXXXXXXXXXXGOOOOOOOOOOXXXXXXXXXGOOOOXXXXXXXXXXXXXXXGOOOOOOOOOOOOXXXXXXXGOOOOOOOOOOOOOXXXXXXGOOOOOXXXXXXXXXXXXXX,0,0,0
34839,117,0,117,37,446,0,0,155,88,67,GOOOOOOOOOOOOXXXXXXXGOOOOOOOOXXXXXXXXXXXGOOOOOXXXXXXXXXXXXXXGOOOOOOOOXXXXXXXXXXXGOOOOOOXXXXXXXXXXXXXGOOOOOOOOOOOXXXXXXXXGOOOOOOOOXXXXXXXXXXXGOOXXXXXXXXXXXXXXXXXGOOOOOOOOOOXXXXXXXXXGOOOOXXXXXXXXXXXXXXXGOOOOOOOOOOOOXXXXXXXGOOOOOOOOOOOOOXXXXXXGOOOOOXXXXXXXXXXXXXX,0,0,0

34860,117,0,117,34,449,0,0,157,88,69,GOOOOOOOOOOOOXXXXXXXGOOOOOOOOXXXXXXXXXXXGOOOOOXXXXXXXXXXXXXXGOOOOOOOOXXXXXXXXXXXGOOOOOOXXXXXXXXXXXXXGOOOOOOOOOOOXXXXXXXXGOOOOOOOOXXXXXXXXXXXGOOXXXXXXXXXXXXXXXXXGOOOOOOOOOOXXXXXXXXXGOOOOXXXXXXXXXXXXXXXGOOOOOOOOOOOOXXXXXXXGOOOOOOOOOOOOOXXXXXXGOOOOOXXXXXXXXXXXXXX,0,0,0
34881,117,0,117,32,451,0,0,159,89,70,GOOOOOOOOOOOOXXXXXXXGOOOOOOOOXXXXXXXXXXXGOOOOOXXXXXXXXXXXXXXGOOOOOOOOXXXXXXXXXXXGOOOOOOXXXXXXXXXXXXXGOOOOOOOOOOOXXXXXXXXGOOOOOOOOXXXXXXXXXXXGOOXXXXXXXXXXXXXXXXXGOOOOOOOOOOXXXXXXXXXGOOOOXXXXXXXXXXXXXXXGOOOOOOOOOOOOXXXXXXXGOOOOOOOOOOOOOXXXXXXGOOOOOXXXXXXXXXXXXXX,0,0,0
34902,117,0,117,32,451,0,0,159,91,68,GOOOOOOOOOOOOXXXXXXXGOOOOOOOOXXXXXXXXXXXGOOOOOXXXXXXXXXXXXXXGOOOOOOOOXXXXXXXXXXXGOOOOOOXXXXXXXXXXXXXGOOOOOOOOOOOXXXXXXXXGOOOOOOOOXXXXXXXXXXXGOOXXXXXXXXXXXXXXXXXGOOOOOOOOOOXXXXXXXXXGOOOOXXXXXXXXXXXXXXXGOOOOOOOOOOOOXXXXXXXGOOOOOOOOOOOOOXXXXXXGOOOOOXXXXXXXXXXXXXX,0,0,0
34923,117,0,117,32,451,0,0,159,89,70,GOOOOOOOOOOOOXXXXXXXGOOOOOOOOXXXXXXXXXXXGOOOOOXXXXXXXXXXXXXXGOOOOOOOOXXXXXXXXXXXGOOOOOOXXXXXXXXXXXXXGOOOOOOOOOOOXXXXXXXXGOOOOOOOOXXXXXXXXXXXGOOXXXXXXXXXXXXXXXXXGOOOOOOOOOOXXXXXXXXXGOOOOXXXXXXXXXXXXXXXGOOOOOOOOOOOOXXXXXXXGOOOOOOOOOOOOOXXXXXXGOOOOOXXXXXXXXXXXXXX,0,0,0
34944,117,0,117,32,451,0,0,159,90,69,GOOOOOOOOOOOOXXXXXXXGOOOOOOOOXXXXXXXXXXXGOOOOOXXXXXXXXXXXXXXGOOOOOOOOXXXXXXXXXXXGOOOOOOXXXXXXXXXXXXXGOOOOOOOOOOOXXXXXXXXGOOOOOOOOXXXXXXXXXXXGOOXXXXXXXXXXXXXXXXXGOOOOOOOOOOXXXXXXXXXGOOOOXXXXXXXXXXXXXXXGOOOOOOOOOOOOXXXXXXXGOOOOOOOOOOOOOXXXXXXGOOOOOXXXXXXXXXXXXXX,0,0,0

34965,117,0,117,32,451,0,0,159,90,69,GOOOOOOOOOOOOXXXXXXXGOOOOOOOOXXXXXXXXXXXGOOOOOXXXXXXXXXXXXXXGOOOOOOOOXXXXXXXXXXXGOOOOOOXXXXXXXXXXXXXGOOOOOOOOOOOXXXXXXXXGOOOOOOOOXXXXXXXXXXXGOOXXXXXXXXXXXXXXXXXGOOOOOOOOOOXXXXXXXXXGOOOOXXXXXXXXXXXXXXXGOOOOOOOOOOOOXXXXXXXGOOOOOOOOOOOOOXXXXXXGOOOOOXXXXXXXXXXXXXX,0,0,0
34986,117,0,117,35,448,0,0,156,93,63,GOOOOOOOOOOOOXXXXXXXGOOOOOOOOXXXXXXXXXXXGOOOOOXXXXXXXXXXXXXXGOOOOOOOOXXXXXXXXXXXGOOOOOOXXXXXXXXXXXXXGOOOOOOOOOOOXXXXXXXXGOOOOOOOOXXXXXXXXXXXGOOXXXXXXXXXXXXXXXXXGOOOOOOOOOOXXXXXXXXXGOOOOXXXXXXXXXXXXXXXGOOOOOOOOOOOOXXXXXXXGOOOOOOOOOOOOOXXXXXXGOOOOOXXXXXXXXXXXXXX,0,0,0
35007,117,0,117,36,447,0,0,155,94,61,GOOOOOOOOOOOOXXXXXXXGOOOOOOOOXXXXXXXXXXXGOOOOOXXXXXXXXXXXXXXGOOOOOOOOXXXXXXXXXXXGOOOOOOXXXXXXXXXXXXXGOOOOOOOOOOOXXXXXXXXGOOOOOOOOXXXXXXXXXXXGOOXXXXXXXXXXXXXXXXXGOOOOOOOOOOXXXXXXXXXGOOOOXXXXXXXXXXXXXXXGOOOOOOOOOOOOXXXXXXXGOOOOOOOOOOOOOXXXXXXGOOOOOXXXXXXXXXXXXXX,0,0,0
35028,117,0,117,39,444,0,0,152,91,61,GOOOOOOOOOOOOXXXXXXXGOOOOOOOOXXXXXXXXXXXGOOOOOXXXXXXXXXXXXXXGOOOOOOOOXXXXXXXXXXXGOOOOOOXXXXXXXXXXXXXGOOOOOOOOOOOXXXXXXXXGOOOOOOOOXXXXXXXXXXXGOOXXXXXXXXXXXXXXXXXGOOOOOOOOOOXXXXXXXXXGOOOOXXXXXXXXXXXXXXXGOOOOOOOOOOOOXXXXXXXGOOOOOOOOOOOOOXXXXXXGOOOOOXXXXXXXXXXXXXX,0,0,0
35049,117,0,117,41,442,0,0,149,91,58,GOOOOOOOOOOOOXXXXXXXGOOOOOOOOXXXXXXXXXXXGOOOOOXXXXXXXXXXXXXXGOOOOOOOOXXXXXXXXXXXGOOOOOOXXXXXXXXXXXXXGOOOOOOOOOOOXXXXXXXXGOOOOOOOOXXXXXXXXXXXGOOXXXXXXXXXXXXXXXXXGOOOOOOOOOOXXXXXXXXXGOOOOXXXXXXXXXXXXXXXGOOOOOOOOOOOOXXXXXXXGOOOOOOOOOOOOOXXXXXXGOOOOOXXXXXXXXXXXXXX,0,0,0

35070,117,0,117,42,441,0,0,149,91,58,GOOOOOOOOOOOOXXXXXXXGOOOOOOOOXXXXXXXXXXXGOOOOOXXXXXXXXXXXXXXGOOOOOOOOXXXXXXXXXXXGOOOOOOXXXXXXXXXXXXXGOOOOOOOOOOOXXXXXXXXGOOOOOOOOXXXXXXXXXXXGOOXXXXXXXXXXXXXXXXXGOOOOOOOOOOXXXXXXXXXGOOOOXXXXXXXXXXXXXXXGOOOOOOOOOOOOXXXXXXXGOOOOOOOOOOOOOXXXXXXGOOOOOXXXXXXXXXXXXXX,0,0,0
35091,117,0,117,41,442,0,0,150,89,61,GOOOOOOOOOOOOXXXXXXXGOOOOOOOOXXXXXXXXXXXGOOOOOXXXXXXXXXXXXXXGOOOOOOOOXXXXXXXXXXXGOOOOOOXXXXXXXXXXXXXGOOOOOOOOOOOXXXXXXXXGOOOOOOOOXXXXXXXXXXXGOOXXXXXXXXXXXXXXXXXGOOOOOOOOOOXXXXXXXXXGOOOOXXXXXXXXXXXXXXXGOOOOOOOOOOOOXXXXXXXGOOOOOOOOOOOOOXXXXXXGOOOOOXXXXXXXXXXXXXX,0,0,0
35112,117,0,117,40,443,0,0,149,87,62,GOOOOOOOOOOOOXXXXXXXGOOOOOOOOXXXXXXXXXXXGOOOOOXXXXXXXXXXXXXXGOOOOOOOOXXXXXXXXXXXGOOOOOOXXXXXXXXXXXXXGOOOOOOOOOOOXXXXXXXXGOOOOOOOOXXXXXXXXXXXGOOXXXXXXXXXXXXXXXXXGOOOOOOOOOOXXXXXXXXXGOOOOXXXXXXXXXXXXXXXGOOOOOOOOOOOOXXXXXXXGOOOOOOOOOOOOOXXXXXXGOOOOOXXXXXXXXXXXXXX,0,0,0
35133,117,0,117,37,446,0,0,153,91,62,GOOOOOOOOOOOOXXXXXXXGOOOOOOOOXXXXXXXXXXXGOOOOOXXXXXXXXXXXXXXGOOOOOOOOXXXXXXXXXXXGOOOOOOXXXXXXXXXXXXXGOOOOOOOOOOOXXXXXXXXGOOOOOOOOXXXXXXXXXXXGOOXXXXXXXXXXXXXXXXXGOOOOOOOOOOXXXXXXXXXGOOOOXXXXXXXXXXXXXXXGOOOOOOOOOOOOXXXXXXXGOOOOOOOOOOOOOXXXXXXGOOOOOXXXXXXXXXXXXXX,0,0,0
35154,117,0,117,36,447,0,0,155,89,66,GOOOOOOOOOOOOXXXXXXXGOOOOOOOOXXXXXXXXXXXGOOOOOXXXXXXXXXXXXXXGOOOOOOOOXXXXXXXXXXXGOOOOOOXXXXXXXXXXXXXGOOOOOOOOOOOXXXXXXXXGOOOOOOOOXXXXXXXXXXXGOOXXXXXXXXXXXXXXXXXGOOOOOOOOOOXXXXXXXXXGOOOOXXXXXXXXXXXXXXXGOOOOOOOOOOOOXXXXXXXGOOOOOOOOOOOOOXXXXXXGOOOOOXXXXXXXXXXXXXX,0,0,0

35175,117,0,117,35,448,0,0,156,91,65,GOOOOOOOOOOOOXXXXXXXGOOOOOOOOXXXXXXXXXXXGOOOOOXXXXXXXXXXXXXXGOOOOOOOOXXXXXXXXXXXGOOOOOOXXXXXXXXXXXXXGOOOOOOOOOOOXXXXXXXXGOOOOOOOOXXXXXXXXXXXGOOXXXXXXXXXXXXXXXXXGOOOOOOOOOOXXXXXXXXXGOOOOXXXXXXXXXXXXXXXGOOOOOOOOOOOOXXXXXXXGOOOOOOOOOOOOOXXXXXXGOOOOOXXXXXXXXXXXXXX,0,0,0
35196,117,0,117,35,448,0,0,157,93,64,GOOOOOOOOOOOOXXXXXXXGOOOOOOOOXXXXXXXXXXXGOOOOOXXXXXXXXXXXXXXGOOOOOOOOXXXXXXXXXXXGOOOOOOXXXXXXXXXXXXXGOOOOOOOOOOOXXXXXXXXGOOOOOOOOXXXXXXXXXXXGOOXXXXXXXXXXXXXXXXXGOOOOOOOOOOXXXXXXXXXGOOOOXXXXXXXXXXXXXXXGOOOOOOOOOOOOXXXXXXXGOOOOOOOOOOOOOXXXXXXGOOOOOXXXXXXXXXXXXXX,0,0,0
35217,117,0,117,34,449,0,0,156,92,64,GOOOOOOOOOOOOXXXXXXXGOOOOOOOOXXXXXXXXXXXGOOOOOXXXXXXXXXXXXXXGOOOOOOOOXXXXXXXXXXXGOOOOOOXXXXXXXXXXXXXGOOOOOOOOOOOXXXXXXXXGOOOOOOOOXXXXXXXXXXXGOOXXXXXXXXXXXXXXXXXGOOOOOOOOOOXXXXXXXXXGOOOOXXXXXXXXXXXXXXXGOOOOOOOOOOOOXXXXXXXGOOOOOOOOOOOOOXXXXXXGOOOOOXXXXXXXXXXXXXX,0,0,0
35238,117,0,117,35,448,0,0,156,90,66,GOOOOOOOOOOOOXXXXXXXGOOOOOOOOXXXXXXXXXXXGOOOOOXXXXXXXXXXXXXXGOOOOOOOOXXXXXXXXXXXGOOOOOOXXXXXXXXXXXXXGOOOOOOOOOOOXXXXXXXXGOOOOOOOOXXXXXXXXXXXGOOXXXXXXXXXXXXXXXXXGOOOOOOOOOOXXXXXXXXXGOOOOXXXXXXXXXXXXXXXGOOOOOOOOOOOOXXXXXXXGOOOOOOOOOOOOOXXXXXXGOOOOOXXXXXXXXXXXXXX,0,0,0
35259,117,0,117,32,451,0,0,159,92,67,GOOOOOOOOOOOOXXXXXXXGOOOOOOOOXXXXXXXXXXXGOOOOOXXXXXXXXXXXXXXGOOOOOOOOXXXXXXXXXXXGOOOOOOXXXXXXXXXXXXXGOOOOOOOOOOOXXXXXXXXGOOOOOOOOXXXXXXXXXXXGOOXXXXXXXXXXXXXXXXXGOOOOOOOOOOXXXXXXXXXGOOOOXXXXXXXXXXXXXXXGOOOOOOOOOOOOXXXXXXXGOOOOOOOOOOOOOXXXXXXGOOOOOXXXXXXXXXXXXXX,0,0,0

35280,117,0,117,34,449,0,0,157,88,69,GOOOOOOOOOOOOXXXXXXXGOOOOOOOOXXXXXXXXXXXGOOOOOXXXXXXXXXXXXXXGOOOOOOOOXXXXXXXXXXXGOOOOOOXXXXXXXXXXXXXGOOOOOOOOOOOXXXXXXXXGOOOOOOOOXXXXXXXXXXXGOOXXXXXXXXXXXXXXXXXGOOOOOOOOOOXXXXXXXXXGOOOOXXXXXXXXXXXXXXXGOOOOOOOOOOOOXXXXXXXGOOOOOOOOOOOOOXXXXXXGOOOOOXXXXXXXXXXXXXX,0,0,0
35301,117,0,117,33,450,0,0,158,91,67,GOOOOOOOOOOOOXXXXXXXGOOOOOOOOXXXXXXXXXXXGOOOOOXXXXXXXXXXXXXXGOOOOOOOOXXXXXXXXXXXGOOOOOOXXXXXXXXXXXXXGOOOOOOOOOOOXXXXXXXXGOOOOOOOOXXXXXXXXXXXGOOXXXXXXXXXXXXXXXXXGOOOOOOOOOOXXXXXXXXXGOOOOXXXXXXXXXXXXXXXGOOOOOOOOOOOOXXXXXXXGOOOOOOOOOOOOOXXXXXXGOOOOOXXXXXXXXXXXXXX,0,0,0
35322,117,0,117,32,451,0,0,159,91,68,GOOOOOOOOOOOOXXXXXXXGOOOOOOOOXXXXXXXXXXXGOOOOOXXXXXXXXXXXXXXGOOOOOOOOXXXXXXXXXXXGOOOOOOXXXXXXXXXXXXXGOOOOOOOOOOOXXXXXXXXGOOOOOOOOXXXXXXXXXXXGOOXXXXXXXXXXXXXXXXXGOOOOOOOOOOXXXXXXXXXGOOOOXXXXXXXXXXXXXXXGOOOOOOOOOOOOXXXXXXXGOOOOOOOOOOOOOXXXXXXGOOOOOXXXXXXXXXXXXXX,0,0,0
35343,117,0,117,33,450,0,0,158,89,69,GOOOOOOOOOOOOXXXXXXXGOOOOOOOOXXXXXXXXXXXGOOOOOXXXXXXXXXXXXXXGOOOOOOOOXXXXXXXXXXXGOOOOOOXXXXXXXXXXXXXGOOOOOOOOOOOXXXXXXXXGOOOOOOOOXXXXXXXXXXXGOOXXXXXXXXXXXXXXXXXGOOOOOOOOOOXXXXXXXXXGOOOOXXXXXXXXXXXXXXXGOOOOOOOOOOOOXXXXXXXGOOOOOOOOOOOOOXXXXXXGOOOOOXXXXXXXXXXXXXX,0,0,0
35364,117,0,117,34,449,0,0,157,90,67,GOOOOOOOOOOOOXXXXXXXGOOOOOOOOXXXXXXXXXXXGOOOOOXXXXXXXXXXXXXXGOOOOOOOOXXXXXXXXXXXGOOOOOOXXXXXXXXXXXXXGOOOOOOOOOOOXXXXXXXXGOOOOOOOOXXXXXXXXXXXGOOXXXXXXXXXXXXXXXXXGOOOOOOOOOOXXXXXXXXXGOOOOXXXXXXXXXXXXXXXGOOOOOOOOOOOOXXXXXXXGOOOOOOOOOOOOOXXXXXXGOOOOOXXXXXXXXXXXXXX,0,0,0

35385,117,0,117,35,448,0,0,156,93,63,GOOOOOOOOOOOOXXXXXXXGOOOOOOOOXXXXXXXXXXXGOOOOOXXXXXXXXXXXXXXGOOOOOOOOXXXXXXXXXXXGOOOOOOXXXXXXXXXXXXXGOOOOOOOOOOOXXXXXXXXGOOOOOOOOXXXXXXXXXXXGOOXXXXXXXXXXXXXXXXXGOOOOOOOOOOXXXXXXXXXGOOOOXXXXXXXXXXXXXXXGOOOOOOOOOOOOXXXXXXXGOOOOOOOOOOOOOXXXXXXGOOOOOXXXXXXXXXXXXXX,0,0,0
35406,117,0,117,37,446,0,0,154,94,60,GOOOOOOOOOOOOXXXXXXXGOOOOOOOOXXXXXXXXXXXGOOOOOXXXXXXXXXXXXXXGOOOOOOOOXXXXXXXXXXXGOOOOOOXXXXXXXXXXXXXGOOOOOOOOOOOXXXXXXXXGOOOOOOOOXXXXXXXXXXXGOOXXXXXXXXXXXXXXXXXGOOOOOOOOOOXXXXXXXXXGOOOOXXXXXXXXXXXXXXXGOOOOOOOOOOOOXXXXXXXGOOOOOOOOOOOOOXXXXXXGOOOOOXXXXXXXXXXXXXX,0,0,0
35427,117,0,117,40,443,0,0,151,90,61,GOOOOOOOOOOOOXXXXXXXGOOOOOOOOXXXXXXXXXXXGOOOOOXXXXXXXXXXXXXXGOOOOOOOOXXXXXXXXXXXGOOOOOOXXXXXXXXXXXXXGOOOOOOOOOOOXXXXXXXXGOOOOOOOOXXXXXXXXXXXGOOXXXXXXXXXXXXXXXXXGOOOOOOOOOOXXXXXXXXXGOOOOXXXXXXXXXXXXXXXGOOOOOOOOOOOOXXXXXXXGOOOOOOOOOOOOOXXXXXXGOOOOOXXXXXXXXXXXXXX,0,0,0
35448,117,0,117,38,445,0,0,153,90,63,GOOOOOOOOOOOOXXXXXXXGOOOOOOOOXXXXXXXXXXXGOOOOOXXXXXXXXXXXXXXGOOOOOOOOXXXXXXXXXXXGOOOOOOXXXXXXXXXXXXXGOOOOOOOOOOOXXXXXXXXGOOOOOOOOXXXXXXXXXXXGOOXXXXXXXXXXXXXXXXXGOOOOOOOOOOXXXXXXXXXGOOOOXXXXXXXXXXXXXXXGOOOOOOOOOOOOXXXXXXXGOOOOOOOOOOOOOXXXXXXGOOOOOXXXXXXXXXXXXXX,0,0,0
35469,117,0,117,41,442,0,0,150,92,58,GOOOOOOOOOOOOXXXXXXXGOOOOOOOOXXXXXXXXXXXGOOOOOXXXXXXXXXXXXXXGOOOOOOOOXXXXXXXXXXXGOOOOOOXXXXXXXXXXXXXGOOOOOOOOOOOXXXXXXXXGOOOOOOOOXXXXXXXXXXXGOOXXXXXXXXXXXXXXXXXGOOOOOOOOOOXXXXXXXXXGOOOOXXXXXXXXXXXXXXXGOOOOOOOOOOOOXXXXXXXGOOOOOOOOOOOOOXXXXXXGOOOOOXXXXXXXXXXXXXX,0,0,0

35490,118,1,117,41,441,0,0,149,92,57,GOOOOOOOOOOOOXXXXXXXGOOOOOOOOXXXXXXXXXXXGOOOOOXXXXXXXXXXXXXXGOOOOOOOOXXXXXXXXXXXGOOOOOOXXXXXXXXXXXXXGOOOOOOOOOOOAXXXXXXXGOOOOOOOOXXXXXXXXXXXGOOXXXXXXXXXXXXXXXXXGOOOOOOOOOOXXXXXXXXXGOOOOXXXXXXXXXXXXXXXGOOOOOOOOOOOOXXXXXXXGOOOOOOOOOOOOOXXXXXXGOOOOOXXXXXXXXXXXXXX,0,0,0
35511,118,1,117,38,444,0,0,152,93,59,GOOOOOOOOOOOOXXXXXXXGOOOOOOOOXXXXXXXXXXXGOOOOOXXXXXXXXXXXXXXGOOOOOOOOXXXXXXXXXXXGOOOOOOXXXXXXXXXXXXXGOOOOOOOOOOOAXXXXXXXGOOOOOOOOXXXXXXXXXXXGOOXXXXXXXXXXXXXXXXXGOOOOOOOOOOXXXXXXXXXGOOOOXXXXXXXXXXXXXXXGOOOOOOOOOOOOXXXXXXXGOOOOOOOOOOOOOXXXXXXGOOOOOXXXXXXXXXXXXXX,0,0,0
35532,118,1,117,40,442,0,0,150,91,59,GOOOOOOOOOOOOXXXXXXXGOOOOOOOOXXXXXXXXXXXGOOOOOXXXXXXXXXXXXXXGOOOOOOOOXXXXXXXXXXXGOOOOOOXXXXXXXXXXXXXGOOOOOOOOOOOAXXXXXXXGOOOOOOOOXXXXXXXXXXXGOOXXXXXXXXXXXXXXXXXGOOOOOOOOOOXXXXXXXXXGOOOOXXXXXXXXXXXXXXXGOOOOOOOOOOOOXXXXXXXGOOOOOOOOOOOOOXXXXXXGOOOOOXXXXXXXXXXXXXX,0,0,0
35553,118,1,117,41,441,0,0,149,90,59,GOOOOOOOOOOOOXXXXXXXGOOOOOOOOXXXXXXXXXXXGOOOOOXXXXXXXXXXXXXXGOOOOOOOOXXXXXXXXXXXGOOOOOOXXXXXXXXXXXXXGOOOOOOOOOOOAXXXXXXXGOOOOOOOOXXXXXXXXXXXGOOXXXXXXXXXXXXXXXXXGOOOOOOOOOOXXXXXXXXXGOOOOXXXXXXXXXXXXXXXGOOOOOOOOOOOOXXXXXXXGOOOOOOOOOOOOOXXXXXXGOOOOOXXXXXXXXXXXXXX,0,0,0
35574,118,1,117,38,444,0,0,152,90,62,GOOOOOOOOOOOOXXXXXXXGOOOOOOOOXXXXXXXXXXXGOOOOOXXXXXXXXXXXXXXGOOOOOOOOXXXXXXXXXXXGOOOOOOXXXXXXXXXXXXXGOOOOOOOOOOOAXXXXXXXGOOOOOOOOXXXXXXXXXXXGOOXXXXXXXXXXXXXXXXXGOOOOOOOOOOXXXXXXXXXGOOOOXXXXXXXXXXXXXXXGOOOOOOOOOOOOXXXXXXXGOOOOOOOOOOOOOXXXXXXGOOOOOXXXXXXXXXXXXXX,0,0,0

35595,118,1,117,35,447,0,0,154,91,63,GOOOOOOOOOOOOXXXXXXXGOOOOOOOOXXXXXXXXXXXGOOOOOXXXXXXXXXXXXXXGOOOOOOOOXXXXXXXXXXXGOOOOOOXXXXXXXXXXXXXGOOOOOOOOOOOAXXXXXXXGOOOOOOOOXXXXXXXXXXXGOOXXXXXXXXXXXXXXXXXGOOOOOOOOOOXXXXXXXXXGOOOOXXXXXXXXXXXXXXXGOOOOOOOOOOOOXXXXXXXGOOOOOOOOOOOOOXXXXXXGOOOOOXXXXXXXXXXXXXX,0,0,0
35616,118,1,117,37,445,0,0,153,91,62,GOOOOOOOOOOOOXXXXXXXGOOOOOOOOXXXXXXXXXXXGOOOOOXXXXXXXXXXXXXXGOOOOOOOOXXXXXXXXXXXGOOOOOOXXXXXXXXXXXXXGOOOOOOOOOOOAXXXXXXXGOOOOOOOOXXXXXXXXXXXGOOXXXXXXXXXXXXXXXXXGOOOOOOOOOOXXXXXXXXXGOOOOXXXXXXXXXXXXXXXGOOOOOOOOOOOOXXXXXXXGOOOOOOOOOOOOOXXXXXXGOOOOOXXXXXXXXXXXXXX,0,0,0
35637,118,1,117,38,444,0,0,152,91,61,GOOOOOOOOOOOOXXXXXXXGOOOOOOOOXXXXXXXXXXXGOOOOOXXXXXXXXXXXXXXGOOOOOOOOXXXXXXXXXXXGOOOOOOXXXXXXXXXXXXXGOOOOOOOOOOOAXXXXXXXGOOOOOOOOXXXXXXXXXXXGOOXXXXXXXXXXXXXXXXXGOOOOOOOOOOXXXXXXXXXGOOOOXXXXXXXXXXXXXXXGOOOOOOOOOOOOXXXXXXXGOOOOOOOOOOOOOXXXXXXGOOOOOXXXXXXXXXXXXXX,0,0,0
35658,118,1,117,36,446,0,0,154,92,62,GOOOOOOOOOOOOXXXXXXXGOOOOOOOOXXXXXXXXXXXGOOOOOXXXXXXXXXXXXXXGOOOOOOOOXXXXXXXXXXXGOOOOOOXXXXXXXXXXXXXGOOOOOOOOOOOAXXXXXXXGOOOOOOOOXXXXXXXXXXXGOOXXXXXXXXXXXXXXXXXGOOOOOOOOOOXXXXXXXXXGOOOOXXXXXXXXXXXXXXXGOOOOOOOOOOOOXXXXXXXGOOOOOOOOOOOOOXXXXXXGOOOOOXXXXXXXXXXXXXX,0,0,0
35679,118,1,117,36,446,0,0,154,89,65,GOOOOOOOOOOOOXXXXXXXGOOOOOOOOXXXXXXXXXXXGOOOOOXXXXXXXXXXXXXXGOOOOOOOOXXXXXXXXXXXGOOOOOOXXXXXXXXXXXXXGOOOOOOOOOOOAXXXXXXXGOOOOOOOOXXXXXXXXXXXGOOXXXXXXXXXXXXXXXXXGOOOOOOOOOOXXXXXXXXXGOOOOXXXXXXXXXXXXXXXGOOOOOOOOOOOOXXXXXXXGOOOOOOOOOOOOOXXXXXXGOOOOOXXXXXXXXXXXXXX,0,0,0

35700,118,1,117,34,448,0,0,154,91,63,GOOOOOOOOOOOOXXXXXXXGOOOOOOOOXXXXXXXXXXXGOOOOOXXXXXXXXXXXXXXGOOOOOOOOXXXXXXXXXXXGOOOOOOXXXXXXXXXXXXXGOOOOOOOOOOOAXXXXXXXGOOOOOOOOXXXXXXXXXXXGOOXXXXXXXXXXXXXXXXXGOOOOOOOOOOXXXXXXXXXGOOOOXXXXXXXXXXXXXXXGOOOOOOOOOOOOXXXXXXXGOOOOOOOOOOOOOXXXXXXGOOOOOXXXXXXXXXXXXXX,0,0,0
35721,118,1,117,33,449,0,0,157,91,66,GOOOOOOOOOOOOXXXXXXXGOOOOOOOOXXXXXXXXXXXGOOOOOXXXXXXXXXXXXXXGOOOOOOOOXXXXXXXXXXXGOOOOOOXXXXXXXXXXXXXGOOOOOOOOOOOAXXXXXXXGOOOOOOOOXXXXXXXXXXXGOOXXXXXXXXXXXXXXXXXGOOOOOOOOOOXXXXXXXXXGOOOOXXXXXXXXXXXXXXXGOOOOOOOOOOOOXXXXXXXGOOOOOOOOOOOOOXXXXXXGOOOOOXXXXXXXXXXXXXX,0,0,0
35742,118,1,117,36,446,0,0,155,91,64,GOOOOOOOOOOOOXXXXXXXGOOOOOOOOXXXXXXXXXXXGOOOOOXXXXXXXXXXXXXXGOOOOOOOOXXXXXXXXXXXGOOOOOOXXXXXXXXXXXXXGOOOOOOOOOOOAXXXXXXXGOOOOOOOOXXXXXXXXXXXGOOXXXXXXXXXXXXXXXXXGOOOOOOOOOOXXXXXXXXXGOOOOXXXXXXXXXXXXXXXGOOOOOOOOOOOOXXXXXXXGOOOOOOOOOOOOOXXXXXXGOOOOOXXXXXXXXXXXXXX,0,0,0
35763,118,0,118,34,448,0,0,157,91,66,GOOOOOOOOOOOOXXXXXXXGOOOOOOOOXXXXXXXXXXXGOOOOOXXXXXXXXXXXXXXGOOOOOOOOXXXXXXXXXXXGOOOOOOXXXXXXXXXXXXXGOOOOOOOOOOOOXXXXXXXGOOOOOOOOXXXXXXXXXXXGOOXXXXXXXXXXXXXXXXXGOOOOOOOOOOXXXXXXXXXGOOOOXXXXXXXXXXXXXXXGOOOOOOOOOOOOXXXXXXXGOOOOOOOOOOOOOXXXXXXGOOOOOXXXXXXXXXXXXXX,0,0,0
35784,118,0,118,33,449,0,0,158,91,67,GOOOOOOOOOOOOXXXXXXXGOOOOOOOOXXXXXXXXXXXGOOOOOXXXXXXXXXXXXXXGOOOOOOOOXXXXXXXXXXXGOOOOOOXXXXXXXXXXXXXGOOOOOOOOOOOOXXXXXXXGOOOOOOOOXXXXXXXXXXXGOOXXXXXXXXXXXXXXXXXGOOOOOOOOOOXXXXXXXXXGOOOOXXXXXXXXXXXXXXXGOOOOOOOOOOOOXXXXXXXGOOOOOOOOOOOOOXXXXXXGOOOOOXXXXXXXXXXXXXX,0,0,0

35805,118,0,118,32,450,0,0,160,91,69,GOOOOOOOOOOOOXXXXXXXGOOOOOOOOXXXXXXXXXXXGOOOOOXXXXXXXXXXXXXXGOOOOOOOOXXXXXXXXXXXGOOOOOOXXXXXXXXXXXXXGOOOOOOOOOOOOXXXXXXXGOOOOOOOOXXXXXXXXXXXGOOXXXXXXXXXXXXXXXXXGOOOOOOOOOOXXXXXXXXXGOOOOXXXXXXXXXXXXXXXGOOOOOOOOOOOOXXXXXXXGOOOOOOOOOOOOOXXXXXXGOOOOOXXXXXXXXXXXXXX,0,0,0
35826,118,0,118,33,449,0,0,160,91,69,GOOOOOOOOOOOOXXXXXXXGOOOOOOOOXXXXXXXXXXXGOOOOOXXXXXXXXXXXXXXGOOOOOOOOXXXXXXXXXXXGOOOOOOXXXXXXXXXXXXXGOOOOOOOOOOOOXXXXXXXGOOOOOOOOXXXXXXXXXXXGOOXXXXXXXXXXXXXXXXXGOOOOOOOOOOXXXXXXXXXGOOOOXXXXXXXXXXXXXXXGOOOOOOOOOOOOXXXXXXXGOOOOOOOOOOOOOXXXXXXGOOOOOXXXXXXXXXXXXXX,0,0,0
35847,118,0,118,32,450,0,0,160,91,69,GOOOOOOOOOOOOXXXXXXXGOOOOOOOOXXXXXXXXXXXGOOOOOXXXXXXXXXXXXXXGOOOOOOOOXXXXXXXXXXXGOOOOOOXXXXXXXXXXXXXGOOOOOOOOOOOOXXXXXXXGOOOOOOOOXXXXXXXXXXXGOOXXXXXXXXXXXXXXXXXGOOOOOOOOOOXXXXXXXXXGOOOOXXXXXXXXXXXXXXXGOOOOOOOOOOOOXXXXXXXGOOOOOOOOOOOOOXXXXXXGOOOOOXXXXXXXXXXXXXX,0,0,0
35868,118,0,118,30,452,0,0,163,91,72,GOOOOOOOOOOOOXXXXXXXGOOOOOOOOXXXXXXXXXXXGOOOOOXXXXXXXXXXXXXXGOOOOOOOOXXXXXXXXXXXGOOOOOOXXXXXXXXXXXXXGOOOOOOOOOOOOXXXXXXXGOOOOOOOOXXXXXXXXXXXGOOXXXXXXXXXXXXXXXXXGOOOOOOOOOOXXXXXXXXXGOOOOXXXXXXXXXXXXXXXGOOOOOOOOOOOOXXXXXXXGOOOOOOOOOOOOOXXXXXXGOOOOOXXXXXXXXXXXXXX,0,0,0
35889,118,0,118,31,451,0,0,161,88,73,GOOOOOOOOOOOOXXXXXXXGOOOOOOOOXXXXXXXXXXXGOOOOOXXXXXXXXXXXXXXGOOOOOOOOXXXXXXXXXXXGOOOOOOXXXXXXXXXXXXXGOOOOOOOOOOOOXXXXXXXGOOOOOOOOXXXXXXXXXXXGOOXXXXXXXXXXXXXXXXXGOOOOOOOOOOXXXXXXXXXGOOOOXXXXXXXXXXXXXXXGOOOOOOOOOOOOXXXXXXXGOOOOOOOOOOOOOXXXXXXGOOOOOXXXXXXXXXXXXXX,0,0,0

35910,118,0,118,31,451,0,0,161,92,69,GOOOOOOOOOOOOXXXXXXXGOOOOOOOOXXXXXXXXXXXGOOOOOXXXXXXXXXXXXXXGOOOOOOOOXXXXXXXXXXXGOOOOOOXXXXXXXXXXXXXGOOOOOOOOOOOOXXXXXXXGOOOOOOOOXXXXXXXXXXXGOOXXXXXXXXXXXXXXXXXGOOOOOOOOOOXXXXXXXXXGOOOOXXXXXXXXXXXXXXXGOOOOOOOOOOOOXXXXXXXGOOOOOOOOOOOOOXXXXXXGOOOOOXXXXXXXXXXXXXX,0,0,0
35931,118,0,118,34,448,0,0,157,90,67,GOOOOOOOOOOOOXXXXXXXGOOOOOOOOXXXXXXXXXXXGOOOOOXXXXXXXXXXXXXXGOOOOOOOOXXXXXXXXXXXGOOOOOOXXXXXXXXXXXXXGOOOOOOOOOOOOXXXXXXXGOOOOOOOOXXXXXXXXXXXGOOXXXXXXXXXXXXXXXXXGOOOOOOOOOOXXXXXXXXXGOOOOXXXXXXXXXXXXXXXGOOOOOOOOOOOOXXXXXXXGOOOOOOOOOOOOOXXXXXXGOOOOOXXXXXXXXXXXXXX,0,0,0
35952,118,0,118,34,448,0,0,157,91,66,GOOOOOOOOOOOOXXXXXXXGOOOOOOOOXXXXXXXXXXXGOOOOOXXXXXXXXXXXXXXGOOOOOOOOXXXXXXXXXXXGOOOOOOXXXXXXXXXXXXXGOOOOOOOOOOOOXXXXXXXGOOOOOOOOXXXXXXXXXXXGOOXXXXXXXXXXXXXXXXXGOOOOOOOOOOXXXXXXXXXGOOOOXXXXXXXXXXXXXXXGOOOOOOOOOOOOXXXXXXXGOOOOOOOOOOOOOXXXXXXGOOOOOXXXXXXXXXXXXXX,0,0,0
35973,118,0,118,35,447,0,0,156,92,64,GOOOOOOOOOOOOXXXXXXXGOOOOOOOOXXXXXXXXXXXGOOOOOXXXXXXXXXXXXXXGOOOOOOOOXXXXXXXXXXXGOOOOOOXXXXXXXXXXXXXGOOOOOOOOOOOOXXXXXXXGOOOOOOOOXXXXXXXXXXXGOOXXXXXXXXXXXXXXXXXGOOOOOOOOOOXXXXXXXXXGOOOOXXXXXXXXXXXXXXXGOOOOOOOOOOOOXXXXXXXGOOOOOOOOOOOOOXXXXXXGOOOOOXXXXXXXXXXXXXX,0,0,0
35994,118,0,118,34,448,0,0,157,92,65,GOOOOOOOOOOOOXXXXXXXGOOOOOOOOXXXXXXXXXXXGOOOOOXXXXXXXXXXXXXXGOOOOOOOOXXXXXXXXXXXGOOOOOOXXXXXXXXXXXXXGOOOOOOOOOOOOXXXXXXXGOOOOOOOOXXXXXXXXXXXGOOXXXXXXXXXXXXXXXXXGOOOOOOOOOOXXXXXXXXXGOOOOXXXXXXXXXXXXXXXGOOOOOOOOOOOOXXXXXXXGOOOOOOOOOOOOOXXXXXXGOOOOOXXXXXXXXXXXXXX,0,0,0

36015,118,0,118,37,445,0,0,154,93,61,GOOOOOOOOOOOOXXXXXXXGOOOOOOOOXXXXXXXXXXXGOOOOOXXXXXXXXXXXXXXGOOOOOOOOXXXXXXXXXXXGOOOOOOXXXXXXXXXXXXXGOOOOOOOOOOOOXXXXXXXGOOOOOOOOXXXXXXXXXXXGOOXXXXXXXXXXXXXXXXXGOOOOOOOOOOXXXXXXXXXGOOOOXXXXXXXXXXXXXXXGOOOOOOOOOOOOXXXXXXXGOOOOOOOOOOOOOXXXXXXGOOOOOXXXXXXXXXXXXXX,0,0,0
36036,118,0,118,41,441,0,0,151,92,59,GOOOOOOOOOOOOXXXXXXXGOOOOOOOOXXXXXXXXXXXGOOOOOXXXXXXXXXXXXXXGOOOOOOOOXXXXXXXXXXXGOOOOOOXXXXXXXXXXXXXGOOOOOOOOOOOOXXXXXXXGOOOOOOOOXXXXXXXXXXXGOOXXXXXXXXXXXXXXXXXGOOOOOOOOOOXXXXXXXXXGOOOOXXXXXXXXXXXXXXXGOOOOOOOOOOOOXXXXXXXGOOOOOOOOOOOOOXXXXXXGOOOOOXXXXXXXXXXXXXX,0,0,0
36057,118,0,118,44,438,0,0,149,90,59,GOOOOOOOOOOOOXXXXXXXGOOOOOOOOXXXXXXXXXXXGOOOOOXXXXXXXXXXXXXXGOOOOOOOOXXXXXXXXXXXGOOOOOOXXXXXXXXXXXXXGOOOOOOOOOOOOXXXXXXXGOOOOOOOOXXXXXXXXXXXGOOXXXXXXXXXXXXXXXXXGOOOOOOOOOOXXXXXXXXXGOOOOXXXXXXXXXXXXXXXGOOOOOOOOOOOOXXXXXXXGOOOOOOOOOOOOOXXXXXXGOOOOOXXXXXXXXXXXXXX,0,0,0
36078,118,0,118,45,437,0,0,148,92,56,GOOOOOOOOOOOOXXXXXXXGOOOOOOOOXXXXXXXXXXXGOOOOOXXXXXXXXXXXXXXGOOOOOOOOXXXXXXXXXXXGOOOOOOXXXXXXXXXXXXXGOOOOOOOOOOOOXXXXXXXGOOOOOOOOXXXXXXXXXXXGOOXXXXXXXXXXXXXXXXXGOOOOOOOOOOXXXXXXXXXGOOOOXXXXXXXXXXXXXXXGOOOOOOOOOOOOXXXXXXXGOOOOOOOOOOOOOXXXXXXGOOOOOXXXXXXXXXXXXXX,0,0,0
36099,118,0,118,45,437,0,0,147,88,59,GOOOOOOOOOOOOXXXXXXXGOOOOOOOOXXXXXXXXXXXGOOOOOXXXXXXXXXXXXXXGOOOOOOOOXXXXXXXXXXXGOOOOOOXXXXXXXXXXXXXGOOOOOOOOOOOOXXXXXXXGOOOOOOOOXXXXXXXXXXXGOOXXXXXXXXXXXXXXXXXGOOOOOOOOOOXXXXXXXXXGOOOOXXXXXXXXXXXXXXXGOOOOOOOOOOOOXXXXXXXGOOOOOOOOOOOOOXXXXXXGOOOOOXXXXXXXXXXXXXX,0,0,0

36120,118,0,118,43,439,0,0,149,89,60,GOOOOOOOOOOOOXXXXXXXGOOOOOOOOXXXXXXXXXXXGOOOOOXXXXXXXXXXXXXXGOOOOOOOOXXXXXXXXXXXGOOOOOOXXXXXXXXXXXXXGOOOOOOOOOOOOXXXXXXXGOOOOOOOOXXXXXXXXXXXGOOXXXXXXXXXXXXXXXXXGOOOOOOOOOOXXXXXXXXXGOOOOXXXXXXXXXXXXXXXGOOOOOOOOOOOOXXXXXXXGOOOOOOOOOOOOOXXXXXXGOOOOOXXXXXXXXXXXXXX,0,0,0
36141,118,0,118,43,439,0,0,149,88,61,GOOOOOOOOOOOOXXXXXXXGOOOOOOOOXXXXXXXXXXXGOOOOOXXXXXXXXXXXXXXGOOOOOOOOXXXXXXXXXXXGOOOOOOXXXXXXXXXXXXXGOOOOOOOOOOOOXXXXXXXGOOOOOOOOXXXXXXXXXXXGOOXXXXXXXXXXXXXXXXXGOOOOOOOOOOXXXXXXXXXGOOOOXXXXXXXXXXXXXXXGOOOOOOOOOOOOXXXXXXXGOOOOOOOOOOOOOXXXXXXGOOOOOXXXXXXXXXXXXXX,0,0,0
36162,118,0,118,39,443,0,0,152,88,64,GOOOOOOOOOOOOXXXXXXXGOOOOOOOOXXXXXXXXXXXGOOOOOXXXXXXXXXXXXXXGOOOOOOOOXXXXXXXXXXXGOOOOOOXXXXXXXXXXXXXGOOOOOOOOOOOOXXXXXXXGOOOOOOOOXXXXXXXXXXXGOOXXXXXXXXXXXXXXXXXGOOOOOOOOOOXXXXXXXXXGOOOOXXXXXXXXXXXXXXXGOOOOOOOOOOOOXXXXXXXGOOOOOOOOOOOOOXXXXXXGOOOOOXXXXXXXXXXXXXX,0,0,0
36183,118,0,118,36,446,0,0,155,91,64,GOOOOOOOOOOOOXXXXXXXGOOOOOOOOXXXXXXXXXXXGOOOOOXXXXXXXXXXXXXXGOOOOOOOOXXXXXXXXXXXGOOOOOOXXXXXXXXXXXXXGOOOOOOOOOOOOXXXXXXXGOOOOOOOOXXXXXXXXXXXGOOXXXXXXXXXXXXXXXXXGOOOOOOOOOOXXXXXXXXXGOOOOXXXXXXXXXXXXXXXGOOOOOOOOOOOOXXXXXXXGOOOOOOOOOOOOOXXXXXXGOOOOOXXXXXXXXXXXXXX,0,0,0
36204,118,0,118,35,447,0,0,156,89,67,GOOOOOOOOOOOOXXXXXXXGOOOOOOOOXXXXXXXXXXXGOOOOOXXXXXXXXXXXXXXGOOOOOOOOXXXXXXXXXXXGOOOOOOXXXXXXXXXXXXXGOOOOOOOOOOOOXXXXXXXGOOOOOOOOXXXXXXXXXXXGOOXXXXXXXXXXXXXXXXXGOOOOOOOOOOXXXXXXXXXGOOOOXXXXXXXXXXXXXXXGOOOOOOOOOOOOXXXXXXXGOOOOOOOOOOOOOXXXXXXGOOOOOXXXXXXXXXXXXXX,0,0,0

36225,118,0,118,32,450,0,0,158,90,68,GOOOOOOOOOOOOXXXXXXXGOOOOOOOOXXXXXXXXXXXGOOOOOXXXXXXXXXXXXXXGOOOOOOOOXXXXXXXXXXXGOOOOOOXXXXXXXXXXXXXGOOOOOOOOOOOOXXXXXXXGOOOOOOOOXXXXXXXXXXXGOOXXXXXXXXXXXXXXXXXGOOOOOOOOOOXXXXXXXXXGOOOOXXXXXXXXXXXXXXXGOOOOOOOOOOOOXXXXXXXGOOOOOOOOOOOOOXXXXXXGOOOOOXXXXXXXXXXXXXX,0,0,0
36246,118,0,118,34,448,0,0,158,94,64,GOOOOOOOOOOOOXXXXXXXGOOOOOOOOXXXXXXXXXXXGOOOOOXXXXXXXXXXXXXXGOOOOOOOOXXXXXXXXXXXGOOOOOOXXXXXXXXXXXXXGOOOOOOOOOOOOXXXXXXXGOOOOOOOOXXXXXXXXXXXGOOXXXXXXXXXXXXXXXXXGOOOOOOOOOOXXXXXXXXXGOOOOXXXXXXXXXXXXXXXGOOOOOOOOOOOOXXXXXXXGOOOOOOOOOOOOOXXXXXXGOOOOOXXXXXXXXXXXXXX,0,0,0
36267,118,0,118,35,447,0,0,156,91,65,GOOOOOOOOOOOOXXXXXXXGOOOOOOOOXXXXXXXXXXXGOOOOOXXXXXXXXXXXXXXGOOOOOOOOXXXXXXXXXXXGOOOOOOXXXXXXXXXXXXXGOOOOOOOOOOOOXXXXXXXGOOOOOOOOXXXXXXXXXXXGOOXXXXXXXXXXXXXXXXXGOOOOOOOOOOXXXXXXXXXGOOOOXXXXXXXXXXXXXXXGOOOOOOOOOOOOXXXXXXXGOOOOOOOOOOOOOXXXXXXGOOOOOXXXXXXXXXXXXXX,0,0,0
36288,118,0,118,36,446,0,0,157,89,68,GOOOOOOOOOOOOXXXXXXXGOOOOOOOOXXXXXXXXXXXGOOOOOXXXXXXXXXXXXXXGOOOOOOOOXXXXXXXXXXXGOOOOOOXXXXXXXXXXXXXGOOOOOOOOOOOOXXXXXXXGOOOOOOOOXXXXXXXXXXXGOOXXXXXXXXXXXXXXXXXGOOOOOOOOOOXXXXXXXXXGOOOOXXXXXXXXXXXXXXXGOOOOOOOOOOOOXXXXXXXGOOOOOOOOOOOOOXXXXXXGOOOOOXXXXXXXXXXXXXX,0,0,0
36309,118,0,118,35,447,0,0,157,90,67,GOOOOOOOOOOOOXXXXXXXGOOOOOOOOXXXXXXXXXXXGOOOOOXXXXXXXXXXXXXXGOOOOOOOOXXXXXXXXXXXGOOOOOOXXXXXXXXXXXXXGOOOOOOOOOOOOXXXXXXXGOOOOOOOOXXXXXXXXXXXGOOXXXXXXXXXXXXXXXXXGOOOOOOOOOOXXXXXXXXXGOOOOXXXXXXXXXXXXXXXGOOOOOOOOOOOOXXXXXXXGOOOOOOOOOOOOOXXXXXXGOOOOOXXXXXXXXXXXXXX,0,0,0

36330,118,0,118,34,448,0,0,158,89,69,GOOOOOOOOOOOOXXXXXXXGOOOOOOOOXXXXXXXXXXXGOOOOOXXXXXXXXXXXXXXGOOOOOOOOXXXXXXXXXXXGOOOOOOXXXXXXXXXXXXXGOOOOOOOOOOOOXXXXXXXGOOOOOOOOXXXXXXXXXXXGOOXXXXXXXXXXXXXXXXXGOOOOOOOOOOXXXXXXXXXGOOOOXXXXXXXXXXXXXXXGOOOOOOOOOOOOXXXXXXXGOOOOOOOOOOOOOXXXXXXGOOOOOXXXXXXXXXXXXXX,0,0,0
36351,118,0,118,36,446,0,0,156,91,65,GOOOOOOOOOOOOXXXXXXXGOOOOOOOOXXXXXXXXXXXGOOOOOXXXXXXXXXXXXXXGOOOOOOOOXXXXXXXXXXXGOOOOOOXXXXXXXXXXXXXGOOOOOOOOOOOOXXXXXXXGOOOOOOOOXXXXXXXXXXXGOOXXXXXXXXXXXXXXXXXGOOOOOOOOOOXXXXXXXXXGOOOOXXXXXXXXXXXXXXXGOOOOOOOOOOOOXXXXXXXGOOOOOOOOOOOOOXXXXXXGOOOOOXXXXXXXXXXXXXX,0,0,0
36372,118,0,118,38,444,0,0,154,90,64,GOOOOOOOOOOOOXXXXXXXGOOOOOOOOXXXXXXXXXXXGOOOOOXXXXXXXXXXXXXXGOOOOOOOOXXXXXXXXXXXGOOOOOOXXXXXXXXXXXXXGOOOOOOOOOOOOXXXXXXXGOOOOOOOOXXXXXXXXXXXGOOXXXXXXXXXXXXXXXXXGOOOOOOOOOOXXXXXXXXXGOOOOXXXXXXXXXXXXXXXGOOOOOOOOOOOOXXXXXXXGOOOOOOOOOOOOOXXXXXXGOOOOOXXXXXXXXXXXXXX,0,0,0
36393,118,0,118,37,445,0,0,155,94,61,GOOOOOOOOOOOOXXXXXXXGOOOOOOOOXXXXXXXXXXXGOOOOOXXXXXXXXXXXXXXGOOOOOOOOXXXXXXXXXXXGOOOOOOXXXXXXXXXXXXXGOOOOOOOOOOOOXXXXXXXGOOOOOOOOXXXXXXXXXXXGOOXXXXXXXXXXXXXXXXXGOOOOOOOOOOXXXXXXXXXGOOOOXXXXXXXXXXXXXXXGOOOOOOOOOOOOXXXXXXXGOOOOOOOOOOOOOXXXXXXGOOOOOXXXXXXXXXXXXXX,0,0,0
36414,118,0,118,40,442,0,0,152,89,63,GOOOOOOOOOOOOXXXXXXXGOOOOOOOOXXXXXXXXXXXGOOOOOXXXXXXXXXXXXXXGOOOOOOOOXXXXXXXXXXXGOOOOOOXXXXXXXXXXXXXGOOOOOOOOOOOOXXXXXXXGOOOOOOOOXXXXXXXXXXXGOOXXXXXXXXXXXXXXXXXGOOOOOOOOOOXXXXXXXXXGOOOOXXXXXXXXXXXXXXXGOOOOOOOOOOOOXXXXXXXGOOOOOOOOOOOOOXXXXXXGOOOOOXXXXXXXXXXXXXX,0,0,0

36435,118,0,118,35,447,0,0,157,92,65,GOOOOOOOOOOOOXXXXXXXGOOOOOOOOXXXXXXXXXXXGOOOOOXXXXXXXXXXXXXXGOOOOOOOOXXXXXXXXXXXGOOOOOOXXXXXXXXXXXXXGOOOOOOOOOOOOXXXXXXXGOOOOOOOOXXXXXXXXXXXGOOXXXXXXXXXXXXXXXXXGOOOOOOOOOOXXXXXXXXXGOOOOXXXXXXXXXXXXXXXGOOOOOOOOOOOOXXXXXXXGOOOOOOOOOOOOOXXXXXXGOOOOOXXXXXXXXXXXXXX,0,0,0
36456,118,0,118,41,441,0,0,150,94,56,GOOOOOOOOOOOOXXXXXXXGOOOOOOOOXXXXXXXXXXXGOOOOOXXXXXXXXXXXXXXGOOOOOOOOXXXXXXXXXXXGOOOOOOXXXXXXXXXXXXXGOOOOOOOOOOOOXXXXXXXGOOOOOOOOXXXXXXXXXXXGOOXXXXXXXXXXXXXXXXXGOOOOOOOOOOXXXXXXXXXGOOOOXXXXXXXXXXXXXXXGOOOOOOOOOOOOXXXXXXXGOOOOOOOOOOOOOXXXXXXGOOOOOXXXXXXXXXXXXXX,0,0,0
36477,118,0,118,42,440,0,0,148,92,56,GOOOOOOOOOOOOXXXXXXXGOOOOOOOOXXXXXXXXXXXGOOOOOXXXXXXXXXXXXXXGOOOOOOOOXXXXXXXXXXXGOOOOOOXXXXXXXXXXXXXGOOOOOOOOOOOOXXXXXXXGOOOOOOOOXXXXXXXXXXXGOOXXXXXXXXXXXXXXXXXGOOOOOOOOOOXXXXXXXXXGOOOOXXXXXXXXXXXXXXXGOOOOOOOOOOOOXXXXXXXGOOOOOOOOOOOOOXXXXXXGOOOOOXXXXXXXXXXXXXX,0,0,0
36498,118,0,118,40,442,0,0,151,90,61,GOOOOOOOOOOOOXXXXXXXGOOOOOOOOXXXXXXXXXXXGOOOOOXXXXXXXXXXXXXXGOOOOOOOOXXXXXXXXXXXGOOOOOOXXXXXXXXXXXXXGOOOOOOOOOOOOXXXXXXXGOOOOOOOOXXXXXXXXXXXGOOXXXXXXXXXXXXXXXXXGOOOOOOOOOOXXXXXXXXXGOOOOXXXXXXXXXXXXXXXGOOOOOOOOOOOOXXXXXXXGOOOOOOOOOOOOOXXXXXXGOOOOOXXXXXXXXXXXXXX,0,0,0
36519,118,0,118,37,445,0,0,154,91,63,GOOOOOOOOOOOOXXXXXXXGOOOOOOOOXXXXXXXXXXXGOOOOOXXXXXXXXXXXXXXGOOOOOOOOXXXXXXXXXXXGOOOOOOXXXXXXXXXXXXXGOOOOOOOOOOOOXXXXXXXGOOOOOOOOXXXXXXXXXXXGOOXXXXXXXXXXXXXXXXXGOOOOOOOOOOXXXXXXXXXGOOOOXXXXXXXXXXXXXXXGOOOOOOOOOOOOXXXXXXXGOOOOOOOOOOOOOXXXXXXGOOOOOXXXXXXXXXXXXXX,0,0,0

36540,118,0,118,34,448,0,0,157,94,63,GOOOOOOOOOOOOXXXXXXXGOOOOOOOOXXXXXXXXXXXGOOOOOXXXXXXXXXXXXXXGOOOOOOOOXXXXXXXXXXXGOOOOOOXXXXXXXXXXXXXGOOOOOOOOOOOOXXXXXXXGOOOOOOOOXXXXXXXXXXXGOOXXXXXXXXXXXXXXXXXGOOOOOOOOOOXXXXXXXXXGOOOOXXXXXXXXXXXXXXXGOOOOOOOOOOOOXXXXXXXGOOOOOOOOOOOOOXXXXXXGOOOOOXXXXXXXXXXXXXX,0,0,0
36561,118,0,118,35,447,0,0,156,90,66,GOOOOOOOOOOOOXXXXXXXGOOOOOOOOXXXXXXXXXXXGOOOOOXXXXXXXXXXXXXXGOOOOOOOOXXXXXXXXXXXGOOOOOOXXXXXXXXXXXXXGOOOOOOOOOOOOXXXXXXXGOOOOOOOOXXXXXXXXXXXGOOXXXXXXXXXXXXXXXXXGOOOOOOOOOOXXXXXXXXXGOOOOXXXXXXXXXXXXXXXGOOOOOOOOOOOOXXXXXXXGOOOOOOOOOOOOOXXXXXXGOOOOOXXXXXXXXXXXXXX,0,0,0
36582,118,0,118,36,446,0,0,155,89,66,GOOOOOOOOOOOOXXXXXXXGOOOOOOOOXXXXXXXXXXXGOOOOOXXXXXXXXXXXXXXGOOOOOOOOXXXXXXXXXXXGOOOOOOXXXXXXXXXXXXXGOOOOOOOOOOOOXXXXXXXGOOOOOOOOXXXXXXXXXXXGOOXXXXXXXXXXXXXXXXXGOOOOOOOOOOXXXXXXXXXGOOOOXXXXXXXXXXXXXXXGOOOOOOOOOOOOXXXXXXXGOOOOOOOOOOOOOXXXXXXGOOOOOXXXXXXXXXXXXXX,0,0,0
36603,118,0,118,35,447,0,0,157,89,68,GOOOOOOOOOOOOXXXXXXXGOOOOOOOOXXXXXXXXXXXGOOOOOXXXXXXXXXXXXXXGOOOOOOOOXXXXXXXXXXXGOOOOOOXXXXXXXXXXXXXGOOOOOOOOOOOOXXXXXXXGOOOOOOOOXXXXXXXXXXXGOOXXXXXXXXXXXXXXXXXGOOOOOOOOOOXXXXXXXXXGOOOOXXXXXXXXXXXXXXXGOOOOOOOOOOOOXXXXXXXGOOOOOOOOOOOOOXXXXXXGOOOOOXXXXXXXXXXXXXX,0,0,0
36624,118,0,118,36,446,0,0,155,92,63,GOOOOOOOOOOOOXXXXXXXGOOOOOOOOXXXXXXXXXXXGOOOOOXXXXXXXXXXXXXXGOOOOOOOOXXXXXXXXXXXGOOOOOOXXXXXXXXXXXXXGOOOOOOOOOOOOXXXXXXXGOOOOOOOOXXXXXXXXXXXGOOXXXXXXXXXXXXXXXXXGOOOOOOOOOOXXXXXXXXXGOOOOXXXXXXXXXXXXXXXGOOOOOOOOOOOOXXXXXXXGOOOOOOOOOOOOOXXXXXXGOOOOOXXXXXXXXXXXXXX,0,0,0

36645,118,0,118,34,448,0,0,158,92,66,GOOOOOOOOOOOOXXXXXXXGOOOOOOOOXXXXXXXXXXXGOOOOOXXXXXXXXXXXXXXGOOOOOOOOXXXXXXXXXXXGOOOOOOXXXXXXXXXXXXXGOOOOOOOOOOOOXXXXXXXGOOOOOOOOXXXXXXXXXXXGOOXXXXXXXXXXXXXXXXXGOOOOOOOOOOXXXXXXXXXGOOOOXXXXXXXXXXXXXXXGOOOOOOOOOOOOXXXXXXXGOOOOOOOOOOOOOXXXXXXGOOOOOXXXXXXXXXXXXXX,0,0,0
36666,118,0,118,32,450,0,0,159,91,68,GOOOOOOOOOOOOXXXXXXXGOOOOOOOOXXXXXXXXXXXGOOOOOXXXXXXXXXXXXXXGOOOOOOOOXXXXXXXXXXXGOOOOOOXXXXXXXXXXXXXGOOOOOOOOOOOOXXXXXXXGOOOOOOOOXXXXXXXXXXXGOOXXXXXXXXXXXXXXXXXGOOOOOOOOOOXXXXXXXXXGOOOOXXXXXXXXXXXXXXXGOOOOOOOOOOOOXXXXXXXGOOOOOOOOOOOOOXXXXXXGOOOOOXXXXXXXXXXXXXX,0,0,0
36687,118,0,118,36,446,0,0,155,89,66,GOOOOOOOOOOOOXXXXXXXGOOOOOOOOXXXXXXXXXXXGOOOOOXXXXXXXXXXXXXXGOOOOOOOOXXXXXXXXXXXGOOOOOOXXXXXXXXXXXXXGOOOOOOOOOOOOXXXXXXXGOOOOOOOOXXXXXXXXXXXGOOXXXXXXXXXXXXXXXXXGOOOOOOOOOOXXXXXXXXXGOOOOXXXXXXXXXXXXXXXGOOOOOOOOOOOOXXXXXXXGOOOOOOOOOOOOOXXXXXXGOOOOOXXXXXXXXXXXXXX,0,0,0
36708,118,0,118,32,450,0,0,159,91,68,GOOOOOOOOOOOOXXXXXXXGOOOOOOOOXXXXXXXXXXXGOOOOOXXXXXXXXXXXXXXGOOOOOOOOXXXXXXXXXXXGOOOOOOXXXXXXXXXXXXXGOOOOOOOOOOOOXXXXXXXGOOOOOOOOXXXXXXXXXXXGOOXXXXXXXXXXXXXXXXXGOOOOOOOOOOXXXXXXXXXGOOOOXXXXXXXXXXXXXXXGOOOOOOOOOOOOXXXXXXXGOOOOOOOOOOOOOXXXXXXGOOOOOXXXXXXXXXXXXXX,0,0,0
36729,118,0,118,33,449,0,0,158,90,68,GOOOOOOOOOOOOXXXXXXXGOOOOOOOOXXXXXXXXXXXGOOOOOXXXXXXXXXXXXXXGOOOOOOOOXXXXXXXXXXXGOOOOOOXXXXXXXXXXXXXGOOOOOOOOOOOOXXXXXXXGOOOOOOOOXXXXXXXXXXXGOOXXXXXXXXXXXXXXXXXGOOOOOOOOOOXXXXXXXXXGOOOOXXXXXXXXXXXXXXXGOOOOOOOOOOOOXXXXXXXGOOOOOOOOOOOOOXXXXXXGOOOOOXXXXXXXXXXXXXX,0,0,0

36750,118,0,118,33,449,0,0,158,91,67,GOOOOOOOOOOOOXXXXXXXGOOOOOOOOXXXXXXXXXXXGOOOOOXXXXXXXXXXXXXXGOOOOOOOOXXXXXXXXXXXGOOOOOOXXXXXXXXXXXXXGOOOOOOOOOOOOXXXXXXXGOOOOOOOOXXXXXXXXXXXGOOXXXXXXXXXXXXXXXXXGOOOOOOOOOOXXXXXXXXXGOOOOXXXXXXXXXXXXXXXGOOOOOOOOOOOOXXXXXXXGOOOOOOOOOOOOOXXXXXXGOOOOOXXXXXXXXXXXXXX,0,0,0
36771,118,0,118,36,446,0,0,155,92,63,GOOOOOOOOOOOOXXXXXXXGOOOOOOOOXXXXXXXXXXXGOOOOOXXXXXXXXXXXXXXGOOOOOOOOXXXXXXXXXXXGOOOOOOXXXXXXXXXXXXXGOOOOOOOOOOOOXXXXXXXGOOOOOOOOXXXXXXXXXXXGOOXXXXXXXXXXXXXXXXXGOOOOOOOOOOXXXXXXXXXGOOOOXXXXXXXXXXXXXXXGOOOOOOOOOOOOXXXXXXXGOOOOOOOOOOOOOXXXXXXGOOOOOXXXXXXXXXXXXXX,0,0,0
36792,118,0,118,37,445,0,0,154,89,65,GOOOOOOOOOOOOXXXXXXXGOOOOOOOOXXXXXXXXXXXGOOOOOXXXXXXXXXXXXXXGOOOOOOOOXXXXXXXXXXXGOOOOOOXXXXXXXXXXXXXGOOOOOOOOOOOOXXXXXXXGOOOOOOOOXXXXXXXXXXXGOOXXXXXXXXXXXXXXXXXGOOOOOOOOOOXXXXXXXXXGOOOOXXXXXXXXXXXXXXXGOOOOOOOOOOOOXXXXXXXGOOOOOOOOOOOOOXXXXXXGOOOOOXXXXXXXXXXXXXX,0,0,0
36813,118,0,118,35,447,0,0,156,91,65,GOOOOOOOOOOOOXXXXXXXGOOOOOOOOXXXXXXXXXXXGOOOOOXXXXXXXXXXXXXXGOOOOOOOOXXXXXXXXXXXGOOOOOOXXXXXXXXXXXXXGOOOOOOOOOOOOXXXXXXXGOOOOOOOOXXXXXXXXXXXGOOXXXXXXXXXXXXXXXXXGOOOOOOOOOOXXXXXXXXXGOOOOXXXXXXXXXXXXXXXGOOOOOOOOOOOOXXXXXXXGOOOOOOOOOOOOOXXXXXXGOOOOOXXXXXXXXXXXXXX,0,0,0
36834,118,0,118,35,447,0,0,156,89,67,GOOOOOOOOOOOOXXXXXXXGOOOOOOOOXXXXXXXXXXXGOOOOOXXXXXXXXXXXXXXGOOOOOOOOXXXXXXXXXXXGOOOOOOXXXXXXXXXXXXXGOOOOOOOOOOOOXXXXXXXGOOOOOOOOXXXXXXXXXXXGOOXXXXXXXXXXXXXXXXXGOOOOOOOOOOXXXXXXXXXGOOOOXXXXXXXXXXXXXXXGOOOOOOOOOOOOXXXXXXXGOOOOOOOOOOOOOXXXXXXGOOOOOXXXXXXXXXXXXXX,0,0,0

36855,118,0,118,35,447,0,0,157,91,66,GOOOOOOOOOOOOXXXXXXXGOOOOOOOOXXXXXXXXXXXGOOOOOXXXXXXXXXXXXXXGOOOOOOOOXXXXXXXXXXXGOOOOOOXXXXXXXXXXXXXGOOOOOOOOOOOOXXXXXXXGOOOOOOOOXXXXXXXXXXXGOOXXXXXXXXXXXXXXXXXGOOOOOOOOOOXXXXXXXXXGOOOOXXXXXXXXXXXXXXXGOOOOOOOOOOOOXXXXXXXGOOOOOOOOOOOOOXXXXXXGOOOOOXXXXXXXXXXXXXX,0,0,0
36876,118,0,118,36,446,0,0,156,90,66,GOOOOOOOOOOOOXXXXXXXGOOOOOOOOXXXXXXXXXXXGOOOOOXXXXXXXXXXXXXXGOOOOOOOOXXXXXXXXXXXGOOOOOOXXXXXXXXXXXXXGOOOOOOOOOOOOXXXXXXXGOOOOOOOOXXXXXXXXXXXGOOXXXXXXXXXXXXXXXXXGOOOOOOOOOOXXXXXXXXXGOOOOXXXXXXXXXXXXXXXGOOOOOOOOOOOOXXXXXXXGOOOOOOOOOOOOOXXXXXXGOOOOOXXXXXXXXXXXXXX,0,0,0
36897,118,0,118,36,446,0,0,155,89,66,GOOOOOOOOOOOOXXXXXXXGOOOOOOOOXXXXXXXXXXXGOOOOOXXXXXXXXXXXXXXGOOOOOOOOXXXXXXXXXXXGOOOOOOXXXXXXXXXXXXXGOOOOOOOOOOOOXXXXXXXGOOOOOOOOXXXXXXXXXXXGOOXXXXXXXXXXXXXXXXXGOOOOOOOOOOXXXXXXXXXGOOOOXXXXXXXXXXXXXXXGOOOOOOOOOOOOXXXXXXXGOOOOOOOOOOOOOXXXXXXGOOOOOXXXXXXXXXXXXXX,0,0,0
36918,118,0,118,36,446,0,0,155,93,62,GOOOOOOOOOOOOXXXXXXXGOOOOOOOOXXXXXXXXXXXGOOOOOXXXXXXXXXXXXXXGOOOOOOOOXXXXXXXXXXXGOOOOOOXXXXXXXXXXXXXGOOOOOOOOOOOOXXXXXXXGOOOOOOOOXXXXXXXXXXXGOOXXXXXXXXXXXXXXXXXGOOOOOOOOOOXXXXXXXXXGOOOOXXXXXXXXXXXXXXXGOOOOOOOOOOOOXXXXXXXGOOOOOOOOOOOOOXXXXXXGOOOOOXXXXXXXXXXXXXX,0,0,0
36939,118,0,118,35,447,0,0,157,91,66,GOOOOOOOOOOOOXXXXXXXGOOOOOOOOXXXXXXXXXXXGOOOOOXXXXXXXXXXXXXXGOOOOOOOOXXXXXXXXXXXGOOOOOOXXXXXXXXXXXXXGOOOOOOOOOOOOXXXXXXXGOOOOOOOOXXXXXXXXXXXGOOXXXXXXXXXXXXXXXXXGOOOOOOOOOOXXXXXXXXXGOOOOXXXXXXXXXXXXXXXGOOOOOOOOOOOOXXXXXXXGOOOOOOOOOOOOOXXXXXXGOOOOOXXXXXXXXXXXXXX,0,0,0

36960,118,0,118,34,448,0,0,158,92,66,GOOOOOOOOOOOOXXXXXXXGOOOOOOOOXXXXXXXXXXXGOOOOOXXXXXXXXXXXXXXGOOOOOOOOXXXXXXXXXXXGOOOOOOXXXXXXXXXXXXXGOOOOOOOOOOOOXXXXXXXGOOOOOOOOXXXXXXXXXXXGOOXXXXXXXXXXXXXXXXXGOOOOOOOOOOXXXXXXXXXGOOOOXXXXXXXXXXXXXXXGOOOOOOOOOOOOXXXXXXXGOOOOOOOOOOOOOXXXXXXGOOOOOXXXXXXXXXXXXXX,0,0,0
36981,118,0,118,36,446,0,0,156,92,64,GOOOOOOOOOOOOXXXXXXXGOOOOOOOOXXXXXXXXXXXGOOOOOXXXXXXXXXXXXXXGOOOOOOOOXXXXXXXXXXXGOOOOOOXXXXXXXXXXXXXGOOOOOOOOOOOOXXXXXXXGOOOOOOOOXXXXXXXXXXXGOOXXXXXXXXXXXXXXXXXGOOOOOOOOOOXXXXXXXXXGOOOOXXXXXXXXXXXXXXXGOOOOOOOOOOOOXXXXXXXGOOOOOOOOOOOOOXXXXXXGOOOOOXXXXXXXXXXXXXX,0,0,0
37002,118,0,118,34,448,0,0,158,92,66,GOOOOOOOOOOOOXXXXXXXGOOOOOOOOXXXXXXXXXXXGOOOOOXXXXXXXXXXXXXXGOOOOOOOOXXXXXXXXXXXGOOOOOOXXXXXXXXXXXXXGOOOOOOOOOOOOXXXXXXXGOOOOOOOOXXXXXXXXXXXGOOXXXXXXXXXXXXXXXXXGOOOOOOOOOOXXXXXXXXXGOOOOXXXXXXXXXXXXXXXGOOOOOOOOOOOOXXXXXXXGOOOOOOOOOOOOOXXXXXXGOOOOOXXXXXXXXXXXXXX,0,0,0
37023,118,0,118,34,448,0,0,158,92,66,GOOOOOOOOOOOOXXXXXXXGOOOOOOOOXXXXXXXXXXXGOOOOOXXXXXXXXXXXXXXGOOOOOOOOXXXXXXXXXXXGOOOOOOXXXXXXXXXXXXXGOOOOOOOOOOOOXXXXXXXGOOOOOOOOXXXXXXXXXXXGOOXXXXXXXXXXXXXXXXXGOOOOOOOOOOXXXXXXXXXGOOOOXXXXXXXXXXXXXXXGOOOOOOOOOOOOXXXXXXXGOOOOOOOOOOOOOXXXXXXGOOOOOXXXXXXXXXXXXXX,0,0,0
37044,118,0,118,30,452,0,0,162,90,72,GOOOOOOOOOOOOXXXXXXXGOOOOOOOOXXXXXXXXXXXGOOOOOXXXXXXXXXXXXXXGOOOOOOOOXXXXXXXXXXXGOOOOOOXXXXXXXXXXXXXGOOOOOOOOOOOOXXXXXXXGOOOOOOOOXXXXXXXXXXXGOOXXXXXXXXXXXXXXXXXGOOOOOOOOOOXXXXXXXXXGOOOOXXXXXXXXXXXXXXXGOOOOOOOOOOOOXXXXXXXGOOOOOOOOOOOOOXXXXXXGOOOOOXXXXXXXXXXXXXX,0,0,0

37065,118,0,118,33,449,0,0,159,92,67,GOOOOOOOOOOOOXXXXXXXGOOOOOOOOXXXXXXXXXXXGOOOOOXXXXXXXXXXXXXXGOOOOOOOOXXXXXXXXXXXGOOOOOOXXXXXXXXXXXXXGOOOOOOOOOOOOXXXXXXXGOOOOOOOOXXXXXXXXXXXGOOXXXXXXXXXXXXXXXXXGOOOOOOOOOOXXXXXXXXXGOOOOXXXXXXXXXXXXXXXGOOOOOOOOOOOOXXXXXXXGOOOOOOOOOOOOOXXXXXXGOOOOOXXXXXXXXXXXXXX,0,0,0
37086,118,0,118,30,452,0,0,162,93,69,GOOOOOOOOOOOOXXXXXXXGOOOOOOOOXXXXXXXXXXXGOOOOOXXXXXXXXXXXXXXGOOOOOOOOXXXXXXXXXXXGOOOOOOXXXXXXXXXXXXXGOOOOOOOOOOOOXXXXXXXGOOOOOOOOXXXXXXXXXXXGOOXXXXXXXXXXXXXXXXXGOOOOOOOOOOXXXXXXXXXGOOOOXXXXXXXXXXXXXXXGOOOOOOOOOOOOXXXXXXXGOOOOOOOOOOOOOXXXXXXGOOOOOXXXXXXXXXXXXXX,0,0,0
37107,118,0,118,33,449,0,0,159,93,66,GOOOOOOOOOOOOXXXXXXXGOOOOOOOOXXXXXXXXXXXGOOOOOXXXXXXXXXXXXXXGOOOOOOOOXXXXXXXXXXXGOOOOOOXXXXXXXXXXXXXGOOOOOOOOOOOOXXXXXXXGOOOOOOOOXXXXXXXXXXXGOOXXXXXXXXXXXXXXXXXGOOOOOOOOOOXXXXXXXXXGOOOOXXXXXXXXXXXXXXXGOOOOOOOOOOOOXXXXXXXGOOOOOOOOOOOOOXXXXXXGOOOOOXXXXXXXXXXXXXX,0,0,0
37128,118,0,118,36,446,0,0,155,90,65,GOOOOOOOOOOOOXXXXXXXGOOOOOOOOXXXXXXXXXXXGOOOOOXXXXXXXXXXXXXXGOOOOOOOOXXXXXXXXXXXGOOOOOOXXXXXXXXXXXXXGOOOOOOOOOOOOXXXXXXXGOOOOOOOOXXXXXXXXXXXGOOXXXXXXXXXXXXXXXXXGOOOOOOOOOOXXXXXXXXXGOOOOXXXXXXXXXXXXXXXGOOOOOOOOOOOOXXXXXXXGOOOOOOOOOOOOOXXXXXXGOOOOOXXXXXXXXXXXXXX,0,0,0
37149,118,0,118,36,446,0,0,155,89,66,GOOOOOOOOOOOOXXXXXXXGOOOOOOOOXXXXXXXXXXXGOOOOOXXXXXXXXXXXXXXGOOOOOOOOXXXXXXXXXXXGOOOOOOXXXXXXXXXXXXXGOOOOOOOOOOOOXXXXXXXGOOOOOOOOXXXXXXXXXXXGOOXXXXXXXXXXXXXXXXXGOOOOOOOOOOXXXXXXXXXGOOOOXXXXXXXXXXXXXXXGOOOOOOOOOOOOXXXXXXXGOOOOOOOOOOOOOXXXXXXGOOOOOXXXXXXXXXXXXXX,0,0,0

37170,118,0,118,35,447,0,0,156,92,64,GOOOOOOOOOOOOXXXXXXXGOOOOOOOOXXXXXXXXXXXGOOOOOXXXXXXXXXXXXXXGOOOOOOOOXXXXXXXXXXXGOOOOOOXXXXXXXXXXXXXGOOOOOOOOOOOOXXXXXXXGOOOOOOOOXXXXXXXXXXXGOOXXXXXXXXXXXXXXXXXGOOOOOOOOOOXXXXXXXXXGOOOOXXXXXXXXXXXXXXXGOOOOOOOOOOOOXXXXXXXGOOOOOOOOOOOOOXXXXXXGOOOOOXXXXXXXXXXXXXX,0,0,0
37191,118,0,118,39,443,0,0,152,90,62,GOOOOOOOOOOOOXXXXXXXGOOOOOOOOXXXXXXXXXXXGOOOOOXXXXXXXXXXXXXXGOOOOOOOOXXXXXXXXXXXGOOOOOOXXXXXXXXXXXXXGOOOOOOOOOOOOXXXXXXXGOOOOOOOOXXXXXXXXXXXGOOXXXXXXXXXXXXXXXXXGOOOOOOOOOOXXXXXXXXXGOOOOXXXXXXXXXXXXXXXGOOOOOOOOOOOOXXXXXXXGOOOOOOOOOOOOOXXXXXXGOOOOOXXXXXXXXXXXXXX,0,0,0
37212,118,0,118,38,444,0,0,152,90,62,GOOOOOOOOOOOOXXXXXXXGOOOOOOOOXXXXXXXXXXXGOOOOOXXXXXXXXXXXXXXGOOOOOOOOXXXXXXXXXXXGOOOOOOXXXXXXXXXXXXXGOOOOOOOOOOOOXXXXXXXGOOOOOOOOXXXXXXXXXXXGOOXXXXXXXXXXXXXXXXXGOOOOOOOOOOXXXXXXXXXGOOOOXXXXXXXXXXXXXXXGOOOOOOOOOOOOXXXXXXXGOOOOOOOOOOOOOXXXXXXGOOOOOXXXXXXXXXXXXXX,0,0,0
37233,118,0,118,36,446,0,0,155,91,64,GOOOOOOOOOOOOXXXXXXXGOOOOOOOOXXXXXXXXXXXGOOOOOXXXXXXXXXXXXXXGOOOOOOOOXXXXXXXXXXXGOOOOOOXXXXXXXXXXXXXGOOOOOOOOOOOOXXXXXXXGOOOOOOOOXXXXXXXXXXXGOOXXXXXXXXXXXXXXXXXGOOOOOOOOOOXXXXXXXXXGOOOOXXXXXXXXXXXXXXXGOOOOOOOOOOOOXXXXXXXGOOOOOOOOOOOOOXXXXXXGOOOOOXXXXXXXXXXXXXX,0,0,0
37254,118,0,118,36,446,0,0,155,91,64,GOOOOOOOOOOOOXXXXXXXGOOOOOOOOXXXXXXXXXXXGOOOOOXXXXXXXXXXXXXXGOOOOOOOOXXXXXXXXXXXGOOOOOOXXXXXXXXXXXXXGOOOOOOOOOOOOXXXXXXXGOOOOOOOOXXXXXXXXXXXGOOXXXXXXXXXXXXXXXXXGOOOOOOOOOOXXXXXXXXXGOOOOXXXXXXXXXXXXXXXGOOOOOOOOOOOOXXXXXXXGOOOOOOOOOOOOOXXXXXXGOOOOOXXXXXXXXXXXXXX,0,0,0

37275,118,0,118,38,444,0,0,153,88,65,GOOOOOOOOOOOOXXXXXXXGOOOOOOOOXXXXXXXXXXXGOOOOOXXXXXXXXXXXXXXGOOOOOOOOXXXXXXXXXXXGOOOOOOXXXXXXXXXXXXXGOOOOOOOOOOOOXXXXXXXGOOOOOOOOXXXXXXXXXXXGOOXXXXXXXXXXXXXXXXXGOOOOOOOOOOXXXXXXXXXGOOOOXXXXXXXXXXXXXXXGOOOOOOOOOOOOXXXXXXXGOOOOOOOOOOOOOXXXXXXGOOOOOXXXXXXXXXXXXXX,0,0,0
37296,118,0,118,40,442,0,0,151,88,63,GOOOOOOOOOOOOXXXXXXXGOOOOOOOOXXXXXXXXXXXGOOOOOXXXXXXXXXXXXXXGOOOOOOOOXXXXXXXXXXXGOOOOOOXXXXXXXXXXXXXGOOOOOOOOOOOOXXXXXXXGOOOOOOOOXXXXXXXXXXXGOOXXXXXXXXXXXXXXXXXGOOOOOOOOOOXXXXXXXXXGOOOOXXXXXXXXXXXXXXXGOOOOOOOOOOOOXXXXXXXGOOOOOOOOOOOOOXXXXXXGOOOOOXXXXXXXXXXXXXX,0,0,0
37317,118,0,118,39,443,0,0,152,92,60,GOOOOOOOOOOOOXXXXXXXGOOOOOOOOXXXXXXXXXXXGOOOOOXXXXXXXXXXXXXXGOOOOOOOOXXXXXXXXXXXGOOOOOOXXXXXXXXXXXXXGOOOOOOOOOOOOXXXXXXXGOOOOOOOOXXXXXXXXXXXGOOXXXXXXXXXXXXXXXXXGOOOOOOOOOOXXXXXXXXXGOOOOXXXXXXXXXXXXXXXGOOOOOOOOOOOOXXXXXXXGOOOOOOOOOOOOOXXXXXXGOOOOOXXXXXXXXXXXXXX,0,0,0
37338,118,0,118,35,447,0,0,155,91,64,GOOOOOOOOOOOOXXXXXXXGOOOOOOOOXXXXXXXXXXXGOOOOOXXXXXXXXXXXXXXGOOOOOOOOXXXXXXXXXXXGOOOOOOXXXXXXXXXXXXXGOOOOOOOOOOOOXXXXXXXGOOOOOOOOXXXXXXXXXXXGOOXXXXXXXXXXXXXXXXXGOOOOOOOOOOXXXXXXXXXGOOOOXXXXXXXXXXXXXXXGOOOOOOOOOOOOXXXXXXXGOOOOOOOOOOOOOXXXXXXGOOOOOXXXXXXXXXXXXXX,0,0,0
37359,118,0,118,36,446,0,0,155,90,65,GOOOOOOOOOOOOXXXXXXXGOOOOOOOOXXXXXXXXXXXGOOOOOXXXXXXXXXXXXXXGOOOOOOOOXXXXXXXXXXXGOOOOOOXXXXXXXXXXXXXGOOOOOOOOOOOOXXXXXXXGOOOOOOOOXXXXXXXXXXXGOOXXXXXXXXXXXXXXXXXGOOOOOOOOOOXXXXXXXXXGOOOOXXXXXXXXXXXXXXXGOOOOOOOOOOOOXXXXXXXGOOOOOOOOOOOOOXXXXXXGOOOOOXXXXXXXXXXXXXX,0,0,0

37380,118,0,118,34,448,0,0,157,88,69,GOOOOOOOOOOOOXXXXXXXGOOOOOOOOXXXXXXXXXXXGOOOOOXXXXXXXXXXXXXXGOOOOOOOOXXXXXXXXXXXGOOOOOOXXXXXXXXXXXXXGOOOOOOOOOOOOXXXXXXXGOOOOOOOOXXXXXXXXXXXGOOXXXXXXXXXXXXXXXXXGOOOOOOOOOOXXXXXXXXXGOOOOXXXXXXXXXXXXXXXGOOOOOOOOOOOOXXXXXXXGOOOOOOOOOOOOOXXXXXXGOOOOOXXXXXXXXXXXXXX,0,0,0
37401,118,0,118,34,448,0,0,157,91,66,GOOOOOOOOOOOOXXXXXXXGOOOOOOOOXXXXXXXXXXXGOOOOOXXXXXXXXXXXXXXGOOOOOOOOXXXXXXXXXXXGOOOOOOXXXXXXXXXXXXXGOOOOOOOOOOOOXXXXXXXGOOOOOOOOXXXXXXXXXXXGOOXXXXXXXXXXXXXXXXXGOOOOOOOOOOXXXXXXXXXGOOOOXXXXXXXXXXXXXXXGOOOOOOOOOOOOXXXXXXXGOOOOOOOOOOOOOXXXXXXGOOOOOXXXXXXXXXXXXXX,0,0,0
37422,118,0,118,37,445,0,0,154,93,61,GOOOOOOOOOOOOXXXXXXXGOOOOOOOOXXXXXXXXXXXGOOOOOXXXXXXXXXXXXXXGOOOOOOOOXXXXXXXXXXXGOOOOOOXXXXXXXXXXXXXGOOOOOOOOOOOOXXXXXXXGOOOOOOOOXXXXXXXXXXXGOOXXXXXXXXXXXXXXXXXGOOOOOOOOOOXXXXXXXXXGOOOOXXXXXXXXXXXXXXXGOOOOOOOOOOOOXXXXXXXGOOOOOOOOOOOOOXXXXXXGOOOOOXXXXXXXXXXXXXX,0,0,0
37443,118,0,118,39,443,0,0,152,95,57,GOOOOOOOOOOOOXXXXXXXGOOOOOOOOXXXXXXXXXXXGOOOOOXXXXXXXXXXXXXXGOOOOOOOOXXXXXXXXXXXGOOOOOOXXXXXXXXXXXXXGOOOOOOOOOOOOXXXXXXXGOOOOOOOOXXXXXXXXXXXGOOXXXXXXXXXXXXXXXXXGOOOOOOOOOOXXXXXXXXXGOOOOXXXXXXXXXXXXXXXGOOOOOOOOOOOOXXXXXXXGOOOOOOOOOOOOOXXXXXXGOOOOOXXXXXXXXXXXXXX,0,0,0
37464,118,0,118,41,441,0,0,150,90,60,GOOOOOOOOOOOOXXXXXXXGOOOOOOOOXXXXXXXXXXXGOOOOOXXXXXXXXXXXXXXGOOOOOOOOXXXXXXXXXXXGOOOOOOXXXXXXXXXXXXXGOOOOOOOOOOOOXXXXXXXGOOOOOOOOXXXXXXXXXXXGOOXXXXXXXXXXXXXXXXXGOOOOOOOOOOXXXXXXXXXGOOOOXXXXXXXXXXXXXXXGOOOOOOOOOOOOXXXXXXXGOOOOOOOOOOOOOXXXXXXGOOOOOXXXXXXXXXXXXXX,0,0,0

37485,118,0,118,38,444,0,0,152,89,63,GOOOOOOOOOOOOXXXXXXXGOOOOOOOOXXXXXXXXXXXGOOOOOXXXXXXXXXXXXXXGOOOOOOOOXXXXXXXXXXXGOOOOOOXXXXXXXXXXXXXGOOOOOOOOOOOOXXXXXXXGOOOOOOOOXXXXXXXXXXXGOOXXXXXXXXXXXXXXXXXGOOOOOOOOOOXXXXXXXXXGOOOOXXXXXXXXXXXXXXXGOOOOOOOOOOOOXXXXXXXGOOOOOOOOOOOOOXXXXXXGOOOOOXXXXXXXXXXXXXX,0,0,0
37506,118,0,118,38,444,0,0,153,95,58,GOOOOOOOOOOOOXXXXXXXGOOOOOOOOXXXXXXXXXXXGOOOOOXXXXXXXXXXXXXXGOOOOOOOOXXXXXXXXXXXGOOOOOOXXXXXXXXXXXXXGOOOOOOOOOOOOXXXXXXXGOOOOOOOOXXXXXXXXXXXGOOXXXXXXXXXXXXXXXXXGOOOOOOOOOOXXXXXXXXXGOOOOXXXXXXXXXXXXXXXGOOOOOOOOOOOOXXXXXXXGOOOOOOOOOOOOOXXXXXXGOOOOOXXXXXXXXXXXXXX,0,0,0
37527,118,0,118,36,446,0,0,155,92,63,GOOOOOOOOOOOOXXXXXXXGOOOOOOOOXXXXXXXXXXXGOOOOOXXXXXXXXXXXXXXGOOOOOOOOXXXXXXXXXXXGOOOOOOXXXXXXXXXXXXXGOOOOOOOOOOOOXXXXXXXGOOOOOOOOXXXXXXXXXXXGOOXXXXXXXXXXXXXXXXXGOOOOOOOOOOXXXXXXXXXGOOOOXXXXXXXXXXXXXXXGOOOOOOOOOOOOXXXXXXXGOOOOOOOOOOOOOXXXXXXGOOOOOXXXXXXXXXXXXXX,0,0,0
37548,118,0,118,38,444,0,0,152,92,60,GOOOOOOOOOOOOXXXXXXXGOOOOOOOOXXXXXXXXXXXGOOOOOXXXXXXXXXXXXXXGOOOOOOOOXXXXXXXXXXXGOOOOOOXXXXXXXXXXXXXGOOOOOOOOOOOOXXXXXXXGOOOOOOOOXXXXXXXXXXXGOOXXXXXXXXXXXXXXXXXGOOOOOOOOOOXXXXXXXXXGOOOOXXXXXXXXXXXXXXXGOOOOOOOOOOOOXXXXXXXGOOOOOOOOOOOOOXXXXXXGOOOOOXXXXXXXXXXXXXX,0,0,0
37569,118,0,118,40,442,0,0,150,93,57,GOOOOOOOOOOOOXXXXXXXGOOOOOOOOXXXXXXXXXXXGOOOOOXXXXXXXXXXXXXXGOOOOOOOOXXXXXXXXXXXGOOOOOOXXXXXXXXXXXXXGOOOOOOOOOOOOXXXXXXXGOOOOOOOOXXXXXXXXXXXGOOXXXXXXXXXXXXXXXXXGOOOOOOOOOOXXXXXXXXXGOOOOXXXXXXXXXXXXXXXGOOOOOOOOOOOOXXXXXXXGOOOOOOOOOOOOOXXXXXXGOOOOOXXXXXXXXXXXXXX,0,0,0

37590,118,0,118,42,440,0,0,149,90,59,GOOOOOOOOOOOOXXXXXXXGOOOOOOOOXXXXXXXXXXXGOOOOOXXXXXXXXXXXXXXGOOOOOOOOXXXXXXXXXXXGOOOOOOXXXXXXXXXXXXXGOOOOOOOOOOOOXXXXXXXGOOOOOOOOXXXXXXXXXXXGOOXXXXXXXXXXXXXXXXXGOOOOOOOOOOXXXXXXXXXGOOOOXXXXXXXXXXXXXXXGOOOOOOOOOOOOXXXXXXXGOOOOOOOOOOOOOXXXXXXGOOOOOXXXXXXXXXXXXXX,0,0,0
37611,118,0,118,37,445,0,0,154,91,63,GOOOOOOOOOOOOXXXXXXXGOOOOOOOOXXXXXXXXXXXGOOOOOXXXXXXXXXXXXXXGOOOOOOOOXXXXXXXXXXXGOOOOOOXXXXXXXXXXXXXGOOOOOOOOOOOOXXXXXXXGOOOOOOOOXXXXXXXXXXXGOOXXXXXXXXXXXXXXXXXGOOOOOOOOOOXXXXXXXXXGOOOOXXXXXXXXXXXXXXXGOOOOOOOOOOOOXXXXXXXGOOOOOOOOOOOOOXXXXXXGOOOOOXXXXXXXXXXXXXX,0,0,0
37632,118,0,118,38,444,0,0,153,91,62,GOOOOOOOOOOOOXXXXXXXGOOOOOOOOXXXXXXXXXXXGOOOOOXXXXXXXXXXXXXXGOOOOOOOOXXXXXXXXXXXGOOOOOOXXXXXXXXXXXXXGOOOOOOOOOOOOXXXXXXXGOOOOOOOOXXXXXXXXXXXGOOXXXXXXXXXXXXXXXXXGOOOOOOOOOOXXXXXXXXXGOOOOXXXXXXXXXXXXXXXGOOOOOOOOOOOOXXXXXXXGOOOOOOOOOOOOOXXXXXXGOOOOOXXXXXXXXXXXXXX,0,0,0
37653,118,0,118,37,445,0,0,154,92,62,GOOOOOOOOOOOOXXXXXXXGOOOOOOOOXXXXXXXXXXXGOOOOOXXXXXXXXXXXXXXGOOOOOOOOXXXXXXXXXXXGOOOOOOXXXXXXXXXXXXXGOOOOOOOOOOOOXXXXXXXGOOOOOOOOXXXXXXXXXXXGOOXXXXXXXXXXXXXXXXXGOOOOOOOOOOXXXXXXXXXGOOOOXXXXXXXXXXXXXXXGOOOOOOOOOOOOXXXXXXXGOOOOOOOOOOOOOXXXXXXGOOOOOXXXXXXXXXXXXXX,0,0,0
37674,118,0,118,39,443,0,0,152,92,60,GOOOOOOOOOOOOXXXXXXXGOOOOOOOOXXXXXXXXXXXGOOOOOXXXXXXXXXXXXXXGOOOOOOOOXXXXXXXXXXXGOOOOOOXXXXXXXXXXXXXGOOOOOOOOOOOOXXXXXXXGOOOOOOOOXXXXXXXXXXXGOOXXXXXXXXXXXXXXXXXGOOOOOOOOOOXXXXXXXXXGOOOOXXXXXXXXXXXXXXXGOOOOOOOOOOOOXXXXXXXGOOOOOOOOOOOOOXXXXXXGOOOOOXXXXXXXXXXXXXX,0,0,0

37695,118,0,118,42,440,0,0,149,92,57,GOOOOOOOOOOOOXXXXXXXGOOOOOOOOXXXXXXXXXXXGOOOOOXXXXXXXXXXXXXXGOOOOOOOOXXXXXXXXXXXGOOOOOOXXXXXXXXXXXXXGOOOOOOOOOOOOXXXXXXXGOOOOOOOOXXXXXXXXXXXGOOXXXXXXXXXXXXXXXXXGOOOOOOOOOOXXXXXXXXXGOOOOXXXXXXXXXXXXXXXGOOOOOOOOOOOOXXXXXXXGOOOOOOOOOOOOOXXXXXXGOOOOOXXXXXXXXXXXXXX,0,0,0
37716,118,0,118,44,438,0,0,146,90,56,GOOOOOOOOOOOOXXXXXXXGOOOOOOOOXXXXXXXXXXXGOOOOOXXXXXXXXXXXXXXGOOOOOOOOXXXXXXXXXXXGOOOOOOXXXXXXXXXXXXXGOOOOOOOOOOOOXXXXXXXGOOOOOOOOXXXXXXXXXXXGOOXXXXXXXXXXXXXXXXXGOOOOOOOOOOXXXXXXXXXGOOOOXXXXXXXXXXXXXXXGOOOOOOOOOOOOXXXXXXXGOOOOOOOOOOOOOXXXXXXGOOOOOXXXXXXXXXXXXXX,0,0,0
37737,118,0,118,42,440,0,0,149,88,61,GOOOOOOOOOOOOXXXXXXXGOOOOOOOOXXXXXXXXXXXGOOOOOXXXXXXXXXXXXXXGOOOOOOOOXXXXXXXXXXXGOOOOOOXXXXXXXXXXXXXGOOOOOOOOOOOOXXXXXXXGOOOOOOOOXXXXXXXXXXXGOOXXXXXXXXXXXXXXXXXGOOOOOOOOOOXXXXXXXXXGOOOOXXXXXXXXXXXXXXXGOOOOOOOOOOOOXXXXXXXGOOOOOOOOOOOOOXXXXXXGOOOOOXXXXXXXXXXXXXX,0,0,0
37758,118,0,118,38,444,0,0,154,89,65,GOOOOOOOOOOOOXXXXXXXGOOOOOOOOXXXXXXXXXXXGOOOOOXXXXXXXXXXXXXXGOOOOOOOOXXXXXXXXXXXGOOOOOOXXXXXXXXXXXXXGOOOOOOOOOOOOXXXXXXXGOOOOOOOOXXXXXXXXXXXGOOXXXXXXXXXXXXXXXXXGOOOOOOOOOOXXXXXXXXXGOOOOXXXXXXXXXXXXXXXGOOOOOOOOOOOOXXXXXXXGOOOOOOOOOOOOOXXXXXXGOOOOOXXXXXXXXXXXXXX,0,0,0
37779,118,0,118,39,443,0,0,153,90,63,GOOOOOOOOOOOOXXXXXXXGOOOOOOOOXXXXXXXXXXXGOOOOOXXXXXXXXXXXXXXGOOOOOOOOXXXXXXXXXXXGOOOOOOXXXXXXXXXXXXXGOOOOOOOOOOOOXXXXXXXGOOOOOOOOXXXXXXXXXXXGOOXXXXXXXXXXXXXXXXXGOOOOOOOOOOXXXXXXXXXGOOOOXXXXXXXXXXXXXXXGOOOOOOOOOOOOXXXXXXXGOOOOOOOOOOOOOXXXXXXGOOOOOXXXXXXXXXXXXXX,0,0,0

37800,119,1,118,34,447,0,0,157,92,65,GOOOOOOOOOOOOXXXXXXXGOOOOOOOOXXXXXXXXXXXGOOOOOXXXXXXXXXXXXXXGOOOOOOOOXXXXXXXXXXXGOOOOOOXXXXXXXXXXXXXGOOOOOOOOOOOOXXXXXXXGOOOOOOOOXXXXXXXXXXXGOOXXXXXXXXXXXXXXXXXGOOOOOOOOOOXXXXXXXXXGOOOOAXXXXXXXXXXXXXXGOOOOOOOOOOOOXXXXXXXGOOOOOOOOOOOOOXXXXXXGOOOOOXXXXXXXXXXXXXX,0,0,0
37821,119,1,118,36,445,0,0,155,91,64,GOOOOOOOOOOOOXXXXXXXGOOOOOOOOXXXXXXXXXXXGOOOOOXXXXXXXXXXXXXXGOOOOOOOOXXXXXXXXXXXGOOOOOOXXXXXXXXXXXXXGOOOOOOOOOOOOXXXXXXXGOOOOOOOOXXXXXXXXXXXGOOXXXXXXXXXXXXXXXXXGOOOOOOOOOOXXXXXXXXXGOOOOAXXXXXXXXXXXXXXGOOOOOOOOOOOOXXXXXXXGOOOOOOOOOOOOOXXXXXXGOOOOOXXXXXXXXXXXXXX,0,0,0
37842,119,0,119,39,442,0,0,152,91,61,GOOOOOOOOOOOOXXXXXXXGOOOOOOOOXXXXXXXXXXXGOOOOOXXXXXXXXXXXXXXGOOOOOOOOXXXXXXXXXXXGOOOOOOXXXXXXXXXXXXXGOOOOOOOOOOOOXXXXXXXGOOOOOOOOXXXXXXXXXXXGOOXXXXXXXXXXXXXXXXXGOOOOOOOOOOXXXXXXXXXGOOOOOXXXXXXXXXXXXXXGOOOOOOOOOOOOXXXXXXXGOOOOOOOOOOOOOXXXXXXGOOOOOXXXXXXXXXXXXXX,0,0,0
37863,119,0,119,41,440,0,0,149,91,58,GOOOOOOOOOOOOXXXXXXXGOOOOOOOOXXXXXXXXXXXGOOOOOXXXXXXXXXXXXXXGOOOOOOOOXXXXXXXXXXXGOOOOOOXXXXXXXXXXXXXGOOOOOOOOOOOOXXXXXXXGOOOOOOOOXXXXXXXXXXXGOOXXXXXXXXXXXXXXXXXGOOOOOOOOOOXXXXXXXXXGOOOOOXXXXXXXXXXXXXXGOOOOOOOOOOOOXXXXXXXGOOOOOOOOOOOOOXXXXXXGOOOOOXXXXXXXXXXXXXX,0,0,0
37884,119,0,119,44,437,0,0,147,92,55,GOOOOOOOOOOOOXXXXXXXGOOOOOOOOXXXXXXXXXXXGOOOOOXXXXXXXXXXXXXXGOOOOOOOOXXXXXXXXXXXGOOOOOOXXXXXXXXXXXXXGOOOOOOOOOOOOXXXXXXXGOOOOOOOOXXXXXXXXXXXGOOXXXXXXXXXXXXXXXXXGOOOOOOOOOOXXXXXXXXXGOOOOOXXXXXXXXXXXXXXGOOOOOOOOOOOOXXXXXXXGOOOOOOOOOOOOOXXXXXXGOOOOOXXXXXXXXXXXXXX,0,0,0

37905,119,0,119,45,436,0,0,146,90,56,GOOOOOOOOOOOOXXXXXXXGOOOOOOOOXXXXXXXXXXXGOOOOOXXXXXXXXXXXXXXGOOOOOOOOXXXXXXXXXXXGOOOOOOXXXXXXXXXXXXXGOOOOOOOOOOOOXXXXXXXGOOOOOOOOXXXXXXXXXXXGOOXXXXXXXXXXXXXXXXXGOOOOOOOOOOXXXXXXXXXGOOOOOXXXXXXXXXXXXXXGOOOOOOOOOOOOXXXXXXXGOOOOOOOOOOOOOXXXXXXGOOOOOXXXXXXXXXXXXXX,0,0,0
37926,119,0,119,45,436,0,0,146,91,55,GOOOOOOOOOOOOXXXXXXXGOOOOOOOOXXXXXXXXXXXGOOOOOXXXXXXXXXXXXXXGOOOOOOOOXXXXXXXXXXXGOOOOOOXXXXXXXXXXXXXGOOOOOOOOOOOOXXXXXXXGOOOOOOOOXXXXXXXXXXXGOOXXXXXXXXXXXXXXXXXGOOOOOOOOOOXXXXXXXXXGOOOOOXXXXXXXXXXXXXXGOOOOOOOOOOOOXXXXXXXGOOOOOOOOOOOOOXXXXXXGOOOOOXXXXXXXXXXXXXX,0,0,0
37947,119,0,119,42,439,0,0,151,90,61,GOOOOOOOOOOOOXXXXXXXGOOOOOOOOXXXXXXXXXXXGOOOOOXXXXXXXXXXXXXXGOOOOOOOOXXXXXXXXXXXGOOOOOOXXXXXXXXXXXXXGOOOOOOOOOOOOXXXXXXXGOOOOOOOOXXXXXXXXXXXGOOXXXXXXXXXXXXXXXXXGOOOOOOOOOOXXXXXXXXXGOOOOOXXXXXXXXXXXXXXGOOOOOOOOOOOOXXXXXXXGOOOOOOOOOOOOOXXXXXXGOOOOOXXXXXXXXXXXXXX,0,0,0
37968,119,0,119,36,445,0,0,156,92,64,GOOOOOOOOOOOOXXXXXXXGOOOOOOOOXXXXXXXXXXXGOOOOOXXXXXXXXXXXXXXGOOOOOOOOXXXXXXXXXXXGOOOOOOXXXXXXXXXXXXXGOOOOOOOOOOOOXXXXXXXGOOOOOOOOXXXXXXXXXXXGOOXXXXXXXXXXXXXXXXXGOOOOOOOOOOXXXXXXXXXGOOOOOXXXXXXXXXXXXXXGOOOOOOOOOOOOXXXXXXXGOOOOOOOOOOOOOXXXXXXGOOOOOXXXXXXXXXXXXXX,0,0,0
37989,119,0,119,36,445,0,0,156,95,61,GOOOOOOOOOOOOXXXXXXXGOOOOOOOOXXXXXXXXXXXGOOOOOXXXXXXXXXXXXXXGOOOOOOOOXXXXXXXXXXXGOOOOOOXXXXXXXXXXXXXGOOOOOOOOOOOOXXXXXXXGOOOOOOOOXXXXXXXXXXXGOOXXXXXXXXXXXXXXXXXGOOOOOOOOOOXXXXXXXXXGOOOOOXXXXXXXXXXXXXXGOOOOOOOOOOOOXXXXXXXGOOOOOOOOOOOOOXXXXXXGOOOOOXXXXXXXXXXXXXX,0,0,0

38010,119,0,119,37,444,0,0,155,91,64,GOOOOOOOOOOOOXXXXXXXGOOOOOOOOXXXXXXXXXXXGOOOOOXXXXXXXXXXXXXXGOOOOOOOOXXXXXXXXXXXGOOOOOOXXXXXXXXXXXXXGOOOOOOOOOOOOXXXXXXXGOOOOOOOOXXXXXXXXXXXGOOXXXXXXXXXXXXXXXXXGOOOOOOOOOOXXXXXXXXXGOOOOOXXXXXXXXXXXXXXGOOOOOOOOOOOOXXXXXXXGOOOOOOOOOOOOOXXXXXXGOOOOOXXXXXXXXXXXXXX,0,0,0
38031,119,0,119,34,447,0,0,158,91,67,GOOOOOOOOOOOOXXXXXXXGOOOOOOOOXXXXXXXXXXXGOOOOOXXXXXXXXXXXXXXGOOOOOOOOXXXXXXXXXXXGOOOOOOXXXXXXXXXXXXXGOOOOOOOOOOOOXXXXXXXGOOOOOOOOXXXXXXXXXXXGOOXXXXXXXXXXXXXXXXXGOOOOOOOOOOXXXXXXXXXGOOOOOXXXXXXXXXXXXXXGOOOOOOOOOOOOXXXXXXXGOOOOOOOOOOOOOXXXXXXGOOOOOXXXXXXXXXXXXXX,0,0,0
38052,119,0,119,31,450,0,0,160,92,68,GOOOOOOOOOOOOXXXXXXXGOOOOOOOOXXXXXXXXXXXGOOOOOXXXXXXXXXXXXXXGOOOOOOOOXXXXXXXXXXXGOOOOOOXXXXXXXXXXXXXGOOOOOOOOOOOOXXXXXXXGOOOOOOOOXXXXXXXXXXXGOOXXXXXXXXXXXXXXXXXGOOOOOOOOOOXXXXXXXXXGOOOOOXXXXXXXXXXXXXXGOOOOOOOOOOOOXXXXXXXGOOOOOOOOOOOOOXXXXXXGOOOOOXXXXXXXXXXXXXX,0,0,0
38073,119,0,119,31,450,0,0,160,90,70,GOOOOOOOOOOOOXXXXXXXGOOOOOOOOXXXXXXXXXXXGOOOOOXXXXXXXXXXXXXXGOOOOOOOOXXXXXXXXXXXGOOOOOOXXXXXXXXXXXXXGOOOOOOOOOOOOXXXXXXXGOOOOOOOOXXXXXXXXXXXGOOXXXXXXXXXXXXXXXXXGOOOOOOOOOOXXXXXXXXXGOOOOOXXXXXXXXXXXXXXGOOOOOOOOOOOOXXXXXXXGOOOOOOOOOOOOOXXXXXXGOOOOOXXXXXXXXXXXXXX,0,0,0
38094,119,0,119,25,456,0,0,165,89,76,GOOOOOOOOOOOOXXXXXXXGOOOOOOOOXXXXXXXXXXXGOOOOOXXXXXXXXXXXXXXGOOOOOOOOXXXXXXXXXXXGOOOOOOXXXXXXXXXXXXXGOOOOOOOOOOOOXXXXXXXGOOOOOOOOXXXXXXXXXXXGOOXXXXXXXXXXXXXXXXXGOOOOOOOOOOXXXXXXXXXGOOOOOXXXXXXXXXXXXXXGOOOOOOOOOOOOXXXXXXXGOOOOOOOOOOOOOXXXXXXGOOOOOXXXXXXXXXXXXXX,0,0,0

38115,119,0,119,25,456,0,0,164,91,73,GOOOOOOOOOOOOXXXXXXXGOOOOOOOOXXXXXXXXXXXGOOOOOXXXXXXXXXXXXXXGOOOOOOOOXXXXXXXXXXXGOOOOOOXXXXXXXXXXXXXGOOOOOOOOOOOOXXXXXXXGOOOOOOOOXXXXXXXXXXXGOOXXXXXXXXXXXXXXXXXGOOOOOOOOOOXXXXXXXXXGOOOOOXXXXXXXXXXXXXXGOOOOOOOOOOOOXXXXXXXGOOOOOOOOOOOOOXXXXXXGOOOOOXXXXXXXXXXXXXX,0,0,0
38136,119,0,119,28,453,0,0,163,91,72,GOOOOOOOOOOOOXXXXXXXGOOOOOOOOXXXXXXXXXXXGOOOOOXXXXXXXXXXXXXXGOOOOOOOOXXXXXXXXXXXGOOOOOOXXXXXXXXXXXXXGOOOOOOOOOOOOXXXXXXXGOOOOOOOOXXXXXXXXXXXGOOXXXXXXXXXXXXXXXXXGOOOOOOOOOOXXXXXXXXXGOOOOOXXXXXXXXXXXXXXGOOOOOOOOOOOOXXXXXXXGOOOOOOOOOOOOOXXXXXXGOOOOOXXXXXXXXXXXXXX,0,0,0
38157,119,0,119,25,456,0,0,166,92,74,GOOOOOOOOOOOOXXXXXXXGOOOOOOOOXXXXXXXXXXXGOOOOOXXXXXXXXXXXXXXGOOOOOOOOXXXXXXXXXXXGOOOOOOXXXXXXXXXXXXXGOOOOOOOOOOOOXXXXXXXGOOOOOOOOXXXXXXXXXXXGOOXXXXXXXXXXXXXXXXXGOOOOOOOOOOXXXXXXXXXGOOOOOXXXXXXXXXXXXXXGOOOOOOOOOOOOXXXXXXXGOOOOOOOOOOOOOXXXXXXGOOOOOXXXXXXXXXXXXXX,0,0,0
38178,119,0,119,29,452,0,0,161,91,70,GOOOOOOOOOOOOXXXXXXXGOOOOOOOOXXXXXXXXXXXGOOOOOXXXXXXXXXXXXXXGOOOOOOOOXXXXXXXXXXXGOOOOOOXXXXXXXXXXXXXGOOOOOOOOOOOOXXXXXXXGOOOOOOOOXXXXXXXXXXXGOOXXXXXXXXXXXXXXXXXGOOOOOOOOOOXXXXXXXXXGOOOOOXXXXXXXXXXXXXXGOOOOOOOOOOOOXXXXXXXGOOOOOOOOOOOOOXXXXXXGOOOOOXXXXXXXXXXXXXX,0,0,0
38199,119,0,119,33,448,0,0,158,90,68,GOOOOOOOOOOOOXXXXXXXGOOOOOOOOXXXXXXXXXXXGOOOOOXXXXXXXXXXXXXXGOOOOOOOOXXXXXXXXXXXGOOOOOOXXXXXXXXXXXXXGOOOOOOOOOOOOXXXXXXXGOOOOOOOOXXXXXXXXXXXGOOXXXXXXXXXXXXXXXXXGOOOOOOOOOOXXXXXXXXXGOOOOOXXXXXXXXXXXXXXGOOOOOOOOOOOOXXXXXXXGOOOOOOOOOOOOOXXXXXXGOOOOOXXXXXXXXXXXXXX,0,0,0

38220,120,1,119,31,449,0,0,159,91,68,GOOOOOOOOOOOOXXXXXXXGOOOOOOOOXXXXXXXXXXXGOOOOOXXXXXXXXXXXXXXGOOOOOOOOXXXXXXXXXXXGOOOOOOXXXXXXXXXXXXXGOOOOOOOOOOOOXXXXXXXGOOOOOOOOXXXXXXXXXXXGOOXXXXXXXXXXXXXXXXXGOOOOOOOOOOXXXXXXXXXGOOOOOXXXXXXXXXXXXXXGOOOOOOOOOOOOXXXXXXXGOOOOOOOOOOOOOAXXXXXGOOOOOXXXXXXXXXXXXXX,0,0,0
38241,120,1,119,32,448,0,0,157,90,67,GOOOOOOOOOOOOXXXXXXXGOOOOOOOOXXXXXXXXXXXGOOOOOXXXXXXXXXXXXXXGOOOOOOOOXXXXXXXXXXXGOOOOOOXXXXXXXXXXXXXGOOOOOOOOOOOOXXXXXXXGOOOOOOOOXXXXXXXXXXXGOOXXXXXXXXXXXXXXXXXGOOOOOOOOOOXXXXXXXXXGOOOOOXXXXXXXXXXXXXXGOOOOOOOOOOOOXXXXXXXGOOOOOOOOOOOOOAXXXXXGOOOOOXXXXXXXXXXXXXX,0,0,0
38262,120,1,119,31,449,0,0,158,93,65,GOOOOOOOOOOOOXXXXXXXGOOOOOOOOXXXXXXXXXXXGOOOOOXXXXXXXXXXXXXXGOOOOOOOOXXXXXXXXXXXGOOOOOOXXXXXXXXXXXXXGOOOOOOOOOOOOXXXXXXXGOOOOOOOOXXXXXXXXXXXGOOXXXXXXXXXXXXXXXXXGOOOOOOOOOOXXXXXXXXXGOOOOOXXXXXXXXXXXXXXGOOOOOOOOOOOOXXXXXXXGOOOOOOOOOOOOOAXXXXXGOOOOOXXXXXXXXXXXXXX,0,0,0
38283,120,1,119,37,443,0,0,152,91,61,GOOOOOOOOOOOOXXXXXXXGOOOOOOOOXXXXXXXXXXXGOOOOOXXXXXXXXXXXXXXGOOOOOOOOXXXXXXXXXXXGOOOOOOXXXXXXXXXXXXXGOOOOOOOOOOOOXXXXXXXGOOOOOOOOXXXXXXXXXXXGOOXXXXXXXXXXXXXXXXXGOOOOOOOOOOXXXXXXXXXGOOOOOXXXXXXXXXXXXXXGOOOOOOOOOOOOXXXXXXXGOOOOOOOOOOOOOAXXXXXGOOOOOXXXXXXXXXXXXXX,0,0,0
38304,120,1,119,39,441,0,0,150,90,60,GOOOOOOOOOOOOXXXXXXXGOOOOOOOOXXXXXXXXXXXGOOOOOXXXXXXXXXXXXXXGOOOOOOOOXXXXXXXXXXXGOOOOOOXXXXXXXXXXXXXGOOOOOOOOOOOOXXXXXXXGOOOOOOOOXXXXXXXXXXXGOOXXXXXXXXXXXXXXXXXGOOOOOOOOOOXXXXXXXXXGOOOOOXXXXXXXXXXXXXXGOOOOOOOOOOOOXXXXXXXGOOOOOOOOOOOOOAXXXXXGOOOOOXXXXXXXXXXXXXX,0,0,0

38325,120,0,120,39,441,0,0,150,91,59,GOOOOOOOOOOOOXXXXXXXGOOOOOOOOXXXXXXXXXXXGOOOOOXXXXXXXXXXXXXXGOOOOOOOOXXXXXXXXXXXGOOOOOOXXXXXXXXXXXXXGOOOOOOOOOOOOXXXXXXXGOOOOOOOOXXXXXXXXXXXGOOXXXXXXXXXXXXXXXXXGOOOOOOOOOOXXXXXXXXXGOOOOOXXXXXXXXXXXXXXGOOOOOOOOOOOOXXXXXXXGOOOOOOOOOOOOOOXXXXXGOOOOOXXXXXXXXXXXXXX,0,0,0
38346,120,0,120,36,444,0,0,153,89,64,GOOOOOOOOOOOOXXXXXXXGOOOOOOOOXXXXXXXXXXXGOOOOOXXXXXXXXXXXXXXGOOOOOOOOXXXXXXXXXXXGOOOOOOXXXXXXXXXXXXXGOOOOOOOOOOOOXXXXXXXGOOOOOOOOXXXXXXXXXXXGOOXXXXXXXXXXXXXXXXXGOOOOOOOOOOXXXXXXXXXGOOOOOXXXXXXXXXXXXXXGOOOOOOOOOOOOXXXXXXXGOOOOOOOOOOOOOOXXXXXGOOOOOXXXXXXXXXXXXXX,0,0,0
38367,120,0,120,37,443,0,0,152,94,58,GOOOOOOOOOOOOXXXXXXXGOOOOOOOOXXXXXXXXXXXGOOOOOXXXXXXXXXXXXXXGOOOOOOOOXXXXXXXXXXXGOOOOOOXXXXXXXXXXXXXGOOOOOOOOOOOOXXXXXXXGOOOOOOOOXXXXXXXXXXXGOOXXXXXXXXXXXXXXXXXGOOOOOOOOOOXXXXXXXXXGOOOOOXXXXXXXXXXXXXXGOOOOOOOOOOOOXXXXXXXGOOOOOOOOOOOOOOXXXXXGOOOOOXXXXXXXXXXXXXX,0,0,0
38388,120,0,120,36,444,0,0,153,91,62,GOOOOOOOOOOOOXXXXXXXGOOOOOOOOXXXXXXXXXXXGOOOOOXXXXXXXXXXXXXXGOOOOOOOOXXXXXXXXXXXGOOOOOOXXXXXXXXXXXXXGOOOOOOOOOOOOXXXXXXXGOOOOOOOOXXXXXXXXXXXGOOXXXXXXXXXXXXXXXXXGOOOOOOOOOOXXXXXXXXXGOOOOOXXXXXXXXXXXXXXGOOOOOOOOOOOOXXXXXXXGOOOOOOOOOOOOOOXXXXXGOOOOOXXXXXXXXXXXXXX,0,0,0
38409,120,0,120,35,445,0,0,154,92,62,GOOOOOOOOOOOOXXXXXXXGOOOOOOOOXXXXXXXXXXXGOOOOOXXXXXXXXXXXXXXGOOOOOOOOXXXXXXXXXXXGOOOOOOXXXXXXXXXXXXXGOOOOOOOOOOOOXXXXXXXGOOOOOOOOXXXXXXXXXXXGOOXXXXXXXXXXXXXXXXXGOOOOOOOOOOXXXXXXXXXGOOOOOXXXXXXXXXXXXXXGOOOOOOOOOOOOXXXXXXXGOOOOOOOOOOOOOOXXXXXGOOOOOXXXXXXXXXXXXXX,0,0,0

38430,120,0,120,36,444,0,0,152,93,59,GOOOOOOOOOOOOXXXXXXXGOOOOOOOOXXXXXXXXXXXGOOOOOXXXXXXXXXXXXXXGOOOOOOOOXXXXXXXXXXXGOOOOOOXXXXXXXXXXXXXGOOOOOOOOOOOOXXXXXXXGOOOOOOOOXXXXXXXXXXXGOOXXXXXXXXXXXXXXXXXGOOOOOOOOOOXXXXXXXXXGOOOOOXXXXXXXXXXXXXXGOOOOOOOOOOOOXXXXXXXGOOOOOOOOOOOOOOXXXXXGOOOOOXXXXXXXXXXXXXX,0,0,0
38451,120,0,120,38,442,0,0,151,93,58,GOOOOOOOOOOOOXXXXXXXGOOOOOOOOXXXXXXXXXXXGOOOOOXXXXXXXXXXXXXXGOOOOOOOOXXXXXXXXXXXGOOOOOOXXXXXXXXXXXXXGOOOOOOOOOOOOXXXXXXXGOOOOOOOOXXXXXXXXXXXGOOXXXXXXXXXXXXXXXXXGOOOOOOOOOOXXXXXXXXXGOOOOOXXXXXXXXXXXXXXGOOOOOOOOOOOOXXXXXXXGOOOOOOOOOOOOOOXXXXXGOOOOOXXXXXXXXXXXXXX,0,0,0
38472,120,0,120,39,441,0,0,150,94,56,GOOOOOOOOOOOOXXXXXXXGOOOOOOOOXXXXXXXXXXXGOOOOOXXXXXXXXXXXXXXGOOOOOOOOXXXXXXXXXXXGOOOOOOXXXXXXXXXXXXXGOOOOOOOOOOOOXXXXXXXGOOOOOOOOXXXXXXXXXXXGOOXXXXXXXXXXXXXXXXXGOOOOOOOOOOXXXXXXXXXGOOOOOXXXXXXXXXXXXXXGOOOOOOOOOOOOXXXXXXXGOOOOOOOOOOOOOOXXXXXGOOOOOXXXXXXXXXXXXXX,0,0,0
38493,120,0,120,43,437,0,0,147,90,57,GOOOOOOOOOOOOXXXXXXXGOOOOOOOOXXXXXXXXXXXGOOOOOXXXXXXXXXXXXXXGOOOOOOOOXXXXXXXXXXXGOOOOOOXXXXXXXXXXXXXGOOOOOOOOOOOOXXXXXXXGOOOOOOOOXXXXXXXXXXXGOOXXXXXXXXXXXXXXXXXGOOOOOOOOOOXXXXXXXXXGOOOOOXXXXXXXXXXXXXXGOOOOOOOOOOOOXXXXXXXGOOOOOOOOOOOOOOXXXXXGOOOOOXXXXXXXXXXXXXX,0,0,0
38514,120,0,120,46,434,0,0,144,90,54,GOOOOOOOOOOOOXXXXXXXGOOOOOOOOXXXXXXXXXXXGOOOOOXXXXXXXXXXXXXXGOOOOOOOOXXXXXXXXXXXGOOOOOOXXXXXXXXXXXXXGOOOOOOOOOOOOXXXXXXXGOOOOOOOOXXXXXXXXXXXGOOXXXXXXXXXXXXXXXXXGOOOOOOOOOOXXXXXXXXXGOOOOOXXXXXXXXXXXXXXGOOOOOOOOOOOOXXXXXXXGOOOOOOOOOOOOOOXXXXXGOOOOOXXXXXXXXXXXXXX,0,0,0

38535,120,0,120,46,434,0,0,143,94,49,GOOOOOOOOOOOOXXXXXXXGOOOOOOOOXXXXXXXXXXXGOOOOOXXXXXXXXXXXXXXGOOOOOOOOXXXXXXXXXXXGOOOOOOXXXXXXXXXXXXXGOOOOOOOOOOOOXXXXXXXGOOOOOOOOXXXXXXXXXXXGOOXXXXXXXXXXXXXXXXXGOOOOOOOOOOXXXXXXXXXGOOOOOXXXXXXXXXXXXXXGOOOOOOOOOOOOXXXXXXXGOOOOOOOOOOOOOOXXXXXGOOOOOXXXXXXXXXXXXXX,0,0,0
38556,120,0,120,45,435,0,0,142,89,53,GOOOOOOOOOOOOXXXXXXXGOOOOOOOOXXXXXXXXXXXGOOOOOXXXXXXXXXXXXXXGOOOOOOOOXXXXXXXXXXXGOOOOOOXXXXXXXXXXXXXGOOOOOOOOOOOOXXXXXXXGOOOOOOOOXXXXXXXXXXXGOOXXXXXXXXXXXXXXXXXGOOOOOOOOOOXXXXXXXXXGOOOOOXXXXXXXXXXXXXXGOOOOOOOOOOOOXXXXXXXGOOOOOOOOOOOOOOXXXXXGOOOOOXXXXXXXXXXXXXX,0,0,0
38577,120,0,120,46,434,0,0,143,89,54,GOOOOOOOOOOOOXXXXXXXGOOOOOOOOXXXXXXXXXXXGOOOOOXXXXXXXXXXXXXXGOOOOOOOOXXXXXXXXXXXGOOOOOOXXXXXXXXXXXXXGOOOOOOOOOOOOXXXXXXXGOOOOOOOOXXXXXXXXXXXGOOXXXXXXXXXXXXXXXXXGOOOOOOOOOOXXXXXXXXXGOOOOOXXXXXXXXXXXXXXGOOOOOOOOOOOOXXXXXXXGOOOOOOOOOOOOOOXXXXXGOOOOOXXXXXXXXXXXXXX,0,0,0
38598,120,0,120,42,438,0,0,148,90,58,GOOOOOOOOOOOOXXXXXXXGOOOOOOOOXXXXXXXXXXXGOOOOOXXXXXXXXXXXXXXGOOOOOOOOXXXXXXXXXXXGOOOOOOXXXXXXXXXXXXXGOOOOOOOOOOOOXXXXXXXGOOOOOOOOXXXXXXXXXXXGOOXXXXXXXXXXXXXXXXXGOOOOOOOOOOXXXXXXXXXGOOOOOXXXXXXXXXXXXXXGOOOOOOOOOOOOXXXXXXXGOOOOOOOOOOOOOOXXXXXGOOOOOXXXXXXXXXXXXXX,0,0,0
38619,120,0,120,39,441,0,0,151,91,60,GOOOOOOOOOOOOXXXXXXXGOOOOOOOOXXXXXXXXXXXGOOOOOXXXXXXXXXXXXXXGOOOOOOOOXXXXXXXXXXXGOOOOOOXXXXXXXXXXXXXGOOOOOOOOOOOOXXXXXXXGOOOOOOOOXXXXXXXXXXXGOOXXXXXXXXXXXXXXXXXGOOOOOOOOOOXXXXXXXXXGOOOOOXXXXXXXXXXXXXXGOOOOOOOOOOOOXXXXXXXGOOOOOOOOOOOOOOXXXXXGOOOOOXXXXXXXXXXXXXX,0,0,0

38640,120,0,120,35,445,0,0,155,92,63,GOOOOOOOOOOOOXXXXXXXGOOOOOOOOXXXXXXXXXXXGOOOOOXXXXXXXXXXXXXXGOOOOOOOOXXXXXXXXXXXGOOOOOOXXXXXXXXXXXXXGOOOOOOOOOOOOXXXXXXXGOOOOOOOOXXXXXXXXXXXGOOXXXXXXXXXXXXXXXXXGOOOOOOOOOOXXXXXXXXXGOOOOOXXXXXXXXXXXXXXGOOOOOOOOOOOOXXXXXXXGOOOOOOOOOOOOOOXXXXXGOOOOOXXXXXXXXXXXXXX,0,0,0
38661,120,0,120,36,444,0,0,152,89,63,GOOOOOOOOOOOOXXXXXXXGOOOOOOOOXXXXXXXXXXXGOOOOOXXXXXXXXXXXXXXGOOOOOOOOXXXXXXXXXXXGOOOOOOXXXXXXXXXXXXXGOOOOOOOOOOOOXXXXXXXGOOOOOOOOXXXXXXXXXXXGOOXXXXXXXXXXXXXXXXXGOOOOOOOOOOXXXXXXXXXGOOOOOXXXXXXXXXXXXXXGOOOOOOOOOOOOXXXXXXXGOOOOOOOOOOOOOOXXXXXGOOOOOXXXXXXXXXXXXXX,0,0,0
38682,120,0,120,34,446,0,0,154,90,64,GOOOOOOOOOOOOXXXXXXXGOOOOOOOOXXXXXXXXXXXGOOOOOXXXXXXXXXXXXXXGOOOOOOOOXXXXXXXXXXXGOOOOOOXXXXXXXXXXXXXGOOOOOOOOOOOOXXXXXXXGOOOOOOOOXXXXXXXXXXXGOOXXXXXXXXXXXXXXXXXGOOOOOOOOOOXXXXXXXXXGOOOOOXXXXXXXXXXXXXXGOOOOOOOOOOOOXXXXXXXGOOOOOOOOOOOOOOXXXXXGOOOOOXXXXXXXXXXXXXX,0,0,0
38703,120,0,120,35,445,0,0,155,91,64,GOOOOOOOOOOOOXXXXXXXGOOOOOOOOXXXXXXXXXXXGOOOOOXXXXXXXXXXXXXXGOOOOOOOOXXXXXXXXXXXGOOOOOOXXXXXXXXXXXXXGOOOOOOOOOOOOXXXXXXXGOOOOOOOOXXXXXXXXXXXGOOXXXXXXXXXXXXXXXXXGOOOOOOOOOOXXXXXXXXXGOOOOOXXXXXXXXXXXXXXGOOOOOOOOOOOOXXXXXXXGOOOOOOOOOOOOOOXXXXXGOOOOOXXXXXXXXXXXXXX,0,0,0
38724,120,0,120,33,447,0,0,157,89,68,GOOOOOOOOOOOOXXXXXXXGOOOOOOOOXXXXXXXXXXXGOOOOOXXXXXXXXXXXXXXGOOOOOOOOXXXXXXXXXXXGOOOOOOXXXXXXXXXXXXXGOOOOOOOOOOOOXXXXXXXGOOOOOOOOXXXXXXXXXXXGOOXXXXXXXXXXXXXXXXXGOOOOOOOOOOXXXXXXXXXGOOOOOXXXXXXXXXXXXXXGOOOOOOOOOOOOXXXXXXXGOOOOOOOOOOOOOOXXXXXGOOOOOXXXXXXXXXXXXXX,0,0,0

38745,120,0,120,28,452,0,0,163,89,74,GOOOOOOOOOOOOXXXXXXXGOOOOOOOOXXXXXXXXXXXGOOOOOXXXXXXXXXXXXXXGOOOOOOOOXXXXXXXXXXXGOOOOOOXXXXXXXXXXXXXGOOOOOOOOOOOOXXXXXXXGOOOOOOOOXXXXXXXXXXXGOOXXXXXXXXXXXXXXXXXGOOOOOOOOOOXXXXXXXXXGOOOOOXXXXXXXXXXXXXXGOOOOOOOOOOOOXXXXXXXGOOOOOOOOOOOOOOXXXXXGOOOOOXXXXXXXXXXXXXX,0,0,0
38766,120,0,120,27,453,0,0,164,90,74,GOOOOOOOOOOOOXXXXXXXGOOOOOOOOXXXXXXXXXXXGOOOOOXXXXXXXXXXXXXXGOOOOOOOOXXXXXXXXXXXGOOOOOOXXXXXXXXXXXXXGOOOOOOOOOOOOXXXXXXXGOOOOOOOOXXXXXXXXXXXGOOXXXXXXXXXXXXXXXXXGOOOOOOOOOOXXXXXXXXXGOOOOOXXXXXXXXXXXXXXGOOOOOOOOOOOOXXXXXXXGOOOOOOOOOOOOOOXXXXXGOOOOOXXXXXXXXXXXXXX,0,0,0
38787,120,0,120,28,452,0,0,163,89,74,GOOOOOOOOOOOOXXXXXXXGOOOOOOOOXXXXXXXXXXXGOOOOOXXXXXXXXXXXXXXGOOOOOOOOXXXXXXXXXXXGOOOOOOXXXXXXXXXXXXXGOOOOOOOOOOOOXXXXXXXGOOOOOOOOXXXXXXXXXXXGOOXXXXXXXXXXXXXXXXXGOOOOOOOOOOXXXXXXXXXGOOOOOXXXXXXXXXXXXXXGOOOOOOOOOOOOXXXXXXXGOOOOOOOOOOOOOOXXXXXGOOOOOXXXXXXXXXXXXXX,0,0,0
38808,120,0,120,28,452,0,0,163,89,74,GOOOOOOOOOOOOXXXXXXXGOOOOOOOOXXXXXXXXXXXGOOOOOXXXXXXXXXXXXXXGOOOOOOOOXXXXXXXXXXXGOOOOOOXXXXXXXXXXXXXGOOOOOOOOOOOOXXXXXXXGOOOOOOOOXXXXXXXXXXXGOOXXXXXXXXXXXXXXXXXGOOOOOOOOOOXXXXXXXXXGOOOOOXXXXXXXXXXXXXXGOOOOOOOOOOOOXXXXXXXGOOOOOOOOOOOOOOXXXXXGOOOOOXXXXXXXXXXXXXX,0,0,0
38829,120,0,120,28,452,0,0,163,89,74,GOOOOOOOOOOOOXXXXXXXGOOOOOOOOXXXXXXXXXXXGOOOOOXXXXXXXXXXXXXXGOOOOOOOOXXXXXXXXXXXGOOOOOOXXXXXXXXXXXXXGOOOOOOOOOOOOXXXXXXXGOOOOOOOOXXXXXXXXXXXGOOXXXXXXXXXXXXXXXXXGOOOOOOOOOOXXXXXXXXXGOOOOOXXXXXXXXXXXXXXGOOOOOOOOOOOOXXXXXXXGOOOOOOOOOOOOOOXXXXXGOOOOOXXXXXXXXXXXXXX,0,0,0

38850,120,0,120,28,452,0,0,163,92,71,GOOOOOOOOOOOOXXXXXXXGOOOOOOOOXXXXXXXXXXXGOOOOOXXXXXXXXXXXXXXGOOOOOOOOXXXXXXXXXXXGOOOOOOXXXXXXXXXXXXXGOOOOOOOOOOOOXXXXXXXGOOOOOOOOXXXXXXXXXXXGOOXXXXXXXXXXXXXXXXXGOOOOOOOOOOXXXXXXXXXGOOOOOXXXXXXXXXXXXXXGOOOOOOOOOOOOXXXXXXXGOOOOOOOOOOOOOOXXXXXGOOOOOXXXXXXXXXXXXXX,0,0,0
38871,120,0,120,33,447,0,0,156,91,65,GOOOOOOOOOOOOXXXXXXXGOOOOOOOOXXXXXXXXXXXGOOOOOXXXXXXXXXXXXXXGOOOOOOOOXXXXXXXXXXXGOOOOOOXXXXXXXXXXXXXGOOOOOOOOOOOOXXXXXXXGOOOOOOOOXXXXXXXXXXXGOOXXXXXXXXXXXXXXXXXGOOOOOOOOOOXXXXXXXXXGOOOOOXXXXXXXXXXXXXXGOOOOOOOOOOOOXXXXXXXGOOOOOOOOOOOOOOXXXXXGOOOOOXXXXXXXXXXXXXX,0,0,0
38892,120,0,120,31,449,0,0,158,91,67,GOOOOOOOOOOOOXXXXXXXGOOOOOOOOXXXXXXXXXXXGOOOOOXXXXXXXXXXXXXXGOOOOOOOOXXXXXXXXXXXGOOOOOOXXXXXXXXXXXXXGOOOOOOOOOOOOXXXXXXXGOOOOOOOOXXXXXXXXXXXGOOXXXXXXXXXXXXXXXXXGOOOOOOOOOOXXXXXXXXXGOOOOOXXXXXXXXXXXXXXGOOOOOOOOOOOOXXXXXXXGOOOOOOOOOOOOOOXXXXXGOOOOOXXXXXXXXXXXXXX,0,0,0
38913,121,1,120,30,449,0,0,158,91,67,GOOOOOOOOOOOOXXXXXXXGOOOOOOOOXXXXXXXXXXXGOOOOOXXXXXXXXXXXXXXGOOOOOOOOXXXXXXXXXXXGOOOOOOXXXXXXXXXXXXXGOOOOOOOOOOOOXXXXXXXGOOOOOOOOXXXXXXXXXXXGOOXXXXXXXXXXXXXXXXXGOOOOOOOOOOXXXXXXXXXGOOOOOXXXXXXXXXXXXXXGOOOOOOOOOOOOXXXXXXXGOOOOOOOOOOOOOOAXXXXGOOOOOXXXXXXXXXXXXXX,0,0,0
38934,121,0,121,31,448,0,0,157,91,66,GOOOOOOOOOOOOXXXXXXXGOOOOOOOOXXXXXXXXXXXGOOOOOXXXXXXXXXXXXXXGOOOOOOOOXXXXXXXXXXXGOOOOOOXXXXXXXXXXXXXGOOOOOOOOOOOOXXXXXXXGOOOOOOOOXXXXXXXXXXXGOOXXXXXXXXXXXXXXXXXGOOOOOOOOOOXXXXXXXXXGOOOOOXXXXXXXXXXXXXXGOOOOOOOOOOOOXXXXXXXGOOOOOOOOOOOOOOOXXXXGOOOOOXXXXXXXXXXXXXX,0,0,0

38955,121,0,121,31,448,0,0,157,92,65,GOOOOOOOOOOOOXXXXXXXGOOOOOOOOXXXXXXXXXXXGOOOOOXXXXXXXXXXXXXXGOOOOOOOOXXXXXXXXXXXGOOOOOOXXXXXXXXXXXXXGOOOOOOOOOOOOXXXXXXXGOOOOOOOOXXXXXXXXXXXGOOXXXXXXXXXXXXXXXXXGOOOOOOOOOOXXXXXXXXXGOOOOOXXXXXXXXXXXXXXGOOOOOOOOOOOOXXXXXXXGOOOOOOOOOOOOOOOXXXXGOOOOOXXXXXXXXXXXXXX,0,0,0
38976,121,0,121,32,447,0,0,157,92,65,GOOOOOOOOOOOOXXXXXXXGOOOOOOOOXXXXXXXXXXXGOOOOOXXXXXXXXXXXXXXGOOOOOOOOXXXXXXXXXXXGOOOOOOXXXXXXXXXXXXXGOOOOOOOOOOOOXXXXXXXGOOOOOOOOXXXXXXXXXXXGOOXXXXXXXXXXXXXXXXXGOOOOOOOOOOXXXXXXXXXGOOOOOXXXXXXXXXXXXXXGOOOOOOOOOOOOXXXXXXXGOOOOOOOOOOOOOOOXXXXGOOOOOXXXXXXXXXXXXXX,0,0,0
38997,121,0,121,38,441,0,0,152,93,59,GOOOOOOOOOOOOXXXXXXXGOOOOOOOOXXXXXXXXXXXGOOOOOXXXXXXXXXXXXXXGOOOOOOOOXXXXXXXXXXXGOOOOOOXXXXXXXXXXXXXGOOOOOOOOOOOOXXXXXXXGOOOOOOOOXXXXXXXXXXXGOOXXXXXXXXXXXXXXXXXGOOOOOOOOOOXXXXXXXXXGOOOOOXXXXXXXXXXXXXXGOOOOOOOOOOOOXXXXXXXGOOOOOOOOOOOOOOOXXXXGOOOOOXXXXXXXXXXXXXX,0,0,0
39018,121,0,121,36,443,0,0,154,96,58,GOOOOOOOOOOOOXXXXXXXGOOOOOOOOXXXXXXXXXXXGOOOOOXXXXXXXXXXXXXXGOOOOOOOOXXXXXXXXXXXGOOOOOOXXXXXXXXXXXXXGOOOOOOOOOOOOXXXXXXXGOOOOOOOOXXXXXXXXXXXGOOXXXXXXXXXXXXXXXXXGOOOOOOOOOOXXXXXXXXXGOOOOOXXXXXXXXXXXXXXGOOOOOOOOOOOOXXXXXXXGOOOOOOOOOOOOOOOXXXXGOOOOOXXXXXXXXXXXXXX,0,0,0
39039,121,0,121,42,437,0,0,148,93,55,GOOOOOOOOOOOOXXXXXXXGOOOOOOOOXXXXXXXXXXXGOOOOOXXXXXXXXXXXXXXGOOOOOOOOXXXXXXXXXXXGOOOOOOXXXXXXXXXXXXXGOOOOOOOOOOOOXXXXXXXGOOOOOOOOXXXXXXXXXXXGOOXXXXXXXXXXXXXXXXXGOOOOOOOOOOXXXXXXXXXGOOOOOXXXXXXXXXXXXXXGOOOOOOOOOOOOXXXXXXXGOOOOOOOOOOOOOOOXXXXGOOOOOXXXXXXXXXXXXXX,0,0,0

39060,121,0,121,43,436,0,0,146,92,54,GOOOOOOOOOOOOXXXXXXXGOOOOOOOOXXXXXXXXXXXGOOOOOXXXXXXXXXXXXXXGOOOOOOOOXXXXXXXXXXXGOOOOOOXXXXXXXXXXXXXGOOOOOOOOOOOOXXXXXXXGOOOOOOOOXXXXXXXXXXXGOOXXXXXXXXXXXXXXXXXGOOOOOOOOOOXXXXXXXXXGOOOOOXXXXXXXXXXXXXXGOOOOOOOOOOOOXXXXXXXGOOOOOOOOOOOOOOOXXXXGOOOOOXXXXXXXXXXXXXX,0,0,0
39081,121,0,121,47,432,0,0,143,91,52,GOOOOOOOOOOOOXXXXXXXGOOOOOOOOXXXXXXXXXXXGOOOOOXXXXXXXXXXXXXXGOOOOOOOOXXXXXXXXXXXGOOOOOOXXXXXXXXXXXXXGOOOOOOOOOOOOXXXXXXXGOOOOOOOOXXXXXXXXXXXGOOXXXXXXXXXXXXXXXXXGOOOOOOOOOOXXXXXXXXXGOOOOOXXXXXXXXXXXXXXGOOOOOOOOOOOOXXXXXXXGOOOOOOOOOOOOOOOXXXXGOOOOOXXXXXXXXXXXXXX,0,0,0
39102,121,0,121,48,431,0,0,142,91,51,GOOOOOOOOOOOOXXXXXXXGOOOOOOOOXXXXXXXXXXXGOOOOOXXXXXXXXXXXXXXGOOOOOOOOXXXXXXXXXXXGOOOOOOXXXXXXXXXXXXXGOOOOOOOOOOOOXXXXXXXGOOOOOOOOXXXXXXXXXXXGOOXXXXXXXXXXXXXXXXXGOOOOOOOOOOXXXXXXXXXGOOOOOXXXXXXXXXXXXXXGOOOOOOOOOOOOXXXXXXXGOOOOOOOOOOOOOOOXXXXGOOOOOXXXXXXXXXXXXXX,0,0,0
39123,121,0,121,48,431,0,0,142,90,52,GOOOOOOOOOOOOXXXXXXXGOOOOOOOOXXXXXXXXXXXGOOOOOXXXXXXXXXXXXXXGOOOOOOOOXXXXXXXXXXXGOOOOOOXXXXXXXXXXXXXGOOOOOOOOOOOOXXXXXXXGOOOOOOOOXXXXXXXXXXXGOOXXXXXXXXXXXXXXXXXGOOOOOOOOOOXXXXXXXXXGOOOOOXXXXXXXXXXXXXXGOOOOOOOOOOOOXXXXXXXGOOOOOOOOOOOOOOOXXXXGOOOOOXXXXXXXXXXXXXX,0,0,0
39144,121,0,121,43,436,0,0,147,92,55,GOOOOOOOOOOOOXXXXXXXGOOOOOOOOXXXXXXXXXXXGOOOOOXXXXXXXXXXXXXXGOOOOOOOOXXXXXXXXXXXGOOOOOOXXXXXXXXXXXXXGOOOOOOOOOOOOXXXXXXXGOOOOOOOOXXXXXXXXXXXGOOXXXXXXXXXXXXXXXXXGOOOOOOOOOOXXXXXXXXXGOOOOOXXXXXXXXXXXXXXGOOOOOOOOOOOOXXXXXXXGOOOOOOOOOOOOOOOXXXXGOOOOOXXXXXXXXXXXXXX,0,0,0

39165,121,0,121,42,437,0,0,148,90,58,GOOOOOOOOOOOOXXXXXXXGOOOOOOOOXXXXXXXXXXXGOOOOOXXXXXXXXXXXXXXGOOOOOOOOXXXXXXXXXXXGOOOOOOXXXXXXXXXXXXXGOOOOOOOOOOOOXXXXXXXGOOOOOOOOXXXXXXXXXXXGOOXXXXXXXXXXXXXXXXXGOOOOOOOOOOXXXXXXXXXGOOOOOXXXXXXXXXXXXXXGOOOOOOOOOOOOXXXXXXXGOOOOOOOOOOOOOOOXXXXGOOOOOXXXXXXXXXXXXXX,0,0,0
39186,121,0,121,38,441,0,0,152,89,63,GOOOOOOOOOOOOXXXXXXXGOOOOOOOOXXXXXXXXXXXGOOOOOXXXXXXXXXXXXXXGOOOOOOOOXXXXXXXXXXXGOOOOOOXXXXXXXXXXXXXGOOOOOOOOOOOOXXXXXXXGOOOOOOOOXXXXXXXXXXXGOOXXXXXXXXXXXXXXXXXGOOOOOOOOOOXXXXXXXXXGOOOOOXXXXXXXXXXXXXXGOOOOOOOOOOOOXXXXXXXGOOOOOOOOOOOOOOOXXXXGOOOOOXXXXXXXXXXXXXX,0,0,0
39207,121,0,121,33,446,0,0,157,90,67,GOOOOOOOOOOOOXXXXXXXGOOOOOOOOXXXXXXXXXXXGOOOOOXXXXXXXXXXXXXXGOOOOOOOOXXXXXXXXXXXGOOOOOOXXXXXXXXXXXXXGOOOOOOOOOOOOXXXXXXXGOOOOOOOOXXXXXXXXXXXGOOXXXXXXXXXXXXXXXXXGOOOOOOOOOOXXXXXXXXXGOOOOOXXXXXXXXXXXXXXGOOOOOOOOOOOOXXXXXXXGOOOOOOOOOOOOOOOXXXXGOOOOOXXXXXXXXXXXXXX,0,0,0
39228,121,0,121,33,446,0,0,156,91,65,GOOOOOOOOOOOOXXXXXXXGOOOOOOOOXXXXXXXXXXXGOOOOOXXXXXXXXXXXXXXGOOOOOOOOXXXXXXXXXXXGOOOOOOXXXXXXXXXXXXXGOOOOOOOOOOOOXXXXXXXGOOOOOOOOXXXXXXXXXXXGOOXXXXXXXXXXXXXXXXXGOOOOOOOOOOXXXXXXXXXGOOOOOXXXXXXXXXXXXXXGOOOOOOOOOOOOXXXXXXXGOOOOOOOOOOOOOOOXXXXGOOOOOXXXXXXXXXXXXXX,0,0,0
39249,121,0,121,34,445,0,0,155,91,64,GOOOOOOOOOOOOXXXXXXXGOOOOOOOOXXXXXXXXXXXGOOOOOXXXXXXXXXXXXXXGOOOOOOOOXXXXXXXXXXXGOOOOOOXXXXXXXXXXXXXGOOOOOOOOOOOOXXXXXXXGOOOOOOOOXXXXXXXXXXXGOOXXXXXXXXXXXXXXXXXGOOOOOOOOOOXXXXXXXXXGOOOOOXXXXXXXXXXXXXXGOOOOOOOOOOOOXXXXXXXGOOOOOOOOOOOOOOOXXXXGOOOOOXXXXXXXXXXXXXX,0,0,0

39270,121,0,121,32,447,0,0,157,90,67,GOOOOOOOOOOOOXXXXXXXGOOOOOOOOXXXXXXXXXXXGOOOOOXXXXXXXXXXXXXXGOOOOOOOOXXXXXXXXXXXGOOOOOOXXXXXXXXXXXXXGOOOOOOOOOOOOXXXXXXXGOOOOOOOOXXXXXXXXXXXGOOXXXXXXXXXXXXXXXXXGOOOOOOOOOOXXXXXXXXXGOOOOOXXXXXXXXXXXXXXGOOOOOOOOOOOOXXXXXXXGOOOOOOOOOOOOOOOXXXXGOOOOOXXXXXXXXXXXXXX,0,0,0
39291,121,0,121,33,446,0,0,157,88,69,GOOOOOOOOOOOOXXXXXXXGOOOOOOOOXXXXXXXXXXXGOOOOOXXXXXXXXXXXXXXGOOOOOOOOXXXXXXXXXXXGOOOOOOXXXXXXXXXXXXXGOOOOOOOOOOOOXXXXXXXGOOOOOOOOXXXXXXXXXXXGOOXXXXXXXXXXXXXXXXXGOOOOOOOOOOXXXXXXXXXGOOOOOXXXXXXXXXXXXXXGOOOOOOOOOOOOXXXXXXXGOOOOOOOOOOOOOOOXXXXGOOOOOXXXXXXXXXXXXXX,0,0,0
39312,121,0,121,29,450,0,0,160,90,70,GOOOOOOOOOOOOXXXXXXXGOOOOOOOOXXXXXXXXXXXGOOOOOXXXXXXXXXXXXXXGOOOOOOOOXXXXXXXXXXXGOOOOOOXXXXXXXXXXXXXGOOOOOOOOOOOOXXXXXXXGOOOOOOOOXXXXXXXXXXXGOOXXXXXXXXXXXXXXXXXGOOOOOOOOOOXXXXXXXXXGOOOOOXXXXXXXXXXXXXXGOOOOOOOOOOOOXXXXXXXGOOOOOOOOOOOOOOOXXXXGOOOOOXXXXXXXXXXXXXX,0,0,0
39333,121,0,121,30,449,0,0,160,94,66,GOOOOOOOOOOOOXXXXXXXGOOOOOOOOXXXXXXXXXXXGOOOOOXXXXXXXXXXXXXXGOOOOOOOOXXXXXXXXXXXGOOOOOOXXXXXXXXXXXXXGOOOOOOOOOOOOXXXXXXXGOOOOOOOOXXXXXXXXXXXGOOXXXXXXXXXXXXXXXXXGOOOOOOOOOOXXXXXXXXXGOOOOOXXXXXXXXXXXXXXGOOOOOOOOOOOOXXXXXXXGOOOOOOOOOOOOOOOXXXXGOOOOOXXXXXXXXXXXXXX,0,0,0
39354,121,0,121,34,445,0,0,156,90,66,GOOOOOOOOOOOOXXXXXXXGOOOOOOOOXXXXXXXXXXXGOOOOOXXXXXXXXXXXXXXGOOOOOOOOXXXXXXXXXXXGOOOOOOXXXXXXXXXXXXXGOOOOOOOOOOOOXXXXXXXGOOOOOOOOXXXXXXXXXXXGOOXXXXXXXXXXXXXXXXXGOOOOOOOOOOXXXXXXXXXGOOOOOXXXXXXXXXXXXXXGOOOOOOOOOOOOXXXXXXXGOOOOOOOOOOOOOOOXXXXGOOOOOXXXXXXXXXXXXXX,0,0,0

39375,121,0,121,35,444,0,0,155,92,63,GOOOOOOOOOOOOXXXXXXXGOOOOOOOOXXXXXXXXXXXGOOOOOXXXXXXXXXXXXXXGOOOOOOOOXXXXXXXXXXXGOOOOOOXXXXXXXXXXXXXGOOOOOOOOOOOOXXXXXXXGOOOOOOOOXXXXXXXXXXXGOOXXXXXXXXXXXXXXXXXGOOOOOOOOOOXXXXXXXXXGOOOOOXXXXXXXXXXXXXXGOOOOOOOOOOOOXXXXXXXGOOOOOOOOOOOOOOOXXXXGOOOOOXXXXXXXXXXXXXX,0,0,0
39396,121,0,121,33,446,0,0,156,93,63,GOOOOOOOOOOOOXXXXXXXGOOOOOOOOXXXXXXXXXXXGOOOOOXXXXXXXXXXXXXXGOOOOOOOOXXXXXXXXXXXGOOOOOOXXXXXXXXXXXXXGOOOOOOOOOOOOXXXXXXXGOOOOOOOOXXXXXXXXXXXGOOXXXXXXXXXXXXXXXXXGOOOOOOOOOOXXXXXXXXXGOOOOOXXXXXXXXXXXXXXGOOOOOOOOOOOOXXXXXXXGOOOOOOOOOOOOOOOXXXXGOOOOOXXXXXXXXXXXXXX,0,0,0
39417,121,0,121,30,449,0,0,160,94,66,GOOOOOOOOOOOOXXXXXXXGOOOOOOOOXXXXXXXXXXXGOOOOOXXXXXXXXXXXXXXGOOOOOOOOXXXXXXXXXXXGOOOOOOXXXXXXXXXXXXXGOOOOOOOOOOOOXXXXXXXGOOOOOOOOXXXXXXXXXXXGOOXXXXXXXXXXXXXXXXXGOOOOOOOOOOXXXXXXXXXGOOOOOXXXXXXXXXXXXXXGOOOOOOOOOOOOXXXXXXXGOOOOOOOOOOOOOOOXXXXGOOOOOXXXXXXXXXXXXXX,0,0,0
39438,121,0,121,31,448,0,0,159,91,68,GOOOOOOOOOOOOXXXXXXXGOOOOOOOOXXXXXXXXXXXGOOOOOXXXXXXXXXXXXXXGOOOOOOOOXXXXXXXXXXXGOOOOOOXXXXXXXXXXXXXGOOOOOOOOOOOOXXXXXXXGOOOOOOOOXXXXXXXXXXXGOOXXXXXXXXXXXXXXXXXGOOOOOOOOOOXXXXXXXXXGOOOOOXXXXXXXXXXXXXXGOOOOOOOOOOOOXXXXXXXGOOOOOOOOOOOOOOOXXXXGOOOOOXXXXXXXXXXXXXX,0,0,0
39459,121,0,121,34,445,0,0,156,93,63,GOOOOOOOOOOOOXXXXXXXGOOOOOOOOXXXXXXXXXXXGOOOOOXXXXXXXXXXXXXXGOOOOOOOOXXXXXXXXXXXGOOOOOOXXXXXXXXXXXXXGOOOOOOOOOOOOXXXXXXXGOOOOOOOOXXXXXXXXXXXGOOXXXXXXXXXXXXXXXXXGOOOOOOOOOOXXXXXXXXXGOOOOOXXXXXXXXXXXXXXGOOOOOOOOOOOOXXXXXXXGOOOOOOOOOOOOOOOXXXXGOOOOOXXXXXXXXXXXXXX,0,0,0

39480,121,0,121,35,444,0,0,155,93,62,GOOOOOOOOOOOOXXXXXXXGOOOOOOOOXXXXXXXXXXXGOOOOOXXXXXXXXXXXXXXGOOOOOOOOXXXXXXXXXXXGOOOOOOXXXXXXXXXXXXXGOOOOOOOOOOOOXXXXXXXGOOOOOOOOXXXXXXXXXXXGOOXXXXXXXXXXXXXXXXXGOOOOOOOOOOXXXXXXXXXGOOOOOXXXXXXXXXXXXXXGOOOOOOOOOOOOXXXXXXXGOOOOOOOOOOOOOOOXXXXGOOOOOXXXXXXXXXXXXXX,0,0,0
39501,121,0,121,33,446,0,0,157,95,62,GOOOOOOOOOOOOXXXXXXXGOOOOOOOOXXXXXXXXXXXGOOOOOXXXXXXXXXXXXXXGOOOOOOOOXXXXXXXXXXXGOOOOOOXXXXXXXXXXXXXGOOOOOOOOOOOOXXXXXXXGOOOOOOOOXXXXXXXXXXXGOOXXXXXXXXXXXXXXXXXGOOOOOOOOOOXXXXXXXXXGOOOOOXXXXXXXXXXXXXXGOOOOOOOOOOOOXXXXXXXGOOOOOOOOOOOOOOOXXXXGOOOOOXXXXXXXXXXXXXX,0,0,0
39522,121,0,121,33,446,0,0,157,93,64,GOOOOOOOOOOOOXXXXXXXGOOOOOOOOXXXXXXXXXXXGOOOOOXXXXXXXXXXXXXXGOOOOOOOOXXXXXXXXXXXGOOOOOOXXXXXXXXXXXXXGOOOOOOOOOOOOXXXXXXXGOOOOOOOOXXXXXXXXXXXGOOXXXXXXXXXXXXXXXXXGOOOOOOOOOOXXXXXXXXXGOOOOOXXXXXXXXXXXXXXGOOOOOOOOOOOOXXXXXXXGOOOOOOOOOOOOOOOXXXXGOOOOOXXXXXXXXXXXXXX,0,0,0
39543,121,0,121,36,443,0,0,154,91,63,GOOOOOOOOOOOOXXXXXXXGOOOOOOOOXXXXXXXXXXXGOOOOOXXXXXXXXXXXXXXGOOOOOOOOXXXXXXXXXXXGOOOOOOXXXXXXXXXXXXXGOOOOOOOOOOOOXXXXXXXGOOOOOOOOXXXXXXXXXXXGOOXXXXXXXXXXXXXXXXXGOOOOOOOOOOXXXXXXXXXGOOOOOXXXXXXXXXXXXXXGOOOOOOOOOOOOXXXXXXXGOOOOOOOOOOOOOOOXXXXGOOOOOXXXXXXXXXXXXXX,0,0,0
39564,121,0,121,38,441,0,0,152,91,61,GOOOOOOOOOOOOXXXXXXXGOOOOOOOOXXXXXXXXXXXGOOOOOXXXXXXXXXXXXXXGOOOOOOOOXXXXXXXXXXXGOOOOOOXXXXXXXXXXXXXGOOOOOOOOOOOOXXXXXXXGOOOOOOOOXXXXXXXXXXXGOOXXXXXXXXXXXXXXXXXGOOOOOOOOOOXXXXXXXXXGOOOOOXXXXXXXXXXXXXXGOOOOOOOOOOOOXXXXXXXGOOOOOOOOOOOOOOOXXXXGOOOOOXXXXXXXXXXXXXX,0,0,0

39585,121,0,121,39,440,0,0,151,93,58,GOOOOOOOOOOOOXXXXXXXGOOOOOOOOXXXXXXXXXXXGOOOOOXXXXXXXXXXXXXXGOOOOOOOOXXXXXXXXXXXGOOOOOOXXXXXXXXXXXXXGOOOOOOOOOOOOXXXXXXXGOOOOOOOOXXXXXXXXXXXGOOXXXXXXXXXXXXXXXXXGOOOOOOOOOOXXXXXXXXXGOOOOOXXXXXXXXXXXXXXGOOOOOOOOOOOOXXXXXXXGOOOOOOOOOOOOOOOXXXXGOOOOOXXXXXXXXXXXXXX,0,0,0
39606,121,0,121,37,442,0,0,153,96,57,GOOOOOOOOOOOOXXXXXXXGOOOOOOOOXXXXXXXXXXXGOOOOOXXXXXXXXXXXXXXGOOOOOOOOXXXXXXXXXXXGOOOOOOXXXXXXXXXXXXXGOOOOOOOOOOOOXXXXXXXGOOOOOOOOXXXXXXXXXXXGOOXXXXXXXXXXXXXXXXXGOOOOOOOOOOXXXXXXXXXGOOOOOXXXXXXXXXXXXXXGOOOOOOOOOOOOXXXXXXXGOOOOOOOOOOOOOOOXXXXGOOOOOXXXXXXXXXXXXXX,0,0,0
39627,122,1,121,40,438,0,0,148,92,56,GOOOOOOOOOOOOXXXXXXXGOOOOOOOOXXXXXXXXXXXGOOOOOXXXXXXXXXXXXXXGOOOOOOOOXXXXXXXXXXXGOOOOOOXXXXXXXXXXXXXGOOOOOOOOOOOOXXXXXXXGOOOOOOOOXXXXXXXXXXXGOOXXXXXXXXXXXXXXXXXGOOOOOOOOOOXXXXXXXXXGOOOOOXXXXXXXXXXXXXXGOOOOOOOOOOOOAXXXXXXGOOOOOOOOOOOOOOOXXXXGOOOOOXXXXXXXXXXXXXX,0,0,0
39648,122,1,121,42,436,0,0,146,90,56,GOOOOOOOOOOOOXXXXXXXGOOOOOOOOXXXXXXXXXXXGOOOOOXXXXXXXXXXXXXXGOOOOOOOOXXXXXXXXXXXGOOOOOOXXXXXXXXXXXXXGOOOOOOOOOOOOXXXXXXXGOOOOOOOOXXXXXXXXXXXGOOXXXXXXXXXXXXXXXXXGOOOOOOOOOOXXXXXXXXXGOOOOOXXXXXXXXXXXXXXGOOOOOOOOOOOOAXXXXXXGOOOOOOOOOOOOOOOXXXXGOOOOOXXXXXXXXXXXXXX,0,0,0
39669,122,1,121,41,437,0,0,147,96,51,GOOOOOOOOOOOOXXXXXXXGOOOOOOOOXXXXXXXXXXXGOOOOOXXXXXXXXXXXXXXGOOOOOOOOXXXXXXXXXXXGOOOOOOXXXXXXXXXXXXXGOOOOOOOOOOOOXXXXXXXGOOOOOOOOXXXXXXXXXXXGOOXXXXXXXXXXXXXXXXXGOOOOOOOOOOXXXXXXXXXGOOOOOXXXXXXXXXXXXXXGOOOOOOOOOOOOAXXXXXXGOOOOOOOOOOOOOOOXXXXGOOOOOXXXXXXXXXXXXXX,0,0,0

39690,122,1,121,38,440,0,0,148,93,55,GOOOOOOOOOOOOXXXXXXXGOOOOOOOOXXXXXXXXXXXGOOOOOXXXXXXXXXXXXXXGOOOOOOOOXXXXXXXXXXXGOOOOOOXXXXXXXXXXXXXGOOOOOOOOOOOOXXXXXXXGOOOOOOOOXXXXXXXXXXXGOOXXXXXXXXXXXXXXXXXGOOOOOOOOOOXXXXXXXXXGOOOOOXXXXXXXXXXXXXXGOOOOOOOOOOOOAXXXXXXGOOOOOOOOOOOOOOOXXXXGOOOOOXXXXXXXXXXXXXX,0,0,0
39711,122,1,121,37,441,0,0,152,94,58,GOOOOOOOOOOOOXXXXXXXGOOOOOOOOXXXXXXXXXXXGOOOOOXXXXXXXXXXXXXXGOOOOOOOOXXXXXXXXXXXGOOOOOOXXXXXXXXXXXXXGOOOOOOOOOOOOXXXXXXXGOOOOOOOOXXXXXXXXXXXGOOXXXXXXXXXXXXXXXXXGOOOOOOOOOOXXXXXXXXXGOOOOOXXXXXXXXXXXXXXGOOOOOOOOOOOOAXXXXXXGOOOOOOOOOOOOOOOXXXXGOOOOOXXXXXXXXXXXXXX,0,0,0
39732,122,1,121,35,443,0,0,154,91,63,GOOOOOOOOOOOOXXXXXXXGOOOOOOOOXXXXXXXXXXXGOOOOOXXXXXXXXXXXXXXGOOOOOOOOXXXXXXXXXXXGOOOOOOXXXXXXXXXXXXXGOOOOOOOOOOOOXXXXXXXGOOOOOOOOXXXXXXXXXXXGOOXXXXXXXXXXXXXXXXXGOOOOOOOOOOXXXXXXXXXGOOOOOXXXXXXXXXXXXXXGOOOOOOOOOOOOAXXXXXXGOOOOOOOOOOOOOOOXXXXGOOOOOXXXXXXXXXXXXXX,0,0,0
39753,122,1,121,35,443,0,0,154,91,63,GOOOOOOOOOOOOXXXXXXXGOOOOOOOOXXXXXXXXXXXGOOOOOXXXXXXXXXXXXXXGOOOOOOOOXXXXXXXXXXXGOOOOOOXXXXXXXXXXXXXGOOOOOOOOOOOOXXXXXXXGOOOOOOOOXXXXXXXXXXXGOOXXXXXXXXXXXXXXXXXGOOOOOOOOOOXXXXXXXXXGOOOOOXXXXXXXXXXXXXXGOOOOOOOOOOOOAXXXXXXGOOOOOOOOOOOOOOOXXXXGOOOOOXXXXXXXXXXXXXX,0,0,0
39774,122,1,121,34,444,0,0,155,92,63,GOOOOOOOOOOOOXXXXXXXGOOOOOOOOXXXXXXXXXXXGOOOOOXXXXXXXXXXXXXXGOOOOOOOOXXXXXXXXXXXGOOOOOOXXXXXXXXXXXXXGOOOOOOOOOOOOXXXXXXXGOOOOOOOOXXXXXXXXXXXGOOXXXXXXXXXXXXXXXXXGOOOOOOOOOOXXXXXXXXXGOOOOOXXXXXXXXXXXXXXGOOOOOOOOOOOOAXXXXXXGOOOOOOOOOOOOOOOXXXXGOOOOOXXXXXXXXXXXXXX,0,0,0

39795,122,1,121,31,447,0,0,157,91,66,GOOOOOOOOOOOOXXXXXXXGOOOOOOOOXXXXXXXXXXXGOOOOOXXXXXXXXXXXXXXGOOOOOOOOXXXXXXXXXXXGOOOOOOXXXXXXXXXXXXXGOOOOOOOOOOOOXXXXXXXGOOOOOOOOXXXXXXXXXXXGOOXXXXXXXXXXXXXXXXXGOOOOOOOOOOXXXXXXXXXGOOOOOXXXXXXXXXXXXXXGOOOOOOOOOOOOAXXXXXXGOOOOOOOOOOOOOOOXXXXGOOOOOXXXXXXXXXXXXXX,0,0,0
39816,122,1,121,29,449,0,0,159,92,67,GOOOOOOOOOOOOXXXXXXXGOOOOOOOOXXXXXXXXXXXGOOOOOXXXXXXXXXXXXXXGOOOOOOOOXXXXXXXXXXXGOOOOOOXXXXXXXXXXXXXGOOOOOOOOOOOOXXXXXXXGOOOOOOOOXXXXXXXXXXXGOOXXXXXXXXXXXXXXXXXGOOOOOOOOOOXXXXXXXXXGOOOOOXXXXXXXXXXXXXXGOOOOOOOOOOOOAXXXXXXGOOOOOOOOOOOOOOOXXXXGOOOOOXXXXXXXXXXXXXX,0,0,0
39837,122,1,121,28,450,0,0,161,92,69,GOOOOOOOOOOOOXXXXXXXGOOOOOOOOXXXXXXXXXXXGOOOOOXXXXXXXXXXXXXXGOOOOOOOOXXXXXXXXXXXGOOOOOOXXXXXXXXXXXXXGOOOOOOOOOOOOXXXXXXXGOOOOOOOOXXXXXXXXXXXGOOXXXXXXXXXXXXXXXXXGOOOOOOOOOOXXXXXXXXXGOOOOOXXXXXXXXXXXXXXGOOOOOOOOOOOOAXXXXXXGOOOOOOOOOOOOOOOXXXXGOOOOOXXXXXXXXXXXXXX,0,0,0
39858,122,1,121,27,451,0,0,161,93,68,GOOOOOOOOOOOOXXXXXXXGOOOOOOOOXXXXXXXXXXXGOOOOOXXXXXXXXXXXXXXGOOOOOOOOXXXXXXXXXXXGOOOOOOXXXXXXXXXXXXXGOOOOOOOOOOOOXXXXXXXGOOOOOOOOXXXXXXXXXXXGOOXXXXXXXXXXXXXXXXXGOOOOOOOOOOXXXXXXXXXGOOOOOXXXXXXXXXXXXXXGOOOOOOOOOOOOAXXXXXXGOOOOOOOOOOOOOOOXXXXGOOOOOXXXXXXXXXXXXXX,0,0,0
39879,122,1,121,28,450,0,0,160,94,66,GOOOOOOOOOOOOXXXXXXXGOOOOOOOOXXXXXXXXXXXGOOOOOXXXXXXXXXXXXXXGOOOOOOOOXXXXXXXXXXXGOOOOOOXXXXXXXXXXXXXGOOOOOOOOOOOOXXXXXXXGOOOOOOOOXXXXXXXXXXXGOOXXXXXXXXXXXXXXXXXGOOOOOOOOOOXXXXXXXXXGOOOOOXXXXXXXXXXXXXXGOOOOOOOOOOOOAXXXXXXGOOOOOOOOOOOOOOOXXXXGOOOOOXXXXXXXXXXXXXX,0,0,0

39900,122,1,121,29,449,0,0,159,95,64,GOOOOOOOOOOOOXXXXXXXGOOOOOOOOXXXXXXXXXXXGOOOOOXXXXXXXXXXXXXXGOOOOOOOOXXXXXXXXXXXGOOOOOOXXXXXXXXXXXXXGOOOOOOOOOOOOXXXXXXXGOOOOOOOOXXXXXXXXXXXGOOXXXXXXXXXXXXXXXXXGOOOOOOOOOOXXXXXXXXXGOOOOOXXXXXXXXXXXXXXGOOOOOOOOOOOOAXXXXXXGOOOOOOOOOOOOOOOXXXXGOOOOOXXXXXXXXXXXXXX,0,0,0
39921,122,0,122,31,447,0,0,157,95,62,GOOOOOOOOOOOOXXXXXXXGOOOOOOOOXXXXXXXXXXXGOOOOOXXXXXXXXXXXXXXGOOOOOOOOXXXXXXXXXXXGOOOOOOXXXXXXXXXXXXXGOOOOOOOOOOOOXXXXXXXGOOOOOOOOXXXXXXXXXXXGOOXXXXXXXXXXXXXXXXXGOOOOOOOOOOXXXXXXXXXGOOOOOXXXXXXXXXXXXXXGOOOOOOOOOOOOOXXXXXXGOOOOOOOOOOOOOOOXXXXGOOOOOXXXXXXXXXXXXXX,0,0,0
39942,122,0,122,35,443,0,0,153,90,63,GOOOOOOOOOOOOXXXXXXXGOOOOOOOOXXXXXXXXXXXGOOOOOXXXXXXXXXXXXXXGOOOOOOOOXXXXXXXXXXXGOOOOOOXXXXXXXXXXXXXGOOOOOOOOOOOOXXXXXXXGOOOOOOOOXXXXXXXXXXXGOOXXXXXXXXXXXXXXXXXGOOOOOOOOOOXXXXXXXXXGOOOOOXXXXXXXXXXXXXXGOOOOOOOOOOOOOXXXXXXGOOOOOOOOOOOOOOOXXXXGOOOOOXXXXXXXXXXXXXX,0,0,0
39963,122,0,122,35,443,0,0,153,91,62,GOOOOOOOOOOOOXXXXXXXGOOOOOOOOXXXXXXXXXXXGOOOOOXXXXXXXXXXXXXXGOOOOOOOOXXXXXXXXXXXGOOOOOOXXXXXXXXXXXXXGOOOOOOOOOOOOXXXXXXXGOOOOOOOOXXXXXXXXXXXGOOXXXXXXXXXXXXXXXXXGOOOOOOOOOOXXXXXXXXXGOOOOOXXXXXXXXXXXXXXGOOOOOOOOOOOOOXXXXXXGOOOOOOOOOOOOOOOXXXXGOOOOOXXXXXXXXXXXXXX,0,0,0
39984,122,0,122,33,445,0,0,155,91,64,GOOOOOOOOOOOOXXXXXXXGOOOOOOOOXXXXXXXXXXXGOOOOOXXXXXXXXXXXXXXGOOOOOOOOXXXXXXXXXXXGOOOOOOXXXXXXXXXXXXXGOOOOOOOOOOOOXXXXXXXGOOOOOOOOXXXXXXXXXXXGOOXXXXXXXXXXXXXXXXXGOOOOOOOOOOXXXXXXXXXGOOOOOXXXXXXXXXXXXXXGOOOOOOOOOOOOOXXXXXXGOOOOOOOOOOOOOOOXXXXGOOOOOXXXXXXXXXXXXXX,0,0,0

40005,122,0,122,34,444,0,0,153,93,60,GOOOOOOOOOOOOXXXXXXXGOOOOOOOOXXXXXXXXXXXGOOOOOXXXXXXXXXXXXXXGOOOOOOOOXXXXXXXXXXXGOOOOOOXXXXXXXXXXXXXGOOOOOOOOOOOOXXXXXXXGOOOOOOOOXXXXXXXXXXXGOOXXXXXXXXXXXXXXXXXGOOOOOOOOOOXXXXXXXXXGOOOOOXXXXXXXXXXXXXXGOOOOOOOOOOOOOXXXXXXGOOOOOOOOOOOOOOOXXXXGOOOOOXXXXXXXXXXXXXX,0,0,0
40026,122,0,122,33,445,0,0,155,92,63,GOOOOOOOOOOOOXXXXXXXGOOOOOOOOXXXXXXXXXXXGOOOOOXXXXXXXXXXXXXXGOOOOOOOOXXXXXXXXXXXGOOOOOOXXXXXXXXXXXXXGOOOOOOOOOOOOXXXXXXXGOOOOOOOOXXXXXXXXXXXGOOXXXXXXXXXXXXXXXXXGOOOOOOOOOOXXXXXXXXXGOOOOOXXXXXXXXXXXXXXGOOOOOOOOOOOOOXXXXXXGOOOOOOOOOOOOOOOXXXXGOOOOOXXXXXXXXXXXXXX,0,0,0
40047,122,0,122,36,442,0,0,153,94,59,GOOOOOOOOOOOOXXXXXXXGOOOOOOOOXXXXXXXXXXXGOOOOOXXXXXXXXXXXXXXGOOOOOOOOXXXXXXXXXXXGOOOOOOXXXXXXXXXXXXXGOOOOOOOOOOOOXXXXXXXGOOOOOOOOXXXXXXXXXXXGOOXXXXXXXXXXXXXXXXXGOOOOOOOOOOXXXXXXXXXGOOOOOXXXXXXXXXXXXXXGOOOOOOOOOOOOOXXXXXXGOOOOOOOOOOOOOOOXXXXGOOOOOXXXXXXXXXXXXXX,0,0,0
40068,122,0,122,38,440,0,0,151,94,57,GOOOOOOOOOOOOXXXXXXXGOOOOOOOOXXXXXXXXXXXGOOOOOXXXXXXXXXXXXXXGOOOOOOOOXXXXXXXXXXXGOOOOOOXXXXXXXXXXXXXGOOOOOOOOOOOOXXXXXXXGOOOOOOOOXXXXXXXXXXXGOOXXXXXXXXXXXXXXXXXGOOOOOOOOOOXXXXXXXXXGOOOOOXXXXXXXXXXXXXXGOOOOOOOOOOOOOXXXXXXGOOOOOOOOOOOOOOOXXXXGOOOOOXXXXXXXXXXXXXX,0,0,0
40089,122,0,122,39,439,0,0,148,93,55,GOOOOOOOOOOOOXXXXXXXGOOOOOOOOXXXXXXXXXXXGOOOOOXXXXXXXXXXXXXXGOOOOOOOOXXXXXXXXXXXGOOOOOOXXXXXXXXXXXXXGOOOOOOOOOOOOXXXXXXXGOOOOOOOOXXXXXXXXXXXGOOXXXXXXXXXXXXXXXXXGOOOOOOOOOOXXXXXXXXXGOOOOOXXXXXXXXXXXXXXGOOOOOOOOOOOOOXXXXXXGOOOOOOOOOOOOOOOXXXXGOOOOOXXXXXXXXXXXXXX,0,0,0

40110,122,0,122,40,438,0,0,149,92,57,GOOOOOOOOOOOOXXXXXXXGOOOOOOOOXXXXXXXXXXXGOOOOOXXXXXXXXXXXXXXGOOOOOOOOXXXXXXXXXXXGOOOOOOXXXXXXXXXXXXXGOOOOOOOOOOOOXXXXXXXGOOOOOOOOXXXXXXXXXXXGOOXXXXXXXXXXXXXXXXXGOOOOOOOOOOXXXXXXXXXGOOOOOXXXXXXXXXXXXXXGOOOOOOOOOOOOOXXXXXXGOOOOOOOOOOOOOOOXXXXGOOOOOXXXXXXXXXXXXXX,0,0,0
40131,122,0,122,39,439,0,0,150,93,57,GOOOOOOOOOOOOXXXXXXXGOOOOOOOOXXXXXXXXXXXGOOOOOXXXXXXXXXXXXXXGOOOOOOOOXXXXXXXXXXXGOOOOOOXXXXXXXXXXXXXGOOOOOOOOOOOOXXXXXXXGOOOOOOOOXXXXXXXXXXXGOOXXXXXXXXXXXXXXXXXGOOOOOOOOOOXXXXXXXXXGOOOOOXXXXXXXXXXXXXXGOOOOOOOOOOOOOXXXXXXGOOOOOOOOOOOOOOOXXXXGOOOOOXXXXXXXXXXXXXX,0,0,0
40152,122,0,122,40,438,0,0,149,93,56,GOOOOOOOOOOOOXXXXXXXGOOOOOOOOXXXXXXXXXXXGOOOOOXXXXXXXXXXXXXXGOOOOOOOOXXXXXXXXXXXGOOOOOOXXXXXXXXXXXXXGOOOOOOOOOOOOXXXXXXXGOOOOOOOOXXXXXXXXXXXGOOXXXXXXXXXXXXXXXXXGOOOOOOOOOOXXXXXXXXXGOOOOOXXXXXXXXXXXXXXGOOOOOOOOOOOOOXXXXXXGOOOOOOOOOOOOOOOXXXXGOOOOOXXXXXXXXXXXXXX,0,0,0
40173,122,0,122,39,439,0,0,149,94,55,GOOOOOOOOOOOOXXXXXXXGOOOOOOOOXXXXXXXXXXXGOOOOOXXXXXXXXXXXXXXGOOOOOOOOXXXXXXXXXXXGOOOOOOXXXXXXXXXXXXXGOOOOOOOOOOOOXXXXXXXGOOOOOOOOXXXXXXXXXXXGOOXXXXXXXXXXXXXXXXXGOOOOOOOOOOXXXXXXXXXGOOOOOXXXXXXXXXXXXXXGOOOOOOOOOOOOOXXXXXXGOOOOOOOOOOOOOOOXXXXGOOOOOXXXXXXXXXXXXXX,0,0,0
40194,122,0,122,41,437,0,0,147,93,54,GOOOOOOOOOOOOXXXXXXXGOOOOOOOOXXXXXXXXXXXGOOOOOXXXXXXXXXXXXXXGOOOOOOOOXXXXXXXXXXXGOOOOOOXXXXXXXXXXXXXGOOOOOOOOOOOOXXXXXXXGOOOOOOOOXXXXXXXXXXXGOOXXXXXXXXXXXXXXXXXGOOOOOOOOOOXXXXXXXXXGOOOOOXXXXXXXXXXXXXXGOOOOOOOOOOOOOXXXXXXGOOOOOOOOOOOOOOOXXXXGOOOOOXXXXXXXXXXXXXX,0,0,0

40215,122,0,122,40,438,0,0,149,92,57,GOOOOOOOOOOOOXXXXXXXGOOOOOOOOXXXXXXXXXXXGOOOOOXXXXXXXXXXXXXXGOOOOOOOOXXXXXXXXXXXGOOOOOOXXXXXXXXXXXXXGOOOOOOOOOOOOXXXXXXXGOOOOOOOOXXXXXXXXXXXGOOXXXXXXXXXXXXXXXXXGOOOOOOOOOOXXXXXXXXXGOOOOOXXXXXXXXXXXXXXGOOOOOOOOOOOOOXXXXXXGOOOOOOOOOOOOOOOXXXXGOOOOOXXXXXXXXXXXXXX,0,0,0
40236,122,0,122,40,438,0,0,149,91,58,GOOOOOOOOOOOOXXXXXXXGOOOOOOOOXXXXXXXXXXXGOOOOOXXXXXXXXXXXXXXGOOOOOOOOXXXXXXXXXXXGOOOOOOXXXXXXXXXXXXXGOOOOOOOOOOOOXXXXXXXGOOOOOOOOXXXXXXXXXXXGOOXXXXXXXXXXXXXXXXXGOOOOOOOOOOXXXXXXXXXGOOOOOXXXXXXXXXXXXXXGOOOOOOOOOOOOOXXXXXXGOOOOOOOOOOOOOOOXXXXGOOOOOXXXXXXXXXXXXXX,0,0,0
40257,122,0,122,38,440,0,0,150,91,59,GOOOOOOOOOOOOXXXXXXXGOOOOOOOOXXXXXXXXXXXGOOOOOXXXXXXXXXXXXXXGOOOOOOOOXXXXXXXXXXXGOOOOOOXXXXXXXXXXXXXGOOOOOOOOOOOOXXXXXXXGOOOOOOOOXXXXXXXXXXXGOOXXXXXXXXXXXXXXXXXGOOOOOOOOOOXXXXXXXXXGOOOOOXXXXXXXXXXXXXXGOOOOOOOOOOOOOXXXXXXGOOOOOOOOOOOOOOOXXXXGOOOOOXXXXXXXXXXXXXX,0,0,0
40278,122,0,122,38,440,0,0,150,93,57,GOOOOOOOOOOOOXXXXXXXGOOOOOOOOXXXXXXXXXXXGOOOOOXXXXXXXXXXXXXXGOOOOOOOOXXXXXXXXXXXGOOOOOOXXXXXXXXXXXXXGOOOOOOOOOOOOXXXXXXXGOOOOOOOOXXXXXXXXXXXGOOXXXXXXXXXXXXXXXXXGOOOOOOOOOOXXXXXXXXXGOOOOOXXXXXXXXXXXXXXGOOOOOOOOOOOOOXXXXXXGOOOOOOOOOOOOOOOXXXXGOOOOOXXXXXXXXXXXXXX,0,0,0
40299,122,0,122,38,440,0,0,151,92,59,GOOOOOOOOOOOOXXXXXXXGOOOOOOOOXXXXXXXXXXXGOOOOOXXXXXXXXXXXXXXGOOOOOOOOXXXXXXXXXXXGOOOOOOXXXXXXXXXXXXXGOOOOOOOOOOOOXXXXXXXGOOOOOOOOXXXXXXXXXXXGOOXXXXXXXXXXXXXXXXXGOOOOOOOOOOXXXXXXXXXGOOOOOXXXXXXXXXXXXXXGOOOOOOOOOOOOOXXXXXXGOOOOOOOOOOOOOOOXXXXGOOOOOXXXXXXXXXXXXXX,0,0,0

40320,122,0,122,34,444,0,0,155,92,63,GOOOOOOOOOOOOXXXXXXXGOOOOOOOOXXXXXXXXXXXGOOOOOXXXXXXXXXXXXXXGOOOOOOOOXXXXXXXXXXXGOOOOOOXXXXXXXXXXXXXGOOOOOOOOOOOOXXXXXXXGOOOOOOOOXXXXXXXXXXXGOOXXXXXXXXXXXXXXXXXGOOOOOOOOOOXXXXXXXXXGOOOOOXXXXXXXXXXXXXXGOOOOOOOOOOOOOXXXXXXGOOOOOOOOOOOOOOOXXXXGOOOOOXXXXXXXXXXXXXX,0,0,0
40341,122,0,122,33,445,0,0,156,92,64,GOOOOOOOOOOOOXXXXXXXGOOOOOOOOXXXXXXXXXXXGOOOOOXXXXXXXXXXXXXXGOOOOOOOOXXXXXXXXXXXGOOOOOOXXXXXXXXXXXXXGOOOOOOOOOOOOXXXXXXXGOOOOOOOOXXXXXXXXXXXGOOXXXXXXXXXXXXXXXXXGOOOOOOOOOOXXXXXXXXXGOOOOOXXXXXXXXXXXXXXGOOOOOOOOOOOOOXXXXXXGOOOOOOOOOOOOOOOXXXXGOOOOOXXXXXXXXXXXXXX,0,0,0
40362,122,0,122,30,448,0,0,159,93,66,GOOOOOOOOOOOOXXXXXXXGOOOOOOOOXXXXXXXXXXXGOOOOOXXXXXXXXXXXXXXGOOOOOOOOXXXXXXXXXXXGOOOOOOXXXXXXXXXXXXXGOOOOOOOOOOOOXXXXXXXGOOOOOOOOXXXXXXXXXXXGOOXXXXXXXXXXXXXXXXXGOOOOOOOOOOXXXXXXXXXGOOOOOXXXXXXXXXXXXXXGOOOOOOOOOOOOOXXXXXXGOOOOOOOOOOOOOOOXXXXGOOOOOXXXXXXXXXXXXXX,0,0,0
40383,123,0,123,30,447,0,0,158,96,62,GOOOOOOOOOOOOXXXXXXXGOOOOOOOOXXXXXXXXXXXGOOOOOXXXXXXXXXXXXXXGOOOOOOOOOXXXXXXXXXXGOOOOOOXXXXXXXXXXXXXGOOOOOOOOOOOOXXXXXXXGOOOOOOOOXXXXXXXXXXXGOOXXXXXXXXXXXXXXXXXGOOOOOOOOOOXXXXXXXXXGOOOOOXXXXXXXXXXXXXXGOOOOOOOOOOOOOXXXXXXGOOOOOOOOOOOOOOOXXXXGOOOOOXXXXXXXXXXXXXX,0,0,0
40404,123,0,123,32,445,0,0,155,94,61,GOOOOOOOOOOOOXXXXXXXGOOOOOOOOXXXXXXXXXXXGOOOOOXXXXXXXXXXXXXXGOOOOOOOOOXXXXXXXXXXGOOOOOOXXXXXXXXXXXXXGOOOOOOOOOOOOXXXXXXXGOOOOOOOOXXXXXXXXXXXGOOXXXXXXXXXXXXXXXXXGOOOOOOOOOOXXXXXXXXXGOOOOOXXXXXXXXXXXXXXGOOOOOOOOOOOOOXXXXXXGOOOOOOOOOOOOOOOXXXXGOOOOOXXXXXXXXXXXXXX,0,0,0

40425,123,0,123,33,444,0,0,153,90,63,GOOOOOOOOOOOOXXXXXXXGOOOOOOOOXXXXXXXXXXXGOOOOOXXXXXXXXXXXXXXGOOOOOOOOOXXXXXXXXXXGOOOOOOXXXXXXXXXXXXXGOOOOOOOOOOOOXXXXXXXGOOOOOOOOXXXXXXXXXXXGOOXXXXXXXXXXXXXXXXXGOOOOOOOOOOXXXXXXXXXGOOOOOXXXXXXXXXXXXXXGOOOOOOOOOOOOOXXXXXXGOOOOOOOOOOOOOOOXXXXGOOOOOXXXXXXXXXXXXXX,0,0,0
40446,123,0,123,33,444,0,0,155,92,63,GOOOOOOOOOOOOXXXXXXXGOOOOOOOOXXXXXXXXXXXGOOOOOXXXXXXXXXXXXXXGOOOOOOOOOXXXXXXXXXXGOOOOOOXXXXXXXXXXXXXGOOOOOOOOOOOOXXXXXXXGOOOOOOOOXXXXXXXXXXXGOOXXXXXXXXXXXXXXXXXGOOOOOOOOOOXXXXXXXXXGOOOOOXXXXXXXXXXXXXXGOOOOOOOOOOOOOXXXXXXGOOOOOOOOOOOOOOOXXXXGOOOOOXXXXXXXXXXXXXX,0,0,0
40467,123,0,123,29,448,0,0,159,93,66,GOOOOOOOOOOOOXXXXXXXGOOOOOOOOXXXXXXXXXXXGOOOOOXXXXXXXXXXXXXXGOOOOOOOOOXXXXXXXXXXGOOOOOOXXXXXXXXXXXXXGOOOOOOOOOOOOXXXXXXXGOOOOOOOOXXXXXXXXXXXGOOXXXXXXXXXXXXXXXXXGOOOOOOOOOOXXXXXXXXXGOOOOOXXXXXXXXXXXXXXGOOOOOOOOOOOOOXXXXXXGOOOOOOOOOOOOOOOXXXXGOOOOOXXXXXXXXXXXXXX,0,0,0
40488,123,0,123,31,446,0,0,157,93,64,GOOOOOOOOOOOOXXXXXXXGOOOOOOOOXXXXXXXXXXXGOOOOOXXXXXXXXXXXXXXGOOOOOOOOOXXXXXXXXXXGOOOOOOXXXXXXXXXXXXXGOOOOOOOOOOOOXXXXXXXGOOOOOOOOXXXXXXXXXXXGOOXXXXXXXXXXXXXXXXXGOOOOOOOOOOXXXXXXXXXGOOOOOXXXXXXXXXXXXXXGOOOOOOOOOOOOOXXXXXXGOOOOOOOOOOOOOOOXXXXGOOOOOXXXXXXXXXXXXXX,0,0,0
40509,123,0,123,32,445,0,0,156,92,64,GOOOOOOOOOOOOXXXXXXXGOOOOOOOOXXXXXXXXXXXGOOOOOXXXXXXXXXXXXXXGOOOOOOOOOXXXXXXXXXXGOOOOOOXXXXXXXXXXXXXGOOOOOOOOOOOOXXXXXXXGOOOOOOOOXXXXXXXXXXXGOOXXXXXXXXXXXXXXXXXGOOOOOOOOOOXXXXXXXXXGOOOOOXXXXXXXXXXXXXXGOOOOOOOOOOOOOXXXXXXGOOOOOOOOOOOOOOOXXXXGOOOOOXXXXXXXXXXXXXX,0,0,0

40530,123,0,123,30,447,0,0,157,95,62,GOOOOOOOOOOOOXXXXXXXGOOOOOOOOXXXXXXXXXXXGOOOOOXXXXXXXXXXXXXXGOOOOOOOOOXXXXXXXXXXGOOOOOOXXXXXXXXXXXXXGOOOOOOOOOOOOXXXXXXXGOOOOOOOOXXXXXXXXXXXGOOXXXXXXXXXXXXXXXXXGOOOOOOOOOOXXXXXXXXXGOOOOOXXXXXXXXXXXXXXGOOOOOOOOOOOOOXXXXXXGOOOOOOOOOOOOOOOXXXXGOOOOOXXXXXXXXXXXXXX,0,0,0
40551,123,0,123,33,444,0,0,154,95,59,GOOOOOOOOOOOOXXXXXXXGOOOOOOOOXXXXXXXXXXXGOOOOOXXXXXXXXXXXXXXGOOOOOOOOOXXXXXXXXXXGOOOOOOXXXXXXXXXXXXXGOOOOOOOOOOOOXXXXXXXGOOOOOOOOXXXXXXXXXXXGOOXXXXXXXXXXXXXXXXXGOOOOOOOOOOXXXXXXXXXGOOOOOXXXXXXXXXXXXXXGOOOOOOOOOOOOOXXXXXXGOOOOOOOOOOOOOOOXXXXGOOOOOXXXXXXXXXXXXXX,0,0,0
40572,123,0,123,32,445,0,0,154,96,58,GOOOOOOOOOOOOXXXXXXXGOOOOOOOOXXXXXXXXXXXGOOOOOXXXXXXXXXXXXXXGOOOOOOOOOXXXXXXXXXXGOOOOOOXXXXXXXXXXXXXGOOOOOOOOOOOOXXXXXXXGOOOOOOOOXXXXXXXXXXXGOOXXXXXXXXXXXXXXXXXGOOOOOOOOOOXXXXXXXXXGOOOOOXXXXXXXXXXXXXXGOOOOOOOOOOOOOXXXXXXGOOOOOOOOOOOOOOOXXXXGOOOOOXXXXXXXXXXXXXX,0,0,0
40593,123,0,123,36,441,0,0,150,94,56,GOOOOOOOOOOOOXXXXXXXGOOOOOOOOXXXXXXXXXXXGOOOOOXXXXXXXXXXXXXXGOOOOOOOOOXXXXXXXXXXGOOOOOOXXXXXXXXXXXXXGOOOOOOOOOOOOXXXXXXXGOOOOOOOOXXXXXXXXXXXGOOXXXXXXXXXXXXXXXXXGOOOOOOOOOOXXXXXXXXXGOOOOOXXXXXXXXXXXXXXGOOOOOOOOOOOOOXXXXXXGOOOOOOOOOOOOOOOXXXXGOOOOOXXXXXXXXXXXXXX,0,0,0
40614,123,0,123,38,439,0,0,149,91,58,GOOOOOOOOOOOOXXXXXXXGOOOOOOOOXXXXXXXXXXXGOOOOOXXXXXXXXXXXXXXGOOOOOOOOOXXXXXXXXXXGOOOOOOXXXXXXXXXXXXXGOOOOOOOOOOOOXXXXXXXGOOOOOOOOXXXXXXXXXXXGOOXXXXXXXXXXXXXXXXXGOOOOOOOOOOXXXXXXXXXGOOOOOXXXXXXXXXXXXXXGOOOOOOOOOOOOOXXXXXXGOOOOOOOOOOOOOOOXXXXGOOOOOXXXXXXXXXXXXXX,0,0,0

40635,123,0,123,34,443,0,0,153,91,62,GOOOOOOOOOOOOXXXXXXXGOOOOOOOOXXXXXXXXXXXGOOOOOXXXXXXXXXXXXXXGOOOOOOOOOXXXXXXXXXXGOOOOOOXXXXXXXXXXXXXGOOOOOOOOOOOOXXXXXXXGOOOOOOOOXXXXXXXXXXXGOOXXXXXXXXXXXXXXXXXGOOOOOOOOOOXXXXXXXXXGOOOOOXXXXXXXXXXXXXXGOOOOOOOOOOOOOXXXXXXGOOOOOOOOOOOOOOOXXXXGOOOOOXXXXXXXXXXXXXX,0,0,0
40656,123,0,123,35,442,0,0,152,93,59,GOOOOOOOOOOOOXXXXXXXGOOOOOOOOXXXXXXXXXXXGOOOOOXXXXXXXXXXXXXXGOOOOOOOOOXXXXXXXXXXGOOOOOOXXXXXXXXXXXXXGOOOOOOOOOOOOXXXXXXXGOOOOOOOOXXXXXXXXXXXGOOXXXXXXXXXXXXXXXXXGOOOOOOOOOOXXXXXXXXXGOOOOOXXXXXXXXXXXXXXGOOOOOOOOOOOOOXXXXXXGOOOOOOOOOOOOOOOXXXXGOOOOOXXXXXXXXXXXXXX,0,0,0
40677,123,0,123,38,439,0,0,148,92,56,GOOOOOOOOOOOOXXXXXXXGOOOOOOOOXXXXXXXXXXXGOOOOOXXXXXXXXXXXXXXGOOOOOOOOOXXXXXXXXXXGOOOOOOXXXXXXXXXXXXXGOOOOOOOOOOOOXXXXXXXGOOOOOOOOXXXXXXXXXXXGOOXXXXXXXXXXXXXXXXXGOOOOOOOOOOXXXXXXXXXGOOOOOXXXXXXXXXXXXXXGOOOOOOOOOOOOOXXXXXXGOOOOOOOOOOOOOOOXXXXGOOOOOXXXXXXXXXXXXXX,0,0,0
40698,123,0,123,38,439,0,0,149,94,55,GOOOOOOOOOOOOXXXXXXXGOOOOOOOOXXXXXXXXXXXGOOOOOXXXXXXXXXXXXXXGOOOOOOOOOXXXXXXXXXXGOOOOOOXXXXXXXXXXXXXGOOOOOOOOOOOOXXXXXXXGOOOOOOOOXXXXXXXXXXXGOOXXXXXXXXXXXXXXXXXGOOOOOOOOOOXXXXXXXXXGOOOOOXXXXXXXXXXXXXXGOOOOOOOOOOOOOXXXXXXGOOOOOOOOOOOOOOOXXXXGOOOOOXXXXXXXXXXXXXX,0,0,0
40719,123,0,123,41,436,0,0,146,93,53,GOOOOOOOOOOOOXXXXXXXGOOOOOOOOXXXXXXXXXXXGOOOOOXXXXXXXXXXXXXXGOOOOOOOOOXXXXXXXXXXGOOOOOOXXXXXXXXXXXXXGOOOOOOOOOOOOXXXXXXXGOOOOOOOOXXXXXXXXXXXGOOXXXXXXXXXXXXXXXXXGOOOOOOOOOOXXXXXXXXXGOOOOOXXXXXXXXXXXXXXGOOOOOOOOOOOOOXXXXXXGOOOOOOOOOOOOOOOXXXXGOOOOOXXXXXXXXXXXXXX,0,0,0

40740,123,0,123,38,439,0,0,149,94,55,GOOOOOOOOOOOOXXXXXXXGOOOOOOOOXXXXXXXXXXXGOOOOOXXXXXXXXXXXXXXGOOOOOOOOOXXXXXXXXXXGOOOOOOXXXXXXXXXXXXXGOOOOOOOOOOOOXXXXXXXGOOOOOOOOXXXXXXXXXXXGOOXXXXXXXXXXXXXXXXXGOOOOOOOOOOXXXXXXXXXGOOOOOXXXXXXXXXXXXXXGOOOOOOOOOOOOOXXXXXXGOOOOOOOOOOOOOOOXXXXGOOOOOXXXXXXXXXXXXXX,0,0,0
40761,123,0,123,39,438,0,0,148,95,53,GOOOOOOOOOOOOXXXXXXXGOOOOOOOOXXXXXXXXXXXGOOOOOXXXXXXXXXXXXXXGOOOOOOOOOXXXXXXXXXXGOOOOOOXXXXXXXXXXXXXGOOOOOOOOOOOOXXXXXXXGOOOOOOOOXXXXXXXXXXXGOOXXXXXXXXXXXXXXXXXGOOOOOOOOOOXXXXXXXXXGOOOOOXXXXXXXXXXXXXXGOOOOOOOOOOOOOXXXXXXGOOOOOOOOOOOOOOOXXXXGOOOOOXXXXXXXXXXXXXX,0,0,0
40782,123,0,123,39,438,0,0,148,92,56,GOOOOOOOOOOOOXXXXXXXGOOOOOOOOXXXXXXXXXXXGOOOOOXXXXXXXXXXXXXXGOOOOOOOOOXXXXXXXXXXGOOOOOOXXXXXXXXXXXXXGOOOOOOOOOOOOXXXXXXXGOOOOOOOOXXXXXXXXXXXGOOXXXXXXXXXXXXXXXXXGOOOOOOOOOOXXXXXXXXXGOOOOOXXXXXXXXXXXXXXGOOOOOOOOOOOOOXXXXXXGOOOOOOOOOOOOOOOXXXXGOOOOOXXXXXXXXXXXXXX,0,0,0
40803,123,0,123,36,441,0,0,152,96,56,GOOOOOOOOOOOOXXXXXXXGOOOOOOOOXXXXXXXXXXXGOOOOOXXXXXXXXXXXXXXGOOOOOOOOOXXXXXXXXXXGOOOOOOXXXXXXXXXXXXXGOOOOOOOOOOOOXXXXXXXGOOOOOOOOXXXXXXXXXXXGOOXXXXXXXXXXXXXXXXXGOOOOOOOOOOXXXXXXXXXGOOOOOXXXXXXXXXXXXXXGOOOOOOOOOOOOOXXXXXXGOOOOOOOOOOOOOOOXXXXGOOOOOXXXXXXXXXXXXXX,0,0,0
40824,123,0,123,39,438,0,0,149,93,56,GOOOOOOOOOOOOXXXXXXXGOOOOOOOOXXXXXXXXXXXGOOOOOXXXXXXXXXXXXXXGOOOOOOOOOXXXXXXXXXXGOOOOOOXXXXXXXXXXXXXGOOOOOOOOOOOOXXXXXXXGOOOOOOOOXXXXXXXXXXXGOOXXXXXXXXXXXXXXXXXGOOOOOOOOOOXXXXXXXXXGOOOOOXXXXXXXXXXXXXXGOOOOOOOOOOOOOXXXXXXGOOOOOOOOOOOOOOOXXXXGOOOOOXXXXXXXXXXXXXX,0,0,0

40845,123,0,123,41,436,0,0,148,93,55,GOOOOOOOOOOOOXXXXXXXGOOOOOOOOXXXXXXXXXXXGOOOOOXXXXXXXXXXXXXXGOOOOOOOOOXXXXXXXXXXGOOOOOOXXXXXXXXXXXXXGOOOOOOOOOOOOXXXXXXXGOOOOOOOOXXXXXXXXXXXGOOXXXXXXXXXXXXXXXXXGOOOOOOOOOOXXXXXXXXXGOOOOOXXXXXXXXXXXXXXGOOOOOOOOOOOOOXXXXXXGOOOOOOOOOOOOOOOXXXXGOOOOOXXXXXXXXXXXXXX,0,0,0
40866,123,0,123,40,437,0,0,149,96,53,GOOOOOOOOOOOOXXXXXXXGOOOOOOOOXXXXXXXXXXXGOOOOOXXXXXXXXXXXXXXGOOOOOOOOOXXXXXXXXXXGOOOOOOXXXXXXXXXXXXXGOOOOOOOOOOOOXXXXXXXGOOOOOOOOXXXXXXXXXXXGOOXXXXXXXXXXXXXXXXXGOOOOOOOOOOXXXXXXXXXGOOOOOXXXXXXXXXXXXXXGOOOOOOOOOOOOOXXXXXXGOOOOOOOOOOOOOOOXXXXGOOOOOXXXXXXXXXXXXXX,0,0,0
40887,123,0,123,43,434,0,0,146,93,53,GOOOOOOOOOOOOXXXXXXXGOOOOOOOOXXXXXXXXXXXGOOOOOXXXXXXXXXXXXXXGOOOOOOOOOXXXXXXXXXXGOOOOOOXXXXXXXXXXXXXGOOOOOOOOOOOOXXXXXXXGOOOOOOOOXXXXXXXXXXXGOOXXXXXXXXXXXXXXXXXGOOOOOOOOOOXXXXXXXXXGOOOOOXXXXXXXXXXXXXXGOOOOOOOOOOOOOXXXXXXGOOOOOOOOOOOOOOOXXXXGOOOOOXXXXXXXXXXXXXX,0,0,0
40908,123,0,123,44,433,0,0,144,90,54,GOOOOOOOOOOOOXXXXXXXGOOOOOOOOXXXXXXXXXXXGOOOOOXXXXXXXXXXXXXXGOOOOOOOOOXXXXXXXXXXGOOOOOOXXXXXXXXXXXXXGOOOOOOOOOOOOXXXXXXXGOOOOOOOOXXXXXXXXXXXGOOXXXXXXXXXXXXXXXXXGOOOOOOOOOOXXXXXXXXXGOOOOOXXXXXXXXXXXXXXGOOOOOOOOOOOOOXXXXXXGOOOOOOOOOOOOOOOXXXXGOOOOOXXXXXXXXXXXXXX,0,0,0
40929,123,0,123,41,436,0,0,147,91,56,GOOOOOOOOOOOOXXXXXXXGOOOOOOOOXXXXXXXXXXXGOOOOOXXXXXXXXXXXXXXGOOOOOOOOOXXXXXXXXXXGOOOOOOXXXXXXXXXXXXXGOOOOOOOOOOOOXXXXXXXGOOOOOOOOXXXXXXXXXXXGOOXXXXXXXXXXXXXXXXXGOOOOOOOOOOXXXXXXXXXGOOOOOXXXXXXXXXXXXXXGOOOOOOOOOOOOOXXXXXXGOOOOOOOOOOOOOOOXXXXGOOOOOXXXXXXXXXXXXXX,0,0,0

40950,123,0,123,38,439,0,0,150,92,58,GOOOOOOOOOOOOXXXXXXXGOOOOOOOOXXXXXXXXXXXGOOOOOXXXXXXXXXXXXXXGOOOOOOOOOXXXXXXXXXXGOOOOOOXXXXXXXXXXXXXGOOOOOOOOOOOOXXXXXXXGOOOOOOOOXXXXXXXXXXXGOOXXXXXXXXXXXXXXXXXGOOOOOOOOOOXXXXXXXXXGOOOOOXXXXXXXXXXXXXXGOOOOOOOOOOOOOXXXXXXGOOOOOOOOOOOOOOOXXXXGOOOOOXXXXXXXXXXXXXX,0,0,0
40971,123,0,123,31,446,0,0,158,93,65,GOOOOOOOOOOOOXXXXXXXGOOOOOOOOXXXXXXXXXXXGOOOOOXXXXXXXXXXXXXXGOOOOOOOOOXXXXXXXXXXGOOOOOOXXXXXXXXXXXXXGOOOOOOOOOOOOXXXXXXXGOOOOOOOOXXXXXXXXXXXGOOXXXXXXXXXXXXXXXXXGOOOOOOOOOOXXXXXXXXXGOOOOOXXXXXXXXXXXXXXGOOOOOOOOOOOOOXXXXXXGOOOOOOOOOOOOOOOXXXXGOOOOOXXXXXXXXXXXXXX,0,0,0
40992,123,0,123,27,450,0,0,162,91,71,GOOOOOOOOOOOOXXXXXXXGOOOOOOOOXXXXXXXXXXXGOOOOOXXXXXXXXXXXXXXGOOOOOOOOOXXXXXXXXXXGOOOOOOXXXXXXXXXXXXXGOOOOOOOOOOOOXXXXXXXGOOOOOOOOXXXXXXXXXXXGOOXXXXXXXXXXXXXXXXXGOOOOOOOOOOXXXXXXXXXGOOOOOXXXXXXXXXXXXXXGOOOOOOOOOOOOOXXXXXXGOOOOOOOOOOOOOOOXXXXGOOOOOXXXXXXXXXXXXXX,0,0,0
41013,123,0,123,27,450,0,0,161,93,68,GOOOOOOOOOOOOXXXXXXXGOOOOOOOOXXXXXXXXXXXGOOOOOXXXXXXXXXXXXXXGOOOOOOOOOXXXXXXXXXXGOOOOOOXXXXXXXXXXXXXGOOOOOOOOOOOOXXXXXXXGOOOOOOOOXXXXXXXXXXXGOOXXXXXXXXXXXXXXXXXGOOOOOOOOOOXXXXXXXXXGOOOOOXXXXXXXXXXXXXXGOOOOOOOOOOOOOXXXXXXGOOOOOOOOOOOOOOOXXXXGOOOOOXXXXXXXXXXXXXX,0,0,0
41034,123,0,123,28,449,0,0,161,93,68,GOOOOOOOOOOOOXXXXXXXGOOOOOOOOXXXXXXXXXXXGOOOOOXXXXXXXXXXXXXXGOOOOOOOOOXXXXXXXXXXGOOOOOOXXXXXXXXXXXXXGOOOOOOOOOOOOXXXXXXXGOOOOOOOOXXXXXXXXXXXGOOXXXXXXXXXXXXXXXXXGOOOOOOOOOOXXXXXXXXXGOOOOOXXXXXXXXXXXXXXGOOOOOOOOOOOOOXXXXXXGOOOOOOOOOOOOOOOXXXXGOOOOOXXXXXXXXXXXXXX,0,0,0

41055,123,0,123,28,449,0,0,160,92,68,GOOOOOOOOOOOOXXXXXXXGOOOOOOOOXXXXXXXXXXXGOOOOOXXXXXXXXXXXXXXGOOOOOOOOOXXXXXXXXXXGOOOOOOXXXXXXXXXXXXXGOOOOOOOOOOOOXXXXXXXGOOOOOOOOXXXXXXXXXXXGOOXXXXXXXXXXXXXXXXXGOOOOOOOOOOXXXXXXXXXGOOOOOXXXXXXXXXXXXXXGOOOOOOOOOOOOOXXXXXXGOOOOOOOOOOOOOOOXXXXGOOOOOXXXXXXXXXXXXXX,0,0,0
41076,123,0,123,27,450,0,0,161,95,66,GOOOOOOOOOOOOXXXXXXXGOOOOOOOOXXXXXXXXXXXGOOOOOXXXXXXXXXXXXXXGOOOOOOOOOXXXXXXXXXXGOOOOOOXXXXXXXXXXXXXGOOOOOOOOOOOOXXXXXXXGOOOOOOOOXXXXXXXXXXXGOOXXXXXXXXXXXXXXXXXGOOOOOOOOOOXXXXXXXXXGOOOOOXXXXXXXXXXXXXXGOOOOOOOOOOOOOXXXXXXGOOOOOOOOOOOOOOOXXXXGOOOOOXXXXXXXXXXXXXX,0,0,0
41097,123,0,123,30,447,0,0,159,94,65,GOOOOOOOOOOOOXXXXXXXGOOOOOOOOXXXXXXXXXXXGOOOOOXXXXXXXXXXXXXXGOOOOOOOOOXXXXXXXXXXGOOOOOOXXXXXXXXXXXXXGOOOOOOOOOOOOXXXXXXXGOOOOOOOOXXXXXXXXXXXGOOXXXXXXXXXXXXXXXXXGOOOOOOOOOOXXXXXXXXXGOOOOOXXXXXXXXXXXXXXGOOOOOOOOOOOOOXXXXXXGOOOOOOOOOOOOOOOXXXXGOOOOOXXXXXXXXXXXXXX,0,0,0
41118,124,1,123,30,446,0,0,158,92,66,GOOOOOOOOOOOOXXXXXXXGOOOOOOOOXXXXXXXXXXXGOOOOOXXXXXXXXXXXXXXGOOOOOOOOOAXXXXXXXXXGOOOOOOXXXXXXXXXXXXXGOOOOOOOOOOOOXXXXXXXGOOOOOOOOXXXXXXXXXXXGOOXXXXXXXXXXXXXXXXXGOOOOOOOOOOXXXXXXXXXGOOOOOXXXXXXXXXXXXXXGOOOOOOOOOOOOOXXXXXXGOOOOOOOOOOOOOOOXXXXGOOOOOXXXXXXXXXXXXXX,0,0,0
41139,124,1,123,29,447,0,0,159,94,65,GOOOOOOOOOOOOXXXXXXXGOOOOOOOOXXXXXXXXXXXGOOOOOXXXXXXXXXXXXXXGOOOOOOOOOAXXXXXXXXXGOOOOOOXXXXXXXXXXXXXGOOOOOOOOOOOOXXXXXXXGOOOOOOOOXXXXXXXXXXXGOOXXXXXXXXXXXXXXXXXGOOOOOOOOOOXXXXXXXXXGOOOOOXXXXXXXXXXXXXXGOOOOOOOOOOOOOXXXXXXGOOOOOOOOOOOOOOOXXXXGOOOOOXXXXXXXXXXXXXX,0,0,0

41160,124,1,123,33,443,0,0,155,92,63,GOOOOOOOOOOOOXXXXXXXGOOOOOOOOXXXXXXXXXXXGOOOOOXXXXXXXXXXXXXXGOOOOOOOOOAXXXXXXXXXGOOOOOOXXXXXXXXXXXXXGOOOOOOOOOOOOXXXXXXXGOOOOOOOOXXXXXXXXXXXGOOXXXXXXXXXXXXXXXXXGOOOOOOOOOOXXXXXXXXXGOOOOOXXXXXXXXXXXXXXGOOOOOOOOOOOOOXXXXXXGOOOOOOOOOOOOOOOXXXXGOOOOOXXXXXXXXXXXXXX,0,0,0
41181,124,1,123,30,446,0,0,157,92,65,GOOOOOOOOOOOOXXXXXXXGOOOOOOOOXXXXXXXXXXXGOOOOOXXXXXXXXXXXXXXGOOOOOOOOOAXXXXXXXXXGOOOOOOXXXXXXXXXXXXXGOOOOOOOOOOOOXXXXXXXGOOOOOOOOXXXXXXXXXXXGOOXXXXXXXXXXXXXXXXXGOOOOOOOOOOXXXXXXXXXGOOOOOXXXXXXXXXXXXXXGOOOOOOOOOOOOOXXXXXXGOOOOOOOOOOOOOOOXXXXGOOOOOXXXXXXXXXXXXXX,0,0,0
41202,124,0,124,26,450,0,0,161,93,68,GOOOOOOOOOOOOXXXXXXXGOOOOOOOOXXXXXXXXXXXGOOOOOXXXXXXXXXXXXXXGOOOOOOOOOOXXXXXXXXXGOOOOOOXXXXXXXXXXXXXGOOOOOOOOOOOOXXXXXXXGOOOOOOOOXXXXXXXXXXXGOOXXXXXXXXXXXXXXXXXGOOOOOOOOOOXXXXXXXXXGOOOOOXXXXXXXXXXXXXXGOOOOOOOOOOOOOXXXXXXGOOOOOOOOOOOOOOOXXXXGOOOOOXXXXXXXXXXXXXX,0,0,0
41223,124,0,124,23,453,0,0,164,96,68,GOOOOOOOOOOOOXXXXXXXGOOOOOOOOXXXXXXXXXXXGOOOOOXXXXXXXXXXXXXXGOOOOOOOOOOXXXXXXXXXGOOOOOOXXXXXXXXXXXXXGOOOOOOOOOOOOXXXXXXXGOOOOOOOOXXXXXXXXXXXGOOXXXXXXXXXXXXXXXXXGOOOOOOOOOOXXXXXXXXXGOOOOOXXXXXXXXXXXXXXGOOOOOOOOOOOOOXXXXXXGOOOOOOOOOOOOOOOXXXXGOOOOOXXXXXXXXXXXXXX,0,0,0
41244,124,0,124,24,452,0,0,163,94,69,GOOOOOOOOOOOOXXXXXXXGOOOOOOOOXXXXXXXXXXXGOOOOOXXXXXXXXXXXXXXGOOOOOOOOOOXXXXXXXXXGOOOOOOXXXXXXXXXXXXXGOOOOOOOOOOOOXXXXXXXGOOOOOOOOXXXXXXXXXXXGOOXXXXXXXXXXXXXXXXXGOOOOOOOOOOXXXXXXXXXGOOOOOXXXXXXXXXXXXXXGOOOOOOOOOOOOOXXXXXXGOOOOOOOOOOOOOOOXXXXGOOOOOXXXXXXXXXXXXXX,0,0,0

41265,124,0,124,27,449,0,0,160,94,66,GOOOOOOOOOOOOXXXXXXXGOOOOOOOOXXXXXXXXXXXGOOOOOXXXXXXXXXXXXXXGOOOOOOOOOOXXXXXXXXXGOOOOOOXXXXXXXXXXXXXGOOOOOOOOOOOOXXXXXXXGOOOOOOOOXXXXXXXXXXXGOOXXXXXXXXXXXXXXXXXGOOOOOOOOOOXXXXXXXXXGOOOOOXXXXXXXXXXXXXXGOOOOOOOOOOOOOXXXXXXGOOOOOOOOOOOOOOOXXXXGOOOOOXXXXXXXXXXXXXX,0,0,0
41286,124,0,124,24,452,0,0,163,93,70,GOOOOOOOOOOOOXXXXXXXGOOOOOOOOXXXXXXXXXXXGOOOOOXXXXXXXXXXXXXXGOOOOOOOOOOXXXXXXXXXGOOOOOOXXXXXXXXXXXXXGOOOOOOOOOOOOXXXXXXXGOOOOOOOOXXXXXXXXXXXGOOXXXXXXXXXXXXXXXXXGOOOOOOOOOOXXXXXXXXXGOOOOOXXXXXXXXXXXXXXGOOOOOOOOOOOOOXXXXXXGOOOOOOOOOOOOOOOXXXXGOOOOOXXXXXXXXXXXXXX,0,0,0
41307,124,0,124,26,450,0,0,161,93,68,GOOOOOOOOOOOOXXXXXXXGOOOOOOOOXXXXXXXXXXXGOOOOOXXXXXXXXXXXXXXGOOOOOOOOOOXXXXXXXXXGOOOOOOXXXXXXXXXXXXXGOOOOOOOOOOOOXXXXXXXGOOOOOOOOXXXXXXXXXXXGOOXXXXXXXXXXXXXXXXXGOOOOOOOOOOXXXXXXXXXGOOOOOXXXXXXXXXXXXXXGOOOOOOOOOOOOOXXXXXXGOOOOOOOOOOOOOOOXXXXGOOOOOXXXXXXXXXXXXXX,0,0,0
41328,124,0,124,25,451,0,0,162,94,68,GOOOOOOOOOOOOXXXXXXXGOOOOOOOOXXXXXXXXXXXGOOOOOXXXXXXXXXXXXXXGOOOOOOOOOOXXXXXXXXXGOOOOOOXXXXXXXXXXXXXGOOOOOOOOOOOOXXXXXXXGOOOOOOOOXXXXXXXXXXXGOOXXXXXXXXXXXXXXXXXGOOOOOOOOOOXXXXXXXXXGOOOOOXXXXXXXXXXXXXXGOOOOOOOOOOOOOXXXXXXGOOOOOOOOOOOOOOOXXXXGOOOOOXXXXXXXXXXXXXX,0,0,0
41349,124,0,124,28,448,0,0,159,94,65,GOOOOOOOOOOOOXXXXXXXGOOOOOOOOXXXXXXXXXXXGOOOOOXXXXXXXXXXXXXXGOOOOOOOOOOXXXXXXXXXGOOOOOOXXXXXXXXXXXXXGOOOOOOOOOOOOXXXXXXXGOOOOOOOOXXXXXXXXXXXGOOXXXXXXXXXXXXXXXXXGOOOOOOOOOOXXXXXXXXXGOOOOOXXXXXXXXXXXXXXGOOOOOOOOOOOOOXXXXXXGOOOOOOOOOOOOOOOXXXXGOOOOOXXXXXXXXXXXXXX,0,0,0

41370,124,0,124,30,446,0,0,157,96,61,GOOOOOOOOOOOOXXXXXXXGOOOOOOOOXXXXXXXXXXXGOOOOOXXXXXXXXXXXXXXGOOOOOOOOOOXXXXXXXXXGOOOOOOXXXXXXXXXXXXXGOOOOOOOOOOOOXXXXXXXGOOOOOOOOXXXXXXXXXXXGOOXXXXXXXXXXXXXXXXXGOOOOOOOOOOXXXXXXXXXGOOOOOXXXXXXXXXXXXXXGOOOOOOOOOOOOOXXXXXXGOOOOOOOOOOOOOOOXXXXGOOOOOXXXXXXXXXXXXXX,0,0,0
41391,124,0,124,37,439,0,0,150,93,57,GOOOOOOOOOOOOXXXXXXXGOOOOOOOOXXXXXXXXXXXGOOOOOXXXXXXXXXXXXXXGOOOOOOOOOOXXXXXXXXXGOOOOOOXXXXXXXXXXXXXGOOOOOOOOOOOOXXXXXXXGOOOOOOOOXXXXXXXXXXXGOOXXXXXXXXXXXXXXXXXGOOOOOOOOOOXXXXXXXXXGOOOOOXXXXXXXXXXXXXXGOOOOOOOOOOOOOXXXXXXGOOOOOOOOOOOOOOOXXXXGOOOOOXXXXXXXXXXXXXX,0,0,0
41412,124,0,124,36,440,0,0,151,92,59,GOOOOOOOOOOOOXXXXXXXGOOOOOOOOXXXXXXXXXXXGOOOOOXXXXXXXXXXXXXXGOOOOOOOOOOXXXXXXXXXGOOOOOOXXXXXXXXXXXXXGOOOOOOOOOOOOXXXXXXXGOOOOOOOOXXXXXXXXXXXGOOXXXXXXXXXXXXXXXXXGOOOOOOOOOOXXXXXXXXXGOOOOOXXXXXXXXXXXXXXGOOOOOOOOOOOOOXXXXXXGOOOOOOOOOOOOOOOXXXXGOOOOOXXXXXXXXXXXXXX,0,0,0
41433,124,0,124,34,442,0,0,153,92,61,GOOOOOOOOOOOOXXXXXXXGOOOOOOOOXXXXXXXXXXXGOOOOOXXXXXXXXXXXXXXGOOOOOOOOOOXXXXXXXXXGOOOOOOXXXXXXXXXXXXXGOOOOOOOOOOOOXXXXXXXGOOOOOOOOXXXXXXXXXXXGOOXXXXXXXXXXXXXXXXXGOOOOOOOOOOXXXXXXXXXGOOOOOXXXXXXXXXXXXXXGOOOOOOOOOOOOOXXXXXXGOOOOOOOOOOOOOOOXXXXGOOOOOXXXXXXXXXXXXXX,0,0,0
41454,124,0,124,32,444,0,0,155,94,61,GOOOOOOOOOOOOXXXXXXXGOOOOOOOOXXXXXXXXXXXGOOOOOXXXXXXXXXXXXXXGOOOOOOOOOOXXXXXXXXXGOOOOOOXXXXXXXXXXXXXGOOOOOOOOOOOOXXXXXXXGOOOOOOOOXXXXXXXXXXXGOOXXXXXXXXXXXXXXXXXGOOOOOOOOOOXXXXXXXXXGOOOOOXXXXXXXXXXXXXXGOOOOOOOOOOOOOXXXXXXGOOOOOOOOOOOOOOOXXXXGOOOOOXXXXXXXXXXXXXX,0,0,0

41475,124,0,124,35,441,0,0,152,94,58,GOOOOOOOOOOOOXXXXXXXGOOOOOOOOXXXXXXXXXXXGOOOOOXXXXXXXXXXXXXXGOOOOOOOOOOXXXXXXXXXGOOOOOOXXXXXXXXXXXXXGOOOOOOOOOOOOXXXXXXXGOOOOOOOOXXXXXXXXXXXGOOXXXXXXXXXXXXXXXXXGOOOOOOOOOOXXXXXXXXXGOOOOOXXXXXXXXXXXXXXGOOOOOOOOOOOOOXXXXXXGOOOOOOOOOOOOOOOXXXXGOOOOOXXXXXXXXXXXXXX,0,0,0
41496,124,0,124,33,443,0,0,154,95,59,GOOOOOOOOOOOOXXXXXXXGOOOOOOOOXXXXXXXXXXXGOOOOOXXXXXXXXXXXXXXGOOOOOOOOOOXXXXXXXXXGOOOOOOXXXXXXXXXXXXXGOOOOOOOOOOOOXXXXXXXGOOOOOOOOXXXXXXXXXXXGOOXXXXXXXXXXXXXXXXXGOOOOOOOOOOXXXXXXXXXGOOOOOXXXXXXXXXXXXXXGOOOOOOOOOOOOOXXXXXXGOOOOOOOOOOOOOOOXXXXGOOOOOXXXXXXXXXXXXXX,0,0,0
41517,124,0,124,35,441,0,0,152,93,59,GOOOOOOOOOOOOXXXXXXXGOOOOOOOOXXXXXXXXXXXGOOOOOXXXXXXXXXXXXXXGOOOOOOOOOOXXXXXXXXXGOOOOOOXXXXXXXXXXXXXGOOOOOOOOOOOOXXXXXXXGOOOOOOOOXXXXXXXXXXXGOOXXXXXXXXXXXXXXXXXGOOOOOOOOOOXXXXXXXXXGOOOOOXXXXXXXXXXXXXXGOOOOOOOOOOOOOXXXXXXGOOOOOOOOOOOOOOOXXXXGOOOOOXXXXXXXXXXXXXX,0,0,0
41538,124,0,124,34,442,0,0,153,95,58,GOOOOOOOOOOOOXXXXXXXGOOOOOOOOXXXXXXXXXXXGOOOOOXXXXXXXXXXXXXXGOOOOOOOOOOXXXXXXXXXGOOOOOOXXXXXXXXXXXXXGOOOOOOOOOOOOXXXXXXXGOOOOOOOOXXXXXXXXXXXGOOXXXXXXXXXXXXXXXXXGOOOOOOOOOOXXXXXXXXXGOOOOOXXXXXXXXXXXXXXGOOOOOOOOOOOOOXXXXXXGOOOOOOOOOOOOOOOXXXXGOOOOOXXXXXXXXXXXXXX,0,0,0
41559,124,0,124,35,441,0,0,152,96,56,GOOOOOOOOOOOOXXXXXXXGOOOOOOOOXXXXXXXXXXXGOOOOOXXXXXXXXXXXXXXGOOOOOOOOOOXXXXXXXXXGOOOOOOXXXXXXXXXXXXXGOOOOOOOOOOOOXXXXXXXGOOOOOOOOXXXXXXXXXXXGOOXXXXXXXXXXXXXXXXXGOOOOOOOOOOXXXXXXXXXGOOOOOXXXXXXXXXXXXXXGOOOOOOOOOOOOOXXXXXXGOOOOOOOOOOOOOOOXXXXGOOOOOXXXXXXXXXXXXXX,0,0,0

41580,124,0,124,36,440,0,0,151,93,58,GOOOOOOOOOOOOXXXXXXXGOOOOOOOOXXXXXXXXXXXGOOOOOXXXXXXXXXXXXXXGOOOOOOOOOOXXXXXXXXXGOOOOOOXXXXXXXXXXXXXGOOOOOOOOOOOOXXXXXXXGOOOOOOOOXXXXXXXXXXXGOOXXXXXXXXXXXXXXXXXGOOOOOOOOOOXXXXXXXXXGOOOOOXXXXXXXXXXXXXXGOOOOOOOOOOOOOXXXXXXGOOOOOOOOOOOOOOOXXXXGOOOOOXXXXXXXXXXXXXX,0,0,0
41601,124,0,124,38,438,0,0,149,94,55,GOOOOOOOOOOOOXXXXXXXGOOOOOOOOXXXXXXXXXXXGOOOOOXXXXXXXXXXXXXXGOOOOOOOOOOXXXXXXXXXGOOOOOOXXXXXXXXXXXXXGOOOOOOOOOOOOXXXXXXXGOOOOOOOOXXXXXXXXXXXGOOXXXXXXXXXXXXXXXXXGOOOOOOOOOOXXXXXXXXXGOOOOOXXXXXXXXXXXXXXGOOOOOOOOOOOOOXXXXXXGOOOOOOOOOOOOOOOXXXXGOOOOOXXXXXXXXXXXXXX,0,0,0
41622,124,0,124,39,437,0,0,148,93,55,GOOOOOOOOOOOOXXXXXXXGOOOOOOOOXXXXXXXXXXXGOOOOOXXXXXXXXXXXXXXGOOOOOOOOOOXXXXXXXXXGOOOOOOXXXXXXXXXXXXXGOOOOOOOOOOOOXXXXXXXGOOOOOOOOXXXXXXXXXXXGOOXXXXXXXXXXXXXXXXXGOOOOOOOOOOXXXXXXXXXGOOOOOXXXXXXXXXXXXXXGOOOOOOOOOOOOOXXXXXXGOOOOOOOOOOOOOOOXXXXGOOOOOXXXXXXXXXXXXXX,0,0,0
41643,124,0,124,39,437,0,0,148,92,56,GOOOOOOOOOOOOXXXXXXXGOOOOOOOOXXXXXXXXXXXGOOOOOXXXXXXXXXXXXXXGOOOOOOOOOOXXXXXXXXXGOOOOOOXXXXXXXXXXXXXGOOOOOOOOOOOOXXXXXXXGOOOOOOOOXXXXXXXXXXXGOOXXXXXXXXXXXXXXXXXGOOOOOOOOOOXXXXXXXXXGOOOOOXXXXXXXXXXXXXXGOOOOOOOOOOOOOXXXXXXGOOOOOOOOOOOOOOOXXXXGOOOOOXXXXXXXXXXXXXX,0,0,0
41664,124,0,124,37,439,0,0,150,92,58,GOOOOOOOOOOOOXXXXXXXGOOOOOOOOXXXXXXXXXXXGOOOOOXXXXXXXXXXXXXXGOOOOOOOOOOXXXXXXXXXGOOOOOOXXXXXXXXXXXXXGOOOOOOOOOOOOXXXXXXXGOOOOOOOOXXXXXXXXXXXGOOXXXXXXXXXXXXXXXXXGOOOOOOOOOOXXXXXXXXXGOOOOOXXXXXXXXXXXXXXGOOOOOOOOOOOOOXXXXXXGOOOOOOOOOOOOOOOXXXXGOOOOOXXXXXXXXXXXXXX,0,0,0

41685,125,1,124,36,439,0,0,151,91,60,GOOOOOOOOOOOOXXXXXXXGOOOOOOOOXXXXXXXXXXXGOOOOOXXXXXXXXXXXXXXGOOOOOOOOOOXXXXXXXXXGOOOOOOAXXXXXXXXXXXXGOOOOOOOOOOOOXXXXXXXGOOOOOOOOXXXXXXXXXXXGOOXXXXXXXXXXXXXXXXXGOOOOOOOOOOXXXXXXXXXGOOOOOXXXXXXXXXXXXXXGOOOOOOOOOOOOOXXXXXXGOOOOOOOOOOOOOOOXXXXGOOOOOXXXXXXXXXXXXXX,0,0,0
41706,125,1,124,32,443,0,0,155,93,62,GOOOOOOOOOOOOXXXXXXXGOOOOOOOOXXXXXXXXXXXGOOOOOXXXXXXXXXXXXXXGOOOOOOOOOOXXXXXXXXXGOOOOOOAXXXXXXXXXXXXGOOOOOOOOOOOOXXXXXXXGOOOOOOOOXXXXXXXXXXXGOOXXXXXXXXXXXXXXXXXGOOOOOOOOOOXXXXXXXXXGOOOOOXXXXXXXXXXXXXXGOOOOOOOOOOOOOXXXXXXGOOOOOOOOOOOOOOOXXXXGOOOOOXXXXXXXXXXXXXX,0,0,0
41727,125,1,124,32,443,0,0,154,92,62,GOOOOOOOOOOOOXXXXXXXGOOOOOOOOXXXXXXXXXXXGOOOOOXXXXXXXXXXXXXXGOOOOOOOOOOXXXXXXXXXGOOOOOOAXXXXXXXXXXXXGOOOOOOOOOOOOXXXXXXXGOOOOOOOOXXXXXXXXXXXGOOXXXXXXXXXXXXXXXXXGOOOOOOOOOOXXXXXXXXXGOOOOOXXXXXXXXXXXXXXGOOOOOOOOOOOOOXXXXXXGOOOOOOOOOOOOOOOXXXXGOOOOOXXXXXXXXXXXXXX,0,0,0
41748,125,1,124,31,444,0,0,155,94,61,GOOOOOOOOOOOOXXXXXXXGOOOOOOOOXXXXXXXXXXXGOOOOOXXXXXXXXXXXXXXGOOOOOOOOOOXXXXXXXXXGOOOOOOAXXXXXXXXXXXXGOOOOOOOOOOOOXXXXXXXGOOOOOOOOXXXXXXXXXXXGOOXXXXXXXXXXXXXXXXXGOOOOOOOOOOXXXXXXXXXGOOOOOXXXXXXXXXXXXXXGOOOOOOOOOOOOOXXXXXXGOOOOOOOOOOOOOOOXXXXGOOOOOXXXXXXXXXXXXXX,0,0,0
41769,125,1,124,30,445,0,0,156,92,64,GOOOOOOOOOOOOXXXXXXXGOOOOOOOOXXXXXXXXXXXGOOOOOXXXXXXXXXXXXXXGOOOOOOOOOOXXXXXXXXXGOOOOOOAXXXXXXXXXXXXGOOOOOOOOOOOOXXXXXXXGOOOOOOOOXXXXXXXXXXXGOOXXXXXXXXXXXXXXXXXGOOOOOOOOOOXXXXXXXXXGOOOOOXXXXXXXXXXXXXXGOOOOOOOOOOOOOXXXXXXGOOOOOOOOOOOOOOOXXXXGOOOOOXXXXXXXXXXXXXX,0,0,0

41790,125,1,124,30,445,0,0,156,92,64,GOOOOOOOOOOOOXXXXXXXGOOOOOOOOXXXXXXXXXXXGOOOOOXXXXXXXXXXXXXXGOOOOOOOOOOXXXXXXXXXGOOOOOOAXXXXXXXXXXXXGOOOOOOOOOOOOXXXXXXXGOOOOOOOOXXXXXXXXXXXGOOXXXXXXXXXXXXXXXXXGOOOOOOOOOOXXXXXXXXXGOOOOOXXXXXXXXXXXXXXGOOOOOOOOOOOOOXXXXXXGOOOOOOOOOOOOOOOXXXXGOOOOOXXXXXXXXXXXXXX,0,0,0
41811,125,1,124,30,445,0,0,156,91,65,GOOOOOOOOOOOOXXXXXXXGOOOOOOOOXXXXXXXXXXXGOOOOOXXXXXXXXXXXXXXGOOOOOOOOOOXXXXXXXXXGOOOOOOAXXXXXXXXXXXXGOOOOOOOOOOOOXXXXXXXGOOOOOOOOXXXXXXXXXXXGOOXXXXXXXXXXXXXXXXXGOOOOOOOOOOXXXXXXXXXGOOOOOXXXXXXXXXXXXXXGOOOOOOOOOOOOOXXXXXXGOOOOOOOOOOOOOOOXXXXGOOOOOXXXXXXXXXXXXXX,0,0,0
41832,125,1,124,29,446,0,0,157,92,65,GOOOOOOOOOOOOXXXXXXXGOOOOOOOOXXXXXXXXXXXGOOOOOXXXXXXXXXXXXXXGOOOOOOOOOOXXXXXXXXXGOOOOOOAXXXXXXXXXXXXGOOOOOOOOOOOOXXXXXXXGOOOOOOOOXXXXXXXXXXXGOOXXXXXXXXXXXXXXXXXGOOOOOOOOOOXXXXXXXXXGOOOOOXXXXXXXXXXXXXXGOOOOOOOOOOOOOXXXXXXGOOOOOOOOOOOOOOOXXXXGOOOOOXXXXXXXXXXXXXX,0,0,0
41853,125,1,124,31,444,0,0,155,96,59,GOOOOOOOOOOOOXXXXXXXGOOOOOOOOXXXXXXXXXXXGOOOOOXXXXXXXXXXXXXXGOOOOOOOOOOXXXXXXXXXGOOOOOOAXXXXXXXXXXXXGOOOOOOOOOOOOXXXXXXXGOOOOOOOOXXXXXXXXXXXGOOXXXXXXXXXXXXXXXXXGOOOOOOOOOOXXXXXXXXXGOOOOOXXXXXXXXXXXXXXGOOOOOOOOOOOOOXXXXXXGOOOOOOOOOOOOOOOXXXXGOOOOOXXXXXXXXXXXXXX,0,0,0
41874,125,0,125,33,442,0,0,153,94,59,GOOOOOOOOOOOOXXXXXXXGOOOOOOOOXXXXXXXXXXXGOOOOOXXXXXXXXXXXXXXGOOOOOOOOOOXXXXXXXXXGOOOOOOOXXXXXXXXXXXXGOOOOOOOOOOOOXXXXXXXGOOOOOOOOXXXXXXXXXXXGOOXXXXXXXXXXXXXXXXXGOOOOOOOOOOXXXXXXXXXGOOOOOXXXXXXXXXXXXXXGOOOOOOOOOOOOOXXXXXXGOOOOOOOOOOOOOOOXXXXGOOOOOXXXXXXXXXXXXXX,0,0,0

41895,125,0,125,31,444,0,0,155,94,61,GOOOOOOOOOOOOXXXXXXXGOOOOOOOOXXXXXXXXXXXGOOOOOXXXXXXXXXXXXXXGOOOOOOOOOOXXXXXXXXXGOOOOOOOXXXXXXXXXXXXGOOOOOOOOOOOOXXXXXXXGOOOOOOOOXXXXXXXXXXXGOOXXXXXXXXXXXXXXXXXGOOOOOOOOOOXXXXXXXXXGOOOOOXXXXXXXXXXXXXXGOOOOOOOOOOOOOXXXXXXGOOOOOOOOOOOOOOOXXXXGOOOOOXXXXXXXXXXXXXX,0,0,0
41916,125,0,125,31,444,0,0,155,96,59,GOOOOOOOOOOOOXXXXXXXGOOOOOOOOXXXXXXXXXXXGOOOOOXXXXXXXXXXXXXXGOOOOOOOOOOXXXXXXXXXGOOOOOOOXXXXXXXXXXXXGOOOOOOOOOOOOXXXXXXXGOOOOOOOOXXXXXXXXXXXGOOXXXXXXXXXXXXXXXXXGOOOOOOOOOOXXXXXXXXXGOOOOOXXXXXXXXXXXXXXGOOOOOOOOOOOOOXXXXXXGOOOOOOOOOOOOOOOXXXXGOOOOOXXXXXXXXXXXXXX,0,0,0
41937,125,0,125,32,443,0,0,154,93,61,GOOOOOOOOOOOOXXXXXXXGOOOOOOOOXXXXXXXXXXXGOOOOOXXXXXXXXXXXXXXGOOOOOOOOOOXXXXXXXXXGOOOOOOOXXXXXXXXXXXXGOOOOOOOOOOOOXXXXXXXGOOOOOOOOXXXXXXXXXXXGOOXXXXXXXXXXXXXXXXXGOOOOOOOOOOXXXXXXXXXGOOOOOXXXXXXXXXXXXXXGOOOOOOOOOOOOOXXXXXXGOOOOOOOOOOOOOOOXXXXGOOOOOXXXXXXXXXXXXXX,0,0,0
41958,125,0,125,33,442,0,0,153,91,62,GOOOOOOOOOOOOXXXXXXXGOOOOOOOOXXXXXXXXXXXGOOOOOXXXXXXXXXXXXXXGOOOOOOOOOOXXXXXXXXXGOOOOOOOXXXXXXXXXXXXGOOOOOOOOOOOOXXXXXXXGOOOOOOOOXXXXXXXXXXXGOOXXXXXXXXXXXXXXXXXGOOOOOOOOOOXXXXXXXXXGOOOOOXXXXXXXXXXXXXXGOOOOOOOOOOOOOXXXXXXGOOOOOOOOOOOOOOOXXXXGOOOOOXXXXXXXXXXXXXX,0,0,0
41979,125,0,125,28,447,0,0,158,94,64,GOOOOOOOOOOOOXXXXXXXGOOOOOOOOXXXXXXXXXXXGOOOOOXXXXXXXXXXXXXXGOOOOOOOOOOXXXXXXXXXGOOOOOOOXXXXXXXXXXXXGOOOOOOOOOOOOXXXXXXXGOOOOOOOOXXXXXXXXXXXGOOXXXXXXXXXXXXXXXXXGOOOOOOOOOOXXXXXXXXXGOOOOOXXXXXXXXXXXXXXGOOOOOOOOOOOOOXXXXXXGOOOOOOOOOOOOOOOXXXXGOOOOOXXXXXXXXXXXXXX,0,0,0

42000,125,0,125,26,449,0,0,159,94,65,GOOOOOOOOOOOOXXXXXXXGOOOOOOOOXXXXXXXXXXXGOOOOOXXXXXXXXXXXXXXGOOOOOOOOOOXXXXXXXXXGOOOOOOOXXXXXXXXXXXXGOOOOOOOOOOOOXXXXXXXGOOOOOOOOXXXXXXXXXXXGOOXXXXXXXXXXXXXXXXXGOOOOOOOOOOXXXXXXXXXGOOOOOXXXXXXXXXXXXXXGOOOOOOOOOOOOOXXXXXXGOOOOOOOOOOOOOOOXXXXGOOOOOXXXXXXXXXXXXXX,0,0,0
42021,125,0,125,25,450,0,0,161,93,68,GOOOOOOOOOOOOXXXXXXXGOOOOOOOOXXXXXXXXXXXGOOOOOXXXXXXXXXXXXXXGOOOOOOOOOOXXXXXXXXXGOOOOOOOXXXXXXXXXXXXGOOOOOOOOOOOOXXXXXXXGOOOOOOOOXXXXXXXXXXXGOOXXXXXXXXXXXXXXXXXGOOOOOOOOOOXXXXXXXXXGOOOOOXXXXXXXXXXXXXXGOOOOOOOOOOOOOXXXXXXGOOOOOOOOOOOOOOOXXXXGOOOOOXXXXXXXXXXXXXX,0,0,0
42042,125,0,125,24,451,0,0,162,93,69,GOOOOOOOOOOOOXXXXXXXGOOOOOOOOXXXXXXXXXXXGOOOOOXXXXXXXXXXXXXXGOOOOOOOOOOXXXXXXXXXGOOOOOOOXXXXXXXXXXXXGOOOOOOOOOOOOXXXXXXXGOOOOOOOOXXXXXXXXXXXGOOXXXXXXXXXXXXXXXXXGOOOOOOOOOOXXXXXXXXXGOOOOOXXXXXXXXXXXXXXGOOOOOOOOOOOOOXXXXXXGOOOOOOOOOOOOOOOXXXXGOOOOOXXXXXXXXXXXXXX,0,0,0
42063,125,0,125,23,452,0,0,163,93,70,GOOOOOOOOOOOOXXXXXXXGOOOOOOOOXXXXXXXXXXXGOOOOOXXXXXXXXXXXXXXGOOOOOOOOOOXXXXXXXXXGOOOOOOOXXXXXXXXXXXXGOOOOOOOOOOOOXXXXXXXGOOOOOOOOXXXXXXXXXXXGOOXXXXXXXXXXXXXXXXXGOOOOOOOOOOXXXXXXXXXGOOOOOXXXXXXXXXXXXXXGOOOOOOOOOOOOOXXXXXXGOOOOOOOOOOOOOOOXXXXGOOOOOXXXXXXXXXXXXXX,0,0,0
42084,125,0,125,26,449,0,0,160,95,65,GOOOOOOOOOOOOXXXXXXXGOOOOOOOOXXXXXXXXXXXGOOOOOXXXXXXXXXXXXXXGOOOOOOOOOOXXXXXXXXXGOOOOOOOXXXXXXXXXXXXGOOOOOOOOOOOOXXXXXXXGOOOOOOOOXXXXXXXXXXXGOOXXXXXXXXXXXXXXXXXGOOOOOOOOOOXXXXXXXXXGOOOOOXXXXXXXXXXXXXXGOOOOOOOOOOOOOXXXXXXGOOOOOOOOOOOOOOOXXXXGOOOOOXXXXXXXXXXXXXX,0,0,0

42105,125,0,125,30,445,0,0,156,96,60,GOOOOOOOOOOOOXXXXXXXGOOOOOOOOXXXXXXXXXXXGOOOOOXXXXXXXXXXXXXXGOOOOOOOOOOXXXXXXXXXGOOOOOOOXXXXXXXXXXXXGOOOOOOOOOOOOXXXXXXXGOOOOOOOOXXXXXXXXXXXGOOXXXXXXXXXXXXXXXXXGOOOOOOOOOOXXXXXXXXXGOOOOOXXXXXXXXXXXXXXGOOOOOOOOOOOOOXXXXXXGOOOOOOOOOOOOOOOXXXXGOOOOOXXXXXXXXXXXXXX,0,0,0
42126,125,0,125,33,442,0,0,153,93,60,GOOOOOOOOOOOOXXXXXXXGOOOOOOOOXXXXXXXXXXXGOOOOOXXXXXXXXXXXXXXGOOOOOOOOOOXXXXXXXXXGOOOOOOOXXXXXXXXXXXXGOOOOOOOOOOOOXXXXXXXGOOOOOOOOXXXXXXXXXXXGOOXXXXXXXXXXXXXXXXXGOOOOOOOOOOXXXXXXXXXGOOOOOXXXXXXXXXXXXXXGOOOOOOOOOOOOOXXXXXXGOOOOOOOOOOOOOOOXXXXGOOOOOXXXXXXXXXXXXXX,0,0,0
42147,125,0,125,30,445,0,0,156,93,63,GOOOOOOOOOOOOXXXXXXXGOOOOOOOOXXXXXXXXXXXGOOOOOXXXXXXXXXXXXXXGOOOOOOOOOOXXXXXXXXXGOOOOOOOXXXXXXXXXXXXGOOOOOOOOOOOOXXXXXXXGOOOOOOOOXXXXXXXXXXXGOOXXXXXXXXXXXXXXXXXGOOOOOOOOOOXXXXXXXXXGOOOOOXXXXXXXXXXXXXXGOOOOOOOOOOOOOXXXXXXGOOOOOOOOOOOOOOOXXXXGOOOOOXXXXXXXXXXXXXX,0,0,0
42168,125,0,125,33,442,0,0,153,94,59,GOOOOOOOOOOOOXXXXXXXGOOOOOOOOXXXXXXXXXXXGOOOOOXXXXXXXXXXXXXXGOOOOOOOOOOXXXXXXXXXGOOOOOOOXXXXXXXXXXXXGOOOOOOOOOOOOXXXXXXXGOOOOOOOOXXXXXXXXXXXGOOXXXXXXXXXXXXXXXXXGOOOOOOOOOOXXXXXXXXXGOOOOOXXXXXXXXXXXXXXGOOOOOOOOOOOOOXXXXXXGOOOOOOOOOOOOOOOXXXXGOOOOOXXXXXXXXXXXXXX,0,0,0
42189,125,0,125,33,442,0,0,154,95,59,GOOOOOOOOOOOOXXXXXXXGOOOOOOOOXXXXXXXXXXXGOOOOOXXXXXXXXXXXXXXGOOOOOOOOOOXXXXXXXXXGOOOOOOOXXXXXXXXXXXXGOOOOOOOOOOOOXXXXXXXGOOOOOOOOXXXXXXXXXXXGOOXXXXXXXXXXXXXXXXXGOOOOOOOOOOXXXXXXXXXGOOOOOXXXXXXXXXXXXXXGOOOOOOOOOOOOOXXXXXXGOOOOOOOOOOOOOOOXXXXGOOOOOXXXXXXXXXXXXXX,0,0,0

42210,125,0,125,35,440,0,0,152,94,58,GOOOOOOOOOOOOXXXXXXXGOOOOOOOOXXXXXXXXXXXGOOOOOXXXXXXXXXXXXXXGOOOOOOOOOOXXXXXXXXXGOOOOOOOXXXXXXXXXXXXGOOOOOOOOOOOOXXXXXXXGOOOOOOOOXXXXXXXXXXXGOOXXXXXXXXXXXXXXXXXGOOOOOOOOOOXXXXXXXXXGOOOOOXXXXXXXXXXXXXXGOOOOOOOOOOOOOXXXXXXGOOOOOOOOOOOOOOOXXXXGOOOOOXXXXXXXXXXXXXX,0,0,0
42231,125,0,125,34,441,0,0,153,98,55,GOOOOOOOOOOOOXXXXXXXGOOOOOOOOXXXXXXXXXXXGOOOOOXXXXXXXXXXXXXXGOOOOOOOOOOXXXXXXXXXGOOOOOOOXXXXXXXXXXXXGOOOOOOOOOOOOXXXXXXXGOOOOOOOOXXXXXXXXXXXGOOXXXXXXXXXXXXXXXXXGOOOOOOOOOOXXXXXXXXXGOOOOOXXXXXXXXXXXXXXGOOOOOOOOOOOOOXXXXXXGOOOOOOOOOOOOOOOXXXXGOOOOOXXXXXXXXXXXXXX,0,0,0
42252,125,0,125,36,439,0,0,150,95,55,GOOOOOOOOOOOOXXXXXXXGOOOOOOOOXXXXXXXXXXXGOOOOOXXXXXXXXXXXXXXGOOOOOOOOOOXXXXXXXXXGOOOOOOOXXXXXXXXXXXXGOOOOOOOOOOOOXXXXXXXGOOOOOOOOXXXXXXXXXXXGOOXXXXXXXXXXXXXXXXXGOOOOOOOOOOXXXXXXXXXGOOOOOXXXXXXXXXXXXXXGOOOOOOOOOOOOOXXXXXXGOOOOOOOOOOOOOOOXXXXGOOOOOXXXXXXXXXXXXXX,0,0,0
42273,125,0,125,37,438,0,0,149,91,58,GOOOOOOOOOOOOXXXXXXXGOOOOOOOOXXXXXXXXXXXGOOOOOXXXXXXXXXXXXXXGOOOOOOOOOOXXXXXXXXXGOOOOOOOXXXXXXXXXXXXGOOOOOOOOOOOOXXXXXXXGOOOOOOOOXXXXXXXXXXXGOOXXXXXXXXXXXXXXXXXGOOOOOOOOOOXXXXXXXXXGOOOOOXXXXXXXXXXXXXXGOOOOOOOOOOOOOXXXXXXGOOOOOOOOOOOOOOOXXXXGOOOOOXXXXXXXXXXXXXX,0,0,0
42294,125,0,125,33,442,0,0,154,96,58,GOOOOOOOOOOOOXXXXXXXGOOOOOOOOXXXXXXXXXXXGOOOOOXXXXXXXXXXXXXXGOOOOOOOOOOXXXXXXXXXGOOOOOOOXXXXXXXXXXXXGOOOOOOOOOOOOXXXXXXXGOOOOOOOOXXXXXXXXXXXGOOXXXXXXXXXXXXXXXXXGOOOOOOOOOOXXXXXXXXXGOOOOOXXXXXXXXXXXXXXGOOOOOOOOOOOOOXXXXXXGOOOOOOOOOOOOOOOXXXXGOOOOOXXXXXXXXXXXXXX,0,0,0

42315,125,0,125,35,440,0,0,152,99,53,GOOOOOOOOOOOOXXXXXXXGOOOOOOOOXXXXXXXXXXXGOOOOOXXXXXXXXXXXXXXGOOOOOOOOOOXXXXXXXXXGOOOOOOOXXXXXXXXXXXXGOOOOOOOOOOOOXXXXXXXGOOOOOOOOXXXXXXXXXXXGOOXXXXXXXXXXXXXXXXXGOOOOOOOOOOXXXXXXXXXGOOOOOXXXXXXXXXXXXXXGOOOOOOOOOOOOOXXXXXXGOOOOOOOOOOOOOOOXXXXGOOOOOXXXXXXXXXXXXXX,0,0,0
42336,125,0,125,41,434,0,0,146,93,53,GOOOOOOOOOOOOXXXXXXXGOOOOOOOOXXXXXXXXXXXGOOOOOXXXXXXXXXXXXXXGOOOOOOOOOOXXXXXXXXXGOOOOOOOXXXXXXXXXXXXGOOOOOOOOOOOOXXXXXXXGOOOOOOOOXXXXXXXXXXXGOOXXXXXXXXXXXXXXXXXGOOOOOOOOOOXXXXXXXXXGOOOOOXXXXXXXXXXXXXXGOOOOOOOOOOOOOXXXXXXGOOOOOOOOOOOOOOOXXXXGOOOOOXXXXXXXXXXXXXX,0,0,0
42357,125,0,125,40,435,0,0,147,92,55,GOOOOOOOOOOOOXXXXXXXGOOOOOOOOXXXXXXXXXXXGOOOOOXXXXXXXXXXXXXXGOOOOOOOOOOXXXXXXXXXGOOOOOOOXXXXXXXXXXXXGOOOOOOOOOOOOXXXXXXXGOOOOOOOOXXXXXXXXXXXGOOXXXXXXXXXXXXXXXXXGOOOOOOOOOOXXXXXXXXXGOOOOOXXXXXXXXXXXXXXGOOOOOOOOOOOOOXXXXXXGOOOOOOOOOOOOOOOXXXXGOOOOOXXXXXXXXXXXXXX,0,0,0
42378,125,0,125,37,438,0,0,149,96,53,GOOOOOOOOOOOOXXXXXXXGOOOOOOOOXXXXXXXXXXXGOOOOOXXXXXXXXXXXXXXGOOOOOOOOOOXXXXXXXXXGOOOOOOOXXXXXXXXXXXXGOOOOOOOOOOOOXXXXXXXGOOOOOOOOXXXXXXXXXXXGOOXXXXXXXXXXXXXXXXXGOOOOOOOOOOXXXXXXXXXGOOOOOXXXXXXXXXXXXXXGOOOOOOOOOOOOOXXXXXXGOOOOOOOOOOOOOOOXXXXGOOOOOXXXXXXXXXXXXXX,0,0,0
42399,125,0,125,38,437,0,0,149,95,54,GOOOOOOOOOOOOXXXXXXXGOOOOOOOOXXXXXXXXXXXGOOOOOXXXXXXXXXXXXXXGOOOOOOOOOOXXXXXXXXXGOOOOOOOXXXXXXXXXXXXGOOOOOOOOOOOOXXXXXXXGOOOOOOOOXXXXXXXXXXXGOOXXXXXXXXXXXXXXXXXGOOOOOOOOOOXXXXXXXXXGOOOOOXXXXXXXXXXXXXXGOOOOOOOOOOOOOXXXXXXGOOOOOOOOOOOOOOOXXXXGOOOOOXXXXXXXXXXXXXX,0,0,0

42420,125,0,125,34,441,0,0,153,94,59,GOOOOOOOOOOOOXXXXXXXGOOOOOOOOXXXXXXXXXXXGOOOOOXXXXXXXXXXXXXXGOOOOOOOOOOXXXXXXXXXGOOOOOOOXXXXXXXXXXXXGOOOOOOOOOOOOXXXXXXXGOOOOOOOOXXXXXXXXXXXGOOXXXXXXXXXXXXXXXXXGOOOOOOOOOOXXXXXXXXXGOOOOOXXXXXXXXXXXXXXGOOOOOOOOOOOOOXXXXXXGOOOOOOOOOOOOOOOXXXXGOOOOOXXXXXXXXXXXXXX,0,0,0
42441,125,0,125,30,445,0,0,156,95,61,GOOOOOOOOOOOOXXXXXXXGOOOOOOOOXXXXXXXXXXXGOOOOOXXXXXXXXXXXXXXGOOOOOOOOOOXXXXXXXXXGOOOOOOOXXXXXXXXXXXXGOOOOOOOOOOOOXXXXXXXGOOOOOOOOXXXXXXXXXXXGOOXXXXXXXXXXXXXXXXXGOOOOOOOOOOXXXXXXXXXGOOOOOXXXXXXXXXXXXXXGOOOOOOOOOOOOOXXXXXXGOOOOOOOOOOOOOOOXXXXGOOOOOXXXXXXXXXXXXXX,0,0,0
42462,125,0,125,28,447,0,0,159,93,66,GOOOOOOOOOOOOXXXXXXXGOOOOOOOOXXXXXXXXXXXGOOOOOXXXXXXXXXXXXXXGOOOOOOOOOOXXXXXXXXXGOOOOOOOXXXXXXXXXXXXGOOOOOOOOOOOOXXXXXXXGOOOOOOOOXXXXXXXXXXXGOOXXXXXXXXXXXXXXXXXGOOOOOOOOOOXXXXXXXXXGOOOOOXXXXXXXXXXXXXXGOOOOOOOOOOOOOXXXXXXGOOOOOOOOOOOOOOOXXXXGOOOOOXXXXXXXXXXXXXX,0,0,0
42483,125,0,125,28,447,0,0,159,94,65,GOOOOOOOOOOOOXXXXXXXGOOOOOOOOXXXXXXXXXXXGOOOOOXXXXXXXXXXXXXXGOOOOOOOOOOXXXXXXXXXGOOOOOOOXXXXXXXXXXXXGOOOOOOOOOOOOXXXXXXXGOOOOOOOOXXXXXXXXXXXGOOXXXXXXXXXXXXXXXXXGOOOOOOOOOOXXXXXXXXXGOOOOOXXXXXXXXXXXXXXGOOOOOOOOOOOOOXXXXXXGOOOOOOOOOOOOOOOXXXXGOOOOOXXXXXXXXXXXXXX,0,0,0
42504,125,0,125,27,448,0,0,160,96,64,GOOOOOOOOOOOOXXXXXXXGOOOOOOOOXXXXXXXXXXXGOOOOOXXXXXXXXXXXXXXGOOOOOOOOOOXXXXXXXXXGOOOOOOOXXXXXXXXXXXXGOOOOOOOOOOOOXXXXXXXGOOOOOOOOXXXXXXXXXXXGOOXXXXXXXXXXXXXXXXXGOOOOOOOOOOXXXXXXXXXGOOOOOXXXXXXXXXXXXXXGOOOOOOOOOOOOOXXXXXXGOOOOOOOOOOOOOOOXXXXGOOOOOXXXXXXXXXXXXXX,0,0,0

42525,125,0,125,26,449,0,0,161,94,67,GOOOOOOOOOOOOXXXXXXXGOOOOOOOOXXXXXXXXXXXGOOOOOXXXXXXXXXXXXXXGOOOOOOOOOOXXXXXXXXXGOOOOOOOXXXXXXXXXXXXGOOOOOOOOOOOOXXXXXXXGOOOOOOOOXXXXXXXXXXXGOOXXXXXXXXXXXXXXXXXGOOOOOOOOOOXXXXXXXXXGOOOOOXXXXXXXXXXXXXXGOOOOOOOOOOOOOXXXXXXGOOOOOOOOOOOOOOOXXXXGOOOOOXXXXXXXXXXXXXX,0,0,0
42546,125,0,125,26,449,0,0,161,93,68,GOOOOOOOOOOOOXXXXXXXGOOOOOOOOXXXXXXXXXXXGOOOOOXXXXXXXXXXXXXXGOOOOOOOOOOXXXXXXXXXGOOOOOOOXXXXXXXXXXXXGOOOOOOOOOOOOXXXXXXXGOOOOOOOOXXXXXXXXXXXGOOXXXXXXXXXXXXXXXXXGOOOOOOOOOOXXXXXXXXXGOOOOOXXXXXXXXXXXXXXGOOOOOOOOOOOOOXXXXXXGOOOOOOOOOOOOOOOXXXXGOOOOOXXXXXXXXXXXXXX,0,0,0
42567,125,0,125,25,450,0,0,162,93,69,GOOOOOOOOOOOOXXXXXXXGOOOOOOOOXXXXXXXXXXXGOOOOOXXXXXXXXXXXXXXGOOOOOOOOOOXXXXXXXXXGOOOOOOOXXXXXXXXXXXXGOOOOOOOOOOOOXXXXXXXGOOOOOOOOXXXXXXXXXXXGOOXXXXXXXXXXXXXXXXXGOOOOOOOOOOXXXXXXXXXGOOOOOXXXXXXXXXXXXXXGOOOOOOOOOOOOOXXXXXXGOOOOOOOOOOOOOOOXXXXGOOOOOXXXXXXXXXXXXXX,0,0,0
42588,125,0,125,28,447,0,0,159,93,66,GOOOOOOOOOOOOXXXXXXXGOOOOOOOOXXXXXXXXXXXGOOOOOXXXXXXXXXXXXXXGOOOOOOOOOOXXXXXXXXXGOOOOOOOXXXXXXXXXXXXGOOOOOOOOOOOOXXXXXXXGOOOOOOOOXXXXXXXXXXXGOOXXXXXXXXXXXXXXXXXGOOOOOOOOOOXXXXXXXXXGOOOOOXXXXXXXXXXXXXXGOOOOOOOOOOOOOXXXXXXGOOOOOOOOOOOOOOOXXXXGOOOOOXXXXXXXXXXXXXX,0,0,0
42609,125,0,125,24,451,0,0,163,93,70,GOOOOOOOOOOOOXXXXXXXGOOOOOOOOXXXXXXXXXXXGOOOOOXXXXXXXXXXXXXXGOOOOOOOOOOXXXXXXXXXGOOOOOOOXXXXXXXXXXXXGOOOOOOOOOOOOXXXXXXXGOOOOOOOOXXXXXXXXXXXGOOXXXXXXXXXXXXXXXXXGOOOOOOOOOOXXXXXXXXXGOOOOOXXXXXXXXXXXXXXGOOOOOOOOOOOOOXXXXXXGOOOOOOOOOOOOOOOXXXXGOOOOOXXXXXXXXXXXXXX,0,0,0

42630,125,0,125,23,452,0,0,164,96,68,GOOOOOOOOOOOOXXXXXXXGOOOOOOOOXXXXXXXXXXXGOOOOOXXXXXXXXXXXXXXGOOOOOOOOOOXXXXXXXXXGOOOOOOOXXXXXXXXXXXXGOOOOOOOOOOOOXXXXXXXGOOOOOOOOXXXXXXXXXXXGOOXXXXXXXXXXXXXXXXXGOOOOOOOOOOXXXXXXXXXGOOOOOXXXXXXXXXXXXXXGOOOOOOOOOOOOOXXXXXXGOOOOOOOOOOOOOOOXXXXGOOOOOXXXXXXXXXXXXXX,0,0,0
42651,125,0,125,24,451,0,0,163,99,64,GOOOOOOOOOOOOXXXXXXXGOOOOOOOOXXXXXXXXXXXGOOOOOXXXXXXXXXXXXXXGOOOOOOOOOOXXXXXXXXXGOOOOOOOXXXXXXXXXXXXGOOOOOOOOOOOOXXXXXXXGOOOOOOOOXXXXXXXXXXXGOOXXXXXXXXXXXXXXXXXGOOOOOOOOOOXXXXXXXXXGOOOOOXXXXXXXXXXXXXXGOOOOOOOOOOOOOXXXXXXGOOOOOOOOOOOOOOOXXXXGOOOOOXXXXXXXXXXXXXX,0,0,0
42672,125,0,125,30,445,0,0,157,97,60,GOOOOOOOOOOOOXXXXXXXGOOOOOOOOXXXXXXXXXXXGOOOOOXXXXXXXXXXXXXXGOOOOOOOOOOXXXXXXXXXGOOOOOOOXXXXXXXXXXXXGOOOOOOOOOOOOXXXXXXXGOOOOOOOOXXXXXXXXXXXGOOXXXXXXXXXXXXXXXXXGOOOOOOOOOOXXXXXXXXXGOOOOOXXXXXXXXXXXXXXGOOOOOOOOOOOOOXXXXXXGOOOOOOOOOOOOOOOXXXXGOOOOOXXXXXXXXXXXXXX,0,0,0
42693,125,0,125,33,442,0,0,154,96,58,GOOOOOOOOOOOOXXXXXXXGOOOOOOOOXXXXXXXXXXXGOOOOOXXXXXXXXXXXXXXGOOOOOOOOOOXXXXXXXXXGOOOOOOOXXXXXXXXXXXXGOOOOOOOOOOOOXXXXXXXGOOOOOOOOXXXXXXXXXXXGOOXXXXXXXXXXXXXXXXXGOOOOOOOOOOXXXXXXXXXGOOOOOXXXXXXXXXXXXXXGOOOOOOOOOOOOOXXXXXXGOOOOOOOOOOOOOOOXXXXGOOOOOXXXXXXXXXXXXXX,0,0,0
42714,125,0,125,37,438,0,0,150,96,54,GOOOOOOOOOOOOXXXXXXXGOOOOOOOOXXXXXXXXXXXGOOOOOXXXXXXXXXXXXXXGOOOOOOOOOOXXXXXXXXXGOOOOOOOXXXXXXXXXXXXGOOOOOOOOOOOOXXXXXXXGOOOOOOOOXXXXXXXXXXXGOOXXXXXXXXXXXXXXXXXGOOOOOOOOOOXXXXXXXXXGOOOOOXXXXXXXXXXXXXXGOOOOOOOOOOOOOXXXXXXGOOOOOOOOOOOOOOOXXXXGOOOOOXXXXXXXXXXXXXX,0,0,0

42735,125,0,125,35,440,0,0,151,95,56,GOOOOOOOOOOOOXXXXXXXGOOOOOOOOXXXXXXXXXXXGOOOOOXXXXXXXXXXXXXXGOOOOOOOOOOXXXXXXXXXGOOOOOOOXXXXXXXXXXXXGOOOOOOOOOOOOXXXXXXXGOOOOOOOOXXXXXXXXXXXGOOXXXXXXXXXXXXXXXXXGOOOOOOOOOOXXXXXXXXXGOOOOOXXXXXXXXXXXXXXGOOOOOOOOOOOOOXXXXXXGOOOOOOOOOOOOOOOXXXXGOOOOOXXXXXXXXXXXXXX,0,0,0
42756,125,0,125,37,438,0,0,150,95,55,GOOOOOOOOOOOOXXXXXXXGOOOOOOOOXXXXXXXXXXXGOOOOOXXXXXXXXXXXXXXGOOOOOOOOOOXXXXXXXXXGOOOOOOOXXXXXXXXXXXXGOOOOOOOOOOOOXXXXXXXGOOOOOOOOXXXXXXXXXXXGOOXXXXXXXXXXXXXXXXXGOOOOOOOOOOXXXXXXXXXGOOOOOXXXXXXXXXXXXXXGOOOOOOOOOOOOOXXXXXXGOOOOOOOOOOOOOOOXXXXGOOOOOXXXXXXXXXXXXXX,0,0,0
42777,125,0,125,39,436,0,0,148,93,55,GOOOOOOOOOOOOXXXXXXXGOOOOOOOOXXXXXXXXXXXGOOOOOXXXXXXXXXXXXXXGOOOOOOOOOOXXXXXXXXXGOOOOOOOXXXXXXXXXXXXGOOOOOOOOOOOOXXXXXXXGOOOOOOOOXXXXXXXXXXXGOOXXXXXXXXXXXXXXXXXGOOOOOOOOOOXXXXXXXXXGOOOOOXXXXXXXXXXXXXXGOOOOOOOOOOOOOXXXXXXGOOOOOOOOOOOOOOOXXXXGOOOOOXXXXXXXXXXXXXX,0,0,0
42798,125,0,125,37,438,0,0,150,95,55,GOOOOOOOOOOOOXXXXXXXGOOOOOOOOXXXXXXXXXXXGOOOOOXXXXXXXXXXXXXXGOOOOOOOOOOXXXXXXXXXGOOOOOOOXXXXXXXXXXXXGOOOOOOOOOOOOXXXXXXXGOOOOOOOOXXXXXXXXXXXGOOXXXXXXXXXXXXXXXXXGOOOOOOOOOOXXXXXXXXXGOOOOOXXXXXXXXXXXXXXGOOOOOOOOOOOOOXXXXXXGOOOOOOOOOOOOOOOXXXXGOOOOOXXXXXXXXXXXXXX,0,0,0
42819,125,0,125,40,435,0,0,147,96,51,GOOOOOOOOOOOOXXXXXXXGOOOOOOOOXXXXXXXXXXXGOOOOOXXXXXXXXXXXXXXGOOOOOOOOOOXXXXXXXXXGOOOOOOOXXXXXXXXXXXXGOOOOOOOOOOOOXXXXXXXGOOOOOOOOXXXXXXXXXXXGOOXXXXXXXXXXXXXXXXXGOOOOOOOOOOXXXXXXXXXGOOOOOXXXXXXXXXXXXXXGOOOOOOOOOOOOOXXXXXXGOOOOOOOOOOOOOOOXXXXGOOOOOXXXXXXXXXXXXXX,0,0,0

42840,125,0,125,40,435,0,0,146,92,54,GOOOOOOOOOOOOXXXXXXXGOOOOOOOOXXXXXXXXXXXGOOOOOXXXXXXXXXXXXXXGOOOOOOOOOOXXXXXXXXXGOOOOOOOXXXXXXXXXXXXGOOOOOOOOOOOOXXXXXXXGOOOOOOOOXXXXXXXXXXXGOOXXXXXXXXXXXXXXXXXGOOOOOOOOOOXXXXXXXXXGOOOOOXXXXXXXXXXXXXXGOOOOOOOOOOOOOXXXXXXGOOOOOOOOOOOOOOOXXXXGOOOOOXXXXXXXXXXXXXX,0,0,0
42861,125,0,125,37,438,0,0,150,95,55,GOOOOOOOOOOOOXXXXXXXGOOOOOOOOXXXXXXXXXXXGOOOOOXXXXXXXXXXXXXXGOOOOOOOOOOXXXXXXXXXGOOOOOOOXXXXXXXXXXXXGOOOOOOOOOOOOXXXXXXXGOOOOOOOOXXXXXXXXXXXGOOXXXXXXXXXXXXXXXXXGOOOOOOOOOOXXXXXXXXXGOOOOOXXXXXXXXXXXXXXGOOOOOOOOOOOOOXXXXXXGOOOOOOOOOOOOOOOXXXXGOOOOOXXXXXXXXXXXXXX,0,0,0
42882,126,1,125,37,437,0,0,149,92,57,GOOOOOOOOOOOOXXXXXXXGOOOOOOOOXXXXXXXXXXXGOOOOOXXXXXXXXXXXXXXGOOOOOOOOOOAXXXXXXXXGOOOOOOOXXXXXXXXXXXXGOOOOOOOOOOOOXXXXXXXGOOOOOOOOXXXXXXXXXXXGOOXXXXXXXXXXXXXXXXXGOOOOOOOOOOXXXXXXXXXGOOOOOXXXXXXXXXXXXXXGOOOOOOOOOOOOOXXXXXXGOOOOOOOOOOOOOOOXXXXGOOOOOXXXXXXXXXXXXXX,0,0,0
42903,126,1,125,32,442,0,0,154,95,59,GOOOOOOOOOOOOXXXXXXXGOOOOOOOOXXXXXXXXXXXGOOOOOXXXXXXXXXXXXXXGOOOOOOOOOOAXXXXXXXXGOOOOOOOXXXXXXXXXXXXGOOOOOOOOOOOOXXXXXXXGOOOOOOOOXXXXXXXXXXXGOOXXXXXXXXXXXXXXXXXGOOOOOOOOOOXXXXXXXXXGOOOOOXXXXXXXXXXXXXXGOOOOOOOOOOOOOXXXXXXGOOOOOOOOOOOOOOOXXXXGOOOOOXXXXXXXXXXXXXX,0,0,0
42924,126,1,125,32,442,0,0,153,94,59,GOOOOOOOOOOOOXXXXXXXGOOOOOOOOXXXXXXXXXXXGOOOOOXXXXXXXXXXXXXXGOOOOOOOOOOAXXXXXXXXGOOOOOOOXXXXXXXXXXXXGOOOOOOOOOOOOXXXXXXXGOOOOOOOOXXXXXXXXXXXGOOXXXXXXXXXXXXXXXXXGOOOOOOOOOOXXXXXXXXXGOOOOOXXXXXXXXXXXXXXGOOOOOOOOOOOOOXXXXXXGOOOOOOOOOOOOOOOXXXXGOOOOOXXXXXXXXXXXXXX,0,0,0

42945,126,1,125,34,440,0,0,151,95,56,GOOOOOOOOOOOOXXXXXXXGOOOOOOOOXXXXXXXXXXXGOOOOOXXXXXXXXXXXXXXGOOOOOOOOOOAXXXXXXXXGOOOOOOOXXXXXXXXXXXXGOOOOOOOOOOOOXXXXXXXGOOOOOOOOXXXXXXXXXXXGOOXXXXXXXXXXXXXXXXXGOOOOOOOOOOXXXXXXXXXGOOOOOXXXXXXXXXXXXXXGOOOOOOOOOOOOOXXXXXXGOOOOOOOOOOOOOOOXXXXGOOOOOXXXXXXXXXXXXXX,0,0,0
42966,126,1,125,33,441,0,0,151,94,57,GOOOOOOOOOOOOXXXXXXXGOOOOOOOOXXXXXXXXXXXGOOOOOXXXXXXXXXXXXXXGOOOOOOOOOOAXXXXXXXXGOOOOOOOXXXXXXXXXXXXGOOOOOOOOOOOOXXXXXXXGOOOOOOOOXXXXXXXXXXXGOOXXXXXXXXXXXXXXXXXGOOOOOOOOOOXXXXXXXXXGOOOOOXXXXXXXXXXXXXXGOOOOOOOOOOOOOXXXXXXGOOOOOOOOOOOOOOOXXXXGOOOOOXXXXXXXXXXXXXX,0,0,0
42987,127,1,126,35,438,0,0,149,93,56,GOOOOOOOOOOOOAXXXXXXGOOOOOOOOXXXXXXXXXXXGOOOOOXXXXXXXXXXXXXXGOOOOOOOOOOOXXXXXXXXGOOOOOOOXXXXXXXXXXXXGOOOOOOOOOOOOXXXXXXXGOOOOOOOOXXXXXXXXXXXGOOXXXXXXXXXXXXXXXXXGOOOOOOOOOOXXXXXXXXXGOOOOOXXXXXXXXXXXXXXGOOOOOOOOOOOOOXXXXXXGOOOOOOOOOOOOOOOXXXXGOOOOOXXXXXXXXXXXXXX,0,0,0
43008,127,1,126,32,441,0,0,152,94,58,GOOOOOOOOOOOOAXXXXXXGOOOOOOOOXXXXXXXXXXXGOOOOOXXXXXXXXXXXXXXGOOOOOOOOOOOXXXXXXXXGOOOOOOOXXXXXXXXXXXXGOOOOOOOOOOOOXXXXXXXGOOOOOOOOXXXXXXXXXXXGOOXXXXXXXXXXXXXXXXXGOOOOOOOOOOXXXXXXXXXGOOOOOXXXXXXXXXXXXXXGOOOOOOOOOOOOOXXXXXXGOOOOOOOOOOOOOOOXXXXGOOOOOXXXXXXXXXXXXXX,0,0,0
43029,127,1,126,28,445,0,0,156,94,62,GOOOOOOOOOOOOAXXXXXXGOOOOOOOOXXXXXXXXXXXGOOOOOXXXXXXXXXXXXXXGOOOOOOOOOOOXXXXXXXXGOOOOOOOXXXXXXXXXXXXGOOOOOOOOOOOOXXXXXXXGOOOOOOOOXXXXXXXXXXXGOOXXXXXXXXXXXXXXXXXGOOOOOOOOOOXXXXXXXXXGOOOOOXXXXXXXXXXXXXXGOOOOOOOOOOOOOXXXXXXGOOOOOOOOOOOOOOOXXXXGOOOOOXXXXXXXXXXXXXX,0,0,0

43050,127,1,126,29,444,0,0,155,92,63,GOOOOOOOOOOOOAXXXXXXGOOOOOOOOXXXXXXXXXXXGOOOOOXXXXXXXXXXXXXXGOOOOOOOOOOOXXXXXXXXGOOOOOOOXXXXXXXXXXXXGOOOOOOOOOOOOXXXXXXXGOOOOOOOOXXXXXXXXXXXGOOXXXXXXXXXXXXXXXXXGOOOOOOOOOOXXXXXXXXXGOOOOOXXXXXXXXXXXXXXGOOOOOOOOOOOOOXXXXXXGOOOOOOOOOOOOOOOXXXXGOOOOOXXXXXXXXXXXXXX,0,0,0
43071,127,1,126,27,446,0,0,157,95,62,GOOOOOOOOOOOOAXXXXXXGOOOOOOOOXXXXXXXXXXXGOOOOOXXXXXXXXXXXXXXGOOOOOOOOOOOXXXXXXXXGOOOOOOOXXXXXXXXXXXXGOOOOOOOOOOOOXXXXXXXGOOOOOOOOXXXXXXXXXXXGOOXXXXXXXXXXXXXXXXXGOOOOOOOOOOXXXXXXXXXGOOOOOXXXXXXXXXXXXXXGOOOOOOOOOOOOOXXXXXXGOOOOOOOOOOOOOOOXXXXGOOOOOXXXXXXXXXXXXXX,0,0,0
43092,127,1,126,33,440,0,0,151,94,57,GOOOOOOOOOOOOAXXXXXXGOOOOOOOOXXXXXXXXXXXGOOOOOXXXXXXXXXXXXXXGOOOOOOOOOOOXXXXXXXXGOOOOOOOXXXXXXXXXXXXGOOOOOOOOOOOOXXXXXXXGOOOOOOOOXXXXXXXXXXXGOOXXXXXXXXXXXXXXXXXGOOOOOOOOOOXXXXXXXXXGOOOOOXXXXXXXXXXXXXXGOOOOOOOOOOOOOXXXXXXGOOOOOOOOOOOOOOOXXXXGOOOOOXXXXXXXXXXXXXX,0,0,0
43113,127,1,126,28,445,0,0,156,93,63,GOOOOOOOOOOOOAXXXXXXGOOOOOOOOXXXXXXXXXXXGOOOOOXXXXXXXXXXXXXXGOOOOOOOOOOOXXXXXXXXGOOOOOOOXXXXXXXXXXXXGOOOOOOOOOOOOXXXXXXXGOOOOOOOOXXXXXXXXXXXGOOXXXXXXXXXXXXXXXXXGOOOOOOOOOOXXXXXXXXXGOOOOOXXXXXXXXXXXXXXGOOOOOOOOOOOOOXXXXXXGOOOOOOOOOOOOOOOXXXXGOOOOOXXXXXXXXXXXXXX,0,0,0
43134,127,1,126,28,445,0,0,156,94,62,GOOOOOOOOOOOOAXXXXXXGOOOOOOOOXXXXXXXXXXXGOOOOOXXXXXXXXXXXXXXGOOOOOOOOOOOXXXXXXXXGOOOOOOOXXXXXXXXXXXXGOOOOOOOOOOOOXXXXXXXGOOOOOOOOXXXXXXXXXXXGOOXXXXXXXXXXXXXXXXXGOOOOOOOOOOXXXXXXXXXGOOOOOXXXXXXXXXXXXXXGOOOOOOOOOOOOOXXXXXXGOOOOOOOOOOOOOOOXXXXGOOOOOXXXXXXXXXXXXXX,0,0,0

43155,127,1,126,30,443,0,0,154,92,62,GOOOOOOOOOOOOAXXXXXXGOOOOOOOOXXXXXXXXXXXGOOOOOXXXXXXXXXXXXXXGOOOOOOOOOOOXXXXXXXXGOOOOOOOXXXXXXXXXXXXGOOOOOOOOOOOOXXXXXXXGOOOOOOOOXXXXXXXXXXXGOOXXXXXXXXXXXXXXXXXGOOOOOOOOOOXXXXXXXXXGOOOOOXXXXXXXXXXXXXXGOOOOOOOOOOOOOXXXXXXGOOOOOOOOOOOOOOOXXXXGOOOOOXXXXXXXXXXXXXX,0,0,0
43176,127,1,126,31,442,0,0,153,94,59,GOOOOOOOOOOOOAXXXXXXGOOOOOOOOXXXXXXXXXXXGOOOOOXXXXXXXXXXXXXXGOOOOOOOOOOOXXXXXXXXGOOOOOOOXXXXXXXXXXXXGOOOOOOOOOOOOXXXXXXXGOOOOOOOOXXXXXXXXXXXGOOXXXXXXXXXXXXXXXXXGOOOOOOOOOOXXXXXXXXXGOOOOOXXXXXXXXXXXXXXGOOOOOOOOOOOOOXXXXXXGOOOOOOOOOOOOOOOXXXXGOOOOOXXXXXXXXXXXXXX,0,0,0
43197,127,0,127,31,442,0,0,153,94,59,GOOOOOOOOOOOOOXXXXXXGOOOOOOOOXXXXXXXXXXXGOOOOOXXXXXXXXXXXXXXGOOOOOOOOOOOXXXXXXXXGOOOOOOOXXXXXXXXXXXXGOOOOOOOOOOOOXXXXXXXGOOOOOOOOXXXXXXXXXXXGOOXXXXXXXXXXXXXXXXXGOOOOOOOOOOXXXXXXXXXGOOOOOXXXXXXXXXXXXXXGOOOOOOOOOOOOOXXXXXXGOOOOOOOOOOOOOOOXXXXGOOOOOXXXXXXXXXXXXXX,0,0,0
43218,127,0,127,30,443,0,0,154,95,59,GOOOOOOOOOOOOOXXXXXXGOOOOOOOOXXXXXXXXXXXGOOOOOXXXXXXXXXXXXXXGOOOOOOOOOOOXXXXXXXXGOOOOOOOXXXXXXXXXXXXGOOOOOOOOOOOOXXXXXXXGOOOOOOOOXXXXXXXXXXXGOOXXXXXXXXXXXXXXXXXGOOOOOOOOOOXXXXXXXXXGOOOOOXXXXXXXXXXXXXXGOOOOOOOOOOOOOXXXXXXGOOOOOOOOOOOOOOOXXXXGOOOOOXXXXXXXXXXXXXX,0,0,0
43239,127,0,127,28,445,0,0,156,98,58,GOOOOOOOOOOOOOXXXXXXGOOOOOOOOXXXXXXXXXXXGOOOOOXXXXXXXXXXXXXXGOOOOOOOOOOOXXXXXXXXGOOOOOOOXXXXXXXXXXXXGOOOOOOOOOOOOXXXXXXXGOOOOOOOOXXXXXXXXXXXGOOXXXXXXXXXXXXXXXXXGOOOOOOOOOOXXXXXXXXXGOOOOOXXXXXXXXXXXXXXGOOOOOOOOOOOOOXXXXXXGOOOOOOOOOOOOOOOXXXXGOOOOOXXXXXXXXXXXXXX,0,0,0

43260,127,0,127,33,440,0,0,151,96,55,GOOOOOOOOOOOOOXXXXXXGOOOOOOOOXXXXXXXXXXXGOOOOOXXXXXXXXXXXXXXGOOOOOOOOOOOXXXXXXXXGOOOOOOOXXXXXXXXXXXXGOOOOOOOOOOOOXXXXXXXGOOOOOOOOXXXXXXXXXXXGOOXXXXXXXXXXXXXXXXXGOOOOOOOOOOXXXXXXXXXGOOOOOXXXXXXXXXXXXXXGOOOOOOOOOOOOOXXXXXXGOOOOOOOOOOOOOOOXXXXGOOOOOXXXXXXXXXXXXXX,0,0,0
43281,127,0,127,32,441,0,0,152,97,55,GOOOOOOOOOOOOOXXXXXXGOOOOOOOOXXXXXXXXXXXGOOOOOXXXXXXXXXXXXXXGOOOOOOOOOOOXXXXXXXXGOOOOOOOXXXXXXXXXXXXGOOOOOOOOOOOOXXXXXXXGOOOOOOOOXXXXXXXXXXXGOOXXXXXXXXXXXXXXXXXGOOOOOOOOOOXXXXXXXXXGOOOOOXXXXXXXXXXXXXXGOOOOOOOOOOOOOXXXXXXGOOOOOOOOOOOOOOOXXXXGOOOOOXXXXXXXXXXXXXX,0,0,0
43302,127,0,127,33,440,0,0,151,93,58,GOOOOOOOOOOOOOXXXXXXGOOOOOOOOXXXXXXXXXXXGOOOOOXXXXXXXXXXXXXXGOOOOOOOOOOOXXXXXXXXGOOOOOOOXXXXXXXXXXXXGOOOOOOOOOOOOXXXXXXXGOOOOOOOOXXXXXXXXXXXGOOXXXXXXXXXXXXXXXXXGOOOOOOOOOOXXXXXXXXXGOOOOOXXXXXXXXXXXXXXGOOOOOOOOOOOOOXXXXXXGOOOOOOOOOOOOOOOXXXXGOOOOOXXXXXXXXXXXXXX,0,0,0
43323,127,0,127,34,439,0,0,149,96,53,GOOOOOOOOOOOOOXXXXXXGOOOOOOOOXXXXXXXXXXXGOOOOOXXXXXXXXXXXXXXGOOOOOOOOOOOXXXXXXXXGOOOOOOOXXXXXXXXXXXXGOOOOOOOOOOOOXXXXXXXGOOOOOOOOXXXXXXXXXXXGOOXXXXXXXXXXXXXXXXXGOOOOOOOOOOXXXXXXXXXGOOOOOXXXXXXXXXXXXXXGOOOOOOOOOOOOOXXXXXXGOOOOOOOOOOOOOOOXXXXGOOOOOXXXXXXXXXXXXXX,0,0,0
43344,128,1,127,36,436,0,0,147,94,53,GOOOOOOOOOOOOOXXXXXXGOOOOOOOOXXXXXXXXXXXGOOOOOXXXXXXXXXXXXXXGOOOOOOOOOOOXXXXXXXXGOOOOOOOXXXXXXXXXXXXGOOOOOOOOOOOOXXXXXXXGOOOOOOOOXXXXXXXXXXXGOOXXXXXXXXXXXXXXXXXGOOOOOOOOOOXXXXXXXXXGOOOOOXXXXXXXXXXXXXXGOOOOOOOOOOOOOXXXXXXGOOOOOOOOOOOOOOOAXXXGOOOOOXXXXXXXXXXXXXX,0,0,0

43365,128,1,127,36,436,0,0,147,94,53,GOOOOOOOOOOOOOXXXXXXGOOOOOOOOXXXXXXXXXXXGOOOOOXXXXXXXXXXXXXXGOOOOOOOOOOOXXXXXXXXGOOOOOOOXXXXXXXXXXXXGOOOOOOOOOOOOXXXXXXXGOOOOOOOOXXXXXXXXXXXGOOXXXXXXXXXXXXXXXXXGOOOOOOOOOOXXXXXXXXXGOOOOOXXXXXXXXXXXXXXGOOOOOOOOOOOOOXXXXXXGOOOOOOOOOOOOOOOAXXXGOOOOOXXXXXXXXXXXXXX,0,0,0
43386,128,1,127,36,436,0,0,147,95,52,GOOOOOOOOOOOOOXXXXXXGOOOOOOOOXXXXXXXXXXXGOOOOOXXXXXXXXXXXXXXGOOOOOOOOOOOXXXXXXXXGOOOOOOOXXXXXXXXXXXXGOOOOOOOOOOOOXXXXXXXGOOOOOOOOXXXXXXXXXXXGOOXXXXXXXXXXXXXXXXXGOOOOOOOOOOXXXXXXXXXGOOOOOXXXXXXXXXXXXXXGOOOOOOOOOOOOOXXXXXXGOOOOOOOOOOOOOOOAXXXGOOOOOXXXXXXXXXXXXXX,0,0,0
43407,128,1,127,32,440,0,0,151,95,56,GOOOOOOOOOOOOOXXXXXXGOOOOOOOOXXXXXXXXXXXGOOOOOXXXXXXXXXXXXXXGOOOOOOOOOOOXXXXXXXXGOOOOOOOXXXXXXXXXXXXGOOOOOOOOOOOOXXXXXXXGOOOOOOOOXXXXXXXXXXXGOOXXXXXXXXXXXXXXXXXGOOOOOOOOOOXXXXXXXXXGOOOOOXXXXXXXXXXXXXXGOOOOOOOOOOOOOXXXXXXGOOOOOOOOOOOOOOOAXXXGOOOOOXXXXXXXXXXXXXX,0,0,0
43428,128,1,127,36,436,0,0,147,95,52,GOOOOOOOOOOOOOXXXXXXGOOOOOOOOXXXXXXXXXXXGOOOOOXXXXXXXXXXXXXXGOOOOOOOOOOOXXXXXXXXGOOOOOOOXXXXXXXXXXXXGOOOOOOOOOOOOXXXXXXXGOOOOOOOOXXXXXXXXXXXGOOXXXXXXXXXXXXXXXXXGOOOOOOOOOOXXXXXXXXXGOOOOOXXXXXXXXXXXXXXGOOOOOOOOOOOOOXXXXXXGOOOOOOOOOOOOOOOAXXXGOOOOOXXXXXXXXXXXXXX,0,0,0
43449,128,0,128,39,433,0,0,144,94,50,GOOOOOOOOOOOOOXXXXXXGOOOOOOOOXXXXXXXXXXXGOOOOOXXXXXXXXXXXXXXGOOOOOOOOOOOXXXXXXXXGOOOOOOOXXXXXXXXXXXXGOOOOOOOOOOOOXXXXXXXGOOOOOOOOXXXXXXXXXXXGOOXXXXXXXXXXXXXXXXXGOOOOOOOOOOXXXXXXXXXGOOOOOXXXXXXXXXXXXXXGOOOOOOOOOOOOOXXXXXXGOOOOOOOOOOOOOOOOXXXGOOOOOXXXXXXXXXXXXXX,0,0,0

43470,128,0,128,36,436,0,0,146,94,52,GOOOOOOOOOOOOOXXXXXXGOOOOOOOOXXXXXXXXXXXGOOOOOXXXXXXXXXXXXXXGOOOOOOOOOOOXXXXXXXXGOOOOOOOXXXXXXXXXXXXGOOOOOOOOOOOOXXXXXXXGOOOOOOOOXXXXXXXXXXXGOOXXXXXXXXXXXXXXXXXGOOOOOOOOOOXXXXXXXXXGOOOOOXXXXXXXXXXXXXXGOOOOOOOOOOOOOXXXXXXGOOOOOOOOOOOOOOOOXXXGOOOOOXXXXXXXXXXXXXX,0,0,0
43491,128,0,128,34,438,0,0,149,95,54,GOOOOOOOOOOOOOXXXXXXGOOOOOOOOXXXXXXXXXXXGOOOOOXXXXXXXXXXXXXXGOOOOOOOOOOOXXXXXXXXGOOOOOOOXXXXXXXXXXXXGOOOOOOOOOOOOXXXXXXXGOOOOOOOOXXXXXXXXXXXGOOXXXXXXXXXXXXXXXXXGOOOOOOOOOOXXXXXXXXXGOOOOOXXXXXXXXXXXXXXGOOOOOOOOOOOOOXXXXXXGOOOOOOOOOOOOOOOOXXXGOOOOOXXXXXXXXXXXXXX,0,0,0
43512,128,0,128,37,435,0,0,146,94,52,GOOOOOOOOOOOOOXXXXXXGOOOOOOOOXXXXXXXXXXXGOOOOOXXXXXXXXXXXXXXGOOOOOOOOOOOXXXXXXXXGOOOOOOOXXXXXXXXXXXXGOOOOOOOOOOOOXXXXXXXGOOOOOOOOXXXXXXXXXXXGOOXXXXXXXXXXXXXXXXXGOOOOOOOOOOXXXXXXXXXGOOOOOXXXXXXXXXXXXXXGOOOOOOOOOOOOOXXXXXXGOOOOOOOOOOOOOOOOXXXGOOOOOXXXXXXXXXXXXXX,0,0,0
43533,128,0,128,37,435,0,0,146,96,50,GOOOOOOOOOOOOOXXXXXXGOOOOOOOOXXXXXXXXXXXGOOOOOXXXXXXXXXXXXXXGOOOOOOOOOOOXXXXXXXXGOOOOOOOXXXXXXXXXXXXGOOOOOOOOOOOOXXXXXXXGOOOOOOOOXXXXXXXXXXXGOOXXXXXXXXXXXXXXXXXGOOOOOOOOOOXXXXXXXXXGOOOOOXXXXXXXXXXXXXXGOOOOOOOOOOOOOXXXXXXGOOOOOOOOOOOOOOOOXXXGOOOOOXXXXXXXXXXXXXX,0,0,0
43554,128,0,128,34,438,0,0,149,96,53,GOOOOOOOOOOOOOXXXXXXGOOOOOOOOXXXXXXXXXXXGOOOOOXXXXXXXXXXXXXXGOOOOOOOOOOOXXXXXXXXGOOOOOOOXXXXXXXXXXXXGOOOOOOOOOOOOXXXXXXXGOOOOOOOOXXXXXXXXXXXGOOXXXXXXXXXXXXXXXXXGOOOOOOOOOOXXXXXXXXXGOOOOOXXXXXXXXXXXXXXGOOOOOOOOOOOOOXXXXXXGOOOOOOOOOOOOOOOOXXXGOOOOOXXXXXXXXXXXXXX,0,0,0

43575,128,0,128,36,436,0,0,147,95,52,GOOOOOOOOOOOOOXXXXXXGOOOOOOOOXXXXXXXXXXXGOOOOOXXXXXXXXXXXXXXGOOOOOOOOOOOXXXXXXXXGOOOOOOOXXXXXXXXXXXXGOOOOOOOOOOOOXXXXXXXGOOOOOOOOXXXXXXXXXXXGOOXXXXXXXXXXXXXXXXXGOOOOOOOOOOXXXXXXXXXGOOOOOXXXXXXXXXXXXXXGOOOOOOOOOOOOOXXXXXXGOOOOOOOOOOOOOOOOXXXGOOOOOXXXXXXXXXXXXXX,0,0,0
43596,128,0,128,36,436,0,0,147,94,53,GOOOOOOOOOOOOOXXXXXXGOOOOOOOOXXXXXXXXXXXGOOOOOXXXXXXXXXXXXXXGOOOOOOOOOOOXXXXXXXXGOOOOOOOXXXXXXXXXXXXGOOOOOOOOOOOOXXXXXXXGOOOOOOOOXXXXXXXXXXXGOOXXXXXXXXXXXXXXXXXGOOOOOOOOOOXXXXXXXXXGOOOOOXXXXXXXXXXXXXXGOOOOOOOOOOOOOXXXXXXGOOOOOOOOOOOOOOOOXXXGOOOOOXXXXXXXXXXXXXX,0,0,0
43617,129,1,128,30,441,0,0,151,97,54,GOOOOOOOOOOOOOXXXXXXGOOOOOOOOXXXXXXXXXXXGOOOOOXXXXXXXXXXXXXXGOOOOOOOOOOOXXXXXXXXGOOOOOOOXXXXXXXXXXXXGOOOOOOOOOOOOXXXXXXXGOOOOOOOOXXXXXXXXXXXGOOXXXXXXXXXXXXXXXXXGOOOOOOOOOOAXXXXXXXXGOOOOOXXXXXXXXXXXXXXGOOOOOOOOOOOOOXXXXXXGOOOOOOOOOOOOOOOOXXXGOOOOOXXXXXXXXXXXXXX,0,0,0
43638,129,1,128,30,441,0,0,152,95,57,GOOOOOOOOOOOOOXXXXXXGOOOOOOOOXXXXXXXXXXXGOOOOOXXXXXXXXXXXXXXGOOOOOOOOOOOXXXXXXXXGOOOOOOOXXXXXXXXXXXXGOOOOOOOOOOOOXXXXXXXGOOOOOOOOXXXXXXXXXXXGOOXXXXXXXXXXXXXXXXXGOOOOOOOOOOAXXXXXXXXGOOOOOXXXXXXXXXXXXXXGOOOOOOOOOOOOOXXXXXXGOOOOOOOOOOOOOOOOXXXGOOOOOXXXXXXXXXXXXXX,0,0,0
43659,129,1,128,31,440,0,0,150,93,57,GOOOOOOOOOOOOOXXXXXXGOOOOOOOOXXXXXXXXXXXGOOOOOXXXXXXXXXXXXXXGOOOOOOOOOOOXXXXXXXXGOOOOOOOXXXXXXXXXXXXGOOOOOOOOOOOOXXXXXXXGOOOOOOOOXXXXXXXXXXXGOOXXXXXXXXXXXXXXXXXGOOOOOOOOOOAXXXXXXXXGOOOOOXXXXXXXXXXXXXXGOOOOOOOOOOOOOXXXXXXGOOOOOOOOOOOOOOOOXXXGOOOOOXXXXXXXXXXXXXX,0,0,0

43680,129,1,128,31,440,0,0,151,94,57,GOOOOOOOOOOOOOXXXXXXGOOOOOOOOXXXXXXXXXXXGOOOOOXXXXXXXXXXXXXXGOOOOOOOOOOOXXXXXXXXGOOOOOOOXXXXXXXXXXXXGOOOOOOOOOOOOXXXXXXXGOOOOOOOOXXXXXXXXXXXGOOXXXXXXXXXXXXXXXXXGOOOOOOOOOOAXXXXXXXXGOOOOOXXXXXXXXXXXXXXGOOOOOOOOOOOOOXXXXXXGOOOOOOOOOOOOOOOOXXXGOOOOOXXXXXXXXXXXXXX,0,0,0
43701,129,1,128,29,442,0,0,153,97,56,GOOOOOOOOOOOOOXXXXXXGOOOOOOOOXXXXXXXXXXXGOOOOOXXXXXXXXXXXXXXGOOOOOOOOOOOXXXXXXXXGOOOOOOOXXXXXXXXXXXXGOOOOOOOOOOOOXXXXXXXGOOOOOOOOXXXXXXXXXXXGOOXXXXXXXXXXXXXXXXXGOOOOOOOOOOAXXXXXXXXGOOOOOXXXXXXXXXXXXXXGOOOOOOOOOOOOOXXXXXXGOOOOOOOOOOOOOOOOXXXGOOOOOXXXXXXXXXXXXXX,0,0,0
43722,129,1,128,29,442,0,0,153,99,54,GOOOOOOOOOOOOOXXXXXXGOOOOOOOOXXXXXXXXXXXGOOOOOXXXXXXXXXXXXXXGOOOOOOOOOOOXXXXXXXXGOOOOOOOXXXXXXXXXXXXGOOOOOOOOOOOOXXXXXXXGOOOOOOOOXXXXXXXXXXXGOOXXXXXXXXXXXXXXXXXGOOOOOOOOOOAXXXXXXXXGOOOOOXXXXXXXXXXXXXXGOOOOOOOOOOOOOXXXXXXGOOOOOOOOOOOOOOOOXXXGOOOOOXXXXXXXXXXXXXX,0,0,0
43743,129,1,128,31,440,0,0,151,97,54,GOOOOOOOOOOOOOXXXXXXGOOOOOOOOXXXXXXXXXXXGOOOOOXXXXXXXXXXXXXXGOOOOOOOOOOOXXXXXXXXGOOOOOOOXXXXXXXXXXXXGOOOOOOOOOOOOXXXXXXXGOOOOOOOOXXXXXXXXXXXGOOXXXXXXXXXXXXXXXXXGOOOOOOOOOOAXXXXXXXXGOOOOOXXXXXXXXXXXXXXGOOOOOOOOOOOOOXXXXXXGOOOOOOOOOOOOOOOOXXXGOOOOOXXXXXXXXXXXXXX,0,0,0
43764,129,1,128,33,438,0,0,149,95,54,GOOOOOOOOOOOOOXXXXXXGOOOOOOOOXXXXXXXXXXXGOOOOOXXXXXXXXXXXXXXGOOOOOOOOOOOXXXXXXXXGOOOOOOOXXXXXXXXXXXXGOOOOOOOOOOOOXXXXXXXGOOOOOOOOXXXXXXXXXXXGOOXXXXXXXXXXXXXXXXXGOOOOOOOOOOAXXXXXXXXGOOOOOXXXXXXXXXXXXXXGOOOOOOOOOOOOOXXXXXXGOOOOOOOOOOOOOOOOXXXGOOOOOXXXXXXXXXXXXXX,0,0,0

43785,129,1,128,31,440,0,0,151,96,55,GOOOOOOOOOOOOOXXXXXXGOOOOOOOOXXXXXXXXXXXGOOOOOXXXXXXXXXXXXXXGOOOOOOOOOOOXXXXXXXXGOOOOOOOXXXXXXXXXXXXGOOOOOOOOOOOOXXXXXXXGOOOOOOOOXXXXXXXXXXXGOOXXXXXXXXXXXXXXXXXGOOOOOOOOOOAXXXXXXXXGOOOOOXXXXXXXXXXXXXXGOOOOOOOOOOOOOXXXXXXGOOOOOOOOOOOOOOOOXXXGOOOOOXXXXXXXXXXXXXX,0,0,0
43806,129,1,128,34,437,0,0,148,96,52,GOOOOOOOOOOOOOXXXXXXGOOOOOOOOXXXXXXXXXXXGOOOOOXXXXXXXXXXXXXXGOOOOOOOOOOOXXXXXXXXGOOOOOOOXXXXXXXXXXXXGOOOOOOOOOOOOXXXXXXXGOOOOOOOOXXXXXXXXXXXGOOXXXXXXXXXXXXXXXXXGOOOOOOOOOOAXXXXXXXXGOOOOOXXXXXXXXXXXXXXGOOOOOOOOOOOOOXXXXXXGOOOOOOOOOOOOOOOOXXXGOOOOOXXXXXXXXXXXXXX,0,0,0
43827,129,1,128,31,440,0,0,152,95,57,GOOOOOOOOOOOOOXXXXXXGOOOOOOOOXXXXXXXXXXXGOOOOOXXXXXXXXXXXXXXGOOOOOOOOOOOXXXXXXXXGOOOOOOOXXXXXXXXXXXXGOOOOOOOOOOOOXXXXXXXGOOOOOOOOXXXXXXXXXXXGOOXXXXXXXXXXXXXXXXXGOOOOOOOOOOAXXXXXXXXGOOOOOXXXXXXXXXXXXXXGOOOOOOOOOOOOOXXXXXXGOOOOOOOOOOOOOOOOXXXGOOOOOXXXXXXXXXXXXXX,0,0,0
43848,129,0,129,29,442,0,0,154,95,59,GOOOOOOOOOOOOOXXXXXXGOOOOOOOOXXXXXXXXXXXGOOOOOXXXXXXXXXXXXXXGOOOOOOOOOOOXXXXXXXXGOOOOOOOXXXXXXXXXXXXGOOOOOOOOOOOOXXXXXXXGOOOOOOOOXXXXXXXXXXXGOOXXXXXXXXXXXXXXXXXGOOOOOOOOOOOXXXXXXXXGOOOOOXXXXXXXXXXXXXXGOOOOOOOOOOOOOXXXXXXGOOOOOOOOOOOOOOOOXXXGOOOOOXXXXXXXXXXXXXX,0,0,0
43869,129,0,129,33,438,0,0,150,96,54,GOOOOOOOOOOOOOXXXXXXGOOOOOOOOXXXXXXXXXXXGOOOOOXXXXXXXXXXXXXXGOOOOOOOOOOOXXXXXXXXGOOOOOOOXXXXXXXXXXXXGOOOOOOOOOOOOXXXXXXXGOOOOOOOOXXXXXXXXXXXGOOXXXXXXXXXXXXXXXXXGOOOOOOOOOOOXXXXXXXXGOOOOOXXXXXXXXXXXXXXGOOOOOOOOOOOOOXXXXXXGOOOOOOOOOOOOOOOOXXXGOOOOOXXXXXXXXXXXXXX,0,0,0

43890,130,1,129,33,437,0,0,149,94,55,GOOOOOOOOOOOOOXXXXXXGOOOOOOOOXXXXXXXXXXXGOOOOOXXXXXXXXXXXXXXGOOOOOOOOOOOXXXXXXXXGOOOOOOOXXXXXXXXXXXXGOOOOOOOOOOOOXXXXXXXGOOOOOOOOXXXXXXXXXXXGOOXXXXXXXXXXXXXXXXXGOOOOOOOOOOOXXXXXXXXGOOOOOXXXXXXXXXXXXXXGOOOOOOOOOOOOOXXXXXXGOOOOOOOOOOOOOOOOXXXGOOOOOAXXXXXXXXXXXXX,0,0,0
43911,130,1,129,34,436,0,0,148,95,53,GOOOOOOOOOOOOOXXXXXXGOOOOOOOOXXXXXXXXXXXGOOOOOXXXXXXXXXXXXXXGOOOOOOOOOOOXXXXXXXXGOOOOOOOXXXXXXXXXXXXGOOOOOOOOOOOOXXXXXXXGOOOOOOOOXXXXXXXXXXXGOOXXXXXXXXXXXXXXXXXGOOOOOOOOOOOXXXXXXXXGOOOOOXXXXXXXXXXXXXXGOOOOOOOOOOOOOXXXXXXGOOOOOOOOOOOOOOOOXXXGOOOOOAXXXXXXXXXXXXX,0,0,0
43932,130,0,130,30,440,0,0,152,98,54,GOOOOOOOOOOOOOXXXXXXGOOOOOOOOXXXXXXXXXXXGOOOOOXXXXXXXXXXXXXXGOOOOOOOOOOOXXXXXXXXGOOOOOOOXXXXXXXXXXXXGOOOOOOOOOOOOXXXXXXXGOOOOOOOOXXXXXXXXXXXGOOXXXXXXXXXXXXXXXXXGOOOOOOOOOOOXXXXXXXXGOOOOOXXXXXXXXXXXXXXGOOOOOOOOOOOOOXXXXXXGOOOOOOOOOOOOOOOOXXXGOOOOOOXXXXXXXXXXXXX,0,0,0
43953,130,0,130,31,439,0,0,151,98,53,GOOOOOOOOOOOOOXXXXXXGOOOOOOOOXXXXXXXXXXXGOOOOOXXXXXXXXXXXXXXGOOOOOOOOOOOXXXXXXXXGOOOOOOOXXXXXXXXXXXXGOOOOOOOOOOOOXXXXXXXGOOOOOOOOXXXXXXXXXXXGOOXXXXXXXXXXXXXXXXXGOOOOOOOOOOOXXXXXXXXGOOOOOXXXXXXXXXXXXXXGOOOOOOOOOOOOOXXXXXXGOOOOOOOOOOOOOOOOXXXGOOOOOOXXXXXXXXXXXXX,0,0,0
43974,130,0,130,35,435,0,0,147,98,49,GOOOOOOOOOOOOOXXXXXXGOOOOOOOOXXXXXXXXXXXGOOOOOXXXXXXXXXXXXXXGOOOOOOOOOOOXXXXXXXXGOOOOOOOXXXXXXXXXXXXGOOOOOOOOOOOOXXXXXXXGOOOOOOOOXXXXXXXXXXXGOOXXXXXXXXXXXXXXXXXGOOOOOOOOOOOXXXXXXXXGOOOOOXXXXXXXXXXXXXXGOOOOOOOOOOOOOXXXXXXGOOOOOOOOOOOOOOOOXXXGOOOOOOXXXXXXXXXXXXX,0,0,0

43995,130,0,130,39,431,0,0,143,96,47,GOOOOOOOOOOOOOXXXXXXGOOOOOOOOXXXXXXXXXXXGOOOOOXXXXXXXXXXXXXXGOOOOOOOOOOOXXXXXXXXGOOOOOOOXXXXXXXXXXXXGOOOOOOOOOOOOXXXXXXXGOOOOOOOOXXXXXXXXXXXGOOXXXXXXXXXXXXXXXXXGOOOOOOOOOOOXXXXXXXXGOOOOOXXXXXXXXXXXXXXGOOOOOOOOOOOOOXXXXXXGOOOOOOOOOOOOOOOOXXXGOOOOOOXXXXXXXXXXXXX,0,0,0
44016,130,0,130,39,431,0,0,143,95,48,GOOOOOOOOOOOOOXXXXXXGOOOOOOOOXXXXXXXXXXXGOOOOOXXXXXXXXXXXXXXGOOOOOOOOOOOXXXXXXXXGOOOOOOOXXXXXXXXXXXXGOOOOOOOOOOOOXXXXXXXGOOOOOOOOXXXXXXXXXXXGOOXXXXXXXXXXXXXXXXXGOOOOOOOOOOOXXXXXXXXGOOOOOXXXXXXXXXXXXXXGOOOOOOOOOOOOOXXXXXXGOOOOOOOOOOOOOOOOXXXGOOOOOOXXXXXXXXXXXXX,0,0,0
44037,130,0,130,39,431,0,0,143,94,49,GOOOOOOOOOOOOOXXXXXXGOOOOOOOOXXXXXXXXXXXGOOOOOXXXXXXXXXXXXXXGOOOOOOOOOOOXXXXXXXXGOOOOOOOXXXXXXXXXXXXGOOOOOOOOOOOOXXXXXXXGOOOOOOOOXXXXXXXXXXXGOOXXXXXXXXXXXXXXXXXGOOOOOOOOOOOXXXXXXXXGOOOOOXXXXXXXXXXXXXXGOOOOOOOOOOOOOXXXXXXGOOOOOOOOOOOOOOOOXXXGOOOOOOXXXXXXXXXXXXX,0,0,0
44058,130,0,130,39,431,0,0,142,96,46,GOOOOOOOOOOOOOXXXXXXGOOOOOOOOXXXXXXXXXXXGOOOOOXXXXXXXXXXXXXXGOOOOOOOOOOOXXXXXXXXGOOOOOOOXXXXXXXXXXXXGOOOOOOOOOOOOXXXXXXXGOOOOOOOOXXXXXXXXXXXGOOXXXXXXXXXXXXXXXXXGOOOOOOOOOOOXXXXXXXXGOOOOOXXXXXXXXXXXXXXGOOOOOOOOOOOOOXXXXXXGOOOOOOOOOOOOOOOOXXXGOOOOOOXXXXXXXXXXXXX,0,0,0
44079,130,0,130,38,432,0,0,143,96,47,GOOOOOOOOOOOOOXXXXXXGOOOOOOOOXXXXXXXXXXXGOOOOOXXXXXXXXXXXXXXGOOOOOOOOOOOXXXXXXXXGOOOOOOOXXXXXXXXXXXXGOOOOOOOOOOOOXXXXXXXGOOOOOOOOXXXXXXXXXXXGOOXXXXXXXXXXXXXXXXXGOOOOOOOOOOOXXXXXXXXGOOOOOXXXXXXXXXXXXXXGOOOOOOOOOOOOOXXXXXXGOOOOOOOOOOOOOOOOXXXGOOOOOOXXXXXXXXXXXXX,0,0,0

44100,130,0,130,38,432,0,0,143,94,49,GOOOOOOOOOOOOOXXXXXXGOOOOOOOOXXXXXXXXXXXGOOOOOXXXXXXXXXXXXXXGOOOOOOOOOOOXXXXXXXXGOOOOOOOXXXXXXXXXXXXGOOOOOOOOOOOOXXXXXXXGOOOOOOOOXXXXXXXXXXXGOOXXXXXXXXXXXXXXXXXGOOOOOOOOOOOXXXXXXXXGOOOOOXXXXXXXXXXXXXXGOOOOOOOOOOOOOXXXXXXGOOOOOOOOOOOOOOOOXXXGOOOOOOXXXXXXXXXXXXX,0,0,0
44121,130,0,130,35,435,0,0,145,94,51,GOOOOOOOOOOOOOXXXXXXGOOOOOOOOXXXXXXXXXXXGOOOOOXXXXXXXXXXXXXXGOOOOOOOOOOOXXXXXXXXGOOOOOOOXXXXXXXXXXXXGOOOOOOOOOOOOXXXXXXXGOOOOOOOOXXXXXXXXXXXGOOXXXXXXXXXXXXXXXXXGOOOOOOOOOOOXXXXXXXXGOOOOOXXXXXXXXXXXXXXGOOOOOOOOOOOOOXXXXXXGOOOOOOOOOOOOOOOOXXXGOOOOOOXXXXXXXXXXXXX,0,0,0
44142,130,0,130,33,437,0,0,148,95,53,GOOOOOOOOOOOOOXXXXXXGOOOOOOOOXXXXXXXXXXXGOOOOOXXXXXXXXXXXXXXGOOOOOOOOOOOXXXXXXXXGOOOOOOOXXXXXXXXXXXXGOOOOOOOOOOOOXXXXXXXGOOOOOOOOXXXXXXXXXXXGOOXXXXXXXXXXXXXXXXXGOOOOOOOOOOOXXXXXXXXGOOOOOXXXXXXXXXXXXXXGOOOOOOOOOOOOOXXXXXXGOOOOOOOOOOOOOOOOXXXGOOOOOOXXXXXXXXXXXXX,0,0,0
44163,130,0,130,31,439,0,0,150,94,56,GOOOOOOOOOOOOOXXXXXXGOOOOOOOOXXXXXXXXXXXGOOOOOXXXXXXXXXXXXXXGOOOOOOOOOOOXXXXXXXXGOOOOOOOXXXXXXXXXXXXGOOOOOOOOOOOOXXXXXXXGOOOOOOOOXXXXXXXXXXXGOOXXXXXXXXXXXXXXXXXGOOOOOOOOOOOXXXXXXXXGOOOOOXXXXXXXXXXXXXXGOOOOOOOOOOOOOXXXXXXGOOOOOOOOOOOOOOOOXXXGOOOOOOXXXXXXXXXXXXX,0,0,0
44184,130,0,130,29,441,0,0,152,94,58,GOOOOOOOOOOOOOXXXXXXGOOOOOOOOXXXXXXXXXXXGOOOOOXXXXXXXXXXXXXXGOOOOOOOOOOOXXXXXXXXGOOOOOOOXXXXXXXXXXXXGOOOOOOOOOOOOXXXXXXXGOOOOOOOOXXXXXXXXXXXGOOXXXXXXXXXXXXXXXXXGOOOOOOOOOOOXXXXXXXXGOOOOOXXXXXXXXXXXXXXGOOOOOOOOOOOOOXXXXXXGOOOOOOOOOOOOOOOOXXXGOOOOOOXXXXXXXXXXXXX,0,0,0

44205,130,0,130,29,441,0,0,152,94,58,GOOOOOOOOOOOOOXXXXXXGOOOOOOOOXXXXXXXXXXXGOOOOOXXXXXXXXXXXXXXGOOOOOOOOOOOXXXXXXXXGOOOOOOOXXXXXXXXXXXXGOOOOOOOOOOOOXXXXXXXGOOOOOOOOXXXXXXXXXXXGOOXXXXXXXXXXXXXXXXXGOOOOOOOOOOOXXXXXXXXGOOOOOXXXXXXXXXXXXXXGOOOOOOOOOOOOOXXXXXXGOOOOOOOOOOOOOOOOXXXGOOOOOOXXXXXXXXXXXXX,0,0,0
44226,130,0,130,30,440,0,0,152,96,56,GOOOOOOOOOOOOOXXXXXXGOOOOOOOOXXXXXXXXXXXGOOOOOXXXXXXXXXXXXXXGOOOOOOOOOOOXXXXXXXXGOOOOOOOXXXXXXXXXXXXGOOOOOOOOOOOOXXXXXXXGOOOOOOOOXXXXXXXXXXXGOOXXXXXXXXXXXXXXXXXGOOOOOOOOOOOXXXXXXXXGOOOOOXXXXXXXXXXXXXXGOOOOOOOOOOOOOXXXXXXGOOOOOOOOOOOOOOOOXXXGOOOOOOXXXXXXXXXXXXX,0,0,0
44247,130,0,130,28,442,0,0,155,94,61,GOOOOOOOOOOOOOXXXXXXGOOOOOOOOXXXXXXXXXXXGOOOOOXXXXXXXXXXXXXXGOOOOOOOOOOOXXXXXXXXGOOOOOOOXXXXXXXXXXXXGOOOOOOOOOOOOXXXXXXXGOOOOOOOOXXXXXXXXXXXGOOXXXXXXXXXXXXXXXXXGOOOOOOOOOOOXXXXXXXXGOOOOOXXXXXXXXXXXXXXGOOOOOOOOOOOOOXXXXXXGOOOOOOOOOOOOOOOOXXXGOOOOOOXXXXXXXXXXXXX,0,0,0
44268,130,0,130,29,441,0,0,154,94,60,GOOOOOOOOOOOOOXXXXXXGOOOOOOOOXXXXXXXXXXXGOOOOOXXXXXXXXXXXXXXGOOOOOOOOOOOXXXXXXXXGOOOOOOOXXXXXXXXXXXXGOOOOOOOOOOOOXXXXXXXGOOOOOOOOXXXXXXXXXXXGOOXXXXXXXXXXXXXXXXXGOOOOOOOOOOOXXXXXXXXGOOOOOXXXXXXXXXXXXXXGOOOOOOOOOOOOOXXXXXXGOOOOOOOOOOOOOOOOXXXGOOOOOOXXXXXXXXXXXXX,0,0,0
44289,130,0,130,29,441,0,0,154,98,56,GOOOOOOOOOOOOOXXXXXXGOOOOOOOOXXXXXXXXXXXGOOOOOXXXXXXXXXXXXXXGOOOOOOOOOOOXXXXXXXXGOOOOOOOXXXXXXXXXXXXGOOOOOOOOOOOOXXXXXXXGOOOOOOOOXXXXXXXXXXXGOOXXXXXXXXXXXXXXXXXGOOOOOOOOOOOXXXXXXXXGOOOOOXXXXXXXXXXXXXXGOOOOOOOOOOOOOXXXXXXGOOOOOOOOOOOOOOOOXXXGOOOOOOXXXXXXXXXXXXX,0,0,0

44310,130,0,130,29,441,0,0,154,97,57,GOOOOOOOOOOOOOXXXXXXGOOOOOOOOXXXXXXXXXXXGOOOOOXXXXXXXXXXXXXXGOOOOOOOOOOOXXXXXXXXGOOOOOOOXXXXXXXXXXXXGOOOOOOOOOOOOXXXXXXXGOOOOOOOOXXXXXXXXXXXGOOXXXXXXXXXXXXXXXXXGOOOOOOOOOOOXXXXXXXXGOOOOOXXXXXXXXXXXXXXGOOOOOOOOOOOOOXXXXXXGOOOOOOOOOOOOOOOOXXXGOOOOOOXXXXXXXXXXXXX,0,0,0
44331,130,0,130,29,441,0,0,153,96,57,GOOOOOOOOOOOOOXXXXXXGOOOOOOOOXXXXXXXXXXXGOOOOOXXXXXXXXXXXXXXGOOOOOOOOOOOXXXXXXXXGOOOOOOOXXXXXXXXXXXXGOOOOOOOOOOOOXXXXXXXGOOOOOOOOXXXXXXXXXXXGOOXXXXXXXXXXXXXXXXXGOOOOOOOOOOOXXXXXXXXGOOOOOXXXXXXXXXXXXXXGOOOOOOOOOOOOOXXXXXXGOOOOOOOOOOOOOOOOXXXGOOOOOOXXXXXXXXXXXXX,0,0,0
44352,130,0,130,29,441,0,0,152,94,58,GOOOOOOOOOOOOOXXXXXXGOOOOOOOOXXXXXXXXXXXGOOOOOXXXXXXXXXXXXXXGOOOOOOOOOOOXXXXXXXXGOOOOOOOXXXXXXXXXXXXGOOOOOOOOOOOOXXXXXXXGOOOOOOOOXXXXXXXXXXXGOOXXXXXXXXXXXXXXXXXGOOOOOOOOOOOXXXXXXXXGOOOOOXXXXXXXXXXXXXXGOOOOOOOOOOOOOXXXXXXGOOOOOOOOOOOOOOOOXXXGOOOOOOXXXXXXXXXXXXX,0,0,0
44373,130,0,130,28,442,0,0,154,96,58,GOOOOOOOOOOOOOXXXXXXGOOOOOOOOXXXXXXXXXXXGOOOOOXXXXXXXXXXXXXXGOOOOOOOOOOOXXXXXXXXGOOOOOOOXXXXXXXXXXXXGOOOOOOOOOOOOXXXXXXXGOOOOOOOOXXXXXXXXXXXGOOXXXXXXXXXXXXXXXXXGOOOOOOOOOOOXXXXXXXXGOOOOOXXXXXXXXXXXXXXGOOOOOOOOOOOOOXXXXXXGOOOOOOOOOOOOOOOOXXXGOOOOOOXXXXXXXXXXXXX,0,0,0
44394,130,0,130,29,441,0,0,152,96,56,GOOOOOOOOOOOOOXXXXXXGOOOOOOOOXXXXXXXXXXXGOOOOOXXXXXXXXXXXXXXGOOOOOOOOOOOXXXXXXXXGOOOOOOOXXXXXXXXXXXXGOOOOOOOOOOOOXXXXXXXGOOOOOOOOXXXXXXXXXXXGOOXXXXXXXXXXXXXXXXXGOOOOOOOOOOOXXXXXXXXGOOOOOXXXXXXXXXXXXXXGOOOOOOOOOOOOOXXXXXXGOOOOOOOOOOOOOOOOXXXGOOOOOOXXXXXXXXXXXXX,0,0,0

44415,130,0,130,26,444,0,0,155,97,58,GOOOOOOOOOOOOOXXXXXXGOOOOOOOOXXXXXXXXXXXGOOOOOXXXXXXXXXXXXXXGOOOOOOOOOOOXXXXXXXXGOOOOOOOXXXXXXXXXXXXGOOOOOOOOOOOOXXXXXXXGOOOOOOOOXXXXXXXXXXXGOOXXXXXXXXXXXXXXXXXGOOOOOOOOOOOXXXXXXXXGOOOOOXXXXXXXXXXXXXXGOOOOOOOOOOOOOXXXXXXGOOOOOOOOOOOOOOOOXXXGOOOOOOXXXXXXXXXXXXX,0,0,0
44436,130,0,130,26,444,0,0,156,96,60,GOOOOOOOOOOOOOXXXXXXGOOOOOOOOXXXXXXXXXXXGOOOOOXXXXXXXXXXXXXXGOOOOOOOOOOOXXXXXXXXGOOOOOOOXXXXXXXXXXXXGOOOOOOOOOOOOXXXXXXXGOOOOOOOOXXXXXXXXXXXGOOXXXXXXXXXXXXXXXXXGOOOOOOOOOOOXXXXXXXXGOOOOOXXXXXXXXXXXXXXGOOOOOOOOOOOOOXXXXXXGOOOOOOOOOOOOOOOOXXXGOOOOOOXXXXXXXXXXXXX,0,0,0
44457,130,0,130,28,442,0,0,154,97,57,GOOOOOOOOOOOOOXXXXXXGOOOOOOOOXXXXXXXXXXXGOOOOOXXXXXXXXXXXXXXGOOOOOOOOOOOXXXXXXXXGOOOOOOOXXXXXXXXXXXXGOOOOOOOOOOOOXXXXXXXGOOOOOOOOXXXXXXXXXXXGOOXXXXXXXXXXXXXXXXXGOOOOOOOOOOOXXXXXXXXGOOOOOXXXXXXXXXXXXXXGOOOOOOOOOOOOOXXXXXXGOOOOOOOOOOOOOOOOXXXGOOOOOOXXXXXXXXXXXXX,0,0,0
44478,130,0,130,31,439,0,0,151,97,54,GOOOOOOOOOOOOOXXXXXXGOOOOOOOOXXXXXXXXXXXGOOOOOXXXXXXXXXXXXXXGOOOOOOOOOOOXXXXXXXXGOOOOOOOXXXXXXXXXXXXGOOOOOOOOOOOOXXXXXXXGOOOOOOOOXXXXXXXXXXXGOOXXXXXXXXXXXXXXXXXGOOOOOOOOOOOXXXXXXXXGOOOOOXXXXXXXXXXXXXXGOOOOOOOOOOOOOXXXXXXGOOOOOOOOOOOOOOOOXXXGOOOOOOXXXXXXXXXXXXX,0,0,0
44499,130,0,130,32,438,0,0,149,94,55,GOOOOOOOOOOOOOXXXXXXGOOOOOOOOXXXXXXXXXXXGOOOOOXXXXXXXXXXXXXXGOOOOOOOOOOOXXXXXXXXGOOOOOOOXXXXXXXXXXXXGOOOOOOOOOOOOXXXXXXXGOOOOOOOOXXXXXXXXXXXGOOXXXXXXXXXXXXXXXXXGOOOOOOOOOOOXXXXXXXXGOOOOOXXXXXXXXXXXXXXGOOOOOOOOOOOOOXXXXXXGOOOOOOOOOOOOOOOOXXXGOOOOOOXXXXXXXXXXXXX,0,0,0

44520,130,0,130,29,441,0,0,152,95,57,GOOOOOOOOOOOOOXXXXXXGOOOOOOOOXXXXXXXXXXXGOOOOOXXXXXXXXXXXXXXGOOOOOOOOOOOXXXXXXXXGOOOOOOOXXXXXXXXXXXXGOOOOOOOOOOOOXXXXXXXGOOOOOOOOXXXXXXXXXXXGOOXXXXXXXXXXXXXXXXXGOOOOOOOOOOOXXXXXXXXGOOOOOXXXXXXXXXXXXXXGOOOOOOOOOOOOOXXXXXXGOOOOOOOOOOOOOOOOXXXGOOOOOOXXXXXXXXXXXXX,0,0,0
44541,130,0,130,28,442,0,0,153,97,56,GOOOOOOOOOOOOOXXXXXXGOOOOOOOOXXXXXXXXXXXGOOOOOXXXXXXXXXXXXXXGOOOOOOOOOOOXXXXXXXXGOOOOOOOXXXXXXXXXXXXGOOOOOOOOOOOOXXXXXXXGOOOOOOOOXXXXXXXXXXXGOOXXXXXXXXXXXXXXXXXGOOOOOOOOOOOXXXXXXXXGOOOOOXXXXXXXXXXXXXXGOOOOOOOOOOOOOXXXXXXGOOOOOOOOOOOOOOOOXXXGOOOOOOXXXXXXXXXXXXX,0,0,0
44562,130,0,130,29,441,0,0,152,99,53,GOOOOOOOOOOOOOXXXXXXGOOOOOOOOXXXXXXXXXXXGOOOOOXXXXXXXXXXXXXXGOOOOOOOOOOOXXXXXXXXGOOOOOOOXXXXXXXXXXXXGOOOOOOOOOOOOXXXXXXXGOOOOOOOOXXXXXXXXXXXGOOXXXXXXXXXXXXXXXXXGOOOOOOOOOOOXXXXXXXXGOOOOOXXXXXXXXXXXXXXGOOOOOOOOOOOOOXXXXXXGOOOOOOOOOOOOOOOOXXXGOOOOOOXXXXXXXXXXXXX,0,0,0
44583,130,0,130,31,439,0,0,150,99,51,GOOOOOOOOOOOOOXXXXXXGOOOOOOOOXXXXXXXXXXXGOOOOOXXXXXXXXXXXXXXGOOOOOOOOOOOXXXXXXXXGOOOOOOOXXXXXXXXXXXXGOOOOOOOOOOOOXXXXXXXGOOOOOOOOXXXXXXXXXXXGOOXXXXXXXXXXXXXXXXXGOOOOOOOOOOOXXXXXXXXGOOOOOXXXXXXXXXXXXXXGOOOOOOOOOOOOOXXXXXXGOOOOOOOOOOOOOOOOXXXGOOOOOOXXXXXXXXXXXXX,0,0,0
44604,130,0,130,32,438,0,0,149,98,51,GOOOOOOOOOOOOOXXXXXXGOOOOOOOOXXXXXXXXXXXGOOOOOXXXXXXXXXXXXXXGOOOOOOOOOOOXXXXXXXXGOOOOOOOXXXXXXXXXXXXGOOOOOOOOOOOOXXXXXXXGOOOOOOOOXXXXXXXXXXXGOOXXXXXXXXXXXXXXXXXGOOOOOOOOOOOXXXXXXXXGOOOOOXXXXXXXXXXXXXXGOOOOOOOOOOOOOXXXXXXGOOOOOOOOOOOOOOOOXXXGOOOOOOXXXXXXXXXXXXX,0,0,0

44625,131,1,130,32,437,0,0,148,98,50,GOOOOOOOOOOOOOXXXXXXGOOOOOOOOXXXXXXXXXXXGOOOOOXXXXXXXXXXXXXXGOOOOOOOOOOOAXXXXXXXGOOOOOOOXXXXXXXXXXXXGOOOOOOOOOOOOXXXXXXXGOOOOOOOOXXXXXXXXXXXGOOXXXXXXXXXXXXXXXXXGOOOOOOOOOOOXXXXXXXXGOOOOOXXXXXXXXXXXXXXGOOOOOOOOOOOOOXXXXXXGOOOOOOOOOOOOOOOOXXXGOOOOOOXXXXXXXXXXXXX,0,0,0
44646,131,1,130,29,440,0,0,150,98,52,GOOOOOOOOOOOOOXXXXXXGOOOOOOOOXXXXXXXXXXXGOOOOOXXXXXXXXXXXXXXGOOOOOOOOOOOAXXXXXXXGOOOOOOOXXXXXXXXXXXXGOOOOOOOOOOOOXXXXXXXGOOOOOOOOXXXXXXXXXXXGOOXXXXXXXXXXXXXXXXXGOOOOOOOOOOOXXXXXXXXGOOOOOXXXXXXXXXXXXXXGOOOOOOOOOOOOOXXXXXXGOOOOOOOOOOOOOOOOXXXGOOOOOOXXXXXXXXXXXXX,0,0,0
44667,131,0,131,29,440,0,0,152,98,54,GOOOOOOOOOOOOOXXXXXXGOOOOOOOOXXXXXXXXXXXGOOOOOXXXXXXXXXXXXXXGOOOOOOOOOOOOXXXXXXXGOOOOOOOXXXXXXXXXXXXGOOOOOOOOOOOOXXXXXXXGOOOOOOOOXXXXXXXXXXXGOOXXXXXXXXXXXXXXXXXGOOOOOOOOOOOXXXXXXXXGOOOOOXXXXXXXXXXXXXXGOOOOOOOOOOOOOXXXXXXGOOOOOOOOOOOOOOOOXXXGOOOOOOXXXXXXXXXXXXX,0,0,0
44688,131,0,131,28,441,0,0,153,98,55,GOOOOOOOOOOOOOXXXXXXGOOOOOOOOXXXXXXXXXXXGOOOOOXXXXXXXXXXXXXXGOOOOOOOOOOOOXXXXXXXGOOOOOOOXXXXXXXXXXXXGOOOOOOOOOOOOXXXXXXXGOOOOOOOOXXXXXXXXXXXGOOXXXXXXXXXXXXXXXXXGOOOOOOOOOOOXXXXXXXXGOOOOOXXXXXXXXXXXXXXGOOOOOOOOOOOOOXXXXXXGOOOOOOOOOOOOOOOOXXXGOOOOOOXXXXXXXXXXXXX,0,0,0
44709,132,1,131,28,440,0,0,152,98,54,GOOOOOOOOOOOOOXXXXXXGOOOOOOOOXXXXXXXXXXXGOOOOOAXXXXXXXXXXXXXGOOOOOOOOOOOOXXXXXXXGOOOOOOOXXXXXXXXXXXXGOOOOOOOOOOOOXXXXXXXGOOOOOOOOXXXXXXXXXXXGOOXXXXXXXXXXXXXXXXXGOOOOOOOOOOOXXXXXXXXGOOOOOXXXXXXXXXXXXXXGOOOOOOOOOOOOOXXXXXXGOOOOOOOOOOOOOOOOXXXGOOOOOOXXXXXXXXXXXXX,0,0,0

44730,132,1,131,31,437,0,0,149,97,52,GOOOOOOOOOOOOOXXXXXXGOOOOOOOOXXXXXXXXXXXGOOOOOAXXXXXXXXXXXXXGOOOOOOOOOOOOXXXXXXXGOOOOOOOXXXXXXXXXXXXGOOOOOOOOOOOOXXXXXXXGOOOOOOOOXXXXXXXXXXXGOOXXXXXXXXXXXXXXXXXGOOOOOOOOOOOXXXXXXXXGOOOOOXXXXXXXXXXXXXXGOOOOOOOOOOOOOXXXXXXGOOOOOOOOOOOOOOOOXXXGOOOOOOXXXXXXXXXXXXX,0,0,0
44751,132,1,131,27,441,0,0,153,99,54,GOOOOOOOOOOOOOXXXXXXGOOOOOOOOXXXXXXXXXXXGOOOOOAXXXXXXXXXXXXXGOOOOOOOOOOOOXXXXXXXGOOOOOOOXXXXXXXXXXXXGOOOOOOOOOOOOXXXXXXXGOOOOOOOOXXXXXXXXXXXGOOXXXXXXXXXXXXXXXXXGOOOOOOOOOOOXXXXXXXXGOOOOOXXXXXXXXXXXXXXGOOOOOOOOOOOOOXXXXXXGOOOOOOOOOOOOOOOOXXXGOOOOOOXXXXXXXXXXXXX,0,0,0
44772,132,1,131,26,442,0,0,153,95,58,GOOOOOOOOOOOOOXXXXXXGOOOOOOOOXXXXXXXXXXXGOOOOOAXXXXXXXXXXXXXGOOOOOOOOOOOOXXXXXXXGOOOOOOOXXXXXXXXXXXXGOOOOOOOOOOOOXXXXXXXGOOOOOOOOXXXXXXXXXXXGOOXXXXXXXXXXXXXXXXXGOOOOOOOOOOOXXXXXXXXGOOOOOXXXXXXXXXXXXXXGOOOOOOOOOOOOOXXXXXXGOOOOOOOOOOOOOOOOXXXGOOOOOOXXXXXXXXXXXXX,0,0,0
44793,132,1,131,27,441,0,0,152,94,58,GOOOOOOOOOOOOOXXXXXXGOOOOOOOOXXXXXXXXXXXGOOOOOAXXXXXXXXXXXXXGOOOOOOOOOOOOXXXXXXXGOOOOOOOXXXXXXXXXXXXGOOOOOOOOOOOOXXXXXXXGOOOOOOOOXXXXXXXXXXXGOOXXXXXXXXXXXXXXXXXGOOOOOOOOOOOXXXXXXXXGOOOOOXXXXXXXXXXXXXXGOOOOOOOOOOOOOXXXXXXGOOOOOOOOOOOOOOOOXXXGOOOOOOXXXXXXXXXXXXX,0,0,0
44814,132,1,131,25,443,0,0,155,97,58,GOOOOOOOOOOOOOXXXXXXGOOOOOOOOXXXXXXXXXXXGOOOOOAXXXXXXXXXXXXXGOOOOOOOOOOOOXXXXXXXGOOOOOOOXXXXXXXXXXXXGOOOOOOOOOOOOXXXXXXXGOOOOOOOOXXXXXXXXXXXGOOXXXXXXXXXXXXXXXXXGOOOOOOOOOOOXXXXXXXXGOOOOOXXXXXXXXXXXXXXGOOOOOOOOOOOOOXXXXXXGOOOOOOOOOOOOOOOOXXXGOOOOOOXXXXXXXXXXXXX,0,0,0

44835,132,1,131,26,442,0,0,154,97,57,GOOOOOOOOOOOOOXXXXXXGOOOOOOOOXXXXXXXXXXXGOOOOOAXXXXXXXXXXXXXGOOOOOOOOOOOOXXXXXXXGOOOOOOOXXXXXXXXXXXXGOOOOOOOOOOOOXXXXXXXGOOOOOOOOXXXXXXXXXXXGOOXXXXXXXXXXXXXXXXXGOOOOOOOOOOOXXXXXXXXGOOOOOXXXXXXXXXXXXXXGOOOOOOOOOOOOOXXXXXXGOOOOOOOOOOOOOOOOXXXGOOOOOOXXXXXXXXXXXXX,0,0,0
44856,132,1,131,24,444,0,0,155,98,57,GOOOOOOOOOOOOOXXXXXXGOOOOOOOOXXXXXXXXXXXGOOOOOAXXXXXXXXXXXXXGOOOOOOOOOOOOXXXXXXXGOOOOOOOXXXXXXXXXXXXGOOOOOOOOOOOOXXXXXXXGOOOOOOOOXXXXXXXXXXXGOOXXXXXXXXXXXXXXXXXGOOOOOOOOOOOXXXXXXXXGOOOOOXXXXXXXXXXXXXXGOOOOOOOOOOOOOXXXXXXGOOOOOOOOOOOOOOOOXXXGOOOOOOXXXXXXXXXXXXX,0,0,0
44877,132,1,131,27,441,0,0,153,98,55,GOOOOOOOOOOOOOXXXXXXGOOOOOOOOXXXXXXXXXXXGOOOOOAXXXXXXXXXXXXXGOOOOOOOOOOOOXXXXXXXGOOOOOOOXXXXXXXXXXXXGOOOOOOOOOOOOXXXXXXXGOOOOOOOOXXXXXXXXXXXGOOXXXXXXXXXXXXXXXXXGOOOOOOOOOOOXXXXXXXXGOOOOOXXXXXXXXXXXXXXGOOOOOOOOOOOOOXXXXXXGOOOOOOOOOOOOOOOOXXXGOOOOOOXXXXXXXXXXXXX,0,0,0
44898,132,1,131,29,439,0,0,151,98,53,GOOOOOOOOOOOOOXXXXXXGOOOOOOOOXXXXXXXXXXXGOOOOOAXXXXXXXXXXXXXGOOOOOOOOOOOOXXXXXXXGOOOOOOOXXXXXXXXXXXXGOOOOOOOOOOOOXXXXXXXGOOOOOOOOXXXXXXXXXXXGOOXXXXXXXXXXXXXXXXXGOOOOOOOOOOOXXXXXXXXGOOOOOXXXXXXXXXXXXXXGOOOOOOOOOOOOOXXXXXXGOOOOOOOOOOOOOOOOXXXGOOOOOOXXXXXXXXXXXXX,0,0,0
44919,132,1,131,31,437,0,0,149,96,53,GOOOOOOOOOOOOOXXXXXXGOOOOOOOOXXXXXXXXXXXGOOOOOAXXXXXXXXXXXXXGOOOOOOOOOOOOXXXXXXXGOOOOOOOXXXXXXXXXXXXGOOOOOOOOOOOOXXXXXXXGOOOOOOOOXXXXXXXXXXXGOOXXXXXXXXXXXXXXXXXGOOOOOOOOOOOXXXXXXXXGOOOOOXXXXXXXXXXXXXXGOOOOOOOOOOOOOXXXXXXGOOOOOOOOOOOOOOOOXXXGOOOOOOXXXXXXXXXXXXX,0,0,0

44940,132,1,131,26,442,0,0,154,98,56,GOOOOOOOOOOOOOXXXXXXGOOOOOOOOXXXXXXXXXXXGOOOOOAXXXXXXXXXXXXXGOOOOOOOOOOOOXXXXXXXGOOOOOOOXXXXXXXXXXXXGOOOOOOOOOOOOXXXXXXXGOOOOOOOOXXXXXXXXXXXGOOXXXXXXXXXXXXXXXXXGOOOOOOOOOOOXXXXXXXXGOOOOOXXXXXXXXXXXXXXGOOOOOOOOOOOOOXXXXXXGOOOOOOOOOOOOOOOOXXXGOOOOOOXXXXXXXXXXXXX,0,0,0
44961,132,1,131,26,442,0,0,153,97,56,GOOOOOOOOOOOOOXXXXXXGOOOOOOOOXXXXXXXXXXXGOOOOOAXXXXXXXXXXXXXGOOOOOOOOOOOOXXXXXXXGOOOOOOOXXXXXXXXXXXXGOOOOOOOOOOOOXXXXXXXGOOOOOOOOXXXXXXXXXXXGOOXXXXXXXXXXXXXXXXXGOOOOOOOOOOOXXXXXXXXGOOOOOXXXXXXXXXXXXXXGOOOOOOOOOOOOOXXXXXXGOOOOOOOOOOOOOOOOXXXGOOOOOOXXXXXXXXXXXXX,0,0,0
44982,132,0,132,25,443,0,0,154,98,56,GOOOOOOOOOOOOOXXXXXXGOOOOOOOOXXXXXXXXXXXGOOOOOOXXXXXXXXXXXXXGOOOOOOOOOOOOXXXXXXXGOOOOOOOXXXXXXXXXXXXGOOOOOOOOOOOOXXXXXXXGOOOOOOOOXXXXXXXXXXXGOOXXXXXXXXXXXXXXXXXGOOOOOOOOOOOXXXXXXXXGOOOOOXXXXXXXXXXXXXXGOOOOOOOOOOOOOXXXXXXGOOOOOOOOOOOOOOOOXXXGOOOOOOXXXXXXXXXXXXX,0,0,0
45003,132,0,132,23,445,0,0,156,97,59,GOOOOOOOOOOOOOXXXXXXGOOOOOOOOXXXXXXXXXXXGOOOOOOXXXXXXXXXXXXXGOOOOOOOOOOOOXXXXXXXGOOOOOOOXXXXXXXXXXXXGOOOOOOOOOOOOXXXXXXXGOOOOOOOOXXXXXXXXXXXGOOXXXXXXXXXXXXXXXXXGOOOOOOOOOOOXXXXXXXXGOOOOOXXXXXXXXXXXXXXGOOOOOOOOOOOOOXXXXXXGOOOOOOOOOOOOOOOOXXXGOOOOOOXXXXXXXXXXXXX,0,0,0
45024,132,0,132,25,443,0,0,154,99,55,GOOOOOOOOOOOOOXXXXXXGOOOOOOOOXXXXXXXXXXXGOOOOOOXXXXXXXXXXXXXGOOOOOOOOOOOOXXXXXXXGOOOOOOOXXXXXXXXXXXXGOOOOOOOOOOOOXXXXXXXGOOOOOOOOXXXXXXXXXXXGOOXXXXXXXXXXXXXXXXXGOOOOOOOOOOOXXXXXXXXGOOOOOXXXXXXXXXXXXXXGOOOOOOOOOOOOOXXXXXXGOOOOOOOOOOOOOOOOXXXGOOOOOOXXXXXXXXXXXXX,0,0,0

45045,132,0,132,30,438,0,0,149,99,50,GOOOOOOOOOOOOOXXXXXXGOOOOOOOOXXXXXXXXXXXGOOOOOOXXXXXXXXXXXXXGOOOOOOOOOOOOXXXXXXXGOOOOOOOXXXXXXXXXXXXGOOOOOOOOOOOOXXXXXXXGOOOOOOOOXXXXXXXXXXXGOOXXXXXXXXXXXXXXXXXGOOOOOOOOOOOXXXXXXXXGOOOOOXXXXXXXXXXXXXXGOOOOOOOOOOOOOXXXXXXGOOOOOOOOOOOOOOOOXXXGOOOOOOXXXXXXXXXXXXX,0,0,0
45066,132,0,132,30,438,0,0,149,97,52,GOOOOOOOOOOOOOXXXXXXGOOOOOOOOXXXXXXXXXXXGOOOOOOXXXXXXXXXXXXXGOOOOOOOOOOOOXXXXXXXGOOOOOOOXXXXXXXXXXXXGOOOOOOOOOOOOXXXXXXXGOOOOOOOOXXXXXXXXXXXGOOXXXXXXXXXXXXXXXXXGOOOOOOOOOOOXXXXXXXXGOOOOOXXXXXXXXXXXXXXGOOOOOOOOOOOOOXXXXXXGOOOOOOOOOOOOOOOOXXXGOOOOOOXXXXXXXXXXXXX,0,0,0
45087,132,0,132,29,439,0,0,150,94,56,GOOOOOOOOOOOOOXXXXXXGOOOOOOOOXXXXXXXXXXXGOOOOOOXXXXXXXXXXXXXGOOOOOOOOOOOOXXXXXXXGOOOOOOOXXXXXXXXXXXXGOOOOOOOOOOOOXXXXXXXGOOOOOOOOXXXXXXXXXXXGOOXXXXXXXXXXXXXXXXXGOOOOOOOOOOOXXXXXXXXGOOOOOXXXXXXXXXXXXXXGOOOOOOOOOOOOOXXXXXXGOOOOOOOOOOOOOOOOXXXGOOOOOOXXXXXXXXXXXXX,0,0,0
45108,132,0,132,27,441,0,0,152,98,54,GOOOOOOOOOOOOOXXXXXXGOOOOOOOOXXXXXXXXXXXGOOOOOOXXXXXXXXXXXXXGOOOOOOOOOOOOXXXXXXXGOOOOOOOXXXXXXXXXXXXGOOOOOOOOOOOOXXXXXXXGOOOOOOOOXXXXXXXXXXXGOOXXXXXXXXXXXXXXXXXGOOOOOOOOOOOXXXXXXXXGOOOOOXXXXXXXXXXXXXXGOOOOOOOOOOOOOXXXXXXGOOOOOOOOOOOOOOOOXXXGOOOOOOXXXXXXXXXXXXX,0,0,0
45129,132,0,132,25,443,0,0,155,96,59,GOOOOOOOOOOOOOXXXXXXGOOOOOOOOXXXXXXXXXXXGOOOOOOXXXXXXXXXXXXXGOOOOOOOOOOOOXXXXXXXGOOOOOOOXXXXXXXXXXXXGOOOOOOOOOOOOXXXXXXXGOOOOOOOOXXXXXXXXXXXGOOXXXXXXXXXXXXXXXXXGOOOOOOOOOOOXXXXXXXXGOOOOOXXXXXXXXXXXXXXGOOOOOOOOOOOOOXXXXXXGOOOOOOOOOOOOOOOOXXXGOOOOOOXXXXXXXXXXXXX,0,0,0

45150,132,0,132,26,442,0,0,153,98,55,GOOOOOOOOOOOOOXXXXXXGOOOOOOOOXXXXXXXXXXXGOOOOOOXXXXXXXXXXXXXGOOOOOOOOOOOOXXXXXXXGOOOOOOOXXXXXXXXXXXXGOOOOOOOOOOOOXXXXXXXGOOOOOOOOXXXXXXXXXXXGOOXXXXXXXXXXXXXXXXXGOOOOOOOOOOOXXXXXXXXGOOOOOXXXXXXXXXXXXXXGOOOOOOOOOOOOOXXXXXXGOOOOOOOOOOOOOOOOXXXGOOOOOOXXXXXXXXXXXXX,0,0,0
45171,132,0,132,27,441,0,0,151,99,52,GOOOOOOOOOOOOOXXXXXXGOOOOOOOOXXXXXXXXXXXGOOOOOOXXXXXXXXXXXXXGOOOOOOOOOOOOXXXXXXXGOOOOOOOXXXXXXXXXXXXGOOOOOOOOOOOOXXXXXXXGOOOOOOOOXXXXXXXXXXXGOOXXXXXXXXXXXXXXXXXGOOOOOOOOOOOXXXXXXXXGOOOOOXXXXXXXXXXXXXXGOOOOOOOOOOOOOXXXXXXGOOOOOOOOOOOOOOOOXXXGOOOOOOXXXXXXXXXXXXX,0,0,0
45192,132,0,132,27,441,0,0,152,97,55,GOOOOOOOOOOOOOXXXXXXGOOOOOOOOXXXXXXXXXXXGOOOOOOXXXXXXXXXXXXXGOOOOOOOOOOOOXXXXXXXGOOOOOOOXXXXXXXXXXXXGOOOOOOOOOOOOXXXXXXXGOOOOOOOOXXXXXXXXXXXGOOXXXXXXXXXXXXXXXXXGOOOOOOOOOOOXXXXXXXXGOOOOOXXXXXXXXXXXXXXGOOOOOOOOOOOOOXXXXXXGOOOOOOOOOOOOOOOOXXXGOOOOOOXXXXXXXXXXXXX,0,0,0
45213,132,0,132,27,441,0,0,152,98,54,GOOOOOOOOOOOOOXXXXXXGOOOOOOOOXXXXXXXXXXXGOOOOOOXXXXXXXXXXXXXGOOOOOOOOOOOOXXXXXXXGOOOOOOOXXXXXXXXXXXXGOOOOOOOOOOOOXXXXXXXGOOOOOOOOXXXXXXXXXXXGOOXXXXXXXXXXXXXXXXXGOOOOOOOOOOOXXXXXXXXGOOOOOXXXXXXXXXXXXXXGOOOOOOOOOOOOOXXXXXXGOOOOOOOOOOOOOOOOXXXGOOOOOOXXXXXXXXXXXXX,0,0,0
45234,132,0,132,24,444,0,0,155,100,55,GOOOOOOOOOOOOOXXXXXXGOOOOOOOOXXXXXXXXXXXGOOOOOOXXXXXXXXXXXXXGOOOOOOOOOOOOXXXXXXXGOOOOOOOXXXXXXXXXXXXGOOOOOOOOOOOOXXXXXXXGOOOOOOOOXXXXXXXXXXXGOOXXXXXXXXXXXXXXXXXGOOOOOOOOOOOXXXXXXXXGOOOOOXXXXXXXXXXXXXXGOOOOOOOOOOOOOXXXXXXGOOOOOOOOOOOOOOOOXXXGOOOOOOXXXXXXXXXXXXX,0,0,0

45255,132,0,132,25,443,0,0,153,99,54,GOOOOOOOOOOOOOXXXXXXGOOOOOOOOXXXXXXXXXXXGOOOOOOXXXXXXXXXXXXXGOOOOOOOOOOOOXXXXXXXGOOOOOOOXXXXXXXXXXXXGOOOOOOOOOOOOXXXXXXXGOOOOOOOOXXXXXXXXXXXGOOXXXXXXXXXXXXXXXXXGOOOOOOOOOOOXXXXXXXXGOOOOOXXXXXXXXXXXXXXGOOOOOOOOOOOOOXXXXXXGOOOOOOOOOOOOOOOOXXXGOOOOOOXXXXXXXXXXXXX,0,0,0
45276,132,0,132,27,441,0,0,151,100,51,GOOOOOOOOOOOOOXXXXXXGOOOOOOOOXXXXXXXXXXXGOOOOOOXXXXXXXXXXXXXGOOOOOOOOOOOOXXXXXXXGOOOOOOOXXXXXXXXXXXXGOOOOOOOOOOOOXXXXXXXGOOOOOOOOXXXXXXXXXXXGOOXXXXXXXXXXXXXXXXXGOOOOOOOOOOOXXXXXXXXGOOOOOXXXXXXXXXXXXXXGOOOOOOOOOOOOOXXXXXXGOOOOOOOOOOOOOOOOXXXGOOOOOOXXXXXXXXXXXXX,0,0,0
45297,132,0,132,29,439,0,0,151,98,53,GOOOOOOOOOOOOOXXXXXXGOOOOOOOOXXXXXXXXXXXGOOOOOOXXXXXXXXXXXXXGOOOOOOOOOOOOXXXXXXXGOOOOOOOXXXXXXXXXXXXGOOOOOOOOOOOOXXXXXXXGOOOOOOOOXXXXXXXXXXXGOOXXXXXXXXXXXXXXXXXGOOOOOOOOOOOXXXXXXXXGOOOOOXXXXXXXXXXXXXXGOOOOOOOOOOOOOXXXXXXGOOOOOOOOOOOOOOOOXXXGOOOOOOXXXXXXXXXXXXX,0,0,0
45318,132,0,132,29,439,0,0,151,96,55,GOOOOOOOOOOOOOXXXXXXGOOOOOOOOXXXXXXXXXXXGOOOOOOXXXXXXXXXXXXXGOOOOOOOOOOOOXXXXXXXGOOOOOOOXXXXXXXXXXXXGOOOOOOOOOOOOXXXXXXXGOOOOOOOOXXXXXXXXXXXGOOXXXXXXXXXXXXXXXXXGOOOOOOOOOOOXXXXXXXXGOOOOOXXXXXXXXXXXXXXGOOOOOOOOOOOOOXXXXXXGOOOOOOOOOOOOOOOOXXXGOOOOOOXXXXXXXXXXXXX,0,0,0
45339,132,0,132,26,442,0,0,154,98,56,GOOOOOOOOOOOOOXXXXXXGOOOOOOOOXXXXXXXXXXXGOOOOOOXXXXXXXXXXXXXGOOOOOOOOOOOOXXXXXXXGOOOOOOOXXXXXXXXXXXXGOOOOOOOOOOOOXXXXXXXGOOOOOOOOXXXXXXXXXXXGOOXXXXXXXXXXXXXXXXXGOOOOOOOOOOOXXXXXXXXGOOOOOXXXXXXXXXXXXXXGOOOOOOOOOOOOOXXXXXXGOOOOOOOOOOOOOOOOXXXGOOOOOOXXXXXXXXXXXXX,0,0,0

45360,132,0,132,27,441,0,0,153,99,54,GOOOOOOOOOOOOOXXXXXXGOOOOOOOOXXXXXXXXXXXGOOOOOOXXXXXXXXXXXXXGOOOOOOOOOOOOXXXXXXXGOOOOOOOXXXXXXXXXXXXGOOOOOOOOOOOOXXXXXXXGOOOOOOOOXXXXXXXXXXXGOOXXXXXXXXXXXXXXXXXGOOOOOOOOOOOXXXXXXXXGOOOOOXXXXXXXXXXXXXXGOOOOOOOOOOOOOXXXXXXGOOOOOOOOOOOOOOOOXXXGOOOOOOXXXXXXXXXXXXX,0,0,0
45381,132,0,132,31,437,0,0,148,94,54,GOOOOOOOOOOOOOXXXXXXGOOOOOOOOXXXXXXXXXXXGOOOOOOXXXXXXXXXXXXXGOOOOOOOOOOOOXXXXXXXGOOOOOOOXXXXXXXXXXXXGOOOOOOOOOOOOXXXXXXXGOOOOOOOOXXXXXXXXXXXGOOXXXXXXXXXXXXXXXXXGOOOOOOOOOOOXXXXXXXXGOOOOOXXXXXXXXXXXXXXGOOOOOOOOOOOOOXXXXXXGOOOOOOOOOOOOOOOOXXXGOOOOOOXXXXXXXXXXXXX,0,0,0
45402,132,0,132,24,444,0,0,155,96,59,GOOOOOOOOOOOOOXXXXXXGOOOOOOOOXXXXXXXXXXXGOOOOOOXXXXXXXXXXXXXGOOOOOOOOOOOOXXXXXXXGOOOOOOOXXXXXXXXXXXXGOOOOOOOOOOOOXXXXXXXGOOOOOOOOXXXXXXXXXXXGOOXXXXXXXXXXXXXXXXXGOOOOOOOOOOOXXXXXXXXGOOOOOXXXXXXXXXXXXXXGOOOOOOOOOOOOOXXXXXXGOOOOOOOOOOOOOOOOXXXGOOOOOOXXXXXXXXXXXXX,0,0,0
45423,132,0,132,24,444,0,0,155,96,59,GOOOOOOOOOOOOOXXXXXXGOOOOOOOOXXXXXXXXXXXGOOOOOOXXXXXXXXXXXXXGOOOOOOOOOOOOXXXXXXXGOOOOOOOXXXXXXXXXXXXGOOOOOOOOOOOOXXXXXXXGOOOOOOOOXXXXXXXXXXXGOOXXXXXXXXXXXXXXXXXGOOOOOOOOOOOXXXXXXXXGOOOOOXXXXXXXXXXXXXXGOOOOOOOOOOOOOXXXXXXGOOOOOOOOOOOOOOOOXXXGOOOOOOXXXXXXXXXXXXX,0,0,0
45444,132,0,132,26,442,0,0,153,98,55,GOOOOOOOOOOOOOXXXXXXGOOOOOOOOXXXXXXXXXXXGOOOOOOXXXXXXXXXXXXXGOOOOOOOOOOOOXXXXXXXGOOOOOOOXXXXXXXXXXXXGOOOOOOOOOOOOXXXXXXXGOOOOOOOOXXXXXXXXXXXGOOXXXXXXXXXXXXXXXXXGOOOOOOOOOOOXXXXXXXXGOOOOOXXXXXXXXXXXXXXGOOOOOOOOOOOOOXXXXXXGOOOOOOOOOOOOOOOOXXXGOOOOOOXXXXXXXXXXXXX,0,0,0

45465,132,0,132,27,441,0,0,153,99,54,GOOOOOOOOOOOOOXXXXXXGOOOOOOOOXXXXXXXXXXXGOOOOOOXXXXXXXXXXXXXGOOOOOOOOOOOOXXXXXXXGOOOOOOOXXXXXXXXXXXXGOOOOOOOOOOOOXXXXXXXGOOOOOOOOXXXXXXXXXXXGOOXXXXXXXXXXXXXXXXXGOOOOOOOOOOOXXXXXXXXGOOOOOXXXXXXXXXXXXXXGOOOOOOOOOOOOOXXXXXXGOOOOOOOOOOOOOOOOXXXGOOOOOOXXXXXXXXXXXXX,0,0,0
45486,132,0,132,28,440,0,0,152,96,56,GOOOOOOOOOOOOOXXXXXXGOOOOOOOOXXXXXXXXXXXGOOOOOOXXXXXXXXXXXXXGOOOOOOOOOOOOXXXXXXXGOOOOOOOXXXXXXXXXXXXGOOOOOOOOOOOOXXXXXXXGOOOOOOOOXXXXXXXXXXXGOOXXXXXXXXXXXXXXXXXGOOOOOOOOOOOXXXXXXXXGOOOOOXXXXXXXXXXXXXXGOOOOOOOOOOOOOXXXXXXGOOOOOOOOOOOOOOOOXXXGOOOOOOXXXXXXXXXXXXX,0,0,0
45507,132,0,132,28,440,0,0,152,97,55,GOOOOOOOOOOOOOXXXXXXGOOOOOOOOXXXXXXXXXXXGOOOOOOXXXXXXXXXXXXXGOOOOOOOOOOOOXXXXXXXGOOOOOOOXXXXXXXXXXXXGOOOOOOOOOOOOXXXXXXXGOOOOOOOOXXXXXXXXXXXGOOXXXXXXXXXXXXXXXXXGOOOOOOOOOOOXXXXXXXXGOOOOOXXXXXXXXXXXXXXGOOOOOOOOOOOOOXXXXXXGOOOOOOOOOOOOOOOOXXXGOOOOOOXXXXXXXXXXXXX,0,0,0
45528,132,0,132,28,440,0,0,153,98,55,GOOOOOOOOOOOOOXXXXXXGOOOOOOOOXXXXXXXXXXXGOOOOOOXXXXXXXXXXXXXGOOOOOOOOOOOOXXXXXXXGOOOOOOOXXXXXXXXXXXXGOOOOOOOOOOOOXXXXXXXGOOOOOOOOXXXXXXXXXXXGOOXXXXXXXXXXXXXXXXXGOOOOOOOOOOOXXXXXXXXGOOOOOXXXXXXXXXXXXXXGOOOOOOOOOOOOOXXXXXXGOOOOOOOOOOOOOOOOXXXGOOOOOOXXXXXXXXXXXXX,0,0,0
45549,132,0,132,28,440,0,0,153,96,57,GOOOOOOOOOOOOOXXXXXXGOOOOOOOOXXXXXXXXXXXGOOOOOOXXXXXXXXXXXXXGOOOOOOOOOOOOXXXXXXXGOOOOOOOXXXXXXXXXXXXGOOOOOOOOOOOOXXXXXXXGOOOOOOOOXXXXXXXXXXXGOOXXXXXXXXXXXXXXXXXGOOOOOOOOOOOXXXXXXXXGOOOOOXXXXXXXXXXXXXXGOOOOOOOOOOOOOXXXXXXGOOOOOOOOOOOOOOOOXXXGOOOOOOXXXXXXXXXXXXX,0,0,0

45570,132,0,132,30,438,0,0,149,94,55,GOOOOOOOOOOOOOXXXXXXGOOOOOOOOXXXXXXXXXXXGOOOOOOXXXXXXXXXXXXXGOOOOOOOOOOOOXXXXXXXGOOOOOOOXXXXXXXXXXXXGOOOOOOOOOOOOXXXXXXXGOOOOOOOOXXXXXXXXXXXGOOXXXXXXXXXXXXXXXXXGOOOOOOOOOOOXXXXXXXXGOOOOOXXXXXXXXXXXXXXGOOOOOOOOOOOOOXXXXXXGOOOOOOOOOOOOOOOOXXXGOOOOOOXXXXXXXXXXXXX,0,0,0
45591,132,0,132,25,443,0,0,154,96,58,GOOOOOOOOOOOOOXXXXXXGOOOOOOOOXXXXXXXXXXXGOOOOOOXXXXXXXXXXXXXGOOOOOOOOOOOOXXXXXXXGOOOOOOOXXXXXXXXXXXXGOOOOOOOOOOOOXXXXXXXGOOOOOOOOXXXXXXXXXXXGOOXXXXXXXXXXXXXXXXXGOOOOOOOOOOOXXXXXXXXGOOOOOXXXXXXXXXXXXXXGOOOOOOOOOOOOOXXXXXXGOOOOOOOOOOOOOOOOXXXGOOOOOOXXXXXXXXXXXXX,0,0,0
45612,132,0,132,25,443,0,0,155,94,61,GOOOOOOOOOOOOOXXXXXXGOOOOOOOOXXXXXXXXXXXGOOOOOOXXXXXXXXXXXXXGOOOOOOOOOOOOXXXXXXXGOOOOOOOXXXXXXXXXXXXGOOOOOOOOOOOOXXXXXXXGOOOOOOOOXXXXXXXXXXXGOOXXXXXXXXXXXXXXXXXGOOOOOOOOOOOXXXXXXXXGOOOOOXXXXXXXXXXXXXXGOOOOOOOOOOOOOXXXXXXGOOOOOOOOOOOOOOOOXXXGOOOOOOXXXXXXXXXXXXX,0,0,0
45633,132,0,132,26,442,0,0,154,97,57,GOOOOOOOOOOOOOXXXXXXGOOOOOOOOXXXXXXXXXXXGOOOOOOXXXXXXXXXXXXXGOOOOOOOOOOOOXXXXXXXGOOOOOOOXXXXXXXXXXXXGOOOOOOOOOOOOXXXXXXXGOOOOOOOOXXXXXXXXXXXGOOXXXXXXXXXXXXXXXXXGOOOOOOOOOOOXXXXXXXXGOOOOOXXXXXXXXXXXXXXGOOOOOOOOOOOOOXXXXXXGOOOOOOOOOOOOOOOOXXXGOOOOOOXXXXXXXXXXXXX,0,0,0
45654,132,0,132,26,442,0,0,154,95,59,GOOOOOOOOOOOOOXXXXXXGOOOOOOOOXXXXXXXXXXXGOOOOOOXXXXXXXXXXXXXGOOOOOOOOOOOOXXXXXXXGOOOOOOOXXXXXXXXXXXXGOOOOOOOOOOOOXXXXXXXGOOOOOOOOXXXXXXXXXXXGOOXXXXXXXXXXXXXXXXXGOOOOOOOOOOOXXXXXXXXGOOOOOXXXXXXXXXXXXXXGOOOOOOOOOOOOOXXXXXXGOOOOOOOOOOOOOOOOXXXGOOOOOOXXXXXXXXXXXXX,0,0,0

45675,132,0,132,23,445,0,0,156,101,55,GOOOOOOOOOOOOOXXXXXXGOOOOOOOOXXXXXXXXXXXGOOOOOOXXXXXXXXXXXXXGOOOOOOOOOOOOXXXXXXXGOOOOOOOXXXXXXXXXXXXGOOOOOOOOOOOOXXXXXXXGOOOOOOOOXXXXXXXXXXXGOOXXXXXXXXXXXXXXXXXGOOOOOOOOOOOXXXXXXXXGOOOOOXXXXXXXXXXXXXXGOOOOOOOOOOOOOXXXXXXGOOOOOOOOOOOOOOOOXXXGOOOOOOXXXXXXXXXXXXX,0,0,0
45696,132,0,132,29,439,0,0,150,97,53,GOOOOOOOOOOOOOXXXXXXGOOOOOOOOXXXXXXXXXXXGOOOOOOXXXXXXXXXXXXXGOOOOOOOOOOOOXXXXXXXGOOOOOOOXXXXXXXXXXXXGOOOOOOOOOOOOXXXXXXXGOOOOOOOOXXXXXXXXXXXGOOXXXXXXXXXXXXXXXXXGOOOOOOOOOOOXXXXXXXXGOOOOOXXXXXXXXXXXXXXGOOOOOOOOOOOOOXXXXXXGOOOOOOOOOOOOOOOOXXXGOOOOOOXXXXXXXXXXXXX,0,0,0
45717,132,0,132,36,432,0,0,144,95,49,GOOOOOOOOOOOOOXXXXXXGOOOOOOOOXXXXXXXXXXXGOOOOOOXXXXXXXXXXXXXGOOOOOOOOOOOOXXXXXXXGOOOOOOOXXXXXXXXXXXXGOOOOOOOOOOOOXXXXXXXGOOOOOOOOXXXXXXXXXXXGOOXXXXXXXXXXXXXXXXXGOOOOOOOOOOOXXXXXXXXGOOOOOXXXXXXXXXXXXXXGOOOOOOOOOOOOOXXXXXXGOOOOOOOOOOOOOOOOXXXGOOOOOOXXXXXXXXXXXXX,0,0,0
45738,132,0,132,36,432,0,0,143,95,48,GOOOOOOOOOOOOOXXXXXXGOOOOOOOOXXXXXXXXXXXGOOOOOOXXXXXXXXXXXXXGOOOOOOOOOOOOXXXXXXXGOOOOOOOXXXXXXXXXXXXGOOOOOOOOOOOOXXXXXXXGOOOOOOOOXXXXXXXXXXXGOOXXXXXXXXXXXXXXXXXGOOOOOOOOOOOXXXXXXXXGOOOOOXXXXXXXXXXXXXXGOOOOOOOOOOOOOXXXXXXGOOOOOOOOOOOOOOOOXXXGOOOOOOXXXXXXXXXXXXX,0,0,0
45759,132,0,132,30,438,0,0,150,96,54,GOOOOOOOOOOOOOXXXXXXGOOOOOOOOXXXXXXXXXXXGOOOOOOXXXXXXXXXXXXXGOOOOOOOOOOOOXXXXXXXGOOOOOOOXXXXXXXXXXXXGOOOOOOOOOOOOXXXXXXXGOOOOOOOOXXXXXXXXXXXGOOXXXXXXXXXXXXXXXXXGOOOOOOOOOOOXXXXXXXXGOOOOOXXXXXXXXXXXXXXGOOOOOOOOOOOOOXXXXXXGOOOOOOOOOOOOOOOOXXXGOOOOOOXXXXXXXXXXXXX,0,0,0

45780,133,1,132,27,440,0,0,152,98,54,GOOOOOOOOOOOOOXXXXXXGOOOOOOOOXXXXXXXXXXXGOOOOOOXXXXXXXXXXXXXGOOOOOOOOOOOOXXXXXXXGOOOOOOOXXXXXXXXXXXXGOOOOOOOOOOOOXXXXXXXGOOOOOOOOXXXXXXXXXXXGOOXXXXXXXXXXXXXXXXXGOOOOOOOOOOOAXXXXXXXGOOOOOXXXXXXXXXXXXXXGOOOOOOOOOOOOOXXXXXXGOOOOOOOOOOOOOOOOXXXGOOOOOOXXXXXXXXXXXXX,0,0,0
45801,133,1,132,26,441,0,0,153,100,53,GOOOOOOOOOOOOOXXXXXXGOOOOOOOOXXXXXXXXXXXGOOOOOOXXXXXXXXXXXXXGOOOOOOOOOOOOXXXXXXXGOOOOOOOXXXXXXXXXXXXGOOOOOOOOOOOOXXXXXXXGOOOOOOOOXXXXXXXXXXXGOOXXXXXXXXXXXXXXXXXGOOOOOOOOOOOAXXXXXXXGOOOOOXXXXXXXXXXXXXXGOOOOOOOOOOOOOXXXXXXGOOOOOOOOOOOOOOOOXXXGOOOOOOXXXXXXXXXXXXX,0,0,0
45822,133,1,132,28,439,0,0,151,97,54,GOOOOOOOOOOOOOXXXXXXGOOOOOOOOXXXXXXXXXXXGOOOOOOXXXXXXXXXXXXXGOOOOOOOOOOOOXXXXXXXGOOOOOOOXXXXXXXXXXXXGOOOOOOOOOOOOXXXXXXXGOOOOOOOOXXXXXXXXXXXGOOXXXXXXXXXXXXXXXXXGOOOOOOOOOOOAXXXXXXXGOOOOOXXXXXXXXXXXXXXGOOOOOOOOOOOOOXXXXXXGOOOOOOOOOOOOOOOOXXXGOOOOOOXXXXXXXXXXXXX,0,0,0
45843,133,1,132,23,444,0,0,156,98,58,GOOOOOOOOOOOOOXXXXXXGOOOOOOOOXXXXXXXXXXXGOOOOOOXXXXXXXXXXXXXGOOOOOOOOOOOOXXXXXXXGOOOOOOOXXXXXXXXXXXXGOOOOOOOOOOOOXXXXXXXGOOOOOOOOXXXXXXXXXXXGOOXXXXXXXXXXXXXXXXXGOOOOOOOOOOOAXXXXXXXGOOOOOXXXXXXXXXXXXXXGOOOOOOOOOOOOOXXXXXXGOOOOOOOOOOOOOOOOXXXGOOOOOOXXXXXXXXXXXXX,0,0,0
45864,133,0,133,25,442,0,0,154,98,56,GOOOOOOOOOOOOOXXXXXXGOOOOOOOOXXXXXXXXXXXGOOOOOOXXXXXXXXXXXXXGOOOOOOOOOOOOXXXXXXXGOOOOOOOXXXXXXXXXXXXGOOOOOOOOOOOOXXXXXXXGOOOOOOOOXXXXXXXXXXXGOOXXXXXXXXXXXXXXXXXGOOOOOOOOOOOOXXXXXXXGOOOOOXXXXXXXXXXXXXXGOOOOOOOOOOOOOXXXXXXGOOOOOOOOOOOOOOOOXXXGOOOOOOXXXXXXXXXXXXX,0,0,0

45885,133,0,133,27,440,0,0,152,98,54,GOOOOOOOOOOOOOXXXXXXGOOOOOOOOXXXXXXXXXXXGOOOOOOXXXXXXXXXXXXXGOOOOOOOOOOOOXXXXXXXGOOOOOOOXXXXXXXXXXXXGOOOOOOOOOOOOXXXXXXXGOOOOOOOOXXXXXXXXXXXGOOXXXXXXXXXXXXXXXXXGOOOOOOOOOOOOXXXXXXXGOOOOOXXXXXXXXXXXXXXGOOOOOOOOOOOOOXXXXXXGOOOOOOOOOOOOOOOOXXXGOOOOOOXXXXXXXXXXXXX,0,0,0
45906,133,0,133,28,439,0,0,151,97,54,GOOOOOOOOOOOOOXXXXXXGOOOOOOOOXXXXXXXXXXXGOOOOOOXXXXXXXXXXXXXGOOOOOOOOOOOOXXXXXXXGOOOOOOOXXXXXXXXXXXXGOOOOOOOOOOOOXXXXXXXGOOOOOOOOXXXXXXXXXXXGOOXXXXXXXXXXXXXXXXXGOOOOOOOOOOOOXXXXXXXGOOOOOXXXXXXXXXXXXXXGOOOOOOOOOOOOOXXXXXXGOOOOOOOOOOOOOOOOXXXGOOOOOOXXXXXXXXXXXXX,0,0,0
45927,133,0,133,29,438,0,0,150,96,54,GOOOOOOOOOOOOOXXXXXXGOOOOOOOOXXXXXXXXXXXGOOOOOOXXXXXXXXXXXXXGOOOOOOOOOOOOXXXXXXXGOOOOOOOXXXXXXXXXXXXGOOOOOOOOOOOOXXXXXXXGOOOOOOOOXXXXXXXXXXXGOOXXXXXXXXXXXXXXXXXGOOOOOOOOOOOOXXXXXXXGOOOOOXXXXXXXXXXXXXXGOOOOOOOOOOOOOXXXXXXGOOOOOOOOOOOOOOOOXXXGOOOOOOXXXXXXXXXXXXX,0,0,0
45948,133,0,133,32,435,0,0,147,97,50,GOOOOOOOOOOOOOXXXXXXGOOOOOOOOXXXXXXXXXXXGOOOOOOXXXXXXXXXXXXXGOOOOOOOOOOOOXXXXXXXGOOOOOOOXXXXXXXXXXXXGOOOOOOOOOOOOXXXXXXXGOOOOOOOOXXXXXXXXXXXGOOXXXXXXXXXXXXXXXXXGOOOOOOOOOOOOXXXXXXXGOOOOOXXXXXXXXXXXXXXGOOOOOOOOOOOOOXXXXXXGOOOOOOOOOOOOOOOOXXXGOOOOOOXXXXXXXXXXXXX,0,0,0
45969,133,0,133,32,435,0,0,146,97,49,GOOOOOOOOOOOOOXXXXXXGOOOOOOOOXXXXXXXXXXXGOOOOOOXXXXXXXXXXXXXGOOOOOOOOOOOOXXXXXXXGOOOOOOOXXXXXXXXXXXXGOOOOOOOOOOOOXXXXXXXGOOOOOOOOXXXXXXXXXXXGOOXXXXXXXXXXXXXXXXXGOOOOOOOOOOOOXXXXXXXGOOOOOXXXXXXXXXXXXXXGOOOOOOOOOOOOOXXXXXXGOOOOOOOOOOOOOOOOXXXGOOOOOOXXXXXXXXXXXXX,0,0,0

45990,133,0,133,32,435,0,0,147,95,52,GOOOOOOOOOOOOOXXXXXXGOOOOOOOOXXXXXXXXXXXGOOOOOOXXXXXXXXXXXXXGOOOOOOOOOOOOXXXXXXXGOOOOOOOXXXXXXXXXXXXGOOOOOOOOOOOOXXXXXXXGOOOOOOOOXXXXXXXXXXXGOOXXXXXXXXXXXXXXXXXGOOOOOOOOOOOOXXXXXXXGOOOOOXXXXXXXXXXXXXXGOOOOOOOOOOOOOXXXXXXGOOOOOOOOOOOOOOOOXXXGOOOOOOXXXXXXXXXXXXX,0,0,0
46011,133,0,133,29,438,0,0,150,97,53,GOOOOOOOOOOOOOXXXXXXGOOOOOOOOXXXXXXXXXXXGOOOOOOXXXXXXXXXXXXXGOOOOOOOOOOOOXXXXXXXGOOOOOOOXXXXXXXXXXXXGOOOOOOOOOOOOXXXXXXXGOOOOOOOOXXXXXXXXXXXGOOXXXXXXXXXXXXXXXXXGOOOOOOOOOOOOXXXXXXXGOOOOOXXXXXXXXXXXXXXGOOOOOOOOOOOOOXXXXXXGOOOOOOOOOOOOOOOOXXXGOOOOOOXXXXXXXXXXXXX,0,0,0
46032,133,0,133,29,438,0,0,150,96,54,GOOOOOOOOOOOOOXXXXXXGOOOOOOOOXXXXXXXXXXXGOOOOOOXXXXXXXXXXXXXGOOOOOOOOOOOOXXXXXXXGOOOOOOOXXXXXXXXXXXXGOOOOOOOOOOOOXXXXXXXGOOOOOOOOXXXXXXXXXXXGOOXXXXXXXXXXXXXXXXXGOOOOOOOOOOOOXXXXXXXGOOOOOXXXXXXXXXXXXXXGOOOOOOOOOOOOOXXXXXXGOOOOOOOOOOOOOOOOXXXGOOOOOOXXXXXXXXXXXXX,0,0,0
46053,134,1,133,29,437,0,0,149,96,53,GOOOOOOOOOOOOOXXXXXXGOOOOOOOOXXXXXXXXXXXGOOOOOOXXXXXXXXXXXXXGOOOOOOOOOOOOXXXXXXXGOOOOOOOXXXXXXXXXXXXGOOOOOOOOOOOOXXXXXXXGOOOOOOOOXXXXXXXXXXXGOOXXXXXXXXXXXXXXXXXGOOOOOOOOOOOOAXXXXXXGOOOOOXXXXXXXXXXXXXXGOOOOOOOOOOOOOXXXXXXGOOOOOOOOOOOOOOOOXXXGOOOOOOXXXXXXXXXXXXX,0,0,0
46074,134,0,134,28,438,0,0,150,97,53,GOOOOOOOOOOOOOXXXXXXGOOOOOOOOXXXXXXXXXXXGOOOOOOXXXXXXXXXXXXXGOOOOOOOOOOOOXXXXXXXGOOOOOOOXXXXXXXXXXXXGOOOOOOOOOOOOXXXXXXXGOOOOOOOOXXXXXXXXXXXGOOXXXXXXXXXXXXXXXXXGOOOOOOOOOOOOOXXXXXXGOOOOOXXXXXXXXXXXXXXGOOOOOOOOOOOOOXXXXXXGOOOOOOOOOOOOOOOOXXXGOOOOOOXXXXXXXXXXXXX,0,0,0

46095,134,0,134,27,439,0,0,150,97,53,GOOOOOOOOOOOOOXXXXXXGOOOOOOOOXXXXXXXXXXXGOOOOOOXXXXXXXXXXXXXGOOOOOOOOOOOOXXXXXXXGOOOOOOOXXXXXXXXXXXXGOOOOOOOOOOOOXXXXXXXGOOOOOOOOXXXXXXXXXXXGOOXXXXXXXXXXXXXXXXXGOOOOOOOOOOOOOXXXXXXGOOOOOXXXXXXXXXXXXXXGOOOOOOOOOOOOOXXXXXXGOOOOOOOOOOOOOOOOXXXGOOOOOOXXXXXXXXXXXXX,0,0,0
46116,134,0,134,29,437,0,0,150,96,54,GOOOOOOOOOOOOOXXXXXXGOOOOOOOOXXXXXXXXXXXGOOOOOOXXXXXXXXXXXXXGOOOOOOOOOOOOXXXXXXXGOOOOOOOXXXXXXXXXXXXGOOOOOOOOOOOOXXXXXXXGOOOOOOOOXXXXXXXXXXXGOOXXXXXXXXXXXXXXXXXGOOOOOOOOOOOOOXXXXXXGOOOOOXXXXXXXXXXXXXXGOOOOOOOOOOOOOXXXXXXGOOOOOOOOOOOOOOOOXXXGOOOOOOXXXXXXXXXXXXX,0,0,0
46137,134,0,134,29,437,0,0,149,96,53,GOOOOOOOOOOOOOXXXXXXGOOOOOOOOXXXXXXXXXXXGOOOOOOXXXXXXXXXXXXXGOOOOOOOOOOOOXXXXXXXGOOOOOOOXXXXXXXXXXXXGOOOOOOOOOOOOXXXXXXXGOOOOOOOOXXXXXXXXXXXGOOXXXXXXXXXXXXXXXXXGOOOOOOOOOOOOOXXXXXXGOOOOOXXXXXXXXXXXXXXGOOOOOOOOOOOOOXXXXXXGOOOOOOOOOOOOOOOOXXXGOOOOOOXXXXXXXXXXXXX,0,0,0
46158,134,0,134,29,437,0,0,149,97,52,GOOOOOOOOOOOOOXXXXXXGOOOOOOOOXXXXXXXXXXXGOOOOOOXXXXXXXXXXXXXGOOOOOOOOOOOOXXXXXXXGOOOOOOOXXXXXXXXXXXXGOOOOOOOOOOOOXXXXXXXGOOOOOOOOXXXXXXXXXXXGOOXXXXXXXXXXXXXXXXXGOOOOOOOOOOOOOXXXXXXGOOOOOXXXXXXXXXXXXXXGOOOOOOOOOOOOOXXXXXXGOOOOOOOOOOOOOOOOXXXGOOOOOOXXXXXXXXXXXXX,0,0,0
46179,134,0,134,25,441,0,0,153,97,56,GOOOOOOOOOOOOOXXXXXXGOOOOOOOOXXXXXXXXXXXGOOOOOOXXXXXXXXXXXXXGOOOOOOOOOOOOXXXXXXXGOOOOOOOXXXXXXXXXXXXGOOOOOOOOOOOOXXXXXXXGOOOOOOOOXXXXXXXXXXXGOOXXXXXXXXXXXXXXXXXGOOOOOOOOOOOOOXXXXXXGOOOOOXXXXXXXXXXXXXXGOOOOOOOOOOOOOXXXXXXGOOOOOOOOOOOOOOOOXXXGOOOOOOXXXXXXXXXXXXX,0,0,0

46200,134,0,134,28,438,0,0,151,96,55,GOOOOOOOOOOOOOXXXXXXGOOOOOOOOXXXXXXXXXXXGOOOOOOXXXXXXXXXXXXXGOOOOOOOOOOOOXXXXXXXGOOOOOOOXXXXXXXXXXXXGOOOOOOOOOOOOXXXXXXXGOOOOOOOOXXXXXXXXXXXGOOXXXXXXXXXXXXXXXXXGOOOOOOOOOOOOOXXXXXXGOOOOOXXXXXXXXXXXXXXGOOOOOOOOOOOOOXXXXXXGOOOOOOOOOOOOOOOOXXXGOOOOOOXXXXXXXXXXXXX,0,0,0
46221,134,0,134,25,441,0,0,153,95,58,GOOOOOOOOOOOOOXXXXXXGOOOOOOOOXXXXXXXXXXXGOOOOOOXXXXXXXXXXXXXGOOOOOOOOOOOOXXXXXXXGOOOOOOOXXXXXXXXXXXXGOOOOOOOOOOOOXXXXXXXGOOOOOOOOXXXXXXXXXXXGOOXXXXXXXXXXXXXXXXXGOOOOOOOOOOOOOXXXXXXGOOOOOXXXXXXXXXXXXXXGOOOOOOOOOOOOOXXXXXXGOOOOOOOOOOOOOOOOXXXGOOOOOOXXXXXXXXXXXXX,0,0,0
46242,134,0,134,25,441,0,0,154,98,56,GOOOOOOOOOOOOOXXXXXXGOOOOOOOOXXXXXXXXXXXGOOOOOOXXXXXXXXXXXXXGOOOOOOOOOOOOXXXXXXXGOOOOOOOXXXXXXXXXXXXGOOOOOOOOOOOOXXXXXXXGOOOOOOOOXXXXXXXXXXXGOOXXXXXXXXXXXXXXXXXGOOOOOOOOOOOOOXXXXXXGOOOOOXXXXXXXXXXXXXXGOOOOOOOOOOOOOXXXXXXGOOOOOOOOOOOOOOOOXXXGOOOOOOXXXXXXXXXXXXX,0,0,0
46263,134,0,134,26,440,0,0,153,98,55,GOOOOOOOOOOOOOXXXXXXGOOOOOOOOXXXXXXXXXXXGOOOOOOXXXXXXXXXXXXXGOOOOOOOOOOOOXXXXXXXGOOOOOOOXXXXXXXXXXXXGOOOOOOOOOOOOXXXXXXXGOOOOOOOOXXXXXXXXXXXGOOXXXXXXXXXXXXXXXXXGOOOOOOOOOOOOOXXXXXXGOOOOOXXXXXXXXXXXXXXGOOOOOOOOOOOOOXXXXXXGOOOOOOOOOOOOOOOOXXXGOOOOOOXXXXXXXXXXXXX,0,0,0
46284,134,0,134,27,439,0,0,153,98,55,GOOOOOOOOOOOOOXXXXXXGOOOOOOOOXXXXXXXXXXXGOOOOOOXXXXXXXXXXXXXGOOOOOOOOOOOOXXXXXXXGOOOOOOOXXXXXXXXXXXXGOOOOOOOOOOOOXXXXXXXGOOOOOOOOXXXXXXXXXXXGOOXXXXXXXXXXXXXXXXXGOOOOOOOOOOOOOXXXXXXGOOOOOXXXXXXXXXXXXXXGOOOOOOOOOOOOOXXXXXXGOOOOOOOOOOOOOOOOXXXGOOOOOOXXXXXXXXXXXXX,0,0,0

46305,134,0,134,29,437,0,0,150,96,54,GOOOOOOOOOOOOOXXXXXXGOOOOOOOOXXXXXXXXXXXGOOOOOOXXXXXXXXXXXXXGOOOOOOOOOOOOXXXXXXXGOOOOOOOXXXXXXXXXXXXGOOOOOOOOOOOOXXXXXXXGOOOOOOOOXXXXXXXXXXXGOOXXXXXXXXXXXXXXXXXGOOOOOOOOOOOOOXXXXXXGOOOOOXXXXXXXXXXXXXXGOOOOOOOOOOOOOXXXXXXGOOOOOOOOOOOOOOOOXXXGOOOOOOXXXXXXXXXXXXX,0,0,0
46326,134,0,134,27,439,0,0,152,96,56,GOOOOOOOOOOOOOXXXXXXGOOOOOOOOXXXXXXXXXXXGOOOOOOXXXXXXXXXXXXXGOOOOOOOOOOOOXXXXXXXGOOOOOOOXXXXXXXXXXXXGOOOOOOOOOOOOXXXXXXXGOOOOOOOOXXXXXXXXXXXGOOXXXXXXXXXXXXXXXXXGOOOOOOOOOOOOOXXXXXXGOOOOOXXXXXXXXXXXXXXGOOOOOOOOOOOOOXXXXXXGOOOOOOOOOOOOOOOOXXXGOOOOOOXXXXXXXXXXXXX,0,0,0
46347,135,1,134,27,438,0,0,150,96,54,GOOOOOOOOOOOOOXXXXXXGOOOOOOOOXXXXXXXXXXXGOOOOOOXXXXXXXXXXXXXGOOOOOOOOOOOOXXXXXXXGOOOOOOOXXXXXXXXXXXXGOOOOOOOOOOOOXXXXXXXGOOOOOOOOXXXXXXXXXXXGOOXXXXXXXXXXXXXXXXXGOOOOOOOOOOOOOXXXXXXGOOOOOXXXXXXXXXXXXXXGOOOOOOOOOOOOOAXXXXXGOOOOOOOOOOOOOOOOXXXGOOOOOOXXXXXXXXXXXXX,0,0,0
46368,135,1,134,27,438,0,0,150,98,52,GOOOOOOOOOOOOOXXXXXXGOOOOOOOOXXXXXXXXXXXGOOOOOOXXXXXXXXXXXXXGOOOOOOOOOOOOXXXXXXXGOOOOOOOXXXXXXXXXXXXGOOOOOOOOOOOOXXXXXXXGOOOOOOOOXXXXXXXXXXXGOOXXXXXXXXXXXXXXXXXGOOOOOOOOOOOOOXXXXXXGOOOOOXXXXXXXXXXXXXXGOOOOOOOOOOOOOAXXXXXGOOOOOOOOOOOOOOOOXXXGOOOOOOXXXXXXXXXXXXX,0,0,0
46389,135,1,134,28,437,0,0,149,98,51,GOOOOOOOOOOOOOXXXXXXGOOOOOOOOXXXXXXXXXXXGOOOOOOXXXXXXXXXXXXXGOOOOOOOOOOOOXXXXXXXGOOOOOOOXXXXXXXXXXXXGOOOOOOOOOOOOXXXXXXXGOOOOOOOOXXXXXXXXXXXGOOXXXXXXXXXXXXXXXXXGOOOOOOOOOOOOOXXXXXXGOOOOOXXXXXXXXXXXXXXGOOOOOOOOOOOOOAXXXXXGOOOOOOOOOOOOOOOOXXXGOOOOOOXXXXXXXXXXXXX,0,0,0

46410,135,1,134,29,436,0,0,148,96,52,GOOOOOOOOOOOOOXXXXXXGOOOOOOOOXXXXXXXXXXXGOOOOOOXXXXXXXXXXXXXGOOOOOOOOOOOOXXXXXXXGOOOOOOOXXXXXXXXXXXXGOOOOOOOOOOOOXXXXXXXGOOOOOOOOXXXXXXXXXXXGOOXXXXXXXXXXXXXXXXXGOOOOOOOOOOOOOXXXXXXGOOOOOXXXXXXXXXXXXXXGOOOOOOOOOOOOOAXXXXXGOOOOOOOOOOOOOOOOXXXGOOOOOOXXXXXXXXXXXXX,0,0,0
46431,135,1,134,29,436,0,0,147,96,51,GOOOOOOOOOOOOOXXXXXXGOOOOOOOOXXXXXXXXXXXGOOOOOOXXXXXXXXXXXXXGOOOOOOOOOOOOXXXXXXXGOOOOOOOXXXXXXXXXXXXGOOOOOOOOOOOOXXXXXXXGOOOOOOOOXXXXXXXXXXXGOOXXXXXXXXXXXXXXXXXGOOOOOOOOOOOOOXXXXXXGOOOOOXXXXXXXXXXXXXXGOOOOOOOOOOOOOAXXXXXGOOOOOOOOOOOOOOOOXXXGOOOOOOXXXXXXXXXXXXX,0,0,0
46452,135,0,135,27,438,0,0,150,94,56,GOOOOOOOOOOOOOXXXXXXGOOOOOOOOXXXXXXXXXXXGOOOOOOXXXXXXXXXXXXXGOOOOOOOOOOOOXXXXXXXGOOOOOOOXXXXXXXXXXXXGOOOOOOOOOOOOXXXXXXXGOOOOOOOOXXXXXXXXXXXGOOXXXXXXXXXXXXXXXXXGOOOOOOOOOOOOOXXXXXXGOOOOOXXXXXXXXXXXXXXGOOOOOOOOOOOOOOXXXXXGOOOOOOOOOOOOOOOOXXXGOOOOOOXXXXXXXXXXXXX,0,0,0
46473,136,1,135,25,439,0,0,151,97,54,GOOOOOOOOOOOOOXXXXXXGOOOOOOOOXXXXXXXXXXXGOOOOOOXXXXXXXXXXXXXGOOOOOOOOOOOOXXXXXXXGOOOOOOOXXXXXXXXXXXXGOOOOOOOOOOOOXXXXXXXGOOOOOOOOXXXXXXXXXXXGOOXXXXXXXXXXXXXXXXXGOOOOOOOOOOOOOAXXXXXGOOOOOXXXXXXXXXXXXXXGOOOOOOOOOOOOOOXXXXXGOOOOOOOOOOOOOOOOXXXGOOOOOOXXXXXXXXXXXXX,0,0,0
46494,136,1,135,25,439,0,0,151,98,53,GOOOOOOOOOOOOOXXXXXXGOOOOOOOOXXXXXXXXXXXGOOOOOOXXXXXXXXXXXXXGOOOOOOOOOOOOXXXXXXXGOOOOOOOXXXXXXXXXXXXGOOOOOOOOOOOOXXXXXXXGOOOOOOOOXXXXXXXXXXXGOOXXXXXXXXXXXXXXXXXGOOOOOOOOOOOOOAXXXXXGOOOOOXXXXXXXXXXXXXXGOOOOOOOOOOOOOOXXXXXGOOOOOOOOOOOOOOOOXXXGOOOOOOXXXXXXXXXXXXX,0,0,0

46515,136,1,135,28,436,0,0,148,96,52,GOOOOOOOOOOOOOXXXXXXGOOOOOOOOXXXXXXXXXXXGOOOOOOXXXXXXXXXXXXXGOOOOOOOOOOOOXXXXXXXGOOOOOOOXXXXXXXXXXXXGOOOOOOOOOOOOXXXXXXXGOOOOOOOOXXXXXXXXXXXGOOXXXXXXXXXXXXXXXXXGOOOOOOOOOOOOOAXXXXXGOOOOOXXXXXXXXXXXXXXGOOOOOOOOOOOOOOXXXXXGOOOOOOOOOOOOOOOOXXXGOOOOOOXXXXXXXXXXXXX,0,0,0
46536,136,1,135,27,437,0,0,149,97,52,GOOOOOOOOOOOOOXXXXXXGOOOOOOOOXXXXXXXXXXXGOOOOOOXXXXXXXXXXXXXGOOOOOOOOOOOOXXXXXXXGOOOOOOOXXXXXXXXXXXXGOOOOOOOOOOOOXXXXXXXGOOOOOOOOXXXXXXXXXXXGOOXXXXXXXXXXXXXXXXXGOOOOOOOOOOOOOAXXXXXGOOOOOXXXXXXXXXXXXXXGOOOOOOOOOOOOOOXXXXXGOOOOOOOOOOOOOOOOXXXGOOOOOOXXXXXXXXXXXXX,0,0,0
46557,136,1,135,27,437,0,0,149,97,52,GOOOOOOOOOOOOOXXXXXXGOOOOOOOOXXXXXXXXXXXGOOOOOOXXXXXXXXXXXXXGOOOOOOOOOOOOXXXXXXXGOOOOOOOXXXXXXXXXXXXGOOOOOOOOOOOOXXXXXXXGOOOOOOOOXXXXXXXXXXXGOOXXXXXXXXXXXXXXXXXGOOOOOOOOOOOOOAXXXXXGOOOOOXXXXXXXXXXXXXXGOOOOOOOOOOOOOOXXXXXGOOOOOOOOOOOOOOOOXXXGOOOOOOXXXXXXXXXXXXX,0,0,0
46578,136,1,135,27,437,0,0,149,97,52,GOOOOOOOOOOOOOXXXXXXGOOOOOOOOXXXXXXXXXXXGOOOOOOXXXXXXXXXXXXXGOOOOOOOOOOOOXXXXXXXGOOOOOOOXXXXXXXXXXXXGOOOOOOOOOOOOXXXXXXXGOOOOOOOOXXXXXXXXXXXGOOXXXXXXXXXXXXXXXXXGOOOOOOOOOOOOOAXXXXXGOOOOOXXXXXXXXXXXXXXGOOOOOOOOOOOOOOXXXXXGOOOOOOOOOOOOOOOOXXXGOOOOOOXXXXXXXXXXXXX,0,0,0
46599,136,0,136,30,434,0,0,147,97,50,GOOOOOOOOOOOOOXXXXXXGOOOOOOOOXXXXXXXXXXXGOOOOOOXXXXXXXXXXXXXGOOOOOOOOOOOOXXXXXXXGOOOOOOOXXXXXXXXXXXXGOOOOOOOOOOOOXXXXXXXGOOOOOOOOXXXXXXXXXXXGOOXXXXXXXXXXXXXXXXXGOOOOOOOOOOOOOOXXXXXGOOOOOXXXXXXXXXXXXXXGOOOOOOOOOOOOOOXXXXXGOOOOOOOOOOOOOOOOXXXGOOOOOOXXXXXXXXXXXXX,0,0,0

46620,136,0,136,30,434,0,0,146,97,49,GOOOOOOOOOOOOOXXXXXXGOOOOOOOOXXXXXXXXXXXGOOOOOOXXXXXXXXXXXXXGOOOOOOOOOOOOXXXXXXXGOOOOOOOXXXXXXXXXXXXGOOOOOOOOOOOOXXXXXXXGOOOOOOOOXXXXXXXXXXXGOOXXXXXXXXXXXXXXXXXGOOOOOOOOOOOOOOXXXXXGOOOOOXXXXXXXXXXXXXXGOOOOOOOOOOOOOOXXXXXGOOOOOOOOOOOOOOOOXXXGOOOOOOXXXXXXXXXXXXX,0,0,0
46641,136,0,136,27,437,0,0,151,101,50,GOOOOOOOOOOOOOXXXXXXGOOOOOOOOXXXXXXXXXXXGOOOOOOXXXXXXXXXXXXXGOOOOOOOOOOOOXXXXXXXGOOOOOOOXXXXXXXXXXXXGOOOOOOOOOOOOXXXXXXXGOOOOOOOOXXXXXXXXXXXGOOXXXXXXXXXXXXXXXXXGOOOOOOOOOOOOOOXXXXXGOOOOOXXXXXXXXXXXXXXGOOOOOOOOOOOOOOXXXXXGOOOOOOOOOOOOOOOOXXXGOOOOOOXXXXXXXXXXXXX,0,0,0
46662,136,0,136,31,433,0,0,147,97,50,GOOOOOOOOOOOOOXXXXXXGOOOOOOOOXXXXXXXXXXXGOOOOOOXXXXXXXXXXXXXGOOOOOOOOOOOOXXXXXXXGOOOOOOOXXXXXXXXXXXXGOOOOOOOOOOOOXXXXXXXGOOOOOOOOXXXXXXXXXXXGOOXXXXXXXXXXXXXXXXXGOOOOOOOOOOOOOOXXXXXGOOOOOXXXXXXXXXXXXXXGOOOOOOOOOOOOOOXXXXXGOOOOOOOOOOOOOOOOXXXGOOOOOOXXXXXXXXXXXXX,0,0,0
46683,136,0,136,35,429,0,0,143,95,48,GOOOOOOOOOOOOOXXXXXXGOOOOOOOOXXXXXXXXXXXGOOOOOOXXXXXXXXXXXXXGOOOOOOOOOOOOXXXXXXXGOOOOOOOXXXXXXXXXXXXGOOOOOOOOOOOOXXXXXXXGOOOOOOOOXXXXXXXXXXXGOOXXXXXXXXXXXXXXXXXGOOOOOOOOOOOOOOXXXXXGOOOOOXXXXXXXXXXXXXXGOOOOOOOOOOOOOOXXXXXGOOOOOOOOOOOOOOOOXXXGOOOOOOXXXXXXXXXXXXX,0,0,0
46704,136,0,136,30,434,0,0,148,97,51,GOOOOOOOOOOOOOXXXXXXGOOOOOOOOXXXXXXXXXXXGOOOOOOXXXXXXXXXXXXXGOOOOOOOOOOOOXXXXXXXGOOOOOOOXXXXXXXXXXXXGOOOOOOOOOOOOXXXXXXXGOOOOOOOOXXXXXXXXXXXGOOXXXXXXXXXXXXXXXXXGOOOOOOOOOOOOOOXXXXXGOOOOOXXXXXXXXXXXXXXGOOOOOOOOOOOOOOXXXXXGOOOOOOOOOOOOOOOOXXXGOOOOOOXXXXXXXXXXXXX,0,0,0

46725,136,0,136,27,437,0,0,151,99,52,GOOOOOOOOOOOOOXXXXXXGOOOOOOOOXXXXXXXXXXXGOOOOOOXXXXXXXXXXXXXGOOOOOOOOOOOOXXXXXXXGOOOOOOOXXXXXXXXXXXXGOOOOOOOOOOOOXXXXXXXGOOOOOOOOXXXXXXXXXXXGOOXXXXXXXXXXXXXXXXXGOOOOOOOOOOOOOOXXXXXGOOOOOXXXXXXXXXXXXXXGOOOOOOOOOOOOOOXXXXXGOOOOOOOOOOOOOOOOXXXGOOOOOOXXXXXXXXXXXXX,0,0,0
46746,136,0,136,29,435,0,0,149,95,54,GOOOOOOOOOOOOOXXXXXXGOOOOOOOOXXXXXXXXXXXGOOOOOOXXXXXXXXXXXXXGOOOOOOOOOOOOXXXXXXXGOOOOOOOXXXXXXXXXXXXGOOOOOOOOOOOOXXXXXXXGOOOOOOOOXXXXXXXXXXXGOOXXXXXXXXXXXXXXXXXGOOOOOOOOOOOOOOXXXXXGOOOOOXXXXXXXXXXXXXXGOOOOOOOOOOOOOOXXXXXGOOOOOOOOOOOOOOOOXXXGOOOOOOXXXXXXXXXXXXX,0,0,0
46767,136,0,136,29,435,0,0,149,96,53,GOOOOOOOOOOOOOXXXXXXGOOOOOOOOXXXXXXXXXXXGOOOOOOXXXXXXXXXXXXXGOOOOOOOOOOOOXXXXXXXGOOOOOOOXXXXXXXXXXXXGOOOOOOOOOOOOXXXXXXXGOOOOOOOOXXXXXXXXXXXGOOXXXXXXXXXXXXXXXXXGOOOOOOOOOOOOOOXXXXXGOOOOOXXXXXXXXXXXXXXGOOOOOOOOOOOOOOXXXXXGOOOOOOOOOOOOOOOOXXXGOOOOOOXXXXXXXXXXXXX,0,0,0
46788,136,0,136,28,436,0,0,150,98,52,GOOOOOOOOOOOOOXXXXXXGOOOOOOOOXXXXXXXXXXXGOOOOOOXXXXXXXXXXXXXGOOOOOOOOOOOOXXXXXXXGOOOOOOOXXXXXXXXXXXXGOOOOOOOOOOOOXXXXXXXGOOOOOOOOXXXXXXXXXXXGOOXXXXXXXXXXXXXXXXXGOOOOOOOOOOOOOOXXXXXGOOOOOXXXXXXXXXXXXXXGOOOOOOOOOOOOOOXXXXXGOOOOOOOOOOOOOOOOXXXGOOOOOOXXXXXXXXXXXXX,0,0,0
46809,136,0,136,27,437,0,0,150,101,49,GOOOOOOOOOOOOOXXXXXXGOOOOOOOOXXXXXXXXXXXGOOOOOOXXXXXXXXXXXXXGOOOOOOOOOOOOXXXXXXXGOOOOOOOXXXXXXXXXXXXGOOOOOOOOOOOOXXXXXXXGOOOOOOOOXXXXXXXXXXXGOOXXXXXXXXXXXXXXXXXGOOOOOOOOOOOOOOXXXXXGOOOOOXXXXXXXXXXXXXXGOOOOOOOOOOOOOOXXXXXGOOOOOOOOOOOOOOOOXXXGOOOOOOXXXXXXXXXXXXX,0,0,0

46830,136,0,136,30,434,0,0,148,97,51,GOOOOOOOOOOOOOXXXXXXGOOOOOOOOXXXXXXXXXXXGOOOOOOXXXXXXXXXXXXXGOOOOOOOOOOOOXXXXXXXGOOOOOOOXXXXXXXXXXXXGOOOOOOOOOOOOXXXXXXXGOOOOOOOOXXXXXXXXXXXGOOXXXXXXXXXXXXXXXXXGOOOOOOOOOOOOOOXXXXXGOOOOOXXXXXXXXXXXXXXGOOOOOOOOOOOOOOXXXXXGOOOOOOOOOOOOOOOOXXXGOOOOOOXXXXXXXXXXXXX,0,0,0
46851,136,0,136,29,435,0,0,149,98,51,GOOOOOOOOOOOOOXXXXXXGOOOOOOOOXXXXXXXXXXXGOOOOOOXXXXXXXXXXXXXGOOOOOOOOOOOOXXXXXXXGOOOOOOOXXXXXXXXXXXXGOOOOOOOOOOOOXXXXXXXGOOOOOOOOXXXXXXXXXXXGOOXXXXXXXXXXXXXXXXXGOOOOOOOOOOOOOOXXXXXGOOOOOXXXXXXXXXXXXXXGOOOOOOOOOOOOOOXXXXXGOOOOOOOOOOOOOOOOXXXGOOOOOOXXXXXXXXXXXXX,0,0,0
46872,136,0,136,27,437,0,0,150,98,52,GOOOOOOOOOOOOOXXXXXXGOOOOOOOOXXXXXXXXXXXGOOOOOOXXXXXXXXXXXXXGOOOOOOOOOOOOXXXXXXXGOOOOOOOXXXXXXXXXXXXGOOOOOOOOOOOOXXXXXXXGOOOOOOOOXXXXXXXXXXXGOOXXXXXXXXXXXXXXXXXGOOOOOOOOOOOOOOXXXXXGOOOOOXXXXXXXXXXXXXXGOOOOOOOOOOOOOOXXXXXGOOOOOOOOOOOOOOOOXXXGOOOOOOXXXXXXXXXXXXX,0,0,0
46893,136,0,136,27,437,0,0,150,95,55,GOOOOOOOOOOOOOXXXXXXGOOOOOOOOXXXXXXXXXXXGOOOOOOXXXXXXXXXXXXXGOOOOOOOOOOOOXXXXXXXGOOOOOOOXXXXXXXXXXXXGOOOOOOOOOOOOXXXXXXXGOOOOOOOOXXXXXXXXXXXGOOXXXXXXXXXXXXXXXXXGOOOOOOOOOOOOOOXXXXXGOOOOOXXXXXXXXXXXXXXGOOOOOOOOOOOOOOXXXXXGOOOOOOOOOOOOOOOOXXXGOOOOOOXXXXXXXXXXXXX,0,0,0
46914,136,0,136,24,440,0,0,154,96,58,GOOOOOOOOOOOOOXXXXXXGOOOOOOOOXXXXXXXXXXXGOOOOOOXXXXXXXXXXXXXGOOOOOOOOOOOOXXXXXXXGOOOOOOOXXXXXXXXXXXXGOOOOOOOOOOOOXXXXXXXGOOOOOOOOXXXXXXXXXXXGOOXXXXXXXXXXXXXXXXXGOOOOOOOOOOOOOOXXXXXGOOOOOXXXXXXXXXXXXXXGOOOOOOOOOOOOOOXXXXXGOOOOOOOOOOOOOOOOXXXGOOOOOOXXXXXXXXXXXXX,0,0,0

46935,136,0,136,24,440,0,0,153,98,55,GOOOOOOOOOOOOOXXXXXXGOOOOOOOOXXXXXXXXXXXGOOOOOOXXXXXXXXXXXXXGOOOOOOOOOOOOXXXXXXXGOOOOOOOXXXXXXXXXXXXGOOOOOOOOOOOOXXXXXXXGOOOOOOOOXXXXXXXXXXXGOOXXXXXXXXXXXXXXXXXGOOOOOOOOOOOOOOXXXXXGOOOOOXXXXXXXXXXXXXXGOOOOOOOOOOOOOOXXXXXGOOOOOOOOOOOOOOOOXXXGOOOOOOXXXXXXXXXXXXX,0,0,0
46956,136,0,136,24,440,0,0,154,97,57,GOOOOOOOOOOOOOXXXXXXGOOOOOOOOXXXXXXXXXXXGOOOOOOXXXXXXXXXXXXXGOOOOOOOOOOOOXXXXXXXGOOOOOOOXXXXXXXXXXXXGOOOOOOOOOOOOXXXXXXXGOOOOOOOOXXXXXXXXXXXGOOXXXXXXXXXXXXXXXXXGOOOOOOOOOOOOOOXXXXXGOOOOOXXXXXXXXXXXXXXGOOOOOOOOOOOOOOXXXXXGOOOOOOOOOOOOOOOOXXXGOOOOOOXXXXXXXXXXXXX,0,0,0
46977,136,0,136,26,438,0,0,152,96,56,GOOOOOOOOOOOOOXXXXXXGOOOOOOOOXXXXXXXXXXXGOOOOOOXXXXXXXXXXXXXGOOOOOOOOOOOOXXXXXXXGOOOOOOOXXXXXXXXXXXXGOOOOOOOOOOOOXXXXXXXGOOOOOOOOXXXXXXXXXXXGOOXXXXXXXXXXXXXXXXXGOOOOOOOOOOOOOOXXXXXGOOOOOXXXXXXXXXXXXXXGOOOOOOOOOOOOOOXXXXXGOOOOOOOOOOOOOOOOXXXGOOOOOOXXXXXXXXXXXXX,0,0,0
46998,136,0,136,24,440,0,0,154,97,57,GOOOOOOOOOOOOOXXXXXXGOOOOOOOOXXXXXXXXXXXGOOOOOOXXXXXXXXXXXXXGOOOOOOOOOOOOXXXXXXXGOOOOOOOXXXXXXXXXXXXGOOOOOOOOOOOOXXXXXXXGOOOOOOOOXXXXXXXXXXXGOOXXXXXXXXXXXXXXXXXGOOOOOOOOOOOOOOXXXXXGOOOOOXXXXXXXXXXXXXXGOOOOOOOOOOOOOOXXXXXGOOOOOOOOOOOOOOOOXXXGOOOOOOXXXXXXXXXXXXX,0,0,0
47019,136,0,136,27,437,0,0,151,98,53,GOOOOOOOOOOOOOXXXXXXGOOOOOOOOXXXXXXXXXXXGOOOOOOXXXXXXXXXXXXXGOOOOOOOOOOOOXXXXXXXGOOOOOOOXXXXXXXXXXXXGOOOOOOOOOOOOXXXXXXXGOOOOOOOOXXXXXXXXXXXGOOXXXXXXXXXXXXXXXXXGOOOOOOOOOOOOOOXXXXXGOOOOOXXXXXXXXXXXXXXGOOOOOOOOOOOOOOXXXXXGOOOOOOOOOOOOOOOOXXXGOOOOOOXXXXXXXXXXXXX,0,0,0

47040,136,0,136,25,439,0,0,152,99,53,GOOOOOOOOOOOOOXXXXXXGOOOOOOOOXXXXXXXXXXXGOOOOOOXXXXXXXXXXXXXGOOOOOOOOOOOOXXXXXXXGOOOOOOOXXXXXXXXXXXXGOOOOOOOOOOOOXXXXXXXGOOOOOOOOXXXXXXXXXXXGOOXXXXXXXXXXXXXXXXXGOOOOOOOOOOOOOOXXXXXGOOOOOXXXXXXXXXXXXXXGOOOOOOOOOOOOOOXXXXXGOOOOOOOOOOOOOOOOXXXGOOOOOOXXXXXXXXXXXXX,0,0,0
47061,136,0,136,29,435,0,0,149,96,53,GOOOOOOOOOOOOOXXXXXXGOOOOOOOOXXXXXXXXXXXGOOOOOOXXXXXXXXXXXXXGOOOOOOOOOOOOXXXXXXXGOOOOOOOXXXXXXXXXXXXGOOOOOOOOOOOOXXXXXXXGOOOOOOOOXXXXXXXXXXXGOOXXXXXXXXXXXXXXXXXGOOOOOOOOOOOOOOXXXXXGOOOOOXXXXXXXXXXXXXXGOOOOOOOOOOOOOOXXXXXGOOOOOOOOOOOOOOOOXXXGOOOOOOXXXXXXXXXXXXX,0,0,0
47082,136,0,136,31,433,0,0,147,97,50,GOOOOOOOOOOOOOXXXXXXGOOOOOOOOXXXXXXXXXXXGOOOOOOXXXXXXXXXXXXXGOOOOOOOOOOOOXXXXXXXGOOOOOOOXXXXXXXXXXXXGOOOOOOOOOOOOXXXXXXXGOOOOOOOOXXXXXXXXXXXGOOXXXXXXXXXXXXXXXXXGOOOOOOOOOOOOOOXXXXXGOOOOOXXXXXXXXXXXXXXGOOOOOOOOOOOOOOXXXXXGOOOOOOOOOOOOOOOOXXXGOOOOOOXXXXXXXXXXXXX,0,0,0
47103,136,0,136,32,432,0,0,146,99,47,GOOOOOOOOOOOOOXXXXXXGOOOOOOOOXXXXXXXXXXXGOOOOOOXXXXXXXXXXXXXGOOOOOOOOOOOOXXXXXXXGOOOOOOOXXXXXXXXXXXXGOOOOOOOOOOOOXXXXXXXGOOOOOOOOXXXXXXXXXXXGOOXXXXXXXXXXXXXXXXXGOOOOOOOOOOOOOOXXXXXGOOOOOXXXXXXXXXXXXXXGOOOOOOOOOOOOOOXXXXXGOOOOOOOOOOOOOOOOXXXGOOOOOOXXXXXXXXXXXXX,0,0,0
47124,136,0,136,33,431,0,0,145,103,42,GOOOOOOOOOOOOOXXXXXXGOOOOOOOOXXXXXXXXXXXGOOOOOOXXXXXXXXXXXXXGOOOOOOOOOOOOXXXXXXXGOOOOOOOXXXXXXXXXXXXGOOOOOOOOOOOOXXXXXXXGOOOOOOOOXXXXXXXXXXXGOOXXXXXXXXXXXXXXXXXGOOOOOOOOOOOOOOXXXXXGOOOOOXXXXXXXXXXXXXXGOOOOOOOOOOOOOOXXXXXGOOOOOOOOOOOOOOOOXXXGOOOOOOXXXXXXXXXXXXX,0,0,0

47145,136,0,136,36,428,0,0,142,98,44,GOOOOOOOOOOOOOXXXXXXGOOOOOOOOXXXXXXXXXXXGOOOOOOXXXXXXXXXXXXXGOOOOOOOOOOOOXXXXXXXGOOOOOOOXXXXXXXXXXXXGOOOOOOOOOOOOXXXXXXXGOOOOOOOOXXXXXXXXXXXGOOXXXXXXXXXXXXXXXXXGOOOOOOOOOOOOOOXXXXXGOOOOOXXXXXXXXXXXXXXGOOOOOOOOOOOOOOXXXXXGOOOOOOOOOOOOOOOOXXXGOOOOOOXXXXXXXXXXXXX,0,0,0
47166,136,0,136,36,428,0,0,142,98,44,GOOOOOOOOOOOOOXXXXXXGOOOOOOOOXXXXXXXXXXXGOOOOOOXXXXXXXXXXXXXGOOOOOOOOOOOOXXXXXXXGOOOOOOOXXXXXXXXXXXXGOOOOOOOOOOOOXXXXXXXGOOOOOOOOXXXXXXXXXXXGOOXXXXXXXXXXXXXXXXXGOOOOOOOOOOOOOOXXXXXGOOOOOXXXXXXXXXXXXXXGOOOOOOOOOOOOOOXXXXXGOOOOOOOOOOOOOOOOXXXGOOOOOOXXXXXXXXXXXXX,0,0,0
47187,136,0,136,38,426,0,0,140,97,43,GOOOOOOOOOOOOOXXXXXXGOOOOOOOOXXXXXXXXXXXGOOOOOOXXXXXXXXXXXXXGOOOOOOOOOOOOXXXXXXXGOOOOOOOXXXXXXXXXXXXGOOOOOOOOOOOOXXXXXXXGOOOOOOOOXXXXXXXXXXXGOOXXXXXXXXXXXXXXXXXGOOOOOOOOOOOOOOXXXXXGOOOOOXXXXXXXXXXXXXXGOOOOOOOOOOOOOOXXXXXGOOOOOOOOOOOOOOOOXXXGOOOOOOXXXXXXXXXXXXX,0,0,0
47208,136,0,136,37,427,0,0,141,97,44,GOOOOOOOOOOOOOXXXXXXGOOOOOOOOXXXXXXXXXXXGOOOOOOXXXXXXXXXXXXXGOOOOOOOOOOOOXXXXXXXGOOOOOOOXXXXXXXXXXXXGOOOOOOOOOOOOXXXXXXXGOOOOOOOOXXXXXXXXXXXGOOXXXXXXXXXXXXXXXXXGOOOOOOOOOOOOOOXXXXXGOOOOOXXXXXXXXXXXXXXGOOOOOOOOOOOOOOXXXXXGOOOOOOOOOOOOOOOOXXXGOOOOOOXXXXXXXXXXXXX,0,0,0
47229,136,0,136,35,429,0,0,143,97,46,GOOOOOOOOOOOOOXXXXXXGOOOOOOOOXXXXXXXXXXXGOOOOOOXXXXXXXXXXXXXGOOOOOOOOOOOOXXXXXXXGOOOOOOOXXXXXXXXXXXXGOOOOOOOOOOOOXXXXXXXGOOOOOOOOXXXXXXXXXXXGOOXXXXXXXXXXXXXXXXXGOOOOOOOOOOOOOOXXXXXGOOOOOXXXXXXXXXXXXXXGOOOOOOOOOOOOOOXXXXXGOOOOOOOOOOOOOOOOXXXGOOOOOOXXXXXXXXXXXXX,0,0,0

47250,136,0,136,35,429,0,0,142,96,46,GOOOOOOOOOOOOOXXXXXXGOOOOOOOOXXXXXXXXXXXGOOOOOOXXXXXXXXXXXXXGOOOOOOOOOOOOXXXXXXXGOOOOOOOXXXXXXXXXXXXGOOOOOOOOOOOOXXXXXXXGOOOOOOOOXXXXXXXXXXXGOOXXXXXXXXXXXXXXXXXGOOOOOOOOOOOOOOXXXXXGOOOOOXXXXXXXXXXXXXXGOOOOOOOOOOOOOOXXXXXGOOOOOOOOOOOOOOOOXXXGOOOOOOXXXXXXXXXXXXX,0,0,0
47271,136,0,136,34,430,0,0,144,98,46,GOOOOOOOOOOOOOXXXXXXGOOOOOOOOXXXXXXXXXXXGOOOOOOXXXXXXXXXXXXXGOOOOOOOOOOOOXXXXXXXGOOOOOOOXXXXXXXXXXXXGOOOOOOOOOOOOXXXXXXXGOOOOOOOOXXXXXXXXXXXGOOXXXXXXXXXXXXXXXXXGOOOOOOOOOOOOOOXXXXXGOOOOOXXXXXXXXXXXXXXGOOOOOOOOOOOOOOXXXXXGOOOOOOOOOOOOOOOOXXXGOOOOOOXXXXXXXXXXXXX,0,0,0
47292,136,0,136,33,431,0,0,145,95,50,GOOOOOOOOOOOOOXXXXXXGOOOOOOOOXXXXXXXXXXXGOOOOOOXXXXXXXXXXXXXGOOOOOOOOOOOOXXXXXXXGOOOOOOOXXXXXXXXXXXXGOOOOOOOOOOOOXXXXXXXGOOOOOOOOXXXXXXXXXXXGOOXXXXXXXXXXXXXXXXXGOOOOOOOOOOOOOOXXXXXGOOOOOXXXXXXXXXXXXXXGOOOOOOOOOOOOOOXXXXXGOOOOOOOOOOOOOOOOXXXGOOOOOOXXXXXXXXXXXXX,0,0,0
47313,136,0,136,32,432,0,0,145,96,49,GOOOOOOOOOOOOOXXXXXXGOOOOOOOOXXXXXXXXXXXGOOOOOOXXXXXXXXXXXXXGOOOOOOOOOOOOXXXXXXXGOOOOOOOXXXXXXXXXXXXGOOOOOOOOOOOOXXXXXXXGOOOOOOOOXXXXXXXXXXXGOOXXXXXXXXXXXXXXXXXGOOOOOOOOOOOOOOXXXXXGOOOOOXXXXXXXXXXXXXXGOOOOOOOOOOOOOOXXXXXGOOOOOOOOOOOOOOOOXXXGOOOOOOXXXXXXXXXXXXX,0,0,0
47334,136,0,136,30,434,0,0,147,97,50,GOOOOOOOOOOOOOXXXXXXGOOOOOOOOXXXXXXXXXXXGOOOOOOXXXXXXXXXXXXXGOOOOOOOOOOOOXXXXXXXGOOOOOOOXXXXXXXXXXXXGOOOOOOOOOOOOXXXXXXXGOOOOOOOOXXXXXXXXXXXGOOXXXXXXXXXXXXXXXXXGOOOOOOOOOOOOOOXXXXXGOOOOOXXXXXXXXXXXXXXGOOOOOOOOOOOOOOXXXXXGOOOOOOOOOOOOOOOOXXXGOOOOOOXXXXXXXXXXXXX,0,0,0

47355,136,0,136,27,437,0,0,150,99,51,GOOOOOOOOOOOOOXXXXXXGOOOOOOOOXXXXXXXXXXXGOOOOOOXXXXXXXXXXXXXGOOOOOOOOOOOOXXXXXXXGOOOOOOOXXXXXXXXXXXXGOOOOOOOOOOOOXXXXXXXGOOOOOOOOXXXXXXXXXXXGOOXXXXXXXXXXXXXXXXXGOOOOOOOOOOOOOOXXXXXGOOOOOXXXXXXXXXXXXXXGOOOOOOOOOOOOOOXXXXXGOOOOOOOOOOOOOOOOXXXGOOOOOOXXXXXXXXXXXXX,0,0,0
47376,136,0,136,28,436,0,0,149,101,48,GOOOOOOOOOOOOOXXXXXXGOOOOOOOOXXXXXXXXXXXGOOOOOOXXXXXXXXXXXXXGOOOOOOOOOOOOXXXXXXXGOOOOOOOXXXXXXXXXXXXGOOOOOOOOOOOOXXXXXXXGOOOOOOOOXXXXXXXXXXXGOOXXXXXXXXXXXXXXXXXGOOOOOOOOOOOOOOXXXXXGOOOOOXXXXXXXXXXXXXXGOOOOOOOOOOOOOOXXXXXGOOOOOOOOOOOOOOOOXXXGOOOOOOXXXXXXXXXXXXX,0,0,0
47397,136,0,136,36,428,0,0,141,96,45,GOOOOOOOOOOOOOXXXXXXGOOOOOOOOXXXXXXXXXXXGOOOOOOXXXXXXXXXXXXXGOOOOOOOOOOOOXXXXXXXGOOOOOOOXXXXXXXXXXXXGOOOOOOOOOOOOXXXXXXXGOOOOOOOOXXXXXXXXXXXGOOXXXXXXXXXXXXXXXXXGOOOOOOOOOOOOOOXXXXXGOOOOOXXXXXXXXXXXXXXGOOOOOOOOOOOOOOXXXXXGOOOOOOOOOOOOOOOOXXXGOOOOOOXXXXXXXXXXXXX,0,0,0
47418,137,1,136,32,431,0,0,143,95,48,GOOOOOOOOOOOOOXXXXXXGOOOOOOOOXXXXXXXXXXXGOOOOOOXXXXXXXXXXXXXGOOOOOOOOOOOOXXXXXXXGOOOOOOOXXXXXXXXXXXXGOOOOOOOOOOOOXXXXXXXGOOOOOOOOXXXXXXXXXXXGOOXXXXXXXXXXXXXXXXXGOOOOOOOOOOOOOOXXXXXGOOOOOXXXXXXXXXXXXXXGOOOOOOOOOOOOOOAXXXXGOOOOOOOOOOOOOOOOXXXGOOOOOOXXXXXXXXXXXXX,0,0,0
47439,137,1,136,29,434,0,0,147,97,50,GOOOOOOOOOOOOOXXXXXXGOOOOOOOOXXXXXXXXXXXGOOOOOOXXXXXXXXXXXXXGOOOOOOOOOOOOXXXXXXXGOOOOOOOXXXXXXXXXXXXGOOOOOOOOOOOOXXXXXXXGOOOOOOOOXXXXXXXXXXXGOOXXXXXXXXXXXXXXXXXGOOOOOOOOOOOOOOXXXXXGOOOOOXXXXXXXXXXXXXXGOOOOOOOOOOOOOOAXXXXGOOOOOOOOOOOOOOOOXXXGOOOOOOXXXXXXXXXXXXX,0,0,0

47460,137,1,136,32,431,0,0,144,95,49,GOOOOOOOOOOOOOXXXXXXGOOOOOOOOXXXXXXXXXXXGOOOOOOXXXXXXXXXXXXXGOOOOOOOOOOOOXXXXXXXGOOOOOOOXXXXXXXXXXXXGOOOOOOOOOOOOXXXXXXXGOOOOOOOOXXXXXXXXXXXGOOXXXXXXXXXXXXXXXXXGOOOOOOOOOOOOOOXXXXXGOOOOOXXXXXXXXXXXXXXGOOOOOOOOOOOOOOAXXXXGOOOOOOOOOOOOOOOOXXXGOOOOOOXXXXXXXXXXXXX,0,0,0
47481,137,1,136,34,429,0,0,142,97,45,GOOOOOOOOOOOOOXXXXXXGOOOOOOOOXXXXXXXXXXXGOOOOOOXXXXXXXXXXXXXGOOOOOOOOOOOOXXXXXXXGOOOOOOOXXXXXXXXXXXXGOOOOOOOOOOOOXXXXXXXGOOOOOOOOXXXXXXXXXXXGOOXXXXXXXXXXXXXXXXXGOOOOOOOOOOOOOOXXXXXGOOOOOXXXXXXXXXXXXXXGOOOOOOOOOOOOOOAXXXXGOOOOOOOOOOOOOOOOXXXGOOOOOOXXXXXXXXXXXXX,0,0,0
47502,137,0,137,34,429,0,0,141,98,43,GOOOOOOOOOOOOOXXXXXXGOOOOOOOOXXXXXXXXXXXGOOOOOOXXXXXXXXXXXXXGOOOOOOOOOOOOXXXXXXXGOOOOOOOXXXXXXXXXXXXGOOOOOOOOOOOOXXXXXXXGOOOOOOOOXXXXXXXXXXXGOOXXXXXXXXXXXXXXXXXGOOOOOOOOOOOOOOXXXXXGOOOOOXXXXXXXXXXXXXXGOOOOOOOOOOOOOOOXXXXGOOOOOOOOOOOOOOOOXXXGOOOOOOXXXXXXXXXXXXX,0,0,0
47523,137,0,137,29,434,0,0,147,100,47,GOOOOOOOOOOOOOXXXXXXGOOOOOOOOXXXXXXXXXXXGOOOOOOXXXXXXXXXXXXXGOOOOOOOOOOOOXXXXXXXGOOOOOOOXXXXXXXXXXXXGOOOOOOOOOOOOXXXXXXXGOOOOOOOOXXXXXXXXXXXGOOXXXXXXXXXXXXXXXXXGOOOOOOOOOOOOOOXXXXXGOOOOOXXXXXXXXXXXXXXGOOOOOOOOOOOOOOOXXXXGOOOOOOOOOOOOOOOOXXXGOOOOOOXXXXXXXXXXXXX,0,0,0
47544,137,0,137,31,432,0,0,145,95,50,GOOOOOOOOOOOOOXXXXXXGOOOOOOOOXXXXXXXXXXXGOOOOOOXXXXXXXXXXXXXGOOOOOOOOOOOOXXXXXXXGOOOOOOOXXXXXXXXXXXXGOOOOOOOOOOOOXXXXXXXGOOOOOOOOXXXXXXXXXXXGOOXXXXXXXXXXXXXXXXXGOOOOOOOOOOOOOOXXXXXGOOOOOXXXXXXXXXXXXXXGOOOOOOOOOOOOOOOXXXXGOOOOOOOOOOOOOOOOXXXGOOOOOOXXXXXXXXXXXXX,0,0,0

47565,137,0,137,29,434,0,0,146,97,49,GOOOOOOOOOOOOOXXXXXXGOOOOOOOOXXXXXXXXXXXGOOOOOOXXXXXXXXXXXXXGOOOOOOOOOOOOXXXXXXXGOOOOOOOXXXXXXXXXXXXGOOOOOOOOOOOOXXXXXXXGOOOOOOOOXXXXXXXXXXXGOOXXXXXXXXXXXXXXXXXGOOOOOOOOOOOOOOXXXXXGOOOOOXXXXXXXXXXXXXXGOOOOOOOOOOOOOOOXXXXGOOOOOOOOOOOOOOOOXXXGOOOOOOXXXXXXXXXXXXX,0,0,0
47586,137,0,137,30,433,0,0,145,95,50,GOOOOOOOOOOOOOXXXXXXGOOOOOOOOXXXXXXXXXXXGOOOOOOXXXXXXXXXXXXXGOOOOOOOOOOOOXXXXXXXGOOOOOOOXXXXXXXXXXXXGOOOOOOOOOOOOXXXXXXXGOOOOOOOOXXXXXXXXXXXGOOXXXXXXXXXXXXXXXXXGOOOOOOOOOOOOOOXXXXXGOOOOOXXXXXXXXXXXXXXGOOOOOOOOOOOOOOOXXXXGOOOOOOOOOOOOOOOOXXXGOOOOOOXXXXXXXXXXXXX,0,0,0
47607,137,0,137,29,434,0,0,147,96,51,GOOOOOOOOOOOOOXXXXXXGOOOOOOOOXXXXXXXXXXXGOOOOOOXXXXXXXXXXXXXGOOOOOOOOOOOOXXXXXXXGOOOOOOOXXXXXXXXXXXXGOOOOOOOOOOOOXXXXXXXGOOOOOOOOXXXXXXXXXXXGOOXXXXXXXXXXXXXXXXXGOOOOOOOOOOOOOOXXXXXGOOOOOXXXXXXXXXXXXXXGOOOOOOOOOOOOOOOXXXXGOOOOOOOOOOOOOOOOXXXGOOOOOOXXXXXXXXXXXXX,0,0,0
47628,137,0,137,28,435,0,0,148,98,50,GOOOOOOOOOOOOOXXXXXXGOOOOOOOOXXXXXXXXXXXGOOOOOOXXXXXXXXXXXXXGOOOOOOOOOOOOXXXXXXXGOOOOOOOXXXXXXXXXXXXGOOOOOOOOOOOOXXXXXXXGOOOOOOOOXXXXXXXXXXXGOOXXXXXXXXXXXXXXXXXGOOOOOOOOOOOOOOXXXXXGOOOOOXXXXXXXXXXXXXXGOOOOOOOOOOOOOOOXXXXGOOOOOOOOOOOOOOOOXXXGOOOOOOXXXXXXXXXXXXX,0,0,0
47649,137,0,137,29,434,0,0,147,96,51,GOOOOOOOOOOOOOXXXXXXGOOOOOOOOXXXXXXXXXXXGOOOOOOXXXXXXXXXXXXXGOOOOOOOOOOOOXXXXXXXGOOOOOOOXXXXXXXXXXXXGOOOOOOOOOOOOXXXXXXXGOOOOOOOOXXXXXXXXXXXGOOXXXXXXXXXXXXXXXXXGOOOOOOOOOOOOOOXXXXXGOOOOOXXXXXXXXXXXXXXGOOOOOOOOOOOOOOOXXXXGOOOOOOOOOOOOOOOOXXXGOOOOOOXXXXXXXXXXXXX,0,0,0

47670,137,0,137,24,439,0,0,152,96,56,GOOOOOOOOOOOOOXXXXXXGOOOOOOOOXXXXXXXXXXXGOOOOOOXXXXXXXXXXXXXGOOOOOOOOOOOOXXXXXXXGOOOOOOOXXXXXXXXXXXXGOOOOOOOOOOOOXXXXXXXGOOOOOOOOXXXXXXXXXXXGOOXXXXXXXXXXXXXXXXXGOOOOOOOOOOOOOOXXXXXGOOOOOXXXXXXXXXXXXXXGOOOOOOOOOOOOOOOXXXXGOOOOOOOOOOOOOOOOXXXGOOOOOOXXXXXXXXXXXXX,0,0,0
47691,137,0,137,21,442,0,0,155,97,58,GOOOOOOOOOOOOOXXXXXXGOOOOOOOOXXXXXXXXXXXGOOOOOOXXXXXXXXXXXXXGOOOOOOOOOOOOXXXXXXXGOOOOOOOXXXXXXXXXXXXGOOOOOOOOOOOOXXXXXXXGOOOOOOOOXXXXXXXXXXXGOOXXXXXXXXXXXXXXXXXGOOOOOOOOOOOOOOXXXXXGOOOOOXXXXXXXXXXXXXXGOOOOOOOOOOOOOOOXXXXGOOOOOOOOOOOOOOOOXXXGOOOOOOXXXXXXXXXXXXX,0,0,0
47712,137,0,137,20,443,0,0,156,98,58,GOOOOOOOOOOOOOXXXXXXGOOOOOOOOXXXXXXXXXXXGOOOOOOXXXXXXXXXXXXXGOOOOOOOOOOOOXXXXXXXGOOOOOOOXXXXXXXXXXXXGOOOOOOOOOOOOXXXXXXXGOOOOOOOOXXXXXXXXXXXGOOXXXXXXXXXXXXXXXXXGOOOOOOOOOOOOOOXXXXXGOOOOOXXXXXXXXXXXXXXGOOOOOOOOOOOOOOOXXXXGOOOOOOOOOOOOOOOOXXXGOOOOOOXXXXXXXXXXXXX,0,0,0
47733,137,0,137,18,445,0,0,155,101,54,GOOOOOOOOOOOOOXXXXXXGOOOOOOOOXXXXXXXXXXXGOOOOOOXXXXXXXXXXXXXGOOOOOOOOOOOOXXXXXXXGOOOOOOOXXXXXXXXXXXXGOOOOOOOOOOOOXXXXXXXGOOOOOOOOXXXXXXXXXXXGOOXXXXXXXXXXXXXXXXXGOOOOOOOOOOOOOOXXXXXGOOOOOXXXXXXXXXXXXXXGOOOOOOOOOOOOOOOXXXXGOOOOOOOOOOOOOOOOXXXGOOOOOOXXXXXXXXXXXXX,0,0,0
47754,137,0,137,19,444,0,0,157,99,58,GOOOOOOOOOOOOOXXXXXXGOOOOOOOOXXXXXXXXXXXGOOOOOOXXXXXXXXXXXXXGOOOOOOOOOOOOXXXXXXXGOOOOOOOXXXXXXXXXXXXGOOOOOOOOOOOOXXXXXXXGOOOOOOOOXXXXXXXXXXXGOOXXXXXXXXXXXXXXXXXGOOOOOOOOOOOOOOXXXXXGOOOOOXXXXXXXXXXXXXXGOOOOOOOOOOOOOOOXXXXGOOOOOOOOOOOOOOOOXXXGOOOOOOXXXXXXXXXXXXX,0,0,0

47775,137,0,137,21,442,0,0,155,97,58,GOOOOOOOOOOOOOXXXXXXGOOOOOOOOXXXXXXXXXXXGOOOOOOXXXXXXXXXXXXXGOOOOOOOOOOOOXXXXXXXGOOOOOOOXXXXXXXXXXXXGOOOOOOOOOOOOXXXXXXXGOOOOOOOOXXXXXXXXXXXGOOXXXXXXXXXXXXXXXXXGOOOOOOOOOOOOOOXXXXXGOOOOOXXXXXXXXXXXXXXGOOOOOOOOOOOOOOOXXXXGOOOOOOOOOOOOOOOOXXXGOOOOOOXXXXXXXXXXXXX,0,0,0
47796,137,0,137,17,446,0,0,159,97,62,GOOOOOOOOOOOOOXXXXXXGOOOOOOOOXXXXXXXXXXXGOOOOOOXXXXXXXXXXXXXGOOOOOOOOOOOOXXXXXXXGOOOOOOOXXXXXXXXXXXXGOOOOOOOOOOOOXXXXXXXGOOOOOOOOXXXXXXXXXXXGOOXXXXXXXXXXXXXXXXXGOOOOOOOOOOOOOOXXXXXGOOOOOXXXXXXXXXXXXXXGOOOOOOOOOOOOOOOXXXXGOOOOOOOOOOOOOOOOXXXGOOOOOOXXXXXXXXXXXXX,0,0,0
47817,137,0,137,16,447,0,0,160,97,63,GOOOOOOOOOOOOOXXXXXXGOOOOOOOOXXXXXXXXXXXGOOOOOOXXXXXXXXXXXXXGOOOOOOOOOOOOXXXXXXXGOOOOOOOXXXXXXXXXXXXGOOOOOOOOOOOOXXXXXXXGOOOOOOOOXXXXXXXXXXXGOOXXXXXXXXXXXXXXXXXGOOOOOOOOOOOOOOXXXXXGOOOOOXXXXXXXXXXXXXXGOOOOOOOOOOOOOOOXXXXGOOOOOOOOOOOOOOOOXXXGOOOOOOXXXXXXXXXXXXX,0,0,0
47838,137,0,137,19,444,0,0,157,98,59,GOOOOOOOOOOOOOXXXXXXGOOOOOOOOXXXXXXXXXXXGOOOOOOXXXXXXXXXXXXXGOOOOOOOOOOOOXXXXXXXGOOOOOOOXXXXXXXXXXXXGOOOOOOOOOOOOXXXXXXXGOOOOOOOOXXXXXXXXXXXGOOXXXXXXXXXXXXXXXXXGOOOOOOOOOOOOOOXXXXXGOOOOOXXXXXXXXXXXXXXGOOOOOOOOOOOOOOOXXXXGOOOOOOOOOOOOOOOOXXXGOOOOOOXXXXXXXXXXXXX,0,0,0
47859,137,0,137,22,441,0,0,154,97,57,GOOOOOOOOOOOOOXXXXXXGOOOOOOOOXXXXXXXXXXXGOOOOOOXXXXXXXXXXXXXGOOOOOOOOOOOOXXXXXXXGOOOOOOOXXXXXXXXXXXXGOOOOOOOOOOOOXXXXXXXGOOOOOOOOXXXXXXXXXXXGOOXXXXXXXXXXXXXXXXXGOOOOOOOOOOOOOOXXXXXGOOOOOXXXXXXXXXXXXXXGOOOOOOOOOOOOOOOXXXXGOOOOOOOOOOOOOOOOXXXGOOOOOOXXXXXXXXXXXXX,0,0,0

47880,137,0,137,22,441,0,0,155,101,54,GOOOOOOOOOOOOOXXXXXXGOOOOOOOOXXXXXXXXXXXGOOOOOOXXXXXXXXXXXXXGOOOOOOOOOOOOXXXXXXXGOOOOOOOXXXXXXXXXXXXGOOOOOOOOOOOOXXXXXXXGOOOOOOOOXXXXXXXXXXXGOOXXXXXXXXXXXXXXXXXGOOOOOOOOOOOOOOXXXXXGOOOOOXXXXXXXXXXXXXXGOOOOOOOOOOOOOOOXXXXGOOOOOOOOOOOOOOOOXXXGOOOOOOXXXXXXXXXXXXX,0,0,0
47901,137,0,137,24,439,0,0,152,99,53,GOOOOOOOOOOOOOXXXXXXGOOOOOOOOXXXXXXXXXXXGOOOOOOXXXXXXXXXXXXXGOOOOOOOOOOOOXXXXXXXGOOOOOOOXXXXXXXXXXXXGOOOOOOOOOOOOXXXXXXXGOOOOOOOOXXXXXXXXXXXGOOXXXXXXXXXXXXXXXXXGOOOOOOOOOOOOOOXXXXXGOOOOOXXXXXXXXXXXXXXGOOOOOOOOOOOOOOOXXXXGOOOOOOOOOOOOOOOOXXXGOOOOOOXXXXXXXXXXXXX,0,0,0
47922,137,0,137,25,438,0,0,152,103,49,GOOOOOOOOOOOOOXXXXXXGOOOOOOOOXXXXXXXXXXXGOOOOOOXXXXXXXXXXXXXGOOOOOOOOOOOOXXXXXXXGOOOOOOOXXXXXXXXXXXXGOOOOOOOOOOOOXXXXXXXGOOOOOOOOXXXXXXXXXXXGOOXXXXXXXXXXXXXXXXXGOOOOOOOOOOOOOOXXXXXGOOOOOXXXXXXXXXXXXXXGOOOOOOOOOOOOOOOXXXXGOOOOOOOOOOOOOOOOXXXGOOOOOOXXXXXXXXXXXXX,0,0,0
47943,137,0,137,32,431,0,0,145,98,47,GOOOOOOOOOOOOOXXXXXXGOOOOOOOOXXXXXXXXXXXGOOOOOOXXXXXXXXXXXXXGOOOOOOOOOOOOXXXXXXXGOOOOOOOXXXXXXXXXXXXGOOOOOOOOOOOOXXXXXXXGOOOOOOOOXXXXXXXXXXXGOOXXXXXXXXXXXXXXXXXGOOOOOOOOOOOOOOXXXXXGOOOOOXXXXXXXXXXXXXXGOOOOOOOOOOOOOOOXXXXGOOOOOOOOOOOOOOOOXXXGOOOOOOXXXXXXXXXXXXX,0,0,0
47964,137,0,137,28,435,0,0,149,98,51,GOOOOOOOOOOOOOXXXXXXGOOOOOOOOXXXXXXXXXXXGOOOOOOXXXXXXXXXXXXXGOOOOOOOOOOOOXXXXXXXGOOOOOOOXXXXXXXXXXXXGOOOOOOOOOOOOXXXXXXXGOOOOOOOOXXXXXXXXXXXGOOXXXXXXXXXXXXXXXXXGOOOOOOOOOOOOOOXXXXXGOOOOOXXXXXXXXXXXXXXGOOOOOOOOOOOOOOOXXXXGOOOOOOOOOOOOOOOOXXXGOOOOOOXXXXXXXXXXXXX,0,0,0

47985,137,0,137,26,437,0,0,151,98,53,GOOOOOOOOOOOOOXXXXXXGOOOOOOOOXXXXXXXXXXXGOOOOOOXXXXXXXXXXXXXGOOOOOOOOOOOOXXXXXXXGOOOOOOOXXXXXXXXXXXXGOOOOOOOOOOOOXXXXXXXGOOOOOOOOXXXXXXXXXXXGOOXXXXXXXXXXXXXXXXXGOOOOOOOOOOOOOOXXXXXGOOOOOXXXXXXXXXXXXXXGOOOOOOOOOOOOOOOXXXXGOOOOOOOOOOOOOOOOXXXGOOOOOOXXXXXXXXXXXXX,0,0,0
48006,137,0,137,26,437,0,0,151,100,51,GOOOOOOOOOOOOOXXXXXXGOOOOOOOOXXXXXXXXXXXGOOOOOOXXXXXXXXXXXXXGOOOOOOOOOOOOXXXXXXXGOOOOOOOXXXXXXXXXXXXGOOOOOOOOOOOOXXXXXXXGOOOOOOOOXXXXXXXXXXXGOOXXXXXXXXXXXXXXXXXGOOOOOOOOOOOOOOXXXXXGOOOOOXXXXXXXXXXXXXXGOOOOOOOOOOOOOOOXXXXGOOOOOOOOOOOOOOOOXXXGOOOOOOXXXXXXXXXXXXX,0,0,0
48027,137,0,137,25,438,0,0,152,102,50,GOOOOOOOOOOOOOXXXXXXGOOOOOOOOXXXXXXXXXXXGOOOOOOXXXXXXXXXXXXXGOOOOOOOOOOOOXXXXXXXGOOOOOOOXXXXXXXXXXXXGOOOOOOOOOOOOXXXXXXXGOOOOOOOOXXXXXXXXXXXGOOXXXXXXXXXXXXXXXXXGOOOOOOOOOOOOOOXXXXXGOOOOOXXXXXXXXXXXXXXGOOOOOOOOOOOOOOOXXXXGOOOOOOOOOOOOOOOOXXXGOOOOOOXXXXXXXXXXXXX,0,0,0
48048,137,0,137,28,435,0,0,148,98,50,GOOOOOOOOOOOOOXXXXXXGOOOOOOOOXXXXXXXXXXXGOOOOOOXXXXXXXXXXXXXGOOOOOOOOOOOOXXXXXXXGOOOOOOOXXXXXXXXXXXXGOOOOOOOOOOOOXXXXXXXGOOOOOOOOXXXXXXXXXXXGOOXXXXXXXXXXXXXXXXXGOOOOOOOOOOOOOOXXXXXGOOOOOXXXXXXXXXXXXXXGOOOOOOOOOOOOOOOXXXXGOOOOOOOOOOOOOOOOXXXGOOOOOOXXXXXXXXXXXXX,0,0,0
48069,137,0,137,30,433,0,0,146,99,47,GOOOOOOOOOOOOOXXXXXXGOOOOOOOOXXXXXXXXXXXGOOOOOOXXXXXXXXXXXXXGOOOOOOOOOOOOXXXXXXXGOOOOOOOXXXXXXXXXXXXGOOOOOOOOOOOOXXXXXXXGOOOOOOOOXXXXXXXXXXXGOOXXXXXXXXXXXXXXXXXGOOOOOOOOOOOOOOXXXXXGOOOOOXXXXXXXXXXXXXXGOOOOOOOOOOOOOOOXXXXGOOOOOOOOOOOOOOOOXXXGOOOOOOXXXXXXXXXXXXX,0,0,0

48090,137,0,137,33,430,0,0,143,96,47,GOOOOOOOOOOOOOXXXXXXGOOOOOOOOXXXXXXXXXXXGOOOOOOXXXXXXXXXXXXXGOOOOOOOOOOOOXXXXXXXGOOOOOOOXXXXXXXXXXXXGOOOOOOOOOOOOXXXXXXXGOOOOOOOOXXXXXXXXXXXGOOXXXXXXXXXXXXXXXXXGOOOOOOOOOOOOOOXXXXXGOOOOOXXXXXXXXXXXXXXGOOOOOOOOOOOOOOOXXXXGOOOOOOOOOOOOOOOOXXXGOOOOOOXXXXXXXXXXXXX,0,0,0
48111,137,0,137,31,432,0,0,146,97,49,GOOOOOOOOOOOOOXXXXXXGOOOOOOOOXXXXXXXXXXXGOOOOOOXXXXXXXXXXXXXGOOOOOOOOOOOOXXXXXXXGOOOOOOOXXXXXXXXXXXXGOOOOOOOOOOOOXXXXXXXGOOOOOOOOXXXXXXXXXXXGOOXXXXXXXXXXXXXXXXXGOOOOOOOOOOOOOOXXXXXGOOOOOXXXXXXXXXXXXXXGOOOOOOOOOOOOOOOXXXXGOOOOOOOOOOOOOOOOXXXGOOOOOOXXXXXXXXXXXXX,0,0,0
48132,138,1,137,30,432,0,0,146,97,49,GOOOOOOOOOOOOOXXXXXXGOOOOOOOOXXXXXXXXXXXGOOOOOOXXXXXXXXXXXXXGOOOOOOOOOOOOAXXXXXXGOOOOOOOXXXXXXXXXXXXGOOOOOOOOOOOOXXXXXXXGOOOOOOOOXXXXXXXXXXXGOOXXXXXXXXXXXXXXXXXGOOOOOOOOOOOOOOXXXXXGOOOOOXXXXXXXXXXXXXXGOOOOOOOOOOOOOOOXXXXGOOOOOOOOOOOOOOOOXXXGOOOOOOXXXXXXXXXXXXX,0,0,0
48153,138,1,137,27,435,0,0,149,100,49,GOOOOOOOOOOOOOXXXXXXGOOOOOOOOXXXXXXXXXXXGOOOOOOXXXXXXXXXXXXXGOOOOOOOOOOOOAXXXXXXGOOOOOOOXXXXXXXXXXXXGOOOOOOOOOOOOXXXXXXXGOOOOOOOOXXXXXXXXXXXGOOXXXXXXXXXXXXXXXXXGOOOOOOOOOOOOOOXXXXXGOOOOOXXXXXXXXXXXXXXGOOOOOOOOOOOOOOOXXXXGOOOOOOOOOOOOOOOOXXXGOOOOOOXXXXXXXXXXXXX,0,0,0
48174,138,0,138,28,434,0,0,148,98,50,GOOOOOOOOOOOOOXXXXXXGOOOOOOOOXXXXXXXXXXXGOOOOOOXXXXXXXXXXXXXGOOOOOOOOOOOOOXXXXXXGOOOOOOOXXXXXXXXXXXXGOOOOOOOOOOOOXXXXXXXGOOOOOOOOXXXXXXXXXXXGOOXXXXXXXXXXXXXXXXXGOOOOOOOOOOOOOOXXXXXGOOOOOXXXXXXXXXXXXXXGOOOOOOOOOOOOOOOXXXXGOOOOOOOOOOOOOOOOXXXGOOOOOOXXXXXXXXXXXXX,0,0,0

48195,138,0,138,28,434,0,0,148,99,49,GOOOOOOOOOOOOOXXXXXXGOOOOOOOOXXXXXXXXXXXGOOOOOOXXXXXXXXXXXXXGOOOOOOOOOOOOOXXXXXXGOOOOOOOXXXXXXXXXXXXGOOOOOOOOOOOOXXXXXXXGOOOOOOOOXXXXXXXXXXXGOOXXXXXXXXXXXXXXXXXGOOOOOOOOOOOOOOXXXXXGOOOOOXXXXXXXXXXXXXXGOOOOOOOOOOOOOOOXXXXGOOOOOOOOOOOOOOOOXXXGOOOOOOXXXXXXXXXXXXX,0,0,0
48216,138,0,138,31,431,0,0,145,98,47,GOOOOOOOOOOOOOXXXXXXGOOOOOOOOXXXXXXXXXXXGOOOOOOXXXXXXXXXXXXXGOOOOOOOOOOOOOXXXXXXGOOOOOOOXXXXXXXXXXXXGOOOOOOOOOOOOXXXXXXXGOOOOOOOOXXXXXXXXXXXGOOXXXXXXXXXXXXXXXXXGOOOOOOOOOOOOOOXXXXXGOOOOOXXXXXXXXXXXXXXGOOOOOOOOOOOOOOOXXXXGOOOOOOOOOOOOOOOOXXXGOOOOOOXXXXXXXXXXXXX,0,0,0
48237,138,0,138,31,431,0,0,145,98,47,GOOOOOOOOOOOOOXXXXXXGOOOOOOOOXXXXXXXXXXXGOOOOOOXXXXXXXXXXXXXGOOOOOOOOOOOOOXXXXXXGOOOOOOOXXXXXXXXXXXXGOOOOOOOOOOOOXXXXXXXGOOOOOOOOXXXXXXXXXXXGOOXXXXXXXXXXXXXXXXXGOOOOOOOOOOOOOOXXXXXGOOOOOXXXXXXXXXXXXXXGOOOOOOOOOOOOOOOXXXXGOOOOOOOOOOOOOOOOXXXGOOOOOOXXXXXXXXXXXXX,0,0,0
48258,138,0,138,28,434,0,0,147,97,50,GOOOOOOOOOOOOOXXXXXXGOOOOOOOOXXXXXXXXXXXGOOOOOOXXXXXXXXXXXXXGOOOOOOOOOOOOOXXXXXXGOOOOOOOXXXXXXXXXXXXGOOOOOOOOOOOOXXXXXXXGOOOOOOOOXXXXXXXXXXXGOOXXXXXXXXXXXXXXXXXGOOOOOOOOOOOOOOXXXXXGOOOOOXXXXXXXXXXXXXXGOOOOOOOOOOOOOOOXXXXGOOOOOOOOOOOOOOOOXXXGOOOOOOXXXXXXXXXXXXX,0,0,0
48279,138,0,138,27,435,0,0,148,99,49,GOOOOOOOOOOOOOXXXXXXGOOOOOOOOXXXXXXXXXXXGOOOOOOXXXXXXXXXXXXXGOOOOOOOOOOOOOXXXXXXGOOOOOOOXXXXXXXXXXXXGOOOOOOOOOOOOXXXXXXXGOOOOOOOOXXXXXXXXXXXGOOXXXXXXXXXXXXXXXXXGOOOOOOOOOOOOOOXXXXXGOOOOOXXXXXXXXXXXXXXGOOOOOOOOOOOOOOOXXXXGOOOOOOOOOOOOOOOOXXXGOOOOOOXXXXXXXXXXXXX,0,0,0

48300,138,0,138,28,434,0,0,147,100,47,GOOOOOOOOOOOOOXXXXXXGOOOOOOOOXXXXXXXXXXXGOOOOOOXXXXXXXXXXXXXGOOOOOOOOOOOOOXXXXXXGOOOOOOOXXXXXXXXXXXXGOOOOOOOOOOOOXXXXXXXGOOOOOOOOXXXXXXXXXXXGOOXXXXXXXXXXXXXXXXXGOOOOOOOOOOOOOOXXXXXGOOOOOXXXXXXXXXXXXXXGOOOOOOOOOOOOOOOXXXXGOOOOOOOOOOOOOOOOXXXGOOOOOOXXXXXXXXXXXXX,0,0,0
48321,138,0,138,29,433,0,0,146,98,48,GOOOOOOOOOOOOOXXXXXXGOOOOOOOOXXXXXXXXXXXGOOOOOOXXXXXXXXXXXXXGOOOOOOOOOOOOOXXXXXXGOOOOOOOXXXXXXXXXXXXGOOOOOOOOOOOOXXXXXXXGOOOOOOOOXXXXXXXXXXXGOOXXXXXXXXXXXXXXXXXGOOOOOOOOOOOOOOXXXXXGOOOOOXXXXXXXXXXXXXXGOOOOOOOOOOOOOOOXXXXGOOOOOOOOOOOOOOOOXXXGOOOOOOXXXXXXXXXXXXX,0,0,0
48342,138,0,138,30,432,0,0,145,99,46,GOOOOOOOOOOOOOXXXXXXGOOOOOOOOXXXXXXXXXXXGOOOOOOXXXXXXXXXXXXXGOOOOOOOOOOOOOXXXXXXGOOOOOOOXXXXXXXXXXXXGOOOOOOOOOOOOXXXXXXXGOOOOOOOOXXXXXXXXXXXGOOXXXXXXXXXXXXXXXXXGOOOOOOOOOOOOOOXXXXXGOOOOOXXXXXXXXXXXXXXGOOOOOOOOOOOOOOOXXXXGOOOOOOOOOOOOOOOOXXXGOOOOOOXXXXXXXXXXXXX,0,0,0
48363,138,0,138,28,434,0,0,147,99,48,GOOOOOOOOOOOOOXXXXXXGOOOOOOOOXXXXXXXXXXXGOOOOOOXXXXXXXXXXXXXGOOOOOOOOOOOOOXXXXXXGOOOOOOOXXXXXXXXXXXXGOOOOOOOOOOOOXXXXXXXGOOOOOOOOXXXXXXXXXXXGOOXXXXXXXXXXXXXXXXXGOOOOOOOOOOOOOOXXXXXGOOOOOXXXXXXXXXXXXXXGOOOOOOOOOOOOOOOXXXXGOOOOOOOOOOOOOOOOXXXGOOOOOOXXXXXXXXXXXXX,0,0,0
48384,138,0,138,28,434,0,0,147,99,48,GOOOOOOOOOOOOOXXXXXXGOOOOOOOOXXXXXXXXXXXGOOOOOOXXXXXXXXXXXXXGOOOOOOOOOOOOOXXXXXXGOOOOOOOXXXXXXXXXXXXGOOOOOOOOOOOOXXXXXXXGOOOOOOOOXXXXXXXXXXXGOOXXXXXXXXXXXXXXXXXGOOOOOOOOOOOOOOXXXXXGOOOOOXXXXXXXXXXXXXXGOOOOOOOOOOOOOOOXXXXGOOOOOOOOOOOOOOOOXXXGOOOOOOXXXXXXXXXXXXX,0,0,0

48405,138,0,138,25,437,0,0,150,104,46,GOOOOOOOOOOOOOXXXXXXGOOOOOOOOXXXXXXXXXXXGOOOOOOXXXXXXXXXXXXXGOOOOOOOOOOOOOXXXXXXGOOOOOOOXXXXXXXXXXXXGOOOOOOOOOOOOXXXXXXXGOOOOOOOOXXXXXXXXXXXGOOXXXXXXXXXXXXXXXXXGOOOOOOOOOOOOOOXXXXXGOOOOOXXXXXXXXXXXXXXGOOOOOOOOOOOOOOOXXXXGOOOOOOOOOOOOOOOOXXXGOOOOOOXXXXXXXXXXXXX,0,0,0
48426,138,0,138,31,431,0,0,143,101,42,GOOOOOOOOOOOOOXXXXXXGOOOOOOOOXXXXXXXXXXXGOOOOOOXXXXXXXXXXXXXGOOOOOOOOOOOOOXXXXXXGOOOOOOOXXXXXXXXXXXXGOOOOOOOOOOOOXXXXXXXGOOOOOOOOXXXXXXXXXXXGOOXXXXXXXXXXXXXXXXXGOOOOOOOOOOOOOOXXXXXGOOOOOXXXXXXXXXXXXXXGOOOOOOOOOOOOOOOXXXXGOOOOOOOOOOOOOOOOXXXGOOOOOOXXXXXXXXXXXXX,0,0,0
48447,138,0,138,36,426,0,0,139,96,43,GOOOOOOOOOOOOOXXXXXXGOOOOOOOOXXXXXXXXXXXGOOOOOOXXXXXXXXXXXXXGOOOOOOOOOOOOOXXXXXXGOOOOOOOXXXXXXXXXXXXGOOOOOOOOOOOOXXXXXXXGOOOOOOOOXXXXXXXXXXXGOOXXXXXXXXXXXXXXXXXGOOOOOOOOOOOOOOXXXXXGOOOOOXXXXXXXXXXXXXXGOOOOOOOOOOOOOOOXXXXGOOOOOOOOOOOOOOOOXXXGOOOOOOXXXXXXXXXXXXX,0,0,0
48468,138,0,138,33,429,0,0,142,96,46,GOOOOOOOOOOOOOXXXXXXGOOOOOOOOXXXXXXXXXXXGOOOOOOXXXXXXXXXXXXXGOOOOOOOOOOOOOXXXXXXGOOOOOOOXXXXXXXXXXXXGOOOOOOOOOOOOXXXXXXXGOOOOOOOOXXXXXXXXXXXGOOXXXXXXXXXXXXXXXXXGOOOOOOOOOOOOOOXXXXXGOOOOOXXXXXXXXXXXXXXGOOOOOOOOOOOOOOOXXXXGOOOOOOOOOOOOOOOOXXXGOOOOOOXXXXXXXXXXXXX,0,0,0
48489,138,0,138,32,430,0,0,144,98,46,GOOOOOOOOOOOOOXXXXXXGOOOOOOOOXXXXXXXXXXXGOOOOOOXXXXXXXXXXXXXGOOOOOOOOOOOOOXXXXXXGOOOOOOOXXXXXXXXXXXXGOOOOOOOOOOOOXXXXXXXGOOOOOOOOXXXXXXXXXXXGOOXXXXXXXXXXXXXXXXXGOOOOOOOOOOOOOOXXXXXGOOOOOXXXXXXXXXXXXXXGOOOOOOOOOOOOOOOXXXXGOOOOOOOOOOOOOOOOXXXGOOOOOOXXXXXXXXXXXXX,0,0,0

48510,138,0,138,31,431,0,0,145,97,48,GOOOOOOOOOOOOOXXXXXXGOOOOOOOOXXXXXXXXXXXGOOOOOOXXXXXXXXXXXXXGOOOOOOOOOOOOOXXXXXXGOOOOOOOXXXXXXXXXXXXGOOOOOOOOOOOOXXXXXXXGOOOOOOOOXXXXXXXXXXXGOOXXXXXXXXXXXXXXXXXGOOOOOOOOOOOOOOXXXXXGOOOOOXXXXXXXXXXXXXXGOOOOOOOOOOOOOOOXXXXGOOOOOOOOOOOOOOOOXXXGOOOOOOXXXXXXXXXXXXX,0,0,0
48531,138,0,138,29,433,0,0,147,98,49,GOOOOOOOOOOOOOXXXXXXGOOOOOOOOXXXXXXXXXXXGOOOOOOXXXXXXXXXXXXXGOOOOOOOOOOOOOXXXXXXGOOOOOOOXXXXXXXXXXXXGOOOOOOOOOOOOXXXXXXXGOOOOOOOOXXXXXXXXXXXGOOXXXXXXXXXXXXXXXXXGOOOOOOOOOOOOOOXXXXXGOOOOOXXXXXXXXXXXXXXGOOOOOOOOOOOOOOOXXXXGOOOOOOOOOOOOOOOOXXXGOOOOOOXXXXXXXXXXXXX,0,0,0
48552,138,0,138,29,433,0,0,147,96,51,GOOOOOOOOOOOOOXXXXXXGOOOOOOOOXXXXXXXXXXXGOOOOOOXXXXXXXXXXXXXGOOOOOOOOOOOOOXXXXXXGOOOOOOOXXXXXXXXXXXXGOOOOOOOOOOOOXXXXXXXGOOOOOOOOXXXXXXXXXXXGOOXXXXXXXXXXXXXXXXXGOOOOOOOOOOOOOOXXXXXGOOOOOXXXXXXXXXXXXXXGOOOOOOOOOOOOOOOXXXXGOOOOOOOOOOOOOOOOXXXGOOOOOOXXXXXXXXXXXXX,0,0,0
48573,138,0,138,29,433,0,0,147,98,49,GOOOOOOOOOOOOOXXXXXXGOOOOOOOOXXXXXXXXXXXGOOOOOOXXXXXXXXXXXXXGOOOOOOOOOOOOOXXXXXXGOOOOOOOXXXXXXXXXXXXGOOOOOOOOOOOOXXXXXXXGOOOOOOOOXXXXXXXXXXXGOOXXXXXXXXXXXXXXXXXGOOOOOOOOOOOOOOXXXXXGOOOOOXXXXXXXXXXXXXXGOOOOOOOOOOOOOOOXXXXGOOOOOOOOOOOOOOOOXXXGOOOOOOXXXXXXXXXXXXX,0,0,0
48594,138,0,138,30,432,0,0,146,96,50,GOOOOOOOOOOOOOXXXXXXGOOOOOOOOXXXXXXXXXXXGOOOOOOXXXXXXXXXXXXXGOOOOOOOOOOOOOXXXXXXGOOOOOOOXXXXXXXXXXXXGOOOOOOOOOOOOXXXXXXXGOOOOOOOOXXXXXXXXXXXGOOXXXXXXXXXXXXXXXXXGOOOOOOOOOOOOOOXXXXXGOOOOOXXXXXXXXXXXXXXGOOOOOOOOOOOOOOOXXXXGOOOOOOOOOOOOOOOOXXXGOOOOOOXXXXXXXXXXXXX,0,0,0

48615,138,0,138,28,434,0,0,147,96,51,GOOOOOOOOOOOOOXXXXXXGOOOOOOOOXXXXXXXXXXXGOOOOOOXXXXXXXXXXXXXGOOOOOOOOOOOOOXXXXXXGOOOOOOOXXXXXXXXXXXXGOOOOOOOOOOOOXXXXXXXGOOOOOOOOXXXXXXXXXXXGOOXXXXXXXXXXXXXXXXXGOOOOOOOOOOOOOOXXXXXGOOOOOXXXXXXXXXXXXXXGOOOOOOOOOOOOOOOXXXXGOOOOOOOOOOOOOOOOXXXGOOOOOOXXXXXXXXXXXXX,0,0,0
48636,138,0,138,26,436,0,0,149,98,51,GOOOOOOOOOOOOOXXXXXXGOOOOOOOOXXXXXXXXXXXGOOOOOOXXXXXXXXXXXXXGOOOOOOOOOOOOOXXXXXXGOOOOOOOXXXXXXXXXXXXGOOOOOOOOOOOOXXXXXXXGOOOOOOOOXXXXXXXXXXXGOOXXXXXXXXXXXXXXXXXGOOOOOOOOOOOOOOXXXXXGOOOOOXXXXXXXXXXXXXXGOOOOOOOOOOOOOOOXXXXGOOOOOOOOOOOOOOOOXXXGOOOOOOXXXXXXXXXXXXX,0,0,0
48657,138,0,138,27,435,0,0,148,101,47,GOOOOOOOOOOOOOXXXXXXGOOOOOOOOXXXXXXXXXXXGOOOOOOXXXXXXXXXXXXXGOOOOOOOOOOOOOXXXXXXGOOOOOOOXXXXXXXXXXXXGOOOOOOOOOOOOXXXXXXXGOOOOOOOOXXXXXXXXXXXGOOXXXXXXXXXXXXXXXXXGOOOOOOOOOOOOOOXXXXXGOOOOOXXXXXXXXXXXXXXGOOOOOOOOOOOOOOOXXXXGOOOOOOOOOOOOOOOOXXXGOOOOOOXXXXXXXXXXXXX,0,0,0
48678,138,0,138,30,432,0,0,145,98,47,GOOOOOOOOOOOOOXXXXXXGOOOOOOOOXXXXXXXXXXXGOOOOOOXXXXXXXXXXXXXGOOOOOOOOOOOOOXXXXXXGOOOOOOOXXXXXXXXXXXXGOOOOOOOOOOOOXXXXXXXGOOOOOOOOXXXXXXXXXXXGOOXXXXXXXXXXXXXXXXXGOOOOOOOOOOOOOOXXXXXGOOOOOXXXXXXXXXXXXXXGOOOOOOOOOOOOOOOXXXXGOOOOOOOOOOOOOOOOXXXGOOOOOOXXXXXXXXXXXXX,0,0,0
48699,138,0,138,30,432,0,0,145,97,48,GOOOOOOOOOOOOOXXXXXXGOOOOOOOOXXXXXXXXXXXGOOOOOOXXXXXXXXXXXXXGOOOOOOOOOOOOOXXXXXXGOOOOOOOXXXXXXXXXXXXGOOOOOOOOOOOOXXXXXXXGOOOOOOOOXXXXXXXXXXXGOOXXXXXXXXXXXXXXXXXGOOOOOOOOOOOOOOXXXXXGOOOOOXXXXXXXXXXXXXXGOOOOOOOOOOOOOOOXXXXGOOOOOOOOOOOOOOOOXXXGOOOOOOXXXXXXXXXXXXX,0,0,0

48720,138,0,138,30,432,0,0,145,97,48,GOOOOOOOOOOOOOXXXXXXGOOOOOOOOXXXXXXXXXXXGOOOOOOXXXXXXXXXXXXXGOOOOOOOOOOOOOXXXXXXGOOOOOOOXXXXXXXXXXXXGOOOOOOOOOOOOXXXXXXXGOOOOOOOOXXXXXXXXXXXGOOXXXXXXXXXXXXXXXXXGOOOOOOOOOOOOOOXXXXXGOOOOOXXXXXXXXXXXXXXGOOOOOOOOOOOOOOOXXXXGOOOOOOOOOOOOOOOOXXXGOOOOOOXXXXXXXXXXXXX,0,0,0
48741,138,0,138,32,430,0,0,143,98,45,GOOOOOOOOOOOOOXXXXXXGOOOOOOOOXXXXXXXXXXXGOOOOOOXXXXXXXXXXXXXGOOOOOOOOOOOOOXXXXXXGOOOOOOOXXXXXXXXXXXXGOOOOOOOOOOOOXXXXXXXGOOOOOOOOXXXXXXXXXXXGOOXXXXXXXXXXXXXXXXXGOOOOOOOOOOOOOOXXXXXGOOOOOXXXXXXXXXXXXXXGOOOOOOOOOOOOOOOXXXXGOOOOOOOOOOOOOOOOXXXGOOOOOOXXXXXXXXXXXXX,0,0,0
48762,138,0,138,31,431,0,0,144,100,44,GOOOOOOOOOOOOOXXXXXXGOOOOOOOOXXXXXXXXXXXGOOOOOOXXXXXXXXXXXXXGOOOOOOOOOOOOOXXXXXXGOOOOOOOXXXXXXXXXXXXGOOOOOOOOOOOOXXXXXXXGOOOOOOOOXXXXXXXXXXXGOOXXXXXXXXXXXXXXXXXGOOOOOOOOOOOOOOXXXXXGOOOOOXXXXXXXXXXXXXXGOOOOOOOOOOOOOOOXXXXGOOOOOOOOOOOOOOOOXXXGOOOOOOXXXXXXXXXXXXX,0,0,0
48783,138,0,138,33,429,0,0,142,99,43,GOOOOOOOOOOOOOXXXXXXGOOOOOOOOXXXXXXXXXXXGOOOOOOXXXXXXXXXXXXXGOOOOOOOOOOOOOXXXXXXGOOOOOOOXXXXXXXXXXXXGOOOOOOOOOOOOXXXXXXXGOOOOOOOOXXXXXXXXXXXGOOXXXXXXXXXXXXXXXXXGOOOOOOOOOOOOOOXXXXXGOOOOOXXXXXXXXXXXXXXGOOOOOOOOOOOOOOOXXXXGOOOOOOOOOOOOOOOOXXXGOOOOOOXXXXXXXXXXXXX,0,0,0
48804,138,0,138,32,430,0,0,143,97,46,GOOOOOOOOOOOOOXXXXXXGOOOOOOOOXXXXXXXXXXXGOOOOOOXXXXXXXXXXXXXGOOOOOOOOOOOOOXXXXXXGOOOOOOOXXXXXXXXXXXXGOOOOOOOOOOOOXXXXXXXGOOOOOOOOXXXXXXXXXXXGOOXXXXXXXXXXXXXXXXXGOOOOOOOOOOOOOOXXXXXGOOOOOXXXXXXXXXXXXXXGOOOOOOOOOOOOOOOXXXXGOOOOOOOOOOOOOOOOXXXGOOOOOOXXXXXXXXXXXXX,0,0,0

48825,138,0,138,27,435,0,0,148,96,52,GOOOOOOOOOOOOOXXXXXXGOOOOOOOOXXXXXXXXXXXGOOOOOOXXXXXXXXXXXXXGOOOOOOOOOOOOOXXXXXXGOOOOOOOXXXXXXXXXXXXGOOOOOOOOOOOOXXXXXXXGOOOOOOOOXXXXXXXXXXXGOOXXXXXXXXXXXXXXXXXGOOOOOOOOOOOOOOXXXXXGOOOOOXXXXXXXXXXXXXXGOOOOOOOOOOOOOOOXXXXGOOOOOOOOOOOOOOOOXXXGOOOOOOXXXXXXXXXXXXX,0,0,0
48846,138,0,138,23,439,0,0,152,100,52,GOOOOOOOOOOOOOXXXXXXGOOOOOOOOXXXXXXXXXXXGOOOOOOXXXXXXXXXXXXXGOOOOOOOOOOOOOXXXXXXGOOOOOOOXXXXXXXXXXXXGOOOOOOOOOOOOXXXXXXXGOOOOOOOOXXXXXXXXXXXGOOXXXXXXXXXXXXXXXXXGOOOOOOOOOOOOOOXXXXXGOOOOOXXXXXXXXXXXXXXGOOOOOOOOOOOOOOOXXXXGOOOOOOOOOOOOOOOOXXXGOOOOOOXXXXXXXXXXXXX,0,0,0
48867,138,0,138,23,439,0,0,152,99,53,GOOOOOOOOOOOOOXXXXXXGOOOOOOOOXXXXXXXXXXXGOOOOOOXXXXXXXXXXXXXGOOOOOOOOOOOOOXXXXXXGOOOOOOOXXXXXXXXXXXXGOOOOOOOOOOOOXXXXXXXGOOOOOOOOXXXXXXXXXXXGOOXXXXXXXXXXXXXXXXXGOOOOOOOOOOOOOOXXXXXGOOOOOXXXXXXXXXXXXXXGOOOOOOOOOOOOOOOXXXXGOOOOOOOOOOOOOOOOXXXGOOOOOOXXXXXXXXXXXXX,0,0,0
48888,138,0,138,23,439,0,0,152,97,55,GOOOOOOOOOOOOOXXXXXXGOOOOOOOOXXXXXXXXXXXGOOOOOOXXXXXXXXXXXXXGOOOOOOOOOOOOOXXXXXXGOOOOOOOXXXXXXXXXXXXGOOOOOOOOOOOOXXXXXXXGOOOOOOOOXXXXXXXXXXXGOOXXXXXXXXXXXXXXXXXGOOOOOOOOOOOOOOXXXXXGOOOOOXXXXXXXXXXXXXXGOOOOOOOOOOOOOOOXXXXGOOOOOOOOOOOOOOOOXXXGOOOOOOXXXXXXXXXXXXX,0,0,0
48909,138,0,138,24,438,0,0,151,98,53,GOOOOOOOOOOOOOXXXXXXGOOOOOOOOXXXXXXXXXXXGOOOOOOXXXXXXXXXXXXXGOOOOOOOOOOOOOXXXXXXGOOOOOOOXXXXXXXXXXXXGOOOOOOOOOOOOXXXXXXXGOOOOOOOOXXXXXXXXXXXGOOXXXXXXXXXXXXXXXXXGOOOOOOOOOOOOOOXXXXXGOOOOOXXXXXXXXXXXXXXGOOOOOOOOOOOOOOOXXXXGOOOOOOOOOOOOOOOOXXXGOOOOOOXXXXXXXXXXXXX,0,0,0

48930,138,0,138,26,436,0,0,149,98,51,GOOOOOOOOOOOOOXXXXXXGOOOOOOOOXXXXXXXXXXXGOOOOOOXXXXXXXXXXXXXGOOOOOOOOOOOOOXXXXXXGOOOOOOOXXXXXXXXXXXXGOOOOOOOOOOOOXXXXXXXGOOOOOOOOXXXXXXXXXXXGOOXXXXXXXXXXXXXXXXXGOOOOOOOOOOOOOOXXXXXGOOOOOXXXXXXXXXXXXXXGOOOOOOOOOOOOOOOXXXXGOOOOOOOOOOOOOOOOXXXGOOOOOOXXXXXXXXXXXXX,0,0,0
48951,138,0,138,23,439,0,0,152,102,50,GOOOOOOOOOOOOOXXXXXXGOOOOOOOOXXXXXXXXXXXGOOOOOOXXXXXXXXXXXXXGOOOOOOOOOOOOOXXXXXXGOOOOOOOXXXXXXXXXXXXGOOOOOOOOOOOOXXXXXXXGOOOOOOOOXXXXXXXXXXXGOOXXXXXXXXXXXXXXXXXGOOOOOOOOOOOOOOXXXXXGOOOOOXXXXXXXXXXXXXXGOOOOOOOOOOOOOOOXXXXGOOOOOOOOOOOOOOOOXXXGOOOOOOXXXXXXXXXXXXX,0,0,0
48972,138,0,138,26,436,0,0,149,97,52,GOOOOOOOOOOOOOXXXXXXGOOOOOOOOXXXXXXXXXXXGOOOOOOXXXXXXXXXXXXXGOOOOOOOOOOOOOXXXXXXGOOOOOOOXXXXXXXXXXXXGOOOOOOOOOOOOXXXXXXXGOOOOOOOOXXXXXXXXXXXGOOXXXXXXXXXXXXXXXXXGOOOOOOOOOOOOOOXXXXXGOOOOOXXXXXXXXXXXXXXGOOOOOOOOOOOOOOOXXXXGOOOOOOOOOOOOOOOOXXXGOOOOOOXXXXXXXXXXXXX,0,0,0
48993,138,0,138,25,437,0,0,150,98,52,GOOOOOOOOOOOOOXXXXXXGOOOOOOOOXXXXXXXXXXXGOOOOOOXXXXXXXXXXXXXGOOOOOOOOOOOOOXXXXXXGOOOOOOOXXXXXXXXXXXXGOOOOOOOOOOOOXXXXXXXGOOOOOOOOXXXXXXXXXXXGOOXXXXXXXXXXXXXXXXXGOOOOOOOOOOOOOOXXXXXGOOOOOXXXXXXXXXXXXXXGOOOOOOOOOOOOOOOXXXXGOOOOOOOOOOOOOOOOXXXGOOOOOOXXXXXXXXXXXXX,0,0,0
49014,138,0,138,25,437,0,0,151,98,53,GOOOOOOOOOOOOOXXXXXXGOOOOOOOOXXXXXXXXXXXGOOOOOOXXXXXXXXXXXXXGOOOOOOOOOOOOOXXXXXXGOOOOOOOXXXXXXXXXXXXGOOOOOOOOOOOOXXXXXXXGOOOOOOOOXXXXXXXXXXXGOOXXXXXXXXXXXXXXXXXGOOOOOOOOOOOOOOXXXXXGOOOOOXXXXXXXXXXXXXXGOOOOOOOOOOOOOOOXXXXGOOOOOOOOOOOOOOOOXXXGOOOOOOXXXXXXXXXXXXX,0,0,0

49035,138,0,138,27,435,0,0,149,97,52,GOOOOOOOOOOOOOXXXXXXGOOOOOOOOXXXXXXXXXXXGOOOOOOXXXXXXXXXXXXXGOOOOOOOOOOOOOXXXXXXGOOOOOOOXXXXXXXXXXXXGOOOOOOOOOOOOXXXXXXXGOOOOOOOOXXXXXXXXXXXGOOXXXXXXXXXXXXXXXXXGOOOOOOOOOOOOOOXXXXXGOOOOOXXXXXXXXXXXXXXGOOOOOOOOOOOOOOOXXXXGOOOOOOOOOOOOOOOOXXXGOOOOOOXXXXXXXXXXXXX,0,0,0
49056,138,0,138,25,437,0,0,151,98,53,GOOOOOOOOOOOOOXXXXXXGOOOOOOOOXXXXXXXXXXXGOOOOOOXXXXXXXXXXXXXGOOOOOOOOOOOOOXXXXXXGOOOOOOOXXXXXXXXXXXXGOOOOOOOOOOOOXXXXXXXGOOOOOOOOXXXXXXXXXXXGOOXXXXXXXXXXXXXXXXXGOOOOOOOOOOOOOOXXXXXGOOOOOXXXXXXXXXXXXXXGOOOOOOOOOOOOOOOXXXXGOOOOOOOOOOOOOOOOXXXGOOOOOOXXXXXXXXXXXXX,0,0,0
49077,138,0,138,23,439,0,0,153,97,56,GOOOOOOOOOOOOOXXXXXXGOOOOOOOOXXXXXXXXXXXGOOOOOOXXXXXXXXXXXXXGOOOOOOOOOOOOOXXXXXXGOOOOOOOXXXXXXXXXXXXGOOOOOOOOOOOOXXXXXXXGOOOOOOOOXXXXXXXXXXXGOOXXXXXXXXXXXXXXXXXGOOOOOOOOOOOOOOXXXXXGOOOOOXXXXXXXXXXXXXXGOOOOOOOOOOOOOOOXXXXGOOOOOOOOOOOOOOOOXXXGOOOOOOXXXXXXXXXXXXX,0,0,0
49098,138,0,138,24,438,0,0,152,100,52,GOOOOOOOOOOOOOXXXXXXGOOOOOOOOXXXXXXXXXXXGOOOOOOXXXXXXXXXXXXXGOOOOOOOOOOOOOXXXXXXGOOOOOOOXXXXXXXXXXXXGOOOOOOOOOOOOXXXXXXXGOOOOOOOOXXXXXXXXXXXGOOXXXXXXXXXXXXXXXXXGOOOOOOOOOOOOOOXXXXXGOOOOOXXXXXXXXXXXXXXGOOOOOOOOOOOOOOOXXXXGOOOOOOOOOOOOOOOOXXXGOOOOOOXXXXXXXXXXXXX,0,0,0
49119,138,0,138,27,435,0,0,148,98,50,GOOOOOOOOOOOOOXXXXXXGOOOOOOOOXXXXXXXXXXXGOOOOOOXXXXXXXXXXXXXGOOOOOOOOOOOOOXXXXXXGOOOOOOOXXXXXXXXXXXXGOOOOOOOOOOOOXXXXXXXGOOOOOOOOXXXXXXXXXXXGOOXXXXXXXXXXXXXXXXXGOOOOOOOOOOOOOOXXXXXGOOOOOXXXXXXXXXXXXXXGOOOOOOOOOOOOOOOXXXXGOOOOOOOOOOOOOOOOXXXGOOOOOOXXXXXXXXXXXXX,0,0,0

49140,138,0,138,27,435,0,0,148,96,52,GOOOOOOOOOOOOOXXXXXXGOOOOOOOOXXXXXXXXXXXGOOOOOOXXXXXXXXXXXXXGOOOOOOOOOOOOOXXXXXXGOOOOOOOXXXXXXXXXXXXGOOOOOOOOOOOOXXXXXXXGOOOOOOOOXXXXXXXXXXXGOOXXXXXXXXXXXXXXXXXGOOOOOOOOOOOOOOXXXXXGOOOOOXXXXXXXXXXXXXXGOOOOOOOOOOOOOOOXXXXGOOOOOOOOOOOOOOOOXXXGOOOOOOXXXXXXXXXXXXX,0,0,0
49161,138,0,138,30,432,0,0,145,100,45,GOOOOOOOOOOOOOXXXXXXGOOOOOOOOXXXXXXXXXXXGOOOOOOXXXXXXXXXXXXXGOOOOOOOOOOOOOXXXXXXGOOOOOOOXXXXXXXXXXXXGOOOOOOOOOOOOXXXXXXXGOOOOOOOOXXXXXXXXXXXGOOXXXXXXXXXXXXXXXXXGOOOOOOOOOOOOOOXXXXXGOOOOOXXXXXXXXXXXXXXGOOOOOOOOOOOOOOOXXXXGOOOOOOOOOOOOOOOOXXXGOOOOOOXXXXXXXXXXXXX,0,0,0
49182,138,0,138,31,431,0,0,144,97,47,GOOOOOOOOOOOOOXXXXXXGOOOOOOOOXXXXXXXXXXXGOOOOOOXXXXXXXXXXXXXGOOOOOOOOOOOOOXXXXXXGOOOOOOOXXXXXXXXXXXXGOOOOOOOOOOOOXXXXXXXGOOOOOOOOXXXXXXXXXXXGOOXXXXXXXXXXXXXXXXXGOOOOOOOOOOOOOOXXXXXGOOOOOXXXXXXXXXXXXXXGOOOOOOOOOOOOOOOXXXXGOOOOOOOOOOOOOOOOXXXGOOOOOOXXXXXXXXXXXXX,0,0,0
49203,138,0,138,32,430,0,0,143,96,47,GOOOOOOOOOOOOOXXXXXXGOOOOOOOOXXXXXXXXXXXGOOOOOOXXXXXXXXXXXXXGOOOOOOOOOOOOOXXXXXXGOOOOOOOXXXXXXXXXXXXGOOOOOOOOOOOOXXXXXXXGOOOOOOOOXXXXXXXXXXXGOOXXXXXXXXXXXXXXXXXGOOOOOOOOOOOOOOXXXXXGOOOOOXXXXXXXXXXXXXXGOOOOOOOOOOOOOOOXXXXGOOOOOOOOOOOOOOOOXXXGOOOOOOXXXXXXXXXXXXX,0,0,0
49224,138,0,138,26,436,0,0,148,101,47,GOOOOOOOOOOOOOXXXXXXGOOOOOOOOXXXXXXXXXXXGOOOOOOXXXXXXXXXXXXXGOOOOOOOOOOOOOXXXXXXGOOOOOOOXXXXXXXXXXXXGOOOOOOOOOOOOXXXXXXXGOOOOOOOOXXXXXXXXXXXGOOXXXXXXXXXXXXXXXXXGOOOOOOOOOOOOOOXXXXXGOOOOOXXXXXXXXXXXXXXGOOOOOOOOOOOOOOOXXXXGOOOOOOOOOOOOOOOOXXXGOOOOOOXXXXXXXXXXXXX,0,0,0

49245,138,0,138,24,438,0,0,150,98,52,GOOOOOOOOOOOOOXXXXXXGOOOOOOOOXXXXXXXXXXXGOOOOOOXXXXXXXXXXXXXGOOOOOOOOOOOOOXXXXXXGOOOOOOOXXXXXXXXXXXXGOOOOOOOOOOOOXXXXXXXGOOOOOOOOXXXXXXXXXXXGOOXXXXXXXXXXXXXXXXXGOOOOOOOOOOOOOOXXXXXGOOOOOXXXXXXXXXXXXXXGOOOOOOOOOOOOOOOXXXXGOOOOOOOOOOOOOOOOXXXGOOOOOOXXXXXXXXXXXXX,0,0,0
49266,138,0,138,23,439,0,0,152,97,55,GOOOOOOOOOOOOOXXXXXXGOOOOOOOOXXXXXXXXXXXGOOOOOOXXXXXXXXXXXXXGOOOOOOOOOOOOOXXXXXXGOOOOOOOXXXXXXXXXXXXGOOOOOOOOOOOOXXXXXXXGOOOOOOOOXXXXXXXXXXXGOOXXXXXXXXXXXXXXXXXGOOOOOOOOOOOOOOXXXXXGOOOOOXXXXXXXXXXXXXXGOOOOOOOOOOOOOOOXXXXGOOOOOOOOOOOOOOOOXXXGOOOOOOXXXXXXXXXXXXX,0,0,0
49287,138,0,138,25,437,0,0,150,100,50,GOOOOOOOOOOOOOXXXXXXGOOOOOOOOXXXXXXXXXXXGOOOOOOXXXXXXXXXXXXXGOOOOOOOOOOOOOXXXXXXGOOOOOOOXXXXXXXXXXXXGOOOOOOOOOOOOXXXXXXXGOOOOOOOOXXXXXXXXXXXGOOXXXXXXXXXXXXXXXXXGOOOOOOOOOOOOOOXXXXXGOOOOOXXXXXXXXXXXXXXGOOOOOOOOOOOOOOOXXXXGOOOOOOOOOOOOOOOOXXXGOOOOOOXXXXXXXXXXXXX,0,0,0
49308,138,0,138,25,437,0,0,150,98,52,GOOOOOOOOOOOOOXXXXXXGOOOOOOOOXXXXXXXXXXXGOOOOOOXXXXXXXXXXXXXGOOOOOOOOOOOOOXXXXXXGOOOOOOOXXXXXXXXXXXXGOOOOOOOOOOOOXXXXXXXGOOOOOOOOXXXXXXXXXXXGOOXXXXXXXXXXXXXXXXXGOOOOOOOOOOOOOOXXXXXGOOOOOXXXXXXXXXXXXXXGOOOOOOOOOOOOOOOXXXXGOOOOOOOOOOOOOOOOXXXGOOOOOOXXXXXXXXXXXXX,0,0,0
49329,138,0,138,22,440,0,0,153,99,54,GOOOOOOOOOOOOOXXXXXXGOOOOOOOOXXXXXXXXXXXGOOOOOOXXXXXXXXXXXXXGOOOOOOOOOOOOOXXXXXXGOOOOOOOXXXXXXXXXXXXGOOOOOOOOOOOOXXXXXXXGOOOOOOOOXXXXXXXXXXXGOOXXXXXXXXXXXXXXXXXGOOOOOOOOOOOOOOXXXXXGOOOOOXXXXXXXXXXXXXXGOOOOOOOOOOOOOOOXXXXGOOOOOOOOOOOOOOOOXXXGOOOOOOXXXXXXXXXXXXX,0,0,0

49350,138,0,138,24,438,0,0,151,99,52,GOOOOOOOOOOOOOXXXXXXGOOOOOOOOXXXXXXXXXXXGOOOOOOXXXXXXXXXXXXXGOOOOOOOOOOOOOXXXXXXGOOOOOOOXXXXXXXXXXXXGOOOOOOOOOOOOXXXXXXXGOOOOOOOOXXXXXXXXXXXGOOXXXXXXXXXXXXXXXXXGOOOOOOOOOOOOOOXXXXXGOOOOOXXXXXXXXXXXXXXGOOOOOOOOOOOOOOOXXXXGOOOOOOOOOOOOOOOOXXXGOOOOOOXXXXXXXXXXXXX,0,0,0
49371,138,0,138,26,436,0,0,149,98,51,GOOOOOOOOOOOOOXXXXXXGOOOOOOOOXXXXXXXXXXXGOOOOOOXXXXXXXXXXXXXGOOOOOOOOOOOOOXXXXXXGOOOOOOOXXXXXXXXXXXXGOOOOOOOOOOOOXXXXXXXGOOOOOOOOXXXXXXXXXXXGOOXXXXXXXXXXXXXXXXXGOOOOOOOOOOOOOOXXXXXGOOOOOXXXXXXXXXXXXXXGOOOOOOOOOOOOOOOXXXXGOOOOOOOOOOOOOOOOXXXGOOOOOOXXXXXXXXXXXXX,0,0,0
49392,138,0,138,26,436,0,0,149,98,51,GOOOOOOOOOOOOOXXXXXXGOOOOOOOOXXXXXXXXXXXGOOOOOOXXXXXXXXXXXXXGOOOOOOOOOOOOOXXXXXXGOOOOOOOXXXXXXXXXXXXGOOOOOOOOOOOOXXXXXXXGOOOOOOOOXXXXXXXXXXXGOOXXXXXXXXXXXXXXXXXGOOOOOOOOOOOOOOXXXXXGOOOOOXXXXXXXXXXXXXXGOOOOOOOOOOOOOOOXXXXGOOOOOOOOOOOOOOOOXXXGOOOOOOXXXXXXXXXXXXX,0,0,0
49413,138,0,138,28,434,0,0,147,96,51,GOOOOOOOOOOOOOXXXXXXGOOOOOOOOXXXXXXXXXXXGOOOOOOXXXXXXXXXXXXXGOOOOOOOOOOOOOXXXXXXGOOOOOOOXXXXXXXXXXXXGOOOOOOOOOOOOXXXXXXXGOOOOOOOOXXXXXXXXXXXGOOXXXXXXXXXXXXXXXXXGOOOOOOOOOOOOOOXXXXXGOOOOOXXXXXXXXXXXXXXGOOOOOOOOOOOOOOOXXXXGOOOOOOOOOOOOOOOOXXXGOOOOOOXXXXXXXXXXXXX,0,0,0
49434,138,0,138,28,434,0,0,147,97,50,GOOOOOOOOOOOOOXXXXXXGOOOOOOOOXXXXXXXXXXXGOOOOOOXXXXXXXXXXXXXGOOOOOOOOOOOOOXXXXXXGOOOOOOOXXXXXXXXXXXXGOOOOOOOOOOOOXXXXXXXGOOOOOOOOXXXXXXXXXXXGOOXXXXXXXXXXXXXXXXXGOOOOOOOOOOOOOOXXXXXGOOOOOXXXXXXXXXXXXXXGOOOOOOOOOOOOOOOXXXXGOOOOOOOOOOOOOOOOXXXGOOOOOOXXXXXXXXXXXXX,0,0,0

49455,138,0,138,23,439,0,0,151,99,52,GOOOOOOOOOOOOOXXXXXXGOOOOOOOOXXXXXXXXXXXGOOOOOOXXXXXXXXXXXXXGOOOOOOOOOOOOOXXXXXXGOOOOOOOXXXXXXXXXXXXGOOOOOOOOOOOOXXXXXXXGOOOOOOOOXXXXXXXXXXXGOOXXXXXXXXXXXXXXXXXGOOOOOOOOOOOOOOXXXXXGOOOOOXXXXXXXXXXXXXXGOOOOOOOOOOOOOOOXXXXGOOOOOOOOOOOOOOOOXXXGOOOOOOXXXXXXXXXXXXX,0,0,0
49476,138,0,138,26,436,0,0,149,100,49,GOOOOOOOOOOOOOXXXXXXGOOOOOOOOXXXXXXXXXXXGOOOOOOXXXXXXXXXXXXXGOOOOOOOOOOOOOXXXXXXGOOOOOOOXXXXXXXXXXXXGOOOOOOOOOOOOXXXXXXXGOOOOOOOOXXXXXXXXXXXGOOXXXXXXXXXXXXXXXXXGOOOOOOOOOOOOOOXXXXXGOOOOOXXXXXXXXXXXXXXGOOOOOOOOOOOOOOOXXXXGOOOOOOOOOOOOOOOOXXXGOOOOOOXXXXXXXXXXXXX,0,0,0
49497,138,0,138,28,434,0,0,146,100,46,GOOOOOOOOOOOOOXXXXXXGOOOOOOOOXXXXXXXXXXXGOOOOOOXXXXXXXXXXXXXGOOOOOOOOOOOOOXXXXXXGOOOOOOOXXXXXXXXXXXXGOOOOOOOOOOOOXXXXXXXGOOOOOOOOXXXXXXXXXXXGOOXXXXXXXXXXXXXXXXXGOOOOOOOOOOOOOOXXXXXGOOOOOXXXXXXXXXXXXXXGOOOOOOOOOOOOOOOXXXXGOOOOOOOOOOOOOOOOXXXGOOOOOOXXXXXXXXXXXXX,0,0,0
49518,138,0,138,31,431,0,0,144,99,45,GOOOOOOOOOOOOOXXXXXXGOOOOOOOOXXXXXXXXXXXGOOOOOOXXXXXXXXXXXXXGOOOOOOOOOOOOOXXXXXXGOOOOOOOXXXXXXXXXXXXGOOOOOOOOOOOOXXXXXXXGOOOOOOOOXXXXXXXXXXXGOOXXXXXXXXXXXXXXXXXGOOOOOOOOOOOOOOXXXXXGOOOOOXXXXXXXXXXXXXXGOOOOOOOOOOOOOOOXXXXGOOOOOOOOOOOOOOOOXXXGOOOOOOXXXXXXXXXXXXX,0,0,0
49539,138,0,138,31,431,0,0,144,100,44,GOOOOOOOOOOOOOXXXXXXGOOOOOOOOXXXXXXXXXXXGOOOOOOXXXXXXXXXXXXXGOOOOOOOOOOOOOXXXXXXGOOOOOOOXXXXXXXXXXXXGOOOOOOOOOOOOXXXXXXXGOOOOOOOOXXXXXXXXXXXGOOXXXXXXXXXXXXXXXXXGOOOOOOOOOOOOOOXXXXXGOOOOOXXXXXXXXXXXXXXGOOOOOOOOOOOOOOOXXXXGOOOOOOOOOOOOOOOOXXXGOOOOOOXXXXXXXXXXXXX,0,0,0

49560,138,0,138,30,432,0,0,144,97,47,GOOOOOOOOOOOOOXXXXXXGOOOOOOOOXXXXXXXXXXXGOOOOOOXXXXXXXXXXXXXGOOOOOOOOOOOOOXXXXXXGOOOOOOOXXXXXXXXXXXXGOOOOOOOOOOOOXXXXXXXGOOOOOOOOXXXXXXXXXXXGOOXXXXXXXXXXXXXXXXXGOOOOOOOOOOOOOOXXXXXGOOOOOXXXXXXXXXXXXXXGOOOOOOOOOOOOOOOXXXXGOOOOOOOOOOOOOOOOXXXGOOOOOOXXXXXXXXXXXXX,0,0,0
49581,138,0,138,29,433,0,0,146,101,45,GOOOOOOOOOOOOOXXXXXXGOOOOOOOOXXXXXXXXXXXGOOOOOOXXXXXXXXXXXXXGOOOOOOOOOOOOOXXXXXXGOOOOOOOXXXXXXXXXXXXGOOOOOOOOOOOOXXXXXXXGOOOOOOOOXXXXXXXXXXXGOOXXXXXXXXXXXXXXXXXGOOOOOOOOOOOOOOXXXXXGOOOOOXXXXXXXXXXXXXXGOOOOOOOOOOOOOOOXXXXGOOOOOOOOOOOOOOOOXXXGOOOOOOXXXXXXXXXXXXX,0,0,0
49602,138,0,138,31,431,0,0,144,97,47,GOOOOOOOOOOOOOXXXXXXGOOOOOOOOXXXXXXXXXXXGOOOOOOXXXXXXXXXXXXXGOOOOOOOOOOOOOXXXXXXGOOOOOOOXXXXXXXXXXXXGOOOOOOOOOOOOXXXXXXXGOOOOOOOOXXXXXXXXXXXGOOXXXXXXXXXXXXXXXXXGOOOOOOOOOOOOOOXXXXXGOOOOOXXXXXXXXXXXXXXGOOOOOOOOOOOOOOOXXXXGOOOOOOOOOOOOOOOOXXXGOOOOOOXXXXXXXXXXXXX,0,0,0
49623,138,0,138,28,434,0,0,147,99,48,GOOOOOOOOOOOOOXXXXXXGOOOOOOOOXXXXXXXXXXXGOOOOOOXXXXXXXXXXXXXGOOOOOOOOOOOOOXXXXXXGOOOOOOOXXXXXXXXXXXXGOOOOOOOOOOOOXXXXXXXGOOOOOOOOXXXXXXXXXXXGOOXXXXXXXXXXXXXXXXXGOOOOOOOOOOOOOOXXXXXGOOOOOXXXXXXXXXXXXXXGOOOOOOOOOOOOOOOXXXXGOOOOOOOOOOOOOOOOXXXGOOOOOOXXXXXXXXXXXXX,0,0,0
49644,138,0,138,25,437,0,0,149,98,51,GOOOOOOOOOOOOOXXXXXXGOOOOOOOOXXXXXXXXXXXGOOOOOOXXXXXXXXXXXXXGOOOOOOOOOOOOOXXXXXXGOOOOOOOXXXXXXXXXXXXGOOOOOOOOOOOOXXXXXXXGOOOOOOOOXXXXXXXXXXXGOOXXXXXXXXXXXXXXXXXGOOOOOOOOOOOOOOXXXXXGOOOOOXXXXXXXXXXXXXXGOOOOOOOOOOOOOOOXXXXGOOOOOOOOOOOOOOOOXXXGOOOOOOXXXXXXXXXXXXX,0,0,0

49665,138,0,138,25,437,0,0,150,97,53,GOOOOOOOOOOOOOXXXXXXGOOOOOOOOXXXXXXXXXXXGOOOOOOXXXXXXXXXXXXXGOOOOOOOOOOOOOXXXXXXGOOOOOOOXXXXXXXXXXXXGOOOOOOOOOOOOXXXXXXXGOOOOOOOOXXXXXXXXXXXGOOXXXXXXXXXXXXXXXXXGOOOOOOOOOOOOOOXXXXXGOOOOOXXXXXXXXXXXXXXGOOOOOOOOOOOOOOOXXXXGOOOOOOOOOOOOOOOOXXXGOOOOOOXXXXXXXXXXXXX,0,0,0
49686,138,0,138,24,438,0,0,151,97,54,GOOOOOOOOOOOOOXXXXXXGOOOOOOOOXXXXXXXXXXXGOOOOOOXXXXXXXXXXXXXGOOOOOOOOOOOOOXXXXXXGOOOOOOOXXXXXXXXXXXXGOOOOOOOOOOOOXXXXXXXGOOOOOOOOXXXXXXXXXXXGOOXXXXXXXXXXXXXXXXXGOOOOOOOOOOOOOOXXXXXGOOOOOXXXXXXXXXXXXXXGOOOOOOOOOOOOOOOXXXXGOOOOOOOOOOOOOOOOXXXGOOOOOOXXXXXXXXXXXXX,0,0,0
49707,138,0,138,23,439,0,0,152,98,54,GOOOOOOOOOOOOOXXXXXXGOOOOOOOOXXXXXXXXXXXGOOOOOOXXXXXXXXXXXXXGOOOOOOOOOOOOOXXXXXXGOOOOOOOXXXXXXXXXXXXGOOOOOOOOOOOOXXXXXXXGOOOOOOOOXXXXXXXXXXXGOOXXXXXXXXXXXXXXXXXGOOOOOOOOOOOOOOXXXXXGOOOOOXXXXXXXXXXXXXXGOOOOOOOOOOOOOOOXXXXGOOOOOOOOOOOOOOOOXXXGOOOOOOXXXXXXXXXXXXX,0,0,0
49728,138,0,138,19,443,0,0,157,101,56,GOOOOOOOOOOOOOXXXXXXGOOOOOOOOXXXXXXXXXXXGOOOOOOXXXXXXXXXXXXXGOOOOOOOOOOOOOXXXXXXGOOOOOOOXXXXXXXXXXXXGOOOOOOOOOOOOXXXXXXXGOOOOOOOOXXXXXXXXXXXGOOXXXXXXXXXXXXXXXXXGOOOOOOOOOOOOOOXXXXXGOOOOOXXXXXXXXXXXXXXGOOOOOOOOOOOOOOOXXXXGOOOOOOOOOOOOOOOOXXXGOOOOOOXXXXXXXXXXXXX,0,0,0
49749,138,0,138,22,440,0,0,154,100,54,GOOOOOOOOOOOOOXXXXXXGOOOOOOOOXXXXXXXXXXXGOOOOOOXXXXXXXXXXXXXGOOOOOOOOOOOOOXXXXXXGOOOOOOOXXXXXXXXXXXXGOOOOOOOOOOOOXXXXXXXGOOOOOOOOXXXXXXXXXXXGOOXXXXXXXXXXXXXXXXXGOOOOOOOOOOOOOOXXXXXGOOOOOXXXXXXXXXXXXXXGOOOOOOOOOOOOOOOXXXXGOOOOOOOOOOOOOOOOXXXGOOOOOOXXXXXXXXXXXXX,0,0,0

49770,138,0,138,24,438,0,0,152,100,52,GOOOOOOOOOOOOOXXXXXXGOOOOOOOOXXXXXXXXXXXGOOOOOOXXXXXXXXXXXXXGOOOOOOOOOOOOOXXXXXXGOOOOOOOXXXXXXXXXXXXGOOOOOOOOOOOOXXXXXXXGOOOOOOOOXXXXXXXXXXXGOOXXXXXXXXXXXXXXXXXGOOOOOOOOOOOOOOXXXXXGOOOOOXXXXXXXXXXXXXXGOOOOOOOOOOOOOOOXXXXGOOOOOOOOOOOOOOOOXXXGOOOOOOXXXXXXXXXXXXX,0,0,0
49791,138,0,138,26,436,0,0,150,98,52,GOOOOOOOOOOOOOXXXXXXGOOOOOOOOXXXXXXXXXXXGOOOOOOXXXXXXXXXXXXXGOOOOOOOOOOOOOXXXXXXGOOOOOOOXXXXXXXXXXXXGOOOOOOOOOOOOXXXXXXXGOOOOOOOOXXXXXXXXXXXGOOXXXXXXXXXXXXXXXXXGOOOOOOOOOOOOOOXXXXXGOOOOOXXXXXXXXXXXXXXGOOOOOOOOOOOOOOOXXXXGOOOOOOOOOOOOOOOOXXXGOOOOOOXXXXXXXXXXXXX,0,0,0
49812,138,0,138,28,434,0,0,148,99,49,GOOOOOOOOOOOOOXXXXXXGOOOOOOOOXXXXXXXXXXXGOOOOOOXXXXXXXXXXXXXGOOOOOOOOOOOOOXXXXXXGOOOOOOOXXXXXXXXXXXXGOOOOOOOOOOOOXXXXXXXGOOOOOOOOXXXXXXXXXXXGOOXXXXXXXXXXXXXXXXXGOOOOOOOOOOOOOOXXXXXGOOOOOXXXXXXXXXXXXXXGOOOOOOOOOOOOOOOXXXXGOOOOOOOOOOOOOOOOXXXGOOOOOOXXXXXXXXXXXXX,0,0,0
49833,138,0,138,28,434,0,0,148,97,51,GOOOOOOOOOOOOOXXXXXXGOOOOOOOOXXXXXXXXXXXGOOOOOOXXXXXXXXXXXXXGOOOOOOOOOOOOOXXXXXXGOOOOOOOXXXXXXXXXXXXGOOOOOOOOOOOOXXXXXXXGOOOOOOOOXXXXXXXXXXXGOOXXXXXXXXXXXXXXXXXGOOOOOOOOOOOOOOXXXXXGOOOOOXXXXXXXXXXXXXXGOOOOOOOOOOOOOOOXXXXGOOOOOOOOOOOOOOOOXXXGOOOOOOXXXXXXXXXXXXX,0,0,0
49854,138,0,138,24,438,0,0,151,97,54,GOOOOOOOOOOOOOXXXXXXGOOOOOOOOXXXXXXXXXXXGOOOOOOXXXXXXXXXXXXXGOOOOOOOOOOOOOXXXXXXGOOOOOOOXXXXXXXXXXXXGOOOOOOOOOOOOXXXXXXXGOOOOOOOOXXXXXXXXXXXGOOXXXXXXXXXXXXXXXXXGOOOOOOOOOOOOOOXXXXXGOOOOOXXXXXXXXXXXXXXGOOOOOOOOOOOOOOOXXXXGOOOOOOOOOOOOOOOOXXXGOOOOOOXXXXXXXXXXXXX,0,0,0

49875,138,0,138,26,436,0,0,149,98,51,GOOOOOOOOOOOOOXXXXXXGOOOOOOOOXXXXXXXXXXXGOOOOOOXXXXXXXXXXXXXGOOOOOOOOOOOOOXXXXXXGOOOOOOOXXXXXXXXXXXXGOOOOOOOOOOOOXXXXXXXGOOOOOOOOXXXXXXXXXXXGOOXXXXXXXXXXXXXXXXXGOOOOOOOOOOOOOOXXXXXGOOOOOXXXXXXXXXXXXXXGOOOOOOOOOOOOOOOXXXXGOOOOOOOOOOOOOOOOXXXGOOOOOOXXXXXXXXXXXXX,0,0,0
49896,138,0,138,25,437,0,0,150,98,52,GOOOOOOOOOOOOOXXXXXXGOOOOOOOOXXXXXXXXXXXGOOOOOOXXXXXXXXXXXXXGOOOOOOOOOOOOOXXXXXXGOOOOOOOXXXXXXXXXXXXGOOOOOOOOOOOOXXXXXXXGOOOOOOOOXXXXXXXXXXXGOOXXXXXXXXXXXXXXXXXGOOOOOOOOOOOOOOXXXXXGOOOOOXXXXXXXXXXXXXXGOOOOOOOOOOOOOOOXXXXGOOOOOOOOOOOOOOOOXXXGOOOOOOXXXXXXXXXXXXX,0,0,0
49917,138,0,138,29,433,0,0,146,98,48,GOOOOOOOOOOOOOXXXXXXGOOOOOOOOXXXXXXXXXXXGOOOOOOXXXXXXXXXXXXXGOOOOOOOOOOOOOXXXXXXGOOOOOOOXXXXXXXXXXXXGOOOOOOOOOOOOXXXXXXXGOOOOOOOOXXXXXXXXXXXGOOXXXXXXXXXXXXXXXXXGOOOOOOOOOOOOOOXXXXXGOOOOOXXXXXXXXXXXXXXGOOOOOOOOOOOOOOOXXXXGOOOOOOOOOOOOOOOOXXXGOOOOOOXXXXXXXXXXXXX,0,0,0
49938,138,0,138,29,433,0,0,145,97,48,GOOOOOOOOOOOOOXXXXXXGOOOOOOOOXXXXXXXXXXXGOOOOOOXXXXXXXXXXXXXGOOOOOOOOOOOOOXXXXXXGOOOOOOOXXXXXXXXXXXXGOOOOOOOOOOOOXXXXXXXGOOOOOOOOXXXXXXXXXXXGOOXXXXXXXXXXXXXXXXXGOOOOOOOOOOOOOOXXXXXGOOOOOXXXXXXXXXXXXXXGOOOOOOOOOOOOOOOXXXXGOOOOOOOOOOOOOOOOXXXGOOOOOOXXXXXXXXXXXXX,0,0,0
49959,138,0,138,27,435,0,0,148,99,49,GOOOOOOOOOOOOOXXXXXXGOOOOOOOOXXXXXXXXXXXGOOOOOOXXXXXXXXXXXXXGOOOOOOOOOOOOOXXXXXXGOOOOOOOXXXXXXXXXXXXGOOOOOOOOOOOOXXXXXXXGOOOOOOOOXXXXXXXXXXXGOOXXXXXXXXXXXXXXXXXGOOOOOOOOOOOOOOXXXXXGOOOOOXXXXXXXXXXXXXXGOOOOOOOOOOOOOOOXXXXGOOOOOOOOOOOOOOOOXXXGOOOOOOXXXXXXXXXXXXX,0,0,0

