iterCounter, dimersInMT, activeDimersInMT, inactiveDimersInMT, activeDimersFree,inactiveDimersFree, longestProtoFilament, lengthOfMT, totalGTPs, activeGTPs,inactiveGTPs, mtRepresentation, DeHydro Katanins, Hydro Katanins, Bonded Katanins

21,0,0,0,0,0,0,0,0,0,0,XXXXXXXXXXXXXXXXXXXXXXXXXXXXXXXXXXXXXXXXXXXXXXXXXXXXXXXXXXXXXXXXXXXXXXXXXXXXXXXXXXXXXXXXXXXXXXXXXXXXXXXXXXXXXXXXXXXXXXXXXXXXXXXXXXXXXXXXXXXXXXXXXXXXXXXXXXXXXXXXXXXXXXXXXXXXXXXXXXXXXXXXXXXXXXXXXXXXXXXXXXXXXXXXXXXXXXXXXXXXXXXXXXXXXXXXXXXXXXXXXXXXXXXXXXXXXXXXXXXX,0,0,0
42,0,0,0,0,0,0,0,0,0,0,XXXXXXXXXXXXXXXXXXXXXXXXXXXXXXXXXXXXXXXXXXXXXXXXXXXXXXXXXXXXXXXXXXXXXXXXXXXXXXXXXXXXXXXXXXXXXXXXXXXXXXXXXXXXXXXXXXXXXXXXXXXXXXXXXXXXXXXXXXXXXXXXXXXXXXXXXXXXXXXXXXXXXXXXXXXXXXXXXXXXXXXXXXXXXXXXXXXXXXXXXXXXXXXXXXXXXXXXXXXXXXXXXXXXXXXXXXXXXXXXXXXXXXXXXXXXXXXXXXXX,0,0,0
63,0,0,0,0,0,0,0,0,0,0,XXXXXXXXXXXXXXXXXXXXXXXXXXXXXXXXXXXXXXXXXXXXXXXXXXXXXXXXXXXXXXXXXXXXXXXXXXXXXXXXXXXXXXXXXXXXXXXXXXXXXXXXXXXXXXXXXXXXXXXXXXXXXXXXXXXXXXXXXXXXXXXXXXXXXXXXXXXXXXXXXXXXXXXXXXXXXXXXXXXXXXXXXXXXXXXXXXXXXXXXXXXXXXXXXXXXXXXXXXXXXXXXXXXXXXXXXXXXXXXXXXXXXXXXXXXXXXXXXXXX,0,0,0
84,0,0,0,0,0,0,0,0,0,0,XXXXXXXXXXXXXXXXXXXXXXXXXXXXXXXXXXXXXXXXXXXXXXXXXXXXXXXXXXXXXXXXXXXXXXXXXXXXXXXXXXXXXXXXXXXXXXXXXXXXXXXXXXXXXXXXXXXXXXXXXXXXXXXXXXXXXXXXXXXXXXXXXXXXXXXXXXXXXXXXXXXXXXXXXXXXXXXXXXXXXXXXXXXXXXXXXXXXXXXXXXXXXXXXXXXXXXXXXXXXXXXXXXXXXXXXXXXXXXXXXXXXXXXXXXXXXXXXXXXX,0,0,0

105,0,0,0,0,500,0,0,500,0,500,XXXXXXXXXXXXXXXXXXXXXXXXXXXXXXXXXXXXXXXXXXXXXXXXXXXXXXXXXXXXXXXXXXXXXXXXXXXXXXXXXXXXXXXXXXXXXXXXXXXXXXXXXXXXXXXXXXXXXXXXXXXXXXXXXXXXXXXXXXXXXXXXXXXXXXXXXXXXXXXXXXXXXXXXXXXXXXXXXXXXXXXXXXXXXXXXXXXXXXXXXXXXXXXXXXXXXXXXXXXXXXXXXXXXXXXXXXXXXXXXXXXXXXXXXXXXXXXXXXXX,0,0,0
126,0,0,0,0,500,0,0,500,0,500,XXXXXXXXXXXXXXXXXXXXXXXXXXXXXXXXXXXXXXXXXXXXXXXXXXXXXXXXXXXXXXXXXXXXXXXXXXXXXXXXXXXXXXXXXXXXXXXXXXXXXXXXXXXXXXXXXXXXXXXXXXXXXXXXXXXXXXXXXXXXXXXXXXXXXXXXXXXXXXXXXXXXXXXXXXXXXXXXXXXXXXXXXXXXXXXXXXXXXXXXXXXXXXXXXXXXXXXXXXXXXXXXXXXXXXXXXXXXXXXXXXXXXXXXXXXXXXXXXXXX,0,0,0
147,0,0,0,0,500,0,0,500,0,500,XXXXXXXXXXXXXXXXXXXXXXXXXXXXXXXXXXXXXXXXXXXXXXXXXXXXXXXXXXXXXXXXXXXXXXXXXXXXXXXXXXXXXXXXXXXXXXXXXXXXXXXXXXXXXXXXXXXXXXXXXXXXXXXXXXXXXXXXXXXXXXXXXXXXXXXXXXXXXXXXXXXXXXXXXXXXXXXXXXXXXXXXXXXXXXXXXXXXXXXXXXXXXXXXXXXXXXXXXXXXXXXXXXXXXXXXXXXXXXXXXXXXXXXXXXXXXXXXXXXX,0,0,0
168,0,0,0,0,500,0,0,500,0,500,XXXXXXXXXXXXXXXXXXXXXXXXXXXXXXXXXXXXXXXXXXXXXXXXXXXXXXXXXXXXXXXXXXXXXXXXXXXXXXXXXXXXXXXXXXXXXXXXXXXXXXXXXXXXXXXXXXXXXXXXXXXXXXXXXXXXXXXXXXXXXXXXXXXXXXXXXXXXXXXXXXXXXXXXXXXXXXXXXXXXXXXXXXXXXXXXXXXXXXXXXXXXXXXXXXXXXXXXXXXXXXXXXXXXXXXXXXXXXXXXXXXXXXXXXXXXXXXXXXXX,0,0,0
189,0,0,0,0,500,0,0,500,0,500,XXXXXXXXXXXXXXXXXXXXXXXXXXXXXXXXXXXXXXXXXXXXXXXXXXXXXXXXXXXXXXXXXXXXXXXXXXXXXXXXXXXXXXXXXXXXXXXXXXXXXXXXXXXXXXXXXXXXXXXXXXXXXXXXXXXXXXXXXXXXXXXXXXXXXXXXXXXXXXXXXXXXXXXXXXXXXXXXXXXXXXXXXXXXXXXXXXXXXXXXXXXXXXXXXXXXXXXXXXXXXXXXXXXXXXXXXXXXXXXXXXXXXXXXXXXXXXXXXXXX,0,0,0

210,0,0,0,0,500,0,0,500,0,500,XXXXXXXXXXXXXXXXXXXXXXXXXXXXXXXXXXXXXXXXXXXXXXXXXXXXXXXXXXXXXXXXXXXXXXXXXXXXXXXXXXXXXXXXXXXXXXXXXXXXXXXXXXXXXXXXXXXXXXXXXXXXXXXXXXXXXXXXXXXXXXXXXXXXXXXXXXXXXXXXXXXXXXXXXXXXXXXXXXXXXXXXXXXXXXXXXXXXXXXXXXXXXXXXXXXXXXXXXXXXXXXXXXXXXXXXXXXXXXXXXXXXXXXXXXXXXXXXXXXX,0,0,0
231,0,0,0,0,500,0,0,500,0,500,XXXXXXXXXXXXXXXXXXXXXXXXXXXXXXXXXXXXXXXXXXXXXXXXXXXXXXXXXXXXXXXXXXXXXXXXXXXXXXXXXXXXXXXXXXXXXXXXXXXXXXXXXXXXXXXXXXXXXXXXXXXXXXXXXXXXXXXXXXXXXXXXXXXXXXXXXXXXXXXXXXXXXXXXXXXXXXXXXXXXXXXXXXXXXXXXXXXXXXXXXXXXXXXXXXXXXXXXXXXXXXXXXXXXXXXXXXXXXXXXXXXXXXXXXXXXXXXXXXXX,0,0,0
252,0,0,0,0,500,0,0,500,0,500,XXXXXXXXXXXXXXXXXXXXXXXXXXXXXXXXXXXXXXXXXXXXXXXXXXXXXXXXXXXXXXXXXXXXXXXXXXXXXXXXXXXXXXXXXXXXXXXXXXXXXXXXXXXXXXXXXXXXXXXXXXXXXXXXXXXXXXXXXXXXXXXXXXXXXXXXXXXXXXXXXXXXXXXXXXXXXXXXXXXXXXXXXXXXXXXXXXXXXXXXXXXXXXXXXXXXXXXXXXXXXXXXXXXXXXXXXXXXXXXXXXXXXXXXXXXXXXXXXXXX,0,0,0
273,0,0,0,0,500,0,0,500,0,500,XXXXXXXXXXXXXXXXXXXXXXXXXXXXXXXXXXXXXXXXXXXXXXXXXXXXXXXXXXXXXXXXXXXXXXXXXXXXXXXXXXXXXXXXXXXXXXXXXXXXXXXXXXXXXXXXXXXXXXXXXXXXXXXXXXXXXXXXXXXXXXXXXXXXXXXXXXXXXXXXXXXXXXXXXXXXXXXXXXXXXXXXXXXXXXXXXXXXXXXXXXXXXXXXXXXXXXXXXXXXXXXXXXXXXXXXXXXXXXXXXXXXXXXXXXXXXXXXXXXX,0,0,0
294,0,0,0,0,500,0,0,500,0,500,XXXXXXXXXXXXXXXXXXXXXXXXXXXXXXXXXXXXXXXXXXXXXXXXXXXXXXXXXXXXXXXXXXXXXXXXXXXXXXXXXXXXXXXXXXXXXXXXXXXXXXXXXXXXXXXXXXXXXXXXXXXXXXXXXXXXXXXXXXXXXXXXXXXXXXXXXXXXXXXXXXXXXXXXXXXXXXXXXXXXXXXXXXXXXXXXXXXXXXXXXXXXXXXXXXXXXXXXXXXXXXXXXXXXXXXXXXXXXXXXXXXXXXXXXXXXXXXXXXXX,0,0,0

315,0,0,0,14,486,0,0,486,10,476,XXXXXXXXXXXXXXXXXXXXXXXXXXXXXXXXXXXXXXXXXXXXXXXXXXXXXXXXXXXXXXXXXXXXXXXXXXXXXXXXXXXXXXXXXXXXXXXXXXXXXXXXXXXXXXXXXXXXXXXXXXXXXXXXXXXXXXXXXXXXXXXXXXXXXXXXXXXXXXXXXXXXXXXXXXXXXXXXXXXXXXXXXXXXXXXXXXXXXXXXXXXXXXXXXXXXXXXXXXXXXXXXXXXXXXXXXXXXXXXXXXXXXXXXXXXXXXXXXXXX,0,0,0
336,0,0,0,41,459,0,0,459,17,442,XXXXXXXXXXXXXXXXXXXXXXXXXXXXXXXXXXXXXXXXXXXXXXXXXXXXXXXXXXXXXXXXXXXXXXXXXXXXXXXXXXXXXXXXXXXXXXXXXXXXXXXXXXXXXXXXXXXXXXXXXXXXXXXXXXXXXXXXXXXXXXXXXXXXXXXXXXXXXXXXXXXXXXXXXXXXXXXXXXXXXXXXXXXXXXXXXXXXXXXXXXXXXXXXXXXXXXXXXXXXXXXXXXXXXXXXXXXXXXXXXXXXXXXXXXXXXXXXXXXX,0,0,0
357,0,0,0,77,423,0,0,423,15,408,XXXXXXXXXXXXXXXXXXXXXXXXXXXXXXXXXXXXXXXXXXXXXXXXXXXXXXXXXXXXXXXXXXXXXXXXXXXXXXXXXXXXXXXXXXXXXXXXXXXXXXXXXXXXXXXXXXXXXXXXXXXXXXXXXXXXXXXXXXXXXXXXXXXXXXXXXXXXXXXXXXXXXXXXXXXXXXXXXXXXXXXXXXXXXXXXXXXXXXXXXXXXXXXXXXXXXXXXXXXXXXXXXXXXXXXXXXXXXXXXXXXXXXXXXXXXXXXXXXXX,0,0,0
378,0,0,0,100,400,0,0,400,24,376,XXXXXXXXXXXXXXXXXXXXXXXXXXXXXXXXXXXXXXXXXXXXXXXXXXXXXXXXXXXXXXXXXXXXXXXXXXXXXXXXXXXXXXXXXXXXXXXXXXXXXXXXXXXXXXXXXXXXXXXXXXXXXXXXXXXXXXXXXXXXXXXXXXXXXXXXXXXXXXXXXXXXXXXXXXXXXXXXXXXXXXXXXXXXXXXXXXXXXXXXXXXXXXXXXXXXXXXXXXXXXXXXXXXXXXXXXXXXXXXXXXXXXXXXXXXXXXXXXXXX,0,0,0
399,2,2,0,133,365,0,0,365,32,333,XXXXXXXXXXXXXXXXXXXXXXXXXXXXXXXXXXXXXXXXXXXXXXXXXXXXXXXXXXXXXXXXXXXXXXXXXXXXXXXXXXXXXXXXXXXXXXXXXXXXXXXXXXXXXXXXXXXXXXXXGXXXXXXXXXXXXXXXXXXXXXXXXXXXXXXXXXXXXXXXXXXXXXXXXXXXXXXXXXXXGXXXXXXXXXXXXXXXXXXXXXXXXXXXXXXXXXXXXXXXXXXXXXXXXXXXXXXXXXXXXXXXXXXXXXXXXXXXXXXX,0,0,0

420,6,6,0,169,325,0,0,325,27,298,XXXXXXXXXXXXXXXXXXXXXXXXXXXXXXXXXXXXXXXXGXXXXXXXXXXXXXXXXXXXGXXXXXXXXXXXXXXXXXXXXXXXXXXXXXXXXXXXXXXXXXXXXXXXXXXXXXXXXXXXGXXXXXXXXXXXXXXXXXXXGXXXXXXXXXXXXXXXXXXXXXXXXXXXXXXXXXXXXXXXGXXXXXXXXXXXXXXXXXXXXXXXXXXXXXXXXXXXXXXXGXXXXXXXXXXXXXXXXXXXXXXXXXXXXXXXXXXXXXXX,0,0,0
441,7,7,0,197,296,0,0,296,34,262,XXXXXXXXXXXXXXXXXXXXXXXXXXXXXXXXXXXXXXXXGXXXXXXXXXXXXXXXXXXXGXXXXXXXXXXXXXXXXXXXGXXXXXXXXXXXXXXXXXXXXXXXXXXXXXXXXXXXXXXXGXXXXXXXXXXXXXXXXXXXGXXXXXXXXXXXXXXXXXXXXXXXXXXXXXXXXXXXXXXXGXXXXXXXXXXXXXXXXXXXXXXXXXXXXXXXXXXXXXXXGXXXXXXXXXXXXXXXXXXXXXXXXXXXXXXXXXXXXXXX,0,0,0
462,8,8,0,223,269,0,0,269,34,235,XXXXXXXXXXXXXXXXXXXXXXXXXXXXXXXXXXXXXXXXGXXXXXXXXXXXXXXXXXXXGXXXXXXXXXXXXXXXXXXXGXXXXXXXXXXXXXXXXXXXXXXXXXXXXXXXXXXXXXXXGAXXXXXXXXXXXXXXXXXXGXXXXXXXXXXXXXXXXXXXXXXXXXXXXXXXXXXXXXXXGXXXXXXXXXXXXXXXXXXXXXXXXXXXXXXXXXXXXXXXGXXXXXXXXXXXXXXXXXXXXXXXXXXXXXXXXXXXXXXX,0,0,0
483,9,9,0,253,238,0,0,238,42,196,XXXXXXXXXXXXXXXXXXXXXXXXXXXXXXXXXXXXXXXXGXXXXXXXXXXXXXXXXXXXGXXXXXXXXXXXXXXXXXXXGXXXXXXXXXXXXXXXXXXXXXXXXXXXXXXXXXXXXXXXGAXXXXXXXXXXXXXXXXXXGXXXXXXXXXXXXXXXXXXXXXXXXXXXXXXXXXXXXXXXGXXXXXXXXXXXXXXXXXXXGXXXXXXXXXXXXXXXXXXXGXXXXXXXXXXXXXXXXXXXXXXXXXXXXXXXXXXXXXXX,0,0,0
504,11,11,0,280,209,0,0,209,55,154,GXXXXXXXXXXXXXXXXXXXXXXXXXXXXXXXXXXXXXXXGXXXXXXXXXXXXXXXXXXXGXXXXXXXXXXXXXXXXXXXGXXXXXXXXXXXXXXXXXXXXXXXXXXXXXXXXXXXXXXXGAXXXXXXXXXXXXXXXXXXGXXXXXXXXXXXXXXXXXXXXXXXXXXXXXXXXXXXXXXXGXXXXXXXXXXXXXXXXXXXGXXXXXXXXXXXXXXXXXXXGXXXXXXXXXXXXXXXXXXXGXXXXXXXXXXXXXXXXXXX,0,0,0

525,12,12,0,308,180,0,0,180,61,119,GXXXXXXXXXXXXXXXXXXXXXXXXXXXXXXXXXXXXXXXGXXXXXXXXXXXXXXXXXXXGXXXXXXXXXXXXXXXXXXXGXXXXXXXXXXXXXXXXXXXXXXXXXXXXXXXXXXXXXXXGAXXXXXXXXXXXXXXXXXXGXXXXXXXXXXXXXXXXXXXGXXXXXXXXXXXXXXXXXXXGXXXXXXXXXXXXXXXXXXXGXXXXXXXXXXXXXXXXXXXGXXXXXXXXXXXXXXXXXXXGXXXXXXXXXXXXXXXXXXX,0,0,0
546,13,13,0,337,150,0,0,150,72,78,GXXXXXXXXXXXXXXXXXXXGXXXXXXXXXXXXXXXXXXXGXXXXXXXXXXXXXXXXXXXGXXXXXXXXXXXXXXXXXXXGXXXXXXXXXXXXXXXXXXXXXXXXXXXXXXXXXXXXXXXGAXXXXXXXXXXXXXXXXXXGXXXXXXXXXXXXXXXXXXXGXXXXXXXXXXXXXXXXXXXGXXXXXXXXXXXXXXXXXXXGXXXXXXXXXXXXXXXXXXXGXXXXXXXXXXXXXXXXXXXGXXXXXXXXXXXXXXXXXXX,0,0,0
567,16,16,0,353,131,0,0,131,74,57,GXXXXXXXXXXXXXXXXXXXGXXXXXXXXXXXXXXXXXXXGAAXXXXXXXXXXXXXXXXXGXXXXXXXXXXXXXXXXXXXGXXXXXXXXXXXXXXXXXXXXXXXXXXXXXXXXXXXXXXXGAXXXXXXXXXXXXXXXXXXGXXXXXXXXXXXXXXXXXXXGXXXXXXXXXXXXXXXXXXXGXXXXXXXXXXXXXXXXXXXGXXXXXXXXXXXXXXXXXXXGXXXXXXXXXXXXXXXXXXXGAXXXXXXXXXXXXXXXXXX,0,0,0
588,16,15,1,364,120,0,0,120,83,37,GXXXXXXXXXXXXXXXXXXXGXXXXXXXXXXXXXXXXXXXGAAXXXXXXXXXXXXXXXXXGXXXXXXXXXXXXXXXXXXXGXXXXXXXXXXXXXXXXXXXXXXXXXXXXXXXXXXXXXXXGAXXXXXXXXXXXXXXXXXXGXXXXXXXXXXXXXXXXXXXGXXXXXXXXXXXXXXXXXXXGXXXXXXXXXXXXXXXXXXXGXXXXXXXXXXXXXXXXXXXGXXXXXXXXXXXXXXXXXXXGAXXXXXXXXXXXXXXXXXX,0,0,0
609,17,16,1,378,105,0,0,105,81,24,GXXXXXXXXXXXXXXXXXXXGXXXXXXXXXXXXXXXXXXXGAAXXXXXXXXXXXXXXXXXGXXXXXXXXXXXXXXXXXXXGXXXXXXXXXXXXXXXXXXXXXXXXXXXXXXXXXXXXXXXGAXXXXXXXXXXXXXXXXXXGXXXXXXXXXXXXXXXXXXXGXXXXXXXXXXXXXXXXXXXGXXXXXXXXXXXXXXXXXXXGXXXXXXXXXXXXXXXXXXXGAXXXXXXXXXXXXXXXXXXGAXXXXXXXXXXXXXXXXXX,0,0,0

630,17,13,4,380,103,0,0,103,68,35,GXXXXXXXXXXXXXXXXXXXGXXXXXXXXXXXXXXXXXXXGAAXXXXXXXXXXXXXXXXXGXXXXXXXXXXXXXXXXXXXGXXXXXXXXXXXXXXXXXXXXXXXXXXXXXXXXXXXXXXXGAXXXXXXXXXXXXXXXXXXGXXXXXXXXXXXXXXXXXXXGXXXXXXXXXXXXXXXXXXXGXXXXXXXXXXXXXXXXXXXGXXXXXXXXXXXXXXXXXXXGAXXXXXXXXXXXXXXXXXXGAXXXXXXXXXXXXXXXXXX,0,0,0
651,18,14,4,373,109,0,0,107,56,51,GXXXXXXXXXXXXXXXXXXXGXXXXXXXXXXXXXXXXXXXGAAXXXXXXXXXXXXXXXXXGXXXXXXXXXXXXXXXXXXXGXXXXXXXXXXXXXXXXXXXGXXXXXXXXXXXXXXXXXXXGAXXXXXXXXXXXXXXXXXXGXXXXXXXXXXXXXXXXXXXGXXXXXXXXXXXXXXXXXXXGXXXXXXXXXXXXXXXXXXXGXXXXXXXXXXXXXXXXXXXGAXXXXXXXXXXXXXXXXXXGAXXXXXXXXXXXXXXXXXX,0,0,0
672,18,12,6,371,111,0,0,109,46,63,GXXXXXXXXXXXXXXXXXXXGXXXXXXXXXXXXXXXXXXXGAAXXXXXXXXXXXXXXXXXGXXXXXXXXXXXXXXXXXXXGXXXXXXXXXXXXXXXXXXXGXXXXXXXXXXXXXXXXXXXGAXXXXXXXXXXXXXXXXXXGXXXXXXXXXXXXXXXXXXXGXXXXXXXXXXXXXXXXXXXGXXXXXXXXXXXXXXXXXXXGXXXXXXXXXXXXXXXXXXXGAXXXXXXXXXXXXXXXXXXGAXXXXXXXXXXXXXXXXXX,0,0,0
693,18,10,8,358,124,0,0,123,41,82,GXXXXXXXXXXXXXXXXXXXGXXXXXXXXXXXXXXXXXXXGAAXXXXXXXXXXXXXXXXXGXXXXXXXXXXXXXXXXXXXGXXXXXXXXXXXXXXXXXXXGXXXXXXXXXXXXXXXXXXXGAXXXXXXXXXXXXXXXXXXGXXXXXXXXXXXXXXXXXXXGXXXXXXXXXXXXXXXXXXXGXXXXXXXXXXXXXXXXXXXGXXXXXXXXXXXXXXXXXXXGAXXXXXXXXXXXXXXXXXXGOXXXXXXXXXXXXXXXXXX,0,0,0
714,18,8,10,338,144,0,0,144,37,107,GXXXXXXXXXXXXXXXXXXXGXXXXXXXXXXXXXXXXXXXGAOXXXXXXXXXXXXXXXXXGXXXXXXXXXXXXXXXXXXXGXXXXXXXXXXXXXXXXXXXGXXXXXXXXXXXXXXXXXXXGOXXXXXXXXXXXXXXXXXXGXXXXXXXXXXXXXXXXXXXGXXXXXXXXXXXXXXXXXXXGXXXXXXXXXXXXXXXXXXXGXXXXXXXXXXXXXXXXXXXGAXXXXXXXXXXXXXXXXXXGOXXXXXXXXXXXXXXXXXX,0,0,0

735,19,9,10,324,157,0,0,157,34,123,GXXXXXXXXXXXXXXXXXXXGXXXXXXXXXXXXXXXXXXXGAOXXXXXXXXXXXXXXXXXGAXXXXXXXXXXXXXXXXXXGXXXXXXXXXXXXXXXXXXXGXXXXXXXXXXXXXXXXXXXGOXXXXXXXXXXXXXXXXXXGXXXXXXXXXXXXXXXXXXXGXXXXXXXXXXXXXXXXXXXGXXXXXXXXXXXXXXXXXXXGXXXXXXXXXXXXXXXXXXXGAXXXXXXXXXXXXXXXXXXGOXXXXXXXXXXXXXXXXXX,0,0,0
756,19,7,12,305,176,0,0,175,31,144,GXXXXXXXXXXXXXXXXXXXGXXXXXXXXXXXXXXXXXXXGAOXXXXXXXXXXXXXXXXXGAXXXXXXXXXXXXXXXXXXGXXXXXXXXXXXXXXXXXXXGXXXXXXXXXXXXXXXXXXXGOXXXXXXXXXXXXXXXXXXGXXXXXXXXXXXXXXXXXXXGXXXXXXXXXXXXXXXXXXXGXXXXXXXXXXXXXXXXXXXGXXXXXXXXXXXXXXXXXXXGAXXXXXXXXXXXXXXXXXXGOXXXXXXXXXXXXXXXXXX,0,0,0
777,19,7,12,291,190,0,0,189,29,160,GXXXXXXXXXXXXXXXXXXXGXXXXXXXXXXXXXXXXXXXGAOXXXXXXXXXXXXXXXXXGAXXXXXXXXXXXXXXXXXXGXXXXXXXXXXXXXXXXXXXGXXXXXXXXXXXXXXXXXXXGOXXXXXXXXXXXXXXXXXXGXXXXXXXXXXXXXXXXXXXGXXXXXXXXXXXXXXXXXXXGXXXXXXXXXXXXXXXXXXXGXXXXXXXXXXXXXXXXXXXGAXXXXXXXXXXXXXXXXXXGOXXXXXXXXXXXXXXXXXX,0,0,0
798,21,8,13,262,217,0,0,216,29,187,GOXXXXXXXXXXXXXXXXXXGXXXXXXXXXXXXXXXXXXXGAOXXXXXXXXXXXXXXXXXGAXXXXXXXXXXXXXXXXXXGXXXXXXXXXXXXXXXXXXXGXXXXXXXXXXXXXXXXXXXGOXXXXXXXXXXXXXXXXXXGAXXXXXXXXXXXXXXXXXXGXXXXXXXXXXXXXXXXXXXGXXXXXXXXXXXXXXXXXXXGXXXXXXXXXXXXXXXXXXXGAXXXXXXXXXXXXXXXXXXGOXXXXXXXXXXXXXXXXXX,0,0,0
819,22,8,14,235,243,0,0,243,29,214,GOXXXXXXXXXXXXXXXXXXGXXXXXXXXXXXXXXXXXXXGAOXXXXXXXXXXXXXXXXXGAXXXXXXXXXXXXXXXXXXGXXXXXXXXXXXXXXXXXXXGXXXXXXXXXXXXXXXXXXXGOAXXXXXXXXXXXXXXXXXGAXXXXXXXXXXXXXXXXXXGXXXXXXXXXXXXXXXXXXXGXXXXXXXXXXXXXXXXXXXGXXXXXXXXXXXXXXXXXXXGAXXXXXXXXXXXXXXXXXXGOXXXXXXXXXXXXXXXXXX,0,0,0

840,22,6,16,216,262,0,0,261,27,234,GOXXXXXXXXXXXXXXXXXXGXXXXXXXXXXXXXXXXXXXGOOXXXXXXXXXXXXXXXXXGAXXXXXXXXXXXXXXXXXXGXXXXXXXXXXXXXXXXXXXGXXXXXXXXXXXXXXXXXXXGOAXXXXXXXXXXXXXXXXXGAXXXXXXXXXXXXXXXXXXGXXXXXXXXXXXXXXXXXXXGXXXXXXXXXXXXXXXXXXXGXXXXXXXXXXXXXXXXXXXGAXXXXXXXXXXXXXXXXXXGOXXXXXXXXXXXXXXXXXX,0,0,0
861,22,4,18,184,294,0,0,292,29,263,GOXXXXXXXXXXXXXXXXXXGXXXXXXXXXXXXXXXXXXXGOOXXXXXXXXXXXXXXXXXGAXXXXXXXXXXXXXXXXXXGXXXXXXXXXXXXXXXXXXXGXXXXXXXXXXXXXXXXXXXGOAXXXXXXXXXXXXXXXXXGAXXXXXXXXXXXXXXXXXXGXXXXXXXXXXXXXXXXXXXGXXXXXXXXXXXXXXXXXXXGXXXXXXXXXXXXXXXXXXXGAXXXXXXXXXXXXXXXXXXGOXXXXXXXXXXXXXXXXXX,0,0,0
882,23,5,18,161,316,0,0,316,27,289,GOXXXXXXXXXXXXXXXXXXGXXXXXXXXXXXXXXXXXXXGOOXXXXXXXXXXXXXXXXXGAXXXXXXXXXXXXXXXXXXGXXXXXXXXXXXXXXXXXXXGAXXXXXXXXXXXXXXXXXXGOAXXXXXXXXXXXXXXXXXGAXXXXXXXXXXXXXXXXXXGXXXXXXXXXXXXXXXXXXXGXXXXXXXXXXXXXXXXXXXGXXXXXXXXXXXXXXXXXXXGAXXXXXXXXXXXXXXXXXXGOXXXXXXXXXXXXXXXXXX,0,0,0
903,23,3,20,144,333,0,0,332,33,299,GOXXXXXXXXXXXXXXXXXXGXXXXXXXXXXXXXXXXXXXGOOXXXXXXXXXXXXXXXXXGOXXXXXXXXXXXXXXXXXXGXXXXXXXXXXXXXXXXXXXGAXXXXXXXXXXXXXXXXXXGOOXXXXXXXXXXXXXXXXXGAXXXXXXXXXXXXXXXXXXGXXXXXXXXXXXXXXXXXXXGXXXXXXXXXXXXXXXXXXXGXXXXXXXXXXXXXXXXXXXGAXXXXXXXXXXXXXXXXXXGOXXXXXXXXXXXXXXXXXX,0,0,0
924,23,3,20,141,336,0,0,336,29,307,GOXXXXXXXXXXXXXXXXXXGXXXXXXXXXXXXXXXXXXXGOOXXXXXXXXXXXXXXXXXGOXXXXXXXXXXXXXXXXXXGXXXXXXXXXXXXXXXXXXXGAXXXXXXXXXXXXXXXXXXGOOXXXXXXXXXXXXXXXXXGAXXXXXXXXXXXXXXXXXXGXXXXXXXXXXXXXXXXXXXGXXXXXXXXXXXXXXXXXXXGXXXXXXXXXXXXXXXXXXXGAXXXXXXXXXXXXXXXXXXGOXXXXXXXXXXXXXXXXXX,0,0,0

945,24,2,22,126,350,0,0,349,28,321,GOXXXXXXXXXXXXXXXXXXGXXXXXXXXXXXXXXXXXXXGOOXXXXXXXXXXXXXXXXXGOAXXXXXXXXXXXXXXXXXGXXXXXXXXXXXXXXXXXXXGAXXXXXXXXXXXXXXXXXXGOOXXXXXXXXXXXXXXXXXGOXXXXXXXXXXXXXXXXXXGXXXXXXXXXXXXXXXXXXXGXXXXXXXXXXXXXXXXXXXGXXXXXXXXXXXXXXXXXXXGOXXXXXXXXXXXXXXXXXXGOXXXXXXXXXXXXXXXXXX,0,0,0
966,24,2,22,113,363,0,0,362,33,329,GOXXXXXXXXXXXXXXXXXXGXXXXXXXXXXXXXXXXXXXGOOXXXXXXXXXXXXXXXXXGOAXXXXXXXXXXXXXXXXXGXXXXXXXXXXXXXXXXXXXGAXXXXXXXXXXXXXXXXXXGOOXXXXXXXXXXXXXXXXXGOXXXXXXXXXXXXXXXXXXGXXXXXXXXXXXXXXXXXXXGXXXXXXXXXXXXXXXXXXXGXXXXXXXXXXXXXXXXXXXGOXXXXXXXXXXXXXXXXXXGOXXXXXXXXXXXXXXXXXX,0,0,0
987,24,1,23,105,371,0,0,370,32,338,GOXXXXXXXXXXXXXXXXXXGXXXXXXXXXXXXXXXXXXXGOOXXXXXXXXXXXXXXXXXGOOXXXXXXXXXXXXXXXXXGXXXXXXXXXXXXXXXXXXXGAXXXXXXXXXXXXXXXXXXGOOXXXXXXXXXXXXXXXXXGOXXXXXXXXXXXXXXXXXXGXXXXXXXXXXXXXXXXXXXGXXXXXXXXXXXXXXXXXXXGXXXXXXXXXXXXXXXXXXXGOXXXXXXXXXXXXXXXXXXGOXXXXXXXXXXXXXXXXXX,0,0,0
1008,24,1,23,98,378,0,0,377,35,342,GOXXXXXXXXXXXXXXXXXXGXXXXXXXXXXXXXXXXXXXGOOXXXXXXXXXXXXXXXXXGOOXXXXXXXXXXXXXXXXXGXXXXXXXXXXXXXXXXXXXGAXXXXXXXXXXXXXXXXXXGOOXXXXXXXXXXXXXXXXXGOXXXXXXXXXXXXXXXXXXGXXXXXXXXXXXXXXXXXXXGXXXXXXXXXXXXXXXXXXXGXXXXXXXXXXXXXXXXXXXGOXXXXXXXXXXXXXXXXXXGOXXXXXXXXXXXXXXXXXX,0,0,0
1029,24,1,23,98,378,0,0,377,34,343,GOXXXXXXXXXXXXXXXXXXGXXXXXXXXXXXXXXXXXXXGOOXXXXXXXXXXXXXXXXXGOOXXXXXXXXXXXXXXXXXGXXXXXXXXXXXXXXXXXXXGAXXXXXXXXXXXXXXXXXXGOOXXXXXXXXXXXXXXXXXGOXXXXXXXXXXXXXXXXXXGXXXXXXXXXXXXXXXXXXXGXXXXXXXXXXXXXXXXXXXGXXXXXXXXXXXXXXXXXXXGOXXXXXXXXXXXXXXXXXXGOXXXXXXXXXXXXXXXXXX,0,0,0

1050,24,1,23,99,377,0,0,374,39,335,GOXXXXXXXXXXXXXXXXXXGXXXXXXXXXXXXXXXXXXXGOOXXXXXXXXXXXXXXXXXGOOXXXXXXXXXXXXXXXXXGXXXXXXXXXXXXXXXXXXXGAXXXXXXXXXXXXXXXXXXGOOXXXXXXXXXXXXXXXXXGOXXXXXXXXXXXXXXXXXXGXXXXXXXXXXXXXXXXXXXGXXXXXXXXXXXXXXXXXXXGXXXXXXXXXXXXXXXXXXXGOXXXXXXXXXXXXXXXXXXGOXXXXXXXXXXXXXXXXXX,0,0,0
1071,24,1,23,105,371,0,0,370,38,332,GOXXXXXXXXXXXXXXXXXXGXXXXXXXXXXXXXXXXXXXGOOXXXXXXXXXXXXXXXXXGOOXXXXXXXXXXXXXXXXXGXXXXXXXXXXXXXXXXXXXGAXXXXXXXXXXXXXXXXXXGOOXXXXXXXXXXXXXXXXXGOXXXXXXXXXXXXXXXXXXGXXXXXXXXXXXXXXXXXXXGXXXXXXXXXXXXXXXXXXXGXXXXXXXXXXXXXXXXXXXGOXXXXXXXXXXXXXXXXXXGOXXXXXXXXXXXXXXXXXX,0,0,0
1092,24,0,24,114,362,0,0,361,42,319,GOXXXXXXXXXXXXXXXXXXGXXXXXXXXXXXXXXXXXXXGOOXXXXXXXXXXXXXXXXXGOOXXXXXXXXXXXXXXXXXGXXXXXXXXXXXXXXXXXXXGOXXXXXXXXXXXXXXXXXXGOOXXXXXXXXXXXXXXXXXGOXXXXXXXXXXXXXXXXXXGXXXXXXXXXXXXXXXXXXXGXXXXXXXXXXXXXXXXXXXGXXXXXXXXXXXXXXXXXXXGOXXXXXXXXXXXXXXXXXXGOXXXXXXXXXXXXXXXXXX,0,0,0
1113,24,0,24,116,360,0,0,360,39,321,GOXXXXXXXXXXXXXXXXXXGXXXXXXXXXXXXXXXXXXXGOOXXXXXXXXXXXXXXXXXGOOXXXXXXXXXXXXXXXXXGXXXXXXXXXXXXXXXXXXXGOXXXXXXXXXXXXXXXXXXGOOXXXXXXXXXXXXXXXXXGOXXXXXXXXXXXXXXXXXXGXXXXXXXXXXXXXXXXXXXGXXXXXXXXXXXXXXXXXXXGXXXXXXXXXXXXXXXXXXXGOXXXXXXXXXXXXXXXXXXGOXXXXXXXXXXXXXXXXXX,0,0,0
1134,24,0,24,119,357,0,0,357,44,313,GOXXXXXXXXXXXXXXXXXXGXXXXXXXXXXXXXXXXXXXGOOXXXXXXXXXXXXXXXXXGOOXXXXXXXXXXXXXXXXXGXXXXXXXXXXXXXXXXXXXGOXXXXXXXXXXXXXXXXXXGOOXXXXXXXXXXXXXXXXXGOXXXXXXXXXXXXXXXXXXGXXXXXXXXXXXXXXXXXXXGXXXXXXXXXXXXXXXXXXXGXXXXXXXXXXXXXXXXXXXGOXXXXXXXXXXXXXXXXXXGOXXXXXXXXXXXXXXXXXX,0,0,0

1155,24,0,24,132,344,0,0,344,47,297,GOXXXXXXXXXXXXXXXXXXGXXXXXXXXXXXXXXXXXXXGOOXXXXXXXXXXXXXXXXXGOOXXXXXXXXXXXXXXXXXGXXXXXXXXXXXXXXXXXXXGOXXXXXXXXXXXXXXXXXXGOOXXXXXXXXXXXXXXXXXGOXXXXXXXXXXXXXXXXXXGXXXXXXXXXXXXXXXXXXXGXXXXXXXXXXXXXXXXXXXGXXXXXXXXXXXXXXXXXXXGOXXXXXXXXXXXXXXXXXXGOXXXXXXXXXXXXXXXXXX,0,0,0
1176,24,0,24,143,333,0,0,333,46,287,GOXXXXXXXXXXXXXXXXXXGXXXXXXXXXXXXXXXXXXXGOOXXXXXXXXXXXXXXXXXGOOXXXXXXXXXXXXXXXXXGXXXXXXXXXXXXXXXXXXXGOXXXXXXXXXXXXXXXXXXGOOXXXXXXXXXXXXXXXXXGOXXXXXXXXXXXXXXXXXXGXXXXXXXXXXXXXXXXXXXGXXXXXXXXXXXXXXXXXXXGXXXXXXXXXXXXXXXXXXXGOXXXXXXXXXXXXXXXXXXGOXXXXXXXXXXXXXXXXXX,0,0,0
1197,24,0,24,150,326,0,0,326,44,282,GOXXXXXXXXXXXXXXXXXXGXXXXXXXXXXXXXXXXXXXGOOXXXXXXXXXXXXXXXXXGOOXXXXXXXXXXXXXXXXXGXXXXXXXXXXXXXXXXXXXGOXXXXXXXXXXXXXXXXXXGOOXXXXXXXXXXXXXXXXXGOXXXXXXXXXXXXXXXXXXGXXXXXXXXXXXXXXXXXXXGXXXXXXXXXXXXXXXXXXXGXXXXXXXXXXXXXXXXXXXGOXXXXXXXXXXXXXXXXXXGOXXXXXXXXXXXXXXXXXX,0,0,0
1218,24,0,24,165,311,0,0,311,55,256,GOXXXXXXXXXXXXXXXXXXGXXXXXXXXXXXXXXXXXXXGOOXXXXXXXXXXXXXXXXXGOOXXXXXXXXXXXXXXXXXGXXXXXXXXXXXXXXXXXXXGOXXXXXXXXXXXXXXXXXXGOOXXXXXXXXXXXXXXXXXGOXXXXXXXXXXXXXXXXXXGXXXXXXXXXXXXXXXXXXXGXXXXXXXXXXXXXXXXXXXGXXXXXXXXXXXXXXXXXXXGOXXXXXXXXXXXXXXXXXXGOXXXXXXXXXXXXXXXXXX,0,0,0
1239,24,0,24,169,307,0,0,307,52,255,GOXXXXXXXXXXXXXXXXXXGXXXXXXXXXXXXXXXXXXXGOOXXXXXXXXXXXXXXXXXGOOXXXXXXXXXXXXXXXXXGXXXXXXXXXXXXXXXXXXXGOXXXXXXXXXXXXXXXXXXGOOXXXXXXXXXXXXXXXXXGOXXXXXXXXXXXXXXXXXXGXXXXXXXXXXXXXXXXXXXGXXXXXXXXXXXXXXXXXXXGXXXXXXXXXXXXXXXXXXXGOXXXXXXXXXXXXXXXXXXGOXXXXXXXXXXXXXXXXXX,0,0,0

1260,24,0,24,169,307,0,0,306,49,257,GOXXXXXXXXXXXXXXXXXXGXXXXXXXXXXXXXXXXXXXGOOXXXXXXXXXXXXXXXXXGOOXXXXXXXXXXXXXXXXXGXXXXXXXXXXXXXXXXXXXGOXXXXXXXXXXXXXXXXXXGOOXXXXXXXXXXXXXXXXXGOXXXXXXXXXXXXXXXXXXGXXXXXXXXXXXXXXXXXXXGXXXXXXXXXXXXXXXXXXXGXXXXXXXXXXXXXXXXXXXGOXXXXXXXXXXXXXXXXXXGOXXXXXXXXXXXXXXXXXX,0,0,0
1281,24,0,24,170,306,0,0,306,51,255,GOXXXXXXXXXXXXXXXXXXGXXXXXXXXXXXXXXXXXXXGOOXXXXXXXXXXXXXXXXXGOOXXXXXXXXXXXXXXXXXGXXXXXXXXXXXXXXXXXXXGOXXXXXXXXXXXXXXXXXXGOOXXXXXXXXXXXXXXXXXGOXXXXXXXXXXXXXXXXXXGXXXXXXXXXXXXXXXXXXXGXXXXXXXXXXXXXXXXXXXGXXXXXXXXXXXXXXXXXXXGOXXXXXXXXXXXXXXXXXXGOXXXXXXXXXXXXXXXXXX,0,0,0
1302,24,0,24,176,300,0,0,300,49,251,GOXXXXXXXXXXXXXXXXXXGXXXXXXXXXXXXXXXXXXXGOOXXXXXXXXXXXXXXXXXGOOXXXXXXXXXXXXXXXXXGXXXXXXXXXXXXXXXXXXXGOXXXXXXXXXXXXXXXXXXGOOXXXXXXXXXXXXXXXXXGOXXXXXXXXXXXXXXXXXXGXXXXXXXXXXXXXXXXXXXGXXXXXXXXXXXXXXXXXXXGXXXXXXXXXXXXXXXXXXXGOXXXXXXXXXXXXXXXXXXGOXXXXXXXXXXXXXXXXXX,0,0,0
1323,24,0,24,176,300,0,0,299,47,252,GOXXXXXXXXXXXXXXXXXXGXXXXXXXXXXXXXXXXXXXGOOXXXXXXXXXXXXXXXXXGOOXXXXXXXXXXXXXXXXXGXXXXXXXXXXXXXXXXXXXGOXXXXXXXXXXXXXXXXXXGOOXXXXXXXXXXXXXXXXXGOXXXXXXXXXXXXXXXXXXGXXXXXXXXXXXXXXXXXXXGXXXXXXXXXXXXXXXXXXXGXXXXXXXXXXXXXXXXXXXGOXXXXXXXXXXXXXXXXXXGOXXXXXXXXXXXXXXXXXX,0,0,0
1344,25,1,24,180,295,0,0,295,53,242,GOXXXXXXXXXXXXXXXXXXGXXXXXXXXXXXXXXXXXXXGOOXXXXXXXXXXXXXXXXXGOOXXXXXXXXXXXXXXXXXGXXXXXXXXXXXXXXXXXXXGOXXXXXXXXXXXXXXXXXXGOOXXXXXXXXXXXXXXXXXGOXXXXXXXXXXXXXXXXXXGXXXXXXXXXXXXXXXXXXXGXXXXXXXXXXXXXXXXXXXGXXXXXXXXXXXXXXXXXXXGOXXXXXXXXXXXXXXXXXXGOAXXXXXXXXXXXXXXXXX,0,0,0

1365,25,1,24,187,288,0,0,288,54,234,GOXXXXXXXXXXXXXXXXXXGXXXXXXXXXXXXXXXXXXXGOOXXXXXXXXXXXXXXXXXGOOXXXXXXXXXXXXXXXXXGXXXXXXXXXXXXXXXXXXXGOXXXXXXXXXXXXXXXXXXGOOXXXXXXXXXXXXXXXXXGOXXXXXXXXXXXXXXXXXXGXXXXXXXXXXXXXXXXXXXGXXXXXXXXXXXXXXXXXXXGXXXXXXXXXXXXXXXXXXXGOXXXXXXXXXXXXXXXXXXGOAXXXXXXXXXXXXXXXXX,0,0,0
1386,25,1,24,186,289,0,0,291,52,239,GOXXXXXXXXXXXXXXXXXXGXXXXXXXXXXXXXXXXXXXGOOXXXXXXXXXXXXXXXXXGOOXXXXXXXXXXXXXXXXXGXXXXXXXXXXXXXXXXXXXGOXXXXXXXXXXXXXXXXXXGOOXXXXXXXXXXXXXXXXXGOXXXXXXXXXXXXXXXXXXGXXXXXXXXXXXXXXXXXXXGXXXXXXXXXXXXXXXXXXXGXXXXXXXXXXXXXXXXXXXGOXXXXXXXXXXXXXXXXXXGOAXXXXXXXXXXXXXXXXX,0,0,0
1407,25,1,24,172,303,0,0,304,56,248,GOXXXXXXXXXXXXXXXXXXGXXXXXXXXXXXXXXXXXXXGOOXXXXXXXXXXXXXXXXXGOOXXXXXXXXXXXXXXXXXGXXXXXXXXXXXXXXXXXXXGOXXXXXXXXXXXXXXXXXXGOOXXXXXXXXXXXXXXXXXGOXXXXXXXXXXXXXXXXXXGXXXXXXXXXXXXXXXXXXXGXXXXXXXXXXXXXXXXXXXGXXXXXXXXXXXXXXXXXXXGOXXXXXXXXXXXXXXXXXXGOAXXXXXXXXXXXXXXXXX,0,0,0
1428,25,1,24,166,309,0,0,311,57,254,GOXXXXXXXXXXXXXXXXXXGXXXXXXXXXXXXXXXXXXXGOOXXXXXXXXXXXXXXXXXGOOXXXXXXXXXXXXXXXXXGXXXXXXXXXXXXXXXXXXXGOXXXXXXXXXXXXXXXXXXGOOXXXXXXXXXXXXXXXXXGOXXXXXXXXXXXXXXXXXXGXXXXXXXXXXXXXXXXXXXGXXXXXXXXXXXXXXXXXXXGXXXXXXXXXXXXXXXXXXXGOXXXXXXXXXXXXXXXXXXGOAXXXXXXXXXXXXXXXXX,0,0,0
1449,25,1,24,168,307,0,0,308,62,246,GOXXXXXXXXXXXXXXXXXXGXXXXXXXXXXXXXXXXXXXGOOXXXXXXXXXXXXXXXXXGOOXXXXXXXXXXXXXXXXXGXXXXXXXXXXXXXXXXXXXGOXXXXXXXXXXXXXXXXXXGOOXXXXXXXXXXXXXXXXXGOXXXXXXXXXXXXXXXXXXGXXXXXXXXXXXXXXXXXXXGXXXXXXXXXXXXXXXXXXXGXXXXXXXXXXXXXXXXXXXGOXXXXXXXXXXXXXXXXXXGOAXXXXXXXXXXXXXXXXX,0,0,0

1470,25,1,24,165,310,0,0,311,53,258,GOXXXXXXXXXXXXXXXXXXGXXXXXXXXXXXXXXXXXXXGOOXXXXXXXXXXXXXXXXXGOOXXXXXXXXXXXXXXXXXGXXXXXXXXXXXXXXXXXXXGOXXXXXXXXXXXXXXXXXXGOOXXXXXXXXXXXXXXXXXGOXXXXXXXXXXXXXXXXXXGXXXXXXXXXXXXXXXXXXXGXXXXXXXXXXXXXXXXXXXGXXXXXXXXXXXXXXXXXXXGOXXXXXXXXXXXXXXXXXXGOAXXXXXXXXXXXXXXXXX,0,0,0
1491,25,1,24,157,318,0,0,319,53,266,GOXXXXXXXXXXXXXXXXXXGXXXXXXXXXXXXXXXXXXXGOOXXXXXXXXXXXXXXXXXGOOXXXXXXXXXXXXXXXXXGXXXXXXXXXXXXXXXXXXXGOXXXXXXXXXXXXXXXXXXGOOXXXXXXXXXXXXXXXXXGOXXXXXXXXXXXXXXXXXXGXXXXXXXXXXXXXXXXXXXGXXXXXXXXXXXXXXXXXXXGXXXXXXXXXXXXXXXXXXXGOXXXXXXXXXXXXXXXXXXGOAXXXXXXXXXXXXXXXXX,0,0,0
1512,25,1,24,161,314,0,0,315,54,261,GOXXXXXXXXXXXXXXXXXXGXXXXXXXXXXXXXXXXXXXGOOXXXXXXXXXXXXXXXXXGOOXXXXXXXXXXXXXXXXXGXXXXXXXXXXXXXXXXXXXGOXXXXXXXXXXXXXXXXXXGOOXXXXXXXXXXXXXXXXXGOXXXXXXXXXXXXXXXXXXGXXXXXXXXXXXXXXXXXXXGXXXXXXXXXXXXXXXXXXXGXXXXXXXXXXXXXXXXXXXGOXXXXXXXXXXXXXXXXXXGOAXXXXXXXXXXXXXXXXX,0,0,0
1533,26,2,24,162,312,0,0,311,55,256,GOXXXXXXXXXXXXXXXXXXGXXXXXXXXXXXXXXXXXXXGOOAXXXXXXXXXXXXXXXXGOOXXXXXXXXXXXXXXXXXGXXXXXXXXXXXXXXXXXXXGOXXXXXXXXXXXXXXXXXXGOOXXXXXXXXXXXXXXXXXGOXXXXXXXXXXXXXXXXXXGXXXXXXXXXXXXXXXXXXXGXXXXXXXXXXXXXXXXXXXGXXXXXXXXXXXXXXXXXXXGOXXXXXXXXXXXXXXXXXXGOAXXXXXXXXXXXXXXXXX,0,0,0
1554,26,1,25,158,316,0,0,314,52,262,GOXXXXXXXXXXXXXXXXXXGXXXXXXXXXXXXXXXXXXXGOOOXXXXXXXXXXXXXXXXGOOXXXXXXXXXXXXXXXXXGXXXXXXXXXXXXXXXXXXXGOXXXXXXXXXXXXXXXXXXGOOXXXXXXXXXXXXXXXXXGOXXXXXXXXXXXXXXXXXXGXXXXXXXXXXXXXXXXXXXGXXXXXXXXXXXXXXXXXXXGXXXXXXXXXXXXXXXXXXXGOXXXXXXXXXXXXXXXXXXGOAXXXXXXXXXXXXXXXXX,0,0,0

1575,26,1,25,154,320,0,0,319,61,258,GOXXXXXXXXXXXXXXXXXXGXXXXXXXXXXXXXXXXXXXGOOOXXXXXXXXXXXXXXXXGOOXXXXXXXXXXXXXXXXXGXXXXXXXXXXXXXXXXXXXGOXXXXXXXXXXXXXXXXXXGOOXXXXXXXXXXXXXXXXXGOXXXXXXXXXXXXXXXXXXGXXXXXXXXXXXXXXXXXXXGXXXXXXXXXXXXXXXXXXXGXXXXXXXXXXXXXXXXXXXGOXXXXXXXXXXXXXXXXXXGOAXXXXXXXXXXXXXXXXX,0,0,0
1596,26,1,25,152,322,0,0,322,59,263,GOXXXXXXXXXXXXXXXXXXGXXXXXXXXXXXXXXXXXXXGOOOXXXXXXXXXXXXXXXXGOOXXXXXXXXXXXXXXXXXGXXXXXXXXXXXXXXXXXXXGOXXXXXXXXXXXXXXXXXXGOOXXXXXXXXXXXXXXXXXGOXXXXXXXXXXXXXXXXXXGXXXXXXXXXXXXXXXXXXXGXXXXXXXXXXXXXXXXXXXGXXXXXXXXXXXXXXXXXXXGOXXXXXXXXXXXXXXXXXXGOAXXXXXXXXXXXXXXXXX,0,0,0
1617,26,1,25,146,328,0,0,328,59,269,GOXXXXXXXXXXXXXXXXXXGXXXXXXXXXXXXXXXXXXXGOOOXXXXXXXXXXXXXXXXGOOXXXXXXXXXXXXXXXXXGXXXXXXXXXXXXXXXXXXXGOXXXXXXXXXXXXXXXXXXGOOXXXXXXXXXXXXXXXXXGOXXXXXXXXXXXXXXXXXXGXXXXXXXXXXXXXXXXXXXGXXXXXXXXXXXXXXXXXXXGXXXXXXXXXXXXXXXXXXXGOXXXXXXXXXXXXXXXXXXGOAXXXXXXXXXXXXXXXXX,0,0,0
1638,26,0,26,141,333,0,0,333,58,275,GOXXXXXXXXXXXXXXXXXXGXXXXXXXXXXXXXXXXXXXGOOOXXXXXXXXXXXXXXXXGOOXXXXXXXXXXXXXXXXXGXXXXXXXXXXXXXXXXXXXGOXXXXXXXXXXXXXXXXXXGOOXXXXXXXXXXXXXXXXXGOXXXXXXXXXXXXXXXXXXGXXXXXXXXXXXXXXXXXXXGXXXXXXXXXXXXXXXXXXXGXXXXXXXXXXXXXXXXXXXGOXXXXXXXXXXXXXXXXXXGOOXXXXXXXXXXXXXXXXX,0,0,0
1659,26,0,26,137,337,0,0,337,57,280,GOXXXXXXXXXXXXXXXXXXGXXXXXXXXXXXXXXXXXXXGOOOXXXXXXXXXXXXXXXXGOOXXXXXXXXXXXXXXXXXGXXXXXXXXXXXXXXXXXXXGOXXXXXXXXXXXXXXXXXXGOOXXXXXXXXXXXXXXXXXGOXXXXXXXXXXXXXXXXXXGXXXXXXXXXXXXXXXXXXXGXXXXXXXXXXXXXXXXXXXGXXXXXXXXXXXXXXXXXXXGOXXXXXXXXXXXXXXXXXXGOOXXXXXXXXXXXXXXXXX,0,0,0

1680,26,0,26,132,342,0,0,344,64,280,GOXXXXXXXXXXXXXXXXXXGXXXXXXXXXXXXXXXXXXXGOOOXXXXXXXXXXXXXXXXGOOXXXXXXXXXXXXXXXXXGXXXXXXXXXXXXXXXXXXXGOXXXXXXXXXXXXXXXXXXGOOXXXXXXXXXXXXXXXXXGOXXXXXXXXXXXXXXXXXXGXXXXXXXXXXXXXXXXXXXGXXXXXXXXXXXXXXXXXXXGXXXXXXXXXXXXXXXXXXXGOXXXXXXXXXXXXXXXXXXGOOXXXXXXXXXXXXXXXXX,0,0,0
1701,26,0,26,143,331,0,0,333,66,267,GOXXXXXXXXXXXXXXXXXXGXXXXXXXXXXXXXXXXXXXGOOOXXXXXXXXXXXXXXXXGOOXXXXXXXXXXXXXXXXXGXXXXXXXXXXXXXXXXXXXGOXXXXXXXXXXXXXXXXXXGOOXXXXXXXXXXXXXXXXXGOXXXXXXXXXXXXXXXXXXGXXXXXXXXXXXXXXXXXXXGXXXXXXXXXXXXXXXXXXXGXXXXXXXXXXXXXXXXXXXGOXXXXXXXXXXXXXXXXXXGOOXXXXXXXXXXXXXXXXX,0,0,0
1722,26,0,26,140,334,0,0,338,68,270,GOXXXXXXXXXXXXXXXXXXGXXXXXXXXXXXXXXXXXXXGOOOXXXXXXXXXXXXXXXXGOOXXXXXXXXXXXXXXXXXGXXXXXXXXXXXXXXXXXXXGOXXXXXXXXXXXXXXXXXXGOOXXXXXXXXXXXXXXXXXGOXXXXXXXXXXXXXXXXXXGXXXXXXXXXXXXXXXXXXXGXXXXXXXXXXXXXXXXXXXGXXXXXXXXXXXXXXXXXXXGOXXXXXXXXXXXXXXXXXXGOOXXXXXXXXXXXXXXXXX,0,0,0
1743,26,0,26,139,335,0,0,340,62,278,GOXXXXXXXXXXXXXXXXXXGXXXXXXXXXXXXXXXXXXXGOOOXXXXXXXXXXXXXXXXGOOXXXXXXXXXXXXXXXXXGXXXXXXXXXXXXXXXXXXXGOXXXXXXXXXXXXXXXXXXGOOXXXXXXXXXXXXXXXXXGOXXXXXXXXXXXXXXXXXXGXXXXXXXXXXXXXXXXXXXGXXXXXXXXXXXXXXXXXXXGXXXXXXXXXXXXXXXXXXXGOXXXXXXXXXXXXXXXXXXGOOXXXXXXXXXXXXXXXXX,0,0,0
1764,26,0,26,143,331,0,0,335,59,276,GOXXXXXXXXXXXXXXXXXXGXXXXXXXXXXXXXXXXXXXGOOOXXXXXXXXXXXXXXXXGOOXXXXXXXXXXXXXXXXXGXXXXXXXXXXXXXXXXXXXGOXXXXXXXXXXXXXXXXXXGOOXXXXXXXXXXXXXXXXXGOXXXXXXXXXXXXXXXXXXGXXXXXXXXXXXXXXXXXXXGXXXXXXXXXXXXXXXXXXXGXXXXXXXXXXXXXXXXXXXGOXXXXXXXXXXXXXXXXXXGOOXXXXXXXXXXXXXXXXX,0,0,0

1785,26,0,26,139,335,0,0,343,65,278,GOXXXXXXXXXXXXXXXXXXGXXXXXXXXXXXXXXXXXXXGOOOXXXXXXXXXXXXXXXXGOOXXXXXXXXXXXXXXXXXGXXXXXXXXXXXXXXXXXXXGOXXXXXXXXXXXXXXXXXXGOOXXXXXXXXXXXXXXXXXGOXXXXXXXXXXXXXXXXXXGXXXXXXXXXXXXXXXXXXXGXXXXXXXXXXXXXXXXXXXGXXXXXXXXXXXXXXXXXXXGOXXXXXXXXXXXXXXXXXXGOOXXXXXXXXXXXXXXXXX,0,0,0
1806,26,0,26,147,327,0,0,333,69,264,GOXXXXXXXXXXXXXXXXXXGXXXXXXXXXXXXXXXXXXXGOOOXXXXXXXXXXXXXXXXGOOXXXXXXXXXXXXXXXXXGXXXXXXXXXXXXXXXXXXXGOXXXXXXXXXXXXXXXXXXGOOXXXXXXXXXXXXXXXXXGOXXXXXXXXXXXXXXXXXXGXXXXXXXXXXXXXXXXXXXGXXXXXXXXXXXXXXXXXXXGXXXXXXXXXXXXXXXXXXXGOXXXXXXXXXXXXXXXXXXGOOXXXXXXXXXXXXXXXXX,0,0,0
1827,27,1,26,151,322,0,0,329,73,256,GOXXXXXXXXXXXXXXXXXXGXXXXXXXXXXXXXXXXXXXGOOOXXXXXXXXXXXXXXXXGOOXXXXXXXXXXXXXXXXXGXXXXXXXXXXXXXXXXXXXGOXXXXXXXXXXXXXXXXXXGOOXXXXXXXXXXXXXXXXXGOXXXXXXXXXXXXXXXXXXGXXXXXXXXXXXXXXXXXXXGXXXXXXXXXXXXXXXXXXXGAXXXXXXXXXXXXXXXXXXGOXXXXXXXXXXXXXXXXXXGOOXXXXXXXXXXXXXXXXX,0,0,0
1848,27,1,26,157,316,0,0,324,67,257,GOXXXXXXXXXXXXXXXXXXGXXXXXXXXXXXXXXXXXXXGOOOXXXXXXXXXXXXXXXXGOOXXXXXXXXXXXXXXXXXGXXXXXXXXXXXXXXXXXXXGOXXXXXXXXXXXXXXXXXXGOOXXXXXXXXXXXXXXXXXGOXXXXXXXXXXXXXXXXXXGXXXXXXXXXXXXXXXXXXXGXXXXXXXXXXXXXXXXXXXGAXXXXXXXXXXXXXXXXXXGOXXXXXXXXXXXXXXXXXXGOOXXXXXXXXXXXXXXXXX,0,0,0
1869,27,0,27,156,317,0,0,325,72,253,GOXXXXXXXXXXXXXXXXXXGXXXXXXXXXXXXXXXXXXXGOOOXXXXXXXXXXXXXXXXGOOXXXXXXXXXXXXXXXXXGXXXXXXXXXXXXXXXXXXXGOXXXXXXXXXXXXXXXXXXGOOXXXXXXXXXXXXXXXXXGOXXXXXXXXXXXXXXXXXXGXXXXXXXXXXXXXXXXXXXGXXXXXXXXXXXXXXXXXXXGOXXXXXXXXXXXXXXXXXXGOXXXXXXXXXXXXXXXXXXGOOXXXXXXXXXXXXXXXXX,0,0,0

1890,27,0,27,154,319,0,0,327,75,252,GOXXXXXXXXXXXXXXXXXXGXXXXXXXXXXXXXXXXXXXGOOOXXXXXXXXXXXXXXXXGOOXXXXXXXXXXXXXXXXXGXXXXXXXXXXXXXXXXXXXGOXXXXXXXXXXXXXXXXXXGOOXXXXXXXXXXXXXXXXXGOXXXXXXXXXXXXXXXXXXGXXXXXXXXXXXXXXXXXXXGXXXXXXXXXXXXXXXXXXXGOXXXXXXXXXXXXXXXXXXGOXXXXXXXXXXXXXXXXXXGOOXXXXXXXXXXXXXXXXX,0,0,0
1911,27,0,27,159,314,0,0,321,72,249,GOXXXXXXXXXXXXXXXXXXGXXXXXXXXXXXXXXXXXXXGOOOXXXXXXXXXXXXXXXXGOOXXXXXXXXXXXXXXXXXGXXXXXXXXXXXXXXXXXXXGOXXXXXXXXXXXXXXXXXXGOOXXXXXXXXXXXXXXXXXGOXXXXXXXXXXXXXXXXXXGXXXXXXXXXXXXXXXXXXXGXXXXXXXXXXXXXXXXXXXGOXXXXXXXXXXXXXXXXXXGOXXXXXXXXXXXXXXXXXXGOOXXXXXXXXXXXXXXXXX,0,0,0
1932,27,0,27,170,303,0,0,309,68,241,GOXXXXXXXXXXXXXXXXXXGXXXXXXXXXXXXXXXXXXXGOOOXXXXXXXXXXXXXXXXGOOXXXXXXXXXXXXXXXXXGXXXXXXXXXXXXXXXXXXXGOXXXXXXXXXXXXXXXXXXGOOXXXXXXXXXXXXXXXXXGOXXXXXXXXXXXXXXXXXXGXXXXXXXXXXXXXXXXXXXGXXXXXXXXXXXXXXXXXXXGOXXXXXXXXXXXXXXXXXXGOXXXXXXXXXXXXXXXXXXGOOXXXXXXXXXXXXXXXXX,0,0,0
1953,27,0,27,165,308,0,0,316,66,250,GOXXXXXXXXXXXXXXXXXXGXXXXXXXXXXXXXXXXXXXGOOOXXXXXXXXXXXXXXXXGOOXXXXXXXXXXXXXXXXXGXXXXXXXXXXXXXXXXXXXGOXXXXXXXXXXXXXXXXXXGOOXXXXXXXXXXXXXXXXXGOXXXXXXXXXXXXXXXXXXGXXXXXXXXXXXXXXXXXXXGXXXXXXXXXXXXXXXXXXXGOXXXXXXXXXXXXXXXXXXGOXXXXXXXXXXXXXXXXXXGOOXXXXXXXXXXXXXXXXX,0,0,0
1974,27,0,27,156,317,0,0,325,77,248,GOXXXXXXXXXXXXXXXXXXGXXXXXXXXXXXXXXXXXXXGOOOXXXXXXXXXXXXXXXXGOOXXXXXXXXXXXXXXXXXGXXXXXXXXXXXXXXXXXXXGOXXXXXXXXXXXXXXXXXXGOOXXXXXXXXXXXXXXXXXGOXXXXXXXXXXXXXXXXXXGXXXXXXXXXXXXXXXXXXXGXXXXXXXXXXXXXXXXXXXGOXXXXXXXXXXXXXXXXXXGOXXXXXXXXXXXXXXXXXXGOOXXXXXXXXXXXXXXXXX,0,0,0

1995,27,0,27,165,308,0,0,316,79,237,GOXXXXXXXXXXXXXXXXXXGXXXXXXXXXXXXXXXXXXXGOOOXXXXXXXXXXXXXXXXGOOXXXXXXXXXXXXXXXXXGXXXXXXXXXXXXXXXXXXXGOXXXXXXXXXXXXXXXXXXGOOXXXXXXXXXXXXXXXXXGOXXXXXXXXXXXXXXXXXXGXXXXXXXXXXXXXXXXXXXGXXXXXXXXXXXXXXXXXXXGOXXXXXXXXXXXXXXXXXXGOXXXXXXXXXXXXXXXXXXGOOXXXXXXXXXXXXXXXXX,0,0,0
2016,28,1,27,166,306,0,0,315,78,237,GOXXXXXXXXXXXXXXXXXXGXXXXXXXXXXXXXXXXXXXGOOOXXXXXXXXXXXXXXXXGOOXXXXXXXXXXXXXXXXXGXXXXXXXXXXXXXXXXXXXGOXXXXXXXXXXXXXXXXXXGOOXXXXXXXXXXXXXXXXXGOXXXXXXXXXXXXXXXXXXGXXXXXXXXXXXXXXXXXXXGXXXXXXXXXXXXXXXXXXXGOAXXXXXXXXXXXXXXXXXGOXXXXXXXXXXXXXXXXXXGOOXXXXXXXXXXXXXXXXX,0,0,0
2037,30,3,27,168,302,0,0,310,80,230,GOXXXXXXXXXXXXXXXXXXGAAXXXXXXXXXXXXXXXXXGOOOXXXXXXXXXXXXXXXXGOOXXXXXXXXXXXXXXXXXGXXXXXXXXXXXXXXXXXXXGOXXXXXXXXXXXXXXXXXXGOOXXXXXXXXXXXXXXXXXGOXXXXXXXXXXXXXXXXXXGXXXXXXXXXXXXXXXXXXXGXXXXXXXXXXXXXXXXXXXGOAXXXXXXXXXXXXXXXXXGOXXXXXXXXXXXXXXXXXXGOOXXXXXXXXXXXXXXXXX,0,0,0
2058,31,4,27,167,302,0,0,310,80,230,GOXXXXXXXXXXXXXXXXXXGAAXXXXXXXXXXXXXXXXXGOOOXXXXXXXXXXXXXXXXGOOXXXXXXXXXXXXXXXXXGXXXXXXXXXXXXXXXXXXXGOXXXXXXXXXXXXXXXXXXGOOXXXXXXXXXXXXXXXXXGOAXXXXXXXXXXXXXXXXXGXXXXXXXXXXXXXXXXXXXGXXXXXXXXXXXXXXXXXXXGOAXXXXXXXXXXXXXXXXXGOXXXXXXXXXXXXXXXXXXGOOXXXXXXXXXXXXXXXXX,0,0,0
2079,31,4,27,166,303,0,0,310,78,232,GOXXXXXXXXXXXXXXXXXXGAAXXXXXXXXXXXXXXXXXGOOOXXXXXXXXXXXXXXXXGOOXXXXXXXXXXXXXXXXXGXXXXXXXXXXXXXXXXXXXGOXXXXXXXXXXXXXXXXXXGOOXXXXXXXXXXXXXXXXXGOAXXXXXXXXXXXXXXXXXGXXXXXXXXXXXXXXXXXXXGXXXXXXXXXXXXXXXXXXXGOAXXXXXXXXXXXXXXXXXGOXXXXXXXXXXXXXXXXXXGOOXXXXXXXXXXXXXXXXX,0,0,0

2100,31,3,28,166,303,0,0,309,72,237,GOXXXXXXXXXXXXXXXXXXGAAXXXXXXXXXXXXXXXXXGOOOXXXXXXXXXXXXXXXXGOOXXXXXXXXXXXXXXXXXGXXXXXXXXXXXXXXXXXXXGOXXXXXXXXXXXXXXXXXXGOOXXXXXXXXXXXXXXXXXGOAXXXXXXXXXXXXXXXXXGXXXXXXXXXXXXXXXXXXXGXXXXXXXXXXXXXXXXXXXGOOXXXXXXXXXXXXXXXXXGOXXXXXXXXXXXXXXXXXXGOOXXXXXXXXXXXXXXXXX,0,0,0
2121,31,3,28,158,311,0,0,317,70,247,GOXXXXXXXXXXXXXXXXXXGAAXXXXXXXXXXXXXXXXXGOOOXXXXXXXXXXXXXXXXGOOXXXXXXXXXXXXXXXXXGXXXXXXXXXXXXXXXXXXXGOXXXXXXXXXXXXXXXXXXGOOXXXXXXXXXXXXXXXXXGOAXXXXXXXXXXXXXXXXXGXXXXXXXXXXXXXXXXXXXGXXXXXXXXXXXXXXXXXXXGOOXXXXXXXXXXXXXXXXXGOXXXXXXXXXXXXXXXXXXGOOXXXXXXXXXXXXXXXXX,0,0,0
2142,31,2,29,147,322,0,0,329,77,252,GOXXXXXXXXXXXXXXXXXXGAAXXXXXXXXXXXXXXXXXGOOOXXXXXXXXXXXXXXXXGOOXXXXXXXXXXXXXXXXXGXXXXXXXXXXXXXXXXXXXGOXXXXXXXXXXXXXXXXXXGOOXXXXXXXXXXXXXXXXXGOOXXXXXXXXXXXXXXXXXGXXXXXXXXXXXXXXXXXXXGXXXXXXXXXXXXXXXXXXXGOOXXXXXXXXXXXXXXXXXGOXXXXXXXXXXXXXXXXXXGOOXXXXXXXXXXXXXXXXX,0,0,0
2163,31,2,29,144,325,0,0,329,77,252,GOXXXXXXXXXXXXXXXXXXGAAXXXXXXXXXXXXXXXXXGOOOXXXXXXXXXXXXXXXXGOOXXXXXXXXXXXXXXXXXGXXXXXXXXXXXXXXXXXXXGOXXXXXXXXXXXXXXXXXXGOOXXXXXXXXXXXXXXXXXGOOXXXXXXXXXXXXXXXXXGXXXXXXXXXXXXXXXXXXXGXXXXXXXXXXXXXXXXXXXGOOXXXXXXXXXXXXXXXXXGOXXXXXXXXXXXXXXXXXXGOOXXXXXXXXXXXXXXXXX,0,0,0
2184,31,2,29,142,327,0,0,331,76,255,GOXXXXXXXXXXXXXXXXXXGAAXXXXXXXXXXXXXXXXXGOOOXXXXXXXXXXXXXXXXGOOXXXXXXXXXXXXXXXXXGXXXXXXXXXXXXXXXXXXXGOXXXXXXXXXXXXXXXXXXGOOXXXXXXXXXXXXXXXXXGOOXXXXXXXXXXXXXXXXXGXXXXXXXXXXXXXXXXXXXGXXXXXXXXXXXXXXXXXXXGOOXXXXXXXXXXXXXXXXXGOXXXXXXXXXXXXXXXXXXGOOXXXXXXXXXXXXXXXXX,0,0,0

2205,31,2,29,136,333,0,0,337,76,261,GOXXXXXXXXXXXXXXXXXXGAAXXXXXXXXXXXXXXXXXGOOOXXXXXXXXXXXXXXXXGOOXXXXXXXXXXXXXXXXXGXXXXXXXXXXXXXXXXXXXGOXXXXXXXXXXXXXXXXXXGOOXXXXXXXXXXXXXXXXXGOOXXXXXXXXXXXXXXXXXGXXXXXXXXXXXXXXXXXXXGXXXXXXXXXXXXXXXXXXXGOOXXXXXXXXXXXXXXXXXGOXXXXXXXXXXXXXXXXXXGOOXXXXXXXXXXXXXXXXX,0,0,0
2226,31,1,30,145,324,0,0,327,81,246,GOXXXXXXXXXXXXXXXXXXGAOXXXXXXXXXXXXXXXXXGOOOXXXXXXXXXXXXXXXXGOOXXXXXXXXXXXXXXXXXGXXXXXXXXXXXXXXXXXXXGOXXXXXXXXXXXXXXXXXXGOOXXXXXXXXXXXXXXXXXGOOXXXXXXXXXXXXXXXXXGXXXXXXXXXXXXXXXXXXXGXXXXXXXXXXXXXXXXXXXGOOXXXXXXXXXXXXXXXXXGOXXXXXXXXXXXXXXXXXXGOOXXXXXXXXXXXXXXXXX,0,0,0
2247,31,1,30,143,326,0,0,329,82,247,GOXXXXXXXXXXXXXXXXXXGAOXXXXXXXXXXXXXXXXXGOOOXXXXXXXXXXXXXXXXGOOXXXXXXXXXXXXXXXXXGXXXXXXXXXXXXXXXXXXXGOXXXXXXXXXXXXXXXXXXGOOXXXXXXXXXXXXXXXXXGOOXXXXXXXXXXXXXXXXXGXXXXXXXXXXXXXXXXXXXGXXXXXXXXXXXXXXXXXXXGOOXXXXXXXXXXXXXXXXXGOXXXXXXXXXXXXXXXXXXGOOXXXXXXXXXXXXXXXXX,0,0,0
2268,31,1,30,147,322,0,0,323,84,239,GOXXXXXXXXXXXXXXXXXXGAOXXXXXXXXXXXXXXXXXGOOOXXXXXXXXXXXXXXXXGOOXXXXXXXXXXXXXXXXXGXXXXXXXXXXXXXXXXXXXGOXXXXXXXXXXXXXXXXXXGOOXXXXXXXXXXXXXXXXXGOOXXXXXXXXXXXXXXXXXGXXXXXXXXXXXXXXXXXXXGXXXXXXXXXXXXXXXXXXXGOOXXXXXXXXXXXXXXXXXGOXXXXXXXXXXXXXXXXXXGOOXXXXXXXXXXXXXXXXX,0,0,0
2289,31,1,30,147,322,0,0,323,79,244,GOXXXXXXXXXXXXXXXXXXGAOXXXXXXXXXXXXXXXXXGOOOXXXXXXXXXXXXXXXXGOOXXXXXXXXXXXXXXXXXGXXXXXXXXXXXXXXXXXXXGOXXXXXXXXXXXXXXXXXXGOOXXXXXXXXXXXXXXXXXGOOXXXXXXXXXXXXXXXXXGXXXXXXXXXXXXXXXXXXXGXXXXXXXXXXXXXXXXXXXGOOXXXXXXXXXXXXXXXXXGOXXXXXXXXXXXXXXXXXXGOOXXXXXXXXXXXXXXXXX,0,0,0

2310,31,0,31,141,328,0,0,327,77,250,GOXXXXXXXXXXXXXXXXXXGOOXXXXXXXXXXXXXXXXXGOOOXXXXXXXXXXXXXXXXGOOXXXXXXXXXXXXXXXXXGXXXXXXXXXXXXXXXXXXXGOXXXXXXXXXXXXXXXXXXGOOXXXXXXXXXXXXXXXXXGOOXXXXXXXXXXXXXXXXXGXXXXXXXXXXXXXXXXXXXGXXXXXXXXXXXXXXXXXXXGOOXXXXXXXXXXXXXXXXXGOXXXXXXXXXXXXXXXXXXGOOXXXXXXXXXXXXXXXXX,0,0,0
2331,31,0,31,138,331,0,0,330,78,252,GOXXXXXXXXXXXXXXXXXXGOOXXXXXXXXXXXXXXXXXGOOOXXXXXXXXXXXXXXXXGOOXXXXXXXXXXXXXXXXXGXXXXXXXXXXXXXXXXXXXGOXXXXXXXXXXXXXXXXXXGOOXXXXXXXXXXXXXXXXXGOOXXXXXXXXXXXXXXXXXGXXXXXXXXXXXXXXXXXXXGXXXXXXXXXXXXXXXXXXXGOOXXXXXXXXXXXXXXXXXGOXXXXXXXXXXXXXXXXXXGOOXXXXXXXXXXXXXXXXX,0,0,0
2352,31,0,31,141,328,0,0,327,83,244,GOXXXXXXXXXXXXXXXXXXGOOXXXXXXXXXXXXXXXXXGOOOXXXXXXXXXXXXXXXXGOOXXXXXXXXXXXXXXXXXGXXXXXXXXXXXXXXXXXXXGOXXXXXXXXXXXXXXXXXXGOOXXXXXXXXXXXXXXXXXGOOXXXXXXXXXXXXXXXXXGXXXXXXXXXXXXXXXXXXXGXXXXXXXXXXXXXXXXXXXGOOXXXXXXXXXXXXXXXXXGOXXXXXXXXXXXXXXXXXXGOOXXXXXXXXXXXXXXXXX,0,0,0
2373,31,0,31,141,328,0,0,329,85,244,GOXXXXXXXXXXXXXXXXXXGOOXXXXXXXXXXXXXXXXXGOOOXXXXXXXXXXXXXXXXGOOXXXXXXXXXXXXXXXXXGXXXXXXXXXXXXXXXXXXXGOXXXXXXXXXXXXXXXXXXGOOXXXXXXXXXXXXXXXXXGOOXXXXXXXXXXXXXXXXXGXXXXXXXXXXXXXXXXXXXGXXXXXXXXXXXXXXXXXXXGOOXXXXXXXXXXXXXXXXXGOXXXXXXXXXXXXXXXXXXGOOXXXXXXXXXXXXXXXXX,0,0,0
2394,31,0,31,151,318,0,0,320,73,247,GOXXXXXXXXXXXXXXXXXXGOOXXXXXXXXXXXXXXXXXGOOOXXXXXXXXXXXXXXXXGOOXXXXXXXXXXXXXXXXXGXXXXXXXXXXXXXXXXXXXGOXXXXXXXXXXXXXXXXXXGOOXXXXXXXXXXXXXXXXXGOOXXXXXXXXXXXXXXXXXGXXXXXXXXXXXXXXXXXXXGXXXXXXXXXXXXXXXXXXXGOOXXXXXXXXXXXXXXXXXGOXXXXXXXXXXXXXXXXXXGOOXXXXXXXXXXXXXXXXX,0,0,0

2415,31,0,31,147,322,0,0,325,80,245,GOXXXXXXXXXXXXXXXXXXGOOXXXXXXXXXXXXXXXXXGOOOXXXXXXXXXXXXXXXXGOOXXXXXXXXXXXXXXXXXGXXXXXXXXXXXXXXXXXXXGOXXXXXXXXXXXXXXXXXXGOOXXXXXXXXXXXXXXXXXGOOXXXXXXXXXXXXXXXXXGXXXXXXXXXXXXXXXXXXXGXXXXXXXXXXXXXXXXXXXGOOXXXXXXXXXXXXXXXXXGOXXXXXXXXXXXXXXXXXXGOOXXXXXXXXXXXXXXXXX,0,0,0
2436,31,0,31,151,318,0,0,321,80,241,GOXXXXXXXXXXXXXXXXXXGOOXXXXXXXXXXXXXXXXXGOOOXXXXXXXXXXXXXXXXGOOXXXXXXXXXXXXXXXXXGXXXXXXXXXXXXXXXXXXXGOXXXXXXXXXXXXXXXXXXGOOXXXXXXXXXXXXXXXXXGOOXXXXXXXXXXXXXXXXXGXXXXXXXXXXXXXXXXXXXGXXXXXXXXXXXXXXXXXXXGOOXXXXXXXXXXXXXXXXXGOXXXXXXXXXXXXXXXXXXGOOXXXXXXXXXXXXXXXXX,0,0,0
2457,31,0,31,152,317,0,0,321,78,243,GOXXXXXXXXXXXXXXXXXXGOOXXXXXXXXXXXXXXXXXGOOOXXXXXXXXXXXXXXXXGOOXXXXXXXXXXXXXXXXXGXXXXXXXXXXXXXXXXXXXGOXXXXXXXXXXXXXXXXXXGOOXXXXXXXXXXXXXXXXXGOOXXXXXXXXXXXXXXXXXGXXXXXXXXXXXXXXXXXXXGXXXXXXXXXXXXXXXXXXXGOOXXXXXXXXXXXXXXXXXGOXXXXXXXXXXXXXXXXXXGOOXXXXXXXXXXXXXXXXX,0,0,0
2478,31,0,31,155,314,0,0,318,83,235,GOXXXXXXXXXXXXXXXXXXGOOXXXXXXXXXXXXXXXXXGOOOXXXXXXXXXXXXXXXXGOOXXXXXXXXXXXXXXXXXGXXXXXXXXXXXXXXXXXXXGOXXXXXXXXXXXXXXXXXXGOOXXXXXXXXXXXXXXXXXGOOXXXXXXXXXXXXXXXXXGXXXXXXXXXXXXXXXXXXXGXXXXXXXXXXXXXXXXXXXGOOXXXXXXXXXXXXXXXXXGOXXXXXXXXXXXXXXXXXXGOOXXXXXXXXXXXXXXXXX,0,0,0
2499,32,1,31,148,320,0,0,323,84,239,GOXXXXXXXXXXXXXXXXXXGOOXXXXXXXXXXXXXXXXXGOOOXXXXXXXXXXXXXXXXGOOXXXXXXXXXXXXXXXXXGXXXXXXXXXXXXXXXXXXXGOXXXXXXXXXXXXXXXXXXGOOXXXXXXXXXXXXXXXXXGOOXXXXXXXXXXXXXXXXXGAXXXXXXXXXXXXXXXXXXGXXXXXXXXXXXXXXXXXXXGOOXXXXXXXXXXXXXXXXXGOXXXXXXXXXXXXXXXXXXGOOXXXXXXXXXXXXXXXXX,0,0,0

2520,32,1,31,146,322,0,0,327,85,242,GOXXXXXXXXXXXXXXXXXXGOOXXXXXXXXXXXXXXXXXGOOOXXXXXXXXXXXXXXXXGOOXXXXXXXXXXXXXXXXXGXXXXXXXXXXXXXXXXXXXGOXXXXXXXXXXXXXXXXXXGOOXXXXXXXXXXXXXXXXXGOOXXXXXXXXXXXXXXXXXGAXXXXXXXXXXXXXXXXXXGXXXXXXXXXXXXXXXXXXXGOOXXXXXXXXXXXXXXXXXGOXXXXXXXXXXXXXXXXXXGOOXXXXXXXXXXXXXXXXX,0,0,0
2541,32,1,31,146,322,0,0,326,88,238,GOXXXXXXXXXXXXXXXXXXGOOXXXXXXXXXXXXXXXXXGOOOXXXXXXXXXXXXXXXXGOOXXXXXXXXXXXXXXXXXGXXXXXXXXXXXXXXXXXXXGOXXXXXXXXXXXXXXXXXXGOOXXXXXXXXXXXXXXXXXGOOXXXXXXXXXXXXXXXXXGAXXXXXXXXXXXXXXXXXXGXXXXXXXXXXXXXXXXXXXGOOXXXXXXXXXXXXXXXXXGOXXXXXXXXXXXXXXXXXXGOOXXXXXXXXXXXXXXXXX,0,0,0
2562,32,1,31,139,329,0,0,334,94,240,GOXXXXXXXXXXXXXXXXXXGOOXXXXXXXXXXXXXXXXXGOOOXXXXXXXXXXXXXXXXGOOXXXXXXXXXXXXXXXXXGXXXXXXXXXXXXXXXXXXXGOXXXXXXXXXXXXXXXXXXGOOXXXXXXXXXXXXXXXXXGOOXXXXXXXXXXXXXXXXXGAXXXXXXXXXXXXXXXXXXGXXXXXXXXXXXXXXXXXXXGOOXXXXXXXXXXXXXXXXXGOXXXXXXXXXXXXXXXXXXGOOXXXXXXXXXXXXXXXXX,0,0,0
2583,32,1,31,147,321,0,0,323,85,238,GOXXXXXXXXXXXXXXXXXXGOOXXXXXXXXXXXXXXXXXGOOOXXXXXXXXXXXXXXXXGOOXXXXXXXXXXXXXXXXXGXXXXXXXXXXXXXXXXXXXGOXXXXXXXXXXXXXXXXXXGOOXXXXXXXXXXXXXXXXXGOOXXXXXXXXXXXXXXXXXGAXXXXXXXXXXXXXXXXXXGXXXXXXXXXXXXXXXXXXXGOOXXXXXXXXXXXXXXXXXGOXXXXXXXXXXXXXXXXXXGOOXXXXXXXXXXXXXXXXX,0,0,0
2604,32,1,31,138,330,0,0,332,88,244,GOXXXXXXXXXXXXXXXXXXGOOXXXXXXXXXXXXXXXXXGOOOXXXXXXXXXXXXXXXXGOOXXXXXXXXXXXXXXXXXGXXXXXXXXXXXXXXXXXXXGOXXXXXXXXXXXXXXXXXXGOOXXXXXXXXXXXXXXXXXGOOXXXXXXXXXXXXXXXXXGAXXXXXXXXXXXXXXXXXXGXXXXXXXXXXXXXXXXXXXGOOXXXXXXXXXXXXXXXXXGOXXXXXXXXXXXXXXXXXXGOOXXXXXXXXXXXXXXXXX,0,0,0

2625,32,1,31,138,330,0,0,332,92,240,GOXXXXXXXXXXXXXXXXXXGOOXXXXXXXXXXXXXXXXXGOOOXXXXXXXXXXXXXXXXGOOXXXXXXXXXXXXXXXXXGXXXXXXXXXXXXXXXXXXXGOXXXXXXXXXXXXXXXXXXGOOXXXXXXXXXXXXXXXXXGOOXXXXXXXXXXXXXXXXXGAXXXXXXXXXXXXXXXXXXGXXXXXXXXXXXXXXXXXXXGOOXXXXXXXXXXXXXXXXXGOXXXXXXXXXXXXXXXXXXGOOXXXXXXXXXXXXXXXXX,0,0,0
2646,32,1,31,143,325,0,0,328,89,239,GOXXXXXXXXXXXXXXXXXXGOOXXXXXXXXXXXXXXXXXGOOOXXXXXXXXXXXXXXXXGOOXXXXXXXXXXXXXXXXXGXXXXXXXXXXXXXXXXXXXGOXXXXXXXXXXXXXXXXXXGOOXXXXXXXXXXXXXXXXXGOOXXXXXXXXXXXXXXXXXGAXXXXXXXXXXXXXXXXXXGXXXXXXXXXXXXXXXXXXXGOOXXXXXXXXXXXXXXXXXGOXXXXXXXXXXXXXXXXXXGOOXXXXXXXXXXXXXXXXX,0,0,0
2667,32,0,32,136,332,0,0,332,91,241,GOXXXXXXXXXXXXXXXXXXGOOXXXXXXXXXXXXXXXXXGOOOXXXXXXXXXXXXXXXXGOOXXXXXXXXXXXXXXXXXGXXXXXXXXXXXXXXXXXXXGOXXXXXXXXXXXXXXXXXXGOOXXXXXXXXXXXXXXXXXGOOXXXXXXXXXXXXXXXXXGOXXXXXXXXXXXXXXXXXXGXXXXXXXXXXXXXXXXXXXGOOXXXXXXXXXXXXXXXXXGOXXXXXXXXXXXXXXXXXXGOOXXXXXXXXXXXXXXXXX,0,0,0
2688,32,0,32,140,328,0,0,333,88,245,GOXXXXXXXXXXXXXXXXXXGOOXXXXXXXXXXXXXXXXXGOOOXXXXXXXXXXXXXXXXGOOXXXXXXXXXXXXXXXXXGXXXXXXXXXXXXXXXXXXXGOXXXXXXXXXXXXXXXXXXGOOXXXXXXXXXXXXXXXXXGOOXXXXXXXXXXXXXXXXXGOXXXXXXXXXXXXXXXXXXGXXXXXXXXXXXXXXXXXXXGOOXXXXXXXXXXXXXXXXXGOXXXXXXXXXXXXXXXXXXGOOXXXXXXXXXXXXXXXXX,0,0,0
2709,32,0,32,139,329,0,0,334,94,240,GOXXXXXXXXXXXXXXXXXXGOOXXXXXXXXXXXXXXXXXGOOOXXXXXXXXXXXXXXXXGOOXXXXXXXXXXXXXXXXXGXXXXXXXXXXXXXXXXXXXGOXXXXXXXXXXXXXXXXXXGOOXXXXXXXXXXXXXXXXXGOOXXXXXXXXXXXXXXXXXGOXXXXXXXXXXXXXXXXXXGXXXXXXXXXXXXXXXXXXXGOOXXXXXXXXXXXXXXXXXGOXXXXXXXXXXXXXXXXXXGOOXXXXXXXXXXXXXXXXX,0,0,0

2730,32,0,32,151,317,0,0,321,87,234,GOXXXXXXXXXXXXXXXXXXGOOXXXXXXXXXXXXXXXXXGOOOXXXXXXXXXXXXXXXXGOOXXXXXXXXXXXXXXXXXGXXXXXXXXXXXXXXXXXXXGOXXXXXXXXXXXXXXXXXXGOOXXXXXXXXXXXXXXXXXGOOXXXXXXXXXXXXXXXXXGOXXXXXXXXXXXXXXXXXXGXXXXXXXXXXXXXXXXXXXGOOXXXXXXXXXXXXXXXXXGOXXXXXXXXXXXXXXXXXXGOOXXXXXXXXXXXXXXXXX,0,0,0
2751,32,0,32,147,321,0,0,324,92,232,GOXXXXXXXXXXXXXXXXXXGOOXXXXXXXXXXXXXXXXXGOOOXXXXXXXXXXXXXXXXGOOXXXXXXXXXXXXXXXXXGXXXXXXXXXXXXXXXXXXXGOXXXXXXXXXXXXXXXXXXGOOXXXXXXXXXXXXXXXXXGOOXXXXXXXXXXXXXXXXXGOXXXXXXXXXXXXXXXXXXGXXXXXXXXXXXXXXXXXXXGOOXXXXXXXXXXXXXXXXXGOXXXXXXXXXXXXXXXXXXGOOXXXXXXXXXXXXXXXXX,0,0,0
2772,33,1,32,147,320,0,0,323,88,235,GOXXXXXXXXXXXXXXXXXXGOOXXXXXXXXXXXXXXXXXGOOOXXXXXXXXXXXXXXXXGOOXXXXXXXXXXXXXXXXXGXXXXXXXXXXXXXXXXXXXGOXXXXXXXXXXXXXXXXXXGOOXXXXXXXXXXXXXXXXXGOOAXXXXXXXXXXXXXXXXGOXXXXXXXXXXXXXXXXXXGXXXXXXXXXXXXXXXXXXXGOOXXXXXXXXXXXXXXXXXGOXXXXXXXXXXXXXXXXXXGOOXXXXXXXXXXXXXXXXX,0,0,0
2793,33,1,32,142,325,0,0,327,90,237,GOXXXXXXXXXXXXXXXXXXGOOXXXXXXXXXXXXXXXXXGOOOXXXXXXXXXXXXXXXXGOOXXXXXXXXXXXXXXXXXGXXXXXXXXXXXXXXXXXXXGOXXXXXXXXXXXXXXXXXXGOOXXXXXXXXXXXXXXXXXGOOAXXXXXXXXXXXXXXXXGOXXXXXXXXXXXXXXXXXXGXXXXXXXXXXXXXXXXXXXGOOXXXXXXXXXXXXXXXXXGOXXXXXXXXXXXXXXXXXXGOOXXXXXXXXXXXXXXXXX,0,0,0
2814,33,1,32,141,326,0,0,328,85,243,GOXXXXXXXXXXXXXXXXXXGOOXXXXXXXXXXXXXXXXXGOOOXXXXXXXXXXXXXXXXGOOXXXXXXXXXXXXXXXXXGXXXXXXXXXXXXXXXXXXXGOXXXXXXXXXXXXXXXXXXGOOXXXXXXXXXXXXXXXXXGOOAXXXXXXXXXXXXXXXXGOXXXXXXXXXXXXXXXXXXGXXXXXXXXXXXXXXXXXXXGOOXXXXXXXXXXXXXXXXXGOXXXXXXXXXXXXXXXXXXGOOXXXXXXXXXXXXXXXXX,0,0,0

2835,33,0,33,135,332,0,0,336,93,243,GOXXXXXXXXXXXXXXXXXXGOOXXXXXXXXXXXXXXXXXGOOOXXXXXXXXXXXXXXXXGOOXXXXXXXXXXXXXXXXXGXXXXXXXXXXXXXXXXXXXGOXXXXXXXXXXXXXXXXXXGOOXXXXXXXXXXXXXXXXXGOOOXXXXXXXXXXXXXXXXGOXXXXXXXXXXXXXXXXXXGXXXXXXXXXXXXXXXXXXXGOOXXXXXXXXXXXXXXXXXGOXXXXXXXXXXXXXXXXXXGOOXXXXXXXXXXXXXXXXX,0,0,0
2856,33,0,33,137,330,0,0,334,95,239,GOXXXXXXXXXXXXXXXXXXGOOXXXXXXXXXXXXXXXXXGOOOXXXXXXXXXXXXXXXXGOOXXXXXXXXXXXXXXXXXGXXXXXXXXXXXXXXXXXXXGOXXXXXXXXXXXXXXXXXXGOOXXXXXXXXXXXXXXXXXGOOOXXXXXXXXXXXXXXXXGOXXXXXXXXXXXXXXXXXXGXXXXXXXXXXXXXXXXXXXGOOXXXXXXXXXXXXXXXXXGOXXXXXXXXXXXXXXXXXXGOOXXXXXXXXXXXXXXXXX,0,0,0
2877,33,0,33,128,339,0,0,344,92,252,GOXXXXXXXXXXXXXXXXXXGOOXXXXXXXXXXXXXXXXXGOOOXXXXXXXXXXXXXXXXGOOXXXXXXXXXXXXXXXXXGXXXXXXXXXXXXXXXXXXXGOXXXXXXXXXXXXXXXXXXGOOXXXXXXXXXXXXXXXXXGOOOXXXXXXXXXXXXXXXXGOXXXXXXXXXXXXXXXXXXGXXXXXXXXXXXXXXXXXXXGOOXXXXXXXXXXXXXXXXXGOXXXXXXXXXXXXXXXXXXGOOXXXXXXXXXXXXXXXXX,0,0,0
2898,34,1,33,125,341,0,0,345,94,251,GOXXXXXXXXXXXXXXXXXXGOOXXXXXXXXXXXXXXXXXGOOOXXXXXXXXXXXXXXXXGOOXXXXXXXXXXXXXXXXXGXXXXXXXXXXXXXXXXXXXGOXXXXXXXXXXXXXXXXXXGOOXXXXXXXXXXXXXXXXXGOOOXXXXXXXXXXXXXXXXGOXXXXXXXXXXXXXXXXXXGXXXXXXXXXXXXXXXXXXXGOOXXXXXXXXXXXXXXXXXGOXXXXXXXXXXXXXXXXXXGOOAXXXXXXXXXXXXXXXX,0,0,0
2919,34,1,33,127,339,0,0,342,95,247,GOXXXXXXXXXXXXXXXXXXGOOXXXXXXXXXXXXXXXXXGOOOXXXXXXXXXXXXXXXXGOOXXXXXXXXXXXXXXXXXGXXXXXXXXXXXXXXXXXXXGOXXXXXXXXXXXXXXXXXXGOOXXXXXXXXXXXXXXXXXGOOOXXXXXXXXXXXXXXXXGOXXXXXXXXXXXXXXXXXXGXXXXXXXXXXXXXXXXXXXGOOXXXXXXXXXXXXXXXXXGOXXXXXXXXXXXXXXXXXXGOOAXXXXXXXXXXXXXXXX,0,0,0

2940,34,1,33,129,337,0,0,339,99,240,GOXXXXXXXXXXXXXXXXXXGOOXXXXXXXXXXXXXXXXXGOOOXXXXXXXXXXXXXXXXGOOXXXXXXXXXXXXXXXXXGXXXXXXXXXXXXXXXXXXXGOXXXXXXXXXXXXXXXXXXGOOXXXXXXXXXXXXXXXXXGOOOXXXXXXXXXXXXXXXXGOXXXXXXXXXXXXXXXXXXGXXXXXXXXXXXXXXXXXXXGOOXXXXXXXXXXXXXXXXXGOXXXXXXXXXXXXXXXXXXGOOAXXXXXXXXXXXXXXXX,0,0,0
2961,34,1,33,129,337,0,0,338,97,241,GOXXXXXXXXXXXXXXXXXXGOOXXXXXXXXXXXXXXXXXGOOOXXXXXXXXXXXXXXXXGOOXXXXXXXXXXXXXXXXXGXXXXXXXXXXXXXXXXXXXGOXXXXXXXXXXXXXXXXXXGOOXXXXXXXXXXXXXXXXXGOOOXXXXXXXXXXXXXXXXGOXXXXXXXXXXXXXXXXXXGXXXXXXXXXXXXXXXXXXXGOOXXXXXXXXXXXXXXXXXGOXXXXXXXXXXXXXXXXXXGOOAXXXXXXXXXXXXXXXX,0,0,0
2982,34,1,33,130,336,0,0,337,97,240,GOXXXXXXXXXXXXXXXXXXGOOXXXXXXXXXXXXXXXXXGOOOXXXXXXXXXXXXXXXXGOOXXXXXXXXXXXXXXXXXGXXXXXXXXXXXXXXXXXXXGOXXXXXXXXXXXXXXXXXXGOOXXXXXXXXXXXXXXXXXGOOOXXXXXXXXXXXXXXXXGOXXXXXXXXXXXXXXXXXXGXXXXXXXXXXXXXXXXXXXGOOXXXXXXXXXXXXXXXXXGOXXXXXXXXXXXXXXXXXXGOOAXXXXXXXXXXXXXXXX,0,0,0
3003,34,1,33,137,329,0,0,329,96,233,GOXXXXXXXXXXXXXXXXXXGOOXXXXXXXXXXXXXXXXXGOOOXXXXXXXXXXXXXXXXGOOXXXXXXXXXXXXXXXXXGXXXXXXXXXXXXXXXXXXXGOXXXXXXXXXXXXXXXXXXGOOXXXXXXXXXXXXXXXXXGOOOXXXXXXXXXXXXXXXXGOXXXXXXXXXXXXXXXXXXGXXXXXXXXXXXXXXXXXXXGOOXXXXXXXXXXXXXXXXXGOXXXXXXXXXXXXXXXXXXGOOAXXXXXXXXXXXXXXXX,0,0,0
3024,34,1,33,141,325,0,0,326,96,230,GOXXXXXXXXXXXXXXXXXXGOOXXXXXXXXXXXXXXXXXGOOOXXXXXXXXXXXXXXXXGOOXXXXXXXXXXXXXXXXXGXXXXXXXXXXXXXXXXXXXGOXXXXXXXXXXXXXXXXXXGOOXXXXXXXXXXXXXXXXXGOOOXXXXXXXXXXXXXXXXGOXXXXXXXXXXXXXXXXXXGXXXXXXXXXXXXXXXXXXXGOOXXXXXXXXXXXXXXXXXGOXXXXXXXXXXXXXXXXXXGOOAXXXXXXXXXXXXXXXX,0,0,0

3045,34,1,33,136,330,0,0,329,95,234,GOXXXXXXXXXXXXXXXXXXGOOXXXXXXXXXXXXXXXXXGOOOXXXXXXXXXXXXXXXXGOOXXXXXXXXXXXXXXXXXGXXXXXXXXXXXXXXXXXXXGOXXXXXXXXXXXXXXXXXXGOOXXXXXXXXXXXXXXXXXGOOOXXXXXXXXXXXXXXXXGOXXXXXXXXXXXXXXXXXXGXXXXXXXXXXXXXXXXXXXGOOXXXXXXXXXXXXXXXXXGOXXXXXXXXXXXXXXXXXXGOOAXXXXXXXXXXXXXXXX,0,0,0
3066,34,1,33,128,338,0,0,336,103,233,GOXXXXXXXXXXXXXXXXXXGOOXXXXXXXXXXXXXXXXXGOOOXXXXXXXXXXXXXXXXGOOXXXXXXXXXXXXXXXXXGXXXXXXXXXXXXXXXXXXXGOXXXXXXXXXXXXXXXXXXGOOXXXXXXXXXXXXXXXXXGOOOXXXXXXXXXXXXXXXXGOXXXXXXXXXXXXXXXXXXGXXXXXXXXXXXXXXXXXXXGOOXXXXXXXXXXXXXXXXXGOXXXXXXXXXXXXXXXXXXGOOAXXXXXXXXXXXXXXXX,0,0,0
3087,34,1,33,129,337,0,0,337,107,230,GOXXXXXXXXXXXXXXXXXXGOOXXXXXXXXXXXXXXXXXGOOOXXXXXXXXXXXXXXXXGOOXXXXXXXXXXXXXXXXXGXXXXXXXXXXXXXXXXXXXGOXXXXXXXXXXXXXXXXXXGOOXXXXXXXXXXXXXXXXXGOOOXXXXXXXXXXXXXXXXGOXXXXXXXXXXXXXXXXXXGXXXXXXXXXXXXXXXXXXXGOOXXXXXXXXXXXXXXXXXGOXXXXXXXXXXXXXXXXXXGOOAXXXXXXXXXXXXXXXX,0,0,0
3108,35,2,33,137,328,0,0,329,101,228,GOXXXXXXXXXXXXXXXXXXGOOXXXXXXXXXXXXXXXXXGOOOXXXXXXXXXXXXXXXXGOOXXXXXXXXXXXXXXXXXGXXXXXXXXXXXXXXXXXXXGOXXXXXXXXXXXXXXXXXXGOOXXXXXXXXXXXXXXXXXGOOOXXXXXXXXXXXXXXXXGOXXXXXXXXXXXXXXXXXXGXXXXXXXXXXXXXXXXXXXGOOAXXXXXXXXXXXXXXXXGOXXXXXXXXXXXXXXXXXXGOOAXXXXXXXXXXXXXXXX,0,0,0
3129,35,2,33,137,328,0,0,328,100,228,GOXXXXXXXXXXXXXXXXXXGOOXXXXXXXXXXXXXXXXXGOOOXXXXXXXXXXXXXXXXGOOXXXXXXXXXXXXXXXXXGXXXXXXXXXXXXXXXXXXXGOXXXXXXXXXXXXXXXXXXGOOXXXXXXXXXXXXXXXXXGOOOXXXXXXXXXXXXXXXXGOXXXXXXXXXXXXXXXXXXGXXXXXXXXXXXXXXXXXXXGOOAXXXXXXXXXXXXXXXXGOXXXXXXXXXXXXXXXXXXGOOAXXXXXXXXXXXXXXXX,0,0,0

3150,35,1,34,133,332,0,0,334,100,234,GOXXXXXXXXXXXXXXXXXXGOOXXXXXXXXXXXXXXXXXGOOOXXXXXXXXXXXXXXXXGOOXXXXXXXXXXXXXXXXXGXXXXXXXXXXXXXXXXXXXGOXXXXXXXXXXXXXXXXXXGOOXXXXXXXXXXXXXXXXXGOOOXXXXXXXXXXXXXXXXGOXXXXXXXXXXXXXXXXXXGXXXXXXXXXXXXXXXXXXXGOOOXXXXXXXXXXXXXXXXGOXXXXXXXXXXXXXXXXXXGOOAXXXXXXXXXXXXXXXX,0,0,0
3171,35,1,34,135,330,0,0,333,100,233,GOXXXXXXXXXXXXXXXXXXGOOXXXXXXXXXXXXXXXXXGOOOXXXXXXXXXXXXXXXXGOOXXXXXXXXXXXXXXXXXGXXXXXXXXXXXXXXXXXXXGOXXXXXXXXXXXXXXXXXXGOOXXXXXXXXXXXXXXXXXGOOOXXXXXXXXXXXXXXXXGOXXXXXXXXXXXXXXXXXXGXXXXXXXXXXXXXXXXXXXGOOOXXXXXXXXXXXXXXXXGOXXXXXXXXXXXXXXXXXXGOOAXXXXXXXXXXXXXXXX,0,0,0
3192,35,1,34,141,324,0,0,327,102,225,GOXXXXXXXXXXXXXXXXXXGOOXXXXXXXXXXXXXXXXXGOOOXXXXXXXXXXXXXXXXGOOXXXXXXXXXXXXXXXXXGXXXXXXXXXXXXXXXXXXXGOXXXXXXXXXXXXXXXXXXGOOXXXXXXXXXXXXXXXXXGOOOXXXXXXXXXXXXXXXXGOXXXXXXXXXXXXXXXXXXGXXXXXXXXXXXXXXXXXXXGOOOXXXXXXXXXXXXXXXXGOXXXXXXXXXXXXXXXXXXGOOAXXXXXXXXXXXXXXXX,0,0,0
3213,35,1,34,140,325,0,0,328,107,221,GOXXXXXXXXXXXXXXXXXXGOOXXXXXXXXXXXXXXXXXGOOOXXXXXXXXXXXXXXXXGOOXXXXXXXXXXXXXXXXXGXXXXXXXXXXXXXXXXXXXGOXXXXXXXXXXXXXXXXXXGOOXXXXXXXXXXXXXXXXXGOOOXXXXXXXXXXXXXXXXGOXXXXXXXXXXXXXXXXXXGXXXXXXXXXXXXXXXXXXXGOOOXXXXXXXXXXXXXXXXGOXXXXXXXXXXXXXXXXXXGOOAXXXXXXXXXXXXXXXX,0,0,0
3234,35,1,34,140,325,0,0,326,105,221,GOXXXXXXXXXXXXXXXXXXGOOXXXXXXXXXXXXXXXXXGOOOXXXXXXXXXXXXXXXXGOOXXXXXXXXXXXXXXXXXGXXXXXXXXXXXXXXXXXXXGOXXXXXXXXXXXXXXXXXXGOOXXXXXXXXXXXXXXXXXGOOOXXXXXXXXXXXXXXXXGOXXXXXXXXXXXXXXXXXXGXXXXXXXXXXXXXXXXXXXGOOOXXXXXXXXXXXXXXXXGOXXXXXXXXXXXXXXXXXXGOOAXXXXXXXXXXXXXXXX,0,0,0

3255,35,1,34,148,317,0,0,318,99,219,GOXXXXXXXXXXXXXXXXXXGOOXXXXXXXXXXXXXXXXXGOOOXXXXXXXXXXXXXXXXGOOXXXXXXXXXXXXXXXXXGXXXXXXXXXXXXXXXXXXXGOXXXXXXXXXXXXXXXXXXGOOXXXXXXXXXXXXXXXXXGOOOXXXXXXXXXXXXXXXXGOXXXXXXXXXXXXXXXXXXGXXXXXXXXXXXXXXXXXXXGOOOXXXXXXXXXXXXXXXXGOXXXXXXXXXXXXXXXXXXGOOAXXXXXXXXXXXXXXXX,0,0,0
3276,35,1,34,148,317,0,0,321,107,214,GOXXXXXXXXXXXXXXXXXXGOOXXXXXXXXXXXXXXXXXGOOOXXXXXXXXXXXXXXXXGOOXXXXXXXXXXXXXXXXXGXXXXXXXXXXXXXXXXXXXGOXXXXXXXXXXXXXXXXXXGOOXXXXXXXXXXXXXXXXXGOOOXXXXXXXXXXXXXXXXGOXXXXXXXXXXXXXXXXXXGXXXXXXXXXXXXXXXXXXXGOOOXXXXXXXXXXXXXXXXGOXXXXXXXXXXXXXXXXXXGOOAXXXXXXXXXXXXXXXX,0,0,0
3297,35,1,34,151,314,0,0,317,104,213,GOXXXXXXXXXXXXXXXXXXGOOXXXXXXXXXXXXXXXXXGOOOXXXXXXXXXXXXXXXXGOOXXXXXXXXXXXXXXXXXGXXXXXXXXXXXXXXXXXXXGOXXXXXXXXXXXXXXXXXXGOOXXXXXXXXXXXXXXXXXGOOOXXXXXXXXXXXXXXXXGOXXXXXXXXXXXXXXXXXXGXXXXXXXXXXXXXXXXXXXGOOOXXXXXXXXXXXXXXXXGOXXXXXXXXXXXXXXXXXXGOOAXXXXXXXXXXXXXXXX,0,0,0
3318,35,0,35,146,319,0,0,321,104,217,GOXXXXXXXXXXXXXXXXXXGOOXXXXXXXXXXXXXXXXXGOOOXXXXXXXXXXXXXXXXGOOXXXXXXXXXXXXXXXXXGXXXXXXXXXXXXXXXXXXXGOXXXXXXXXXXXXXXXXXXGOOXXXXXXXXXXXXXXXXXGOOOXXXXXXXXXXXXXXXXGOXXXXXXXXXXXXXXXXXXGXXXXXXXXXXXXXXXXXXXGOOOXXXXXXXXXXXXXXXXGOXXXXXXXXXXXXXXXXXXGOOOXXXXXXXXXXXXXXXX,0,0,0
3339,35,0,35,138,327,0,0,328,109,219,GOXXXXXXXXXXXXXXXXXXGOOXXXXXXXXXXXXXXXXXGOOOXXXXXXXXXXXXXXXXGOOXXXXXXXXXXXXXXXXXGXXXXXXXXXXXXXXXXXXXGOXXXXXXXXXXXXXXXXXXGOOXXXXXXXXXXXXXXXXXGOOOXXXXXXXXXXXXXXXXGOXXXXXXXXXXXXXXXXXXGXXXXXXXXXXXXXXXXXXXGOOOXXXXXXXXXXXXXXXXGOXXXXXXXXXXXXXXXXXXGOOOXXXXXXXXXXXXXXXX,0,0,0

3360,35,0,35,134,331,0,0,334,107,227,GOXXXXXXXXXXXXXXXXXXGOOXXXXXXXXXXXXXXXXXGOOOXXXXXXXXXXXXXXXXGOOXXXXXXXXXXXXXXXXXGXXXXXXXXXXXXXXXXXXXGOXXXXXXXXXXXXXXXXXXGOOXXXXXXXXXXXXXXXXXGOOOXXXXXXXXXXXXXXXXGOXXXXXXXXXXXXXXXXXXGXXXXXXXXXXXXXXXXXXXGOOOXXXXXXXXXXXXXXXXGOXXXXXXXXXXXXXXXXXXGOOOXXXXXXXXXXXXXXXX,0,0,0
3381,35,0,35,124,341,0,0,342,111,231,GOXXXXXXXXXXXXXXXXXXGOOXXXXXXXXXXXXXXXXXGOOOXXXXXXXXXXXXXXXXGOOXXXXXXXXXXXXXXXXXGXXXXXXXXXXXXXXXXXXXGOXXXXXXXXXXXXXXXXXXGOOXXXXXXXXXXXXXXXXXGOOOXXXXXXXXXXXXXXXXGOXXXXXXXXXXXXXXXXXXGXXXXXXXXXXXXXXXXXXXGOOOXXXXXXXXXXXXXXXXGOXXXXXXXXXXXXXXXXXXGOOOXXXXXXXXXXXXXXXX,0,0,0
3402,35,0,35,120,345,0,0,349,108,241,GOXXXXXXXXXXXXXXXXXXGOOXXXXXXXXXXXXXXXXXGOOOXXXXXXXXXXXXXXXXGOOXXXXXXXXXXXXXXXXXGXXXXXXXXXXXXXXXXXXXGOXXXXXXXXXXXXXXXXXXGOOXXXXXXXXXXXXXXXXXGOOOXXXXXXXXXXXXXXXXGOXXXXXXXXXXXXXXXXXXGXXXXXXXXXXXXXXXXXXXGOOOXXXXXXXXXXXXXXXXGOXXXXXXXXXXXXXXXXXXGOOOXXXXXXXXXXXXXXXX,0,0,0
3423,35,0,35,121,344,0,0,349,107,242,GOXXXXXXXXXXXXXXXXXXGOOXXXXXXXXXXXXXXXXXGOOOXXXXXXXXXXXXXXXXGOOXXXXXXXXXXXXXXXXXGXXXXXXXXXXXXXXXXXXXGOXXXXXXXXXXXXXXXXXXGOOXXXXXXXXXXXXXXXXXGOOOXXXXXXXXXXXXXXXXGOXXXXXXXXXXXXXXXXXXGXXXXXXXXXXXXXXXXXXXGOOOXXXXXXXXXXXXXXXXGOXXXXXXXXXXXXXXXXXXGOOOXXXXXXXXXXXXXXXX,0,0,0
3444,35,0,35,118,347,0,0,351,113,238,GOXXXXXXXXXXXXXXXXXXGOOXXXXXXXXXXXXXXXXXGOOOXXXXXXXXXXXXXXXXGOOXXXXXXXXXXXXXXXXXGXXXXXXXXXXXXXXXXXXXGOXXXXXXXXXXXXXXXXXXGOOXXXXXXXXXXXXXXXXXGOOOXXXXXXXXXXXXXXXXGOXXXXXXXXXXXXXXXXXXGXXXXXXXXXXXXXXXXXXXGOOOXXXXXXXXXXXXXXXXGOXXXXXXXXXXXXXXXXXXGOOOXXXXXXXXXXXXXXXX,0,0,0

3465,35,0,35,126,339,0,0,341,120,221,GOXXXXXXXXXXXXXXXXXXGOOXXXXXXXXXXXXXXXXXGOOOXXXXXXXXXXXXXXXXGOOXXXXXXXXXXXXXXXXXGXXXXXXXXXXXXXXXXXXXGOXXXXXXXXXXXXXXXXXXGOOXXXXXXXXXXXXXXXXXGOOOXXXXXXXXXXXXXXXXGOXXXXXXXXXXXXXXXXXXGXXXXXXXXXXXXXXXXXXXGOOOXXXXXXXXXXXXXXXXGOXXXXXXXXXXXXXXXXXXGOOOXXXXXXXXXXXXXXXX,0,0,0
3486,35,0,35,129,336,0,0,339,119,220,GOXXXXXXXXXXXXXXXXXXGOOXXXXXXXXXXXXXXXXXGOOOXXXXXXXXXXXXXXXXGOOXXXXXXXXXXXXXXXXXGXXXXXXXXXXXXXXXXXXXGOXXXXXXXXXXXXXXXXXXGOOXXXXXXXXXXXXXXXXXGOOOXXXXXXXXXXXXXXXXGOXXXXXXXXXXXXXXXXXXGXXXXXXXXXXXXXXXXXXXGOOOXXXXXXXXXXXXXXXXGOXXXXXXXXXXXXXXXXXXGOOOXXXXXXXXXXXXXXXX,0,0,0
3507,36,1,35,124,340,0,0,343,114,229,GOXXXXXXXXXXXXXXXXXXGOOXXXXXXXXXXXXXXXXXGOOOXXXXXXXXXXXXXXXXGOOXXXXXXXXXXXXXXXXXGXXXXXXXXXXXXXXXXXXXGOXXXXXXXXXXXXXXXXXXGOOXXXXXXXXXXXXXXXXXGOOOXXXXXXXXXXXXXXXXGOXXXXXXXXXXXXXXXXXXGXXXXXXXXXXXXXXXXXXXGOOOXXXXXXXXXXXXXXXXGOXXXXXXXXXXXXXXXXXXGOOOAXXXXXXXXXXXXXXX,0,0,0
3528,36,1,35,123,341,0,0,343,116,227,GOXXXXXXXXXXXXXXXXXXGOOXXXXXXXXXXXXXXXXXGOOOXXXXXXXXXXXXXXXXGOOXXXXXXXXXXXXXXXXXGXXXXXXXXXXXXXXXXXXXGOXXXXXXXXXXXXXXXXXXGOOXXXXXXXXXXXXXXXXXGOOOXXXXXXXXXXXXXXXXGOXXXXXXXXXXXXXXXXXXGXXXXXXXXXXXXXXXXXXXGOOOXXXXXXXXXXXXXXXXGOXXXXXXXXXXXXXXXXXXGOOOAXXXXXXXXXXXXXXX,0,0,0
3549,36,1,35,130,334,0,0,336,118,218,GOXXXXXXXXXXXXXXXXXXGOOXXXXXXXXXXXXXXXXXGOOOXXXXXXXXXXXXXXXXGOOXXXXXXXXXXXXXXXXXGXXXXXXXXXXXXXXXXXXXGOXXXXXXXXXXXXXXXXXXGOOXXXXXXXXXXXXXXXXXGOOOXXXXXXXXXXXXXXXXGOXXXXXXXXXXXXXXXXXXGXXXXXXXXXXXXXXXXXXXGOOOXXXXXXXXXXXXXXXXGOXXXXXXXXXXXXXXXXXXGOOOAXXXXXXXXXXXXXXX,0,0,0

3570,36,1,35,134,330,0,0,333,119,214,GOXXXXXXXXXXXXXXXXXXGOOXXXXXXXXXXXXXXXXXGOOOXXXXXXXXXXXXXXXXGOOXXXXXXXXXXXXXXXXXGXXXXXXXXXXXXXXXXXXXGOXXXXXXXXXXXXXXXXXXGOOXXXXXXXXXXXXXXXXXGOOOXXXXXXXXXXXXXXXXGOXXXXXXXXXXXXXXXXXXGXXXXXXXXXXXXXXXXXXXGOOOXXXXXXXXXXXXXXXXGOXXXXXXXXXXXXXXXXXXGOOOAXXXXXXXXXXXXXXX,0,0,0
3591,37,2,35,124,339,0,0,343,125,218,GOXXXXXXXXXXXXXXXXXXGOOXXXXXXXXXXXXXXXXXGOOOXXXXXXXXXXXXXXXXGOOXXXXXXXXXXXXXXXXXGXXXXXXXXXXXXXXXXXXXGOXXXXXXXXXXXXXXXXXXGOOXXXXXXXXXXXXXXXXXGOOOXXXXXXXXXXXXXXXXGOAXXXXXXXXXXXXXXXXXGXXXXXXXXXXXXXXXXXXXGOOOXXXXXXXXXXXXXXXXGOXXXXXXXXXXXXXXXXXXGOOOAXXXXXXXXXXXXXXX,0,0,0
3612,37,1,36,130,333,0,0,338,121,217,GOXXXXXXXXXXXXXXXXXXGOOXXXXXXXXXXXXXXXXXGOOOXXXXXXXXXXXXXXXXGOOXXXXXXXXXXXXXXXXXGXXXXXXXXXXXXXXXXXXXGOXXXXXXXXXXXXXXXXXXGOOXXXXXXXXXXXXXXXXXGOOOXXXXXXXXXXXXXXXXGOOXXXXXXXXXXXXXXXXXGXXXXXXXXXXXXXXXXXXXGOOOXXXXXXXXXXXXXXXXGOXXXXXXXXXXXXXXXXXXGOOOAXXXXXXXXXXXXXXX,0,0,0
3633,37,1,36,132,331,0,0,336,128,208,GOXXXXXXXXXXXXXXXXXXGOOXXXXXXXXXXXXXXXXXGOOOXXXXXXXXXXXXXXXXGOOXXXXXXXXXXXXXXXXXGXXXXXXXXXXXXXXXXXXXGOXXXXXXXXXXXXXXXXXXGOOXXXXXXXXXXXXXXXXXGOOOXXXXXXXXXXXXXXXXGOOXXXXXXXXXXXXXXXXXGXXXXXXXXXXXXXXXXXXXGOOOXXXXXXXXXXXXXXXXGOXXXXXXXXXXXXXXXXXXGOOOAXXXXXXXXXXXXXXX,0,0,0
3654,37,1,36,141,322,0,0,326,119,207,GOXXXXXXXXXXXXXXXXXXGOOXXXXXXXXXXXXXXXXXGOOOXXXXXXXXXXXXXXXXGOOXXXXXXXXXXXXXXXXXGXXXXXXXXXXXXXXXXXXXGOXXXXXXXXXXXXXXXXXXGOOXXXXXXXXXXXXXXXXXGOOOXXXXXXXXXXXXXXXXGOOXXXXXXXXXXXXXXXXXGXXXXXXXXXXXXXXXXXXXGOOOXXXXXXXXXXXXXXXXGOXXXXXXXXXXXXXXXXXXGOOOAXXXXXXXXXXXXXXX,0,0,0

3675,37,1,36,142,321,0,0,325,126,199,GOXXXXXXXXXXXXXXXXXXGOOXXXXXXXXXXXXXXXXXGOOOXXXXXXXXXXXXXXXXGOOXXXXXXXXXXXXXXXXXGXXXXXXXXXXXXXXXXXXXGOXXXXXXXXXXXXXXXXXXGOOXXXXXXXXXXXXXXXXXGOOOXXXXXXXXXXXXXXXXGOOXXXXXXXXXXXXXXXXXGXXXXXXXXXXXXXXXXXXXGOOOXXXXXXXXXXXXXXXXGOXXXXXXXXXXXXXXXXXXGOOOAXXXXXXXXXXXXXXX,0,0,0
3696,37,1,36,146,317,0,0,321,126,195,GOXXXXXXXXXXXXXXXXXXGOOXXXXXXXXXXXXXXXXXGOOOXXXXXXXXXXXXXXXXGOOXXXXXXXXXXXXXXXXXGXXXXXXXXXXXXXXXXXXXGOXXXXXXXXXXXXXXXXXXGOOXXXXXXXXXXXXXXXXXGOOOXXXXXXXXXXXXXXXXGOOXXXXXXXXXXXXXXXXXGXXXXXXXXXXXXXXXXXXXGOOOXXXXXXXXXXXXXXXXGOXXXXXXXXXXXXXXXXXXGOOOAXXXXXXXXXXXXXXX,0,0,0
3717,37,1,36,145,318,0,0,319,126,193,GOXXXXXXXXXXXXXXXXXXGOOXXXXXXXXXXXXXXXXXGOOOXXXXXXXXXXXXXXXXGOOXXXXXXXXXXXXXXXXXGXXXXXXXXXXXXXXXXXXXGOXXXXXXXXXXXXXXXXXXGOOXXXXXXXXXXXXXXXXXGOOOXXXXXXXXXXXXXXXXGOOXXXXXXXXXXXXXXXXXGXXXXXXXXXXXXXXXXXXXGOOOXXXXXXXXXXXXXXXXGOXXXXXXXXXXXXXXXXXXGOOOAXXXXXXXXXXXXXXX,0,0,0
3738,37,1,36,140,323,0,0,324,125,199,GOXXXXXXXXXXXXXXXXXXGOOXXXXXXXXXXXXXXXXXGOOOXXXXXXXXXXXXXXXXGOOXXXXXXXXXXXXXXXXXGXXXXXXXXXXXXXXXXXXXGOXXXXXXXXXXXXXXXXXXGOOXXXXXXXXXXXXXXXXXGOOOXXXXXXXXXXXXXXXXGOOXXXXXXXXXXXXXXXXXGXXXXXXXXXXXXXXXXXXXGOOOXXXXXXXXXXXXXXXXGOXXXXXXXXXXXXXXXXXXGOOOAXXXXXXXXXXXXXXX,0,0,0
3759,37,1,36,146,317,0,0,320,122,198,GOXXXXXXXXXXXXXXXXXXGOOXXXXXXXXXXXXXXXXXGOOOXXXXXXXXXXXXXXXXGOOXXXXXXXXXXXXXXXXXGXXXXXXXXXXXXXXXXXXXGOXXXXXXXXXXXXXXXXXXGOOXXXXXXXXXXXXXXXXXGOOOXXXXXXXXXXXXXXXXGOOXXXXXXXXXXXXXXXXXGXXXXXXXXXXXXXXXXXXXGOOOXXXXXXXXXXXXXXXXGOXXXXXXXXXXXXXXXXXXGOOOAXXXXXXXXXXXXXXX,0,0,0

3780,37,1,36,145,318,0,0,320,120,200,GOXXXXXXXXXXXXXXXXXXGOOXXXXXXXXXXXXXXXXXGOOOXXXXXXXXXXXXXXXXGOOXXXXXXXXXXXXXXXXXGXXXXXXXXXXXXXXXXXXXGOXXXXXXXXXXXXXXXXXXGOOXXXXXXXXXXXXXXXXXGOOOXXXXXXXXXXXXXXXXGOOXXXXXXXXXXXXXXXXXGXXXXXXXXXXXXXXXXXXXGOOOXXXXXXXXXXXXXXXXGOXXXXXXXXXXXXXXXXXXGOOOAXXXXXXXXXXXXXXX,0,0,0
3801,37,0,37,141,322,0,0,325,119,206,GOXXXXXXXXXXXXXXXXXXGOOXXXXXXXXXXXXXXXXXGOOOXXXXXXXXXXXXXXXXGOOXXXXXXXXXXXXXXXXXGXXXXXXXXXXXXXXXXXXXGOXXXXXXXXXXXXXXXXXXGOOXXXXXXXXXXXXXXXXXGOOOXXXXXXXXXXXXXXXXGOOXXXXXXXXXXXXXXXXXGXXXXXXXXXXXXXXXXXXXGOOOXXXXXXXXXXXXXXXXGOXXXXXXXXXXXXXXXXXXGOOOOXXXXXXXXXXXXXXX,0,0,0
3822,37,0,37,135,328,0,0,329,118,211,GOXXXXXXXXXXXXXXXXXXGOOXXXXXXXXXXXXXXXXXGOOOXXXXXXXXXXXXXXXXGOOXXXXXXXXXXXXXXXXXGXXXXXXXXXXXXXXXXXXXGOXXXXXXXXXXXXXXXXXXGOOXXXXXXXXXXXXXXXXXGOOOXXXXXXXXXXXXXXXXGOOXXXXXXXXXXXXXXXXXGXXXXXXXXXXXXXXXXXXXGOOOXXXXXXXXXXXXXXXXGOXXXXXXXXXXXXXXXXXXGOOOOXXXXXXXXXXXXXXX,0,0,0
3843,37,0,37,134,329,0,0,332,117,215,GOXXXXXXXXXXXXXXXXXXGOOXXXXXXXXXXXXXXXXXGOOOXXXXXXXXXXXXXXXXGOOXXXXXXXXXXXXXXXXXGXXXXXXXXXXXXXXXXXXXGOXXXXXXXXXXXXXXXXXXGOOXXXXXXXXXXXXXXXXXGOOOXXXXXXXXXXXXXXXXGOOXXXXXXXXXXXXXXXXXGXXXXXXXXXXXXXXXXXXXGOOOXXXXXXXXXXXXXXXXGOXXXXXXXXXXXXXXXXXXGOOOOXXXXXXXXXXXXXXX,0,0,0
3864,37,0,37,140,323,0,0,324,119,205,GOXXXXXXXXXXXXXXXXXXGOOXXXXXXXXXXXXXXXXXGOOOXXXXXXXXXXXXXXXXGOOXXXXXXXXXXXXXXXXXGXXXXXXXXXXXXXXXXXXXGOXXXXXXXXXXXXXXXXXXGOOXXXXXXXXXXXXXXXXXGOOOXXXXXXXXXXXXXXXXGOOXXXXXXXXXXXXXXXXXGXXXXXXXXXXXXXXXXXXXGOOOXXXXXXXXXXXXXXXXGOXXXXXXXXXXXXXXXXXXGOOOOXXXXXXXXXXXXXXX,0,0,0

3885,37,0,37,135,328,0,0,329,121,208,GOXXXXXXXXXXXXXXXXXXGOOXXXXXXXXXXXXXXXXXGOOOXXXXXXXXXXXXXXXXGOOXXXXXXXXXXXXXXXXXGXXXXXXXXXXXXXXXXXXXGOXXXXXXXXXXXXXXXXXXGOOXXXXXXXXXXXXXXXXXGOOOXXXXXXXXXXXXXXXXGOOXXXXXXXXXXXXXXXXXGXXXXXXXXXXXXXXXXXXXGOOOXXXXXXXXXXXXXXXXGOXXXXXXXXXXXXXXXXXXGOOOOXXXXXXXXXXXXXXX,0,0,0
3906,37,0,37,133,330,0,0,332,121,211,GOXXXXXXXXXXXXXXXXXXGOOXXXXXXXXXXXXXXXXXGOOOXXXXXXXXXXXXXXXXGOOXXXXXXXXXXXXXXXXXGXXXXXXXXXXXXXXXXXXXGOXXXXXXXXXXXXXXXXXXGOOXXXXXXXXXXXXXXXXXGOOOXXXXXXXXXXXXXXXXGOOXXXXXXXXXXXXXXXXXGXXXXXXXXXXXXXXXXXXXGOOOXXXXXXXXXXXXXXXXGOXXXXXXXXXXXXXXXXXXGOOOOXXXXXXXXXXXXXXX,0,0,0
3927,37,0,37,131,332,0,0,334,124,210,GOXXXXXXXXXXXXXXXXXXGOOXXXXXXXXXXXXXXXXXGOOOXXXXXXXXXXXXXXXXGOOXXXXXXXXXXXXXXXXXGXXXXXXXXXXXXXXXXXXXGOXXXXXXXXXXXXXXXXXXGOOXXXXXXXXXXXXXXXXXGOOOXXXXXXXXXXXXXXXXGOOXXXXXXXXXXXXXXXXXGXXXXXXXXXXXXXXXXXXXGOOOXXXXXXXXXXXXXXXXGOXXXXXXXXXXXXXXXXXXGOOOOXXXXXXXXXXXXXXX,0,0,0
3948,37,0,37,126,337,0,0,340,127,213,GOXXXXXXXXXXXXXXXXXXGOOXXXXXXXXXXXXXXXXXGOOOXXXXXXXXXXXXXXXXGOOXXXXXXXXXXXXXXXXXGXXXXXXXXXXXXXXXXXXXGOXXXXXXXXXXXXXXXXXXGOOXXXXXXXXXXXXXXXXXGOOOXXXXXXXXXXXXXXXXGOOXXXXXXXXXXXXXXXXXGXXXXXXXXXXXXXXXXXXXGOOOXXXXXXXXXXXXXXXXGOXXXXXXXXXXXXXXXXXXGOOOOXXXXXXXXXXXXXXX,0,0,0
3969,38,1,37,125,337,0,0,340,124,216,GOXXXXXXXXXXXXXXXXXXGOOXXXXXXXXXXXXXXXXXGOOOAXXXXXXXXXXXXXXXGOOXXXXXXXXXXXXXXXXXGXXXXXXXXXXXXXXXXXXXGOXXXXXXXXXXXXXXXXXXGOOXXXXXXXXXXXXXXXXXGOOOXXXXXXXXXXXXXXXXGOOXXXXXXXXXXXXXXXXXGXXXXXXXXXXXXXXXXXXXGOOOXXXXXXXXXXXXXXXXGOXXXXXXXXXXXXXXXXXXGOOOOXXXXXXXXXXXXXXX,0,0,0

3990,38,1,37,121,341,0,0,343,128,215,GOXXXXXXXXXXXXXXXXXXGOOXXXXXXXXXXXXXXXXXGOOOAXXXXXXXXXXXXXXXGOOXXXXXXXXXXXXXXXXXGXXXXXXXXXXXXXXXXXXXGOXXXXXXXXXXXXXXXXXXGOOXXXXXXXXXXXXXXXXXGOOOXXXXXXXXXXXXXXXXGOOXXXXXXXXXXXXXXXXXGXXXXXXXXXXXXXXXXXXXGOOOXXXXXXXXXXXXXXXXGOXXXXXXXXXXXXXXXXXXGOOOOXXXXXXXXXXXXXXX,0,0,0
4011,38,1,37,118,344,0,0,346,124,222,GOXXXXXXXXXXXXXXXXXXGOOXXXXXXXXXXXXXXXXXGOOOAXXXXXXXXXXXXXXXGOOXXXXXXXXXXXXXXXXXGXXXXXXXXXXXXXXXXXXXGOXXXXXXXXXXXXXXXXXXGOOXXXXXXXXXXXXXXXXXGOOOXXXXXXXXXXXXXXXXGOOXXXXXXXXXXXXXXXXXGXXXXXXXXXXXXXXXXXXXGOOOXXXXXXXXXXXXXXXXGOXXXXXXXXXXXXXXXXXXGOOOOXXXXXXXXXXXXXXX,0,0,0
4032,38,1,37,110,352,0,0,354,131,223,GOXXXXXXXXXXXXXXXXXXGOOXXXXXXXXXXXXXXXXXGOOOAXXXXXXXXXXXXXXXGOOXXXXXXXXXXXXXXXXXGXXXXXXXXXXXXXXXXXXXGOXXXXXXXXXXXXXXXXXXGOOXXXXXXXXXXXXXXXXXGOOOXXXXXXXXXXXXXXXXGOOXXXXXXXXXXXXXXXXXGXXXXXXXXXXXXXXXXXXXGOOOXXXXXXXXXXXXXXXXGOXXXXXXXXXXXXXXXXXXGOOOOXXXXXXXXXXXXXXX,0,0,0
4053,38,1,37,109,353,0,0,357,133,224,GOXXXXXXXXXXXXXXXXXXGOOXXXXXXXXXXXXXXXXXGOOOAXXXXXXXXXXXXXXXGOOXXXXXXXXXXXXXXXXXGXXXXXXXXXXXXXXXXXXXGOXXXXXXXXXXXXXXXXXXGOOXXXXXXXXXXXXXXXXXGOOOXXXXXXXXXXXXXXXXGOOXXXXXXXXXXXXXXXXXGXXXXXXXXXXXXXXXXXXXGOOOXXXXXXXXXXXXXXXXGOXXXXXXXXXXXXXXXXXXGOOOOXXXXXXXXXXXXXXX,0,0,0
4074,38,1,37,116,346,0,0,349,131,218,GOXXXXXXXXXXXXXXXXXXGOOXXXXXXXXXXXXXXXXXGOOOAXXXXXXXXXXXXXXXGOOXXXXXXXXXXXXXXXXXGXXXXXXXXXXXXXXXXXXXGOXXXXXXXXXXXXXXXXXXGOOXXXXXXXXXXXXXXXXXGOOOXXXXXXXXXXXXXXXXGOOXXXXXXXXXXXXXXXXXGXXXXXXXXXXXXXXXXXXXGOOOXXXXXXXXXXXXXXXXGOXXXXXXXXXXXXXXXXXXGOOOOXXXXXXXXXXXXXXX,0,0,0

4095,38,1,37,117,345,0,0,349,128,221,GOXXXXXXXXXXXXXXXXXXGOOXXXXXXXXXXXXXXXXXGOOOAXXXXXXXXXXXXXXXGOOXXXXXXXXXXXXXXXXXGXXXXXXXXXXXXXXXXXXXGOXXXXXXXXXXXXXXXXXXGOOXXXXXXXXXXXXXXXXXGOOOXXXXXXXXXXXXXXXXGOOXXXXXXXXXXXXXXXXXGXXXXXXXXXXXXXXXXXXXGOOOXXXXXXXXXXXXXXXXGOXXXXXXXXXXXXXXXXXXGOOOOXXXXXXXXXXXXXXX,0,0,0
4116,38,1,37,118,344,0,0,347,130,217,GOXXXXXXXXXXXXXXXXXXGOOXXXXXXXXXXXXXXXXXGOOOAXXXXXXXXXXXXXXXGOOXXXXXXXXXXXXXXXXXGXXXXXXXXXXXXXXXXXXXGOXXXXXXXXXXXXXXXXXXGOOXXXXXXXXXXXXXXXXXGOOOXXXXXXXXXXXXXXXXGOOXXXXXXXXXXXXXXXXXGXXXXXXXXXXXXXXXXXXXGOOOXXXXXXXXXXXXXXXXGOXXXXXXXXXXXXXXXXXXGOOOOXXXXXXXXXXXXXXX,0,0,0
4137,38,1,37,119,343,0,0,347,137,210,GOXXXXXXXXXXXXXXXXXXGOOXXXXXXXXXXXXXXXXXGOOOAXXXXXXXXXXXXXXXGOOXXXXXXXXXXXXXXXXXGXXXXXXXXXXXXXXXXXXXGOXXXXXXXXXXXXXXXXXXGOOXXXXXXXXXXXXXXXXXGOOOXXXXXXXXXXXXXXXXGOOXXXXXXXXXXXXXXXXXGXXXXXXXXXXXXXXXXXXXGOOOXXXXXXXXXXXXXXXXGOXXXXXXXXXXXXXXXXXXGOOOOXXXXXXXXXXXXXXX,0,0,0
4158,38,1,37,128,334,0,0,339,135,204,GOXXXXXXXXXXXXXXXXXXGOOXXXXXXXXXXXXXXXXXGOOOAXXXXXXXXXXXXXXXGOOXXXXXXXXXXXXXXXXXGXXXXXXXXXXXXXXXXXXXGOXXXXXXXXXXXXXXXXXXGOOXXXXXXXXXXXXXXXXXGOOOXXXXXXXXXXXXXXXXGOOXXXXXXXXXXXXXXXXXGXXXXXXXXXXXXXXXXXXXGOOOXXXXXXXXXXXXXXXXGOXXXXXXXXXXXXXXXXXXGOOOOXXXXXXXXXXXXXXX,0,0,0
4179,38,1,37,128,334,0,0,339,132,207,GOXXXXXXXXXXXXXXXXXXGOOXXXXXXXXXXXXXXXXXGOOOAXXXXXXXXXXXXXXXGOOXXXXXXXXXXXXXXXXXGXXXXXXXXXXXXXXXXXXXGOXXXXXXXXXXXXXXXXXXGOOXXXXXXXXXXXXXXXXXGOOOXXXXXXXXXXXXXXXXGOOXXXXXXXXXXXXXXXXXGXXXXXXXXXXXXXXXXXXXGOOOXXXXXXXXXXXXXXXXGOXXXXXXXXXXXXXXXXXXGOOOOXXXXXXXXXXXXXXX,0,0,0

4200,39,2,37,130,331,0,0,336,136,200,GOXXXXXXXXXXXXXXXXXXGOOXXXXXXXXXXXXXXXXXGOOOAXXXXXXXXXXXXXXXGOOXXXXXXXXXXXXXXXXXGXXXXXXXXXXXXXXXXXXXGOAXXXXXXXXXXXXXXXXXGOOXXXXXXXXXXXXXXXXXGOOOXXXXXXXXXXXXXXXXGOOXXXXXXXXXXXXXXXXXGXXXXXXXXXXXXXXXXXXXGOOOXXXXXXXXXXXXXXXXGOXXXXXXXXXXXXXXXXXXGOOOOXXXXXXXXXXXXXXX,0,0,0
4221,39,1,38,132,329,0,0,335,136,199,GOXXXXXXXXXXXXXXXXXXGOOXXXXXXXXXXXXXXXXXGOOOOXXXXXXXXXXXXXXXGOOXXXXXXXXXXXXXXXXXGXXXXXXXXXXXXXXXXXXXGOAXXXXXXXXXXXXXXXXXGOOXXXXXXXXXXXXXXXXXGOOOXXXXXXXXXXXXXXXXGOOXXXXXXXXXXXXXXXXXGXXXXXXXXXXXXXXXXXXXGOOOXXXXXXXXXXXXXXXXGOXXXXXXXXXXXXXXXXXXGOOOOXXXXXXXXXXXXXXX,0,0,0
4242,39,1,38,136,325,0,0,330,135,195,GOXXXXXXXXXXXXXXXXXXGOOXXXXXXXXXXXXXXXXXGOOOOXXXXXXXXXXXXXXXGOOXXXXXXXXXXXXXXXXXGXXXXXXXXXXXXXXXXXXXGOAXXXXXXXXXXXXXXXXXGOOXXXXXXXXXXXXXXXXXGOOOXXXXXXXXXXXXXXXXGOOXXXXXXXXXXXXXXXXXGXXXXXXXXXXXXXXXXXXXGOOOXXXXXXXXXXXXXXXXGOXXXXXXXXXXXXXXXXXXGOOOOXXXXXXXXXXXXXXX,0,0,0
4263,39,0,39,139,322,0,0,327,133,194,GOXXXXXXXXXXXXXXXXXXGOOXXXXXXXXXXXXXXXXXGOOOOXXXXXXXXXXXXXXXGOOXXXXXXXXXXXXXXXXXGXXXXXXXXXXXXXXXXXXXGOOXXXXXXXXXXXXXXXXXGOOXXXXXXXXXXXXXXXXXGOOOXXXXXXXXXXXXXXXXGOOXXXXXXXXXXXXXXXXXGXXXXXXXXXXXXXXXXXXXGOOOXXXXXXXXXXXXXXXXGOXXXXXXXXXXXXXXXXXXGOOOOXXXXXXXXXXXXXXX,0,0,0
4284,39,0,39,135,326,0,0,331,134,197,GOXXXXXXXXXXXXXXXXXXGOOXXXXXXXXXXXXXXXXXGOOOOXXXXXXXXXXXXXXXGOOXXXXXXXXXXXXXXXXXGXXXXXXXXXXXXXXXXXXXGOOXXXXXXXXXXXXXXXXXGOOXXXXXXXXXXXXXXXXXGOOOXXXXXXXXXXXXXXXXGOOXXXXXXXXXXXXXXXXXGXXXXXXXXXXXXXXXXXXXGOOOXXXXXXXXXXXXXXXXGOXXXXXXXXXXXXXXXXXXGOOOOXXXXXXXXXXXXXXX,0,0,0

4305,39,0,39,141,320,0,0,325,135,190,GOXXXXXXXXXXXXXXXXXXGOOXXXXXXXXXXXXXXXXXGOOOOXXXXXXXXXXXXXXXGOOXXXXXXXXXXXXXXXXXGXXXXXXXXXXXXXXXXXXXGOOXXXXXXXXXXXXXXXXXGOOXXXXXXXXXXXXXXXXXGOOOXXXXXXXXXXXXXXXXGOOXXXXXXXXXXXXXXXXXGXXXXXXXXXXXXXXXXXXXGOOOXXXXXXXXXXXXXXXXGOXXXXXXXXXXXXXXXXXXGOOOOXXXXXXXXXXXXXXX,0,0,0
4326,39,0,39,136,325,0,0,330,138,192,GOXXXXXXXXXXXXXXXXXXGOOXXXXXXXXXXXXXXXXXGOOOOXXXXXXXXXXXXXXXGOOXXXXXXXXXXXXXXXXXGXXXXXXXXXXXXXXXXXXXGOOXXXXXXXXXXXXXXXXXGOOXXXXXXXXXXXXXXXXXGOOOXXXXXXXXXXXXXXXXGOOXXXXXXXXXXXXXXXXXGXXXXXXXXXXXXXXXXXXXGOOOXXXXXXXXXXXXXXXXGOXXXXXXXXXXXXXXXXXXGOOOOXXXXXXXXXXXXXXX,0,0,0
4347,39,0,39,133,328,0,0,332,141,191,GOXXXXXXXXXXXXXXXXXXGOOXXXXXXXXXXXXXXXXXGOOOOXXXXXXXXXXXXXXXGOOXXXXXXXXXXXXXXXXXGXXXXXXXXXXXXXXXXXXXGOOXXXXXXXXXXXXXXXXXGOOXXXXXXXXXXXXXXXXXGOOOXXXXXXXXXXXXXXXXGOOXXXXXXXXXXXXXXXXXGXXXXXXXXXXXXXXXXXXXGOOOXXXXXXXXXXXXXXXXGOXXXXXXXXXXXXXXXXXXGOOOOXXXXXXXXXXXXXXX,0,0,0
4368,39,0,39,133,328,0,0,333,137,196,GOXXXXXXXXXXXXXXXXXXGOOXXXXXXXXXXXXXXXXXGOOOOXXXXXXXXXXXXXXXGOOXXXXXXXXXXXXXXXXXGXXXXXXXXXXXXXXXXXXXGOOXXXXXXXXXXXXXXXXXGOOXXXXXXXXXXXXXXXXXGOOOXXXXXXXXXXXXXXXXGOOXXXXXXXXXXXXXXXXXGXXXXXXXXXXXXXXXXXXXGOOOXXXXXXXXXXXXXXXXGOXXXXXXXXXXXXXXXXXXGOOOOXXXXXXXXXXXXXXX,0,0,0
4389,39,0,39,125,336,0,0,342,141,201,GOXXXXXXXXXXXXXXXXXXGOOXXXXXXXXXXXXXXXXXGOOOOXXXXXXXXXXXXXXXGOOXXXXXXXXXXXXXXXXXGXXXXXXXXXXXXXXXXXXXGOOXXXXXXXXXXXXXXXXXGOOXXXXXXXXXXXXXXXXXGOOOXXXXXXXXXXXXXXXXGOOXXXXXXXXXXXXXXXXXGXXXXXXXXXXXXXXXXXXXGOOOXXXXXXXXXXXXXXXXGOXXXXXXXXXXXXXXXXXXGOOOOXXXXXXXXXXXXXXX,0,0,0

4410,39,0,39,129,332,0,0,336,135,201,GOXXXXXXXXXXXXXXXXXXGOOXXXXXXXXXXXXXXXXXGOOOOXXXXXXXXXXXXXXXGOOXXXXXXXXXXXXXXXXXGXXXXXXXXXXXXXXXXXXXGOOXXXXXXXXXXXXXXXXXGOOXXXXXXXXXXXXXXXXXGOOOXXXXXXXXXXXXXXXXGOOXXXXXXXXXXXXXXXXXGXXXXXXXXXXXXXXXXXXXGOOOXXXXXXXXXXXXXXXXGOXXXXXXXXXXXXXXXXXXGOOOOXXXXXXXXXXXXXXX,0,0,0
4431,39,0,39,119,342,0,0,345,134,211,GOXXXXXXXXXXXXXXXXXXGOOXXXXXXXXXXXXXXXXXGOOOOXXXXXXXXXXXXXXXGOOXXXXXXXXXXXXXXXXXGXXXXXXXXXXXXXXXXXXXGOOXXXXXXXXXXXXXXXXXGOOXXXXXXXXXXXXXXXXXGOOOXXXXXXXXXXXXXXXXGOOXXXXXXXXXXXXXXXXXGXXXXXXXXXXXXXXXXXXXGOOOXXXXXXXXXXXXXXXXGOXXXXXXXXXXXXXXXXXXGOOOOXXXXXXXXXXXXXXX,0,0,0
4452,39,0,39,125,336,0,0,339,136,203,GOXXXXXXXXXXXXXXXXXXGOOXXXXXXXXXXXXXXXXXGOOOOXXXXXXXXXXXXXXXGOOXXXXXXXXXXXXXXXXXGXXXXXXXXXXXXXXXXXXXGOOXXXXXXXXXXXXXXXXXGOOXXXXXXXXXXXXXXXXXGOOOXXXXXXXXXXXXXXXXGOOXXXXXXXXXXXXXXXXXGXXXXXXXXXXXXXXXXXXXGOOOXXXXXXXXXXXXXXXXGOXXXXXXXXXXXXXXXXXXGOOOOXXXXXXXXXXXXXXX,0,0,0
4473,39,0,39,122,339,0,0,343,142,201,GOXXXXXXXXXXXXXXXXXXGOOXXXXXXXXXXXXXXXXXGOOOOXXXXXXXXXXXXXXXGOOXXXXXXXXXXXXXXXXXGXXXXXXXXXXXXXXXXXXXGOOXXXXXXXXXXXXXXXXXGOOXXXXXXXXXXXXXXXXXGOOOXXXXXXXXXXXXXXXXGOOXXXXXXXXXXXXXXXXXGXXXXXXXXXXXXXXXXXXXGOOOXXXXXXXXXXXXXXXXGOXXXXXXXXXXXXXXXXXXGOOOOXXXXXXXXXXXXXXX,0,0,0
4494,39,0,39,125,336,0,0,338,139,199,GOXXXXXXXXXXXXXXXXXXGOOXXXXXXXXXXXXXXXXXGOOOOXXXXXXXXXXXXXXXGOOXXXXXXXXXXXXXXXXXGXXXXXXXXXXXXXXXXXXXGOOXXXXXXXXXXXXXXXXXGOOXXXXXXXXXXXXXXXXXGOOOXXXXXXXXXXXXXXXXGOOXXXXXXXXXXXXXXXXXGXXXXXXXXXXXXXXXXXXXGOOOXXXXXXXXXXXXXXXXGOXXXXXXXXXXXXXXXXXXGOOOOXXXXXXXXXXXXXXX,0,0,0

4515,40,1,39,126,334,0,0,337,137,200,GOXXXXXXXXXXXXXXXXXXGOOXXXXXXXXXXXXXXXXXGOOOOXXXXXXXXXXXXXXXGOOXXXXXXXXXXXXXXXXXGXXXXXXXXXXXXXXXXXXXGOOAXXXXXXXXXXXXXXXXGOOXXXXXXXXXXXXXXXXXGOOOXXXXXXXXXXXXXXXXGOOXXXXXXXXXXXXXXXXXGXXXXXXXXXXXXXXXXXXXGOOOXXXXXXXXXXXXXXXXGOXXXXXXXXXXXXXXXXXXGOOOOXXXXXXXXXXXXXXX,0,0,0
4536,40,1,39,127,333,0,0,337,139,198,GOXXXXXXXXXXXXXXXXXXGOOXXXXXXXXXXXXXXXXXGOOOOXXXXXXXXXXXXXXXGOOXXXXXXXXXXXXXXXXXGXXXXXXXXXXXXXXXXXXXGOOAXXXXXXXXXXXXXXXXGOOXXXXXXXXXXXXXXXXXGOOOXXXXXXXXXXXXXXXXGOOXXXXXXXXXXXXXXXXXGXXXXXXXXXXXXXXXXXXXGOOOXXXXXXXXXXXXXXXXGOXXXXXXXXXXXXXXXXXXGOOOOXXXXXXXXXXXXXXX,0,0,0
4557,40,0,40,123,337,0,0,341,134,207,GOXXXXXXXXXXXXXXXXXXGOOXXXXXXXXXXXXXXXXXGOOOOXXXXXXXXXXXXXXXGOOXXXXXXXXXXXXXXXXXGXXXXXXXXXXXXXXXXXXXGOOOXXXXXXXXXXXXXXXXGOOXXXXXXXXXXXXXXXXXGOOOXXXXXXXXXXXXXXXXGOOXXXXXXXXXXXXXXXXXGXXXXXXXXXXXXXXXXXXXGOOOXXXXXXXXXXXXXXXXGOXXXXXXXXXXXXXXXXXXGOOOOXXXXXXXXXXXXXXX,0,0,0
4578,40,0,40,114,346,0,0,349,139,210,GOXXXXXXXXXXXXXXXXXXGOOXXXXXXXXXXXXXXXXXGOOOOXXXXXXXXXXXXXXXGOOXXXXXXXXXXXXXXXXXGXXXXXXXXXXXXXXXXXXXGOOOXXXXXXXXXXXXXXXXGOOXXXXXXXXXXXXXXXXXGOOOXXXXXXXXXXXXXXXXGOOXXXXXXXXXXXXXXXXXGXXXXXXXXXXXXXXXXXXXGOOOXXXXXXXXXXXXXXXXGOXXXXXXXXXXXXXXXXXXGOOOOXXXXXXXXXXXXXXX,0,0,0
4599,40,0,40,110,350,0,0,353,139,214,GOXXXXXXXXXXXXXXXXXXGOOXXXXXXXXXXXXXXXXXGOOOOXXXXXXXXXXXXXXXGOOXXXXXXXXXXXXXXXXXGXXXXXXXXXXXXXXXXXXXGOOOXXXXXXXXXXXXXXXXGOOXXXXXXXXXXXXXXXXXGOOOXXXXXXXXXXXXXXXXGOOXXXXXXXXXXXXXXXXXGXXXXXXXXXXXXXXXXXXXGOOOXXXXXXXXXXXXXXXXGOXXXXXXXXXXXXXXXXXXGOOOOXXXXXXXXXXXXXXX,0,0,0

4620,41,1,40,103,356,0,0,360,135,225,GOXXXXXXXXXXXXXXXXXXGOOAXXXXXXXXXXXXXXXXGOOOOXXXXXXXXXXXXXXXGOOXXXXXXXXXXXXXXXXXGXXXXXXXXXXXXXXXXXXXGOOOXXXXXXXXXXXXXXXXGOOXXXXXXXXXXXXXXXXXGOOOXXXXXXXXXXXXXXXXGOOXXXXXXXXXXXXXXXXXGXXXXXXXXXXXXXXXXXXXGOOOXXXXXXXXXXXXXXXXGOXXXXXXXXXXXXXXXXXXGOOOOXXXXXXXXXXXXXXX,0,0,0
4641,41,1,40,104,355,0,0,357,141,216,GOXXXXXXXXXXXXXXXXXXGOOAXXXXXXXXXXXXXXXXGOOOOXXXXXXXXXXXXXXXGOOXXXXXXXXXXXXXXXXXGXXXXXXXXXXXXXXXXXXXGOOOXXXXXXXXXXXXXXXXGOOXXXXXXXXXXXXXXXXXGOOOXXXXXXXXXXXXXXXXGOOXXXXXXXXXXXXXXXXXGXXXXXXXXXXXXXXXXXXXGOOOXXXXXXXXXXXXXXXXGOXXXXXXXXXXXXXXXXXXGOOOOXXXXXXXXXXXXXXX,0,0,0
4662,41,1,40,107,352,0,0,356,140,216,GOXXXXXXXXXXXXXXXXXXGOOAXXXXXXXXXXXXXXXXGOOOOXXXXXXXXXXXXXXXGOOXXXXXXXXXXXXXXXXXGXXXXXXXXXXXXXXXXXXXGOOOXXXXXXXXXXXXXXXXGOOXXXXXXXXXXXXXXXXXGOOOXXXXXXXXXXXXXXXXGOOXXXXXXXXXXXXXXXXXGXXXXXXXXXXXXXXXXXXXGOOOXXXXXXXXXXXXXXXXGOXXXXXXXXXXXXXXXXXXGOOOOXXXXXXXXXXXXXXX,0,0,0
4683,41,1,40,107,352,0,0,356,144,212,GOXXXXXXXXXXXXXXXXXXGOOAXXXXXXXXXXXXXXXXGOOOOXXXXXXXXXXXXXXXGOOXXXXXXXXXXXXXXXXXGXXXXXXXXXXXXXXXXXXXGOOOXXXXXXXXXXXXXXXXGOOXXXXXXXXXXXXXXXXXGOOOXXXXXXXXXXXXXXXXGOOXXXXXXXXXXXXXXXXXGXXXXXXXXXXXXXXXXXXXGOOOXXXXXXXXXXXXXXXXGOXXXXXXXXXXXXXXXXXXGOOOOXXXXXXXXXXXXXXX,0,0,0
4704,41,1,40,109,350,0,0,353,144,209,GOXXXXXXXXXXXXXXXXXXGOOAXXXXXXXXXXXXXXXXGOOOOXXXXXXXXXXXXXXXGOOXXXXXXXXXXXXXXXXXGXXXXXXXXXXXXXXXXXXXGOOOXXXXXXXXXXXXXXXXGOOXXXXXXXXXXXXXXXXXGOOOXXXXXXXXXXXXXXXXGOOXXXXXXXXXXXXXXXXXGXXXXXXXXXXXXXXXXXXXGOOOXXXXXXXXXXXXXXXXGOXXXXXXXXXXXXXXXXXXGOOOOXXXXXXXXXXXXXXX,0,0,0

4725,41,0,41,111,348,0,0,352,145,207,GOXXXXXXXXXXXXXXXXXXGOOOXXXXXXXXXXXXXXXXGOOOOXXXXXXXXXXXXXXXGOOXXXXXXXXXXXXXXXXXGXXXXXXXXXXXXXXXXXXXGOOOXXXXXXXXXXXXXXXXGOOXXXXXXXXXXXXXXXXXGOOOXXXXXXXXXXXXXXXXGOOXXXXXXXXXXXXXXXXXGXXXXXXXXXXXXXXXXXXXGOOOXXXXXXXXXXXXXXXXGOXXXXXXXXXXXXXXXXXXGOOOOXXXXXXXXXXXXXXX,0,0,0
4746,42,1,41,115,343,0,0,346,140,206,GOXXXXXXXXXXXXXXXXXXGOOOXXXXXXXXXXXXXXXXGOOOOXXXXXXXXXXXXXXXGOOXXXXXXXXXXXXXXXXXGXXXXXXXXXXXXXXXXXXXGOOOXXXXXXXXXXXXXXXXGOOAXXXXXXXXXXXXXXXXGOOOXXXXXXXXXXXXXXXXGOOXXXXXXXXXXXXXXXXXGXXXXXXXXXXXXXXXXXXXGOOOXXXXXXXXXXXXXXXXGOXXXXXXXXXXXXXXXXXXGOOOOXXXXXXXXXXXXXXX,0,0,0
4767,42,1,41,111,347,0,0,348,141,207,GOXXXXXXXXXXXXXXXXXXGOOOXXXXXXXXXXXXXXXXGOOOOXXXXXXXXXXXXXXXGOOXXXXXXXXXXXXXXXXXGXXXXXXXXXXXXXXXXXXXGOOOXXXXXXXXXXXXXXXXGOOAXXXXXXXXXXXXXXXXGOOOXXXXXXXXXXXXXXXXGOOXXXXXXXXXXXXXXXXXGXXXXXXXXXXXXXXXXXXXGOOOXXXXXXXXXXXXXXXXGOXXXXXXXXXXXXXXXXXXGOOOOXXXXXXXXXXXXXXX,0,0,0
4788,42,0,42,111,347,0,0,349,147,202,GOXXXXXXXXXXXXXXXXXXGOOOXXXXXXXXXXXXXXXXGOOOOXXXXXXXXXXXXXXXGOOXXXXXXXXXXXXXXXXXGXXXXXXXXXXXXXXXXXXXGOOOXXXXXXXXXXXXXXXXGOOOXXXXXXXXXXXXXXXXGOOOXXXXXXXXXXXXXXXXGOOXXXXXXXXXXXXXXXXXGXXXXXXXXXXXXXXXXXXXGOOOXXXXXXXXXXXXXXXXGOXXXXXXXXXXXXXXXXXXGOOOOXXXXXXXXXXXXXXX,0,0,0
4809,43,0,43,105,352,0,0,353,140,213,GOXXXXXXXXXXXXXXXXXXGOOOXXXXXXXXXXXXXXXXGOOOOXXXXXXXXXXXXXXXGOOXXXXXXXXXXXXXXXXXGXXXXXXXXXXXXXXXXXXXGOOOXXXXXXXXXXXXXXXXGOOOXXXXXXXXXXXXXXXXGOOOXXXXXXXXXXXXXXXXGOOXXXXXXXXXXXXXXXXXGXXXXXXXXXXXXXXXXXXXGOOOXXXXXXXXXXXXXXXXGOOXXXXXXXXXXXXXXXXXGOOOOXXXXXXXXXXXXXXX,0,0,0

4830,43,0,43,101,356,0,0,359,153,206,GOXXXXXXXXXXXXXXXXXXGOOOXXXXXXXXXXXXXXXXGOOOOXXXXXXXXXXXXXXXGOOXXXXXXXXXXXXXXXXXGXXXXXXXXXXXXXXXXXXXGOOOXXXXXXXXXXXXXXXXGOOOXXXXXXXXXXXXXXXXGOOOXXXXXXXXXXXXXXXXGOOXXXXXXXXXXXXXXXXXGXXXXXXXXXXXXXXXXXXXGOOOXXXXXXXXXXXXXXXXGOOXXXXXXXXXXXXXXXXXGOOOOXXXXXXXXXXXXXXX,0,0,0
4851,43,0,43,106,351,0,0,352,155,197,GOXXXXXXXXXXXXXXXXXXGOOOXXXXXXXXXXXXXXXXGOOOOXXXXXXXXXXXXXXXGOOXXXXXXXXXXXXXXXXXGXXXXXXXXXXXXXXXXXXXGOOOXXXXXXXXXXXXXXXXGOOOXXXXXXXXXXXXXXXXGOOOXXXXXXXXXXXXXXXXGOOXXXXXXXXXXXXXXXXXGXXXXXXXXXXXXXXXXXXXGOOOXXXXXXXXXXXXXXXXGOOXXXXXXXXXXXXXXXXXGOOOOXXXXXXXXXXXXXXX,0,0,0
4872,43,0,43,115,342,0,0,344,149,195,GOXXXXXXXXXXXXXXXXXXGOOOXXXXXXXXXXXXXXXXGOOOOXXXXXXXXXXXXXXXGOOXXXXXXXXXXXXXXXXXGXXXXXXXXXXXXXXXXXXXGOOOXXXXXXXXXXXXXXXXGOOOXXXXXXXXXXXXXXXXGOOOXXXXXXXXXXXXXXXXGOOXXXXXXXXXXXXXXXXXGXXXXXXXXXXXXXXXXXXXGOOOXXXXXXXXXXXXXXXXGOOXXXXXXXXXXXXXXXXXGOOOOXXXXXXXXXXXXXXX,0,0,0
4893,43,0,43,118,339,0,0,341,146,195,GOXXXXXXXXXXXXXXXXXXGOOOXXXXXXXXXXXXXXXXGOOOOXXXXXXXXXXXXXXXGOOXXXXXXXXXXXXXXXXXGXXXXXXXXXXXXXXXXXXXGOOOXXXXXXXXXXXXXXXXGOOOXXXXXXXXXXXXXXXXGOOOXXXXXXXXXXXXXXXXGOOXXXXXXXXXXXXXXXXXGXXXXXXXXXXXXXXXXXXXGOOOXXXXXXXXXXXXXXXXGOOXXXXXXXXXXXXXXXXXGOOOOXXXXXXXXXXXXXXX,0,0,0
4914,43,0,43,119,338,0,0,340,152,188,GOXXXXXXXXXXXXXXXXXXGOOOXXXXXXXXXXXXXXXXGOOOOXXXXXXXXXXXXXXXGOOXXXXXXXXXXXXXXXXXGXXXXXXXXXXXXXXXXXXXGOOOXXXXXXXXXXXXXXXXGOOOXXXXXXXXXXXXXXXXGOOOXXXXXXXXXXXXXXXXGOOXXXXXXXXXXXXXXXXXGXXXXXXXXXXXXXXXXXXXGOOOXXXXXXXXXXXXXXXXGOOXXXXXXXXXXXXXXXXXGOOOOXXXXXXXXXXXXXXX,0,0,0

4935,43,0,43,126,331,0,0,332,148,184,GOXXXXXXXXXXXXXXXXXXGOOOXXXXXXXXXXXXXXXXGOOOOXXXXXXXXXXXXXXXGOOXXXXXXXXXXXXXXXXXGXXXXXXXXXXXXXXXXXXXGOOOXXXXXXXXXXXXXXXXGOOOXXXXXXXXXXXXXXXXGOOOXXXXXXXXXXXXXXXXGOOXXXXXXXXXXXXXXXXXGXXXXXXXXXXXXXXXXXXXGOOOXXXXXXXXXXXXXXXXGOOXXXXXXXXXXXXXXXXXGOOOOXXXXXXXXXXXXXXX,0,0,0
4956,43,0,43,131,326,0,0,328,150,178,GOXXXXXXXXXXXXXXXXXXGOOOXXXXXXXXXXXXXXXXGOOOOXXXXXXXXXXXXXXXGOOXXXXXXXXXXXXXXXXXGXXXXXXXXXXXXXXXXXXXGOOOXXXXXXXXXXXXXXXXGOOOXXXXXXXXXXXXXXXXGOOOXXXXXXXXXXXXXXXXGOOXXXXXXXXXXXXXXXXXGXXXXXXXXXXXXXXXXXXXGOOOXXXXXXXXXXXXXXXXGOOXXXXXXXXXXXXXXXXXGOOOOXXXXXXXXXXXXXXX,0,0,0
4977,43,0,43,119,338,0,0,341,152,189,GOXXXXXXXXXXXXXXXXXXGOOOXXXXXXXXXXXXXXXXGOOOOXXXXXXXXXXXXXXXGOOXXXXXXXXXXXXXXXXXGXXXXXXXXXXXXXXXXXXXGOOOXXXXXXXXXXXXXXXXGOOOXXXXXXXXXXXXXXXXGOOOXXXXXXXXXXXXXXXXGOOXXXXXXXXXXXXXXXXXGXXXXXXXXXXXXXXXXXXXGOOOXXXXXXXXXXXXXXXXGOOXXXXXXXXXXXXXXXXXGOOOOXXXXXXXXXXXXXXX,0,0,0
4998,43,0,43,122,335,0,0,339,151,188,GOXXXXXXXXXXXXXXXXXXGOOOXXXXXXXXXXXXXXXXGOOOOXXXXXXXXXXXXXXXGOOXXXXXXXXXXXXXXXXXGXXXXXXXXXXXXXXXXXXXGOOOXXXXXXXXXXXXXXXXGOOOXXXXXXXXXXXXXXXXGOOOXXXXXXXXXXXXXXXXGOOXXXXXXXXXXXXXXXXXGXXXXXXXXXXXXXXXXXXXGOOOXXXXXXXXXXXXXXXXGOOXXXXXXXXXXXXXXXXXGOOOOXXXXXXXXXXXXXXX,0,0,0
5019,43,0,43,119,338,0,0,340,153,187,GOXXXXXXXXXXXXXXXXXXGOOOXXXXXXXXXXXXXXXXGOOOOXXXXXXXXXXXXXXXGOOXXXXXXXXXXXXXXXXXGXXXXXXXXXXXXXXXXXXXGOOOXXXXXXXXXXXXXXXXGOOOXXXXXXXXXXXXXXXXGOOOXXXXXXXXXXXXXXXXGOOXXXXXXXXXXXXXXXXXGXXXXXXXXXXXXXXXXXXXGOOOXXXXXXXXXXXXXXXXGOOXXXXXXXXXXXXXXXXXGOOOOXXXXXXXXXXXXXXX,0,0,0

5040,43,0,43,125,332,0,0,337,153,184,GOXXXXXXXXXXXXXXXXXXGOOOXXXXXXXXXXXXXXXXGOOOOXXXXXXXXXXXXXXXGOOXXXXXXXXXXXXXXXXXGXXXXXXXXXXXXXXXXXXXGOOOXXXXXXXXXXXXXXXXGOOOXXXXXXXXXXXXXXXXGOOOXXXXXXXXXXXXXXXXGOOXXXXXXXXXXXXXXXXXGXXXXXXXXXXXXXXXXXXXGOOOXXXXXXXXXXXXXXXXGOOXXXXXXXXXXXXXXXXXGOOOOXXXXXXXXXXXXXXX,0,0,0
5061,43,0,43,121,336,0,0,340,155,185,GOXXXXXXXXXXXXXXXXXXGOOOXXXXXXXXXXXXXXXXGOOOOXXXXXXXXXXXXXXXGOOXXXXXXXXXXXXXXXXXGXXXXXXXXXXXXXXXXXXXGOOOXXXXXXXXXXXXXXXXGOOOXXXXXXXXXXXXXXXXGOOOXXXXXXXXXXXXXXXXGOOXXXXXXXXXXXXXXXXXGXXXXXXXXXXXXXXXXXXXGOOOXXXXXXXXXXXXXXXXGOOXXXXXXXXXXXXXXXXXGOOOOXXXXXXXXXXXXXXX,0,0,0
5082,43,0,43,123,334,0,0,336,151,185,GOXXXXXXXXXXXXXXXXXXGOOOXXXXXXXXXXXXXXXXGOOOOXXXXXXXXXXXXXXXGOOXXXXXXXXXXXXXXXXXGXXXXXXXXXXXXXXXXXXXGOOOXXXXXXXXXXXXXXXXGOOOXXXXXXXXXXXXXXXXGOOOXXXXXXXXXXXXXXXXGOOXXXXXXXXXXXXXXXXXGXXXXXXXXXXXXXXXXXXXGOOOXXXXXXXXXXXXXXXXGOOXXXXXXXXXXXXXXXXXGOOOOXXXXXXXXXXXXXXX,0,0,0
5103,43,0,43,121,336,0,0,337,155,182,GOXXXXXXXXXXXXXXXXXXGOOOXXXXXXXXXXXXXXXXGOOOOXXXXXXXXXXXXXXXGOOXXXXXXXXXXXXXXXXXGXXXXXXXXXXXXXXXXXXXGOOOXXXXXXXXXXXXXXXXGOOOXXXXXXXXXXXXXXXXGOOOXXXXXXXXXXXXXXXXGOOXXXXXXXXXXXXXXXXXGXXXXXXXXXXXXXXXXXXXGOOOXXXXXXXXXXXXXXXXGOOXXXXXXXXXXXXXXXXXGOOOOXXXXXXXXXXXXXXX,0,0,0
5124,43,0,43,121,336,0,0,338,152,186,GOXXXXXXXXXXXXXXXXXXGOOOXXXXXXXXXXXXXXXXGOOOOXXXXXXXXXXXXXXXGOOXXXXXXXXXXXXXXXXXGXXXXXXXXXXXXXXXXXXXGOOOXXXXXXXXXXXXXXXXGOOOXXXXXXXXXXXXXXXXGOOOXXXXXXXXXXXXXXXXGOOXXXXXXXXXXXXXXXXXGXXXXXXXXXXXXXXXXXXXGOOOXXXXXXXXXXXXXXXXGOOXXXXXXXXXXXXXXXXXGOOOOXXXXXXXXXXXXXXX,0,0,0

5145,43,0,43,113,344,0,0,347,153,194,GOXXXXXXXXXXXXXXXXXXGOOOXXXXXXXXXXXXXXXXGOOOOXXXXXXXXXXXXXXXGOOXXXXXXXXXXXXXXXXXGXXXXXXXXXXXXXXXXXXXGOOOXXXXXXXXXXXXXXXXGOOOXXXXXXXXXXXXXXXXGOOOXXXXXXXXXXXXXXXXGOOXXXXXXXXXXXXXXXXXGXXXXXXXXXXXXXXXXXXXGOOOXXXXXXXXXXXXXXXXGOOXXXXXXXXXXXXXXXXXGOOOOXXXXXXXXXXXXXXX,0,0,0
5166,43,0,43,110,347,0,0,352,153,199,GOXXXXXXXXXXXXXXXXXXGOOOXXXXXXXXXXXXXXXXGOOOOXXXXXXXXXXXXXXXGOOXXXXXXXXXXXXXXXXXGXXXXXXXXXXXXXXXXXXXGOOOXXXXXXXXXXXXXXXXGOOOXXXXXXXXXXXXXXXXGOOOXXXXXXXXXXXXXXXXGOOXXXXXXXXXXXXXXXXXGXXXXXXXXXXXXXXXXXXXGOOOXXXXXXXXXXXXXXXXGOOXXXXXXXXXXXXXXXXXGOOOOXXXXXXXXXXXXXXX,0,0,0
5187,43,0,43,103,354,0,0,358,158,200,GOXXXXXXXXXXXXXXXXXXGOOOXXXXXXXXXXXXXXXXGOOOOXXXXXXXXXXXXXXXGOOXXXXXXXXXXXXXXXXXGXXXXXXXXXXXXXXXXXXXGOOOXXXXXXXXXXXXXXXXGOOOXXXXXXXXXXXXXXXXGOOOXXXXXXXXXXXXXXXXGOOXXXXXXXXXXXXXXXXXGXXXXXXXXXXXXXXXXXXXGOOOXXXXXXXXXXXXXXXXGOOXXXXXXXXXXXXXXXXXGOOOOXXXXXXXXXXXXXXX,0,0,0
5208,43,0,43,102,355,0,0,358,153,205,GOXXXXXXXXXXXXXXXXXXGOOOXXXXXXXXXXXXXXXXGOOOOXXXXXXXXXXXXXXXGOOXXXXXXXXXXXXXXXXXGXXXXXXXXXXXXXXXXXXXGOOOXXXXXXXXXXXXXXXXGOOOXXXXXXXXXXXXXXXXGOOOXXXXXXXXXXXXXXXXGOOXXXXXXXXXXXXXXXXXGXXXXXXXXXXXXXXXXXXXGOOOXXXXXXXXXXXXXXXXGOOXXXXXXXXXXXXXXXXXGOOOOXXXXXXXXXXXXXXX,0,0,0
5229,43,0,43,103,354,0,0,358,153,205,GOXXXXXXXXXXXXXXXXXXGOOOXXXXXXXXXXXXXXXXGOOOOXXXXXXXXXXXXXXXGOOXXXXXXXXXXXXXXXXXGXXXXXXXXXXXXXXXXXXXGOOOXXXXXXXXXXXXXXXXGOOOXXXXXXXXXXXXXXXXGOOOXXXXXXXXXXXXXXXXGOOXXXXXXXXXXXXXXXXXGXXXXXXXXXXXXXXXXXXXGOOOXXXXXXXXXXXXXXXXGOOXXXXXXXXXXXXXXXXXGOOOOXXXXXXXXXXXXXXX,0,0,0

5250,43,0,43,109,348,0,0,352,156,196,GOXXXXXXXXXXXXXXXXXXGOOOXXXXXXXXXXXXXXXXGOOOOXXXXXXXXXXXXXXXGOOXXXXXXXXXXXXXXXXXGXXXXXXXXXXXXXXXXXXXGOOOXXXXXXXXXXXXXXXXGOOOXXXXXXXXXXXXXXXXGOOOXXXXXXXXXXXXXXXXGOOXXXXXXXXXXXXXXXXXGXXXXXXXXXXXXXXXXXXXGOOOXXXXXXXXXXXXXXXXGOOXXXXXXXXXXXXXXXXXGOOOOXXXXXXXXXXXXXXX,0,0,0
5271,44,0,44,107,349,0,0,353,159,194,GOXXXXXXXXXXXXXXXXXXGOOOXXXXXXXXXXXXXXXXGOOOOXXXXXXXXXXXXXXXGOOXXXXXXXXXXXXXXXXXGXXXXXXXXXXXXXXXXXXXGOOOXXXXXXXXXXXXXXXXGOOOXXXXXXXXXXXXXXXXGOOOOXXXXXXXXXXXXXXXGOOXXXXXXXXXXXXXXXXXGXXXXXXXXXXXXXXXXXXXGOOOXXXXXXXXXXXXXXXXGOOXXXXXXXXXXXXXXXXXGOOOOXXXXXXXXXXXXXXX,0,0,0
5292,44,0,44,109,347,0,0,350,154,196,GOXXXXXXXXXXXXXXXXXXGOOOXXXXXXXXXXXXXXXXGOOOOXXXXXXXXXXXXXXXGOOXXXXXXXXXXXXXXXXXGXXXXXXXXXXXXXXXXXXXGOOOXXXXXXXXXXXXXXXXGOOOXXXXXXXXXXXXXXXXGOOOOXXXXXXXXXXXXXXXGOOXXXXXXXXXXXXXXXXXGXXXXXXXXXXXXXXXXXXXGOOOXXXXXXXXXXXXXXXXGOOXXXXXXXXXXXXXXXXXGOOOOXXXXXXXXXXXXXXX,0,0,0
5313,44,0,44,104,352,0,0,355,156,199,GOXXXXXXXXXXXXXXXXXXGOOOXXXXXXXXXXXXXXXXGOOOOXXXXXXXXXXXXXXXGOOXXXXXXXXXXXXXXXXXGXXXXXXXXXXXXXXXXXXXGOOOXXXXXXXXXXXXXXXXGOOOXXXXXXXXXXXXXXXXGOOOOXXXXXXXXXXXXXXXGOOXXXXXXXXXXXXXXXXXGXXXXXXXXXXXXXXXXXXXGOOOXXXXXXXXXXXXXXXXGOOXXXXXXXXXXXXXXXXXGOOOOXXXXXXXXXXXXXXX,0,0,0
5334,45,1,44,108,347,0,0,352,158,194,GOXXXXXXXXXXXXXXXXXXGOOOXXXXXXXXXXXXXXXXGOOOOXXXXXXXXXXXXXXXGOOAXXXXXXXXXXXXXXXXGXXXXXXXXXXXXXXXXXXXGOOOXXXXXXXXXXXXXXXXGOOOXXXXXXXXXXXXXXXXGOOOOXXXXXXXXXXXXXXXGOOXXXXXXXXXXXXXXXXXGXXXXXXXXXXXXXXXXXXXGOOOXXXXXXXXXXXXXXXXGOOXXXXXXXXXXXXXXXXXGOOOOXXXXXXXXXXXXXXX,0,0,0

5355,45,1,44,113,342,0,0,345,160,185,GOXXXXXXXXXXXXXXXXXXGOOOXXXXXXXXXXXXXXXXGOOOOXXXXXXXXXXXXXXXGOOAXXXXXXXXXXXXXXXXGXXXXXXXXXXXXXXXXXXXGOOOXXXXXXXXXXXXXXXXGOOOXXXXXXXXXXXXXXXXGOOOOXXXXXXXXXXXXXXXGOOXXXXXXXXXXXXXXXXXGXXXXXXXXXXXXXXXXXXXGOOOXXXXXXXXXXXXXXXXGOOXXXXXXXXXXXXXXXXXGOOOOXXXXXXXXXXXXXXX,0,0,0
5376,45,1,44,110,345,0,0,352,161,191,GOXXXXXXXXXXXXXXXXXXGOOOXXXXXXXXXXXXXXXXGOOOOXXXXXXXXXXXXXXXGOOAXXXXXXXXXXXXXXXXGXXXXXXXXXXXXXXXXXXXGOOOXXXXXXXXXXXXXXXXGOOOXXXXXXXXXXXXXXXXGOOOOXXXXXXXXXXXXXXXGOOXXXXXXXXXXXXXXXXXGXXXXXXXXXXXXXXXXXXXGOOOXXXXXXXXXXXXXXXXGOOXXXXXXXXXXXXXXXXXGOOOOXXXXXXXXXXXXXXX,0,0,0
5397,46,2,44,116,338,0,0,345,154,191,GOXXXXXXXXXXXXXXXXXXGOOOXXXXXXXXXXXXXXXXGOOOOXXXXXXXXXXXXXXXGOOAXXXXXXXXXXXXXXXXGXXXXXXXXXXXXXXXXXXXGOOOXXXXXXXXXXXXXXXXGOOOXXXXXXXXXXXXXXXXGOOOOXXXXXXXXXXXXXXXGOOAXXXXXXXXXXXXXXXXGXXXXXXXXXXXXXXXXXXXGOOOXXXXXXXXXXXXXXXXGOOXXXXXXXXXXXXXXXXXGOOOOXXXXXXXXXXXXXXX,0,0,0
5418,46,1,45,105,349,0,0,352,157,195,GOXXXXXXXXXXXXXXXXXXGOOOXXXXXXXXXXXXXXXXGOOOOXXXXXXXXXXXXXXXGOOAXXXXXXXXXXXXXXXXGXXXXXXXXXXXXXXXXXXXGOOOXXXXXXXXXXXXXXXXGOOOXXXXXXXXXXXXXXXXGOOOOXXXXXXXXXXXXXXXGOOOXXXXXXXXXXXXXXXXGXXXXXXXXXXXXXXXXXXXGOOOXXXXXXXXXXXXXXXXGOOXXXXXXXXXXXXXXXXXGOOOOXXXXXXXXXXXXXXX,0,0,0
5439,48,2,46,106,346,0,0,352,154,198,GOXXXXXXXXXXXXXXXXXXGOOOXXXXXXXXXXXXXXXXGOOOOXXXXXXXXXXXXXXXGOOAXXXXXXXXXXXXXXXXGXXXXXXXXXXXXXXXXXXXGOOOXXXXXXXXXXXXXXXXGOOOOAXXXXXXXXXXXXXXGOOOOXXXXXXXXXXXXXXXGOOOXXXXXXXXXXXXXXXXGXXXXXXXXXXXXXXXXXXXGOOOXXXXXXXXXXXXXXXXGOOXXXXXXXXXXXXXXXXXGOOOOXXXXXXXXXXXXXXX,0,0,0

5460,48,2,46,104,348,0,0,354,159,195,GOXXXXXXXXXXXXXXXXXXGOOOXXXXXXXXXXXXXXXXGOOOOXXXXXXXXXXXXXXXGOOAXXXXXXXXXXXXXXXXGXXXXXXXXXXXXXXXXXXXGOOOXXXXXXXXXXXXXXXXGOOOOAXXXXXXXXXXXXXXGOOOOXXXXXXXXXXXXXXXGOOOXXXXXXXXXXXXXXXXGXXXXXXXXXXXXXXXXXXXGOOOXXXXXXXXXXXXXXXXGOOXXXXXXXXXXXXXXXXXGOOOOXXXXXXXXXXXXXXX,0,0,0
5481,48,2,46,105,347,0,0,351,161,190,GOXXXXXXXXXXXXXXXXXXGOOOXXXXXXXXXXXXXXXXGOOOOXXXXXXXXXXXXXXXGOOAXXXXXXXXXXXXXXXXGXXXXXXXXXXXXXXXXXXXGOOOXXXXXXXXXXXXXXXXGOOOOAXXXXXXXXXXXXXXGOOOOXXXXXXXXXXXXXXXGOOOXXXXXXXXXXXXXXXXGXXXXXXXXXXXXXXXXXXXGOOOXXXXXXXXXXXXXXXXGOOXXXXXXXXXXXXXXXXXGOOOOXXXXXXXXXXXXXXX,0,0,0
5502,48,2,46,107,345,0,0,349,165,184,GOXXXXXXXXXXXXXXXXXXGOOOXXXXXXXXXXXXXXXXGOOOOXXXXXXXXXXXXXXXGOOAXXXXXXXXXXXXXXXXGXXXXXXXXXXXXXXXXXXXGOOOXXXXXXXXXXXXXXXXGOOOOAXXXXXXXXXXXXXXGOOOOXXXXXXXXXXXXXXXGOOOXXXXXXXXXXXXXXXXGXXXXXXXXXXXXXXXXXXXGOOOXXXXXXXXXXXXXXXXGOOXXXXXXXXXXXXXXXXXGOOOOXXXXXXXXXXXXXXX,0,0,0
5523,49,2,47,104,347,0,0,352,162,190,GOXXXXXXXXXXXXXXXXXXGOOOXXXXXXXXXXXXXXXXGOOOOXXXXXXXXXXXXXXXGOOAXXXXXXXXXXXXXXXXGXXXXXXXXXXXXXXXXXXXGOOOXXXXXXXXXXXXXXXXGOOOOAXXXXXXXXXXXXXXGOOOOXXXXXXXXXXXXXXXGOOOXXXXXXXXXXXXXXXXGXXXXXXXXXXXXXXXXXXXGOOOOXXXXXXXXXXXXXXXGOOXXXXXXXXXXXXXXXXXGOOOOXXXXXXXXXXXXXXX,0,0,0
5544,49,1,48,109,342,0,0,350,161,189,GOXXXXXXXXXXXXXXXXXXGOOOXXXXXXXXXXXXXXXXGOOOOXXXXXXXXXXXXXXXGOOAXXXXXXXXXXXXXXXXGXXXXXXXXXXXXXXXXXXXGOOOXXXXXXXXXXXXXXXXGOOOOOXXXXXXXXXXXXXXGOOOOXXXXXXXXXXXXXXXGOOOXXXXXXXXXXXXXXXXGXXXXXXXXXXXXXXXXXXXGOOOOXXXXXXXXXXXXXXXGOOXXXXXXXXXXXXXXXXXGOOOOXXXXXXXXXXXXXXX,0,0,0

5565,49,1,48,107,344,0,0,352,161,191,GOXXXXXXXXXXXXXXXXXXGOOOXXXXXXXXXXXXXXXXGOOOOXXXXXXXXXXXXXXXGOOAXXXXXXXXXXXXXXXXGXXXXXXXXXXXXXXXXXXXGOOOXXXXXXXXXXXXXXXXGOOOOOXXXXXXXXXXXXXXGOOOOXXXXXXXXXXXXXXXGOOOXXXXXXXXXXXXXXXXGXXXXXXXXXXXXXXXXXXXGOOOOXXXXXXXXXXXXXXXGOOXXXXXXXXXXXXXXXXXGOOOOXXXXXXXXXXXXXXX,0,0,0
5586,50,2,48,102,348,0,0,354,163,191,GOXXXXXXXXXXXXXXXXXXGOOOAXXXXXXXXXXXXXXXGOOOOXXXXXXXXXXXXXXXGOOAXXXXXXXXXXXXXXXXGXXXXXXXXXXXXXXXXXXXGOOOXXXXXXXXXXXXXXXXGOOOOOXXXXXXXXXXXXXXGOOOOXXXXXXXXXXXXXXXGOOOXXXXXXXXXXXXXXXXGXXXXXXXXXXXXXXXXXXXGOOOOXXXXXXXXXXXXXXXGOOXXXXXXXXXXXXXXXXXGOOOOXXXXXXXXXXXXXXX,0,0,0
5607,50,2,48,104,346,0,0,353,164,189,GOXXXXXXXXXXXXXXXXXXGOOOAXXXXXXXXXXXXXXXGOOOOXXXXXXXXXXXXXXXGOOAXXXXXXXXXXXXXXXXGXXXXXXXXXXXXXXXXXXXGOOOXXXXXXXXXXXXXXXXGOOOOOXXXXXXXXXXXXXXGOOOOXXXXXXXXXXXXXXXGOOOXXXXXXXXXXXXXXXXGXXXXXXXXXXXXXXXXXXXGOOOOXXXXXXXXXXXXXXXGOOXXXXXXXXXXXXXXXXXGOOOOXXXXXXXXXXXXXXX,0,0,0
5628,50,2,48,105,345,0,0,352,170,182,GOXXXXXXXXXXXXXXXXXXGOOOAXXXXXXXXXXXXXXXGOOOOXXXXXXXXXXXXXXXGOOAXXXXXXXXXXXXXXXXGXXXXXXXXXXXXXXXXXXXGOOOXXXXXXXXXXXXXXXXGOOOOOXXXXXXXXXXXXXXGOOOOXXXXXXXXXXXXXXXGOOOXXXXXXXXXXXXXXXXGXXXXXXXXXXXXXXXXXXXGOOOOXXXXXXXXXXXXXXXGOOXXXXXXXXXXXXXXXXXGOOOOXXXXXXXXXXXXXXX,0,0,0
5649,50,1,49,106,344,0,0,352,167,185,GOXXXXXXXXXXXXXXXXXXGOOOAXXXXXXXXXXXXXXXGOOOOXXXXXXXXXXXXXXXGOOOXXXXXXXXXXXXXXXXGXXXXXXXXXXXXXXXXXXXGOOOXXXXXXXXXXXXXXXXGOOOOOXXXXXXXXXXXXXXGOOOOXXXXXXXXXXXXXXXGOOOXXXXXXXXXXXXXXXXGXXXXXXXXXXXXXXXXXXXGOOOOXXXXXXXXXXXXXXXGOOXXXXXXXXXXXXXXXXXGOOOOXXXXXXXXXXXXXXX,0,0,0

5670,50,1,49,111,339,0,0,346,167,179,GOXXXXXXXXXXXXXXXXXXGOOOAXXXXXXXXXXXXXXXGOOOOXXXXXXXXXXXXXXXGOOOXXXXXXXXXXXXXXXXGXXXXXXXXXXXXXXXXXXXGOOOXXXXXXXXXXXXXXXXGOOOOOXXXXXXXXXXXXXXGOOOOXXXXXXXXXXXXXXXGOOOXXXXXXXXXXXXXXXXGXXXXXXXXXXXXXXXXXXXGOOOOXXXXXXXXXXXXXXXGOOXXXXXXXXXXXXXXXXXGOOOOXXXXXXXXXXXXXXX,0,0,0
5691,50,0,50,108,342,0,0,348,167,181,GOXXXXXXXXXXXXXXXXXXGOOOOXXXXXXXXXXXXXXXGOOOOXXXXXXXXXXXXXXXGOOOXXXXXXXXXXXXXXXXGXXXXXXXXXXXXXXXXXXXGOOOXXXXXXXXXXXXXXXXGOOOOOXXXXXXXXXXXXXXGOOOOXXXXXXXXXXXXXXXGOOOXXXXXXXXXXXXXXXXGXXXXXXXXXXXXXXXXXXXGOOOOXXXXXXXXXXXXXXXGOOXXXXXXXXXXXXXXXXXGOOOOXXXXXXXXXXXXXXX,0,0,0
5712,50,0,50,105,345,0,0,352,169,183,GOXXXXXXXXXXXXXXXXXXGOOOOXXXXXXXXXXXXXXXGOOOOXXXXXXXXXXXXXXXGOOOXXXXXXXXXXXXXXXXGXXXXXXXXXXXXXXXXXXXGOOOXXXXXXXXXXXXXXXXGOOOOOXXXXXXXXXXXXXXGOOOOXXXXXXXXXXXXXXXGOOOXXXXXXXXXXXXXXXXGXXXXXXXXXXXXXXXXXXXGOOOOXXXXXXXXXXXXXXXGOOXXXXXXXXXXXXXXXXXGOOOOXXXXXXXXXXXXXXX,0,0,0
5733,50,0,50,108,342,0,0,347,171,176,GOXXXXXXXXXXXXXXXXXXGOOOOXXXXXXXXXXXXXXXGOOOOXXXXXXXXXXXXXXXGOOOXXXXXXXXXXXXXXXXGXXXXXXXXXXXXXXXXXXXGOOOXXXXXXXXXXXXXXXXGOOOOOXXXXXXXXXXXXXXGOOOOXXXXXXXXXXXXXXXGOOOXXXXXXXXXXXXXXXXGXXXXXXXXXXXXXXXXXXXGOOOOXXXXXXXXXXXXXXXGOOXXXXXXXXXXXXXXXXXGOOOOXXXXXXXXXXXXXXX,0,0,0
5754,50,0,50,106,344,0,0,348,170,178,GOXXXXXXXXXXXXXXXXXXGOOOOXXXXXXXXXXXXXXXGOOOOXXXXXXXXXXXXXXXGOOOXXXXXXXXXXXXXXXXGXXXXXXXXXXXXXXXXXXXGOOOXXXXXXXXXXXXXXXXGOOOOOXXXXXXXXXXXXXXGOOOOXXXXXXXXXXXXXXXGOOOXXXXXXXXXXXXXXXXGXXXXXXXXXXXXXXXXXXXGOOOOXXXXXXXXXXXXXXXGOOXXXXXXXXXXXXXXXXXGOOOOXXXXXXXXXXXXXXX,0,0,0

5775,51,1,50,104,345,0,0,350,166,184,GOXXXXXXXXXXXXXXXXXXGOOOOXXXXXXXXXXXXXXXGOOOOXXXXXXXXXXXXXXXGOOOXXXXXXXXXXXXXXXXGAXXXXXXXXXXXXXXXXXXGOOOXXXXXXXXXXXXXXXXGOOOOOXXXXXXXXXXXXXXGOOOOXXXXXXXXXXXXXXXGOOOXXXXXXXXXXXXXXXXGXXXXXXXXXXXXXXXXXXXGOOOOXXXXXXXXXXXXXXXGOOXXXXXXXXXXXXXXXXXGOOOOXXXXXXXXXXXXXXX,0,0,0
5796,51,1,50,102,347,0,0,352,168,184,GOXXXXXXXXXXXXXXXXXXGOOOOXXXXXXXXXXXXXXXGOOOOXXXXXXXXXXXXXXXGOOOXXXXXXXXXXXXXXXXGAXXXXXXXXXXXXXXXXXXGOOOXXXXXXXXXXXXXXXXGOOOOOXXXXXXXXXXXXXXGOOOOXXXXXXXXXXXXXXXGOOOXXXXXXXXXXXXXXXXGXXXXXXXXXXXXXXXXXXXGOOOOXXXXXXXXXXXXXXXGOOXXXXXXXXXXXXXXXXXGOOOOXXXXXXXXXXXXXXX,0,0,0
5817,51,1,50,105,344,0,0,349,172,177,GOXXXXXXXXXXXXXXXXXXGOOOOXXXXXXXXXXXXXXXGOOOOXXXXXXXXXXXXXXXGOOOXXXXXXXXXXXXXXXXGAXXXXXXXXXXXXXXXXXXGOOOXXXXXXXXXXXXXXXXGOOOOOXXXXXXXXXXXXXXGOOOOXXXXXXXXXXXXXXXGOOOXXXXXXXXXXXXXXXXGXXXXXXXXXXXXXXXXXXXGOOOOXXXXXXXXXXXXXXXGOOXXXXXXXXXXXXXXXXXGOOOOXXXXXXXXXXXXXXX,0,0,0
5838,51,1,50,103,346,0,0,350,175,175,GOXXXXXXXXXXXXXXXXXXGOOOOXXXXXXXXXXXXXXXGOOOOXXXXXXXXXXXXXXXGOOOXXXXXXXXXXXXXXXXGAXXXXXXXXXXXXXXXXXXGOOOXXXXXXXXXXXXXXXXGOOOOOXXXXXXXXXXXXXXGOOOOXXXXXXXXXXXXXXXGOOOXXXXXXXXXXXXXXXXGXXXXXXXXXXXXXXXXXXXGOOOOXXXXXXXXXXXXXXXGOOXXXXXXXXXXXXXXXXXGOOOOXXXXXXXXXXXXXXX,0,0,0
5859,51,0,51,104,345,0,0,348,171,177,GOXXXXXXXXXXXXXXXXXXGOOOOXXXXXXXXXXXXXXXGOOOOXXXXXXXXXXXXXXXGOOOXXXXXXXXXXXXXXXXGOXXXXXXXXXXXXXXXXXXGOOOXXXXXXXXXXXXXXXXGOOOOOXXXXXXXXXXXXXXGOOOOXXXXXXXXXXXXXXXGOOOXXXXXXXXXXXXXXXXGXXXXXXXXXXXXXXXXXXXGOOOOXXXXXXXXXXXXXXXGOOXXXXXXXXXXXXXXXXXGOOOOXXXXXXXXXXXXXXX,0,0,0

5880,51,0,51,101,348,0,0,352,175,177,GOXXXXXXXXXXXXXXXXXXGOOOOXXXXXXXXXXXXXXXGOOOOXXXXXXXXXXXXXXXGOOOXXXXXXXXXXXXXXXXGOXXXXXXXXXXXXXXXXXXGOOOXXXXXXXXXXXXXXXXGOOOOOXXXXXXXXXXXXXXGOOOOXXXXXXXXXXXXXXXGOOOXXXXXXXXXXXXXXXXGXXXXXXXXXXXXXXXXXXXGOOOOXXXXXXXXXXXXXXXGOOXXXXXXXXXXXXXXXXXGOOOOXXXXXXXXXXXXXXX,0,0,0
5901,51,0,51,103,346,0,0,350,178,172,GOXXXXXXXXXXXXXXXXXXGOOOOXXXXXXXXXXXXXXXGOOOOXXXXXXXXXXXXXXXGOOOXXXXXXXXXXXXXXXXGOXXXXXXXXXXXXXXXXXXGOOOXXXXXXXXXXXXXXXXGOOOOOXXXXXXXXXXXXXXGOOOOXXXXXXXXXXXXXXXGOOOXXXXXXXXXXXXXXXXGXXXXXXXXXXXXXXXXXXXGOOOOXXXXXXXXXXXXXXXGOOXXXXXXXXXXXXXXXXXGOOOOXXXXXXXXXXXXXXX,0,0,0
5922,51,0,51,109,340,0,0,344,172,172,GOXXXXXXXXXXXXXXXXXXGOOOOXXXXXXXXXXXXXXXGOOOOXXXXXXXXXXXXXXXGOOOXXXXXXXXXXXXXXXXGOXXXXXXXXXXXXXXXXXXGOOOXXXXXXXXXXXXXXXXGOOOOOXXXXXXXXXXXXXXGOOOOXXXXXXXXXXXXXXXGOOOXXXXXXXXXXXXXXXXGXXXXXXXXXXXXXXXXXXXGOOOOXXXXXXXXXXXXXXXGOOXXXXXXXXXXXXXXXXXGOOOOXXXXXXXXXXXXXXX,0,0,0
5943,51,0,51,101,348,0,0,351,172,179,GOXXXXXXXXXXXXXXXXXXGOOOOXXXXXXXXXXXXXXXGOOOOXXXXXXXXXXXXXXXGOOOXXXXXXXXXXXXXXXXGOXXXXXXXXXXXXXXXXXXGOOOXXXXXXXXXXXXXXXXGOOOOOXXXXXXXXXXXXXXGOOOOXXXXXXXXXXXXXXXGOOOXXXXXXXXXXXXXXXXGXXXXXXXXXXXXXXXXXXXGOOOOXXXXXXXXXXXXXXXGOOXXXXXXXXXXXXXXXXXGOOOOXXXXXXXXXXXXXXX,0,0,0
5964,51,0,51,103,346,0,0,350,178,172,GOXXXXXXXXXXXXXXXXXXGOOOOXXXXXXXXXXXXXXXGOOOOXXXXXXXXXXXXXXXGOOOXXXXXXXXXXXXXXXXGOXXXXXXXXXXXXXXXXXXGOOOXXXXXXXXXXXXXXXXGOOOOOXXXXXXXXXXXXXXGOOOOXXXXXXXXXXXXXXXGOOOXXXXXXXXXXXXXXXXGXXXXXXXXXXXXXXXXXXXGOOOOXXXXXXXXXXXXXXXGOOXXXXXXXXXXXXXXXXXGOOOOXXXXXXXXXXXXXXX,0,0,0

5985,51,0,51,105,344,0,0,347,176,171,GOXXXXXXXXXXXXXXXXXXGOOOOXXXXXXXXXXXXXXXGOOOOXXXXXXXXXXXXXXXGOOOXXXXXXXXXXXXXXXXGOXXXXXXXXXXXXXXXXXXGOOOXXXXXXXXXXXXXXXXGOOOOOXXXXXXXXXXXXXXGOOOOXXXXXXXXXXXXXXXGOOOXXXXXXXXXXXXXXXXGXXXXXXXXXXXXXXXXXXXGOOOOXXXXXXXXXXXXXXXGOOXXXXXXXXXXXXXXXXXGOOOOXXXXXXXXXXXXXXX,0,0,0
6006,51,0,51,101,348,0,0,352,185,167,GOXXXXXXXXXXXXXXXXXXGOOOOXXXXXXXXXXXXXXXGOOOOXXXXXXXXXXXXXXXGOOOXXXXXXXXXXXXXXXXGOXXXXXXXXXXXXXXXXXXGOOOXXXXXXXXXXXXXXXXGOOOOOXXXXXXXXXXXXXXGOOOOXXXXXXXXXXXXXXXGOOOXXXXXXXXXXXXXXXXGXXXXXXXXXXXXXXXXXXXGOOOOXXXXXXXXXXXXXXXGOOXXXXXXXXXXXXXXXXXGOOOOXXXXXXXXXXXXXXX,0,0,0
6027,51,0,51,107,342,0,0,346,177,169,GOXXXXXXXXXXXXXXXXXXGOOOOXXXXXXXXXXXXXXXGOOOOXXXXXXXXXXXXXXXGOOOXXXXXXXXXXXXXXXXGOXXXXXXXXXXXXXXXXXXGOOOXXXXXXXXXXXXXXXXGOOOOOXXXXXXXXXXXXXXGOOOOXXXXXXXXXXXXXXXGOOOXXXXXXXXXXXXXXXXGXXXXXXXXXXXXXXXXXXXGOOOOXXXXXXXXXXXXXXXGOOXXXXXXXXXXXXXXXXXGOOOOXXXXXXXXXXXXXXX,0,0,0
6048,52,1,51,110,338,0,0,343,175,168,GOAXXXXXXXXXXXXXXXXXGOOOOXXXXXXXXXXXXXXXGOOOOXXXXXXXXXXXXXXXGOOOXXXXXXXXXXXXXXXXGOXXXXXXXXXXXXXXXXXXGOOOXXXXXXXXXXXXXXXXGOOOOOXXXXXXXXXXXXXXGOOOOXXXXXXXXXXXXXXXGOOOXXXXXXXXXXXXXXXXGXXXXXXXXXXXXXXXXXXXGOOOOXXXXXXXXXXXXXXXGOOXXXXXXXXXXXXXXXXXGOOOOXXXXXXXXXXXXXXX,0,0,0
6069,52,1,51,105,343,0,0,347,181,166,GOAXXXXXXXXXXXXXXXXXGOOOOXXXXXXXXXXXXXXXGOOOOXXXXXXXXXXXXXXXGOOOXXXXXXXXXXXXXXXXGOXXXXXXXXXXXXXXXXXXGOOOXXXXXXXXXXXXXXXXGOOOOOXXXXXXXXXXXXXXGOOOOXXXXXXXXXXXXXXXGOOOXXXXXXXXXXXXXXXXGXXXXXXXXXXXXXXXXXXXGOOOOXXXXXXXXXXXXXXXGOOXXXXXXXXXXXXXXXXXGOOOOXXXXXXXXXXXXXXX,0,0,0

6090,52,1,51,104,344,0,0,349,182,167,GOAXXXXXXXXXXXXXXXXXGOOOOXXXXXXXXXXXXXXXGOOOOXXXXXXXXXXXXXXXGOOOXXXXXXXXXXXXXXXXGOXXXXXXXXXXXXXXXXXXGOOOXXXXXXXXXXXXXXXXGOOOOOXXXXXXXXXXXXXXGOOOOXXXXXXXXXXXXXXXGOOOXXXXXXXXXXXXXXXXGXXXXXXXXXXXXXXXXXXXGOOOOXXXXXXXXXXXXXXXGOOXXXXXXXXXXXXXXXXXGOOOOXXXXXXXXXXXXXXX,0,0,0
6111,52,1,51,101,347,0,0,351,180,171,GOAXXXXXXXXXXXXXXXXXGOOOOXXXXXXXXXXXXXXXGOOOOXXXXXXXXXXXXXXXGOOOXXXXXXXXXXXXXXXXGOXXXXXXXXXXXXXXXXXXGOOOXXXXXXXXXXXXXXXXGOOOOOXXXXXXXXXXXXXXGOOOOXXXXXXXXXXXXXXXGOOOXXXXXXXXXXXXXXXXGXXXXXXXXXXXXXXXXXXXGOOOOXXXXXXXXXXXXXXXGOOXXXXXXXXXXXXXXXXXGOOOOXXXXXXXXXXXXXXX,0,0,0
6132,52,1,51,103,345,0,0,350,177,173,GOAXXXXXXXXXXXXXXXXXGOOOOXXXXXXXXXXXXXXXGOOOOXXXXXXXXXXXXXXXGOOOXXXXXXXXXXXXXXXXGOXXXXXXXXXXXXXXXXXXGOOOXXXXXXXXXXXXXXXXGOOOOOXXXXXXXXXXXXXXGOOOOXXXXXXXXXXXXXXXGOOOXXXXXXXXXXXXXXXXGXXXXXXXXXXXXXXXXXXXGOOOOXXXXXXXXXXXXXXXGOOXXXXXXXXXXXXXXXXXGOOOOXXXXXXXXXXXXXXX,0,0,0
6153,52,1,51,95,353,0,0,357,180,177,GOAXXXXXXXXXXXXXXXXXGOOOOXXXXXXXXXXXXXXXGOOOOXXXXXXXXXXXXXXXGOOOXXXXXXXXXXXXXXXXGOXXXXXXXXXXXXXXXXXXGOOOXXXXXXXXXXXXXXXXGOOOOOXXXXXXXXXXXXXXGOOOOXXXXXXXXXXXXXXXGOOOXXXXXXXXXXXXXXXXGXXXXXXXXXXXXXXXXXXXGOOOOXXXXXXXXXXXXXXXGOOXXXXXXXXXXXXXXXXXGOOOOXXXXXXXXXXXXXXX,0,0,0
6174,52,1,51,93,355,0,0,359,180,179,GOAXXXXXXXXXXXXXXXXXGOOOOXXXXXXXXXXXXXXXGOOOOXXXXXXXXXXXXXXXGOOOXXXXXXXXXXXXXXXXGOXXXXXXXXXXXXXXXXXXGOOOXXXXXXXXXXXXXXXXGOOOOOXXXXXXXXXXXXXXGOOOOXXXXXXXXXXXXXXXGOOOXXXXXXXXXXXXXXXXGXXXXXXXXXXXXXXXXXXXGOOOOXXXXXXXXXXXXXXXGOOXXXXXXXXXXXXXXXXXGOOOOXXXXXXXXXXXXXXX,0,0,0

6195,52,1,51,92,356,0,0,359,180,179,GOAXXXXXXXXXXXXXXXXXGOOOOXXXXXXXXXXXXXXXGOOOOXXXXXXXXXXXXXXXGOOOXXXXXXXXXXXXXXXXGOXXXXXXXXXXXXXXXXXXGOOOXXXXXXXXXXXXXXXXGOOOOOXXXXXXXXXXXXXXGOOOOXXXXXXXXXXXXXXXGOOOXXXXXXXXXXXXXXXXGXXXXXXXXXXXXXXXXXXXGOOOOXXXXXXXXXXXXXXXGOOXXXXXXXXXXXXXXXXXGOOOOXXXXXXXXXXXXXXX,0,0,0
6216,53,2,51,95,352,0,0,356,183,173,GOAXXXXXXXXXXXXXXXXXGOOOOXXXXXXXXXXXXXXXGOOOOXXXXXXXXXXXXXXXGOOOXXXXXXXXXXXXXXXXGOXXXXXXXXXXXXXXXXXXGOOOXXXXXXXXXXXXXXXXGOOOOOXXXXXXXXXXXXXXGOOOOXXXXXXXXXXXXXXXGOOOXXXXXXXXXXXXXXXXGAXXXXXXXXXXXXXXXXXXGOOOOXXXXXXXXXXXXXXXGOOXXXXXXXXXXXXXXXXXGOOOOXXXXXXXXXXXXXXX,0,0,0
6237,53,2,51,90,357,0,0,360,180,180,GOAXXXXXXXXXXXXXXXXXGOOOOXXXXXXXXXXXXXXXGOOOOXXXXXXXXXXXXXXXGOOOXXXXXXXXXXXXXXXXGOXXXXXXXXXXXXXXXXXXGOOOXXXXXXXXXXXXXXXXGOOOOOXXXXXXXXXXXXXXGOOOOXXXXXXXXXXXXXXXGOOOXXXXXXXXXXXXXXXXGAXXXXXXXXXXXXXXXXXXGOOOOXXXXXXXXXXXXXXXGOOXXXXXXXXXXXXXXXXXGOOOOXXXXXXXXXXXXXXX,0,0,0
6258,53,2,51,88,359,0,0,364,179,185,GOAXXXXXXXXXXXXXXXXXGOOOOXXXXXXXXXXXXXXXGOOOOXXXXXXXXXXXXXXXGOOOXXXXXXXXXXXXXXXXGOXXXXXXXXXXXXXXXXXXGOOOXXXXXXXXXXXXXXXXGOOOOOXXXXXXXXXXXXXXGOOOOXXXXXXXXXXXXXXXGOOOXXXXXXXXXXXXXXXXGAXXXXXXXXXXXXXXXXXXGOOOOXXXXXXXXXXXXXXXGOOXXXXXXXXXXXXXXXXXGOOOOXXXXXXXXXXXXXXX,0,0,0
6279,53,2,51,80,367,0,0,371,181,190,GOAXXXXXXXXXXXXXXXXXGOOOOXXXXXXXXXXXXXXXGOOOOXXXXXXXXXXXXXXXGOOOXXXXXXXXXXXXXXXXGOXXXXXXXXXXXXXXXXXXGOOOXXXXXXXXXXXXXXXXGOOOOOXXXXXXXXXXXXXXGOOOOXXXXXXXXXXXXXXXGOOOXXXXXXXXXXXXXXXXGAXXXXXXXXXXXXXXXXXXGOOOOXXXXXXXXXXXXXXXGOOXXXXXXXXXXXXXXXXXGOOOOXXXXXXXXXXXXXXX,0,0,0

6300,53,1,52,85,362,0,0,366,189,177,GOAXXXXXXXXXXXXXXXXXGOOOOXXXXXXXXXXXXXXXGOOOOXXXXXXXXXXXXXXXGOOOXXXXXXXXXXXXXXXXGOXXXXXXXXXXXXXXXXXXGOOOXXXXXXXXXXXXXXXXGOOOOOXXXXXXXXXXXXXXGOOOOXXXXXXXXXXXXXXXGOOOXXXXXXXXXXXXXXXXGOXXXXXXXXXXXXXXXXXXGOOOOXXXXXXXXXXXXXXXGOOXXXXXXXXXXXXXXXXXGOOOOXXXXXXXXXXXXXXX,0,0,0
6321,53,1,52,91,356,0,0,360,191,169,GOAXXXXXXXXXXXXXXXXXGOOOOXXXXXXXXXXXXXXXGOOOOXXXXXXXXXXXXXXXGOOOXXXXXXXXXXXXXXXXGOXXXXXXXXXXXXXXXXXXGOOOXXXXXXXXXXXXXXXXGOOOOOXXXXXXXXXXXXXXGOOOOXXXXXXXXXXXXXXXGOOOXXXXXXXXXXXXXXXXGOXXXXXXXXXXXXXXXXXXGOOOOXXXXXXXXXXXXXXXGOOXXXXXXXXXXXXXXXXXGOOOOXXXXXXXXXXXXXXX,0,0,0
6342,53,1,52,99,348,0,0,352,190,162,GOAXXXXXXXXXXXXXXXXXGOOOOXXXXXXXXXXXXXXXGOOOOXXXXXXXXXXXXXXXGOOOXXXXXXXXXXXXXXXXGOXXXXXXXXXXXXXXXXXXGOOOXXXXXXXXXXXXXXXXGOOOOOXXXXXXXXXXXXXXGOOOOXXXXXXXXXXXXXXXGOOOXXXXXXXXXXXXXXXXGOXXXXXXXXXXXXXXXXXXGOOOOXXXXXXXXXXXXXXXGOOXXXXXXXXXXXXXXXXXGOOOOXXXXXXXXXXXXXXX,0,0,0
6363,53,1,52,98,349,0,0,353,184,169,GOAXXXXXXXXXXXXXXXXXGOOOOXXXXXXXXXXXXXXXGOOOOXXXXXXXXXXXXXXXGOOOXXXXXXXXXXXXXXXXGOXXXXXXXXXXXXXXXXXXGOOOXXXXXXXXXXXXXXXXGOOOOOXXXXXXXXXXXXXXGOOOOXXXXXXXXXXXXXXXGOOOXXXXXXXXXXXXXXXXGOXXXXXXXXXXXXXXXXXXGOOOOXXXXXXXXXXXXXXXGOOXXXXXXXXXXXXXXXXXGOOOOXXXXXXXXXXXXXXX,0,0,0
6384,53,0,53,96,351,0,0,356,190,166,GOOXXXXXXXXXXXXXXXXXGOOOOXXXXXXXXXXXXXXXGOOOOXXXXXXXXXXXXXXXGOOOXXXXXXXXXXXXXXXXGOXXXXXXXXXXXXXXXXXXGOOOXXXXXXXXXXXXXXXXGOOOOOXXXXXXXXXXXXXXGOOOOXXXXXXXXXXXXXXXGOOOXXXXXXXXXXXXXXXXGOXXXXXXXXXXXXXXXXXXGOOOOXXXXXXXXXXXXXXXGOOXXXXXXXXXXXXXXXXXGOOOOXXXXXXXXXXXXXXX,0,0,0

6405,53,0,53,98,349,0,0,354,188,166,GOOXXXXXXXXXXXXXXXXXGOOOOXXXXXXXXXXXXXXXGOOOOXXXXXXXXXXXXXXXGOOOXXXXXXXXXXXXXXXXGOXXXXXXXXXXXXXXXXXXGOOOXXXXXXXXXXXXXXXXGOOOOOXXXXXXXXXXXXXXGOOOOXXXXXXXXXXXXXXXGOOOXXXXXXXXXXXXXXXXGOXXXXXXXXXXXXXXXXXXGOOOOXXXXXXXXXXXXXXXGOOXXXXXXXXXXXXXXXXXGOOOOXXXXXXXXXXXXXXX,0,0,0
6426,53,0,53,95,352,0,0,354,194,160,GOOXXXXXXXXXXXXXXXXXGOOOOXXXXXXXXXXXXXXXGOOOOXXXXXXXXXXXXXXXGOOOXXXXXXXXXXXXXXXXGOXXXXXXXXXXXXXXXXXXGOOOXXXXXXXXXXXXXXXXGOOOOOXXXXXXXXXXXXXXGOOOOXXXXXXXXXXXXXXXGOOOXXXXXXXXXXXXXXXXGOXXXXXXXXXXXXXXXXXXGOOOOXXXXXXXXXXXXXXXGOOXXXXXXXXXXXXXXXXXGOOOOXXXXXXXXXXXXXXX,0,0,0
6447,53,0,53,101,346,0,0,351,189,162,GOOXXXXXXXXXXXXXXXXXGOOOOXXXXXXXXXXXXXXXGOOOOXXXXXXXXXXXXXXXGOOOXXXXXXXXXXXXXXXXGOXXXXXXXXXXXXXXXXXXGOOOXXXXXXXXXXXXXXXXGOOOOOXXXXXXXXXXXXXXGOOOOXXXXXXXXXXXXXXXGOOOXXXXXXXXXXXXXXXXGOXXXXXXXXXXXXXXXXXXGOOOOXXXXXXXXXXXXXXXGOOXXXXXXXXXXXXXXXXXGOOOOXXXXXXXXXXXXXXX,0,0,0
6468,53,0,53,97,350,0,0,354,193,161,GOOXXXXXXXXXXXXXXXXXGOOOOXXXXXXXXXXXXXXXGOOOOXXXXXXXXXXXXXXXGOOOXXXXXXXXXXXXXXXXGOXXXXXXXXXXXXXXXXXXGOOOXXXXXXXXXXXXXXXXGOOOOOXXXXXXXXXXXXXXGOOOOXXXXXXXXXXXXXXXGOOOXXXXXXXXXXXXXXXXGOXXXXXXXXXXXXXXXXXXGOOOOXXXXXXXXXXXXXXXGOOXXXXXXXXXXXXXXXXXGOOOOXXXXXXXXXXXXXXX,0,0,0
6489,53,0,53,104,343,0,0,347,187,160,GOOXXXXXXXXXXXXXXXXXGOOOOXXXXXXXXXXXXXXXGOOOOXXXXXXXXXXXXXXXGOOOXXXXXXXXXXXXXXXXGOXXXXXXXXXXXXXXXXXXGOOOXXXXXXXXXXXXXXXXGOOOOOXXXXXXXXXXXXXXGOOOOXXXXXXXXXXXXXXXGOOOXXXXXXXXXXXXXXXXGOXXXXXXXXXXXXXXXXXXGOOOOXXXXXXXXXXXXXXXGOOXXXXXXXXXXXXXXXXXGOOOOXXXXXXXXXXXXXXX,0,0,0

6510,53,0,53,97,350,0,0,353,191,162,GOOXXXXXXXXXXXXXXXXXGOOOOXXXXXXXXXXXXXXXGOOOOXXXXXXXXXXXXXXXGOOOXXXXXXXXXXXXXXXXGOXXXXXXXXXXXXXXXXXXGOOOXXXXXXXXXXXXXXXXGOOOOOXXXXXXXXXXXXXXGOOOOXXXXXXXXXXXXXXXGOOOXXXXXXXXXXXXXXXXGOXXXXXXXXXXXXXXXXXXGOOOOXXXXXXXXXXXXXXXGOOXXXXXXXXXXXXXXXXXGOOOOXXXXXXXXXXXXXXX,0,0,0
6531,53,0,53,93,354,0,0,357,193,164,GOOXXXXXXXXXXXXXXXXXGOOOOXXXXXXXXXXXXXXXGOOOOXXXXXXXXXXXXXXXGOOOXXXXXXXXXXXXXXXXGOXXXXXXXXXXXXXXXXXXGOOOXXXXXXXXXXXXXXXXGOOOOOXXXXXXXXXXXXXXGOOOOXXXXXXXXXXXXXXXGOOOXXXXXXXXXXXXXXXXGOXXXXXXXXXXXXXXXXXXGOOOOXXXXXXXXXXXXXXXGOOXXXXXXXXXXXXXXXXXGOOOOXXXXXXXXXXXXXXX,0,0,0
6552,53,0,53,97,350,0,0,354,189,165,GOOXXXXXXXXXXXXXXXXXGOOOOXXXXXXXXXXXXXXXGOOOOXXXXXXXXXXXXXXXGOOOXXXXXXXXXXXXXXXXGOXXXXXXXXXXXXXXXXXXGOOOXXXXXXXXXXXXXXXXGOOOOOXXXXXXXXXXXXXXGOOOOXXXXXXXXXXXXXXXGOOOXXXXXXXXXXXXXXXXGOXXXXXXXXXXXXXXXXXXGOOOOXXXXXXXXXXXXXXXGOOXXXXXXXXXXXXXXXXXGOOOOXXXXXXXXXXXXXXX,0,0,0
6573,54,1,53,92,354,0,0,358,194,164,GOOXXXXXXXXXXXXXXXXXGOOOOAXXXXXXXXXXXXXXGOOOOXXXXXXXXXXXXXXXGOOOXXXXXXXXXXXXXXXXGOXXXXXXXXXXXXXXXXXXGOOOXXXXXXXXXXXXXXXXGOOOOOXXXXXXXXXXXXXXGOOOOXXXXXXXXXXXXXXXGOOOXXXXXXXXXXXXXXXXGOXXXXXXXXXXXXXXXXXXGOOOOXXXXXXXXXXXXXXXGOOXXXXXXXXXXXXXXXXXGOOOOXXXXXXXXXXXXXXX,0,0,0
6594,54,1,53,91,355,0,0,358,192,166,GOOXXXXXXXXXXXXXXXXXGOOOOAXXXXXXXXXXXXXXGOOOOXXXXXXXXXXXXXXXGOOOXXXXXXXXXXXXXXXXGOXXXXXXXXXXXXXXXXXXGOOOXXXXXXXXXXXXXXXXGOOOOOXXXXXXXXXXXXXXGOOOOXXXXXXXXXXXXXXXGOOOXXXXXXXXXXXXXXXXGOXXXXXXXXXXXXXXXXXXGOOOOXXXXXXXXXXXXXXXGOOXXXXXXXXXXXXXXXXXGOOOOXXXXXXXXXXXXXXX,0,0,0

6615,54,1,53,96,350,0,0,354,192,162,GOOXXXXXXXXXXXXXXXXXGOOOOAXXXXXXXXXXXXXXGOOOOXXXXXXXXXXXXXXXGOOOXXXXXXXXXXXXXXXXGOXXXXXXXXXXXXXXXXXXGOOOXXXXXXXXXXXXXXXXGOOOOOXXXXXXXXXXXXXXGOOOOXXXXXXXXXXXXXXXGOOOXXXXXXXXXXXXXXXXGOXXXXXXXXXXXXXXXXXXGOOOOXXXXXXXXXXXXXXXGOOXXXXXXXXXXXXXXXXXGOOOOXXXXXXXXXXXXXXX,0,0,0
6636,54,1,53,96,350,0,0,352,186,166,GOOXXXXXXXXXXXXXXXXXGOOOOAXXXXXXXXXXXXXXGOOOOXXXXXXXXXXXXXXXGOOOXXXXXXXXXXXXXXXXGOXXXXXXXXXXXXXXXXXXGOOOXXXXXXXXXXXXXXXXGOOOOOXXXXXXXXXXXXXXGOOOOXXXXXXXXXXXXXXXGOOOXXXXXXXXXXXXXXXXGOXXXXXXXXXXXXXXXXXXGOOOOXXXXXXXXXXXXXXXGOOXXXXXXXXXXXXXXXXXGOOOOXXXXXXXXXXXXXXX,0,0,0
6657,54,1,53,91,355,0,0,358,192,166,GOOXXXXXXXXXXXXXXXXXGOOOOAXXXXXXXXXXXXXXGOOOOXXXXXXXXXXXXXXXGOOOXXXXXXXXXXXXXXXXGOXXXXXXXXXXXXXXXXXXGOOOXXXXXXXXXXXXXXXXGOOOOOXXXXXXXXXXXXXXGOOOOXXXXXXXXXXXXXXXGOOOXXXXXXXXXXXXXXXXGOXXXXXXXXXXXXXXXXXXGOOOOXXXXXXXXXXXXXXXGOOXXXXXXXXXXXXXXXXXGOOOOXXXXXXXXXXXXXXX,0,0,0
6678,54,0,54,96,350,0,0,354,194,160,GOOXXXXXXXXXXXXXXXXXGOOOOOXXXXXXXXXXXXXXGOOOOXXXXXXXXXXXXXXXGOOOXXXXXXXXXXXXXXXXGOXXXXXXXXXXXXXXXXXXGOOOXXXXXXXXXXXXXXXXGOOOOOXXXXXXXXXXXXXXGOOOOXXXXXXXXXXXXXXXGOOOXXXXXXXXXXXXXXXXGOXXXXXXXXXXXXXXXXXXGOOOOXXXXXXXXXXXXXXXGOOXXXXXXXXXXXXXXXXXGOOOOXXXXXXXXXXXXXXX,0,0,0
6699,54,0,54,93,353,0,0,356,192,164,GOOXXXXXXXXXXXXXXXXXGOOOOOXXXXXXXXXXXXXXGOOOOXXXXXXXXXXXXXXXGOOOXXXXXXXXXXXXXXXXGOXXXXXXXXXXXXXXXXXXGOOOXXXXXXXXXXXXXXXXGOOOOOXXXXXXXXXXXXXXGOOOOXXXXXXXXXXXXXXXGOOOXXXXXXXXXXXXXXXXGOXXXXXXXXXXXXXXXXXXGOOOOXXXXXXXXXXXXXXXGOOXXXXXXXXXXXXXXXXXGOOOOXXXXXXXXXXXXXXX,0,0,0

6720,54,0,54,93,353,0,0,357,191,166,GOOXXXXXXXXXXXXXXXXXGOOOOOXXXXXXXXXXXXXXGOOOOXXXXXXXXXXXXXXXGOOOXXXXXXXXXXXXXXXXGOXXXXXXXXXXXXXXXXXXGOOOXXXXXXXXXXXXXXXXGOOOOOXXXXXXXXXXXXXXGOOOOXXXXXXXXXXXXXXXGOOOXXXXXXXXXXXXXXXXGOXXXXXXXXXXXXXXXXXXGOOOOXXXXXXXXXXXXXXXGOOXXXXXXXXXXXXXXXXXGOOOOXXXXXXXXXXXXXXX,0,0,0
6741,54,0,54,96,350,0,0,354,193,161,GOOXXXXXXXXXXXXXXXXXGOOOOOXXXXXXXXXXXXXXGOOOOXXXXXXXXXXXXXXXGOOOXXXXXXXXXXXXXXXXGOXXXXXXXXXXXXXXXXXXGOOOXXXXXXXXXXXXXXXXGOOOOOXXXXXXXXXXXXXXGOOOOXXXXXXXXXXXXXXXGOOOXXXXXXXXXXXXXXXXGOXXXXXXXXXXXXXXXXXXGOOOOXXXXXXXXXXXXXXXGOOXXXXXXXXXXXXXXXXXGOOOOXXXXXXXXXXXXXXX,0,0,0
6762,54,0,54,98,348,0,0,351,196,155,GOOXXXXXXXXXXXXXXXXXGOOOOOXXXXXXXXXXXXXXGOOOOXXXXXXXXXXXXXXXGOOOXXXXXXXXXXXXXXXXGOXXXXXXXXXXXXXXXXXXGOOOXXXXXXXXXXXXXXXXGOOOOOXXXXXXXXXXXXXXGOOOOXXXXXXXXXXXXXXXGOOOXXXXXXXXXXXXXXXXGOXXXXXXXXXXXXXXXXXXGOOOOXXXXXXXXXXXXXXXGOOXXXXXXXXXXXXXXXXXGOOOOXXXXXXXXXXXXXXX,0,0,0
6783,54,0,54,98,348,0,0,354,190,164,GOOXXXXXXXXXXXXXXXXXGOOOOOXXXXXXXXXXXXXXGOOOOXXXXXXXXXXXXXXXGOOOXXXXXXXXXXXXXXXXGOXXXXXXXXXXXXXXXXXXGOOOXXXXXXXXXXXXXXXXGOOOOOXXXXXXXXXXXXXXGOOOOXXXXXXXXXXXXXXXGOOOXXXXXXXXXXXXXXXXGOXXXXXXXXXXXXXXXXXXGOOOOXXXXXXXXXXXXXXXGOOXXXXXXXXXXXXXXXXXGOOOOXXXXXXXXXXXXXXX,0,0,0
6804,54,0,54,91,355,0,0,360,197,163,GOOXXXXXXXXXXXXXXXXXGOOOOOXXXXXXXXXXXXXXGOOOOXXXXXXXXXXXXXXXGOOOXXXXXXXXXXXXXXXXGOXXXXXXXXXXXXXXXXXXGOOOXXXXXXXXXXXXXXXXGOOOOOXXXXXXXXXXXXXXGOOOOXXXXXXXXXXXXXXXGOOOXXXXXXXXXXXXXXXXGOXXXXXXXXXXXXXXXXXXGOOOOXXXXXXXXXXXXXXXGOOXXXXXXXXXXXXXXXXXGOOOOXXXXXXXXXXXXXXX,0,0,0

6825,54,0,54,87,359,0,0,364,201,163,GOOXXXXXXXXXXXXXXXXXGOOOOOXXXXXXXXXXXXXXGOOOOXXXXXXXXXXXXXXXGOOOXXXXXXXXXXXXXXXXGOXXXXXXXXXXXXXXXXXXGOOOXXXXXXXXXXXXXXXXGOOOOOXXXXXXXXXXXXXXGOOOOXXXXXXXXXXXXXXXGOOOXXXXXXXXXXXXXXXXGOXXXXXXXXXXXXXXXXXXGOOOOXXXXXXXXXXXXXXXGOOXXXXXXXXXXXXXXXXXGOOOOXXXXXXXXXXXXXXX,0,0,0
6846,54,0,54,87,359,0,0,362,201,161,GOOXXXXXXXXXXXXXXXXXGOOOOOXXXXXXXXXXXXXXGOOOOXXXXXXXXXXXXXXXGOOOXXXXXXXXXXXXXXXXGOXXXXXXXXXXXXXXXXXXGOOOXXXXXXXXXXXXXXXXGOOOOOXXXXXXXXXXXXXXGOOOOXXXXXXXXXXXXXXXGOOOXXXXXXXXXXXXXXXXGOXXXXXXXXXXXXXXXXXXGOOOOXXXXXXXXXXXXXXXGOOXXXXXXXXXXXXXXXXXGOOOOXXXXXXXXXXXXXXX,0,0,0
6867,54,0,54,93,353,0,0,358,199,159,GOOXXXXXXXXXXXXXXXXXGOOOOOXXXXXXXXXXXXXXGOOOOXXXXXXXXXXXXXXXGOOOXXXXXXXXXXXXXXXXGOXXXXXXXXXXXXXXXXXXGOOOXXXXXXXXXXXXXXXXGOOOOOXXXXXXXXXXXXXXGOOOOXXXXXXXXXXXXXXXGOOOXXXXXXXXXXXXXXXXGOXXXXXXXXXXXXXXXXXXGOOOOXXXXXXXXXXXXXXXGOOXXXXXXXXXXXXXXXXXGOOOOXXXXXXXXXXXXXXX,0,0,0
6888,54,0,54,97,349,0,0,352,198,154,GOOXXXXXXXXXXXXXXXXXGOOOOOXXXXXXXXXXXXXXGOOOOXXXXXXXXXXXXXXXGOOOXXXXXXXXXXXXXXXXGOXXXXXXXXXXXXXXXXXXGOOOXXXXXXXXXXXXXXXXGOOOOOXXXXXXXXXXXXXXGOOOOXXXXXXXXXXXXXXXGOOOXXXXXXXXXXXXXXXXGOXXXXXXXXXXXXXXXXXXGOOOOXXXXXXXXXXXXXXXGOOXXXXXXXXXXXXXXXXXGOOOOXXXXXXXXXXXXXXX,0,0,0
6909,54,0,54,98,348,0,0,352,195,157,GOOXXXXXXXXXXXXXXXXXGOOOOOXXXXXXXXXXXXXXGOOOOXXXXXXXXXXXXXXXGOOOXXXXXXXXXXXXXXXXGOXXXXXXXXXXXXXXXXXXGOOOXXXXXXXXXXXXXXXXGOOOOOXXXXXXXXXXXXXXGOOOOXXXXXXXXXXXXXXXGOOOXXXXXXXXXXXXXXXXGOXXXXXXXXXXXXXXXXXXGOOOOXXXXXXXXXXXXXXXGOOXXXXXXXXXXXXXXXXXGOOOOXXXXXXXXXXXXXXX,0,0,0

6930,55,1,54,90,355,0,0,358,204,154,GOOXXXXXXXXXXXXXXXXXGOOOOOXXXXXXXXXXXXXXGOOOOXXXXXXXXXXXXXXXGOOOXXXXXXXXXXXXXXXXGOXXXXXXXXXXXXXXXXXXGOOOAXXXXXXXXXXXXXXXGOOOOOXXXXXXXXXXXXXXGOOOOXXXXXXXXXXXXXXXGOOOXXXXXXXXXXXXXXXXGOXXXXXXXXXXXXXXXXXXGOOOOXXXXXXXXXXXXXXXGOOXXXXXXXXXXXXXXXXXGOOOOXXXXXXXXXXXXXXX,0,0,0
6951,55,1,54,94,351,0,0,353,198,155,GOOXXXXXXXXXXXXXXXXXGOOOOOXXXXXXXXXXXXXXGOOOOXXXXXXXXXXXXXXXGOOOXXXXXXXXXXXXXXXXGOXXXXXXXXXXXXXXXXXXGOOOAXXXXXXXXXXXXXXXGOOOOOXXXXXXXXXXXXXXGOOOOXXXXXXXXXXXXXXXGOOOXXXXXXXXXXXXXXXXGOXXXXXXXXXXXXXXXXXXGOOOOXXXXXXXXXXXXXXXGOOXXXXXXXXXXXXXXXXXGOOOOXXXXXXXXXXXXXXX,0,0,0
6972,56,2,54,93,351,0,0,354,196,158,GOOXXXXXXXXXXXXXXXXXGOOOOOXXXXXXXXXXXXXXGOOOOXXXXXXXXXXXXXXXGOOOXXXXXXXXXXXXXXXXGOAXXXXXXXXXXXXXXXXXGOOOAXXXXXXXXXXXXXXXGOOOOOXXXXXXXXXXXXXXGOOOOXXXXXXXXXXXXXXXGOOOXXXXXXXXXXXXXXXXGOXXXXXXXXXXXXXXXXXXGOOOOXXXXXXXXXXXXXXXGOOXXXXXXXXXXXXXXXXXGOOOOXXXXXXXXXXXXXXX,0,0,0
6993,56,1,55,84,360,0,0,364,202,162,GOOXXXXXXXXXXXXXXXXXGOOOOOXXXXXXXXXXXXXXGOOOOXXXXXXXXXXXXXXXGOOOXXXXXXXXXXXXXXXXGOOXXXXXXXXXXXXXXXXXGOOOAXXXXXXXXXXXXXXXGOOOOOXXXXXXXXXXXXXXGOOOOXXXXXXXXXXXXXXXGOOOXXXXXXXXXXXXXXXXGOXXXXXXXXXXXXXXXXXXGOOOOXXXXXXXXXXXXXXXGOOXXXXXXXXXXXXXXXXXGOOOOXXXXXXXXXXXXXXX,0,0,0
7014,57,2,55,86,357,0,0,360,199,161,GOOXXXXXXXXXXXXXXXXXGOOOOOXXXXXXXXXXXXXXGOOOOAXXXXXXXXXXXXXXGOOOXXXXXXXXXXXXXXXXGOOXXXXXXXXXXXXXXXXXGOOOAXXXXXXXXXXXXXXXGOOOOOXXXXXXXXXXXXXXGOOOOXXXXXXXXXXXXXXXGOOOXXXXXXXXXXXXXXXXGOXXXXXXXXXXXXXXXXXXGOOOOXXXXXXXXXXXXXXXGOOXXXXXXXXXXXXXXXXXGOOOOXXXXXXXXXXXXXXX,0,0,0

7035,57,2,55,86,357,0,0,360,203,157,GOOXXXXXXXXXXXXXXXXXGOOOOOXXXXXXXXXXXXXXGOOOOAXXXXXXXXXXXXXXGOOOXXXXXXXXXXXXXXXXGOOXXXXXXXXXXXXXXXXXGOOOAXXXXXXXXXXXXXXXGOOOOOXXXXXXXXXXXXXXGOOOOXXXXXXXXXXXXXXXGOOOXXXXXXXXXXXXXXXXGOXXXXXXXXXXXXXXXXXXGOOOOXXXXXXXXXXXXXXXGOOXXXXXXXXXXXXXXXXXGOOOOXXXXXXXXXXXXXXX,0,0,0
7056,58,3,55,85,357,0,0,358,204,154,GOOXXXXXXXXXXXXXXXXXGOOOOOXXXXXXXXXXXXXXGOOOOAXXXXXXXXXXXXXXGOOOXXXXXXXXXXXXXXXXGOOXXXXXXXXXXXXXXXXXGOOOAXXXXXXXXXXXXXXXGOOOOOXXXXXXXXXXXXXXGOOOOXXXXXXXXXXXXXXXGOOOXXXXXXXXXXXXXXXXGOXXXXXXXXXXXXXXXXXXGOOOOXXXXXXXXXXXXXXXGOOXXXXXXXXXXXXXXXXXGOOOOAXXXXXXXXXXXXXX,0,0,0
7077,58,2,56,89,353,0,0,355,199,156,GOOXXXXXXXXXXXXXXXXXGOOOOOXXXXXXXXXXXXXXGOOOOOXXXXXXXXXXXXXXGOOOXXXXXXXXXXXXXXXXGOOXXXXXXXXXXXXXXXXXGOOOAXXXXXXXXXXXXXXXGOOOOOXXXXXXXXXXXXXXGOOOOXXXXXXXXXXXXXXXGOOOXXXXXXXXXXXXXXXXGOXXXXXXXXXXXXXXXXXXGOOOOXXXXXXXXXXXXXXXGOOXXXXXXXXXXXXXXXXXGOOOOAXXXXXXXXXXXXXX,0,0,0
7098,58,1,57,88,354,0,0,357,200,157,GOOXXXXXXXXXXXXXXXXXGOOOOOXXXXXXXXXXXXXXGOOOOOXXXXXXXXXXXXXXGOOOXXXXXXXXXXXXXXXXGOOXXXXXXXXXXXXXXXXXGOOOOXXXXXXXXXXXXXXXGOOOOOXXXXXXXXXXXXXXGOOOOXXXXXXXXXXXXXXXGOOOXXXXXXXXXXXXXXXXGOXXXXXXXXXXXXXXXXXXGOOOOXXXXXXXXXXXXXXXGOOXXXXXXXXXXXXXXXXXGOOOOAXXXXXXXXXXXXXX,0,0,0
7119,58,1,57,89,353,0,0,356,205,151,GOOXXXXXXXXXXXXXXXXXGOOOOOXXXXXXXXXXXXXXGOOOOOXXXXXXXXXXXXXXGOOOXXXXXXXXXXXXXXXXGOOXXXXXXXXXXXXXXXXXGOOOOXXXXXXXXXXXXXXXGOOOOOXXXXXXXXXXXXXXGOOOOXXXXXXXXXXXXXXXGOOOXXXXXXXXXXXXXXXXGOXXXXXXXXXXXXXXXXXXGOOOOXXXXXXXXXXXXXXXGOOXXXXXXXXXXXXXXXXXGOOOOAXXXXXXXXXXXXXX,0,0,0

7140,58,1,57,89,353,0,0,355,205,150,GOOXXXXXXXXXXXXXXXXXGOOOOOXXXXXXXXXXXXXXGOOOOOXXXXXXXXXXXXXXGOOOXXXXXXXXXXXXXXXXGOOXXXXXXXXXXXXXXXXXGOOOOXXXXXXXXXXXXXXXGOOOOOXXXXXXXXXXXXXXGOOOOXXXXXXXXXXXXXXXGOOOXXXXXXXXXXXXXXXXGOXXXXXXXXXXXXXXXXXXGOOOOXXXXXXXXXXXXXXXGOOXXXXXXXXXXXXXXXXXGOOOOAXXXXXXXXXXXXXX,0,0,0
7161,58,1,57,92,350,0,0,354,205,149,GOOXXXXXXXXXXXXXXXXXGOOOOOXXXXXXXXXXXXXXGOOOOOXXXXXXXXXXXXXXGOOOXXXXXXXXXXXXXXXXGOOXXXXXXXXXXXXXXXXXGOOOOXXXXXXXXXXXXXXXGOOOOOXXXXXXXXXXXXXXGOOOOXXXXXXXXXXXXXXXGOOOXXXXXXXXXXXXXXXXGOXXXXXXXXXXXXXXXXXXGOOOOXXXXXXXXXXXXXXXGOOXXXXXXXXXXXXXXXXXGOOOOAXXXXXXXXXXXXXX,0,0,0
7182,58,1,57,84,358,0,0,361,203,158,GOOXXXXXXXXXXXXXXXXXGOOOOOXXXXXXXXXXXXXXGOOOOOXXXXXXXXXXXXXXGOOOXXXXXXXXXXXXXXXXGOOXXXXXXXXXXXXXXXXXGOOOOXXXXXXXXXXXXXXXGOOOOOXXXXXXXXXXXXXXGOOOOXXXXXXXXXXXXXXXGOOOXXXXXXXXXXXXXXXXGOXXXXXXXXXXXXXXXXXXGOOOOXXXXXXXXXXXXXXXGOOXXXXXXXXXXXXXXXXXGOOOOAXXXXXXXXXXXXXX,0,0,0
7203,58,1,57,87,355,0,0,359,201,158,GOOXXXXXXXXXXXXXXXXXGOOOOOXXXXXXXXXXXXXXGOOOOOXXXXXXXXXXXXXXGOOOXXXXXXXXXXXXXXXXGOOXXXXXXXXXXXXXXXXXGOOOOXXXXXXXXXXXXXXXGOOOOOXXXXXXXXXXXXXXGOOOOXXXXXXXXXXXXXXXGOOOXXXXXXXXXXXXXXXXGOXXXXXXXXXXXXXXXXXXGOOOOXXXXXXXXXXXXXXXGOOXXXXXXXXXXXXXXXXXGOOOOAXXXXXXXXXXXXXX,0,0,0
7224,58,1,57,86,356,0,0,359,207,152,GOOXXXXXXXXXXXXXXXXXGOOOOOXXXXXXXXXXXXXXGOOOOOXXXXXXXXXXXXXXGOOOXXXXXXXXXXXXXXXXGOOXXXXXXXXXXXXXXXXXGOOOOXXXXXXXXXXXXXXXGOOOOOXXXXXXXXXXXXXXGOOOOXXXXXXXXXXXXXXXGOOOXXXXXXXXXXXXXXXXGOXXXXXXXXXXXXXXXXXXGOOOOXXXXXXXXXXXXXXXGOOXXXXXXXXXXXXXXXXXGOOOOAXXXXXXXXXXXXXX,0,0,0

7245,58,1,57,88,354,0,0,358,211,147,GOOXXXXXXXXXXXXXXXXXGOOOOOXXXXXXXXXXXXXXGOOOOOXXXXXXXXXXXXXXGOOOXXXXXXXXXXXXXXXXGOOXXXXXXXXXXXXXXXXXGOOOOXXXXXXXXXXXXXXXGOOOOOXXXXXXXXXXXXXXGOOOOXXXXXXXXXXXXXXXGOOOXXXXXXXXXXXXXXXXGOXXXXXXXXXXXXXXXXXXGOOOOXXXXXXXXXXXXXXXGOOXXXXXXXXXXXXXXXXXGOOOOAXXXXXXXXXXXXXX,0,0,0
7266,58,1,57,91,351,0,0,354,206,148,GOOXXXXXXXXXXXXXXXXXGOOOOOXXXXXXXXXXXXXXGOOOOOXXXXXXXXXXXXXXGOOOXXXXXXXXXXXXXXXXGOOXXXXXXXXXXXXXXXXXGOOOOXXXXXXXXXXXXXXXGOOOOOXXXXXXXXXXXXXXGOOOOXXXXXXXXXXXXXXXGOOOXXXXXXXXXXXXXXXXGOXXXXXXXXXXXXXXXXXXGOOOOXXXXXXXXXXXXXXXGOOXXXXXXXXXXXXXXXXXGOOOOAXXXXXXXXXXXXXX,0,0,0
7287,58,1,57,93,349,0,0,352,206,146,GOOXXXXXXXXXXXXXXXXXGOOOOOXXXXXXXXXXXXXXGOOOOOXXXXXXXXXXXXXXGOOOXXXXXXXXXXXXXXXXGOOXXXXXXXXXXXXXXXXXGOOOOXXXXXXXXXXXXXXXGOOOOOXXXXXXXXXXXXXXGOOOOXXXXXXXXXXXXXXXGOOOXXXXXXXXXXXXXXXXGOXXXXXXXXXXXXXXXXXXGOOOOXXXXXXXXXXXXXXXGOOXXXXXXXXXXXXXXXXXGOOOOAXXXXXXXXXXXXXX,0,0,0
7308,58,0,58,87,355,0,0,358,209,149,GOOXXXXXXXXXXXXXXXXXGOOOOOXXXXXXXXXXXXXXGOOOOOXXXXXXXXXXXXXXGOOOXXXXXXXXXXXXXXXXGOOXXXXXXXXXXXXXXXXXGOOOOXXXXXXXXXXXXXXXGOOOOOXXXXXXXXXXXXXXGOOOOXXXXXXXXXXXXXXXGOOOXXXXXXXXXXXXXXXXGOXXXXXXXXXXXXXXXXXXGOOOOXXXXXXXXXXXXXXXGOOXXXXXXXXXXXXXXXXXGOOOOOXXXXXXXXXXXXXX,0,0,0
7329,58,0,58,82,360,0,0,363,213,150,GOOXXXXXXXXXXXXXXXXXGOOOOOXXXXXXXXXXXXXXGOOOOOXXXXXXXXXXXXXXGOOOXXXXXXXXXXXXXXXXGOOXXXXXXXXXXXXXXXXXGOOOOXXXXXXXXXXXXXXXGOOOOOXXXXXXXXXXXXXXGOOOOXXXXXXXXXXXXXXXGOOOXXXXXXXXXXXXXXXXGOXXXXXXXXXXXXXXXXXXGOOOOXXXXXXXXXXXXXXXGOOXXXXXXXXXXXXXXXXXGOOOOOXXXXXXXXXXXXXX,0,0,0

7350,58,0,58,85,357,0,0,361,212,149,GOOXXXXXXXXXXXXXXXXXGOOOOOXXXXXXXXXXXXXXGOOOOOXXXXXXXXXXXXXXGOOOXXXXXXXXXXXXXXXXGOOXXXXXXXXXXXXXXXXXGOOOOXXXXXXXXXXXXXXXGOOOOOXXXXXXXXXXXXXXGOOOOXXXXXXXXXXXXXXXGOOOXXXXXXXXXXXXXXXXGOXXXXXXXXXXXXXXXXXXGOOOOXXXXXXXXXXXXXXXGOOXXXXXXXXXXXXXXXXXGOOOOOXXXXXXXXXXXXXX,0,0,0
7371,58,0,58,85,357,0,0,361,212,149,GOOXXXXXXXXXXXXXXXXXGOOOOOXXXXXXXXXXXXXXGOOOOOXXXXXXXXXXXXXXGOOOXXXXXXXXXXXXXXXXGOOXXXXXXXXXXXXXXXXXGOOOOXXXXXXXXXXXXXXXGOOOOOXXXXXXXXXXXXXXGOOOOXXXXXXXXXXXXXXXGOOOXXXXXXXXXXXXXXXXGOXXXXXXXXXXXXXXXXXXGOOOOXXXXXXXXXXXXXXXGOOXXXXXXXXXXXXXXXXXGOOOOOXXXXXXXXXXXXXX,0,0,0
7392,58,0,58,86,356,0,0,358,212,146,GOOXXXXXXXXXXXXXXXXXGOOOOOXXXXXXXXXXXXXXGOOOOOXXXXXXXXXXXXXXGOOOXXXXXXXXXXXXXXXXGOOXXXXXXXXXXXXXXXXXGOOOOXXXXXXXXXXXXXXXGOOOOOXXXXXXXXXXXXXXGOOOOXXXXXXXXXXXXXXXGOOOXXXXXXXXXXXXXXXXGOXXXXXXXXXXXXXXXXXXGOOOOXXXXXXXXXXXXXXXGOOXXXXXXXXXXXXXXXXXGOOOOOXXXXXXXXXXXXXX,0,0,0
7413,58,0,58,82,360,0,0,363,213,150,GOOXXXXXXXXXXXXXXXXXGOOOOOXXXXXXXXXXXXXXGOOOOOXXXXXXXXXXXXXXGOOOXXXXXXXXXXXXXXXXGOOXXXXXXXXXXXXXXXXXGOOOOXXXXXXXXXXXXXXXGOOOOOXXXXXXXXXXXXXXGOOOOXXXXXXXXXXXXXXXGOOOXXXXXXXXXXXXXXXXGOXXXXXXXXXXXXXXXXXXGOOOOXXXXXXXXXXXXXXXGOOXXXXXXXXXXXXXXXXXGOOOOOXXXXXXXXXXXXXX,0,0,0
7434,58,0,58,88,354,0,0,357,211,146,GOOXXXXXXXXXXXXXXXXXGOOOOOXXXXXXXXXXXXXXGOOOOOXXXXXXXXXXXXXXGOOOXXXXXXXXXXXXXXXXGOOXXXXXXXXXXXXXXXXXGOOOOXXXXXXXXXXXXXXXGOOOOOXXXXXXXXXXXXXXGOOOOXXXXXXXXXXXXXXXGOOOXXXXXXXXXXXXXXXXGOXXXXXXXXXXXXXXXXXXGOOOOXXXXXXXXXXXXXXXGOOXXXXXXXXXXXXXXXXXGOOOOOXXXXXXXXXXXXXX,0,0,0

7455,58,0,58,89,353,0,0,356,210,146,GOOXXXXXXXXXXXXXXXXXGOOOOOXXXXXXXXXXXXXXGOOOOOXXXXXXXXXXXXXXGOOOXXXXXXXXXXXXXXXXGOOXXXXXXXXXXXXXXXXXGOOOOXXXXXXXXXXXXXXXGOOOOOXXXXXXXXXXXXXXGOOOOXXXXXXXXXXXXXXXGOOOXXXXXXXXXXXXXXXXGOXXXXXXXXXXXXXXXXXXGOOOOXXXXXXXXXXXXXXXGOOXXXXXXXXXXXXXXXXXGOOOOOXXXXXXXXXXXXXX,0,0,0
7476,58,0,58,90,352,0,0,356,215,141,GOOXXXXXXXXXXXXXXXXXGOOOOOXXXXXXXXXXXXXXGOOOOOXXXXXXXXXXXXXXGOOOXXXXXXXXXXXXXXXXGOOXXXXXXXXXXXXXXXXXGOOOOXXXXXXXXXXXXXXXGOOOOOXXXXXXXXXXXXXXGOOOOXXXXXXXXXXXXXXXGOOOXXXXXXXXXXXXXXXXGOXXXXXXXXXXXXXXXXXXGOOOOXXXXXXXXXXXXXXXGOOXXXXXXXXXXXXXXXXXGOOOOOXXXXXXXXXXXXXX,0,0,0
7497,59,1,58,84,357,0,0,362,212,150,GOOXXXXXXXXXXXXXXXXXGOOOOOXXXXXXXXXXXXXXGOOOOOXXXXXXXXXXXXXXGOOOXXXXXXXXXXXXXXXXGOOXXXXXXXXXXXXXXXXXGOOOOXXXXXXXXXXXXXXXGOOOOOXXXXXXXXXXXXXXGOOOOXXXXXXXXXXXXXXXGOOOAXXXXXXXXXXXXXXXGOXXXXXXXXXXXXXXXXXXGOOOOXXXXXXXXXXXXXXXGOOXXXXXXXXXXXXXXXXXGOOOOOXXXXXXXXXXXXXX,0,0,0
7518,59,1,58,81,360,0,0,364,214,150,GOOXXXXXXXXXXXXXXXXXGOOOOOXXXXXXXXXXXXXXGOOOOOXXXXXXXXXXXXXXGOOOXXXXXXXXXXXXXXXXGOOXXXXXXXXXXXXXXXXXGOOOOXXXXXXXXXXXXXXXGOOOOOXXXXXXXXXXXXXXGOOOOXXXXXXXXXXXXXXXGOOOAXXXXXXXXXXXXXXXGOXXXXXXXXXXXXXXXXXXGOOOOXXXXXXXXXXXXXXXGOOXXXXXXXXXXXXXXXXXGOOOOOXXXXXXXXXXXXXX,0,0,0
7539,59,1,58,83,358,0,0,363,215,148,GOOXXXXXXXXXXXXXXXXXGOOOOOXXXXXXXXXXXXXXGOOOOOXXXXXXXXXXXXXXGOOOXXXXXXXXXXXXXXXXGOOXXXXXXXXXXXXXXXXXGOOOOXXXXXXXXXXXXXXXGOOOOOXXXXXXXXXXXXXXGOOOOXXXXXXXXXXXXXXXGOOOAXXXXXXXXXXXXXXXGOXXXXXXXXXXXXXXXXXXGOOOOXXXXXXXXXXXXXXXGOOXXXXXXXXXXXXXXXXXGOOOOOXXXXXXXXXXXXXX,0,0,0

7560,59,1,58,80,361,0,0,366,220,146,GOOXXXXXXXXXXXXXXXXXGOOOOOXXXXXXXXXXXXXXGOOOOOXXXXXXXXXXXXXXGOOOXXXXXXXXXXXXXXXXGOOXXXXXXXXXXXXXXXXXGOOOOXXXXXXXXXXXXXXXGOOOOOXXXXXXXXXXXXXXGOOOOXXXXXXXXXXXXXXXGOOOAXXXXXXXXXXXXXXXGOXXXXXXXXXXXXXXXXXXGOOOOXXXXXXXXXXXXXXXGOOXXXXXXXXXXXXXXXXXGOOOOOXXXXXXXXXXXXXX,0,0,0
7581,60,2,58,83,357,0,0,361,215,146,GOOXXXXXXXXXXXXXXXXXGOOOOOXXXXXXXXXXXXXXGOOOOOXXXXXXXXXXXXXXGOOOXXXXXXXXXXXXXXXXGOOXXXXXXXXXXXXXXXXXGOOOOXXXXXXXXXXXXXXXGOOOOOAXXXXXXXXXXXXXGOOOOXXXXXXXXXXXXXXXGOOOAXXXXXXXXXXXXXXXGOXXXXXXXXXXXXXXXXXXGOOOOXXXXXXXXXXXXXXXGOOXXXXXXXXXXXXXXXXXGOOOOOXXXXXXXXXXXXXX,0,0,0
7602,60,2,58,79,361,0,0,366,217,149,GOOXXXXXXXXXXXXXXXXXGOOOOOXXXXXXXXXXXXXXGOOOOOXXXXXXXXXXXXXXGOOOXXXXXXXXXXXXXXXXGOOXXXXXXXXXXXXXXXXXGOOOOXXXXXXXXXXXXXXXGOOOOOAXXXXXXXXXXXXXGOOOOXXXXXXXXXXXXXXXGOOOAXXXXXXXXXXXXXXXGOXXXXXXXXXXXXXXXXXXGOOOOXXXXXXXXXXXXXXXGOOXXXXXXXXXXXXXXXXXGOOOOOXXXXXXXXXXXXXX,0,0,0
7623,60,2,58,81,359,0,0,364,215,149,GOOXXXXXXXXXXXXXXXXXGOOOOOXXXXXXXXXXXXXXGOOOOOXXXXXXXXXXXXXXGOOOXXXXXXXXXXXXXXXXGOOXXXXXXXXXXXXXXXXXGOOOOXXXXXXXXXXXXXXXGOOOOOAXXXXXXXXXXXXXGOOOOXXXXXXXXXXXXXXXGOOOAXXXXXXXXXXXXXXXGOXXXXXXXXXXXXXXXXXXGOOOOXXXXXXXXXXXXXXXGOOXXXXXXXXXXXXXXXXXGOOOOOXXXXXXXXXXXXXX,0,0,0
7644,60,2,58,81,359,0,0,363,220,143,GOOXXXXXXXXXXXXXXXXXGOOOOOXXXXXXXXXXXXXXGOOOOOXXXXXXXXXXXXXXGOOOXXXXXXXXXXXXXXXXGOOXXXXXXXXXXXXXXXXXGOOOOXXXXXXXXXXXXXXXGOOOOOAXXXXXXXXXXXXXGOOOOXXXXXXXXXXXXXXXGOOOAXXXXXXXXXXXXXXXGOXXXXXXXXXXXXXXXXXXGOOOOXXXXXXXXXXXXXXXGOOXXXXXXXXXXXXXXXXXGOOOOOXXXXXXXXXXXXXX,0,0,0

7665,60,2,58,81,359,0,0,363,220,143,GOOXXXXXXXXXXXXXXXXXGOOOOOXXXXXXXXXXXXXXGOOOOOXXXXXXXXXXXXXXGOOOXXXXXXXXXXXXXXXXGOOXXXXXXXXXXXXXXXXXGOOOOXXXXXXXXXXXXXXXGOOOOOAXXXXXXXXXXXXXGOOOOXXXXXXXXXXXXXXXGOOOAXXXXXXXXXXXXXXXGOXXXXXXXXXXXXXXXXXXGOOOOXXXXXXXXXXXXXXXGOOXXXXXXXXXXXXXXXXXGOOOOOXXXXXXXXXXXXXX,0,0,0
7686,60,2,58,83,357,0,0,361,219,142,GOOXXXXXXXXXXXXXXXXXGOOOOOXXXXXXXXXXXXXXGOOOOOXXXXXXXXXXXXXXGOOOXXXXXXXXXXXXXXXXGOOXXXXXXXXXXXXXXXXXGOOOOXXXXXXXXXXXXXXXGOOOOOAXXXXXXXXXXXXXGOOOOXXXXXXXXXXXXXXXGOOOAXXXXXXXXXXXXXXXGOXXXXXXXXXXXXXXXXXXGOOOOXXXXXXXXXXXXXXXGOOXXXXXXXXXXXXXXXXXGOOOOOXXXXXXXXXXXXXX,0,0,0
7707,60,2,58,82,358,0,0,362,218,144,GOOXXXXXXXXXXXXXXXXXGOOOOOXXXXXXXXXXXXXXGOOOOOXXXXXXXXXXXXXXGOOOXXXXXXXXXXXXXXXXGOOXXXXXXXXXXXXXXXXXGOOOOXXXXXXXXXXXXXXXGOOOOOAXXXXXXXXXXXXXGOOOOXXXXXXXXXXXXXXXGOOOAXXXXXXXXXXXXXXXGOXXXXXXXXXXXXXXXXXXGOOOOXXXXXXXXXXXXXXXGOOXXXXXXXXXXXXXXXXXGOOOOOXXXXXXXXXXXXXX,0,0,0
7728,60,2,58,84,356,0,0,360,221,139,GOOXXXXXXXXXXXXXXXXXGOOOOOXXXXXXXXXXXXXXGOOOOOXXXXXXXXXXXXXXGOOOXXXXXXXXXXXXXXXXGOOXXXXXXXXXXXXXXXXXGOOOOXXXXXXXXXXXXXXXGOOOOOAXXXXXXXXXXXXXGOOOOXXXXXXXXXXXXXXXGOOOAXXXXXXXXXXXXXXXGOXXXXXXXXXXXXXXXXXXGOOOOXXXXXXXXXXXXXXXGOOXXXXXXXXXXXXXXXXXGOOOOOXXXXXXXXXXXXXX,0,0,0
7749,60,2,58,83,357,0,0,361,223,138,GOOXXXXXXXXXXXXXXXXXGOOOOOXXXXXXXXXXXXXXGOOOOOXXXXXXXXXXXXXXGOOOXXXXXXXXXXXXXXXXGOOXXXXXXXXXXXXXXXXXGOOOOXXXXXXXXXXXXXXXGOOOOOAXXXXXXXXXXXXXGOOOOXXXXXXXXXXXXXXXGOOOAXXXXXXXXXXXXXXXGOXXXXXXXXXXXXXXXXXXGOOOOXXXXXXXXXXXXXXXGOOXXXXXXXXXXXXXXXXXGOOOOOXXXXXXXXXXXXXX,0,0,0

7770,60,1,59,78,362,0,0,364,221,143,GOOXXXXXXXXXXXXXXXXXGOOOOOXXXXXXXXXXXXXXGOOOOOXXXXXXXXXXXXXXGOOOXXXXXXXXXXXXXXXXGOOXXXXXXXXXXXXXXXXXGOOOOXXXXXXXXXXXXXXXGOOOOOAXXXXXXXXXXXXXGOOOOXXXXXXXXXXXXXXXGOOOOXXXXXXXXXXXXXXXGOXXXXXXXXXXXXXXXXXXGOOOOXXXXXXXXXXXXXXXGOOXXXXXXXXXXXXXXXXXGOOOOOXXXXXXXXXXXXXX,0,0,0
7791,60,0,60,78,362,0,0,364,222,142,GOOXXXXXXXXXXXXXXXXXGOOOOOXXXXXXXXXXXXXXGOOOOOXXXXXXXXXXXXXXGOOOXXXXXXXXXXXXXXXXGOOXXXXXXXXXXXXXXXXXGOOOOXXXXXXXXXXXXXXXGOOOOOOXXXXXXXXXXXXXGOOOOXXXXXXXXXXXXXXXGOOOOXXXXXXXXXXXXXXXGOXXXXXXXXXXXXXXXXXXGOOOOXXXXXXXXXXXXXXXGOOXXXXXXXXXXXXXXXXXGOOOOOXXXXXXXXXXXXXX,0,0,0
7812,60,0,60,81,359,0,0,363,223,140,GOOXXXXXXXXXXXXXXXXXGOOOOOXXXXXXXXXXXXXXGOOOOOXXXXXXXXXXXXXXGOOOXXXXXXXXXXXXXXXXGOOXXXXXXXXXXXXXXXXXGOOOOXXXXXXXXXXXXXXXGOOOOOOXXXXXXXXXXXXXGOOOOXXXXXXXXXXXXXXXGOOOOXXXXXXXXXXXXXXXGOXXXXXXXXXXXXXXXXXXGOOOOXXXXXXXXXXXXXXXGOOXXXXXXXXXXXXXXXXXGOOOOOXXXXXXXXXXXXXX,0,0,0
7833,60,0,60,76,364,0,0,368,226,142,GOOXXXXXXXXXXXXXXXXXGOOOOOXXXXXXXXXXXXXXGOOOOOXXXXXXXXXXXXXXGOOOXXXXXXXXXXXXXXXXGOOXXXXXXXXXXXXXXXXXGOOOOXXXXXXXXXXXXXXXGOOOOOOXXXXXXXXXXXXXGOOOOXXXXXXXXXXXXXXXGOOOOXXXXXXXXXXXXXXXGOXXXXXXXXXXXXXXXXXXGOOOOXXXXXXXXXXXXXXXGOOXXXXXXXXXXXXXXXXXGOOOOOXXXXXXXXXXXXXX,0,0,0
7854,60,0,60,84,356,0,0,360,223,137,GOOXXXXXXXXXXXXXXXXXGOOOOOXXXXXXXXXXXXXXGOOOOOXXXXXXXXXXXXXXGOOOXXXXXXXXXXXXXXXXGOOXXXXXXXXXXXXXXXXXGOOOOXXXXXXXXXXXXXXXGOOOOOOXXXXXXXXXXXXXGOOOOXXXXXXXXXXXXXXXGOOOOXXXXXXXXXXXXXXXGOXXXXXXXXXXXXXXXXXXGOOOOXXXXXXXXXXXXXXXGOOXXXXXXXXXXXXXXXXXGOOOOOXXXXXXXXXXXXXX,0,0,0

7875,60,0,60,77,363,0,0,369,224,145,GOOXXXXXXXXXXXXXXXXXGOOOOOXXXXXXXXXXXXXXGOOOOOXXXXXXXXXXXXXXGOOOXXXXXXXXXXXXXXXXGOOXXXXXXXXXXXXXXXXXGOOOOXXXXXXXXXXXXXXXGOOOOOOXXXXXXXXXXXXXGOOOOXXXXXXXXXXXXXXXGOOOOXXXXXXXXXXXXXXXGOXXXXXXXXXXXXXXXXXXGOOOOXXXXXXXXXXXXXXXGOOXXXXXXXXXXXXXXXXXGOOOOOXXXXXXXXXXXXXX,0,0,0
7896,60,0,60,78,362,0,0,367,228,139,GOOXXXXXXXXXXXXXXXXXGOOOOOXXXXXXXXXXXXXXGOOOOOXXXXXXXXXXXXXXGOOOXXXXXXXXXXXXXXXXGOOXXXXXXXXXXXXXXXXXGOOOOXXXXXXXXXXXXXXXGOOOOOOXXXXXXXXXXXXXGOOOOXXXXXXXXXXXXXXXGOOOOXXXXXXXXXXXXXXXGOXXXXXXXXXXXXXXXXXXGOOOOXXXXXXXXXXXXXXXGOOXXXXXXXXXXXXXXXXXGOOOOOXXXXXXXXXXXXXX,0,0,0
7917,60,0,60,81,359,0,0,364,230,134,GOOXXXXXXXXXXXXXXXXXGOOOOOXXXXXXXXXXXXXXGOOOOOXXXXXXXXXXXXXXGOOOXXXXXXXXXXXXXXXXGOOXXXXXXXXXXXXXXXXXGOOOOXXXXXXXXXXXXXXXGOOOOOOXXXXXXXXXXXXXGOOOOXXXXXXXXXXXXXXXGOOOOXXXXXXXXXXXXXXXGOXXXXXXXXXXXXXXXXXXGOOOOXXXXXXXXXXXXXXXGOOXXXXXXXXXXXXXXXXXGOOOOOXXXXXXXXXXXXXX,0,0,0
7938,60,0,60,87,353,0,0,358,227,131,GOOXXXXXXXXXXXXXXXXXGOOOOOXXXXXXXXXXXXXXGOOOOOXXXXXXXXXXXXXXGOOOXXXXXXXXXXXXXXXXGOOXXXXXXXXXXXXXXXXXGOOOOXXXXXXXXXXXXXXXGOOOOOOXXXXXXXXXXXXXGOOOOXXXXXXXXXXXXXXXGOOOOXXXXXXXXXXXXXXXGOXXXXXXXXXXXXXXXXXXGOOOOXXXXXXXXXXXXXXXGOOXXXXXXXXXXXXXXXXXGOOOOOXXXXXXXXXXXXXX,0,0,0
7959,60,0,60,80,360,0,0,366,229,137,GOOXXXXXXXXXXXXXXXXXGOOOOOXXXXXXXXXXXXXXGOOOOOXXXXXXXXXXXXXXGOOOXXXXXXXXXXXXXXXXGOOXXXXXXXXXXXXXXXXXGOOOOXXXXXXXXXXXXXXXGOOOOOOXXXXXXXXXXXXXGOOOOXXXXXXXXXXXXXXXGOOOOXXXXXXXXXXXXXXXGOXXXXXXXXXXXXXXXXXXGOOOOXXXXXXXXXXXXXXXGOOXXXXXXXXXXXXXXXXXGOOOOOXXXXXXXXXXXXXX,0,0,0

7980,61,1,60,77,362,0,0,368,231,137,GOOXXXXXXXXXXXXXXXXXGOOOOOXXXXXXXXXXXXXXGOOOOOXXXXXXXXXXXXXXGOOOXXXXXXXXXXXXXXXXGOOXXXXXXXXXXXXXXXXXGOOOOXXXXXXXXXXXXXXXGOOOOOOXXXXXXXXXXXXXGOOOOXXXXXXXXXXXXXXXGOOOOXXXXXXXXXXXXXXXGOAXXXXXXXXXXXXXXXXXGOOOOXXXXXXXXXXXXXXXGOOXXXXXXXXXXXXXXXXXGOOOOOXXXXXXXXXXXXXX,0,0,0
8001,61,1,60,84,355,0,0,361,231,130,GOOXXXXXXXXXXXXXXXXXGOOOOOXXXXXXXXXXXXXXGOOOOOXXXXXXXXXXXXXXGOOOXXXXXXXXXXXXXXXXGOOXXXXXXXXXXXXXXXXXGOOOOXXXXXXXXXXXXXXXGOOOOOOXXXXXXXXXXXXXGOOOOXXXXXXXXXXXXXXXGOOOOXXXXXXXXXXXXXXXGOAXXXXXXXXXXXXXXXXXGOOOOXXXXXXXXXXXXXXXGOOXXXXXXXXXXXXXXXXXGOOOOOXXXXXXXXXXXXXX,0,0,0
8022,61,1,60,79,360,0,0,364,232,132,GOOXXXXXXXXXXXXXXXXXGOOOOOXXXXXXXXXXXXXXGOOOOOXXXXXXXXXXXXXXGOOOXXXXXXXXXXXXXXXXGOOXXXXXXXXXXXXXXXXXGOOOOXXXXXXXXXXXXXXXGOOOOOOXXXXXXXXXXXXXGOOOOXXXXXXXXXXXXXXXGOOOOXXXXXXXXXXXXXXXGOAXXXXXXXXXXXXXXXXXGOOOOXXXXXXXXXXXXXXXGOOXXXXXXXXXXXXXXXXXGOOOOOXXXXXXXXXXXXXX,0,0,0
8043,61,1,60,83,356,0,0,360,229,131,GOOXXXXXXXXXXXXXXXXXGOOOOOXXXXXXXXXXXXXXGOOOOOXXXXXXXXXXXXXXGOOOXXXXXXXXXXXXXXXXGOOXXXXXXXXXXXXXXXXXGOOOOXXXXXXXXXXXXXXXGOOOOOOXXXXXXXXXXXXXGOOOOXXXXXXXXXXXXXXXGOOOOXXXXXXXXXXXXXXXGOAXXXXXXXXXXXXXXXXXGOOOOXXXXXXXXXXXXXXXGOOXXXXXXXXXXXXXXXXXGOOOOOXXXXXXXXXXXXXX,0,0,0
8064,61,1,60,83,356,0,0,360,229,131,GOOXXXXXXXXXXXXXXXXXGOOOOOXXXXXXXXXXXXXXGOOOOOXXXXXXXXXXXXXXGOOOXXXXXXXXXXXXXXXXGOOXXXXXXXXXXXXXXXXXGOOOOXXXXXXXXXXXXXXXGOOOOOOXXXXXXXXXXXXXGOOOOXXXXXXXXXXXXXXXGOOOOXXXXXXXXXXXXXXXGOAXXXXXXXXXXXXXXXXXGOOOOXXXXXXXXXXXXXXXGOOXXXXXXXXXXXXXXXXXGOOOOOXXXXXXXXXXXXXX,0,0,0

8085,61,1,60,84,355,0,0,360,227,133,GOOXXXXXXXXXXXXXXXXXGOOOOOXXXXXXXXXXXXXXGOOOOOXXXXXXXXXXXXXXGOOOXXXXXXXXXXXXXXXXGOOXXXXXXXXXXXXXXXXXGOOOOXXXXXXXXXXXXXXXGOOOOOOXXXXXXXXXXXXXGOOOOXXXXXXXXXXXXXXXGOOOOXXXXXXXXXXXXXXXGOAXXXXXXXXXXXXXXXXXGOOOOXXXXXXXXXXXXXXXGOOXXXXXXXXXXXXXXXXXGOOOOOXXXXXXXXXXXXXX,0,0,0
8106,61,1,60,73,366,0,0,370,232,138,GOOXXXXXXXXXXXXXXXXXGOOOOOXXXXXXXXXXXXXXGOOOOOXXXXXXXXXXXXXXGOOOXXXXXXXXXXXXXXXXGOOXXXXXXXXXXXXXXXXXGOOOOXXXXXXXXXXXXXXXGOOOOOOXXXXXXXXXXXXXGOOOOXXXXXXXXXXXXXXXGOOOOXXXXXXXXXXXXXXXGOAXXXXXXXXXXXXXXXXXGOOOOXXXXXXXXXXXXXXXGOOXXXXXXXXXXXXXXXXXGOOOOOXXXXXXXXXXXXXX,0,0,0
8127,61,1,60,76,363,0,0,365,230,135,GOOXXXXXXXXXXXXXXXXXGOOOOOXXXXXXXXXXXXXXGOOOOOXXXXXXXXXXXXXXGOOOXXXXXXXXXXXXXXXXGOOXXXXXXXXXXXXXXXXXGOOOOXXXXXXXXXXXXXXXGOOOOOOXXXXXXXXXXXXXGOOOOXXXXXXXXXXXXXXXGOOOOXXXXXXXXXXXXXXXGOAXXXXXXXXXXXXXXXXXGOOOOXXXXXXXXXXXXXXXGOOXXXXXXXXXXXXXXXXXGOOOOOXXXXXXXXXXXXXX,0,0,0
8148,61,1,60,78,361,0,0,365,229,136,GOOXXXXXXXXXXXXXXXXXGOOOOOXXXXXXXXXXXXXXGOOOOOXXXXXXXXXXXXXXGOOOXXXXXXXXXXXXXXXXGOOXXXXXXXXXXXXXXXXXGOOOOXXXXXXXXXXXXXXXGOOOOOOXXXXXXXXXXXXXGOOOOXXXXXXXXXXXXXXXGOOOOXXXXXXXXXXXXXXXGOAXXXXXXXXXXXXXXXXXGOOOOXXXXXXXXXXXXXXXGOOXXXXXXXXXXXXXXXXXGOOOOOXXXXXXXXXXXXXX,0,0,0
8169,61,0,61,80,359,0,0,363,230,133,GOOXXXXXXXXXXXXXXXXXGOOOOOXXXXXXXXXXXXXXGOOOOOXXXXXXXXXXXXXXGOOOXXXXXXXXXXXXXXXXGOOXXXXXXXXXXXXXXXXXGOOOOXXXXXXXXXXXXXXXGOOOOOOXXXXXXXXXXXXXGOOOOXXXXXXXXXXXXXXXGOOOOXXXXXXXXXXXXXXXGOOXXXXXXXXXXXXXXXXXGOOOOXXXXXXXXXXXXXXXGOOXXXXXXXXXXXXXXXXXGOOOOOXXXXXXXXXXXXXX,0,0,0

8190,61,0,61,83,356,0,0,359,231,128,GOOXXXXXXXXXXXXXXXXXGOOOOOXXXXXXXXXXXXXXGOOOOOXXXXXXXXXXXXXXGOOOXXXXXXXXXXXXXXXXGOOXXXXXXXXXXXXXXXXXGOOOOXXXXXXXXXXXXXXXGOOOOOOXXXXXXXXXXXXXGOOOOXXXXXXXXXXXXXXXGOOOOXXXXXXXXXXXXXXXGOOXXXXXXXXXXXXXXXXXGOOOOXXXXXXXXXXXXXXXGOOXXXXXXXXXXXXXXXXXGOOOOOXXXXXXXXXXXXXX,0,0,0
8211,61,0,61,84,355,0,0,359,230,129,GOOXXXXXXXXXXXXXXXXXGOOOOOXXXXXXXXXXXXXXGOOOOOXXXXXXXXXXXXXXGOOOXXXXXXXXXXXXXXXXGOOXXXXXXXXXXXXXXXXXGOOOOXXXXXXXXXXXXXXXGOOOOOOXXXXXXXXXXXXXGOOOOXXXXXXXXXXXXXXXGOOOOXXXXXXXXXXXXXXXGOOXXXXXXXXXXXXXXXXXGOOOOXXXXXXXXXXXXXXXGOOXXXXXXXXXXXXXXXXXGOOOOOXXXXXXXXXXXXXX,0,0,0
8232,61,0,61,81,358,0,0,362,229,133,GOOXXXXXXXXXXXXXXXXXGOOOOOXXXXXXXXXXXXXXGOOOOOXXXXXXXXXXXXXXGOOOXXXXXXXXXXXXXXXXGOOXXXXXXXXXXXXXXXXXGOOOOXXXXXXXXXXXXXXXGOOOOOOXXXXXXXXXXXXXGOOOOXXXXXXXXXXXXXXXGOOOOXXXXXXXXXXXXXXXGOOXXXXXXXXXXXXXXXXXGOOOOXXXXXXXXXXXXXXXGOOXXXXXXXXXXXXXXXXXGOOOOOXXXXXXXXXXXXXX,0,0,0
8253,61,0,61,70,369,0,0,373,236,137,GOOXXXXXXXXXXXXXXXXXGOOOOOXXXXXXXXXXXXXXGOOOOOXXXXXXXXXXXXXXGOOOXXXXXXXXXXXXXXXXGOOXXXXXXXXXXXXXXXXXGOOOOXXXXXXXXXXXXXXXGOOOOOOXXXXXXXXXXXXXGOOOOXXXXXXXXXXXXXXXGOOOOXXXXXXXXXXXXXXXGOOXXXXXXXXXXXXXXXXXGOOOOXXXXXXXXXXXXXXXGOOXXXXXXXXXXXXXXXXXGOOOOOXXXXXXXXXXXXXX,0,0,0
8274,61,0,61,69,370,0,0,374,238,136,GOOXXXXXXXXXXXXXXXXXGOOOOOXXXXXXXXXXXXXXGOOOOOXXXXXXXXXXXXXXGOOOXXXXXXXXXXXXXXXXGOOXXXXXXXXXXXXXXXXXGOOOOXXXXXXXXXXXXXXXGOOOOOOXXXXXXXXXXXXXGOOOOXXXXXXXXXXXXXXXGOOOOXXXXXXXXXXXXXXXGOOXXXXXXXXXXXXXXXXXGOOOOXXXXXXXXXXXXXXXGOOXXXXXXXXXXXXXXXXXGOOOOOXXXXXXXXXXXXXX,0,0,0

8295,61,0,61,74,365,0,0,368,234,134,GOOXXXXXXXXXXXXXXXXXGOOOOOXXXXXXXXXXXXXXGOOOOOXXXXXXXXXXXXXXGOOOXXXXXXXXXXXXXXXXGOOXXXXXXXXXXXXXXXXXGOOOOXXXXXXXXXXXXXXXGOOOOOOXXXXXXXXXXXXXGOOOOXXXXXXXXXXXXXXXGOOOOXXXXXXXXXXXXXXXGOOXXXXXXXXXXXXXXXXXGOOOOXXXXXXXXXXXXXXXGOOXXXXXXXXXXXXXXXXXGOOOOOXXXXXXXXXXXXXX,0,0,0
8316,61,0,61,75,364,0,0,368,235,133,GOOXXXXXXXXXXXXXXXXXGOOOOOXXXXXXXXXXXXXXGOOOOOXXXXXXXXXXXXXXGOOOXXXXXXXXXXXXXXXXGOOXXXXXXXXXXXXXXXXXGOOOOXXXXXXXXXXXXXXXGOOOOOOXXXXXXXXXXXXXGOOOOXXXXXXXXXXXXXXXGOOOOXXXXXXXXXXXXXXXGOOXXXXXXXXXXXXXXXXXGOOOOXXXXXXXXXXXXXXXGOOXXXXXXXXXXXXXXXXXGOOOOOXXXXXXXXXXXXXX,0,0,0
8337,61,0,61,75,364,0,0,368,235,133,GOOXXXXXXXXXXXXXXXXXGOOOOOXXXXXXXXXXXXXXGOOOOOXXXXXXXXXXXXXXGOOOXXXXXXXXXXXXXXXXGOOXXXXXXXXXXXXXXXXXGOOOOXXXXXXXXXXXXXXXGOOOOOOXXXXXXXXXXXXXGOOOOXXXXXXXXXXXXXXXGOOOOXXXXXXXXXXXXXXXGOOXXXXXXXXXXXXXXXXXGOOOOXXXXXXXXXXXXXXXGOOXXXXXXXXXXXXXXXXXGOOOOOXXXXXXXXXXXXXX,0,0,0
8358,61,0,61,74,365,0,0,368,234,134,GOOXXXXXXXXXXXXXXXXXGOOOOOXXXXXXXXXXXXXXGOOOOOXXXXXXXXXXXXXXGOOOXXXXXXXXXXXXXXXXGOOXXXXXXXXXXXXXXXXXGOOOOXXXXXXXXXXXXXXXGOOOOOOXXXXXXXXXXXXXGOOOOXXXXXXXXXXXXXXXGOOOOXXXXXXXXXXXXXXXGOOXXXXXXXXXXXXXXXXXGOOOOXXXXXXXXXXXXXXXGOOXXXXXXXXXXXXXXXXXGOOOOOXXXXXXXXXXXXXX,0,0,0
8379,61,0,61,74,365,0,0,369,231,138,GOOXXXXXXXXXXXXXXXXXGOOOOOXXXXXXXXXXXXXXGOOOOOXXXXXXXXXXXXXXGOOOXXXXXXXXXXXXXXXXGOOXXXXXXXXXXXXXXXXXGOOOOXXXXXXXXXXXXXXXGOOOOOOXXXXXXXXXXXXXGOOOOXXXXXXXXXXXXXXXGOOOOXXXXXXXXXXXXXXXGOOXXXXXXXXXXXXXXXXXGOOOOXXXXXXXXXXXXXXXGOOXXXXXXXXXXXXXXXXXGOOOOOXXXXXXXXXXXXXX,0,0,0

8400,61,0,61,74,365,0,0,368,234,134,GOOXXXXXXXXXXXXXXXXXGOOOOOXXXXXXXXXXXXXXGOOOOOXXXXXXXXXXXXXXGOOOXXXXXXXXXXXXXXXXGOOXXXXXXXXXXXXXXXXXGOOOOXXXXXXXXXXXXXXXGOOOOOOXXXXXXXXXXXXXGOOOOXXXXXXXXXXXXXXXGOOOOXXXXXXXXXXXXXXXGOOXXXXXXXXXXXXXXXXXGOOOOXXXXXXXXXXXXXXXGOOXXXXXXXXXXXXXXXXXGOOOOOXXXXXXXXXXXXXX,0,0,0
8421,61,0,61,75,364,0,0,367,233,134,GOOXXXXXXXXXXXXXXXXXGOOOOOXXXXXXXXXXXXXXGOOOOOXXXXXXXXXXXXXXGOOOXXXXXXXXXXXXXXXXGOOXXXXXXXXXXXXXXXXXGOOOOXXXXXXXXXXXXXXXGOOOOOOXXXXXXXXXXXXXGOOOOXXXXXXXXXXXXXXXGOOOOXXXXXXXXXXXXXXXGOOXXXXXXXXXXXXXXXXXGOOOOXXXXXXXXXXXXXXXGOOXXXXXXXXXXXXXXXXXGOOOOOXXXXXXXXXXXXXX,0,0,0
8442,61,0,61,72,367,0,0,370,230,140,GOOXXXXXXXXXXXXXXXXXGOOOOOXXXXXXXXXXXXXXGOOOOOXXXXXXXXXXXXXXGOOOXXXXXXXXXXXXXXXXGOOXXXXXXXXXXXXXXXXXGOOOOXXXXXXXXXXXXXXXGOOOOOOXXXXXXXXXXXXXGOOOOXXXXXXXXXXXXXXXGOOOOXXXXXXXXXXXXXXXGOOXXXXXXXXXXXXXXXXXGOOOOXXXXXXXXXXXXXXXGOOXXXXXXXXXXXXXXXXXGOOOOOXXXXXXXXXXXXXX,0,0,0
8463,61,0,61,62,377,0,0,379,234,145,GOOXXXXXXXXXXXXXXXXXGOOOOOXXXXXXXXXXXXXXGOOOOOXXXXXXXXXXXXXXGOOOXXXXXXXXXXXXXXXXGOOXXXXXXXXXXXXXXXXXGOOOOXXXXXXXXXXXXXXXGOOOOOOXXXXXXXXXXXXXGOOOOXXXXXXXXXXXXXXXGOOOOXXXXXXXXXXXXXXXGOOXXXXXXXXXXXXXXXXXGOOOOXXXXXXXXXXXXXXXGOOXXXXXXXXXXXXXXXXXGOOOOOXXXXXXXXXXXXXX,0,0,0
8484,61,0,61,61,378,0,0,382,234,148,GOOXXXXXXXXXXXXXXXXXGOOOOOXXXXXXXXXXXXXXGOOOOOXXXXXXXXXXXXXXGOOOXXXXXXXXXXXXXXXXGOOXXXXXXXXXXXXXXXXXGOOOOXXXXXXXXXXXXXXXGOOOOOOXXXXXXXXXXXXXGOOOOXXXXXXXXXXXXXXXGOOOOXXXXXXXXXXXXXXXGOOXXXXXXXXXXXXXXXXXGOOOOXXXXXXXXXXXXXXXGOOXXXXXXXXXXXXXXXXXGOOOOOXXXXXXXXXXXXXX,0,0,0

8505,61,0,61,63,376,0,0,381,236,145,GOOXXXXXXXXXXXXXXXXXGOOOOOXXXXXXXXXXXXXXGOOOOOXXXXXXXXXXXXXXGOOOXXXXXXXXXXXXXXXXGOOXXXXXXXXXXXXXXXXXGOOOOXXXXXXXXXXXXXXXGOOOOOOXXXXXXXXXXXXXGOOOOXXXXXXXXXXXXXXXGOOOOXXXXXXXXXXXXXXXGOOXXXXXXXXXXXXXXXXXGOOOOXXXXXXXXXXXXXXXGOOXXXXXXXXXXXXXXXXXGOOOOOXXXXXXXXXXXXXX,0,0,0
8526,61,0,61,68,371,0,0,376,238,138,GOOXXXXXXXXXXXXXXXXXGOOOOOXXXXXXXXXXXXXXGOOOOOXXXXXXXXXXXXXXGOOOXXXXXXXXXXXXXXXXGOOXXXXXXXXXXXXXXXXXGOOOOXXXXXXXXXXXXXXXGOOOOOOXXXXXXXXXXXXXGOOOOXXXXXXXXXXXXXXXGOOOOXXXXXXXXXXXXXXXGOOXXXXXXXXXXXXXXXXXGOOOOXXXXXXXXXXXXXXXGOOXXXXXXXXXXXXXXXXXGOOOOOXXXXXXXXXXXXXX,0,0,0
8547,61,0,61,73,366,0,0,371,241,130,GOOXXXXXXXXXXXXXXXXXGOOOOOXXXXXXXXXXXXXXGOOOOOXXXXXXXXXXXXXXGOOOXXXXXXXXXXXXXXXXGOOXXXXXXXXXXXXXXXXXGOOOOXXXXXXXXXXXXXXXGOOOOOOXXXXXXXXXXXXXGOOOOXXXXXXXXXXXXXXXGOOOOXXXXXXXXXXXXXXXGOOXXXXXXXXXXXXXXXXXGOOOOXXXXXXXXXXXXXXXGOOXXXXXXXXXXXXXXXXXGOOOOOXXXXXXXXXXXXXX,0,0,0
8568,61,0,61,76,363,0,0,368,239,129,GOOXXXXXXXXXXXXXXXXXGOOOOOXXXXXXXXXXXXXXGOOOOOXXXXXXXXXXXXXXGOOOXXXXXXXXXXXXXXXXGOOXXXXXXXXXXXXXXXXXGOOOOXXXXXXXXXXXXXXXGOOOOOOXXXXXXXXXXXXXGOOOOXXXXXXXXXXXXXXXGOOOOXXXXXXXXXXXXXXXGOOXXXXXXXXXXXXXXXXXGOOOOXXXXXXXXXXXXXXXGOOXXXXXXXXXXXXXXXXXGOOOOOXXXXXXXXXXXXXX,0,0,0
8589,61,0,61,79,360,0,0,365,241,124,GOOXXXXXXXXXXXXXXXXXGOOOOOXXXXXXXXXXXXXXGOOOOOXXXXXXXXXXXXXXGOOOXXXXXXXXXXXXXXXXGOOXXXXXXXXXXXXXXXXXGOOOOXXXXXXXXXXXXXXXGOOOOOOXXXXXXXXXXXXXGOOOOXXXXXXXXXXXXXXXGOOOOXXXXXXXXXXXXXXXGOOXXXXXXXXXXXXXXXXXGOOOOXXXXXXXXXXXXXXXGOOXXXXXXXXXXXXXXXXXGOOOOOXXXXXXXXXXXXXX,0,0,0

8610,61,0,61,81,358,0,0,363,237,126,GOOXXXXXXXXXXXXXXXXXGOOOOOXXXXXXXXXXXXXXGOOOOOXXXXXXXXXXXXXXGOOOXXXXXXXXXXXXXXXXGOOXXXXXXXXXXXXXXXXXGOOOOXXXXXXXXXXXXXXXGOOOOOOXXXXXXXXXXXXXGOOOOXXXXXXXXXXXXXXXGOOOOXXXXXXXXXXXXXXXGOOXXXXXXXXXXXXXXXXXGOOOOXXXXXXXXXXXXXXXGOOXXXXXXXXXXXXXXXXXGOOOOOXXXXXXXXXXXXXX,0,0,0
8631,61,0,61,86,353,0,0,358,235,123,GOOXXXXXXXXXXXXXXXXXGOOOOOXXXXXXXXXXXXXXGOOOOOXXXXXXXXXXXXXXGOOOXXXXXXXXXXXXXXXXGOOXXXXXXXXXXXXXXXXXGOOOOXXXXXXXXXXXXXXXGOOOOOOXXXXXXXXXXXXXGOOOOXXXXXXXXXXXXXXXGOOOOXXXXXXXXXXXXXXXGOOXXXXXXXXXXXXXXXXXGOOOOXXXXXXXXXXXXXXXGOOXXXXXXXXXXXXXXXXXGOOOOOXXXXXXXXXXXXXX,0,0,0
8652,61,0,61,80,359,0,0,362,238,124,GOOXXXXXXXXXXXXXXXXXGOOOOOXXXXXXXXXXXXXXGOOOOOXXXXXXXXXXXXXXGOOOXXXXXXXXXXXXXXXXGOOXXXXXXXXXXXXXXXXXGOOOOXXXXXXXXXXXXXXXGOOOOOOXXXXXXXXXXXXXGOOOOXXXXXXXXXXXXXXXGOOOOXXXXXXXXXXXXXXXGOOXXXXXXXXXXXXXXXXXGOOOOXXXXXXXXXXXXXXXGOOXXXXXXXXXXXXXXXXXGOOOOOXXXXXXXXXXXXXX,0,0,0
8673,61,0,61,81,358,0,0,361,237,124,GOOXXXXXXXXXXXXXXXXXGOOOOOXXXXXXXXXXXXXXGOOOOOXXXXXXXXXXXXXXGOOOXXXXXXXXXXXXXXXXGOOXXXXXXXXXXXXXXXXXGOOOOXXXXXXXXXXXXXXXGOOOOOOXXXXXXXXXXXXXGOOOOXXXXXXXXXXXXXXXGOOOOXXXXXXXXXXXXXXXGOOXXXXXXXXXXXXXXXXXGOOOOXXXXXXXXXXXXXXXGOOXXXXXXXXXXXXXXXXXGOOOOOXXXXXXXXXXXXXX,0,0,0
8694,61,0,61,77,362,0,0,366,238,128,GOOXXXXXXXXXXXXXXXXXGOOOOOXXXXXXXXXXXXXXGOOOOOXXXXXXXXXXXXXXGOOOXXXXXXXXXXXXXXXXGOOXXXXXXXXXXXXXXXXXGOOOOXXXXXXXXXXXXXXXGOOOOOOXXXXXXXXXXXXXGOOOOXXXXXXXXXXXXXXXGOOOOXXXXXXXXXXXXXXXGOOXXXXXXXXXXXXXXXXXGOOOOXXXXXXXXXXXXXXXGOOXXXXXXXXXXXXXXXXXGOOOOOXXXXXXXXXXXXXX,0,0,0

8715,61,0,61,71,368,0,0,372,240,132,GOOXXXXXXXXXXXXXXXXXGOOOOOXXXXXXXXXXXXXXGOOOOOXXXXXXXXXXXXXXGOOOXXXXXXXXXXXXXXXXGOOXXXXXXXXXXXXXXXXXGOOOOXXXXXXXXXXXXXXXGOOOOOOXXXXXXXXXXXXXGOOOOXXXXXXXXXXXXXXXGOOOOXXXXXXXXXXXXXXXGOOXXXXXXXXXXXXXXXXXGOOOOXXXXXXXXXXXXXXXGOOXXXXXXXXXXXXXXXXXGOOOOOXXXXXXXXXXXXXX,0,0,0
8736,61,0,61,75,364,0,0,368,241,127,GOOXXXXXXXXXXXXXXXXXGOOOOOXXXXXXXXXXXXXXGOOOOOXXXXXXXXXXXXXXGOOOXXXXXXXXXXXXXXXXGOOXXXXXXXXXXXXXXXXXGOOOOXXXXXXXXXXXXXXXGOOOOOOXXXXXXXXXXXXXGOOOOXXXXXXXXXXXXXXXGOOOOXXXXXXXXXXXXXXXGOOXXXXXXXXXXXXXXXXXGOOOOXXXXXXXXXXXXXXXGOOXXXXXXXXXXXXXXXXXGOOOOOXXXXXXXXXXXXXX,0,0,0
8757,61,0,61,75,364,0,0,367,240,127,GOOXXXXXXXXXXXXXXXXXGOOOOOXXXXXXXXXXXXXXGOOOOOXXXXXXXXXXXXXXGOOOXXXXXXXXXXXXXXXXGOOXXXXXXXXXXXXXXXXXGOOOOXXXXXXXXXXXXXXXGOOOOOOXXXXXXXXXXXXXGOOOOXXXXXXXXXXXXXXXGOOOOXXXXXXXXXXXXXXXGOOXXXXXXXXXXXXXXXXXGOOOOXXXXXXXXXXXXXXXGOOXXXXXXXXXXXXXXXXXGOOOOOXXXXXXXXXXXXXX,0,0,0
8778,61,0,61,71,368,0,0,371,242,129,GOOXXXXXXXXXXXXXXXXXGOOOOOXXXXXXXXXXXXXXGOOOOOXXXXXXXXXXXXXXGOOOXXXXXXXXXXXXXXXXGOOXXXXXXXXXXXXXXXXXGOOOOXXXXXXXXXXXXXXXGOOOOOOXXXXXXXXXXXXXGOOOOXXXXXXXXXXXXXXXGOOOOXXXXXXXXXXXXXXXGOOXXXXXXXXXXXXXXXXXGOOOOXXXXXXXXXXXXXXXGOOXXXXXXXXXXXXXXXXXGOOOOOXXXXXXXXXXXXXX,0,0,0
8799,61,0,61,67,372,0,0,377,247,130,GOOXXXXXXXXXXXXXXXXXGOOOOOXXXXXXXXXXXXXXGOOOOOXXXXXXXXXXXXXXGOOOXXXXXXXXXXXXXXXXGOOXXXXXXXXXXXXXXXXXGOOOOXXXXXXXXXXXXXXXGOOOOOOXXXXXXXXXXXXXGOOOOXXXXXXXXXXXXXXXGOOOOXXXXXXXXXXXXXXXGOOXXXXXXXXXXXXXXXXXGOOOOXXXXXXXXXXXXXXXGOOXXXXXXXXXXXXXXXXXGOOOOOXXXXXXXXXXXXXX,0,0,0

8820,61,0,61,75,364,0,0,368,239,129,GOOXXXXXXXXXXXXXXXXXGOOOOOXXXXXXXXXXXXXXGOOOOOXXXXXXXXXXXXXXGOOOXXXXXXXXXXXXXXXXGOOXXXXXXXXXXXXXXXXXGOOOOXXXXXXXXXXXXXXXGOOOOOOXXXXXXXXXXXXXGOOOOXXXXXXXXXXXXXXXGOOOOXXXXXXXXXXXXXXXGOOXXXXXXXXXXXXXXXXXGOOOOXXXXXXXXXXXXXXXGOOXXXXXXXXXXXXXXXXXGOOOOOXXXXXXXXXXXXXX,0,0,0
8841,61,0,61,70,369,0,0,372,243,129,GOOXXXXXXXXXXXXXXXXXGOOOOOXXXXXXXXXXXXXXGOOOOOXXXXXXXXXXXXXXGOOOXXXXXXXXXXXXXXXXGOOXXXXXXXXXXXXXXXXXGOOOOXXXXXXXXXXXXXXXGOOOOOOXXXXXXXXXXXXXGOOOOXXXXXXXXXXXXXXXGOOOOXXXXXXXXXXXXXXXGOOXXXXXXXXXXXXXXXXXGOOOOXXXXXXXXXXXXXXXGOOXXXXXXXXXXXXXXXXXGOOOOOXXXXXXXXXXXXXX,0,0,0
8862,61,0,61,75,364,0,0,368,244,124,GOOXXXXXXXXXXXXXXXXXGOOOOOXXXXXXXXXXXXXXGOOOOOXXXXXXXXXXXXXXGOOOXXXXXXXXXXXXXXXXGOOXXXXXXXXXXXXXXXXXGOOOOXXXXXXXXXXXXXXXGOOOOOOXXXXXXXXXXXXXGOOOOXXXXXXXXXXXXXXXGOOOOXXXXXXXXXXXXXXXGOOXXXXXXXXXXXXXXXXXGOOOOXXXXXXXXXXXXXXXGOOXXXXXXXXXXXXXXXXXGOOOOOXXXXXXXXXXXXXX,0,0,0
8883,61,0,61,77,362,0,0,365,239,126,GOOXXXXXXXXXXXXXXXXXGOOOOOXXXXXXXXXXXXXXGOOOOOXXXXXXXXXXXXXXGOOOXXXXXXXXXXXXXXXXGOOXXXXXXXXXXXXXXXXXGOOOOXXXXXXXXXXXXXXXGOOOOOOXXXXXXXXXXXXXGOOOOXXXXXXXXXXXXXXXGOOOOXXXXXXXXXXXXXXXGOOXXXXXXXXXXXXXXXXXGOOOOXXXXXXXXXXXXXXXGOOXXXXXXXXXXXXXXXXXGOOOOOXXXXXXXXXXXXXX,0,0,0
8904,61,0,61,72,367,0,0,370,239,131,GOOXXXXXXXXXXXXXXXXXGOOOOOXXXXXXXXXXXXXXGOOOOOXXXXXXXXXXXXXXGOOOXXXXXXXXXXXXXXXXGOOXXXXXXXXXXXXXXXXXGOOOOXXXXXXXXXXXXXXXGOOOOOOXXXXXXXXXXXXXGOOOOXXXXXXXXXXXXXXXGOOOOXXXXXXXXXXXXXXXGOOXXXXXXXXXXXXXXXXXGOOOOXXXXXXXXXXXXXXXGOOXXXXXXXXXXXXXXXXXGOOOOOXXXXXXXXXXXXXX,0,0,0

8925,61,0,61,71,368,0,0,372,240,132,GOOXXXXXXXXXXXXXXXXXGOOOOOXXXXXXXXXXXXXXGOOOOOXXXXXXXXXXXXXXGOOOXXXXXXXXXXXXXXXXGOOXXXXXXXXXXXXXXXXXGOOOOXXXXXXXXXXXXXXXGOOOOOOXXXXXXXXXXXXXGOOOOXXXXXXXXXXXXXXXGOOOOXXXXXXXXXXXXXXXGOOXXXXXXXXXXXXXXXXXGOOOOXXXXXXXXXXXXXXXGOOXXXXXXXXXXXXXXXXXGOOOOOXXXXXXXXXXXXXX,0,0,0
8946,61,0,61,67,372,0,0,375,243,132,GOOXXXXXXXXXXXXXXXXXGOOOOOXXXXXXXXXXXXXXGOOOOOXXXXXXXXXXXXXXGOOOXXXXXXXXXXXXXXXXGOOXXXXXXXXXXXXXXXXXGOOOOXXXXXXXXXXXXXXXGOOOOOOXXXXXXXXXXXXXGOOOOXXXXXXXXXXXXXXXGOOOOXXXXXXXXXXXXXXXGOOXXXXXXXXXXXXXXXXXGOOOOXXXXXXXXXXXXXXXGOOXXXXXXXXXXXXXXXXXGOOOOOXXXXXXXXXXXXXX,0,0,0
8967,61,0,61,67,372,0,0,376,243,133,GOOXXXXXXXXXXXXXXXXXGOOOOOXXXXXXXXXXXXXXGOOOOOXXXXXXXXXXXXXXGOOOXXXXXXXXXXXXXXXXGOOXXXXXXXXXXXXXXXXXGOOOOXXXXXXXXXXXXXXXGOOOOOOXXXXXXXXXXXXXGOOOOXXXXXXXXXXXXXXXGOOOOXXXXXXXXXXXXXXXGOOXXXXXXXXXXXXXXXXXGOOOOXXXXXXXXXXXXXXXGOOXXXXXXXXXXXXXXXXXGOOOOOXXXXXXXXXXXXXX,0,0,0
8988,61,0,61,65,374,0,0,376,246,130,GOOXXXXXXXXXXXXXXXXXGOOOOOXXXXXXXXXXXXXXGOOOOOXXXXXXXXXXXXXXGOOOXXXXXXXXXXXXXXXXGOOXXXXXXXXXXXXXXXXXGOOOOXXXXXXXXXXXXXXXGOOOOOOXXXXXXXXXXXXXGOOOOXXXXXXXXXXXXXXXGOOOOXXXXXXXXXXXXXXXGOOXXXXXXXXXXXXXXXXXGOOOOXXXXXXXXXXXXXXXGOOXXXXXXXXXXXXXXXXXGOOOOOXXXXXXXXXXXXXX,0,0,0
9009,61,0,61,67,372,0,0,375,245,130,GOOXXXXXXXXXXXXXXXXXGOOOOOXXXXXXXXXXXXXXGOOOOOXXXXXXXXXXXXXXGOOOXXXXXXXXXXXXXXXXGOOXXXXXXXXXXXXXXXXXGOOOOXXXXXXXXXXXXXXXGOOOOOOXXXXXXXXXXXXXGOOOOXXXXXXXXXXXXXXXGOOOOXXXXXXXXXXXXXXXGOOXXXXXXXXXXXXXXXXXGOOOOXXXXXXXXXXXXXXXGOOXXXXXXXXXXXXXXXXXGOOOOOXXXXXXXXXXXXXX,0,0,0

9030,61,0,61,68,371,0,0,374,243,131,GOOXXXXXXXXXXXXXXXXXGOOOOOXXXXXXXXXXXXXXGOOOOOXXXXXXXXXXXXXXGOOOXXXXXXXXXXXXXXXXGOOXXXXXXXXXXXXXXXXXGOOOOXXXXXXXXXXXXXXXGOOOOOOXXXXXXXXXXXXXGOOOOXXXXXXXXXXXXXXXGOOOOXXXXXXXXXXXXXXXGOOXXXXXXXXXXXXXXXXXGOOOOXXXXXXXXXXXXXXXGOOXXXXXXXXXXXXXXXXXGOOOOOXXXXXXXXXXXXXX,0,0,0
9051,61,0,61,64,375,0,0,377,246,131,GOOXXXXXXXXXXXXXXXXXGOOOOOXXXXXXXXXXXXXXGOOOOOXXXXXXXXXXXXXXGOOOXXXXXXXXXXXXXXXXGOOXXXXXXXXXXXXXXXXXGOOOOXXXXXXXXXXXXXXXGOOOOOOXXXXXXXXXXXXXGOOOOXXXXXXXXXXXXXXXGOOOOXXXXXXXXXXXXXXXGOOXXXXXXXXXXXXXXXXXGOOOOXXXXXXXXXXXXXXXGOOXXXXXXXXXXXXXXXXXGOOOOOXXXXXXXXXXXXXX,0,0,0
9072,61,0,61,63,376,0,0,379,243,136,GOOXXXXXXXXXXXXXXXXXGOOOOOXXXXXXXXXXXXXXGOOOOOXXXXXXXXXXXXXXGOOOXXXXXXXXXXXXXXXXGOOXXXXXXXXXXXXXXXXXGOOOOXXXXXXXXXXXXXXXGOOOOOOXXXXXXXXXXXXXGOOOOXXXXXXXXXXXXXXXGOOOOXXXXXXXXXXXXXXXGOOXXXXXXXXXXXXXXXXXGOOOOXXXXXXXXXXXXXXXGOOXXXXXXXXXXXXXXXXXGOOOOOXXXXXXXXXXXXXX,0,0,0
9093,61,0,61,64,375,0,0,378,244,134,GOOXXXXXXXXXXXXXXXXXGOOOOOXXXXXXXXXXXXXXGOOOOOXXXXXXXXXXXXXXGOOOXXXXXXXXXXXXXXXXGOOXXXXXXXXXXXXXXXXXGOOOOXXXXXXXXXXXXXXXGOOOOOOXXXXXXXXXXXXXGOOOOXXXXXXXXXXXXXXXGOOOOXXXXXXXXXXXXXXXGOOXXXXXXXXXXXXXXXXXGOOOOXXXXXXXXXXXXXXXGOOXXXXXXXXXXXXXXXXXGOOOOOXXXXXXXXXXXXXX,0,0,0
9114,61,0,61,63,376,0,0,377,244,133,GOOXXXXXXXXXXXXXXXXXGOOOOOXXXXXXXXXXXXXXGOOOOOXXXXXXXXXXXXXXGOOOXXXXXXXXXXXXXXXXGOOXXXXXXXXXXXXXXXXXGOOOOXXXXXXXXXXXXXXXGOOOOOOXXXXXXXXXXXXXGOOOOXXXXXXXXXXXXXXXGOOOOXXXXXXXXXXXXXXXGOOXXXXXXXXXXXXXXXXXGOOOOXXXXXXXXXXXXXXXGOOXXXXXXXXXXXXXXXXXGOOOOOXXXXXXXXXXXXXX,0,0,0

9135,61,0,61,63,376,0,0,378,243,135,GOOXXXXXXXXXXXXXXXXXGOOOOOXXXXXXXXXXXXXXGOOOOOXXXXXXXXXXXXXXGOOOXXXXXXXXXXXXXXXXGOOXXXXXXXXXXXXXXXXXGOOOOXXXXXXXXXXXXXXXGOOOOOOXXXXXXXXXXXXXGOOOOXXXXXXXXXXXXXXXGOOOOXXXXXXXXXXXXXXXGOOXXXXXXXXXXXXXXXXXGOOOOXXXXXXXXXXXXXXXGOOXXXXXXXXXXXXXXXXXGOOOOOXXXXXXXXXXXXXX,0,0,0
9156,61,0,61,63,376,0,0,380,245,135,GOOXXXXXXXXXXXXXXXXXGOOOOOXXXXXXXXXXXXXXGOOOOOXXXXXXXXXXXXXXGOOOXXXXXXXXXXXXXXXXGOOXXXXXXXXXXXXXXXXXGOOOOXXXXXXXXXXXXXXXGOOOOOOXXXXXXXXXXXXXGOOOOXXXXXXXXXXXXXXXGOOOOXXXXXXXXXXXXXXXGOOXXXXXXXXXXXXXXXXXGOOOOXXXXXXXXXXXXXXXGOOXXXXXXXXXXXXXXXXXGOOOOOXXXXXXXXXXXXXX,0,0,0
9177,61,0,61,67,372,0,0,376,246,130,GOOXXXXXXXXXXXXXXXXXGOOOOOXXXXXXXXXXXXXXGOOOOOXXXXXXXXXXXXXXGOOOXXXXXXXXXXXXXXXXGOOXXXXXXXXXXXXXXXXXGOOOOXXXXXXXXXXXXXXXGOOOOOOXXXXXXXXXXXXXGOOOOXXXXXXXXXXXXXXXGOOOOXXXXXXXXXXXXXXXGOOXXXXXXXXXXXXXXXXXGOOOOXXXXXXXXXXXXXXXGOOXXXXXXXXXXXXXXXXXGOOOOOXXXXXXXXXXXXXX,0,0,0
9198,61,0,61,66,373,0,0,376,244,132,GOOXXXXXXXXXXXXXXXXXGOOOOOXXXXXXXXXXXXXXGOOOOOXXXXXXXXXXXXXXGOOOXXXXXXXXXXXXXXXXGOOXXXXXXXXXXXXXXXXXGOOOOXXXXXXXXXXXXXXXGOOOOOOXXXXXXXXXXXXXGOOOOXXXXXXXXXXXXXXXGOOOOXXXXXXXXXXXXXXXGOOXXXXXXXXXXXXXXXXXGOOOOXXXXXXXXXXXXXXXGOOXXXXXXXXXXXXXXXXXGOOOOOXXXXXXXXXXXXXX,0,0,0
9219,61,0,61,69,370,0,0,373,243,130,GOOXXXXXXXXXXXXXXXXXGOOOOOXXXXXXXXXXXXXXGOOOOOXXXXXXXXXXXXXXGOOOXXXXXXXXXXXXXXXXGOOXXXXXXXXXXXXXXXXXGOOOOXXXXXXXXXXXXXXXGOOOOOOXXXXXXXXXXXXXGOOOOXXXXXXXXXXXXXXXGOOOOXXXXXXXXXXXXXXXGOOXXXXXXXXXXXXXXXXXGOOOOXXXXXXXXXXXXXXXGOOXXXXXXXXXXXXXXXXXGOOOOOXXXXXXXXXXXXXX,0,0,0

9240,61,0,61,70,369,0,0,372,245,127,GOOXXXXXXXXXXXXXXXXXGOOOOOXXXXXXXXXXXXXXGOOOOOXXXXXXXXXXXXXXGOOOXXXXXXXXXXXXXXXXGOOXXXXXXXXXXXXXXXXXGOOOOXXXXXXXXXXXXXXXGOOOOOOXXXXXXXXXXXXXGOOOOXXXXXXXXXXXXXXXGOOOOXXXXXXXXXXXXXXXGOOXXXXXXXXXXXXXXXXXGOOOOXXXXXXXXXXXXXXXGOOXXXXXXXXXXXXXXXXXGOOOOOXXXXXXXXXXXXXX,0,0,0
9261,61,0,61,74,365,0,0,369,250,119,GOOXXXXXXXXXXXXXXXXXGOOOOOXXXXXXXXXXXXXXGOOOOOXXXXXXXXXXXXXXGOOOXXXXXXXXXXXXXXXXGOOXXXXXXXXXXXXXXXXXGOOOOXXXXXXXXXXXXXXXGOOOOOOXXXXXXXXXXXXXGOOOOXXXXXXXXXXXXXXXGOOOOXXXXXXXXXXXXXXXGOOXXXXXXXXXXXXXXXXXGOOOOXXXXXXXXXXXXXXXGOOXXXXXXXXXXXXXXXXXGOOOOOXXXXXXXXXXXXXX,0,0,0
9282,61,0,61,76,363,0,0,367,249,118,GOOXXXXXXXXXXXXXXXXXGOOOOOXXXXXXXXXXXXXXGOOOOOXXXXXXXXXXXXXXGOOOXXXXXXXXXXXXXXXXGOOXXXXXXXXXXXXXXXXXGOOOOXXXXXXXXXXXXXXXGOOOOOOXXXXXXXXXXXXXGOOOOXXXXXXXXXXXXXXXGOOOOXXXXXXXXXXXXXXXGOOXXXXXXXXXXXXXXXXXGOOOOXXXXXXXXXXXXXXXGOOXXXXXXXXXXXXXXXXXGOOOOOXXXXXXXXXXXXXX,0,0,0
9303,61,0,61,80,359,0,0,362,248,114,GOOXXXXXXXXXXXXXXXXXGOOOOOXXXXXXXXXXXXXXGOOOOOXXXXXXXXXXXXXXGOOOXXXXXXXXXXXXXXXXGOOXXXXXXXXXXXXXXXXXGOOOOXXXXXXXXXXXXXXXGOOOOOOXXXXXXXXXXXXXGOOOOXXXXXXXXXXXXXXXGOOOOXXXXXXXXXXXXXXXGOOXXXXXXXXXXXXXXXXXGOOOOXXXXXXXXXXXXXXXGOOXXXXXXXXXXXXXXXXXGOOOOOXXXXXXXXXXXXXX,0,0,0
9324,61,0,61,85,354,0,0,357,244,113,GOOXXXXXXXXXXXXXXXXXGOOOOOXXXXXXXXXXXXXXGOOOOOXXXXXXXXXXXXXXGOOOXXXXXXXXXXXXXXXXGOOXXXXXXXXXXXXXXXXXGOOOOXXXXXXXXXXXXXXXGOOOOOOXXXXXXXXXXXXXGOOOOXXXXXXXXXXXXXXXGOOOOXXXXXXXXXXXXXXXGOOXXXXXXXXXXXXXXXXXGOOOOXXXXXXXXXXXXXXXGOOXXXXXXXXXXXXXXXXXGOOOOOXXXXXXXXXXXXXX,0,0,0

9345,61,0,61,81,358,0,0,361,251,110,GOOXXXXXXXXXXXXXXXXXGOOOOOXXXXXXXXXXXXXXGOOOOOXXXXXXXXXXXXXXGOOOXXXXXXXXXXXXXXXXGOOXXXXXXXXXXXXXXXXXGOOOOXXXXXXXXXXXXXXXGOOOOOOXXXXXXXXXXXXXGOOOOXXXXXXXXXXXXXXXGOOOOXXXXXXXXXXXXXXXGOOXXXXXXXXXXXXXXXXXGOOOOXXXXXXXXXXXXXXXGOOXXXXXXXXXXXXXXXXXGOOOOOXXXXXXXXXXXXXX,0,0,0
9366,61,0,61,80,359,0,0,362,248,114,GOOXXXXXXXXXXXXXXXXXGOOOOOXXXXXXXXXXXXXXGOOOOOXXXXXXXXXXXXXXGOOOXXXXXXXXXXXXXXXXGOOXXXXXXXXXXXXXXXXXGOOOOXXXXXXXXXXXXXXXGOOOOOOXXXXXXXXXXXXXGOOOOXXXXXXXXXXXXXXXGOOOOXXXXXXXXXXXXXXXGOOXXXXXXXXXXXXXXXXXGOOOOXXXXXXXXXXXXXXXGOOXXXXXXXXXXXXXXXXXGOOOOOXXXXXXXXXXXXXX,0,0,0
9387,61,0,61,77,362,0,0,365,250,115,GOOXXXXXXXXXXXXXXXXXGOOOOOXXXXXXXXXXXXXXGOOOOOXXXXXXXXXXXXXXGOOOXXXXXXXXXXXXXXXXGOOXXXXXXXXXXXXXXXXXGOOOOXXXXXXXXXXXXXXXGOOOOOOXXXXXXXXXXXXXGOOOOXXXXXXXXXXXXXXXGOOOOXXXXXXXXXXXXXXXGOOXXXXXXXXXXXXXXXXXGOOOOXXXXXXXXXXXXXXXGOOXXXXXXXXXXXXXXXXXGOOOOOXXXXXXXXXXXXXX,0,0,0
9408,61,0,61,79,360,0,0,364,248,116,GOOXXXXXXXXXXXXXXXXXGOOOOOXXXXXXXXXXXXXXGOOOOOXXXXXXXXXXXXXXGOOOXXXXXXXXXXXXXXXXGOOXXXXXXXXXXXXXXXXXGOOOOXXXXXXXXXXXXXXXGOOOOOOXXXXXXXXXXXXXGOOOOXXXXXXXXXXXXXXXGOOOOXXXXXXXXXXXXXXXGOOXXXXXXXXXXXXXXXXXGOOOOXXXXXXXXXXXXXXXGOOXXXXXXXXXXXXXXXXXGOOOOOXXXXXXXXXXXXXX,0,0,0
9429,61,0,61,77,362,0,0,366,249,117,GOOXXXXXXXXXXXXXXXXXGOOOOOXXXXXXXXXXXXXXGOOOOOXXXXXXXXXXXXXXGOOOXXXXXXXXXXXXXXXXGOOXXXXXXXXXXXXXXXXXGOOOOXXXXXXXXXXXXXXXGOOOOOOXXXXXXXXXXXXXGOOOOXXXXXXXXXXXXXXXGOOOOXXXXXXXXXXXXXXXGOOXXXXXXXXXXXXXXXXXGOOOOXXXXXXXXXXXXXXXGOOXXXXXXXXXXXXXXXXXGOOOOOXXXXXXXXXXXXXX,0,0,0

9450,61,0,61,72,367,0,0,369,247,122,GOOXXXXXXXXXXXXXXXXXGOOOOOXXXXXXXXXXXXXXGOOOOOXXXXXXXXXXXXXXGOOOXXXXXXXXXXXXXXXXGOOXXXXXXXXXXXXXXXXXGOOOOXXXXXXXXXXXXXXXGOOOOOOXXXXXXXXXXXXXGOOOOXXXXXXXXXXXXXXXGOOOOXXXXXXXXXXXXXXXGOOXXXXXXXXXXXXXXXXXGOOOOXXXXXXXXXXXXXXXGOOXXXXXXXXXXXXXXXXXGOOOOOXXXXXXXXXXXXXX,0,0,0
9471,61,0,61,73,366,0,0,371,250,121,GOOXXXXXXXXXXXXXXXXXGOOOOOXXXXXXXXXXXXXXGOOOOOXXXXXXXXXXXXXXGOOOXXXXXXXXXXXXXXXXGOOXXXXXXXXXXXXXXXXXGOOOOXXXXXXXXXXXXXXXGOOOOOOXXXXXXXXXXXXXGOOOOXXXXXXXXXXXXXXXGOOOOXXXXXXXXXXXXXXXGOOXXXXXXXXXXXXXXXXXGOOOOXXXXXXXXXXXXXXXGOOXXXXXXXXXXXXXXXXXGOOOOOXXXXXXXXXXXXXX,0,0,0
9492,61,0,61,72,367,0,0,372,249,123,GOOXXXXXXXXXXXXXXXXXGOOOOOXXXXXXXXXXXXXXGOOOOOXXXXXXXXXXXXXXGOOOXXXXXXXXXXXXXXXXGOOXXXXXXXXXXXXXXXXXGOOOOXXXXXXXXXXXXXXXGOOOOOOXXXXXXXXXXXXXGOOOOXXXXXXXXXXXXXXXGOOOOXXXXXXXXXXXXXXXGOOXXXXXXXXXXXXXXXXXGOOOOXXXXXXXXXXXXXXXGOOXXXXXXXXXXXXXXXXXGOOOOOXXXXXXXXXXXXXX,0,0,0
9513,61,0,61,69,370,0,0,375,252,123,GOOXXXXXXXXXXXXXXXXXGOOOOOXXXXXXXXXXXXXXGOOOOOXXXXXXXXXXXXXXGOOOXXXXXXXXXXXXXXXXGOOXXXXXXXXXXXXXXXXXGOOOOXXXXXXXXXXXXXXXGOOOOOOXXXXXXXXXXXXXGOOOOXXXXXXXXXXXXXXXGOOOOXXXXXXXXXXXXXXXGOOXXXXXXXXXXXXXXXXXGOOOOXXXXXXXXXXXXXXXGOOXXXXXXXXXXXXXXXXXGOOOOOXXXXXXXXXXXXXX,0,0,0
9534,61,0,61,69,370,0,0,374,250,124,GOOXXXXXXXXXXXXXXXXXGOOOOOXXXXXXXXXXXXXXGOOOOOXXXXXXXXXXXXXXGOOOXXXXXXXXXXXXXXXXGOOXXXXXXXXXXXXXXXXXGOOOOXXXXXXXXXXXXXXXGOOOOOOXXXXXXXXXXXXXGOOOOXXXXXXXXXXXXXXXGOOOOXXXXXXXXXXXXXXXGOOXXXXXXXXXXXXXXXXXGOOOOXXXXXXXXXXXXXXXGOOXXXXXXXXXXXXXXXXXGOOOOOXXXXXXXXXXXXXX,0,0,0

9555,61,0,61,71,368,0,0,373,252,121,GOOXXXXXXXXXXXXXXXXXGOOOOOXXXXXXXXXXXXXXGOOOOOXXXXXXXXXXXXXXGOOOXXXXXXXXXXXXXXXXGOOXXXXXXXXXXXXXXXXXGOOOOXXXXXXXXXXXXXXXGOOOOOOXXXXXXXXXXXXXGOOOOXXXXXXXXXXXXXXXGOOOOXXXXXXXXXXXXXXXGOOXXXXXXXXXXXXXXXXXGOOOOXXXXXXXXXXXXXXXGOOXXXXXXXXXXXXXXXXXGOOOOOXXXXXXXXXXXXXX,0,0,0
9576,61,0,61,68,371,0,0,374,251,123,GOOXXXXXXXXXXXXXXXXXGOOOOOXXXXXXXXXXXXXXGOOOOOXXXXXXXXXXXXXXGOOOXXXXXXXXXXXXXXXXGOOXXXXXXXXXXXXXXXXXGOOOOXXXXXXXXXXXXXXXGOOOOOOXXXXXXXXXXXXXGOOOOXXXXXXXXXXXXXXXGOOOOXXXXXXXXXXXXXXXGOOXXXXXXXXXXXXXXXXXGOOOOXXXXXXXXXXXXXXXGOOXXXXXXXXXXXXXXXXXGOOOOOXXXXXXXXXXXXXX,0,0,0
9597,61,0,61,65,374,0,0,378,253,125,GOOXXXXXXXXXXXXXXXXXGOOOOOXXXXXXXXXXXXXXGOOOOOXXXXXXXXXXXXXXGOOOXXXXXXXXXXXXXXXXGOOXXXXXXXXXXXXXXXXXGOOOOXXXXXXXXXXXXXXXGOOOOOOXXXXXXXXXXXXXGOOOOXXXXXXXXXXXXXXXGOOOOXXXXXXXXXXXXXXXGOOXXXXXXXXXXXXXXXXXGOOOOXXXXXXXXXXXXXXXGOOXXXXXXXXXXXXXXXXXGOOOOOXXXXXXXXXXXXXX,0,0,0
9618,62,1,61,62,376,0,0,381,254,127,GOOXXXXXXXXXXXXXXXXXGOOOOOXXXXXXXXXXXXXXGOOOOOAXXXXXXXXXXXXXGOOOXXXXXXXXXXXXXXXXGOOXXXXXXXXXXXXXXXXXGOOOOXXXXXXXXXXXXXXXGOOOOOOXXXXXXXXXXXXXGOOOOXXXXXXXXXXXXXXXGOOOOXXXXXXXXXXXXXXXGOOXXXXXXXXXXXXXXXXXGOOOOXXXXXXXXXXXXXXXGOOXXXXXXXXXXXXXXXXXGOOOOOXXXXXXXXXXXXXX,0,0,0
9639,62,1,61,63,375,0,0,379,254,125,GOOXXXXXXXXXXXXXXXXXGOOOOOXXXXXXXXXXXXXXGOOOOOAXXXXXXXXXXXXXGOOOXXXXXXXXXXXXXXXXGOOXXXXXXXXXXXXXXXXXGOOOOXXXXXXXXXXXXXXXGOOOOOOXXXXXXXXXXXXXGOOOOXXXXXXXXXXXXXXXGOOOOXXXXXXXXXXXXXXXGOOXXXXXXXXXXXXXXXXXGOOOOXXXXXXXXXXXXXXXGOOXXXXXXXXXXXXXXXXXGOOOOOXXXXXXXXXXXXXX,0,0,0

9660,62,1,61,65,373,0,0,376,255,121,GOOXXXXXXXXXXXXXXXXXGOOOOOXXXXXXXXXXXXXXGOOOOOAXXXXXXXXXXXXXGOOOXXXXXXXXXXXXXXXXGOOXXXXXXXXXXXXXXXXXGOOOOXXXXXXXXXXXXXXXGOOOOOOXXXXXXXXXXXXXGOOOOXXXXXXXXXXXXXXXGOOOOXXXXXXXXXXXXXXXGOOXXXXXXXXXXXXXXXXXGOOOOXXXXXXXXXXXXXXXGOOXXXXXXXXXXXXXXXXXGOOOOOXXXXXXXXXXXXXX,0,0,0
9681,62,0,62,64,374,0,0,377,253,124,GOOXXXXXXXXXXXXXXXXXGOOOOOXXXXXXXXXXXXXXGOOOOOOXXXXXXXXXXXXXGOOOXXXXXXXXXXXXXXXXGOOXXXXXXXXXXXXXXXXXGOOOOXXXXXXXXXXXXXXXGOOOOOOXXXXXXXXXXXXXGOOOOXXXXXXXXXXXXXXXGOOOOXXXXXXXXXXXXXXXGOOXXXXXXXXXXXXXXXXXGOOOOXXXXXXXXXXXXXXXGOOXXXXXXXXXXXXXXXXXGOOOOOXXXXXXXXXXXXXX,0,0,0
9702,62,0,62,66,372,0,0,374,254,120,GOOXXXXXXXXXXXXXXXXXGOOOOOXXXXXXXXXXXXXXGOOOOOOXXXXXXXXXXXXXGOOOXXXXXXXXXXXXXXXXGOOXXXXXXXXXXXXXXXXXGOOOOXXXXXXXXXXXXXXXGOOOOOOXXXXXXXXXXXXXGOOOOXXXXXXXXXXXXXXXGOOOOXXXXXXXXXXXXXXXGOOXXXXXXXXXXXXXXXXXGOOOOXXXXXXXXXXXXXXXGOOXXXXXXXXXXXXXXXXXGOOOOOXXXXXXXXXXXXXX,0,0,0
9723,62,0,62,67,371,0,0,374,253,121,GOOXXXXXXXXXXXXXXXXXGOOOOOXXXXXXXXXXXXXXGOOOOOOXXXXXXXXXXXXXGOOOXXXXXXXXXXXXXXXXGOOXXXXXXXXXXXXXXXXXGOOOOXXXXXXXXXXXXXXXGOOOOOOXXXXXXXXXXXXXGOOOOXXXXXXXXXXXXXXXGOOOOXXXXXXXXXXXXXXXGOOXXXXXXXXXXXXXXXXXGOOOOXXXXXXXXXXXXXXXGOOXXXXXXXXXXXXXXXXXGOOOOOXXXXXXXXXXXXXX,0,0,0
9744,62,0,62,69,369,0,0,372,251,121,GOOXXXXXXXXXXXXXXXXXGOOOOOXXXXXXXXXXXXXXGOOOOOOXXXXXXXXXXXXXGOOOXXXXXXXXXXXXXXXXGOOXXXXXXXXXXXXXXXXXGOOOOXXXXXXXXXXXXXXXGOOOOOOXXXXXXXXXXXXXGOOOOXXXXXXXXXXXXXXXGOOOOXXXXXXXXXXXXXXXGOOXXXXXXXXXXXXXXXXXGOOOOXXXXXXXXXXXXXXXGOOXXXXXXXXXXXXXXXXXGOOOOOXXXXXXXXXXXXXX,0,0,0

9765,62,0,62,70,368,0,0,369,253,116,GOOXXXXXXXXXXXXXXXXXGOOOOOXXXXXXXXXXXXXXGOOOOOOXXXXXXXXXXXXXGOOOXXXXXXXXXXXXXXXXGOOXXXXXXXXXXXXXXXXXGOOOOXXXXXXXXXXXXXXXGOOOOOOXXXXXXXXXXXXXGOOOOXXXXXXXXXXXXXXXGOOOOXXXXXXXXXXXXXXXGOOXXXXXXXXXXXXXXXXXGOOOOXXXXXXXXXXXXXXXGOOXXXXXXXXXXXXXXXXXGOOOOOXXXXXXXXXXXXXX,0,0,0
9786,62,0,62,74,364,0,0,367,250,117,GOOXXXXXXXXXXXXXXXXXGOOOOOXXXXXXXXXXXXXXGOOOOOOXXXXXXXXXXXXXGOOOXXXXXXXXXXXXXXXXGOOXXXXXXXXXXXXXXXXXGOOOOXXXXXXXXXXXXXXXGOOOOOOXXXXXXXXXXXXXGOOOOXXXXXXXXXXXXXXXGOOOOXXXXXXXXXXXXXXXGOOXXXXXXXXXXXXXXXXXGOOOOXXXXXXXXXXXXXXXGOOXXXXXXXXXXXXXXXXXGOOOOOXXXXXXXXXXXXXX,0,0,0
9807,62,0,62,71,367,0,0,370,251,119,GOOXXXXXXXXXXXXXXXXXGOOOOOXXXXXXXXXXXXXXGOOOOOOXXXXXXXXXXXXXGOOOXXXXXXXXXXXXXXXXGOOXXXXXXXXXXXXXXXXXGOOOOXXXXXXXXXXXXXXXGOOOOOOXXXXXXXXXXXXXGOOOOXXXXXXXXXXXXXXXGOOOOXXXXXXXXXXXXXXXGOOXXXXXXXXXXXXXXXXXGOOOOXXXXXXXXXXXXXXXGOOXXXXXXXXXXXXXXXXXGOOOOOXXXXXXXXXXXXXX,0,0,0
9828,62,0,62,66,372,0,0,375,251,124,GOOXXXXXXXXXXXXXXXXXGOOOOOXXXXXXXXXXXXXXGOOOOOOXXXXXXXXXXXXXGOOOXXXXXXXXXXXXXXXXGOOXXXXXXXXXXXXXXXXXGOOOOXXXXXXXXXXXXXXXGOOOOOOXXXXXXXXXXXXXGOOOOXXXXXXXXXXXXXXXGOOOOXXXXXXXXXXXXXXXGOOXXXXXXXXXXXXXXXXXGOOOOXXXXXXXXXXXXXXXGOOXXXXXXXXXXXXXXXXXGOOOOOXXXXXXXXXXXXXX,0,0,0
9849,63,0,63,59,378,0,0,380,258,122,GOOXXXXXXXXXXXXXXXXXGOOOOOXXXXXXXXXXXXXXGOOOOOOXXXXXXXXXXXXXGOOOXXXXXXXXXXXXXXXXGOOXXXXXXXXXXXXXXXXXGOOOOXXXXXXXXXXXXXXXGOOOOOOXXXXXXXXXXXXXGOOOOXXXXXXXXXXXXXXXGOOOOXXXXXXXXXXXXXXXGOOXXXXXXXXXXXXXXXXXGOOOOXXXXXXXXXXXXXXXGOOXXXXXXXXXXXXXXXXXGOOOOOOXXXXXXXXXXXXX,0,0,0

9870,63,0,63,60,377,0,0,381,257,124,GOOXXXXXXXXXXXXXXXXXGOOOOOXXXXXXXXXXXXXXGOOOOOOXXXXXXXXXXXXXGOOOXXXXXXXXXXXXXXXXGOOXXXXXXXXXXXXXXXXXGOOOOXXXXXXXXXXXXXXXGOOOOOOXXXXXXXXXXXXXGOOOOXXXXXXXXXXXXXXXGOOOOXXXXXXXXXXXXXXXGOOXXXXXXXXXXXXXXXXXGOOOOXXXXXXXXXXXXXXXGOOXXXXXXXXXXXXXXXXXGOOOOOOXXXXXXXXXXXXX,0,0,0
9891,63,0,63,64,373,0,0,378,254,124,GOOXXXXXXXXXXXXXXXXXGOOOOOXXXXXXXXXXXXXXGOOOOOOXXXXXXXXXXXXXGOOOXXXXXXXXXXXXXXXXGOOXXXXXXXXXXXXXXXXXGOOOOXXXXXXXXXXXXXXXGOOOOOOXXXXXXXXXXXXXGOOOOXXXXXXXXXXXXXXXGOOOOXXXXXXXXXXXXXXXGOOXXXXXXXXXXXXXXXXXGOOOOXXXXXXXXXXXXXXXGOOXXXXXXXXXXXXXXXXXGOOOOOOXXXXXXXXXXXXX,0,0,0
9912,63,0,63,68,369,0,0,374,257,117,GOOXXXXXXXXXXXXXXXXXGOOOOOXXXXXXXXXXXXXXGOOOOOOXXXXXXXXXXXXXGOOOXXXXXXXXXXXXXXXXGOOXXXXXXXXXXXXXXXXXGOOOOXXXXXXXXXXXXXXXGOOOOOOXXXXXXXXXXXXXGOOOOXXXXXXXXXXXXXXXGOOOOXXXXXXXXXXXXXXXGOOXXXXXXXXXXXXXXXXXGOOOOXXXXXXXXXXXXXXXGOOXXXXXXXXXXXXXXXXXGOOOOOOXXXXXXXXXXXXX,0,0,0
9933,63,0,63,64,373,0,0,378,261,117,GOOXXXXXXXXXXXXXXXXXGOOOOOXXXXXXXXXXXXXXGOOOOOOXXXXXXXXXXXXXGOOOXXXXXXXXXXXXXXXXGOOXXXXXXXXXXXXXXXXXGOOOOXXXXXXXXXXXXXXXGOOOOOOXXXXXXXXXXXXXGOOOOXXXXXXXXXXXXXXXGOOOOXXXXXXXXXXXXXXXGOOXXXXXXXXXXXXXXXXXGOOOOXXXXXXXXXXXXXXXGOOXXXXXXXXXXXXXXXXXGOOOOOOXXXXXXXXXXXXX,0,0,0
9954,63,0,63,67,370,0,0,375,258,117,GOOXXXXXXXXXXXXXXXXXGOOOOOXXXXXXXXXXXXXXGOOOOOOXXXXXXXXXXXXXGOOOXXXXXXXXXXXXXXXXGOOXXXXXXXXXXXXXXXXXGOOOOXXXXXXXXXXXXXXXGOOOOOOXXXXXXXXXXXXXGOOOOXXXXXXXXXXXXXXXGOOOOXXXXXXXXXXXXXXXGOOXXXXXXXXXXXXXXXXXGOOOOXXXXXXXXXXXXXXXGOOXXXXXXXXXXXXXXXXXGOOOOOOXXXXXXXXXXXXX,0,0,0

9975,63,0,63,65,372,0,0,378,257,121,GOOXXXXXXXXXXXXXXXXXGOOOOOXXXXXXXXXXXXXXGOOOOOOXXXXXXXXXXXXXGOOOXXXXXXXXXXXXXXXXGOOXXXXXXXXXXXXXXXXXGOOOOXXXXXXXXXXXXXXXGOOOOOOXXXXXXXXXXXXXGOOOOXXXXXXXXXXXXXXXGOOOOXXXXXXXXXXXXXXXGOOXXXXXXXXXXXXXXXXXGOOOOXXXXXXXXXXXXXXXGOOXXXXXXXXXXXXXXXXXGOOOOOOXXXXXXXXXXXXX,0,0,0
9996,63,0,63,66,371,0,0,377,258,119,GOOXXXXXXXXXXXXXXXXXGOOOOOXXXXXXXXXXXXXXGOOOOOOXXXXXXXXXXXXXGOOOXXXXXXXXXXXXXXXXGOOXXXXXXXXXXXXXXXXXGOOOOXXXXXXXXXXXXXXXGOOOOOOXXXXXXXXXXXXXGOOOOXXXXXXXXXXXXXXXGOOOOXXXXXXXXXXXXXXXGOOXXXXXXXXXXXXXXXXXGOOOOXXXXXXXXXXXXXXXGOOXXXXXXXXXXXXXXXXXGOOOOOOXXXXXXXXXXXXX,0,0,0
10017,63,0,63,65,372,0,0,379,261,118,GOOXXXXXXXXXXXXXXXXXGOOOOOXXXXXXXXXXXXXXGOOOOOOXXXXXXXXXXXXXGOOOXXXXXXXXXXXXXXXXGOOXXXXXXXXXXXXXXXXXGOOOOXXXXXXXXXXXXXXXGOOOOOOXXXXXXXXXXXXXGOOOOXXXXXXXXXXXXXXXGOOOOXXXXXXXXXXXXXXXGOOXXXXXXXXXXXXXXXXXGOOOOXXXXXXXXXXXXXXXGOOXXXXXXXXXXXXXXXXXGOOOOOOXXXXXXXXXXXXX,0,0,0
10038,63,0,63,70,367,0,0,374,256,118,GOOXXXXXXXXXXXXXXXXXGOOOOOXXXXXXXXXXXXXXGOOOOOOXXXXXXXXXXXXXGOOOXXXXXXXXXXXXXXXXGOOXXXXXXXXXXXXXXXXXGOOOOXXXXXXXXXXXXXXXGOOOOOOXXXXXXXXXXXXXGOOOOXXXXXXXXXXXXXXXGOOOOXXXXXXXXXXXXXXXGOOXXXXXXXXXXXXXXXXXGOOOOXXXXXXXXXXXXXXXGOOXXXXXXXXXXXXXXXXXGOOOOOOXXXXXXXXXXXXX,0,0,0
10059,63,0,63,70,367,0,0,374,261,113,GOOXXXXXXXXXXXXXXXXXGOOOOOXXXXXXXXXXXXXXGOOOOOOXXXXXXXXXXXXXGOOOXXXXXXXXXXXXXXXXGOOXXXXXXXXXXXXXXXXXGOOOOXXXXXXXXXXXXXXXGOOOOOOXXXXXXXXXXXXXGOOOOXXXXXXXXXXXXXXXGOOOOXXXXXXXXXXXXXXXGOOXXXXXXXXXXXXXXXXXGOOOOXXXXXXXXXXXXXXXGOOXXXXXXXXXXXXXXXXXGOOOOOOXXXXXXXXXXXXX,0,0,0

10080,63,0,63,70,367,0,0,374,260,114,GOOXXXXXXXXXXXXXXXXXGOOOOOXXXXXXXXXXXXXXGOOOOOOXXXXXXXXXXXXXGOOOXXXXXXXXXXXXXXXXGOOXXXXXXXXXXXXXXXXXGOOOOXXXXXXXXXXXXXXXGOOOOOOXXXXXXXXXXXXXGOOOOXXXXXXXXXXXXXXXGOOOOXXXXXXXXXXXXXXXGOOXXXXXXXXXXXXXXXXXGOOOOXXXXXXXXXXXXXXXGOOXXXXXXXXXXXXXXXXXGOOOOOOXXXXXXXXXXXXX,0,0,0
10101,63,0,63,64,373,0,0,380,259,121,GOOXXXXXXXXXXXXXXXXXGOOOOOXXXXXXXXXXXXXXGOOOOOOXXXXXXXXXXXXXGOOOXXXXXXXXXXXXXXXXGOOXXXXXXXXXXXXXXXXXGOOOOXXXXXXXXXXXXXXXGOOOOOOXXXXXXXXXXXXXGOOOOXXXXXXXXXXXXXXXGOOOOXXXXXXXXXXXXXXXGOOXXXXXXXXXXXXXXXXXGOOOOXXXXXXXXXXXXXXXGOOXXXXXXXXXXXXXXXXXGOOOOOOXXXXXXXXXXXXX,0,0,0
10122,63,0,63,67,370,0,0,374,260,114,GOOXXXXXXXXXXXXXXXXXGOOOOOXXXXXXXXXXXXXXGOOOOOOXXXXXXXXXXXXXGOOOXXXXXXXXXXXXXXXXGOOXXXXXXXXXXXXXXXXXGOOOOXXXXXXXXXXXXXXXGOOOOOOXXXXXXXXXXXXXGOOOOXXXXXXXXXXXXXXXGOOOOXXXXXXXXXXXXXXXGOOXXXXXXXXXXXXXXXXXGOOOOXXXXXXXXXXXXXXXGOOXXXXXXXXXXXXXXXXXGOOOOOOXXXXXXXXXXXXX,0,0,0
10143,63,0,63,67,370,0,0,376,259,117,GOOXXXXXXXXXXXXXXXXXGOOOOOXXXXXXXXXXXXXXGOOOOOOXXXXXXXXXXXXXGOOOXXXXXXXXXXXXXXXXGOOXXXXXXXXXXXXXXXXXGOOOOXXXXXXXXXXXXXXXGOOOOOOXXXXXXXXXXXXXGOOOOXXXXXXXXXXXXXXXGOOOOXXXXXXXXXXXXXXXGOOXXXXXXXXXXXXXXXXXGOOOOXXXXXXXXXXXXXXXGOOXXXXXXXXXXXXXXXXXGOOOOOOXXXXXXXXXXXXX,0,0,0
10164,63,0,63,67,370,0,0,376,260,116,GOOXXXXXXXXXXXXXXXXXGOOOOOXXXXXXXXXXXXXXGOOOOOOXXXXXXXXXXXXXGOOOXXXXXXXXXXXXXXXXGOOXXXXXXXXXXXXXXXXXGOOOOXXXXXXXXXXXXXXXGOOOOOOXXXXXXXXXXXXXGOOOOXXXXXXXXXXXXXXXGOOOOXXXXXXXXXXXXXXXGOOXXXXXXXXXXXXXXXXXGOOOOXXXXXXXXXXXXXXXGOOXXXXXXXXXXXXXXXXXGOOOOOOXXXXXXXXXXXXX,0,0,0

10185,63,0,63,62,375,0,0,381,259,122,GOOXXXXXXXXXXXXXXXXXGOOOOOXXXXXXXXXXXXXXGOOOOOOXXXXXXXXXXXXXGOOOXXXXXXXXXXXXXXXXGOOXXXXXXXXXXXXXXXXXGOOOOXXXXXXXXXXXXXXXGOOOOOOXXXXXXXXXXXXXGOOOOXXXXXXXXXXXXXXXGOOOOXXXXXXXXXXXXXXXGOOXXXXXXXXXXXXXXXXXGOOOOXXXXXXXXXXXXXXXGOOXXXXXXXXXXXXXXXXXGOOOOOOXXXXXXXXXXXXX,0,0,0
10206,63,0,63,62,375,0,0,381,257,124,GOOXXXXXXXXXXXXXXXXXGOOOOOXXXXXXXXXXXXXXGOOOOOOXXXXXXXXXXXXXGOOOXXXXXXXXXXXXXXXXGOOXXXXXXXXXXXXXXXXXGOOOOXXXXXXXXXXXXXXXGOOOOOOXXXXXXXXXXXXXGOOOOXXXXXXXXXXXXXXXGOOOOXXXXXXXXXXXXXXXGOOXXXXXXXXXXXXXXXXXGOOOOXXXXXXXXXXXXXXXGOOXXXXXXXXXXXXXXXXXGOOOOOOXXXXXXXXXXXXX,0,0,0
10227,63,0,63,61,376,0,0,380,261,119,GOOXXXXXXXXXXXXXXXXXGOOOOOXXXXXXXXXXXXXXGOOOOOOXXXXXXXXXXXXXGOOOXXXXXXXXXXXXXXXXGOOXXXXXXXXXXXXXXXXXGOOOOXXXXXXXXXXXXXXXGOOOOOOXXXXXXXXXXXXXGOOOOXXXXXXXXXXXXXXXGOOOOXXXXXXXXXXXXXXXGOOXXXXXXXXXXXXXXXXXGOOOOXXXXXXXXXXXXXXXGOOXXXXXXXXXXXXXXXXXGOOOOOOXXXXXXXXXXXXX,0,0,0
10248,63,0,63,63,374,0,0,378,263,115,GOOXXXXXXXXXXXXXXXXXGOOOOOXXXXXXXXXXXXXXGOOOOOOXXXXXXXXXXXXXGOOOXXXXXXXXXXXXXXXXGOOXXXXXXXXXXXXXXXXXGOOOOXXXXXXXXXXXXXXXGOOOOOOXXXXXXXXXXXXXGOOOOXXXXXXXXXXXXXXXGOOOOXXXXXXXXXXXXXXXGOOXXXXXXXXXXXXXXXXXGOOOOXXXXXXXXXXXXXXXGOOXXXXXXXXXXXXXXXXXGOOOOOOXXXXXXXXXXXXX,0,0,0
10269,63,0,63,66,371,0,0,376,260,116,GOOXXXXXXXXXXXXXXXXXGOOOOOXXXXXXXXXXXXXXGOOOOOOXXXXXXXXXXXXXGOOOXXXXXXXXXXXXXXXXGOOXXXXXXXXXXXXXXXXXGOOOOXXXXXXXXXXXXXXXGOOOOOOXXXXXXXXXXXXXGOOOOXXXXXXXXXXXXXXXGOOOOXXXXXXXXXXXXXXXGOOXXXXXXXXXXXXXXXXXGOOOOXXXXXXXXXXXXXXXGOOXXXXXXXXXXXXXXXXXGOOOOOOXXXXXXXXXXXXX,0,0,0

10290,63,0,63,64,373,0,0,378,262,116,GOOXXXXXXXXXXXXXXXXXGOOOOOXXXXXXXXXXXXXXGOOOOOOXXXXXXXXXXXXXGOOOXXXXXXXXXXXXXXXXGOOXXXXXXXXXXXXXXXXXGOOOOXXXXXXXXXXXXXXXGOOOOOOXXXXXXXXXXXXXGOOOOXXXXXXXXXXXXXXXGOOOOXXXXXXXXXXXXXXXGOOXXXXXXXXXXXXXXXXXGOOOOXXXXXXXXXXXXXXXGOOXXXXXXXXXXXXXXXXXGOOOOOOXXXXXXXXXXXXX,0,0,0
10311,63,0,63,68,369,0,0,374,262,112,GOOXXXXXXXXXXXXXXXXXGOOOOOXXXXXXXXXXXXXXGOOOOOOXXXXXXXXXXXXXGOOOXXXXXXXXXXXXXXXXGOOXXXXXXXXXXXXXXXXXGOOOOXXXXXXXXXXXXXXXGOOOOOOXXXXXXXXXXXXXGOOOOXXXXXXXXXXXXXXXGOOOOXXXXXXXXXXXXXXXGOOXXXXXXXXXXXXXXXXXGOOOOXXXXXXXXXXXXXXXGOOXXXXXXXXXXXXXXXXXGOOOOOOXXXXXXXXXXXXX,0,0,0
10332,63,0,63,70,367,0,0,371,259,112,GOOXXXXXXXXXXXXXXXXXGOOOOOXXXXXXXXXXXXXXGOOOOOOXXXXXXXXXXXXXGOOOXXXXXXXXXXXXXXXXGOOXXXXXXXXXXXXXXXXXGOOOOXXXXXXXXXXXXXXXGOOOOOOXXXXXXXXXXXXXGOOOOXXXXXXXXXXXXXXXGOOOOXXXXXXXXXXXXXXXGOOXXXXXXXXXXXXXXXXXGOOOOXXXXXXXXXXXXXXXGOOXXXXXXXXXXXXXXXXXGOOOOOOXXXXXXXXXXXXX,0,0,0
10353,63,0,63,65,372,0,0,376,259,117,GOOXXXXXXXXXXXXXXXXXGOOOOOXXXXXXXXXXXXXXGOOOOOOXXXXXXXXXXXXXGOOOXXXXXXXXXXXXXXXXGOOXXXXXXXXXXXXXXXXXGOOOOXXXXXXXXXXXXXXXGOOOOOOXXXXXXXXXXXXXGOOOOXXXXXXXXXXXXXXXGOOOOXXXXXXXXXXXXXXXGOOXXXXXXXXXXXXXXXXXGOOOOXXXXXXXXXXXXXXXGOOXXXXXXXXXXXXXXXXXGOOOOOOXXXXXXXXXXXXX,0,0,0
10374,63,0,63,63,374,0,0,378,259,119,GOOXXXXXXXXXXXXXXXXXGOOOOOXXXXXXXXXXXXXXGOOOOOOXXXXXXXXXXXXXGOOOXXXXXXXXXXXXXXXXGOOXXXXXXXXXXXXXXXXXGOOOOXXXXXXXXXXXXXXXGOOOOOOXXXXXXXXXXXXXGOOOOXXXXXXXXXXXXXXXGOOOOXXXXXXXXXXXXXXXGOOXXXXXXXXXXXXXXXXXGOOOOXXXXXXXXXXXXXXXGOOXXXXXXXXXXXXXXXXXGOOOOOOXXXXXXXXXXXXX,0,0,0

10395,63,0,63,62,375,0,0,380,261,119,GOOXXXXXXXXXXXXXXXXXGOOOOOXXXXXXXXXXXXXXGOOOOOOXXXXXXXXXXXXXGOOOXXXXXXXXXXXXXXXXGOOXXXXXXXXXXXXXXXXXGOOOOXXXXXXXXXXXXXXXGOOOOOOXXXXXXXXXXXXXGOOOOXXXXXXXXXXXXXXXGOOOOXXXXXXXXXXXXXXXGOOXXXXXXXXXXXXXXXXXGOOOOXXXXXXXXXXXXXXXGOOXXXXXXXXXXXXXXXXXGOOOOOOXXXXXXXXXXXXX,0,0,0
10416,63,0,63,64,373,0,0,378,261,117,GOOXXXXXXXXXXXXXXXXXGOOOOOXXXXXXXXXXXXXXGOOOOOOXXXXXXXXXXXXXGOOOXXXXXXXXXXXXXXXXGOOXXXXXXXXXXXXXXXXXGOOOOXXXXXXXXXXXXXXXGOOOOOOXXXXXXXXXXXXXGOOOOXXXXXXXXXXXXXXXGOOOOXXXXXXXXXXXXXXXGOOXXXXXXXXXXXXXXXXXGOOOOXXXXXXXXXXXXXXXGOOXXXXXXXXXXXXXXXXXGOOOOOOXXXXXXXXXXXXX,0,0,0
10437,63,0,63,67,370,0,0,375,266,109,GOOXXXXXXXXXXXXXXXXXGOOOOOXXXXXXXXXXXXXXGOOOOOOXXXXXXXXXXXXXGOOOXXXXXXXXXXXXXXXXGOOXXXXXXXXXXXXXXXXXGOOOOXXXXXXXXXXXXXXXGOOOOOOXXXXXXXXXXXXXGOOOOXXXXXXXXXXXXXXXGOOOOXXXXXXXXXXXXXXXGOOXXXXXXXXXXXXXXXXXGOOOOXXXXXXXXXXXXXXXGOOXXXXXXXXXXXXXXXXXGOOOOOOXXXXXXXXXXXXX,0,0,0
10458,63,0,63,69,368,0,0,373,265,108,GOOXXXXXXXXXXXXXXXXXGOOOOOXXXXXXXXXXXXXXGOOOOOOXXXXXXXXXXXXXGOOOXXXXXXXXXXXXXXXXGOOXXXXXXXXXXXXXXXXXGOOOOXXXXXXXXXXXXXXXGOOOOOOXXXXXXXXXXXXXGOOOOXXXXXXXXXXXXXXXGOOOOXXXXXXXXXXXXXXXGOOXXXXXXXXXXXXXXXXXGOOOOXXXXXXXXXXXXXXXGOOXXXXXXXXXXXXXXXXXGOOOOOOXXXXXXXXXXXXX,0,0,0
10479,63,0,63,70,367,0,0,370,265,105,GOOXXXXXXXXXXXXXXXXXGOOOOOXXXXXXXXXXXXXXGOOOOOOXXXXXXXXXXXXXGOOOXXXXXXXXXXXXXXXXGOOXXXXXXXXXXXXXXXXXGOOOOXXXXXXXXXXXXXXXGOOOOOOXXXXXXXXXXXXXGOOOOXXXXXXXXXXXXXXXGOOOOXXXXXXXXXXXXXXXGOOXXXXXXXXXXXXXXXXXGOOOOXXXXXXXXXXXXXXXGOOXXXXXXXXXXXXXXXXXGOOOOOOXXXXXXXXXXXXX,0,0,0

10500,63,0,63,68,369,0,0,373,263,110,GOOXXXXXXXXXXXXXXXXXGOOOOOXXXXXXXXXXXXXXGOOOOOOXXXXXXXXXXXXXGOOOXXXXXXXXXXXXXXXXGOOXXXXXXXXXXXXXXXXXGOOOOXXXXXXXXXXXXXXXGOOOOOOXXXXXXXXXXXXXGOOOOXXXXXXXXXXXXXXXGOOOOXXXXXXXXXXXXXXXGOOXXXXXXXXXXXXXXXXXGOOOOXXXXXXXXXXXXXXXGOOXXXXXXXXXXXXXXXXXGOOOOOOXXXXXXXXXXXXX,0,0,0
10521,63,0,63,66,371,0,0,374,266,108,GOOXXXXXXXXXXXXXXXXXGOOOOOXXXXXXXXXXXXXXGOOOOOOXXXXXXXXXXXXXGOOOXXXXXXXXXXXXXXXXGOOXXXXXXXXXXXXXXXXXGOOOOXXXXXXXXXXXXXXXGOOOOOOXXXXXXXXXXXXXGOOOOXXXXXXXXXXXXXXXGOOOOXXXXXXXXXXXXXXXGOOXXXXXXXXXXXXXXXXXGOOOOXXXXXXXXXXXXXXXGOOXXXXXXXXXXXXXXXXXGOOOOOOXXXXXXXXXXXXX,0,0,0
10542,63,0,63,62,375,0,0,379,264,115,GOOXXXXXXXXXXXXXXXXXGOOOOOXXXXXXXXXXXXXXGOOOOOOXXXXXXXXXXXXXGOOOXXXXXXXXXXXXXXXXGOOXXXXXXXXXXXXXXXXXGOOOOXXXXXXXXXXXXXXXGOOOOOOXXXXXXXXXXXXXGOOOOXXXXXXXXXXXXXXXGOOOOXXXXXXXXXXXXXXXGOOXXXXXXXXXXXXXXXXXGOOOOXXXXXXXXXXXXXXXGOOXXXXXXXXXXXXXXXXXGOOOOOOXXXXXXXXXXXXX,0,0,0
10563,63,0,63,65,372,0,0,376,262,114,GOOXXXXXXXXXXXXXXXXXGOOOOOXXXXXXXXXXXXXXGOOOOOOXXXXXXXXXXXXXGOOOXXXXXXXXXXXXXXXXGOOXXXXXXXXXXXXXXXXXGOOOOXXXXXXXXXXXXXXXGOOOOOOXXXXXXXXXXXXXGOOOOXXXXXXXXXXXXXXXGOOOOXXXXXXXXXXXXXXXGOOXXXXXXXXXXXXXXXXXGOOOOXXXXXXXXXXXXXXXGOOXXXXXXXXXXXXXXXXXGOOOOOOXXXXXXXXXXXXX,0,0,0
10584,63,0,63,63,374,0,0,378,263,115,GOOXXXXXXXXXXXXXXXXXGOOOOOXXXXXXXXXXXXXXGOOOOOOXXXXXXXXXXXXXGOOOXXXXXXXXXXXXXXXXGOOXXXXXXXXXXXXXXXXXGOOOOXXXXXXXXXXXXXXXGOOOOOOXXXXXXXXXXXXXGOOOOXXXXXXXXXXXXXXXGOOOOXXXXXXXXXXXXXXXGOOXXXXXXXXXXXXXXXXXGOOOOXXXXXXXXXXXXXXXGOOXXXXXXXXXXXXXXXXXGOOOOOOXXXXXXXXXXXXX,0,0,0

10605,63,0,63,58,379,0,0,382,267,115,GOOXXXXXXXXXXXXXXXXXGOOOOOXXXXXXXXXXXXXXGOOOOOOXXXXXXXXXXXXXGOOOXXXXXXXXXXXXXXXXGOOXXXXXXXXXXXXXXXXXGOOOOXXXXXXXXXXXXXXXGOOOOOOXXXXXXXXXXXXXGOOOOXXXXXXXXXXXXXXXGOOOOXXXXXXXXXXXXXXXGOOXXXXXXXXXXXXXXXXXGOOOOXXXXXXXXXXXXXXXGOOXXXXXXXXXXXXXXXXXGOOOOOOXXXXXXXXXXXXX,0,0,0
10626,63,0,63,61,376,0,0,379,265,114,GOOXXXXXXXXXXXXXXXXXGOOOOOXXXXXXXXXXXXXXGOOOOOOXXXXXXXXXXXXXGOOOXXXXXXXXXXXXXXXXGOOXXXXXXXXXXXXXXXXXGOOOOXXXXXXXXXXXXXXXGOOOOOOXXXXXXXXXXXXXGOOOOXXXXXXXXXXXXXXXGOOOOXXXXXXXXXXXXXXXGOOXXXXXXXXXXXXXXXXXGOOOOXXXXXXXXXXXXXXXGOOXXXXXXXXXXXXXXXXXGOOOOOOXXXXXXXXXXXXX,0,0,0
10647,63,0,63,62,375,0,0,379,266,113,GOOXXXXXXXXXXXXXXXXXGOOOOOXXXXXXXXXXXXXXGOOOOOOXXXXXXXXXXXXXGOOOXXXXXXXXXXXXXXXXGOOXXXXXXXXXXXXXXXXXGOOOOXXXXXXXXXXXXXXXGOOOOOOXXXXXXXXXXXXXGOOOOXXXXXXXXXXXXXXXGOOOOXXXXXXXXXXXXXXXGOOXXXXXXXXXXXXXXXXXGOOOOXXXXXXXXXXXXXXXGOOXXXXXXXXXXXXXXXXXGOOOOOOXXXXXXXXXXXXX,0,0,0
10668,63,0,63,66,371,0,0,375,268,107,GOOXXXXXXXXXXXXXXXXXGOOOOOXXXXXXXXXXXXXXGOOOOOOXXXXXXXXXXXXXGOOOXXXXXXXXXXXXXXXXGOOXXXXXXXXXXXXXXXXXGOOOOXXXXXXXXXXXXXXXGOOOOOOXXXXXXXXXXXXXGOOOOXXXXXXXXXXXXXXXGOOOOXXXXXXXXXXXXXXXGOOXXXXXXXXXXXXXXXXXGOOOOXXXXXXXXXXXXXXXGOOXXXXXXXXXXXXXXXXXGOOOOOOXXXXXXXXXXXXX,0,0,0
10689,63,0,63,68,369,0,0,373,266,107,GOOXXXXXXXXXXXXXXXXXGOOOOOXXXXXXXXXXXXXXGOOOOOOXXXXXXXXXXXXXGOOOXXXXXXXXXXXXXXXXGOOXXXXXXXXXXXXXXXXXGOOOOXXXXXXXXXXXXXXXGOOOOOOXXXXXXXXXXXXXGOOOOXXXXXXXXXXXXXXXGOOOOXXXXXXXXXXXXXXXGOOXXXXXXXXXXXXXXXXXGOOOOXXXXXXXXXXXXXXXGOOXXXXXXXXXXXXXXXXXGOOOOOOXXXXXXXXXXXXX,0,0,0

10710,63,0,63,67,370,0,0,375,267,108,GOOXXXXXXXXXXXXXXXXXGOOOOOXXXXXXXXXXXXXXGOOOOOOXXXXXXXXXXXXXGOOOXXXXXXXXXXXXXXXXGOOXXXXXXXXXXXXXXXXXGOOOOXXXXXXXXXXXXXXXGOOOOOOXXXXXXXXXXXXXGOOOOXXXXXXXXXXXXXXXGOOOOXXXXXXXXXXXXXXXGOOXXXXXXXXXXXXXXXXXGOOOOXXXXXXXXXXXXXXXGOOXXXXXXXXXXXXXXXXXGOOOOOOXXXXXXXXXXXXX,0,0,0
10731,63,0,63,70,367,0,0,372,263,109,GOOXXXXXXXXXXXXXXXXXGOOOOOXXXXXXXXXXXXXXGOOOOOOXXXXXXXXXXXXXGOOOXXXXXXXXXXXXXXXXGOOXXXXXXXXXXXXXXXXXGOOOOXXXXXXXXXXXXXXXGOOOOOOXXXXXXXXXXXXXGOOOOXXXXXXXXXXXXXXXGOOOOXXXXXXXXXXXXXXXGOOXXXXXXXXXXXXXXXXXGOOOOXXXXXXXXXXXXXXXGOOXXXXXXXXXXXXXXXXXGOOOOOOXXXXXXXXXXXXX,0,0,0
10752,64,1,63,66,370,0,0,373,271,102,GOOXXXXXXXXXXXXXXXXXGOOOOOXXXXXXXXXXXXXXGOOOOOOXXXXXXXXXXXXXGOOOXXXXXXXXXXXXXXXXGOOXXXXXXXXXXXXXXXXXGOOOOXXXXXXXXXXXXXXXGOOOOOOXXXXXXXXXXXXXGOOOOAXXXXXXXXXXXXXXGOOOOXXXXXXXXXXXXXXXGOOXXXXXXXXXXXXXXXXXGOOOOXXXXXXXXXXXXXXXGOOXXXXXXXXXXXXXXXXXGOOOOOOXXXXXXXXXXXXX,0,0,0
10773,64,1,63,63,373,0,0,376,269,107,GOOXXXXXXXXXXXXXXXXXGOOOOOXXXXXXXXXXXXXXGOOOOOOXXXXXXXXXXXXXGOOOXXXXXXXXXXXXXXXXGOOXXXXXXXXXXXXXXXXXGOOOOXXXXXXXXXXXXXXXGOOOOOOXXXXXXXXXXXXXGOOOOAXXXXXXXXXXXXXXGOOOOXXXXXXXXXXXXXXXGOOXXXXXXXXXXXXXXXXXGOOOOXXXXXXXXXXXXXXXGOOXXXXXXXXXXXXXXXXXGOOOOOOXXXXXXXXXXXXX,0,0,0
10794,64,0,64,63,373,0,0,376,269,107,GOOXXXXXXXXXXXXXXXXXGOOOOOXXXXXXXXXXXXXXGOOOOOOXXXXXXXXXXXXXGOOOXXXXXXXXXXXXXXXXGOOXXXXXXXXXXXXXXXXXGOOOOXXXXXXXXXXXXXXXGOOOOOOXXXXXXXXXXXXXGOOOOOXXXXXXXXXXXXXXGOOOOXXXXXXXXXXXXXXXGOOXXXXXXXXXXXXXXXXXGOOOOXXXXXXXXXXXXXXXGOOXXXXXXXXXXXXXXXXXGOOOOOOXXXXXXXXXXXXX,0,0,0

10815,64,0,64,59,377,0,0,379,270,109,GOOXXXXXXXXXXXXXXXXXGOOOOOXXXXXXXXXXXXXXGOOOOOOXXXXXXXXXXXXXGOOOXXXXXXXXXXXXXXXXGOOXXXXXXXXXXXXXXXXXGOOOOXXXXXXXXXXXXXXXGOOOOOOXXXXXXXXXXXXXGOOOOOXXXXXXXXXXXXXXGOOOOXXXXXXXXXXXXXXXGOOXXXXXXXXXXXXXXXXXGOOOOXXXXXXXXXXXXXXXGOOXXXXXXXXXXXXXXXXXGOOOOOOXXXXXXXXXXXXX,0,0,0
10836,65,1,64,55,380,0,0,383,269,114,GOOXXXXXXXXXXXXXXXXXGOOOOOXXXXXXXXXXXXXXGOOOOOOXXXXXXXXXXXXXGOOOXXXXXXXXXXXXXXXXGOOXXXXXXXXXXXXXXXXXGOOOOXXXXXXXXXXXXXXXGOOOOOOXXXXXXXXXXXXXGOOOOOAXXXXXXXXXXXXXGOOOOXXXXXXXXXXXXXXXGOOXXXXXXXXXXXXXXXXXGOOOOXXXXXXXXXXXXXXXGOOXXXXXXXXXXXXXXXXXGOOOOOOXXXXXXXXXXXXX,0,0,0
10857,65,0,65,57,378,0,0,381,265,116,GOOXXXXXXXXXXXXXXXXXGOOOOOXXXXXXXXXXXXXXGOOOOOOXXXXXXXXXXXXXGOOOXXXXXXXXXXXXXXXXGOOXXXXXXXXXXXXXXXXXGOOOOXXXXXXXXXXXXXXXGOOOOOOXXXXXXXXXXXXXGOOOOOOXXXXXXXXXXXXXGOOOOXXXXXXXXXXXXXXXGOOXXXXXXXXXXXXXXXXXGOOOOXXXXXXXXXXXXXXXGOOXXXXXXXXXXXXXXXXXGOOOOOOXXXXXXXXXXXXX,0,0,0
10878,65,0,65,57,378,0,0,382,269,113,GOOXXXXXXXXXXXXXXXXXGOOOOOXXXXXXXXXXXXXXGOOOOOOXXXXXXXXXXXXXGOOOXXXXXXXXXXXXXXXXGOOXXXXXXXXXXXXXXXXXGOOOOXXXXXXXXXXXXXXXGOOOOOOXXXXXXXXXXXXXGOOOOOOXXXXXXXXXXXXXGOOOOXXXXXXXXXXXXXXXGOOXXXXXXXXXXXXXXXXXGOOOOXXXXXXXXXXXXXXXGOOXXXXXXXXXXXXXXXXXGOOOOOOXXXXXXXXXXXXX,0,0,0
10899,65,0,65,61,374,0,0,379,266,113,GOOXXXXXXXXXXXXXXXXXGOOOOOXXXXXXXXXXXXXXGOOOOOOXXXXXXXXXXXXXGOOOXXXXXXXXXXXXXXXXGOOXXXXXXXXXXXXXXXXXGOOOOXXXXXXXXXXXXXXXGOOOOOOXXXXXXXXXXXXXGOOOOOOXXXXXXXXXXXXXGOOOOXXXXXXXXXXXXXXXGOOXXXXXXXXXXXXXXXXXGOOOOXXXXXXXXXXXXXXXGOOXXXXXXXXXXXXXXXXXGOOOOOOXXXXXXXXXXXXX,0,0,0

10920,65,0,65,57,378,0,0,383,269,114,GOOXXXXXXXXXXXXXXXXXGOOOOOXXXXXXXXXXXXXXGOOOOOOXXXXXXXXXXXXXGOOOXXXXXXXXXXXXXXXXGOOXXXXXXXXXXXXXXXXXGOOOOXXXXXXXXXXXXXXXGOOOOOOXXXXXXXXXXXXXGOOOOOOXXXXXXXXXXXXXGOOOOXXXXXXXXXXXXXXXGOOXXXXXXXXXXXXXXXXXGOOOOXXXXXXXXXXXXXXXGOOXXXXXXXXXXXXXXXXXGOOOOOOXXXXXXXXXXXXX,0,0,0
10941,65,0,65,50,385,0,0,390,271,119,GOOXXXXXXXXXXXXXXXXXGOOOOOXXXXXXXXXXXXXXGOOOOOOXXXXXXXXXXXXXGOOOXXXXXXXXXXXXXXXXGOOXXXXXXXXXXXXXXXXXGOOOOXXXXXXXXXXXXXXXGOOOOOOXXXXXXXXXXXXXGOOOOOOXXXXXXXXXXXXXGOOOOXXXXXXXXXXXXXXXGOOXXXXXXXXXXXXXXXXXGOOOOXXXXXXXXXXXXXXXGOOXXXXXXXXXXXXXXXXXGOOOOOOXXXXXXXXXXXXX,0,0,0
10962,65,0,65,52,383,0,0,388,271,117,GOOXXXXXXXXXXXXXXXXXGOOOOOXXXXXXXXXXXXXXGOOOOOOXXXXXXXXXXXXXGOOOXXXXXXXXXXXXXXXXGOOXXXXXXXXXXXXXXXXXGOOOOXXXXXXXXXXXXXXXGOOOOOOXXXXXXXXXXXXXGOOOOOOXXXXXXXXXXXXXGOOOOXXXXXXXXXXXXXXXGOOXXXXXXXXXXXXXXXXXGOOOOXXXXXXXXXXXXXXXGOOXXXXXXXXXXXXXXXXXGOOOOOOXXXXXXXXXXXXX,0,0,0
10983,65,0,65,51,384,0,0,389,271,118,GOOXXXXXXXXXXXXXXXXXGOOOOOXXXXXXXXXXXXXXGOOOOOOXXXXXXXXXXXXXGOOOXXXXXXXXXXXXXXXXGOOXXXXXXXXXXXXXXXXXGOOOOXXXXXXXXXXXXXXXGOOOOOOXXXXXXXXXXXXXGOOOOOOXXXXXXXXXXXXXGOOOOXXXXXXXXXXXXXXXGOOXXXXXXXXXXXXXXXXXGOOOOXXXXXXXXXXXXXXXGOOXXXXXXXXXXXXXXXXXGOOOOOOXXXXXXXXXXXXX,0,0,0
11004,65,0,65,51,384,0,0,388,271,117,GOOXXXXXXXXXXXXXXXXXGOOOOOXXXXXXXXXXXXXXGOOOOOOXXXXXXXXXXXXXGOOOXXXXXXXXXXXXXXXXGOOXXXXXXXXXXXXXXXXXGOOOOXXXXXXXXXXXXXXXGOOOOOOXXXXXXXXXXXXXGOOOOOOXXXXXXXXXXXXXGOOOOXXXXXXXXXXXXXXXGOOXXXXXXXXXXXXXXXXXGOOOOXXXXXXXXXXXXXXXGOOXXXXXXXXXXXXXXXXXGOOOOOOXXXXXXXXXXXXX,0,0,0

11025,65,0,65,47,388,0,0,391,275,116,GOOXXXXXXXXXXXXXXXXXGOOOOOXXXXXXXXXXXXXXGOOOOOOXXXXXXXXXXXXXGOOOXXXXXXXXXXXXXXXXGOOXXXXXXXXXXXXXXXXXGOOOOXXXXXXXXXXXXXXXGOOOOOOXXXXXXXXXXXXXGOOOOOOXXXXXXXXXXXXXGOOOOXXXXXXXXXXXXXXXGOOXXXXXXXXXXXXXXXXXGOOOOXXXXXXXXXXXXXXXGOOXXXXXXXXXXXXXXXXXGOOOOOOXXXXXXXXXXXXX,0,0,0
11046,66,1,65,49,385,0,0,389,275,114,GOOXXXXXXXXXXXXXXXXXGOOOOOXXXXXXXXXXXXXXGOOOOOOAXXXXXXXXXXXXGOOOXXXXXXXXXXXXXXXXGOOXXXXXXXXXXXXXXXXXGOOOOXXXXXXXXXXXXXXXGOOOOOOXXXXXXXXXXXXXGOOOOOOXXXXXXXXXXXXXGOOOOXXXXXXXXXXXXXXXGOOXXXXXXXXXXXXXXXXXGOOOOXXXXXXXXXXXXXXXGOOXXXXXXXXXXXXXXXXXGOOOOOOXXXXXXXXXXXXX,0,0,0
11067,66,1,65,51,383,0,0,387,275,112,GOOXXXXXXXXXXXXXXXXXGOOOOOXXXXXXXXXXXXXXGOOOOOOAXXXXXXXXXXXXGOOOXXXXXXXXXXXXXXXXGOOXXXXXXXXXXXXXXXXXGOOOOXXXXXXXXXXXXXXXGOOOOOOXXXXXXXXXXXXXGOOOOOOXXXXXXXXXXXXXGOOOOXXXXXXXXXXXXXXXGOOXXXXXXXXXXXXXXXXXGOOOOXXXXXXXXXXXXXXXGOOXXXXXXXXXXXXXXXXXGOOOOOOXXXXXXXXXXXXX,0,0,0
11088,66,1,65,49,385,0,0,388,273,115,GOOXXXXXXXXXXXXXXXXXGOOOOOXXXXXXXXXXXXXXGOOOOOOAXXXXXXXXXXXXGOOOXXXXXXXXXXXXXXXXGOOXXXXXXXXXXXXXXXXXGOOOOXXXXXXXXXXXXXXXGOOOOOOXXXXXXXXXXXXXGOOOOOOXXXXXXXXXXXXXGOOOOXXXXXXXXXXXXXXXGOOXXXXXXXXXXXXXXXXXGOOOOXXXXXXXXXXXXXXXGOOXXXXXXXXXXXXXXXXXGOOOOOOXXXXXXXXXXXXX,0,0,0
11109,66,1,65,55,379,0,0,382,277,105,GOOXXXXXXXXXXXXXXXXXGOOOOOXXXXXXXXXXXXXXGOOOOOOAXXXXXXXXXXXXGOOOXXXXXXXXXXXXXXXXGOOXXXXXXXXXXXXXXXXXGOOOOXXXXXXXXXXXXXXXGOOOOOOXXXXXXXXXXXXXGOOOOOOXXXXXXXXXXXXXGOOOOXXXXXXXXXXXXXXXGOOXXXXXXXXXXXXXXXXXGOOOOXXXXXXXXXXXXXXXGOOXXXXXXXXXXXXXXXXXGOOOOOOXXXXXXXXXXXXX,0,0,0

11130,66,1,65,60,374,0,0,378,277,101,GOOXXXXXXXXXXXXXXXXXGOOOOOXXXXXXXXXXXXXXGOOOOOOAXXXXXXXXXXXXGOOOXXXXXXXXXXXXXXXXGOOXXXXXXXXXXXXXXXXXGOOOOXXXXXXXXXXXXXXXGOOOOOOXXXXXXXXXXXXXGOOOOOOXXXXXXXXXXXXXGOOOOXXXXXXXXXXXXXXXGOOXXXXXXXXXXXXXXXXXGOOOOXXXXXXXXXXXXXXXGOOXXXXXXXXXXXXXXXXXGOOOOOOXXXXXXXXXXXXX,0,0,0
11151,66,1,65,65,369,0,0,373,272,101,GOOXXXXXXXXXXXXXXXXXGOOOOOXXXXXXXXXXXXXXGOOOOOOAXXXXXXXXXXXXGOOOXXXXXXXXXXXXXXXXGOOXXXXXXXXXXXXXXXXXGOOOOXXXXXXXXXXXXXXXGOOOOOOXXXXXXXXXXXXXGOOOOOOXXXXXXXXXXXXXGOOOOXXXXXXXXXXXXXXXGOOXXXXXXXXXXXXXXXXXGOOOOXXXXXXXXXXXXXXXGOOXXXXXXXXXXXXXXXXXGOOOOOOXXXXXXXXXXXXX,0,0,0
11172,66,1,65,64,370,0,0,375,272,103,GOOXXXXXXXXXXXXXXXXXGOOOOOXXXXXXXXXXXXXXGOOOOOOAXXXXXXXXXXXXGOOOXXXXXXXXXXXXXXXXGOOXXXXXXXXXXXXXXXXXGOOOOXXXXXXXXXXXXXXXGOOOOOOXXXXXXXXXXXXXGOOOOOOXXXXXXXXXXXXXGOOOOXXXXXXXXXXXXXXXGOOXXXXXXXXXXXXXXXXXGOOOOXXXXXXXXXXXXXXXGOOXXXXXXXXXXXXXXXXXGOOOOOOXXXXXXXXXXXXX,0,0,0
11193,66,1,65,61,373,0,0,377,277,100,GOOXXXXXXXXXXXXXXXXXGOOOOOXXXXXXXXXXXXXXGOOOOOOAXXXXXXXXXXXXGOOOXXXXXXXXXXXXXXXXGOOXXXXXXXXXXXXXXXXXGOOOOXXXXXXXXXXXXXXXGOOOOOOXXXXXXXXXXXXXGOOOOOOXXXXXXXXXXXXXGOOOOXXXXXXXXXXXXXXXGOOXXXXXXXXXXXXXXXXXGOOOOXXXXXXXXXXXXXXXGOOXXXXXXXXXXXXXXXXXGOOOOOOXXXXXXXXXXXXX,0,0,0
11214,66,1,65,64,370,0,0,374,278,96,GOOXXXXXXXXXXXXXXXXXGOOOOOXXXXXXXXXXXXXXGOOOOOOAXXXXXXXXXXXXGOOOXXXXXXXXXXXXXXXXGOOXXXXXXXXXXXXXXXXXGOOOOXXXXXXXXXXXXXXXGOOOOOOXXXXXXXXXXXXXGOOOOOOXXXXXXXXXXXXXGOOOOXXXXXXXXXXXXXXXGOOXXXXXXXXXXXXXXXXXGOOOOXXXXXXXXXXXXXXXGOOXXXXXXXXXXXXXXXXXGOOOOOOXXXXXXXXXXXXX,0,0,0

11235,66,1,65,62,372,0,0,377,280,97,GOOXXXXXXXXXXXXXXXXXGOOOOOXXXXXXXXXXXXXXGOOOOOOAXXXXXXXXXXXXGOOOXXXXXXXXXXXXXXXXGOOXXXXXXXXXXXXXXXXXGOOOOXXXXXXXXXXXXXXXGOOOOOOXXXXXXXXXXXXXGOOOOOOXXXXXXXXXXXXXGOOOOXXXXXXXXXXXXXXXGOOXXXXXXXXXXXXXXXXXGOOOOXXXXXXXXXXXXXXXGOOXXXXXXXXXXXXXXXXXGOOOOOOXXXXXXXXXXXXX,0,0,0
11256,66,0,66,62,372,0,0,375,277,98,GOOXXXXXXXXXXXXXXXXXGOOOOOXXXXXXXXXXXXXXGOOOOOOOXXXXXXXXXXXXGOOOXXXXXXXXXXXXXXXXGOOXXXXXXXXXXXXXXXXXGOOOOXXXXXXXXXXXXXXXGOOOOOOXXXXXXXXXXXXXGOOOOOOXXXXXXXXXXXXXGOOOOXXXXXXXXXXXXXXXGOOXXXXXXXXXXXXXXXXXGOOOOXXXXXXXXXXXXXXXGOOXXXXXXXXXXXXXXXXXGOOOOOOXXXXXXXXXXXXX,0,0,0
11277,66,0,66,66,368,0,0,372,277,95,GOOXXXXXXXXXXXXXXXXXGOOOOOXXXXXXXXXXXXXXGOOOOOOOXXXXXXXXXXXXGOOOXXXXXXXXXXXXXXXXGOOXXXXXXXXXXXXXXXXXGOOOOXXXXXXXXXXXXXXXGOOOOOOXXXXXXXXXXXXXGOOOOOOXXXXXXXXXXXXXGOOOOXXXXXXXXXXXXXXXGOOXXXXXXXXXXXXXXXXXGOOOOXXXXXXXXXXXXXXXGOOXXXXXXXXXXXXXXXXXGOOOOOOXXXXXXXXXXXXX,0,0,0
11298,66,0,66,68,366,0,0,370,278,92,GOOXXXXXXXXXXXXXXXXXGOOOOOXXXXXXXXXXXXXXGOOOOOOOXXXXXXXXXXXXGOOOXXXXXXXXXXXXXXXXGOOXXXXXXXXXXXXXXXXXGOOOOXXXXXXXXXXXXXXXGOOOOOOXXXXXXXXXXXXXGOOOOOOXXXXXXXXXXXXXGOOOOXXXXXXXXXXXXXXXGOOXXXXXXXXXXXXXXXXXGOOOOXXXXXXXXXXXXXXXGOOXXXXXXXXXXXXXXXXXGOOOOOOXXXXXXXXXXXXX,0,0,0
11319,66,0,66,70,364,0,0,366,279,87,GOOXXXXXXXXXXXXXXXXXGOOOOOXXXXXXXXXXXXXXGOOOOOOOXXXXXXXXXXXXGOOOXXXXXXXXXXXXXXXXGOOXXXXXXXXXXXXXXXXXGOOOOXXXXXXXXXXXXXXXGOOOOOOXXXXXXXXXXXXXGOOOOOOXXXXXXXXXXXXXGOOOOXXXXXXXXXXXXXXXGOOXXXXXXXXXXXXXXXXXGOOOOXXXXXXXXXXXXXXXGOOXXXXXXXXXXXXXXXXXGOOOOOOXXXXXXXXXXXXX,0,0,0

11340,66,0,66,66,368,0,0,371,279,92,GOOXXXXXXXXXXXXXXXXXGOOOOOXXXXXXXXXXXXXXGOOOOOOOXXXXXXXXXXXXGOOOXXXXXXXXXXXXXXXXGOOXXXXXXXXXXXXXXXXXGOOOOXXXXXXXXXXXXXXXGOOOOOOXXXXXXXXXXXXXGOOOOOOXXXXXXXXXXXXXGOOOOXXXXXXXXXXXXXXXGOOXXXXXXXXXXXXXXXXXGOOOOXXXXXXXXXXXXXXXGOOXXXXXXXXXXXXXXXXXGOOOOOOXXXXXXXXXXXXX,0,0,0
11361,67,1,66,61,372,0,0,375,281,94,GOOXXXXXXXXXXXXXXXXXGOOOOOXXXXXXXXXXXXXXGOOOOOOOXXXXXXXXXXXXGOOOXXXXXXXXXXXXXXXXGOOXXXXXXXXXXXXXXXXXGOOOOXXXXXXXXXXXXXXXGOOOOOOXXXXXXXXXXXXXGOOOOOOXXXXXXXXXXXXXGOOOOAXXXXXXXXXXXXXXGOOXXXXXXXXXXXXXXXXXGOOOOXXXXXXXXXXXXXXXGOOXXXXXXXXXXXXXXXXXGOOOOOOXXXXXXXXXXXXX,0,0,0
11382,67,0,67,60,373,0,0,376,282,94,GOOXXXXXXXXXXXXXXXXXGOOOOOXXXXXXXXXXXXXXGOOOOOOOXXXXXXXXXXXXGOOOXXXXXXXXXXXXXXXXGOOXXXXXXXXXXXXXXXXXGOOOOXXXXXXXXXXXXXXXGOOOOOOXXXXXXXXXXXXXGOOOOOOXXXXXXXXXXXXXGOOOOOXXXXXXXXXXXXXXGOOXXXXXXXXXXXXXXXXXGOOOOXXXXXXXXXXXXXXXGOOXXXXXXXXXXXXXXXXXGOOOOOOXXXXXXXXXXXXX,0,0,0
11403,67,0,67,59,374,0,0,377,279,98,GOOXXXXXXXXXXXXXXXXXGOOOOOXXXXXXXXXXXXXXGOOOOOOOXXXXXXXXXXXXGOOOXXXXXXXXXXXXXXXXGOOXXXXXXXXXXXXXXXXXGOOOOXXXXXXXXXXXXXXXGOOOOOOXXXXXXXXXXXXXGOOOOOOXXXXXXXXXXXXXGOOOOOXXXXXXXXXXXXXXGOOXXXXXXXXXXXXXXXXXGOOOOXXXXXXXXXXXXXXXGOOXXXXXXXXXXXXXXXXXGOOOOOOXXXXXXXXXXXXX,0,0,0
11424,67,0,67,52,381,0,0,383,278,105,GOOXXXXXXXXXXXXXXXXXGOOOOOXXXXXXXXXXXXXXGOOOOOOOXXXXXXXXXXXXGOOOXXXXXXXXXXXXXXXXGOOXXXXXXXXXXXXXXXXXGOOOOXXXXXXXXXXXXXXXGOOOOOOXXXXXXXXXXXXXGOOOOOOXXXXXXXXXXXXXGOOOOOXXXXXXXXXXXXXXGOOXXXXXXXXXXXXXXXXXGOOOOXXXXXXXXXXXXXXXGOOXXXXXXXXXXXXXXXXXGOOOOOOXXXXXXXXXXXXX,0,0,0

11445,67,0,67,50,383,0,0,386,280,106,GOOXXXXXXXXXXXXXXXXXGOOOOOXXXXXXXXXXXXXXGOOOOOOOXXXXXXXXXXXXGOOOXXXXXXXXXXXXXXXXGOOXXXXXXXXXXXXXXXXXGOOOOXXXXXXXXXXXXXXXGOOOOOOXXXXXXXXXXXXXGOOOOOOXXXXXXXXXXXXXGOOOOOXXXXXXXXXXXXXXGOOXXXXXXXXXXXXXXXXXGOOOOXXXXXXXXXXXXXXXGOOXXXXXXXXXXXXXXXXXGOOOOOOXXXXXXXXXXXXX,0,0,0
11466,67,0,67,55,378,0,0,380,278,102,GOOXXXXXXXXXXXXXXXXXGOOOOOXXXXXXXXXXXXXXGOOOOOOOXXXXXXXXXXXXGOOOXXXXXXXXXXXXXXXXGOOXXXXXXXXXXXXXXXXXGOOOOXXXXXXXXXXXXXXXGOOOOOOXXXXXXXXXXXXXGOOOOOOXXXXXXXXXXXXXGOOOOOXXXXXXXXXXXXXXGOOXXXXXXXXXXXXXXXXXGOOOOXXXXXXXXXXXXXXXGOOXXXXXXXXXXXXXXXXXGOOOOOOXXXXXXXXXXXXX,0,0,0
11487,67,0,67,49,384,0,0,387,279,108,GOOXXXXXXXXXXXXXXXXXGOOOOOXXXXXXXXXXXXXXGOOOOOOOXXXXXXXXXXXXGOOOXXXXXXXXXXXXXXXXGOOXXXXXXXXXXXXXXXXXGOOOOXXXXXXXXXXXXXXXGOOOOOOXXXXXXXXXXXXXGOOOOOOXXXXXXXXXXXXXGOOOOOXXXXXXXXXXXXXXGOOXXXXXXXXXXXXXXXXXGOOOOXXXXXXXXXXXXXXXGOOXXXXXXXXXXXXXXXXXGOOOOOOXXXXXXXXXXXXX,0,0,0
11508,67,0,67,49,384,0,0,387,280,107,GOOXXXXXXXXXXXXXXXXXGOOOOOXXXXXXXXXXXXXXGOOOOOOOXXXXXXXXXXXXGOOOXXXXXXXXXXXXXXXXGOOXXXXXXXXXXXXXXXXXGOOOOXXXXXXXXXXXXXXXGOOOOOOXXXXXXXXXXXXXGOOOOOOXXXXXXXXXXXXXGOOOOOXXXXXXXXXXXXXXGOOXXXXXXXXXXXXXXXXXGOOOOXXXXXXXXXXXXXXXGOOXXXXXXXXXXXXXXXXXGOOOOOOXXXXXXXXXXXXX,0,0,0
11529,67,0,67,51,382,0,0,385,280,105,GOOXXXXXXXXXXXXXXXXXGOOOOOXXXXXXXXXXXXXXGOOOOOOOXXXXXXXXXXXXGOOOXXXXXXXXXXXXXXXXGOOXXXXXXXXXXXXXXXXXGOOOOXXXXXXXXXXXXXXXGOOOOOOXXXXXXXXXXXXXGOOOOOOXXXXXXXXXXXXXGOOOOOXXXXXXXXXXXXXXGOOXXXXXXXXXXXXXXXXXGOOOOXXXXXXXXXXXXXXXGOOXXXXXXXXXXXXXXXXXGOOOOOOXXXXXXXXXXXXX,0,0,0

11550,67,0,67,53,380,0,0,383,283,100,GOOXXXXXXXXXXXXXXXXXGOOOOOXXXXXXXXXXXXXXGOOOOOOOXXXXXXXXXXXXGOOOXXXXXXXXXXXXXXXXGOOXXXXXXXXXXXXXXXXXGOOOOXXXXXXXXXXXXXXXGOOOOOOXXXXXXXXXXXXXGOOOOOOXXXXXXXXXXXXXGOOOOOXXXXXXXXXXXXXXGOOXXXXXXXXXXXXXXXXXGOOOOXXXXXXXXXXXXXXXGOOXXXXXXXXXXXXXXXXXGOOOOOOXXXXXXXXXXXXX,0,0,0
11571,67,0,67,52,381,0,0,383,283,100,GOOXXXXXXXXXXXXXXXXXGOOOOOXXXXXXXXXXXXXXGOOOOOOOXXXXXXXXXXXXGOOOXXXXXXXXXXXXXXXXGOOXXXXXXXXXXXXXXXXXGOOOOXXXXXXXXXXXXXXXGOOOOOOXXXXXXXXXXXXXGOOOOOOXXXXXXXXXXXXXGOOOOOXXXXXXXXXXXXXXGOOXXXXXXXXXXXXXXXXXGOOOOXXXXXXXXXXXXXXXGOOXXXXXXXXXXXXXXXXXGOOOOOOXXXXXXXXXXXXX,0,0,0
11592,67,0,67,50,383,0,0,386,284,102,GOOXXXXXXXXXXXXXXXXXGOOOOOXXXXXXXXXXXXXXGOOOOOOOXXXXXXXXXXXXGOOOXXXXXXXXXXXXXXXXGOOXXXXXXXXXXXXXXXXXGOOOOXXXXXXXXXXXXXXXGOOOOOOXXXXXXXXXXXXXGOOOOOOXXXXXXXXXXXXXGOOOOOXXXXXXXXXXXXXXGOOXXXXXXXXXXXXXXXXXGOOOOXXXXXXXXXXXXXXXGOOXXXXXXXXXXXXXXXXXGOOOOOOXXXXXXXXXXXXX,0,0,0
11613,68,1,67,48,384,0,0,387,280,107,GOOXXXXXXXXXXXXXXXXXGOOOOOXXXXXXXXXXXXXXGOOOOOOOXXXXXXXXXXXXGOOOXXXXXXXXXXXXXXXXGOOXXXXXXXXXXXXXXXXXGOOOOXXXXXXXXXXXXXXXGOOOOOOXXXXXXXXXXXXXGOOOOOOAXXXXXXXXXXXXGOOOOOXXXXXXXXXXXXXXGOOXXXXXXXXXXXXXXXXXGOOOOXXXXXXXXXXXXXXXGOOXXXXXXXXXXXXXXXXXGOOOOOOXXXXXXXXXXXXX,0,0,0
11634,68,1,67,48,384,0,0,387,281,106,GOOXXXXXXXXXXXXXXXXXGOOOOOXXXXXXXXXXXXXXGOOOOOOOXXXXXXXXXXXXGOOOXXXXXXXXXXXXXXXXGOOXXXXXXXXXXXXXXXXXGOOOOXXXXXXXXXXXXXXXGOOOOOOXXXXXXXXXXXXXGOOOOOOAXXXXXXXXXXXXGOOOOOXXXXXXXXXXXXXXGOOXXXXXXXXXXXXXXXXXGOOOOXXXXXXXXXXXXXXXGOOXXXXXXXXXXXXXXXXXGOOOOOOXXXXXXXXXXXXX,0,0,0

11655,68,1,67,47,385,0,0,388,283,105,GOOXXXXXXXXXXXXXXXXXGOOOOOXXXXXXXXXXXXXXGOOOOOOOXXXXXXXXXXXXGOOOXXXXXXXXXXXXXXXXGOOXXXXXXXXXXXXXXXXXGOOOOXXXXXXXXXXXXXXXGOOOOOOXXXXXXXXXXXXXGOOOOOOAXXXXXXXXXXXXGOOOOOXXXXXXXXXXXXXXGOOXXXXXXXXXXXXXXXXXGOOOOXXXXXXXXXXXXXXXGOOXXXXXXXXXXXXXXXXXGOOOOOOXXXXXXXXXXXXX,0,0,0
11676,68,1,67,52,380,0,0,383,283,100,GOOXXXXXXXXXXXXXXXXXGOOOOOXXXXXXXXXXXXXXGOOOOOOOXXXXXXXXXXXXGOOOXXXXXXXXXXXXXXXXGOOXXXXXXXXXXXXXXXXXGOOOOXXXXXXXXXXXXXXXGOOOOOOXXXXXXXXXXXXXGOOOOOOAXXXXXXXXXXXXGOOOOOXXXXXXXXXXXXXXGOOXXXXXXXXXXXXXXXXXGOOOOXXXXXXXXXXXXXXXGOOXXXXXXXXXXXXXXXXXGOOOOOOXXXXXXXXXXXXX,0,0,0
11697,68,0,68,46,386,0,0,389,285,104,GOOXXXXXXXXXXXXXXXXXGOOOOOXXXXXXXXXXXXXXGOOOOOOOXXXXXXXXXXXXGOOOXXXXXXXXXXXXXXXXGOOXXXXXXXXXXXXXXXXXGOOOOXXXXXXXXXXXXXXXGOOOOOOXXXXXXXXXXXXXGOOOOOOOXXXXXXXXXXXXGOOOOOXXXXXXXXXXXXXXGOOXXXXXXXXXXXXXXXXXGOOOOXXXXXXXXXXXXXXXGOOXXXXXXXXXXXXXXXXXGOOOOOOXXXXXXXXXXXXX,0,0,0
11718,68,0,68,42,390,0,0,394,287,107,GOOXXXXXXXXXXXXXXXXXGOOOOOXXXXXXXXXXXXXXGOOOOOOOXXXXXXXXXXXXGOOOXXXXXXXXXXXXXXXXGOOXXXXXXXXXXXXXXXXXGOOOOXXXXXXXXXXXXXXXGOOOOOOXXXXXXXXXXXXXGOOOOOOOXXXXXXXXXXXXGOOOOOXXXXXXXXXXXXXXGOOXXXXXXXXXXXXXXXXXGOOOOXXXXXXXXXXXXXXXGOOXXXXXXXXXXXXXXXXXGOOOOOOXXXXXXXXXXXXX,0,0,0
11739,68,0,68,43,389,0,0,394,286,108,GOOXXXXXXXXXXXXXXXXXGOOOOOXXXXXXXXXXXXXXGOOOOOOOXXXXXXXXXXXXGOOOXXXXXXXXXXXXXXXXGOOXXXXXXXXXXXXXXXXXGOOOOXXXXXXXXXXXXXXXGOOOOOOXXXXXXXXXXXXXGOOOOOOOXXXXXXXXXXXXGOOOOOXXXXXXXXXXXXXXGOOXXXXXXXXXXXXXXXXXGOOOOXXXXXXXXXXXXXXXGOOXXXXXXXXXXXXXXXXXGOOOOOOXXXXXXXXXXXXX,0,0,0

11760,68,0,68,45,387,0,0,391,285,106,GOOXXXXXXXXXXXXXXXXXGOOOOOXXXXXXXXXXXXXXGOOOOOOOXXXXXXXXXXXXGOOOXXXXXXXXXXXXXXXXGOOXXXXXXXXXXXXXXXXXGOOOOXXXXXXXXXXXXXXXGOOOOOOXXXXXXXXXXXXXGOOOOOOOXXXXXXXXXXXXGOOOOOXXXXXXXXXXXXXXGOOXXXXXXXXXXXXXXXXXGOOOOXXXXXXXXXXXXXXXGOOXXXXXXXXXXXXXXXXXGOOOOOOXXXXXXXXXXXXX,0,0,0
11781,68,0,68,46,386,0,0,391,283,108,GOOXXXXXXXXXXXXXXXXXGOOOOOXXXXXXXXXXXXXXGOOOOOOOXXXXXXXXXXXXGOOOXXXXXXXXXXXXXXXXGOOXXXXXXXXXXXXXXXXXGOOOOXXXXXXXXXXXXXXXGOOOOOOXXXXXXXXXXXXXGOOOOOOOXXXXXXXXXXXXGOOOOOXXXXXXXXXXXXXXGOOXXXXXXXXXXXXXXXXXGOOOOXXXXXXXXXXXXXXXGOOXXXXXXXXXXXXXXXXXGOOOOOOXXXXXXXXXXXXX,0,0,0
11802,68,0,68,47,385,0,0,390,284,106,GOOXXXXXXXXXXXXXXXXXGOOOOOXXXXXXXXXXXXXXGOOOOOOOXXXXXXXXXXXXGOOOXXXXXXXXXXXXXXXXGOOXXXXXXXXXXXXXXXXXGOOOOXXXXXXXXXXXXXXXGOOOOOOXXXXXXXXXXXXXGOOOOOOOXXXXXXXXXXXXGOOOOOXXXXXXXXXXXXXXGOOXXXXXXXXXXXXXXXXXGOOOOXXXXXXXXXXXXXXXGOOXXXXXXXXXXXXXXXXXGOOOOOOXXXXXXXXXXXXX,0,0,0
11823,68,0,68,49,383,0,0,388,283,105,GOOXXXXXXXXXXXXXXXXXGOOOOOXXXXXXXXXXXXXXGOOOOOOOXXXXXXXXXXXXGOOOXXXXXXXXXXXXXXXXGOOXXXXXXXXXXXXXXXXXGOOOOXXXXXXXXXXXXXXXGOOOOOOXXXXXXXXXXXXXGOOOOOOOXXXXXXXXXXXXGOOOOOXXXXXXXXXXXXXXGOOXXXXXXXXXXXXXXXXXGOOOOXXXXXXXXXXXXXXXGOOXXXXXXXXXXXXXXXXXGOOOOOOXXXXXXXXXXXXX,0,0,0
11844,68,0,68,52,380,0,0,385,284,101,GOOXXXXXXXXXXXXXXXXXGOOOOOXXXXXXXXXXXXXXGOOOOOOOXXXXXXXXXXXXGOOOXXXXXXXXXXXXXXXXGOOXXXXXXXXXXXXXXXXXGOOOOXXXXXXXXXXXXXXXGOOOOOOXXXXXXXXXXXXXGOOOOOOOXXXXXXXXXXXXGOOOOOXXXXXXXXXXXXXXGOOXXXXXXXXXXXXXXXXXGOOOOXXXXXXXXXXXXXXXGOOXXXXXXXXXXXXXXXXXGOOOOOOXXXXXXXXXXXXX,0,0,0

11865,68,0,68,62,370,0,0,375,284,91,GOOXXXXXXXXXXXXXXXXXGOOOOOXXXXXXXXXXXXXXGOOOOOOOXXXXXXXXXXXXGOOOXXXXXXXXXXXXXXXXGOOXXXXXXXXXXXXXXXXXGOOOOXXXXXXXXXXXXXXXGOOOOOOXXXXXXXXXXXXXGOOOOOOOXXXXXXXXXXXXGOOOOOXXXXXXXXXXXXXXGOOXXXXXXXXXXXXXXXXXGOOOOXXXXXXXXXXXXXXXGOOXXXXXXXXXXXXXXXXXGOOOOOOXXXXXXXXXXXXX,0,0,0
11886,68,0,68,58,374,0,0,379,284,95,GOOXXXXXXXXXXXXXXXXXGOOOOOXXXXXXXXXXXXXXGOOOOOOOXXXXXXXXXXXXGOOOXXXXXXXXXXXXXXXXGOOXXXXXXXXXXXXXXXXXGOOOOXXXXXXXXXXXXXXXGOOOOOOXXXXXXXXXXXXXGOOOOOOOXXXXXXXXXXXXGOOOOOXXXXXXXXXXXXXXGOOXXXXXXXXXXXXXXXXXGOOOOXXXXXXXXXXXXXXXGOOXXXXXXXXXXXXXXXXXGOOOOOOXXXXXXXXXXXXX,0,0,0
11907,68,0,68,59,373,0,0,378,284,94,GOOXXXXXXXXXXXXXXXXXGOOOOOXXXXXXXXXXXXXXGOOOOOOOXXXXXXXXXXXXGOOOXXXXXXXXXXXXXXXXGOOXXXXXXXXXXXXXXXXXGOOOOXXXXXXXXXXXXXXXGOOOOOOXXXXXXXXXXXXXGOOOOOOOXXXXXXXXXXXXGOOOOOXXXXXXXXXXXXXXGOOXXXXXXXXXXXXXXXXXGOOOOXXXXXXXXXXXXXXXGOOXXXXXXXXXXXXXXXXXGOOOOOOXXXXXXXXXXXXX,0,0,0
11928,68,0,68,52,380,0,0,384,285,99,GOOXXXXXXXXXXXXXXXXXGOOOOOXXXXXXXXXXXXXXGOOOOOOOXXXXXXXXXXXXGOOOXXXXXXXXXXXXXXXXGOOXXXXXXXXXXXXXXXXXGOOOOXXXXXXXXXXXXXXXGOOOOOOXXXXXXXXXXXXXGOOOOOOOXXXXXXXXXXXXGOOOOOXXXXXXXXXXXXXXGOOXXXXXXXXXXXXXXXXXGOOOOXXXXXXXXXXXXXXXGOOXXXXXXXXXXXXXXXXXGOOOOOOXXXXXXXXXXXXX,0,0,0
11949,68,0,68,52,380,0,0,385,283,102,GOOXXXXXXXXXXXXXXXXXGOOOOOXXXXXXXXXXXXXXGOOOOOOOXXXXXXXXXXXXGOOOXXXXXXXXXXXXXXXXGOOXXXXXXXXXXXXXXXXXGOOOOXXXXXXXXXXXXXXXGOOOOOOXXXXXXXXXXXXXGOOOOOOOXXXXXXXXXXXXGOOOOOXXXXXXXXXXXXXXGOOXXXXXXXXXXXXXXXXXGOOOOXXXXXXXXXXXXXXXGOOXXXXXXXXXXXXXXXXXGOOOOOOXXXXXXXXXXXXX,0,0,0

11970,69,1,68,52,379,0,0,384,284,100,GOOXXXXXXXXXXXXXXXXXGOOOOOXXXXXXXXXXXXXXGOOOOOOOXXXXXXXXXXXXGOOOXXXXXXXXXXXXXXXXGOOXXXXXXXXXXXXXXXXXGOOOOXXXXXXXXXXXXXXXGOOOOOOXXXXXXXXXXXXXGOOOOOOOXXXXXXXXXXXXGOOOOOXXXXXXXXXXXXXXGOOXXXXXXXXXXXXXXXXXGOOOOAXXXXXXXXXXXXXXGOOXXXXXXXXXXXXXXXXXGOOOOOOXXXXXXXXXXXXX,0,0,0
11991,69,1,68,52,379,0,0,384,289,95,GOOXXXXXXXXXXXXXXXXXGOOOOOXXXXXXXXXXXXXXGOOOOOOOXXXXXXXXXXXXGOOOXXXXXXXXXXXXXXXXGOOXXXXXXXXXXXXXXXXXGOOOOXXXXXXXXXXXXXXXGOOOOOOXXXXXXXXXXXXXGOOOOOOOXXXXXXXXXXXXGOOOOOXXXXXXXXXXXXXXGOOXXXXXXXXXXXXXXXXXGOOOOAXXXXXXXXXXXXXXGOOXXXXXXXXXXXXXXXXXGOOOOOOXXXXXXXXXXXXX,0,0,0
12012,69,1,68,54,377,0,0,382,285,97,GOOXXXXXXXXXXXXXXXXXGOOOOOXXXXXXXXXXXXXXGOOOOOOOXXXXXXXXXXXXGOOOXXXXXXXXXXXXXXXXGOOXXXXXXXXXXXXXXXXXGOOOOXXXXXXXXXXXXXXXGOOOOOOXXXXXXXXXXXXXGOOOOOOOXXXXXXXXXXXXGOOOOOXXXXXXXXXXXXXXGOOXXXXXXXXXXXXXXXXXGOOOOAXXXXXXXXXXXXXXGOOXXXXXXXXXXXXXXXXXGOOOOOOXXXXXXXXXXXXX,0,0,0
12033,69,1,68,50,381,0,0,385,286,99,GOOXXXXXXXXXXXXXXXXXGOOOOOXXXXXXXXXXXXXXGOOOOOOOXXXXXXXXXXXXGOOOXXXXXXXXXXXXXXXXGOOXXXXXXXXXXXXXXXXXGOOOOXXXXXXXXXXXXXXXGOOOOOOXXXXXXXXXXXXXGOOOOOOOXXXXXXXXXXXXGOOOOOXXXXXXXXXXXXXXGOOXXXXXXXXXXXXXXXXXGOOOOAXXXXXXXXXXXXXXGOOXXXXXXXXXXXXXXXXXGOOOOOOXXXXXXXXXXXXX,0,0,0
12054,69,1,68,57,374,0,0,379,292,87,GOOXXXXXXXXXXXXXXXXXGOOOOOXXXXXXXXXXXXXXGOOOOOOOXXXXXXXXXXXXGOOOXXXXXXXXXXXXXXXXGOOXXXXXXXXXXXXXXXXXGOOOOXXXXXXXXXXXXXXXGOOOOOOXXXXXXXXXXXXXGOOOOOOOXXXXXXXXXXXXGOOOOOXXXXXXXXXXXXXXGOOXXXXXXXXXXXXXXXXXGOOOOAXXXXXXXXXXXXXXGOOXXXXXXXXXXXXXXXXXGOOOOOOXXXXXXXXXXXXX,0,0,0

12075,69,1,68,58,373,0,0,378,285,93,GOOXXXXXXXXXXXXXXXXXGOOOOOXXXXXXXXXXXXXXGOOOOOOOXXXXXXXXXXXXGOOOXXXXXXXXXXXXXXXXGOOXXXXXXXXXXXXXXXXXGOOOOXXXXXXXXXXXXXXXGOOOOOOXXXXXXXXXXXXXGOOOOOOOXXXXXXXXXXXXGOOOOOXXXXXXXXXXXXXXGOOXXXXXXXXXXXXXXXXXGOOOOAXXXXXXXXXXXXXXGOOXXXXXXXXXXXXXXXXXGOOOOOOXXXXXXXXXXXXX,0,0,0
12096,69,1,68,63,368,0,0,372,285,87,GOOXXXXXXXXXXXXXXXXXGOOOOOXXXXXXXXXXXXXXGOOOOOOOXXXXXXXXXXXXGOOOXXXXXXXXXXXXXXXXGOOXXXXXXXXXXXXXXXXXGOOOOXXXXXXXXXXXXXXXGOOOOOOXXXXXXXXXXXXXGOOOOOOOXXXXXXXXXXXXGOOOOOXXXXXXXXXXXXXXGOOXXXXXXXXXXXXXXXXXGOOOOAXXXXXXXXXXXXXXGOOXXXXXXXXXXXXXXXXXGOOOOOOXXXXXXXXXXXXX,0,0,0
12117,69,1,68,56,375,0,0,377,287,90,GOOXXXXXXXXXXXXXXXXXGOOOOOXXXXXXXXXXXXXXGOOOOOOOXXXXXXXXXXXXGOOOXXXXXXXXXXXXXXXXGOOXXXXXXXXXXXXXXXXXGOOOOXXXXXXXXXXXXXXXGOOOOOOXXXXXXXXXXXXXGOOOOOOOXXXXXXXXXXXXGOOOOOXXXXXXXXXXXXXXGOOXXXXXXXXXXXXXXXXXGOOOOAXXXXXXXXXXXXXXGOOXXXXXXXXXXXXXXXXXGOOOOOOXXXXXXXXXXXXX,0,0,0
12138,69,1,68,55,376,0,0,379,287,92,GOOXXXXXXXXXXXXXXXXXGOOOOOXXXXXXXXXXXXXXGOOOOOOOXXXXXXXXXXXXGOOOXXXXXXXXXXXXXXXXGOOXXXXXXXXXXXXXXXXXGOOOOXXXXXXXXXXXXXXXGOOOOOOXXXXXXXXXXXXXGOOOOOOOXXXXXXXXXXXXGOOOOOXXXXXXXXXXXXXXGOOXXXXXXXXXXXXXXXXXGOOOOAXXXXXXXXXXXXXXGOOXXXXXXXXXXXXXXXXXGOOOOOOXXXXXXXXXXXXX,0,0,0
12159,69,1,68,58,373,0,0,376,287,89,GOOXXXXXXXXXXXXXXXXXGOOOOOXXXXXXXXXXXXXXGOOOOOOOXXXXXXXXXXXXGOOOXXXXXXXXXXXXXXXXGOOXXXXXXXXXXXXXXXXXGOOOOXXXXXXXXXXXXXXXGOOOOOOXXXXXXXXXXXXXGOOOOOOOXXXXXXXXXXXXGOOOOOXXXXXXXXXXXXXXGOOXXXXXXXXXXXXXXXXXGOOOOAXXXXXXXXXXXXXXGOOXXXXXXXXXXXXXXXXXGOOOOOOXXXXXXXXXXXXX,0,0,0

12180,69,1,68,57,374,0,0,377,286,91,GOOXXXXXXXXXXXXXXXXXGOOOOOXXXXXXXXXXXXXXGOOOOOOOXXXXXXXXXXXXGOOOXXXXXXXXXXXXXXXXGOOXXXXXXXXXXXXXXXXXGOOOOXXXXXXXXXXXXXXXGOOOOOOXXXXXXXXXXXXXGOOOOOOOXXXXXXXXXXXXGOOOOOXXXXXXXXXXXXXXGOOXXXXXXXXXXXXXXXXXGOOOOAXXXXXXXXXXXXXXGOOXXXXXXXXXXXXXXXXXGOOOOOOXXXXXXXXXXXXX,0,0,0
12201,69,1,68,55,376,0,0,379,286,93,GOOXXXXXXXXXXXXXXXXXGOOOOOXXXXXXXXXXXXXXGOOOOOOOXXXXXXXXXXXXGOOOXXXXXXXXXXXXXXXXGOOXXXXXXXXXXXXXXXXXGOOOOXXXXXXXXXXXXXXXGOOOOOOXXXXXXXXXXXXXGOOOOOOOXXXXXXXXXXXXGOOOOOXXXXXXXXXXXXXXGOOXXXXXXXXXXXXXXXXXGOOOOAXXXXXXXXXXXXXXGOOXXXXXXXXXXXXXXXXXGOOOOOOXXXXXXXXXXXXX,0,0,0
12222,69,1,68,49,382,0,0,385,289,96,GOOXXXXXXXXXXXXXXXXXGOOOOOXXXXXXXXXXXXXXGOOOOOOOXXXXXXXXXXXXGOOOXXXXXXXXXXXXXXXXGOOXXXXXXXXXXXXXXXXXGOOOOXXXXXXXXXXXXXXXGOOOOOOXXXXXXXXXXXXXGOOOOOOOXXXXXXXXXXXXGOOOOOXXXXXXXXXXXXXXGOOXXXXXXXXXXXXXXXXXGOOOOAXXXXXXXXXXXXXXGOOXXXXXXXXXXXXXXXXXGOOOOOOXXXXXXXXXXXXX,0,0,0
12243,69,1,68,44,387,0,0,388,287,101,GOOXXXXXXXXXXXXXXXXXGOOOOOXXXXXXXXXXXXXXGOOOOOOOXXXXXXXXXXXXGOOOXXXXXXXXXXXXXXXXGOOXXXXXXXXXXXXXXXXXGOOOOXXXXXXXXXXXXXXXGOOOOOOXXXXXXXXXXXXXGOOOOOOOXXXXXXXXXXXXGOOOOOXXXXXXXXXXXXXXGOOXXXXXXXXXXXXXXXXXGOOOOAXXXXXXXXXXXXXXGOOXXXXXXXXXXXXXXXXXGOOOOOOXXXXXXXXXXXXX,0,0,0
12264,69,1,68,44,387,0,0,390,285,105,GOOXXXXXXXXXXXXXXXXXGOOOOOXXXXXXXXXXXXXXGOOOOOOOXXXXXXXXXXXXGOOOXXXXXXXXXXXXXXXXGOOXXXXXXXXXXXXXXXXXGOOOOXXXXXXXXXXXXXXXGOOOOOOXXXXXXXXXXXXXGOOOOOOOXXXXXXXXXXXXGOOOOOXXXXXXXXXXXXXXGOOXXXXXXXXXXXXXXXXXGOOOOAXXXXXXXXXXXXXXGOOXXXXXXXXXXXXXXXXXGOOOOOOXXXXXXXXXXXXX,0,0,0

12285,69,0,69,42,389,0,0,392,289,103,GOOXXXXXXXXXXXXXXXXXGOOOOOXXXXXXXXXXXXXXGOOOOOOOXXXXXXXXXXXXGOOOXXXXXXXXXXXXXXXXGOOXXXXXXXXXXXXXXXXXGOOOOXXXXXXXXXXXXXXXGOOOOOOXXXXXXXXXXXXXGOOOOOOOXXXXXXXXXXXXGOOOOOXXXXXXXXXXXXXXGOOXXXXXXXXXXXXXXXXXGOOOOOXXXXXXXXXXXXXXGOOXXXXXXXXXXXXXXXXXGOOOOOOXXXXXXXXXXXXX,0,0,0
12306,69,0,69,41,390,0,0,394,291,103,GOOXXXXXXXXXXXXXXXXXGOOOOOXXXXXXXXXXXXXXGOOOOOOOXXXXXXXXXXXXGOOOXXXXXXXXXXXXXXXXGOOXXXXXXXXXXXXXXXXXGOOOOXXXXXXXXXXXXXXXGOOOOOOXXXXXXXXXXXXXGOOOOOOOXXXXXXXXXXXXGOOOOOXXXXXXXXXXXXXXGOOXXXXXXXXXXXXXXXXXGOOOOOXXXXXXXXXXXXXXGOOXXXXXXXXXXXXXXXXXGOOOOOOXXXXXXXXXXXXX,0,0,0
12327,69,0,69,44,387,0,0,391,289,102,GOOXXXXXXXXXXXXXXXXXGOOOOOXXXXXXXXXXXXXXGOOOOOOOXXXXXXXXXXXXGOOOXXXXXXXXXXXXXXXXGOOXXXXXXXXXXXXXXXXXGOOOOXXXXXXXXXXXXXXXGOOOOOOXXXXXXXXXXXXXGOOOOOOOXXXXXXXXXXXXGOOOOOXXXXXXXXXXXXXXGOOXXXXXXXXXXXXXXXXXGOOOOOXXXXXXXXXXXXXXGOOXXXXXXXXXXXXXXXXXGOOOOOOXXXXXXXXXXXXX,0,0,0
12348,69,0,69,43,388,0,0,391,291,100,GOOXXXXXXXXXXXXXXXXXGOOOOOXXXXXXXXXXXXXXGOOOOOOOXXXXXXXXXXXXGOOOXXXXXXXXXXXXXXXXGOOXXXXXXXXXXXXXXXXXGOOOOXXXXXXXXXXXXXXXGOOOOOOXXXXXXXXXXXXXGOOOOOOOXXXXXXXXXXXXGOOOOOXXXXXXXXXXXXXXGOOXXXXXXXXXXXXXXXXXGOOOOOXXXXXXXXXXXXXXGOOXXXXXXXXXXXXXXXXXGOOOOOOXXXXXXXXXXXXX,0,0,0
12369,69,0,69,43,388,0,0,392,293,99,GOOXXXXXXXXXXXXXXXXXGOOOOOXXXXXXXXXXXXXXGOOOOOOOXXXXXXXXXXXXGOOOXXXXXXXXXXXXXXXXGOOXXXXXXXXXXXXXXXXXGOOOOXXXXXXXXXXXXXXXGOOOOOOXXXXXXXXXXXXXGOOOOOOOXXXXXXXXXXXXGOOOOOXXXXXXXXXXXXXXGOOXXXXXXXXXXXXXXXXXGOOOOOXXXXXXXXXXXXXXGOOXXXXXXXXXXXXXXXXXGOOOOOOXXXXXXXXXXXXX,0,0,0

12390,69,0,69,48,383,0,0,388,292,96,GOOXXXXXXXXXXXXXXXXXGOOOOOXXXXXXXXXXXXXXGOOOOOOOXXXXXXXXXXXXGOOOXXXXXXXXXXXXXXXXGOOXXXXXXXXXXXXXXXXXGOOOOXXXXXXXXXXXXXXXGOOOOOOXXXXXXXXXXXXXGOOOOOOOXXXXXXXXXXXXGOOOOOXXXXXXXXXXXXXXGOOXXXXXXXXXXXXXXXXXGOOOOOXXXXXXXXXXXXXXGOOXXXXXXXXXXXXXXXXXGOOOOOOXXXXXXXXXXXXX,0,0,0
12411,69,0,69,49,382,0,0,387,297,90,GOOXXXXXXXXXXXXXXXXXGOOOOOXXXXXXXXXXXXXXGOOOOOOOXXXXXXXXXXXXGOOOXXXXXXXXXXXXXXXXGOOXXXXXXXXXXXXXXXXXGOOOOXXXXXXXXXXXXXXXGOOOOOOXXXXXXXXXXXXXGOOOOOOOXXXXXXXXXXXXGOOOOOXXXXXXXXXXXXXXGOOXXXXXXXXXXXXXXXXXGOOOOOXXXXXXXXXXXXXXGOOXXXXXXXXXXXXXXXXXGOOOOOOXXXXXXXXXXXXX,0,0,0
12432,69,0,69,49,382,0,0,385,291,94,GOOXXXXXXXXXXXXXXXXXGOOOOOXXXXXXXXXXXXXXGOOOOOOOXXXXXXXXXXXXGOOOXXXXXXXXXXXXXXXXGOOXXXXXXXXXXXXXXXXXGOOOOXXXXXXXXXXXXXXXGOOOOOOXXXXXXXXXXXXXGOOOOOOOXXXXXXXXXXXXGOOOOOXXXXXXXXXXXXXXGOOXXXXXXXXXXXXXXXXXGOOOOOXXXXXXXXXXXXXXGOOXXXXXXXXXXXXXXXXXGOOOOOOXXXXXXXXXXXXX,0,0,0
12453,69,0,69,51,380,0,0,384,292,92,GOOXXXXXXXXXXXXXXXXXGOOOOOXXXXXXXXXXXXXXGOOOOOOOXXXXXXXXXXXXGOOOXXXXXXXXXXXXXXXXGOOXXXXXXXXXXXXXXXXXGOOOOXXXXXXXXXXXXXXXGOOOOOOXXXXXXXXXXXXXGOOOOOOOXXXXXXXXXXXXGOOOOOXXXXXXXXXXXXXXGOOXXXXXXXXXXXXXXXXXGOOOOOXXXXXXXXXXXXXXGOOXXXXXXXXXXXXXXXXXGOOOOOOXXXXXXXXXXXXX,0,0,0
12474,69,0,69,50,381,0,0,385,294,91,GOOXXXXXXXXXXXXXXXXXGOOOOOXXXXXXXXXXXXXXGOOOOOOOXXXXXXXXXXXXGOOOXXXXXXXXXXXXXXXXGOOXXXXXXXXXXXXXXXXXGOOOOXXXXXXXXXXXXXXXGOOOOOOXXXXXXXXXXXXXGOOOOOOOXXXXXXXXXXXXGOOOOOXXXXXXXXXXXXXXGOOXXXXXXXXXXXXXXXXXGOOOOOXXXXXXXXXXXXXXGOOXXXXXXXXXXXXXXXXXGOOOOOOXXXXXXXXXXXXX,0,0,0

12495,69,0,69,51,380,0,0,383,295,88,GOOXXXXXXXXXXXXXXXXXGOOOOOXXXXXXXXXXXXXXGOOOOOOOXXXXXXXXXXXXGOOOXXXXXXXXXXXXXXXXGOOXXXXXXXXXXXXXXXXXGOOOOXXXXXXXXXXXXXXXGOOOOOOXXXXXXXXXXXXXGOOOOOOOXXXXXXXXXXXXGOOOOOXXXXXXXXXXXXXXGOOXXXXXXXXXXXXXXXXXGOOOOOXXXXXXXXXXXXXXGOOXXXXXXXXXXXXXXXXXGOOOOOOXXXXXXXXXXXXX,0,0,0
12516,69,0,69,49,382,0,0,385,298,87,GOOXXXXXXXXXXXXXXXXXGOOOOOXXXXXXXXXXXXXXGOOOOOOOXXXXXXXXXXXXGOOOXXXXXXXXXXXXXXXXGOOXXXXXXXXXXXXXXXXXGOOOOXXXXXXXXXXXXXXXGOOOOOOXXXXXXXXXXXXXGOOOOOOOXXXXXXXXXXXXGOOOOOXXXXXXXXXXXXXXGOOXXXXXXXXXXXXXXXXXGOOOOOXXXXXXXXXXXXXXGOOXXXXXXXXXXXXXXXXXGOOOOOOXXXXXXXXXXXXX,0,0,0
12537,69,0,69,55,376,0,0,381,294,87,GOOXXXXXXXXXXXXXXXXXGOOOOOXXXXXXXXXXXXXXGOOOOOOOXXXXXXXXXXXXGOOOXXXXXXXXXXXXXXXXGOOXXXXXXXXXXXXXXXXXGOOOOXXXXXXXXXXXXXXXGOOOOOOXXXXXXXXXXXXXGOOOOOOOXXXXXXXXXXXXGOOOOOXXXXXXXXXXXXXXGOOXXXXXXXXXXXXXXXXXGOOOOOXXXXXXXXXXXXXXGOOXXXXXXXXXXXXXXXXXGOOOOOOXXXXXXXXXXXXX,0,0,0
12558,69,0,69,54,377,0,0,382,293,89,GOOXXXXXXXXXXXXXXXXXGOOOOOXXXXXXXXXXXXXXGOOOOOOOXXXXXXXXXXXXGOOOXXXXXXXXXXXXXXXXGOOXXXXXXXXXXXXXXXXXGOOOOXXXXXXXXXXXXXXXGOOOOOOXXXXXXXXXXXXXGOOOOOOOXXXXXXXXXXXXGOOOOOXXXXXXXXXXXXXXGOOXXXXXXXXXXXXXXXXXGOOOOOXXXXXXXXXXXXXXGOOXXXXXXXXXXXXXXXXXGOOOOOOXXXXXXXXXXXXX,0,0,0
12579,69,0,69,51,380,0,0,385,295,90,GOOXXXXXXXXXXXXXXXXXGOOOOOXXXXXXXXXXXXXXGOOOOOOOXXXXXXXXXXXXGOOOXXXXXXXXXXXXXXXXGOOXXXXXXXXXXXXXXXXXGOOOOXXXXXXXXXXXXXXXGOOOOOOXXXXXXXXXXXXXGOOOOOOOXXXXXXXXXXXXGOOOOOXXXXXXXXXXXXXXGOOXXXXXXXXXXXXXXXXXGOOOOOXXXXXXXXXXXXXXGOOXXXXXXXXXXXXXXXXXGOOOOOOXXXXXXXXXXXXX,0,0,0

12600,69,0,69,43,388,0,0,392,295,97,GOOXXXXXXXXXXXXXXXXXGOOOOOXXXXXXXXXXXXXXGOOOOOOOXXXXXXXXXXXXGOOOXXXXXXXXXXXXXXXXGOOXXXXXXXXXXXXXXXXXGOOOOXXXXXXXXXXXXXXXGOOOOOOXXXXXXXXXXXXXGOOOOOOOXXXXXXXXXXXXGOOOOOXXXXXXXXXXXXXXGOOXXXXXXXXXXXXXXXXXGOOOOOXXXXXXXXXXXXXXGOOXXXXXXXXXXXXXXXXXGOOOOOOXXXXXXXXXXXXX,0,0,0
12621,70,1,69,40,390,0,0,394,293,101,GOOXXXXXXXXXXXXXXXXXGOOOOOXXXXXXXXXXXXXXGOOOOOOOXXXXXXXXXXXXGOOOXXXXXXXXXXXXXXXXGOOXXXXXXXXXXXXXXXXXGOOOOXXXXXXXXXXXXXXXGOOOOOOXXXXXXXXXXXXXGOOOOOOOXXXXXXXXXXXXGOOOOOXXXXXXXXXXXXXXGOOXXXXXXXXXXXXXXXXXGOOOOOXXXXXXXXXXXXXXGOOXXXXXXXXXXXXXXXXXGOOOOOOAXXXXXXXXXXXX,0,0,0
12642,70,1,69,42,388,0,0,392,295,97,GOOXXXXXXXXXXXXXXXXXGOOOOOXXXXXXXXXXXXXXGOOOOOOOXXXXXXXXXXXXGOOOXXXXXXXXXXXXXXXXGOOXXXXXXXXXXXXXXXXXGOOOOXXXXXXXXXXXXXXXGOOOOOOXXXXXXXXXXXXXGOOOOOOOXXXXXXXXXXXXGOOOOOXXXXXXXXXXXXXXGOOXXXXXXXXXXXXXXXXXGOOOOOXXXXXXXXXXXXXXGOOXXXXXXXXXXXXXXXXXGOOOOOOAXXXXXXXXXXXX,0,0,0
12663,70,1,69,42,388,0,0,391,294,97,GOOXXXXXXXXXXXXXXXXXGOOOOOXXXXXXXXXXXXXXGOOOOOOOXXXXXXXXXXXXGOOOXXXXXXXXXXXXXXXXGOOXXXXXXXXXXXXXXXXXGOOOOXXXXXXXXXXXXXXXGOOOOOOXXXXXXXXXXXXXGOOOOOOOXXXXXXXXXXXXGOOOOOXXXXXXXXXXXXXXGOOXXXXXXXXXXXXXXXXXGOOOOOXXXXXXXXXXXXXXGOOXXXXXXXXXXXXXXXXXGOOOOOOAXXXXXXXXXXXX,0,0,0
12684,70,1,69,45,385,0,0,389,296,93,GOOXXXXXXXXXXXXXXXXXGOOOOOXXXXXXXXXXXXXXGOOOOOOOXXXXXXXXXXXXGOOOXXXXXXXXXXXXXXXXGOOXXXXXXXXXXXXXXXXXGOOOOXXXXXXXXXXXXXXXGOOOOOOXXXXXXXXXXXXXGOOOOOOOXXXXXXXXXXXXGOOOOOXXXXXXXXXXXXXXGOOXXXXXXXXXXXXXXXXXGOOOOOXXXXXXXXXXXXXXGOOXXXXXXXXXXXXXXXXXGOOOOOOAXXXXXXXXXXXX,0,0,0

12705,70,1,69,46,384,0,0,388,294,94,GOOXXXXXXXXXXXXXXXXXGOOOOOXXXXXXXXXXXXXXGOOOOOOOXXXXXXXXXXXXGOOOXXXXXXXXXXXXXXXXGOOXXXXXXXXXXXXXXXXXGOOOOXXXXXXXXXXXXXXXGOOOOOOXXXXXXXXXXXXXGOOOOOOOXXXXXXXXXXXXGOOOOOXXXXXXXXXXXXXXGOOXXXXXXXXXXXXXXXXXGOOOOOXXXXXXXXXXXXXXGOOXXXXXXXXXXXXXXXXXGOOOOOOAXXXXXXXXXXXX,0,0,0
12726,70,1,69,43,387,0,0,391,293,98,GOOXXXXXXXXXXXXXXXXXGOOOOOXXXXXXXXXXXXXXGOOOOOOOXXXXXXXXXXXXGOOOXXXXXXXXXXXXXXXXGOOXXXXXXXXXXXXXXXXXGOOOOXXXXXXXXXXXXXXXGOOOOOOXXXXXXXXXXXXXGOOOOOOOXXXXXXXXXXXXGOOOOOXXXXXXXXXXXXXXGOOXXXXXXXXXXXXXXXXXGOOOOOXXXXXXXXXXXXXXGOOXXXXXXXXXXXXXXXXXGOOOOOOAXXXXXXXXXXXX,0,0,0
12747,70,1,69,48,382,0,0,386,292,94,GOOXXXXXXXXXXXXXXXXXGOOOOOXXXXXXXXXXXXXXGOOOOOOOXXXXXXXXXXXXGOOOXXXXXXXXXXXXXXXXGOOXXXXXXXXXXXXXXXXXGOOOOXXXXXXXXXXXXXXXGOOOOOOXXXXXXXXXXXXXGOOOOOOOXXXXXXXXXXXXGOOOOOXXXXXXXXXXXXXXGOOXXXXXXXXXXXXXXXXXGOOOOOXXXXXXXXXXXXXXGOOXXXXXXXXXXXXXXXXXGOOOOOOAXXXXXXXXXXXX,0,0,0
12768,70,1,69,50,380,0,0,383,295,88,GOOXXXXXXXXXXXXXXXXXGOOOOOXXXXXXXXXXXXXXGOOOOOOOXXXXXXXXXXXXGOOOXXXXXXXXXXXXXXXXGOOXXXXXXXXXXXXXXXXXGOOOOXXXXXXXXXXXXXXXGOOOOOOXXXXXXXXXXXXXGOOOOOOOXXXXXXXXXXXXGOOOOOXXXXXXXXXXXXXXGOOXXXXXXXXXXXXXXXXXGOOOOOXXXXXXXXXXXXXXGOOXXXXXXXXXXXXXXXXXGOOOOOOAXXXXXXXXXXXX,0,0,0
12789,70,1,69,50,380,0,0,384,295,89,GOOXXXXXXXXXXXXXXXXXGOOOOOXXXXXXXXXXXXXXGOOOOOOOXXXXXXXXXXXXGOOOXXXXXXXXXXXXXXXXGOOXXXXXXXXXXXXXXXXXGOOOOXXXXXXXXXXXXXXXGOOOOOOXXXXXXXXXXXXXGOOOOOOOXXXXXXXXXXXXGOOOOOXXXXXXXXXXXXXXGOOXXXXXXXXXXXXXXXXXGOOOOOXXXXXXXXXXXXXXGOOXXXXXXXXXXXXXXXXXGOOOOOOAXXXXXXXXXXXX,0,0,0

12810,70,1,69,54,376,0,0,380,295,85,GOOXXXXXXXXXXXXXXXXXGOOOOOXXXXXXXXXXXXXXGOOOOOOOXXXXXXXXXXXXGOOOXXXXXXXXXXXXXXXXGOOXXXXXXXXXXXXXXXXXGOOOOXXXXXXXXXXXXXXXGOOOOOOXXXXXXXXXXXXXGOOOOOOOXXXXXXXXXXXXGOOOOOXXXXXXXXXXXXXXGOOXXXXXXXXXXXXXXXXXGOOOOOXXXXXXXXXXXXXXGOOXXXXXXXXXXXXXXXXXGOOOOOOAXXXXXXXXXXXX,0,0,0
12831,70,1,69,52,378,0,0,381,295,86,GOOXXXXXXXXXXXXXXXXXGOOOOOXXXXXXXXXXXXXXGOOOOOOOXXXXXXXXXXXXGOOOXXXXXXXXXXXXXXXXGOOXXXXXXXXXXXXXXXXXGOOOOXXXXXXXXXXXXXXXGOOOOOOXXXXXXXXXXXXXGOOOOOOOXXXXXXXXXXXXGOOOOOXXXXXXXXXXXXXXGOOXXXXXXXXXXXXXXXXXGOOOOOXXXXXXXXXXXXXXGOOXXXXXXXXXXXXXXXXXGOOOOOOAXXXXXXXXXXXX,0,0,0
12852,70,1,69,51,379,0,0,383,297,86,GOOXXXXXXXXXXXXXXXXXGOOOOOXXXXXXXXXXXXXXGOOOOOOOXXXXXXXXXXXXGOOOXXXXXXXXXXXXXXXXGOOXXXXXXXXXXXXXXXXXGOOOOXXXXXXXXXXXXXXXGOOOOOOXXXXXXXXXXXXXGOOOOOOOXXXXXXXXXXXXGOOOOOXXXXXXXXXXXXXXGOOXXXXXXXXXXXXXXXXXGOOOOOXXXXXXXXXXXXXXGOOXXXXXXXXXXXXXXXXXGOOOOOOAXXXXXXXXXXXX,0,0,0
12873,70,0,70,55,375,0,0,377,296,81,GOOXXXXXXXXXXXXXXXXXGOOOOOXXXXXXXXXXXXXXGOOOOOOOXXXXXXXXXXXXGOOOXXXXXXXXXXXXXXXXGOOXXXXXXXXXXXXXXXXXGOOOOXXXXXXXXXXXXXXXGOOOOOOXXXXXXXXXXXXXGOOOOOOOXXXXXXXXXXXXGOOOOOXXXXXXXXXXXXXXGOOXXXXXXXXXXXXXXXXXGOOOOOXXXXXXXXXXXXXXGOOXXXXXXXXXXXXXXXXXGOOOOOOOXXXXXXXXXXXX,0,0,0
12894,70,0,70,52,378,0,0,379,296,83,GOOXXXXXXXXXXXXXXXXXGOOOOOXXXXXXXXXXXXXXGOOOOOOOXXXXXXXXXXXXGOOOXXXXXXXXXXXXXXXXGOOXXXXXXXXXXXXXXXXXGOOOOXXXXXXXXXXXXXXXGOOOOOOXXXXXXXXXXXXXGOOOOOOOXXXXXXXXXXXXGOOOOOXXXXXXXXXXXXXXGOOXXXXXXXXXXXXXXXXXGOOOOOXXXXXXXXXXXXXXGOOXXXXXXXXXXXXXXXXXGOOOOOOOXXXXXXXXXXXX,0,0,0

12915,70,0,70,49,381,0,0,384,293,91,GOOXXXXXXXXXXXXXXXXXGOOOOOXXXXXXXXXXXXXXGOOOOOOOXXXXXXXXXXXXGOOOXXXXXXXXXXXXXXXXGOOXXXXXXXXXXXXXXXXXGOOOOXXXXXXXXXXXXXXXGOOOOOOXXXXXXXXXXXXXGOOOOOOOXXXXXXXXXXXXGOOOOOXXXXXXXXXXXXXXGOOXXXXXXXXXXXXXXXXXGOOOOOXXXXXXXXXXXXXXGOOXXXXXXXXXXXXXXXXXGOOOOOOOXXXXXXXXXXXX,0,0,0
12936,70,0,70,49,381,0,0,385,299,86,GOOXXXXXXXXXXXXXXXXXGOOOOOXXXXXXXXXXXXXXGOOOOOOOXXXXXXXXXXXXGOOOXXXXXXXXXXXXXXXXGOOXXXXXXXXXXXXXXXXXGOOOOXXXXXXXXXXXXXXXGOOOOOOXXXXXXXXXXXXXGOOOOOOOXXXXXXXXXXXXGOOOOOXXXXXXXXXXXXXXGOOXXXXXXXXXXXXXXXXXGOOOOOXXXXXXXXXXXXXXGOOXXXXXXXXXXXXXXXXXGOOOOOOOXXXXXXXXXXXX,0,0,0
12957,70,0,70,52,378,0,0,382,300,82,GOOXXXXXXXXXXXXXXXXXGOOOOOXXXXXXXXXXXXXXGOOOOOOOXXXXXXXXXXXXGOOOXXXXXXXXXXXXXXXXGOOXXXXXXXXXXXXXXXXXGOOOOXXXXXXXXXXXXXXXGOOOOOOXXXXXXXXXXXXXGOOOOOOOXXXXXXXXXXXXGOOOOOXXXXXXXXXXXXXXGOOXXXXXXXXXXXXXXXXXGOOOOOXXXXXXXXXXXXXXGOOXXXXXXXXXXXXXXXXXGOOOOOOOXXXXXXXXXXXX,0,0,0
12978,70,0,70,53,377,0,0,381,302,79,GOOXXXXXXXXXXXXXXXXXGOOOOOXXXXXXXXXXXXXXGOOOOOOOXXXXXXXXXXXXGOOOXXXXXXXXXXXXXXXXGOOXXXXXXXXXXXXXXXXXGOOOOXXXXXXXXXXXXXXXGOOOOOOXXXXXXXXXXXXXGOOOOOOOXXXXXXXXXXXXGOOOOOXXXXXXXXXXXXXXGOOXXXXXXXXXXXXXXXXXGOOOOOXXXXXXXXXXXXXXGOOXXXXXXXXXXXXXXXXXGOOOOOOOXXXXXXXXXXXX,0,0,0
12999,70,0,70,54,376,0,0,380,298,82,GOOXXXXXXXXXXXXXXXXXGOOOOOXXXXXXXXXXXXXXGOOOOOOOXXXXXXXXXXXXGOOOXXXXXXXXXXXXXXXXGOOXXXXXXXXXXXXXXXXXGOOOOXXXXXXXXXXXXXXXGOOOOOOXXXXXXXXXXXXXGOOOOOOOXXXXXXXXXXXXGOOOOOXXXXXXXXXXXXXXGOOXXXXXXXXXXXXXXXXXGOOOOOXXXXXXXXXXXXXXGOOXXXXXXXXXXXXXXXXXGOOOOOOOXXXXXXXXXXXX,0,0,0

13020,70,0,70,53,377,0,0,381,298,83,GOOXXXXXXXXXXXXXXXXXGOOOOOXXXXXXXXXXXXXXGOOOOOOOXXXXXXXXXXXXGOOOXXXXXXXXXXXXXXXXGOOXXXXXXXXXXXXXXXXXGOOOOXXXXXXXXXXXXXXXGOOOOOOXXXXXXXXXXXXXGOOOOOOOXXXXXXXXXXXXGOOOOOXXXXXXXXXXXXXXGOOXXXXXXXXXXXXXXXXXGOOOOOXXXXXXXXXXXXXXGOOXXXXXXXXXXXXXXXXXGOOOOOOOXXXXXXXXXXXX,0,0,0
13041,70,0,70,52,378,0,0,381,297,84,GOOXXXXXXXXXXXXXXXXXGOOOOOXXXXXXXXXXXXXXGOOOOOOOXXXXXXXXXXXXGOOOXXXXXXXXXXXXXXXXGOOXXXXXXXXXXXXXXXXXGOOOOXXXXXXXXXXXXXXXGOOOOOOXXXXXXXXXXXXXGOOOOOOOXXXXXXXXXXXXGOOOOOXXXXXXXXXXXXXXGOOXXXXXXXXXXXXXXXXXGOOOOOXXXXXXXXXXXXXXGOOXXXXXXXXXXXXXXXXXGOOOOOOOXXXXXXXXXXXX,0,0,0
13062,70,0,70,51,379,0,0,383,296,87,GOOXXXXXXXXXXXXXXXXXGOOOOOXXXXXXXXXXXXXXGOOOOOOOXXXXXXXXXXXXGOOOXXXXXXXXXXXXXXXXGOOXXXXXXXXXXXXXXXXXGOOOOXXXXXXXXXXXXXXXGOOOOOOXXXXXXXXXXXXXGOOOOOOOXXXXXXXXXXXXGOOOOOXXXXXXXXXXXXXXGOOXXXXXXXXXXXXXXXXXGOOOOOXXXXXXXXXXXXXXGOOXXXXXXXXXXXXXXXXXGOOOOOOOXXXXXXXXXXXX,0,0,0
13083,70,0,70,51,379,0,0,382,296,86,GOOXXXXXXXXXXXXXXXXXGOOOOOXXXXXXXXXXXXXXGOOOOOOOXXXXXXXXXXXXGOOOXXXXXXXXXXXXXXXXGOOXXXXXXXXXXXXXXXXXGOOOOXXXXXXXXXXXXXXXGOOOOOOXXXXXXXXXXXXXGOOOOOOOXXXXXXXXXXXXGOOOOOXXXXXXXXXXXXXXGOOXXXXXXXXXXXXXXXXXGOOOOOXXXXXXXXXXXXXXGOOXXXXXXXXXXXXXXXXXGOOOOOOOXXXXXXXXXXXX,0,0,0
13104,70,0,70,54,376,0,0,380,296,84,GOOXXXXXXXXXXXXXXXXXGOOOOOXXXXXXXXXXXXXXGOOOOOOOXXXXXXXXXXXXGOOOXXXXXXXXXXXXXXXXGOOXXXXXXXXXXXXXXXXXGOOOOXXXXXXXXXXXXXXXGOOOOOOXXXXXXXXXXXXXGOOOOOOOXXXXXXXXXXXXGOOOOOXXXXXXXXXXXXXXGOOXXXXXXXXXXXXXXXXXGOOOOOXXXXXXXXXXXXXXGOOXXXXXXXXXXXXXXXXXGOOOOOOOXXXXXXXXXXXX,0,0,0

13125,70,0,70,51,379,0,0,383,295,88,GOOXXXXXXXXXXXXXXXXXGOOOOOXXXXXXXXXXXXXXGOOOOOOOXXXXXXXXXXXXGOOOXXXXXXXXXXXXXXXXGOOXXXXXXXXXXXXXXXXXGOOOOXXXXXXXXXXXXXXXGOOOOOOXXXXXXXXXXXXXGOOOOOOOXXXXXXXXXXXXGOOOOOXXXXXXXXXXXXXXGOOXXXXXXXXXXXXXXXXXGOOOOOXXXXXXXXXXXXXXGOOXXXXXXXXXXXXXXXXXGOOOOOOOXXXXXXXXXXXX,0,0,0
13146,70,0,70,50,380,0,0,384,298,86,GOOXXXXXXXXXXXXXXXXXGOOOOOXXXXXXXXXXXXXXGOOOOOOOXXXXXXXXXXXXGOOOXXXXXXXXXXXXXXXXGOOXXXXXXXXXXXXXXXXXGOOOOXXXXXXXXXXXXXXXGOOOOOOXXXXXXXXXXXXXGOOOOOOOXXXXXXXXXXXXGOOOOOXXXXXXXXXXXXXXGOOXXXXXXXXXXXXXXXXXGOOOOOXXXXXXXXXXXXXXGOOXXXXXXXXXXXXXXXXXGOOOOOOOXXXXXXXXXXXX,0,0,0
13167,71,1,70,45,384,0,0,388,298,90,GOOXXXXXXXXXXXXXXXXXGOOOOOXXXXXXXXXXXXXXGOOOOOOOXXXXXXXXXXXXGOOOXXXXXXXXXXXXXXXXGOOXXXXXXXXXXXXXXXXXGOOOOXXXXXXXXXXXXXXXGOOOOOOXXXXXXXXXXXXXGOOOOOOOXXXXXXXXXXXXGOOOOOAXXXXXXXXXXXXXGOOXXXXXXXXXXXXXXXXXGOOOOOXXXXXXXXXXXXXXGOOXXXXXXXXXXXXXXXXXGOOOOOOOXXXXXXXXXXXX,0,0,0
13188,71,1,70,40,389,0,0,393,301,92,GOOXXXXXXXXXXXXXXXXXGOOOOOXXXXXXXXXXXXXXGOOOOOOOXXXXXXXXXXXXGOOOXXXXXXXXXXXXXXXXGOOXXXXXXXXXXXXXXXXXGOOOOXXXXXXXXXXXXXXXGOOOOOOXXXXXXXXXXXXXGOOOOOOOXXXXXXXXXXXXGOOOOOAXXXXXXXXXXXXXGOOXXXXXXXXXXXXXXXXXGOOOOOXXXXXXXXXXXXXXGOOXXXXXXXXXXXXXXXXXGOOOOOOOXXXXXXXXXXXX,0,0,0
13209,71,1,70,40,389,0,0,393,300,93,GOOXXXXXXXXXXXXXXXXXGOOOOOXXXXXXXXXXXXXXGOOOOOOOXXXXXXXXXXXXGOOOXXXXXXXXXXXXXXXXGOOXXXXXXXXXXXXXXXXXGOOOOXXXXXXXXXXXXXXXGOOOOOOXXXXXXXXXXXXXGOOOOOOOXXXXXXXXXXXXGOOOOOAXXXXXXXXXXXXXGOOXXXXXXXXXXXXXXXXXGOOOOOXXXXXXXXXXXXXXGOOXXXXXXXXXXXXXXXXXGOOOOOOOXXXXXXXXXXXX,0,0,0

13230,71,1,70,37,392,0,0,395,303,92,GOOXXXXXXXXXXXXXXXXXGOOOOOXXXXXXXXXXXXXXGOOOOOOOXXXXXXXXXXXXGOOOXXXXXXXXXXXXXXXXGOOXXXXXXXXXXXXXXXXXGOOOOXXXXXXXXXXXXXXXGOOOOOOXXXXXXXXXXXXXGOOOOOOOXXXXXXXXXXXXGOOOOOAXXXXXXXXXXXXXGOOXXXXXXXXXXXXXXXXXGOOOOOXXXXXXXXXXXXXXGOOXXXXXXXXXXXXXXXXXGOOOOOOOXXXXXXXXXXXX,0,0,0
13251,71,1,70,39,390,0,0,395,305,90,GOOXXXXXXXXXXXXXXXXXGOOOOOXXXXXXXXXXXXXXGOOOOOOOXXXXXXXXXXXXGOOOXXXXXXXXXXXXXXXXGOOXXXXXXXXXXXXXXXXXGOOOOXXXXXXXXXXXXXXXGOOOOOOXXXXXXXXXXXXXGOOOOOOOXXXXXXXXXXXXGOOOOOAXXXXXXXXXXXXXGOOXXXXXXXXXXXXXXXXXGOOOOOXXXXXXXXXXXXXXGOOXXXXXXXXXXXXXXXXXGOOOOOOOXXXXXXXXXXXX,0,0,0
13272,71,1,70,41,388,0,0,393,303,90,GOOXXXXXXXXXXXXXXXXXGOOOOOXXXXXXXXXXXXXXGOOOOOOOXXXXXXXXXXXXGOOOXXXXXXXXXXXXXXXXGOOXXXXXXXXXXXXXXXXXGOOOOXXXXXXXXXXXXXXXGOOOOOOXXXXXXXXXXXXXGOOOOOOOXXXXXXXXXXXXGOOOOOAXXXXXXXXXXXXXGOOXXXXXXXXXXXXXXXXXGOOOOOXXXXXXXXXXXXXXGOOXXXXXXXXXXXXXXXXXGOOOOOOOXXXXXXXXXXXX,0,0,0
13293,71,1,70,41,388,0,0,393,303,90,GOOXXXXXXXXXXXXXXXXXGOOOOOXXXXXXXXXXXXXXGOOOOOOOXXXXXXXXXXXXGOOOXXXXXXXXXXXXXXXXGOOXXXXXXXXXXXXXXXXXGOOOOXXXXXXXXXXXXXXXGOOOOOOXXXXXXXXXXXXXGOOOOOOOXXXXXXXXXXXXGOOOOOAXXXXXXXXXXXXXGOOXXXXXXXXXXXXXXXXXGOOOOOXXXXXXXXXXXXXXGOOXXXXXXXXXXXXXXXXXGOOOOOOOXXXXXXXXXXXX,0,0,0
13314,71,1,70,46,383,0,0,388,301,87,GOOXXXXXXXXXXXXXXXXXGOOOOOXXXXXXXXXXXXXXGOOOOOOOXXXXXXXXXXXXGOOOXXXXXXXXXXXXXXXXGOOXXXXXXXXXXXXXXXXXGOOOOXXXXXXXXXXXXXXXGOOOOOOXXXXXXXXXXXXXGOOOOOOOXXXXXXXXXXXXGOOOOOAXXXXXXXXXXXXXGOOXXXXXXXXXXXXXXXXXGOOOOOXXXXXXXXXXXXXXGOOXXXXXXXXXXXXXXXXXGOOOOOOOXXXXXXXXXXXX,0,0,0

13335,71,1,70,49,380,0,0,385,301,84,GOOXXXXXXXXXXXXXXXXXGOOOOOXXXXXXXXXXXXXXGOOOOOOOXXXXXXXXXXXXGOOOXXXXXXXXXXXXXXXXGOOXXXXXXXXXXXXXXXXXGOOOOXXXXXXXXXXXXXXXGOOOOOOXXXXXXXXXXXXXGOOOOOOOXXXXXXXXXXXXGOOOOOAXXXXXXXXXXXXXGOOXXXXXXXXXXXXXXXXXGOOOOOXXXXXXXXXXXXXXGOOXXXXXXXXXXXXXXXXXGOOOOOOOXXXXXXXXXXXX,0,0,0
13356,72,1,71,48,380,0,0,385,302,83,GOOXXXXXXXXXXXXXXXXXGOOOOOXXXXXXXXXXXXXXGOOOOOOOXXXXXXXXXXXXGOOOXXXXXXXXXXXXXXXXGOOXXXXXXXXXXXXXXXXXGOOOOXXXXXXXXXXXXXXXGOOOOOOXXXXXXXXXXXXXGOOOOOOOXXXXXXXXXXXXGOOOOOOXXXXXXXXXXXXXGOOXXXXXXXXXXXXXXXXXGOOOOOXXXXXXXXXXXXXXGOOAXXXXXXXXXXXXXXXXGOOOOOOOXXXXXXXXXXXX,0,0,0
13377,72,0,72,48,380,0,0,386,303,83,GOOXXXXXXXXXXXXXXXXXGOOOOOXXXXXXXXXXXXXXGOOOOOOOXXXXXXXXXXXXGOOOXXXXXXXXXXXXXXXXGOOXXXXXXXXXXXXXXXXXGOOOOXXXXXXXXXXXXXXXGOOOOOOXXXXXXXXXXXXXGOOOOOOOXXXXXXXXXXXXGOOOOOOXXXXXXXXXXXXXGOOXXXXXXXXXXXXXXXXXGOOOOOXXXXXXXXXXXXXXGOOOXXXXXXXXXXXXXXXXGOOOOOOOXXXXXXXXXXXX,0,0,0
13398,72,0,72,45,383,0,0,386,301,85,GOOXXXXXXXXXXXXXXXXXGOOOOOXXXXXXXXXXXXXXGOOOOOOOXXXXXXXXXXXXGOOOXXXXXXXXXXXXXXXXGOOXXXXXXXXXXXXXXXXXGOOOOXXXXXXXXXXXXXXXGOOOOOOXXXXXXXXXXXXXGOOOOOOOXXXXXXXXXXXXGOOOOOOXXXXXXXXXXXXXGOOXXXXXXXXXXXXXXXXXGOOOOOXXXXXXXXXXXXXXGOOOXXXXXXXXXXXXXXXXGOOOOOOOXXXXXXXXXXXX,0,0,0
13419,72,0,72,42,386,0,0,390,300,90,GOOXXXXXXXXXXXXXXXXXGOOOOOXXXXXXXXXXXXXXGOOOOOOOXXXXXXXXXXXXGOOOXXXXXXXXXXXXXXXXGOOXXXXXXXXXXXXXXXXXGOOOOXXXXXXXXXXXXXXXGOOOOOOXXXXXXXXXXXXXGOOOOOOOXXXXXXXXXXXXGOOOOOOXXXXXXXXXXXXXGOOXXXXXXXXXXXXXXXXXGOOOOOXXXXXXXXXXXXXXGOOOXXXXXXXXXXXXXXXXGOOOOOOOXXXXXXXXXXXX,0,0,0

13440,72,0,72,39,389,0,0,392,305,87,GOOXXXXXXXXXXXXXXXXXGOOOOOXXXXXXXXXXXXXXGOOOOOOOXXXXXXXXXXXXGOOOXXXXXXXXXXXXXXXXGOOXXXXXXXXXXXXXXXXXGOOOOXXXXXXXXXXXXXXXGOOOOOOXXXXXXXXXXXXXGOOOOOOOXXXXXXXXXXXXGOOOOOOXXXXXXXXXXXXXGOOXXXXXXXXXXXXXXXXXGOOOOOXXXXXXXXXXXXXXGOOOXXXXXXXXXXXXXXXXGOOOOOOOXXXXXXXXXXXX,0,0,0
13461,72,0,72,43,385,0,0,388,303,85,GOOXXXXXXXXXXXXXXXXXGOOOOOXXXXXXXXXXXXXXGOOOOOOOXXXXXXXXXXXXGOOOXXXXXXXXXXXXXXXXGOOXXXXXXXXXXXXXXXXXGOOOOXXXXXXXXXXXXXXXGOOOOOOXXXXXXXXXXXXXGOOOOOOOXXXXXXXXXXXXGOOOOOOXXXXXXXXXXXXXGOOXXXXXXXXXXXXXXXXXGOOOOOXXXXXXXXXXXXXXGOOOXXXXXXXXXXXXXXXXGOOOOOOOXXXXXXXXXXXX,0,0,0
13482,72,0,72,39,389,0,0,393,305,88,GOOXXXXXXXXXXXXXXXXXGOOOOOXXXXXXXXXXXXXXGOOOOOOOXXXXXXXXXXXXGOOOXXXXXXXXXXXXXXXXGOOXXXXXXXXXXXXXXXXXGOOOOXXXXXXXXXXXXXXXGOOOOOOXXXXXXXXXXXXXGOOOOOOOXXXXXXXXXXXXGOOOOOOXXXXXXXXXXXXXGOOXXXXXXXXXXXXXXXXXGOOOOOXXXXXXXXXXXXXXGOOOXXXXXXXXXXXXXXXXGOOOOOOOXXXXXXXXXXXX,0,0,0
13503,72,0,72,47,381,0,0,385,306,79,GOOXXXXXXXXXXXXXXXXXGOOOOOXXXXXXXXXXXXXXGOOOOOOOXXXXXXXXXXXXGOOOXXXXXXXXXXXXXXXXGOOXXXXXXXXXXXXXXXXXGOOOOXXXXXXXXXXXXXXXGOOOOOOXXXXXXXXXXXXXGOOOOOOOXXXXXXXXXXXXGOOOOOOXXXXXXXXXXXXXGOOXXXXXXXXXXXXXXXXXGOOOOOXXXXXXXXXXXXXXGOOOXXXXXXXXXXXXXXXXGOOOOOOOXXXXXXXXXXXX,0,0,0
13524,72,0,72,48,380,0,0,384,309,75,GOOXXXXXXXXXXXXXXXXXGOOOOOXXXXXXXXXXXXXXGOOOOOOOXXXXXXXXXXXXGOOOXXXXXXXXXXXXXXXXGOOXXXXXXXXXXXXXXXXXGOOOOXXXXXXXXXXXXXXXGOOOOOOXXXXXXXXXXXXXGOOOOOOOXXXXXXXXXXXXGOOOOOOXXXXXXXXXXXXXGOOXXXXXXXXXXXXXXXXXGOOOOOXXXXXXXXXXXXXXGOOOXXXXXXXXXXXXXXXXGOOOOOOOXXXXXXXXXXXX,0,0,0

13545,72,0,72,49,379,0,0,383,304,79,GOOXXXXXXXXXXXXXXXXXGOOOOOXXXXXXXXXXXXXXGOOOOOOOXXXXXXXXXXXXGOOOXXXXXXXXXXXXXXXXGOOXXXXXXXXXXXXXXXXXGOOOOXXXXXXXXXXXXXXXGOOOOOOXXXXXXXXXXXXXGOOOOOOOXXXXXXXXXXXXGOOOOOOXXXXXXXXXXXXXGOOXXXXXXXXXXXXXXXXXGOOOOOXXXXXXXXXXXXXXGOOOXXXXXXXXXXXXXXXXGOOOOOOOXXXXXXXXXXXX,0,0,0
13566,72,0,72,51,377,0,0,381,302,79,GOOXXXXXXXXXXXXXXXXXGOOOOOXXXXXXXXXXXXXXGOOOOOOOXXXXXXXXXXXXGOOOXXXXXXXXXXXXXXXXGOOXXXXXXXXXXXXXXXXXGOOOOXXXXXXXXXXXXXXXGOOOOOOXXXXXXXXXXXXXGOOOOOOOXXXXXXXXXXXXGOOOOOOXXXXXXXXXXXXXGOOXXXXXXXXXXXXXXXXXGOOOOOXXXXXXXXXXXXXXGOOOXXXXXXXXXXXXXXXXGOOOOOOOXXXXXXXXXXXX,0,0,0
13587,72,0,72,51,377,0,0,381,305,76,GOOXXXXXXXXXXXXXXXXXGOOOOOXXXXXXXXXXXXXXGOOOOOOOXXXXXXXXXXXXGOOOXXXXXXXXXXXXXXXXGOOXXXXXXXXXXXXXXXXXGOOOOXXXXXXXXXXXXXXXGOOOOOOXXXXXXXXXXXXXGOOOOOOOXXXXXXXXXXXXGOOOOOOXXXXXXXXXXXXXGOOXXXXXXXXXXXXXXXXXGOOOOOXXXXXXXXXXXXXXGOOOXXXXXXXXXXXXXXXXGOOOOOOOXXXXXXXXXXXX,0,0,0
13608,72,0,72,49,379,0,0,383,307,76,GOOXXXXXXXXXXXXXXXXXGOOOOOXXXXXXXXXXXXXXGOOOOOOOXXXXXXXXXXXXGOOOXXXXXXXXXXXXXXXXGOOXXXXXXXXXXXXXXXXXGOOOOXXXXXXXXXXXXXXXGOOOOOOXXXXXXXXXXXXXGOOOOOOOXXXXXXXXXXXXGOOOOOOXXXXXXXXXXXXXGOOXXXXXXXXXXXXXXXXXGOOOOOXXXXXXXXXXXXXXGOOOXXXXXXXXXXXXXXXXGOOOOOOOXXXXXXXXXXXX,0,0,0
13629,72,0,72,50,378,0,0,382,306,76,GOOXXXXXXXXXXXXXXXXXGOOOOOXXXXXXXXXXXXXXGOOOOOOOXXXXXXXXXXXXGOOOXXXXXXXXXXXXXXXXGOOXXXXXXXXXXXXXXXXXGOOOOXXXXXXXXXXXXXXXGOOOOOOXXXXXXXXXXXXXGOOOOOOOXXXXXXXXXXXXGOOOOOOXXXXXXXXXXXXXGOOXXXXXXXXXXXXXXXXXGOOOOOXXXXXXXXXXXXXXGOOOXXXXXXXXXXXXXXXXGOOOOOOOXXXXXXXXXXXX,0,0,0

13650,72,0,72,48,380,0,0,384,305,79,GOOXXXXXXXXXXXXXXXXXGOOOOOXXXXXXXXXXXXXXGOOOOOOOXXXXXXXXXXXXGOOOXXXXXXXXXXXXXXXXGOOXXXXXXXXXXXXXXXXXGOOOOXXXXXXXXXXXXXXXGOOOOOOXXXXXXXXXXXXXGOOOOOOOXXXXXXXXXXXXGOOOOOOXXXXXXXXXXXXXGOOXXXXXXXXXXXXXXXXXGOOOOOXXXXXXXXXXXXXXGOOOXXXXXXXXXXXXXXXXGOOOOOOOXXXXXXXXXXXX,0,0,0
13671,72,0,72,45,383,0,0,387,305,82,GOOXXXXXXXXXXXXXXXXXGOOOOOXXXXXXXXXXXXXXGOOOOOOOXXXXXXXXXXXXGOOOXXXXXXXXXXXXXXXXGOOXXXXXXXXXXXXXXXXXGOOOOXXXXXXXXXXXXXXXGOOOOOOXXXXXXXXXXXXXGOOOOOOOXXXXXXXXXXXXGOOOOOOXXXXXXXXXXXXXGOOXXXXXXXXXXXXXXXXXGOOOOOXXXXXXXXXXXXXXGOOOXXXXXXXXXXXXXXXXGOOOOOOOXXXXXXXXXXXX,0,0,0
13692,72,0,72,42,386,0,0,390,304,86,GOOXXXXXXXXXXXXXXXXXGOOOOOXXXXXXXXXXXXXXGOOOOOOOXXXXXXXXXXXXGOOOXXXXXXXXXXXXXXXXGOOXXXXXXXXXXXXXXXXXGOOOOXXXXXXXXXXXXXXXGOOOOOOXXXXXXXXXXXXXGOOOOOOOXXXXXXXXXXXXGOOOOOOXXXXXXXXXXXXXGOOXXXXXXXXXXXXXXXXXGOOOOOXXXXXXXXXXXXXXGOOOXXXXXXXXXXXXXXXXGOOOOOOOXXXXXXXXXXXX,0,0,0
13713,72,0,72,40,388,0,0,392,307,85,GOOXXXXXXXXXXXXXXXXXGOOOOOXXXXXXXXXXXXXXGOOOOOOOXXXXXXXXXXXXGOOOXXXXXXXXXXXXXXXXGOOXXXXXXXXXXXXXXXXXGOOOOXXXXXXXXXXXXXXXGOOOOOOXXXXXXXXXXXXXGOOOOOOOXXXXXXXXXXXXGOOOOOOXXXXXXXXXXXXXGOOXXXXXXXXXXXXXXXXXGOOOOOXXXXXXXXXXXXXXGOOOXXXXXXXXXXXXXXXXGOOOOOOOXXXXXXXXXXXX,0,0,0
13734,72,0,72,43,385,0,0,389,306,83,GOOXXXXXXXXXXXXXXXXXGOOOOOXXXXXXXXXXXXXXGOOOOOOOXXXXXXXXXXXXGOOOXXXXXXXXXXXXXXXXGOOXXXXXXXXXXXXXXXXXGOOOOXXXXXXXXXXXXXXXGOOOOOOXXXXXXXXXXXXXGOOOOOOOXXXXXXXXXXXXGOOOOOOXXXXXXXXXXXXXGOOXXXXXXXXXXXXXXXXXGOOOOOXXXXXXXXXXXXXXGOOOXXXXXXXXXXXXXXXXGOOOOOOOXXXXXXXXXXXX,0,0,0

13755,72,0,72,42,386,0,0,389,308,81,GOOXXXXXXXXXXXXXXXXXGOOOOOXXXXXXXXXXXXXXGOOOOOOOXXXXXXXXXXXXGOOOXXXXXXXXXXXXXXXXGOOXXXXXXXXXXXXXXXXXGOOOOXXXXXXXXXXXXXXXGOOOOOOXXXXXXXXXXXXXGOOOOOOOXXXXXXXXXXXXGOOOOOOXXXXXXXXXXXXXGOOXXXXXXXXXXXXXXXXXGOOOOOXXXXXXXXXXXXXXGOOOXXXXXXXXXXXXXXXXGOOOOOOOXXXXXXXXXXXX,0,0,0
13776,72,0,72,45,383,0,0,386,307,79,GOOXXXXXXXXXXXXXXXXXGOOOOOXXXXXXXXXXXXXXGOOOOOOOXXXXXXXXXXXXGOOOXXXXXXXXXXXXXXXXGOOXXXXXXXXXXXXXXXXXGOOOOXXXXXXXXXXXXXXXGOOOOOOXXXXXXXXXXXXXGOOOOOOOXXXXXXXXXXXXGOOOOOOXXXXXXXXXXXXXGOOXXXXXXXXXXXXXXXXXGOOOOOXXXXXXXXXXXXXXGOOOXXXXXXXXXXXXXXXXGOOOOOOOXXXXXXXXXXXX,0,0,0
13797,72,0,72,45,383,0,0,386,307,79,GOOXXXXXXXXXXXXXXXXXGOOOOOXXXXXXXXXXXXXXGOOOOOOOXXXXXXXXXXXXGOOOXXXXXXXXXXXXXXXXGOOXXXXXXXXXXXXXXXXXGOOOOXXXXXXXXXXXXXXXGOOOOOOXXXXXXXXXXXXXGOOOOOOOXXXXXXXXXXXXGOOOOOOXXXXXXXXXXXXXGOOXXXXXXXXXXXXXXXXXGOOOOOXXXXXXXXXXXXXXGOOOXXXXXXXXXXXXXXXXGOOOOOOOXXXXXXXXXXXX,0,0,0
13818,72,0,72,42,386,0,0,389,308,81,GOOXXXXXXXXXXXXXXXXXGOOOOOXXXXXXXXXXXXXXGOOOOOOOXXXXXXXXXXXXGOOOXXXXXXXXXXXXXXXXGOOXXXXXXXXXXXXXXXXXGOOOOXXXXXXXXXXXXXXXGOOOOOOXXXXXXXXXXXXXGOOOOOOOXXXXXXXXXXXXGOOOOOOXXXXXXXXXXXXXGOOXXXXXXXXXXXXXXXXXGOOOOOXXXXXXXXXXXXXXGOOOXXXXXXXXXXXXXXXXGOOOOOOOXXXXXXXXXXXX,0,0,0
13839,72,0,72,42,386,0,0,387,307,80,GOOXXXXXXXXXXXXXXXXXGOOOOOXXXXXXXXXXXXXXGOOOOOOOXXXXXXXXXXXXGOOOXXXXXXXXXXXXXXXXGOOXXXXXXXXXXXXXXXXXGOOOOXXXXXXXXXXXXXXXGOOOOOOXXXXXXXXXXXXXGOOOOOOOXXXXXXXXXXXXGOOOOOOXXXXXXXXXXXXXGOOXXXXXXXXXXXXXXXXXGOOOOOXXXXXXXXXXXXXXGOOOXXXXXXXXXXXXXXXXGOOOOOOOXXXXXXXXXXXX,0,0,0

13860,72,0,72,40,388,0,0,391,310,81,GOOXXXXXXXXXXXXXXXXXGOOOOOXXXXXXXXXXXXXXGOOOOOOOXXXXXXXXXXXXGOOOXXXXXXXXXXXXXXXXGOOXXXXXXXXXXXXXXXXXGOOOOXXXXXXXXXXXXXXXGOOOOOOXXXXXXXXXXXXXGOOOOOOOXXXXXXXXXXXXGOOOOOOXXXXXXXXXXXXXGOOXXXXXXXXXXXXXXXXXGOOOOOXXXXXXXXXXXXXXGOOOXXXXXXXXXXXXXXXXGOOOOOOOXXXXXXXXXXXX,0,0,0
13881,72,0,72,40,388,0,0,390,307,83,GOOXXXXXXXXXXXXXXXXXGOOOOOXXXXXXXXXXXXXXGOOOOOOOXXXXXXXXXXXXGOOOXXXXXXXXXXXXXXXXGOOXXXXXXXXXXXXXXXXXGOOOOXXXXXXXXXXXXXXXGOOOOOOXXXXXXXXXXXXXGOOOOOOOXXXXXXXXXXXXGOOOOOOXXXXXXXXXXXXXGOOXXXXXXXXXXXXXXXXXGOOOOOXXXXXXXXXXXXXXGOOOXXXXXXXXXXXXXXXXGOOOOOOOXXXXXXXXXXXX,0,0,0
13902,72,0,72,39,389,0,0,392,308,84,GOOXXXXXXXXXXXXXXXXXGOOOOOXXXXXXXXXXXXXXGOOOOOOOXXXXXXXXXXXXGOOOXXXXXXXXXXXXXXXXGOOXXXXXXXXXXXXXXXXXGOOOOXXXXXXXXXXXXXXXGOOOOOOXXXXXXXXXXXXXGOOOOOOOXXXXXXXXXXXXGOOOOOOXXXXXXXXXXXXXGOOXXXXXXXXXXXXXXXXXGOOOOOXXXXXXXXXXXXXXGOOOXXXXXXXXXXXXXXXXGOOOOOOOXXXXXXXXXXXX,0,0,0
13923,72,0,72,36,392,0,0,395,311,84,GOOXXXXXXXXXXXXXXXXXGOOOOOXXXXXXXXXXXXXXGOOOOOOOXXXXXXXXXXXXGOOOXXXXXXXXXXXXXXXXGOOXXXXXXXXXXXXXXXXXGOOOOXXXXXXXXXXXXXXXGOOOOOOXXXXXXXXXXXXXGOOOOOOOXXXXXXXXXXXXGOOOOOOXXXXXXXXXXXXXGOOXXXXXXXXXXXXXXXXXGOOOOOXXXXXXXXXXXXXXGOOOXXXXXXXXXXXXXXXXGOOOOOOOXXXXXXXXXXXX,0,0,0
13944,72,0,72,36,392,0,0,395,309,86,GOOXXXXXXXXXXXXXXXXXGOOOOOXXXXXXXXXXXXXXGOOOOOOOXXXXXXXXXXXXGOOOXXXXXXXXXXXXXXXXGOOXXXXXXXXXXXXXXXXXGOOOOXXXXXXXXXXXXXXXGOOOOOOXXXXXXXXXXXXXGOOOOOOOXXXXXXXXXXXXGOOOOOOXXXXXXXXXXXXXGOOXXXXXXXXXXXXXXXXXGOOOOOXXXXXXXXXXXXXXGOOOXXXXXXXXXXXXXXXXGOOOOOOOXXXXXXXXXXXX,0,0,0

13965,72,0,72,38,390,0,0,393,312,81,GOOXXXXXXXXXXXXXXXXXGOOOOOXXXXXXXXXXXXXXGOOOOOOOXXXXXXXXXXXXGOOOXXXXXXXXXXXXXXXXGOOXXXXXXXXXXXXXXXXXGOOOOXXXXXXXXXXXXXXXGOOOOOOXXXXXXXXXXXXXGOOOOOOOXXXXXXXXXXXXGOOOOOOXXXXXXXXXXXXXGOOXXXXXXXXXXXXXXXXXGOOOOOXXXXXXXXXXXXXXGOOOXXXXXXXXXXXXXXXXGOOOOOOOXXXXXXXXXXXX,0,0,0
13986,72,0,72,41,387,0,0,390,309,81,GOOXXXXXXXXXXXXXXXXXGOOOOOXXXXXXXXXXXXXXGOOOOOOOXXXXXXXXXXXXGOOOXXXXXXXXXXXXXXXXGOOXXXXXXXXXXXXXXXXXGOOOOXXXXXXXXXXXXXXXGOOOOOOXXXXXXXXXXXXXGOOOOOOOXXXXXXXXXXXXGOOOOOOXXXXXXXXXXXXXGOOXXXXXXXXXXXXXXXXXGOOOOOXXXXXXXXXXXXXXGOOOXXXXXXXXXXXXXXXXGOOOOOOOXXXXXXXXXXXX,0,0,0
14007,72,0,72,42,386,0,0,389,310,79,GOOXXXXXXXXXXXXXXXXXGOOOOOXXXXXXXXXXXXXXGOOOOOOOXXXXXXXXXXXXGOOOXXXXXXXXXXXXXXXXGOOXXXXXXXXXXXXXXXXXGOOOOXXXXXXXXXXXXXXXGOOOOOOXXXXXXXXXXXXXGOOOOOOOXXXXXXXXXXXXGOOOOOOXXXXXXXXXXXXXGOOXXXXXXXXXXXXXXXXXGOOOOOXXXXXXXXXXXXXXGOOOXXXXXXXXXXXXXXXXGOOOOOOOXXXXXXXXXXXX,0,0,0
14028,72,0,72,47,381,0,0,384,309,75,GOOXXXXXXXXXXXXXXXXXGOOOOOXXXXXXXXXXXXXXGOOOOOOOXXXXXXXXXXXXGOOOXXXXXXXXXXXXXXXXGOOXXXXXXXXXXXXXXXXXGOOOOXXXXXXXXXXXXXXXGOOOOOOXXXXXXXXXXXXXGOOOOOOOXXXXXXXXXXXXGOOOOOOXXXXXXXXXXXXXGOOXXXXXXXXXXXXXXXXXGOOOOOXXXXXXXXXXXXXXGOOOXXXXXXXXXXXXXXXXGOOOOOOOXXXXXXXXXXXX,0,0,0
14049,72,0,72,49,379,0,0,382,310,72,GOOXXXXXXXXXXXXXXXXXGOOOOOXXXXXXXXXXXXXXGOOOOOOOXXXXXXXXXXXXGOOOXXXXXXXXXXXXXXXXGOOXXXXXXXXXXXXXXXXXGOOOOXXXXXXXXXXXXXXXGOOOOOOXXXXXXXXXXXXXGOOOOOOOXXXXXXXXXXXXGOOOOOOXXXXXXXXXXXXXGOOXXXXXXXXXXXXXXXXXGOOOOOXXXXXXXXXXXXXXGOOOXXXXXXXXXXXXXXXXGOOOOOOOXXXXXXXXXXXX,0,0,0

14070,72,0,72,49,379,0,0,382,308,74,GOOXXXXXXXXXXXXXXXXXGOOOOOXXXXXXXXXXXXXXGOOOOOOOXXXXXXXXXXXXGOOOXXXXXXXXXXXXXXXXGOOXXXXXXXXXXXXXXXXXGOOOOXXXXXXXXXXXXXXXGOOOOOOXXXXXXXXXXXXXGOOOOOOOXXXXXXXXXXXXGOOOOOOXXXXXXXXXXXXXGOOXXXXXXXXXXXXXXXXXGOOOOOXXXXXXXXXXXXXXGOOOXXXXXXXXXXXXXXXXGOOOOOOOXXXXXXXXXXXX,0,0,0
14091,72,0,72,47,381,0,0,383,310,73,GOOXXXXXXXXXXXXXXXXXGOOOOOXXXXXXXXXXXXXXGOOOOOOOXXXXXXXXXXXXGOOOXXXXXXXXXXXXXXXXGOOXXXXXXXXXXXXXXXXXGOOOOXXXXXXXXXXXXXXXGOOOOOOXXXXXXXXXXXXXGOOOOOOOXXXXXXXXXXXXGOOOOOOXXXXXXXXXXXXXGOOXXXXXXXXXXXXXXXXXGOOOOOXXXXXXXXXXXXXXGOOOXXXXXXXXXXXXXXXXGOOOOOOOXXXXXXXXXXXX,0,0,0
14112,72,0,72,45,383,0,0,385,310,75,GOOXXXXXXXXXXXXXXXXXGOOOOOXXXXXXXXXXXXXXGOOOOOOOXXXXXXXXXXXXGOOOXXXXXXXXXXXXXXXXGOOXXXXXXXXXXXXXXXXXGOOOOXXXXXXXXXXXXXXXGOOOOOOXXXXXXXXXXXXXGOOOOOOOXXXXXXXXXXXXGOOOOOOXXXXXXXXXXXXXGOOXXXXXXXXXXXXXXXXXGOOOOOXXXXXXXXXXXXXXGOOOXXXXXXXXXXXXXXXXGOOOOOOOXXXXXXXXXXXX,0,0,0
14133,72,0,72,44,384,0,0,387,308,79,GOOXXXXXXXXXXXXXXXXXGOOOOOXXXXXXXXXXXXXXGOOOOOOOXXXXXXXXXXXXGOOOXXXXXXXXXXXXXXXXGOOXXXXXXXXXXXXXXXXXGOOOOXXXXXXXXXXXXXXXGOOOOOOXXXXXXXXXXXXXGOOOOOOOXXXXXXXXXXXXGOOOOOOXXXXXXXXXXXXXGOOXXXXXXXXXXXXXXXXXGOOOOOXXXXXXXXXXXXXXGOOOXXXXXXXXXXXXXXXXGOOOOOOOXXXXXXXXXXXX,0,0,0
14154,72,0,72,42,386,0,0,389,309,80,GOOXXXXXXXXXXXXXXXXXGOOOOOXXXXXXXXXXXXXXGOOOOOOOXXXXXXXXXXXXGOOOXXXXXXXXXXXXXXXXGOOXXXXXXXXXXXXXXXXXGOOOOXXXXXXXXXXXXXXXGOOOOOOXXXXXXXXXXXXXGOOOOOOOXXXXXXXXXXXXGOOOOOOXXXXXXXXXXXXXGOOXXXXXXXXXXXXXXXXXGOOOOOXXXXXXXXXXXXXXGOOOXXXXXXXXXXXXXXXXGOOOOOOOXXXXXXXXXXXX,0,0,0

14175,72,0,72,46,382,0,0,384,309,75,GOOXXXXXXXXXXXXXXXXXGOOOOOXXXXXXXXXXXXXXGOOOOOOOXXXXXXXXXXXXGOOOXXXXXXXXXXXXXXXXGOOXXXXXXXXXXXXXXXXXGOOOOXXXXXXXXXXXXXXXGOOOOOOXXXXXXXXXXXXXGOOOOOOOXXXXXXXXXXXXGOOOOOOXXXXXXXXXXXXXGOOXXXXXXXXXXXXXXXXXGOOOOOXXXXXXXXXXXXXXGOOOXXXXXXXXXXXXXXXXGOOOOOOOXXXXXXXXXXXX,0,0,0
14196,72,0,72,43,385,0,0,388,311,77,GOOXXXXXXXXXXXXXXXXXGOOOOOXXXXXXXXXXXXXXGOOOOOOOXXXXXXXXXXXXGOOOXXXXXXXXXXXXXXXXGOOXXXXXXXXXXXXXXXXXGOOOOXXXXXXXXXXXXXXXGOOOOOOXXXXXXXXXXXXXGOOOOOOOXXXXXXXXXXXXGOOOOOOXXXXXXXXXXXXXGOOXXXXXXXXXXXXXXXXXGOOOOOXXXXXXXXXXXXXXGOOOXXXXXXXXXXXXXXXXGOOOOOOOXXXXXXXXXXXX,0,0,0
14217,72,0,72,45,383,0,0,386,311,75,GOOXXXXXXXXXXXXXXXXXGOOOOOXXXXXXXXXXXXXXGOOOOOOOXXXXXXXXXXXXGOOOXXXXXXXXXXXXXXXXGOOXXXXXXXXXXXXXXXXXGOOOOXXXXXXXXXXXXXXXGOOOOOOXXXXXXXXXXXXXGOOOOOOOXXXXXXXXXXXXGOOOOOOXXXXXXXXXXXXXGOOXXXXXXXXXXXXXXXXXGOOOOOXXXXXXXXXXXXXXGOOOXXXXXXXXXXXXXXXXGOOOOOOOXXXXXXXXXXXX,0,0,0
14238,72,0,72,46,382,0,0,385,311,74,GOOXXXXXXXXXXXXXXXXXGOOOOOXXXXXXXXXXXXXXGOOOOOOOXXXXXXXXXXXXGOOOXXXXXXXXXXXXXXXXGOOXXXXXXXXXXXXXXXXXGOOOOXXXXXXXXXXXXXXXGOOOOOOXXXXXXXXXXXXXGOOOOOOOXXXXXXXXXXXXGOOOOOOXXXXXXXXXXXXXGOOXXXXXXXXXXXXXXXXXGOOOOOXXXXXXXXXXXXXXGOOOXXXXXXXXXXXXXXXXGOOOOOOOXXXXXXXXXXXX,0,0,0
14259,72,0,72,48,380,0,0,381,311,70,GOOXXXXXXXXXXXXXXXXXGOOOOOXXXXXXXXXXXXXXGOOOOOOOXXXXXXXXXXXXGOOOXXXXXXXXXXXXXXXXGOOXXXXXXXXXXXXXXXXXGOOOOXXXXXXXXXXXXXXXGOOOOOOXXXXXXXXXXXXXGOOOOOOOXXXXXXXXXXXXGOOOOOOXXXXXXXXXXXXXGOOXXXXXXXXXXXXXXXXXGOOOOOXXXXXXXXXXXXXXGOOOXXXXXXXXXXXXXXXXGOOOOOOOXXXXXXXXXXXX,0,0,0

14280,72,0,72,44,384,0,0,387,310,77,GOOXXXXXXXXXXXXXXXXXGOOOOOXXXXXXXXXXXXXXGOOOOOOOXXXXXXXXXXXXGOOOXXXXXXXXXXXXXXXXGOOXXXXXXXXXXXXXXXXXGOOOOXXXXXXXXXXXXXXXGOOOOOOXXXXXXXXXXXXXGOOOOOOOXXXXXXXXXXXXGOOOOOOXXXXXXXXXXXXXGOOXXXXXXXXXXXXXXXXXGOOOOOXXXXXXXXXXXXXXGOOOXXXXXXXXXXXXXXXXGOOOOOOOXXXXXXXXXXXX,0,0,0
14301,72,0,72,46,382,0,0,385,310,75,GOOXXXXXXXXXXXXXXXXXGOOOOOXXXXXXXXXXXXXXGOOOOOOOXXXXXXXXXXXXGOOOXXXXXXXXXXXXXXXXGOOXXXXXXXXXXXXXXXXXGOOOOXXXXXXXXXXXXXXXGOOOOOOXXXXXXXXXXXXXGOOOOOOOXXXXXXXXXXXXGOOOOOOXXXXXXXXXXXXXGOOXXXXXXXXXXXXXXXXXGOOOOOXXXXXXXXXXXXXXGOOOXXXXXXXXXXXXXXXXGOOOOOOOXXXXXXXXXXXX,0,0,0
14322,72,0,72,46,382,0,0,385,311,74,GOOXXXXXXXXXXXXXXXXXGOOOOOXXXXXXXXXXXXXXGOOOOOOOXXXXXXXXXXXXGOOOXXXXXXXXXXXXXXXXGOOXXXXXXXXXXXXXXXXXGOOOOXXXXXXXXXXXXXXXGOOOOOOXXXXXXXXXXXXXGOOOOOOOXXXXXXXXXXXXGOOOOOOXXXXXXXXXXXXXGOOXXXXXXXXXXXXXXXXXGOOOOOXXXXXXXXXXXXXXGOOOXXXXXXXXXXXXXXXXGOOOOOOOXXXXXXXXXXXX,0,0,0
14343,72,0,72,50,378,0,0,382,310,72,GOOXXXXXXXXXXXXXXXXXGOOOOOXXXXXXXXXXXXXXGOOOOOOOXXXXXXXXXXXXGOOOXXXXXXXXXXXXXXXXGOOXXXXXXXXXXXXXXXXXGOOOOXXXXXXXXXXXXXXXGOOOOOOXXXXXXXXXXXXXGOOOOOOOXXXXXXXXXXXXGOOOOOOXXXXXXXXXXXXXGOOXXXXXXXXXXXXXXXXXGOOOOOXXXXXXXXXXXXXXGOOOXXXXXXXXXXXXXXXXGOOOOOOOXXXXXXXXXXXX,0,0,0
14364,73,1,72,48,379,0,0,383,311,72,GOOXXXXXXXXXXXXXXXXXGOOOOOXXXXXXXXXXXXXXGOOOOOOOAXXXXXXXXXXXGOOOXXXXXXXXXXXXXXXXGOOXXXXXXXXXXXXXXXXXGOOOOXXXXXXXXXXXXXXXGOOOOOOXXXXXXXXXXXXXGOOOOOOOXXXXXXXXXXXXGOOOOOOXXXXXXXXXXXXXGOOXXXXXXXXXXXXXXXXXGOOOOOXXXXXXXXXXXXXXGOOOXXXXXXXXXXXXXXXXGOOOOOOOXXXXXXXXXXXX,0,0,0

14385,73,1,72,45,382,0,0,386,309,77,GOOXXXXXXXXXXXXXXXXXGOOOOOXXXXXXXXXXXXXXGOOOOOOOAXXXXXXXXXXXGOOOXXXXXXXXXXXXXXXXGOOXXXXXXXXXXXXXXXXXGOOOOXXXXXXXXXXXXXXXGOOOOOOXXXXXXXXXXXXXGOOOOOOOXXXXXXXXXXXXGOOOOOOXXXXXXXXXXXXXGOOXXXXXXXXXXXXXXXXXGOOOOOXXXXXXXXXXXXXXGOOOXXXXXXXXXXXXXXXXGOOOOOOOXXXXXXXXXXXX,0,0,0
14406,73,0,73,36,391,0,0,393,313,80,GOOXXXXXXXXXXXXXXXXXGOOOOOXXXXXXXXXXXXXXGOOOOOOOOXXXXXXXXXXXGOOOXXXXXXXXXXXXXXXXGOOXXXXXXXXXXXXXXXXXGOOOOXXXXXXXXXXXXXXXGOOOOOOXXXXXXXXXXXXXGOOOOOOOXXXXXXXXXXXXGOOOOOOXXXXXXXXXXXXXGOOXXXXXXXXXXXXXXXXXGOOOOOXXXXXXXXXXXXXXGOOOXXXXXXXXXXXXXXXXGOOOOOOOXXXXXXXXXXXX,0,0,0
14427,73,0,73,38,389,0,0,392,310,82,GOOXXXXXXXXXXXXXXXXXGOOOOOXXXXXXXXXXXXXXGOOOOOOOOXXXXXXXXXXXGOOOXXXXXXXXXXXXXXXXGOOXXXXXXXXXXXXXXXXXGOOOOXXXXXXXXXXXXXXXGOOOOOOXXXXXXXXXXXXXGOOOOOOOXXXXXXXXXXXXGOOOOOOXXXXXXXXXXXXXGOOXXXXXXXXXXXXXXXXXGOOOOOXXXXXXXXXXXXXXGOOOXXXXXXXXXXXXXXXXGOOOOOOOXXXXXXXXXXXX,0,0,0
14448,73,0,73,36,391,0,0,393,310,83,GOOXXXXXXXXXXXXXXXXXGOOOOOXXXXXXXXXXXXXXGOOOOOOOOXXXXXXXXXXXGOOOXXXXXXXXXXXXXXXXGOOXXXXXXXXXXXXXXXXXGOOOOXXXXXXXXXXXXXXXGOOOOOOXXXXXXXXXXXXXGOOOOOOOXXXXXXXXXXXXGOOOOOOXXXXXXXXXXXXXGOOXXXXXXXXXXXXXXXXXGOOOOOXXXXXXXXXXXXXXGOOOXXXXXXXXXXXXXXXXGOOOOOOOXXXXXXXXXXXX,0,0,0
14469,73,0,73,36,391,0,0,394,308,86,GOOXXXXXXXXXXXXXXXXXGOOOOOXXXXXXXXXXXXXXGOOOOOOOOXXXXXXXXXXXGOOOXXXXXXXXXXXXXXXXGOOXXXXXXXXXXXXXXXXXGOOOOXXXXXXXXXXXXXXXGOOOOOOXXXXXXXXXXXXXGOOOOOOOXXXXXXXXXXXXGOOOOOOXXXXXXXXXXXXXGOOXXXXXXXXXXXXXXXXXGOOOOOXXXXXXXXXXXXXXGOOOXXXXXXXXXXXXXXXXGOOOOOOOXXXXXXXXXXXX,0,0,0

14490,73,0,73,36,391,0,0,394,309,85,GOOXXXXXXXXXXXXXXXXXGOOOOOXXXXXXXXXXXXXXGOOOOOOOOXXXXXXXXXXXGOOOXXXXXXXXXXXXXXXXGOOXXXXXXXXXXXXXXXXXGOOOOXXXXXXXXXXXXXXXGOOOOOOXXXXXXXXXXXXXGOOOOOOOXXXXXXXXXXXXGOOOOOOXXXXXXXXXXXXXGOOXXXXXXXXXXXXXXXXXGOOOOOXXXXXXXXXXXXXXGOOOXXXXXXXXXXXXXXXXGOOOOOOOXXXXXXXXXXXX,0,0,0
14511,73,0,73,37,390,0,0,393,312,81,GOOXXXXXXXXXXXXXXXXXGOOOOOXXXXXXXXXXXXXXGOOOOOOOOXXXXXXXXXXXGOOOXXXXXXXXXXXXXXXXGOOXXXXXXXXXXXXXXXXXGOOOOXXXXXXXXXXXXXXXGOOOOOOXXXXXXXXXXXXXGOOOOOOOXXXXXXXXXXXXGOOOOOOXXXXXXXXXXXXXGOOXXXXXXXXXXXXXXXXXGOOOOOXXXXXXXXXXXXXXGOOOXXXXXXXXXXXXXXXXGOOOOOOOXXXXXXXXXXXX,0,0,0
14532,73,0,73,40,387,0,0,390,310,80,GOOXXXXXXXXXXXXXXXXXGOOOOOXXXXXXXXXXXXXXGOOOOOOOOXXXXXXXXXXXGOOOXXXXXXXXXXXXXXXXGOOXXXXXXXXXXXXXXXXXGOOOOXXXXXXXXXXXXXXXGOOOOOOXXXXXXXXXXXXXGOOOOOOOXXXXXXXXXXXXGOOOOOOXXXXXXXXXXXXXGOOXXXXXXXXXXXXXXXXXGOOOOOXXXXXXXXXXXXXXGOOOXXXXXXXXXXXXXXXXGOOOOOOOXXXXXXXXXXXX,0,0,0
14553,73,0,73,39,388,0,0,391,310,81,GOOXXXXXXXXXXXXXXXXXGOOOOOXXXXXXXXXXXXXXGOOOOOOOOXXXXXXXXXXXGOOOXXXXXXXXXXXXXXXXGOOXXXXXXXXXXXXXXXXXGOOOOXXXXXXXXXXXXXXXGOOOOOOXXXXXXXXXXXXXGOOOOOOOXXXXXXXXXXXXGOOOOOOXXXXXXXXXXXXXGOOXXXXXXXXXXXXXXXXXGOOOOOXXXXXXXXXXXXXXGOOOXXXXXXXXXXXXXXXXGOOOOOOOXXXXXXXXXXXX,0,0,0
14574,73,0,73,44,383,0,0,386,309,77,GOOXXXXXXXXXXXXXXXXXGOOOOOXXXXXXXXXXXXXXGOOOOOOOOXXXXXXXXXXXGOOOXXXXXXXXXXXXXXXXGOOXXXXXXXXXXXXXXXXXGOOOOXXXXXXXXXXXXXXXGOOOOOOXXXXXXXXXXXXXGOOOOOOOXXXXXXXXXXXXGOOOOOOXXXXXXXXXXXXXGOOXXXXXXXXXXXXXXXXXGOOOOOXXXXXXXXXXXXXXGOOOXXXXXXXXXXXXXXXXGOOOOOOOXXXXXXXXXXXX,0,0,0

14595,73,0,73,38,389,0,0,394,313,81,GOOXXXXXXXXXXXXXXXXXGOOOOOXXXXXXXXXXXXXXGOOOOOOOOXXXXXXXXXXXGOOOXXXXXXXXXXXXXXXXGOOXXXXXXXXXXXXXXXXXGOOOOXXXXXXXXXXXXXXXGOOOOOOXXXXXXXXXXXXXGOOOOOOOXXXXXXXXXXXXGOOOOOOXXXXXXXXXXXXXGOOXXXXXXXXXXXXXXXXXGOOOOOXXXXXXXXXXXXXXGOOOXXXXXXXXXXXXXXXXGOOOOOOOXXXXXXXXXXXX,0,0,0
14616,73,0,73,40,387,0,0,391,308,83,GOOXXXXXXXXXXXXXXXXXGOOOOOXXXXXXXXXXXXXXGOOOOOOOOXXXXXXXXXXXGOOOXXXXXXXXXXXXXXXXGOOXXXXXXXXXXXXXXXXXGOOOOXXXXXXXXXXXXXXXGOOOOOOXXXXXXXXXXXXXGOOOOOOOXXXXXXXXXXXXGOOOOOOXXXXXXXXXXXXXGOOXXXXXXXXXXXXXXXXXGOOOOOXXXXXXXXXXXXXXGOOOXXXXXXXXXXXXXXXXGOOOOOOOXXXXXXXXXXXX,0,0,0
14637,73,0,73,33,394,0,0,398,312,86,GOOXXXXXXXXXXXXXXXXXGOOOOOXXXXXXXXXXXXXXGOOOOOOOOXXXXXXXXXXXGOOOXXXXXXXXXXXXXXXXGOOXXXXXXXXXXXXXXXXXGOOOOXXXXXXXXXXXXXXXGOOOOOOXXXXXXXXXXXXXGOOOOOOOXXXXXXXXXXXXGOOOOOOXXXXXXXXXXXXXGOOXXXXXXXXXXXXXXXXXGOOOOOXXXXXXXXXXXXXXGOOOXXXXXXXXXXXXXXXXGOOOOOOOXXXXXXXXXXXX,0,0,0
14658,73,0,73,32,395,0,0,399,314,85,GOOXXXXXXXXXXXXXXXXXGOOOOOXXXXXXXXXXXXXXGOOOOOOOOXXXXXXXXXXXGOOOXXXXXXXXXXXXXXXXGOOXXXXXXXXXXXXXXXXXGOOOOXXXXXXXXXXXXXXXGOOOOOOXXXXXXXXXXXXXGOOOOOOOXXXXXXXXXXXXGOOOOOOXXXXXXXXXXXXXGOOXXXXXXXXXXXXXXXXXGOOOOOXXXXXXXXXXXXXXGOOOXXXXXXXXXXXXXXXXGOOOOOOOXXXXXXXXXXXX,0,0,0
14679,73,0,73,29,398,0,0,402,315,87,GOOXXXXXXXXXXXXXXXXXGOOOOOXXXXXXXXXXXXXXGOOOOOOOOXXXXXXXXXXXGOOOXXXXXXXXXXXXXXXXGOOXXXXXXXXXXXXXXXXXGOOOOXXXXXXXXXXXXXXXGOOOOOOXXXXXXXXXXXXXGOOOOOOOXXXXXXXXXXXXGOOOOOOXXXXXXXXXXXXXGOOXXXXXXXXXXXXXXXXXGOOOOOXXXXXXXXXXXXXXGOOOXXXXXXXXXXXXXXXXGOOOOOOOXXXXXXXXXXXX,0,0,0

14700,73,0,73,35,392,0,0,396,312,84,GOOXXXXXXXXXXXXXXXXXGOOOOOXXXXXXXXXXXXXXGOOOOOOOOXXXXXXXXXXXGOOOXXXXXXXXXXXXXXXXGOOXXXXXXXXXXXXXXXXXGOOOOXXXXXXXXXXXXXXXGOOOOOOXXXXXXXXXXXXXGOOOOOOOXXXXXXXXXXXXGOOOOOOXXXXXXXXXXXXXGOOXXXXXXXXXXXXXXXXXGOOOOOXXXXXXXXXXXXXXGOOOXXXXXXXXXXXXXXXXGOOOOOOOXXXXXXXXXXXX,0,0,0
14721,73,0,73,39,388,0,0,392,311,81,GOOXXXXXXXXXXXXXXXXXGOOOOOXXXXXXXXXXXXXXGOOOOOOOOXXXXXXXXXXXGOOOXXXXXXXXXXXXXXXXGOOXXXXXXXXXXXXXXXXXGOOOOXXXXXXXXXXXXXXXGOOOOOOXXXXXXXXXXXXXGOOOOOOOXXXXXXXXXXXXGOOOOOOXXXXXXXXXXXXXGOOXXXXXXXXXXXXXXXXXGOOOOOXXXXXXXXXXXXXXGOOOXXXXXXXXXXXXXXXXGOOOOOOOXXXXXXXXXXXX,0,0,0
14742,73,0,73,39,388,0,0,392,319,73,GOOXXXXXXXXXXXXXXXXXGOOOOOXXXXXXXXXXXXXXGOOOOOOOOXXXXXXXXXXXGOOOXXXXXXXXXXXXXXXXGOOXXXXXXXXXXXXXXXXXGOOOOXXXXXXXXXXXXXXXGOOOOOOXXXXXXXXXXXXXGOOOOOOOXXXXXXXXXXXXGOOOOOOXXXXXXXXXXXXXGOOXXXXXXXXXXXXXXXXXGOOOOOXXXXXXXXXXXXXXGOOOXXXXXXXXXXXXXXXXGOOOOOOOXXXXXXXXXXXX,0,0,0
14763,73,0,73,41,386,0,0,390,314,76,GOOXXXXXXXXXXXXXXXXXGOOOOOXXXXXXXXXXXXXXGOOOOOOOOXXXXXXXXXXXGOOOXXXXXXXXXXXXXXXXGOOXXXXXXXXXXXXXXXXXGOOOOXXXXXXXXXXXXXXXGOOOOOOXXXXXXXXXXXXXGOOOOOOOXXXXXXXXXXXXGOOOOOOXXXXXXXXXXXXXGOOXXXXXXXXXXXXXXXXXGOOOOOXXXXXXXXXXXXXXGOOOXXXXXXXXXXXXXXXXGOOOOOOOXXXXXXXXXXXX,0,0,0
14784,73,0,73,40,387,0,0,392,315,77,GOOXXXXXXXXXXXXXXXXXGOOOOOXXXXXXXXXXXXXXGOOOOOOOOXXXXXXXXXXXGOOOXXXXXXXXXXXXXXXXGOOXXXXXXXXXXXXXXXXXGOOOOXXXXXXXXXXXXXXXGOOOOOOXXXXXXXXXXXXXGOOOOOOOXXXXXXXXXXXXGOOOOOOXXXXXXXXXXXXXGOOXXXXXXXXXXXXXXXXXGOOOOOXXXXXXXXXXXXXXGOOOXXXXXXXXXXXXXXXXGOOOOOOOXXXXXXXXXXXX,0,0,0

14805,73,0,73,46,381,0,0,386,312,74,GOOXXXXXXXXXXXXXXXXXGOOOOOXXXXXXXXXXXXXXGOOOOOOOOXXXXXXXXXXXGOOOXXXXXXXXXXXXXXXXGOOXXXXXXXXXXXXXXXXXGOOOOXXXXXXXXXXXXXXXGOOOOOOXXXXXXXXXXXXXGOOOOOOOXXXXXXXXXXXXGOOOOOOXXXXXXXXXXXXXGOOXXXXXXXXXXXXXXXXXGOOOOOXXXXXXXXXXXXXXGOOOXXXXXXXXXXXXXXXXGOOOOOOOXXXXXXXXXXXX,0,0,0
14826,73,0,73,44,383,0,0,388,315,73,GOOXXXXXXXXXXXXXXXXXGOOOOOXXXXXXXXXXXXXXGOOOOOOOOXXXXXXXXXXXGOOOXXXXXXXXXXXXXXXXGOOXXXXXXXXXXXXXXXXXGOOOOXXXXXXXXXXXXXXXGOOOOOOXXXXXXXXXXXXXGOOOOOOOXXXXXXXXXXXXGOOOOOOXXXXXXXXXXXXXGOOXXXXXXXXXXXXXXXXXGOOOOOXXXXXXXXXXXXXXGOOOXXXXXXXXXXXXXXXXGOOOOOOOXXXXXXXXXXXX,0,0,0
14847,73,0,73,44,383,0,0,388,315,73,GOOXXXXXXXXXXXXXXXXXGOOOOOXXXXXXXXXXXXXXGOOOOOOOOXXXXXXXXXXXGOOOXXXXXXXXXXXXXXXXGOOXXXXXXXXXXXXXXXXXGOOOOXXXXXXXXXXXXXXXGOOOOOOXXXXXXXXXXXXXGOOOOOOOXXXXXXXXXXXXGOOOOOOXXXXXXXXXXXXXGOOXXXXXXXXXXXXXXXXXGOOOOOXXXXXXXXXXXXXXGOOOXXXXXXXXXXXXXXXXGOOOOOOOXXXXXXXXXXXX,0,0,0
14868,73,0,73,45,382,0,0,387,316,71,GOOXXXXXXXXXXXXXXXXXGOOOOOXXXXXXXXXXXXXXGOOOOOOOOXXXXXXXXXXXGOOOXXXXXXXXXXXXXXXXGOOXXXXXXXXXXXXXXXXXGOOOOXXXXXXXXXXXXXXXGOOOOOOXXXXXXXXXXXXXGOOOOOOOXXXXXXXXXXXXGOOOOOOXXXXXXXXXXXXXGOOXXXXXXXXXXXXXXXXXGOOOOOXXXXXXXXXXXXXXGOOOXXXXXXXXXXXXXXXXGOOOOOOOXXXXXXXXXXXX,0,0,0
14889,73,0,73,46,381,0,0,386,316,70,GOOXXXXXXXXXXXXXXXXXGOOOOOXXXXXXXXXXXXXXGOOOOOOOOXXXXXXXXXXXGOOOXXXXXXXXXXXXXXXXGOOXXXXXXXXXXXXXXXXXGOOOOXXXXXXXXXXXXXXXGOOOOOOXXXXXXXXXXXXXGOOOOOOOXXXXXXXXXXXXGOOOOOOXXXXXXXXXXXXXGOOXXXXXXXXXXXXXXXXXGOOOOOXXXXXXXXXXXXXXGOOOXXXXXXXXXXXXXXXXGOOOOOOOXXXXXXXXXXXX,0,0,0

14910,73,0,73,41,386,0,0,391,314,77,GOOXXXXXXXXXXXXXXXXXGOOOOOXXXXXXXXXXXXXXGOOOOOOOOXXXXXXXXXXXGOOOXXXXXXXXXXXXXXXXGOOXXXXXXXXXXXXXXXXXGOOOOXXXXXXXXXXXXXXXGOOOOOOXXXXXXXXXXXXXGOOOOOOOXXXXXXXXXXXXGOOOOOOXXXXXXXXXXXXXGOOXXXXXXXXXXXXXXXXXGOOOOOXXXXXXXXXXXXXXGOOOXXXXXXXXXXXXXXXXGOOOOOOOXXXXXXXXXXXX,0,0,0
14931,73,0,73,41,386,0,0,391,316,75,GOOXXXXXXXXXXXXXXXXXGOOOOOXXXXXXXXXXXXXXGOOOOOOOOXXXXXXXXXXXGOOOXXXXXXXXXXXXXXXXGOOXXXXXXXXXXXXXXXXXGOOOOXXXXXXXXXXXXXXXGOOOOOOXXXXXXXXXXXXXGOOOOOOOXXXXXXXXXXXXGOOOOOOXXXXXXXXXXXXXGOOXXXXXXXXXXXXXXXXXGOOOOOXXXXXXXXXXXXXXGOOOXXXXXXXXXXXXXXXXGOOOOOOOXXXXXXXXXXXX,0,0,0
14952,73,0,73,39,388,0,0,393,314,79,GOOXXXXXXXXXXXXXXXXXGOOOOOXXXXXXXXXXXXXXGOOOOOOOOXXXXXXXXXXXGOOOXXXXXXXXXXXXXXXXGOOXXXXXXXXXXXXXXXXXGOOOOXXXXXXXXXXXXXXXGOOOOOOXXXXXXXXXXXXXGOOOOOOOXXXXXXXXXXXXGOOOOOOXXXXXXXXXXXXXGOOXXXXXXXXXXXXXXXXXGOOOOOXXXXXXXXXXXXXXGOOOXXXXXXXXXXXXXXXXGOOOOOOOXXXXXXXXXXXX,0,0,0
14973,73,0,73,40,387,0,0,391,317,74,GOOXXXXXXXXXXXXXXXXXGOOOOOXXXXXXXXXXXXXXGOOOOOOOOXXXXXXXXXXXGOOOXXXXXXXXXXXXXXXXGOOXXXXXXXXXXXXXXXXXGOOOOXXXXXXXXXXXXXXXGOOOOOOXXXXXXXXXXXXXGOOOOOOOXXXXXXXXXXXXGOOOOOOXXXXXXXXXXXXXGOOXXXXXXXXXXXXXXXXXGOOOOOXXXXXXXXXXXXXXGOOOXXXXXXXXXXXXXXXXGOOOOOOOXXXXXXXXXXXX,0,0,0
14994,73,0,73,42,385,0,0,389,314,75,GOOXXXXXXXXXXXXXXXXXGOOOOOXXXXXXXXXXXXXXGOOOOOOOOXXXXXXXXXXXGOOOXXXXXXXXXXXXXXXXGOOXXXXXXXXXXXXXXXXXGOOOOXXXXXXXXXXXXXXXGOOOOOOXXXXXXXXXXXXXGOOOOOOOXXXXXXXXXXXXGOOOOOOXXXXXXXXXXXXXGOOXXXXXXXXXXXXXXXXXGOOOOOXXXXXXXXXXXXXXGOOOXXXXXXXXXXXXXXXXGOOOOOOOXXXXXXXXXXXX,0,0,0

15015,73,0,73,46,381,0,0,386,314,72,GOOXXXXXXXXXXXXXXXXXGOOOOOXXXXXXXXXXXXXXGOOOOOOOOXXXXXXXXXXXGOOOXXXXXXXXXXXXXXXXGOOXXXXXXXXXXXXXXXXXGOOOOXXXXXXXXXXXXXXXGOOOOOOXXXXXXXXXXXXXGOOOOOOOXXXXXXXXXXXXGOOOOOOXXXXXXXXXXXXXGOOXXXXXXXXXXXXXXXXXGOOOOOXXXXXXXXXXXXXXGOOOXXXXXXXXXXXXXXXXGOOOOOOOXXXXXXXXXXXX,0,0,0
15036,73,0,73,42,385,0,0,390,317,73,GOOXXXXXXXXXXXXXXXXXGOOOOOXXXXXXXXXXXXXXGOOOOOOOOXXXXXXXXXXXGOOOXXXXXXXXXXXXXXXXGOOXXXXXXXXXXXXXXXXXGOOOOXXXXXXXXXXXXXXXGOOOOOOXXXXXXXXXXXXXGOOOOOOOXXXXXXXXXXXXGOOOOOOXXXXXXXXXXXXXGOOXXXXXXXXXXXXXXXXXGOOOOOXXXXXXXXXXXXXXGOOOXXXXXXXXXXXXXXXXGOOOOOOOXXXXXXXXXXXX,0,0,0
15057,73,0,73,44,383,0,0,388,317,71,GOOXXXXXXXXXXXXXXXXXGOOOOOXXXXXXXXXXXXXXGOOOOOOOOXXXXXXXXXXXGOOOXXXXXXXXXXXXXXXXGOOXXXXXXXXXXXXXXXXXGOOOOXXXXXXXXXXXXXXXGOOOOOOXXXXXXXXXXXXXGOOOOOOOXXXXXXXXXXXXGOOOOOOXXXXXXXXXXXXXGOOXXXXXXXXXXXXXXXXXGOOOOOXXXXXXXXXXXXXXGOOOXXXXXXXXXXXXXXXXGOOOOOOOXXXXXXXXXXXX,0,0,0
15078,73,0,73,43,384,0,0,388,315,73,GOOXXXXXXXXXXXXXXXXXGOOOOOXXXXXXXXXXXXXXGOOOOOOOOXXXXXXXXXXXGOOOXXXXXXXXXXXXXXXXGOOXXXXXXXXXXXXXXXXXGOOOOXXXXXXXXXXXXXXXGOOOOOOXXXXXXXXXXXXXGOOOOOOOXXXXXXXXXXXXGOOOOOOXXXXXXXXXXXXXGOOXXXXXXXXXXXXXXXXXGOOOOOXXXXXXXXXXXXXXGOOOXXXXXXXXXXXXXXXXGOOOOOOOXXXXXXXXXXXX,0,0,0
15099,73,0,73,43,384,0,0,390,316,74,GOOXXXXXXXXXXXXXXXXXGOOOOOXXXXXXXXXXXXXXGOOOOOOOOXXXXXXXXXXXGOOOXXXXXXXXXXXXXXXXGOOXXXXXXXXXXXXXXXXXGOOOOXXXXXXXXXXXXXXXGOOOOOOXXXXXXXXXXXXXGOOOOOOOXXXXXXXXXXXXGOOOOOOXXXXXXXXXXXXXGOOXXXXXXXXXXXXXXXXXGOOOOOXXXXXXXXXXXXXXGOOOXXXXXXXXXXXXXXXXGOOOOOOOXXXXXXXXXXXX,0,0,0

15120,74,1,73,47,379,0,0,384,317,67,GOOXXXXXXXXXXXXXXXXXGOOOOOXXXXXXXXXXXXXXGOOOOOOOOXXXXXXXXXXXGOOOXXXXXXXXXXXXXXXXGOOXXXXXXXXXXXXXXXXXGOOOOXXXXXXXXXXXXXXXGOOOOOOXXXXXXXXXXXXXGOOOOOOOAXXXXXXXXXXXGOOOOOOXXXXXXXXXXXXXGOOXXXXXXXXXXXXXXXXXGOOOOOXXXXXXXXXXXXXXGOOOXXXXXXXXXXXXXXXXGOOOOOOOXXXXXXXXXXXX,0,0,0
15141,74,1,73,47,379,0,0,384,317,67,GOOXXXXXXXXXXXXXXXXXGOOOOOXXXXXXXXXXXXXXGOOOOOOOOXXXXXXXXXXXGOOOXXXXXXXXXXXXXXXXGOOXXXXXXXXXXXXXXXXXGOOOOXXXXXXXXXXXXXXXGOOOOOOXXXXXXXXXXXXXGOOOOOOOAXXXXXXXXXXXGOOOOOOXXXXXXXXXXXXXGOOXXXXXXXXXXXXXXXXXGOOOOOXXXXXXXXXXXXXXGOOOXXXXXXXXXXXXXXXXGOOOOOOOXXXXXXXXXXXX,0,0,0
15162,74,1,73,44,382,0,0,387,316,71,GOOXXXXXXXXXXXXXXXXXGOOOOOXXXXXXXXXXXXXXGOOOOOOOOXXXXXXXXXXXGOOOXXXXXXXXXXXXXXXXGOOXXXXXXXXXXXXXXXXXGOOOOXXXXXXXXXXXXXXXGOOOOOOXXXXXXXXXXXXXGOOOOOOOAXXXXXXXXXXXGOOOOOOXXXXXXXXXXXXXGOOXXXXXXXXXXXXXXXXXGOOOOOXXXXXXXXXXXXXXGOOOXXXXXXXXXXXXXXXXGOOOOOOOXXXXXXXXXXXX,0,0,0
15183,74,0,74,43,383,0,0,388,316,72,GOOXXXXXXXXXXXXXXXXXGOOOOOXXXXXXXXXXXXXXGOOOOOOOOXXXXXXXXXXXGOOOXXXXXXXXXXXXXXXXGOOXXXXXXXXXXXXXXXXXGOOOOXXXXXXXXXXXXXXXGOOOOOOXXXXXXXXXXXXXGOOOOOOOOXXXXXXXXXXXGOOOOOOXXXXXXXXXXXXXGOOXXXXXXXXXXXXXXXXXGOOOOOXXXXXXXXXXXXXXGOOOXXXXXXXXXXXXXXXXGOOOOOOOXXXXXXXXXXXX,0,0,0
15204,74,0,74,37,389,0,0,394,316,78,GOOXXXXXXXXXXXXXXXXXGOOOOOXXXXXXXXXXXXXXGOOOOOOOOXXXXXXXXXXXGOOOXXXXXXXXXXXXXXXXGOOXXXXXXXXXXXXXXXXXGOOOOXXXXXXXXXXXXXXXGOOOOOOXXXXXXXXXXXXXGOOOOOOOOXXXXXXXXXXXGOOOOOOXXXXXXXXXXXXXGOOXXXXXXXXXXXXXXXXXGOOOOOXXXXXXXXXXXXXXGOOOXXXXXXXXXXXXXXXXGOOOOOOOXXXXXXXXXXXX,0,0,0

15225,74,0,74,39,387,0,0,392,320,72,GOOXXXXXXXXXXXXXXXXXGOOOOOXXXXXXXXXXXXXXGOOOOOOOOXXXXXXXXXXXGOOOXXXXXXXXXXXXXXXXGOOXXXXXXXXXXXXXXXXXGOOOOXXXXXXXXXXXXXXXGOOOOOOXXXXXXXXXXXXXGOOOOOOOOXXXXXXXXXXXGOOOOOOXXXXXXXXXXXXXGOOXXXXXXXXXXXXXXXXXGOOOOOXXXXXXXXXXXXXXGOOOXXXXXXXXXXXXXXXXGOOOOOOOXXXXXXXXXXXX,0,0,0
15246,74,0,74,42,384,0,0,389,319,70,GOOXXXXXXXXXXXXXXXXXGOOOOOXXXXXXXXXXXXXXGOOOOOOOOXXXXXXXXXXXGOOOXXXXXXXXXXXXXXXXGOOXXXXXXXXXXXXXXXXXGOOOOXXXXXXXXXXXXXXXGOOOOOOXXXXXXXXXXXXXGOOOOOOOOXXXXXXXXXXXGOOOOOOXXXXXXXXXXXXXGOOXXXXXXXXXXXXXXXXXGOOOOOXXXXXXXXXXXXXXGOOOXXXXXXXXXXXXXXXXGOOOOOOOXXXXXXXXXXXX,0,0,0
15267,74,0,74,41,385,0,0,390,316,74,GOOXXXXXXXXXXXXXXXXXGOOOOOXXXXXXXXXXXXXXGOOOOOOOOXXXXXXXXXXXGOOOXXXXXXXXXXXXXXXXGOOXXXXXXXXXXXXXXXXXGOOOOXXXXXXXXXXXXXXXGOOOOOOXXXXXXXXXXXXXGOOOOOOOOXXXXXXXXXXXGOOOOOOXXXXXXXXXXXXXGOOXXXXXXXXXXXXXXXXXGOOOOOXXXXXXXXXXXXXXGOOOXXXXXXXXXXXXXXXXGOOOOOOOXXXXXXXXXXXX,0,0,0
15288,74,0,74,40,386,0,0,391,316,75,GOOXXXXXXXXXXXXXXXXXGOOOOOXXXXXXXXXXXXXXGOOOOOOOOXXXXXXXXXXXGOOOXXXXXXXXXXXXXXXXGOOXXXXXXXXXXXXXXXXXGOOOOXXXXXXXXXXXXXXXGOOOOOOXXXXXXXXXXXXXGOOOOOOOOXXXXXXXXXXXGOOOOOOXXXXXXXXXXXXXGOOXXXXXXXXXXXXXXXXXGOOOOOXXXXXXXXXXXXXXGOOOXXXXXXXXXXXXXXXXGOOOOOOOXXXXXXXXXXXX,0,0,0
15309,74,0,74,32,394,0,0,398,317,81,GOOXXXXXXXXXXXXXXXXXGOOOOOXXXXXXXXXXXXXXGOOOOOOOOXXXXXXXXXXXGOOOXXXXXXXXXXXXXXXXGOOXXXXXXXXXXXXXXXXXGOOOOXXXXXXXXXXXXXXXGOOOOOOXXXXXXXXXXXXXGOOOOOOOOXXXXXXXXXXXGOOOOOOXXXXXXXXXXXXXGOOXXXXXXXXXXXXXXXXXGOOOOOXXXXXXXXXXXXXXGOOOXXXXXXXXXXXXXXXXGOOOOOOOXXXXXXXXXXXX,0,0,0

15330,74,0,74,30,396,0,0,401,321,80,GOOXXXXXXXXXXXXXXXXXGOOOOOXXXXXXXXXXXXXXGOOOOOOOOXXXXXXXXXXXGOOOXXXXXXXXXXXXXXXXGOOXXXXXXXXXXXXXXXXXGOOOOXXXXXXXXXXXXXXXGOOOOOOXXXXXXXXXXXXXGOOOOOOOOXXXXXXXXXXXGOOOOOOXXXXXXXXXXXXXGOOXXXXXXXXXXXXXXXXXGOOOOOXXXXXXXXXXXXXXGOOOXXXXXXXXXXXXXXXXGOOOOOOOXXXXXXXXXXXX,0,0,0
15351,74,0,74,35,391,0,0,396,319,77,GOOXXXXXXXXXXXXXXXXXGOOOOOXXXXXXXXXXXXXXGOOOOOOOOXXXXXXXXXXXGOOOXXXXXXXXXXXXXXXXGOOXXXXXXXXXXXXXXXXXGOOOOXXXXXXXXXXXXXXXGOOOOOOXXXXXXXXXXXXXGOOOOOOOOXXXXXXXXXXXGOOOOOOXXXXXXXXXXXXXGOOXXXXXXXXXXXXXXXXXGOOOOOXXXXXXXXXXXXXXGOOOXXXXXXXXXXXXXXXXGOOOOOOOXXXXXXXXXXXX,0,0,0
15372,74,0,74,38,388,0,0,392,322,70,GOOXXXXXXXXXXXXXXXXXGOOOOOXXXXXXXXXXXXXXGOOOOOOOOXXXXXXXXXXXGOOOXXXXXXXXXXXXXXXXGOOXXXXXXXXXXXXXXXXXGOOOOXXXXXXXXXXXXXXXGOOOOOOXXXXXXXXXXXXXGOOOOOOOOXXXXXXXXXXXGOOOOOOXXXXXXXXXXXXXGOOXXXXXXXXXXXXXXXXXGOOOOOXXXXXXXXXXXXXXGOOOXXXXXXXXXXXXXXXXGOOOOOOOXXXXXXXXXXXX,0,0,0
15393,74,0,74,38,388,0,0,393,322,71,GOOXXXXXXXXXXXXXXXXXGOOOOOXXXXXXXXXXXXXXGOOOOOOOOXXXXXXXXXXXGOOOXXXXXXXXXXXXXXXXGOOXXXXXXXXXXXXXXXXXGOOOOXXXXXXXXXXXXXXXGOOOOOOXXXXXXXXXXXXXGOOOOOOOOXXXXXXXXXXXGOOOOOOXXXXXXXXXXXXXGOOXXXXXXXXXXXXXXXXXGOOOOOXXXXXXXXXXXXXXGOOOXXXXXXXXXXXXXXXXGOOOOOOOXXXXXXXXXXXX,0,0,0
15414,74,0,74,42,384,0,0,389,321,68,GOOXXXXXXXXXXXXXXXXXGOOOOOXXXXXXXXXXXXXXGOOOOOOOOXXXXXXXXXXXGOOOXXXXXXXXXXXXXXXXGOOXXXXXXXXXXXXXXXXXGOOOOXXXXXXXXXXXXXXXGOOOOOOXXXXXXXXXXXXXGOOOOOOOOXXXXXXXXXXXGOOOOOOXXXXXXXXXXXXXGOOXXXXXXXXXXXXXXXXXGOOOOOXXXXXXXXXXXXXXGOOOXXXXXXXXXXXXXXXXGOOOOOOOXXXXXXXXXXXX,0,0,0

15435,74,0,74,43,383,0,0,388,324,64,GOOXXXXXXXXXXXXXXXXXGOOOOOXXXXXXXXXXXXXXGOOOOOOOOXXXXXXXXXXXGOOOXXXXXXXXXXXXXXXXGOOXXXXXXXXXXXXXXXXXGOOOOXXXXXXXXXXXXXXXGOOOOOOXXXXXXXXXXXXXGOOOOOOOOXXXXXXXXXXXGOOOOOOXXXXXXXXXXXXXGOOXXXXXXXXXXXXXXXXXGOOOOOXXXXXXXXXXXXXXGOOOXXXXXXXXXXXXXXXXGOOOOOOOXXXXXXXXXXXX,0,0,0
15456,74,0,74,43,383,0,0,387,321,66,GOOXXXXXXXXXXXXXXXXXGOOOOOXXXXXXXXXXXXXXGOOOOOOOOXXXXXXXXXXXGOOOXXXXXXXXXXXXXXXXGOOXXXXXXXXXXXXXXXXXGOOOOXXXXXXXXXXXXXXXGOOOOOOXXXXXXXXXXXXXGOOOOOOOOXXXXXXXXXXXGOOOOOOXXXXXXXXXXXXXGOOXXXXXXXXXXXXXXXXXGOOOOOXXXXXXXXXXXXXXGOOOXXXXXXXXXXXXXXXXGOOOOOOOXXXXXXXXXXXX,0,0,0
15477,74,0,74,37,389,0,0,394,321,73,GOOXXXXXXXXXXXXXXXXXGOOOOOXXXXXXXXXXXXXXGOOOOOOOOXXXXXXXXXXXGOOOXXXXXXXXXXXXXXXXGOOXXXXXXXXXXXXXXXXXGOOOOXXXXXXXXXXXXXXXGOOOOOOXXXXXXXXXXXXXGOOOOOOOOXXXXXXXXXXXGOOOOOOXXXXXXXXXXXXXGOOXXXXXXXXXXXXXXXXXGOOOOOXXXXXXXXXXXXXXGOOOXXXXXXXXXXXXXXXXGOOOOOOOXXXXXXXXXXXX,0,0,0
15498,74,0,74,33,393,0,0,398,325,73,GOOXXXXXXXXXXXXXXXXXGOOOOOXXXXXXXXXXXXXXGOOOOOOOOXXXXXXXXXXXGOOOXXXXXXXXXXXXXXXXGOOXXXXXXXXXXXXXXXXXGOOOOXXXXXXXXXXXXXXXGOOOOOOXXXXXXXXXXXXXGOOOOOOOOXXXXXXXXXXXGOOOOOOXXXXXXXXXXXXXGOOXXXXXXXXXXXXXXXXXGOOOOOXXXXXXXXXXXXXXGOOOXXXXXXXXXXXXXXXXGOOOOOOOXXXXXXXXXXXX,0,0,0
15519,74,0,74,35,391,0,0,396,324,72,GOOXXXXXXXXXXXXXXXXXGOOOOOXXXXXXXXXXXXXXGOOOOOOOOXXXXXXXXXXXGOOOXXXXXXXXXXXXXXXXGOOXXXXXXXXXXXXXXXXXGOOOOXXXXXXXXXXXXXXXGOOOOOOXXXXXXXXXXXXXGOOOOOOOOXXXXXXXXXXXGOOOOOOXXXXXXXXXXXXXGOOXXXXXXXXXXXXXXXXXGOOOOOXXXXXXXXXXXXXXGOOOXXXXXXXXXXXXXXXXGOOOOOOOXXXXXXXXXXXX,0,0,0

15540,74,0,74,33,393,0,0,398,323,75,GOOXXXXXXXXXXXXXXXXXGOOOOOXXXXXXXXXXXXXXGOOOOOOOOXXXXXXXXXXXGOOOXXXXXXXXXXXXXXXXGOOXXXXXXXXXXXXXXXXXGOOOOXXXXXXXXXXXXXXXGOOOOOOXXXXXXXXXXXXXGOOOOOOOOXXXXXXXXXXXGOOOOOOXXXXXXXXXXXXXGOOXXXXXXXXXXXXXXXXXGOOOOOXXXXXXXXXXXXXXGOOOXXXXXXXXXXXXXXXXGOOOOOOOXXXXXXXXXXXX,0,0,0
15561,74,0,74,37,389,0,0,395,321,74,GOOXXXXXXXXXXXXXXXXXGOOOOOXXXXXXXXXXXXXXGOOOOOOOOXXXXXXXXXXXGOOOXXXXXXXXXXXXXXXXGOOXXXXXXXXXXXXXXXXXGOOOOXXXXXXXXXXXXXXXGOOOOOOXXXXXXXXXXXXXGOOOOOOOOXXXXXXXXXXXGOOOOOOXXXXXXXXXXXXXGOOXXXXXXXXXXXXXXXXXGOOOOOXXXXXXXXXXXXXXGOOOXXXXXXXXXXXXXXXXGOOOOOOOXXXXXXXXXXXX,0,0,0
15582,74,0,74,37,389,0,0,396,322,74,GOOXXXXXXXXXXXXXXXXXGOOOOOXXXXXXXXXXXXXXGOOOOOOOOXXXXXXXXXXXGOOOXXXXXXXXXXXXXXXXGOOXXXXXXXXXXXXXXXXXGOOOOXXXXXXXXXXXXXXXGOOOOOOXXXXXXXXXXXXXGOOOOOOOOXXXXXXXXXXXGOOOOOOXXXXXXXXXXXXXGOOXXXXXXXXXXXXXXXXXGOOOOOXXXXXXXXXXXXXXGOOOXXXXXXXXXXXXXXXXGOOOOOOOXXXXXXXXXXXX,0,0,0
15603,74,0,74,35,391,0,0,398,323,75,GOOXXXXXXXXXXXXXXXXXGOOOOOXXXXXXXXXXXXXXGOOOOOOOOXXXXXXXXXXXGOOOXXXXXXXXXXXXXXXXGOOXXXXXXXXXXXXXXXXXGOOOOXXXXXXXXXXXXXXXGOOOOOOXXXXXXXXXXXXXGOOOOOOOOXXXXXXXXXXXGOOOOOOXXXXXXXXXXXXXGOOXXXXXXXXXXXXXXXXXGOOOOOXXXXXXXXXXXXXXGOOOXXXXXXXXXXXXXXXXGOOOOOOOXXXXXXXXXXXX,0,0,0
15624,74,0,74,33,393,0,0,400,324,76,GOOXXXXXXXXXXXXXXXXXGOOOOOXXXXXXXXXXXXXXGOOOOOOOOXXXXXXXXXXXGOOOXXXXXXXXXXXXXXXXGOOXXXXXXXXXXXXXXXXXGOOOOXXXXXXXXXXXXXXXGOOOOOOXXXXXXXXXXXXXGOOOOOOOOXXXXXXXXXXXGOOOOOOXXXXXXXXXXXXXGOOXXXXXXXXXXXXXXXXXGOOOOOXXXXXXXXXXXXXXGOOOXXXXXXXXXXXXXXXXGOOOOOOOXXXXXXXXXXXX,0,0,0

15645,74,0,74,30,396,0,0,403,323,80,GOOXXXXXXXXXXXXXXXXXGOOOOOXXXXXXXXXXXXXXGOOOOOOOOXXXXXXXXXXXGOOOXXXXXXXXXXXXXXXXGOOXXXXXXXXXXXXXXXXXGOOOOXXXXXXXXXXXXXXXGOOOOOOXXXXXXXXXXXXXGOOOOOOOOXXXXXXXXXXXGOOOOOOXXXXXXXXXXXXXGOOXXXXXXXXXXXXXXXXXGOOOOOXXXXXXXXXXXXXXGOOOXXXXXXXXXXXXXXXXGOOOOOOOXXXXXXXXXXXX,0,0,0
15666,74,0,74,27,399,0,0,405,323,82,GOOXXXXXXXXXXXXXXXXXGOOOOOXXXXXXXXXXXXXXGOOOOOOOOXXXXXXXXXXXGOOOXXXXXXXXXXXXXXXXGOOXXXXXXXXXXXXXXXXXGOOOOXXXXXXXXXXXXXXXGOOOOOOXXXXXXXXXXXXXGOOOOOOOOXXXXXXXXXXXGOOOOOOXXXXXXXXXXXXXGOOXXXXXXXXXXXXXXXXXGOOOOOXXXXXXXXXXXXXXGOOOXXXXXXXXXXXXXXXXGOOOOOOOXXXXXXXXXXXX,0,0,0
15687,74,0,74,28,398,0,0,403,325,78,GOOXXXXXXXXXXXXXXXXXGOOOOOXXXXXXXXXXXXXXGOOOOOOOOXXXXXXXXXXXGOOOXXXXXXXXXXXXXXXXGOOXXXXXXXXXXXXXXXXXGOOOOXXXXXXXXXXXXXXXGOOOOOOXXXXXXXXXXXXXGOOOOOOOOXXXXXXXXXXXGOOOOOOXXXXXXXXXXXXXGOOXXXXXXXXXXXXXXXXXGOOOOOXXXXXXXXXXXXXXGOOOXXXXXXXXXXXXXXXXGOOOOOOOXXXXXXXXXXXX,0,0,0
15708,74,0,74,28,398,0,0,403,326,77,GOOXXXXXXXXXXXXXXXXXGOOOOOXXXXXXXXXXXXXXGOOOOOOOOXXXXXXXXXXXGOOOXXXXXXXXXXXXXXXXGOOXXXXXXXXXXXXXXXXXGOOOOXXXXXXXXXXXXXXXGOOOOOOXXXXXXXXXXXXXGOOOOOOOOXXXXXXXXXXXGOOOOOOXXXXXXXXXXXXXGOOXXXXXXXXXXXXXXXXXGOOOOOXXXXXXXXXXXXXXGOOOXXXXXXXXXXXXXXXXGOOOOOOOXXXXXXXXXXXX,0,0,0
15729,74,0,74,29,397,0,0,402,326,76,GOOXXXXXXXXXXXXXXXXXGOOOOOXXXXXXXXXXXXXXGOOOOOOOOXXXXXXXXXXXGOOOXXXXXXXXXXXXXXXXGOOXXXXXXXXXXXXXXXXXGOOOOXXXXXXXXXXXXXXXGOOOOOOXXXXXXXXXXXXXGOOOOOOOOXXXXXXXXXXXGOOOOOOXXXXXXXXXXXXXGOOXXXXXXXXXXXXXXXXXGOOOOOXXXXXXXXXXXXXXGOOOXXXXXXXXXXXXXXXXGOOOOOOOXXXXXXXXXXXX,0,0,0

15750,74,0,74,32,394,0,0,398,324,74,GOOXXXXXXXXXXXXXXXXXGOOOOOXXXXXXXXXXXXXXGOOOOOOOOXXXXXXXXXXXGOOOXXXXXXXXXXXXXXXXGOOXXXXXXXXXXXXXXXXXGOOOOXXXXXXXXXXXXXXXGOOOOOOXXXXXXXXXXXXXGOOOOOOOOXXXXXXXXXXXGOOOOOOXXXXXXXXXXXXXGOOXXXXXXXXXXXXXXXXXGOOOOOXXXXXXXXXXXXXXGOOOXXXXXXXXXXXXXXXXGOOOOOOOXXXXXXXXXXXX,0,0,0
15771,74,0,74,34,392,0,0,397,328,69,GOOXXXXXXXXXXXXXXXXXGOOOOOXXXXXXXXXXXXXXGOOOOOOOOXXXXXXXXXXXGOOOXXXXXXXXXXXXXXXXGOOXXXXXXXXXXXXXXXXXGOOOOXXXXXXXXXXXXXXXGOOOOOOXXXXXXXXXXXXXGOOOOOOOOXXXXXXXXXXXGOOOOOOXXXXXXXXXXXXXGOOXXXXXXXXXXXXXXXXXGOOOOOXXXXXXXXXXXXXXGOOOXXXXXXXXXXXXXXXXGOOOOOOOXXXXXXXXXXXX,0,0,0
15792,74,0,74,37,389,0,0,393,328,65,GOOXXXXXXXXXXXXXXXXXGOOOOOXXXXXXXXXXXXXXGOOOOOOOOXXXXXXXXXXXGOOOXXXXXXXXXXXXXXXXGOOXXXXXXXXXXXXXXXXXGOOOOXXXXXXXXXXXXXXXGOOOOOOXXXXXXXXXXXXXGOOOOOOOOXXXXXXXXXXXGOOOOOOXXXXXXXXXXXXXGOOXXXXXXXXXXXXXXXXXGOOOOOXXXXXXXXXXXXXXGOOOXXXXXXXXXXXXXXXXGOOOOOOOXXXXXXXXXXXX,0,0,0
15813,74,0,74,43,383,0,0,388,327,61,GOOXXXXXXXXXXXXXXXXXGOOOOOXXXXXXXXXXXXXXGOOOOOOOOXXXXXXXXXXXGOOOXXXXXXXXXXXXXXXXGOOXXXXXXXXXXXXXXXXXGOOOOXXXXXXXXXXXXXXXGOOOOOOXXXXXXXXXXXXXGOOOOOOOOXXXXXXXXXXXGOOOOOOXXXXXXXXXXXXXGOOXXXXXXXXXXXXXXXXXGOOOOOXXXXXXXXXXXXXXGOOOXXXXXXXXXXXXXXXXGOOOOOOOXXXXXXXXXXXX,0,0,0
15834,74,0,74,40,386,0,0,391,328,63,GOOXXXXXXXXXXXXXXXXXGOOOOOXXXXXXXXXXXXXXGOOOOOOOOXXXXXXXXXXXGOOOXXXXXXXXXXXXXXXXGOOXXXXXXXXXXXXXXXXXGOOOOXXXXXXXXXXXXXXXGOOOOOOXXXXXXXXXXXXXGOOOOOOOOXXXXXXXXXXXGOOOOOOXXXXXXXXXXXXXGOOXXXXXXXXXXXXXXXXXGOOOOOXXXXXXXXXXXXXXGOOOXXXXXXXXXXXXXXXXGOOOOOOOXXXXXXXXXXXX,0,0,0

15855,75,1,74,44,381,0,0,386,326,60,GOOXXXXXXXXXXXXXXXXXGOOOOOXXXXXXXXXXXXXXGOOOOOOOOXXXXXXXXXXXGOOOXXXXXXXXXXXXXXXXGOOXXXXXXXXXXXXXXXXXGOOOOXXXXXXXXXXXXXXXGOOOOOOXXXXXXXXXXXXXGOOOOOOOOAXXXXXXXXXXGOOOOOOXXXXXXXXXXXXXGOOXXXXXXXXXXXXXXXXXGOOOOOXXXXXXXXXXXXXXGOOOXXXXXXXXXXXXXXXXGOOOOOOOXXXXXXXXXXXX,0,0,0
15876,75,1,74,41,384,0,0,389,325,64,GOOXXXXXXXXXXXXXXXXXGOOOOOXXXXXXXXXXXXXXGOOOOOOOOXXXXXXXXXXXGOOOXXXXXXXXXXXXXXXXGOOXXXXXXXXXXXXXXXXXGOOOOXXXXXXXXXXXXXXXGOOOOOOXXXXXXXXXXXXXGOOOOOOOOAXXXXXXXXXXGOOOOOOXXXXXXXXXXXXXGOOXXXXXXXXXXXXXXXXXGOOOOOXXXXXXXXXXXXXXGOOOXXXXXXXXXXXXXXXXGOOOOOOOXXXXXXXXXXXX,0,0,0
15897,75,0,75,41,384,0,0,389,329,60,GOOXXXXXXXXXXXXXXXXXGOOOOOXXXXXXXXXXXXXXGOOOOOOOOXXXXXXXXXXXGOOOXXXXXXXXXXXXXXXXGOOXXXXXXXXXXXXXXXXXGOOOOXXXXXXXXXXXXXXXGOOOOOOXXXXXXXXXXXXXGOOOOOOOOOXXXXXXXXXXGOOOOOOXXXXXXXXXXXXXGOOXXXXXXXXXXXXXXXXXGOOOOOXXXXXXXXXXXXXXGOOOXXXXXXXXXXXXXXXXGOOOOOOOXXXXXXXXXXXX,0,0,0
15918,75,0,75,42,383,0,0,388,328,60,GOOXXXXXXXXXXXXXXXXXGOOOOOXXXXXXXXXXXXXXGOOOOOOOOXXXXXXXXXXXGOOOXXXXXXXXXXXXXXXXGOOXXXXXXXXXXXXXXXXXGOOOOXXXXXXXXXXXXXXXGOOOOOOXXXXXXXXXXXXXGOOOOOOOOOXXXXXXXXXXGOOOOOOXXXXXXXXXXXXXGOOXXXXXXXXXXXXXXXXXGOOOOOXXXXXXXXXXXXXXGOOOXXXXXXXXXXXXXXXXGOOOOOOOXXXXXXXXXXXX,0,0,0
15939,75,0,75,41,384,0,0,389,325,64,GOOXXXXXXXXXXXXXXXXXGOOOOOXXXXXXXXXXXXXXGOOOOOOOOXXXXXXXXXXXGOOOXXXXXXXXXXXXXXXXGOOXXXXXXXXXXXXXXXXXGOOOOXXXXXXXXXXXXXXXGOOOOOOXXXXXXXXXXXXXGOOOOOOOOOXXXXXXXXXXGOOOOOOXXXXXXXXXXXXXGOOXXXXXXXXXXXXXXXXXGOOOOOXXXXXXXXXXXXXXGOOOXXXXXXXXXXXXXXXXGOOOOOOOXXXXXXXXXXXX,0,0,0

15960,75,0,75,39,386,0,0,391,328,63,GOOXXXXXXXXXXXXXXXXXGOOOOOXXXXXXXXXXXXXXGOOOOOOOOXXXXXXXXXXXGOOOXXXXXXXXXXXXXXXXGOOXXXXXXXXXXXXXXXXXGOOOOXXXXXXXXXXXXXXXGOOOOOOXXXXXXXXXXXXXGOOOOOOOOOXXXXXXXXXXGOOOOOOXXXXXXXXXXXXXGOOXXXXXXXXXXXXXXXXXGOOOOOXXXXXXXXXXXXXXGOOOXXXXXXXXXXXXXXXXGOOOOOOOXXXXXXXXXXXX,0,0,0
15981,75,0,75,40,385,0,0,390,327,63,GOOXXXXXXXXXXXXXXXXXGOOOOOXXXXXXXXXXXXXXGOOOOOOOOXXXXXXXXXXXGOOOXXXXXXXXXXXXXXXXGOOXXXXXXXXXXXXXXXXXGOOOOXXXXXXXXXXXXXXXGOOOOOOXXXXXXXXXXXXXGOOOOOOOOOXXXXXXXXXXGOOOOOOXXXXXXXXXXXXXGOOXXXXXXXXXXXXXXXXXGOOOOOXXXXXXXXXXXXXXGOOOXXXXXXXXXXXXXXXXGOOOOOOOXXXXXXXXXXXX,0,0,0
16002,75,0,75,38,387,0,0,392,328,64,GOOXXXXXXXXXXXXXXXXXGOOOOOXXXXXXXXXXXXXXGOOOOOOOOXXXXXXXXXXXGOOOXXXXXXXXXXXXXXXXGOOXXXXXXXXXXXXXXXXXGOOOOXXXXXXXXXXXXXXXGOOOOOOXXXXXXXXXXXXXGOOOOOOOOOXXXXXXXXXXGOOOOOOXXXXXXXXXXXXXGOOXXXXXXXXXXXXXXXXXGOOOOOXXXXXXXXXXXXXXGOOOXXXXXXXXXXXXXXXXGOOOOOOOXXXXXXXXXXXX,0,0,0
16023,75,0,75,37,388,0,0,392,326,66,GOOXXXXXXXXXXXXXXXXXGOOOOOXXXXXXXXXXXXXXGOOOOOOOOXXXXXXXXXXXGOOOXXXXXXXXXXXXXXXXGOOXXXXXXXXXXXXXXXXXGOOOOXXXXXXXXXXXXXXXGOOOOOOXXXXXXXXXXXXXGOOOOOOOOOXXXXXXXXXXGOOOOOOXXXXXXXXXXXXXGOOXXXXXXXXXXXXXXXXXGOOOOOXXXXXXXXXXXXXXGOOOXXXXXXXXXXXXXXXXGOOOOOOOXXXXXXXXXXXX,0,0,0
16044,75,0,75,37,388,0,0,393,326,67,GOOXXXXXXXXXXXXXXXXXGOOOOOXXXXXXXXXXXXXXGOOOOOOOOXXXXXXXXXXXGOOOXXXXXXXXXXXXXXXXGOOXXXXXXXXXXXXXXXXXGOOOOXXXXXXXXXXXXXXXGOOOOOOXXXXXXXXXXXXXGOOOOOOOOOXXXXXXXXXXGOOOOOOXXXXXXXXXXXXXGOOXXXXXXXXXXXXXXXXXGOOOOOXXXXXXXXXXXXXXGOOOXXXXXXXXXXXXXXXXGOOOOOOOXXXXXXXXXXXX,0,0,0

16065,75,0,75,35,390,0,0,395,327,68,GOOXXXXXXXXXXXXXXXXXGOOOOOXXXXXXXXXXXXXXGOOOOOOOOXXXXXXXXXXXGOOOXXXXXXXXXXXXXXXXGOOXXXXXXXXXXXXXXXXXGOOOOXXXXXXXXXXXXXXXGOOOOOOXXXXXXXXXXXXXGOOOOOOOOOXXXXXXXXXXGOOOOOOXXXXXXXXXXXXXGOOXXXXXXXXXXXXXXXXXGOOOOOXXXXXXXXXXXXXXGOOOXXXXXXXXXXXXXXXXGOOOOOOOXXXXXXXXXXXX,0,0,0
16086,75,0,75,36,389,0,0,394,329,65,GOOXXXXXXXXXXXXXXXXXGOOOOOXXXXXXXXXXXXXXGOOOOOOOOXXXXXXXXXXXGOOOXXXXXXXXXXXXXXXXGOOXXXXXXXXXXXXXXXXXGOOOOXXXXXXXXXXXXXXXGOOOOOOXXXXXXXXXXXXXGOOOOOOOOOXXXXXXXXXXGOOOOOOXXXXXXXXXXXXXGOOXXXXXXXXXXXXXXXXXGOOOOOXXXXXXXXXXXXXXGOOOXXXXXXXXXXXXXXXXGOOOOOOOXXXXXXXXXXXX,0,0,0
16107,75,0,75,38,387,0,0,392,326,66,GOOXXXXXXXXXXXXXXXXXGOOOOOXXXXXXXXXXXXXXGOOOOOOOOXXXXXXXXXXXGOOOXXXXXXXXXXXXXXXXGOOXXXXXXXXXXXXXXXXXGOOOOXXXXXXXXXXXXXXXGOOOOOOXXXXXXXXXXXXXGOOOOOOOOOXXXXXXXXXXGOOOOOOXXXXXXXXXXXXXGOOXXXXXXXXXXXXXXXXXGOOOOOXXXXXXXXXXXXXXGOOOXXXXXXXXXXXXXXXXGOOOOOOOXXXXXXXXXXXX,0,0,0
16128,75,0,75,36,389,0,0,394,329,65,GOOXXXXXXXXXXXXXXXXXGOOOOOXXXXXXXXXXXXXXGOOOOOOOOXXXXXXXXXXXGOOOXXXXXXXXXXXXXXXXGOOXXXXXXXXXXXXXXXXXGOOOOXXXXXXXXXXXXXXXGOOOOOOXXXXXXXXXXXXXGOOOOOOOOOXXXXXXXXXXGOOOOOOXXXXXXXXXXXXXGOOXXXXXXXXXXXXXXXXXGOOOOOXXXXXXXXXXXXXXGOOOXXXXXXXXXXXXXXXXGOOOOOOOXXXXXXXXXXXX,0,0,0
16149,75,0,75,38,387,0,0,392,332,60,GOOXXXXXXXXXXXXXXXXXGOOOOOXXXXXXXXXXXXXXGOOOOOOOOXXXXXXXXXXXGOOOXXXXXXXXXXXXXXXXGOOXXXXXXXXXXXXXXXXXGOOOOXXXXXXXXXXXXXXXGOOOOOOXXXXXXXXXXXXXGOOOOOOOOOXXXXXXXXXXGOOOOOOXXXXXXXXXXXXXGOOXXXXXXXXXXXXXXXXXGOOOOOXXXXXXXXXXXXXXGOOOXXXXXXXXXXXXXXXXGOOOOOOOXXXXXXXXXXXX,0,0,0

16170,75,0,75,35,390,0,0,395,327,68,GOOXXXXXXXXXXXXXXXXXGOOOOOXXXXXXXXXXXXXXGOOOOOOOOXXXXXXXXXXXGOOOXXXXXXXXXXXXXXXXGOOXXXXXXXXXXXXXXXXXGOOOOXXXXXXXXXXXXXXXGOOOOOOXXXXXXXXXXXXXGOOOOOOOOOXXXXXXXXXXGOOOOOOXXXXXXXXXXXXXGOOXXXXXXXXXXXXXXXXXGOOOOOXXXXXXXXXXXXXXGOOOXXXXXXXXXXXXXXXXGOOOOOOOXXXXXXXXXXXX,0,0,0
16191,75,0,75,33,392,0,0,397,328,69,GOOXXXXXXXXXXXXXXXXXGOOOOOXXXXXXXXXXXXXXGOOOOOOOOXXXXXXXXXXXGOOOXXXXXXXXXXXXXXXXGOOXXXXXXXXXXXXXXXXXGOOOOXXXXXXXXXXXXXXXGOOOOOOXXXXXXXXXXXXXGOOOOOOOOOXXXXXXXXXXGOOOOOOXXXXXXXXXXXXXGOOXXXXXXXXXXXXXXXXXGOOOOOXXXXXXXXXXXXXXGOOOXXXXXXXXXXXXXXXXGOOOOOOOXXXXXXXXXXXX,0,0,0
16212,75,0,75,30,395,0,0,400,328,72,GOOXXXXXXXXXXXXXXXXXGOOOOOXXXXXXXXXXXXXXGOOOOOOOOXXXXXXXXXXXGOOOXXXXXXXXXXXXXXXXGOOXXXXXXXXXXXXXXXXXGOOOOXXXXXXXXXXXXXXXGOOOOOOXXXXXXXXXXXXXGOOOOOOOOOXXXXXXXXXXGOOOOOOXXXXXXXXXXXXXGOOXXXXXXXXXXXXXXXXXGOOOOOXXXXXXXXXXXXXXGOOOXXXXXXXXXXXXXXXXGOOOOOOOXXXXXXXXXXXX,0,0,0
16233,75,0,75,27,398,0,0,403,329,74,GOOXXXXXXXXXXXXXXXXXGOOOOOXXXXXXXXXXXXXXGOOOOOOOOXXXXXXXXXXXGOOOXXXXXXXXXXXXXXXXGOOXXXXXXXXXXXXXXXXXGOOOOXXXXXXXXXXXXXXXGOOOOOOXXXXXXXXXXXXXGOOOOOOOOOXXXXXXXXXXGOOOOOOXXXXXXXXXXXXXGOOXXXXXXXXXXXXXXXXXGOOOOOXXXXXXXXXXXXXXGOOOXXXXXXXXXXXXXXXXGOOOOOOOXXXXXXXXXXXX,0,0,0
16254,75,0,75,26,399,0,0,404,328,76,GOOXXXXXXXXXXXXXXXXXGOOOOOXXXXXXXXXXXXXXGOOOOOOOOXXXXXXXXXXXGOOOXXXXXXXXXXXXXXXXGOOXXXXXXXXXXXXXXXXXGOOOOXXXXXXXXXXXXXXXGOOOOOOXXXXXXXXXXXXXGOOOOOOOOOXXXXXXXXXXGOOOOOOXXXXXXXXXXXXXGOOXXXXXXXXXXXXXXXXXGOOOOOXXXXXXXXXXXXXXGOOOXXXXXXXXXXXXXXXXGOOOOOOOXXXXXXXXXXXX,0,0,0

16275,75,0,75,29,396,0,0,401,330,71,GOOXXXXXXXXXXXXXXXXXGOOOOOXXXXXXXXXXXXXXGOOOOOOOOXXXXXXXXXXXGOOOXXXXXXXXXXXXXXXXGOOXXXXXXXXXXXXXXXXXGOOOOXXXXXXXXXXXXXXXGOOOOOOXXXXXXXXXXXXXGOOOOOOOOOXXXXXXXXXXGOOOOOOXXXXXXXXXXXXXGOOXXXXXXXXXXXXXXXXXGOOOOOXXXXXXXXXXXXXXGOOOXXXXXXXXXXXXXXXXGOOOOOOOXXXXXXXXXXXX,0,0,0
16296,75,0,75,30,395,0,0,400,330,70,GOOXXXXXXXXXXXXXXXXXGOOOOOXXXXXXXXXXXXXXGOOOOOOOOXXXXXXXXXXXGOOOXXXXXXXXXXXXXXXXGOOXXXXXXXXXXXXXXXXXGOOOOXXXXXXXXXXXXXXXGOOOOOOXXXXXXXXXXXXXGOOOOOOOOOXXXXXXXXXXGOOOOOOXXXXXXXXXXXXXGOOXXXXXXXXXXXXXXXXXGOOOOOXXXXXXXXXXXXXXGOOOXXXXXXXXXXXXXXXXGOOOOOOOXXXXXXXXXXXX,0,0,0
16317,75,0,75,28,397,0,0,402,332,70,GOOXXXXXXXXXXXXXXXXXGOOOOOXXXXXXXXXXXXXXGOOOOOOOOXXXXXXXXXXXGOOOXXXXXXXXXXXXXXXXGOOXXXXXXXXXXXXXXXXXGOOOOXXXXXXXXXXXXXXXGOOOOOOXXXXXXXXXXXXXGOOOOOOOOOXXXXXXXXXXGOOOOOOXXXXXXXXXXXXXGOOXXXXXXXXXXXXXXXXXGOOOOOXXXXXXXXXXXXXXGOOOXXXXXXXXXXXXXXXXGOOOOOOOXXXXXXXXXXXX,0,0,0
16338,75,0,75,30,395,0,0,400,330,70,GOOXXXXXXXXXXXXXXXXXGOOOOOXXXXXXXXXXXXXXGOOOOOOOOXXXXXXXXXXXGOOOXXXXXXXXXXXXXXXXGOOXXXXXXXXXXXXXXXXXGOOOOXXXXXXXXXXXXXXXGOOOOOOXXXXXXXXXXXXXGOOOOOOOOOXXXXXXXXXXGOOOOOOXXXXXXXXXXXXXGOOXXXXXXXXXXXXXXXXXGOOOOOXXXXXXXXXXXXXXGOOOXXXXXXXXXXXXXXXXGOOOOOOOXXXXXXXXXXXX,0,0,0
16359,75,0,75,30,395,0,0,399,331,68,GOOXXXXXXXXXXXXXXXXXGOOOOOXXXXXXXXXXXXXXGOOOOOOOOXXXXXXXXXXXGOOOXXXXXXXXXXXXXXXXGOOXXXXXXXXXXXXXXXXXGOOOOXXXXXXXXXXXXXXXGOOOOOOXXXXXXXXXXXXXGOOOOOOOOOXXXXXXXXXXGOOOOOOXXXXXXXXXXXXXGOOXXXXXXXXXXXXXXXXXGOOOOOXXXXXXXXXXXXXXGOOOXXXXXXXXXXXXXXXXGOOOOOOOXXXXXXXXXXXX,0,0,0

16380,75,0,75,33,392,0,0,395,329,66,GOOXXXXXXXXXXXXXXXXXGOOOOOXXXXXXXXXXXXXXGOOOOOOOOXXXXXXXXXXXGOOOXXXXXXXXXXXXXXXXGOOXXXXXXXXXXXXXXXXXGOOOOXXXXXXXXXXXXXXXGOOOOOOXXXXXXXXXXXXXGOOOOOOOOOXXXXXXXXXXGOOOOOOXXXXXXXXXXXXXGOOXXXXXXXXXXXXXXXXXGOOOOOXXXXXXXXXXXXXXGOOOXXXXXXXXXXXXXXXXGOOOOOOOXXXXXXXXXXXX,0,0,0
16401,75,0,75,36,389,0,0,394,329,65,GOOXXXXXXXXXXXXXXXXXGOOOOOXXXXXXXXXXXXXXGOOOOOOOOXXXXXXXXXXXGOOOXXXXXXXXXXXXXXXXGOOXXXXXXXXXXXXXXXXXGOOOOXXXXXXXXXXXXXXXGOOOOOOXXXXXXXXXXXXXGOOOOOOOOOXXXXXXXXXXGOOOOOOXXXXXXXXXXXXXGOOXXXXXXXXXXXXXXXXXGOOOOOXXXXXXXXXXXXXXGOOOXXXXXXXXXXXXXXXXGOOOOOOOXXXXXXXXXXXX,0,0,0
16422,75,0,75,38,387,0,0,392,332,60,GOOXXXXXXXXXXXXXXXXXGOOOOOXXXXXXXXXXXXXXGOOOOOOOOXXXXXXXXXXXGOOOXXXXXXXXXXXXXXXXGOOXXXXXXXXXXXXXXXXXGOOOOXXXXXXXXXXXXXXXGOOOOOOXXXXXXXXXXXXXGOOOOOOOOOXXXXXXXXXXGOOOOOOXXXXXXXXXXXXXGOOXXXXXXXXXXXXXXXXXGOOOOOXXXXXXXXXXXXXXGOOOXXXXXXXXXXXXXXXXGOOOOOOOXXXXXXXXXXXX,0,0,0
16443,75,0,75,34,391,0,0,395,332,63,GOOXXXXXXXXXXXXXXXXXGOOOOOXXXXXXXXXXXXXXGOOOOOOOOXXXXXXXXXXXGOOOXXXXXXXXXXXXXXXXGOOXXXXXXXXXXXXXXXXXGOOOOXXXXXXXXXXXXXXXGOOOOOOXXXXXXXXXXXXXGOOOOOOOOOXXXXXXXXXXGOOOOOOXXXXXXXXXXXXXGOOXXXXXXXXXXXXXXXXXGOOOOOXXXXXXXXXXXXXXGOOOXXXXXXXXXXXXXXXXGOOOOOOOXXXXXXXXXXXX,0,0,0
16464,75,0,75,37,388,0,0,393,330,63,GOOXXXXXXXXXXXXXXXXXGOOOOOXXXXXXXXXXXXXXGOOOOOOOOXXXXXXXXXXXGOOOXXXXXXXXXXXXXXXXGOOXXXXXXXXXXXXXXXXXGOOOOXXXXXXXXXXXXXXXGOOOOOOXXXXXXXXXXXXXGOOOOOOOOOXXXXXXXXXXGOOOOOOXXXXXXXXXXXXXGOOXXXXXXXXXXXXXXXXXGOOOOOXXXXXXXXXXXXXXGOOOXXXXXXXXXXXXXXXXGOOOOOOOXXXXXXXXXXXX,0,0,0

16485,75,0,75,40,385,0,0,389,330,59,GOOXXXXXXXXXXXXXXXXXGOOOOOXXXXXXXXXXXXXXGOOOOOOOOXXXXXXXXXXXGOOOXXXXXXXXXXXXXXXXGOOXXXXXXXXXXXXXXXXXGOOOOXXXXXXXXXXXXXXXGOOOOOOXXXXXXXXXXXXXGOOOOOOOOOXXXXXXXXXXGOOOOOOXXXXXXXXXXXXXGOOXXXXXXXXXXXXXXXXXGOOOOOXXXXXXXXXXXXXXGOOOXXXXXXXXXXXXXXXXGOOOOOOOXXXXXXXXXXXX,0,0,0
16506,75,0,75,40,385,0,0,390,331,59,GOOXXXXXXXXXXXXXXXXXGOOOOOXXXXXXXXXXXXXXGOOOOOOOOXXXXXXXXXXXGOOOXXXXXXXXXXXXXXXXGOOXXXXXXXXXXXXXXXXXGOOOOXXXXXXXXXXXXXXXGOOOOOOXXXXXXXXXXXXXGOOOOOOOOOXXXXXXXXXXGOOOOOOXXXXXXXXXXXXXGOOXXXXXXXXXXXXXXXXXGOOOOOXXXXXXXXXXXXXXGOOOXXXXXXXXXXXXXXXXGOOOOOOOXXXXXXXXXXXX,0,0,0
16527,75,0,75,43,382,0,0,387,326,61,GOOXXXXXXXXXXXXXXXXXGOOOOOXXXXXXXXXXXXXXGOOOOOOOOXXXXXXXXXXXGOOOXXXXXXXXXXXXXXXXGOOXXXXXXXXXXXXXXXXXGOOOOXXXXXXXXXXXXXXXGOOOOOOXXXXXXXXXXXXXGOOOOOOOOOXXXXXXXXXXGOOOOOOXXXXXXXXXXXXXGOOXXXXXXXXXXXXXXXXXGOOOOOXXXXXXXXXXXXXXGOOOXXXXXXXXXXXXXXXXGOOOOOOOXXXXXXXXXXXX,0,0,0
16548,75,0,75,39,386,0,0,391,328,63,GOOXXXXXXXXXXXXXXXXXGOOOOOXXXXXXXXXXXXXXGOOOOOOOOXXXXXXXXXXXGOOOXXXXXXXXXXXXXXXXGOOXXXXXXXXXXXXXXXXXGOOOOXXXXXXXXXXXXXXXGOOOOOOXXXXXXXXXXXXXGOOOOOOOOOXXXXXXXXXXGOOOOOOXXXXXXXXXXXXXGOOXXXXXXXXXXXXXXXXXGOOOOOXXXXXXXXXXXXXXGOOOXXXXXXXXXXXXXXXXGOOOOOOOXXXXXXXXXXXX,0,0,0
16569,75,0,75,41,384,0,0,389,331,58,GOOXXXXXXXXXXXXXXXXXGOOOOOXXXXXXXXXXXXXXGOOOOOOOOXXXXXXXXXXXGOOOXXXXXXXXXXXXXXXXGOOXXXXXXXXXXXXXXXXXGOOOOXXXXXXXXXXXXXXXGOOOOOOXXXXXXXXXXXXXGOOOOOOOOOXXXXXXXXXXGOOOOOOXXXXXXXXXXXXXGOOXXXXXXXXXXXXXXXXXGOOOOOXXXXXXXXXXXXXXGOOOXXXXXXXXXXXXXXXXGOOOOOOOXXXXXXXXXXXX,0,0,0

16590,75,0,75,40,385,0,0,390,329,61,GOOXXXXXXXXXXXXXXXXXGOOOOOXXXXXXXXXXXXXXGOOOOOOOOXXXXXXXXXXXGOOOXXXXXXXXXXXXXXXXGOOXXXXXXXXXXXXXXXXXGOOOOXXXXXXXXXXXXXXXGOOOOOOXXXXXXXXXXXXXGOOOOOOOOOXXXXXXXXXXGOOOOOOXXXXXXXXXXXXXGOOXXXXXXXXXXXXXXXXXGOOOOOXXXXXXXXXXXXXXGOOOXXXXXXXXXXXXXXXXGOOOOOOOXXXXXXXXXXXX,0,0,0
16611,75,0,75,37,388,0,0,392,329,63,GOOXXXXXXXXXXXXXXXXXGOOOOOXXXXXXXXXXXXXXGOOOOOOOOXXXXXXXXXXXGOOOXXXXXXXXXXXXXXXXGOOXXXXXXXXXXXXXXXXXGOOOOXXXXXXXXXXXXXXXGOOOOOOXXXXXXXXXXXXXGOOOOOOOOOXXXXXXXXXXGOOOOOOXXXXXXXXXXXXXGOOXXXXXXXXXXXXXXXXXGOOOOOXXXXXXXXXXXXXXGOOOXXXXXXXXXXXXXXXXGOOOOOOOXXXXXXXXXXXX,0,0,0
16632,75,0,75,36,389,0,0,393,329,64,GOOXXXXXXXXXXXXXXXXXGOOOOOXXXXXXXXXXXXXXGOOOOOOOOXXXXXXXXXXXGOOOXXXXXXXXXXXXXXXXGOOXXXXXXXXXXXXXXXXXGOOOOXXXXXXXXXXXXXXXGOOOOOOXXXXXXXXXXXXXGOOOOOOOOOXXXXXXXXXXGOOOOOOXXXXXXXXXXXXXGOOXXXXXXXXXXXXXXXXXGOOOOOXXXXXXXXXXXXXXGOOOXXXXXXXXXXXXXXXXGOOOOOOOXXXXXXXXXXXX,0,0,0
16653,75,0,75,34,391,0,0,396,328,68,GOOXXXXXXXXXXXXXXXXXGOOOOOXXXXXXXXXXXXXXGOOOOOOOOXXXXXXXXXXXGOOOXXXXXXXXXXXXXXXXGOOXXXXXXXXXXXXXXXXXGOOOOXXXXXXXXXXXXXXXGOOOOOOXXXXXXXXXXXXXGOOOOOOOOOXXXXXXXXXXGOOOOOOXXXXXXXXXXXXXGOOXXXXXXXXXXXXXXXXXGOOOOOXXXXXXXXXXXXXXGOOOXXXXXXXXXXXXXXXXGOOOOOOOXXXXXXXXXXXX,0,0,0
16674,75,0,75,34,391,0,0,397,330,67,GOOXXXXXXXXXXXXXXXXXGOOOOOXXXXXXXXXXXXXXGOOOOOOOOXXXXXXXXXXXGOOOXXXXXXXXXXXXXXXXGOOXXXXXXXXXXXXXXXXXGOOOOXXXXXXXXXXXXXXXGOOOOOOXXXXXXXXXXXXXGOOOOOOOOOXXXXXXXXXXGOOOOOOXXXXXXXXXXXXXGOOXXXXXXXXXXXXXXXXXGOOOOOXXXXXXXXXXXXXXGOOOXXXXXXXXXXXXXXXXGOOOOOOOXXXXXXXXXXXX,0,0,0

16695,75,0,75,34,391,0,0,397,330,67,GOOXXXXXXXXXXXXXXXXXGOOOOOXXXXXXXXXXXXXXGOOOOOOOOXXXXXXXXXXXGOOOXXXXXXXXXXXXXXXXGOOXXXXXXXXXXXXXXXXXGOOOOXXXXXXXXXXXXXXXGOOOOOOXXXXXXXXXXXXXGOOOOOOOOOXXXXXXXXXXGOOOOOOXXXXXXXXXXXXXGOOXXXXXXXXXXXXXXXXXGOOOOOXXXXXXXXXXXXXXGOOOXXXXXXXXXXXXXXXXGOOOOOOOXXXXXXXXXXXX,0,0,0
16716,75,0,75,37,388,0,0,394,328,66,GOOXXXXXXXXXXXXXXXXXGOOOOOXXXXXXXXXXXXXXGOOOOOOOOXXXXXXXXXXXGOOOXXXXXXXXXXXXXXXXGOOXXXXXXXXXXXXXXXXXGOOOOXXXXXXXXXXXXXXXGOOOOOOXXXXXXXXXXXXXGOOOOOOOOOXXXXXXXXXXGOOOOOOXXXXXXXXXXXXXGOOXXXXXXXXXXXXXXXXXGOOOOOXXXXXXXXXXXXXXGOOOXXXXXXXXXXXXXXXXGOOOOOOOXXXXXXXXXXXX,0,0,0
16737,75,0,75,35,390,0,0,396,330,66,GOOXXXXXXXXXXXXXXXXXGOOOOOXXXXXXXXXXXXXXGOOOOOOOOXXXXXXXXXXXGOOOXXXXXXXXXXXXXXXXGOOXXXXXXXXXXXXXXXXXGOOOOXXXXXXXXXXXXXXXGOOOOOOXXXXXXXXXXXXXGOOOOOOOOOXXXXXXXXXXGOOOOOOXXXXXXXXXXXXXGOOXXXXXXXXXXXXXXXXXGOOOOOXXXXXXXXXXXXXXGOOOXXXXXXXXXXXXXXXXGOOOOOOOXXXXXXXXXXXX,0,0,0
16758,75,0,75,34,391,0,0,397,333,64,GOOXXXXXXXXXXXXXXXXXGOOOOOXXXXXXXXXXXXXXGOOOOOOOOXXXXXXXXXXXGOOOXXXXXXXXXXXXXXXXGOOXXXXXXXXXXXXXXXXXGOOOOXXXXXXXXXXXXXXXGOOOOOOXXXXXXXXXXXXXGOOOOOOOOOXXXXXXXXXXGOOOOOOXXXXXXXXXXXXXGOOXXXXXXXXXXXXXXXXXGOOOOOXXXXXXXXXXXXXXGOOOXXXXXXXXXXXXXXXXGOOOOOOOXXXXXXXXXXXX,0,0,0
16779,75,0,75,35,390,0,0,395,330,65,GOOXXXXXXXXXXXXXXXXXGOOOOOXXXXXXXXXXXXXXGOOOOOOOOXXXXXXXXXXXGOOOXXXXXXXXXXXXXXXXGOOXXXXXXXXXXXXXXXXXGOOOOXXXXXXXXXXXXXXXGOOOOOOXXXXXXXXXXXXXGOOOOOOOOOXXXXXXXXXXGOOOOOOXXXXXXXXXXXXXGOOXXXXXXXXXXXXXXXXXGOOOOOXXXXXXXXXXXXXXGOOOXXXXXXXXXXXXXXXXGOOOOOOOXXXXXXXXXXXX,0,0,0

16800,75,0,75,32,393,0,0,399,331,68,GOOXXXXXXXXXXXXXXXXXGOOOOOXXXXXXXXXXXXXXGOOOOOOOOXXXXXXXXXXXGOOOXXXXXXXXXXXXXXXXGOOXXXXXXXXXXXXXXXXXGOOOOXXXXXXXXXXXXXXXGOOOOOOXXXXXXXXXXXXXGOOOOOOOOOXXXXXXXXXXGOOOOOOXXXXXXXXXXXXXGOOXXXXXXXXXXXXXXXXXGOOOOOXXXXXXXXXXXXXXGOOOXXXXXXXXXXXXXXXXGOOOOOOOXXXXXXXXXXXX,0,0,0
16821,75,0,75,33,392,0,0,398,332,66,GOOXXXXXXXXXXXXXXXXXGOOOOOXXXXXXXXXXXXXXGOOOOOOOOXXXXXXXXXXXGOOOXXXXXXXXXXXXXXXXGOOXXXXXXXXXXXXXXXXXGOOOOXXXXXXXXXXXXXXXGOOOOOOXXXXXXXXXXXXXGOOOOOOOOOXXXXXXXXXXGOOOOOOXXXXXXXXXXXXXGOOXXXXXXXXXXXXXXXXXGOOOOOXXXXXXXXXXXXXXGOOOXXXXXXXXXXXXXXXXGOOOOOOOXXXXXXXXXXXX,0,0,0
16842,75,0,75,36,389,0,0,395,330,65,GOOXXXXXXXXXXXXXXXXXGOOOOOXXXXXXXXXXXXXXGOOOOOOOOXXXXXXXXXXXGOOOXXXXXXXXXXXXXXXXGOOXXXXXXXXXXXXXXXXXGOOOOXXXXXXXXXXXXXXXGOOOOOOXXXXXXXXXXXXXGOOOOOOOOOXXXXXXXXXXGOOOOOOXXXXXXXXXXXXXGOOXXXXXXXXXXXXXXXXXGOOOOOXXXXXXXXXXXXXXGOOOXXXXXXXXXXXXXXXXGOOOOOOOXXXXXXXXXXXX,0,0,0
16863,75,0,75,38,387,0,0,395,330,65,GOOXXXXXXXXXXXXXXXXXGOOOOOXXXXXXXXXXXXXXGOOOOOOOOXXXXXXXXXXXGOOOXXXXXXXXXXXXXXXXGOOXXXXXXXXXXXXXXXXXGOOOOXXXXXXXXXXXXXXXGOOOOOOXXXXXXXXXXXXXGOOOOOOOOOXXXXXXXXXXGOOOOOOXXXXXXXXXXXXXGOOXXXXXXXXXXXXXXXXXGOOOOOXXXXXXXXXXXXXXGOOOXXXXXXXXXXXXXXXXGOOOOOOOXXXXXXXXXXXX,0,0,0
16884,75,0,75,36,389,0,0,396,332,64,GOOXXXXXXXXXXXXXXXXXGOOOOOXXXXXXXXXXXXXXGOOOOOOOOXXXXXXXXXXXGOOOXXXXXXXXXXXXXXXXGOOXXXXXXXXXXXXXXXXXGOOOOXXXXXXXXXXXXXXXGOOOOOOXXXXXXXXXXXXXGOOOOOOOOOXXXXXXXXXXGOOOOOOXXXXXXXXXXXXXGOOXXXXXXXXXXXXXXXXXGOOOOOXXXXXXXXXXXXXXGOOOXXXXXXXXXXXXXXXXGOOOOOOOXXXXXXXXXXXX,0,0,0

16905,75,0,75,37,388,0,0,396,330,66,GOOXXXXXXXXXXXXXXXXXGOOOOOXXXXXXXXXXXXXXGOOOOOOOOXXXXXXXXXXXGOOOXXXXXXXXXXXXXXXXGOOXXXXXXXXXXXXXXXXXGOOOOXXXXXXXXXXXXXXXGOOOOOOXXXXXXXXXXXXXGOOOOOOOOOXXXXXXXXXXGOOOOOOXXXXXXXXXXXXXGOOXXXXXXXXXXXXXXXXXGOOOOOXXXXXXXXXXXXXXGOOOXXXXXXXXXXXXXXXXGOOOOOOOXXXXXXXXXXXX,0,0,0
16926,75,0,75,34,391,0,0,399,331,68,GOOXXXXXXXXXXXXXXXXXGOOOOOXXXXXXXXXXXXXXGOOOOOOOOXXXXXXXXXXXGOOOXXXXXXXXXXXXXXXXGOOXXXXXXXXXXXXXXXXXGOOOOXXXXXXXXXXXXXXXGOOOOOOXXXXXXXXXXXXXGOOOOOOOOOXXXXXXXXXXGOOOOOOXXXXXXXXXXXXXGOOXXXXXXXXXXXXXXXXXGOOOOOXXXXXXXXXXXXXXGOOOXXXXXXXXXXXXXXXXGOOOOOOOXXXXXXXXXXXX,0,0,0
16947,75,0,75,34,391,0,0,399,333,66,GOOXXXXXXXXXXXXXXXXXGOOOOOXXXXXXXXXXXXXXGOOOOOOOOXXXXXXXXXXXGOOOXXXXXXXXXXXXXXXXGOOXXXXXXXXXXXXXXXXXGOOOOXXXXXXXXXXXXXXXGOOOOOOXXXXXXXXXXXXXGOOOOOOOOOXXXXXXXXXXGOOOOOOXXXXXXXXXXXXXGOOXXXXXXXXXXXXXXXXXGOOOOOXXXXXXXXXXXXXXGOOOXXXXXXXXXXXXXXXXGOOOOOOOXXXXXXXXXXXX,0,0,0
16968,75,0,75,30,395,0,0,402,332,70,GOOXXXXXXXXXXXXXXXXXGOOOOOXXXXXXXXXXXXXXGOOOOOOOOXXXXXXXXXXXGOOOXXXXXXXXXXXXXXXXGOOXXXXXXXXXXXXXXXXXGOOOOXXXXXXXXXXXXXXXGOOOOOOXXXXXXXXXXXXXGOOOOOOOOOXXXXXXXXXXGOOOOOOXXXXXXXXXXXXXGOOXXXXXXXXXXXXXXXXXGOOOOOXXXXXXXXXXXXXXGOOOXXXXXXXXXXXXXXXXGOOOOOOOXXXXXXXXXXXX,0,0,0
16989,75,0,75,28,397,0,0,404,333,71,GOOXXXXXXXXXXXXXXXXXGOOOOOXXXXXXXXXXXXXXGOOOOOOOOXXXXXXXXXXXGOOOXXXXXXXXXXXXXXXXGOOXXXXXXXXXXXXXXXXXGOOOOXXXXXXXXXXXXXXXGOOOOOOXXXXXXXXXXXXXGOOOOOOOOOXXXXXXXXXXGOOOOOOXXXXXXXXXXXXXGOOXXXXXXXXXXXXXXXXXGOOOOOXXXXXXXXXXXXXXGOOOXXXXXXXXXXXXXXXXGOOOOOOOXXXXXXXXXXXX,0,0,0

17010,75,0,75,30,395,0,0,401,334,67,GOOXXXXXXXXXXXXXXXXXGOOOOOXXXXXXXXXXXXXXGOOOOOOOOXXXXXXXXXXXGOOOXXXXXXXXXXXXXXXXGOOXXXXXXXXXXXXXXXXXGOOOOXXXXXXXXXXXXXXXGOOOOOOXXXXXXXXXXXXXGOOOOOOOOOXXXXXXXXXXGOOOOOOXXXXXXXXXXXXXGOOXXXXXXXXXXXXXXXXXGOOOOOXXXXXXXXXXXXXXGOOOXXXXXXXXXXXXXXXXGOOOOOOOXXXXXXXXXXXX,0,0,0
17031,75,0,75,28,397,0,0,403,332,71,GOOXXXXXXXXXXXXXXXXXGOOOOOXXXXXXXXXXXXXXGOOOOOOOOXXXXXXXXXXXGOOOXXXXXXXXXXXXXXXXGOOXXXXXXXXXXXXXXXXXGOOOOXXXXXXXXXXXXXXXGOOOOOOXXXXXXXXXXXXXGOOOOOOOOOXXXXXXXXXXGOOOOOOXXXXXXXXXXXXXGOOXXXXXXXXXXXXXXXXXGOOOOOXXXXXXXXXXXXXXGOOOXXXXXXXXXXXXXXXXGOOOOOOOXXXXXXXXXXXX,0,0,0
17052,76,1,75,27,397,0,0,402,332,70,GOOXXXXXXXXXXXXXXXXXGOOOOOXXXXXXXXXXXXXXGOOOOOOOOXXXXXXXXXXXGOOOAXXXXXXXXXXXXXXXGOOXXXXXXXXXXXXXXXXXGOOOOXXXXXXXXXXXXXXXGOOOOOOXXXXXXXXXXXXXGOOOOOOOOOXXXXXXXXXXGOOOOOOXXXXXXXXXXXXXGOOXXXXXXXXXXXXXXXXXGOOOOOXXXXXXXXXXXXXXGOOOXXXXXXXXXXXXXXXXGOOOOOOOXXXXXXXXXXXX,0,0,0
17073,76,1,75,27,397,0,0,402,332,70,GOOXXXXXXXXXXXXXXXXXGOOOOOXXXXXXXXXXXXXXGOOOOOOOOXXXXXXXXXXXGOOOAXXXXXXXXXXXXXXXGOOXXXXXXXXXXXXXXXXXGOOOOXXXXXXXXXXXXXXXGOOOOOOXXXXXXXXXXXXXGOOOOOOOOOXXXXXXXXXXGOOOOOOXXXXXXXXXXXXXGOOXXXXXXXXXXXXXXXXXGOOOOOXXXXXXXXXXXXXXGOOOXXXXXXXXXXXXXXXXGOOOOOOOXXXXXXXXXXXX,0,0,0
17094,76,1,75,25,399,0,0,404,333,71,GOOXXXXXXXXXXXXXXXXXGOOOOOXXXXXXXXXXXXXXGOOOOOOOOXXXXXXXXXXXGOOOAXXXXXXXXXXXXXXXGOOXXXXXXXXXXXXXXXXXGOOOOXXXXXXXXXXXXXXXGOOOOOOXXXXXXXXXXXXXGOOOOOOOOOXXXXXXXXXXGOOOOOOXXXXXXXXXXXXXGOOXXXXXXXXXXXXXXXXXGOOOOOXXXXXXXXXXXXXXGOOOXXXXXXXXXXXXXXXXGOOOOOOOXXXXXXXXXXXX,0,0,0

17115,76,1,75,28,396,0,0,401,333,68,GOOXXXXXXXXXXXXXXXXXGOOOOOXXXXXXXXXXXXXXGOOOOOOOOXXXXXXXXXXXGOOOAXXXXXXXXXXXXXXXGOOXXXXXXXXXXXXXXXXXGOOOOXXXXXXXXXXXXXXXGOOOOOOXXXXXXXXXXXXXGOOOOOOOOOXXXXXXXXXXGOOOOOOXXXXXXXXXXXXXGOOXXXXXXXXXXXXXXXXXGOOOOOXXXXXXXXXXXXXXGOOOXXXXXXXXXXXXXXXXGOOOOOOOXXXXXXXXXXXX,0,0,0
17136,76,0,76,27,397,0,0,402,334,68,GOOXXXXXXXXXXXXXXXXXGOOOOOXXXXXXXXXXXXXXGOOOOOOOOXXXXXXXXXXXGOOOOXXXXXXXXXXXXXXXGOOXXXXXXXXXXXXXXXXXGOOOOXXXXXXXXXXXXXXXGOOOOOOXXXXXXXXXXXXXGOOOOOOOOOXXXXXXXXXXGOOOOOOXXXXXXXXXXXXXGOOXXXXXXXXXXXXXXXXXGOOOOOXXXXXXXXXXXXXXGOOOXXXXXXXXXXXXXXXXGOOOOOOOXXXXXXXXXXXX,0,0,0
17157,76,0,76,24,400,0,0,405,338,67,GOOXXXXXXXXXXXXXXXXXGOOOOOXXXXXXXXXXXXXXGOOOOOOOOXXXXXXXXXXXGOOOOXXXXXXXXXXXXXXXGOOXXXXXXXXXXXXXXXXXGOOOOXXXXXXXXXXXXXXXGOOOOOOXXXXXXXXXXXXXGOOOOOOOOOXXXXXXXXXXGOOOOOOXXXXXXXXXXXXXGOOXXXXXXXXXXXXXXXXXGOOOOOXXXXXXXXXXXXXXGOOOXXXXXXXXXXXXXXXXGOOOOOOOXXXXXXXXXXXX,0,0,0
17178,76,0,76,30,394,0,0,399,334,65,GOOXXXXXXXXXXXXXXXXXGOOOOOXXXXXXXXXXXXXXGOOOOOOOOXXXXXXXXXXXGOOOOXXXXXXXXXXXXXXXGOOXXXXXXXXXXXXXXXXXGOOOOXXXXXXXXXXXXXXXGOOOOOOXXXXXXXXXXXXXGOOOOOOOOOXXXXXXXXXXGOOOOOOXXXXXXXXXXXXXGOOXXXXXXXXXXXXXXXXXGOOOOOXXXXXXXXXXXXXXGOOOXXXXXXXXXXXXXXXXGOOOOOOOXXXXXXXXXXXX,0,0,0
17199,76,0,76,32,392,0,0,398,333,65,GOOXXXXXXXXXXXXXXXXXGOOOOOXXXXXXXXXXXXXXGOOOOOOOOXXXXXXXXXXXGOOOOXXXXXXXXXXXXXXXGOOXXXXXXXXXXXXXXXXXGOOOOXXXXXXXXXXXXXXXGOOOOOOXXXXXXXXXXXXXGOOOOOOOOOXXXXXXXXXXGOOOOOOXXXXXXXXXXXXXGOOXXXXXXXXXXXXXXXXXGOOOOOXXXXXXXXXXXXXXGOOOXXXXXXXXXXXXXXXXGOOOOOOOXXXXXXXXXXXX,0,0,0

17220,76,0,76,30,394,0,0,399,337,62,GOOXXXXXXXXXXXXXXXXXGOOOOOXXXXXXXXXXXXXXGOOOOOOOOXXXXXXXXXXXGOOOOXXXXXXXXXXXXXXXGOOXXXXXXXXXXXXXXXXXGOOOOXXXXXXXXXXXXXXXGOOOOOOXXXXXXXXXXXXXGOOOOOOOOOXXXXXXXXXXGOOOOOOXXXXXXXXXXXXXGOOXXXXXXXXXXXXXXXXXGOOOOOXXXXXXXXXXXXXXGOOOXXXXXXXXXXXXXXXXGOOOOOOOXXXXXXXXXXXX,0,0,0
17241,76,0,76,33,391,0,0,397,337,60,GOOXXXXXXXXXXXXXXXXXGOOOOOXXXXXXXXXXXXXXGOOOOOOOOXXXXXXXXXXXGOOOOXXXXXXXXXXXXXXXGOOXXXXXXXXXXXXXXXXXGOOOOXXXXXXXXXXXXXXXGOOOOOOXXXXXXXXXXXXXGOOOOOOOOOXXXXXXXXXXGOOOOOOXXXXXXXXXXXXXGOOXXXXXXXXXXXXXXXXXGOOOOOXXXXXXXXXXXXXXGOOOXXXXXXXXXXXXXXXXGOOOOOOOXXXXXXXXXXXX,0,0,0
17262,76,0,76,37,387,0,0,393,337,56,GOOXXXXXXXXXXXXXXXXXGOOOOOXXXXXXXXXXXXXXGOOOOOOOOXXXXXXXXXXXGOOOOXXXXXXXXXXXXXXXGOOXXXXXXXXXXXXXXXXXGOOOOXXXXXXXXXXXXXXXGOOOOOOXXXXXXXXXXXXXGOOOOOOOOOXXXXXXXXXXGOOOOOOXXXXXXXXXXXXXGOOXXXXXXXXXXXXXXXXXGOOOOOXXXXXXXXXXXXXXGOOOXXXXXXXXXXXXXXXXGOOOOOOOXXXXXXXXXXXX,0,0,0
17283,76,0,76,33,391,0,0,397,337,60,GOOXXXXXXXXXXXXXXXXXGOOOOOXXXXXXXXXXXXXXGOOOOOOOOXXXXXXXXXXXGOOOOXXXXXXXXXXXXXXXGOOXXXXXXXXXXXXXXXXXGOOOOXXXXXXXXXXXXXXXGOOOOOOXXXXXXXXXXXXXGOOOOOOOOOXXXXXXXXXXGOOOOOOXXXXXXXXXXXXXGOOXXXXXXXXXXXXXXXXXGOOOOOXXXXXXXXXXXXXXGOOOXXXXXXXXXXXXXXXXGOOOOOOOXXXXXXXXXXXX,0,0,0
17304,76,0,76,33,391,0,0,397,337,60,GOOXXXXXXXXXXXXXXXXXGOOOOOXXXXXXXXXXXXXXGOOOOOOOOXXXXXXXXXXXGOOOOXXXXXXXXXXXXXXXGOOXXXXXXXXXXXXXXXXXGOOOOXXXXXXXXXXXXXXXGOOOOOOXXXXXXXXXXXXXGOOOOOOOOOXXXXXXXXXXGOOOOOOXXXXXXXXXXXXXGOOXXXXXXXXXXXXXXXXXGOOOOOXXXXXXXXXXXXXXGOOOXXXXXXXXXXXXXXXXGOOOOOOOXXXXXXXXXXXX,0,0,0

17325,76,0,76,31,393,0,0,399,337,62,GOOXXXXXXXXXXXXXXXXXGOOOOOXXXXXXXXXXXXXXGOOOOOOOOXXXXXXXXXXXGOOOOXXXXXXXXXXXXXXXGOOXXXXXXXXXXXXXXXXXGOOOOXXXXXXXXXXXXXXXGOOOOOOXXXXXXXXXXXXXGOOOOOOOOOXXXXXXXXXXGOOOOOOXXXXXXXXXXXXXGOOXXXXXXXXXXXXXXXXXGOOOOOXXXXXXXXXXXXXXGOOOXXXXXXXXXXXXXXXXGOOOOOOOXXXXXXXXXXXX,0,0,0
17346,76,0,76,30,394,0,0,399,339,60,GOOXXXXXXXXXXXXXXXXXGOOOOOXXXXXXXXXXXXXXGOOOOOOOOXXXXXXXXXXXGOOOOXXXXXXXXXXXXXXXGOOXXXXXXXXXXXXXXXXXGOOOOXXXXXXXXXXXXXXXGOOOOOOXXXXXXXXXXXXXGOOOOOOOOOXXXXXXXXXXGOOOOOOXXXXXXXXXXXXXGOOXXXXXXXXXXXXXXXXXGOOOOOXXXXXXXXXXXXXXGOOOXXXXXXXXXXXXXXXXGOOOOOOOXXXXXXXXXXXX,0,0,0
17367,76,0,76,34,390,0,0,395,339,56,GOOXXXXXXXXXXXXXXXXXGOOOOOXXXXXXXXXXXXXXGOOOOOOOOXXXXXXXXXXXGOOOOXXXXXXXXXXXXXXXGOOXXXXXXXXXXXXXXXXXGOOOOXXXXXXXXXXXXXXXGOOOOOOXXXXXXXXXXXXXGOOOOOOOOOXXXXXXXXXXGOOOOOOXXXXXXXXXXXXXGOOXXXXXXXXXXXXXXXXXGOOOOOXXXXXXXXXXXXXXGOOOXXXXXXXXXXXXXXXXGOOOOOOOXXXXXXXXXXXX,0,0,0
17388,76,0,76,34,390,0,0,395,340,55,GOOXXXXXXXXXXXXXXXXXGOOOOOXXXXXXXXXXXXXXGOOOOOOOOXXXXXXXXXXXGOOOOXXXXXXXXXXXXXXXGOOXXXXXXXXXXXXXXXXXGOOOOXXXXXXXXXXXXXXXGOOOOOOXXXXXXXXXXXXXGOOOOOOOOOXXXXXXXXXXGOOOOOOXXXXXXXXXXXXXGOOXXXXXXXXXXXXXXXXXGOOOOOXXXXXXXXXXXXXXGOOOXXXXXXXXXXXXXXXXGOOOOOOOXXXXXXXXXXXX,0,0,0
17409,76,0,76,35,389,0,0,394,339,55,GOOXXXXXXXXXXXXXXXXXGOOOOOXXXXXXXXXXXXXXGOOOOOOOOXXXXXXXXXXXGOOOOXXXXXXXXXXXXXXXGOOXXXXXXXXXXXXXXXXXGOOOOXXXXXXXXXXXXXXXGOOOOOOXXXXXXXXXXXXXGOOOOOOOOOXXXXXXXXXXGOOOOOOXXXXXXXXXXXXXGOOXXXXXXXXXXXXXXXXXGOOOOOXXXXXXXXXXXXXXGOOOXXXXXXXXXXXXXXXXGOOOOOOOXXXXXXXXXXXX,0,0,0

17430,76,0,76,34,390,0,0,395,341,54,GOOXXXXXXXXXXXXXXXXXGOOOOOXXXXXXXXXXXXXXGOOOOOOOOXXXXXXXXXXXGOOOOXXXXXXXXXXXXXXXGOOXXXXXXXXXXXXXXXXXGOOOOXXXXXXXXXXXXXXXGOOOOOOXXXXXXXXXXXXXGOOOOOOOOOXXXXXXXXXXGOOOOOOXXXXXXXXXXXXXGOOXXXXXXXXXXXXXXXXXGOOOOOXXXXXXXXXXXXXXGOOOXXXXXXXXXXXXXXXXGOOOOOOOXXXXXXXXXXXX,0,0,0
17451,76,0,76,33,391,0,0,396,343,53,GOOXXXXXXXXXXXXXXXXXGOOOOOXXXXXXXXXXXXXXGOOOOOOOOXXXXXXXXXXXGOOOOXXXXXXXXXXXXXXXGOOXXXXXXXXXXXXXXXXXGOOOOXXXXXXXXXXXXXXXGOOOOOOXXXXXXXXXXXXXGOOOOOOOOOXXXXXXXXXXGOOOOOOXXXXXXXXXXXXXGOOXXXXXXXXXXXXXXXXXGOOOOOXXXXXXXXXXXXXXGOOOXXXXXXXXXXXXXXXXGOOOOOOOXXXXXXXXXXXX,0,0,0
17472,76,0,76,34,390,0,0,395,339,56,GOOXXXXXXXXXXXXXXXXXGOOOOOXXXXXXXXXXXXXXGOOOOOOOOXXXXXXXXXXXGOOOOXXXXXXXXXXXXXXXGOOXXXXXXXXXXXXXXXXXGOOOOXXXXXXXXXXXXXXXGOOOOOOXXXXXXXXXXXXXGOOOOOOOOOXXXXXXXXXXGOOOOOOXXXXXXXXXXXXXGOOXXXXXXXXXXXXXXXXXGOOOOOXXXXXXXXXXXXXXGOOOXXXXXXXXXXXXXXXXGOOOOOOOXXXXXXXXXXXX,0,0,0
17493,76,0,76,33,391,0,0,397,342,55,GOOXXXXXXXXXXXXXXXXXGOOOOOXXXXXXXXXXXXXXGOOOOOOOOXXXXXXXXXXXGOOOOXXXXXXXXXXXXXXXGOOXXXXXXXXXXXXXXXXXGOOOOXXXXXXXXXXXXXXXGOOOOOOXXXXXXXXXXXXXGOOOOOOOOOXXXXXXXXXXGOOOOOOXXXXXXXXXXXXXGOOXXXXXXXXXXXXXXXXXGOOOOOXXXXXXXXXXXXXXGOOOXXXXXXXXXXXXXXXXGOOOOOOOXXXXXXXXXXXX,0,0,0
17514,76,0,76,36,388,0,0,393,339,54,GOOXXXXXXXXXXXXXXXXXGOOOOOXXXXXXXXXXXXXXGOOOOOOOOXXXXXXXXXXXGOOOOXXXXXXXXXXXXXXXGOOXXXXXXXXXXXXXXXXXGOOOOXXXXXXXXXXXXXXXGOOOOOOXXXXXXXXXXXXXGOOOOOOOOOXXXXXXXXXXGOOOOOOXXXXXXXXXXXXXGOOXXXXXXXXXXXXXXXXXGOOOOOXXXXXXXXXXXXXXGOOOXXXXXXXXXXXXXXXXGOOOOOOOXXXXXXXXXXXX,0,0,0

17535,76,0,76,37,387,0,0,392,341,51,GOOXXXXXXXXXXXXXXXXXGOOOOOXXXXXXXXXXXXXXGOOOOOOOOXXXXXXXXXXXGOOOOXXXXXXXXXXXXXXXGOOXXXXXXXXXXXXXXXXXGOOOOXXXXXXXXXXXXXXXGOOOOOOXXXXXXXXXXXXXGOOOOOOOOOXXXXXXXXXXGOOOOOOXXXXXXXXXXXXXGOOXXXXXXXXXXXXXXXXXGOOOOOXXXXXXXXXXXXXXGOOOXXXXXXXXXXXXXXXXGOOOOOOOXXXXXXXXXXXX,0,0,0
17556,76,0,76,34,390,0,0,395,339,56,GOOXXXXXXXXXXXXXXXXXGOOOOOXXXXXXXXXXXXXXGOOOOOOOOXXXXXXXXXXXGOOOOXXXXXXXXXXXXXXXGOOXXXXXXXXXXXXXXXXXGOOOOXXXXXXXXXXXXXXXGOOOOOOXXXXXXXXXXXXXGOOOOOOOOOXXXXXXXXXXGOOOOOOXXXXXXXXXXXXXGOOXXXXXXXXXXXXXXXXXGOOOOOXXXXXXXXXXXXXXGOOOXXXXXXXXXXXXXXXXGOOOOOOOXXXXXXXXXXXX,0,0,0
17577,76,0,76,32,392,0,0,396,339,57,GOOXXXXXXXXXXXXXXXXXGOOOOOXXXXXXXXXXXXXXGOOOOOOOOXXXXXXXXXXXGOOOOXXXXXXXXXXXXXXXGOOXXXXXXXXXXXXXXXXXGOOOOXXXXXXXXXXXXXXXGOOOOOOXXXXXXXXXXXXXGOOOOOOOOOXXXXXXXXXXGOOOOOOXXXXXXXXXXXXXGOOXXXXXXXXXXXXXXXXXGOOOOOXXXXXXXXXXXXXXGOOOXXXXXXXXXXXXXXXXGOOOOOOOXXXXXXXXXXXX,0,0,0
17598,76,0,76,32,392,0,0,398,338,60,GOOXXXXXXXXXXXXXXXXXGOOOOOXXXXXXXXXXXXXXGOOOOOOOOXXXXXXXXXXXGOOOOXXXXXXXXXXXXXXXGOOXXXXXXXXXXXXXXXXXGOOOOXXXXXXXXXXXXXXXGOOOOOOXXXXXXXXXXXXXGOOOOOOOOOXXXXXXXXXXGOOOOOOXXXXXXXXXXXXXGOOXXXXXXXXXXXXXXXXXGOOOOOXXXXXXXXXXXXXXGOOOXXXXXXXXXXXXXXXXGOOOOOOOXXXXXXXXXXXX,0,0,0
17619,76,0,76,27,397,0,0,403,340,63,GOOXXXXXXXXXXXXXXXXXGOOOOOXXXXXXXXXXXXXXGOOOOOOOOXXXXXXXXXXXGOOOOXXXXXXXXXXXXXXXGOOXXXXXXXXXXXXXXXXXGOOOOXXXXXXXXXXXXXXXGOOOOOOXXXXXXXXXXXXXGOOOOOOOOOXXXXXXXXXXGOOOOOOXXXXXXXXXXXXXGOOXXXXXXXXXXXXXXXXXGOOOOOXXXXXXXXXXXXXXGOOOXXXXXXXXXXXXXXXXGOOOOOOOXXXXXXXXXXXX,0,0,0

17640,76,0,76,27,397,0,0,403,341,62,GOOXXXXXXXXXXXXXXXXXGOOOOOXXXXXXXXXXXXXXGOOOOOOOOXXXXXXXXXXXGOOOOXXXXXXXXXXXXXXXGOOXXXXXXXXXXXXXXXXXGOOOOXXXXXXXXXXXXXXXGOOOOOOXXXXXXXXXXXXXGOOOOOOOOOXXXXXXXXXXGOOOOOOXXXXXXXXXXXXXGOOXXXXXXXXXXXXXXXXXGOOOOOXXXXXXXXXXXXXXGOOOXXXXXXXXXXXXXXXXGOOOOOOOXXXXXXXXXXXX,0,0,0
17661,76,0,76,31,393,0,0,399,343,56,GOOXXXXXXXXXXXXXXXXXGOOOOOXXXXXXXXXXXXXXGOOOOOOOOXXXXXXXXXXXGOOOOXXXXXXXXXXXXXXXGOOXXXXXXXXXXXXXXXXXGOOOOXXXXXXXXXXXXXXXGOOOOOOXXXXXXXXXXXXXGOOOOOOOOOXXXXXXXXXXGOOOOOOXXXXXXXXXXXXXGOOXXXXXXXXXXXXXXXXXGOOOOOXXXXXXXXXXXXXXGOOOXXXXXXXXXXXXXXXXGOOOOOOOXXXXXXXXXXXX,0,0,0
17682,76,0,76,33,391,0,0,397,340,57,GOOXXXXXXXXXXXXXXXXXGOOOOOXXXXXXXXXXXXXXGOOOOOOOOXXXXXXXXXXXGOOOOXXXXXXXXXXXXXXXGOOXXXXXXXXXXXXXXXXXGOOOOXXXXXXXXXXXXXXXGOOOOOOXXXXXXXXXXXXXGOOOOOOOOOXXXXXXXXXXGOOOOOOXXXXXXXXXXXXXGOOXXXXXXXXXXXXXXXXXGOOOOOXXXXXXXXXXXXXXGOOOXXXXXXXXXXXXXXXXGOOOOOOOXXXXXXXXXXXX,0,0,0
17703,76,0,76,35,389,0,0,396,338,58,GOOXXXXXXXXXXXXXXXXXGOOOOOXXXXXXXXXXXXXXGOOOOOOOOXXXXXXXXXXXGOOOOXXXXXXXXXXXXXXXGOOXXXXXXXXXXXXXXXXXGOOOOXXXXXXXXXXXXXXXGOOOOOOXXXXXXXXXXXXXGOOOOOOOOOXXXXXXXXXXGOOOOOOXXXXXXXXXXXXXGOOXXXXXXXXXXXXXXXXXGOOOOOXXXXXXXXXXXXXXGOOOXXXXXXXXXXXXXXXXGOOOOOOOXXXXXXXXXXXX,0,0,0
17724,76,0,76,30,394,0,0,400,339,61,GOOXXXXXXXXXXXXXXXXXGOOOOOXXXXXXXXXXXXXXGOOOOOOOOXXXXXXXXXXXGOOOOXXXXXXXXXXXXXXXGOOXXXXXXXXXXXXXXXXXGOOOOXXXXXXXXXXXXXXXGOOOOOOXXXXXXXXXXXXXGOOOOOOOOOXXXXXXXXXXGOOOOOOXXXXXXXXXXXXXGOOXXXXXXXXXXXXXXXXXGOOOOOXXXXXXXXXXXXXXGOOOXXXXXXXXXXXXXXXXGOOOOOOOXXXXXXXXXXXX,0,0,0

17745,76,0,76,27,397,0,0,404,338,66,GOOXXXXXXXXXXXXXXXXXGOOOOOXXXXXXXXXXXXXXGOOOOOOOOXXXXXXXXXXXGOOOOXXXXXXXXXXXXXXXGOOXXXXXXXXXXXXXXXXXGOOOOXXXXXXXXXXXXXXXGOOOOOOXXXXXXXXXXXXXGOOOOOOOOOXXXXXXXXXXGOOOOOOXXXXXXXXXXXXXGOOXXXXXXXXXXXXXXXXXGOOOOOXXXXXXXXXXXXXXGOOOXXXXXXXXXXXXXXXXGOOOOOOOXXXXXXXXXXXX,0,0,0
17766,76,0,76,27,397,0,0,404,340,64,GOOXXXXXXXXXXXXXXXXXGOOOOOXXXXXXXXXXXXXXGOOOOOOOOXXXXXXXXXXXGOOOOXXXXXXXXXXXXXXXGOOXXXXXXXXXXXXXXXXXGOOOOXXXXXXXXXXXXXXXGOOOOOOXXXXXXXXXXXXXGOOOOOOOOOXXXXXXXXXXGOOOOOOXXXXXXXXXXXXXGOOXXXXXXXXXXXXXXXXXGOOOOOXXXXXXXXXXXXXXGOOOXXXXXXXXXXXXXXXXGOOOOOOOXXXXXXXXXXXX,0,0,0
17787,76,0,76,25,399,0,0,405,341,64,GOOXXXXXXXXXXXXXXXXXGOOOOOXXXXXXXXXXXXXXGOOOOOOOOXXXXXXXXXXXGOOOOXXXXXXXXXXXXXXXGOOXXXXXXXXXXXXXXXXXGOOOOXXXXXXXXXXXXXXXGOOOOOOXXXXXXXXXXXXXGOOOOOOOOOXXXXXXXXXXGOOOOOOXXXXXXXXXXXXXGOOXXXXXXXXXXXXXXXXXGOOOOOXXXXXXXXXXXXXXGOOOXXXXXXXXXXXXXXXXGOOOOOOOXXXXXXXXXXXX,0,0,0
17808,76,0,76,25,399,0,0,405,340,65,GOOXXXXXXXXXXXXXXXXXGOOOOOXXXXXXXXXXXXXXGOOOOOOOOXXXXXXXXXXXGOOOOXXXXXXXXXXXXXXXGOOXXXXXXXXXXXXXXXXXGOOOOXXXXXXXXXXXXXXXGOOOOOOXXXXXXXXXXXXXGOOOOOOOOOXXXXXXXXXXGOOOOOOXXXXXXXXXXXXXGOOXXXXXXXXXXXXXXXXXGOOOOOXXXXXXXXXXXXXXGOOOXXXXXXXXXXXXXXXXGOOOOOOOXXXXXXXXXXXX,0,0,0
17829,76,0,76,25,399,0,0,405,340,65,GOOXXXXXXXXXXXXXXXXXGOOOOOXXXXXXXXXXXXXXGOOOOOOOOXXXXXXXXXXXGOOOOXXXXXXXXXXXXXXXGOOXXXXXXXXXXXXXXXXXGOOOOXXXXXXXXXXXXXXXGOOOOOOXXXXXXXXXXXXXGOOOOOOOOOXXXXXXXXXXGOOOOOOXXXXXXXXXXXXXGOOXXXXXXXXXXXXXXXXXGOOOOOXXXXXXXXXXXXXXGOOOXXXXXXXXXXXXXXXXGOOOOOOOXXXXXXXXXXXX,0,0,0

17850,76,0,76,24,400,0,0,406,340,66,GOOXXXXXXXXXXXXXXXXXGOOOOOXXXXXXXXXXXXXXGOOOOOOOOXXXXXXXXXXXGOOOOXXXXXXXXXXXXXXXGOOXXXXXXXXXXXXXXXXXGOOOOXXXXXXXXXXXXXXXGOOOOOOXXXXXXXXXXXXXGOOOOOOOOOXXXXXXXXXXGOOOOOOXXXXXXXXXXXXXGOOXXXXXXXXXXXXXXXXXGOOOOOXXXXXXXXXXXXXXGOOOXXXXXXXXXXXXXXXXGOOOOOOOXXXXXXXXXXXX,0,0,0
17871,76,0,76,20,404,0,0,409,340,69,GOOXXXXXXXXXXXXXXXXXGOOOOOXXXXXXXXXXXXXXGOOOOOOOOXXXXXXXXXXXGOOOOXXXXXXXXXXXXXXXGOOXXXXXXXXXXXXXXXXXGOOOOXXXXXXXXXXXXXXXGOOOOOOXXXXXXXXXXXXXGOOOOOOOOOXXXXXXXXXXGOOOOOOXXXXXXXXXXXXXGOOXXXXXXXXXXXXXXXXXGOOOOOXXXXXXXXXXXXXXGOOOXXXXXXXXXXXXXXXXGOOOOOOOXXXXXXXXXXXX,0,0,0
17892,76,0,76,19,405,0,0,409,342,67,GOOXXXXXXXXXXXXXXXXXGOOOOOXXXXXXXXXXXXXXGOOOOOOOOXXXXXXXXXXXGOOOOXXXXXXXXXXXXXXXGOOXXXXXXXXXXXXXXXXXGOOOOXXXXXXXXXXXXXXXGOOOOOOXXXXXXXXXXXXXGOOOOOOOOOXXXXXXXXXXGOOOOOOXXXXXXXXXXXXXGOOXXXXXXXXXXXXXXXXXGOOOOOXXXXXXXXXXXXXXGOOOXXXXXXXXXXXXXXXXGOOOOOOOXXXXXXXXXXXX,0,0,0
17913,76,0,76,22,402,0,0,407,342,65,GOOXXXXXXXXXXXXXXXXXGOOOOOXXXXXXXXXXXXXXGOOOOOOOOXXXXXXXXXXXGOOOOXXXXXXXXXXXXXXXGOOXXXXXXXXXXXXXXXXXGOOOOXXXXXXXXXXXXXXXGOOOOOOXXXXXXXXXXXXXGOOOOOOOOOXXXXXXXXXXGOOOOOOXXXXXXXXXXXXXGOOXXXXXXXXXXXXXXXXXGOOOOOXXXXXXXXXXXXXXGOOOXXXXXXXXXXXXXXXXGOOOOOOOXXXXXXXXXXXX,0,0,0
17934,76,0,76,21,403,0,0,408,342,66,GOOXXXXXXXXXXXXXXXXXGOOOOOXXXXXXXXXXXXXXGOOOOOOOOXXXXXXXXXXXGOOOOXXXXXXXXXXXXXXXGOOXXXXXXXXXXXXXXXXXGOOOOXXXXXXXXXXXXXXXGOOOOOOXXXXXXXXXXXXXGOOOOOOOOOXXXXXXXXXXGOOOOOOXXXXXXXXXXXXXGOOXXXXXXXXXXXXXXXXXGOOOOOXXXXXXXXXXXXXXGOOOXXXXXXXXXXXXXXXXGOOOOOOOXXXXXXXXXXXX,0,0,0

17955,76,0,76,24,400,0,0,405,343,62,GOOXXXXXXXXXXXXXXXXXGOOOOOXXXXXXXXXXXXXXGOOOOOOOOXXXXXXXXXXXGOOOOXXXXXXXXXXXXXXXGOOXXXXXXXXXXXXXXXXXGOOOOXXXXXXXXXXXXXXXGOOOOOOXXXXXXXXXXXXXGOOOOOOOOOXXXXXXXXXXGOOOOOOXXXXXXXXXXXXXGOOXXXXXXXXXXXXXXXXXGOOOOOXXXXXXXXXXXXXXGOOOXXXXXXXXXXXXXXXXGOOOOOOOXXXXXXXXXXXX,0,0,0
17976,76,0,76,26,398,0,0,403,344,59,GOOXXXXXXXXXXXXXXXXXGOOOOOXXXXXXXXXXXXXXGOOOOOOOOXXXXXXXXXXXGOOOOXXXXXXXXXXXXXXXGOOXXXXXXXXXXXXXXXXXGOOOOXXXXXXXXXXXXXXXGOOOOOOXXXXXXXXXXXXXGOOOOOOOOOXXXXXXXXXXGOOOOOOXXXXXXXXXXXXXGOOXXXXXXXXXXXXXXXXXGOOOOOXXXXXXXXXXXXXXGOOOXXXXXXXXXXXXXXXXGOOOOOOOXXXXXXXXXXXX,0,0,0
17997,76,0,76,26,398,0,0,403,343,60,GOOXXXXXXXXXXXXXXXXXGOOOOOXXXXXXXXXXXXXXGOOOOOOOOXXXXXXXXXXXGOOOOXXXXXXXXXXXXXXXGOOXXXXXXXXXXXXXXXXXGOOOOXXXXXXXXXXXXXXXGOOOOOOXXXXXXXXXXXXXGOOOOOOOOOXXXXXXXXXXGOOOOOOXXXXXXXXXXXXXGOOXXXXXXXXXXXXXXXXXGOOOOOXXXXXXXXXXXXXXGOOOXXXXXXXXXXXXXXXXGOOOOOOOXXXXXXXXXXXX,0,0,0
18018,76,0,76,28,396,0,0,402,344,58,GOOXXXXXXXXXXXXXXXXXGOOOOOXXXXXXXXXXXXXXGOOOOOOOOXXXXXXXXXXXGOOOOXXXXXXXXXXXXXXXGOOXXXXXXXXXXXXXXXXXGOOOOXXXXXXXXXXXXXXXGOOOOOOXXXXXXXXXXXXXGOOOOOOOOOXXXXXXXXXXGOOOOOOXXXXXXXXXXXXXGOOXXXXXXXXXXXXXXXXXGOOOOOXXXXXXXXXXXXXXGOOOXXXXXXXXXXXXXXXXGOOOOOOOXXXXXXXXXXXX,0,0,0
18039,76,0,76,29,395,0,0,401,345,56,GOOXXXXXXXXXXXXXXXXXGOOOOOXXXXXXXXXXXXXXGOOOOOOOOXXXXXXXXXXXGOOOOXXXXXXXXXXXXXXXGOOXXXXXXXXXXXXXXXXXGOOOOXXXXXXXXXXXXXXXGOOOOOOXXXXXXXXXXXXXGOOOOOOOOOXXXXXXXXXXGOOOOOOXXXXXXXXXXXXXGOOXXXXXXXXXXXXXXXXXGOOOOOXXXXXXXXXXXXXXGOOOXXXXXXXXXXXXXXXXGOOOOOOOXXXXXXXXXXXX,0,0,0

18060,76,0,76,29,395,0,0,401,347,54,GOOXXXXXXXXXXXXXXXXXGOOOOOXXXXXXXXXXXXXXGOOOOOOOOXXXXXXXXXXXGOOOOXXXXXXXXXXXXXXXGOOXXXXXXXXXXXXXXXXXGOOOOXXXXXXXXXXXXXXXGOOOOOOXXXXXXXXXXXXXGOOOOOOOOOXXXXXXXXXXGOOOOOOXXXXXXXXXXXXXGOOXXXXXXXXXXXXXXXXXGOOOOOXXXXXXXXXXXXXXGOOOXXXXXXXXXXXXXXXXGOOOOOOOXXXXXXXXXXXX,0,0,0
18081,76,0,76,32,392,0,0,398,344,54,GOOXXXXXXXXXXXXXXXXXGOOOOOXXXXXXXXXXXXXXGOOOOOOOOXXXXXXXXXXXGOOOOXXXXXXXXXXXXXXXGOOXXXXXXXXXXXXXXXXXGOOOOXXXXXXXXXXXXXXXGOOOOOOXXXXXXXXXXXXXGOOOOOOOOOXXXXXXXXXXGOOOOOOXXXXXXXXXXXXXGOOXXXXXXXXXXXXXXXXXGOOOOOXXXXXXXXXXXXXXGOOOXXXXXXXXXXXXXXXXGOOOOOOOXXXXXXXXXXXX,0,0,0
18102,76,0,76,34,390,0,0,396,344,52,GOOXXXXXXXXXXXXXXXXXGOOOOOXXXXXXXXXXXXXXGOOOOOOOOXXXXXXXXXXXGOOOOXXXXXXXXXXXXXXXGOOXXXXXXXXXXXXXXXXXGOOOOXXXXXXXXXXXXXXXGOOOOOOXXXXXXXXXXXXXGOOOOOOOOOXXXXXXXXXXGOOOOOOXXXXXXXXXXXXXGOOXXXXXXXXXXXXXXXXXGOOOOOXXXXXXXXXXXXXXGOOOXXXXXXXXXXXXXXXXGOOOOOOOXXXXXXXXXXXX,0,0,0
18123,76,0,76,33,391,0,0,397,346,51,GOOXXXXXXXXXXXXXXXXXGOOOOOXXXXXXXXXXXXXXGOOOOOOOOXXXXXXXXXXXGOOOOXXXXXXXXXXXXXXXGOOXXXXXXXXXXXXXXXXXGOOOOXXXXXXXXXXXXXXXGOOOOOOXXXXXXXXXXXXXGOOOOOOOOOXXXXXXXXXXGOOOOOOXXXXXXXXXXXXXGOOXXXXXXXXXXXXXXXXXGOOOOOXXXXXXXXXXXXXXGOOOXXXXXXXXXXXXXXXXGOOOOOOOXXXXXXXXXXXX,0,0,0
18144,76,0,76,34,390,0,0,396,344,52,GOOXXXXXXXXXXXXXXXXXGOOOOOXXXXXXXXXXXXXXGOOOOOOOOXXXXXXXXXXXGOOOOXXXXXXXXXXXXXXXGOOXXXXXXXXXXXXXXXXXGOOOOXXXXXXXXXXXXXXXGOOOOOOXXXXXXXXXXXXXGOOOOOOOOOXXXXXXXXXXGOOOOOOXXXXXXXXXXXXXGOOXXXXXXXXXXXXXXXXXGOOOOOXXXXXXXXXXXXXXGOOOXXXXXXXXXXXXXXXXGOOOOOOOXXXXXXXXXXXX,0,0,0

18165,76,0,76,30,394,0,0,400,346,54,GOOXXXXXXXXXXXXXXXXXGOOOOOXXXXXXXXXXXXXXGOOOOOOOOXXXXXXXXXXXGOOOOXXXXXXXXXXXXXXXGOOXXXXXXXXXXXXXXXXXGOOOOXXXXXXXXXXXXXXXGOOOOOOXXXXXXXXXXXXXGOOOOOOOOOXXXXXXXXXXGOOOOOOXXXXXXXXXXXXXGOOXXXXXXXXXXXXXXXXXGOOOOOXXXXXXXXXXXXXXGOOOXXXXXXXXXXXXXXXXGOOOOOOOXXXXXXXXXXXX,0,0,0
18186,76,0,76,28,396,0,0,400,347,53,GOOXXXXXXXXXXXXXXXXXGOOOOOXXXXXXXXXXXXXXGOOOOOOOOXXXXXXXXXXXGOOOOXXXXXXXXXXXXXXXGOOXXXXXXXXXXXXXXXXXGOOOOXXXXXXXXXXXXXXXGOOOOOOXXXXXXXXXXXXXGOOOOOOOOOXXXXXXXXXXGOOOOOOXXXXXXXXXXXXXGOOXXXXXXXXXXXXXXXXXGOOOOOXXXXXXXXXXXXXXGOOOXXXXXXXXXXXXXXXXGOOOOOOOXXXXXXXXXXXX,0,0,0
18207,76,0,76,24,400,0,0,405,345,60,GOOXXXXXXXXXXXXXXXXXGOOOOOXXXXXXXXXXXXXXGOOOOOOOOXXXXXXXXXXXGOOOOXXXXXXXXXXXXXXXGOOXXXXXXXXXXXXXXXXXGOOOOXXXXXXXXXXXXXXXGOOOOOOXXXXXXXXXXXXXGOOOOOOOOOXXXXXXXXXXGOOOOOOXXXXXXXXXXXXXGOOXXXXXXXXXXXXXXXXXGOOOOOXXXXXXXXXXXXXXGOOOXXXXXXXXXXXXXXXXGOOOOOOOXXXXXXXXXXXX,0,0,0
18228,76,0,76,27,397,0,0,402,348,54,GOOXXXXXXXXXXXXXXXXXGOOOOOXXXXXXXXXXXXXXGOOOOOOOOXXXXXXXXXXXGOOOOXXXXXXXXXXXXXXXGOOXXXXXXXXXXXXXXXXXGOOOOXXXXXXXXXXXXXXXGOOOOOOXXXXXXXXXXXXXGOOOOOOOOOXXXXXXXXXXGOOOOOOXXXXXXXXXXXXXGOOXXXXXXXXXXXXXXXXXGOOOOOXXXXXXXXXXXXXXGOOOXXXXXXXXXXXXXXXXGOOOOOOOXXXXXXXXXXXX,0,0,0
18249,76,0,76,28,396,0,0,401,345,56,GOOXXXXXXXXXXXXXXXXXGOOOOOXXXXXXXXXXXXXXGOOOOOOOOXXXXXXXXXXXGOOOOXXXXXXXXXXXXXXXGOOXXXXXXXXXXXXXXXXXGOOOOXXXXXXXXXXXXXXXGOOOOOOXXXXXXXXXXXXXGOOOOOOOOOXXXXXXXXXXGOOOOOOXXXXXXXXXXXXXGOOXXXXXXXXXXXXXXXXXGOOOOOXXXXXXXXXXXXXXGOOOXXXXXXXXXXXXXXXXGOOOOOOOXXXXXXXXXXXX,0,0,0

18270,76,0,76,25,399,0,0,404,347,57,GOOXXXXXXXXXXXXXXXXXGOOOOOXXXXXXXXXXXXXXGOOOOOOOOXXXXXXXXXXXGOOOOXXXXXXXXXXXXXXXGOOXXXXXXXXXXXXXXXXXGOOOOXXXXXXXXXXXXXXXGOOOOOOXXXXXXXXXXXXXGOOOOOOOOOXXXXXXXXXXGOOOOOOXXXXXXXXXXXXXGOOXXXXXXXXXXXXXXXXXGOOOOOXXXXXXXXXXXXXXGOOOXXXXXXXXXXXXXXXXGOOOOOOOXXXXXXXXXXXX,0,0,0
18291,76,0,76,25,399,0,0,404,345,59,GOOXXXXXXXXXXXXXXXXXGOOOOOXXXXXXXXXXXXXXGOOOOOOOOXXXXXXXXXXXGOOOOXXXXXXXXXXXXXXXGOOXXXXXXXXXXXXXXXXXGOOOOXXXXXXXXXXXXXXXGOOOOOOXXXXXXXXXXXXXGOOOOOOOOOXXXXXXXXXXGOOOOOOXXXXXXXXXXXXXGOOXXXXXXXXXXXXXXXXXGOOOOOXXXXXXXXXXXXXXGOOOXXXXXXXXXXXXXXXXGOOOOOOOXXXXXXXXXXXX,0,0,0
18312,76,0,76,25,399,0,0,404,345,59,GOOXXXXXXXXXXXXXXXXXGOOOOOXXXXXXXXXXXXXXGOOOOOOOOXXXXXXXXXXXGOOOOXXXXXXXXXXXXXXXGOOXXXXXXXXXXXXXXXXXGOOOOXXXXXXXXXXXXXXXGOOOOOOXXXXXXXXXXXXXGOOOOOOOOOXXXXXXXXXXGOOOOOOXXXXXXXXXXXXXGOOXXXXXXXXXXXXXXXXXGOOOOOXXXXXXXXXXXXXXGOOOXXXXXXXXXXXXXXXXGOOOOOOOXXXXXXXXXXXX,0,0,0
18333,76,0,76,26,398,0,0,403,347,56,GOOXXXXXXXXXXXXXXXXXGOOOOOXXXXXXXXXXXXXXGOOOOOOOOXXXXXXXXXXXGOOOOXXXXXXXXXXXXXXXGOOXXXXXXXXXXXXXXXXXGOOOOXXXXXXXXXXXXXXXGOOOOOOXXXXXXXXXXXXXGOOOOOOOOOXXXXXXXXXXGOOOOOOXXXXXXXXXXXXXGOOXXXXXXXXXXXXXXXXXGOOOOOXXXXXXXXXXXXXXGOOOXXXXXXXXXXXXXXXXGOOOOOOOXXXXXXXXXXXX,0,0,0
18354,76,0,76,29,395,0,0,400,348,52,GOOXXXXXXXXXXXXXXXXXGOOOOOXXXXXXXXXXXXXXGOOOOOOOOXXXXXXXXXXXGOOOOXXXXXXXXXXXXXXXGOOXXXXXXXXXXXXXXXXXGOOOOXXXXXXXXXXXXXXXGOOOOOOXXXXXXXXXXXXXGOOOOOOOOOXXXXXXXXXXGOOOOOOXXXXXXXXXXXXXGOOXXXXXXXXXXXXXXXXXGOOOOOXXXXXXXXXXXXXXGOOOXXXXXXXXXXXXXXXXGOOOOOOOXXXXXXXXXXXX,0,0,0

18375,76,0,76,33,391,0,0,396,348,48,GOOXXXXXXXXXXXXXXXXXGOOOOOXXXXXXXXXXXXXXGOOOOOOOOXXXXXXXXXXXGOOOOXXXXXXXXXXXXXXXGOOXXXXXXXXXXXXXXXXXGOOOOXXXXXXXXXXXXXXXGOOOOOOXXXXXXXXXXXXXGOOOOOOOOOXXXXXXXXXXGOOOOOOXXXXXXXXXXXXXGOOXXXXXXXXXXXXXXXXXGOOOOOXXXXXXXXXXXXXXGOOOXXXXXXXXXXXXXXXXGOOOOOOOXXXXXXXXXXXX,0,0,0
18396,76,0,76,37,387,0,0,391,345,46,GOOXXXXXXXXXXXXXXXXXGOOOOOXXXXXXXXXXXXXXGOOOOOOOOXXXXXXXXXXXGOOOOXXXXXXXXXXXXXXXGOOXXXXXXXXXXXXXXXXXGOOOOXXXXXXXXXXXXXXXGOOOOOOXXXXXXXXXXXXXGOOOOOOOOOXXXXXXXXXXGOOOOOOXXXXXXXXXXXXXGOOXXXXXXXXXXXXXXXXXGOOOOOXXXXXXXXXXXXXXGOOOXXXXXXXXXXXXXXXXGOOOOOOOXXXXXXXXXXXX,0,0,0
18417,76,0,76,34,390,0,0,394,349,45,GOOXXXXXXXXXXXXXXXXXGOOOOOXXXXXXXXXXXXXXGOOOOOOOOXXXXXXXXXXXGOOOOXXXXXXXXXXXXXXXGOOXXXXXXXXXXXXXXXXXGOOOOXXXXXXXXXXXXXXXGOOOOOOXXXXXXXXXXXXXGOOOOOOOOOXXXXXXXXXXGOOOOOOXXXXXXXXXXXXXGOOXXXXXXXXXXXXXXXXXGOOOOOXXXXXXXXXXXXXXGOOOXXXXXXXXXXXXXXXXGOOOOOOOXXXXXXXXXXXX,0,0,0
18438,76,0,76,32,392,0,0,397,345,52,GOOXXXXXXXXXXXXXXXXXGOOOOOXXXXXXXXXXXXXXGOOOOOOOOXXXXXXXXXXXGOOOOXXXXXXXXXXXXXXXGOOXXXXXXXXXXXXXXXXXGOOOOXXXXXXXXXXXXXXXGOOOOOOXXXXXXXXXXXXXGOOOOOOOOOXXXXXXXXXXGOOOOOOXXXXXXXXXXXXXGOOXXXXXXXXXXXXXXXXXGOOOOOXXXXXXXXXXXXXXGOOOXXXXXXXXXXXXXXXXGOOOOOOOXXXXXXXXXXXX,0,0,0
18459,76,0,76,30,394,0,0,399,347,52,GOOXXXXXXXXXXXXXXXXXGOOOOOXXXXXXXXXXXXXXGOOOOOOOOXXXXXXXXXXXGOOOOXXXXXXXXXXXXXXXGOOXXXXXXXXXXXXXXXXXGOOOOXXXXXXXXXXXXXXXGOOOOOOXXXXXXXXXXXXXGOOOOOOOOOXXXXXXXXXXGOOOOOOXXXXXXXXXXXXXGOOXXXXXXXXXXXXXXXXXGOOOOOXXXXXXXXXXXXXXGOOOXXXXXXXXXXXXXXXXGOOOOOOOXXXXXXXXXXXX,0,0,0

18480,76,0,76,32,392,0,0,398,347,51,GOOXXXXXXXXXXXXXXXXXGOOOOOXXXXXXXXXXXXXXGOOOOOOOOXXXXXXXXXXXGOOOOXXXXXXXXXXXXXXXGOOXXXXXXXXXXXXXXXXXGOOOOXXXXXXXXXXXXXXXGOOOOOOXXXXXXXXXXXXXGOOOOOOOOOXXXXXXXXXXGOOOOOOXXXXXXXXXXXXXGOOXXXXXXXXXXXXXXXXXGOOOOOXXXXXXXXXXXXXXGOOOXXXXXXXXXXXXXXXXGOOOOOOOXXXXXXXXXXXX,0,0,0
18501,76,0,76,33,391,0,0,398,347,51,GOOXXXXXXXXXXXXXXXXXGOOOOOXXXXXXXXXXXXXXGOOOOOOOOXXXXXXXXXXXGOOOOXXXXXXXXXXXXXXXGOOXXXXXXXXXXXXXXXXXGOOOOXXXXXXXXXXXXXXXGOOOOOOXXXXXXXXXXXXXGOOOOOOOOOXXXXXXXXXXGOOOOOOXXXXXXXXXXXXXGOOXXXXXXXXXXXXXXXXXGOOOOOXXXXXXXXXXXXXXGOOOXXXXXXXXXXXXXXXXGOOOOOOOXXXXXXXXXXXX,0,0,0
18522,76,0,76,33,391,0,0,398,347,51,GOOXXXXXXXXXXXXXXXXXGOOOOOXXXXXXXXXXXXXXGOOOOOOOOXXXXXXXXXXXGOOOOXXXXXXXXXXXXXXXGOOXXXXXXXXXXXXXXXXXGOOOOXXXXXXXXXXXXXXXGOOOOOOXXXXXXXXXXXXXGOOOOOOOOOXXXXXXXXXXGOOOOOOXXXXXXXXXXXXXGOOXXXXXXXXXXXXXXXXXGOOOOOXXXXXXXXXXXXXXGOOOXXXXXXXXXXXXXXXXGOOOOOOOXXXXXXXXXXXX,0,0,0
18543,76,0,76,32,392,0,0,399,347,52,GOOXXXXXXXXXXXXXXXXXGOOOOOXXXXXXXXXXXXXXGOOOOOOOOXXXXXXXXXXXGOOOOXXXXXXXXXXXXXXXGOOXXXXXXXXXXXXXXXXXGOOOOXXXXXXXXXXXXXXXGOOOOOOXXXXXXXXXXXXXGOOOOOOOOOXXXXXXXXXXGOOOOOOXXXXXXXXXXXXXGOOXXXXXXXXXXXXXXXXXGOOOOOXXXXXXXXXXXXXXGOOOXXXXXXXXXXXXXXXXGOOOOOOOXXXXXXXXXXXX,0,0,0
18564,76,0,76,33,391,0,0,399,347,52,GOOXXXXXXXXXXXXXXXXXGOOOOOXXXXXXXXXXXXXXGOOOOOOOOXXXXXXXXXXXGOOOOXXXXXXXXXXXXXXXGOOXXXXXXXXXXXXXXXXXGOOOOXXXXXXXXXXXXXXXGOOOOOOXXXXXXXXXXXXXGOOOOOOOOOXXXXXXXXXXGOOOOOOXXXXXXXXXXXXXGOOXXXXXXXXXXXXXXXXXGOOOOOXXXXXXXXXXXXXXGOOOXXXXXXXXXXXXXXXXGOOOOOOOXXXXXXXXXXXX,0,0,0

18585,76,0,76,34,390,0,0,398,346,52,GOOXXXXXXXXXXXXXXXXXGOOOOOXXXXXXXXXXXXXXGOOOOOOOOXXXXXXXXXXXGOOOOXXXXXXXXXXXXXXXGOOXXXXXXXXXXXXXXXXXGOOOOXXXXXXXXXXXXXXXGOOOOOOXXXXXXXXXXXXXGOOOOOOOOOXXXXXXXXXXGOOOOOOXXXXXXXXXXXXXGOOXXXXXXXXXXXXXXXXXGOOOOOXXXXXXXXXXXXXXGOOOXXXXXXXXXXXXXXXXGOOOOOOOXXXXXXXXXXXX,0,0,0
18606,76,0,76,30,394,0,0,401,346,55,GOOXXXXXXXXXXXXXXXXXGOOOOOXXXXXXXXXXXXXXGOOOOOOOOXXXXXXXXXXXGOOOOXXXXXXXXXXXXXXXGOOXXXXXXXXXXXXXXXXXGOOOOXXXXXXXXXXXXXXXGOOOOOOXXXXXXXXXXXXXGOOOOOOOOOXXXXXXXXXXGOOOOOOXXXXXXXXXXXXXGOOXXXXXXXXXXXXXXXXXGOOOOOXXXXXXXXXXXXXXGOOOXXXXXXXXXXXXXXXXGOOOOOOOXXXXXXXXXXXX,0,0,0
18627,76,0,76,27,397,0,0,404,345,59,GOOXXXXXXXXXXXXXXXXXGOOOOOXXXXXXXXXXXXXXGOOOOOOOOXXXXXXXXXXXGOOOOXXXXXXXXXXXXXXXGOOXXXXXXXXXXXXXXXXXGOOOOXXXXXXXXXXXXXXXGOOOOOOXXXXXXXXXXXXXGOOOOOOOOOXXXXXXXXXXGOOOOOOXXXXXXXXXXXXXGOOXXXXXXXXXXXXXXXXXGOOOOOXXXXXXXXXXXXXXGOOOXXXXXXXXXXXXXXXXGOOOOOOOXXXXXXXXXXXX,0,0,0
18648,76,0,76,29,395,0,0,402,345,57,GOOXXXXXXXXXXXXXXXXXGOOOOOXXXXXXXXXXXXXXGOOOOOOOOXXXXXXXXXXXGOOOOXXXXXXXXXXXXXXXGOOXXXXXXXXXXXXXXXXXGOOOOXXXXXXXXXXXXXXXGOOOOOOXXXXXXXXXXXXXGOOOOOOOOOXXXXXXXXXXGOOOOOOXXXXXXXXXXXXXGOOXXXXXXXXXXXXXXXXXGOOOOOXXXXXXXXXXXXXXGOOOXXXXXXXXXXXXXXXXGOOOOOOOXXXXXXXXXXXX,0,0,0
18669,76,0,76,31,393,0,0,400,347,53,GOOXXXXXXXXXXXXXXXXXGOOOOOXXXXXXXXXXXXXXGOOOOOOOOXXXXXXXXXXXGOOOOXXXXXXXXXXXXXXXGOOXXXXXXXXXXXXXXXXXGOOOOXXXXXXXXXXXXXXXGOOOOOOXXXXXXXXXXXXXGOOOOOOOOOXXXXXXXXXXGOOOOOOXXXXXXXXXXXXXGOOXXXXXXXXXXXXXXXXXGOOOOOXXXXXXXXXXXXXXGOOOXXXXXXXXXXXXXXXXGOOOOOOOXXXXXXXXXXXX,0,0,0

18690,77,1,76,31,392,0,0,399,345,54,GOOXXXXXXXXXXXXXXXXXGOOOOOXXXXXXXXXXXXXXGOOOOOOOOXXXXXXXXXXXGOOOOXXXXXXXXXXXXXXXGOOXXXXXXXXXXXXXXXXXGOOOOXXXXXXXXXXXXXXXGOOOOOOXXXXXXXXXXXXXGOOOOOOOOOXXXXXXXXXXGOOOOOOXXXXXXXXXXXXXGOOXXXXXXXXXXXXXXXXXGOOOOOXXXXXXXXXXXXXXGOOOXXXXXXXXXXXXXXXXGOOOOOOOAXXXXXXXXXXX,0,0,0
18711,77,1,76,31,392,0,0,399,346,53,GOOXXXXXXXXXXXXXXXXXGOOOOOXXXXXXXXXXXXXXGOOOOOOOOXXXXXXXXXXXGOOOOXXXXXXXXXXXXXXXGOOXXXXXXXXXXXXXXXXXGOOOOXXXXXXXXXXXXXXXGOOOOOOXXXXXXXXXXXXXGOOOOOOOOOXXXXXXXXXXGOOOOOOXXXXXXXXXXXXXGOOXXXXXXXXXXXXXXXXXGOOOOOXXXXXXXXXXXXXXGOOOXXXXXXXXXXXXXXXXGOOOOOOOAXXXXXXXXXXX,0,0,0
18732,77,1,76,31,392,0,0,399,347,52,GOOXXXXXXXXXXXXXXXXXGOOOOOXXXXXXXXXXXXXXGOOOOOOOOXXXXXXXXXXXGOOOOXXXXXXXXXXXXXXXGOOXXXXXXXXXXXXXXXXXGOOOOXXXXXXXXXXXXXXXGOOOOOOXXXXXXXXXXXXXGOOOOOOOOOXXXXXXXXXXGOOOOOOXXXXXXXXXXXXXGOOXXXXXXXXXXXXXXXXXGOOOOOXXXXXXXXXXXXXXGOOOXXXXXXXXXXXXXXXXGOOOOOOOAXXXXXXXXXXX,0,0,0
18753,77,0,77,30,393,0,0,399,349,50,GOOXXXXXXXXXXXXXXXXXGOOOOOXXXXXXXXXXXXXXGOOOOOOOOXXXXXXXXXXXGOOOOXXXXXXXXXXXXXXXGOOXXXXXXXXXXXXXXXXXGOOOOXXXXXXXXXXXXXXXGOOOOOOXXXXXXXXXXXXXGOOOOOOOOOXXXXXXXXXXGOOOOOOXXXXXXXXXXXXXGOOXXXXXXXXXXXXXXXXXGOOOOOXXXXXXXXXXXXXXGOOOXXXXXXXXXXXXXXXXGOOOOOOOOXXXXXXXXXXX,0,0,0
18774,77,0,77,35,388,0,0,394,348,46,GOOXXXXXXXXXXXXXXXXXGOOOOOXXXXXXXXXXXXXXGOOOOOOOOXXXXXXXXXXXGOOOOXXXXXXXXXXXXXXXGOOXXXXXXXXXXXXXXXXXGOOOOXXXXXXXXXXXXXXXGOOOOOOXXXXXXXXXXXXXGOOOOOOOOOXXXXXXXXXXGOOOOOOXXXXXXXXXXXXXGOOXXXXXXXXXXXXXXXXXGOOOOOXXXXXXXXXXXXXXGOOOXXXXXXXXXXXXXXXXGOOOOOOOOXXXXXXXXXXX,0,0,0

18795,77,0,77,38,385,0,0,391,347,44,GOOXXXXXXXXXXXXXXXXXGOOOOOXXXXXXXXXXXXXXGOOOOOOOOXXXXXXXXXXXGOOOOXXXXXXXXXXXXXXXGOOXXXXXXXXXXXXXXXXXGOOOOXXXXXXXXXXXXXXXGOOOOOOXXXXXXXXXXXXXGOOOOOOOOOXXXXXXXXXXGOOOOOOXXXXXXXXXXXXXGOOXXXXXXXXXXXXXXXXXGOOOOOXXXXXXXXXXXXXXGOOOXXXXXXXXXXXXXXXXGOOOOOOOOXXXXXXXXXXX,0,0,0
18816,77,0,77,35,388,0,0,393,348,45,GOOXXXXXXXXXXXXXXXXXGOOOOOXXXXXXXXXXXXXXGOOOOOOOOXXXXXXXXXXXGOOOOXXXXXXXXXXXXXXXGOOXXXXXXXXXXXXXXXXXGOOOOXXXXXXXXXXXXXXXGOOOOOOXXXXXXXXXXXXXGOOOOOOOOOXXXXXXXXXXGOOOOOOXXXXXXXXXXXXXGOOXXXXXXXXXXXXXXXXXGOOOOOXXXXXXXXXXXXXXGOOOXXXXXXXXXXXXXXXXGOOOOOOOOXXXXXXXXXXX,0,0,0
18837,77,0,77,36,387,0,0,392,348,44,GOOXXXXXXXXXXXXXXXXXGOOOOOXXXXXXXXXXXXXXGOOOOOOOOXXXXXXXXXXXGOOOOXXXXXXXXXXXXXXXGOOXXXXXXXXXXXXXXXXXGOOOOXXXXXXXXXXXXXXXGOOOOOOXXXXXXXXXXXXXGOOOOOOOOOXXXXXXXXXXGOOOOOOXXXXXXXXXXXXXGOOXXXXXXXXXXXXXXXXXGOOOOOXXXXXXXXXXXXXXGOOOXXXXXXXXXXXXXXXXGOOOOOOOOXXXXXXXXXXX,0,0,0
18858,77,0,77,35,388,0,0,393,348,45,GOOXXXXXXXXXXXXXXXXXGOOOOOXXXXXXXXXXXXXXGOOOOOOOOXXXXXXXXXXXGOOOOXXXXXXXXXXXXXXXGOOXXXXXXXXXXXXXXXXXGOOOOXXXXXXXXXXXXXXXGOOOOOOXXXXXXXXXXXXXGOOOOOOOOOXXXXXXXXXXGOOOOOOXXXXXXXXXXXXXGOOXXXXXXXXXXXXXXXXXGOOOOOXXXXXXXXXXXXXXGOOOXXXXXXXXXXXXXXXXGOOOOOOOOXXXXXXXXXXX,0,0,0
18879,77,0,77,36,387,0,0,392,348,44,GOOXXXXXXXXXXXXXXXXXGOOOOOXXXXXXXXXXXXXXGOOOOOOOOXXXXXXXXXXXGOOOOXXXXXXXXXXXXXXXGOOXXXXXXXXXXXXXXXXXGOOOOXXXXXXXXXXXXXXXGOOOOOOXXXXXXXXXXXXXGOOOOOOOOOXXXXXXXXXXGOOOOOOXXXXXXXXXXXXXGOOXXXXXXXXXXXXXXXXXGOOOOOXXXXXXXXXXXXXXGOOOXXXXXXXXXXXXXXXXGOOOOOOOOXXXXXXXXXXX,0,0,0

18900,77,0,77,35,388,0,0,393,347,46,GOOXXXXXXXXXXXXXXXXXGOOOOOXXXXXXXXXXXXXXGOOOOOOOOXXXXXXXXXXXGOOOOXXXXXXXXXXXXXXXGOOXXXXXXXXXXXXXXXXXGOOOOXXXXXXXXXXXXXXXGOOOOOOXXXXXXXXXXXXXGOOOOOOOOOXXXXXXXXXXGOOOOOOXXXXXXXXXXXXXGOOXXXXXXXXXXXXXXXXXGOOOOOXXXXXXXXXXXXXXGOOOXXXXXXXXXXXXXXXXGOOOOOOOOXXXXXXXXXXX,0,0,0
18921,77,0,77,33,390,0,0,394,348,46,GOOXXXXXXXXXXXXXXXXXGOOOOOXXXXXXXXXXXXXXGOOOOOOOOXXXXXXXXXXXGOOOOXXXXXXXXXXXXXXXGOOXXXXXXXXXXXXXXXXXGOOOOXXXXXXXXXXXXXXXGOOOOOOXXXXXXXXXXXXXGOOOOOOOOOXXXXXXXXXXGOOOOOOXXXXXXXXXXXXXGOOXXXXXXXXXXXXXXXXXGOOOOOXXXXXXXXXXXXXXGOOOXXXXXXXXXXXXXXXXGOOOOOOOOXXXXXXXXXXX,0,0,0
18942,77,0,77,34,389,0,0,394,346,48,GOOXXXXXXXXXXXXXXXXXGOOOOOXXXXXXXXXXXXXXGOOOOOOOOXXXXXXXXXXXGOOOOXXXXXXXXXXXXXXXGOOXXXXXXXXXXXXXXXXXGOOOOXXXXXXXXXXXXXXXGOOOOOOXXXXXXXXXXXXXGOOOOOOOOOXXXXXXXXXXGOOOOOOXXXXXXXXXXXXXGOOXXXXXXXXXXXXXXXXXGOOOOOXXXXXXXXXXXXXXGOOOXXXXXXXXXXXXXXXXGOOOOOOOOXXXXXXXXXXX,0,0,0
18963,77,0,77,31,392,0,0,397,348,49,GOOXXXXXXXXXXXXXXXXXGOOOOOXXXXXXXXXXXXXXGOOOOOOOOXXXXXXXXXXXGOOOOXXXXXXXXXXXXXXXGOOXXXXXXXXXXXXXXXXXGOOOOXXXXXXXXXXXXXXXGOOOOOOXXXXXXXXXXXXXGOOOOOOOOOXXXXXXXXXXGOOOOOOXXXXXXXXXXXXXGOOXXXXXXXXXXXXXXXXXGOOOOOXXXXXXXXXXXXXXGOOOXXXXXXXXXXXXXXXXGOOOOOOOOXXXXXXXXXXX,0,0,0
18984,78,1,77,28,394,0,0,399,348,51,GOOXXXXXXXXXXXXXXXXXGOOOOOXXXXXXXXXXXXXXGOOOOOOOOXXXXXXXXXXXGOOOOXXXXXXXXXXXXXXXGOOXXXXXXXXXXXXXXXXXGOOOOXXXXXXXXXXXXXXXGOOOOOOXXXXXXXXXXXXXGOOOOOOOOOXXXXXXXXXXGOOOOOOAXXXXXXXXXXXXGOOXXXXXXXXXXXXXXXXXGOOOOOXXXXXXXXXXXXXXGOOOXXXXXXXXXXXXXXXXGOOOOOOOOXXXXXXXXXXX,0,0,0

19005,78,1,77,28,394,0,0,399,345,54,GOOXXXXXXXXXXXXXXXXXGOOOOOXXXXXXXXXXXXXXGOOOOOOOOXXXXXXXXXXXGOOOOXXXXXXXXXXXXXXXGOOXXXXXXXXXXXXXXXXXGOOOOXXXXXXXXXXXXXXXGOOOOOOXXXXXXXXXXXXXGOOOOOOOOOXXXXXXXXXXGOOOOOOAXXXXXXXXXXXXGOOXXXXXXXXXXXXXXXXXGOOOOOXXXXXXXXXXXXXXGOOOXXXXXXXXXXXXXXXXGOOOOOOOOXXXXXXXXXXX,0,0,0
19026,78,1,77,27,395,0,0,400,345,55,GOOXXXXXXXXXXXXXXXXXGOOOOOXXXXXXXXXXXXXXGOOOOOOOOXXXXXXXXXXXGOOOOXXXXXXXXXXXXXXXGOOXXXXXXXXXXXXXXXXXGOOOOXXXXXXXXXXXXXXXGOOOOOOXXXXXXXXXXXXXGOOOOOOOOOXXXXXXXXXXGOOOOOOAXXXXXXXXXXXXGOOXXXXXXXXXXXXXXXXXGOOOOOXXXXXXXXXXXXXXGOOOXXXXXXXXXXXXXXXXGOOOOOOOOXXXXXXXXXXX,0,0,0
19047,78,1,77,26,396,0,0,401,346,55,GOOXXXXXXXXXXXXXXXXXGOOOOOXXXXXXXXXXXXXXGOOOOOOOOXXXXXXXXXXXGOOOOXXXXXXXXXXXXXXXGOOXXXXXXXXXXXXXXXXXGOOOOXXXXXXXXXXXXXXXGOOOOOOXXXXXXXXXXXXXGOOOOOOOOOXXXXXXXXXXGOOOOOOAXXXXXXXXXXXXGOOXXXXXXXXXXXXXXXXXGOOOOOXXXXXXXXXXXXXXGOOOXXXXXXXXXXXXXXXXGOOOOOOOOXXXXXXXXXXX,0,0,0
19068,78,1,77,25,397,0,0,402,346,56,GOOXXXXXXXXXXXXXXXXXGOOOOOXXXXXXXXXXXXXXGOOOOOOOOXXXXXXXXXXXGOOOOXXXXXXXXXXXXXXXGOOXXXXXXXXXXXXXXXXXGOOOOXXXXXXXXXXXXXXXGOOOOOOXXXXXXXXXXXXXGOOOOOOOOOXXXXXXXXXXGOOOOOOAXXXXXXXXXXXXGOOXXXXXXXXXXXXXXXXXGOOOOOXXXXXXXXXXXXXXGOOOXXXXXXXXXXXXXXXXGOOOOOOOOXXXXXXXXXXX,0,0,0
19089,78,1,77,22,400,0,0,404,348,56,GOOXXXXXXXXXXXXXXXXXGOOOOOXXXXXXXXXXXXXXGOOOOOOOOXXXXXXXXXXXGOOOOXXXXXXXXXXXXXXXGOOXXXXXXXXXXXXXXXXXGOOOOXXXXXXXXXXXXXXXGOOOOOOXXXXXXXXXXXXXGOOOOOOOOOXXXXXXXXXXGOOOOOOAXXXXXXXXXXXXGOOXXXXXXXXXXXXXXXXXGOOOOOXXXXXXXXXXXXXXGOOOXXXXXXXXXXXXXXXXGOOOOOOOOXXXXXXXXXXX,0,0,0

19110,78,1,77,25,397,0,0,402,348,54,GOOXXXXXXXXXXXXXXXXXGOOOOOXXXXXXXXXXXXXXGOOOOOOOOXXXXXXXXXXXGOOOOXXXXXXXXXXXXXXXGOOXXXXXXXXXXXXXXXXXGOOOOXXXXXXXXXXXXXXXGOOOOOOXXXXXXXXXXXXXGOOOOOOOOOXXXXXXXXXXGOOOOOOAXXXXXXXXXXXXGOOXXXXXXXXXXXXXXXXXGOOOOOXXXXXXXXXXXXXXGOOOXXXXXXXXXXXXXXXXGOOOOOOOOXXXXXXXXXXX,0,0,0
19131,78,1,77,24,398,0,0,404,348,56,GOOXXXXXXXXXXXXXXXXXGOOOOOXXXXXXXXXXXXXXGOOOOOOOOXXXXXXXXXXXGOOOOXXXXXXXXXXXXXXXGOOXXXXXXXXXXXXXXXXXGOOOOXXXXXXXXXXXXXXXGOOOOOOXXXXXXXXXXXXXGOOOOOOOOOXXXXXXXXXXGOOOOOOAXXXXXXXXXXXXGOOXXXXXXXXXXXXXXXXXGOOOOOXXXXXXXXXXXXXXGOOOXXXXXXXXXXXXXXXXGOOOOOOOOXXXXXXXXXXX,0,0,0
19152,78,1,77,23,399,0,0,405,350,55,GOOXXXXXXXXXXXXXXXXXGOOOOOXXXXXXXXXXXXXXGOOOOOOOOXXXXXXXXXXXGOOOOXXXXXXXXXXXXXXXGOOXXXXXXXXXXXXXXXXXGOOOOXXXXXXXXXXXXXXXGOOOOOOXXXXXXXXXXXXXGOOOOOOOOOXXXXXXXXXXGOOOOOOAXXXXXXXXXXXXGOOXXXXXXXXXXXXXXXXXGOOOOOXXXXXXXXXXXXXXGOOOXXXXXXXXXXXXXXXXGOOOOOOOOXXXXXXXXXXX,0,0,0
19173,78,0,78,25,397,0,0,402,347,55,GOOXXXXXXXXXXXXXXXXXGOOOOOXXXXXXXXXXXXXXGOOOOOOOOXXXXXXXXXXXGOOOOXXXXXXXXXXXXXXXGOOXXXXXXXXXXXXXXXXXGOOOOXXXXXXXXXXXXXXXGOOOOOOXXXXXXXXXXXXXGOOOOOOOOOXXXXXXXXXXGOOOOOOOXXXXXXXXXXXXGOOXXXXXXXXXXXXXXXXXGOOOOOXXXXXXXXXXXXXXGOOOXXXXXXXXXXXXXXXXGOOOOOOOOXXXXXXXXXXX,0,0,0
19194,78,0,78,24,398,0,0,403,346,57,GOOXXXXXXXXXXXXXXXXXGOOOOOXXXXXXXXXXXXXXGOOOOOOOOXXXXXXXXXXXGOOOOXXXXXXXXXXXXXXXGOOXXXXXXXXXXXXXXXXXGOOOOXXXXXXXXXXXXXXXGOOOOOOXXXXXXXXXXXXXGOOOOOOOOOXXXXXXXXXXGOOOOOOOXXXXXXXXXXXXGOOXXXXXXXXXXXXXXXXXGOOOOOXXXXXXXXXXXXXXGOOOXXXXXXXXXXXXXXXXGOOOOOOOOXXXXXXXXXXX,0,0,0

19215,78,0,78,22,400,0,0,405,348,57,GOOXXXXXXXXXXXXXXXXXGOOOOOXXXXXXXXXXXXXXGOOOOOOOOXXXXXXXXXXXGOOOOXXXXXXXXXXXXXXXGOOXXXXXXXXXXXXXXXXXGOOOOXXXXXXXXXXXXXXXGOOOOOOXXXXXXXXXXXXXGOOOOOOOOOXXXXXXXXXXGOOOOOOOXXXXXXXXXXXXGOOXXXXXXXXXXXXXXXXXGOOOOOXXXXXXXXXXXXXXGOOOXXXXXXXXXXXXXXXXGOOOOOOOOXXXXXXXXXXX,0,0,0
19236,78,0,78,25,397,0,0,402,346,56,GOOXXXXXXXXXXXXXXXXXGOOOOOXXXXXXXXXXXXXXGOOOOOOOOXXXXXXXXXXXGOOOOXXXXXXXXXXXXXXXGOOXXXXXXXXXXXXXXXXXGOOOOXXXXXXXXXXXXXXXGOOOOOOXXXXXXXXXXXXXGOOOOOOOOOXXXXXXXXXXGOOOOOOOXXXXXXXXXXXXGOOXXXXXXXXXXXXXXXXXGOOOOOXXXXXXXXXXXXXXGOOOXXXXXXXXXXXXXXXXGOOOOOOOOXXXXXXXXXXX,0,0,0
19257,78,0,78,23,399,0,0,404,347,57,GOOXXXXXXXXXXXXXXXXXGOOOOOXXXXXXXXXXXXXXGOOOOOOOOXXXXXXXXXXXGOOOOXXXXXXXXXXXXXXXGOOXXXXXXXXXXXXXXXXXGOOOOXXXXXXXXXXXXXXXGOOOOOOXXXXXXXXXXXXXGOOOOOOOOOXXXXXXXXXXGOOOOOOOXXXXXXXXXXXXGOOXXXXXXXXXXXXXXXXXGOOOOOXXXXXXXXXXXXXXGOOOXXXXXXXXXXXXXXXXGOOOOOOOOXXXXXXXXXXX,0,0,0
19278,78,0,78,22,400,0,0,405,348,57,GOOXXXXXXXXXXXXXXXXXGOOOOOXXXXXXXXXXXXXXGOOOOOOOOXXXXXXXXXXXGOOOOXXXXXXXXXXXXXXXGOOXXXXXXXXXXXXXXXXXGOOOOXXXXXXXXXXXXXXXGOOOOOOXXXXXXXXXXXXXGOOOOOOOOOXXXXXXXXXXGOOOOOOOXXXXXXXXXXXXGOOXXXXXXXXXXXXXXXXXGOOOOOXXXXXXXXXXXXXXGOOOXXXXXXXXXXXXXXXXGOOOOOOOOXXXXXXXXXXX,0,0,0
19299,78,0,78,21,401,0,0,406,352,54,GOOXXXXXXXXXXXXXXXXXGOOOOOXXXXXXXXXXXXXXGOOOOOOOOXXXXXXXXXXXGOOOOXXXXXXXXXXXXXXXGOOXXXXXXXXXXXXXXXXXGOOOOXXXXXXXXXXXXXXXGOOOOOOXXXXXXXXXXXXXGOOOOOOOOOXXXXXXXXXXGOOOOOOOXXXXXXXXXXXXGOOXXXXXXXXXXXXXXXXXGOOOOOXXXXXXXXXXXXXXGOOOXXXXXXXXXXXXXXXXGOOOOOOOOXXXXXXXXXXX,0,0,0

19320,78,0,78,23,399,0,0,404,351,53,GOOXXXXXXXXXXXXXXXXXGOOOOOXXXXXXXXXXXXXXGOOOOOOOOXXXXXXXXXXXGOOOOXXXXXXXXXXXXXXXGOOXXXXXXXXXXXXXXXXXGOOOOXXXXXXXXXXXXXXXGOOOOOOXXXXXXXXXXXXXGOOOOOOOOOXXXXXXXXXXGOOOOOOOXXXXXXXXXXXXGOOXXXXXXXXXXXXXXXXXGOOOOOXXXXXXXXXXXXXXGOOOXXXXXXXXXXXXXXXXGOOOOOOOOXXXXXXXXXXX,0,0,0
19341,78,0,78,25,397,0,0,402,350,52,GOOXXXXXXXXXXXXXXXXXGOOOOOXXXXXXXXXXXXXXGOOOOOOOOXXXXXXXXXXXGOOOOXXXXXXXXXXXXXXXGOOXXXXXXXXXXXXXXXXXGOOOOXXXXXXXXXXXXXXXGOOOOOOXXXXXXXXXXXXXGOOOOOOOOOXXXXXXXXXXGOOOOOOOXXXXXXXXXXXXGOOXXXXXXXXXXXXXXXXXGOOOOOXXXXXXXXXXXXXXGOOOXXXXXXXXXXXXXXXXGOOOOOOOOXXXXXXXXXXX,0,0,0
19362,78,0,78,24,398,0,0,403,349,54,GOOXXXXXXXXXXXXXXXXXGOOOOOXXXXXXXXXXXXXXGOOOOOOOOXXXXXXXXXXXGOOOOXXXXXXXXXXXXXXXGOOXXXXXXXXXXXXXXXXXGOOOOXXXXXXXXXXXXXXXGOOOOOOXXXXXXXXXXXXXGOOOOOOOOOXXXXXXXXXXGOOOOOOOXXXXXXXXXXXXGOOXXXXXXXXXXXXXXXXXGOOOOOXXXXXXXXXXXXXXGOOOXXXXXXXXXXXXXXXXGOOOOOOOOXXXXXXXXXXX,0,0,0
19383,78,0,78,24,398,0,0,403,350,53,GOOXXXXXXXXXXXXXXXXXGOOOOOXXXXXXXXXXXXXXGOOOOOOOOXXXXXXXXXXXGOOOOXXXXXXXXXXXXXXXGOOXXXXXXXXXXXXXXXXXGOOOOXXXXXXXXXXXXXXXGOOOOOOXXXXXXXXXXXXXGOOOOOOOOOXXXXXXXXXXGOOOOOOOXXXXXXXXXXXXGOOXXXXXXXXXXXXXXXXXGOOOOOXXXXXXXXXXXXXXGOOOXXXXXXXXXXXXXXXXGOOOOOOOOXXXXXXXXXXX,0,0,0
19404,78,0,78,25,397,0,0,402,350,52,GOOXXXXXXXXXXXXXXXXXGOOOOOXXXXXXXXXXXXXXGOOOOOOOOXXXXXXXXXXXGOOOOXXXXXXXXXXXXXXXGOOXXXXXXXXXXXXXXXXXGOOOOXXXXXXXXXXXXXXXGOOOOOOXXXXXXXXXXXXXGOOOOOOOOOXXXXXXXXXXGOOOOOOOXXXXXXXXXXXXGOOXXXXXXXXXXXXXXXXXGOOOOOXXXXXXXXXXXXXXGOOOXXXXXXXXXXXXXXXXGOOOOOOOOXXXXXXXXXXX,0,0,0

19425,78,0,78,27,395,0,0,400,351,49,GOOXXXXXXXXXXXXXXXXXGOOOOOXXXXXXXXXXXXXXGOOOOOOOOXXXXXXXXXXXGOOOOXXXXXXXXXXXXXXXGOOXXXXXXXXXXXXXXXXXGOOOOXXXXXXXXXXXXXXXGOOOOOOXXXXXXXXXXXXXGOOOOOOOOOXXXXXXXXXXGOOOOOOOXXXXXXXXXXXXGOOXXXXXXXXXXXXXXXXXGOOOOOXXXXXXXXXXXXXXGOOOXXXXXXXXXXXXXXXXGOOOOOOOOXXXXXXXXXXX,0,0,0
19446,80,2,78,26,394,0,0,399,351,48,GOOXXXXXXXXXXXXXXXXXGOOOOOXXXXXXXXXXXXXXGOOOOOOOOXXXXXXXXXXXGOOOOXXXXXXXXXXXXXXXGOOXXXXXXXXXXXXXXXXXGOOOOAXXXXXXXXXXXXXXGOOOOOOXXXXXXXXXXXXXGOOOOOOOOOXXXXXXXXXXGOOOOOOOAXXXXXXXXXXXGOOXXXXXXXXXXXXXXXXXGOOOOOXXXXXXXXXXXXXXGOOOXXXXXXXXXXXXXXXXGOOOOOOOOXXXXXXXXXXX,0,0,0
19467,80,2,78,22,398,0,0,403,351,52,GOOXXXXXXXXXXXXXXXXXGOOOOOXXXXXXXXXXXXXXGOOOOOOOOXXXXXXXXXXXGOOOOXXXXXXXXXXXXXXXGOOXXXXXXXXXXXXXXXXXGOOOOAXXXXXXXXXXXXXXGOOOOOOXXXXXXXXXXXXXGOOOOOOOOOXXXXXXXXXXGOOOOOOOAXXXXXXXXXXXGOOXXXXXXXXXXXXXXXXXGOOOOOXXXXXXXXXXXXXXGOOOXXXXXXXXXXXXXXXXGOOOOOOOOXXXXXXXXXXX,0,0,0
19488,80,2,78,26,394,0,0,399,350,49,GOOXXXXXXXXXXXXXXXXXGOOOOOXXXXXXXXXXXXXXGOOOOOOOOXXXXXXXXXXXGOOOOXXXXXXXXXXXXXXXGOOXXXXXXXXXXXXXXXXXGOOOOAXXXXXXXXXXXXXXGOOOOOOXXXXXXXXXXXXXGOOOOOOOOOXXXXXXXXXXGOOOOOOOAXXXXXXXXXXXGOOXXXXXXXXXXXXXXXXXGOOOOOXXXXXXXXXXXXXXGOOOXXXXXXXXXXXXXXXXGOOOOOOOOXXXXXXXXXXX,0,0,0
19509,80,1,79,30,390,0,0,395,350,45,GOOXXXXXXXXXXXXXXXXXGOOOOOXXXXXXXXXXXXXXGOOOOOOOOXXXXXXXXXXXGOOOOXXXXXXXXXXXXXXXGOOXXXXXXXXXXXXXXXXXGOOOOOXXXXXXXXXXXXXXGOOOOOOXXXXXXXXXXXXXGOOOOOOOOOXXXXXXXXXXGOOOOOOOAXXXXXXXXXXXGOOXXXXXXXXXXXXXXXXXGOOOOOXXXXXXXXXXXXXXGOOOXXXXXXXXXXXXXXXXGOOOOOOOOXXXXXXXXXXX,0,0,0

19530,80,1,79,33,387,0,0,392,350,42,GOOXXXXXXXXXXXXXXXXXGOOOOOXXXXXXXXXXXXXXGOOOOOOOOXXXXXXXXXXXGOOOOXXXXXXXXXXXXXXXGOOXXXXXXXXXXXXXXXXXGOOOOOXXXXXXXXXXXXXXGOOOOOOXXXXXXXXXXXXXGOOOOOOOOOXXXXXXXXXXGOOOOOOOAXXXXXXXXXXXGOOXXXXXXXXXXXXXXXXXGOOOOOXXXXXXXXXXXXXXGOOOXXXXXXXXXXXXXXXXGOOOOOOOOXXXXXXXXXXX,0,0,0
19551,80,1,79,33,387,0,0,392,349,43,GOOXXXXXXXXXXXXXXXXXGOOOOOXXXXXXXXXXXXXXGOOOOOOOOXXXXXXXXXXXGOOOOXXXXXXXXXXXXXXXGOOXXXXXXXXXXXXXXXXXGOOOOOXXXXXXXXXXXXXXGOOOOOOXXXXXXXXXXXXXGOOOOOOOOOXXXXXXXXXXGOOOOOOOAXXXXXXXXXXXGOOXXXXXXXXXXXXXXXXXGOOOOOXXXXXXXXXXXXXXGOOOXXXXXXXXXXXXXXXXGOOOOOOOOXXXXXXXXXXX,0,0,0
19572,80,0,80,31,389,0,0,394,349,45,GOOXXXXXXXXXXXXXXXXXGOOOOOXXXXXXXXXXXXXXGOOOOOOOOXXXXXXXXXXXGOOOOXXXXXXXXXXXXXXXGOOXXXXXXXXXXXXXXXXXGOOOOOXXXXXXXXXXXXXXGOOOOOOXXXXXXXXXXXXXGOOOOOOOOOXXXXXXXXXXGOOOOOOOOXXXXXXXXXXXGOOXXXXXXXXXXXXXXXXXGOOOOOXXXXXXXXXXXXXXGOOOXXXXXXXXXXXXXXXXGOOOOOOOOXXXXXXXXXXX,0,0,0
19593,80,0,80,31,389,0,0,394,350,44,GOOXXXXXXXXXXXXXXXXXGOOOOOXXXXXXXXXXXXXXGOOOOOOOOXXXXXXXXXXXGOOOOXXXXXXXXXXXXXXXGOOXXXXXXXXXXXXXXXXXGOOOOOXXXXXXXXXXXXXXGOOOOOOXXXXXXXXXXXXXGOOOOOOOOOXXXXXXXXXXGOOOOOOOOXXXXXXXXXXXGOOXXXXXXXXXXXXXXXXXGOOOOOXXXXXXXXXXXXXXGOOOXXXXXXXXXXXXXXXXGOOOOOOOOXXXXXXXXXXX,0,0,0
19614,80,0,80,30,390,0,0,395,351,44,GOOXXXXXXXXXXXXXXXXXGOOOOOXXXXXXXXXXXXXXGOOOOOOOOXXXXXXXXXXXGOOOOXXXXXXXXXXXXXXXGOOXXXXXXXXXXXXXXXXXGOOOOOXXXXXXXXXXXXXXGOOOOOOXXXXXXXXXXXXXGOOOOOOOOOXXXXXXXXXXGOOOOOOOOXXXXXXXXXXXGOOXXXXXXXXXXXXXXXXXGOOOOOXXXXXXXXXXXXXXGOOOXXXXXXXXXXXXXXXXGOOOOOOOOXXXXXXXXXXX,0,0,0

19635,80,0,80,31,389,0,0,394,352,42,GOOXXXXXXXXXXXXXXXXXGOOOOOXXXXXXXXXXXXXXGOOOOOOOOXXXXXXXXXXXGOOOOXXXXXXXXXXXXXXXGOOXXXXXXXXXXXXXXXXXGOOOOOXXXXXXXXXXXXXXGOOOOOOXXXXXXXXXXXXXGOOOOOOOOOXXXXXXXXXXGOOOOOOOOXXXXXXXXXXXGOOXXXXXXXXXXXXXXXXXGOOOOOXXXXXXXXXXXXXXGOOOXXXXXXXXXXXXXXXXGOOOOOOOOXXXXXXXXXXX,0,0,0
19656,80,0,80,34,386,0,0,391,349,42,GOOXXXXXXXXXXXXXXXXXGOOOOOXXXXXXXXXXXXXXGOOOOOOOOXXXXXXXXXXXGOOOOXXXXXXXXXXXXXXXGOOXXXXXXXXXXXXXXXXXGOOOOOXXXXXXXXXXXXXXGOOOOOOXXXXXXXXXXXXXGOOOOOOOOOXXXXXXXXXXGOOOOOOOOXXXXXXXXXXXGOOXXXXXXXXXXXXXXXXXGOOOOOXXXXXXXXXXXXXXGOOOXXXXXXXXXXXXXXXXGOOOOOOOOXXXXXXXXXXX,0,0,0
19677,80,0,80,34,386,0,0,391,351,40,GOOXXXXXXXXXXXXXXXXXGOOOOOXXXXXXXXXXXXXXGOOOOOOOOXXXXXXXXXXXGOOOOXXXXXXXXXXXXXXXGOOXXXXXXXXXXXXXXXXXGOOOOOXXXXXXXXXXXXXXGOOOOOOXXXXXXXXXXXXXGOOOOOOOOOXXXXXXXXXXGOOOOOOOOXXXXXXXXXXXGOOXXXXXXXXXXXXXXXXXGOOOOOXXXXXXXXXXXXXXGOOOXXXXXXXXXXXXXXXXGOOOOOOOOXXXXXXXXXXX,0,0,0
19698,80,0,80,35,385,0,0,390,349,41,GOOXXXXXXXXXXXXXXXXXGOOOOOXXXXXXXXXXXXXXGOOOOOOOOXXXXXXXXXXXGOOOOXXXXXXXXXXXXXXXGOOXXXXXXXXXXXXXXXXXGOOOOOXXXXXXXXXXXXXXGOOOOOOXXXXXXXXXXXXXGOOOOOOOOOXXXXXXXXXXGOOOOOOOOXXXXXXXXXXXGOOXXXXXXXXXXXXXXXXXGOOOOOXXXXXXXXXXXXXXGOOOXXXXXXXXXXXXXXXXGOOOOOOOOXXXXXXXXXXX,0,0,0
19719,80,0,80,36,384,0,0,389,349,40,GOOXXXXXXXXXXXXXXXXXGOOOOOXXXXXXXXXXXXXXGOOOOOOOOXXXXXXXXXXXGOOOOXXXXXXXXXXXXXXXGOOXXXXXXXXXXXXXXXXXGOOOOOXXXXXXXXXXXXXXGOOOOOOXXXXXXXXXXXXXGOOOOOOOOOXXXXXXXXXXGOOOOOOOOXXXXXXXXXXXGOOXXXXXXXXXXXXXXXXXGOOOOOXXXXXXXXXXXXXXGOOOXXXXXXXXXXXXXXXXGOOOOOOOOXXXXXXXXXXX,0,0,0

19740,80,0,80,31,389,0,0,394,352,42,GOOXXXXXXXXXXXXXXXXXGOOOOOXXXXXXXXXXXXXXGOOOOOOOOXXXXXXXXXXXGOOOOXXXXXXXXXXXXXXXGOOXXXXXXXXXXXXXXXXXGOOOOOXXXXXXXXXXXXXXGOOOOOOXXXXXXXXXXXXXGOOOOOOOOOXXXXXXXXXXGOOOOOOOOXXXXXXXXXXXGOOXXXXXXXXXXXXXXXXXGOOOOOXXXXXXXXXXXXXXGOOOXXXXXXXXXXXXXXXXGOOOOOOOOXXXXXXXXXXX,0,0,0
19761,80,0,80,31,389,0,0,394,351,43,GOOXXXXXXXXXXXXXXXXXGOOOOOXXXXXXXXXXXXXXGOOOOOOOOXXXXXXXXXXXGOOOOXXXXXXXXXXXXXXXGOOXXXXXXXXXXXXXXXXXGOOOOOXXXXXXXXXXXXXXGOOOOOOXXXXXXXXXXXXXGOOOOOOOOOXXXXXXXXXXGOOOOOOOOXXXXXXXXXXXGOOXXXXXXXXXXXXXXXXXGOOOOOXXXXXXXXXXXXXXGOOOXXXXXXXXXXXXXXXXGOOOOOOOOXXXXXXXXXXX,0,0,0
19782,80,0,80,31,389,0,0,394,352,42,GOOXXXXXXXXXXXXXXXXXGOOOOOXXXXXXXXXXXXXXGOOOOOOOOXXXXXXXXXXXGOOOOXXXXXXXXXXXXXXXGOOXXXXXXXXXXXXXXXXXGOOOOOXXXXXXXXXXXXXXGOOOOOOXXXXXXXXXXXXXGOOOOOOOOOXXXXXXXXXXGOOOOOOOOXXXXXXXXXXXGOOXXXXXXXXXXXXXXXXXGOOOOOXXXXXXXXXXXXXXGOOOXXXXXXXXXXXXXXXXGOOOOOOOOXXXXXXXXXXX,0,0,0
19803,80,0,80,29,391,0,0,396,349,47,GOOXXXXXXXXXXXXXXXXXGOOOOOXXXXXXXXXXXXXXGOOOOOOOOXXXXXXXXXXXGOOOOXXXXXXXXXXXXXXXGOOXXXXXXXXXXXXXXXXXGOOOOOXXXXXXXXXXXXXXGOOOOOOXXXXXXXXXXXXXGOOOOOOOOOXXXXXXXXXXGOOOOOOOOXXXXXXXXXXXGOOXXXXXXXXXXXXXXXXXGOOOOOXXXXXXXXXXXXXXGOOOXXXXXXXXXXXXXXXXGOOOOOOOOXXXXXXXXXXX,0,0,0
19824,80,0,80,23,397,0,0,402,353,49,GOOXXXXXXXXXXXXXXXXXGOOOOOXXXXXXXXXXXXXXGOOOOOOOOXXXXXXXXXXXGOOOOXXXXXXXXXXXXXXXGOOXXXXXXXXXXXXXXXXXGOOOOOXXXXXXXXXXXXXXGOOOOOOXXXXXXXXXXXXXGOOOOOOOOOXXXXXXXXXXGOOOOOOOOXXXXXXXXXXXGOOXXXXXXXXXXXXXXXXXGOOOOOXXXXXXXXXXXXXXGOOOXXXXXXXXXXXXXXXXGOOOOOOOOXXXXXXXXXXX,0,0,0

19845,81,1,80,22,397,0,0,402,351,51,GOOXXXXXXXXXXXXXXXXXGOOOOOXXXXXXXXXXXXXXGOOOOOOOOAXXXXXXXXXXGOOOOXXXXXXXXXXXXXXXGOOXXXXXXXXXXXXXXXXXGOOOOOXXXXXXXXXXXXXXGOOOOOOXXXXXXXXXXXXXGOOOOOOOOOXXXXXXXXXXGOOOOOOOOXXXXXXXXXXXGOOXXXXXXXXXXXXXXXXXGOOOOOXXXXXXXXXXXXXXGOOOXXXXXXXXXXXXXXXXGOOOOOOOOXXXXXXXXXXX,0,0,0
19866,81,1,80,24,395,0,0,399,351,48,GOOXXXXXXXXXXXXXXXXXGOOOOOXXXXXXXXXXXXXXGOOOOOOOOAXXXXXXXXXXGOOOOXXXXXXXXXXXXXXXGOOXXXXXXXXXXXXXXXXXGOOOOOXXXXXXXXXXXXXXGOOOOOOXXXXXXXXXXXXXGOOOOOOOOOXXXXXXXXXXGOOOOOOOOXXXXXXXXXXXGOOXXXXXXXXXXXXXXXXXGOOOOOXXXXXXXXXXXXXXGOOOXXXXXXXXXXXXXXXXGOOOOOOOOXXXXXXXXXXX,0,0,0
19887,81,1,80,22,397,0,0,402,351,51,GOOXXXXXXXXXXXXXXXXXGOOOOOXXXXXXXXXXXXXXGOOOOOOOOAXXXXXXXXXXGOOOOXXXXXXXXXXXXXXXGOOXXXXXXXXXXXXXXXXXGOOOOOXXXXXXXXXXXXXXGOOOOOOXXXXXXXXXXXXXGOOOOOOOOOXXXXXXXXXXGOOOOOOOOXXXXXXXXXXXGOOXXXXXXXXXXXXXXXXXGOOOOOXXXXXXXXXXXXXXGOOOXXXXXXXXXXXXXXXXGOOOOOOOOXXXXXXXXXXX,0,0,0
19908,81,1,80,21,398,0,0,402,351,51,GOOXXXXXXXXXXXXXXXXXGOOOOOXXXXXXXXXXXXXXGOOOOOOOOAXXXXXXXXXXGOOOOXXXXXXXXXXXXXXXGOOXXXXXXXXXXXXXXXXXGOOOOOXXXXXXXXXXXXXXGOOOOOOXXXXXXXXXXXXXGOOOOOOOOOXXXXXXXXXXGOOOOOOOOXXXXXXXXXXXGOOXXXXXXXXXXXXXXXXXGOOOOOXXXXXXXXXXXXXXGOOOXXXXXXXXXXXXXXXXGOOOOOOOOXXXXXXXXXXX,0,0,0
19929,81,1,80,20,399,0,0,404,352,52,GOOXXXXXXXXXXXXXXXXXGOOOOOXXXXXXXXXXXXXXGOOOOOOOOAXXXXXXXXXXGOOOOXXXXXXXXXXXXXXXGOOXXXXXXXXXXXXXXXXXGOOOOOXXXXXXXXXXXXXXGOOOOOOXXXXXXXXXXXXXGOOOOOOOOOXXXXXXXXXXGOOOOOOOOXXXXXXXXXXXGOOXXXXXXXXXXXXXXXXXGOOOOOXXXXXXXXXXXXXXGOOOXXXXXXXXXXXXXXXXGOOOOOOOOXXXXXXXXXXX,0,0,0

19950,81,1,80,20,399,0,0,404,350,54,GOOXXXXXXXXXXXXXXXXXGOOOOOXXXXXXXXXXXXXXGOOOOOOOOAXXXXXXXXXXGOOOOXXXXXXXXXXXXXXXGOOXXXXXXXXXXXXXXXXXGOOOOOXXXXXXXXXXXXXXGOOOOOOXXXXXXXXXXXXXGOOOOOOOOOXXXXXXXXXXGOOOOOOOOXXXXXXXXXXXGOOXXXXXXXXXXXXXXXXXGOOOOOXXXXXXXXXXXXXXGOOOXXXXXXXXXXXXXXXXGOOOOOOOOXXXXXXXXXXX,0,0,0
19971,81,1,80,20,399,0,0,404,351,53,GOOXXXXXXXXXXXXXXXXXGOOOOOXXXXXXXXXXXXXXGOOOOOOOOAXXXXXXXXXXGOOOOXXXXXXXXXXXXXXXGOOXXXXXXXXXXXXXXXXXGOOOOOXXXXXXXXXXXXXXGOOOOOOXXXXXXXXXXXXXGOOOOOOOOOXXXXXXXXXXGOOOOOOOOXXXXXXXXXXXGOOXXXXXXXXXXXXXXXXXGOOOOOXXXXXXXXXXXXXXGOOOXXXXXXXXXXXXXXXXGOOOOOOOOXXXXXXXXXXX,0,0,0
19992,81,1,80,20,399,0,0,404,352,52,GOOXXXXXXXXXXXXXXXXXGOOOOOXXXXXXXXXXXXXXGOOOOOOOOAXXXXXXXXXXGOOOOXXXXXXXXXXXXXXXGOOXXXXXXXXXXXXXXXXXGOOOOOXXXXXXXXXXXXXXGOOOOOOXXXXXXXXXXXXXGOOOOOOOOOXXXXXXXXXXGOOOOOOOOXXXXXXXXXXXGOOXXXXXXXXXXXXXXXXXGOOOOOXXXXXXXXXXXXXXGOOOXXXXXXXXXXXXXXXXGOOOOOOOOXXXXXXXXXXX,0,0,0
20013,81,1,80,19,400,0,0,404,353,51,GOOXXXXXXXXXXXXXXXXXGOOOOOXXXXXXXXXXXXXXGOOOOOOOOAXXXXXXXXXXGOOOOXXXXXXXXXXXXXXXGOOXXXXXXXXXXXXXXXXXGOOOOOXXXXXXXXXXXXXXGOOOOOOXXXXXXXXXXXXXGOOOOOOOOOXXXXXXXXXXGOOOOOOOOXXXXXXXXXXXGOOXXXXXXXXXXXXXXXXXGOOOOOXXXXXXXXXXXXXXGOOOXXXXXXXXXXXXXXXXGOOOOOOOOXXXXXXXXXXX,0,0,0
20034,81,1,80,18,401,0,0,406,350,56,GOOXXXXXXXXXXXXXXXXXGOOOOOXXXXXXXXXXXXXXGOOOOOOOOAXXXXXXXXXXGOOOOXXXXXXXXXXXXXXXGOOXXXXXXXXXXXXXXXXXGOOOOOXXXXXXXXXXXXXXGOOOOOOXXXXXXXXXXXXXGOOOOOOOOOXXXXXXXXXXGOOOOOOOOXXXXXXXXXXXGOOXXXXXXXXXXXXXXXXXGOOOOOXXXXXXXXXXXXXXGOOOXXXXXXXXXXXXXXXXGOOOOOOOOXXXXXXXXXXX,0,0,0

20055,81,0,81,19,400,0,0,405,351,54,GOOXXXXXXXXXXXXXXXXXGOOOOOXXXXXXXXXXXXXXGOOOOOOOOOXXXXXXXXXXGOOOOXXXXXXXXXXXXXXXGOOXXXXXXXXXXXXXXXXXGOOOOOXXXXXXXXXXXXXXGOOOOOOXXXXXXXXXXXXXGOOOOOOOOOXXXXXXXXXXGOOOOOOOOXXXXXXXXXXXGOOXXXXXXXXXXXXXXXXXGOOOOOXXXXXXXXXXXXXXGOOOXXXXXXXXXXXXXXXXGOOOOOOOOXXXXXXXXXXX,0,0,0
20076,81,0,81,16,403,0,0,408,351,57,GOOXXXXXXXXXXXXXXXXXGOOOOOXXXXXXXXXXXXXXGOOOOOOOOOXXXXXXXXXXGOOOOXXXXXXXXXXXXXXXGOOXXXXXXXXXXXXXXXXXGOOOOOXXXXXXXXXXXXXXGOOOOOOXXXXXXXXXXXXXGOOOOOOOOOXXXXXXXXXXGOOOOOOOOXXXXXXXXXXXGOOXXXXXXXXXXXXXXXXXGOOOOOXXXXXXXXXXXXXXGOOOXXXXXXXXXXXXXXXXGOOOOOOOOXXXXXXXXXXX,0,0,0
20097,81,0,81,13,406,0,0,410,352,58,GOOXXXXXXXXXXXXXXXXXGOOOOOXXXXXXXXXXXXXXGOOOOOOOOOXXXXXXXXXXGOOOOXXXXXXXXXXXXXXXGOOXXXXXXXXXXXXXXXXXGOOOOOXXXXXXXXXXXXXXGOOOOOOXXXXXXXXXXXXXGOOOOOOOOOXXXXXXXXXXGOOOOOOOOXXXXXXXXXXXGOOXXXXXXXXXXXXXXXXXGOOOOOXXXXXXXXXXXXXXGOOOXXXXXXXXXXXXXXXXGOOOOOOOOXXXXXXXXXXX,0,0,0
20118,81,0,81,17,402,0,0,407,354,53,GOOXXXXXXXXXXXXXXXXXGOOOOOXXXXXXXXXXXXXXGOOOOOOOOOXXXXXXXXXXGOOOOXXXXXXXXXXXXXXXGOOXXXXXXXXXXXXXXXXXGOOOOOXXXXXXXXXXXXXXGOOOOOOXXXXXXXXXXXXXGOOOOOOOOOXXXXXXXXXXGOOOOOOOOXXXXXXXXXXXGOOXXXXXXXXXXXXXXXXXGOOOOOXXXXXXXXXXXXXXGOOOXXXXXXXXXXXXXXXXGOOOOOOOOXXXXXXXXXXX,0,0,0
20139,81,0,81,21,398,0,0,403,353,50,GOOXXXXXXXXXXXXXXXXXGOOOOOXXXXXXXXXXXXXXGOOOOOOOOOXXXXXXXXXXGOOOOXXXXXXXXXXXXXXXGOOXXXXXXXXXXXXXXXXXGOOOOOXXXXXXXXXXXXXXGOOOOOOXXXXXXXXXXXXXGOOOOOOOOOXXXXXXXXXXGOOOOOOOOXXXXXXXXXXXGOOXXXXXXXXXXXXXXXXXGOOOOOXXXXXXXXXXXXXXGOOOXXXXXXXXXXXXXXXXGOOOOOOOOXXXXXXXXXXX,0,0,0

20160,81,0,81,22,397,0,0,402,354,48,GOOXXXXXXXXXXXXXXXXXGOOOOOXXXXXXXXXXXXXXGOOOOOOOOOXXXXXXXXXXGOOOOXXXXXXXXXXXXXXXGOOXXXXXXXXXXXXXXXXXGOOOOOXXXXXXXXXXXXXXGOOOOOOXXXXXXXXXXXXXGOOOOOOOOOXXXXXXXXXXGOOOOOOOOXXXXXXXXXXXGOOXXXXXXXXXXXXXXXXXGOOOOOXXXXXXXXXXXXXXGOOOXXXXXXXXXXXXXXXXGOOOOOOOOXXXXXXXXXXX,0,0,0
20181,81,0,81,21,398,0,0,402,359,43,GOOXXXXXXXXXXXXXXXXXGOOOOOXXXXXXXXXXXXXXGOOOOOOOOOXXXXXXXXXXGOOOOXXXXXXXXXXXXXXXGOOXXXXXXXXXXXXXXXXXGOOOOOXXXXXXXXXXXXXXGOOOOOOXXXXXXXXXXXXXGOOOOOOOOOXXXXXXXXXXGOOOOOOOOXXXXXXXXXXXGOOXXXXXXXXXXXXXXXXXGOOOOOXXXXXXXXXXXXXXGOOOXXXXXXXXXXXXXXXXGOOOOOOOOXXXXXXXXXXX,0,0,0
20202,81,0,81,24,395,0,0,400,356,44,GOOXXXXXXXXXXXXXXXXXGOOOOOXXXXXXXXXXXXXXGOOOOOOOOOXXXXXXXXXXGOOOOXXXXXXXXXXXXXXXGOOXXXXXXXXXXXXXXXXXGOOOOOXXXXXXXXXXXXXXGOOOOOOXXXXXXXXXXXXXGOOOOOOOOOXXXXXXXXXXGOOOOOOOOXXXXXXXXXXXGOOXXXXXXXXXXXXXXXXXGOOOOOXXXXXXXXXXXXXXGOOOXXXXXXXXXXXXXXXXGOOOOOOOOXXXXXXXXXXX,0,0,0
20223,81,0,81,26,393,0,0,398,355,43,GOOXXXXXXXXXXXXXXXXXGOOOOOXXXXXXXXXXXXXXGOOOOOOOOOXXXXXXXXXXGOOOOXXXXXXXXXXXXXXXGOOXXXXXXXXXXXXXXXXXGOOOOOXXXXXXXXXXXXXXGOOOOOOXXXXXXXXXXXXXGOOOOOOOOOXXXXXXXXXXGOOOOOOOOXXXXXXXXXXXGOOXXXXXXXXXXXXXXXXXGOOOOOXXXXXXXXXXXXXXGOOOXXXXXXXXXXXXXXXXGOOOOOOOOXXXXXXXXXXX,0,0,0
20244,81,0,81,22,397,0,0,401,357,44,GOOXXXXXXXXXXXXXXXXXGOOOOOXXXXXXXXXXXXXXGOOOOOOOOOXXXXXXXXXXGOOOOXXXXXXXXXXXXXXXGOOXXXXXXXXXXXXXXXXXGOOOOOXXXXXXXXXXXXXXGOOOOOOXXXXXXXXXXXXXGOOOOOOOOOXXXXXXXXXXGOOOOOOOOXXXXXXXXXXXGOOXXXXXXXXXXXXXXXXXGOOOOOXXXXXXXXXXXXXXGOOOXXXXXXXXXXXXXXXXGOOOOOOOOXXXXXXXXXXX,0,0,0

20265,81,0,81,24,395,0,0,400,355,45,GOOXXXXXXXXXXXXXXXXXGOOOOOXXXXXXXXXXXXXXGOOOOOOOOOXXXXXXXXXXGOOOOXXXXXXXXXXXXXXXGOOXXXXXXXXXXXXXXXXXGOOOOOXXXXXXXXXXXXXXGOOOOOOXXXXXXXXXXXXXGOOOOOOOOOXXXXXXXXXXGOOOOOOOOXXXXXXXXXXXGOOXXXXXXXXXXXXXXXXXGOOOOOXXXXXXXXXXXXXXGOOOXXXXXXXXXXXXXXXXGOOOOOOOOXXXXXXXXXXX,0,0,0
20286,81,0,81,26,393,0,0,398,359,39,GOOXXXXXXXXXXXXXXXXXGOOOOOXXXXXXXXXXXXXXGOOOOOOOOOXXXXXXXXXXGOOOOXXXXXXXXXXXXXXXGOOXXXXXXXXXXXXXXXXXGOOOOOXXXXXXXXXXXXXXGOOOOOOXXXXXXXXXXXXXGOOOOOOOOOXXXXXXXXXXGOOOOOOOOXXXXXXXXXXXGOOXXXXXXXXXXXXXXXXXGOOOOOXXXXXXXXXXXXXXGOOOXXXXXXXXXXXXXXXXGOOOOOOOOXXXXXXXXXXX,0,0,0
20307,81,0,81,29,390,0,0,395,356,39,GOOXXXXXXXXXXXXXXXXXGOOOOOXXXXXXXXXXXXXXGOOOOOOOOOXXXXXXXXXXGOOOOXXXXXXXXXXXXXXXGOOXXXXXXXXXXXXXXXXXGOOOOOXXXXXXXXXXXXXXGOOOOOOXXXXXXXXXXXXXGOOOOOOOOOXXXXXXXXXXGOOOOOOOOXXXXXXXXXXXGOOXXXXXXXXXXXXXXXXXGOOOOOXXXXXXXXXXXXXXGOOOXXXXXXXXXXXXXXXXGOOOOOOOOXXXXXXXXXXX,0,0,0
20328,81,0,81,31,388,0,0,393,355,38,GOOXXXXXXXXXXXXXXXXXGOOOOOXXXXXXXXXXXXXXGOOOOOOOOOXXXXXXXXXXGOOOOXXXXXXXXXXXXXXXGOOXXXXXXXXXXXXXXXXXGOOOOOXXXXXXXXXXXXXXGOOOOOOXXXXXXXXXXXXXGOOOOOOOOOXXXXXXXXXXGOOOOOOOOXXXXXXXXXXXGOOXXXXXXXXXXXXXXXXXGOOOOOXXXXXXXXXXXXXXGOOOXXXXXXXXXXXXXXXXGOOOOOOOOXXXXXXXXXXX,0,0,0
20349,81,0,81,31,388,0,0,393,354,39,GOOXXXXXXXXXXXXXXXXXGOOOOOXXXXXXXXXXXXXXGOOOOOOOOOXXXXXXXXXXGOOOOXXXXXXXXXXXXXXXGOOXXXXXXXXXXXXXXXXXGOOOOOXXXXXXXXXXXXXXGOOOOOOXXXXXXXXXXXXXGOOOOOOOOOXXXXXXXXXXGOOOOOOOOXXXXXXXXXXXGOOXXXXXXXXXXXXXXXXXGOOOOOXXXXXXXXXXXXXXGOOOXXXXXXXXXXXXXXXXGOOOOOOOOXXXXXXXXXXX,0,0,0

20370,81,0,81,28,391,0,0,395,355,40,GOOXXXXXXXXXXXXXXXXXGOOOOOXXXXXXXXXXXXXXGOOOOOOOOOXXXXXXXXXXGOOOOXXXXXXXXXXXXXXXGOOXXXXXXXXXXXXXXXXXGOOOOOXXXXXXXXXXXXXXGOOOOOOXXXXXXXXXXXXXGOOOOOOOOOXXXXXXXXXXGOOOOOOOOXXXXXXXXXXXGOOXXXXXXXXXXXXXXXXXGOOOOOXXXXXXXXXXXXXXGOOOXXXXXXXXXXXXXXXXGOOOOOOOOXXXXXXXXXXX,0,0,0
20391,81,0,81,26,393,0,0,398,356,42,GOOXXXXXXXXXXXXXXXXXGOOOOOXXXXXXXXXXXXXXGOOOOOOOOOXXXXXXXXXXGOOOOXXXXXXXXXXXXXXXGOOXXXXXXXXXXXXXXXXXGOOOOOXXXXXXXXXXXXXXGOOOOOOXXXXXXXXXXXXXGOOOOOOOOOXXXXXXXXXXGOOOOOOOOXXXXXXXXXXXGOOXXXXXXXXXXXXXXXXXGOOOOOXXXXXXXXXXXXXXGOOOXXXXXXXXXXXXXXXXGOOOOOOOOXXXXXXXXXXX,0,0,0
20412,81,0,81,30,389,0,0,394,355,39,GOOXXXXXXXXXXXXXXXXXGOOOOOXXXXXXXXXXXXXXGOOOOOOOOOXXXXXXXXXXGOOOOXXXXXXXXXXXXXXXGOOXXXXXXXXXXXXXXXXXGOOOOOXXXXXXXXXXXXXXGOOOOOOXXXXXXXXXXXXXGOOOOOOOOOXXXXXXXXXXGOOOOOOOOXXXXXXXXXXXGOOXXXXXXXXXXXXXXXXXGOOOOOXXXXXXXXXXXXXXGOOOXXXXXXXXXXXXXXXXGOOOOOOOOXXXXXXXXXXX,0,0,0
20433,81,0,81,28,391,0,0,396,355,41,GOOXXXXXXXXXXXXXXXXXGOOOOOXXXXXXXXXXXXXXGOOOOOOOOOXXXXXXXXXXGOOOOXXXXXXXXXXXXXXXGOOXXXXXXXXXXXXXXXXXGOOOOOXXXXXXXXXXXXXXGOOOOOOXXXXXXXXXXXXXGOOOOOOOOOXXXXXXXXXXGOOOOOOOOXXXXXXXXXXXGOOXXXXXXXXXXXXXXXXXGOOOOOXXXXXXXXXXXXXXGOOOXXXXXXXXXXXXXXXXGOOOOOOOOXXXXXXXXXXX,0,0,0
20454,81,0,81,26,393,0,0,398,356,42,GOOXXXXXXXXXXXXXXXXXGOOOOOXXXXXXXXXXXXXXGOOOOOOOOOXXXXXXXXXXGOOOOXXXXXXXXXXXXXXXGOOXXXXXXXXXXXXXXXXXGOOOOOXXXXXXXXXXXXXXGOOOOOOXXXXXXXXXXXXXGOOOOOOOOOXXXXXXXXXXGOOOOOOOOXXXXXXXXXXXGOOXXXXXXXXXXXXXXXXXGOOOOOXXXXXXXXXXXXXXGOOOXXXXXXXXXXXXXXXXGOOOOOOOOXXXXXXXXXXX,0,0,0

20475,81,0,81,28,391,0,0,397,356,41,GOOXXXXXXXXXXXXXXXXXGOOOOOXXXXXXXXXXXXXXGOOOOOOOOOXXXXXXXXXXGOOOOXXXXXXXXXXXXXXXGOOXXXXXXXXXXXXXXXXXGOOOOOXXXXXXXXXXXXXXGOOOOOOXXXXXXXXXXXXXGOOOOOOOOOXXXXXXXXXXGOOOOOOOOXXXXXXXXXXXGOOXXXXXXXXXXXXXXXXXGOOOOOXXXXXXXXXXXXXXGOOOXXXXXXXXXXXXXXXXGOOOOOOOOXXXXXXXXXXX,0,0,0
20496,81,0,81,28,391,0,0,396,356,40,GOOXXXXXXXXXXXXXXXXXGOOOOOXXXXXXXXXXXXXXGOOOOOOOOOXXXXXXXXXXGOOOOXXXXXXXXXXXXXXXGOOXXXXXXXXXXXXXXXXXGOOOOOXXXXXXXXXXXXXXGOOOOOOXXXXXXXXXXXXXGOOOOOOOOOXXXXXXXXXXGOOOOOOOOXXXXXXXXXXXGOOXXXXXXXXXXXXXXXXXGOOOOOXXXXXXXXXXXXXXGOOOXXXXXXXXXXXXXXXXGOOOOOOOOXXXXXXXXXXX,0,0,0
20517,81,0,81,28,391,0,0,397,354,43,GOOXXXXXXXXXXXXXXXXXGOOOOOXXXXXXXXXXXXXXGOOOOOOOOOXXXXXXXXXXGOOOOXXXXXXXXXXXXXXXGOOXXXXXXXXXXXXXXXXXGOOOOOXXXXXXXXXXXXXXGOOOOOOXXXXXXXXXXXXXGOOOOOOOOOXXXXXXXXXXGOOOOOOOOXXXXXXXXXXXGOOXXXXXXXXXXXXXXXXXGOOOOOXXXXXXXXXXXXXXGOOOXXXXXXXXXXXXXXXXGOOOOOOOOXXXXXXXXXXX,0,0,0
20538,81,0,81,29,390,0,0,396,354,42,GOOXXXXXXXXXXXXXXXXXGOOOOOXXXXXXXXXXXXXXGOOOOOOOOOXXXXXXXXXXGOOOOXXXXXXXXXXXXXXXGOOXXXXXXXXXXXXXXXXXGOOOOOXXXXXXXXXXXXXXGOOOOOOXXXXXXXXXXXXXGOOOOOOOOOXXXXXXXXXXGOOOOOOOOXXXXXXXXXXXGOOXXXXXXXXXXXXXXXXXGOOOOOXXXXXXXXXXXXXXGOOOXXXXXXXXXXXXXXXXGOOOOOOOOXXXXXXXXXXX,0,0,0
20559,81,0,81,25,394,0,0,400,356,44,GOOXXXXXXXXXXXXXXXXXGOOOOOXXXXXXXXXXXXXXGOOOOOOOOOXXXXXXXXXXGOOOOXXXXXXXXXXXXXXXGOOXXXXXXXXXXXXXXXXXGOOOOOXXXXXXXXXXXXXXGOOOOOOXXXXXXXXXXXXXGOOOOOOOOOXXXXXXXXXXGOOOOOOOOXXXXXXXXXXXGOOXXXXXXXXXXXXXXXXXGOOOOOXXXXXXXXXXXXXXGOOOXXXXXXXXXXXXXXXXGOOOOOOOOXXXXXXXXXXX,0,0,0

20580,81,0,81,23,396,0,0,401,355,46,GOOXXXXXXXXXXXXXXXXXGOOOOOXXXXXXXXXXXXXXGOOOOOOOOOXXXXXXXXXXGOOOOXXXXXXXXXXXXXXXGOOXXXXXXXXXXXXXXXXXGOOOOOXXXXXXXXXXXXXXGOOOOOOXXXXXXXXXXXXXGOOOOOOOOOXXXXXXXXXXGOOOOOOOOXXXXXXXXXXXGOOXXXXXXXXXXXXXXXXXGOOOOOXXXXXXXXXXXXXXGOOOXXXXXXXXXXXXXXXXGOOOOOOOOXXXXXXXXXXX,0,0,0
20601,81,0,81,22,397,0,0,403,355,48,GOOXXXXXXXXXXXXXXXXXGOOOOOXXXXXXXXXXXXXXGOOOOOOOOOXXXXXXXXXXGOOOOXXXXXXXXXXXXXXXGOOXXXXXXXXXXXXXXXXXGOOOOOXXXXXXXXXXXXXXGOOOOOOXXXXXXXXXXXXXGOOOOOOOOOXXXXXXXXXXGOOOOOOOOXXXXXXXXXXXGOOXXXXXXXXXXXXXXXXXGOOOOOXXXXXXXXXXXXXXGOOOXXXXXXXXXXXXXXXXGOOOOOOOOXXXXXXXXXXX,0,0,0
20622,81,0,81,21,398,0,0,404,353,51,GOOXXXXXXXXXXXXXXXXXGOOOOOXXXXXXXXXXXXXXGOOOOOOOOOXXXXXXXXXXGOOOOXXXXXXXXXXXXXXXGOOXXXXXXXXXXXXXXXXXGOOOOOXXXXXXXXXXXXXXGOOOOOOXXXXXXXXXXXXXGOOOOOOOOOXXXXXXXXXXGOOOOOOOOXXXXXXXXXXXGOOXXXXXXXXXXXXXXXXXGOOOOOXXXXXXXXXXXXXXGOOOXXXXXXXXXXXXXXXXGOOOOOOOOXXXXXXXXXXX,0,0,0
20643,81,0,81,20,399,0,0,406,356,50,GOOXXXXXXXXXXXXXXXXXGOOOOOXXXXXXXXXXXXXXGOOOOOOOOOXXXXXXXXXXGOOOOXXXXXXXXXXXXXXXGOOXXXXXXXXXXXXXXXXXGOOOOOXXXXXXXXXXXXXXGOOOOOOXXXXXXXXXXXXXGOOOOOOOOOXXXXXXXXXXGOOOOOOOOXXXXXXXXXXXGOOXXXXXXXXXXXXXXXXXGOOOOOXXXXXXXXXXXXXXGOOOXXXXXXXXXXXXXXXXGOOOOOOOOXXXXXXXXXXX,0,0,0
20664,81,0,81,21,398,0,0,406,356,50,GOOXXXXXXXXXXXXXXXXXGOOOOOXXXXXXXXXXXXXXGOOOOOOOOOXXXXXXXXXXGOOOOXXXXXXXXXXXXXXXGOOXXXXXXXXXXXXXXXXXGOOOOOXXXXXXXXXXXXXXGOOOOOOXXXXXXXXXXXXXGOOOOOOOOOXXXXXXXXXXGOOOOOOOOXXXXXXXXXXXGOOXXXXXXXXXXXXXXXXXGOOOOOXXXXXXXXXXXXXXGOOOXXXXXXXXXXXXXXXXGOOOOOOOOXXXXXXXXXXX,0,0,0

20685,81,0,81,19,400,0,0,408,355,53,GOOXXXXXXXXXXXXXXXXXGOOOOOXXXXXXXXXXXXXXGOOOOOOOOOXXXXXXXXXXGOOOOXXXXXXXXXXXXXXXGOOXXXXXXXXXXXXXXXXXGOOOOOXXXXXXXXXXXXXXGOOOOOOXXXXXXXXXXXXXGOOOOOOOOOXXXXXXXXXXGOOOOOOOOXXXXXXXXXXXGOOXXXXXXXXXXXXXXXXXGOOOOOXXXXXXXXXXXXXXGOOOXXXXXXXXXXXXXXXXGOOOOOOOOXXXXXXXXXXX,0,0,0
20706,81,0,81,20,399,0,0,405,357,48,GOOXXXXXXXXXXXXXXXXXGOOOOOXXXXXXXXXXXXXXGOOOOOOOOOXXXXXXXXXXGOOOOXXXXXXXXXXXXXXXGOOXXXXXXXXXXXXXXXXXGOOOOOXXXXXXXXXXXXXXGOOOOOOXXXXXXXXXXXXXGOOOOOOOOOXXXXXXXXXXGOOOOOOOOXXXXXXXXXXXGOOXXXXXXXXXXXXXXXXXGOOOOOXXXXXXXXXXXXXXGOOOXXXXXXXXXXXXXXXXGOOOOOOOOXXXXXXXXXXX,0,0,0
20727,81,0,81,18,401,0,0,407,355,52,GOOXXXXXXXXXXXXXXXXXGOOOOOXXXXXXXXXXXXXXGOOOOOOOOOXXXXXXXXXXGOOOOXXXXXXXXXXXXXXXGOOXXXXXXXXXXXXXXXXXGOOOOOXXXXXXXXXXXXXXGOOOOOOXXXXXXXXXXXXXGOOOOOOOOOXXXXXXXXXXGOOOOOOOOXXXXXXXXXXXGOOXXXXXXXXXXXXXXXXXGOOOOOXXXXXXXXXXXXXXGOOOXXXXXXXXXXXXXXXXGOOOOOOOOXXXXXXXXXXX,0,0,0
20748,81,0,81,19,400,0,0,406,355,51,GOOXXXXXXXXXXXXXXXXXGOOOOOXXXXXXXXXXXXXXGOOOOOOOOOXXXXXXXXXXGOOOOXXXXXXXXXXXXXXXGOOXXXXXXXXXXXXXXXXXGOOOOOXXXXXXXXXXXXXXGOOOOOOXXXXXXXXXXXXXGOOOOOOOOOXXXXXXXXXXGOOOOOOOOXXXXXXXXXXXGOOXXXXXXXXXXXXXXXXXGOOOOOXXXXXXXXXXXXXXGOOOXXXXXXXXXXXXXXXXGOOOOOOOOXXXXXXXXXXX,0,0,0
20769,81,0,81,18,401,0,0,407,357,50,GOOXXXXXXXXXXXXXXXXXGOOOOOXXXXXXXXXXXXXXGOOOOOOOOOXXXXXXXXXXGOOOOXXXXXXXXXXXXXXXGOOXXXXXXXXXXXXXXXXXGOOOOOXXXXXXXXXXXXXXGOOOOOOXXXXXXXXXXXXXGOOOOOOOOOXXXXXXXXXXGOOOOOOOOXXXXXXXXXXXGOOXXXXXXXXXXXXXXXXXGOOOOOXXXXXXXXXXXXXXGOOOXXXXXXXXXXXXXXXXGOOOOOOOOXXXXXXXXXXX,0,0,0

20790,81,0,81,21,398,0,0,404,360,44,GOOXXXXXXXXXXXXXXXXXGOOOOOXXXXXXXXXXXXXXGOOOOOOOOOXXXXXXXXXXGOOOOXXXXXXXXXXXXXXXGOOXXXXXXXXXXXXXXXXXGOOOOOXXXXXXXXXXXXXXGOOOOOOXXXXXXXXXXXXXGOOOOOOOOOXXXXXXXXXXGOOOOOOOOXXXXXXXXXXXGOOXXXXXXXXXXXXXXXXXGOOOOOXXXXXXXXXXXXXXGOOOXXXXXXXXXXXXXXXXGOOOOOOOOXXXXXXXXXXX,0,0,0
20811,81,0,81,23,396,0,0,402,358,44,GOOXXXXXXXXXXXXXXXXXGOOOOOXXXXXXXXXXXXXXGOOOOOOOOOXXXXXXXXXXGOOOOXXXXXXXXXXXXXXXGOOXXXXXXXXXXXXXXXXXGOOOOOXXXXXXXXXXXXXXGOOOOOOXXXXXXXXXXXXXGOOOOOOOOOXXXXXXXXXXGOOOOOOOOXXXXXXXXXXXGOOXXXXXXXXXXXXXXXXXGOOOOOXXXXXXXXXXXXXXGOOOXXXXXXXXXXXXXXXXGOOOOOOOOXXXXXXXXXXX,0,0,0
20832,81,0,81,25,394,0,0,401,357,44,GOOXXXXXXXXXXXXXXXXXGOOOOOXXXXXXXXXXXXXXGOOOOOOOOOXXXXXXXXXXGOOOOXXXXXXXXXXXXXXXGOOXXXXXXXXXXXXXXXXXGOOOOOXXXXXXXXXXXXXXGOOOOOOXXXXXXXXXXXXXGOOOOOOOOOXXXXXXXXXXGOOOOOOOOXXXXXXXXXXXGOOXXXXXXXXXXXXXXXXXGOOOOOXXXXXXXXXXXXXXGOOOXXXXXXXXXXXXXXXXGOOOOOOOOXXXXXXXXXXX,0,0,0
20853,81,0,81,22,397,0,0,402,358,44,GOOXXXXXXXXXXXXXXXXXGOOOOOXXXXXXXXXXXXXXGOOOOOOOOOXXXXXXXXXXGOOOOXXXXXXXXXXXXXXXGOOXXXXXXXXXXXXXXXXXGOOOOOXXXXXXXXXXXXXXGOOOOOOXXXXXXXXXXXXXGOOOOOOOOOXXXXXXXXXXGOOOOOOOOXXXXXXXXXXXGOOXXXXXXXXXXXXXXXXXGOOOOOXXXXXXXXXXXXXXGOOOXXXXXXXXXXXXXXXXGOOOOOOOOXXXXXXXXXXX,0,0,0
20874,81,0,81,22,397,0,0,404,356,48,GOOXXXXXXXXXXXXXXXXXGOOOOOXXXXXXXXXXXXXXGOOOOOOOOOXXXXXXXXXXGOOOOXXXXXXXXXXXXXXXGOOXXXXXXXXXXXXXXXXXGOOOOOXXXXXXXXXXXXXXGOOOOOOXXXXXXXXXXXXXGOOOOOOOOOXXXXXXXXXXGOOOOOOOOXXXXXXXXXXXGOOXXXXXXXXXXXXXXXXXGOOOOOXXXXXXXXXXXXXXGOOOXXXXXXXXXXXXXXXXGOOOOOOOOXXXXXXXXXXX,0,0,0

20895,81,0,81,23,396,0,0,403,356,47,GOOXXXXXXXXXXXXXXXXXGOOOOOXXXXXXXXXXXXXXGOOOOOOOOOXXXXXXXXXXGOOOOXXXXXXXXXXXXXXXGOOXXXXXXXXXXXXXXXXXGOOOOOXXXXXXXXXXXXXXGOOOOOOXXXXXXXXXXXXXGOOOOOOOOOXXXXXXXXXXGOOOOOOOOXXXXXXXXXXXGOOXXXXXXXXXXXXXXXXXGOOOOOXXXXXXXXXXXXXXGOOOXXXXXXXXXXXXXXXXGOOOOOOOOXXXXXXXXXXX,0,0,0
20916,81,0,81,26,393,0,0,400,358,42,GOOXXXXXXXXXXXXXXXXXGOOOOOXXXXXXXXXXXXXXGOOOOOOOOOXXXXXXXXXXGOOOOXXXXXXXXXXXXXXXGOOXXXXXXXXXXXXXXXXXGOOOOOXXXXXXXXXXXXXXGOOOOOOXXXXXXXXXXXXXGOOOOOOOOOXXXXXXXXXXGOOOOOOOOXXXXXXXXXXXGOOXXXXXXXXXXXXXXXXXGOOOOOXXXXXXXXXXXXXXGOOOXXXXXXXXXXXXXXXXGOOOOOOOOXXXXXXXXXXX,0,0,0
20937,81,0,81,26,393,0,0,400,358,42,GOOXXXXXXXXXXXXXXXXXGOOOOOXXXXXXXXXXXXXXGOOOOOOOOOXXXXXXXXXXGOOOOXXXXXXXXXXXXXXXGOOXXXXXXXXXXXXXXXXXGOOOOOXXXXXXXXXXXXXXGOOOOOOXXXXXXXXXXXXXGOOOOOOOOOXXXXXXXXXXGOOOOOOOOXXXXXXXXXXXGOOXXXXXXXXXXXXXXXXXGOOOOOXXXXXXXXXXXXXXGOOOXXXXXXXXXXXXXXXXGOOOOOOOOXXXXXXXXXXX,0,0,0
20958,81,0,81,24,395,0,0,402,359,43,GOOXXXXXXXXXXXXXXXXXGOOOOOXXXXXXXXXXXXXXGOOOOOOOOOXXXXXXXXXXGOOOOXXXXXXXXXXXXXXXGOOXXXXXXXXXXXXXXXXXGOOOOOXXXXXXXXXXXXXXGOOOOOOXXXXXXXXXXXXXGOOOOOOOOOXXXXXXXXXXGOOOOOOOOXXXXXXXXXXXGOOXXXXXXXXXXXXXXXXXGOOOOOXXXXXXXXXXXXXXGOOOXXXXXXXXXXXXXXXXGOOOOOOOOXXXXXXXXXXX,0,0,0
20979,81,0,81,26,393,0,0,400,356,44,GOOXXXXXXXXXXXXXXXXXGOOOOOXXXXXXXXXXXXXXGOOOOOOOOOXXXXXXXXXXGOOOOXXXXXXXXXXXXXXXGOOXXXXXXXXXXXXXXXXXGOOOOOXXXXXXXXXXXXXXGOOOOOOXXXXXXXXXXXXXGOOOOOOOOOXXXXXXXXXXGOOOOOOOOXXXXXXXXXXXGOOXXXXXXXXXXXXXXXXXGOOOOOXXXXXXXXXXXXXXGOOOXXXXXXXXXXXXXXXXGOOOOOOOOXXXXXXXXXXX,0,0,0

21000,81,0,81,27,392,0,0,399,355,44,GOOXXXXXXXXXXXXXXXXXGOOOOOXXXXXXXXXXXXXXGOOOOOOOOOXXXXXXXXXXGOOOOXXXXXXXXXXXXXXXGOOXXXXXXXXXXXXXXXXXGOOOOOXXXXXXXXXXXXXXGOOOOOOXXXXXXXXXXXXXGOOOOOOOOOXXXXXXXXXXGOOOOOOOOXXXXXXXXXXXGOOXXXXXXXXXXXXXXXXXGOOOOOXXXXXXXXXXXXXXGOOOXXXXXXXXXXXXXXXXGOOOOOOOOXXXXXXXXXXX,0,0,0
21021,81,0,81,25,394,0,0,401,357,44,GOOXXXXXXXXXXXXXXXXXGOOOOOXXXXXXXXXXXXXXGOOOOOOOOOXXXXXXXXXXGOOOOXXXXXXXXXXXXXXXGOOXXXXXXXXXXXXXXXXXGOOOOOXXXXXXXXXXXXXXGOOOOOOXXXXXXXXXXXXXGOOOOOOOOOXXXXXXXXXXGOOOOOOOOXXXXXXXXXXXGOOXXXXXXXXXXXXXXXXXGOOOOOXXXXXXXXXXXXXXGOOOXXXXXXXXXXXXXXXXGOOOOOOOOXXXXXXXXXXX,0,0,0
21042,81,0,81,20,399,0,0,406,358,48,GOOXXXXXXXXXXXXXXXXXGOOOOOXXXXXXXXXXXXXXGOOOOOOOOOXXXXXXXXXXGOOOOXXXXXXXXXXXXXXXGOOXXXXXXXXXXXXXXXXXGOOOOOXXXXXXXXXXXXXXGOOOOOOXXXXXXXXXXXXXGOOOOOOOOOXXXXXXXXXXGOOOOOOOOXXXXXXXXXXXGOOXXXXXXXXXXXXXXXXXGOOOOOXXXXXXXXXXXXXXGOOOXXXXXXXXXXXXXXXXGOOOOOOOOXXXXXXXXXXX,0,0,0
21063,81,0,81,25,394,0,0,401,356,45,GOOXXXXXXXXXXXXXXXXXGOOOOOXXXXXXXXXXXXXXGOOOOOOOOOXXXXXXXXXXGOOOOXXXXXXXXXXXXXXXGOOXXXXXXXXXXXXXXXXXGOOOOOXXXXXXXXXXXXXXGOOOOOOXXXXXXXXXXXXXGOOOOOOOOOXXXXXXXXXXGOOOOOOOOXXXXXXXXXXXGOOXXXXXXXXXXXXXXXXXGOOOOOXXXXXXXXXXXXXXGOOOXXXXXXXXXXXXXXXXGOOOOOOOOXXXXXXXXXXX,0,0,0
21084,81,0,81,22,397,0,0,404,358,46,GOOXXXXXXXXXXXXXXXXXGOOOOOXXXXXXXXXXXXXXGOOOOOOOOOXXXXXXXXXXGOOOOXXXXXXXXXXXXXXXGOOXXXXXXXXXXXXXXXXXGOOOOOXXXXXXXXXXXXXXGOOOOOOXXXXXXXXXXXXXGOOOOOOOOOXXXXXXXXXXGOOOOOOOOXXXXXXXXXXXGOOXXXXXXXXXXXXXXXXXGOOOOOXXXXXXXXXXXXXXGOOOXXXXXXXXXXXXXXXXGOOOOOOOOXXXXXXXXXXX,0,0,0

21105,81,0,81,22,397,0,0,403,358,45,GOOXXXXXXXXXXXXXXXXXGOOOOOXXXXXXXXXXXXXXGOOOOOOOOOXXXXXXXXXXGOOOOXXXXXXXXXXXXXXXGOOXXXXXXXXXXXXXXXXXGOOOOOXXXXXXXXXXXXXXGOOOOOOXXXXXXXXXXXXXGOOOOOOOOOXXXXXXXXXXGOOOOOOOOXXXXXXXXXXXGOOXXXXXXXXXXXXXXXXXGOOOOOXXXXXXXXXXXXXXGOOOXXXXXXXXXXXXXXXXGOOOOOOOOXXXXXXXXXXX,0,0,0
21126,81,0,81,23,396,0,0,402,356,46,GOOXXXXXXXXXXXXXXXXXGOOOOOXXXXXXXXXXXXXXGOOOOOOOOOXXXXXXXXXXGOOOOXXXXXXXXXXXXXXXGOOXXXXXXXXXXXXXXXXXGOOOOOXXXXXXXXXXXXXXGOOOOOOXXXXXXXXXXXXXGOOOOOOOOOXXXXXXXXXXGOOOOOOOOXXXXXXXXXXXGOOXXXXXXXXXXXXXXXXXGOOOOOXXXXXXXXXXXXXXGOOOXXXXXXXXXXXXXXXXGOOOOOOOOXXXXXXXXXXX,0,0,0
21147,81,0,81,22,397,0,0,403,361,42,GOOXXXXXXXXXXXXXXXXXGOOOOOXXXXXXXXXXXXXXGOOOOOOOOOXXXXXXXXXXGOOOOXXXXXXXXXXXXXXXGOOXXXXXXXXXXXXXXXXXGOOOOOXXXXXXXXXXXXXXGOOOOOOXXXXXXXXXXXXXGOOOOOOOOOXXXXXXXXXXGOOOOOOOOXXXXXXXXXXXGOOXXXXXXXXXXXXXXXXXGOOOOOXXXXXXXXXXXXXXGOOOXXXXXXXXXXXXXXXXGOOOOOOOOXXXXXXXXXXX,0,0,0
21168,81,0,81,25,394,0,0,400,358,42,GOOXXXXXXXXXXXXXXXXXGOOOOOXXXXXXXXXXXXXXGOOOOOOOOOXXXXXXXXXXGOOOOXXXXXXXXXXXXXXXGOOXXXXXXXXXXXXXXXXXGOOOOOXXXXXXXXXXXXXXGOOOOOOXXXXXXXXXXXXXGOOOOOOOOOXXXXXXXXXXGOOOOOOOOXXXXXXXXXXXGOOXXXXXXXXXXXXXXXXXGOOOOOXXXXXXXXXXXXXXGOOOXXXXXXXXXXXXXXXXGOOOOOOOOXXXXXXXXXXX,0,0,0
21189,81,0,81,25,394,0,0,400,357,43,GOOXXXXXXXXXXXXXXXXXGOOOOOXXXXXXXXXXXXXXGOOOOOOOOOXXXXXXXXXXGOOOOXXXXXXXXXXXXXXXGOOXXXXXXXXXXXXXXXXXGOOOOOXXXXXXXXXXXXXXGOOOOOOXXXXXXXXXXXXXGOOOOOOOOOXXXXXXXXXXGOOOOOOOOXXXXXXXXXXXGOOXXXXXXXXXXXXXXXXXGOOOOOXXXXXXXXXXXXXXGOOOXXXXXXXXXXXXXXXXGOOOOOOOOXXXXXXXXXXX,0,0,0

21210,81,0,81,24,395,0,0,401,357,44,GOOXXXXXXXXXXXXXXXXXGOOOOOXXXXXXXXXXXXXXGOOOOOOOOOXXXXXXXXXXGOOOOXXXXXXXXXXXXXXXGOOXXXXXXXXXXXXXXXXXGOOOOOXXXXXXXXXXXXXXGOOOOOOXXXXXXXXXXXXXGOOOOOOOOOXXXXXXXXXXGOOOOOOOOXXXXXXXXXXXGOOXXXXXXXXXXXXXXXXXGOOOOOXXXXXXXXXXXXXXGOOOXXXXXXXXXXXXXXXXGOOOOOOOOXXXXXXXXXXX,0,0,0
21231,81,0,81,23,396,0,0,402,358,44,GOOXXXXXXXXXXXXXXXXXGOOOOOXXXXXXXXXXXXXXGOOOOOOOOOXXXXXXXXXXGOOOOXXXXXXXXXXXXXXXGOOXXXXXXXXXXXXXXXXXGOOOOOXXXXXXXXXXXXXXGOOOOOOXXXXXXXXXXXXXGOOOOOOOOOXXXXXXXXXXGOOOOOOOOXXXXXXXXXXXGOOXXXXXXXXXXXXXXXXXGOOOOOXXXXXXXXXXXXXXGOOOXXXXXXXXXXXXXXXXGOOOOOOOOXXXXXXXXXXX,0,0,0
21252,81,0,81,23,396,0,0,402,356,46,GOOXXXXXXXXXXXXXXXXXGOOOOOXXXXXXXXXXXXXXGOOOOOOOOOXXXXXXXXXXGOOOOXXXXXXXXXXXXXXXGOOXXXXXXXXXXXXXXXXXGOOOOOXXXXXXXXXXXXXXGOOOOOOXXXXXXXXXXXXXGOOOOOOOOOXXXXXXXXXXGOOOOOOOOXXXXXXXXXXXGOOXXXXXXXXXXXXXXXXXGOOOOOXXXXXXXXXXXXXXGOOOXXXXXXXXXXXXXXXXGOOOOOOOOXXXXXXXXXXX,0,0,0
21273,81,0,81,21,398,0,0,404,360,44,GOOXXXXXXXXXXXXXXXXXGOOOOOXXXXXXXXXXXXXXGOOOOOOOOOXXXXXXXXXXGOOOOXXXXXXXXXXXXXXXGOOXXXXXXXXXXXXXXXXXGOOOOOXXXXXXXXXXXXXXGOOOOOOXXXXXXXXXXXXXGOOOOOOOOOXXXXXXXXXXGOOOOOOOOXXXXXXXXXXXGOOXXXXXXXXXXXXXXXXXGOOOOOXXXXXXXXXXXXXXGOOOXXXXXXXXXXXXXXXXGOOOOOOOOXXXXXXXXXXX,0,0,0
21294,81,0,81,25,394,0,0,400,358,42,GOOXXXXXXXXXXXXXXXXXGOOOOOXXXXXXXXXXXXXXGOOOOOOOOOXXXXXXXXXXGOOOOXXXXXXXXXXXXXXXGOOXXXXXXXXXXXXXXXXXGOOOOOXXXXXXXXXXXXXXGOOOOOOXXXXXXXXXXXXXGOOOOOOOOOXXXXXXXXXXGOOOOOOOOXXXXXXXXXXXGOOXXXXXXXXXXXXXXXXXGOOOOOXXXXXXXXXXXXXXGOOOXXXXXXXXXXXXXXXXGOOOOOOOOXXXXXXXXXXX,0,0,0

21315,81,0,81,25,394,0,0,400,361,39,GOOXXXXXXXXXXXXXXXXXGOOOOOXXXXXXXXXXXXXXGOOOOOOOOOXXXXXXXXXXGOOOOXXXXXXXXXXXXXXXGOOXXXXXXXXXXXXXXXXXGOOOOOXXXXXXXXXXXXXXGOOOOOOXXXXXXXXXXXXXGOOOOOOOOOXXXXXXXXXXGOOOOOOOOXXXXXXXXXXXGOOXXXXXXXXXXXXXXXXXGOOOOOXXXXXXXXXXXXXXGOOOXXXXXXXXXXXXXXXXGOOOOOOOOXXXXXXXXXXX,0,0,0
21336,81,0,81,27,392,0,0,397,356,41,GOOXXXXXXXXXXXXXXXXXGOOOOOXXXXXXXXXXXXXXGOOOOOOOOOXXXXXXXXXXGOOOOXXXXXXXXXXXXXXXGOOXXXXXXXXXXXXXXXXXGOOOOOXXXXXXXXXXXXXXGOOOOOOXXXXXXXXXXXXXGOOOOOOOOOXXXXXXXXXXGOOOOOOOOXXXXXXXXXXXGOOXXXXXXXXXXXXXXXXXGOOOOOXXXXXXXXXXXXXXGOOOXXXXXXXXXXXXXXXXGOOOOOOOOXXXXXXXXXXX,0,0,0
21357,81,0,81,28,391,0,0,397,360,37,GOOXXXXXXXXXXXXXXXXXGOOOOOXXXXXXXXXXXXXXGOOOOOOOOOXXXXXXXXXXGOOOOXXXXXXXXXXXXXXXGOOXXXXXXXXXXXXXXXXXGOOOOOXXXXXXXXXXXXXXGOOOOOOXXXXXXXXXXXXXGOOOOOOOOOXXXXXXXXXXGOOOOOOOOXXXXXXXXXXXGOOXXXXXXXXXXXXXXXXXGOOOOOXXXXXXXXXXXXXXGOOOXXXXXXXXXXXXXXXXGOOOOOOOOXXXXXXXXXXX,0,0,0
21378,81,0,81,29,390,0,0,397,359,38,GOOXXXXXXXXXXXXXXXXXGOOOOOXXXXXXXXXXXXXXGOOOOOOOOOXXXXXXXXXXGOOOOXXXXXXXXXXXXXXXGOOXXXXXXXXXXXXXXXXXGOOOOOXXXXXXXXXXXXXXGOOOOOOXXXXXXXXXXXXXGOOOOOOOOOXXXXXXXXXXGOOOOOOOOXXXXXXXXXXXGOOXXXXXXXXXXXXXXXXXGOOOOOXXXXXXXXXXXXXXGOOOXXXXXXXXXXXXXXXXGOOOOOOOOXXXXXXXXXXX,0,0,0
21399,81,0,81,28,391,0,0,398,358,40,GOOXXXXXXXXXXXXXXXXXGOOOOOXXXXXXXXXXXXXXGOOOOOOOOOXXXXXXXXXXGOOOOXXXXXXXXXXXXXXXGOOXXXXXXXXXXXXXXXXXGOOOOOXXXXXXXXXXXXXXGOOOOOOXXXXXXXXXXXXXGOOOOOOOOOXXXXXXXXXXGOOOOOOOOXXXXXXXXXXXGOOXXXXXXXXXXXXXXXXXGOOOOOXXXXXXXXXXXXXXGOOOXXXXXXXXXXXXXXXXGOOOOOOOOXXXXXXXXXXX,0,0,0

21420,81,0,81,28,391,0,0,398,360,38,GOOXXXXXXXXXXXXXXXXXGOOOOOXXXXXXXXXXXXXXGOOOOOOOOOXXXXXXXXXXGOOOOXXXXXXXXXXXXXXXGOOXXXXXXXXXXXXXXXXXGOOOOOXXXXXXXXXXXXXXGOOOOOOXXXXXXXXXXXXXGOOOOOOOOOXXXXXXXXXXGOOOOOOOOXXXXXXXXXXXGOOXXXXXXXXXXXXXXXXXGOOOOOXXXXXXXXXXXXXXGOOOXXXXXXXXXXXXXXXXGOOOOOOOOXXXXXXXXXXX,0,0,0
21441,81,0,81,29,390,0,0,397,360,37,GOOXXXXXXXXXXXXXXXXXGOOOOOXXXXXXXXXXXXXXGOOOOOOOOOXXXXXXXXXXGOOOOXXXXXXXXXXXXXXXGOOXXXXXXXXXXXXXXXXXGOOOOOXXXXXXXXXXXXXXGOOOOOOXXXXXXXXXXXXXGOOOOOOOOOXXXXXXXXXXGOOOOOOOOXXXXXXXXXXXGOOXXXXXXXXXXXXXXXXXGOOOOOXXXXXXXXXXXXXXGOOOXXXXXXXXXXXXXXXXGOOOOOOOOXXXXXXXXXXX,0,0,0
21462,81,0,81,30,389,0,0,396,358,38,GOOXXXXXXXXXXXXXXXXXGOOOOOXXXXXXXXXXXXXXGOOOOOOOOOXXXXXXXXXXGOOOOXXXXXXXXXXXXXXXGOOXXXXXXXXXXXXXXXXXGOOOOOXXXXXXXXXXXXXXGOOOOOOXXXXXXXXXXXXXGOOOOOOOOOXXXXXXXXXXGOOOOOOOOXXXXXXXXXXXGOOXXXXXXXXXXXXXXXXXGOOOOOXXXXXXXXXXXXXXGOOOXXXXXXXXXXXXXXXXGOOOOOOOOXXXXXXXXXXX,0,0,0
21483,81,0,81,30,389,0,0,396,358,38,GOOXXXXXXXXXXXXXXXXXGOOOOOXXXXXXXXXXXXXXGOOOOOOOOOXXXXXXXXXXGOOOOXXXXXXXXXXXXXXXGOOXXXXXXXXXXXXXXXXXGOOOOOXXXXXXXXXXXXXXGOOOOOOXXXXXXXXXXXXXGOOOOOOOOOXXXXXXXXXXGOOOOOOOOXXXXXXXXXXXGOOXXXXXXXXXXXXXXXXXGOOOOOXXXXXXXXXXXXXXGOOOXXXXXXXXXXXXXXXXGOOOOOOOOXXXXXXXXXXX,0,0,0
21504,81,0,81,29,390,0,0,396,358,38,GOOXXXXXXXXXXXXXXXXXGOOOOOXXXXXXXXXXXXXXGOOOOOOOOOXXXXXXXXXXGOOOOXXXXXXXXXXXXXXXGOOXXXXXXXXXXXXXXXXXGOOOOOXXXXXXXXXXXXXXGOOOOOOXXXXXXXXXXXXXGOOOOOOOOOXXXXXXXXXXGOOOOOOOOXXXXXXXXXXXGOOXXXXXXXXXXXXXXXXXGOOOOOXXXXXXXXXXXXXXGOOOXXXXXXXXXXXXXXXXGOOOOOOOOXXXXXXXXXXX,0,0,0

21525,81,0,81,28,391,0,0,397,357,40,GOOXXXXXXXXXXXXXXXXXGOOOOOXXXXXXXXXXXXXXGOOOOOOOOOXXXXXXXXXXGOOOOXXXXXXXXXXXXXXXGOOXXXXXXXXXXXXXXXXXGOOOOOXXXXXXXXXXXXXXGOOOOOOXXXXXXXXXXXXXGOOOOOOOOOXXXXXXXXXXGOOOOOOOOXXXXXXXXXXXGOOXXXXXXXXXXXXXXXXXGOOOOOXXXXXXXXXXXXXXGOOOXXXXXXXXXXXXXXXXGOOOOOOOOXXXXXXXXXXX,0,0,0
21546,81,0,81,28,391,0,0,398,358,40,GOOXXXXXXXXXXXXXXXXXGOOOOOXXXXXXXXXXXXXXGOOOOOOOOOXXXXXXXXXXGOOOOXXXXXXXXXXXXXXXGOOXXXXXXXXXXXXXXXXXGOOOOOXXXXXXXXXXXXXXGOOOOOOXXXXXXXXXXXXXGOOOOOOOOOXXXXXXXXXXGOOOOOOOOXXXXXXXXXXXGOOXXXXXXXXXXXXXXXXXGOOOOOXXXXXXXXXXXXXXGOOOXXXXXXXXXXXXXXXXGOOOOOOOOXXXXXXXXXXX,0,0,0
21567,81,0,81,22,397,0,0,404,358,46,GOOXXXXXXXXXXXXXXXXXGOOOOOXXXXXXXXXXXXXXGOOOOOOOOOXXXXXXXXXXGOOOOXXXXXXXXXXXXXXXGOOXXXXXXXXXXXXXXXXXGOOOOOXXXXXXXXXXXXXXGOOOOOOXXXXXXXXXXXXXGOOOOOOOOOXXXXXXXXXXGOOOOOOOOXXXXXXXXXXXGOOXXXXXXXXXXXXXXXXXGOOOOOXXXXXXXXXXXXXXGOOOXXXXXXXXXXXXXXXXGOOOOOOOOXXXXXXXXXXX,0,0,0
21588,81,0,81,19,400,0,0,405,358,47,GOOXXXXXXXXXXXXXXXXXGOOOOOXXXXXXXXXXXXXXGOOOOOOOOOXXXXXXXXXXGOOOOXXXXXXXXXXXXXXXGOOXXXXXXXXXXXXXXXXXGOOOOOXXXXXXXXXXXXXXGOOOOOOXXXXXXXXXXXXXGOOOOOOOOOXXXXXXXXXXGOOOOOOOOXXXXXXXXXXXGOOXXXXXXXXXXXXXXXXXGOOOOOXXXXXXXXXXXXXXGOOOXXXXXXXXXXXXXXXXGOOOOOOOOXXXXXXXXXXX,0,0,0
21609,81,0,81,17,402,0,0,408,357,51,GOOXXXXXXXXXXXXXXXXXGOOOOOXXXXXXXXXXXXXXGOOOOOOOOOXXXXXXXXXXGOOOOXXXXXXXXXXXXXXXGOOXXXXXXXXXXXXXXXXXGOOOOOXXXXXXXXXXXXXXGOOOOOOXXXXXXXXXXXXXGOOOOOOOOOXXXXXXXXXXGOOOOOOOOXXXXXXXXXXXGOOXXXXXXXXXXXXXXXXXGOOOOOXXXXXXXXXXXXXXGOOOXXXXXXXXXXXXXXXXGOOOOOOOOXXXXXXXXXXX,0,0,0

21630,81,0,81,18,401,0,0,407,359,48,GOOXXXXXXXXXXXXXXXXXGOOOOOXXXXXXXXXXXXXXGOOOOOOOOOXXXXXXXXXXGOOOOXXXXXXXXXXXXXXXGOOXXXXXXXXXXXXXXXXXGOOOOOXXXXXXXXXXXXXXGOOOOOOXXXXXXXXXXXXXGOOOOOOOOOXXXXXXXXXXGOOOOOOOOXXXXXXXXXXXGOOXXXXXXXXXXXXXXXXXGOOOOOXXXXXXXXXXXXXXGOOOXXXXXXXXXXXXXXXXGOOOOOOOOXXXXXXXXXXX,0,0,0
21651,81,0,81,18,401,0,0,407,360,47,GOOXXXXXXXXXXXXXXXXXGOOOOOXXXXXXXXXXXXXXGOOOOOOOOOXXXXXXXXXXGOOOOXXXXXXXXXXXXXXXGOOXXXXXXXXXXXXXXXXXGOOOOOXXXXXXXXXXXXXXGOOOOOOXXXXXXXXXXXXXGOOOOOOOOOXXXXXXXXXXGOOOOOOOOXXXXXXXXXXXGOOXXXXXXXXXXXXXXXXXGOOOOOXXXXXXXXXXXXXXGOOOXXXXXXXXXXXXXXXXGOOOOOOOOXXXXXXXXXXX,0,0,0
21672,81,0,81,19,400,0,0,405,357,48,GOOXXXXXXXXXXXXXXXXXGOOOOOXXXXXXXXXXXXXXGOOOOOOOOOXXXXXXXXXXGOOOOXXXXXXXXXXXXXXXGOOXXXXXXXXXXXXXXXXXGOOOOOXXXXXXXXXXXXXXGOOOOOOXXXXXXXXXXXXXGOOOOOOOOOXXXXXXXXXXGOOOOOOOOXXXXXXXXXXXGOOXXXXXXXXXXXXXXXXXGOOOOOXXXXXXXXXXXXXXGOOOXXXXXXXXXXXXXXXXGOOOOOOOOXXXXXXXXXXX,0,0,0
21693,81,0,81,18,401,0,0,407,357,50,GOOXXXXXXXXXXXXXXXXXGOOOOOXXXXXXXXXXXXXXGOOOOOOOOOXXXXXXXXXXGOOOOXXXXXXXXXXXXXXXGOOXXXXXXXXXXXXXXXXXGOOOOOXXXXXXXXXXXXXXGOOOOOOXXXXXXXXXXXXXGOOOOOOOOOXXXXXXXXXXGOOOOOOOOXXXXXXXXXXXGOOXXXXXXXXXXXXXXXXXGOOOOOXXXXXXXXXXXXXXGOOOXXXXXXXXXXXXXXXXGOOOOOOOOXXXXXXXXXXX,0,0,0
21714,81,0,81,16,403,0,0,408,358,50,GOOXXXXXXXXXXXXXXXXXGOOOOOXXXXXXXXXXXXXXGOOOOOOOOOXXXXXXXXXXGOOOOXXXXXXXXXXXXXXXGOOXXXXXXXXXXXXXXXXXGOOOOOXXXXXXXXXXXXXXGOOOOOOXXXXXXXXXXXXXGOOOOOOOOOXXXXXXXXXXGOOOOOOOOXXXXXXXXXXXGOOXXXXXXXXXXXXXXXXXGOOOOOXXXXXXXXXXXXXXGOOOXXXXXXXXXXXXXXXXGOOOOOOOOXXXXXXXXXXX,0,0,0

21735,81,0,81,18,401,0,0,407,360,47,GOOXXXXXXXXXXXXXXXXXGOOOOOXXXXXXXXXXXXXXGOOOOOOOOOXXXXXXXXXXGOOOOXXXXXXXXXXXXXXXGOOXXXXXXXXXXXXXXXXXGOOOOOXXXXXXXXXXXXXXGOOOOOOXXXXXXXXXXXXXGOOOOOOOOOXXXXXXXXXXGOOOOOOOOXXXXXXXXXXXGOOXXXXXXXXXXXXXXXXXGOOOOOXXXXXXXXXXXXXXGOOOXXXXXXXXXXXXXXXXGOOOOOOOOXXXXXXXXXXX,0,0,0
21756,81,0,81,18,401,0,0,406,358,48,GOOXXXXXXXXXXXXXXXXXGOOOOOXXXXXXXXXXXXXXGOOOOOOOOOXXXXXXXXXXGOOOOXXXXXXXXXXXXXXXGOOXXXXXXXXXXXXXXXXXGOOOOOXXXXXXXXXXXXXXGOOOOOOXXXXXXXXXXXXXGOOOOOOOOOXXXXXXXXXXGOOOOOOOOXXXXXXXXXXXGOOXXXXXXXXXXXXXXXXXGOOOOOXXXXXXXXXXXXXXGOOOXXXXXXXXXXXXXXXXGOOOOOOOOXXXXXXXXXXX,0,0,0
21777,81,0,81,19,400,0,0,406,359,47,GOOXXXXXXXXXXXXXXXXXGOOOOOXXXXXXXXXXXXXXGOOOOOOOOOXXXXXXXXXXGOOOOXXXXXXXXXXXXXXXGOOXXXXXXXXXXXXXXXXXGOOOOOXXXXXXXXXXXXXXGOOOOOOXXXXXXXXXXXXXGOOOOOOOOOXXXXXXXXXXGOOOOOOOOXXXXXXXXXXXGOOXXXXXXXXXXXXXXXXXGOOOOOXXXXXXXXXXXXXXGOOOXXXXXXXXXXXXXXXXGOOOOOOOOXXXXXXXXXXX,0,0,0
21798,81,0,81,20,399,0,0,405,357,48,GOOXXXXXXXXXXXXXXXXXGOOOOOXXXXXXXXXXXXXXGOOOOOOOOOXXXXXXXXXXGOOOOXXXXXXXXXXXXXXXGOOXXXXXXXXXXXXXXXXXGOOOOOXXXXXXXXXXXXXXGOOOOOOXXXXXXXXXXXXXGOOOOOOOOOXXXXXXXXXXGOOOOOOOOXXXXXXXXXXXGOOXXXXXXXXXXXXXXXXXGOOOOOXXXXXXXXXXXXXXGOOOXXXXXXXXXXXXXXXXGOOOOOOOOXXXXXXXXXXX,0,0,0
21819,81,0,81,18,401,0,0,407,360,47,GOOXXXXXXXXXXXXXXXXXGOOOOOXXXXXXXXXXXXXXGOOOOOOOOOXXXXXXXXXXGOOOOXXXXXXXXXXXXXXXGOOXXXXXXXXXXXXXXXXXGOOOOOXXXXXXXXXXXXXXGOOOOOOXXXXXXXXXXXXXGOOOOOOOOOXXXXXXXXXXGOOOOOOOOXXXXXXXXXXXGOOXXXXXXXXXXXXXXXXXGOOOOOXXXXXXXXXXXXXXGOOOXXXXXXXXXXXXXXXXGOOOOOOOOXXXXXXXXXXX,0,0,0

21840,81,0,81,20,399,0,0,405,361,44,GOOXXXXXXXXXXXXXXXXXGOOOOOXXXXXXXXXXXXXXGOOOOOOOOOXXXXXXXXXXGOOOOXXXXXXXXXXXXXXXGOOXXXXXXXXXXXXXXXXXGOOOOOXXXXXXXXXXXXXXGOOOOOOXXXXXXXXXXXXXGOOOOOOOOOXXXXXXXXXXGOOOOOOOOXXXXXXXXXXXGOOXXXXXXXXXXXXXXXXXGOOOOOXXXXXXXXXXXXXXGOOOXXXXXXXXXXXXXXXXGOOOOOOOOXXXXXXXXXXX,0,0,0
21861,81,0,81,22,397,0,0,403,357,46,GOOXXXXXXXXXXXXXXXXXGOOOOOXXXXXXXXXXXXXXGOOOOOOOOOXXXXXXXXXXGOOOOXXXXXXXXXXXXXXXGOOXXXXXXXXXXXXXXXXXGOOOOOXXXXXXXXXXXXXXGOOOOOOXXXXXXXXXXXXXGOOOOOOOOOXXXXXXXXXXGOOOOOOOOXXXXXXXXXXXGOOXXXXXXXXXXXXXXXXXGOOOOOXXXXXXXXXXXXXXGOOOXXXXXXXXXXXXXXXXGOOOOOOOOXXXXXXXXXXX,0,0,0
21882,81,0,81,22,397,0,0,403,359,44,GOOXXXXXXXXXXXXXXXXXGOOOOOXXXXXXXXXXXXXXGOOOOOOOOOXXXXXXXXXXGOOOOXXXXXXXXXXXXXXXGOOXXXXXXXXXXXXXXXXXGOOOOOXXXXXXXXXXXXXXGOOOOOOXXXXXXXXXXXXXGOOOOOOOOOXXXXXXXXXXGOOOOOOOOXXXXXXXXXXXGOOXXXXXXXXXXXXXXXXXGOOOOOXXXXXXXXXXXXXXGOOOXXXXXXXXXXXXXXXXGOOOOOOOOXXXXXXXXXXX,0,0,0
21903,81,0,81,22,397,0,0,403,358,45,GOOXXXXXXXXXXXXXXXXXGOOOOOXXXXXXXXXXXXXXGOOOOOOOOOXXXXXXXXXXGOOOOXXXXXXXXXXXXXXXGOOXXXXXXXXXXXXXXXXXGOOOOOXXXXXXXXXXXXXXGOOOOOOXXXXXXXXXXXXXGOOOOOOOOOXXXXXXXXXXGOOOOOOOOXXXXXXXXXXXGOOXXXXXXXXXXXXXXXXXGOOOOOXXXXXXXXXXXXXXGOOOXXXXXXXXXXXXXXXXGOOOOOOOOXXXXXXXXXXX,0,0,0
21924,81,0,81,23,396,0,0,402,359,43,GOOXXXXXXXXXXXXXXXXXGOOOOOXXXXXXXXXXXXXXGOOOOOOOOOXXXXXXXXXXGOOOOXXXXXXXXXXXXXXXGOOXXXXXXXXXXXXXXXXXGOOOOOXXXXXXXXXXXXXXGOOOOOOXXXXXXXXXXXXXGOOOOOOOOOXXXXXXXXXXGOOOOOOOOXXXXXXXXXXXGOOXXXXXXXXXXXXXXXXXGOOOOOXXXXXXXXXXXXXXGOOOXXXXXXXXXXXXXXXXGOOOOOOOOXXXXXXXXXXX,0,0,0

21945,81,0,81,23,396,0,0,402,360,42,GOOXXXXXXXXXXXXXXXXXGOOOOOXXXXXXXXXXXXXXGOOOOOOOOOXXXXXXXXXXGOOOOXXXXXXXXXXXXXXXGOOXXXXXXXXXXXXXXXXXGOOOOOXXXXXXXXXXXXXXGOOOOOOXXXXXXXXXXXXXGOOOOOOOOOXXXXXXXXXXGOOOOOOOOXXXXXXXXXXXGOOXXXXXXXXXXXXXXXXXGOOOOOXXXXXXXXXXXXXXGOOOXXXXXXXXXXXXXXXXGOOOOOOOOXXXXXXXXXXX,0,0,0
21966,81,0,81,27,392,0,0,398,358,40,GOOXXXXXXXXXXXXXXXXXGOOOOOXXXXXXXXXXXXXXGOOOOOOOOOXXXXXXXXXXGOOOOXXXXXXXXXXXXXXXGOOXXXXXXXXXXXXXXXXXGOOOOOXXXXXXXXXXXXXXGOOOOOOXXXXXXXXXXXXXGOOOOOOOOOXXXXXXXXXXGOOOOOOOOXXXXXXXXXXXGOOXXXXXXXXXXXXXXXXXGOOOOOXXXXXXXXXXXXXXGOOOXXXXXXXXXXXXXXXXGOOOOOOOOXXXXXXXXXXX,0,0,0
21987,81,0,81,29,390,0,0,396,358,38,GOOXXXXXXXXXXXXXXXXXGOOOOOXXXXXXXXXXXXXXGOOOOOOOOOXXXXXXXXXXGOOOOXXXXXXXXXXXXXXXGOOXXXXXXXXXXXXXXXXXGOOOOOXXXXXXXXXXXXXXGOOOOOOXXXXXXXXXXXXXGOOOOOOOOOXXXXXXXXXXGOOOOOOOOXXXXXXXXXXXGOOXXXXXXXXXXXXXXXXXGOOOOOXXXXXXXXXXXXXXGOOOXXXXXXXXXXXXXXXXGOOOOOOOOXXXXXXXXXXX,0,0,0
22008,81,0,81,25,394,0,0,400,359,41,GOOXXXXXXXXXXXXXXXXXGOOOOOXXXXXXXXXXXXXXGOOOOOOOOOXXXXXXXXXXGOOOOXXXXXXXXXXXXXXXGOOXXXXXXXXXXXXXXXXXGOOOOOXXXXXXXXXXXXXXGOOOOOOXXXXXXXXXXXXXGOOOOOOOOOXXXXXXXXXXGOOOOOOOOXXXXXXXXXXXGOOXXXXXXXXXXXXXXXXXGOOOOOXXXXXXXXXXXXXXGOOOXXXXXXXXXXXXXXXXGOOOOOOOOXXXXXXXXXXX,0,0,0
22029,81,0,81,25,394,0,0,399,359,40,GOOXXXXXXXXXXXXXXXXXGOOOOOXXXXXXXXXXXXXXGOOOOOOOOOXXXXXXXXXXGOOOOXXXXXXXXXXXXXXXGOOXXXXXXXXXXXXXXXXXGOOOOOXXXXXXXXXXXXXXGOOOOOOXXXXXXXXXXXXXGOOOOOOOOOXXXXXXXXXXGOOOOOOOOXXXXXXXXXXXGOOXXXXXXXXXXXXXXXXXGOOOOOXXXXXXXXXXXXXXGOOOXXXXXXXXXXXXXXXXGOOOOOOOOXXXXXXXXXXX,0,0,0

22050,81,0,81,23,396,0,0,402,360,42,GOOXXXXXXXXXXXXXXXXXGOOOOOXXXXXXXXXXXXXXGOOOOOOOOOXXXXXXXXXXGOOOOXXXXXXXXXXXXXXXGOOXXXXXXXXXXXXXXXXXGOOOOOXXXXXXXXXXXXXXGOOOOOOXXXXXXXXXXXXXGOOOOOOOOOXXXXXXXXXXGOOOOOOOOXXXXXXXXXXXGOOXXXXXXXXXXXXXXXXXGOOOOOXXXXXXXXXXXXXXGOOOXXXXXXXXXXXXXXXXGOOOOOOOOXXXXXXXXXXX,0,0,0
22071,81,0,81,26,393,0,0,398,359,39,GOOXXXXXXXXXXXXXXXXXGOOOOOXXXXXXXXXXXXXXGOOOOOOOOOXXXXXXXXXXGOOOOXXXXXXXXXXXXXXXGOOXXXXXXXXXXXXXXXXXGOOOOOXXXXXXXXXXXXXXGOOOOOOXXXXXXXXXXXXXGOOOOOOOOOXXXXXXXXXXGOOOOOOOOXXXXXXXXXXXGOOXXXXXXXXXXXXXXXXXGOOOOOXXXXXXXXXXXXXXGOOOXXXXXXXXXXXXXXXXGOOOOOOOOXXXXXXXXXXX,0,0,0
22092,81,0,81,29,390,0,0,395,357,38,GOOXXXXXXXXXXXXXXXXXGOOOOOXXXXXXXXXXXXXXGOOOOOOOOOXXXXXXXXXXGOOOOXXXXXXXXXXXXXXXGOOXXXXXXXXXXXXXXXXXGOOOOOXXXXXXXXXXXXXXGOOOOOOXXXXXXXXXXXXXGOOOOOOOOOXXXXXXXXXXGOOOOOOOOXXXXXXXXXXXGOOXXXXXXXXXXXXXXXXXGOOOOOXXXXXXXXXXXXXXGOOOXXXXXXXXXXXXXXXXGOOOOOOOOXXXXXXXXXXX,0,0,0
22113,81,0,81,27,392,0,0,397,359,38,GOOXXXXXXXXXXXXXXXXXGOOOOOXXXXXXXXXXXXXXGOOOOOOOOOXXXXXXXXXXGOOOOXXXXXXXXXXXXXXXGOOXXXXXXXXXXXXXXXXXGOOOOOXXXXXXXXXXXXXXGOOOOOOXXXXXXXXXXXXXGOOOOOOOOOXXXXXXXXXXGOOOOOOOOXXXXXXXXXXXGOOXXXXXXXXXXXXXXXXXGOOOOOXXXXXXXXXXXXXXGOOOXXXXXXXXXXXXXXXXGOOOOOOOOXXXXXXXXXXX,0,0,0
22134,81,0,81,26,393,0,0,398,359,39,GOOXXXXXXXXXXXXXXXXXGOOOOOXXXXXXXXXXXXXXGOOOOOOOOOXXXXXXXXXXGOOOOXXXXXXXXXXXXXXXGOOXXXXXXXXXXXXXXXXXGOOOOOXXXXXXXXXXXXXXGOOOOOOXXXXXXXXXXXXXGOOOOOOOOOXXXXXXXXXXGOOOOOOOOXXXXXXXXXXXGOOXXXXXXXXXXXXXXXXXGOOOOOXXXXXXXXXXXXXXGOOOXXXXXXXXXXXXXXXXGOOOOOOOOXXXXXXXXXXX,0,0,0

22155,81,0,81,26,393,0,0,397,359,38,GOOXXXXXXXXXXXXXXXXXGOOOOOXXXXXXXXXXXXXXGOOOOOOOOOXXXXXXXXXXGOOOOXXXXXXXXXXXXXXXGOOXXXXXXXXXXXXXXXXXGOOOOOXXXXXXXXXXXXXXGOOOOOOXXXXXXXXXXXXXGOOOOOOOOOXXXXXXXXXXGOOOOOOOOXXXXXXXXXXXGOOXXXXXXXXXXXXXXXXXGOOOOOXXXXXXXXXXXXXXGOOOXXXXXXXXXXXXXXXXGOOOOOOOOXXXXXXXXXXX,0,0,0
22176,81,0,81,24,395,0,0,400,359,41,GOOXXXXXXXXXXXXXXXXXGOOOOOXXXXXXXXXXXXXXGOOOOOOOOOXXXXXXXXXXGOOOOXXXXXXXXXXXXXXXGOOXXXXXXXXXXXXXXXXXGOOOOOXXXXXXXXXXXXXXGOOOOOOXXXXXXXXXXXXXGOOOOOOOOOXXXXXXXXXXGOOOOOOOOXXXXXXXXXXXGOOXXXXXXXXXXXXXXXXXGOOOOOXXXXXXXXXXXXXXGOOOXXXXXXXXXXXXXXXXGOOOOOOOOXXXXXXXXXXX,0,0,0
22197,81,0,81,25,394,0,0,399,359,40,GOOXXXXXXXXXXXXXXXXXGOOOOOXXXXXXXXXXXXXXGOOOOOOOOOXXXXXXXXXXGOOOOXXXXXXXXXXXXXXXGOOXXXXXXXXXXXXXXXXXGOOOOOXXXXXXXXXXXXXXGOOOOOOXXXXXXXXXXXXXGOOOOOOOOOXXXXXXXXXXGOOOOOOOOXXXXXXXXXXXGOOXXXXXXXXXXXXXXXXXGOOOOOXXXXXXXXXXXXXXGOOOXXXXXXXXXXXXXXXXGOOOOOOOOXXXXXXXXXXX,0,0,0
22218,81,0,81,23,396,0,0,401,359,42,GOOXXXXXXXXXXXXXXXXXGOOOOOXXXXXXXXXXXXXXGOOOOOOOOOXXXXXXXXXXGOOOOXXXXXXXXXXXXXXXGOOXXXXXXXXXXXXXXXXXGOOOOOXXXXXXXXXXXXXXGOOOOOOXXXXXXXXXXXXXGOOOOOOOOOXXXXXXXXXXGOOOOOOOOXXXXXXXXXXXGOOXXXXXXXXXXXXXXXXXGOOOOOXXXXXXXXXXXXXXGOOOXXXXXXXXXXXXXXXXGOOOOOOOOXXXXXXXXXXX,0,0,0
22239,81,0,81,21,398,0,0,403,357,46,GOOXXXXXXXXXXXXXXXXXGOOOOOXXXXXXXXXXXXXXGOOOOOOOOOXXXXXXXXXXGOOOOXXXXXXXXXXXXXXXGOOXXXXXXXXXXXXXXXXXGOOOOOXXXXXXXXXXXXXXGOOOOOOXXXXXXXXXXXXXGOOOOOOOOOXXXXXXXXXXGOOOOOOOOXXXXXXXXXXXGOOXXXXXXXXXXXXXXXXXGOOOOOXXXXXXXXXXXXXXGOOOXXXXXXXXXXXXXXXXGOOOOOOOOXXXXXXXXXXX,0,0,0

22260,81,0,81,16,403,0,0,408,357,51,GOOXXXXXXXXXXXXXXXXXGOOOOOXXXXXXXXXXXXXXGOOOOOOOOOXXXXXXXXXXGOOOOXXXXXXXXXXXXXXXGOOXXXXXXXXXXXXXXXXXGOOOOOXXXXXXXXXXXXXXGOOOOOOXXXXXXXXXXXXXGOOOOOOOOOXXXXXXXXXXGOOOOOOOOXXXXXXXXXXXGOOXXXXXXXXXXXXXXXXXGOOOOOXXXXXXXXXXXXXXGOOOXXXXXXXXXXXXXXXXGOOOOOOOOXXXXXXXXXXX,0,0,0
22281,81,0,81,17,402,0,0,407,357,50,GOOXXXXXXXXXXXXXXXXXGOOOOOXXXXXXXXXXXXXXGOOOOOOOOOXXXXXXXXXXGOOOOXXXXXXXXXXXXXXXGOOXXXXXXXXXXXXXXXXXGOOOOOXXXXXXXXXXXXXXGOOOOOOXXXXXXXXXXXXXGOOOOOOOOOXXXXXXXXXXGOOOOOOOOXXXXXXXXXXXGOOXXXXXXXXXXXXXXXXXGOOOOOXXXXXXXXXXXXXXGOOOXXXXXXXXXXXXXXXXGOOOOOOOOXXXXXXXXXXX,0,0,0
22302,81,0,81,17,402,0,0,407,359,48,GOOXXXXXXXXXXXXXXXXXGOOOOOXXXXXXXXXXXXXXGOOOOOOOOOXXXXXXXXXXGOOOOXXXXXXXXXXXXXXXGOOXXXXXXXXXXXXXXXXXGOOOOOXXXXXXXXXXXXXXGOOOOOOXXXXXXXXXXXXXGOOOOOOOOOXXXXXXXXXXGOOOOOOOOXXXXXXXXXXXGOOXXXXXXXXXXXXXXXXXGOOOOOXXXXXXXXXXXXXXGOOOXXXXXXXXXXXXXXXXGOOOOOOOOXXXXXXXXXXX,0,0,0
22323,81,0,81,17,402,0,0,407,362,45,GOOXXXXXXXXXXXXXXXXXGOOOOOXXXXXXXXXXXXXXGOOOOOOOOOXXXXXXXXXXGOOOOXXXXXXXXXXXXXXXGOOXXXXXXXXXXXXXXXXXGOOOOOXXXXXXXXXXXXXXGOOOOOOXXXXXXXXXXXXXGOOOOOOOOOXXXXXXXXXXGOOOOOOOOXXXXXXXXXXXGOOXXXXXXXXXXXXXXXXXGOOOOOXXXXXXXXXXXXXXGOOOXXXXXXXXXXXXXXXXGOOOOOOOOXXXXXXXXXXX,0,0,0
22344,81,0,81,23,396,0,0,401,359,42,GOOXXXXXXXXXXXXXXXXXGOOOOOXXXXXXXXXXXXXXGOOOOOOOOOXXXXXXXXXXGOOOOXXXXXXXXXXXXXXXGOOXXXXXXXXXXXXXXXXXGOOOOOXXXXXXXXXXXXXXGOOOOOOXXXXXXXXXXXXXGOOOOOOOOOXXXXXXXXXXGOOOOOOOOXXXXXXXXXXXGOOXXXXXXXXXXXXXXXXXGOOOOOXXXXXXXXXXXXXXGOOOXXXXXXXXXXXXXXXXGOOOOOOOOXXXXXXXXXXX,0,0,0

22365,81,0,81,23,396,0,0,401,358,43,GOOXXXXXXXXXXXXXXXXXGOOOOOXXXXXXXXXXXXXXGOOOOOOOOOXXXXXXXXXXGOOOOXXXXXXXXXXXXXXXGOOXXXXXXXXXXXXXXXXXGOOOOOXXXXXXXXXXXXXXGOOOOOOXXXXXXXXXXXXXGOOOOOOOOOXXXXXXXXXXGOOOOOOOOXXXXXXXXXXXGOOXXXXXXXXXXXXXXXXXGOOOOOXXXXXXXXXXXXXXGOOOXXXXXXXXXXXXXXXXGOOOOOOOOXXXXXXXXXXX,0,0,0
22386,81,0,81,23,396,0,0,401,360,41,GOOXXXXXXXXXXXXXXXXXGOOOOOXXXXXXXXXXXXXXGOOOOOOOOOXXXXXXXXXXGOOOOXXXXXXXXXXXXXXXGOOXXXXXXXXXXXXXXXXXGOOOOOXXXXXXXXXXXXXXGOOOOOOXXXXXXXXXXXXXGOOOOOOOOOXXXXXXXXXXGOOOOOOOOXXXXXXXXXXXGOOXXXXXXXXXXXXXXXXXGOOOOOXXXXXXXXXXXXXXGOOOXXXXXXXXXXXXXXXXGOOOOOOOOXXXXXXXXXXX,0,0,0
22407,81,0,81,21,398,0,0,402,358,44,GOOXXXXXXXXXXXXXXXXXGOOOOOXXXXXXXXXXXXXXGOOOOOOOOOXXXXXXXXXXGOOOOXXXXXXXXXXXXXXXGOOXXXXXXXXXXXXXXXXXGOOOOOXXXXXXXXXXXXXXGOOOOOOXXXXXXXXXXXXXGOOOOOOOOOXXXXXXXXXXGOOOOOOOOXXXXXXXXXXXGOOXXXXXXXXXXXXXXXXXGOOOOOXXXXXXXXXXXXXXGOOOXXXXXXXXXXXXXXXXGOOOOOOOOXXXXXXXXXXX,0,0,0
22428,81,0,81,20,399,0,0,403,360,43,GOOXXXXXXXXXXXXXXXXXGOOOOOXXXXXXXXXXXXXXGOOOOOOOOOXXXXXXXXXXGOOOOXXXXXXXXXXXXXXXGOOXXXXXXXXXXXXXXXXXGOOOOOXXXXXXXXXXXXXXGOOOOOOXXXXXXXXXXXXXGOOOOOOOOOXXXXXXXXXXGOOOOOOOOXXXXXXXXXXXGOOXXXXXXXXXXXXXXXXXGOOOOOXXXXXXXXXXXXXXGOOOXXXXXXXXXXXXXXXXGOOOOOOOOXXXXXXXXXXX,0,0,0
22449,81,0,81,21,398,0,0,403,360,43,GOOXXXXXXXXXXXXXXXXXGOOOOOXXXXXXXXXXXXXXGOOOOOOOOOXXXXXXXXXXGOOOOXXXXXXXXXXXXXXXGOOXXXXXXXXXXXXXXXXXGOOOOOXXXXXXXXXXXXXXGOOOOOOXXXXXXXXXXXXXGOOOOOOOOOXXXXXXXXXXGOOOOOOOOXXXXXXXXXXXGOOXXXXXXXXXXXXXXXXXGOOOOOXXXXXXXXXXXXXXGOOOXXXXXXXXXXXXXXXXGOOOOOOOOXXXXXXXXXXX,0,0,0

22470,81,0,81,23,396,0,0,401,359,42,GOOXXXXXXXXXXXXXXXXXGOOOOOXXXXXXXXXXXXXXGOOOOOOOOOXXXXXXXXXXGOOOOXXXXXXXXXXXXXXXGOOXXXXXXXXXXXXXXXXXGOOOOOXXXXXXXXXXXXXXGOOOOOOXXXXXXXXXXXXXGOOOOOOOOOXXXXXXXXXXGOOOOOOOOXXXXXXXXXXXGOOXXXXXXXXXXXXXXXXXGOOOOOXXXXXXXXXXXXXXGOOOXXXXXXXXXXXXXXXXGOOOOOOOOXXXXXXXXXXX,0,0,0
22491,81,0,81,24,395,0,0,400,361,39,GOOXXXXXXXXXXXXXXXXXGOOOOOXXXXXXXXXXXXXXGOOOOOOOOOXXXXXXXXXXGOOOOXXXXXXXXXXXXXXXGOOXXXXXXXXXXXXXXXXXGOOOOOXXXXXXXXXXXXXXGOOOOOOXXXXXXXXXXXXXGOOOOOOOOOXXXXXXXXXXGOOOOOOOOXXXXXXXXXXXGOOXXXXXXXXXXXXXXXXXGOOOOOXXXXXXXXXXXXXXGOOOXXXXXXXXXXXXXXXXGOOOOOOOOXXXXXXXXXXX,0,0,0
22512,81,0,81,26,393,0,0,398,360,38,GOOXXXXXXXXXXXXXXXXXGOOOOOXXXXXXXXXXXXXXGOOOOOOOOOXXXXXXXXXXGOOOOXXXXXXXXXXXXXXXGOOXXXXXXXXXXXXXXXXXGOOOOOXXXXXXXXXXXXXXGOOOOOOXXXXXXXXXXXXXGOOOOOOOOOXXXXXXXXXXGOOOOOOOOXXXXXXXXXXXGOOXXXXXXXXXXXXXXXXXGOOOOOXXXXXXXXXXXXXXGOOOXXXXXXXXXXXXXXXXGOOOOOOOOXXXXXXXXXXX,0,0,0
22533,81,0,81,23,396,0,0,401,361,40,GOOXXXXXXXXXXXXXXXXXGOOOOOXXXXXXXXXXXXXXGOOOOOOOOOXXXXXXXXXXGOOOOXXXXXXXXXXXXXXXGOOXXXXXXXXXXXXXXXXXGOOOOOXXXXXXXXXXXXXXGOOOOOOXXXXXXXXXXXXXGOOOOOOOOOXXXXXXXXXXGOOOOOOOOXXXXXXXXXXXGOOXXXXXXXXXXXXXXXXXGOOOOOXXXXXXXXXXXXXXGOOOXXXXXXXXXXXXXXXXGOOOOOOOOXXXXXXXXXXX,0,0,0
22554,81,0,81,24,395,0,0,400,359,41,GOOXXXXXXXXXXXXXXXXXGOOOOOXXXXXXXXXXXXXXGOOOOOOOOOXXXXXXXXXXGOOOOXXXXXXXXXXXXXXXGOOXXXXXXXXXXXXXXXXXGOOOOOXXXXXXXXXXXXXXGOOOOOOXXXXXXXXXXXXXGOOOOOOOOOXXXXXXXXXXGOOOOOOOOXXXXXXXXXXXGOOXXXXXXXXXXXXXXXXXGOOOOOXXXXXXXXXXXXXXGOOOXXXXXXXXXXXXXXXXGOOOOOOOOXXXXXXXXXXX,0,0,0

22575,81,0,81,26,393,0,0,398,361,37,GOOXXXXXXXXXXXXXXXXXGOOOOOXXXXXXXXXXXXXXGOOOOOOOOOXXXXXXXXXXGOOOOXXXXXXXXXXXXXXXGOOXXXXXXXXXXXXXXXXXGOOOOOXXXXXXXXXXXXXXGOOOOOOXXXXXXXXXXXXXGOOOOOOOOOXXXXXXXXXXGOOOOOOOOXXXXXXXXXXXGOOXXXXXXXXXXXXXXXXXGOOOOOXXXXXXXXXXXXXXGOOOXXXXXXXXXXXXXXXXGOOOOOOOOXXXXXXXXXXX,0,0,0
22596,81,0,81,24,395,0,0,400,361,39,GOOXXXXXXXXXXXXXXXXXGOOOOOXXXXXXXXXXXXXXGOOOOOOOOOXXXXXXXXXXGOOOOXXXXXXXXXXXXXXXGOOXXXXXXXXXXXXXXXXXGOOOOOXXXXXXXXXXXXXXGOOOOOOXXXXXXXXXXXXXGOOOOOOOOOXXXXXXXXXXGOOOOOOOOXXXXXXXXXXXGOOXXXXXXXXXXXXXXXXXGOOOOOXXXXXXXXXXXXXXGOOOXXXXXXXXXXXXXXXXGOOOOOOOOXXXXXXXXXXX,0,0,0
22617,81,0,81,25,394,0,0,399,361,38,GOOXXXXXXXXXXXXXXXXXGOOOOOXXXXXXXXXXXXXXGOOOOOOOOOXXXXXXXXXXGOOOOXXXXXXXXXXXXXXXGOOXXXXXXXXXXXXXXXXXGOOOOOXXXXXXXXXXXXXXGOOOOOOXXXXXXXXXXXXXGOOOOOOOOOXXXXXXXXXXGOOOOOOOOXXXXXXXXXXXGOOXXXXXXXXXXXXXXXXXGOOOOOXXXXXXXXXXXXXXGOOOXXXXXXXXXXXXXXXXGOOOOOOOOXXXXXXXXXXX,0,0,0
22638,81,0,81,27,392,0,0,398,360,38,GOOXXXXXXXXXXXXXXXXXGOOOOOXXXXXXXXXXXXXXGOOOOOOOOOXXXXXXXXXXGOOOOXXXXXXXXXXXXXXXGOOXXXXXXXXXXXXXXXXXGOOOOOXXXXXXXXXXXXXXGOOOOOOXXXXXXXXXXXXXGOOOOOOOOOXXXXXXXXXXGOOOOOOOOXXXXXXXXXXXGOOXXXXXXXXXXXXXXXXXGOOOOOXXXXXXXXXXXXXXGOOOXXXXXXXXXXXXXXXXGOOOOOOOOXXXXXXXXXXX,0,0,0
22659,81,0,81,29,390,0,0,396,361,35,GOOXXXXXXXXXXXXXXXXXGOOOOOXXXXXXXXXXXXXXGOOOOOOOOOXXXXXXXXXXGOOOOXXXXXXXXXXXXXXXGOOXXXXXXXXXXXXXXXXXGOOOOOXXXXXXXXXXXXXXGOOOOOOXXXXXXXXXXXXXGOOOOOOOOOXXXXXXXXXXGOOOOOOOOXXXXXXXXXXXGOOXXXXXXXXXXXXXXXXXGOOOOOXXXXXXXXXXXXXXGOOOXXXXXXXXXXXXXXXXGOOOOOOOOXXXXXXXXXXX,0,0,0

22680,81,0,81,23,396,0,0,402,363,39,GOOXXXXXXXXXXXXXXXXXGOOOOOXXXXXXXXXXXXXXGOOOOOOOOOXXXXXXXXXXGOOOOXXXXXXXXXXXXXXXGOOXXXXXXXXXXXXXXXXXGOOOOOXXXXXXXXXXXXXXGOOOOOOXXXXXXXXXXXXXGOOOOOOOOOXXXXXXXXXXGOOOOOOOOXXXXXXXXXXXGOOXXXXXXXXXXXXXXXXXGOOOOOXXXXXXXXXXXXXXGOOOXXXXXXXXXXXXXXXXGOOOOOOOOXXXXXXXXXXX,0,0,0
22701,81,0,81,25,394,0,0,400,362,38,GOOXXXXXXXXXXXXXXXXXGOOOOOXXXXXXXXXXXXXXGOOOOOOOOOXXXXXXXXXXGOOOOXXXXXXXXXXXXXXXGOOXXXXXXXXXXXXXXXXXGOOOOOXXXXXXXXXXXXXXGOOOOOOXXXXXXXXXXXXXGOOOOOOOOOXXXXXXXXXXGOOOOOOOOXXXXXXXXXXXGOOXXXXXXXXXXXXXXXXXGOOOOOXXXXXXXXXXXXXXGOOOXXXXXXXXXXXXXXXXGOOOOOOOOXXXXXXXXXXX,0,0,0
22722,81,0,81,22,397,0,0,402,363,39,GOOXXXXXXXXXXXXXXXXXGOOOOOXXXXXXXXXXXXXXGOOOOOOOOOXXXXXXXXXXGOOOOXXXXXXXXXXXXXXXGOOXXXXXXXXXXXXXXXXXGOOOOOXXXXXXXXXXXXXXGOOOOOOXXXXXXXXXXXXXGOOOOOOOOOXXXXXXXXXXGOOOOOOOOXXXXXXXXXXXGOOXXXXXXXXXXXXXXXXXGOOOOOXXXXXXXXXXXXXXGOOOXXXXXXXXXXXXXXXXGOOOOOOOOXXXXXXXXXXX,0,0,0
22743,81,0,81,21,398,0,0,404,365,39,GOOXXXXXXXXXXXXXXXXXGOOOOOXXXXXXXXXXXXXXGOOOOOOOOOXXXXXXXXXXGOOOOXXXXXXXXXXXXXXXGOOXXXXXXXXXXXXXXXXXGOOOOOXXXXXXXXXXXXXXGOOOOOOXXXXXXXXXXXXXGOOOOOOOOOXXXXXXXXXXGOOOOOOOOXXXXXXXXXXXGOOXXXXXXXXXXXXXXXXXGOOOOOXXXXXXXXXXXXXXGOOOXXXXXXXXXXXXXXXXGOOOOOOOOXXXXXXXXXXX,0,0,0
22764,81,0,81,24,395,0,0,401,363,38,GOOXXXXXXXXXXXXXXXXXGOOOOOXXXXXXXXXXXXXXGOOOOOOOOOXXXXXXXXXXGOOOOXXXXXXXXXXXXXXXGOOXXXXXXXXXXXXXXXXXGOOOOOXXXXXXXXXXXXXXGOOOOOOXXXXXXXXXXXXXGOOOOOOOOOXXXXXXXXXXGOOOOOOOOXXXXXXXXXXXGOOXXXXXXXXXXXXXXXXXGOOOOOXXXXXXXXXXXXXXGOOOXXXXXXXXXXXXXXXXGOOOOOOOOXXXXXXXXXXX,0,0,0

22785,81,0,81,25,394,0,0,401,363,38,GOOXXXXXXXXXXXXXXXXXGOOOOOXXXXXXXXXXXXXXGOOOOOOOOOXXXXXXXXXXGOOOOXXXXXXXXXXXXXXXGOOXXXXXXXXXXXXXXXXXGOOOOOXXXXXXXXXXXXXXGOOOOOOXXXXXXXXXXXXXGOOOOOOOOOXXXXXXXXXXGOOOOOOOOXXXXXXXXXXXGOOXXXXXXXXXXXXXXXXXGOOOOOXXXXXXXXXXXXXXGOOOXXXXXXXXXXXXXXXXGOOOOOOOOXXXXXXXXXXX,0,0,0
22806,81,0,81,21,398,0,0,405,365,40,GOOXXXXXXXXXXXXXXXXXGOOOOOXXXXXXXXXXXXXXGOOOOOOOOOXXXXXXXXXXGOOOOXXXXXXXXXXXXXXXGOOXXXXXXXXXXXXXXXXXGOOOOOXXXXXXXXXXXXXXGOOOOOOXXXXXXXXXXXXXGOOOOOOOOOXXXXXXXXXXGOOOOOOOOXXXXXXXXXXXGOOXXXXXXXXXXXXXXXXXGOOOOOXXXXXXXXXXXXXXGOOOXXXXXXXXXXXXXXXXGOOOOOOOOXXXXXXXXXXX,0,0,0
22827,81,0,81,17,402,0,0,408,367,41,GOOXXXXXXXXXXXXXXXXXGOOOOOXXXXXXXXXXXXXXGOOOOOOOOOXXXXXXXXXXGOOOOXXXXXXXXXXXXXXXGOOXXXXXXXXXXXXXXXXXGOOOOOXXXXXXXXXXXXXXGOOOOOOXXXXXXXXXXXXXGOOOOOOOOOXXXXXXXXXXGOOOOOOOOXXXXXXXXXXXGOOXXXXXXXXXXXXXXXXXGOOOOOXXXXXXXXXXXXXXGOOOXXXXXXXXXXXXXXXXGOOOOOOOOXXXXXXXXXXX,0,0,0
22848,81,0,81,20,399,0,0,405,366,39,GOOXXXXXXXXXXXXXXXXXGOOOOOXXXXXXXXXXXXXXGOOOOOOOOOXXXXXXXXXXGOOOOXXXXXXXXXXXXXXXGOOXXXXXXXXXXXXXXXXXGOOOOOXXXXXXXXXXXXXXGOOOOOOXXXXXXXXXXXXXGOOOOOOOOOXXXXXXXXXXGOOOOOOOOXXXXXXXXXXXGOOXXXXXXXXXXXXXXXXXGOOOOOXXXXXXXXXXXXXXGOOOXXXXXXXXXXXXXXXXGOOOOOOOOXXXXXXXXXXX,0,0,0
22869,81,0,81,14,405,0,0,409,366,43,GOOXXXXXXXXXXXXXXXXXGOOOOOXXXXXXXXXXXXXXGOOOOOOOOOXXXXXXXXXXGOOOOXXXXXXXXXXXXXXXGOOXXXXXXXXXXXXXXXXXGOOOOOXXXXXXXXXXXXXXGOOOOOOXXXXXXXXXXXXXGOOOOOOOOOXXXXXXXXXXGOOOOOOOOXXXXXXXXXXXGOOXXXXXXXXXXXXXXXXXGOOOOOXXXXXXXXXXXXXXGOOOXXXXXXXXXXXXXXXXGOOOOOOOOXXXXXXXXXXX,0,0,0

22890,81,0,81,15,404,0,0,409,365,44,GOOXXXXXXXXXXXXXXXXXGOOOOOXXXXXXXXXXXXXXGOOOOOOOOOXXXXXXXXXXGOOOOXXXXXXXXXXXXXXXGOOXXXXXXXXXXXXXXXXXGOOOOOXXXXXXXXXXXXXXGOOOOOOXXXXXXXXXXXXXGOOOOOOOOOXXXXXXXXXXGOOOOOOOOXXXXXXXXXXXGOOXXXXXXXXXXXXXXXXXGOOOOOXXXXXXXXXXXXXXGOOOXXXXXXXXXXXXXXXXGOOOOOOOOXXXXXXXXXXX,0,0,0
22911,81,0,81,16,403,0,0,408,363,45,GOOXXXXXXXXXXXXXXXXXGOOOOOXXXXXXXXXXXXXXGOOOOOOOOOXXXXXXXXXXGOOOOXXXXXXXXXXXXXXXGOOXXXXXXXXXXXXXXXXXGOOOOOXXXXXXXXXXXXXXGOOOOOOXXXXXXXXXXXXXGOOOOOOOOOXXXXXXXXXXGOOOOOOOOXXXXXXXXXXXGOOXXXXXXXXXXXXXXXXXGOOOOOXXXXXXXXXXXXXXGOOOXXXXXXXXXXXXXXXXGOOOOOOOOXXXXXXXXXXX,0,0,0
22932,81,0,81,13,406,0,0,412,363,49,GOOXXXXXXXXXXXXXXXXXGOOOOOXXXXXXXXXXXXXXGOOOOOOOOOXXXXXXXXXXGOOOOXXXXXXXXXXXXXXXGOOXXXXXXXXXXXXXXXXXGOOOOOXXXXXXXXXXXXXXGOOOOOOXXXXXXXXXXXXXGOOOOOOOOOXXXXXXXXXXGOOOOOOOOXXXXXXXXXXXGOOXXXXXXXXXXXXXXXXXGOOOOOXXXXXXXXXXXXXXGOOOXXXXXXXXXXXXXXXXGOOOOOOOOXXXXXXXXXXX,0,0,0
22953,81,0,81,13,406,0,0,411,364,47,GOOXXXXXXXXXXXXXXXXXGOOOOOXXXXXXXXXXXXXXGOOOOOOOOOXXXXXXXXXXGOOOOXXXXXXXXXXXXXXXGOOXXXXXXXXXXXXXXXXXGOOOOOXXXXXXXXXXXXXXGOOOOOOXXXXXXXXXXXXXGOOOOOOOOOXXXXXXXXXXGOOOOOOOOXXXXXXXXXXXGOOXXXXXXXXXXXXXXXXXGOOOOOXXXXXXXXXXXXXXGOOOXXXXXXXXXXXXXXXXGOOOOOOOOXXXXXXXXXXX,0,0,0
22974,81,0,81,17,402,0,0,407,365,42,GOOXXXXXXXXXXXXXXXXXGOOOOOXXXXXXXXXXXXXXGOOOOOOOOOXXXXXXXXXXGOOOOXXXXXXXXXXXXXXXGOOXXXXXXXXXXXXXXXXXGOOOOOXXXXXXXXXXXXXXGOOOOOOXXXXXXXXXXXXXGOOOOOOOOOXXXXXXXXXXGOOOOOOOOXXXXXXXXXXXGOOXXXXXXXXXXXXXXXXXGOOOOOXXXXXXXXXXXXXXGOOOXXXXXXXXXXXXXXXXGOOOOOOOOXXXXXXXXXXX,0,0,0

22995,81,0,81,17,402,0,0,407,365,42,GOOXXXXXXXXXXXXXXXXXGOOOOOXXXXXXXXXXXXXXGOOOOOOOOOXXXXXXXXXXGOOOOXXXXXXXXXXXXXXXGOOXXXXXXXXXXXXXXXXXGOOOOOXXXXXXXXXXXXXXGOOOOOOXXXXXXXXXXXXXGOOOOOOOOOXXXXXXXXXXGOOOOOOOOXXXXXXXXXXXGOOXXXXXXXXXXXXXXXXXGOOOOOXXXXXXXXXXXXXXGOOOXXXXXXXXXXXXXXXXGOOOOOOOOXXXXXXXXXXX,0,0,0
23016,81,0,81,18,401,0,0,406,364,42,GOOXXXXXXXXXXXXXXXXXGOOOOOXXXXXXXXXXXXXXGOOOOOOOOOXXXXXXXXXXGOOOOXXXXXXXXXXXXXXXGOOXXXXXXXXXXXXXXXXXGOOOOOXXXXXXXXXXXXXXGOOOOOOXXXXXXXXXXXXXGOOOOOOOOOXXXXXXXXXXGOOOOOOOOXXXXXXXXXXXGOOXXXXXXXXXXXXXXXXXGOOOOOXXXXXXXXXXXXXXGOOOXXXXXXXXXXXXXXXXGOOOOOOOOXXXXXXXXXXX,0,0,0
23037,81,0,81,16,403,0,0,408,364,44,GOOXXXXXXXXXXXXXXXXXGOOOOOXXXXXXXXXXXXXXGOOOOOOOOOXXXXXXXXXXGOOOOXXXXXXXXXXXXXXXGOOXXXXXXXXXXXXXXXXXGOOOOOXXXXXXXXXXXXXXGOOOOOOXXXXXXXXXXXXXGOOOOOOOOOXXXXXXXXXXGOOOOOOOOXXXXXXXXXXXGOOXXXXXXXXXXXXXXXXXGOOOOOXXXXXXXXXXXXXXGOOOXXXXXXXXXXXXXXXXGOOOOOOOOXXXXXXXXXXX,0,0,0
23058,81,0,81,15,404,0,0,408,366,42,GOOXXXXXXXXXXXXXXXXXGOOOOOXXXXXXXXXXXXXXGOOOOOOOOOXXXXXXXXXXGOOOOXXXXXXXXXXXXXXXGOOXXXXXXXXXXXXXXXXXGOOOOOXXXXXXXXXXXXXXGOOOOOOXXXXXXXXXXXXXGOOOOOOOOOXXXXXXXXXXGOOOOOOOOXXXXXXXXXXXGOOXXXXXXXXXXXXXXXXXGOOOOOXXXXXXXXXXXXXXGOOOXXXXXXXXXXXXXXXXGOOOOOOOOXXXXXXXXXXX,0,0,0
23079,81,0,81,14,405,0,0,410,365,45,GOOXXXXXXXXXXXXXXXXXGOOOOOXXXXXXXXXXXXXXGOOOOOOOOOXXXXXXXXXXGOOOOXXXXXXXXXXXXXXXGOOXXXXXXXXXXXXXXXXXGOOOOOXXXXXXXXXXXXXXGOOOOOOXXXXXXXXXXXXXGOOOOOOOOOXXXXXXXXXXGOOOOOOOOXXXXXXXXXXXGOOXXXXXXXXXXXXXXXXXGOOOOOXXXXXXXXXXXXXXGOOOXXXXXXXXXXXXXXXXGOOOOOOOOXXXXXXXXXXX,0,0,0

23100,81,0,81,13,406,0,0,411,364,47,GOOXXXXXXXXXXXXXXXXXGOOOOOXXXXXXXXXXXXXXGOOOOOOOOOXXXXXXXXXXGOOOOXXXXXXXXXXXXXXXGOOXXXXXXXXXXXXXXXXXGOOOOOXXXXXXXXXXXXXXGOOOOOOXXXXXXXXXXXXXGOOOOOOOOOXXXXXXXXXXGOOOOOOOOXXXXXXXXXXXGOOXXXXXXXXXXXXXXXXXGOOOOOXXXXXXXXXXXXXXGOOOXXXXXXXXXXXXXXXXGOOOOOOOOXXXXXXXXXXX,0,0,0
23121,81,0,81,15,404,0,0,409,365,44,GOOXXXXXXXXXXXXXXXXXGOOOOOXXXXXXXXXXXXXXGOOOOOOOOOXXXXXXXXXXGOOOOXXXXXXXXXXXXXXXGOOXXXXXXXXXXXXXXXXXGOOOOOXXXXXXXXXXXXXXGOOOOOOXXXXXXXXXXXXXGOOOOOOOOOXXXXXXXXXXGOOOOOOOOXXXXXXXXXXXGOOXXXXXXXXXXXXXXXXXGOOOOOXXXXXXXXXXXXXXGOOOXXXXXXXXXXXXXXXXGOOOOOOOOXXXXXXXXXXX,0,0,0
23142,81,0,81,17,402,0,0,407,366,41,GOOXXXXXXXXXXXXXXXXXGOOOOOXXXXXXXXXXXXXXGOOOOOOOOOXXXXXXXXXXGOOOOXXXXXXXXXXXXXXXGOOXXXXXXXXXXXXXXXXXGOOOOOXXXXXXXXXXXXXXGOOOOOOXXXXXXXXXXXXXGOOOOOOOOOXXXXXXXXXXGOOOOOOOOXXXXXXXXXXXGOOXXXXXXXXXXXXXXXXXGOOOOOXXXXXXXXXXXXXXGOOOXXXXXXXXXXXXXXXXGOOOOOOOOXXXXXXXXXXX,0,0,0
23163,81,0,81,21,398,0,0,403,364,39,GOOXXXXXXXXXXXXXXXXXGOOOOOXXXXXXXXXXXXXXGOOOOOOOOOXXXXXXXXXXGOOOOXXXXXXXXXXXXXXXGOOXXXXXXXXXXXXXXXXXGOOOOOXXXXXXXXXXXXXXGOOOOOOXXXXXXXXXXXXXGOOOOOOOOOXXXXXXXXXXGOOOOOOOOXXXXXXXXXXXGOOXXXXXXXXXXXXXXXXXGOOOOOXXXXXXXXXXXXXXGOOOXXXXXXXXXXXXXXXXGOOOOOOOOXXXXXXXXXXX,0,0,0
23184,81,0,81,21,398,0,0,403,364,39,GOOXXXXXXXXXXXXXXXXXGOOOOOXXXXXXXXXXXXXXGOOOOOOOOOXXXXXXXXXXGOOOOXXXXXXXXXXXXXXXGOOXXXXXXXXXXXXXXXXXGOOOOOXXXXXXXXXXXXXXGOOOOOOXXXXXXXXXXXXXGOOOOOOOOOXXXXXXXXXXGOOOOOOOOXXXXXXXXXXXGOOXXXXXXXXXXXXXXXXXGOOOOOXXXXXXXXXXXXXXGOOOXXXXXXXXXXXXXXXXGOOOOOOOOXXXXXXXXXXX,0,0,0

23205,81,0,81,23,396,0,0,401,363,38,GOOXXXXXXXXXXXXXXXXXGOOOOOXXXXXXXXXXXXXXGOOOOOOOOOXXXXXXXXXXGOOOOXXXXXXXXXXXXXXXGOOXXXXXXXXXXXXXXXXXGOOOOOXXXXXXXXXXXXXXGOOOOOOXXXXXXXXXXXXXGOOOOOOOOOXXXXXXXXXXGOOOOOOOOXXXXXXXXXXXGOOXXXXXXXXXXXXXXXXXGOOOOOXXXXXXXXXXXXXXGOOOXXXXXXXXXXXXXXXXGOOOOOOOOXXXXXXXXXXX,0,0,0
23226,81,0,81,22,397,0,0,402,366,36,GOOXXXXXXXXXXXXXXXXXGOOOOOXXXXXXXXXXXXXXGOOOOOOOOOXXXXXXXXXXGOOOOXXXXXXXXXXXXXXXGOOXXXXXXXXXXXXXXXXXGOOOOOXXXXXXXXXXXXXXGOOOOOOXXXXXXXXXXXXXGOOOOOOOOOXXXXXXXXXXGOOOOOOOOXXXXXXXXXXXGOOXXXXXXXXXXXXXXXXXGOOOOOXXXXXXXXXXXXXXGOOOXXXXXXXXXXXXXXXXGOOOOOOOOXXXXXXXXXXX,0,0,0
23247,81,0,81,24,395,0,0,400,364,36,GOOXXXXXXXXXXXXXXXXXGOOOOOXXXXXXXXXXXXXXGOOOOOOOOOXXXXXXXXXXGOOOOXXXXXXXXXXXXXXXGOOXXXXXXXXXXXXXXXXXGOOOOOXXXXXXXXXXXXXXGOOOOOOXXXXXXXXXXXXXGOOOOOOOOOXXXXXXXXXXGOOOOOOOOXXXXXXXXXXXGOOXXXXXXXXXXXXXXXXXGOOOOOXXXXXXXXXXXXXXGOOOXXXXXXXXXXXXXXXXGOOOOOOOOXXXXXXXXXXX,0,0,0
23268,81,0,81,23,396,0,0,400,363,37,GOOXXXXXXXXXXXXXXXXXGOOOOOXXXXXXXXXXXXXXGOOOOOOOOOXXXXXXXXXXGOOOOXXXXXXXXXXXXXXXGOOXXXXXXXXXXXXXXXXXGOOOOOXXXXXXXXXXXXXXGOOOOOOXXXXXXXXXXXXXGOOOOOOOOOXXXXXXXXXXGOOOOOOOOXXXXXXXXXXXGOOXXXXXXXXXXXXXXXXXGOOOOOXXXXXXXXXXXXXXGOOOXXXXXXXXXXXXXXXXGOOOOOOOOXXXXXXXXXXX,0,0,0
23289,81,0,81,22,397,0,0,401,364,37,GOOXXXXXXXXXXXXXXXXXGOOOOOXXXXXXXXXXXXXXGOOOOOOOOOXXXXXXXXXXGOOOOXXXXXXXXXXXXXXXGOOXXXXXXXXXXXXXXXXXGOOOOOXXXXXXXXXXXXXXGOOOOOOXXXXXXXXXXXXXGOOOOOOOOOXXXXXXXXXXGOOOOOOOOXXXXXXXXXXXGOOXXXXXXXXXXXXXXXXXGOOOOOXXXXXXXXXXXXXXGOOOXXXXXXXXXXXXXXXXGOOOOOOOOXXXXXXXXXXX,0,0,0

23310,81,0,81,24,395,0,0,400,364,36,GOOXXXXXXXXXXXXXXXXXGOOOOOXXXXXXXXXXXXXXGOOOOOOOOOXXXXXXXXXXGOOOOXXXXXXXXXXXXXXXGOOXXXXXXXXXXXXXXXXXGOOOOOXXXXXXXXXXXXXXGOOOOOOXXXXXXXXXXXXXGOOOOOOOOOXXXXXXXXXXGOOOOOOOOXXXXXXXXXXXGOOXXXXXXXXXXXXXXXXXGOOOOOXXXXXXXXXXXXXXGOOOXXXXXXXXXXXXXXXXGOOOOOOOOXXXXXXXXXXX,0,0,0
23331,81,0,81,23,396,0,0,401,365,36,GOOXXXXXXXXXXXXXXXXXGOOOOOXXXXXXXXXXXXXXGOOOOOOOOOXXXXXXXXXXGOOOOXXXXXXXXXXXXXXXGOOXXXXXXXXXXXXXXXXXGOOOOOXXXXXXXXXXXXXXGOOOOOOXXXXXXXXXXXXXGOOOOOOOOOXXXXXXXXXXGOOOOOOOOXXXXXXXXXXXGOOXXXXXXXXXXXXXXXXXGOOOOOXXXXXXXXXXXXXXGOOOXXXXXXXXXXXXXXXXGOOOOOOOOXXXXXXXXXXX,0,0,0
23352,81,0,81,24,395,0,0,400,365,35,GOOXXXXXXXXXXXXXXXXXGOOOOOXXXXXXXXXXXXXXGOOOOOOOOOXXXXXXXXXXGOOOOXXXXXXXXXXXXXXXGOOXXXXXXXXXXXXXXXXXGOOOOOXXXXXXXXXXXXXXGOOOOOOXXXXXXXXXXXXXGOOOOOOOOOXXXXXXXXXXGOOOOOOOOXXXXXXXXXXXGOOXXXXXXXXXXXXXXXXXGOOOOOXXXXXXXXXXXXXXGOOOXXXXXXXXXXXXXXXXGOOOOOOOOXXXXXXXXXXX,0,0,0
23373,81,0,81,21,398,0,0,402,366,36,GOOXXXXXXXXXXXXXXXXXGOOOOOXXXXXXXXXXXXXXGOOOOOOOOOXXXXXXXXXXGOOOOXXXXXXXXXXXXXXXGOOXXXXXXXXXXXXXXXXXGOOOOOXXXXXXXXXXXXXXGOOOOOOXXXXXXXXXXXXXGOOOOOOOOOXXXXXXXXXXGOOOOOOOOXXXXXXXXXXXGOOXXXXXXXXXXXXXXXXXGOOOOOXXXXXXXXXXXXXXGOOOXXXXXXXXXXXXXXXXGOOOOOOOOXXXXXXXXXXX,0,0,0
23394,81,0,81,22,397,0,0,402,365,37,GOOXXXXXXXXXXXXXXXXXGOOOOOXXXXXXXXXXXXXXGOOOOOOOOOXXXXXXXXXXGOOOOXXXXXXXXXXXXXXXGOOXXXXXXXXXXXXXXXXXGOOOOOXXXXXXXXXXXXXXGOOOOOOXXXXXXXXXXXXXGOOOOOOOOOXXXXXXXXXXGOOOOOOOOXXXXXXXXXXXGOOXXXXXXXXXXXXXXXXXGOOOOOXXXXXXXXXXXXXXGOOOXXXXXXXXXXXXXXXXGOOOOOOOOXXXXXXXXXXX,0,0,0

23415,81,0,81,21,398,0,0,403,367,36,GOOXXXXXXXXXXXXXXXXXGOOOOOXXXXXXXXXXXXXXGOOOOOOOOOXXXXXXXXXXGOOOOXXXXXXXXXXXXXXXGOOXXXXXXXXXXXXXXXXXGOOOOOXXXXXXXXXXXXXXGOOOOOOXXXXXXXXXXXXXGOOOOOOOOOXXXXXXXXXXGOOOOOOOOXXXXXXXXXXXGOOXXXXXXXXXXXXXXXXXGOOOOOXXXXXXXXXXXXXXGOOOXXXXXXXXXXXXXXXXGOOOOOOOOXXXXXXXXXXX,0,0,0
23436,81,0,81,22,397,0,0,402,365,37,GOOXXXXXXXXXXXXXXXXXGOOOOOXXXXXXXXXXXXXXGOOOOOOOOOXXXXXXXXXXGOOOOXXXXXXXXXXXXXXXGOOXXXXXXXXXXXXXXXXXGOOOOOXXXXXXXXXXXXXXGOOOOOOXXXXXXXXXXXXXGOOOOOOOOOXXXXXXXXXXGOOOOOOOOXXXXXXXXXXXGOOXXXXXXXXXXXXXXXXXGOOOOOXXXXXXXXXXXXXXGOOOXXXXXXXXXXXXXXXXGOOOOOOOOXXXXXXXXXXX,0,0,0
23457,81,0,81,21,398,0,0,403,364,39,GOOXXXXXXXXXXXXXXXXXGOOOOOXXXXXXXXXXXXXXGOOOOOOOOOXXXXXXXXXXGOOOOXXXXXXXXXXXXXXXGOOXXXXXXXXXXXXXXXXXGOOOOOXXXXXXXXXXXXXXGOOOOOOXXXXXXXXXXXXXGOOOOOOOOOXXXXXXXXXXGOOOOOOOOXXXXXXXXXXXGOOXXXXXXXXXXXXXXXXXGOOOOOXXXXXXXXXXXXXXGOOOXXXXXXXXXXXXXXXXGOOOOOOOOXXXXXXXXXXX,0,0,0
23478,81,0,81,17,402,0,0,406,365,41,GOOXXXXXXXXXXXXXXXXXGOOOOOXXXXXXXXXXXXXXGOOOOOOOOOXXXXXXXXXXGOOOOXXXXXXXXXXXXXXXGOOXXXXXXXXXXXXXXXXXGOOOOOXXXXXXXXXXXXXXGOOOOOOXXXXXXXXXXXXXGOOOOOOOOOXXXXXXXXXXGOOOOOOOOXXXXXXXXXXXGOOXXXXXXXXXXXXXXXXXGOOOOOXXXXXXXXXXXXXXGOOOXXXXXXXXXXXXXXXXGOOOOOOOOXXXXXXXXXXX,0,0,0
23499,81,0,81,14,405,0,0,410,367,43,GOOXXXXXXXXXXXXXXXXXGOOOOOXXXXXXXXXXXXXXGOOOOOOOOOXXXXXXXXXXGOOOOXXXXXXXXXXXXXXXGOOXXXXXXXXXXXXXXXXXGOOOOOXXXXXXXXXXXXXXGOOOOOOXXXXXXXXXXXXXGOOOOOOOOOXXXXXXXXXXGOOOOOOOOXXXXXXXXXXXGOOXXXXXXXXXXXXXXXXXGOOOOOXXXXXXXXXXXXXXGOOOXXXXXXXXXXXXXXXXGOOOOOOOOXXXXXXXXXXX,0,0,0

23520,81,0,81,16,403,0,0,408,365,43,GOOXXXXXXXXXXXXXXXXXGOOOOOXXXXXXXXXXXXXXGOOOOOOOOOXXXXXXXXXXGOOOOXXXXXXXXXXXXXXXGOOXXXXXXXXXXXXXXXXXGOOOOOXXXXXXXXXXXXXXGOOOOOOXXXXXXXXXXXXXGOOOOOOOOOXXXXXXXXXXGOOOOOOOOXXXXXXXXXXXGOOXXXXXXXXXXXXXXXXXGOOOOOXXXXXXXXXXXXXXGOOOXXXXXXXXXXXXXXXXGOOOOOOOOXXXXXXXXXXX,0,0,0
23541,81,0,81,17,402,0,0,407,365,42,GOOXXXXXXXXXXXXXXXXXGOOOOOXXXXXXXXXXXXXXGOOOOOOOOOXXXXXXXXXXGOOOOXXXXXXXXXXXXXXXGOOXXXXXXXXXXXXXXXXXGOOOOOXXXXXXXXXXXXXXGOOOOOOXXXXXXXXXXXXXGOOOOOOOOOXXXXXXXXXXGOOOOOOOOXXXXXXXXXXXGOOXXXXXXXXXXXXXXXXXGOOOOOXXXXXXXXXXXXXXGOOOXXXXXXXXXXXXXXXXGOOOOOOOOXXXXXXXXXXX,0,0,0
23562,81,0,81,17,402,0,0,407,366,41,GOOXXXXXXXXXXXXXXXXXGOOOOOXXXXXXXXXXXXXXGOOOOOOOOOXXXXXXXXXXGOOOOXXXXXXXXXXXXXXXGOOXXXXXXXXXXXXXXXXXGOOOOOXXXXXXXXXXXXXXGOOOOOOXXXXXXXXXXXXXGOOOOOOOOOXXXXXXXXXXGOOOOOOOOXXXXXXXXXXXGOOXXXXXXXXXXXXXXXXXGOOOOOXXXXXXXXXXXXXXGOOOXXXXXXXXXXXXXXXXGOOOOOOOOXXXXXXXXXXX,0,0,0
23583,81,0,81,19,400,0,0,405,367,38,GOOXXXXXXXXXXXXXXXXXGOOOOOXXXXXXXXXXXXXXGOOOOOOOOOXXXXXXXXXXGOOOOXXXXXXXXXXXXXXXGOOXXXXXXXXXXXXXXXXXGOOOOOXXXXXXXXXXXXXXGOOOOOOXXXXXXXXXXXXXGOOOOOOOOOXXXXXXXXXXGOOOOOOOOXXXXXXXXXXXGOOXXXXXXXXXXXXXXXXXGOOOOOXXXXXXXXXXXXXXGOOOXXXXXXXXXXXXXXXXGOOOOOOOOXXXXXXXXXXX,0,0,0
23604,81,0,81,20,399,0,0,404,365,39,GOOXXXXXXXXXXXXXXXXXGOOOOOXXXXXXXXXXXXXXGOOOOOOOOOXXXXXXXXXXGOOOOXXXXXXXXXXXXXXXGOOXXXXXXXXXXXXXXXXXGOOOOOXXXXXXXXXXXXXXGOOOOOOXXXXXXXXXXXXXGOOOOOOOOOXXXXXXXXXXGOOOOOOOOXXXXXXXXXXXGOOXXXXXXXXXXXXXXXXXGOOOOOXXXXXXXXXXXXXXGOOOXXXXXXXXXXXXXXXXGOOOOOOOOXXXXXXXXXXX,0,0,0

23625,81,0,81,18,401,0,0,406,367,39,GOOXXXXXXXXXXXXXXXXXGOOOOOXXXXXXXXXXXXXXGOOOOOOOOOXXXXXXXXXXGOOOOXXXXXXXXXXXXXXXGOOXXXXXXXXXXXXXXXXXGOOOOOXXXXXXXXXXXXXXGOOOOOOXXXXXXXXXXXXXGOOOOOOOOOXXXXXXXXXXGOOOOOOOOXXXXXXXXXXXGOOXXXXXXXXXXXXXXXXXGOOOOOXXXXXXXXXXXXXXGOOOXXXXXXXXXXXXXXXXGOOOOOOOOXXXXXXXXXXX,0,0,0
23646,81,0,81,20,399,0,0,404,368,36,GOOXXXXXXXXXXXXXXXXXGOOOOOXXXXXXXXXXXXXXGOOOOOOOOOXXXXXXXXXXGOOOOXXXXXXXXXXXXXXXGOOXXXXXXXXXXXXXXXXXGOOOOOXXXXXXXXXXXXXXGOOOOOOXXXXXXXXXXXXXGOOOOOOOOOXXXXXXXXXXGOOOOOOOOXXXXXXXXXXXGOOXXXXXXXXXXXXXXXXXGOOOOOXXXXXXXXXXXXXXGOOOXXXXXXXXXXXXXXXXGOOOOOOOOXXXXXXXXXXX,0,0,0
23667,81,0,81,20,399,0,0,404,369,35,GOOXXXXXXXXXXXXXXXXXGOOOOOXXXXXXXXXXXXXXGOOOOOOOOOXXXXXXXXXXGOOOOXXXXXXXXXXXXXXXGOOXXXXXXXXXXXXXXXXXGOOOOOXXXXXXXXXXXXXXGOOOOOOXXXXXXXXXXXXXGOOOOOOOOOXXXXXXXXXXGOOOOOOOOXXXXXXXXXXXGOOXXXXXXXXXXXXXXXXXGOOOOOXXXXXXXXXXXXXXGOOOXXXXXXXXXXXXXXXXGOOOOOOOOXXXXXXXXXXX,0,0,0
23688,81,0,81,24,395,0,0,400,369,31,GOOXXXXXXXXXXXXXXXXXGOOOOOXXXXXXXXXXXXXXGOOOOOOOOOXXXXXXXXXXGOOOOXXXXXXXXXXXXXXXGOOXXXXXXXXXXXXXXXXXGOOOOOXXXXXXXXXXXXXXGOOOOOOXXXXXXXXXXXXXGOOOOOOOOOXXXXXXXXXXGOOOOOOOOXXXXXXXXXXXGOOXXXXXXXXXXXXXXXXXGOOOOOXXXXXXXXXXXXXXGOOOXXXXXXXXXXXXXXXXGOOOOOOOOXXXXXXXXXXX,0,0,0
23709,81,0,81,23,396,0,0,402,367,35,GOOXXXXXXXXXXXXXXXXXGOOOOOXXXXXXXXXXXXXXGOOOOOOOOOXXXXXXXXXXGOOOOXXXXXXXXXXXXXXXGOOXXXXXXXXXXXXXXXXXGOOOOOXXXXXXXXXXXXXXGOOOOOOXXXXXXXXXXXXXGOOOOOOOOOXXXXXXXXXXGOOOOOOOOXXXXXXXXXXXGOOXXXXXXXXXXXXXXXXXGOOOOOXXXXXXXXXXXXXXGOOOXXXXXXXXXXXXXXXXGOOOOOOOOXXXXXXXXXXX,0,0,0

23730,81,0,81,25,394,0,0,400,366,34,GOOXXXXXXXXXXXXXXXXXGOOOOOXXXXXXXXXXXXXXGOOOOOOOOOXXXXXXXXXXGOOOOXXXXXXXXXXXXXXXGOOXXXXXXXXXXXXXXXXXGOOOOOXXXXXXXXXXXXXXGOOOOOOXXXXXXXXXXXXXGOOOOOOOOOXXXXXXXXXXGOOOOOOOOXXXXXXXXXXXGOOXXXXXXXXXXXXXXXXXGOOOOOXXXXXXXXXXXXXXGOOOXXXXXXXXXXXXXXXXGOOOOOOOOXXXXXXXXXXX,0,0,0
23751,81,0,81,26,393,0,0,400,365,35,GOOXXXXXXXXXXXXXXXXXGOOOOOXXXXXXXXXXXXXXGOOOOOOOOOXXXXXXXXXXGOOOOXXXXXXXXXXXXXXXGOOXXXXXXXXXXXXXXXXXGOOOOOXXXXXXXXXXXXXXGOOOOOOXXXXXXXXXXXXXGOOOOOOOOOXXXXXXXXXXGOOOOOOOOXXXXXXXXXXXGOOXXXXXXXXXXXXXXXXXGOOOOOXXXXXXXXXXXXXXGOOOXXXXXXXXXXXXXXXXGOOOOOOOOXXXXXXXXXXX,0,0,0
23772,81,0,81,27,392,0,0,399,366,33,GOOXXXXXXXXXXXXXXXXXGOOOOOXXXXXXXXXXXXXXGOOOOOOOOOXXXXXXXXXXGOOOOXXXXXXXXXXXXXXXGOOXXXXXXXXXXXXXXXXXGOOOOOXXXXXXXXXXXXXXGOOOOOOXXXXXXXXXXXXXGOOOOOOOOOXXXXXXXXXXGOOOOOOOOXXXXXXXXXXXGOOXXXXXXXXXXXXXXXXXGOOOOOXXXXXXXXXXXXXXGOOOXXXXXXXXXXXXXXXXGOOOOOOOOXXXXXXXXXXX,0,0,0
23793,81,0,81,21,398,0,0,404,366,38,GOOXXXXXXXXXXXXXXXXXGOOOOOXXXXXXXXXXXXXXGOOOOOOOOOXXXXXXXXXXGOOOOXXXXXXXXXXXXXXXGOOXXXXXXXXXXXXXXXXXGOOOOOXXXXXXXXXXXXXXGOOOOOOXXXXXXXXXXXXXGOOOOOOOOOXXXXXXXXXXGOOOOOOOOXXXXXXXXXXXGOOXXXXXXXXXXXXXXXXXGOOOOOXXXXXXXXXXXXXXGOOOXXXXXXXXXXXXXXXXGOOOOOOOOXXXXXXXXXXX,0,0,0
23814,81,0,81,22,397,0,0,403,366,37,GOOXXXXXXXXXXXXXXXXXGOOOOOXXXXXXXXXXXXXXGOOOOOOOOOXXXXXXXXXXGOOOOXXXXXXXXXXXXXXXGOOXXXXXXXXXXXXXXXXXGOOOOOXXXXXXXXXXXXXXGOOOOOOXXXXXXXXXXXXXGOOOOOOOOOXXXXXXXXXXGOOOOOOOOXXXXXXXXXXXGOOXXXXXXXXXXXXXXXXXGOOOOOXXXXXXXXXXXXXXGOOOXXXXXXXXXXXXXXXXGOOOOOOOOXXXXXXXXXXX,0,0,0

23835,81,0,81,21,398,0,0,404,368,36,GOOXXXXXXXXXXXXXXXXXGOOOOOXXXXXXXXXXXXXXGOOOOOOOOOXXXXXXXXXXGOOOOXXXXXXXXXXXXXXXGOOXXXXXXXXXXXXXXXXXGOOOOOXXXXXXXXXXXXXXGOOOOOOXXXXXXXXXXXXXGOOOOOOOOOXXXXXXXXXXGOOOOOOOOXXXXXXXXXXXGOOXXXXXXXXXXXXXXXXXGOOOOOXXXXXXXXXXXXXXGOOOXXXXXXXXXXXXXXXXGOOOOOOOOXXXXXXXXXXX,0,0,0
23856,81,0,81,23,396,0,0,402,365,37,GOOXXXXXXXXXXXXXXXXXGOOOOOXXXXXXXXXXXXXXGOOOOOOOOOXXXXXXXXXXGOOOOXXXXXXXXXXXXXXXGOOXXXXXXXXXXXXXXXXXGOOOOOXXXXXXXXXXXXXXGOOOOOOXXXXXXXXXXXXXGOOOOOOOOOXXXXXXXXXXGOOOOOOOOXXXXXXXXXXXGOOXXXXXXXXXXXXXXXXXGOOOOOXXXXXXXXXXXXXXGOOOXXXXXXXXXXXXXXXXGOOOOOOOOXXXXXXXXXXX,0,0,0
23877,81,0,81,20,399,0,0,405,365,40,GOOXXXXXXXXXXXXXXXXXGOOOOOXXXXXXXXXXXXXXGOOOOOOOOOXXXXXXXXXXGOOOOXXXXXXXXXXXXXXXGOOXXXXXXXXXXXXXXXXXGOOOOOXXXXXXXXXXXXXXGOOOOOOXXXXXXXXXXXXXGOOOOOOOOOXXXXXXXXXXGOOOOOOOOXXXXXXXXXXXGOOXXXXXXXXXXXXXXXXXGOOOOOXXXXXXXXXXXXXXGOOOXXXXXXXXXXXXXXXXGOOOOOOOOXXXXXXXXXXX,0,0,0
23898,81,0,81,22,397,0,0,403,366,37,GOOXXXXXXXXXXXXXXXXXGOOOOOXXXXXXXXXXXXXXGOOOOOOOOOXXXXXXXXXXGOOOOXXXXXXXXXXXXXXXGOOXXXXXXXXXXXXXXXXXGOOOOOXXXXXXXXXXXXXXGOOOOOOXXXXXXXXXXXXXGOOOOOOOOOXXXXXXXXXXGOOOOOOOOXXXXXXXXXXXGOOXXXXXXXXXXXXXXXXXGOOOOOXXXXXXXXXXXXXXGOOOXXXXXXXXXXXXXXXXGOOOOOOOOXXXXXXXXXXX,0,0,0
23919,82,1,81,20,398,0,0,404,367,37,GOOXXXXXXXXXXXXXXXXXGOOOOOXXXXXXXXXXXXXXGOOOOOOOOOXXXXXXXXXXGOOOOXXXXXXXXXXXXXXXGOOXXXXXXXXXXXXXXXXXGOOOOOXXXXXXXXXXXXXXGOOOOOOXXXXXXXXXXXXXGOOOOOOOOOXXXXXXXXXXGOOOOOOOOAXXXXXXXXXXGOOXXXXXXXXXXXXXXXXXGOOOOOXXXXXXXXXXXXXXGOOOXXXXXXXXXXXXXXXXGOOOOOOOOXXXXXXXXXXX,0,0,0

23940,82,1,81,18,400,0,0,406,366,40,GOOXXXXXXXXXXXXXXXXXGOOOOOXXXXXXXXXXXXXXGOOOOOOOOOXXXXXXXXXXGOOOOXXXXXXXXXXXXXXXGOOXXXXXXXXXXXXXXXXXGOOOOOXXXXXXXXXXXXXXGOOOOOOXXXXXXXXXXXXXGOOOOOOOOOXXXXXXXXXXGOOOOOOOOAXXXXXXXXXXGOOXXXXXXXXXXXXXXXXXGOOOOOXXXXXXXXXXXXXXGOOOXXXXXXXXXXXXXXXXGOOOOOOOOXXXXXXXXXXX,0,0,0
23961,82,1,81,17,401,0,0,407,366,41,GOOXXXXXXXXXXXXXXXXXGOOOOOXXXXXXXXXXXXXXGOOOOOOOOOXXXXXXXXXXGOOOOXXXXXXXXXXXXXXXGOOXXXXXXXXXXXXXXXXXGOOOOOXXXXXXXXXXXXXXGOOOOOOXXXXXXXXXXXXXGOOOOOOOOOXXXXXXXXXXGOOOOOOOOAXXXXXXXXXXGOOXXXXXXXXXXXXXXXXXGOOOOOXXXXXXXXXXXXXXGOOOXXXXXXXXXXXXXXXXGOOOOOOOOXXXXXXXXXXX,0,0,0
23982,82,1,81,18,400,0,0,406,367,39,GOOXXXXXXXXXXXXXXXXXGOOOOOXXXXXXXXXXXXXXGOOOOOOOOOXXXXXXXXXXGOOOOXXXXXXXXXXXXXXXGOOXXXXXXXXXXXXXXXXXGOOOOOXXXXXXXXXXXXXXGOOOOOOXXXXXXXXXXXXXGOOOOOOOOOXXXXXXXXXXGOOOOOOOOAXXXXXXXXXXGOOXXXXXXXXXXXXXXXXXGOOOOOXXXXXXXXXXXXXXGOOOXXXXXXXXXXXXXXXXGOOOOOOOOXXXXXXXXXXX,0,0,0
24003,82,0,82,19,399,0,0,405,367,38,GOOXXXXXXXXXXXXXXXXXGOOOOOXXXXXXXXXXXXXXGOOOOOOOOOXXXXXXXXXXGOOOOXXXXXXXXXXXXXXXGOOXXXXXXXXXXXXXXXXXGOOOOOXXXXXXXXXXXXXXGOOOOOOXXXXXXXXXXXXXGOOOOOOOOOXXXXXXXXXXGOOOOOOOOOXXXXXXXXXXGOOXXXXXXXXXXXXXXXXXGOOOOOXXXXXXXXXXXXXXGOOOXXXXXXXXXXXXXXXXGOOOOOOOOXXXXXXXXXXX,0,0,0
24024,82,0,82,18,400,0,0,406,367,39,GOOXXXXXXXXXXXXXXXXXGOOOOOXXXXXXXXXXXXXXGOOOOOOOOOXXXXXXXXXXGOOOOXXXXXXXXXXXXXXXGOOXXXXXXXXXXXXXXXXXGOOOOOXXXXXXXXXXXXXXGOOOOOOXXXXXXXXXXXXXGOOOOOOOOOXXXXXXXXXXGOOOOOOOOOXXXXXXXXXXGOOXXXXXXXXXXXXXXXXXGOOOOOXXXXXXXXXXXXXXGOOOXXXXXXXXXXXXXXXXGOOOOOOOOXXXXXXXXXXX,0,0,0

24045,82,0,82,21,397,0,0,403,366,37,GOOXXXXXXXXXXXXXXXXXGOOOOOXXXXXXXXXXXXXXGOOOOOOOOOXXXXXXXXXXGOOOOXXXXXXXXXXXXXXXGOOXXXXXXXXXXXXXXXXXGOOOOOXXXXXXXXXXXXXXGOOOOOOXXXXXXXXXXXXXGOOOOOOOOOXXXXXXXXXXGOOOOOOOOOXXXXXXXXXXGOOXXXXXXXXXXXXXXXXXGOOOOOXXXXXXXXXXXXXXGOOOXXXXXXXXXXXXXXXXGOOOOOOOOXXXXXXXXXXX,0,0,0
24066,82,0,82,22,396,0,0,402,368,34,GOOXXXXXXXXXXXXXXXXXGOOOOOXXXXXXXXXXXXXXGOOOOOOOOOXXXXXXXXXXGOOOOXXXXXXXXXXXXXXXGOOXXXXXXXXXXXXXXXXXGOOOOOXXXXXXXXXXXXXXGOOOOOOXXXXXXXXXXXXXGOOOOOOOOOXXXXXXXXXXGOOOOOOOOOXXXXXXXXXXGOOXXXXXXXXXXXXXXXXXGOOOOOXXXXXXXXXXXXXXGOOOXXXXXXXXXXXXXXXXGOOOOOOOOXXXXXXXXXXX,0,0,0
24087,82,0,82,21,397,0,0,403,366,37,GOOXXXXXXXXXXXXXXXXXGOOOOOXXXXXXXXXXXXXXGOOOOOOOOOXXXXXXXXXXGOOOOXXXXXXXXXXXXXXXGOOXXXXXXXXXXXXXXXXXGOOOOOXXXXXXXXXXXXXXGOOOOOOXXXXXXXXXXXXXGOOOOOOOOOXXXXXXXXXXGOOOOOOOOOXXXXXXXXXXGOOXXXXXXXXXXXXXXXXXGOOOOOXXXXXXXXXXXXXXGOOOXXXXXXXXXXXXXXXXGOOOOOOOOXXXXXXXXXXX,0,0,0
24108,82,0,82,18,400,0,0,404,365,39,GOOXXXXXXXXXXXXXXXXXGOOOOOXXXXXXXXXXXXXXGOOOOOOOOOXXXXXXXXXXGOOOOXXXXXXXXXXXXXXXGOOXXXXXXXXXXXXXXXXXGOOOOOXXXXXXXXXXXXXXGOOOOOOXXXXXXXXXXXXXGOOOOOOOOOXXXXXXXXXXGOOOOOOOOOXXXXXXXXXXGOOXXXXXXXXXXXXXXXXXGOOOOOXXXXXXXXXXXXXXGOOOXXXXXXXXXXXXXXXXGOOOOOOOOXXXXXXXXXXX,0,0,0
24129,82,0,82,18,400,0,0,405,365,40,GOOXXXXXXXXXXXXXXXXXGOOOOOXXXXXXXXXXXXXXGOOOOOOOOOXXXXXXXXXXGOOOOXXXXXXXXXXXXXXXGOOXXXXXXXXXXXXXXXXXGOOOOOXXXXXXXXXXXXXXGOOOOOOXXXXXXXXXXXXXGOOOOOOOOOXXXXXXXXXXGOOOOOOOOOXXXXXXXXXXGOOXXXXXXXXXXXXXXXXXGOOOOOXXXXXXXXXXXXXXGOOOXXXXXXXXXXXXXXXXGOOOOOOOOXXXXXXXXXXX,0,0,0

24150,82,0,82,16,402,0,0,407,368,39,GOOXXXXXXXXXXXXXXXXXGOOOOOXXXXXXXXXXXXXXGOOOOOOOOOXXXXXXXXXXGOOOOXXXXXXXXXXXXXXXGOOXXXXXXXXXXXXXXXXXGOOOOOXXXXXXXXXXXXXXGOOOOOOXXXXXXXXXXXXXGOOOOOOOOOXXXXXXXXXXGOOOOOOOOOXXXXXXXXXXGOOXXXXXXXXXXXXXXXXXGOOOOOXXXXXXXXXXXXXXGOOOXXXXXXXXXXXXXXXXGOOOOOOOOXXXXXXXXXXX,0,0,0
24171,82,0,82,20,398,0,0,403,366,37,GOOXXXXXXXXXXXXXXXXXGOOOOOXXXXXXXXXXXXXXGOOOOOOOOOXXXXXXXXXXGOOOOXXXXXXXXXXXXXXXGOOXXXXXXXXXXXXXXXXXGOOOOOXXXXXXXXXXXXXXGOOOOOOXXXXXXXXXXXXXGOOOOOOOOOXXXXXXXXXXGOOOOOOOOOXXXXXXXXXXGOOXXXXXXXXXXXXXXXXXGOOOOOXXXXXXXXXXXXXXGOOOXXXXXXXXXXXXXXXXGOOOOOOOOXXXXXXXXXXX,0,0,0
24192,82,0,82,20,398,0,0,403,366,37,GOOXXXXXXXXXXXXXXXXXGOOOOOXXXXXXXXXXXXXXGOOOOOOOOOXXXXXXXXXXGOOOOXXXXXXXXXXXXXXXGOOXXXXXXXXXXXXXXXXXGOOOOOXXXXXXXXXXXXXXGOOOOOOXXXXXXXXXXXXXGOOOOOOOOOXXXXXXXXXXGOOOOOOOOOXXXXXXXXXXGOOXXXXXXXXXXXXXXXXXGOOOOOXXXXXXXXXXXXXXGOOOXXXXXXXXXXXXXXXXGOOOOOOOOXXXXXXXXXXX,0,0,0
24213,82,0,82,21,397,0,0,402,365,37,GOOXXXXXXXXXXXXXXXXXGOOOOOXXXXXXXXXXXXXXGOOOOOOOOOXXXXXXXXXXGOOOOXXXXXXXXXXXXXXXGOOXXXXXXXXXXXXXXXXXGOOOOOXXXXXXXXXXXXXXGOOOOOOXXXXXXXXXXXXXGOOOOOOOOOXXXXXXXXXXGOOOOOOOOOXXXXXXXXXXGOOXXXXXXXXXXXXXXXXXGOOOOOXXXXXXXXXXXXXXGOOOXXXXXXXXXXXXXXXXGOOOOOOOOXXXXXXXXXXX,0,0,0
24234,82,0,82,22,396,0,0,401,365,36,GOOXXXXXXXXXXXXXXXXXGOOOOOXXXXXXXXXXXXXXGOOOOOOOOOXXXXXXXXXXGOOOOXXXXXXXXXXXXXXXGOOXXXXXXXXXXXXXXXXXGOOOOOXXXXXXXXXXXXXXGOOOOOOXXXXXXXXXXXXXGOOOOOOOOOXXXXXXXXXXGOOOOOOOOOXXXXXXXXXXGOOXXXXXXXXXXXXXXXXXGOOOOOXXXXXXXXXXXXXXGOOOXXXXXXXXXXXXXXXXGOOOOOOOOXXXXXXXXXXX,0,0,0

24255,82,0,82,20,398,0,0,403,367,36,GOOXXXXXXXXXXXXXXXXXGOOOOOXXXXXXXXXXXXXXGOOOOOOOOOXXXXXXXXXXGOOOOXXXXXXXXXXXXXXXGOOXXXXXXXXXXXXXXXXXGOOOOOXXXXXXXXXXXXXXGOOOOOOXXXXXXXXXXXXXGOOOOOOOOOXXXXXXXXXXGOOOOOOOOOXXXXXXXXXXGOOXXXXXXXXXXXXXXXXXGOOOOOXXXXXXXXXXXXXXGOOOXXXXXXXXXXXXXXXXGOOOOOOOOXXXXXXXXXXX,0,0,0
24276,82,0,82,26,392,0,0,397,366,31,GOOXXXXXXXXXXXXXXXXXGOOOOOXXXXXXXXXXXXXXGOOOOOOOOOXXXXXXXXXXGOOOOXXXXXXXXXXXXXXXGOOXXXXXXXXXXXXXXXXXGOOOOOXXXXXXXXXXXXXXGOOOOOOXXXXXXXXXXXXXGOOOOOOOOOXXXXXXXXXXGOOOOOOOOOXXXXXXXXXXGOOXXXXXXXXXXXXXXXXXGOOOOOXXXXXXXXXXXXXXGOOOXXXXXXXXXXXXXXXXGOOOOOOOOXXXXXXXXXXX,0,0,0
24297,82,0,82,28,390,0,0,395,367,28,GOOXXXXXXXXXXXXXXXXXGOOOOOXXXXXXXXXXXXXXGOOOOOOOOOXXXXXXXXXXGOOOOXXXXXXXXXXXXXXXGOOXXXXXXXXXXXXXXXXXGOOOOOXXXXXXXXXXXXXXGOOOOOOXXXXXXXXXXXXXGOOOOOOOOOXXXXXXXXXXGOOOOOOOOOXXXXXXXXXXGOOXXXXXXXXXXXXXXXXXGOOOOOXXXXXXXXXXXXXXGOOOXXXXXXXXXXXXXXXXGOOOOOOOOXXXXXXXXXXX,0,0,0
24318,82,0,82,29,389,0,0,394,366,28,GOOXXXXXXXXXXXXXXXXXGOOOOOXXXXXXXXXXXXXXGOOOOOOOOOXXXXXXXXXXGOOOOXXXXXXXXXXXXXXXGOOXXXXXXXXXXXXXXXXXGOOOOOXXXXXXXXXXXXXXGOOOOOOXXXXXXXXXXXXXGOOOOOOOOOXXXXXXXXXXGOOOOOOOOOXXXXXXXXXXGOOXXXXXXXXXXXXXXXXXGOOOOOXXXXXXXXXXXXXXGOOOXXXXXXXXXXXXXXXXGOOOOOOOOXXXXXXXXXXX,0,0,0
24339,82,0,82,29,389,0,0,394,365,29,GOOXXXXXXXXXXXXXXXXXGOOOOOXXXXXXXXXXXXXXGOOOOOOOOOXXXXXXXXXXGOOOOXXXXXXXXXXXXXXXGOOXXXXXXXXXXXXXXXXXGOOOOOXXXXXXXXXXXXXXGOOOOOOXXXXXXXXXXXXXGOOOOOOOOOXXXXXXXXXXGOOOOOOOOOXXXXXXXXXXGOOXXXXXXXXXXXXXXXXXGOOOOOXXXXXXXXXXXXXXGOOOXXXXXXXXXXXXXXXXGOOOOOOOOXXXXXXXXXXX,0,0,0

24360,82,0,82,25,393,0,0,398,366,32,GOOXXXXXXXXXXXXXXXXXGOOOOOXXXXXXXXXXXXXXGOOOOOOOOOXXXXXXXXXXGOOOOXXXXXXXXXXXXXXXGOOXXXXXXXXXXXXXXXXXGOOOOOXXXXXXXXXXXXXXGOOOOOOXXXXXXXXXXXXXGOOOOOOOOOXXXXXXXXXXGOOOOOOOOOXXXXXXXXXXGOOXXXXXXXXXXXXXXXXXGOOOOOXXXXXXXXXXXXXXGOOOXXXXXXXXXXXXXXXXGOOOOOOOOXXXXXXXXXXX,0,0,0
24381,82,0,82,23,395,0,0,400,366,34,GOOXXXXXXXXXXXXXXXXXGOOOOOXXXXXXXXXXXXXXGOOOOOOOOOXXXXXXXXXXGOOOOXXXXXXXXXXXXXXXGOOXXXXXXXXXXXXXXXXXGOOOOOXXXXXXXXXXXXXXGOOOOOOXXXXXXXXXXXXXGOOOOOOOOOXXXXXXXXXXGOOOOOOOOOXXXXXXXXXXGOOXXXXXXXXXXXXXXXXXGOOOOOXXXXXXXXXXXXXXGOOOXXXXXXXXXXXXXXXXGOOOOOOOOXXXXXXXXXXX,0,0,0
24402,82,0,82,21,397,0,0,402,366,36,GOOXXXXXXXXXXXXXXXXXGOOOOOXXXXXXXXXXXXXXGOOOOOOOOOXXXXXXXXXXGOOOOXXXXXXXXXXXXXXXGOOXXXXXXXXXXXXXXXXXGOOOOOXXXXXXXXXXXXXXGOOOOOOXXXXXXXXXXXXXGOOOOOOOOOXXXXXXXXXXGOOOOOOOOOXXXXXXXXXXGOOXXXXXXXXXXXXXXXXXGOOOOOXXXXXXXXXXXXXXGOOOXXXXXXXXXXXXXXXXGOOOOOOOOXXXXXXXXXXX,0,0,0
24423,82,0,82,17,401,0,0,405,367,38,GOOXXXXXXXXXXXXXXXXXGOOOOOXXXXXXXXXXXXXXGOOOOOOOOOXXXXXXXXXXGOOOOXXXXXXXXXXXXXXXGOOXXXXXXXXXXXXXXXXXGOOOOOXXXXXXXXXXXXXXGOOOOOOXXXXXXXXXXXXXGOOOOOOOOOXXXXXXXXXXGOOOOOOOOOXXXXXXXXXXGOOXXXXXXXXXXXXXXXXXGOOOOOXXXXXXXXXXXXXXGOOOXXXXXXXXXXXXXXXXGOOOOOOOOXXXXXXXXXXX,0,0,0
24444,82,0,82,17,401,0,0,406,366,40,GOOXXXXXXXXXXXXXXXXXGOOOOOXXXXXXXXXXXXXXGOOOOOOOOOXXXXXXXXXXGOOOOXXXXXXXXXXXXXXXGOOXXXXXXXXXXXXXXXXXGOOOOOXXXXXXXXXXXXXXGOOOOOOXXXXXXXXXXXXXGOOOOOOOOOXXXXXXXXXXGOOOOOOOOOXXXXXXXXXXGOOXXXXXXXXXXXXXXXXXGOOOOOXXXXXXXXXXXXXXGOOOXXXXXXXXXXXXXXXXGOOOOOOOOXXXXXXXXXXX,0,0,0

24465,82,0,82,14,404,0,0,409,368,41,GOOXXXXXXXXXXXXXXXXXGOOOOOXXXXXXXXXXXXXXGOOOOOOOOOXXXXXXXXXXGOOOOXXXXXXXXXXXXXXXGOOXXXXXXXXXXXXXXXXXGOOOOOXXXXXXXXXXXXXXGOOOOOOXXXXXXXXXXXXXGOOOOOOOOOXXXXXXXXXXGOOOOOOOOOXXXXXXXXXXGOOXXXXXXXXXXXXXXXXXGOOOOOXXXXXXXXXXXXXXGOOOXXXXXXXXXXXXXXXXGOOOOOOOOXXXXXXXXXXX,0,0,0
24486,82,0,82,16,402,0,0,407,367,40,GOOXXXXXXXXXXXXXXXXXGOOOOOXXXXXXXXXXXXXXGOOOOOOOOOXXXXXXXXXXGOOOOXXXXXXXXXXXXXXXGOOXXXXXXXXXXXXXXXXXGOOOOOXXXXXXXXXXXXXXGOOOOOOXXXXXXXXXXXXXGOOOOOOOOOXXXXXXXXXXGOOOOOOOOOXXXXXXXXXXGOOXXXXXXXXXXXXXXXXXGOOOOOXXXXXXXXXXXXXXGOOOXXXXXXXXXXXXXXXXGOOOOOOOOXXXXXXXXXXX,0,0,0
24507,82,0,82,17,401,0,0,406,369,37,GOOXXXXXXXXXXXXXXXXXGOOOOOXXXXXXXXXXXXXXGOOOOOOOOOXXXXXXXXXXGOOOOXXXXXXXXXXXXXXXGOOXXXXXXXXXXXXXXXXXGOOOOOXXXXXXXXXXXXXXGOOOOOOXXXXXXXXXXXXXGOOOOOOOOOXXXXXXXXXXGOOOOOOOOOXXXXXXXXXXGOOXXXXXXXXXXXXXXXXXGOOOOOXXXXXXXXXXXXXXGOOOXXXXXXXXXXXXXXXXGOOOOOOOOXXXXXXXXXXX,0,0,0
24528,82,0,82,19,399,0,0,403,368,35,GOOXXXXXXXXXXXXXXXXXGOOOOOXXXXXXXXXXXXXXGOOOOOOOOOXXXXXXXXXXGOOOOXXXXXXXXXXXXXXXGOOXXXXXXXXXXXXXXXXXGOOOOOXXXXXXXXXXXXXXGOOOOOOXXXXXXXXXXXXXGOOOOOOOOOXXXXXXXXXXGOOOOOOOOOXXXXXXXXXXGOOXXXXXXXXXXXXXXXXXGOOOOOXXXXXXXXXXXXXXGOOOXXXXXXXXXXXXXXXXGOOOOOOOOXXXXXXXXXXX,0,0,0
24549,82,0,82,18,400,0,0,405,366,39,GOOXXXXXXXXXXXXXXXXXGOOOOOXXXXXXXXXXXXXXGOOOOOOOOOXXXXXXXXXXGOOOOXXXXXXXXXXXXXXXGOOXXXXXXXXXXXXXXXXXGOOOOOXXXXXXXXXXXXXXGOOOOOOXXXXXXXXXXXXXGOOOOOOOOOXXXXXXXXXXGOOOOOOOOOXXXXXXXXXXGOOXXXXXXXXXXXXXXXXXGOOOOOXXXXXXXXXXXXXXGOOOXXXXXXXXXXXXXXXXGOOOOOOOOXXXXXXXXXXX,0,0,0

24570,82,0,82,17,401,0,0,406,366,40,GOOXXXXXXXXXXXXXXXXXGOOOOOXXXXXXXXXXXXXXGOOOOOOOOOXXXXXXXXXXGOOOOXXXXXXXXXXXXXXXGOOXXXXXXXXXXXXXXXXXGOOOOOXXXXXXXXXXXXXXGOOOOOOXXXXXXXXXXXXXGOOOOOOOOOXXXXXXXXXXGOOOOOOOOOXXXXXXXXXXGOOXXXXXXXXXXXXXXXXXGOOOOOXXXXXXXXXXXXXXGOOOXXXXXXXXXXXXXXXXGOOOOOOOOXXXXXXXXXXX,0,0,0
24591,82,0,82,14,404,0,0,409,367,42,GOOXXXXXXXXXXXXXXXXXGOOOOOXXXXXXXXXXXXXXGOOOOOOOOOXXXXXXXXXXGOOOOXXXXXXXXXXXXXXXGOOXXXXXXXXXXXXXXXXXGOOOOOXXXXXXXXXXXXXXGOOOOOOXXXXXXXXXXXXXGOOOOOOOOOXXXXXXXXXXGOOOOOOOOOXXXXXXXXXXGOOXXXXXXXXXXXXXXXXXGOOOOOXXXXXXXXXXXXXXGOOOXXXXXXXXXXXXXXXXGOOOOOOOOXXXXXXXXXXX,0,0,0
24612,82,0,82,15,403,0,0,408,367,41,GOOXXXXXXXXXXXXXXXXXGOOOOOXXXXXXXXXXXXXXGOOOOOOOOOXXXXXXXXXXGOOOOXXXXXXXXXXXXXXXGOOXXXXXXXXXXXXXXXXXGOOOOOXXXXXXXXXXXXXXGOOOOOOXXXXXXXXXXXXXGOOOOOOOOOXXXXXXXXXXGOOOOOOOOOXXXXXXXXXXGOOXXXXXXXXXXXXXXXXXGOOOOOXXXXXXXXXXXXXXGOOOXXXXXXXXXXXXXXXXGOOOOOOOOXXXXXXXXXXX,0,0,0
24633,82,0,82,14,404,0,0,409,369,40,GOOXXXXXXXXXXXXXXXXXGOOOOOXXXXXXXXXXXXXXGOOOOOOOOOXXXXXXXXXXGOOOOXXXXXXXXXXXXXXXGOOXXXXXXXXXXXXXXXXXGOOOOOXXXXXXXXXXXXXXGOOOOOOXXXXXXXXXXXXXGOOOOOOOOOXXXXXXXXXXGOOOOOOOOOXXXXXXXXXXGOOXXXXXXXXXXXXXXXXXGOOOOOXXXXXXXXXXXXXXGOOOXXXXXXXXXXXXXXXXGOOOOOOOOXXXXXXXXXXX,0,0,0
24654,82,0,82,14,404,0,0,409,368,41,GOOXXXXXXXXXXXXXXXXXGOOOOOXXXXXXXXXXXXXXGOOOOOOOOOXXXXXXXXXXGOOOOXXXXXXXXXXXXXXXGOOXXXXXXXXXXXXXXXXXGOOOOOXXXXXXXXXXXXXXGOOOOOOXXXXXXXXXXXXXGOOOOOOOOOXXXXXXXXXXGOOOOOOOOOXXXXXXXXXXGOOXXXXXXXXXXXXXXXXXGOOOOOXXXXXXXXXXXXXXGOOOXXXXXXXXXXXXXXXXGOOOOOOOOXXXXXXXXXXX,0,0,0

24675,82,0,82,15,403,0,0,408,368,40,GOOXXXXXXXXXXXXXXXXXGOOOOOXXXXXXXXXXXXXXGOOOOOOOOOXXXXXXXXXXGOOOOXXXXXXXXXXXXXXXGOOXXXXXXXXXXXXXXXXXGOOOOOXXXXXXXXXXXXXXGOOOOOOXXXXXXXXXXXXXGOOOOOOOOOXXXXXXXXXXGOOOOOOOOOXXXXXXXXXXGOOXXXXXXXXXXXXXXXXXGOOOOOXXXXXXXXXXXXXXGOOOXXXXXXXXXXXXXXXXGOOOOOOOOXXXXXXXXXXX,0,0,0
24696,82,0,82,17,401,0,0,407,368,39,GOOXXXXXXXXXXXXXXXXXGOOOOOXXXXXXXXXXXXXXGOOOOOOOOOXXXXXXXXXXGOOOOXXXXXXXXXXXXXXXGOOXXXXXXXXXXXXXXXXXGOOOOOXXXXXXXXXXXXXXGOOOOOOXXXXXXXXXXXXXGOOOOOOOOOXXXXXXXXXXGOOOOOOOOOXXXXXXXXXXGOOXXXXXXXXXXXXXXXXXGOOOOOXXXXXXXXXXXXXXGOOOXXXXXXXXXXXXXXXXGOOOOOOOOXXXXXXXXXXX,0,0,0
24717,82,0,82,18,400,0,0,406,368,38,GOOXXXXXXXXXXXXXXXXXGOOOOOXXXXXXXXXXXXXXGOOOOOOOOOXXXXXXXXXXGOOOOXXXXXXXXXXXXXXXGOOXXXXXXXXXXXXXXXXXGOOOOOXXXXXXXXXXXXXXGOOOOOOXXXXXXXXXXXXXGOOOOOOOOOXXXXXXXXXXGOOOOOOOOOXXXXXXXXXXGOOXXXXXXXXXXXXXXXXXGOOOOOXXXXXXXXXXXXXXGOOOXXXXXXXXXXXXXXXXGOOOOOOOOXXXXXXXXXXX,0,0,0
24738,82,0,82,18,400,0,0,406,367,39,GOOXXXXXXXXXXXXXXXXXGOOOOOXXXXXXXXXXXXXXGOOOOOOOOOXXXXXXXXXXGOOOOXXXXXXXXXXXXXXXGOOXXXXXXXXXXXXXXXXXGOOOOOXXXXXXXXXXXXXXGOOOOOOXXXXXXXXXXXXXGOOOOOOOOOXXXXXXXXXXGOOOOOOOOOXXXXXXXXXXGOOXXXXXXXXXXXXXXXXXGOOOOOXXXXXXXXXXXXXXGOOOXXXXXXXXXXXXXXXXGOOOOOOOOXXXXXXXXXXX,0,0,0
24759,82,0,82,16,402,0,0,408,368,40,GOOXXXXXXXXXXXXXXXXXGOOOOOXXXXXXXXXXXXXXGOOOOOOOOOXXXXXXXXXXGOOOOXXXXXXXXXXXXXXXGOOXXXXXXXXXXXXXXXXXGOOOOOXXXXXXXXXXXXXXGOOOOOOXXXXXXXXXXXXXGOOOOOOOOOXXXXXXXXXXGOOOOOOOOOXXXXXXXXXXGOOXXXXXXXXXXXXXXXXXGOOOOOXXXXXXXXXXXXXXGOOOXXXXXXXXXXXXXXXXGOOOOOOOOXXXXXXXXXXX,0,0,0

24780,82,0,82,18,400,0,0,406,368,38,GOOXXXXXXXXXXXXXXXXXGOOOOOXXXXXXXXXXXXXXGOOOOOOOOOXXXXXXXXXXGOOOOXXXXXXXXXXXXXXXGOOXXXXXXXXXXXXXXXXXGOOOOOXXXXXXXXXXXXXXGOOOOOOXXXXXXXXXXXXXGOOOOOOOOOXXXXXXXXXXGOOOOOOOOOXXXXXXXXXXGOOXXXXXXXXXXXXXXXXXGOOOOOXXXXXXXXXXXXXXGOOOXXXXXXXXXXXXXXXXGOOOOOOOOXXXXXXXXXXX,0,0,0
24801,82,0,82,19,399,0,0,405,367,38,GOOXXXXXXXXXXXXXXXXXGOOOOOXXXXXXXXXXXXXXGOOOOOOOOOXXXXXXXXXXGOOOOXXXXXXXXXXXXXXXGOOXXXXXXXXXXXXXXXXXGOOOOOXXXXXXXXXXXXXXGOOOOOOXXXXXXXXXXXXXGOOOOOOOOOXXXXXXXXXXGOOOOOOOOOXXXXXXXXXXGOOXXXXXXXXXXXXXXXXXGOOOOOXXXXXXXXXXXXXXGOOOXXXXXXXXXXXXXXXXGOOOOOOOOXXXXXXXXXXX,0,0,0
24822,82,0,82,21,397,0,0,403,370,33,GOOXXXXXXXXXXXXXXXXXGOOOOOXXXXXXXXXXXXXXGOOOOOOOOOXXXXXXXXXXGOOOOXXXXXXXXXXXXXXXGOOXXXXXXXXXXXXXXXXXGOOOOOXXXXXXXXXXXXXXGOOOOOOXXXXXXXXXXXXXGOOOOOOOOOXXXXXXXXXXGOOOOOOOOOXXXXXXXXXXGOOXXXXXXXXXXXXXXXXXGOOOOOXXXXXXXXXXXXXXGOOOXXXXXXXXXXXXXXXXGOOOOOOOOXXXXXXXXXXX,0,0,0
24843,82,0,82,23,395,0,0,401,368,33,GOOXXXXXXXXXXXXXXXXXGOOOOOXXXXXXXXXXXXXXGOOOOOOOOOXXXXXXXXXXGOOOOXXXXXXXXXXXXXXXGOOXXXXXXXXXXXXXXXXXGOOOOOXXXXXXXXXXXXXXGOOOOOOXXXXXXXXXXXXXGOOOOOOOOOXXXXXXXXXXGOOOOOOOOOXXXXXXXXXXGOOXXXXXXXXXXXXXXXXXGOOOOOXXXXXXXXXXXXXXGOOOXXXXXXXXXXXXXXXXGOOOOOOOOXXXXXXXXXXX,0,0,0
24864,82,0,82,24,394,0,0,400,369,31,GOOXXXXXXXXXXXXXXXXXGOOOOOXXXXXXXXXXXXXXGOOOOOOOOOXXXXXXXXXXGOOOOXXXXXXXXXXXXXXXGOOXXXXXXXXXXXXXXXXXGOOOOOXXXXXXXXXXXXXXGOOOOOOXXXXXXXXXXXXXGOOOOOOOOOXXXXXXXXXXGOOOOOOOOOXXXXXXXXXXGOOXXXXXXXXXXXXXXXXXGOOOOOXXXXXXXXXXXXXXGOOOXXXXXXXXXXXXXXXXGOOOOOOOOXXXXXXXXXXX,0,0,0

24885,82,0,82,25,393,0,0,399,368,31,GOOXXXXXXXXXXXXXXXXXGOOOOOXXXXXXXXXXXXXXGOOOOOOOOOXXXXXXXXXXGOOOOXXXXXXXXXXXXXXXGOOXXXXXXXXXXXXXXXXXGOOOOOXXXXXXXXXXXXXXGOOOOOOXXXXXXXXXXXXXGOOOOOOOOOXXXXXXXXXXGOOOOOOOOOXXXXXXXXXXGOOXXXXXXXXXXXXXXXXXGOOOOOXXXXXXXXXXXXXXGOOOXXXXXXXXXXXXXXXXGOOOOOOOOXXXXXXXXXXX,0,0,0
24906,82,0,82,24,394,0,0,400,368,32,GOOXXXXXXXXXXXXXXXXXGOOOOOXXXXXXXXXXXXXXGOOOOOOOOOXXXXXXXXXXGOOOOXXXXXXXXXXXXXXXGOOXXXXXXXXXXXXXXXXXGOOOOOXXXXXXXXXXXXXXGOOOOOOXXXXXXXXXXXXXGOOOOOOOOOXXXXXXXXXXGOOOOOOOOOXXXXXXXXXXGOOXXXXXXXXXXXXXXXXXGOOOOOXXXXXXXXXXXXXXGOOOXXXXXXXXXXXXXXXXGOOOOOOOOXXXXXXXXXXX,0,0,0
24927,82,0,82,20,398,0,0,404,367,37,GOOXXXXXXXXXXXXXXXXXGOOOOOXXXXXXXXXXXXXXGOOOOOOOOOXXXXXXXXXXGOOOOXXXXXXXXXXXXXXXGOOXXXXXXXXXXXXXXXXXGOOOOOXXXXXXXXXXXXXXGOOOOOOXXXXXXXXXXXXXGOOOOOOOOOXXXXXXXXXXGOOOOOOOOOXXXXXXXXXXGOOXXXXXXXXXXXXXXXXXGOOOOOXXXXXXXXXXXXXXGOOOXXXXXXXXXXXXXXXXGOOOOOOOOXXXXXXXXXXX,0,0,0
24948,82,0,82,17,401,0,0,407,368,39,GOOXXXXXXXXXXXXXXXXXGOOOOOXXXXXXXXXXXXXXGOOOOOOOOOXXXXXXXXXXGOOOOXXXXXXXXXXXXXXXGOOXXXXXXXXXXXXXXXXXGOOOOOXXXXXXXXXXXXXXGOOOOOOXXXXXXXXXXXXXGOOOOOOOOOXXXXXXXXXXGOOOOOOOOOXXXXXXXXXXGOOXXXXXXXXXXXXXXXXXGOOOOOXXXXXXXXXXXXXXGOOOXXXXXXXXXXXXXXXXGOOOOOOOOXXXXXXXXXXX,0,0,0
24969,82,0,82,17,401,0,0,407,370,37,GOOXXXXXXXXXXXXXXXXXGOOOOOXXXXXXXXXXXXXXGOOOOOOOOOXXXXXXXXXXGOOOOXXXXXXXXXXXXXXXGOOXXXXXXXXXXXXXXXXXGOOOOOXXXXXXXXXXXXXXGOOOOOOXXXXXXXXXXXXXGOOOOOOOOOXXXXXXXXXXGOOOOOOOOOXXXXXXXXXXGOOXXXXXXXXXXXXXXXXXGOOOOOXXXXXXXXXXXXXXGOOOXXXXXXXXXXXXXXXXGOOOOOOOOXXXXXXXXXXX,0,0,0

24990,82,0,82,20,398,0,0,404,370,34,GOOXXXXXXXXXXXXXXXXXGOOOOOXXXXXXXXXXXXXXGOOOOOOOOOXXXXXXXXXXGOOOOXXXXXXXXXXXXXXXGOOXXXXXXXXXXXXXXXXXGOOOOOXXXXXXXXXXXXXXGOOOOOOXXXXXXXXXXXXXGOOOOOOOOOXXXXXXXXXXGOOOOOOOOOXXXXXXXXXXGOOXXXXXXXXXXXXXXXXXGOOOOOXXXXXXXXXXXXXXGOOOXXXXXXXXXXXXXXXXGOOOOOOOOXXXXXXXXXXX,0,0,0
25011,83,0,83,20,397,0,0,403,369,34,GOOXXXXXXXXXXXXXXXXXGOOOOOXXXXXXXXXXXXXXGOOOOOOOOOXXXXXXXXXXGOOOOOXXXXXXXXXXXXXXGOOXXXXXXXXXXXXXXXXXGOOOOOXXXXXXXXXXXXXXGOOOOOOXXXXXXXXXXXXXGOOOOOOOOOXXXXXXXXXXGOOOOOOOOOXXXXXXXXXXGOOXXXXXXXXXXXXXXXXXGOOOOOXXXXXXXXXXXXXXGOOOXXXXXXXXXXXXXXXXGOOOOOOOOXXXXXXXXXXX,600,0,0
25032,83,0,83,23,394,0,0,400,368,32,GOOXXXXXXXXXXXXXXXXXGOOOOOXXXXXXXXXXXXXXGOOOOOOOOOXXXXXXXXXXGOOOOOXXXXXXXXXXXXXXGOOXXXXXXXXXXXXXXXXXGOOOOOXXXXXXXXXXXXXXGOOOOOOXXXXXXXXXXXXXGOOOOOOOOOXXXXXXXXXXGOOOOOOOOOXXXXXXXXXXGOOXXXXXXXXXXXXXXXXXGOOOOOXXXXXXXXXXXXXXGOOOXXXXXXXXXXXXXXXXGOOOOOOOOXXXXXXXXXXX,600,0,0
25053,83,0,83,22,395,0,0,401,368,33,GOOXXXXXXXXXXXXXXXXXGOOOOOXXXXXXXXXXXXXXGOOOOOOOOOXXXXXXXXXXGOOOOOXXXXXXXXXXXXXXGOOXXXXXXXXXXXXXXXXXGOOOOOXXXXXXXXXXXXXXGOOOOOOXXXXXXXXXXXXXGOOOOOOOOOXXXXXXXXXXGOOOOOOOOOXXXXXXXXXXGOOXXXXXXXXXXXXXXXXXGOOOOOXXXXXXXXXXXXXXGOOOXXXXXXXXXXXXXXXXGOOOOOOOOXXXXXXXXXXX,600,0,0
25074,83,0,83,23,394,0,0,400,367,33,GOOXXXXXXXXXXXXXXXXXGOOOOOXXXXXXXXXXXXXXGOOOOOOOOOXXXXXXXXXXGOOOOOXXXXXXXXXXXXXXGOOXXXXXXXXXXXXXXXXXGOOOOOXXXXXXXXXXXXXXGOOOOOOXXXXXXXXXXXXXGOOOOOOOOOXXXXXXXXXXGOOOOOOOOOXXXXXXXXXXGOOXXXXXXXXXXXXXXXXXGOOOOOXXXXXXXXXXXXXXGOOOXXXXXXXXXXXXXXXXGOOOOOOOOXXXXXXXXXXX,600,0,0

25095,83,0,83,20,397,0,0,403,367,36,GOOXXXXXXXXXXXXXXXXXGOOOOOXXXXXXXXXXXXXXGOOOOOOOOOXXXXXXXXXXGOOOOOXXXXXXXXXXXXXXGOOXXXXXXXXXXXXXXXXXGOOOOOXXXXXXXXXXXXXXGOOOOOOXXXXXXXXXXXXXGOOOOOOOOOXXXXXXXXXXGOOOOOOOOOXXXXXXXXXXGOOXXXXXXXXXXXXXXXXXGOOOOOXXXXXXXXXXXXXXGOOOXXXXXXXXXXXXXXXXGOOOOOOOOXXXXXXXXXXX,600,0,0
25116,83,0,83,22,395,0,0,401,367,34,GOOXXXXXXXXXXXXXXXXXGOOOOOXXXXXXXXXXXXXXGOOOOOOOOOXXXXXXXXXXGOOOOOXXXXXXXXXXXXXXGOOXXXXXXXXXXXXXXXXXGOOOOOXXXXXXXXXXXXXXGOOOOOOXXXXXXXXXXXXXGOOOOOOOOOXXXXXXXXXXGOOOOOOOOOXXXXXXXXXXGOOXXXXXXXXXXXXXXXXXGOOOOOXXXXXXXXXXXXXXGOOOXXXXXXXXXXXXXXXXGOOOOOOOOXXXXXXXXXXX,600,0,0
25137,83,0,83,20,397,0,0,403,367,36,GOOXXXXXXXXXXXXXXXXXGOOOOOXXXXXXXXXXXXXXGOOOOOOOOOXXXXXXXXXXGOOOOOXXXXXXXXXXXXXXGOOXXXXXXXXXXXXXXXXXGOOOOOXXXXXXXXXXXXXXGOOOOOOXXXXXXXXXXXXXGOOOOOOOOOXXXXXXXXXXGOOOOOOOOOXXXXXXXXXXGOOXXXXXXXXXXXXXXXXXGOOOOOXXXXXXXXXXXXXXGOOOXXXXXXXXXXXXXXXXGOOOOOOOOXXXXXXXXXXX,600,0,0
25158,83,0,83,15,402,0,0,408,367,41,GOOXXXXXXXXXXXXXXXXXGOOOOOXXXXXXXXXXXXXXGOOOOOOOOOXXXXXXXXXXGOOOOOXXXXXXXXXXXXXXGOOXXXXXXXXXXXXXXXXXGOOOOOXXXXXXXXXXXXXXGOOOOOOXXXXXXXXXXXXXGOOOOOOOOOXXXXXXXXXXGOOOOOOOOOXXXXXXXXXXGOOXXXXXXXXXXXXXXXXXGOOOOOXXXXXXXXXXXXXXGOOOXXXXXXXXXXXXXXXXGOOOOOOOOXXXXXXXXXXX,600,0,0
25179,83,0,83,12,405,0,0,410,368,42,GOOXXXXXXXXXXXXXXXXXGOOOOOXXXXXXXXXXXXXXGOOOOOOOOOXXXXXXXXXXGOOOOOXXXXXXXXXXXXXXGOOXXXXXXXXXXXXXXXXXGOOOOOXXXXXXXXXXXXXXGOOOOOOXXXXXXXXXXXXXGOOOOOOOOOXXXXXXXXXXGOOOOOOOOOXXXXXXXXXXGOOXXXXXXXXXXXXXXXXXGOOOOOXXXXXXXXXXXXXXGOOOXXXXXXXXXXXXXXXXGOOOOOOOOXXXXXXXXXXX,600,0,0

25200,83,0,83,14,403,0,0,409,367,42,GOOXXXXXXXXXXXXXXXXXGOOOOOXXXXXXXXXXXXXXGOOOOOOOOOXXXXXXXXXXGOOOOOXXXXXXXXXXXXXXGOOXXXXXXXXXXXXXXXXXGOOOOOXXXXXXXXXXXXXXGOOOOOOXXXXXXXXXXXXXGOOOOOOOOOXXXXXXXXXXGOOOOOOOOOXXXXXXXXXXGOOXXXXXXXXXXXXXXXXXGOOOOOXXXXXXXXXXXXXXGOOOXXXXXXXXXXXXXXXXGOOOOOOOOXXXXXXXXXXX,600,0,0
25221,83,0,83,15,402,0,0,408,368,40,GOOXXXXXXXXXXXXXXXXXGOOOOOXXXXXXXXXXXXXXGOOOOOOOOOXXXXXXXXXXGOOOOOXXXXXXXXXXXXXXGOOXXXXXXXXXXXXXXXXXGOOOOOXXXXXXXXXXXXXXGOOOOOOXXXXXXXXXXXXXGOOOOOOOOOXXXXXXXXXXGOOOOOOOOOXXXXXXXXXXGOOXXXXXXXXXXXXXXXXXGOOOOOXXXXXXXXXXXXXXGOOOXXXXXXXXXXXXXXXXGOOOOOOOOXXXXXXXXXXX,600,0,0
25242,83,0,83,15,402,0,0,408,369,39,GOOXXXXXXXXXXXXXXXXXGOOOOOXXXXXXXXXXXXXXGOOOOOOOOOXXXXXXXXXXGOOOOOXXXXXXXXXXXXXXGOOXXXXXXXXXXXXXXXXXGOOOOOXXXXXXXXXXXXXXGOOOOOOXXXXXXXXXXXXXGOOOOOOOOOXXXXXXXXXXGOOOOOOOOOXXXXXXXXXXGOOXXXXXXXXXXXXXXXXXGOOOOOXXXXXXXXXXXXXXGOOOXXXXXXXXXXXXXXXXGOOOOOOOOXXXXXXXXXXX,600,0,0
25263,83,0,83,16,401,0,0,407,368,39,GOOXXXXXXXXXXXXXXXXXGOOOOOXXXXXXXXXXXXXXGOOOOOOOOOXXXXXXXXXXGOOOOOXXXXXXXXXXXXXXGOOXXXXXXXXXXXXXXXXXGOOOOOXXXXXXXXXXXXXXGOOOOOOXXXXXXXXXXXXXGOOOOOOOOOXXXXXXXXXXGOOOOOOOOOXXXXXXXXXXGOOXXXXXXXXXXXXXXXXXGOOOOOXXXXXXXXXXXXXXGOOOXXXXXXXXXXXXXXXXGOOOOOOOOXXXXXXXXXXX,600,0,0
25284,83,0,83,14,403,0,0,409,369,40,GOOXXXXXXXXXXXXXXXXXGOOOOOXXXXXXXXXXXXXXGOOOOOOOOOXXXXXXXXXXGOOOOOXXXXXXXXXXXXXXGOOXXXXXXXXXXXXXXXXXGOOOOOXXXXXXXXXXXXXXGOOOOOOXXXXXXXXXXXXXGOOOOOOOOOXXXXXXXXXXGOOOOOOOOOXXXXXXXXXXGOOXXXXXXXXXXXXXXXXXGOOOOOXXXXXXXXXXXXXXGOOOXXXXXXXXXXXXXXXXGOOOOOOOOXXXXXXXXXXX,600,0,0

25305,83,0,83,14,403,0,0,409,371,38,GOOXXXXXXXXXXXXXXXXXGOOOOOXXXXXXXXXXXXXXGOOOOOOOOOXXXXXXXXXXGOOOOOXXXXXXXXXXXXXXGOOXXXXXXXXXXXXXXXXXGOOOOOXXXXXXXXXXXXXXGOOOOOOXXXXXXXXXXXXXGOOOOOOOOOXXXXXXXXXXGOOOOOOOOOXXXXXXXXXXGOOXXXXXXXXXXXXXXXXXGOOOOOXXXXXXXXXXXXXXGOOOXXXXXXXXXXXXXXXXGOOOOOOOOXXXXXXXXXXX,600,0,0
25326,83,0,83,15,402,0,0,408,372,36,GOOXXXXXXXXXXXXXXXXXGOOOOOXXXXXXXXXXXXXXGOOOOOOOOOXXXXXXXXXXGOOOOOXXXXXXXXXXXXXXGOOXXXXXXXXXXXXXXXXXGOOOOOXXXXXXXXXXXXXXGOOOOOOXXXXXXXXXXXXXGOOOOOOOOOXXXXXXXXXXGOOOOOOOOOXXXXXXXXXXGOOXXXXXXXXXXXXXXXXXGOOOOOXXXXXXXXXXXXXXGOOOXXXXXXXXXXXXXXXXGOOOOOOOOXXXXXXXXXXX,600,0,0
25347,83,0,83,18,399,0,0,405,371,34,GOOXXXXXXXXXXXXXXXXXGOOOOOXXXXXXXXXXXXXXGOOOOOOOOOXXXXXXXXXXGOOOOOXXXXXXXXXXXXXXGOOXXXXXXXXXXXXXXXXXGOOOOOXXXXXXXXXXXXXXGOOOOOOXXXXXXXXXXXXXGOOOOOOOOOXXXXXXXXXXGOOOOOOOOOXXXXXXXXXXGOOXXXXXXXXXXXXXXXXXGOOOOOXXXXXXXXXXXXXXGOOOXXXXXXXXXXXXXXXXGOOOOOOOOXXXXXXXXXXX,600,0,0
25368,83,0,83,18,399,0,0,405,371,34,GOOXXXXXXXXXXXXXXXXXGOOOOOXXXXXXXXXXXXXXGOOOOOOOOOXXXXXXXXXXGOOOOOXXXXXXXXXXXXXXGOOXXXXXXXXXXXXXXXXXGOOOOOXXXXXXXXXXXXXXGOOOOOOXXXXXXXXXXXXXGOOOOOOOOOXXXXXXXXXXGOOOOOOOOOXXXXXXXXXXGOOXXXXXXXXXXXXXXXXXGOOOOOXXXXXXXXXXXXXXGOOOXXXXXXXXXXXXXXXXGOOOOOOOOXXXXXXXXXXX,600,0,0
25389,83,0,83,19,398,0,0,404,370,34,GOOXXXXXXXXXXXXXXXXXGOOOOOXXXXXXXXXXXXXXGOOOOOOOOOXXXXXXXXXXGOOOOOXXXXXXXXXXXXXXGOOXXXXXXXXXXXXXXXXXGOOOOOXXXXXXXXXXXXXXGOOOOOOXXXXXXXXXXXXXGOOOOOOOOOXXXXXXXXXXGOOOOOOOOOXXXXXXXXXXGOOXXXXXXXXXXXXXXXXXGOOOOOXXXXXXXXXXXXXXGOOOXXXXXXXXXXXXXXXXGOOOOOOOOXXXXXXXXXXX,600,0,0

25410,83,0,83,20,397,0,0,403,370,33,GOOXXXXXXXXXXXXXXXXXGOOOOOXXXXXXXXXXXXXXGOOOOOOOOOXXXXXXXXXXGOOOOOXXXXXXXXXXXXXXGOOXXXXXXXXXXXXXXXXXGOOOOOXXXXXXXXXXXXXXGOOOOOOXXXXXXXXXXXXXGOOOOOOOOOXXXXXXXXXXGOOOOOOOOOXXXXXXXXXXGOOXXXXXXXXXXXXXXXXXGOOOOOXXXXXXXXXXXXXXGOOOXXXXXXXXXXXXXXXXGOOOOOOOOXXXXXXXXXXX,600,0,0
25431,83,0,83,20,397,0,0,404,370,34,GOOXXXXXXXXXXXXXXXXXGOOOOOXXXXXXXXXXXXXXGOOOOOOOOOXXXXXXXXXXGOOOOOXXXXXXXXXXXXXXGOOXXXXXXXXXXXXXXXXXGOOOOOXXXXXXXXXXXXXXGOOOOOOXXXXXXXXXXXXXGOOOOOOOOOXXXXXXXXXXGOOOOOOOOOXXXXXXXXXXGOOXXXXXXXXXXXXXXXXXGOOOOOXXXXXXXXXXXXXXGOOOXXXXXXXXXXXXXXXXGOOOOOOOOXXXXXXXXXXX,600,0,0
25452,83,0,83,20,397,0,0,404,369,35,GOOXXXXXXXXXXXXXXXXXGOOOOOXXXXXXXXXXXXXXGOOOOOOOOOXXXXXXXXXXGOOOOOXXXXXXXXXXXXXXGOOXXXXXXXXXXXXXXXXXGOOOOOXXXXXXXXXXXXXXGOOOOOOXXXXXXXXXXXXXGOOOOOOOOOXXXXXXXXXXGOOOOOOOOOXXXXXXXXXXGOOXXXXXXXXXXXXXXXXXGOOOOOXXXXXXXXXXXXXXGOOOXXXXXXXXXXXXXXXXGOOOOOOOOXXXXXXXXXXX,600,0,0
25473,83,0,83,19,398,0,0,404,370,34,GOOXXXXXXXXXXXXXXXXXGOOOOOXXXXXXXXXXXXXXGOOOOOOOOOXXXXXXXXXXGOOOOOXXXXXXXXXXXXXXGOOXXXXXXXXXXXXXXXXXGOOOOOXXXXXXXXXXXXXXGOOOOOOXXXXXXXXXXXXXGOOOOOOOOOXXXXXXXXXXGOOOOOOOOOXXXXXXXXXXGOOXXXXXXXXXXXXXXXXXGOOOOOXXXXXXXXXXXXXXGOOOXXXXXXXXXXXXXXXXGOOOOOOOOXXXXXXXXXXX,600,0,0
25494,83,0,83,21,396,0,0,402,370,32,GOOXXXXXXXXXXXXXXXXXGOOOOOXXXXXXXXXXXXXXGOOOOOOOOOXXXXXXXXXXGOOOOOXXXXXXXXXXXXXXGOOXXXXXXXXXXXXXXXXXGOOOOOXXXXXXXXXXXXXXGOOOOOOXXXXXXXXXXXXXGOOOOOOOOOXXXXXXXXXXGOOOOOOOOOXXXXXXXXXXGOOXXXXXXXXXXXXXXXXXGOOOOOXXXXXXXXXXXXXXGOOOXXXXXXXXXXXXXXXXGOOOOOOOOXXXXXXXXXXX,600,0,0

25515,83,0,83,21,396,0,0,401,371,30,GOOXXXXXXXXXXXXXXXXXGOOOOOXXXXXXXXXXXXXXGOOOOOOOOOXXXXXXXXXXGOOOOOXXXXXXXXXXXXXXGOOXXXXXXXXXXXXXXXXXGOOOOOXXXXXXXXXXXXXXGOOOOOOXXXXXXXXXXXXXGOOOOOOOOOXXXXXXXXXXGOOOOOOOOOXXXXXXXXXXGOOXXXXXXXXXXXXXXXXXGOOOOOXXXXXXXXXXXXXXGOOOXXXXXXXXXXXXXXXXGOOOOOOOOXXXXXXXXXXX,589,11,0
25536,83,0,83,21,396,0,0,401,371,30,GOOXXXXXXXXXXXXXXXXXGOOOOOXXXXXXXXXXXXXXGOOOOOOOOOXXXXXXXXXXGOOOOOXXXXXXXXXXXXXXGOOXXXXXXXXXXXXXXXXXGOOOOOXXXXXXXXXXXXXXGOOOOOOXXXXXXXXXXXXXGOOOOOOOOOXXXXXXXXXXGOOOOOOOOOXXXXXXXXXXGOOXXXXXXXXXXXXXXXXXGOOOOOXXXXXXXXXXXXXXGOOOXXXXXXXXXXXXXXXXGOOOOOOOOXXXXXXXXXXX,565,35,0
25557,83,0,83,24,393,0,0,399,368,31,GOOXXXXXXXXXXXXXXXXXGOOOOOXXXXXXXXXXXXXXGOOOOOOOOOXXXXXXXXXXGOOOOOXXXXXXXXXXXXXXGOOXXXXXXXXXXXXXXXXXGOOOOOXXXXXXXXXXXXXXGOOOOOOXXXXXXXXXXXXXGOOOOOOOOOXXXXXXXXXXGOOOOOOOOOXXXXXXXXXXGOOXXXXXXXXXXXXXXXXXGOOOOOXXXXXXXXXXXXXXGOOOXXXXXXXXXXXXXXXXGOOOOOOOOXXXXXXXXXXX,543,57,0
25578,83,0,83,22,395,0,0,400,368,32,GOOXXXXXXXXXXXXXXXXXGOOOOOXXXXXXXXXXXXXXGOOOOOOOOOXXXXXXXXXXGOOOOOXXXXXXXXXXXXXXGOOXXXXXXXXXXXXXXXXXGOOOOOXXXXXXXXXXXXXXGOOOOOOXXXXXXXXXXXXXGOOOOOOOOOXXXXXXXXXXGOOOOOOOOOXXXXXXXXXXGOOXXXXXXXXXXXXXXXXXGOOOOOXXXXXXXXXXXXXXGOOOXXXXXXXXXXXXXXXXGOOOOOOOOXXXXXXXXXXX,511,89,0
25599,83,0,83,21,396,0,0,402,369,33,GOOXXXXXXXXXXXXXXXXXGOOOOOXXXXXXXXXXXXXXGOOOOOOOOOXXXXXXXXXXGOOOOOXXXXXXXXXXXXXXGOOXXXXXXXXXXXXXXXXXGOOOOOXXXXXXXXXXXXXXGOOOOOOXXXXXXXXXXXXXGOOOOOOOOOXXXXXXXXXXGOOOOOOOOOXXXXXXXXXXGOOXXXXXXXXXXXXXXXXXGOOOOOXXXXXXXXXXXXXXGOOOXXXXXXXXXXXXXXXXGOOOOOOOOXXXXXXXXXXX,492,108,0

25620,83,0,83,19,398,0,0,404,372,32,GOOXXXXXXXXXXXXXXXXXGOOOOOXXXXXXXXXXXXXXGOOOOOOOOOXXXXXXXXXXGOOOOOXXXXXXXXXXXXXXGOOXXXXXXXXXXXXXXXXXGOOOOOXXXXXXXXXXXXXXGOOOOOOXXXXXXXXXXXXXGOOOOOOOOOXXXXXXXXXXGOOOOOOOOOXXXXXXXXXXGOOXXXXXXXXXXXXXXXXXGOOOOOXXXXXXXXXXXXXXGOOOXXXXXXXXXXXXXXXXGOOOOOOOOXXXXXXXXXXX,470,130,0
25641,83,0,83,21,396,0,0,402,372,30,GOOXXXXXXXXXXXXXXXXXGOOOOOXXXXXXXXXXXXXXGOOOOOOOOOXXXXXXXXXXGOOOOOXXXXXXXXXXXXXXGOOXXXXXXXXXXXXXXXXXGOOOOOXXXXXXXXXXXXXXGOOOOOOXXXXXXXXXXXXXGOOOOOOOOOXXXXXXXXXXGOOOOOOOOOXXXXXXXXXXGOOXXXXXXXXXXXXXXXXXGOOOOOXXXXXXXXXXXXXXGOOOXXXXXXXXXXXXXXXXGOOOOOOOOXXXXXXXXXXX,447,153,0
25662,83,0,83,26,391,0,0,397,371,26,GOOXXXXXXXXXXXXXXXXXGOOOOOXXXXXXXXXXXXXXGOOOOOOOOOXXXXXXXXXXGOOOOOXXXXXXXXXXXXXXGOOXXXXXXXXXXXXXXXXXGOOOOOXXXXXXXXXXXXXXGOOOOOOXXXXXXXXXXXXXGOOOOOOOOOXXXXXXXXXXGOOOOOOOOOXXXXXXXXXXGOOXXXXXXXXXXXXXXXXXGOOOOOXXXXXXXXXXXXXXGOOOXXXXXXXXXXXXXXXXGOOOOOOOOXXXXXXXXXXX,429,171,0
25683,83,0,83,28,389,0,0,395,369,26,GOOXXXXXXXXXXXXXXXXXGOOOOOXXXXXXXXXXXXXXGOOOOOOOOOXXXXXXXXXXGOOOOOXXXXXXXXXXXXXXGOOXXXXXXXXXXXXXXXXXGOOOOOXXXXXXXXXXXXXXGOOOOOOXXXXXXXXXXXXXGOOOOOOOOOXXXXXXXXXXGOOOOOOOOOXXXXXXXXXXGOOXXXXXXXXXXXXXXXXXGOOOOOXXXXXXXXXXXXXXGOOOXXXXXXXXXXXXXXXXGOOOOOOOOXXXXXXXXXXX,404,196,0
25704,83,0,83,24,393,0,0,398,367,31,GOOXXXXXXXXXXXXXXXXXGOOOOOXXXXXXXXXXXXXXGOOOOOOOOOXXXXXXXXXXGOOOOOXXXXXXXXXXXXXXGOOXXXXXXXXXXXXXXXXXGOOOOOXXXXXXXXXXXXXXGOOOOOOXXXXXXXXXXXXXGOOOOOOOOOXXXXXXXXXXGOOOOOOOOOXXXXXXXXXXGOOXXXXXXXXXXXXXXXXXGOOOOOXXXXXXXXXXXXXXGOOOXXXXXXXXXXXXXXXXGOOOOOOOOXXXXXXXXXXX,372,228,0

25725,83,0,83,25,392,0,0,398,370,28,GOOXXXXXXXXXXXXXXXXXGOOOOOXXXXXXXXXXXXXXGOOOOOOOOOXXXXXXXXXXGOOOOOXXXXXXXXXXXXXXGOOXXXXXXXXXXXXXXXXXGOOOOOXXXXXXXXXXXXXXGOOOOOOXXXXXXXXXXXXXGOOOOOOOOOXXXXXXXXXXGOOOOOOOOOXXXXXXXXXXGOOXXXXXXXXXXXXXXXXXGOOOOOXXXXXXXXXXXXXXGOOOXXXXXXXXXXXXXXXXGOOOOOOOOXXXXXXXXXXX,351,249,0
25746,83,0,83,22,395,0,0,401,368,33,GOOXXXXXXXXXXXXXXXXXGOOOOOXXXXXXXXXXXXXXGOOOOOOOOOXXXXXXXXXXGOOOOOXXXXXXXXXXXXXXGOOXXXXXXXXXXXXXXXXXGOOOOOXXXXXXXXXXXXXXGOOOOOOXXXXXXXXXXXXXGOOOOOOOOOXXXXXXXXXXGOOOOOOOOOXXXXXXXXXXGOOXXXXXXXXXXXXXXXXXGOOOOOXXXXXXXXXXXXXXGOOOXXXXXXXXXXXXXXXXGOOOOOOOOXXXXXXXXXXX,320,280,0
25767,83,0,83,20,397,0,0,403,368,35,GOOXXXXXXXXXXXXXXXXXGOOOOOXXXXXXXXXXXXXXGOOOOOOOOOXXXXXXXXXXGOOOOOXXXXXXXXXXXXXXGOOXXXXXXXXXXXXXXXXXGOOOOOXXXXXXXXXXXXXXGOOOOOOXXXXXXXXXXXXXGOOOOOOOOOXXXXXXXXXXGOOOOOOOOOXXXXXXXXXXGOOXXXXXXXXXXXXXXXXXGOOOOOXXXXXXXXXXXXXXGOOOXXXXXXXXXXXXXXXXGOOOOOOOOXXXXXXXXXXX,294,306,0
25788,83,0,83,19,398,0,0,404,370,34,GOOXXXXXXXXXXXXXXXXXGOOOOOXXXXXXXXXXXXXXGOOOOOOOOOXXXXXXXXXXGOOOOOXXXXXXXXXXXXXXGOOXXXXXXXXXXXXXXXXXGOOOOOXXXXXXXXXXXXXXGOOOOOOXXXXXXXXXXXXXGOOOOOOOOOXXXXXXXXXXGOOOOOOOOOXXXXXXXXXXGOOXXXXXXXXXXXXXXXXXGOOOOOXXXXXXXXXXXXXXGOOOXXXXXXXXXXXXXXXXGOOOOOOOOXXXXXXXXXXX,272,328,0
25809,83,0,83,18,399,0,0,405,368,37,GOOXXXXXXXXXXXXXXXXXGOOOOOXXXXXXXXXXXXXXGOOOOOOOOOXXXXXXXXXXGOOOOOXXXXXXXXXXXXXXGOOXXXXXXXXXXXXXXXXXGOOOOOXXXXXXXXXXXXXXGOOOOOOXXXXXXXXXXXXXGOOOOOOOOOXXXXXXXXXXGOOOOOOOOOXXXXXXXXXXGOOXXXXXXXXXXXXXXXXXGOOOOOXXXXXXXXXXXXXXGOOOXXXXXXXXXXXXXXXXGOOOOOOOOXXXXXXXXXXX,248,352,0

25830,83,0,83,15,402,0,0,408,367,41,GOOXXXXXXXXXXXXXXXXXGOOOOOXXXXXXXXXXXXXXGOOOOOOOOOXXXXXXXXXXGOOOOOXXXXXXXXXXXXXXGOOXXXXXXXXXXXXXXXXXGOOOOOXXXXXXXXXXXXXXGOOOOOOXXXXXXXXXXXXXGOOOOOOOOOXXXXXXXXXXGOOOOOOOOOXXXXXXXXXXGOOXXXXXXXXXXXXXXXXXGOOOOOXXXXXXXXXXXXXXGOOOXXXXXXXXXXXXXXXXGOOOOOOOOXXXXXXXXXXX,231,369,0
25851,83,0,83,13,404,0,0,410,367,43,GOOXXXXXXXXXXXXXXXXXGOOOOOXXXXXXXXXXXXXXGOOOOOOOOOXXXXXXXXXXGOOOOOXXXXXXXXXXXXXXGOOXXXXXXXXXXXXXXXXXGOOOOOXXXXXXXXXXXXXXGOOOOOOXXXXXXXXXXXXXGOOOOOOOOOXXXXXXXXXXGOOOOOOOOOXXXXXXXXXXGOOXXXXXXXXXXXXXXXXXGOOOOOXXXXXXXXXXXXXXGOOOXXXXXXXXXXXXXXXXGOOOOOOOOXXXXXXXXXXX,196,404,0
25872,83,0,83,12,405,0,0,411,367,44,GOOXXXXXXXXXXXXXXXXXGOOOOOXXXXXXXXXXXXXXGOOOOOOOOOXXXXXXXXXXGOOOOOXXXXXXXXXXXXXXGOOXXXXXXXXXXXXXXXXXGOOOOOXXXXXXXXXXXXXXGOOOOOOXXXXXXXXXXXXXGOOOOOOOOOXXXXXXXXXXGOOOOOOOOOXXXXXXXXXXGOOXXXXXXXXXXXXXXXXXGOOOOOXXXXXXXXXXXXXXGOOOXXXXXXXXXXXXXXXXGOOOOOOOOXXXXXXXXXXX,173,427,0
25893,83,0,83,15,402,0,0,408,367,41,GOOXXXXXXXXXXXXXXXXXGOOOOOXXXXXXXXXXXXXXGOOOOOOOOOXXXXXXXXXXGOOOOOXXXXXXXXXXXXXXGOOXXXXXXXXXXXXXXXXXGOOOOOXXXXXXXXXXXXXXGOOOOOOXXXXXXXXXXXXXGOOOOOOOOOXXXXXXXXXXGOOOOOOOOOXXXXXXXXXXGOOXXXXXXXXXXXXXXXXXGOOOOOXXXXXXXXXXXXXXGOOOXXXXXXXXXXXXXXXXGOOOOOOOOXXXXXXXXXXX,142,458,0
25914,83,0,83,17,400,0,0,406,368,38,GOOXXXXXXXXXXXXXXXXXGOOOOOXXXXXXXXXXXXXXGOOOOOOOOOXXXXXXXXXXGOOOOOXXXXXXXXXXXXXXGOOXXXXXXXXXXXXXXXXXGOOOOOXXXXXXXXXXXXXXGOOOOOOXXXXXXXXXXXXXGOOOOOOOOOXXXXXXXXXXGOOOOOOOOOXXXXXXXXXXGOOXXXXXXXXXXXXXXXXXGOOOOOXXXXXXXXXXXXXXGOOOXXXXXXXXXXXXXXXXGOOOOOOOOXXXXXXXXXXX,112,488,0

25935,83,0,83,15,402,0,0,408,371,37,GOOXXXXXXXXXXXXXXXXXGOOOOOXXXXXXXXXXXXXXGOOOOOOOOOXXXXXXXXXXGOOOOOXXXXXXXXXXXXXXGOOXXXXXXXXXXXXXXXXXGOOOOOXXXXXXXXXXXXXXGOOOOOOXXXXXXXXXXXXXGOOOOOOOOOXXXXXXXXXXGOOOOOOOOOXXXXXXXXXXGOOXXXXXXXXXXXXXXXXXGOOOOOXXXXXXXXXXXXXXGOOOXXXXXXXXXXXXXXXXGOOOOOOOOXXXXXXXXXXX,88,512,0
25956,83,0,83,18,399,0,0,405,369,36,GOOXXXXXXXXXXXXXXXXXGOOOOOXXXXXXXXXXXXXXGOOOOOOOOOXXXXXXXXXXGOOOOOXXXXXXXXXXXXXXGOOXXXXXXXXXXXXXXXXXGOOOOOXXXXXXXXXXXXXXGOOOOOOXXXXXXXXXXXXXGOOOOOOOOOXXXXXXXXXXGOOOOOOOOOXXXXXXXXXXGOOXXXXXXXXXXXXXXXXXGOOOOOXXXXXXXXXXXXXXGOOOXXXXXXXXXXXXXXXXGOOOOOOOOXXXXXXXXXXX,64,536,0
25977,83,0,83,19,398,0,0,404,368,36,GOOXXXXXXXXXXXXXXXXXGOOOOOXXXXXXXXXXXXXXGOOOOOOOOOXXXXXXXXXXGOOOOOXXXXXXXXXXXXXXGOOXXXXXXXXXXXXXXXXXGOOOOOXXXXXXXXXXXXXXGOOOOOOXXXXXXXXXXXXXGOOOOOOOOOXXXXXXXXXXGOOOOOOOOOXXXXXXXXXXGOOXXXXXXXXXXXXXXXXXGOOOOOXXXXXXXXXXXXXXGOOOXXXXXXXXXXXXXXXXGOOOOOOOOXXXXXXXXXXX,31,569,0
25998,83,0,83,19,398,0,0,404,367,37,GOOXXXXXXXXXXXXXXXXXGOOOOOXXXXXXXXXXXXXXGOOOOOOOOOXXXXXXXXXXGOOOOOXXXXXXXXXXXXXXGOOXXXXXXXXXXXXXXXXXGOOOOOXXXXXXXXXXXXXXGOOOOOOXXXXXXXXXXXXXGOOOOOOOOOXXXXXXXXXXGOOOOOOOOOXXXXXXXXXXGOOXXXXXXXXXXXXXXXXXGOOOOOXXXXXXXXXXXXXXGOOOXXXXXXXXXXXXXXXXGOOOOOOOOXXXXXXXXXXX,4,596,0
26019,83,0,83,19,398,0,0,404,367,37,GOOXXXXXXXXXXXXXXXXXGOOOOOXXXXXXXXXXXXXXGOOOOOOOOOXXXXXXXXXXGOOOOOXXXXXXXXXXXXXXGOOXXXXXXXXXXXXXXXXXGOOOOOXXXXXXXXXXXXXXGOOOOOOXXXXXXXXXXXXXGOOOOOOOOOXXXXXXXXXXGOOOOOOOOOXXXXXXXXXXGOOXXXXXXXXXXXXXXXXXGOOOOOXXXXXXXXXXXXXXGOOOXXXXXXXXXXXXXXXXGOOOOOOOOXXXXXXXXXXX,0,600,0

26040,83,0,83,19,398,0,0,404,369,35,GOOXXXXXXXXXXXXXXXXXGOOOOOXXXXXXXXXXXXXXGOOOOOOOOOXXXXXXXXXXGOOOOOXXXXXXXXXXXXXXGOOXXXXXXXXXXXXXXXXXGOOOOOXXXXXXXXXXXXXXGOOOOOOXXXXXXXXXXXXXGOOOOOOOOOXXXXXXXXXXGOOOOOOOOOXXXXXXXXXXGOOXXXXXXXXXXXXXXXXXGOOOOOXXXXXXXXXXXXXXGOOOXXXXXXXXXXXXXXXXGOOOOOOOOXXXXXXXXXXX,0,600,0
26061,83,0,83,18,399,0,0,405,367,38,GOOXXXXXXXXXXXXXXXXXGOOOOOXXXXXXXXXXXXXXGOOOOOOOOOXXXXXXXXXXGOOOOOXXXXXXXXXXXXXXGOOXXXXXXXXXXXXXXXXXGOOOOOXXXXXXXXXXXXXXGOOOOOOXXXXXXXXXXXXXGOOOOOOOOOXXXXXXXXXXGOOOOOOOOOXXXXXXXXXXGOOXXXXXXXXXXXXXXXXXGOOOOOXXXXXXXXXXXXXXGOOOXXXXXXXXXXXXXXXXGOOOOOOOOXXXXXXXXXXX,0,600,0
26082,83,0,83,17,400,0,0,406,368,38,GOOXXXXXXXXXXXXXXXXXGOOOOOXXXXXXXXXXXXXXGOOOOOOOOOXXXXXXXXXXGOOOOOXXXXXXXXXXXXXXGOOXXXXXXXXXXXXXXXXXGOOOOOXXXXXXXXXXXXXXGOOOOOOXXXXXXXXXXXXXGOOOOOOOOOXXXXXXXXXXGOOOOOOOOOXXXXXXXXXXGOOXXXXXXXXXXXXXXXXXGOOOOOXXXXXXXXXXXXXXGOOOXXXXXXXXXXXXXXXXGOOOOOOOOXXXXXXXXXXX,0,600,0
26103,83,0,83,15,402,0,0,408,369,39,GOOXXXXXXXXXXXXXXXXXGOOOOOXXXXXXXXXXXXXXGOOOOOOOOOXXXXXXXXXXGOOOOOXXXXXXXXXXXXXXGOOXXXXXXXXXXXXXXXXXGOOOOOXXXXXXXXXXXXXXGOOOOOOXXXXXXXXXXXXXGOOOOOOOOOXXXXXXXXXXGOOOOOOOOOXXXXXXXXXXGOOXXXXXXXXXXXXXXXXXGOOOOOXXXXXXXXXXXXXXGOOOXXXXXXXXXXXXXXXXGOOOOOOOOXXXXXXXXXXX,0,600,0
26124,83,0,83,16,401,0,0,407,369,38,GOOXXXXXXXXXXXXXXXXXGOOOOOXXXXXXXXXXXXXXGOOOOOOOOOXXXXXXXXXXGOOOOOXXXXXXXXXXXXXXGOOXXXXXXXXXXXXXXXXXGOOOOOXXXXXXXXXXXXXXGOOOOOOXXXXXXXXXXXXXGOOOOOOOOOXXXXXXXXXXGOOOOOOOOOXXXXXXXXXXGOOXXXXXXXXXXXXXXXXXGOOOOOXXXXXXXXXXXXXXGOOOXXXXXXXXXXXXXXXXGOOOOOOOOXXXXXXXXXXX,0,600,0

26145,83,0,83,14,403,0,0,408,369,39,GOOXXXXXXXXXXXXXXXXXGOOOOOXXXXXXXXXXXXXXGOOOOOOOOOXXXXXXXXXXGOOOOOXXXXXXXXXXXXXXGOOXXXXXXXXXXXXXXXXXGOOOOOXXXXXXXXXXXXXXGOOOOOOXXXXXXXXXXXXXGOOOOOOOOOXXXXXXXXXXGOOOOOOOOOXXXXXXXXXXGOOXXXXXXXXXXXXXXXXXGOOOOOXXXXXXXXXXXXXXGOOOXXXXXXXXXXXXXXXXGOOOOOOOOXXXXXXXXXXX,0,600,0
26166,83,0,83,13,404,0,0,410,370,40,GOOXXXXXXXXXXXXXXXXXGOOOOOXXXXXXXXXXXXXXGOOOOOOOOOXXXXXXXXXXGOOOOOXXXXXXXXXXXXXXGOOXXXXXXXXXXXXXXXXXGOOOOOXXXXXXXXXXXXXXGOOOOOOXXXXXXXXXXXXXGOOOOOOOOOXXXXXXXXXXGOOOOOOOOOXXXXXXXXXXGOOXXXXXXXXXXXXXXXXXGOOOOOXXXXXXXXXXXXXXGOOOXXXXXXXXXXXXXXXXGOOOOOOOOXXXXXXXXXXX,0,600,0
26187,83,0,83,18,399,0,0,405,370,35,GOOXXXXXXXXXXXXXXXXXGOOOOOXXXXXXXXXXXXXXGOOOOOOOOOXXXXXXXXXXGOOOOOXXXXXXXXXXXXXXGOOXXXXXXXXXXXXXXXXXGOOOOOXXXXXXXXXXXXXXGOOOOOOXXXXXXXXXXXXXGOOOOOOOOOXXXXXXXXXXGOOOOOOOOOXXXXXXXXXXGOOXXXXXXXXXXXXXXXXXGOOOOOXXXXXXXXXXXXXXGOOOXXXXXXXXXXXXXXXXGOOOOOOOOXXXXXXXXXXX,0,600,0
26208,83,0,83,20,397,0,0,403,369,34,GOOXXXXXXXXXXXXXXXXXGOOOOOXXXXXXXXXXXXXXGOOOOOOOOOXXXXXXXXXXGOOOOOXXXXXXXXXXXXXXGOOXXXXXXXXXXXXXXXXXGOOOOOXXXXXXXXXXXXXXGOOOOOOXXXXXXXXXXXXXGOOOOOOOOOXXXXXXXXXXGOOOOOOOOOXXXXXXXXXXGOOXXXXXXXXXXXXXXXXXGOOOOOXXXXXXXXXXXXXXGOOOXXXXXXXXXXXXXXXXGOOOOOOOOXXXXXXXXXXX,0,600,0
26229,83,0,83,22,395,0,0,401,370,31,GOOXXXXXXXXXXXXXXXXXGOOOOOXXXXXXXXXXXXXXGOOOOOOOOOXXXXXXXXXXGOOOOOXXXXXXXXXXXXXXGOOXXXXXXXXXXXXXXXXXGOOOOOXXXXXXXXXXXXXXGOOOOOOXXXXXXXXXXXXXGOOOOOOOOOXXXXXXXXXXGOOOOOOOOOXXXXXXXXXXGOOXXXXXXXXXXXXXXXXXGOOOOOXXXXXXXXXXXXXXGOOOXXXXXXXXXXXXXXXXGOOOOOOOOXXXXXXXXXXX,0,600,0

26250,83,0,83,22,395,0,0,402,371,31,GOOXXXXXXXXXXXXXXXXXGOOOOOXXXXXXXXXXXXXXGOOOOOOOOOXXXXXXXXXXGOOOOOXXXXXXXXXXXXXXGOOXXXXXXXXXXXXXXXXXGOOOOOXXXXXXXXXXXXXXGOOOOOOXXXXXXXXXXXXXGOOOOOOOOOXXXXXXXXXXGOOOOOOOOOXXXXXXXXXXGOOXXXXXXXXXXXXXXXXXGOOOOOXXXXXXXXXXXXXXGOOOXXXXXXXXXXXXXXXXGOOOOOOOOXXXXXXXXXXX,0,600,0
26271,83,0,83,21,396,0,0,403,371,32,GOOXXXXXXXXXXXXXXXXXGOOOOOXXXXXXXXXXXXXXGOOOOOOOOOXXXXXXXXXXGOOOOOXXXXXXXXXXXXXXGOOXXXXXXXXXXXXXXXXXGOOOOOXXXXXXXXXXXXXXGOOOOOOXXXXXXXXXXXXXGOOOOOOOOOXXXXXXXXXXGOOOOOOOOOXXXXXXXXXXGOOXXXXXXXXXXXXXXXXXGOOOOOXXXXXXXXXXXXXXGOOOXXXXXXXXXXXXXXXXGOOOOOOOOXXXXXXXXXXX,0,600,0
26292,83,0,83,21,396,0,0,402,372,30,GOOXXXXXXXXXXXXXXXXXGOOOOOXXXXXXXXXXXXXXGOOOOOOOOOXXXXXXXXXXGOOOOOXXXXXXXXXXXXXXGOOXXXXXXXXXXXXXXXXXGOOOOOXXXXXXXXXXXXXXGOOOOOOXXXXXXXXXXXXXGOOOOOOOOOXXXXXXXXXXGOOOOOOOOOXXXXXXXXXXGOOXXXXXXXXXXXXXXXXXGOOOOOXXXXXXXXXXXXXXGOOOXXXXXXXXXXXXXXXXGOOOOOOOOXXXXXXXXXXX,0,600,0
26313,83,0,83,22,395,0,0,402,373,29,GOOXXXXXXXXXXXXXXXXXGOOOOOXXXXXXXXXXXXXXGOOOOOOOOOXXXXXXXXXXGOOOOOXXXXXXXXXXXXXXGOOXXXXXXXXXXXXXXXXXGOOOOOXXXXXXXXXXXXXXGOOOOOOXXXXXXXXXXXXXGOOOOOOOOOXXXXXXXXXXGOOOOOOOOOXXXXXXXXXXGOOXXXXXXXXXXXXXXXXXGOOOOOXXXXXXXXXXXXXXGOOOXXXXXXXXXXXXXXXXGOOOOOOOOXXXXXXXXXXX,0,600,0
26334,83,0,83,24,393,0,0,400,372,28,GOOXXXXXXXXXXXXXXXXXGOOOOOXXXXXXXXXXXXXXGOOOOOOOOOXXXXXXXXXXGOOOOOXXXXXXXXXXXXXXGOOXXXXXXXXXXXXXXXXXGOOOOOXXXXXXXXXXXXXXGOOOOOOXXXXXXXXXXXXXGOOOOOOOOOXXXXXXXXXXGOOOOOOOOOXXXXXXXXXXGOOXXXXXXXXXXXXXXXXXGOOOOOXXXXXXXXXXXXXXGOOOXXXXXXXXXXXXXXXXGOOOOOOOOXXXXXXXXXXX,0,600,0

26355,83,0,83,21,396,0,0,402,371,31,GOOXXXXXXXXXXXXXXXXXGOOOOOXXXXXXXXXXXXXXGOOOOOOOOOXXXXXXXXXXGOOOOOXXXXXXXXXXXXXXGOOXXXXXXXXXXXXXXXXXGOOOOOXXXXXXXXXXXXXXGOOOOOOXXXXXXXXXXXXXGOOOOOOOOOXXXXXXXXXXGOOOOOOOOOXXXXXXXXXXGOOXXXXXXXXXXXXXXXXXGOOOOOXXXXXXXXXXXXXXGOOOXXXXXXXXXXXXXXXXGOOOOOOOOXXXXXXXXXXX,0,600,0
26376,83,0,83,21,396,0,0,403,372,31,GOOXXXXXXXXXXXXXXXXXGOOOOOXXXXXXXXXXXXXXGOOOOOOOOOXXXXXXXXXXGOOOOOXXXXXXXXXXXXXXGOOXXXXXXXXXXXXXXXXXGOOOOOXXXXXXXXXXXXXXGOOOOOOXXXXXXXXXXXXXGOOOOOOOOOXXXXXXXXXXGOOOOOOOOOXXXXXXXXXXGOOXXXXXXXXXXXXXXXXXGOOOOOXXXXXXXXXXXXXXGOOOXXXXXXXXXXXXXXXXGOOOOOOOOXXXXXXXXXXX,0,600,0
26397,83,0,83,23,394,0,0,401,372,29,GOOXXXXXXXXXXXXXXXXXGOOOOOXXXXXXXXXXXXXXGOOOOOOOOOXXXXXXXXXXGOOOOOXXXXXXXXXXXXXXGOOXXXXXXXXXXXXXXXXXGOOOOOXXXXXXXXXXXXXXGOOOOOOXXXXXXXXXXXXXGOOOOOOOOOXXXXXXXXXXGOOOOOOOOOXXXXXXXXXXGOOXXXXXXXXXXXXXXXXXGOOOOOXXXXXXXXXXXXXXGOOOXXXXXXXXXXXXXXXXGOOOOOOOOXXXXXXXXXXX,0,600,0
26418,83,0,83,22,395,0,0,402,371,31,GOOXXXXXXXXXXXXXXXXXGOOOOOXXXXXXXXXXXXXXGOOOOOOOOOXXXXXXXXXXGOOOOOXXXXXXXXXXXXXXGOOXXXXXXXXXXXXXXXXXGOOOOOXXXXXXXXXXXXXXGOOOOOOXXXXXXXXXXXXXGOOOOOOOOOXXXXXXXXXXGOOOOOOOOOXXXXXXXXXXGOOXXXXXXXXXXXXXXXXXGOOOOOXXXXXXXXXXXXXXGOOOXXXXXXXXXXXXXXXXGOOOOOOOOXXXXXXXXXXX,0,600,0
26439,83,0,83,24,393,0,0,400,372,28,GOOXXXXXXXXXXXXXXXXXGOOOOOXXXXXXXXXXXXXXGOOOOOOOOOXXXXXXXXXXGOOOOOXXXXXXXXXXXXXXGOOXXXXXXXXXXXXXXXXXGOOOOOXXXXXXXXXXXXXXGOOOOOOXXXXXXXXXXXXXGOOOOOOOOOXXXXXXXXXXGOOOOOOOOOXXXXXXXXXXGOOXXXXXXXXXXXXXXXXXGOOOOOXXXXXXXXXXXXXXGOOOXXXXXXXXXXXXXXXXGOOOOOOOOXXXXXXXXXXX,0,600,0

26460,83,0,83,23,394,0,0,400,372,28,GOOXXXXXXXXXXXXXXXXXGOOOOOXXXXXXXXXXXXXXGOOOOOOOOOXXXXXXXXXXGOOOOOXXXXXXXXXXXXXXGOOXXXXXXXXXXXXXXXXXGOOOOOXXXXXXXXXXXXXXGOOOOOOXXXXXXXXXXXXXGOOOOOOOOOXXXXXXXXXXGOOOOOOOOOXXXXXXXXXXGOOXXXXXXXXXXXXXXXXXGOOOOOXXXXXXXXXXXXXXGOOOXXXXXXXXXXXXXXXXGOOOOOOOOXXXXXXXXXXX,0,600,0
26481,83,0,83,23,394,0,0,400,372,28,GOOXXXXXXXXXXXXXXXXXGOOOOOXXXXXXXXXXXXXXGOOOOOOOOOXXXXXXXXXXGOOOOOXXXXXXXXXXXXXXGOOXXXXXXXXXXXXXXXXXGOOOOOXXXXXXXXXXXXXXGOOOOOOXXXXXXXXXXXXXGOOOOOOOOOXXXXXXXXXXGOOOOOOOOOXXXXXXXXXXGOOXXXXXXXXXXXXXXXXXGOOOOOXXXXXXXXXXXXXXGOOOXXXXXXXXXXXXXXXXGOOOOOOOOXXXXXXXXXXX,0,600,0
26502,83,0,83,24,393,0,0,399,371,28,GOOXXXXXXXXXXXXXXXXXGOOOOOXXXXXXXXXXXXXXGOOOOOOOOOXXXXXXXXXXGOOOOOXXXXXXXXXXXXXXGOOXXXXXXXXXXXXXXXXXGOOOOOXXXXXXXXXXXXXXGOOOOOOXXXXXXXXXXXXXGOOOOOOOOOXXXXXXXXXXGOOOOOOOOOXXXXXXXXXXGOOXXXXXXXXXXXXXXXXXGOOOOOXXXXXXXXXXXXXXGOOOXXXXXXXXXXXXXXXXGOOOOOOOOXXXXXXXXXXX,0,600,0
26523,83,0,83,22,395,0,0,401,371,30,GOOXXXXXXXXXXXXXXXXXGOOOOOXXXXXXXXXXXXXXGOOOOOOOOOXXXXXXXXXXGOOOOOXXXXXXXXXXXXXXGOOXXXXXXXXXXXXXXXXXGOOOOOXXXXXXXXXXXXXXGOOOOOOXXXXXXXXXXXXXGOOOOOOOOOXXXXXXXXXXGOOOOOOOOOXXXXXXXXXXGOOXXXXXXXXXXXXXXXXXGOOOOOXXXXXXXXXXXXXXGOOOXXXXXXXXXXXXXXXXGOOOOOOOOXXXXXXXXXXX,0,600,0
26544,83,0,83,21,396,0,0,402,371,31,GOOXXXXXXXXXXXXXXXXXGOOOOOXXXXXXXXXXXXXXGOOOOOOOOOXXXXXXXXXXGOOOOOXXXXXXXXXXXXXXGOOXXXXXXXXXXXXXXXXXGOOOOOXXXXXXXXXXXXXXGOOOOOOXXXXXXXXXXXXXGOOOOOOOOOXXXXXXXXXXGOOOOOOOOOXXXXXXXXXXGOOXXXXXXXXXXXXXXXXXGOOOOOXXXXXXXXXXXXXXGOOOXXXXXXXXXXXXXXXXGOOOOOOOOXXXXXXXXXXX,0,600,0

26565,83,0,83,17,400,0,0,406,371,35,GOOXXXXXXXXXXXXXXXXXGOOOOOXXXXXXXXXXXXXXGOOOOOOOOOXXXXXXXXXXGOOOOOXXXXXXXXXXXXXXGOOXXXXXXXXXXXXXXXXXGOOOOOXXXXXXXXXXXXXXGOOOOOOXXXXXXXXXXXXXGOOOOOOOOOXXXXXXXXXXGOOOOOOOOOXXXXXXXXXXGOOXXXXXXXXXXXXXXXXXGOOOOOXXXXXXXXXXXXXXGOOOXXXXXXXXXXXXXXXXGOOOOOOOOXXXXXXXXXXX,0,600,0
26586,83,0,83,17,400,0,0,406,373,33,GOOXXXXXXXXXXXXXXXXXGOOOOOXXXXXXXXXXXXXXGOOOOOOOOOXXXXXXXXXXGOOOOOXXXXXXXXXXXXXXGOOXXXXXXXXXXXXXXXXXGOOOOOXXXXXXXXXXXXXXGOOOOOOXXXXXXXXXXXXXGOOOOOOOOOXXXXXXXXXXGOOOOOOOOOXXXXXXXXXXGOOXXXXXXXXXXXXXXXXXGOOOOOXXXXXXXXXXXXXXGOOOXXXXXXXXXXXXXXXXGOOOOOOOOXXXXXXXXXXX,0,600,0
26607,83,0,83,17,400,0,0,406,373,33,GOOXXXXXXXXXXXXXXXXXGOOOOOXXXXXXXXXXXXXXGOOOOOOOOOXXXXXXXXXXGOOOOOXXXXXXXXXXXXXXGOOXXXXXXXXXXXXXXXXXGOOOOOXXXXXXXXXXXXXXGOOOOOOXXXXXXXXXXXXXGOOOOOOOOOXXXXXXXXXXGOOOOOOOOOXXXXXXXXXXGOOXXXXXXXXXXXXXXXXXGOOOOOXXXXXXXXXXXXXXGOOOXXXXXXXXXXXXXXXXGOOOOOOOOXXXXXXXXXXX,0,600,0
26628,83,0,83,15,402,0,0,408,372,36,GOOXXXXXXXXXXXXXXXXXGOOOOOXXXXXXXXXXXXXXGOOOOOOOOOXXXXXXXXXXGOOOOOXXXXXXXXXXXXXXGOOXXXXXXXXXXXXXXXXXGOOOOOXXXXXXXXXXXXXXGOOOOOOXXXXXXXXXXXXXGOOOOOOOOOXXXXXXXXXXGOOOOOOOOOXXXXXXXXXXGOOXXXXXXXXXXXXXXXXXGOOOOOXXXXXXXXXXXXXXGOOOXXXXXXXXXXXXXXXXGOOOOOOOOXXXXXXXXXXX,0,600,0
26649,83,0,83,14,403,0,0,409,372,37,GOOXXXXXXXXXXXXXXXXXGOOOOOXXXXXXXXXXXXXXGOOOOOOOOOXXXXXXXXXXGOOOOOXXXXXXXXXXXXXXGOOXXXXXXXXXXXXXXXXXGOOOOOXXXXXXXXXXXXXXGOOOOOOXXXXXXXXXXXXXGOOOOOOOOOXXXXXXXXXXGOOOOOOOOOXXXXXXXXXXGOOXXXXXXXXXXXXXXXXXGOOOOOXXXXXXXXXXXXXXGOOOXXXXXXXXXXXXXXXXGOOOOOOOOXXXXXXXXXXX,0,600,0

26670,83,0,83,13,404,0,0,409,373,36,GOOXXXXXXXXXXXXXXXXXGOOOOOXXXXXXXXXXXXXXGOOOOOOOOOXXXXXXXXXXGOOOOOXXXXXXXXXXXXXXGOOXXXXXXXXXXXXXXXXXGOOOOOXXXXXXXXXXXXXXGOOOOOOXXXXXXXXXXXXXGOOOOOOOOOXXXXXXXXXXGOOOOOOOOOXXXXXXXXXXGOOXXXXXXXXXXXXXXXXXGOOOOOXXXXXXXXXXXXXXGOOOXXXXXXXXXXXXXXXXGOOOOOOOOXXXXXXXXXXX,0,600,0
26691,83,0,83,13,404,0,0,410,373,37,GOOXXXXXXXXXXXXXXXXXGOOOOOXXXXXXXXXXXXXXGOOOOOOOOOXXXXXXXXXXGOOOOOXXXXXXXXXXXXXXGOOXXXXXXXXXXXXXXXXXGOOOOOXXXXXXXXXXXXXXGOOOOOOXXXXXXXXXXXXXGOOOOOOOOOXXXXXXXXXXGOOOOOOOOOXXXXXXXXXXGOOXXXXXXXXXXXXXXXXXGOOOOOXXXXXXXXXXXXXXGOOOXXXXXXXXXXXXXXXXGOOOOOOOOXXXXXXXXXXX,0,600,0
26712,83,0,83,14,403,0,0,409,373,36,GOOXXXXXXXXXXXXXXXXXGOOOOOXXXXXXXXXXXXXXGOOOOOOOOOXXXXXXXXXXGOOOOOXXXXXXXXXXXXXXGOOXXXXXXXXXXXXXXXXXGOOOOOXXXXXXXXXXXXXXGOOOOOOXXXXXXXXXXXXXGOOOOOOOOOXXXXXXXXXXGOOOOOOOOOXXXXXXXXXXGOOXXXXXXXXXXXXXXXXXGOOOOOXXXXXXXXXXXXXXGOOOXXXXXXXXXXXXXXXXGOOOOOOOOXXXXXXXXXXX,0,600,0
26733,83,0,83,15,402,0,0,408,372,36,GOOXXXXXXXXXXXXXXXXXGOOOOOXXXXXXXXXXXXXXGOOOOOOOOOXXXXXXXXXXGOOOOOXXXXXXXXXXXXXXGOOXXXXXXXXXXXXXXXXXGOOOOOXXXXXXXXXXXXXXGOOOOOOXXXXXXXXXXXXXGOOOOOOOOOXXXXXXXXXXGOOOOOOOOOXXXXXXXXXXGOOXXXXXXXXXXXXXXXXXGOOOOOXXXXXXXXXXXXXXGOOOXXXXXXXXXXXXXXXXGOOOOOOOOXXXXXXXXXXX,0,600,0
26754,83,0,83,18,399,0,0,405,373,32,GOOXXXXXXXXXXXXXXXXXGOOOOOXXXXXXXXXXXXXXGOOOOOOOOOXXXXXXXXXXGOOOOOXXXXXXXXXXXXXXGOOXXXXXXXXXXXXXXXXXGOOOOOXXXXXXXXXXXXXXGOOOOOOXXXXXXXXXXXXXGOOOOOOOOOXXXXXXXXXXGOOOOOOOOOXXXXXXXXXXGOOXXXXXXXXXXXXXXXXXGOOOOOXXXXXXXXXXXXXXGOOOXXXXXXXXXXXXXXXXGOOOOOOOOXXXXXXXXXXX,0,600,0

26775,83,0,83,20,397,0,0,403,372,31,GOOXXXXXXXXXXXXXXXXXGOOOOOXXXXXXXXXXXXXXGOOOOOOOOOXXXXXXXXXXGOOOOOXXXXXXXXXXXXXXGOOXXXXXXXXXXXXXXXXXGOOOOOXXXXXXXXXXXXXXGOOOOOOXXXXXXXXXXXXXGOOOOOOOOOXXXXXXXXXXGOOOOOOOOOXXXXXXXXXXGOOXXXXXXXXXXXXXXXXXGOOOOOXXXXXXXXXXXXXXGOOOXXXXXXXXXXXXXXXXGOOOOOOOOXXXXXXXXXXX,0,600,0
26796,83,0,83,18,399,0,0,405,373,32,GOOXXXXXXXXXXXXXXXXXGOOOOOXXXXXXXXXXXXXXGOOOOOOOOOXXXXXXXXXXGOOOOOXXXXXXXXXXXXXXGOOXXXXXXXXXXXXXXXXXGOOOOOXXXXXXXXXXXXXXGOOOOOOXXXXXXXXXXXXXGOOOOOOOOOXXXXXXXXXXGOOOOOOOOOXXXXXXXXXXGOOXXXXXXXXXXXXXXXXXGOOOOOXXXXXXXXXXXXXXGOOOXXXXXXXXXXXXXXXXGOOOOOOOOXXXXXXXXXXX,0,600,0
26817,83,0,83,19,398,0,0,405,374,31,GOOXXXXXXXXXXXXXXXXXGOOOOOXXXXXXXXXXXXXXGOOOOOOOOOXXXXXXXXXXGOOOOOXXXXXXXXXXXXXXGOOXXXXXXXXXXXXXXXXXGOOOOOXXXXXXXXXXXXXXGOOOOOOXXXXXXXXXXXXXGOOOOOOOOOXXXXXXXXXXGOOOOOOOOOXXXXXXXXXXGOOXXXXXXXXXXXXXXXXXGOOOOOXXXXXXXXXXXXXXGOOOXXXXXXXXXXXXXXXXGOOOOOOOOXXXXXXXXXXX,0,600,0
26838,83,0,83,22,395,0,0,402,372,30,GOOXXXXXXXXXXXXXXXXXGOOOOOXXXXXXXXXXXXXXGOOOOOOOOOXXXXXXXXXXGOOOOOXXXXXXXXXXXXXXGOOXXXXXXXXXXXXXXXXXGOOOOOXXXXXXXXXXXXXXGOOOOOOXXXXXXXXXXXXXGOOOOOOOOOXXXXXXXXXXGOOOOOOOOOXXXXXXXXXXGOOXXXXXXXXXXXXXXXXXGOOOOOXXXXXXXXXXXXXXGOOOXXXXXXXXXXXXXXXXGOOOOOOOOXXXXXXXXXXX,0,600,0
26859,83,0,83,22,395,0,0,401,373,28,GOOXXXXXXXXXXXXXXXXXGOOOOOXXXXXXXXXXXXXXGOOOOOOOOOXXXXXXXXXXGOOOOOXXXXXXXXXXXXXXGOOXXXXXXXXXXXXXXXXXGOOOOOXXXXXXXXXXXXXXGOOOOOOXXXXXXXXXXXXXGOOOOOOOOOXXXXXXXXXXGOOOOOOOOOXXXXXXXXXXGOOXXXXXXXXXXXXXXXXXGOOOOOXXXXXXXXXXXXXXGOOOXXXXXXXXXXXXXXXXGOOOOOOOOXXXXXXXXXXX,0,600,0

26880,83,0,83,22,395,0,0,400,373,27,GOOXXXXXXXXXXXXXXXXXGOOOOOXXXXXXXXXXXXXXGOOOOOOOOOXXXXXXXXXXGOOOOOXXXXXXXXXXXXXXGOOXXXXXXXXXXXXXXXXXGOOOOOXXXXXXXXXXXXXXGOOOOOOXXXXXXXXXXXXXGOOOOOOOOOXXXXXXXXXXGOOOOOOOOOXXXXXXXXXXGOOXXXXXXXXXXXXXXXXXGOOOOOXXXXXXXXXXXXXXGOOOXXXXXXXXXXXXXXXXGOOOOOOOOXXXXXXXXXXX,0,600,0
26901,83,0,83,22,395,0,0,401,374,27,GOOXXXXXXXXXXXXXXXXXGOOOOOXXXXXXXXXXXXXXGOOOOOOOOOXXXXXXXXXXGOOOOOXXXXXXXXXXXXXXGOOXXXXXXXXXXXXXXXXXGOOOOOXXXXXXXXXXXXXXGOOOOOOXXXXXXXXXXXXXGOOOOOOOOOXXXXXXXXXXGOOOOOOOOOXXXXXXXXXXGOOXXXXXXXXXXXXXXXXXGOOOOOXXXXXXXXXXXXXXGOOOXXXXXXXXXXXXXXXXGOOOOOOOOXXXXXXXXXXX,0,600,0
26922,83,0,83,20,397,0,0,403,375,28,GOOXXXXXXXXXXXXXXXXXGOOOOOXXXXXXXXXXXXXXGOOOOOOOOOXXXXXXXXXXGOOOOOXXXXXXXXXXXXXXGOOXXXXXXXXXXXXXXXXXGOOOOOXXXXXXXXXXXXXXGOOOOOOXXXXXXXXXXXXXGOOOOOOOOOXXXXXXXXXXGOOOOOOOOOXXXXXXXXXXGOOXXXXXXXXXXXXXXXXXGOOOOOXXXXXXXXXXXXXXGOOOXXXXXXXXXXXXXXXXGOOOOOOOOXXXXXXXXXXX,0,600,0
26943,83,0,83,22,395,0,0,400,373,27,GOOXXXXXXXXXXXXXXXXXGOOOOOXXXXXXXXXXXXXXGOOOOOOOOOXXXXXXXXXXGOOOOOXXXXXXXXXXXXXXGOOXXXXXXXXXXXXXXXXXGOOOOOXXXXXXXXXXXXXXGOOOOOOXXXXXXXXXXXXXGOOOOOOOOOXXXXXXXXXXGOOOOOOOOOXXXXXXXXXXGOOXXXXXXXXXXXXXXXXXGOOOOOXXXXXXXXXXXXXXGOOOXXXXXXXXXXXXXXXXGOOOOOOOOXXXXXXXXXXX,0,600,0
26964,83,0,83,16,401,0,0,407,374,33,GOOXXXXXXXXXXXXXXXXXGOOOOOXXXXXXXXXXXXXXGOOOOOOOOOXXXXXXXXXXGOOOOOXXXXXXXXXXXXXXGOOXXXXXXXXXXXXXXXXXGOOOOOXXXXXXXXXXXXXXGOOOOOOXXXXXXXXXXXXXGOOOOOOOOOXXXXXXXXXXGOOOOOOOOOXXXXXXXXXXGOOXXXXXXXXXXXXXXXXXGOOOOOXXXXXXXXXXXXXXGOOOXXXXXXXXXXXXXXXXGOOOOOOOOXXXXXXXXXXX,0,600,0

26985,83,0,83,14,403,0,0,409,372,37,GOOXXXXXXXXXXXXXXXXXGOOOOOXXXXXXXXXXXXXXGOOOOOOOOOXXXXXXXXXXGOOOOOXXXXXXXXXXXXXXGOOXXXXXXXXXXXXXXXXXGOOOOOXXXXXXXXXXXXXXGOOOOOOXXXXXXXXXXXXXGOOOOOOOOOXXXXXXXXXXGOOOOOOOOOXXXXXXXXXXGOOXXXXXXXXXXXXXXXXXGOOOOOXXXXXXXXXXXXXXGOOOXXXXXXXXXXXXXXXXGOOOOOOOOXXXXXXXXXXX,0,600,0
27006,83,0,83,12,405,0,0,411,373,38,GOOXXXXXXXXXXXXXXXXXGOOOOOXXXXXXXXXXXXXXGOOOOOOOOOXXXXXXXXXXGOOOOOXXXXXXXXXXXXXXGOOXXXXXXXXXXXXXXXXXGOOOOOXXXXXXXXXXXXXXGOOOOOOXXXXXXXXXXXXXGOOOOOOOOOXXXXXXXXXXGOOOOOOOOOXXXXXXXXXXGOOXXXXXXXXXXXXXXXXXGOOOOOXXXXXXXXXXXXXXGOOOXXXXXXXXXXXXXXXXGOOOOOOOOXXXXXXXXXXX,0,600,0
27027,83,0,83,12,405,0,0,411,377,34,GOOXXXXXXXXXXXXXXXXXGOOOOOXXXXXXXXXXXXXXGOOOOOOOOOXXXXXXXXXXGOOOOOXXXXXXXXXXXXXXGOOXXXXXXXXXXXXXXXXXGOOOOOXXXXXXXXXXXXXXGOOOOOOXXXXXXXXXXXXXGOOOOOOOOOXXXXXXXXXXGOOOOOOOOOXXXXXXXXXXGOOXXXXXXXXXXXXXXXXXGOOOOOXXXXXXXXXXXXXXGOOOXXXXXXXXXXXXXXXXGOOOOOOOOXXXXXXXXXXX,0,600,0
27048,83,0,83,15,402,0,0,409,374,35,GOOXXXXXXXXXXXXXXXXXGOOOOOXXXXXXXXXXXXXXGOOOOOOOOOXXXXXXXXXXGOOOOOXXXXXXXXXXXXXXGOOXXXXXXXXXXXXXXXXXGOOOOOXXXXXXXXXXXXXXGOOOOOOXXXXXXXXXXXXXGOOOOOOOOOXXXXXXXXXXGOOOOOOOOOXXXXXXXXXXGOOXXXXXXXXXXXXXXXXXGOOOOOXXXXXXXXXXXXXXGOOOXXXXXXXXXXXXXXXXGOOOOOOOOXXXXXXXXXXX,0,600,0
27069,83,0,83,18,399,0,0,406,372,34,GOOXXXXXXXXXXXXXXXXXGOOOOOXXXXXXXXXXXXXXGOOOOOOOOOXXXXXXXXXXGOOOOOXXXXXXXXXXXXXXGOOXXXXXXXXXXXXXXXXXGOOOOOXXXXXXXXXXXXXXGOOOOOOXXXXXXXXXXXXXGOOOOOOOOOXXXXXXXXXXGOOOOOOOOOXXXXXXXXXXGOOXXXXXXXXXXXXXXXXXGOOOOOXXXXXXXXXXXXXXGOOOXXXXXXXXXXXXXXXXGOOOOOOOOXXXXXXXXXXX,0,600,0

27090,83,0,83,19,398,0,0,405,372,33,GOOXXXXXXXXXXXXXXXXXGOOOOOXXXXXXXXXXXXXXGOOOOOOOOOXXXXXXXXXXGOOOOOXXXXXXXXXXXXXXGOOXXXXXXXXXXXXXXXXXGOOOOOXXXXXXXXXXXXXXGOOOOOOXXXXXXXXXXXXXGOOOOOOOOOXXXXXXXXXXGOOOOOOOOOXXXXXXXXXXGOOXXXXXXXXXXXXXXXXXGOOOOOXXXXXXXXXXXXXXGOOOXXXXXXXXXXXXXXXXGOOOOOOOOXXXXXXXXXXX,0,600,0
27111,83,0,83,16,401,0,0,408,372,36,GOOXXXXXXXXXXXXXXXXXGOOOOOXXXXXXXXXXXXXXGOOOOOOOOOXXXXXXXXXXGOOOOOXXXXXXXXXXXXXXGOOXXXXXXXXXXXXXXXXXGOOOOOXXXXXXXXXXXXXXGOOOOOOXXXXXXXXXXXXXGOOOOOOOOOXXXXXXXXXXGOOOOOOOOOXXXXXXXXXXGOOXXXXXXXXXXXXXXXXXGOOOOOXXXXXXXXXXXXXXGOOOXXXXXXXXXXXXXXXXGOOOOOOOOXXXXXXXXXXX,0,600,0
27132,83,0,83,18,399,0,0,406,371,35,GOOXXXXXXXXXXXXXXXXXGOOOOOXXXXXXXXXXXXXXGOOOOOOOOOXXXXXXXXXXGOOOOOXXXXXXXXXXXXXXGOOXXXXXXXXXXXXXXXXXGOOOOOXXXXXXXXXXXXXXGOOOOOOXXXXXXXXXXXXXGOOOOOOOOOXXXXXXXXXXGOOOOOOOOOXXXXXXXXXXGOOXXXXXXXXXXXXXXXXXGOOOOOXXXXXXXXXXXXXXGOOOXXXXXXXXXXXXXXXXGOOOOOOOOXXXXXXXXXXX,0,600,0
27153,83,0,83,16,401,0,0,408,373,35,GOOXXXXXXXXXXXXXXXXXGOOOOOXXXXXXXXXXXXXXGOOOOOOOOOXXXXXXXXXXGOOOOOXXXXXXXXXXXXXXGOOXXXXXXXXXXXXXXXXXGOOOOOXXXXXXXXXXXXXXGOOOOOOXXXXXXXXXXXXXGOOOOOOOOOXXXXXXXXXXGOOOOOOOOOXXXXXXXXXXGOOXXXXXXXXXXXXXXXXXGOOOOOXXXXXXXXXXXXXXGOOOXXXXXXXXXXXXXXXXGOOOOOOOOXXXXXXXXXXX,0,600,0
27174,83,0,83,16,401,0,0,408,372,36,GOOXXXXXXXXXXXXXXXXXGOOOOOXXXXXXXXXXXXXXGOOOOOOOOOXXXXXXXXXXGOOOOOXXXXXXXXXXXXXXGOOXXXXXXXXXXXXXXXXXGOOOOOXXXXXXXXXXXXXXGOOOOOOXXXXXXXXXXXXXGOOOOOOOOOXXXXXXXXXXGOOOOOOOOOXXXXXXXXXXGOOXXXXXXXXXXXXXXXXXGOOOOOXXXXXXXXXXXXXXGOOOXXXXXXXXXXXXXXXXGOOOOOOOOXXXXXXXXXXX,0,600,0

27195,83,0,83,16,401,0,0,407,371,36,GOOXXXXXXXXXXXXXXXXXGOOOOOXXXXXXXXXXXXXXGOOOOOOOOOXXXXXXXXXXGOOOOOXXXXXXXXXXXXXXGOOXXXXXXXXXXXXXXXXXGOOOOOXXXXXXXXXXXXXXGOOOOOOXXXXXXXXXXXXXGOOOOOOOOOXXXXXXXXXXGOOOOOOOOOXXXXXXXXXXGOOXXXXXXXXXXXXXXXXXGOOOOOXXXXXXXXXXXXXXGOOOXXXXXXXXXXXXXXXXGOOOOOOOOXXXXXXXXXXX,0,600,0
27216,83,0,83,16,401,0,0,407,371,36,GOOXXXXXXXXXXXXXXXXXGOOOOOXXXXXXXXXXXXXXGOOOOOOOOOXXXXXXXXXXGOOOOOXXXXXXXXXXXXXXGOOXXXXXXXXXXXXXXXXXGOOOOOXXXXXXXXXXXXXXGOOOOOOXXXXXXXXXXXXXGOOOOOOOOOXXXXXXXXXXGOOOOOOOOOXXXXXXXXXXGOOXXXXXXXXXXXXXXXXXGOOOOOXXXXXXXXXXXXXXGOOOXXXXXXXXXXXXXXXXGOOOOOOOOXXXXXXXXXXX,0,600,0
27237,83,0,83,18,399,0,0,405,372,33,GOOXXXXXXXXXXXXXXXXXGOOOOOXXXXXXXXXXXXXXGOOOOOOOOOXXXXXXXXXXGOOOOOXXXXXXXXXXXXXXGOOXXXXXXXXXXXXXXXXXGOOOOOXXXXXXXXXXXXXXGOOOOOOXXXXXXXXXXXXXGOOOOOOOOOXXXXXXXXXXGOOOOOOOOOXXXXXXXXXXGOOXXXXXXXXXXXXXXXXXGOOOOOXXXXXXXXXXXXXXGOOOXXXXXXXXXXXXXXXXGOOOOOOOOXXXXXXXXXXX,0,600,0
27258,83,0,83,19,398,0,0,404,372,32,GOOXXXXXXXXXXXXXXXXXGOOOOOXXXXXXXXXXXXXXGOOOOOOOOOXXXXXXXXXXGOOOOOXXXXXXXXXXXXXXGOOXXXXXXXXXXXXXXXXXGOOOOOXXXXXXXXXXXXXXGOOOOOOXXXXXXXXXXXXXGOOOOOOOOOXXXXXXXXXXGOOOOOOOOOXXXXXXXXXXGOOXXXXXXXXXXXXXXXXXGOOOOOXXXXXXXXXXXXXXGOOOXXXXXXXXXXXXXXXXGOOOOOOOOXXXXXXXXXXX,0,600,0
27279,83,0,83,20,397,0,0,403,372,31,GOOXXXXXXXXXXXXXXXXXGOOOOOXXXXXXXXXXXXXXGOOOOOOOOOXXXXXXXXXXGOOOOOXXXXXXXXXXXXXXGOOXXXXXXXXXXXXXXXXXGOOOOOXXXXXXXXXXXXXXGOOOOOOXXXXXXXXXXXXXGOOOOOOOOOXXXXXXXXXXGOOOOOOOOOXXXXXXXXXXGOOXXXXXXXXXXXXXXXXXGOOOOOXXXXXXXXXXXXXXGOOOXXXXXXXXXXXXXXXXGOOOOOOOOXXXXXXXXXXX,0,600,0

27300,83,0,83,20,397,0,0,403,374,29,GOOXXXXXXXXXXXXXXXXXGOOOOOXXXXXXXXXXXXXXGOOOOOOOOOXXXXXXXXXXGOOOOOXXXXXXXXXXXXXXGOOXXXXXXXXXXXXXXXXXGOOOOOXXXXXXXXXXXXXXGOOOOOOXXXXXXXXXXXXXGOOOOOOOOOXXXXXXXXXXGOOOOOOOOOXXXXXXXXXXGOOXXXXXXXXXXXXXXXXXGOOOOOXXXXXXXXXXXXXXGOOOXXXXXXXXXXXXXXXXGOOOOOOOOXXXXXXXXXXX,0,600,0
27321,83,0,83,22,395,0,0,401,371,30,GOOXXXXXXXXXXXXXXXXXGOOOOOXXXXXXXXXXXXXXGOOOOOOOOOXXXXXXXXXXGOOOOOXXXXXXXXXXXXXXGOOXXXXXXXXXXXXXXXXXGOOOOOXXXXXXXXXXXXXXGOOOOOOXXXXXXXXXXXXXGOOOOOOOOOXXXXXXXXXXGOOOOOOOOOXXXXXXXXXXGOOXXXXXXXXXXXXXXXXXGOOOOOXXXXXXXXXXXXXXGOOOXXXXXXXXXXXXXXXXGOOOOOOOOXXXXXXXXXXX,0,600,0
27342,83,0,83,22,395,0,0,401,373,28,GOOXXXXXXXXXXXXXXXXXGOOOOOXXXXXXXXXXXXXXGOOOOOOOOOXXXXXXXXXXGOOOOOXXXXXXXXXXXXXXGOOXXXXXXXXXXXXXXXXXGOOOOOXXXXXXXXXXXXXXGOOOOOOXXXXXXXXXXXXXGOOOOOOOOOXXXXXXXXXXGOOOOOOOOOXXXXXXXXXXGOOXXXXXXXXXXXXXXXXXGOOOOOXXXXXXXXXXXXXXGOOOXXXXXXXXXXXXXXXXGOOOOOOOOXXXXXXXXXXX,0,600,0
27363,83,0,83,22,395,0,0,401,371,30,GOOXXXXXXXXXXXXXXXXXGOOOOOXXXXXXXXXXXXXXGOOOOOOOOOXXXXXXXXXXGOOOOOXXXXXXXXXXXXXXGOOXXXXXXXXXXXXXXXXXGOOOOOXXXXXXXXXXXXXXGOOOOOOXXXXXXXXXXXXXGOOOOOOOOOXXXXXXXXXXGOOOOOOOOOXXXXXXXXXXGOOXXXXXXXXXXXXXXXXXGOOOOOXXXXXXXXXXXXXXGOOOXXXXXXXXXXXXXXXXGOOOOOOOOXXXXXXXXXXX,0,600,0
27384,83,0,83,19,398,0,0,404,372,32,GOOXXXXXXXXXXXXXXXXXGOOOOOXXXXXXXXXXXXXXGOOOOOOOOOXXXXXXXXXXGOOOOOXXXXXXXXXXXXXXGOOXXXXXXXXXXXXXXXXXGOOOOOXXXXXXXXXXXXXXGOOOOOOXXXXXXXXXXXXXGOOOOOOOOOXXXXXXXXXXGOOOOOOOOOXXXXXXXXXXGOOXXXXXXXXXXXXXXXXXGOOOOOXXXXXXXXXXXXXXGOOOXXXXXXXXXXXXXXXXGOOOOOOOOXXXXXXXXXXX,0,600,0

27405,83,0,83,18,399,0,0,405,372,33,GOOXXXXXXXXXXXXXXXXXGOOOOOXXXXXXXXXXXXXXGOOOOOOOOOXXXXXXXXXXGOOOOOXXXXXXXXXXXXXXGOOXXXXXXXXXXXXXXXXXGOOOOOXXXXXXXXXXXXXXGOOOOOOXXXXXXXXXXXXXGOOOOOOOOOXXXXXXXXXXGOOOOOOOOOXXXXXXXXXXGOOXXXXXXXXXXXXXXXXXGOOOOOXXXXXXXXXXXXXXGOOOXXXXXXXXXXXXXXXXGOOOOOOOOXXXXXXXXXXX,0,600,0
27426,83,0,83,18,399,0,0,405,372,33,GOOXXXXXXXXXXXXXXXXXGOOOOOXXXXXXXXXXXXXXGOOOOOOOOOXXXXXXXXXXGOOOOOXXXXXXXXXXXXXXGOOXXXXXXXXXXXXXXXXXGOOOOOXXXXXXXXXXXXXXGOOOOOOXXXXXXXXXXXXXGOOOOOOOOOXXXXXXXXXXGOOOOOOOOOXXXXXXXXXXGOOXXXXXXXXXXXXXXXXXGOOOOOXXXXXXXXXXXXXXGOOOXXXXXXXXXXXXXXXXGOOOOOOOOXXXXXXXXXXX,0,600,0
27447,83,0,83,20,397,0,0,403,374,29,GOOXXXXXXXXXXXXXXXXXGOOOOOXXXXXXXXXXXXXXGOOOOOOOOOXXXXXXXXXXGOOOOOXXXXXXXXXXXXXXGOOXXXXXXXXXXXXXXXXXGOOOOOXXXXXXXXXXXXXXGOOOOOOXXXXXXXXXXXXXGOOOOOOOOOXXXXXXXXXXGOOOOOOOOOXXXXXXXXXXGOOXXXXXXXXXXXXXXXXXGOOOOOXXXXXXXXXXXXXXGOOOXXXXXXXXXXXXXXXXGOOOOOOOOXXXXXXXXXXX,0,600,0
27468,83,0,83,18,399,0,0,404,373,31,GOOXXXXXXXXXXXXXXXXXGOOOOOXXXXXXXXXXXXXXGOOOOOOOOOXXXXXXXXXXGOOOOOXXXXXXXXXXXXXXGOOXXXXXXXXXXXXXXXXXGOOOOOXXXXXXXXXXXXXXGOOOOOOXXXXXXXXXXXXXGOOOOOOOOOXXXXXXXXXXGOOOOOOOOOXXXXXXXXXXGOOXXXXXXXXXXXXXXXXXGOOOOOXXXXXXXXXXXXXXGOOOXXXXXXXXXXXXXXXXGOOOOOOOOXXXXXXXXXXX,0,600,0
27489,83,0,83,16,401,0,0,406,373,33,GOOXXXXXXXXXXXXXXXXXGOOOOOXXXXXXXXXXXXXXGOOOOOOOOOXXXXXXXXXXGOOOOOXXXXXXXXXXXXXXGOOXXXXXXXXXXXXXXXXXGOOOOOXXXXXXXXXXXXXXGOOOOOOXXXXXXXXXXXXXGOOOOOOOOOXXXXXXXXXXGOOOOOOOOOXXXXXXXXXXGOOXXXXXXXXXXXXXXXXXGOOOOOXXXXXXXXXXXXXXGOOOXXXXXXXXXXXXXXXXGOOOOOOOOXXXXXXXXXXX,0,600,0

27510,83,0,83,16,401,0,0,407,373,34,GOOXXXXXXXXXXXXXXXXXGOOOOOXXXXXXXXXXXXXXGOOOOOOOOOXXXXXXXXXXGOOOOOXXXXXXXXXXXXXXGOOXXXXXXXXXXXXXXXXXGOOOOOXXXXXXXXXXXXXXGOOOOOOXXXXXXXXXXXXXGOOOOOOOOOXXXXXXXXXXGOOOOOOOOOXXXXXXXXXXGOOXXXXXXXXXXXXXXXXXGOOOOOXXXXXXXXXXXXXXGOOOXXXXXXXXXXXXXXXXGOOOOOOOOXXXXXXXXXXX,0,600,0
27531,83,0,83,19,398,0,0,404,372,32,GOOXXXXXXXXXXXXXXXXXGOOOOOXXXXXXXXXXXXXXGOOOOOOOOOXXXXXXXXXXGOOOOOXXXXXXXXXXXXXXGOOXXXXXXXXXXXXXXXXXGOOOOOXXXXXXXXXXXXXXGOOOOOOXXXXXXXXXXXXXGOOOOOOOOOXXXXXXXXXXGOOOOOOOOOXXXXXXXXXXGOOXXXXXXXXXXXXXXXXXGOOOOOXXXXXXXXXXXXXXGOOOXXXXXXXXXXXXXXXXGOOOOOOOOXXXXXXXXXXX,0,600,0
27552,83,0,83,17,400,0,0,406,374,32,GOOXXXXXXXXXXXXXXXXXGOOOOOXXXXXXXXXXXXXXGOOOOOOOOOXXXXXXXXXXGOOOOOXXXXXXXXXXXXXXGOOXXXXXXXXXXXXXXXXXGOOOOOXXXXXXXXXXXXXXGOOOOOOXXXXXXXXXXXXXGOOOOOOOOOXXXXXXXXXXGOOOOOOOOOXXXXXXXXXXGOOXXXXXXXXXXXXXXXXXGOOOOOXXXXXXXXXXXXXXGOOOXXXXXXXXXXXXXXXXGOOOOOOOOXXXXXXXXXXX,0,600,0
27573,83,0,83,18,399,0,0,405,373,32,GOOXXXXXXXXXXXXXXXXXGOOOOOXXXXXXXXXXXXXXGOOOOOOOOOXXXXXXXXXXGOOOOOXXXXXXXXXXXXXXGOOXXXXXXXXXXXXXXXXXGOOOOOXXXXXXXXXXXXXXGOOOOOOXXXXXXXXXXXXXGOOOOOOOOOXXXXXXXXXXGOOOOOOOOOXXXXXXXXXXGOOXXXXXXXXXXXXXXXXXGOOOOOXXXXXXXXXXXXXXGOOOXXXXXXXXXXXXXXXXGOOOOOOOOXXXXXXXXXXX,0,600,0
27594,83,0,83,17,400,0,0,406,374,32,GOOXXXXXXXXXXXXXXXXXGOOOOOXXXXXXXXXXXXXXGOOOOOOOOOXXXXXXXXXXGOOOOOXXXXXXXXXXXXXXGOOXXXXXXXXXXXXXXXXXGOOOOOXXXXXXXXXXXXXXGOOOOOOXXXXXXXXXXXXXGOOOOOOOOOXXXXXXXXXXGOOOOOOOOOXXXXXXXXXXGOOXXXXXXXXXXXXXXXXXGOOOOOXXXXXXXXXXXXXXGOOOXXXXXXXXXXXXXXXXGOOOOOOOOXXXXXXXXXXX,0,600,0

27615,83,0,83,17,400,0,0,406,374,32,GOOXXXXXXXXXXXXXXXXXGOOOOOXXXXXXXXXXXXXXGOOOOOOOOOXXXXXXXXXXGOOOOOXXXXXXXXXXXXXXGOOXXXXXXXXXXXXXXXXXGOOOOOXXXXXXXXXXXXXXGOOOOOOXXXXXXXXXXXXXGOOOOOOOOOXXXXXXXXXXGOOOOOOOOOXXXXXXXXXXGOOXXXXXXXXXXXXXXXXXGOOOOOXXXXXXXXXXXXXXGOOOXXXXXXXXXXXXXXXXGOOOOOOOOXXXXXXXXXXX,0,600,0
27636,83,0,83,20,397,0,0,403,373,30,GOOXXXXXXXXXXXXXXXXXGOOOOOXXXXXXXXXXXXXXGOOOOOOOOOXXXXXXXXXXGOOOOOXXXXXXXXXXXXXXGOOXXXXXXXXXXXXXXXXXGOOOOOXXXXXXXXXXXXXXGOOOOOOXXXXXXXXXXXXXGOOOOOOOOOXXXXXXXXXXGOOOOOOOOOXXXXXXXXXXGOOXXXXXXXXXXXXXXXXXGOOOOOXXXXXXXXXXXXXXGOOOXXXXXXXXXXXXXXXXGOOOOOOOOXXXXXXXXXXX,0,600,0
27657,83,0,83,18,399,0,0,405,374,31,GOOXXXXXXXXXXXXXXXXXGOOOOOXXXXXXXXXXXXXXGOOOOOOOOOXXXXXXXXXXGOOOOOXXXXXXXXXXXXXXGOOXXXXXXXXXXXXXXXXXGOOOOOXXXXXXXXXXXXXXGOOOOOOXXXXXXXXXXXXXGOOOOOOOOOXXXXXXXXXXGOOOOOOOOOXXXXXXXXXXGOOXXXXXXXXXXXXXXXXXGOOOOOXXXXXXXXXXXXXXGOOOXXXXXXXXXXXXXXXXGOOOOOOOOXXXXXXXXXXX,0,600,0
27678,83,0,83,17,400,0,0,406,376,30,GOOXXXXXXXXXXXXXXXXXGOOOOOXXXXXXXXXXXXXXGOOOOOOOOOXXXXXXXXXXGOOOOOXXXXXXXXXXXXXXGOOXXXXXXXXXXXXXXXXXGOOOOOXXXXXXXXXXXXXXGOOOOOOXXXXXXXXXXXXXGOOOOOOOOOXXXXXXXXXXGOOOOOOOOOXXXXXXXXXXGOOXXXXXXXXXXXXXXXXXGOOOOOXXXXXXXXXXXXXXGOOOXXXXXXXXXXXXXXXXGOOOOOOOOXXXXXXXXXXX,0,600,0
27699,83,0,83,19,398,0,0,404,374,30,GOOXXXXXXXXXXXXXXXXXGOOOOOXXXXXXXXXXXXXXGOOOOOOOOOXXXXXXXXXXGOOOOOXXXXXXXXXXXXXXGOOXXXXXXXXXXXXXXXXXGOOOOOXXXXXXXXXXXXXXGOOOOOOXXXXXXXXXXXXXGOOOOOOOOOXXXXXXXXXXGOOOOOOOOOXXXXXXXXXXGOOXXXXXXXXXXXXXXXXXGOOOOOXXXXXXXXXXXXXXGOOOXXXXXXXXXXXXXXXXGOOOOOOOOXXXXXXXXXXX,0,600,0

27720,83,0,83,18,399,0,0,405,374,31,GOOXXXXXXXXXXXXXXXXXGOOOOOXXXXXXXXXXXXXXGOOOOOOOOOXXXXXXXXXXGOOOOOXXXXXXXXXXXXXXGOOXXXXXXXXXXXXXXXXXGOOOOOXXXXXXXXXXXXXXGOOOOOOXXXXXXXXXXXXXGOOOOOOOOOXXXXXXXXXXGOOOOOOOOOXXXXXXXXXXGOOXXXXXXXXXXXXXXXXXGOOOOOXXXXXXXXXXXXXXGOOOXXXXXXXXXXXXXXXXGOOOOOOOOXXXXXXXXXXX,0,600,0
27741,83,0,83,18,399,0,0,406,375,31,GOOXXXXXXXXXXXXXXXXXGOOOOOXXXXXXXXXXXXXXGOOOOOOOOOXXXXXXXXXXGOOOOOXXXXXXXXXXXXXXGOOXXXXXXXXXXXXXXXXXGOOOOOXXXXXXXXXXXXXXGOOOOOOXXXXXXXXXXXXXGOOOOOOOOOXXXXXXXXXXGOOOOOOOOOXXXXXXXXXXGOOXXXXXXXXXXXXXXXXXGOOOOOXXXXXXXXXXXXXXGOOOXXXXXXXXXXXXXXXXGOOOOOOOOXXXXXXXXXXX,0,600,0
27762,83,0,83,20,397,0,0,404,375,29,GOOXXXXXXXXXXXXXXXXXGOOOOOXXXXXXXXXXXXXXGOOOOOOOOOXXXXXXXXXXGOOOOOXXXXXXXXXXXXXXGOOXXXXXXXXXXXXXXXXXGOOOOOXXXXXXXXXXXXXXGOOOOOOXXXXXXXXXXXXXGOOOOOOOOOXXXXXXXXXXGOOOOOOOOOXXXXXXXXXXGOOXXXXXXXXXXXXXXXXXGOOOOOXXXXXXXXXXXXXXGOOOXXXXXXXXXXXXXXXXGOOOOOOOOXXXXXXXXXXX,0,600,0
27783,83,0,83,18,399,0,0,406,375,31,GOOXXXXXXXXXXXXXXXXXGOOOOOXXXXXXXXXXXXXXGOOOOOOOOOXXXXXXXXXXGOOOOOXXXXXXXXXXXXXXGOOXXXXXXXXXXXXXXXXXGOOOOOXXXXXXXXXXXXXXGOOOOOOXXXXXXXXXXXXXGOOOOOOOOOXXXXXXXXXXGOOOOOOOOOXXXXXXXXXXGOOXXXXXXXXXXXXXXXXXGOOOOOXXXXXXXXXXXXXXGOOOXXXXXXXXXXXXXXXXGOOOOOOOOXXXXXXXXXXX,0,600,0
27804,83,0,83,18,399,0,0,406,373,33,GOOXXXXXXXXXXXXXXXXXGOOOOOXXXXXXXXXXXXXXGOOOOOOOOOXXXXXXXXXXGOOOOOXXXXXXXXXXXXXXGOOXXXXXXXXXXXXXXXXXGOOOOOXXXXXXXXXXXXXXGOOOOOOXXXXXXXXXXXXXGOOOOOOOOOXXXXXXXXXXGOOOOOOOOOXXXXXXXXXXGOOXXXXXXXXXXXXXXXXXGOOOOOXXXXXXXXXXXXXXGOOOXXXXXXXXXXXXXXXXGOOOOOOOOXXXXXXXXXXX,0,600,0

27825,83,0,83,18,399,0,0,406,374,32,GOOXXXXXXXXXXXXXXXXXGOOOOOXXXXXXXXXXXXXXGOOOOOOOOOXXXXXXXXXXGOOOOOXXXXXXXXXXXXXXGOOXXXXXXXXXXXXXXXXXGOOOOOXXXXXXXXXXXXXXGOOOOOOXXXXXXXXXXXXXGOOOOOOOOOXXXXXXXXXXGOOOOOOOOOXXXXXXXXXXGOOXXXXXXXXXXXXXXXXXGOOOOOXXXXXXXXXXXXXXGOOOXXXXXXXXXXXXXXXXGOOOOOOOOXXXXXXXXXXX,0,600,0
27846,83,0,83,18,399,0,0,406,374,32,GOOXXXXXXXXXXXXXXXXXGOOOOOXXXXXXXXXXXXXXGOOOOOOOOOXXXXXXXXXXGOOOOOXXXXXXXXXXXXXXGOOXXXXXXXXXXXXXXXXXGOOOOOXXXXXXXXXXXXXXGOOOOOOXXXXXXXXXXXXXGOOOOOOOOOXXXXXXXXXXGOOOOOOOOOXXXXXXXXXXGOOXXXXXXXXXXXXXXXXXGOOOOOXXXXXXXXXXXXXXGOOOXXXXXXXXXXXXXXXXGOOOOOOOOXXXXXXXXXXX,0,600,0
27867,83,0,83,15,402,0,0,409,373,36,GOOXXXXXXXXXXXXXXXXXGOOOOOXXXXXXXXXXXXXXGOOOOOOOOOXXXXXXXXXXGOOOOOXXXXXXXXXXXXXXGOOXXXXXXXXXXXXXXXXXGOOOOOXXXXXXXXXXXXXXGOOOOOOXXXXXXXXXXXXXGOOOOOOOOOXXXXXXXXXXGOOOOOOOOOXXXXXXXXXXGOOXXXXXXXXXXXXXXXXXGOOOOOXXXXXXXXXXXXXXGOOOXXXXXXXXXXXXXXXXGOOOOOOOOXXXXXXXXXXX,0,600,0
27888,83,0,83,13,404,0,0,411,375,36,GOOXXXXXXXXXXXXXXXXXGOOOOOXXXXXXXXXXXXXXGOOOOOOOOOXXXXXXXXXXGOOOOOXXXXXXXXXXXXXXGOOXXXXXXXXXXXXXXXXXGOOOOOXXXXXXXXXXXXXXGOOOOOOXXXXXXXXXXXXXGOOOOOOOOOXXXXXXXXXXGOOOOOOOOOXXXXXXXXXXGOOXXXXXXXXXXXXXXXXXGOOOOOXXXXXXXXXXXXXXGOOOXXXXXXXXXXXXXXXXGOOOOOOOOXXXXXXXXXXX,0,600,0
27909,83,0,83,13,404,0,0,411,372,39,GOOXXXXXXXXXXXXXXXXXGOOOOOXXXXXXXXXXXXXXGOOOOOOOOOXXXXXXXXXXGOOOOOXXXXXXXXXXXXXXGOOXXXXXXXXXXXXXXXXXGOOOOOXXXXXXXXXXXXXXGOOOOOOXXXXXXXXXXXXXGOOOOOOOOOXXXXXXXXXXGOOOOOOOOOXXXXXXXXXXGOOXXXXXXXXXXXXXXXXXGOOOOOXXXXXXXXXXXXXXGOOOXXXXXXXXXXXXXXXXGOOOOOOOOXXXXXXXXXXX,0,600,0

27930,83,0,83,12,405,0,0,412,372,40,GOOXXXXXXXXXXXXXXXXXGOOOOOXXXXXXXXXXXXXXGOOOOOOOOOXXXXXXXXXXGOOOOOXXXXXXXXXXXXXXGOOXXXXXXXXXXXXXXXXXGOOOOOXXXXXXXXXXXXXXGOOOOOOXXXXXXXXXXXXXGOOOOOOOOOXXXXXXXXXXGOOOOOOOOOXXXXXXXXXXGOOXXXXXXXXXXXXXXXXXGOOOOOXXXXXXXXXXXXXXGOOOXXXXXXXXXXXXXXXXGOOOOOOOOXXXXXXXXXXX,0,600,0
27951,83,0,83,11,406,0,0,413,373,40,GOOXXXXXXXXXXXXXXXXXGOOOOOXXXXXXXXXXXXXXGOOOOOOOOOXXXXXXXXXXGOOOOOXXXXXXXXXXXXXXGOOXXXXXXXXXXXXXXXXXGOOOOOXXXXXXXXXXXXXXGOOOOOOXXXXXXXXXXXXXGOOOOOOOOOXXXXXXXXXXGOOOOOOOOOXXXXXXXXXXGOOXXXXXXXXXXXXXXXXXGOOOOOXXXXXXXXXXXXXXGOOOXXXXXXXXXXXXXXXXGOOOOOOOOXXXXXXXXXXX,0,600,0
27972,83,0,83,11,406,0,0,413,372,41,GOOXXXXXXXXXXXXXXXXXGOOOOOXXXXXXXXXXXXXXGOOOOOOOOOXXXXXXXXXXGOOOOOXXXXXXXXXXXXXXGOOXXXXXXXXXXXXXXXXXGOOOOOXXXXXXXXXXXXXXGOOOOOOXXXXXXXXXXXXXGOOOOOOOOOXXXXXXXXXXGOOOOOOOOOXXXXXXXXXXGOOXXXXXXXXXXXXXXXXXGOOOOOXXXXXXXXXXXXXXGOOOXXXXXXXXXXXXXXXXGOOOOOOOOXXXXXXXXXXX,0,600,0
27993,83,0,83,9,408,0,0,415,374,41,GOOXXXXXXXXXXXXXXXXXGOOOOOXXXXXXXXXXXXXXGOOOOOOOOOXXXXXXXXXXGOOOOOXXXXXXXXXXXXXXGOOXXXXXXXXXXXXXXXXXGOOOOOXXXXXXXXXXXXXXGOOOOOOXXXXXXXXXXXXXGOOOOOOOOOXXXXXXXXXXGOOOOOOOOOXXXXXXXXXXGOOXXXXXXXXXXXXXXXXXGOOOOOXXXXXXXXXXXXXXGOOOXXXXXXXXXXXXXXXXGOOOOOOOOXXXXXXXXXXX,0,600,0
28014,83,0,83,8,409,0,0,416,375,41,GOOXXXXXXXXXXXXXXXXXGOOOOOXXXXXXXXXXXXXXGOOOOOOOOOXXXXXXXXXXGOOOOOXXXXXXXXXXXXXXGOOXXXXXXXXXXXXXXXXXGOOOOOXXXXXXXXXXXXXXGOOOOOOXXXXXXXXXXXXXGOOOOOOOOOXXXXXXXXXXGOOOOOOOOOXXXXXXXXXXGOOXXXXXXXXXXXXXXXXXGOOOOOXXXXXXXXXXXXXXGOOOXXXXXXXXXXXXXXXXGOOOOOOOOXXXXXXXXXXX,0,600,0

28035,83,0,83,12,405,0,0,412,373,39,GOOXXXXXXXXXXXXXXXXXGOOOOOXXXXXXXXXXXXXXGOOOOOOOOOXXXXXXXXXXGOOOOOXXXXXXXXXXXXXXGOOXXXXXXXXXXXXXXXXXGOOOOOXXXXXXXXXXXXXXGOOOOOOXXXXXXXXXXXXXGOOOOOOOOOXXXXXXXXXXGOOOOOOOOOXXXXXXXXXXGOOXXXXXXXXXXXXXXXXXGOOOOOXXXXXXXXXXXXXXGOOOXXXXXXXXXXXXXXXXGOOOOOOOOXXXXXXXXXXX,0,600,0
28056,83,0,83,10,407,0,0,414,373,41,GOOXXXXXXXXXXXXXXXXXGOOOOOXXXXXXXXXXXXXXGOOOOOOOOOXXXXXXXXXXGOOOOOXXXXXXXXXXXXXXGOOXXXXXXXXXXXXXXXXXGOOOOOXXXXXXXXXXXXXXGOOOOOOXXXXXXXXXXXXXGOOOOOOOOOXXXXXXXXXXGOOOOOOOOOXXXXXXXXXXGOOXXXXXXXXXXXXXXXXXGOOOOOXXXXXXXXXXXXXXGOOOXXXXXXXXXXXXXXXXGOOOOOOOOXXXXXXXXXXX,0,600,0
28077,83,0,83,12,405,0,0,412,373,39,GOOXXXXXXXXXXXXXXXXXGOOOOOXXXXXXXXXXXXXXGOOOOOOOOOXXXXXXXXXXGOOOOOXXXXXXXXXXXXXXGOOXXXXXXXXXXXXXXXXXGOOOOOXXXXXXXXXXXXXXGOOOOOOXXXXXXXXXXXXXGOOOOOOOOOXXXXXXXXXXGOOOOOOOOOXXXXXXXXXXGOOXXXXXXXXXXXXXXXXXGOOOOOXXXXXXXXXXXXXXGOOOXXXXXXXXXXXXXXXXGOOOOOOOOXXXXXXXXXXX,0,600,0
28098,83,0,83,13,404,0,0,411,375,36,GOOXXXXXXXXXXXXXXXXXGOOOOOXXXXXXXXXXXXXXGOOOOOOOOOXXXXXXXXXXGOOOOOXXXXXXXXXXXXXXGOOXXXXXXXXXXXXXXXXXGOOOOOXXXXXXXXXXXXXXGOOOOOOXXXXXXXXXXXXXGOOOOOOOOOXXXXXXXXXXGOOOOOOOOOXXXXXXXXXXGOOXXXXXXXXXXXXXXXXXGOOOOOXXXXXXXXXXXXXXGOOOXXXXXXXXXXXXXXXXGOOOOOOOOXXXXXXXXXXX,0,600,0
28119,83,0,83,14,403,0,0,410,376,34,GOOXXXXXXXXXXXXXXXXXGOOOOOXXXXXXXXXXXXXXGOOOOOOOOOXXXXXXXXXXGOOOOOXXXXXXXXXXXXXXGOOXXXXXXXXXXXXXXXXXGOOOOOXXXXXXXXXXXXXXGOOOOOOXXXXXXXXXXXXXGOOOOOOOOOXXXXXXXXXXGOOOOOOOOOXXXXXXXXXXGOOXXXXXXXXXXXXXXXXXGOOOOOXXXXXXXXXXXXXXGOOOXXXXXXXXXXXXXXXXGOOOOOOOOXXXXXXXXXXX,0,600,0

28140,83,0,83,17,400,0,0,407,376,31,GOOXXXXXXXXXXXXXXXXXGOOOOOXXXXXXXXXXXXXXGOOOOOOOOOXXXXXXXXXXGOOOOOXXXXXXXXXXXXXXGOOXXXXXXXXXXXXXXXXXGOOOOOXXXXXXXXXXXXXXGOOOOOOXXXXXXXXXXXXXGOOOOOOOOOXXXXXXXXXXGOOOOOOOOOXXXXXXXXXXGOOXXXXXXXXXXXXXXXXXGOOOOOXXXXXXXXXXXXXXGOOOXXXXXXXXXXXXXXXXGOOOOOOOOXXXXXXXXXXX,0,600,0
28161,83,0,83,20,397,0,0,403,376,27,GOOXXXXXXXXXXXXXXXXXGOOOOOXXXXXXXXXXXXXXGOOOOOOOOOXXXXXXXXXXGOOOOOXXXXXXXXXXXXXXGOOXXXXXXXXXXXXXXXXXGOOOOOXXXXXXXXXXXXXXGOOOOOOXXXXXXXXXXXXXGOOOOOOOOOXXXXXXXXXXGOOOOOOOOOXXXXXXXXXXGOOXXXXXXXXXXXXXXXXXGOOOOOXXXXXXXXXXXXXXGOOOXXXXXXXXXXXXXXXXGOOOOOOOOXXXXXXXXXXX,0,600,0
28182,83,0,83,22,395,0,0,401,375,26,GOOXXXXXXXXXXXXXXXXXGOOOOOXXXXXXXXXXXXXXGOOOOOOOOOXXXXXXXXXXGOOOOOXXXXXXXXXXXXXXGOOXXXXXXXXXXXXXXXXXGOOOOOXXXXXXXXXXXXXXGOOOOOOXXXXXXXXXXXXXGOOOOOOOOOXXXXXXXXXXGOOOOOOOOOXXXXXXXXXXGOOXXXXXXXXXXXXXXXXXGOOOOOXXXXXXXXXXXXXXGOOOXXXXXXXXXXXXXXXXGOOOOOOOOXXXXXXXXXXX,0,600,0
28203,83,0,83,20,397,0,0,403,374,29,GOOXXXXXXXXXXXXXXXXXGOOOOOXXXXXXXXXXXXXXGOOOOOOOOOXXXXXXXXXXGOOOOOXXXXXXXXXXXXXXGOOXXXXXXXXXXXXXXXXXGOOOOOXXXXXXXXXXXXXXGOOOOOOXXXXXXXXXXXXXGOOOOOOOOOXXXXXXXXXXGOOOOOOOOOXXXXXXXXXXGOOXXXXXXXXXXXXXXXXXGOOOOOXXXXXXXXXXXXXXGOOOXXXXXXXXXXXXXXXXGOOOOOOOOXXXXXXXXXXX,0,600,0
28224,83,0,83,20,397,0,0,403,373,30,GOOXXXXXXXXXXXXXXXXXGOOOOOXXXXXXXXXXXXXXGOOOOOOOOOXXXXXXXXXXGOOOOOXXXXXXXXXXXXXXGOOXXXXXXXXXXXXXXXXXGOOOOOXXXXXXXXXXXXXXGOOOOOOXXXXXXXXXXXXXGOOOOOOOOOXXXXXXXXXXGOOOOOOOOOXXXXXXXXXXGOOXXXXXXXXXXXXXXXXXGOOOOOXXXXXXXXXXXXXXGOOOXXXXXXXXXXXXXXXXGOOOOOOOOXXXXXXXXXXX,0,600,0

28245,83,0,83,19,398,0,0,405,373,32,GOOXXXXXXXXXXXXXXXXXGOOOOOXXXXXXXXXXXXXXGOOOOOOOOOXXXXXXXXXXGOOOOOXXXXXXXXXXXXXXGOOXXXXXXXXXXXXXXXXXGOOOOOXXXXXXXXXXXXXXGOOOOOOXXXXXXXXXXXXXGOOOOOOOOOXXXXXXXXXXGOOOOOOOOOXXXXXXXXXXGOOXXXXXXXXXXXXXXXXXGOOOOOXXXXXXXXXXXXXXGOOOXXXXXXXXXXXXXXXXGOOOOOOOOXXXXXXXXXXX,0,600,0
28266,83,0,83,19,398,0,0,405,374,31,GOOXXXXXXXXXXXXXXXXXGOOOOOXXXXXXXXXXXXXXGOOOOOOOOOXXXXXXXXXXGOOOOOXXXXXXXXXXXXXXGOOXXXXXXXXXXXXXXXXXGOOOOOXXXXXXXXXXXXXXGOOOOOOXXXXXXXXXXXXXGOOOOOOOOOXXXXXXXXXXGOOOOOOOOOXXXXXXXXXXGOOXXXXXXXXXXXXXXXXXGOOOOOXXXXXXXXXXXXXXGOOOXXXXXXXXXXXXXXXXGOOOOOOOOXXXXXXXXXXX,0,600,0
28287,83,0,83,18,399,0,0,406,375,31,GOOXXXXXXXXXXXXXXXXXGOOOOOXXXXXXXXXXXXXXGOOOOOOOOOXXXXXXXXXXGOOOOOXXXXXXXXXXXXXXGOOXXXXXXXXXXXXXXXXXGOOOOOXXXXXXXXXXXXXXGOOOOOOXXXXXXXXXXXXXGOOOOOOOOOXXXXXXXXXXGOOOOOOOOOXXXXXXXXXXGOOXXXXXXXXXXXXXXXXXGOOOOOXXXXXXXXXXXXXXGOOOXXXXXXXXXXXXXXXXGOOOOOOOOXXXXXXXXXXX,0,600,0
28308,83,0,83,18,399,0,0,406,374,32,GOOXXXXXXXXXXXXXXXXXGOOOOOXXXXXXXXXXXXXXGOOOOOOOOOXXXXXXXXXXGOOOOOXXXXXXXXXXXXXXGOOXXXXXXXXXXXXXXXXXGOOOOOXXXXXXXXXXXXXXGOOOOOOXXXXXXXXXXXXXGOOOOOOOOOXXXXXXXXXXGOOOOOOOOOXXXXXXXXXXGOOXXXXXXXXXXXXXXXXXGOOOOOXXXXXXXXXXXXXXGOOOXXXXXXXXXXXXXXXXGOOOOOOOOXXXXXXXXXXX,0,600,0
28329,83,0,83,17,400,0,0,407,373,34,GOOXXXXXXXXXXXXXXXXXGOOOOOXXXXXXXXXXXXXXGOOOOOOOOOXXXXXXXXXXGOOOOOXXXXXXXXXXXXXXGOOXXXXXXXXXXXXXXXXXGOOOOOXXXXXXXXXXXXXXGOOOOOOXXXXXXXXXXXXXGOOOOOOOOOXXXXXXXXXXGOOOOOOOOOXXXXXXXXXXGOOXXXXXXXXXXXXXXXXXGOOOOOXXXXXXXXXXXXXXGOOOXXXXXXXXXXXXXXXXGOOOOOOOOXXXXXXXXXXX,0,600,0

28350,83,0,83,19,398,0,0,405,375,30,GOOXXXXXXXXXXXXXXXXXGOOOOOXXXXXXXXXXXXXXGOOOOOOOOOXXXXXXXXXXGOOOOOXXXXXXXXXXXXXXGOOXXXXXXXXXXXXXXXXXGOOOOOXXXXXXXXXXXXXXGOOOOOOXXXXXXXXXXXXXGOOOOOOOOOXXXXXXXXXXGOOOOOOOOOXXXXXXXXXXGOOXXXXXXXXXXXXXXXXXGOOOOOXXXXXXXXXXXXXXGOOOXXXXXXXXXXXXXXXXGOOOOOOOOXXXXXXXXXXX,0,600,0
28371,83,0,83,18,399,0,0,406,375,31,GOOXXXXXXXXXXXXXXXXXGOOOOOXXXXXXXXXXXXXXGOOOOOOOOOXXXXXXXXXXGOOOOOXXXXXXXXXXXXXXGOOXXXXXXXXXXXXXXXXXGOOOOOXXXXXXXXXXXXXXGOOOOOOXXXXXXXXXXXXXGOOOOOOOOOXXXXXXXXXXGOOOOOOOOOXXXXXXXXXXGOOXXXXXXXXXXXXXXXXXGOOOOOXXXXXXXXXXXXXXGOOOXXXXXXXXXXXXXXXXGOOOOOOOOXXXXXXXXXXX,0,600,0
28392,83,0,83,17,400,0,0,406,375,31,GOOXXXXXXXXXXXXXXXXXGOOOOOXXXXXXXXXXXXXXGOOOOOOOOOXXXXXXXXXXGOOOOOXXXXXXXXXXXXXXGOOXXXXXXXXXXXXXXXXXGOOOOOXXXXXXXXXXXXXXGOOOOOOXXXXXXXXXXXXXGOOOOOOOOOXXXXXXXXXXGOOOOOOOOOXXXXXXXXXXGOOXXXXXXXXXXXXXXXXXGOOOOOXXXXXXXXXXXXXXGOOOXXXXXXXXXXXXXXXXGOOOOOOOOXXXXXXXXXXX,0,600,0
28413,83,0,83,17,400,0,0,407,376,31,GOOXXXXXXXXXXXXXXXXXGOOOOOXXXXXXXXXXXXXXGOOOOOOOOOXXXXXXXXXXGOOOOOXXXXXXXXXXXXXXGOOXXXXXXXXXXXXXXXXXGOOOOOXXXXXXXXXXXXXXGOOOOOOXXXXXXXXXXXXXGOOOOOOOOOXXXXXXXXXXGOOOOOOOOOXXXXXXXXXXGOOXXXXXXXXXXXXXXXXXGOOOOOXXXXXXXXXXXXXXGOOOXXXXXXXXXXXXXXXXGOOOOOOOOXXXXXXXXXXX,0,600,0
28434,83,0,83,19,398,0,0,405,374,31,GOOXXXXXXXXXXXXXXXXXGOOOOOXXXXXXXXXXXXXXGOOOOOOOOOXXXXXXXXXXGOOOOOXXXXXXXXXXXXXXGOOXXXXXXXXXXXXXXXXXGOOOOOXXXXXXXXXXXXXXGOOOOOOXXXXXXXXXXXXXGOOOOOOOOOXXXXXXXXXXGOOOOOOOOOXXXXXXXXXXGOOXXXXXXXXXXXXXXXXXGOOOOOXXXXXXXXXXXXXXGOOOXXXXXXXXXXXXXXXXGOOOOOOOOXXXXXXXXXXX,0,600,0

28455,83,0,83,18,399,0,0,405,374,31,GOOXXXXXXXXXXXXXXXXXGOOOOOXXXXXXXXXXXXXXGOOOOOOOOOXXXXXXXXXXGOOOOOXXXXXXXXXXXXXXGOOXXXXXXXXXXXXXXXXXGOOOOOXXXXXXXXXXXXXXGOOOOOOXXXXXXXXXXXXXGOOOOOOOOOXXXXXXXXXXGOOOOOOOOOXXXXXXXXXXGOOXXXXXXXXXXXXXXXXXGOOOOOXXXXXXXXXXXXXXGOOOXXXXXXXXXXXXXXXXGOOOOOOOOXXXXXXXXXXX,0,600,0
28476,83,0,83,17,400,0,0,407,375,32,GOOXXXXXXXXXXXXXXXXXGOOOOOXXXXXXXXXXXXXXGOOOOOOOOOXXXXXXXXXXGOOOOOXXXXXXXXXXXXXXGOOXXXXXXXXXXXXXXXXXGOOOOOXXXXXXXXXXXXXXGOOOOOOXXXXXXXXXXXXXGOOOOOOOOOXXXXXXXXXXGOOOOOOOOOXXXXXXXXXXGOOXXXXXXXXXXXXXXXXXGOOOOOXXXXXXXXXXXXXXGOOOXXXXXXXXXXXXXXXXGOOOOOOOOXXXXXXXXXXX,0,600,0
28497,83,0,83,17,400,0,0,407,374,33,GOOXXXXXXXXXXXXXXXXXGOOOOOXXXXXXXXXXXXXXGOOOOOOOOOXXXXXXXXXXGOOOOOXXXXXXXXXXXXXXGOOXXXXXXXXXXXXXXXXXGOOOOOXXXXXXXXXXXXXXGOOOOOOXXXXXXXXXXXXXGOOOOOOOOOXXXXXXXXXXGOOOOOOOOOXXXXXXXXXXGOOXXXXXXXXXXXXXXXXXGOOOOOXXXXXXXXXXXXXXGOOOXXXXXXXXXXXXXXXXGOOOOOOOOXXXXXXXXXXX,0,600,0
28518,83,0,83,18,399,0,0,406,374,32,GOOXXXXXXXXXXXXXXXXXGOOOOOXXXXXXXXXXXXXXGOOOOOOOOOXXXXXXXXXXGOOOOOXXXXXXXXXXXXXXGOOXXXXXXXXXXXXXXXXXGOOOOOXXXXXXXXXXXXXXGOOOOOOXXXXXXXXXXXXXGOOOOOOOOOXXXXXXXXXXGOOOOOOOOOXXXXXXXXXXGOOXXXXXXXXXXXXXXXXXGOOOOOXXXXXXXXXXXXXXGOOOXXXXXXXXXXXXXXXXGOOOOOOOOXXXXXXXXXXX,0,600,0
28539,83,0,83,20,397,0,0,404,375,29,GOOXXXXXXXXXXXXXXXXXGOOOOOXXXXXXXXXXXXXXGOOOOOOOOOXXXXXXXXXXGOOOOOXXXXXXXXXXXXXXGOOXXXXXXXXXXXXXXXXXGOOOOOXXXXXXXXXXXXXXGOOOOOOXXXXXXXXXXXXXGOOOOOOOOOXXXXXXXXXXGOOOOOOOOOXXXXXXXXXXGOOXXXXXXXXXXXXXXXXXGOOOOOXXXXXXXXXXXXXXGOOOXXXXXXXXXXXXXXXXGOOOOOOOOXXXXXXXXXXX,0,600,0

28560,83,0,83,20,397,0,0,404,375,29,GOOXXXXXXXXXXXXXXXXXGOOOOOXXXXXXXXXXXXXXGOOOOOOOOOXXXXXXXXXXGOOOOOXXXXXXXXXXXXXXGOOXXXXXXXXXXXXXXXXXGOOOOOXXXXXXXXXXXXXXGOOOOOOXXXXXXXXXXXXXGOOOOOOOOOXXXXXXXXXXGOOOOOOOOOXXXXXXXXXXGOOXXXXXXXXXXXXXXXXXGOOOOOXXXXXXXXXXXXXXGOOOXXXXXXXXXXXXXXXXGOOOOOOOOXXXXXXXXXXX,0,600,0
28581,83,0,83,17,400,0,0,406,374,32,GOOXXXXXXXXXXXXXXXXXGOOOOOXXXXXXXXXXXXXXGOOOOOOOOOXXXXXXXXXXGOOOOOXXXXXXXXXXXXXXGOOXXXXXXXXXXXXXXXXXGOOOOOXXXXXXXXXXXXXXGOOOOOOXXXXXXXXXXXXXGOOOOOOOOOXXXXXXXXXXGOOOOOOOOOXXXXXXXXXXGOOXXXXXXXXXXXXXXXXXGOOOOOXXXXXXXXXXXXXXGOOOXXXXXXXXXXXXXXXXGOOOOOOOOXXXXXXXXXXX,0,600,0
28602,83,0,83,18,399,0,0,406,376,30,GOOXXXXXXXXXXXXXXXXXGOOOOOXXXXXXXXXXXXXXGOOOOOOOOOXXXXXXXXXXGOOOOOXXXXXXXXXXXXXXGOOXXXXXXXXXXXXXXXXXGOOOOOXXXXXXXXXXXXXXGOOOOOOXXXXXXXXXXXXXGOOOOOOOOOXXXXXXXXXXGOOOOOOOOOXXXXXXXXXXGOOXXXXXXXXXXXXXXXXXGOOOOOXXXXXXXXXXXXXXGOOOXXXXXXXXXXXXXXXXGOOOOOOOOXXXXXXXXXXX,0,600,0
28623,83,0,83,17,400,0,0,405,377,28,GOOXXXXXXXXXXXXXXXXXGOOOOOXXXXXXXXXXXXXXGOOOOOOOOOXXXXXXXXXXGOOOOOXXXXXXXXXXXXXXGOOXXXXXXXXXXXXXXXXXGOOOOOXXXXXXXXXXXXXXGOOOOOOXXXXXXXXXXXXXGOOOOOOOOOXXXXXXXXXXGOOOOOOOOOXXXXXXXXXXGOOXXXXXXXXXXXXXXXXXGOOOOOXXXXXXXXXXXXXXGOOOXXXXXXXXXXXXXXXXGOOOOOOOOXXXXXXXXXXX,0,600,0
28644,83,0,83,18,399,0,0,406,376,30,GOOXXXXXXXXXXXXXXXXXGOOOOOXXXXXXXXXXXXXXGOOOOOOOOOXXXXXXXXXXGOOOOOXXXXXXXXXXXXXXGOOXXXXXXXXXXXXXXXXXGOOOOOXXXXXXXXXXXXXXGOOOOOOXXXXXXXXXXXXXGOOOOOOOOOXXXXXXXXXXGOOOOOOOOOXXXXXXXXXXGOOXXXXXXXXXXXXXXXXXGOOOOOXXXXXXXXXXXXXXGOOOXXXXXXXXXXXXXXXXGOOOOOOOOXXXXXXXXXXX,0,600,0

28665,83,0,83,18,399,0,0,406,374,32,GOOXXXXXXXXXXXXXXXXXGOOOOOXXXXXXXXXXXXXXGOOOOOOOOOXXXXXXXXXXGOOOOOXXXXXXXXXXXXXXGOOXXXXXXXXXXXXXXXXXGOOOOOXXXXXXXXXXXXXXGOOOOOOXXXXXXXXXXXXXGOOOOOOOOOXXXXXXXXXXGOOOOOOOOOXXXXXXXXXXGOOXXXXXXXXXXXXXXXXXGOOOOOXXXXXXXXXXXXXXGOOOXXXXXXXXXXXXXXXXGOOOOOOOOXXXXXXXXXXX,0,600,0
28686,83,0,83,19,398,0,0,405,374,31,GOOXXXXXXXXXXXXXXXXXGOOOOOXXXXXXXXXXXXXXGOOOOOOOOOXXXXXXXXXXGOOOOOXXXXXXXXXXXXXXGOOXXXXXXXXXXXXXXXXXGOOOOOXXXXXXXXXXXXXXGOOOOOOXXXXXXXXXXXXXGOOOOOOOOOXXXXXXXXXXGOOOOOOOOOXXXXXXXXXXGOOXXXXXXXXXXXXXXXXXGOOOOOXXXXXXXXXXXXXXGOOOXXXXXXXXXXXXXXXXGOOOOOOOOXXXXXXXXXXX,0,600,0
28707,83,0,83,18,399,0,0,406,374,32,GOOXXXXXXXXXXXXXXXXXGOOOOOXXXXXXXXXXXXXXGOOOOOOOOOXXXXXXXXXXGOOOOOXXXXXXXXXXXXXXGOOXXXXXXXXXXXXXXXXXGOOOOOXXXXXXXXXXXXXXGOOOOOOXXXXXXXXXXXXXGOOOOOOOOOXXXXXXXXXXGOOOOOOOOOXXXXXXXXXXGOOXXXXXXXXXXXXXXXXXGOOOOOXXXXXXXXXXXXXXGOOOXXXXXXXXXXXXXXXXGOOOOOOOOXXXXXXXXXXX,0,600,0
28728,83,0,83,19,398,0,0,405,375,30,GOOXXXXXXXXXXXXXXXXXGOOOOOXXXXXXXXXXXXXXGOOOOOOOOOXXXXXXXXXXGOOOOOXXXXXXXXXXXXXXGOOXXXXXXXXXXXXXXXXXGOOOOOXXXXXXXXXXXXXXGOOOOOOXXXXXXXXXXXXXGOOOOOOOOOXXXXXXXXXXGOOOOOOOOOXXXXXXXXXXGOOXXXXXXXXXXXXXXXXXGOOOOOXXXXXXXXXXXXXXGOOOXXXXXXXXXXXXXXXXGOOOOOOOOXXXXXXXXXXX,0,600,0
28749,83,0,83,20,397,0,0,404,374,30,GOOXXXXXXXXXXXXXXXXXGOOOOOXXXXXXXXXXXXXXGOOOOOOOOOXXXXXXXXXXGOOOOOXXXXXXXXXXXXXXGOOXXXXXXXXXXXXXXXXXGOOOOOXXXXXXXXXXXXXXGOOOOOOXXXXXXXXXXXXXGOOOOOOOOOXXXXXXXXXXGOOOOOOOOOXXXXXXXXXXGOOXXXXXXXXXXXXXXXXXGOOOOOXXXXXXXXXXXXXXGOOOXXXXXXXXXXXXXXXXGOOOOOOOOXXXXXXXXXXX,0,600,0

28770,83,0,83,19,398,0,0,405,373,32,GOOXXXXXXXXXXXXXXXXXGOOOOOXXXXXXXXXXXXXXGOOOOOOOOOXXXXXXXXXXGOOOOOXXXXXXXXXXXXXXGOOXXXXXXXXXXXXXXXXXGOOOOOXXXXXXXXXXXXXXGOOOOOOXXXXXXXXXXXXXGOOOOOOOOOXXXXXXXXXXGOOOOOOOOOXXXXXXXXXXGOOXXXXXXXXXXXXXXXXXGOOOOOXXXXXXXXXXXXXXGOOOXXXXXXXXXXXXXXXXGOOOOOOOOXXXXXXXXXXX,0,600,0
28791,84,1,83,17,399,0,0,406,373,33,GOOXXXXXXXXXXXXXXXXXGOOOOOXXXXXXXXXXXXXXGOOOOOOOOOXXXXXXXXXXGOOOOOXXXXXXXXXXXXXXGOOXXXXXXXXXXXXXXXXXGOOOOOXXXXXXXXXXXXXXGOOOOOOXXXXXXXXXXXXXGOOOOOOOOOXXXXXXXXXXGOOOOOOOOOAXXXXXXXXXGOOXXXXXXXXXXXXXXXXXGOOOOOXXXXXXXXXXXXXXGOOOXXXXXXXXXXXXXXXXGOOOOOOOOXXXXXXXXXXX,0,600,0
28812,84,1,83,17,399,0,0,406,373,33,GOOXXXXXXXXXXXXXXXXXGOOOOOXXXXXXXXXXXXXXGOOOOOOOOOXXXXXXXXXXGOOOOOXXXXXXXXXXXXXXGOOXXXXXXXXXXXXXXXXXGOOOOOXXXXXXXXXXXXXXGOOOOOOXXXXXXXXXXXXXGOOOOOOOOOXXXXXXXXXXGOOOOOOOOOAXXXXXXXXXGOOXXXXXXXXXXXXXXXXXGOOOOOXXXXXXXXXXXXXXGOOOXXXXXXXXXXXXXXXXGOOOOOOOOXXXXXXXXXXX,0,600,0
28833,84,1,83,12,404,0,0,411,374,37,GOOXXXXXXXXXXXXXXXXXGOOOOOXXXXXXXXXXXXXXGOOOOOOOOOXXXXXXXXXXGOOOOOXXXXXXXXXXXXXXGOOXXXXXXXXXXXXXXXXXGOOOOOXXXXXXXXXXXXXXGOOOOOOXXXXXXXXXXXXXGOOOOOOOOOXXXXXXXXXXGOOOOOOOOOAXXXXXXXXXGOOXXXXXXXXXXXXXXXXXGOOOOOXXXXXXXXXXXXXXGOOOXXXXXXXXXXXXXXXXGOOOOOOOOXXXXXXXXXXX,0,600,0
28854,84,1,83,12,404,0,0,412,373,39,GOOXXXXXXXXXXXXXXXXXGOOOOOXXXXXXXXXXXXXXGOOOOOOOOOXXXXXXXXXXGOOOOOXXXXXXXXXXXXXXGOOXXXXXXXXXXXXXXXXXGOOOOOXXXXXXXXXXXXXXGOOOOOOXXXXXXXXXXXXXGOOOOOOOOOXXXXXXXXXXGOOOOOOOOOAXXXXXXXXXGOOXXXXXXXXXXXXXXXXXGOOOOOXXXXXXXXXXXXXXGOOOXXXXXXXXXXXXXXXXGOOOOOOOOXXXXXXXXXXX,0,600,0

28875,84,0,84,11,405,0,0,413,373,40,GOOXXXXXXXXXXXXXXXXXGOOOOOXXXXXXXXXXXXXXGOOOOOOOOOXXXXXXXXXXGOOOOOXXXXXXXXXXXXXXGOOXXXXXXXXXXXXXXXXXGOOOOOXXXXXXXXXXXXXXGOOOOOOXXXXXXXXXXXXXGOOOOOOOOOXXXXXXXXXXGOOOOOOOOOOXXXXXXXXXGOOXXXXXXXXXXXXXXXXXGOOOOOXXXXXXXXXXXXXXGOOOXXXXXXXXXXXXXXXXGOOOOOOOOXXXXXXXXXXX,0,600,0
28896,84,0,84,12,404,0,0,411,375,36,GOOXXXXXXXXXXXXXXXXXGOOOOOXXXXXXXXXXXXXXGOOOOOOOOOXXXXXXXXXXGOOOOOXXXXXXXXXXXXXXGOOXXXXXXXXXXXXXXXXXGOOOOOXXXXXXXXXXXXXXGOOOOOOXXXXXXXXXXXXXGOOOOOOOOOXXXXXXXXXXGOOOOOOOOOOXXXXXXXXXGOOXXXXXXXXXXXXXXXXXGOOOOOXXXXXXXXXXXXXXGOOOXXXXXXXXXXXXXXXXGOOOOOOOOXXXXXXXXXXX,0,600,0
28917,84,0,84,16,400,0,0,407,375,32,GOOXXXXXXXXXXXXXXXXXGOOOOOXXXXXXXXXXXXXXGOOOOOOOOOXXXXXXXXXXGOOOOOXXXXXXXXXXXXXXGOOXXXXXXXXXXXXXXXXXGOOOOOXXXXXXXXXXXXXXGOOOOOOXXXXXXXXXXXXXGOOOOOOOOOXXXXXXXXXXGOOOOOOOOOOXXXXXXXXXGOOXXXXXXXXXXXXXXXXXGOOOOOXXXXXXXXXXXXXXGOOOXXXXXXXXXXXXXXXXGOOOOOOOOXXXXXXXXXXX,0,600,0
28938,84,0,84,15,401,0,0,408,377,31,GOOXXXXXXXXXXXXXXXXXGOOOOOXXXXXXXXXXXXXXGOOOOOOOOOXXXXXXXXXXGOOOOOXXXXXXXXXXXXXXGOOXXXXXXXXXXXXXXXXXGOOOOOXXXXXXXXXXXXXXGOOOOOOXXXXXXXXXXXXXGOOOOOOOOOXXXXXXXXXXGOOOOOOOOOOXXXXXXXXXGOOXXXXXXXXXXXXXXXXXGOOOOOXXXXXXXXXXXXXXGOOOXXXXXXXXXXXXXXXXGOOOOOOOOXXXXXXXXXXX,0,600,0
28959,84,0,84,15,401,0,0,408,377,31,GOOXXXXXXXXXXXXXXXXXGOOOOOXXXXXXXXXXXXXXGOOOOOOOOOXXXXXXXXXXGOOOOOXXXXXXXXXXXXXXGOOXXXXXXXXXXXXXXXXXGOOOOOXXXXXXXXXXXXXXGOOOOOOXXXXXXXXXXXXXGOOOOOOOOOXXXXXXXXXXGOOOOOOOOOOXXXXXXXXXGOOXXXXXXXXXXXXXXXXXGOOOOOXXXXXXXXXXXXXXGOOOXXXXXXXXXXXXXXXXGOOOOOOOOXXXXXXXXXXX,0,600,0

28980,84,0,84,14,402,0,0,409,380,29,GOOXXXXXXXXXXXXXXXXXGOOOOOXXXXXXXXXXXXXXGOOOOOOOOOXXXXXXXXXXGOOOOOXXXXXXXXXXXXXXGOOXXXXXXXXXXXXXXXXXGOOOOOXXXXXXXXXXXXXXGOOOOOOXXXXXXXXXXXXXGOOOOOOOOOXXXXXXXXXXGOOOOOOOOOOXXXXXXXXXGOOXXXXXXXXXXXXXXXXXGOOOOOXXXXXXXXXXXXXXGOOOXXXXXXXXXXXXXXXXGOOOOOOOOXXXXXXXXXXX,0,600,0
29001,84,0,84,13,403,0,0,410,384,26,GOOXXXXXXXXXXXXXXXXXGOOOOOXXXXXXXXXXXXXXGOOOOOOOOOXXXXXXXXXXGOOOOOXXXXXXXXXXXXXXGOOXXXXXXXXXXXXXXXXXGOOOOOXXXXXXXXXXXXXXGOOOOOOXXXXXXXXXXXXXGOOOOOOOOOXXXXXXXXXXGOOOOOOOOOOXXXXXXXXXGOOXXXXXXXXXXXXXXXXXGOOOOOXXXXXXXXXXXXXXGOOOXXXXXXXXXXXXXXXXGOOOOOOOOXXXXXXXXXXX,0,600,0
29022,84,0,84,15,401,0,0,408,379,29,GOOXXXXXXXXXXXXXXXXXGOOOOOXXXXXXXXXXXXXXGOOOOOOOOOXXXXXXXXXXGOOOOOXXXXXXXXXXXXXXGOOXXXXXXXXXXXXXXXXXGOOOOOXXXXXXXXXXXXXXGOOOOOOXXXXXXXXXXXXXGOOOOOOOOOXXXXXXXXXXGOOOOOOOOOOXXXXXXXXXGOOXXXXXXXXXXXXXXXXXGOOOOOXXXXXXXXXXXXXXGOOOXXXXXXXXXXXXXXXXGOOOOOOOOXXXXXXXXXXX,0,600,0
29043,84,0,84,17,399,0,0,406,377,29,GOOXXXXXXXXXXXXXXXXXGOOOOOXXXXXXXXXXXXXXGOOOOOOOOOXXXXXXXXXXGOOOOOXXXXXXXXXXXXXXGOOXXXXXXXXXXXXXXXXXGOOOOOXXXXXXXXXXXXXXGOOOOOOXXXXXXXXXXXXXGOOOOOOOOOXXXXXXXXXXGOOOOOOOOOOXXXXXXXXXGOOXXXXXXXXXXXXXXXXXGOOOOOXXXXXXXXXXXXXXGOOOXXXXXXXXXXXXXXXXGOOOOOOOOXXXXXXXXXXX,0,600,0
29064,84,0,84,17,399,0,0,406,378,28,GOOXXXXXXXXXXXXXXXXXGOOOOOXXXXXXXXXXXXXXGOOOOOOOOOXXXXXXXXXXGOOOOOXXXXXXXXXXXXXXGOOXXXXXXXXXXXXXXXXXGOOOOOXXXXXXXXXXXXXXGOOOOOOXXXXXXXXXXXXXGOOOOOOOOOXXXXXXXXXXGOOOOOOOOOOXXXXXXXXXGOOXXXXXXXXXXXXXXXXXGOOOOOXXXXXXXXXXXXXXGOOOXXXXXXXXXXXXXXXXGOOOOOOOOXXXXXXXXXXX,0,600,0

29085,84,0,84,17,399,0,0,406,379,27,GOOXXXXXXXXXXXXXXXXXGOOOOOXXXXXXXXXXXXXXGOOOOOOOOOXXXXXXXXXXGOOOOOXXXXXXXXXXXXXXGOOXXXXXXXXXXXXXXXXXGOOOOOXXXXXXXXXXXXXXGOOOOOOXXXXXXXXXXXXXGOOOOOOOOOXXXXXXXXXXGOOOOOOOOOOXXXXXXXXXGOOXXXXXXXXXXXXXXXXXGOOOOOXXXXXXXXXXXXXXGOOOXXXXXXXXXXXXXXXXGOOOOOOOOXXXXXXXXXXX,0,600,0
29106,84,0,84,18,398,0,0,405,378,27,GOOXXXXXXXXXXXXXXXXXGOOOOOXXXXXXXXXXXXXXGOOOOOOOOOXXXXXXXXXXGOOOOOXXXXXXXXXXXXXXGOOXXXXXXXXXXXXXXXXXGOOOOOXXXXXXXXXXXXXXGOOOOOOXXXXXXXXXXXXXGOOOOOOOOOXXXXXXXXXXGOOOOOOOOOOXXXXXXXXXGOOXXXXXXXXXXXXXXXXXGOOOOOXXXXXXXXXXXXXXGOOOXXXXXXXXXXXXXXXXGOOOOOOOOXXXXXXXXXXX,0,600,0
29127,84,0,84,20,396,0,0,403,377,26,GOOXXXXXXXXXXXXXXXXXGOOOOOXXXXXXXXXXXXXXGOOOOOOOOOXXXXXXXXXXGOOOOOXXXXXXXXXXXXXXGOOXXXXXXXXXXXXXXXXXGOOOOOXXXXXXXXXXXXXXGOOOOOOXXXXXXXXXXXXXGOOOOOOOOOXXXXXXXXXXGOOOOOOOOOOXXXXXXXXXGOOXXXXXXXXXXXXXXXXXGOOOOOXXXXXXXXXXXXXXGOOOXXXXXXXXXXXXXXXXGOOOOOOOOXXXXXXXXXXX,0,600,0
29148,84,0,84,17,399,0,0,406,377,29,GOOXXXXXXXXXXXXXXXXXGOOOOOXXXXXXXXXXXXXXGOOOOOOOOOXXXXXXXXXXGOOOOOXXXXXXXXXXXXXXGOOXXXXXXXXXXXXXXXXXGOOOOOXXXXXXXXXXXXXXGOOOOOOXXXXXXXXXXXXXGOOOOOOOOOXXXXXXXXXXGOOOOOOOOOOXXXXXXXXXGOOXXXXXXXXXXXXXXXXXGOOOOOXXXXXXXXXXXXXXGOOOXXXXXXXXXXXXXXXXGOOOOOOOOXXXXXXXXXXX,0,600,0
29169,84,0,84,15,401,0,0,408,377,31,GOOXXXXXXXXXXXXXXXXXGOOOOOXXXXXXXXXXXXXXGOOOOOOOOOXXXXXXXXXXGOOOOOXXXXXXXXXXXXXXGOOXXXXXXXXXXXXXXXXXGOOOOOXXXXXXXXXXXXXXGOOOOOOXXXXXXXXXXXXXGOOOOOOOOOXXXXXXXXXXGOOOOOOOOOOXXXXXXXXXGOOXXXXXXXXXXXXXXXXXGOOOOOXXXXXXXXXXXXXXGOOOXXXXXXXXXXXXXXXXGOOOOOOOOXXXXXXXXXXX,0,600,0

29190,84,0,84,15,401,0,0,408,377,31,GOOXXXXXXXXXXXXXXXXXGOOOOOXXXXXXXXXXXXXXGOOOOOOOOOXXXXXXXXXXGOOOOOXXXXXXXXXXXXXXGOOXXXXXXXXXXXXXXXXXGOOOOOXXXXXXXXXXXXXXGOOOOOOXXXXXXXXXXXXXGOOOOOOOOOXXXXXXXXXXGOOOOOOOOOOXXXXXXXXXGOOXXXXXXXXXXXXXXXXXGOOOOOXXXXXXXXXXXXXXGOOOXXXXXXXXXXXXXXXXGOOOOOOOOXXXXXXXXXXX,0,600,0
29211,84,0,84,15,401,0,0,408,378,30,GOOXXXXXXXXXXXXXXXXXGOOOOOXXXXXXXXXXXXXXGOOOOOOOOOXXXXXXXXXXGOOOOOXXXXXXXXXXXXXXGOOXXXXXXXXXXXXXXXXXGOOOOOXXXXXXXXXXXXXXGOOOOOOXXXXXXXXXXXXXGOOOOOOOOOXXXXXXXXXXGOOOOOOOOOOXXXXXXXXXGOOXXXXXXXXXXXXXXXXXGOOOOOXXXXXXXXXXXXXXGOOOXXXXXXXXXXXXXXXXGOOOOOOOOXXXXXXXXXXX,0,600,0
29232,84,0,84,17,399,0,0,406,378,28,GOOXXXXXXXXXXXXXXXXXGOOOOOXXXXXXXXXXXXXXGOOOOOOOOOXXXXXXXXXXGOOOOOXXXXXXXXXXXXXXGOOXXXXXXXXXXXXXXXXXGOOOOOXXXXXXXXXXXXXXGOOOOOOXXXXXXXXXXXXXGOOOOOOOOOXXXXXXXXXXGOOOOOOOOOOXXXXXXXXXGOOXXXXXXXXXXXXXXXXXGOOOOOXXXXXXXXXXXXXXGOOOXXXXXXXXXXXXXXXXGOOOOOOOOXXXXXXXXXXX,0,600,0
29253,84,0,84,17,399,0,0,406,378,28,GOOXXXXXXXXXXXXXXXXXGOOOOOXXXXXXXXXXXXXXGOOOOOOOOOXXXXXXXXXXGOOOOOXXXXXXXXXXXXXXGOOXXXXXXXXXXXXXXXXXGOOOOOXXXXXXXXXXXXXXGOOOOOOXXXXXXXXXXXXXGOOOOOOOOOXXXXXXXXXXGOOOOOOOOOOXXXXXXXXXGOOXXXXXXXXXXXXXXXXXGOOOOOXXXXXXXXXXXXXXGOOOXXXXXXXXXXXXXXXXGOOOOOOOOXXXXXXXXXXX,0,600,0
29274,84,0,84,17,399,0,0,406,380,26,GOOXXXXXXXXXXXXXXXXXGOOOOOXXXXXXXXXXXXXXGOOOOOOOOOXXXXXXXXXXGOOOOOXXXXXXXXXXXXXXGOOXXXXXXXXXXXXXXXXXGOOOOOXXXXXXXXXXXXXXGOOOOOOXXXXXXXXXXXXXGOOOOOOOOOXXXXXXXXXXGOOOOOOOOOOXXXXXXXXXGOOXXXXXXXXXXXXXXXXXGOOOOOXXXXXXXXXXXXXXGOOOXXXXXXXXXXXXXXXXGOOOOOOOOXXXXXXXXXXX,0,600,0

29295,84,0,84,16,400,0,0,407,381,26,GOOXXXXXXXXXXXXXXXXXGOOOOOXXXXXXXXXXXXXXGOOOOOOOOOXXXXXXXXXXGOOOOOXXXXXXXXXXXXXXGOOXXXXXXXXXXXXXXXXXGOOOOOXXXXXXXXXXXXXXGOOOOOOXXXXXXXXXXXXXGOOOOOOOOOXXXXXXXXXXGOOOOOOOOOOXXXXXXXXXGOOXXXXXXXXXXXXXXXXXGOOOOOXXXXXXXXXXXXXXGOOOXXXXXXXXXXXXXXXXGOOOOOOOOXXXXXXXXXXX,0,600,0
29316,84,0,84,13,403,0,0,410,379,31,GOOXXXXXXXXXXXXXXXXXGOOOOOXXXXXXXXXXXXXXGOOOOOOOOOXXXXXXXXXXGOOOOOXXXXXXXXXXXXXXGOOXXXXXXXXXXXXXXXXXGOOOOOXXXXXXXXXXXXXXGOOOOOOXXXXXXXXXXXXXGOOOOOOOOOXXXXXXXXXXGOOOOOOOOOOXXXXXXXXXGOOXXXXXXXXXXXXXXXXXGOOOOOXXXXXXXXXXXXXXGOOOXXXXXXXXXXXXXXXXGOOOOOOOOXXXXXXXXXXX,0,600,0
29337,84,0,84,12,404,0,0,411,380,31,GOOXXXXXXXXXXXXXXXXXGOOOOOXXXXXXXXXXXXXXGOOOOOOOOOXXXXXXXXXXGOOOOOXXXXXXXXXXXXXXGOOXXXXXXXXXXXXXXXXXGOOOOOXXXXXXXXXXXXXXGOOOOOOXXXXXXXXXXXXXGOOOOOOOOOXXXXXXXXXXGOOOOOOOOOOXXXXXXXXXGOOXXXXXXXXXXXXXXXXXGOOOOOXXXXXXXXXXXXXXGOOOXXXXXXXXXXXXXXXXGOOOOOOOOXXXXXXXXXXX,0,600,0
29358,84,0,84,15,401,0,0,408,380,28,GOOXXXXXXXXXXXXXXXXXGOOOOOXXXXXXXXXXXXXXGOOOOOOOOOXXXXXXXXXXGOOOOOXXXXXXXXXXXXXXGOOXXXXXXXXXXXXXXXXXGOOOOOXXXXXXXXXXXXXXGOOOOOOXXXXXXXXXXXXXGOOOOOOOOOXXXXXXXXXXGOOOOOOOOOOXXXXXXXXXGOOXXXXXXXXXXXXXXXXXGOOOOOXXXXXXXXXXXXXXGOOOXXXXXXXXXXXXXXXXGOOOOOOOOXXXXXXXXXXX,0,600,0
29379,84,0,84,16,400,0,0,407,379,28,GOOXXXXXXXXXXXXXXXXXGOOOOOXXXXXXXXXXXXXXGOOOOOOOOOXXXXXXXXXXGOOOOOXXXXXXXXXXXXXXGOOXXXXXXXXXXXXXXXXXGOOOOOXXXXXXXXXXXXXXGOOOOOOXXXXXXXXXXXXXGOOOOOOOOOXXXXXXXXXXGOOOOOOOOOOXXXXXXXXXGOOXXXXXXXXXXXXXXXXXGOOOOOXXXXXXXXXXXXXXGOOOXXXXXXXXXXXXXXXXGOOOOOOOOXXXXXXXXXXX,0,600,0

29400,84,0,84,18,398,0,0,405,379,26,GOOXXXXXXXXXXXXXXXXXGOOOOOXXXXXXXXXXXXXXGOOOOOOOOOXXXXXXXXXXGOOOOOXXXXXXXXXXXXXXGOOXXXXXXXXXXXXXXXXXGOOOOOXXXXXXXXXXXXXXGOOOOOOXXXXXXXXXXXXXGOOOOOOOOOXXXXXXXXXXGOOOOOOOOOOXXXXXXXXXGOOXXXXXXXXXXXXXXXXXGOOOOOXXXXXXXXXXXXXXGOOOXXXXXXXXXXXXXXXXGOOOOOOOOXXXXXXXXXXX,0,600,0
29421,84,0,84,22,394,0,0,401,378,23,GOOXXXXXXXXXXXXXXXXXGOOOOOXXXXXXXXXXXXXXGOOOOOOOOOXXXXXXXXXXGOOOOOXXXXXXXXXXXXXXGOOXXXXXXXXXXXXXXXXXGOOOOOXXXXXXXXXXXXXXGOOOOOOXXXXXXXXXXXXXGOOOOOOOOOXXXXXXXXXXGOOOOOOOOOOXXXXXXXXXGOOXXXXXXXXXXXXXXXXXGOOOOOXXXXXXXXXXXXXXGOOOXXXXXXXXXXXXXXXXGOOOOOOOOXXXXXXXXXXX,0,600,0
29442,84,0,84,22,394,0,0,401,378,23,GOOXXXXXXXXXXXXXXXXXGOOOOOXXXXXXXXXXXXXXGOOOOOOOOOXXXXXXXXXXGOOOOOXXXXXXXXXXXXXXGOOXXXXXXXXXXXXXXXXXGOOOOOXXXXXXXXXXXXXXGOOOOOOXXXXXXXXXXXXXGOOOOOOOOOXXXXXXXXXXGOOOOOOOOOOXXXXXXXXXGOOXXXXXXXXXXXXXXXXXGOOOOOXXXXXXXXXXXXXXGOOOXXXXXXXXXXXXXXXXGOOOOOOOOXXXXXXXXXXX,0,600,0
29463,84,0,84,20,396,0,0,403,378,25,GOOXXXXXXXXXXXXXXXXXGOOOOOXXXXXXXXXXXXXXGOOOOOOOOOXXXXXXXXXXGOOOOOXXXXXXXXXXXXXXGOOXXXXXXXXXXXXXXXXXGOOOOOXXXXXXXXXXXXXXGOOOOOOXXXXXXXXXXXXXGOOOOOOOOOXXXXXXXXXXGOOOOOOOOOOXXXXXXXXXGOOXXXXXXXXXXXXXXXXXGOOOOOXXXXXXXXXXXXXXGOOOXXXXXXXXXXXXXXXXGOOOOOOOOXXXXXXXXXXX,0,600,0
29484,84,0,84,21,395,0,0,402,379,23,GOOXXXXXXXXXXXXXXXXXGOOOOOXXXXXXXXXXXXXXGOOOOOOOOOXXXXXXXXXXGOOOOOXXXXXXXXXXXXXXGOOXXXXXXXXXXXXXXXXXGOOOOOXXXXXXXXXXXXXXGOOOOOOXXXXXXXXXXXXXGOOOOOOOOOXXXXXXXXXXGOOOOOOOOOOXXXXXXXXXGOOXXXXXXXXXXXXXXXXXGOOOOOXXXXXXXXXXXXXXGOOOXXXXXXXXXXXXXXXXGOOOOOOOOXXXXXXXXXXX,0,600,0

29505,84,0,84,21,395,0,0,402,379,23,GOOXXXXXXXXXXXXXXXXXGOOOOOXXXXXXXXXXXXXXGOOOOOOOOOXXXXXXXXXXGOOOOOXXXXXXXXXXXXXXGOOXXXXXXXXXXXXXXXXXGOOOOOXXXXXXXXXXXXXXGOOOOOOXXXXXXXXXXXXXGOOOOOOOOOXXXXXXXXXXGOOOOOOOOOOXXXXXXXXXGOOXXXXXXXXXXXXXXXXXGOOOOOXXXXXXXXXXXXXXGOOOXXXXXXXXXXXXXXXXGOOOOOOOOXXXXXXXXXXX,0,600,0
29526,84,0,84,19,397,0,0,404,379,25,GOOXXXXXXXXXXXXXXXXXGOOOOOXXXXXXXXXXXXXXGOOOOOOOOOXXXXXXXXXXGOOOOOXXXXXXXXXXXXXXGOOXXXXXXXXXXXXXXXXXGOOOOOXXXXXXXXXXXXXXGOOOOOOXXXXXXXXXXXXXGOOOOOOOOOXXXXXXXXXXGOOOOOOOOOOXXXXXXXXXGOOXXXXXXXXXXXXXXXXXGOOOOOXXXXXXXXXXXXXXGOOOXXXXXXXXXXXXXXXXGOOOOOOOOXXXXXXXXXXX,0,600,0
29547,84,0,84,20,396,0,0,403,379,24,GOOXXXXXXXXXXXXXXXXXGOOOOOXXXXXXXXXXXXXXGOOOOOOOOOXXXXXXXXXXGOOOOOXXXXXXXXXXXXXXGOOXXXXXXXXXXXXXXXXXGOOOOOXXXXXXXXXXXXXXGOOOOOOXXXXXXXXXXXXXGOOOOOOOOOXXXXXXXXXXGOOOOOOOOOOXXXXXXXXXGOOXXXXXXXXXXXXXXXXXGOOOOOXXXXXXXXXXXXXXGOOOXXXXXXXXXXXXXXXXGOOOOOOOOXXXXXXXXXXX,0,600,0
29568,84,0,84,20,396,0,0,403,378,25,GOOXXXXXXXXXXXXXXXXXGOOOOOXXXXXXXXXXXXXXGOOOOOOOOOXXXXXXXXXXGOOOOOXXXXXXXXXXXXXXGOOXXXXXXXXXXXXXXXXXGOOOOOXXXXXXXXXXXXXXGOOOOOOXXXXXXXXXXXXXGOOOOOOOOOXXXXXXXXXXGOOOOOOOOOOXXXXXXXXXGOOXXXXXXXXXXXXXXXXXGOOOOOXXXXXXXXXXXXXXGOOOXXXXXXXXXXXXXXXXGOOOOOOOOXXXXXXXXXXX,0,600,0
29589,84,0,84,19,397,0,0,404,379,25,GOOXXXXXXXXXXXXXXXXXGOOOOOXXXXXXXXXXXXXXGOOOOOOOOOXXXXXXXXXXGOOOOOXXXXXXXXXXXXXXGOOXXXXXXXXXXXXXXXXXGOOOOOXXXXXXXXXXXXXXGOOOOOOXXXXXXXXXXXXXGOOOOOOOOOXXXXXXXXXXGOOOOOOOOOOXXXXXXXXXGOOXXXXXXXXXXXXXXXXXGOOOOOXXXXXXXXXXXXXXGOOOXXXXXXXXXXXXXXXXGOOOOOOOOXXXXXXXXXXX,0,600,0

29610,84,0,84,22,394,0,0,401,378,23,GOOXXXXXXXXXXXXXXXXXGOOOOOXXXXXXXXXXXXXXGOOOOOOOOOXXXXXXXXXXGOOOOOXXXXXXXXXXXXXXGOOXXXXXXXXXXXXXXXXXGOOOOOXXXXXXXXXXXXXXGOOOOOOXXXXXXXXXXXXXGOOOOOOOOOXXXXXXXXXXGOOOOOOOOOOXXXXXXXXXGOOXXXXXXXXXXXXXXXXXGOOOOOXXXXXXXXXXXXXXGOOOXXXXXXXXXXXXXXXXGOOOOOOOOXXXXXXXXXXX,0,600,0
29631,84,0,84,20,396,0,0,403,379,24,GOOXXXXXXXXXXXXXXXXXGOOOOOXXXXXXXXXXXXXXGOOOOOOOOOXXXXXXXXXXGOOOOOXXXXXXXXXXXXXXGOOXXXXXXXXXXXXXXXXXGOOOOOXXXXXXXXXXXXXXGOOOOOOXXXXXXXXXXXXXGOOOOOOOOOXXXXXXXXXXGOOOOOOOOOOXXXXXXXXXGOOXXXXXXXXXXXXXXXXXGOOOOOXXXXXXXXXXXXXXGOOOXXXXXXXXXXXXXXXXGOOOOOOOOXXXXXXXXXXX,0,600,0
29652,84,0,84,21,395,0,0,402,378,24,GOOXXXXXXXXXXXXXXXXXGOOOOOXXXXXXXXXXXXXXGOOOOOOOOOXXXXXXXXXXGOOOOOXXXXXXXXXXXXXXGOOXXXXXXXXXXXXXXXXXGOOOOOXXXXXXXXXXXXXXGOOOOOOXXXXXXXXXXXXXGOOOOOOOOOXXXXXXXXXXGOOOOOOOOOOXXXXXXXXXGOOXXXXXXXXXXXXXXXXXGOOOOOXXXXXXXXXXXXXXGOOOXXXXXXXXXXXXXXXXGOOOOOOOOXXXXXXXXXXX,0,600,0
29673,84,0,84,20,396,0,0,403,379,24,GOOXXXXXXXXXXXXXXXXXGOOOOOXXXXXXXXXXXXXXGOOOOOOOOOXXXXXXXXXXGOOOOOXXXXXXXXXXXXXXGOOXXXXXXXXXXXXXXXXXGOOOOOXXXXXXXXXXXXXXGOOOOOOXXXXXXXXXXXXXGOOOOOOOOOXXXXXXXXXXGOOOOOOOOOOXXXXXXXXXGOOXXXXXXXXXXXXXXXXXGOOOOOXXXXXXXXXXXXXXGOOOXXXXXXXXXXXXXXXXGOOOOOOOOXXXXXXXXXXX,0,600,0
29694,84,0,84,21,395,0,0,402,378,24,GOOXXXXXXXXXXXXXXXXXGOOOOOXXXXXXXXXXXXXXGOOOOOOOOOXXXXXXXXXXGOOOOOXXXXXXXXXXXXXXGOOXXXXXXXXXXXXXXXXXGOOOOOXXXXXXXXXXXXXXGOOOOOOXXXXXXXXXXXXXGOOOOOOOOOXXXXXXXXXXGOOOOOOOOOOXXXXXXXXXGOOXXXXXXXXXXXXXXXXXGOOOOOXXXXXXXXXXXXXXGOOOXXXXXXXXXXXXXXXXGOOOOOOOOXXXXXXXXXXX,0,600,0

29715,84,0,84,18,398,0,0,404,379,25,GOOXXXXXXXXXXXXXXXXXGOOOOOXXXXXXXXXXXXXXGOOOOOOOOOXXXXXXXXXXGOOOOOXXXXXXXXXXXXXXGOOXXXXXXXXXXXXXXXXXGOOOOOXXXXXXXXXXXXXXGOOOOOOXXXXXXXXXXXXXGOOOOOOOOOXXXXXXXXXXGOOOOOOOOOOXXXXXXXXXGOOXXXXXXXXXXXXXXXXXGOOOOOXXXXXXXXXXXXXXGOOOXXXXXXXXXXXXXXXXGOOOOOOOOXXXXXXXXXXX,0,600,0
29736,84,0,84,17,399,0,0,406,379,27,GOOXXXXXXXXXXXXXXXXXGOOOOOXXXXXXXXXXXXXXGOOOOOOOOOXXXXXXXXXXGOOOOOXXXXXXXXXXXXXXGOOXXXXXXXXXXXXXXXXXGOOOOOXXXXXXXXXXXXXXGOOOOOOXXXXXXXXXXXXXGOOOOOOOOOXXXXXXXXXXGOOOOOOOOOOXXXXXXXXXGOOXXXXXXXXXXXXXXXXXGOOOOOXXXXXXXXXXXXXXGOOOXXXXXXXXXXXXXXXXGOOOOOOOOXXXXXXXXXXX,0,600,0
29757,84,0,84,16,400,0,0,407,379,28,GOOXXXXXXXXXXXXXXXXXGOOOOOXXXXXXXXXXXXXXGOOOOOOOOOXXXXXXXXXXGOOOOOXXXXXXXXXXXXXXGOOXXXXXXXXXXXXXXXXXGOOOOOXXXXXXXXXXXXXXGOOOOOOXXXXXXXXXXXXXGOOOOOOOOOXXXXXXXXXXGOOOOOOOOOOXXXXXXXXXGOOXXXXXXXXXXXXXXXXXGOOOOOXXXXXXXXXXXXXXGOOOXXXXXXXXXXXXXXXXGOOOOOOOOXXXXXXXXXXX,0,600,0
29778,84,0,84,15,401,0,0,408,378,30,GOOXXXXXXXXXXXXXXXXXGOOOOOXXXXXXXXXXXXXXGOOOOOOOOOXXXXXXXXXXGOOOOOXXXXXXXXXXXXXXGOOXXXXXXXXXXXXXXXXXGOOOOOXXXXXXXXXXXXXXGOOOOOOXXXXXXXXXXXXXGOOOOOOOOOXXXXXXXXXXGOOOOOOOOOOXXXXXXXXXGOOXXXXXXXXXXXXXXXXXGOOOOOXXXXXXXXXXXXXXGOOOXXXXXXXXXXXXXXXXGOOOOOOOOXXXXXXXXXXX,0,600,0
29799,84,0,84,14,402,0,0,409,380,29,GOOXXXXXXXXXXXXXXXXXGOOOOOXXXXXXXXXXXXXXGOOOOOOOOOXXXXXXXXXXGOOOOOXXXXXXXXXXXXXXGOOXXXXXXXXXXXXXXXXXGOOOOOXXXXXXXXXXXXXXGOOOOOOXXXXXXXXXXXXXGOOOOOOOOOXXXXXXXXXXGOOOOOOOOOOXXXXXXXXXGOOXXXXXXXXXXXXXXXXXGOOOOOXXXXXXXXXXXXXXGOOOXXXXXXXXXXXXXXXXGOOOOOOOOXXXXXXXXXXX,0,600,0

29820,84,0,84,14,402,0,0,409,380,29,GOOXXXXXXXXXXXXXXXXXGOOOOOXXXXXXXXXXXXXXGOOOOOOOOOXXXXXXXXXXGOOOOOXXXXXXXXXXXXXXGOOXXXXXXXXXXXXXXXXXGOOOOOXXXXXXXXXXXXXXGOOOOOOXXXXXXXXXXXXXGOOOOOOOOOXXXXXXXXXXGOOOOOOOOOOXXXXXXXXXGOOXXXXXXXXXXXXXXXXXGOOOOOXXXXXXXXXXXXXXGOOOXXXXXXXXXXXXXXXXGOOOOOOOOXXXXXXXXXXX,0,600,0
29841,84,0,84,14,402,0,0,409,379,30,GOOXXXXXXXXXXXXXXXXXGOOOOOXXXXXXXXXXXXXXGOOOOOOOOOXXXXXXXXXXGOOOOOXXXXXXXXXXXXXXGOOXXXXXXXXXXXXXXXXXGOOOOOXXXXXXXXXXXXXXGOOOOOOXXXXXXXXXXXXXGOOOOOOOOOXXXXXXXXXXGOOOOOOOOOOXXXXXXXXXGOOXXXXXXXXXXXXXXXXXGOOOOOXXXXXXXXXXXXXXGOOOXXXXXXXXXXXXXXXXGOOOOOOOOXXXXXXXXXXX,0,600,0
29862,84,0,84,11,405,0,0,412,380,32,GOOXXXXXXXXXXXXXXXXXGOOOOOXXXXXXXXXXXXXXGOOOOOOOOOXXXXXXXXXXGOOOOOXXXXXXXXXXXXXXGOOXXXXXXXXXXXXXXXXXGOOOOOXXXXXXXXXXXXXXGOOOOOOXXXXXXXXXXXXXGOOOOOOOOOXXXXXXXXXXGOOOOOOOOOOXXXXXXXXXGOOXXXXXXXXXXXXXXXXXGOOOOOXXXXXXXXXXXXXXGOOOXXXXXXXXXXXXXXXXGOOOOOOOOXXXXXXXXXXX,0,600,0
29883,84,0,84,9,407,0,0,414,380,34,GOOXXXXXXXXXXXXXXXXXGOOOOOXXXXXXXXXXXXXXGOOOOOOOOOXXXXXXXXXXGOOOOOXXXXXXXXXXXXXXGOOXXXXXXXXXXXXXXXXXGOOOOOXXXXXXXXXXXXXXGOOOOOOXXXXXXXXXXXXXGOOOOOOOOOXXXXXXXXXXGOOOOOOOOOOXXXXXXXXXGOOXXXXXXXXXXXXXXXXXGOOOOOXXXXXXXXXXXXXXGOOOXXXXXXXXXXXXXXXXGOOOOOOOOXXXXXXXXXXX,0,600,0
29904,84,0,84,9,407,0,0,414,379,35,GOOXXXXXXXXXXXXXXXXXGOOOOOXXXXXXXXXXXXXXGOOOOOOOOOXXXXXXXXXXGOOOOOXXXXXXXXXXXXXXGOOXXXXXXXXXXXXXXXXXGOOOOOXXXXXXXXXXXXXXGOOOOOOXXXXXXXXXXXXXGOOOOOOOOOXXXXXXXXXXGOOOOOOOOOOXXXXXXXXXGOOXXXXXXXXXXXXXXXXXGOOOOOXXXXXXXXXXXXXXGOOOXXXXXXXXXXXXXXXXGOOOOOOOOXXXXXXXXXXX,0,600,0

29925,84,0,84,10,406,0,0,413,381,32,GOOXXXXXXXXXXXXXXXXXGOOOOOXXXXXXXXXXXXXXGOOOOOOOOOXXXXXXXXXXGOOOOOXXXXXXXXXXXXXXGOOXXXXXXXXXXXXXXXXXGOOOOOXXXXXXXXXXXXXXGOOOOOOXXXXXXXXXXXXXGOOOOOOOOOXXXXXXXXXXGOOOOOOOOOOXXXXXXXXXGOOXXXXXXXXXXXXXXXXXGOOOOOXXXXXXXXXXXXXXGOOOXXXXXXXXXXXXXXXXGOOOOOOOOXXXXXXXXXXX,0,600,0
29946,84,0,84,10,406,0,0,413,382,31,GOOXXXXXXXXXXXXXXXXXGOOOOOXXXXXXXXXXXXXXGOOOOOOOOOXXXXXXXXXXGOOOOOXXXXXXXXXXXXXXGOOXXXXXXXXXXXXXXXXXGOOOOOXXXXXXXXXXXXXXGOOOOOOXXXXXXXXXXXXXGOOOOOOOOOXXXXXXXXXXGOOOOOOOOOOXXXXXXXXXGOOXXXXXXXXXXXXXXXXXGOOOOOXXXXXXXXXXXXXXGOOOXXXXXXXXXXXXXXXXGOOOOOOOOXXXXXXXXXXX,0,600,0
29967,84,0,84,12,404,0,0,411,381,30,GOOXXXXXXXXXXXXXXXXXGOOOOOXXXXXXXXXXXXXXGOOOOOOOOOXXXXXXXXXXGOOOOOXXXXXXXXXXXXXXGOOXXXXXXXXXXXXXXXXXGOOOOOXXXXXXXXXXXXXXGOOOOOOXXXXXXXXXXXXXGOOOOOOOOOXXXXXXXXXXGOOOOOOOOOOXXXXXXXXXGOOXXXXXXXXXXXXXXXXXGOOOOOXXXXXXXXXXXXXXGOOOXXXXXXXXXXXXXXXXGOOOOOOOOXXXXXXXXXXX,0,600,0
29988,84,0,84,12,404,0,0,411,381,30,GOOXXXXXXXXXXXXXXXXXGOOOOOXXXXXXXXXXXXXXGOOOOOOOOOXXXXXXXXXXGOOOOOXXXXXXXXXXXXXXGOOXXXXXXXXXXXXXXXXXGOOOOOXXXXXXXXXXXXXXGOOOOOOXXXXXXXXXXXXXGOOOOOOOOOXXXXXXXXXXGOOOOOOOOOOXXXXXXXXXGOOXXXXXXXXXXXXXXXXXGOOOOOXXXXXXXXXXXXXXGOOOXXXXXXXXXXXXXXXXGOOOOOOOOXXXXXXXXXXX,0,600,0
30009,84,0,84,12,404,0,0,411,380,31,GOOXXXXXXXXXXXXXXXXXGOOOOOXXXXXXXXXXXXXXGOOOOOOOOOXXXXXXXXXXGOOOOOXXXXXXXXXXXXXXGOOXXXXXXXXXXXXXXXXXGOOOOOXXXXXXXXXXXXXXGOOOOOOXXXXXXXXXXXXXGOOOOOOOOOXXXXXXXXXXGOOOOOOOOOOXXXXXXXXXGOOXXXXXXXXXXXXXXXXXGOOOOOXXXXXXXXXXXXXXGOOOXXXXXXXXXXXXXXXXGOOOOOOOOXXXXXXXXXXX,0,600,0

30030,84,0,84,15,401,0,0,408,381,27,GOOXXXXXXXXXXXXXXXXXGOOOOOXXXXXXXXXXXXXXGOOOOOOOOOXXXXXXXXXXGOOOOOXXXXXXXXXXXXXXGOOXXXXXXXXXXXXXXXXXGOOOOOXXXXXXXXXXXXXXGOOOOOOXXXXXXXXXXXXXGOOOOOOOOOXXXXXXXXXXGOOOOOOOOOOXXXXXXXXXGOOXXXXXXXXXXXXXXXXXGOOOOOXXXXXXXXXXXXXXGOOOXXXXXXXXXXXXXXXXGOOOOOOOOXXXXXXXXXXX,0,600,0
30051,84,0,84,16,400,0,0,407,380,27,GOOXXXXXXXXXXXXXXXXXGOOOOOXXXXXXXXXXXXXXGOOOOOOOOOXXXXXXXXXXGOOOOOXXXXXXXXXXXXXXGOOXXXXXXXXXXXXXXXXXGOOOOOXXXXXXXXXXXXXXGOOOOOOXXXXXXXXXXXXXGOOOOOOOOOXXXXXXXXXXGOOOOOOOOOOXXXXXXXXXGOOXXXXXXXXXXXXXXXXXGOOOOOXXXXXXXXXXXXXXGOOOXXXXXXXXXXXXXXXXGOOOOOOOOXXXXXXXXXXX,0,600,0
30072,84,0,84,15,401,0,0,408,382,26,GOOXXXXXXXXXXXXXXXXXGOOOOOXXXXXXXXXXXXXXGOOOOOOOOOXXXXXXXXXXGOOOOOXXXXXXXXXXXXXXGOOXXXXXXXXXXXXXXXXXGOOOOOXXXXXXXXXXXXXXGOOOOOOXXXXXXXXXXXXXGOOOOOOOOOXXXXXXXXXXGOOOOOOOOOOXXXXXXXXXGOOXXXXXXXXXXXXXXXXXGOOOOOXXXXXXXXXXXXXXGOOOXXXXXXXXXXXXXXXXGOOOOOOOOXXXXXXXXXXX,0,600,0
30093,84,0,84,20,396,0,0,403,381,22,GOOXXXXXXXXXXXXXXXXXGOOOOOXXXXXXXXXXXXXXGOOOOOOOOOXXXXXXXXXXGOOOOOXXXXXXXXXXXXXXGOOXXXXXXXXXXXXXXXXXGOOOOOXXXXXXXXXXXXXXGOOOOOOXXXXXXXXXXXXXGOOOOOOOOOXXXXXXXXXXGOOOOOOOOOOXXXXXXXXXGOOXXXXXXXXXXXXXXXXXGOOOOOXXXXXXXXXXXXXXGOOOXXXXXXXXXXXXXXXXGOOOOOOOOXXXXXXXXXXX,0,600,0
30114,84,0,84,18,398,0,0,405,383,22,GOOXXXXXXXXXXXXXXXXXGOOOOOXXXXXXXXXXXXXXGOOOOOOOOOXXXXXXXXXXGOOOOOXXXXXXXXXXXXXXGOOXXXXXXXXXXXXXXXXXGOOOOOXXXXXXXXXXXXXXGOOOOOOXXXXXXXXXXXXXGOOOOOOOOOXXXXXXXXXXGOOOOOOOOOOXXXXXXXXXGOOXXXXXXXXXXXXXXXXXGOOOOOXXXXXXXXXXXXXXGOOOXXXXXXXXXXXXXXXXGOOOOOOOOXXXXXXXXXXX,0,600,0

30135,84,0,84,22,394,0,0,400,382,18,GOOXXXXXXXXXXXXXXXXXGOOOOOXXXXXXXXXXXXXXGOOOOOOOOOXXXXXXXXXXGOOOOOXXXXXXXXXXXXXXGOOXXXXXXXXXXXXXXXXXGOOOOOXXXXXXXXXXXXXXGOOOOOOXXXXXXXXXXXXXGOOOOOOOOOXXXXXXXXXXGOOOOOOOOOOXXXXXXXXXGOOXXXXXXXXXXXXXXXXXGOOOOOXXXXXXXXXXXXXXGOOOXXXXXXXXXXXXXXXXGOOOOOOOOXXXXXXXXXXX,0,600,0
30156,84,0,84,22,394,0,0,401,383,18,GOOXXXXXXXXXXXXXXXXXGOOOOOXXXXXXXXXXXXXXGOOOOOOOOOXXXXXXXXXXGOOOOOXXXXXXXXXXXXXXGOOXXXXXXXXXXXXXXXXXGOOOOOXXXXXXXXXXXXXXGOOOOOOXXXXXXXXXXXXXGOOOOOOOOOXXXXXXXXXXGOOOOOOOOOOXXXXXXXXXGOOXXXXXXXXXXXXXXXXXGOOOOOXXXXXXXXXXXXXXGOOOXXXXXXXXXXXXXXXXGOOOOOOOOXXXXXXXXXXX,0,600,0
30177,84,0,84,24,392,0,0,399,380,19,GOOXXXXXXXXXXXXXXXXXGOOOOOXXXXXXXXXXXXXXGOOOOOOOOOXXXXXXXXXXGOOOOOXXXXXXXXXXXXXXGOOXXXXXXXXXXXXXXXXXGOOOOOXXXXXXXXXXXXXXGOOOOOOXXXXXXXXXXXXXGOOOOOOOOOXXXXXXXXXXGOOOOOOOOOOXXXXXXXXXGOOXXXXXXXXXXXXXXXXXGOOOOOXXXXXXXXXXXXXXGOOOXXXXXXXXXXXXXXXXGOOOOOOOOXXXXXXXXXXX,0,600,0
30198,84,0,84,25,391,0,0,398,380,18,GOOXXXXXXXXXXXXXXXXXGOOOOOXXXXXXXXXXXXXXGOOOOOOOOOXXXXXXXXXXGOOOOOXXXXXXXXXXXXXXGOOXXXXXXXXXXXXXXXXXGOOOOOXXXXXXXXXXXXXXGOOOOOOXXXXXXXXXXXXXGOOOOOOOOOXXXXXXXXXXGOOOOOOOOOOXXXXXXXXXGOOXXXXXXXXXXXXXXXXXGOOOOOXXXXXXXXXXXXXXGOOOXXXXXXXXXXXXXXXXGOOOOOOOOXXXXXXXXXXX,0,600,0
30219,84,0,84,25,391,0,0,398,382,16,GOOXXXXXXXXXXXXXXXXXGOOOOOXXXXXXXXXXXXXXGOOOOOOOOOXXXXXXXXXXGOOOOOXXXXXXXXXXXXXXGOOXXXXXXXXXXXXXXXXXGOOOOOXXXXXXXXXXXXXXGOOOOOOXXXXXXXXXXXXXGOOOOOOOOOXXXXXXXXXXGOOOOOOOOOOXXXXXXXXXGOOXXXXXXXXXXXXXXXXXGOOOOOXXXXXXXXXXXXXXGOOOXXXXXXXXXXXXXXXXGOOOOOOOOXXXXXXXXXXX,0,600,0

30240,84,0,84,24,392,0,0,399,381,18,GOOXXXXXXXXXXXXXXXXXGOOOOOXXXXXXXXXXXXXXGOOOOOOOOOXXXXXXXXXXGOOOOOXXXXXXXXXXXXXXGOOXXXXXXXXXXXXXXXXXGOOOOOXXXXXXXXXXXXXXGOOOOOOXXXXXXXXXXXXXGOOOOOOOOOXXXXXXXXXXGOOOOOOOOOOXXXXXXXXXGOOXXXXXXXXXXXXXXXXXGOOOOOXXXXXXXXXXXXXXGOOOXXXXXXXXXXXXXXXXGOOOOOOOOXXXXXXXXXXX,0,600,0
30261,84,0,84,22,394,0,0,401,380,21,GOOXXXXXXXXXXXXXXXXXGOOOOOXXXXXXXXXXXXXXGOOOOOOOOOXXXXXXXXXXGOOOOOXXXXXXXXXXXXXXGOOXXXXXXXXXXXXXXXXXGOOOOOXXXXXXXXXXXXXXGOOOOOOXXXXXXXXXXXXXGOOOOOOOOOXXXXXXXXXXGOOOOOOOOOOXXXXXXXXXGOOXXXXXXXXXXXXXXXXXGOOOOOXXXXXXXXXXXXXXGOOOXXXXXXXXXXXXXXXXGOOOOOOOOXXXXXXXXXXX,0,600,0
30282,84,0,84,21,395,0,0,402,381,21,GOOXXXXXXXXXXXXXXXXXGOOOOOXXXXXXXXXXXXXXGOOOOOOOOOXXXXXXXXXXGOOOOOXXXXXXXXXXXXXXGOOXXXXXXXXXXXXXXXXXGOOOOOXXXXXXXXXXXXXXGOOOOOOXXXXXXXXXXXXXGOOOOOOOOOXXXXXXXXXXGOOOOOOOOOOXXXXXXXXXGOOXXXXXXXXXXXXXXXXXGOOOOOXXXXXXXXXXXXXXGOOOXXXXXXXXXXXXXXXXGOOOOOOOOXXXXXXXXXXX,0,600,0
30303,84,0,84,19,397,0,0,404,380,24,GOOXXXXXXXXXXXXXXXXXGOOOOOXXXXXXXXXXXXXXGOOOOOOOOOXXXXXXXXXXGOOOOOXXXXXXXXXXXXXXGOOXXXXXXXXXXXXXXXXXGOOOOOXXXXXXXXXXXXXXGOOOOOOXXXXXXXXXXXXXGOOOOOOOOOXXXXXXXXXXGOOOOOOOOOOXXXXXXXXXGOOXXXXXXXXXXXXXXXXXGOOOOOXXXXXXXXXXXXXXGOOOXXXXXXXXXXXXXXXXGOOOOOOOOXXXXXXXXXXX,0,600,0
30324,84,0,84,19,397,0,0,404,380,24,GOOXXXXXXXXXXXXXXXXXGOOOOOXXXXXXXXXXXXXXGOOOOOOOOOXXXXXXXXXXGOOOOOXXXXXXXXXXXXXXGOOXXXXXXXXXXXXXXXXXGOOOOOXXXXXXXXXXXXXXGOOOOOOXXXXXXXXXXXXXGOOOOOOOOOXXXXXXXXXXGOOOOOOOOOOXXXXXXXXXGOOXXXXXXXXXXXXXXXXXGOOOOOXXXXXXXXXXXXXXGOOOXXXXXXXXXXXXXXXXGOOOOOOOOXXXXXXXXXXX,0,600,0

30345,84,0,84,16,400,0,0,406,381,25,GOOXXXXXXXXXXXXXXXXXGOOOOOXXXXXXXXXXXXXXGOOOOOOOOOXXXXXXXXXXGOOOOOXXXXXXXXXXXXXXGOOXXXXXXXXXXXXXXXXXGOOOOOXXXXXXXXXXXXXXGOOOOOOXXXXXXXXXXXXXGOOOOOOOOOXXXXXXXXXXGOOOOOOOOOOXXXXXXXXXGOOXXXXXXXXXXXXXXXXXGOOOOOXXXXXXXXXXXXXXGOOOXXXXXXXXXXXXXXXXGOOOOOOOOXXXXXXXXXXX,0,600,0
30366,84,0,84,15,401,0,0,408,381,27,GOOXXXXXXXXXXXXXXXXXGOOOOOXXXXXXXXXXXXXXGOOOOOOOOOXXXXXXXXXXGOOOOOXXXXXXXXXXXXXXGOOXXXXXXXXXXXXXXXXXGOOOOOXXXXXXXXXXXXXXGOOOOOOXXXXXXXXXXXXXGOOOOOOOOOXXXXXXXXXXGOOOOOOOOOOXXXXXXXXXGOOXXXXXXXXXXXXXXXXXGOOOOOXXXXXXXXXXXXXXGOOOXXXXXXXXXXXXXXXXGOOOOOOOOXXXXXXXXXXX,0,600,0
30387,84,0,84,13,403,0,0,410,381,29,GOOXXXXXXXXXXXXXXXXXGOOOOOXXXXXXXXXXXXXXGOOOOOOOOOXXXXXXXXXXGOOOOOXXXXXXXXXXXXXXGOOXXXXXXXXXXXXXXXXXGOOOOOXXXXXXXXXXXXXXGOOOOOOXXXXXXXXXXXXXGOOOOOOOOOXXXXXXXXXXGOOOOOOOOOOXXXXXXXXXGOOXXXXXXXXXXXXXXXXXGOOOOOXXXXXXXXXXXXXXGOOOXXXXXXXXXXXXXXXXGOOOOOOOOXXXXXXXXXXX,0,600,0
30408,84,0,84,11,405,0,0,412,381,31,GOOXXXXXXXXXXXXXXXXXGOOOOOXXXXXXXXXXXXXXGOOOOOOOOOXXXXXXXXXXGOOOOOXXXXXXXXXXXXXXGOOXXXXXXXXXXXXXXXXXGOOOOOXXXXXXXXXXXXXXGOOOOOOXXXXXXXXXXXXXGOOOOOOOOOXXXXXXXXXXGOOOOOOOOOOXXXXXXXXXGOOXXXXXXXXXXXXXXXXXGOOOOOXXXXXXXXXXXXXXGOOOXXXXXXXXXXXXXXXXGOOOOOOOOXXXXXXXXXXX,0,600,0
30429,84,0,84,8,408,0,0,415,382,33,GOOXXXXXXXXXXXXXXXXXGOOOOOXXXXXXXXXXXXXXGOOOOOOOOOXXXXXXXXXXGOOOOOXXXXXXXXXXXXXXGOOXXXXXXXXXXXXXXXXXGOOOOOXXXXXXXXXXXXXXGOOOOOOXXXXXXXXXXXXXGOOOOOOOOOXXXXXXXXXXGOOOOOOOOOOXXXXXXXXXGOOXXXXXXXXXXXXXXXXXGOOOOOXXXXXXXXXXXXXXGOOOXXXXXXXXXXXXXXXXGOOOOOOOOXXXXXXXXXXX,0,600,0

30450,84,0,84,9,407,0,0,414,381,33,GOOXXXXXXXXXXXXXXXXXGOOOOOXXXXXXXXXXXXXXGOOOOOOOOOXXXXXXXXXXGOOOOOXXXXXXXXXXXXXXGOOXXXXXXXXXXXXXXXXXGOOOOOXXXXXXXXXXXXXXGOOOOOOXXXXXXXXXXXXXGOOOOOOOOOXXXXXXXXXXGOOOOOOOOOOXXXXXXXXXGOOXXXXXXXXXXXXXXXXXGOOOOOXXXXXXXXXXXXXXGOOOXXXXXXXXXXXXXXXXGOOOOOOOOXXXXXXXXXXX,0,600,0
30471,84,0,84,9,407,0,0,414,382,32,GOOXXXXXXXXXXXXXXXXXGOOOOOXXXXXXXXXXXXXXGOOOOOOOOOXXXXXXXXXXGOOOOOXXXXXXXXXXXXXXGOOXXXXXXXXXXXXXXXXXGOOOOOXXXXXXXXXXXXXXGOOOOOOXXXXXXXXXXXXXGOOOOOOOOOXXXXXXXXXXGOOOOOOOOOOXXXXXXXXXGOOXXXXXXXXXXXXXXXXXGOOOOOXXXXXXXXXXXXXXGOOOXXXXXXXXXXXXXXXXGOOOOOOOOXXXXXXXXXXX,0,600,0
30492,84,0,84,11,405,0,0,412,381,31,GOOXXXXXXXXXXXXXXXXXGOOOOOXXXXXXXXXXXXXXGOOOOOOOOOXXXXXXXXXXGOOOOOXXXXXXXXXXXXXXGOOXXXXXXXXXXXXXXXXXGOOOOOXXXXXXXXXXXXXXGOOOOOOXXXXXXXXXXXXXGOOOOOOOOOXXXXXXXXXXGOOOOOOOOOOXXXXXXXXXGOOXXXXXXXXXXXXXXXXXGOOOOOXXXXXXXXXXXXXXGOOOXXXXXXXXXXXXXXXXGOOOOOOOOXXXXXXXXXXX,0,600,0
30513,84,0,84,10,406,0,0,413,382,31,GOOXXXXXXXXXXXXXXXXXGOOOOOXXXXXXXXXXXXXXGOOOOOOOOOXXXXXXXXXXGOOOOOXXXXXXXXXXXXXXGOOXXXXXXXXXXXXXXXXXGOOOOOXXXXXXXXXXXXXXGOOOOOOXXXXXXXXXXXXXGOOOOOOOOOXXXXXXXXXXGOOOOOOOOOOXXXXXXXXXGOOXXXXXXXXXXXXXXXXXGOOOOOXXXXXXXXXXXXXXGOOOXXXXXXXXXXXXXXXXGOOOOOOOOXXXXXXXXXXX,0,600,0
30534,84,0,84,10,406,0,0,413,382,31,GOOXXXXXXXXXXXXXXXXXGOOOOOXXXXXXXXXXXXXXGOOOOOOOOOXXXXXXXXXXGOOOOOXXXXXXXXXXXXXXGOOXXXXXXXXXXXXXXXXXGOOOOOXXXXXXXXXXXXXXGOOOOOOXXXXXXXXXXXXXGOOOOOOOOOXXXXXXXXXXGOOOOOOOOOOXXXXXXXXXGOOXXXXXXXXXXXXXXXXXGOOOOOXXXXXXXXXXXXXXGOOOXXXXXXXXXXXXXXXXGOOOOOOOOXXXXXXXXXXX,0,600,0

30555,84,0,84,12,404,0,0,411,381,30,GOOXXXXXXXXXXXXXXXXXGOOOOOXXXXXXXXXXXXXXGOOOOOOOOOXXXXXXXXXXGOOOOOXXXXXXXXXXXXXXGOOXXXXXXXXXXXXXXXXXGOOOOOXXXXXXXXXXXXXXGOOOOOOXXXXXXXXXXXXXGOOOOOOOOOXXXXXXXXXXGOOOOOOOOOOXXXXXXXXXGOOXXXXXXXXXXXXXXXXXGOOOOOXXXXXXXXXXXXXXGOOOXXXXXXXXXXXXXXXXGOOOOOOOOXXXXXXXXXXX,0,600,0
30576,84,0,84,12,404,0,0,411,382,29,GOOXXXXXXXXXXXXXXXXXGOOOOOXXXXXXXXXXXXXXGOOOOOOOOOXXXXXXXXXXGOOOOOXXXXXXXXXXXXXXGOOXXXXXXXXXXXXXXXXXGOOOOOXXXXXXXXXXXXXXGOOOOOOXXXXXXXXXXXXXGOOOOOOOOOXXXXXXXXXXGOOOOOOOOOOXXXXXXXXXGOOXXXXXXXXXXXXXXXXXGOOOOOXXXXXXXXXXXXXXGOOOXXXXXXXXXXXXXXXXGOOOOOOOOXXXXXXXXXXX,0,600,0
30597,84,0,84,13,403,0,0,410,382,28,GOOXXXXXXXXXXXXXXXXXGOOOOOXXXXXXXXXXXXXXGOOOOOOOOOXXXXXXXXXXGOOOOOXXXXXXXXXXXXXXGOOXXXXXXXXXXXXXXXXXGOOOOOXXXXXXXXXXXXXXGOOOOOOXXXXXXXXXXXXXGOOOOOOOOOXXXXXXXXXXGOOOOOOOOOOXXXXXXXXXGOOXXXXXXXXXXXXXXXXXGOOOOOXXXXXXXXXXXXXXGOOOXXXXXXXXXXXXXXXXGOOOOOOOOXXXXXXXXXXX,0,600,0
30618,84,0,84,12,404,0,0,411,382,29,GOOXXXXXXXXXXXXXXXXXGOOOOOXXXXXXXXXXXXXXGOOOOOOOOOXXXXXXXXXXGOOOOOXXXXXXXXXXXXXXGOOXXXXXXXXXXXXXXXXXGOOOOOXXXXXXXXXXXXXXGOOOOOOXXXXXXXXXXXXXGOOOOOOOOOXXXXXXXXXXGOOOOOOOOOOXXXXXXXXXGOOXXXXXXXXXXXXXXXXXGOOOOOXXXXXXXXXXXXXXGOOOXXXXXXXXXXXXXXXXGOOOOOOOOXXXXXXXXXXX,0,600,0
30639,84,0,84,14,402,0,0,409,383,26,GOOXXXXXXXXXXXXXXXXXGOOOOOXXXXXXXXXXXXXXGOOOOOOOOOXXXXXXXXXXGOOOOOXXXXXXXXXXXXXXGOOXXXXXXXXXXXXXXXXXGOOOOOXXXXXXXXXXXXXXGOOOOOOXXXXXXXXXXXXXGOOOOOOOOOXXXXXXXXXXGOOOOOOOOOOXXXXXXXXXGOOXXXXXXXXXXXXXXXXXGOOOOOXXXXXXXXXXXXXXGOOOXXXXXXXXXXXXXXXXGOOOOOOOOXXXXXXXXXXX,0,600,0

30660,84,0,84,14,402,0,0,409,382,27,GOOXXXXXXXXXXXXXXXXXGOOOOOXXXXXXXXXXXXXXGOOOOOOOOOXXXXXXXXXXGOOOOOXXXXXXXXXXXXXXGOOXXXXXXXXXXXXXXXXXGOOOOOXXXXXXXXXXXXXXGOOOOOOXXXXXXXXXXXXXGOOOOOOOOOXXXXXXXXXXGOOOOOOOOOOXXXXXXXXXGOOXXXXXXXXXXXXXXXXXGOOOOOXXXXXXXXXXXXXXGOOOXXXXXXXXXXXXXXXXGOOOOOOOOXXXXXXXXXXX,0,600,0
30681,84,0,84,14,402,0,0,409,382,27,GOOXXXXXXXXXXXXXXXXXGOOOOOXXXXXXXXXXXXXXGOOOOOOOOOXXXXXXXXXXGOOOOOXXXXXXXXXXXXXXGOOXXXXXXXXXXXXXXXXXGOOOOOXXXXXXXXXXXXXXGOOOOOOXXXXXXXXXXXXXGOOOOOOOOOXXXXXXXXXXGOOOOOOOOOOXXXXXXXXXGOOXXXXXXXXXXXXXXXXXGOOOOOXXXXXXXXXXXXXXGOOOXXXXXXXXXXXXXXXXGOOOOOOOOXXXXXXXXXXX,0,600,0
30702,84,0,84,12,404,0,0,410,385,25,GOOXXXXXXXXXXXXXXXXXGOOOOOXXXXXXXXXXXXXXGOOOOOOOOOXXXXXXXXXXGOOOOOXXXXXXXXXXXXXXGOOXXXXXXXXXXXXXXXXXGOOOOOXXXXXXXXXXXXXXGOOOOOOXXXXXXXXXXXXXGOOOOOOOOOXXXXXXXXXXGOOOOOOOOOOXXXXXXXXXGOOXXXXXXXXXXXXXXXXXGOOOOOXXXXXXXXXXXXXXGOOOXXXXXXXXXXXXXXXXGOOOOOOOOXXXXXXXXXXX,0,600,0
30723,84,0,84,14,402,0,0,409,383,26,GOOXXXXXXXXXXXXXXXXXGOOOOOXXXXXXXXXXXXXXGOOOOOOOOOXXXXXXXXXXGOOOOOXXXXXXXXXXXXXXGOOXXXXXXXXXXXXXXXXXGOOOOOXXXXXXXXXXXXXXGOOOOOOXXXXXXXXXXXXXGOOOOOOOOOXXXXXXXXXXGOOOOOOOOOOXXXXXXXXXGOOXXXXXXXXXXXXXXXXXGOOOOOXXXXXXXXXXXXXXGOOOXXXXXXXXXXXXXXXXGOOOOOOOOXXXXXXXXXXX,0,600,0
30744,84,0,84,12,404,0,0,411,384,27,GOOXXXXXXXXXXXXXXXXXGOOOOOXXXXXXXXXXXXXXGOOOOOOOOOXXXXXXXXXXGOOOOOXXXXXXXXXXXXXXGOOXXXXXXXXXXXXXXXXXGOOOOOXXXXXXXXXXXXXXGOOOOOOXXXXXXXXXXXXXGOOOOOOOOOXXXXXXXXXXGOOOOOOOOOOXXXXXXXXXGOOXXXXXXXXXXXXXXXXXGOOOOOXXXXXXXXXXXXXXGOOOXXXXXXXXXXXXXXXXGOOOOOOOOXXXXXXXXXXX,0,600,0

30765,84,0,84,13,403,0,0,410,385,25,GOOXXXXXXXXXXXXXXXXXGOOOOOXXXXXXXXXXXXXXGOOOOOOOOOXXXXXXXXXXGOOOOOXXXXXXXXXXXXXXGOOXXXXXXXXXXXXXXXXXGOOOOOXXXXXXXXXXXXXXGOOOOOOXXXXXXXXXXXXXGOOOOOOOOOXXXXXXXXXXGOOOOOOOOOOXXXXXXXXXGOOXXXXXXXXXXXXXXXXXGOOOOOXXXXXXXXXXXXXXGOOOXXXXXXXXXXXXXXXXGOOOOOOOOXXXXXXXXXXX,0,600,0
30786,84,0,84,12,404,0,0,411,385,26,GOOXXXXXXXXXXXXXXXXXGOOOOOXXXXXXXXXXXXXXGOOOOOOOOOXXXXXXXXXXGOOOOOXXXXXXXXXXXXXXGOOXXXXXXXXXXXXXXXXXGOOOOOXXXXXXXXXXXXXXGOOOOOOXXXXXXXXXXXXXGOOOOOOOOOXXXXXXXXXXGOOOOOOOOOOXXXXXXXXXGOOXXXXXXXXXXXXXXXXXGOOOOOXXXXXXXXXXXXXXGOOOXXXXXXXXXXXXXXXXGOOOOOOOOXXXXXXXXXXX,0,600,0
30807,84,0,84,11,405,0,0,412,385,27,GOOXXXXXXXXXXXXXXXXXGOOOOOXXXXXXXXXXXXXXGOOOOOOOOOXXXXXXXXXXGOOOOOXXXXXXXXXXXXXXGOOXXXXXXXXXXXXXXXXXGOOOOOXXXXXXXXXXXXXXGOOOOOOXXXXXXXXXXXXXGOOOOOOOOOXXXXXXXXXXGOOOOOOOOOOXXXXXXXXXGOOXXXXXXXXXXXXXXXXXGOOOOOXXXXXXXXXXXXXXGOOOXXXXXXXXXXXXXXXXGOOOOOOOOXXXXXXXXXXX,0,600,0
30828,84,0,84,11,405,0,0,412,386,26,GOOXXXXXXXXXXXXXXXXXGOOOOOXXXXXXXXXXXXXXGOOOOOOOOOXXXXXXXXXXGOOOOOXXXXXXXXXXXXXXGOOXXXXXXXXXXXXXXXXXGOOOOOXXXXXXXXXXXXXXGOOOOOOXXXXXXXXXXXXXGOOOOOOOOOXXXXXXXXXXGOOOOOOOOOOXXXXXXXXXGOOXXXXXXXXXXXXXXXXXGOOOOOXXXXXXXXXXXXXXGOOOXXXXXXXXXXXXXXXXGOOOOOOOOXXXXXXXXXXX,0,600,0
30849,84,0,84,12,404,0,0,410,385,25,GOOXXXXXXXXXXXXXXXXXGOOOOOXXXXXXXXXXXXXXGOOOOOOOOOXXXXXXXXXXGOOOOOXXXXXXXXXXXXXXGOOXXXXXXXXXXXXXXXXXGOOOOOXXXXXXXXXXXXXXGOOOOOOXXXXXXXXXXXXXGOOOOOOOOOXXXXXXXXXXGOOOOOOOOOOXXXXXXXXXGOOXXXXXXXXXXXXXXXXXGOOOOOXXXXXXXXXXXXXXGOOOXXXXXXXXXXXXXXXXGOOOOOOOOXXXXXXXXXXX,0,600,0

30870,84,0,84,10,406,0,0,413,387,26,GOOXXXXXXXXXXXXXXXXXGOOOOOXXXXXXXXXXXXXXGOOOOOOOOOXXXXXXXXXXGOOOOOXXXXXXXXXXXXXXGOOXXXXXXXXXXXXXXXXXGOOOOOXXXXXXXXXXXXXXGOOOOOOXXXXXXXXXXXXXGOOOOOOOOOXXXXXXXXXXGOOOOOOOOOOXXXXXXXXXGOOXXXXXXXXXXXXXXXXXGOOOOOXXXXXXXXXXXXXXGOOOXXXXXXXXXXXXXXXXGOOOOOOOOXXXXXXXXXXX,0,600,0
30891,84,0,84,10,406,0,0,413,387,26,GOOXXXXXXXXXXXXXXXXXGOOOOOXXXXXXXXXXXXXXGOOOOOOOOOXXXXXXXXXXGOOOOOXXXXXXXXXXXXXXGOOXXXXXXXXXXXXXXXXXGOOOOOXXXXXXXXXXXXXXGOOOOOOXXXXXXXXXXXXXGOOOOOOOOOXXXXXXXXXXGOOOOOOOOOOXXXXXXXXXGOOXXXXXXXXXXXXXXXXXGOOOOOXXXXXXXXXXXXXXGOOOXXXXXXXXXXXXXXXXGOOOOOOOOXXXXXXXXXXX,0,600,0
30912,84,0,84,14,402,0,0,409,385,24,GOOXXXXXXXXXXXXXXXXXGOOOOOXXXXXXXXXXXXXXGOOOOOOOOOXXXXXXXXXXGOOOOOXXXXXXXXXXXXXXGOOXXXXXXXXXXXXXXXXXGOOOOOXXXXXXXXXXXXXXGOOOOOOXXXXXXXXXXXXXGOOOOOOOOOXXXXXXXXXXGOOOOOOOOOOXXXXXXXXXGOOXXXXXXXXXXXXXXXXXGOOOOOXXXXXXXXXXXXXXGOOOXXXXXXXXXXXXXXXXGOOOOOOOOXXXXXXXXXXX,0,600,0
30933,84,0,84,16,400,0,0,407,385,22,GOOXXXXXXXXXXXXXXXXXGOOOOOXXXXXXXXXXXXXXGOOOOOOOOOXXXXXXXXXXGOOOOOXXXXXXXXXXXXXXGOOXXXXXXXXXXXXXXXXXGOOOOOXXXXXXXXXXXXXXGOOOOOOXXXXXXXXXXXXXGOOOOOOOOOXXXXXXXXXXGOOOOOOOOOOXXXXXXXXXGOOXXXXXXXXXXXXXXXXXGOOOOOXXXXXXXXXXXXXXGOOOXXXXXXXXXXXXXXXXGOOOOOOOOXXXXXXXXXXX,0,600,0
30954,84,0,84,13,403,0,0,410,386,24,GOOXXXXXXXXXXXXXXXXXGOOOOOXXXXXXXXXXXXXXGOOOOOOOOOXXXXXXXXXXGOOOOOXXXXXXXXXXXXXXGOOXXXXXXXXXXXXXXXXXGOOOOOXXXXXXXXXXXXXXGOOOOOOXXXXXXXXXXXXXGOOOOOOOOOXXXXXXXXXXGOOOOOOOOOOXXXXXXXXXGOOXXXXXXXXXXXXXXXXXGOOOOOXXXXXXXXXXXXXXGOOOXXXXXXXXXXXXXXXXGOOOOOOOOXXXXXXXXXXX,0,600,0

30975,84,0,84,13,403,0,0,410,387,23,GOOXXXXXXXXXXXXXXXXXGOOOOOXXXXXXXXXXXXXXGOOOOOOOOOXXXXXXXXXXGOOOOOXXXXXXXXXXXXXXGOOXXXXXXXXXXXXXXXXXGOOOOOXXXXXXXXXXXXXXGOOOOOOXXXXXXXXXXXXXGOOOOOOOOOXXXXXXXXXXGOOOOOOOOOOXXXXXXXXXGOOXXXXXXXXXXXXXXXXXGOOOOOXXXXXXXXXXXXXXGOOOXXXXXXXXXXXXXXXXGOOOOOOOOXXXXXXXXXXX,0,600,0
30996,84,0,84,12,404,0,0,411,386,25,GOOXXXXXXXXXXXXXXXXXGOOOOOXXXXXXXXXXXXXXGOOOOOOOOOXXXXXXXXXXGOOOOOXXXXXXXXXXXXXXGOOXXXXXXXXXXXXXXXXXGOOOOOXXXXXXXXXXXXXXGOOOOOOXXXXXXXXXXXXXGOOOOOOOOOXXXXXXXXXXGOOOOOOOOOOXXXXXXXXXGOOXXXXXXXXXXXXXXXXXGOOOOOXXXXXXXXXXXXXXGOOOXXXXXXXXXXXXXXXXGOOOOOOOOXXXXXXXXXXX,0,600,0
31017,85,1,84,12,403,0,0,411,385,26,GOOXXXXXXXXXXXXXXXXXGOOOOOXXXXXXXXXXXXXXGOOOOOOOOOXXXXXXXXXXGOOOOOXXXXXXXXXXXXXXGOOXXXXXXXXXXXXXXXXXGOOOOOXXXXXXXXXXXXXXGOOOOOOXXXXXXXXXXXXXGOOOOOOOOOXXXXXXXXXXGOOOOOOOOOOXXXXXXXXXGOOXXXXXXXXXXXXXXXXXGOOOOOXXXXXXXXXXXXXXGOOOAXXXXXXXXXXXXXXXGOOOOOOOOXXXXXXXXXXX,0,600,0
31038,85,0,85,13,402,0,0,410,385,25,GOOXXXXXXXXXXXXXXXXXGOOOOOXXXXXXXXXXXXXXGOOOOOOOOOXXXXXXXXXXGOOOOOXXXXXXXXXXXXXXGOOXXXXXXXXXXXXXXXXXGOOOOOXXXXXXXXXXXXXXGOOOOOOXXXXXXXXXXXXXGOOOOOOOOOXXXXXXXXXXGOOOOOOOOOOXXXXXXXXXGOOXXXXXXXXXXXXXXXXXGOOOOOXXXXXXXXXXXXXXGOOOOXXXXXXXXXXXXXXXGOOOOOOOOXXXXXXXXXXX,0,600,0
31059,85,0,85,13,402,0,0,410,386,24,GOOXXXXXXXXXXXXXXXXXGOOOOOXXXXXXXXXXXXXXGOOOOOOOOOXXXXXXXXXXGOOOOOXXXXXXXXXXXXXXGOOXXXXXXXXXXXXXXXXXGOOOOOXXXXXXXXXXXXXXGOOOOOOXXXXXXXXXXXXXGOOOOOOOOOXXXXXXXXXXGOOOOOOOOOOXXXXXXXXXGOOXXXXXXXXXXXXXXXXXGOOOOOXXXXXXXXXXXXXXGOOOOXXXXXXXXXXXXXXXGOOOOOOOOXXXXXXXXXXX,0,600,0

31080,85,0,85,11,404,0,0,411,385,26,GOOXXXXXXXXXXXXXXXXXGOOOOOXXXXXXXXXXXXXXGOOOOOOOOOXXXXXXXXXXGOOOOOXXXXXXXXXXXXXXGOOXXXXXXXXXXXXXXXXXGOOOOOXXXXXXXXXXXXXXGOOOOOOXXXXXXXXXXXXXGOOOOOOOOOXXXXXXXXXXGOOOOOOOOOOXXXXXXXXXGOOXXXXXXXXXXXXXXXXXGOOOOOXXXXXXXXXXXXXXGOOOOXXXXXXXXXXXXXXXGOOOOOOOOXXXXXXXXXXX,0,600,0
31101,85,0,85,12,403,0,0,410,387,23,GOOXXXXXXXXXXXXXXXXXGOOOOOXXXXXXXXXXXXXXGOOOOOOOOOXXXXXXXXXXGOOOOOXXXXXXXXXXXXXXGOOXXXXXXXXXXXXXXXXXGOOOOOXXXXXXXXXXXXXXGOOOOOOXXXXXXXXXXXXXGOOOOOOOOOXXXXXXXXXXGOOOOOOOOOOXXXXXXXXXGOOXXXXXXXXXXXXXXXXXGOOOOOXXXXXXXXXXXXXXGOOOOXXXXXXXXXXXXXXXGOOOOOOOOXXXXXXXXXXX,0,600,0
31122,85,0,85,12,403,0,0,410,389,21,GOOXXXXXXXXXXXXXXXXXGOOOOOXXXXXXXXXXXXXXGOOOOOOOOOXXXXXXXXXXGOOOOOXXXXXXXXXXXXXXGOOXXXXXXXXXXXXXXXXXGOOOOOXXXXXXXXXXXXXXGOOOOOOXXXXXXXXXXXXXGOOOOOOOOOXXXXXXXXXXGOOOOOOOOOOXXXXXXXXXGOOXXXXXXXXXXXXXXXXXGOOOOOXXXXXXXXXXXXXXGOOOOXXXXXXXXXXXXXXXGOOOOOOOOXXXXXXXXXXX,0,600,0
31143,85,0,85,13,402,0,0,409,387,22,GOOXXXXXXXXXXXXXXXXXGOOOOOXXXXXXXXXXXXXXGOOOOOOOOOXXXXXXXXXXGOOOOOXXXXXXXXXXXXXXGOOXXXXXXXXXXXXXXXXXGOOOOOXXXXXXXXXXXXXXGOOOOOOXXXXXXXXXXXXXGOOOOOOOOOXXXXXXXXXXGOOOOOOOOOOXXXXXXXXXGOOXXXXXXXXXXXXXXXXXGOOOOOXXXXXXXXXXXXXXGOOOOXXXXXXXXXXXXXXXGOOOOOOOOXXXXXXXXXXX,0,600,0
31164,85,0,85,16,399,0,0,406,385,21,GOOXXXXXXXXXXXXXXXXXGOOOOOXXXXXXXXXXXXXXGOOOOOOOOOXXXXXXXXXXGOOOOOXXXXXXXXXXXXXXGOOXXXXXXXXXXXXXXXXXGOOOOOXXXXXXXXXXXXXXGOOOOOOXXXXXXXXXXXXXGOOOOOOOOOXXXXXXXXXXGOOOOOOOOOOXXXXXXXXXGOOXXXXXXXXXXXXXXXXXGOOOOOXXXXXXXXXXXXXXGOOOOXXXXXXXXXXXXXXXGOOOOOOOOXXXXXXXXXXX,0,600,0

31185,85,0,85,16,399,0,0,406,386,20,GOOXXXXXXXXXXXXXXXXXGOOOOOXXXXXXXXXXXXXXGOOOOOOOOOXXXXXXXXXXGOOOOOXXXXXXXXXXXXXXGOOXXXXXXXXXXXXXXXXXGOOOOOXXXXXXXXXXXXXXGOOOOOOXXXXXXXXXXXXXGOOOOOOOOOXXXXXXXXXXGOOOOOOOOOOXXXXXXXXXGOOXXXXXXXXXXXXXXXXXGOOOOOXXXXXXXXXXXXXXGOOOOXXXXXXXXXXXXXXXGOOOOOOOOXXXXXXXXXXX,0,600,0
31206,85,0,85,13,402,0,0,409,385,24,GOOXXXXXXXXXXXXXXXXXGOOOOOXXXXXXXXXXXXXXGOOOOOOOOOXXXXXXXXXXGOOOOOXXXXXXXXXXXXXXGOOXXXXXXXXXXXXXXXXXGOOOOOXXXXXXXXXXXXXXGOOOOOOXXXXXXXXXXXXXGOOOOOOOOOXXXXXXXXXXGOOOOOOOOOOXXXXXXXXXGOOXXXXXXXXXXXXXXXXXGOOOOOXXXXXXXXXXXXXXGOOOOXXXXXXXXXXXXXXXGOOOOOOOOXXXXXXXXXXX,0,600,0
31227,85,0,85,12,403,0,0,410,386,24,GOOXXXXXXXXXXXXXXXXXGOOOOOXXXXXXXXXXXXXXGOOOOOOOOOXXXXXXXXXXGOOOOOXXXXXXXXXXXXXXGOOXXXXXXXXXXXXXXXXXGOOOOOXXXXXXXXXXXXXXGOOOOOOXXXXXXXXXXXXXGOOOOOOOOOXXXXXXXXXXGOOOOOOOOOOXXXXXXXXXGOOXXXXXXXXXXXXXXXXXGOOOOOXXXXXXXXXXXXXXGOOOOXXXXXXXXXXXXXXXGOOOOOOOOXXXXXXXXXXX,0,600,0
31248,85,0,85,12,403,0,0,410,386,24,GOOXXXXXXXXXXXXXXXXXGOOOOOXXXXXXXXXXXXXXGOOOOOOOOOXXXXXXXXXXGOOOOOXXXXXXXXXXXXXXGOOXXXXXXXXXXXXXXXXXGOOOOOXXXXXXXXXXXXXXGOOOOOOXXXXXXXXXXXXXGOOOOOOOOOXXXXXXXXXXGOOOOOOOOOOXXXXXXXXXGOOXXXXXXXXXXXXXXXXXGOOOOOXXXXXXXXXXXXXXGOOOOXXXXXXXXXXXXXXXGOOOOOOOOXXXXXXXXXXX,0,600,0
31269,85,0,85,14,401,0,0,408,385,23,GOOXXXXXXXXXXXXXXXXXGOOOOOXXXXXXXXXXXXXXGOOOOOOOOOXXXXXXXXXXGOOOOOXXXXXXXXXXXXXXGOOXXXXXXXXXXXXXXXXXGOOOOOXXXXXXXXXXXXXXGOOOOOOXXXXXXXXXXXXXGOOOOOOOOOXXXXXXXXXXGOOOOOOOOOOXXXXXXXXXGOOXXXXXXXXXXXXXXXXXGOOOOOXXXXXXXXXXXXXXGOOOOXXXXXXXXXXXXXXXGOOOOOOOOXXXXXXXXXXX,0,600,0

31290,85,0,85,13,402,0,0,409,385,24,GOOXXXXXXXXXXXXXXXXXGOOOOOXXXXXXXXXXXXXXGOOOOOOOOOXXXXXXXXXXGOOOOOXXXXXXXXXXXXXXGOOXXXXXXXXXXXXXXXXXGOOOOOXXXXXXXXXXXXXXGOOOOOOXXXXXXXXXXXXXGOOOOOOOOOXXXXXXXXXXGOOOOOOOOOOXXXXXXXXXGOOXXXXXXXXXXXXXXXXXGOOOOOXXXXXXXXXXXXXXGOOOOXXXXXXXXXXXXXXXGOOOOOOOOXXXXXXXXXXX,0,600,0
31311,85,0,85,12,403,0,0,410,386,24,GOOXXXXXXXXXXXXXXXXXGOOOOOXXXXXXXXXXXXXXGOOOOOOOOOXXXXXXXXXXGOOOOOXXXXXXXXXXXXXXGOOXXXXXXXXXXXXXXXXXGOOOOOXXXXXXXXXXXXXXGOOOOOOXXXXXXXXXXXXXGOOOOOOOOOXXXXXXXXXXGOOOOOOOOOOXXXXXXXXXGOOXXXXXXXXXXXXXXXXXGOOOOOXXXXXXXXXXXXXXGOOOOXXXXXXXXXXXXXXXGOOOOOOOOXXXXXXXXXXX,0,600,0
31332,85,0,85,13,402,0,0,409,388,21,GOOXXXXXXXXXXXXXXXXXGOOOOOXXXXXXXXXXXXXXGOOOOOOOOOXXXXXXXXXXGOOOOOXXXXXXXXXXXXXXGOOXXXXXXXXXXXXXXXXXGOOOOOXXXXXXXXXXXXXXGOOOOOOXXXXXXXXXXXXXGOOOOOOOOOXXXXXXXXXXGOOOOOOOOOOXXXXXXXXXGOOXXXXXXXXXXXXXXXXXGOOOOOXXXXXXXXXXXXXXGOOOOXXXXXXXXXXXXXXXGOOOOOOOOXXXXXXXXXXX,0,600,0
31353,85,0,85,14,401,0,0,408,387,21,GOOXXXXXXXXXXXXXXXXXGOOOOOXXXXXXXXXXXXXXGOOOOOOOOOXXXXXXXXXXGOOOOOXXXXXXXXXXXXXXGOOXXXXXXXXXXXXXXXXXGOOOOOXXXXXXXXXXXXXXGOOOOOOXXXXXXXXXXXXXGOOOOOOOOOXXXXXXXXXXGOOOOOOOOOOXXXXXXXXXGOOXXXXXXXXXXXXXXXXXGOOOOOXXXXXXXXXXXXXXGOOOOXXXXXXXXXXXXXXXGOOOOOOOOXXXXXXXXXXX,0,600,0
31374,85,0,85,14,401,0,0,408,387,21,GOOXXXXXXXXXXXXXXXXXGOOOOOXXXXXXXXXXXXXXGOOOOOOOOOXXXXXXXXXXGOOOOOXXXXXXXXXXXXXXGOOXXXXXXXXXXXXXXXXXGOOOOOXXXXXXXXXXXXXXGOOOOOOXXXXXXXXXXXXXGOOOOOOOOOXXXXXXXXXXGOOOOOOOOOOXXXXXXXXXGOOXXXXXXXXXXXXXXXXXGOOOOOXXXXXXXXXXXXXXGOOOOXXXXXXXXXXXXXXXGOOOOOOOOXXXXXXXXXXX,0,600,0

31395,85,0,85,13,402,0,0,409,386,23,GOOXXXXXXXXXXXXXXXXXGOOOOOXXXXXXXXXXXXXXGOOOOOOOOOXXXXXXXXXXGOOOOOXXXXXXXXXXXXXXGOOXXXXXXXXXXXXXXXXXGOOOOOXXXXXXXXXXXXXXGOOOOOOXXXXXXXXXXXXXGOOOOOOOOOXXXXXXXXXXGOOOOOOOOOOXXXXXXXXXGOOXXXXXXXXXXXXXXXXXGOOOOOXXXXXXXXXXXXXXGOOOOXXXXXXXXXXXXXXXGOOOOOOOOXXXXXXXXXXX,0,600,0
31416,85,0,85,13,402,0,0,408,386,22,GOOXXXXXXXXXXXXXXXXXGOOOOOXXXXXXXXXXXXXXGOOOOOOOOOXXXXXXXXXXGOOOOOXXXXXXXXXXXXXXGOOXXXXXXXXXXXXXXXXXGOOOOOXXXXXXXXXXXXXXGOOOOOOXXXXXXXXXXXXXGOOOOOOOOOXXXXXXXXXXGOOOOOOOOOOXXXXXXXXXGOOXXXXXXXXXXXXXXXXXGOOOOOXXXXXXXXXXXXXXGOOOOXXXXXXXXXXXXXXXGOOOOOOOOXXXXXXXXXXX,0,600,0
31437,85,0,85,12,403,0,0,410,386,24,GOOXXXXXXXXXXXXXXXXXGOOOOOXXXXXXXXXXXXXXGOOOOOOOOOXXXXXXXXXXGOOOOOXXXXXXXXXXXXXXGOOXXXXXXXXXXXXXXXXXGOOOOOXXXXXXXXXXXXXXGOOOOOOXXXXXXXXXXXXXGOOOOOOOOOXXXXXXXXXXGOOOOOOOOOOXXXXXXXXXGOOXXXXXXXXXXXXXXXXXGOOOOOXXXXXXXXXXXXXXGOOOOXXXXXXXXXXXXXXXGOOOOOOOOXXXXXXXXXXX,0,600,0
31458,85,0,85,11,404,0,0,411,386,25,GOOXXXXXXXXXXXXXXXXXGOOOOOXXXXXXXXXXXXXXGOOOOOOOOOXXXXXXXXXXGOOOOOXXXXXXXXXXXXXXGOOXXXXXXXXXXXXXXXXXGOOOOOXXXXXXXXXXXXXXGOOOOOOXXXXXXXXXXXXXGOOOOOOOOOXXXXXXXXXXGOOOOOOOOOOXXXXXXXXXGOOXXXXXXXXXXXXXXXXXGOOOOOXXXXXXXXXXXXXXGOOOOXXXXXXXXXXXXXXXGOOOOOOOOXXXXXXXXXXX,0,600,0
31479,85,0,85,11,404,0,0,411,386,25,GOOXXXXXXXXXXXXXXXXXGOOOOOXXXXXXXXXXXXXXGOOOOOOOOOXXXXXXXXXXGOOOOOXXXXXXXXXXXXXXGOOXXXXXXXXXXXXXXXXXGOOOOOXXXXXXXXXXXXXXGOOOOOOXXXXXXXXXXXXXGOOOOOOOOOXXXXXXXXXXGOOOOOOOOOOXXXXXXXXXGOOXXXXXXXXXXXXXXXXXGOOOOOXXXXXXXXXXXXXXGOOOOXXXXXXXXXXXXXXXGOOOOOOOOXXXXXXXXXXX,0,600,0

31500,85,0,85,12,403,0,0,410,388,22,GOOXXXXXXXXXXXXXXXXXGOOOOOXXXXXXXXXXXXXXGOOOOOOOOOXXXXXXXXXXGOOOOOXXXXXXXXXXXXXXGOOXXXXXXXXXXXXXXXXXGOOOOOXXXXXXXXXXXXXXGOOOOOOXXXXXXXXXXXXXGOOOOOOOOOXXXXXXXXXXGOOOOOOOOOOXXXXXXXXXGOOXXXXXXXXXXXXXXXXXGOOOOOXXXXXXXXXXXXXXGOOOOXXXXXXXXXXXXXXXGOOOOOOOOXXXXXXXXXXX,0,600,0
31521,85,0,85,12,403,0,0,410,387,23,GOOXXXXXXXXXXXXXXXXXGOOOOOXXXXXXXXXXXXXXGOOOOOOOOOXXXXXXXXXXGOOOOOXXXXXXXXXXXXXXGOOXXXXXXXXXXXXXXXXXGOOOOOXXXXXXXXXXXXXXGOOOOOOXXXXXXXXXXXXXGOOOOOOOOOXXXXXXXXXXGOOOOOOOOOOXXXXXXXXXGOOXXXXXXXXXXXXXXXXXGOOOOOXXXXXXXXXXXXXXGOOOOXXXXXXXXXXXXXXXGOOOOOOOOXXXXXXXXXXX,0,600,0
31542,85,0,85,13,402,0,0,409,387,22,GOOXXXXXXXXXXXXXXXXXGOOOOOXXXXXXXXXXXXXXGOOOOOOOOOXXXXXXXXXXGOOOOOXXXXXXXXXXXXXXGOOXXXXXXXXXXXXXXXXXGOOOOOXXXXXXXXXXXXXXGOOOOOOXXXXXXXXXXXXXGOOOOOOOOOXXXXXXXXXXGOOOOOOOOOOXXXXXXXXXGOOXXXXXXXXXXXXXXXXXGOOOOOXXXXXXXXXXXXXXGOOOOXXXXXXXXXXXXXXXGOOOOOOOOXXXXXXXXXXX,0,600,0
31563,85,0,85,12,403,0,0,409,389,20,GOOXXXXXXXXXXXXXXXXXGOOOOOXXXXXXXXXXXXXXGOOOOOOOOOXXXXXXXXXXGOOOOOXXXXXXXXXXXXXXGOOXXXXXXXXXXXXXXXXXGOOOOOXXXXXXXXXXXXXXGOOOOOOXXXXXXXXXXXXXGOOOOOOOOOXXXXXXXXXXGOOOOOOOOOOXXXXXXXXXGOOXXXXXXXXXXXXXXXXXGOOOOOXXXXXXXXXXXXXXGOOOOXXXXXXXXXXXXXXXGOOOOOOOOXXXXXXXXXXX,0,600,0
31584,85,0,85,14,401,0,0,408,388,20,GOOXXXXXXXXXXXXXXXXXGOOOOOXXXXXXXXXXXXXXGOOOOOOOOOXXXXXXXXXXGOOOOOXXXXXXXXXXXXXXGOOXXXXXXXXXXXXXXXXXGOOOOOXXXXXXXXXXXXXXGOOOOOOXXXXXXXXXXXXXGOOOOOOOOOXXXXXXXXXXGOOOOOOOOOOXXXXXXXXXGOOXXXXXXXXXXXXXXXXXGOOOOOXXXXXXXXXXXXXXGOOOOXXXXXXXXXXXXXXXGOOOOOOOOXXXXXXXXXXX,0,600,0

31605,85,0,85,11,404,0,0,411,388,23,GOOXXXXXXXXXXXXXXXXXGOOOOOXXXXXXXXXXXXXXGOOOOOOOOOXXXXXXXXXXGOOOOOXXXXXXXXXXXXXXGOOXXXXXXXXXXXXXXXXXGOOOOOXXXXXXXXXXXXXXGOOOOOOXXXXXXXXXXXXXGOOOOOOOOOXXXXXXXXXXGOOOOOOOOOOXXXXXXXXXGOOXXXXXXXXXXXXXXXXXGOOOOOXXXXXXXXXXXXXXGOOOOXXXXXXXXXXXXXXXGOOOOOOOOXXXXXXXXXXX,0,600,0
31626,85,0,85,13,402,0,0,409,388,21,GOOXXXXXXXXXXXXXXXXXGOOOOOXXXXXXXXXXXXXXGOOOOOOOOOXXXXXXXXXXGOOOOOXXXXXXXXXXXXXXGOOXXXXXXXXXXXXXXXXXGOOOOOXXXXXXXXXXXXXXGOOOOOOXXXXXXXXXXXXXGOOOOOOOOOXXXXXXXXXXGOOOOOOOOOOXXXXXXXXXGOOXXXXXXXXXXXXXXXXXGOOOOOXXXXXXXXXXXXXXGOOOOXXXXXXXXXXXXXXXGOOOOOOOOXXXXXXXXXXX,0,600,0
31647,85,0,85,13,402,0,0,409,387,22,GOOXXXXXXXXXXXXXXXXXGOOOOOXXXXXXXXXXXXXXGOOOOOOOOOXXXXXXXXXXGOOOOOXXXXXXXXXXXXXXGOOXXXXXXXXXXXXXXXXXGOOOOOXXXXXXXXXXXXXXGOOOOOOXXXXXXXXXXXXXGOOOOOOOOOXXXXXXXXXXGOOOOOOOOOOXXXXXXXXXGOOXXXXXXXXXXXXXXXXXGOOOOOXXXXXXXXXXXXXXGOOOOXXXXXXXXXXXXXXXGOOOOOOOOXXXXXXXXXXX,0,600,0
31668,85,0,85,12,403,0,0,410,389,21,GOOXXXXXXXXXXXXXXXXXGOOOOOXXXXXXXXXXXXXXGOOOOOOOOOXXXXXXXXXXGOOOOOXXXXXXXXXXXXXXGOOXXXXXXXXXXXXXXXXXGOOOOOXXXXXXXXXXXXXXGOOOOOOXXXXXXXXXXXXXGOOOOOOOOOXXXXXXXXXXGOOOOOOOOOOXXXXXXXXXGOOXXXXXXXXXXXXXXXXXGOOOOOXXXXXXXXXXXXXXGOOOOXXXXXXXXXXXXXXXGOOOOOOOOXXXXXXXXXXX,0,600,0
31689,85,0,85,11,404,0,0,411,388,23,GOOXXXXXXXXXXXXXXXXXGOOOOOXXXXXXXXXXXXXXGOOOOOOOOOXXXXXXXXXXGOOOOOXXXXXXXXXXXXXXGOOXXXXXXXXXXXXXXXXXGOOOOOXXXXXXXXXXXXXXGOOOOOOXXXXXXXXXXXXXGOOOOOOOOOXXXXXXXXXXGOOOOOOOOOOXXXXXXXXXGOOXXXXXXXXXXXXXXXXXGOOOOOXXXXXXXXXXXXXXGOOOOXXXXXXXXXXXXXXXGOOOOOOOOXXXXXXXXXXX,0,600,0

31710,85,0,85,8,407,0,0,414,390,24,GOOXXXXXXXXXXXXXXXXXGOOOOOXXXXXXXXXXXXXXGOOOOOOOOOXXXXXXXXXXGOOOOOXXXXXXXXXXXXXXGOOXXXXXXXXXXXXXXXXXGOOOOOXXXXXXXXXXXXXXGOOOOOOXXXXXXXXXXXXXGOOOOOOOOOXXXXXXXXXXGOOOOOOOOOOXXXXXXXXXGOOXXXXXXXXXXXXXXXXXGOOOOOXXXXXXXXXXXXXXGOOOOXXXXXXXXXXXXXXXGOOOOOOOOXXXXXXXXXXX,0,600,0
31731,85,0,85,8,407,0,0,414,388,26,GOOXXXXXXXXXXXXXXXXXGOOOOOXXXXXXXXXXXXXXGOOOOOOOOOXXXXXXXXXXGOOOOOXXXXXXXXXXXXXXGOOXXXXXXXXXXXXXXXXXGOOOOOXXXXXXXXXXXXXXGOOOOOOXXXXXXXXXXXXXGOOOOOOOOOXXXXXXXXXXGOOOOOOOOOOXXXXXXXXXGOOXXXXXXXXXXXXXXXXXGOOOOOXXXXXXXXXXXXXXGOOOOXXXXXXXXXXXXXXXGOOOOOOOOXXXXXXXXXXX,0,600,0
31752,85,0,85,9,406,0,0,413,387,26,GOOXXXXXXXXXXXXXXXXXGOOOOOXXXXXXXXXXXXXXGOOOOOOOOOXXXXXXXXXXGOOOOOXXXXXXXXXXXXXXGOOXXXXXXXXXXXXXXXXXGOOOOOXXXXXXXXXXXXXXGOOOOOOXXXXXXXXXXXXXGOOOOOOOOOXXXXXXXXXXGOOOOOOOOOOXXXXXXXXXGOOXXXXXXXXXXXXXXXXXGOOOOOXXXXXXXXXXXXXXGOOOOXXXXXXXXXXXXXXXGOOOOOOOOXXXXXXXXXXX,0,600,0
31773,85,0,85,7,408,0,0,415,388,27,GOOXXXXXXXXXXXXXXXXXGOOOOOXXXXXXXXXXXXXXGOOOOOOOOOXXXXXXXXXXGOOOOOXXXXXXXXXXXXXXGOOXXXXXXXXXXXXXXXXXGOOOOOXXXXXXXXXXXXXXGOOOOOOXXXXXXXXXXXXXGOOOOOOOOOXXXXXXXXXXGOOOOOOOOOOXXXXXXXXXGOOXXXXXXXXXXXXXXXXXGOOOOOXXXXXXXXXXXXXXGOOOOXXXXXXXXXXXXXXXGOOOOOOOOXXXXXXXXXXX,0,600,0
31794,85,0,85,7,408,0,0,415,388,27,GOOXXXXXXXXXXXXXXXXXGOOOOOXXXXXXXXXXXXXXGOOOOOOOOOXXXXXXXXXXGOOOOOXXXXXXXXXXXXXXGOOXXXXXXXXXXXXXXXXXGOOOOOXXXXXXXXXXXXXXGOOOOOOXXXXXXXXXXXXXGOOOOOOOOOXXXXXXXXXXGOOOOOOOOOOXXXXXXXXXGOOXXXXXXXXXXXXXXXXXGOOOOOXXXXXXXXXXXXXXGOOOOXXXXXXXXXXXXXXXGOOOOOOOOXXXXXXXXXXX,0,600,0

31815,85,0,85,7,408,0,0,415,389,26,GOOXXXXXXXXXXXXXXXXXGOOOOOXXXXXXXXXXXXXXGOOOOOOOOOXXXXXXXXXXGOOOOOXXXXXXXXXXXXXXGOOXXXXXXXXXXXXXXXXXGOOOOOXXXXXXXXXXXXXXGOOOOOOXXXXXXXXXXXXXGOOOOOOOOOXXXXXXXXXXGOOOOOOOOOOXXXXXXXXXGOOXXXXXXXXXXXXXXXXXGOOOOOXXXXXXXXXXXXXXGOOOOXXXXXXXXXXXXXXXGOOOOOOOOXXXXXXXXXXX,0,600,0
31836,85,0,85,11,404,0,0,411,388,23,GOOXXXXXXXXXXXXXXXXXGOOOOOXXXXXXXXXXXXXXGOOOOOOOOOXXXXXXXXXXGOOOOOXXXXXXXXXXXXXXGOOXXXXXXXXXXXXXXXXXGOOOOOXXXXXXXXXXXXXXGOOOOOOXXXXXXXXXXXXXGOOOOOOOOOXXXXXXXXXXGOOOOOOOOOOXXXXXXXXXGOOXXXXXXXXXXXXXXXXXGOOOOOXXXXXXXXXXXXXXGOOOOXXXXXXXXXXXXXXXGOOOOOOOOXXXXXXXXXXX,0,600,0
31857,85,0,85,10,405,0,0,412,388,24,GOOXXXXXXXXXXXXXXXXXGOOOOOXXXXXXXXXXXXXXGOOOOOOOOOXXXXXXXXXXGOOOOOXXXXXXXXXXXXXXGOOXXXXXXXXXXXXXXXXXGOOOOOXXXXXXXXXXXXXXGOOOOOOXXXXXXXXXXXXXGOOOOOOOOOXXXXXXXXXXGOOOOOOOOOOXXXXXXXXXGOOXXXXXXXXXXXXXXXXXGOOOOOXXXXXXXXXXXXXXGOOOOXXXXXXXXXXXXXXXGOOOOOOOOXXXXXXXXXXX,0,600,0
31878,85,0,85,11,404,0,0,411,387,24,GOOXXXXXXXXXXXXXXXXXGOOOOOXXXXXXXXXXXXXXGOOOOOOOOOXXXXXXXXXXGOOOOOXXXXXXXXXXXXXXGOOXXXXXXXXXXXXXXXXXGOOOOOXXXXXXXXXXXXXXGOOOOOOXXXXXXXXXXXXXGOOOOOOOOOXXXXXXXXXXGOOOOOOOOOOXXXXXXXXXGOOXXXXXXXXXXXXXXXXXGOOOOOXXXXXXXXXXXXXXGOOOOXXXXXXXXXXXXXXXGOOOOOOOOXXXXXXXXXXX,0,600,0
31899,85,0,85,12,403,0,0,410,387,23,GOOXXXXXXXXXXXXXXXXXGOOOOOXXXXXXXXXXXXXXGOOOOOOOOOXXXXXXXXXXGOOOOOXXXXXXXXXXXXXXGOOXXXXXXXXXXXXXXXXXGOOOOOXXXXXXXXXXXXXXGOOOOOOXXXXXXXXXXXXXGOOOOOOOOOXXXXXXXXXXGOOOOOOOOOOXXXXXXXXXGOOXXXXXXXXXXXXXXXXXGOOOOOXXXXXXXXXXXXXXGOOOOXXXXXXXXXXXXXXXGOOOOOOOOXXXXXXXXXXX,0,600,0

31920,85,0,85,12,403,0,0,410,387,23,GOOXXXXXXXXXXXXXXXXXGOOOOOXXXXXXXXXXXXXXGOOOOOOOOOXXXXXXXXXXGOOOOOXXXXXXXXXXXXXXGOOXXXXXXXXXXXXXXXXXGOOOOOXXXXXXXXXXXXXXGOOOOOOXXXXXXXXXXXXXGOOOOOOOOOXXXXXXXXXXGOOOOOOOOOOXXXXXXXXXGOOXXXXXXXXXXXXXXXXXGOOOOOXXXXXXXXXXXXXXGOOOOXXXXXXXXXXXXXXXGOOOOOOOOXXXXXXXXXXX,0,600,0
31941,85,0,85,11,404,0,0,411,388,23,GOOXXXXXXXXXXXXXXXXXGOOOOOXXXXXXXXXXXXXXGOOOOOOOOOXXXXXXXXXXGOOOOOXXXXXXXXXXXXXXGOOXXXXXXXXXXXXXXXXXGOOOOOXXXXXXXXXXXXXXGOOOOOOXXXXXXXXXXXXXGOOOOOOOOOXXXXXXXXXXGOOOOOOOOOOXXXXXXXXXGOOXXXXXXXXXXXXXXXXXGOOOOOXXXXXXXXXXXXXXGOOOOXXXXXXXXXXXXXXXGOOOOOOOOXXXXXXXXXXX,0,600,0
31962,85,0,85,12,403,0,0,411,387,24,GOOXXXXXXXXXXXXXXXXXGOOOOOXXXXXXXXXXXXXXGOOOOOOOOOXXXXXXXXXXGOOOOOXXXXXXXXXXXXXXGOOXXXXXXXXXXXXXXXXXGOOOOOXXXXXXXXXXXXXXGOOOOOOXXXXXXXXXXXXXGOOOOOOOOOXXXXXXXXXXGOOOOOOOOOOXXXXXXXXXGOOXXXXXXXXXXXXXXXXXGOOOOOXXXXXXXXXXXXXXGOOOOXXXXXXXXXXXXXXXGOOOOOOOOXXXXXXXXXXX,0,600,0
31983,85,0,85,14,401,0,0,409,387,22,GOOXXXXXXXXXXXXXXXXXGOOOOOXXXXXXXXXXXXXXGOOOOOOOOOXXXXXXXXXXGOOOOOXXXXXXXXXXXXXXGOOXXXXXXXXXXXXXXXXXGOOOOOXXXXXXXXXXXXXXGOOOOOOXXXXXXXXXXXXXGOOOOOOOOOXXXXXXXXXXGOOOOOOOOOOXXXXXXXXXGOOXXXXXXXXXXXXXXXXXGOOOOOXXXXXXXXXXXXXXGOOOOXXXXXXXXXXXXXXXGOOOOOOOOXXXXXXXXXXX,0,600,0
32004,85,0,85,14,401,0,0,408,387,21,GOOXXXXXXXXXXXXXXXXXGOOOOOXXXXXXXXXXXXXXGOOOOOOOOOXXXXXXXXXXGOOOOOXXXXXXXXXXXXXXGOOXXXXXXXXXXXXXXXXXGOOOOOXXXXXXXXXXXXXXGOOOOOOXXXXXXXXXXXXXGOOOOOOOOOXXXXXXXXXXGOOOOOOOOOOXXXXXXXXXGOOXXXXXXXXXXXXXXXXXGOOOOOXXXXXXXXXXXXXXGOOOOXXXXXXXXXXXXXXXGOOOOOOOOXXXXXXXXXXX,0,600,0

32025,85,0,85,12,403,0,0,411,388,23,GOOXXXXXXXXXXXXXXXXXGOOOOOXXXXXXXXXXXXXXGOOOOOOOOOXXXXXXXXXXGOOOOOXXXXXXXXXXXXXXGOOXXXXXXXXXXXXXXXXXGOOOOOXXXXXXXXXXXXXXGOOOOOOXXXXXXXXXXXXXGOOOOOOOOOXXXXXXXXXXGOOOOOOOOOOXXXXXXXXXGOOXXXXXXXXXXXXXXXXXGOOOOOXXXXXXXXXXXXXXGOOOOXXXXXXXXXXXXXXXGOOOOOOOOXXXXXXXXXXX,0,600,0
32046,85,0,85,12,403,0,0,411,388,23,GOOXXXXXXXXXXXXXXXXXGOOOOOXXXXXXXXXXXXXXGOOOOOOOOOXXXXXXXXXXGOOOOOXXXXXXXXXXXXXXGOOXXXXXXXXXXXXXXXXXGOOOOOXXXXXXXXXXXXXXGOOOOOOXXXXXXXXXXXXXGOOOOOOOOOXXXXXXXXXXGOOOOOOOOOOXXXXXXXXXGOOXXXXXXXXXXXXXXXXXGOOOOOXXXXXXXXXXXXXXGOOOOXXXXXXXXXXXXXXXGOOOOOOOOXXXXXXXXXXX,0,600,0
32067,85,0,85,13,402,0,0,410,389,21,GOOXXXXXXXXXXXXXXXXXGOOOOOXXXXXXXXXXXXXXGOOOOOOOOOXXXXXXXXXXGOOOOOXXXXXXXXXXXXXXGOOXXXXXXXXXXXXXXXXXGOOOOOXXXXXXXXXXXXXXGOOOOOOXXXXXXXXXXXXXGOOOOOOOOOXXXXXXXXXXGOOOOOOOOOOXXXXXXXXXGOOXXXXXXXXXXXXXXXXXGOOOOOXXXXXXXXXXXXXXGOOOOXXXXXXXXXXXXXXXGOOOOOOOOXXXXXXXXXXX,0,600,0
32088,85,0,85,14,401,0,0,410,389,21,GOOXXXXXXXXXXXXXXXXXGOOOOOXXXXXXXXXXXXXXGOOOOOOOOOXXXXXXXXXXGOOOOOXXXXXXXXXXXXXXGOOXXXXXXXXXXXXXXXXXGOOOOOXXXXXXXXXXXXXXGOOOOOOXXXXXXXXXXXXXGOOOOOOOOOXXXXXXXXXXGOOOOOOOOOOXXXXXXXXXGOOXXXXXXXXXXXXXXXXXGOOOOOXXXXXXXXXXXXXXGOOOOXXXXXXXXXXXXXXXGOOOOOOOOXXXXXXXXXXX,0,600,0
32109,85,0,85,15,400,0,0,409,388,21,GOOXXXXXXXXXXXXXXXXXGOOOOOXXXXXXXXXXXXXXGOOOOOOOOOXXXXXXXXXXGOOOOOXXXXXXXXXXXXXXGOOXXXXXXXXXXXXXXXXXGOOOOOXXXXXXXXXXXXXXGOOOOOOXXXXXXXXXXXXXGOOOOOOOOOXXXXXXXXXXGOOOOOOOOOOXXXXXXXXXGOOXXXXXXXXXXXXXXXXXGOOOOOXXXXXXXXXXXXXXGOOOOXXXXXXXXXXXXXXXGOOOOOOOOXXXXXXXXXXX,0,600,0

32130,85,0,85,17,398,0,0,407,388,19,GOOXXXXXXXXXXXXXXXXXGOOOOOXXXXXXXXXXXXXXGOOOOOOOOOXXXXXXXXXXGOOOOOXXXXXXXXXXXXXXGOOXXXXXXXXXXXXXXXXXGOOOOOXXXXXXXXXXXXXXGOOOOOOXXXXXXXXXXXXXGOOOOOOOOOXXXXXXXXXXGOOOOOOOOOOXXXXXXXXXGOOXXXXXXXXXXXXXXXXXGOOOOOXXXXXXXXXXXXXXGOOOOXXXXXXXXXXXXXXXGOOOOOOOOXXXXXXXXXXX,0,600,0
32151,85,0,85,16,399,0,0,408,387,21,GOOXXXXXXXXXXXXXXXXXGOOOOOXXXXXXXXXXXXXXGOOOOOOOOOXXXXXXXXXXGOOOOOXXXXXXXXXXXXXXGOOXXXXXXXXXXXXXXXXXGOOOOOXXXXXXXXXXXXXXGOOOOOOXXXXXXXXXXXXXGOOOOOOOOOXXXXXXXXXXGOOOOOOOOOOXXXXXXXXXGOOXXXXXXXXXXXXXXXXXGOOOOOXXXXXXXXXXXXXXGOOOOXXXXXXXXXXXXXXXGOOOOOOOOXXXXXXXXXXX,0,600,0
32172,85,0,85,14,401,0,0,410,387,23,GOOXXXXXXXXXXXXXXXXXGOOOOOXXXXXXXXXXXXXXGOOOOOOOOOXXXXXXXXXXGOOOOOXXXXXXXXXXXXXXGOOXXXXXXXXXXXXXXXXXGOOOOOXXXXXXXXXXXXXXGOOOOOOXXXXXXXXXXXXXGOOOOOOOOOXXXXXXXXXXGOOOOOOOOOOXXXXXXXXXGOOXXXXXXXXXXXXXXXXXGOOOOOXXXXXXXXXXXXXXGOOOOXXXXXXXXXXXXXXXGOOOOOOOOXXXXXXXXXXX,0,600,0
32193,85,0,85,13,402,0,0,411,388,23,GOOXXXXXXXXXXXXXXXXXGOOOOOXXXXXXXXXXXXXXGOOOOOOOOOXXXXXXXXXXGOOOOOXXXXXXXXXXXXXXGOOXXXXXXXXXXXXXXXXXGOOOOOXXXXXXXXXXXXXXGOOOOOOXXXXXXXXXXXXXGOOOOOOOOOXXXXXXXXXXGOOOOOOOOOOXXXXXXXXXGOOXXXXXXXXXXXXXXXXXGOOOOOXXXXXXXXXXXXXXGOOOOXXXXXXXXXXXXXXXGOOOOOOOOXXXXXXXXXXX,0,600,0
32214,85,0,85,11,404,0,0,413,389,24,GOOXXXXXXXXXXXXXXXXXGOOOOOXXXXXXXXXXXXXXGOOOOOOOOOXXXXXXXXXXGOOOOOXXXXXXXXXXXXXXGOOXXXXXXXXXXXXXXXXXGOOOOOXXXXXXXXXXXXXXGOOOOOOXXXXXXXXXXXXXGOOOOOOOOOXXXXXXXXXXGOOOOOOOOOOXXXXXXXXXGOOXXXXXXXXXXXXXXXXXGOOOOOXXXXXXXXXXXXXXGOOOOXXXXXXXXXXXXXXXGOOOOOOOOXXXXXXXXXXX,0,600,0

32235,85,0,85,9,406,0,0,414,388,26,GOOXXXXXXXXXXXXXXXXXGOOOOOXXXXXXXXXXXXXXGOOOOOOOOOXXXXXXXXXXGOOOOOXXXXXXXXXXXXXXGOOXXXXXXXXXXXXXXXXXGOOOOOXXXXXXXXXXXXXXGOOOOOOXXXXXXXXXXXXXGOOOOOOOOOXXXXXXXXXXGOOOOOOOOOOXXXXXXXXXGOOXXXXXXXXXXXXXXXXXGOOOOOXXXXXXXXXXXXXXGOOOOXXXXXXXXXXXXXXXGOOOOOOOOXXXXXXXXXXX,0,600,0
32256,85,0,85,8,407,0,0,415,388,27,GOOXXXXXXXXXXXXXXXXXGOOOOOXXXXXXXXXXXXXXGOOOOOOOOOXXXXXXXXXXGOOOOOXXXXXXXXXXXXXXGOOXXXXXXXXXXXXXXXXXGOOOOOXXXXXXXXXXXXXXGOOOOOOXXXXXXXXXXXXXGOOOOOOOOOXXXXXXXXXXGOOOOOOOOOOXXXXXXXXXGOOXXXXXXXXXXXXXXXXXGOOOOOXXXXXXXXXXXXXXGOOOOXXXXXXXXXXXXXXXGOOOOOOOOXXXXXXXXXXX,0,600,0
32277,85,0,85,8,407,0,0,415,388,27,GOOXXXXXXXXXXXXXXXXXGOOOOOXXXXXXXXXXXXXXGOOOOOOOOOXXXXXXXXXXGOOOOOXXXXXXXXXXXXXXGOOXXXXXXXXXXXXXXXXXGOOOOOXXXXXXXXXXXXXXGOOOOOOXXXXXXXXXXXXXGOOOOOOOOOXXXXXXXXXXGOOOOOOOOOOXXXXXXXXXGOOXXXXXXXXXXXXXXXXXGOOOOOXXXXXXXXXXXXXXGOOOOXXXXXXXXXXXXXXXGOOOOOOOOXXXXXXXXXXX,0,600,0
32298,85,0,85,8,407,0,0,414,387,27,GOOXXXXXXXXXXXXXXXXXGOOOOOXXXXXXXXXXXXXXGOOOOOOOOOXXXXXXXXXXGOOOOOXXXXXXXXXXXXXXGOOXXXXXXXXXXXXXXXXXGOOOOOXXXXXXXXXXXXXXGOOOOOOXXXXXXXXXXXXXGOOOOOOOOOXXXXXXXXXXGOOOOOOOOOOXXXXXXXXXGOOXXXXXXXXXXXXXXXXXGOOOOOXXXXXXXXXXXXXXGOOOOXXXXXXXXXXXXXXXGOOOOOOOOXXXXXXXXXXX,0,600,0
32319,85,0,85,9,406,0,0,414,388,26,GOOXXXXXXXXXXXXXXXXXGOOOOOXXXXXXXXXXXXXXGOOOOOOOOOXXXXXXXXXXGOOOOOXXXXXXXXXXXXXXGOOXXXXXXXXXXXXXXXXXGOOOOOXXXXXXXXXXXXXXGOOOOOOXXXXXXXXXXXXXGOOOOOOOOOXXXXXXXXXXGOOOOOOOOOOXXXXXXXXXGOOXXXXXXXXXXXXXXXXXGOOOOOXXXXXXXXXXXXXXGOOOOXXXXXXXXXXXXXXXGOOOOOOOOXXXXXXXXXXX,0,600,0

32340,85,0,85,8,407,0,0,414,389,25,GOOXXXXXXXXXXXXXXXXXGOOOOOXXXXXXXXXXXXXXGOOOOOOOOOXXXXXXXXXXGOOOOOXXXXXXXXXXXXXXGOOXXXXXXXXXXXXXXXXXGOOOOOXXXXXXXXXXXXXXGOOOOOOXXXXXXXXXXXXXGOOOOOOOOOXXXXXXXXXXGOOOOOOOOOOXXXXXXXXXGOOXXXXXXXXXXXXXXXXXGOOOOOXXXXXXXXXXXXXXGOOOOXXXXXXXXXXXXXXXGOOOOOOOOXXXXXXXXXXX,0,600,0
32361,85,0,85,9,406,0,0,413,387,26,GOOXXXXXXXXXXXXXXXXXGOOOOOXXXXXXXXXXXXXXGOOOOOOOOOXXXXXXXXXXGOOOOOXXXXXXXXXXXXXXGOOXXXXXXXXXXXXXXXXXGOOOOOXXXXXXXXXXXXXXGOOOOOOXXXXXXXXXXXXXGOOOOOOOOOXXXXXXXXXXGOOOOOOOOOOXXXXXXXXXGOOXXXXXXXXXXXXXXXXXGOOOOOXXXXXXXXXXXXXXGOOOOXXXXXXXXXXXXXXXGOOOOOOOOXXXXXXXXXXX,0,600,0
32382,85,0,85,10,405,0,0,412,388,24,GOOXXXXXXXXXXXXXXXXXGOOOOOXXXXXXXXXXXXXXGOOOOOOOOOXXXXXXXXXXGOOOOOXXXXXXXXXXXXXXGOOXXXXXXXXXXXXXXXXXGOOOOOXXXXXXXXXXXXXXGOOOOOOXXXXXXXXXXXXXGOOOOOOOOOXXXXXXXXXXGOOOOOOOOOOXXXXXXXXXGOOXXXXXXXXXXXXXXXXXGOOOOOXXXXXXXXXXXXXXGOOOOXXXXXXXXXXXXXXXGOOOOOOOOXXXXXXXXXXX,0,600,0
32403,85,0,85,10,405,0,0,412,387,25,GOOXXXXXXXXXXXXXXXXXGOOOOOXXXXXXXXXXXXXXGOOOOOOOOOXXXXXXXXXXGOOOOOXXXXXXXXXXXXXXGOOXXXXXXXXXXXXXXXXXGOOOOOXXXXXXXXXXXXXXGOOOOOOXXXXXXXXXXXXXGOOOOOOOOOXXXXXXXXXXGOOOOOOOOOOXXXXXXXXXGOOXXXXXXXXXXXXXXXXXGOOOOOXXXXXXXXXXXXXXGOOOOXXXXXXXXXXXXXXXGOOOOOOOOXXXXXXXXXXX,0,600,0
32424,85,0,85,9,406,0,0,413,387,26,GOOXXXXXXXXXXXXXXXXXGOOOOOXXXXXXXXXXXXXXGOOOOOOOOOXXXXXXXXXXGOOOOOXXXXXXXXXXXXXXGOOXXXXXXXXXXXXXXXXXGOOOOOXXXXXXXXXXXXXXGOOOOOOXXXXXXXXXXXXXGOOOOOOOOOXXXXXXXXXXGOOOOOOOOOOXXXXXXXXXGOOXXXXXXXXXXXXXXXXXGOOOOOXXXXXXXXXXXXXXGOOOOXXXXXXXXXXXXXXXGOOOOOOOOXXXXXXXXXXX,0,600,0

32445,85,0,85,12,403,0,0,410,388,22,GOOXXXXXXXXXXXXXXXXXGOOOOOXXXXXXXXXXXXXXGOOOOOOOOOXXXXXXXXXXGOOOOOXXXXXXXXXXXXXXGOOXXXXXXXXXXXXXXXXXGOOOOOXXXXXXXXXXXXXXGOOOOOOXXXXXXXXXXXXXGOOOOOOOOOXXXXXXXXXXGOOOOOOOOOOXXXXXXXXXGOOXXXXXXXXXXXXXXXXXGOOOOOXXXXXXXXXXXXXXGOOOOXXXXXXXXXXXXXXXGOOOOOOOOXXXXXXXXXXX,0,600,0
32466,85,0,85,9,406,0,0,413,389,24,GOOXXXXXXXXXXXXXXXXXGOOOOOXXXXXXXXXXXXXXGOOOOOOOOOXXXXXXXXXXGOOOOOXXXXXXXXXXXXXXGOOXXXXXXXXXXXXXXXXXGOOOOOXXXXXXXXXXXXXXGOOOOOOXXXXXXXXXXXXXGOOOOOOOOOXXXXXXXXXXGOOOOOOOOOOXXXXXXXXXGOOXXXXXXXXXXXXXXXXXGOOOOOXXXXXXXXXXXXXXGOOOOXXXXXXXXXXXXXXXGOOOOOOOOXXXXXXXXXXX,0,600,0
32487,85,0,85,10,405,0,0,412,388,24,GOOXXXXXXXXXXXXXXXXXGOOOOOXXXXXXXXXXXXXXGOOOOOOOOOXXXXXXXXXXGOOOOOXXXXXXXXXXXXXXGOOXXXXXXXXXXXXXXXXXGOOOOOXXXXXXXXXXXXXXGOOOOOOXXXXXXXXXXXXXGOOOOOOOOOXXXXXXXXXXGOOOOOOOOOOXXXXXXXXXGOOXXXXXXXXXXXXXXXXXGOOOOOXXXXXXXXXXXXXXGOOOOXXXXXXXXXXXXXXXGOOOOOOOOXXXXXXXXXXX,0,600,0
32508,85,0,85,10,405,0,0,412,390,22,GOOXXXXXXXXXXXXXXXXXGOOOOOXXXXXXXXXXXXXXGOOOOOOOOOXXXXXXXXXXGOOOOOXXXXXXXXXXXXXXGOOXXXXXXXXXXXXXXXXXGOOOOOXXXXXXXXXXXXXXGOOOOOOXXXXXXXXXXXXXGOOOOOOOOOXXXXXXXXXXGOOOOOOOOOOXXXXXXXXXGOOXXXXXXXXXXXXXXXXXGOOOOOXXXXXXXXXXXXXXGOOOOXXXXXXXXXXXXXXXGOOOOOOOOXXXXXXXXXXX,0,600,0
32529,85,0,85,13,402,0,0,409,390,19,GOOXXXXXXXXXXXXXXXXXGOOOOOXXXXXXXXXXXXXXGOOOOOOOOOXXXXXXXXXXGOOOOOXXXXXXXXXXXXXXGOOXXXXXXXXXXXXXXXXXGOOOOOXXXXXXXXXXXXXXGOOOOOOXXXXXXXXXXXXXGOOOOOOOOOXXXXXXXXXXGOOOOOOOOOOXXXXXXXXXGOOXXXXXXXXXXXXXXXXXGOOOOOXXXXXXXXXXXXXXGOOOOXXXXXXXXXXXXXXXGOOOOOOOOXXXXXXXXXXX,0,600,0

32550,85,0,85,15,400,0,0,407,387,20,GOOXXXXXXXXXXXXXXXXXGOOOOOXXXXXXXXXXXXXXGOOOOOOOOOXXXXXXXXXXGOOOOOXXXXXXXXXXXXXXGOOXXXXXXXXXXXXXXXXXGOOOOOXXXXXXXXXXXXXXGOOOOOOXXXXXXXXXXXXXGOOOOOOOOOXXXXXXXXXXGOOOOOOOOOOXXXXXXXXXGOOXXXXXXXXXXXXXXXXXGOOOOOXXXXXXXXXXXXXXGOOOOXXXXXXXXXXXXXXXGOOOOOOOOXXXXXXXXXXX,0,600,0
32571,85,0,85,15,400,0,0,407,388,19,GOOXXXXXXXXXXXXXXXXXGOOOOOXXXXXXXXXXXXXXGOOOOOOOOOXXXXXXXXXXGOOOOOXXXXXXXXXXXXXXGOOXXXXXXXXXXXXXXXXXGOOOOOXXXXXXXXXXXXXXGOOOOOOXXXXXXXXXXXXXGOOOOOOOOOXXXXXXXXXXGOOOOOOOOOOXXXXXXXXXGOOXXXXXXXXXXXXXXXXXGOOOOOXXXXXXXXXXXXXXGOOOOXXXXXXXXXXXXXXXGOOOOOOOOXXXXXXXXXXX,0,600,0
32592,85,0,85,15,400,0,0,407,388,19,GOOXXXXXXXXXXXXXXXXXGOOOOOXXXXXXXXXXXXXXGOOOOOOOOOXXXXXXXXXXGOOOOOXXXXXXXXXXXXXXGOOXXXXXXXXXXXXXXXXXGOOOOOXXXXXXXXXXXXXXGOOOOOOXXXXXXXXXXXXXGOOOOOOOOOXXXXXXXXXXGOOOOOOOOOOXXXXXXXXXGOOXXXXXXXXXXXXXXXXXGOOOOOXXXXXXXXXXXXXXGOOOOXXXXXXXXXXXXXXXGOOOOOOOOXXXXXXXXXXX,0,600,0
32613,85,0,85,15,400,0,0,407,386,21,GOOXXXXXXXXXXXXXXXXXGOOOOOXXXXXXXXXXXXXXGOOOOOOOOOXXXXXXXXXXGOOOOOXXXXXXXXXXXXXXGOOXXXXXXXXXXXXXXXXXGOOOOOXXXXXXXXXXXXXXGOOOOOOXXXXXXXXXXXXXGOOOOOOOOOXXXXXXXXXXGOOOOOOOOOOXXXXXXXXXGOOXXXXXXXXXXXXXXXXXGOOOOOXXXXXXXXXXXXXXGOOOOXXXXXXXXXXXXXXXGOOOOOOOOXXXXXXXXXXX,0,600,0
32634,85,0,85,13,402,0,0,409,386,23,GOOXXXXXXXXXXXXXXXXXGOOOOOXXXXXXXXXXXXXXGOOOOOOOOOXXXXXXXXXXGOOOOOXXXXXXXXXXXXXXGOOXXXXXXXXXXXXXXXXXGOOOOOXXXXXXXXXXXXXXGOOOOOOXXXXXXXXXXXXXGOOOOOOOOOXXXXXXXXXXGOOOOOOOOOOXXXXXXXXXGOOXXXXXXXXXXXXXXXXXGOOOOOXXXXXXXXXXXXXXGOOOOXXXXXXXXXXXXXXXGOOOOOOOOXXXXXXXXXXX,0,600,0

32655,85,0,85,13,402,0,0,409,386,23,GOOXXXXXXXXXXXXXXXXXGOOOOOXXXXXXXXXXXXXXGOOOOOOOOOXXXXXXXXXXGOOOOOXXXXXXXXXXXXXXGOOXXXXXXXXXXXXXXXXXGOOOOOXXXXXXXXXXXXXXGOOOOOOXXXXXXXXXXXXXGOOOOOOOOOXXXXXXXXXXGOOOOOOOOOOXXXXXXXXXGOOXXXXXXXXXXXXXXXXXGOOOOOXXXXXXXXXXXXXXGOOOOXXXXXXXXXXXXXXXGOOOOOOOOXXXXXXXXXXX,0,600,0
32676,85,0,85,13,402,0,0,409,386,23,GOOXXXXXXXXXXXXXXXXXGOOOOOXXXXXXXXXXXXXXGOOOOOOOOOXXXXXXXXXXGOOOOOXXXXXXXXXXXXXXGOOXXXXXXXXXXXXXXXXXGOOOOOXXXXXXXXXXXXXXGOOOOOOXXXXXXXXXXXXXGOOOOOOOOOXXXXXXXXXXGOOOOOOOOOOXXXXXXXXXGOOXXXXXXXXXXXXXXXXXGOOOOOXXXXXXXXXXXXXXGOOOOXXXXXXXXXXXXXXXGOOOOOOOOXXXXXXXXXXX,0,600,0
32697,85,0,85,14,401,0,0,408,385,23,GOOXXXXXXXXXXXXXXXXXGOOOOOXXXXXXXXXXXXXXGOOOOOOOOOXXXXXXXXXXGOOOOOXXXXXXXXXXXXXXGOOXXXXXXXXXXXXXXXXXGOOOOOXXXXXXXXXXXXXXGOOOOOOXXXXXXXXXXXXXGOOOOOOOOOXXXXXXXXXXGOOOOOOOOOOXXXXXXXXXGOOXXXXXXXXXXXXXXXXXGOOOOOXXXXXXXXXXXXXXGOOOOXXXXXXXXXXXXXXXGOOOOOOOOXXXXXXXXXXX,0,600,0
32718,85,0,85,14,401,0,0,408,386,22,GOOXXXXXXXXXXXXXXXXXGOOOOOXXXXXXXXXXXXXXGOOOOOOOOOXXXXXXXXXXGOOOOOXXXXXXXXXXXXXXGOOXXXXXXXXXXXXXXXXXGOOOOOXXXXXXXXXXXXXXGOOOOOOXXXXXXXXXXXXXGOOOOOOOOOXXXXXXXXXXGOOOOOOOOOOXXXXXXXXXGOOXXXXXXXXXXXXXXXXXGOOOOOXXXXXXXXXXXXXXGOOOOXXXXXXXXXXXXXXXGOOOOOOOOXXXXXXXXXXX,0,600,0
32739,85,0,85,15,400,0,0,407,385,22,GOOXXXXXXXXXXXXXXXXXGOOOOOXXXXXXXXXXXXXXGOOOOOOOOOXXXXXXXXXXGOOOOOXXXXXXXXXXXXXXGOOXXXXXXXXXXXXXXXXXGOOOOOXXXXXXXXXXXXXXGOOOOOOXXXXXXXXXXXXXGOOOOOOOOOXXXXXXXXXXGOOOOOOOOOOXXXXXXXXXGOOXXXXXXXXXXXXXXXXXGOOOOOXXXXXXXXXXXXXXGOOOOXXXXXXXXXXXXXXXGOOOOOOOOXXXXXXXXXXX,0,600,0

32760,85,0,85,15,400,0,0,407,386,21,GOOXXXXXXXXXXXXXXXXXGOOOOOXXXXXXXXXXXXXXGOOOOOOOOOXXXXXXXXXXGOOOOOXXXXXXXXXXXXXXGOOXXXXXXXXXXXXXXXXXGOOOOOXXXXXXXXXXXXXXGOOOOOOXXXXXXXXXXXXXGOOOOOOOOOXXXXXXXXXXGOOOOOOOOOOXXXXXXXXXGOOXXXXXXXXXXXXXXXXXGOOOOOXXXXXXXXXXXXXXGOOOOXXXXXXXXXXXXXXXGOOOOOOOOXXXXXXXXXXX,0,600,0
32781,85,0,85,15,400,0,0,407,386,21,GOOXXXXXXXXXXXXXXXXXGOOOOOXXXXXXXXXXXXXXGOOOOOOOOOXXXXXXXXXXGOOOOOXXXXXXXXXXXXXXGOOXXXXXXXXXXXXXXXXXGOOOOOXXXXXXXXXXXXXXGOOOOOOXXXXXXXXXXXXXGOOOOOOOOOXXXXXXXXXXGOOOOOOOOOOXXXXXXXXXGOOXXXXXXXXXXXXXXXXXGOOOOOXXXXXXXXXXXXXXGOOOOXXXXXXXXXXXXXXXGOOOOOOOOXXXXXXXXXXX,0,600,0
32802,85,0,85,16,399,0,0,406,386,20,GOOXXXXXXXXXXXXXXXXXGOOOOOXXXXXXXXXXXXXXGOOOOOOOOOXXXXXXXXXXGOOOOOXXXXXXXXXXXXXXGOOXXXXXXXXXXXXXXXXXGOOOOOXXXXXXXXXXXXXXGOOOOOOXXXXXXXXXXXXXGOOOOOOOOOXXXXXXXXXXGOOOOOOOOOOXXXXXXXXXGOOXXXXXXXXXXXXXXXXXGOOOOOXXXXXXXXXXXXXXGOOOOXXXXXXXXXXXXXXXGOOOOOOOOXXXXXXXXXXX,0,600,0
32823,85,0,85,15,400,0,0,406,386,20,GOOXXXXXXXXXXXXXXXXXGOOOOOXXXXXXXXXXXXXXGOOOOOOOOOXXXXXXXXXXGOOOOOXXXXXXXXXXXXXXGOOXXXXXXXXXXXXXXXXXGOOOOOXXXXXXXXXXXXXXGOOOOOOXXXXXXXXXXXXXGOOOOOOOOOXXXXXXXXXXGOOOOOOOOOOXXXXXXXXXGOOXXXXXXXXXXXXXXXXXGOOOOOXXXXXXXXXXXXXXGOOOOXXXXXXXXXXXXXXXGOOOOOOOOXXXXXXXXXXX,0,600,0
32844,85,0,85,14,401,0,0,408,386,22,GOOXXXXXXXXXXXXXXXXXGOOOOOXXXXXXXXXXXXXXGOOOOOOOOOXXXXXXXXXXGOOOOOXXXXXXXXXXXXXXGOOXXXXXXXXXXXXXXXXXGOOOOOXXXXXXXXXXXXXXGOOOOOOXXXXXXXXXXXXXGOOOOOOOOOXXXXXXXXXXGOOOOOOOOOOXXXXXXXXXGOOXXXXXXXXXXXXXXXXXGOOOOOXXXXXXXXXXXXXXGOOOOXXXXXXXXXXXXXXXGOOOOOOOOXXXXXXXXXXX,0,600,0

32865,85,0,85,15,400,0,0,407,386,21,GOOXXXXXXXXXXXXXXXXXGOOOOOXXXXXXXXXXXXXXGOOOOOOOOOXXXXXXXXXXGOOOOOXXXXXXXXXXXXXXGOOXXXXXXXXXXXXXXXXXGOOOOOXXXXXXXXXXXXXXGOOOOOOXXXXXXXXXXXXXGOOOOOOOOOXXXXXXXXXXGOOOOOOOOOOXXXXXXXXXGOOXXXXXXXXXXXXXXXXXGOOOOOXXXXXXXXXXXXXXGOOOOXXXXXXXXXXXXXXXGOOOOOOOOXXXXXXXXXXX,0,600,0
32886,85,0,85,16,399,0,0,406,386,20,GOOXXXXXXXXXXXXXXXXXGOOOOOXXXXXXXXXXXXXXGOOOOOOOOOXXXXXXXXXXGOOOOOXXXXXXXXXXXXXXGOOXXXXXXXXXXXXXXXXXGOOOOOXXXXXXXXXXXXXXGOOOOOOXXXXXXXXXXXXXGOOOOOOOOOXXXXXXXXXXGOOOOOOOOOOXXXXXXXXXGOOXXXXXXXXXXXXXXXXXGOOOOOXXXXXXXXXXXXXXGOOOOXXXXXXXXXXXXXXXGOOOOOOOOXXXXXXXXXXX,0,600,0
32907,85,0,85,15,400,0,0,407,385,22,GOOXXXXXXXXXXXXXXXXXGOOOOOXXXXXXXXXXXXXXGOOOOOOOOOXXXXXXXXXXGOOOOOXXXXXXXXXXXXXXGOOXXXXXXXXXXXXXXXXXGOOOOOXXXXXXXXXXXXXXGOOOOOOXXXXXXXXXXXXXGOOOOOOOOOXXXXXXXXXXGOOOOOOOOOOXXXXXXXXXGOOXXXXXXXXXXXXXXXXXGOOOOOXXXXXXXXXXXXXXGOOOOXXXXXXXXXXXXXXXGOOOOOOOOXXXXXXXXXXX,0,600,0
32928,85,0,85,12,403,0,0,409,387,22,GOOXXXXXXXXXXXXXXXXXGOOOOOXXXXXXXXXXXXXXGOOOOOOOOOXXXXXXXXXXGOOOOOXXXXXXXXXXXXXXGOOXXXXXXXXXXXXXXXXXGOOOOOXXXXXXXXXXXXXXGOOOOOOXXXXXXXXXXXXXGOOOOOOOOOXXXXXXXXXXGOOOOOOOOOOXXXXXXXXXGOOXXXXXXXXXXXXXXXXXGOOOOOXXXXXXXXXXXXXXGOOOOXXXXXXXXXXXXXXXGOOOOOOOOXXXXXXXXXXX,0,600,0
32949,85,0,85,14,401,0,0,408,387,21,GOOXXXXXXXXXXXXXXXXXGOOOOOXXXXXXXXXXXXXXGOOOOOOOOOXXXXXXXXXXGOOOOOXXXXXXXXXXXXXXGOOXXXXXXXXXXXXXXXXXGOOOOOXXXXXXXXXXXXXXGOOOOOOXXXXXXXXXXXXXGOOOOOOOOOXXXXXXXXXXGOOOOOOOOOOXXXXXXXXXGOOXXXXXXXXXXXXXXXXXGOOOOOXXXXXXXXXXXXXXGOOOOXXXXXXXXXXXXXXXGOOOOOOOOXXXXXXXXXXX,0,600,0

32970,85,0,85,14,401,0,0,408,385,23,GOOXXXXXXXXXXXXXXXXXGOOOOOXXXXXXXXXXXXXXGOOOOOOOOOXXXXXXXXXXGOOOOOXXXXXXXXXXXXXXGOOXXXXXXXXXXXXXXXXXGOOOOOXXXXXXXXXXXXXXGOOOOOOXXXXXXXXXXXXXGOOOOOOOOOXXXXXXXXXXGOOOOOOOOOOXXXXXXXXXGOOXXXXXXXXXXXXXXXXXGOOOOOXXXXXXXXXXXXXXGOOOOXXXXXXXXXXXXXXXGOOOOOOOOXXXXXXXXXXX,0,600,0
32991,85,0,85,14,401,0,0,408,385,23,GOOXXXXXXXXXXXXXXXXXGOOOOOXXXXXXXXXXXXXXGOOOOOOOOOXXXXXXXXXXGOOOOOXXXXXXXXXXXXXXGOOXXXXXXXXXXXXXXXXXGOOOOOXXXXXXXXXXXXXXGOOOOOOXXXXXXXXXXXXXGOOOOOOOOOXXXXXXXXXXGOOOOOOOOOOXXXXXXXXXGOOXXXXXXXXXXXXXXXXXGOOOOOXXXXXXXXXXXXXXGOOOOXXXXXXXXXXXXXXXGOOOOOOOOXXXXXXXXXXX,0,600,0
33012,85,0,85,14,401,0,0,409,386,23,GOOXXXXXXXXXXXXXXXXXGOOOOOXXXXXXXXXXXXXXGOOOOOOOOOXXXXXXXXXXGOOOOOXXXXXXXXXXXXXXGOOXXXXXXXXXXXXXXXXXGOOOOOXXXXXXXXXXXXXXGOOOOOOXXXXXXXXXXXXXGOOOOOOOOOXXXXXXXXXXGOOOOOOOOOOXXXXXXXXXGOOXXXXXXXXXXXXXXXXXGOOOOOXXXXXXXXXXXXXXGOOOOXXXXXXXXXXXXXXXGOOOOOOOOXXXXXXXXXXX,0,600,0
33033,85,0,85,14,401,0,0,409,387,22,GOOXXXXXXXXXXXXXXXXXGOOOOOXXXXXXXXXXXXXXGOOOOOOOOOXXXXXXXXXXGOOOOOXXXXXXXXXXXXXXGOOXXXXXXXXXXXXXXXXXGOOOOOXXXXXXXXXXXXXXGOOOOOOXXXXXXXXXXXXXGOOOOOOOOOXXXXXXXXXXGOOOOOOOOOOXXXXXXXXXGOOXXXXXXXXXXXXXXXXXGOOOOOXXXXXXXXXXXXXXGOOOOXXXXXXXXXXXXXXXGOOOOOOOOXXXXXXXXXXX,0,600,0
33054,85,0,85,12,403,0,0,410,387,23,GOOXXXXXXXXXXXXXXXXXGOOOOOXXXXXXXXXXXXXXGOOOOOOOOOXXXXXXXXXXGOOOOOXXXXXXXXXXXXXXGOOXXXXXXXXXXXXXXXXXGOOOOOXXXXXXXXXXXXXXGOOOOOOXXXXXXXXXXXXXGOOOOOOOOOXXXXXXXXXXGOOOOOOOOOOXXXXXXXXXGOOXXXXXXXXXXXXXXXXXGOOOOOXXXXXXXXXXXXXXGOOOOXXXXXXXXXXXXXXXGOOOOOOOOXXXXXXXXXXX,0,600,0

33075,85,0,85,9,406,0,0,413,387,26,GOOXXXXXXXXXXXXXXXXXGOOOOOXXXXXXXXXXXXXXGOOOOOOOOOXXXXXXXXXXGOOOOOXXXXXXXXXXXXXXGOOXXXXXXXXXXXXXXXXXGOOOOOXXXXXXXXXXXXXXGOOOOOOXXXXXXXXXXXXXGOOOOOOOOOXXXXXXXXXXGOOOOOOOOOOXXXXXXXXXGOOXXXXXXXXXXXXXXXXXGOOOOOXXXXXXXXXXXXXXGOOOOXXXXXXXXXXXXXXXGOOOOOOOOXXXXXXXXXXX,0,600,0
33096,85,0,85,9,406,0,0,413,387,26,GOOXXXXXXXXXXXXXXXXXGOOOOOXXXXXXXXXXXXXXGOOOOOOOOOXXXXXXXXXXGOOOOOXXXXXXXXXXXXXXGOOXXXXXXXXXXXXXXXXXGOOOOOXXXXXXXXXXXXXXGOOOOOOXXXXXXXXXXXXXGOOOOOOOOOXXXXXXXXXXGOOOOOOOOOOXXXXXXXXXGOOXXXXXXXXXXXXXXXXXGOOOOOXXXXXXXXXXXXXXGOOOOXXXXXXXXXXXXXXXGOOOOOOOOXXXXXXXXXXX,0,600,0
33117,85,0,85,9,406,0,0,413,390,23,GOOXXXXXXXXXXXXXXXXXGOOOOOXXXXXXXXXXXXXXGOOOOOOOOOXXXXXXXXXXGOOOOOXXXXXXXXXXXXXXGOOXXXXXXXXXXXXXXXXXGOOOOOXXXXXXXXXXXXXXGOOOOOOXXXXXXXXXXXXXGOOOOOOOOOXXXXXXXXXXGOOOOOOOOOOXXXXXXXXXGOOXXXXXXXXXXXXXXXXXGOOOOOXXXXXXXXXXXXXXGOOOOXXXXXXXXXXXXXXXGOOOOOOOOXXXXXXXXXXX,0,600,0
33138,85,0,85,11,404,0,0,412,387,25,GOOXXXXXXXXXXXXXXXXXGOOOOOXXXXXXXXXXXXXXGOOOOOOOOOXXXXXXXXXXGOOOOOXXXXXXXXXXXXXXGOOXXXXXXXXXXXXXXXXXGOOOOOXXXXXXXXXXXXXXGOOOOOOXXXXXXXXXXXXXGOOOOOOOOOXXXXXXXXXXGOOOOOOOOOOXXXXXXXXXGOOXXXXXXXXXXXXXXXXXGOOOOOXXXXXXXXXXXXXXGOOOOXXXXXXXXXXXXXXXGOOOOOOOOXXXXXXXXXXX,0,600,0
33159,85,0,85,11,404,0,0,411,387,24,GOOXXXXXXXXXXXXXXXXXGOOOOOXXXXXXXXXXXXXXGOOOOOOOOOXXXXXXXXXXGOOOOOXXXXXXXXXXXXXXGOOXXXXXXXXXXXXXXXXXGOOOOOXXXXXXXXXXXXXXGOOOOOOXXXXXXXXXXXXXGOOOOOOOOOXXXXXXXXXXGOOOOOOOOOOXXXXXXXXXGOOXXXXXXXXXXXXXXXXXGOOOOOXXXXXXXXXXXXXXGOOOOXXXXXXXXXXXXXXXGOOOOOOOOXXXXXXXXXXX,0,600,0

33180,85,0,85,13,402,0,0,410,388,22,GOOXXXXXXXXXXXXXXXXXGOOOOOXXXXXXXXXXXXXXGOOOOOOOOOXXXXXXXXXXGOOOOOXXXXXXXXXXXXXXGOOXXXXXXXXXXXXXXXXXGOOOOOXXXXXXXXXXXXXXGOOOOOOXXXXXXXXXXXXXGOOOOOOOOOXXXXXXXXXXGOOOOOOOOOOXXXXXXXXXGOOXXXXXXXXXXXXXXXXXGOOOOOXXXXXXXXXXXXXXGOOOOXXXXXXXXXXXXXXXGOOOOOOOOXXXXXXXXXXX,0,600,0
33201,85,0,85,12,403,0,0,411,390,21,GOOXXXXXXXXXXXXXXXXXGOOOOOXXXXXXXXXXXXXXGOOOOOOOOOXXXXXXXXXXGOOOOOXXXXXXXXXXXXXXGOOXXXXXXXXXXXXXXXXXGOOOOOXXXXXXXXXXXXXXGOOOOOOXXXXXXXXXXXXXGOOOOOOOOOXXXXXXXXXXGOOOOOOOOOOXXXXXXXXXGOOXXXXXXXXXXXXXXXXXGOOOOOXXXXXXXXXXXXXXGOOOOXXXXXXXXXXXXXXXGOOOOOOOOXXXXXXXXXXX,0,600,0
33222,86,1,85,13,401,0,0,409,387,22,GOOXXXXXXXXXXXXXXXXXGOOOOOXXXXXXXXXXXXXXGOOOOOOOOOXXXXXXXXXXGOOOOOXXXXXXXXXXXXXXGOOXXXXXXXXXXXXXXXXXGOOOOOXXXXXXXXXXXXXXGOOOOOOXXXXXXXXXXXXXGOOOOOOOOOXXXXXXXXXXGOOOOOOOOOOAXXXXXXXXGOOXXXXXXXXXXXXXXXXXGOOOOOXXXXXXXXXXXXXXGOOOOXXXXXXXXXXXXXXXGOOOOOOOOXXXXXXXXXXX,0,600,0
33243,86,1,85,13,401,0,0,409,389,20,GOOXXXXXXXXXXXXXXXXXGOOOOOXXXXXXXXXXXXXXGOOOOOOOOOXXXXXXXXXXGOOOOOXXXXXXXXXXXXXXGOOXXXXXXXXXXXXXXXXXGOOOOOXXXXXXXXXXXXXXGOOOOOOXXXXXXXXXXXXXGOOOOOOOOOXXXXXXXXXXGOOOOOOOOOOAXXXXXXXXGOOXXXXXXXXXXXXXXXXXGOOOOOXXXXXXXXXXXXXXGOOOOXXXXXXXXXXXXXXXGOOOOOOOOXXXXXXXXXXX,0,600,0
33264,86,1,85,14,400,0,0,407,389,18,GOOXXXXXXXXXXXXXXXXXGOOOOOXXXXXXXXXXXXXXGOOOOOOOOOXXXXXXXXXXGOOOOOXXXXXXXXXXXXXXGOOXXXXXXXXXXXXXXXXXGOOOOOXXXXXXXXXXXXXXGOOOOOOXXXXXXXXXXXXXGOOOOOOOOOXXXXXXXXXXGOOOOOOOOOOAXXXXXXXXGOOXXXXXXXXXXXXXXXXXGOOOOOXXXXXXXXXXXXXXGOOOOXXXXXXXXXXXXXXXGOOOOOOOOXXXXXXXXXXX,0,600,0

33285,86,1,85,16,398,0,0,406,387,19,GOOXXXXXXXXXXXXXXXXXGOOOOOXXXXXXXXXXXXXXGOOOOOOOOOXXXXXXXXXXGOOOOOXXXXXXXXXXXXXXGOOXXXXXXXXXXXXXXXXXGOOOOOXXXXXXXXXXXXXXGOOOOOOXXXXXXXXXXXXXGOOOOOOOOOXXXXXXXXXXGOOOOOOOOOOAXXXXXXXXGOOXXXXXXXXXXXXXXXXXGOOOOOXXXXXXXXXXXXXXGOOOOXXXXXXXXXXXXXXXGOOOOOOOOXXXXXXXXXXX,0,600,0
33306,86,1,85,16,398,0,0,406,387,19,GOOXXXXXXXXXXXXXXXXXGOOOOOXXXXXXXXXXXXXXGOOOOOOOOOXXXXXXXXXXGOOOOOXXXXXXXXXXXXXXGOOXXXXXXXXXXXXXXXXXGOOOOOXXXXXXXXXXXXXXGOOOOOOXXXXXXXXXXXXXGOOOOOOOOOXXXXXXXXXXGOOOOOOOOOOAXXXXXXXXGOOXXXXXXXXXXXXXXXXXGOOOOOXXXXXXXXXXXXXXGOOOOXXXXXXXXXXXXXXXGOOOOOOOOXXXXXXXXXXX,0,600,0
33327,86,1,85,14,400,0,0,408,388,20,GOOXXXXXXXXXXXXXXXXXGOOOOOXXXXXXXXXXXXXXGOOOOOOOOOXXXXXXXXXXGOOOOOXXXXXXXXXXXXXXGOOXXXXXXXXXXXXXXXXXGOOOOOXXXXXXXXXXXXXXGOOOOOOXXXXXXXXXXXXXGOOOOOOOOOXXXXXXXXXXGOOOOOOOOOOAXXXXXXXXGOOXXXXXXXXXXXXXXXXXGOOOOOXXXXXXXXXXXXXXGOOOOXXXXXXXXXXXXXXXGOOOOOOOOXXXXXXXXXXX,0,600,0
33348,86,1,85,13,401,0,0,409,387,22,GOOXXXXXXXXXXXXXXXXXGOOOOOXXXXXXXXXXXXXXGOOOOOOOOOXXXXXXXXXXGOOOOOXXXXXXXXXXXXXXGOOXXXXXXXXXXXXXXXXXGOOOOOXXXXXXXXXXXXXXGOOOOOOXXXXXXXXXXXXXGOOOOOOOOOXXXXXXXXXXGOOOOOOOOOOAXXXXXXXXGOOXXXXXXXXXXXXXXXXXGOOOOOXXXXXXXXXXXXXXGOOOOXXXXXXXXXXXXXXXGOOOOOOOOXXXXXXXXXXX,0,600,0
33369,86,1,85,12,402,0,0,410,387,23,GOOXXXXXXXXXXXXXXXXXGOOOOOXXXXXXXXXXXXXXGOOOOOOOOOXXXXXXXXXXGOOOOOXXXXXXXXXXXXXXGOOXXXXXXXXXXXXXXXXXGOOOOOXXXXXXXXXXXXXXGOOOOOOXXXXXXXXXXXXXGOOOOOOOOOXXXXXXXXXXGOOOOOOOOOOAXXXXXXXXGOOXXXXXXXXXXXXXXXXXGOOOOOXXXXXXXXXXXXXXGOOOOXXXXXXXXXXXXXXXGOOOOOOOOXXXXXXXXXXX,0,600,0

33390,86,0,86,11,403,0,0,411,387,24,GOOXXXXXXXXXXXXXXXXXGOOOOOXXXXXXXXXXXXXXGOOOOOOOOOXXXXXXXXXXGOOOOOXXXXXXXXXXXXXXGOOXXXXXXXXXXXXXXXXXGOOOOOXXXXXXXXXXXXXXGOOOOOOXXXXXXXXXXXXXGOOOOOOOOOXXXXXXXXXXGOOOOOOOOOOOXXXXXXXXGOOXXXXXXXXXXXXXXXXXGOOOOOXXXXXXXXXXXXXXGOOOOXXXXXXXXXXXXXXXGOOOOOOOOXXXXXXXXXXX,0,600,0
33411,86,0,86,12,402,0,0,410,388,22,GOOXXXXXXXXXXXXXXXXXGOOOOOXXXXXXXXXXXXXXGOOOOOOOOOXXXXXXXXXXGOOOOOXXXXXXXXXXXXXXGOOXXXXXXXXXXXXXXXXXGOOOOOXXXXXXXXXXXXXXGOOOOOOXXXXXXXXXXXXXGOOOOOOOOOXXXXXXXXXXGOOOOOOOOOOOXXXXXXXXGOOXXXXXXXXXXXXXXXXXGOOOOOXXXXXXXXXXXXXXGOOOOXXXXXXXXXXXXXXXGOOOOOOOOXXXXXXXXXXX,0,600,0
33432,86,0,86,13,401,0,0,409,387,22,GOOXXXXXXXXXXXXXXXXXGOOOOOXXXXXXXXXXXXXXGOOOOOOOOOXXXXXXXXXXGOOOOOXXXXXXXXXXXXXXGOOXXXXXXXXXXXXXXXXXGOOOOOXXXXXXXXXXXXXXGOOOOOOXXXXXXXXXXXXXGOOOOOOOOOXXXXXXXXXXGOOOOOOOOOOOXXXXXXXXGOOXXXXXXXXXXXXXXXXXGOOOOOXXXXXXXXXXXXXXGOOOOXXXXXXXXXXXXXXXGOOOOOOOOXXXXXXXXXXX,0,600,0
33453,86,0,86,15,399,0,0,407,388,19,GOOXXXXXXXXXXXXXXXXXGOOOOOXXXXXXXXXXXXXXGOOOOOOOOOXXXXXXXXXXGOOOOOXXXXXXXXXXXXXXGOOXXXXXXXXXXXXXXXXXGOOOOOXXXXXXXXXXXXXXGOOOOOOXXXXXXXXXXXXXGOOOOOOOOOXXXXXXXXXXGOOOOOOOOOOOXXXXXXXXGOOXXXXXXXXXXXXXXXXXGOOOOOXXXXXXXXXXXXXXGOOOOXXXXXXXXXXXXXXXGOOOOOOOOXXXXXXXXXXX,0,600,0
33474,86,0,86,14,400,0,0,408,388,20,GOOXXXXXXXXXXXXXXXXXGOOOOOXXXXXXXXXXXXXXGOOOOOOOOOXXXXXXXXXXGOOOOOXXXXXXXXXXXXXXGOOXXXXXXXXXXXXXXXXXGOOOOOXXXXXXXXXXXXXXGOOOOOOXXXXXXXXXXXXXGOOOOOOOOOXXXXXXXXXXGOOOOOOOOOOOXXXXXXXXGOOXXXXXXXXXXXXXXXXXGOOOOOXXXXXXXXXXXXXXGOOOOXXXXXXXXXXXXXXXGOOOOOOOOXXXXXXXXXXX,0,600,0

33495,86,0,86,13,401,0,0,409,387,22,GOOXXXXXXXXXXXXXXXXXGOOOOOXXXXXXXXXXXXXXGOOOOOOOOOXXXXXXXXXXGOOOOOXXXXXXXXXXXXXXGOOXXXXXXXXXXXXXXXXXGOOOOOXXXXXXXXXXXXXXGOOOOOOXXXXXXXXXXXXXGOOOOOOOOOXXXXXXXXXXGOOOOOOOOOOOXXXXXXXXGOOXXXXXXXXXXXXXXXXXGOOOOOXXXXXXXXXXXXXXGOOOOXXXXXXXXXXXXXXXGOOOOOOOOXXXXXXXXXXX,0,600,0
33516,86,0,86,14,400,0,0,408,387,21,GOOXXXXXXXXXXXXXXXXXGOOOOOXXXXXXXXXXXXXXGOOOOOOOOOXXXXXXXXXXGOOOOOXXXXXXXXXXXXXXGOOXXXXXXXXXXXXXXXXXGOOOOOXXXXXXXXXXXXXXGOOOOOOXXXXXXXXXXXXXGOOOOOOOOOXXXXXXXXXXGOOOOOOOOOOOXXXXXXXXGOOXXXXXXXXXXXXXXXXXGOOOOOXXXXXXXXXXXXXXGOOOOXXXXXXXXXXXXXXXGOOOOOOOOXXXXXXXXXXX,0,600,0
33537,86,0,86,17,397,0,0,405,387,18,GOOXXXXXXXXXXXXXXXXXGOOOOOXXXXXXXXXXXXXXGOOOOOOOOOXXXXXXXXXXGOOOOOXXXXXXXXXXXXXXGOOXXXXXXXXXXXXXXXXXGOOOOOXXXXXXXXXXXXXXGOOOOOOXXXXXXXXXXXXXGOOOOOOOOOXXXXXXXXXXGOOOOOOOOOOOXXXXXXXXGOOXXXXXXXXXXXXXXXXXGOOOOOXXXXXXXXXXXXXXGOOOOXXXXXXXXXXXXXXXGOOOOOOOOXXXXXXXXXXX,0,600,0
33558,86,0,86,16,398,0,0,406,388,18,GOOXXXXXXXXXXXXXXXXXGOOOOOXXXXXXXXXXXXXXGOOOOOOOOOXXXXXXXXXXGOOOOOXXXXXXXXXXXXXXGOOXXXXXXXXXXXXXXXXXGOOOOOXXXXXXXXXXXXXXGOOOOOOXXXXXXXXXXXXXGOOOOOOOOOXXXXXXXXXXGOOOOOOOOOOOXXXXXXXXGOOXXXXXXXXXXXXXXXXXGOOOOOXXXXXXXXXXXXXXGOOOOXXXXXXXXXXXXXXXGOOOOOOOOXXXXXXXXXXX,0,600,0
33579,86,0,86,15,399,0,0,406,389,17,GOOXXXXXXXXXXXXXXXXXGOOOOOXXXXXXXXXXXXXXGOOOOOOOOOXXXXXXXXXXGOOOOOXXXXXXXXXXXXXXGOOXXXXXXXXXXXXXXXXXGOOOOOXXXXXXXXXXXXXXGOOOOOOXXXXXXXXXXXXXGOOOOOOOOOXXXXXXXXXXGOOOOOOOOOOOXXXXXXXXGOOXXXXXXXXXXXXXXXXXGOOOOOXXXXXXXXXXXXXXGOOOOXXXXXXXXXXXXXXXGOOOOOOOOXXXXXXXXXXX,0,600,0

33600,86,0,86,14,400,0,0,407,388,19,GOOXXXXXXXXXXXXXXXXXGOOOOOXXXXXXXXXXXXXXGOOOOOOOOOXXXXXXXXXXGOOOOOXXXXXXXXXXXXXXGOOXXXXXXXXXXXXXXXXXGOOOOOXXXXXXXXXXXXXXGOOOOOOXXXXXXXXXXXXXGOOOOOOOOOXXXXXXXXXXGOOOOOOOOOOOXXXXXXXXGOOXXXXXXXXXXXXXXXXXGOOOOOXXXXXXXXXXXXXXGOOOOXXXXXXXXXXXXXXXGOOOOOOOOXXXXXXXXXXX,0,600,0
33621,86,0,86,13,401,0,0,407,388,19,GOOXXXXXXXXXXXXXXXXXGOOOOOXXXXXXXXXXXXXXGOOOOOOOOOXXXXXXXXXXGOOOOOXXXXXXXXXXXXXXGOOXXXXXXXXXXXXXXXXXGOOOOOXXXXXXXXXXXXXXGOOOOOOXXXXXXXXXXXXXGOOOOOOOOOXXXXXXXXXXGOOOOOOOOOOOXXXXXXXXGOOXXXXXXXXXXXXXXXXXGOOOOOXXXXXXXXXXXXXXGOOOOXXXXXXXXXXXXXXXGOOOOOOOOXXXXXXXXXXX,0,600,0
33642,86,0,86,12,402,0,0,409,387,22,GOOXXXXXXXXXXXXXXXXXGOOOOOXXXXXXXXXXXXXXGOOOOOOOOOXXXXXXXXXXGOOOOOXXXXXXXXXXXXXXGOOXXXXXXXXXXXXXXXXXGOOOOOXXXXXXXXXXXXXXGOOOOOOXXXXXXXXXXXXXGOOOOOOOOOXXXXXXXXXXGOOOOOOOOOOOXXXXXXXXGOOXXXXXXXXXXXXXXXXXGOOOOOXXXXXXXXXXXXXXGOOOOXXXXXXXXXXXXXXXGOOOOOOOOXXXXXXXXXXX,0,600,0
33663,86,0,86,10,404,0,0,411,387,24,GOOXXXXXXXXXXXXXXXXXGOOOOOXXXXXXXXXXXXXXGOOOOOOOOOXXXXXXXXXXGOOOOOXXXXXXXXXXXXXXGOOXXXXXXXXXXXXXXXXXGOOOOOXXXXXXXXXXXXXXGOOOOOOXXXXXXXXXXXXXGOOOOOOOOOXXXXXXXXXXGOOOOOOOOOOOXXXXXXXXGOOXXXXXXXXXXXXXXXXXGOOOOOXXXXXXXXXXXXXXGOOOOXXXXXXXXXXXXXXXGOOOOOOOOXXXXXXXXXXX,0,600,0
33684,86,0,86,11,403,0,0,410,387,23,GOOXXXXXXXXXXXXXXXXXGOOOOOXXXXXXXXXXXXXXGOOOOOOOOOXXXXXXXXXXGOOOOOXXXXXXXXXXXXXXGOOXXXXXXXXXXXXXXXXXGOOOOOXXXXXXXXXXXXXXGOOOOOOXXXXXXXXXXXXXGOOOOOOOOOXXXXXXXXXXGOOOOOOOOOOOXXXXXXXXGOOXXXXXXXXXXXXXXXXXGOOOOOXXXXXXXXXXXXXXGOOOOXXXXXXXXXXXXXXXGOOOOOOOOXXXXXXXXXXX,0,600,0

33705,86,0,86,11,403,0,0,410,387,23,GOOXXXXXXXXXXXXXXXXXGOOOOOXXXXXXXXXXXXXXGOOOOOOOOOXXXXXXXXXXGOOOOOXXXXXXXXXXXXXXGOOXXXXXXXXXXXXXXXXXGOOOOOXXXXXXXXXXXXXXGOOOOOOXXXXXXXXXXXXXGOOOOOOOOOXXXXXXXXXXGOOOOOOOOOOOXXXXXXXXGOOXXXXXXXXXXXXXXXXXGOOOOOXXXXXXXXXXXXXXGOOOOXXXXXXXXXXXXXXXGOOOOOOOOXXXXXXXXXXX,0,600,0
33726,86,0,86,9,405,0,0,412,388,24,GOOXXXXXXXXXXXXXXXXXGOOOOOXXXXXXXXXXXXXXGOOOOOOOOOXXXXXXXXXXGOOOOOXXXXXXXXXXXXXXGOOXXXXXXXXXXXXXXXXXGOOOOOXXXXXXXXXXXXXXGOOOOOOXXXXXXXXXXXXXGOOOOOOOOOXXXXXXXXXXGOOOOOOOOOOOXXXXXXXXGOOXXXXXXXXXXXXXXXXXGOOOOOXXXXXXXXXXXXXXGOOOOXXXXXXXXXXXXXXXGOOOOOOOOXXXXXXXXXXX,0,600,0
33747,86,0,86,8,406,0,0,413,389,24,GOOXXXXXXXXXXXXXXXXXGOOOOOXXXXXXXXXXXXXXGOOOOOOOOOXXXXXXXXXXGOOOOOXXXXXXXXXXXXXXGOOXXXXXXXXXXXXXXXXXGOOOOOXXXXXXXXXXXXXXGOOOOOOXXXXXXXXXXXXXGOOOOOOOOOXXXXXXXXXXGOOOOOOOOOOOXXXXXXXXGOOXXXXXXXXXXXXXXXXXGOOOOOXXXXXXXXXXXXXXGOOOOXXXXXXXXXXXXXXXGOOOOOOOOXXXXXXXXXXX,0,600,0
33768,86,0,86,9,405,0,0,412,387,25,GOOXXXXXXXXXXXXXXXXXGOOOOOXXXXXXXXXXXXXXGOOOOOOOOOXXXXXXXXXXGOOOOOXXXXXXXXXXXXXXGOOXXXXXXXXXXXXXXXXXGOOOOOXXXXXXXXXXXXXXGOOOOOOXXXXXXXXXXXXXGOOOOOOOOOXXXXXXXXXXGOOOOOOOOOOOXXXXXXXXGOOXXXXXXXXXXXXXXXXXGOOOOOXXXXXXXXXXXXXXGOOOOXXXXXXXXXXXXXXXGOOOOOOOOXXXXXXXXXXX,0,600,0
33789,86,0,86,9,405,0,0,412,387,25,GOOXXXXXXXXXXXXXXXXXGOOOOOXXXXXXXXXXXXXXGOOOOOOOOOXXXXXXXXXXGOOOOOXXXXXXXXXXXXXXGOOXXXXXXXXXXXXXXXXXGOOOOOXXXXXXXXXXXXXXGOOOOOOXXXXXXXXXXXXXGOOOOOOOOOXXXXXXXXXXGOOOOOOOOOOOXXXXXXXXGOOXXXXXXXXXXXXXXXXXGOOOOOXXXXXXXXXXXXXXGOOOOXXXXXXXXXXXXXXXGOOOOOOOOXXXXXXXXXXX,0,600,0

33810,86,0,86,9,405,0,0,412,387,25,GOOXXXXXXXXXXXXXXXXXGOOOOOXXXXXXXXXXXXXXGOOOOOOOOOXXXXXXXXXXGOOOOOXXXXXXXXXXXXXXGOOXXXXXXXXXXXXXXXXXGOOOOOXXXXXXXXXXXXXXGOOOOOOXXXXXXXXXXXXXGOOOOOOOOOXXXXXXXXXXGOOOOOOOOOOOXXXXXXXXGOOXXXXXXXXXXXXXXXXXGOOOOOXXXXXXXXXXXXXXGOOOOXXXXXXXXXXXXXXXGOOOOOOOOXXXXXXXXXXX,0,600,0
33831,86,0,86,8,406,0,0,412,387,25,GOOXXXXXXXXXXXXXXXXXGOOOOOXXXXXXXXXXXXXXGOOOOOOOOOXXXXXXXXXXGOOOOOXXXXXXXXXXXXXXGOOXXXXXXXXXXXXXXXXXGOOOOOXXXXXXXXXXXXXXGOOOOOOXXXXXXXXXXXXXGOOOOOOOOOXXXXXXXXXXGOOOOOOOOOOOXXXXXXXXGOOXXXXXXXXXXXXXXXXXGOOOOOXXXXXXXXXXXXXXGOOOOXXXXXXXXXXXXXXXGOOOOOOOOXXXXXXXXXXX,0,600,0
33852,86,0,86,8,406,0,0,413,388,25,GOOXXXXXXXXXXXXXXXXXGOOOOOXXXXXXXXXXXXXXGOOOOOOOOOXXXXXXXXXXGOOOOOXXXXXXXXXXXXXXGOOXXXXXXXXXXXXXXXXXGOOOOOXXXXXXXXXXXXXXGOOOOOOXXXXXXXXXXXXXGOOOOOOOOOXXXXXXXXXXGOOOOOOOOOOOXXXXXXXXGOOXXXXXXXXXXXXXXXXXGOOOOOXXXXXXXXXXXXXXGOOOOXXXXXXXXXXXXXXXGOOOOOOOOXXXXXXXXXXX,0,600,0
33873,86,0,86,8,406,0,0,413,389,24,GOOXXXXXXXXXXXXXXXXXGOOOOOXXXXXXXXXXXXXXGOOOOOOOOOXXXXXXXXXXGOOOOOXXXXXXXXXXXXXXGOOXXXXXXXXXXXXXXXXXGOOOOOXXXXXXXXXXXXXXGOOOOOOXXXXXXXXXXXXXGOOOOOOOOOXXXXXXXXXXGOOOOOOOOOOOXXXXXXXXGOOXXXXXXXXXXXXXXXXXGOOOOOXXXXXXXXXXXXXXGOOOOXXXXXXXXXXXXXXXGOOOOOOOOXXXXXXXXXXX,0,600,0
33894,86,0,86,8,406,0,0,413,389,24,GOOXXXXXXXXXXXXXXXXXGOOOOOXXXXXXXXXXXXXXGOOOOOOOOOXXXXXXXXXXGOOOOOXXXXXXXXXXXXXXGOOXXXXXXXXXXXXXXXXXGOOOOOXXXXXXXXXXXXXXGOOOOOOXXXXXXXXXXXXXGOOOOOOOOOXXXXXXXXXXGOOOOOOOOOOOXXXXXXXXGOOXXXXXXXXXXXXXXXXXGOOOOOXXXXXXXXXXXXXXGOOOOXXXXXXXXXXXXXXXGOOOOOOOOXXXXXXXXXXX,0,600,0

33915,86,0,86,7,407,0,0,413,389,24,GOOXXXXXXXXXXXXXXXXXGOOOOOXXXXXXXXXXXXXXGOOOOOOOOOXXXXXXXXXXGOOOOOXXXXXXXXXXXXXXGOOXXXXXXXXXXXXXXXXXGOOOOOXXXXXXXXXXXXXXGOOOOOOXXXXXXXXXXXXXGOOOOOOOOOXXXXXXXXXXGOOOOOOOOOOOXXXXXXXXGOOXXXXXXXXXXXXXXXXXGOOOOOXXXXXXXXXXXXXXGOOOOXXXXXXXXXXXXXXXGOOOOOOOOXXXXXXXXXXX,0,600,0
33936,86,0,86,6,408,0,0,415,390,25,GOOXXXXXXXXXXXXXXXXXGOOOOOXXXXXXXXXXXXXXGOOOOOOOOOXXXXXXXXXXGOOOOOXXXXXXXXXXXXXXGOOXXXXXXXXXXXXXXXXXGOOOOOXXXXXXXXXXXXXXGOOOOOOXXXXXXXXXXXXXGOOOOOOOOOXXXXXXXXXXGOOOOOOOOOOOXXXXXXXXGOOXXXXXXXXXXXXXXXXXGOOOOOXXXXXXXXXXXXXXGOOOOXXXXXXXXXXXXXXXGOOOOOOOOXXXXXXXXXXX,0,600,0
33957,86,0,86,6,408,0,0,415,390,25,GOOXXXXXXXXXXXXXXXXXGOOOOOXXXXXXXXXXXXXXGOOOOOOOOOXXXXXXXXXXGOOOOOXXXXXXXXXXXXXXGOOXXXXXXXXXXXXXXXXXGOOOOOXXXXXXXXXXXXXXGOOOOOOXXXXXXXXXXXXXGOOOOOOOOOXXXXXXXXXXGOOOOOOOOOOOXXXXXXXXGOOXXXXXXXXXXXXXXXXXGOOOOOXXXXXXXXXXXXXXGOOOOXXXXXXXXXXXXXXXGOOOOOOOOXXXXXXXXXXX,0,600,0
33978,86,0,86,6,408,0,0,415,391,24,GOOXXXXXXXXXXXXXXXXXGOOOOOXXXXXXXXXXXXXXGOOOOOOOOOXXXXXXXXXXGOOOOOXXXXXXXXXXXXXXGOOXXXXXXXXXXXXXXXXXGOOOOOXXXXXXXXXXXXXXGOOOOOOXXXXXXXXXXXXXGOOOOOOOOOXXXXXXXXXXGOOOOOOOOOOOXXXXXXXXGOOXXXXXXXXXXXXXXXXXGOOOOOXXXXXXXXXXXXXXGOOOOXXXXXXXXXXXXXXXGOOOOOOOOXXXXXXXXXXX,0,600,0
33999,86,0,86,7,407,0,0,414,391,23,GOOXXXXXXXXXXXXXXXXXGOOOOOXXXXXXXXXXXXXXGOOOOOOOOOXXXXXXXXXXGOOOOOXXXXXXXXXXXXXXGOOXXXXXXXXXXXXXXXXXGOOOOOXXXXXXXXXXXXXXGOOOOOOXXXXXXXXXXXXXGOOOOOOOOOXXXXXXXXXXGOOOOOOOOOOOXXXXXXXXGOOXXXXXXXXXXXXXXXXXGOOOOOXXXXXXXXXXXXXXGOOOOXXXXXXXXXXXXXXXGOOOOOOOOXXXXXXXXXXX,0,600,0

34020,86,0,86,7,407,0,0,414,390,24,GOOXXXXXXXXXXXXXXXXXGOOOOOXXXXXXXXXXXXXXGOOOOOOOOOXXXXXXXXXXGOOOOOXXXXXXXXXXXXXXGOOXXXXXXXXXXXXXXXXXGOOOOOXXXXXXXXXXXXXXGOOOOOOXXXXXXXXXXXXXGOOOOOOOOOXXXXXXXXXXGOOOOOOOOOOOXXXXXXXXGOOXXXXXXXXXXXXXXXXXGOOOOOXXXXXXXXXXXXXXGOOOOXXXXXXXXXXXXXXXGOOOOOOOOXXXXXXXXXXX,0,600,0
34041,86,0,86,9,405,0,0,412,389,23,GOOXXXXXXXXXXXXXXXXXGOOOOOXXXXXXXXXXXXXXGOOOOOOOOOXXXXXXXXXXGOOOOOXXXXXXXXXXXXXXGOOXXXXXXXXXXXXXXXXXGOOOOOXXXXXXXXXXXXXXGOOOOOOXXXXXXXXXXXXXGOOOOOOOOOXXXXXXXXXXGOOOOOOOOOOOXXXXXXXXGOOXXXXXXXXXXXXXXXXXGOOOOOXXXXXXXXXXXXXXGOOOOXXXXXXXXXXXXXXXGOOOOOOOOXXXXXXXXXXX,0,600,0
34062,86,0,86,8,406,0,0,413,389,24,GOOXXXXXXXXXXXXXXXXXGOOOOOXXXXXXXXXXXXXXGOOOOOOOOOXXXXXXXXXXGOOOOOXXXXXXXXXXXXXXGOOXXXXXXXXXXXXXXXXXGOOOOOXXXXXXXXXXXXXXGOOOOOOXXXXXXXXXXXXXGOOOOOOOOOXXXXXXXXXXGOOOOOOOOOOOXXXXXXXXGOOXXXXXXXXXXXXXXXXXGOOOOOXXXXXXXXXXXXXXGOOOOXXXXXXXXXXXXXXXGOOOOOOOOXXXXXXXXXXX,0,600,0
34083,86,0,86,11,403,0,0,410,390,20,GOOXXXXXXXXXXXXXXXXXGOOOOOXXXXXXXXXXXXXXGOOOOOOOOOXXXXXXXXXXGOOOOOXXXXXXXXXXXXXXGOOXXXXXXXXXXXXXXXXXGOOOOOXXXXXXXXXXXXXXGOOOOOOXXXXXXXXXXXXXGOOOOOOOOOXXXXXXXXXXGOOOOOOOOOOOXXXXXXXXGOOXXXXXXXXXXXXXXXXXGOOOOOXXXXXXXXXXXXXXGOOOOXXXXXXXXXXXXXXXGOOOOOOOOXXXXXXXXXXX,0,600,0
34104,86,0,86,13,401,0,0,408,391,17,GOOXXXXXXXXXXXXXXXXXGOOOOOXXXXXXXXXXXXXXGOOOOOOOOOXXXXXXXXXXGOOOOOXXXXXXXXXXXXXXGOOXXXXXXXXXXXXXXXXXGOOOOOXXXXXXXXXXXXXXGOOOOOOXXXXXXXXXXXXXGOOOOOOOOOXXXXXXXXXXGOOOOOOOOOOOXXXXXXXXGOOXXXXXXXXXXXXXXXXXGOOOOOXXXXXXXXXXXXXXGOOOOXXXXXXXXXXXXXXXGOOOOOOOOXXXXXXXXXXX,0,600,0

34125,86,0,86,15,399,0,0,406,389,17,GOOXXXXXXXXXXXXXXXXXGOOOOOXXXXXXXXXXXXXXGOOOOOOOOOXXXXXXXXXXGOOOOOXXXXXXXXXXXXXXGOOXXXXXXXXXXXXXXXXXGOOOOOXXXXXXXXXXXXXXGOOOOOOXXXXXXXXXXXXXGOOOOOOOOOXXXXXXXXXXGOOOOOOOOOOOXXXXXXXXGOOXXXXXXXXXXXXXXXXXGOOOOOXXXXXXXXXXXXXXGOOOOXXXXXXXXXXXXXXXGOOOOOOOOXXXXXXXXXXX,0,600,0
34146,86,0,86,15,399,0,0,406,390,16,GOOXXXXXXXXXXXXXXXXXGOOOOOXXXXXXXXXXXXXXGOOOOOOOOOXXXXXXXXXXGOOOOOXXXXXXXXXXXXXXGOOXXXXXXXXXXXXXXXXXGOOOOOXXXXXXXXXXXXXXGOOOOOOXXXXXXXXXXXXXGOOOOOOOOOXXXXXXXXXXGOOOOOOOOOOOXXXXXXXXGOOXXXXXXXXXXXXXXXXXGOOOOOXXXXXXXXXXXXXXGOOOOXXXXXXXXXXXXXXXGOOOOOOOOXXXXXXXXXXX,0,600,0
34167,86,0,86,16,398,0,0,405,389,16,GOOXXXXXXXXXXXXXXXXXGOOOOOXXXXXXXXXXXXXXGOOOOOOOOOXXXXXXXXXXGOOOOOXXXXXXXXXXXXXXGOOXXXXXXXXXXXXXXXXXGOOOOOXXXXXXXXXXXXXXGOOOOOOXXXXXXXXXXXXXGOOOOOOOOOXXXXXXXXXXGOOOOOOOOOOOXXXXXXXXGOOXXXXXXXXXXXXXXXXXGOOOOOXXXXXXXXXXXXXXGOOOOXXXXXXXXXXXXXXXGOOOOOOOOXXXXXXXXXXX,0,600,0
34188,86,0,86,16,398,0,0,405,389,16,GOOXXXXXXXXXXXXXXXXXGOOOOOXXXXXXXXXXXXXXGOOOOOOOOOXXXXXXXXXXGOOOOOXXXXXXXXXXXXXXGOOXXXXXXXXXXXXXXXXXGOOOOOXXXXXXXXXXXXXXGOOOOOOXXXXXXXXXXXXXGOOOOOOOOOXXXXXXXXXXGOOOOOOOOOOOXXXXXXXXGOOXXXXXXXXXXXXXXXXXGOOOOOXXXXXXXXXXXXXXGOOOOXXXXXXXXXXXXXXXGOOOOOOOOXXXXXXXXXXX,0,600,0
34209,86,0,86,12,402,0,0,409,389,20,GOOXXXXXXXXXXXXXXXXXGOOOOOXXXXXXXXXXXXXXGOOOOOOOOOXXXXXXXXXXGOOOOOXXXXXXXXXXXXXXGOOXXXXXXXXXXXXXXXXXGOOOOOXXXXXXXXXXXXXXGOOOOOOXXXXXXXXXXXXXGOOOOOOOOOXXXXXXXXXXGOOOOOOOOOOOXXXXXXXXGOOXXXXXXXXXXXXXXXXXGOOOOOXXXXXXXXXXXXXXGOOOOXXXXXXXXXXXXXXXGOOOOOOOOXXXXXXXXXXX,0,600,0

34230,86,0,86,11,403,0,0,410,390,20,GOOXXXXXXXXXXXXXXXXXGOOOOOXXXXXXXXXXXXXXGOOOOOOOOOXXXXXXXXXXGOOOOOXXXXXXXXXXXXXXGOOXXXXXXXXXXXXXXXXXGOOOOOXXXXXXXXXXXXXXGOOOOOOXXXXXXXXXXXXXGOOOOOOOOOXXXXXXXXXXGOOOOOOOOOOOXXXXXXXXGOOXXXXXXXXXXXXXXXXXGOOOOOXXXXXXXXXXXXXXGOOOOXXXXXXXXXXXXXXXGOOOOOOOOXXXXXXXXXXX,0,600,0
34251,86,0,86,10,404,0,0,411,391,20,GOOXXXXXXXXXXXXXXXXXGOOOOOXXXXXXXXXXXXXXGOOOOOOOOOXXXXXXXXXXGOOOOOXXXXXXXXXXXXXXGOOXXXXXXXXXXXXXXXXXGOOOOOXXXXXXXXXXXXXXGOOOOOOXXXXXXXXXXXXXGOOOOOOOOOXXXXXXXXXXGOOOOOOOOOOOXXXXXXXXGOOXXXXXXXXXXXXXXXXXGOOOOOXXXXXXXXXXXXXXGOOOOXXXXXXXXXXXXXXXGOOOOOOOOXXXXXXXXXXX,0,600,0
34272,86,0,86,10,404,0,0,410,390,20,GOOXXXXXXXXXXXXXXXXXGOOOOOXXXXXXXXXXXXXXGOOOOOOOOOXXXXXXXXXXGOOOOOXXXXXXXXXXXXXXGOOXXXXXXXXXXXXXXXXXGOOOOOXXXXXXXXXXXXXXGOOOOOOXXXXXXXXXXXXXGOOOOOOOOOXXXXXXXXXXGOOOOOOOOOOOXXXXXXXXGOOXXXXXXXXXXXXXXXXXGOOOOOXXXXXXXXXXXXXXGOOOOXXXXXXXXXXXXXXXGOOOOOOOOXXXXXXXXXXX,0,600,0
34293,86,0,86,11,403,0,0,410,389,21,GOOXXXXXXXXXXXXXXXXXGOOOOOXXXXXXXXXXXXXXGOOOOOOOOOXXXXXXXXXXGOOOOOXXXXXXXXXXXXXXGOOXXXXXXXXXXXXXXXXXGOOOOOXXXXXXXXXXXXXXGOOOOOOXXXXXXXXXXXXXGOOOOOOOOOXXXXXXXXXXGOOOOOOOOOOOXXXXXXXXGOOXXXXXXXXXXXXXXXXXGOOOOOXXXXXXXXXXXXXXGOOOOXXXXXXXXXXXXXXXGOOOOOOOOXXXXXXXXXXX,0,600,0
34314,86,0,86,9,405,0,0,412,390,22,GOOXXXXXXXXXXXXXXXXXGOOOOOXXXXXXXXXXXXXXGOOOOOOOOOXXXXXXXXXXGOOOOOXXXXXXXXXXXXXXGOOXXXXXXXXXXXXXXXXXGOOOOOXXXXXXXXXXXXXXGOOOOOOXXXXXXXXXXXXXGOOOOOOOOOXXXXXXXXXXGOOOOOOOOOOOXXXXXXXXGOOXXXXXXXXXXXXXXXXXGOOOOOXXXXXXXXXXXXXXGOOOOXXXXXXXXXXXXXXXGOOOOOOOOXXXXXXXXXXX,0,600,0

34335,86,0,86,10,404,0,0,411,389,22,GOOXXXXXXXXXXXXXXXXXGOOOOOXXXXXXXXXXXXXXGOOOOOOOOOXXXXXXXXXXGOOOOOXXXXXXXXXXXXXXGOOXXXXXXXXXXXXXXXXXGOOOOOXXXXXXXXXXXXXXGOOOOOOXXXXXXXXXXXXXGOOOOOOOOOXXXXXXXXXXGOOOOOOOOOOOXXXXXXXXGOOXXXXXXXXXXXXXXXXXGOOOOOXXXXXXXXXXXXXXGOOOOXXXXXXXXXXXXXXXGOOOOOOOOXXXXXXXXXXX,0,600,0
34356,86,0,86,10,404,0,0,411,391,20,GOOXXXXXXXXXXXXXXXXXGOOOOOXXXXXXXXXXXXXXGOOOOOOOOOXXXXXXXXXXGOOOOOXXXXXXXXXXXXXXGOOXXXXXXXXXXXXXXXXXGOOOOOXXXXXXXXXXXXXXGOOOOOOXXXXXXXXXXXXXGOOOOOOOOOXXXXXXXXXXGOOOOOOOOOOOXXXXXXXXGOOXXXXXXXXXXXXXXXXXGOOOOOXXXXXXXXXXXXXXGOOOOXXXXXXXXXXXXXXXGOOOOOOOOXXXXXXXXXXX,0,600,0
34377,86,0,86,10,404,0,0,411,390,21,GOOXXXXXXXXXXXXXXXXXGOOOOOXXXXXXXXXXXXXXGOOOOOOOOOXXXXXXXXXXGOOOOOXXXXXXXXXXXXXXGOOXXXXXXXXXXXXXXXXXGOOOOOXXXXXXXXXXXXXXGOOOOOOXXXXXXXXXXXXXGOOOOOOOOOXXXXXXXXXXGOOOOOOOOOOOXXXXXXXXGOOXXXXXXXXXXXXXXXXXGOOOOOXXXXXXXXXXXXXXGOOOOXXXXXXXXXXXXXXXGOOOOOOOOXXXXXXXXXXX,0,600,0
34398,87,1,86,8,405,0,0,412,390,22,GOOXXXXXXXXXXXXXXXXXGOOOOOXXXXXXXXXXXXXXGOOOOOOOOOXXXXXXXXXXGOOOOOXXXXXXXXXXXXXXGOOXXXXXXXXXXXXXXXXXGOOOOOAXXXXXXXXXXXXXGOOOOOOXXXXXXXXXXXXXGOOOOOOOOOXXXXXXXXXXGOOOOOOOOOOOXXXXXXXXGOOXXXXXXXXXXXXXXXXXGOOOOOXXXXXXXXXXXXXXGOOOOXXXXXXXXXXXXXXXGOOOOOOOOXXXXXXXXXXX,0,600,0
34419,87,1,86,9,404,0,0,411,390,21,GOOXXXXXXXXXXXXXXXXXGOOOOOXXXXXXXXXXXXXXGOOOOOOOOOXXXXXXXXXXGOOOOOXXXXXXXXXXXXXXGOOXXXXXXXXXXXXXXXXXGOOOOOAXXXXXXXXXXXXXGOOOOOOXXXXXXXXXXXXXGOOOOOOOOOXXXXXXXXXXGOOOOOOOOOOOXXXXXXXXGOOXXXXXXXXXXXXXXXXXGOOOOOXXXXXXXXXXXXXXGOOOOXXXXXXXXXXXXXXXGOOOOOOOOXXXXXXXXXXX,0,600,0

34440,87,1,86,10,403,0,0,410,390,20,GOOXXXXXXXXXXXXXXXXXGOOOOOXXXXXXXXXXXXXXGOOOOOOOOOXXXXXXXXXXGOOOOOXXXXXXXXXXXXXXGOOXXXXXXXXXXXXXXXXXGOOOOOAXXXXXXXXXXXXXGOOOOOOXXXXXXXXXXXXXGOOOOOOOOOXXXXXXXXXXGOOOOOOOOOOOXXXXXXXXGOOXXXXXXXXXXXXXXXXXGOOOOOXXXXXXXXXXXXXXGOOOOXXXXXXXXXXXXXXXGOOOOOOOOXXXXXXXXXXX,0,600,0
34461,87,1,86,9,404,0,0,411,390,21,GOOXXXXXXXXXXXXXXXXXGOOOOOXXXXXXXXXXXXXXGOOOOOOOOOXXXXXXXXXXGOOOOOXXXXXXXXXXXXXXGOOXXXXXXXXXXXXXXXXXGOOOOOAXXXXXXXXXXXXXGOOOOOOXXXXXXXXXXXXXGOOOOOOOOOXXXXXXXXXXGOOOOOOOOOOOXXXXXXXXGOOXXXXXXXXXXXXXXXXXGOOOOOXXXXXXXXXXXXXXGOOOOXXXXXXXXXXXXXXXGOOOOOOOOXXXXXXXXXXX,0,600,0
34482,87,1,86,9,404,0,0,411,390,21,GOOXXXXXXXXXXXXXXXXXGOOOOOXXXXXXXXXXXXXXGOOOOOOOOOXXXXXXXXXXGOOOOOXXXXXXXXXXXXXXGOOXXXXXXXXXXXXXXXXXGOOOOOAXXXXXXXXXXXXXGOOOOOOXXXXXXXXXXXXXGOOOOOOOOOXXXXXXXXXXGOOOOOOOOOOOXXXXXXXXGOOXXXXXXXXXXXXXXXXXGOOOOOXXXXXXXXXXXXXXGOOOOXXXXXXXXXXXXXXXGOOOOOOOOXXXXXXXXXXX,0,600,0
34503,87,1,86,7,406,0,0,413,390,23,GOOXXXXXXXXXXXXXXXXXGOOOOOXXXXXXXXXXXXXXGOOOOOOOOOXXXXXXXXXXGOOOOOXXXXXXXXXXXXXXGOOXXXXXXXXXXXXXXXXXGOOOOOAXXXXXXXXXXXXXGOOOOOOXXXXXXXXXXXXXGOOOOOOOOOXXXXXXXXXXGOOOOOOOOOOOXXXXXXXXGOOXXXXXXXXXXXXXXXXXGOOOOOXXXXXXXXXXXXXXGOOOOXXXXXXXXXXXXXXXGOOOOOOOOXXXXXXXXXXX,0,600,0
34524,87,1,86,7,406,0,0,413,391,22,GOOXXXXXXXXXXXXXXXXXGOOOOOXXXXXXXXXXXXXXGOOOOOOOOOXXXXXXXXXXGOOOOOXXXXXXXXXXXXXXGOOXXXXXXXXXXXXXXXXXGOOOOOAXXXXXXXXXXXXXGOOOOOOXXXXXXXXXXXXXGOOOOOOOOOXXXXXXXXXXGOOOOOOOOOOOXXXXXXXXGOOXXXXXXXXXXXXXXXXXGOOOOOXXXXXXXXXXXXXXGOOOOXXXXXXXXXXXXXXXGOOOOOOOOXXXXXXXXXXX,0,600,0

34545,87,1,86,9,404,0,0,411,391,20,GOOXXXXXXXXXXXXXXXXXGOOOOOXXXXXXXXXXXXXXGOOOOOOOOOXXXXXXXXXXGOOOOOXXXXXXXXXXXXXXGOOXXXXXXXXXXXXXXXXXGOOOOOAXXXXXXXXXXXXXGOOOOOOXXXXXXXXXXXXXGOOOOOOOOOXXXXXXXXXXGOOOOOOOOOOOXXXXXXXXGOOXXXXXXXXXXXXXXXXXGOOOOOXXXXXXXXXXXXXXGOOOOXXXXXXXXXXXXXXXGOOOOOOOOXXXXXXXXXXX,0,600,0
34566,87,0,87,9,404,0,0,411,391,20,GOOXXXXXXXXXXXXXXXXXGOOOOOXXXXXXXXXXXXXXGOOOOOOOOOXXXXXXXXXXGOOOOOXXXXXXXXXXXXXXGOOXXXXXXXXXXXXXXXXXGOOOOOOXXXXXXXXXXXXXGOOOOOOXXXXXXXXXXXXXGOOOOOOOOOXXXXXXXXXXGOOOOOOOOOOOXXXXXXXXGOOXXXXXXXXXXXXXXXXXGOOOOOXXXXXXXXXXXXXXGOOOOXXXXXXXXXXXXXXXGOOOOOOOOXXXXXXXXXXX,0,600,0
34587,87,0,87,11,402,0,0,409,391,18,GOOXXXXXXXXXXXXXXXXXGOOOOOXXXXXXXXXXXXXXGOOOOOOOOOXXXXXXXXXXGOOOOOXXXXXXXXXXXXXXGOOXXXXXXXXXXXXXXXXXGOOOOOOXXXXXXXXXXXXXGOOOOOOXXXXXXXXXXXXXGOOOOOOOOOXXXXXXXXXXGOOOOOOOOOOOXXXXXXXXGOOXXXXXXXXXXXXXXXXXGOOOOOXXXXXXXXXXXXXXGOOOOXXXXXXXXXXXXXXXGOOOOOOOOXXXXXXXXXXX,0,600,0
34608,87,0,87,11,402,0,0,409,391,18,GOOXXXXXXXXXXXXXXXXXGOOOOOXXXXXXXXXXXXXXGOOOOOOOOOXXXXXXXXXXGOOOOOXXXXXXXXXXXXXXGOOXXXXXXXXXXXXXXXXXGOOOOOOXXXXXXXXXXXXXGOOOOOOXXXXXXXXXXXXXGOOOOOOOOOXXXXXXXXXXGOOOOOOOOOOOXXXXXXXXGOOXXXXXXXXXXXXXXXXXGOOOOOXXXXXXXXXXXXXXGOOOOXXXXXXXXXXXXXXXGOOOOOOOOXXXXXXXXXXX,0,600,0
34629,87,0,87,9,404,0,0,411,391,20,GOOXXXXXXXXXXXXXXXXXGOOOOOXXXXXXXXXXXXXXGOOOOOOOOOXXXXXXXXXXGOOOOOXXXXXXXXXXXXXXGOOXXXXXXXXXXXXXXXXXGOOOOOOXXXXXXXXXXXXXGOOOOOOXXXXXXXXXXXXXGOOOOOOOOOXXXXXXXXXXGOOOOOOOOOOOXXXXXXXXGOOXXXXXXXXXXXXXXXXXGOOOOOXXXXXXXXXXXXXXGOOOOXXXXXXXXXXXXXXXGOOOOOOOOXXXXXXXXXXX,0,600,0

34650,87,0,87,11,402,0,0,409,390,19,GOOXXXXXXXXXXXXXXXXXGOOOOOXXXXXXXXXXXXXXGOOOOOOOOOXXXXXXXXXXGOOOOOXXXXXXXXXXXXXXGOOXXXXXXXXXXXXXXXXXGOOOOOOXXXXXXXXXXXXXGOOOOOOXXXXXXXXXXXXXGOOOOOOOOOXXXXXXXXXXGOOOOOOOOOOOXXXXXXXXGOOXXXXXXXXXXXXXXXXXGOOOOOXXXXXXXXXXXXXXGOOOOXXXXXXXXXXXXXXXGOOOOOOOOXXXXXXXXXXX,0,600,0
34671,87,0,87,12,401,0,0,408,390,18,GOOXXXXXXXXXXXXXXXXXGOOOOOXXXXXXXXXXXXXXGOOOOOOOOOXXXXXXXXXXGOOOOOXXXXXXXXXXXXXXGOOXXXXXXXXXXXXXXXXXGOOOOOOXXXXXXXXXXXXXGOOOOOOXXXXXXXXXXXXXGOOOOOOOOOXXXXXXXXXXGOOOOOOOOOOOXXXXXXXXGOOXXXXXXXXXXXXXXXXXGOOOOOXXXXXXXXXXXXXXGOOOOXXXXXXXXXXXXXXXGOOOOOOOOXXXXXXXXXXX,0,600,0
34692,87,0,87,11,402,0,0,409,392,17,GOOXXXXXXXXXXXXXXXXXGOOOOOXXXXXXXXXXXXXXGOOOOOOOOOXXXXXXXXXXGOOOOOXXXXXXXXXXXXXXGOOXXXXXXXXXXXXXXXXXGOOOOOOXXXXXXXXXXXXXGOOOOOOXXXXXXXXXXXXXGOOOOOOOOOXXXXXXXXXXGOOOOOOOOOOOXXXXXXXXGOOXXXXXXXXXXXXXXXXXGOOOOOXXXXXXXXXXXXXXGOOOOXXXXXXXXXXXXXXXGOOOOOOOOXXXXXXXXXXX,0,600,0
34713,87,0,87,11,402,0,0,409,392,17,GOOXXXXXXXXXXXXXXXXXGOOOOOXXXXXXXXXXXXXXGOOOOOOOOOXXXXXXXXXXGOOOOOXXXXXXXXXXXXXXGOOXXXXXXXXXXXXXXXXXGOOOOOOXXXXXXXXXXXXXGOOOOOOXXXXXXXXXXXXXGOOOOOOOOOXXXXXXXXXXGOOOOOOOOOOOXXXXXXXXGOOXXXXXXXXXXXXXXXXXGOOOOOXXXXXXXXXXXXXXGOOOOXXXXXXXXXXXXXXXGOOOOOOOOXXXXXXXXXXX,0,600,0
34734,87,0,87,13,400,0,0,407,392,15,GOOXXXXXXXXXXXXXXXXXGOOOOOXXXXXXXXXXXXXXGOOOOOOOOOXXXXXXXXXXGOOOOOXXXXXXXXXXXXXXGOOXXXXXXXXXXXXXXXXXGOOOOOOXXXXXXXXXXXXXGOOOOOOXXXXXXXXXXXXXGOOOOOOOOOXXXXXXXXXXGOOOOOOOOOOOXXXXXXXXGOOXXXXXXXXXXXXXXXXXGOOOOOXXXXXXXXXXXXXXGOOOOXXXXXXXXXXXXXXXGOOOOOOOOXXXXXXXXXXX,0,600,0

34755,87,0,87,14,399,0,0,406,392,14,GOOXXXXXXXXXXXXXXXXXGOOOOOXXXXXXXXXXXXXXGOOOOOOOOOXXXXXXXXXXGOOOOOXXXXXXXXXXXXXXGOOXXXXXXXXXXXXXXXXXGOOOOOOXXXXXXXXXXXXXGOOOOOOXXXXXXXXXXXXXGOOOOOOOOOXXXXXXXXXXGOOOOOOOOOOOXXXXXXXXGOOXXXXXXXXXXXXXXXXXGOOOOOXXXXXXXXXXXXXXGOOOOXXXXXXXXXXXXXXXGOOOOOOOOXXXXXXXXXXX,0,600,0
34776,87,0,87,16,397,0,0,404,390,14,GOOXXXXXXXXXXXXXXXXXGOOOOOXXXXXXXXXXXXXXGOOOOOOOOOXXXXXXXXXXGOOOOOXXXXXXXXXXXXXXGOOXXXXXXXXXXXXXXXXXGOOOOOOXXXXXXXXXXXXXGOOOOOOXXXXXXXXXXXXXGOOOOOOOOOXXXXXXXXXXGOOOOOOOOOOOXXXXXXXXGOOXXXXXXXXXXXXXXXXXGOOOOOXXXXXXXXXXXXXXGOOOOXXXXXXXXXXXXXXXGOOOOOOOOXXXXXXXXXXX,0,600,0
34797,87,0,87,14,399,0,0,406,390,16,GOOXXXXXXXXXXXXXXXXXGOOOOOXXXXXXXXXXXXXXGOOOOOOOOOXXXXXXXXXXGOOOOOXXXXXXXXXXXXXXGOOXXXXXXXXXXXXXXXXXGOOOOOOXXXXXXXXXXXXXGOOOOOOXXXXXXXXXXXXXGOOOOOOOOOXXXXXXXXXXGOOOOOOOOOOOXXXXXXXXGOOXXXXXXXXXXXXXXXXXGOOOOOXXXXXXXXXXXXXXGOOOOXXXXXXXXXXXXXXXGOOOOOOOOXXXXXXXXXXX,0,600,0
34818,87,0,87,13,400,0,0,407,392,15,GOOXXXXXXXXXXXXXXXXXGOOOOOXXXXXXXXXXXXXXGOOOOOOOOOXXXXXXXXXXGOOOOOXXXXXXXXXXXXXXGOOXXXXXXXXXXXXXXXXXGOOOOOOXXXXXXXXXXXXXGOOOOOOXXXXXXXXXXXXXGOOOOOOOOOXXXXXXXXXXGOOOOOOOOOOOXXXXXXXXGOOXXXXXXXXXXXXXXXXXGOOOOOXXXXXXXXXXXXXXGOOOOXXXXXXXXXXXXXXXGOOOOOOOOXXXXXXXXXXX,0,600,0
34839,87,0,87,12,401,0,0,408,390,18,GOOXXXXXXXXXXXXXXXXXGOOOOOXXXXXXXXXXXXXXGOOOOOOOOOXXXXXXXXXXGOOOOOXXXXXXXXXXXXXXGOOXXXXXXXXXXXXXXXXXGOOOOOOXXXXXXXXXXXXXGOOOOOOXXXXXXXXXXXXXGOOOOOOOOOXXXXXXXXXXGOOOOOOOOOOOXXXXXXXXGOOXXXXXXXXXXXXXXXXXGOOOOOXXXXXXXXXXXXXXGOOOOXXXXXXXXXXXXXXXGOOOOOOOOXXXXXXXXXXX,0,600,0

34860,87,0,87,11,402,0,0,409,391,18,GOOXXXXXXXXXXXXXXXXXGOOOOOXXXXXXXXXXXXXXGOOOOOOOOOXXXXXXXXXXGOOOOOXXXXXXXXXXXXXXGOOXXXXXXXXXXXXXXXXXGOOOOOOXXXXXXXXXXXXXGOOOOOOXXXXXXXXXXXXXGOOOOOOOOOXXXXXXXXXXGOOOOOOOOOOOXXXXXXXXGOOXXXXXXXXXXXXXXXXXGOOOOOXXXXXXXXXXXXXXGOOOOXXXXXXXXXXXXXXXGOOOOOOOOXXXXXXXXXXX,0,600,0
34881,87,0,87,10,403,0,0,410,390,20,GOOXXXXXXXXXXXXXXXXXGOOOOOXXXXXXXXXXXXXXGOOOOOOOOOXXXXXXXXXXGOOOOOXXXXXXXXXXXXXXGOOXXXXXXXXXXXXXXXXXGOOOOOOXXXXXXXXXXXXXGOOOOOOXXXXXXXXXXXXXGOOOOOOOOOXXXXXXXXXXGOOOOOOOOOOOXXXXXXXXGOOXXXXXXXXXXXXXXXXXGOOOOOXXXXXXXXXXXXXXGOOOOXXXXXXXXXXXXXXXGOOOOOOOOXXXXXXXXXXX,0,600,0
34902,87,0,87,7,406,0,0,413,390,23,GOOXXXXXXXXXXXXXXXXXGOOOOOXXXXXXXXXXXXXXGOOOOOOOOOXXXXXXXXXXGOOOOOXXXXXXXXXXXXXXGOOXXXXXXXXXXXXXXXXXGOOOOOOXXXXXXXXXXXXXGOOOOOOXXXXXXXXXXXXXGOOOOOOOOOXXXXXXXXXXGOOOOOOOOOOOXXXXXXXXGOOXXXXXXXXXXXXXXXXXGOOOOOXXXXXXXXXXXXXXGOOOOXXXXXXXXXXXXXXXGOOOOOOOOXXXXXXXXXXX,0,600,0
34923,87,0,87,7,406,0,0,413,390,23,GOOXXXXXXXXXXXXXXXXXGOOOOOXXXXXXXXXXXXXXGOOOOOOOOOXXXXXXXXXXGOOOOOXXXXXXXXXXXXXXGOOXXXXXXXXXXXXXXXXXGOOOOOOXXXXXXXXXXXXXGOOOOOOXXXXXXXXXXXXXGOOOOOOOOOXXXXXXXXXXGOOOOOOOOOOOXXXXXXXXGOOXXXXXXXXXXXXXXXXXGOOOOOXXXXXXXXXXXXXXGOOOOXXXXXXXXXXXXXXXGOOOOOOOOXXXXXXXXXXX,0,600,0
34944,87,0,87,5,408,0,0,415,390,25,GOOXXXXXXXXXXXXXXXXXGOOOOOXXXXXXXXXXXXXXGOOOOOOOOOXXXXXXXXXXGOOOOOXXXXXXXXXXXXXXGOOXXXXXXXXXXXXXXXXXGOOOOOOXXXXXXXXXXXXXGOOOOOOXXXXXXXXXXXXXGOOOOOOOOOXXXXXXXXXXGOOOOOOOOOOOXXXXXXXXGOOXXXXXXXXXXXXXXXXXGOOOOOXXXXXXXXXXXXXXGOOOOXXXXXXXXXXXXXXXGOOOOOOOOXXXXXXXXXXX,0,600,0

34965,87,0,87,4,409,0,0,416,391,25,GOOXXXXXXXXXXXXXXXXXGOOOOOXXXXXXXXXXXXXXGOOOOOOOOOXXXXXXXXXXGOOOOOXXXXXXXXXXXXXXGOOXXXXXXXXXXXXXXXXXGOOOOOOXXXXXXXXXXXXXGOOOOOOXXXXXXXXXXXXXGOOOOOOOOOXXXXXXXXXXGOOOOOOOOOOOXXXXXXXXGOOXXXXXXXXXXXXXXXXXGOOOOOXXXXXXXXXXXXXXGOOOOXXXXXXXXXXXXXXXGOOOOOOOOXXXXXXXXXXX,0,600,0
34986,87,0,87,6,407,0,0,414,390,24,GOOXXXXXXXXXXXXXXXXXGOOOOOXXXXXXXXXXXXXXGOOOOOOOOOXXXXXXXXXXGOOOOOXXXXXXXXXXXXXXGOOXXXXXXXXXXXXXXXXXGOOOOOOXXXXXXXXXXXXXGOOOOOOXXXXXXXXXXXXXGOOOOOOOOOXXXXXXXXXXGOOOOOOOOOOOXXXXXXXXGOOXXXXXXXXXXXXXXXXXGOOOOOXXXXXXXXXXXXXXGOOOOXXXXXXXXXXXXXXXGOOOOOOOOXXXXXXXXXXX,0,600,0
35007,87,0,87,5,408,0,0,415,390,25,GOOXXXXXXXXXXXXXXXXXGOOOOOXXXXXXXXXXXXXXGOOOOOOOOOXXXXXXXXXXGOOOOOXXXXXXXXXXXXXXGOOXXXXXXXXXXXXXXXXXGOOOOOOXXXXXXXXXXXXXGOOOOOOXXXXXXXXXXXXXGOOOOOOOOOXXXXXXXXXXGOOOOOOOOOOOXXXXXXXXGOOXXXXXXXXXXXXXXXXXGOOOOOXXXXXXXXXXXXXXGOOOOXXXXXXXXXXXXXXXGOOOOOOOOXXXXXXXXXXX,0,600,0
35028,87,0,87,4,409,0,0,416,392,24,GOOXXXXXXXXXXXXXXXXXGOOOOOXXXXXXXXXXXXXXGOOOOOOOOOXXXXXXXXXXGOOOOOXXXXXXXXXXXXXXGOOXXXXXXXXXXXXXXXXXGOOOOOOXXXXXXXXXXXXXGOOOOOOXXXXXXXXXXXXXGOOOOOOOOOXXXXXXXXXXGOOOOOOOOOOOXXXXXXXXGOOXXXXXXXXXXXXXXXXXGOOOOOXXXXXXXXXXXXXXGOOOOXXXXXXXXXXXXXXXGOOOOOOOOXXXXXXXXXXX,0,600,0
35049,87,0,87,4,409,0,0,414,390,24,GOOXXXXXXXXXXXXXXXXXGOOOOOXXXXXXXXXXXXXXGOOOOOOOOOXXXXXXXXXXGOOOOOXXXXXXXXXXXXXXGOOXXXXXXXXXXXXXXXXXGOOOOOOXXXXXXXXXXXXXGOOOOOOXXXXXXXXXXXXXGOOOOOOOOOXXXXXXXXXXGOOOOOOOOOOOXXXXXXXXGOOXXXXXXXXXXXXXXXXXGOOOOOXXXXXXXXXXXXXXGOOOOXXXXXXXXXXXXXXXGOOOOOOOOXXXXXXXXXXX,0,600,0

35070,87,0,87,5,408,0,0,415,391,24,GOOXXXXXXXXXXXXXXXXXGOOOOOXXXXXXXXXXXXXXGOOOOOOOOOXXXXXXXXXXGOOOOOXXXXXXXXXXXXXXGOOXXXXXXXXXXXXXXXXXGOOOOOOXXXXXXXXXXXXXGOOOOOOXXXXXXXXXXXXXGOOOOOOOOOXXXXXXXXXXGOOOOOOOOOOOXXXXXXXXGOOXXXXXXXXXXXXXXXXXGOOOOOXXXXXXXXXXXXXXGOOOOXXXXXXXXXXXXXXXGOOOOOOOOXXXXXXXXXXX,0,600,0
35091,87,0,87,7,406,0,0,413,390,23,GOOXXXXXXXXXXXXXXXXXGOOOOOXXXXXXXXXXXXXXGOOOOOOOOOXXXXXXXXXXGOOOOOXXXXXXXXXXXXXXGOOXXXXXXXXXXXXXXXXXGOOOOOOXXXXXXXXXXXXXGOOOOOOXXXXXXXXXXXXXGOOOOOOOOOXXXXXXXXXXGOOOOOOOOOOOXXXXXXXXGOOXXXXXXXXXXXXXXXXXGOOOOOXXXXXXXXXXXXXXGOOOOXXXXXXXXXXXXXXXGOOOOOOOOXXXXXXXXXXX,0,600,0
35112,87,0,87,8,405,0,0,412,392,20,GOOXXXXXXXXXXXXXXXXXGOOOOOXXXXXXXXXXXXXXGOOOOOOOOOXXXXXXXXXXGOOOOOXXXXXXXXXXXXXXGOOXXXXXXXXXXXXXXXXXGOOOOOOXXXXXXXXXXXXXGOOOOOOXXXXXXXXXXXXXGOOOOOOOOOXXXXXXXXXXGOOOOOOOOOOOXXXXXXXXGOOXXXXXXXXXXXXXXXXXGOOOOOXXXXXXXXXXXXXXGOOOOXXXXXXXXXXXXXXXGOOOOOOOOXXXXXXXXXXX,0,600,0
35133,87,0,87,10,403,0,0,410,394,16,GOOXXXXXXXXXXXXXXXXXGOOOOOXXXXXXXXXXXXXXGOOOOOOOOOXXXXXXXXXXGOOOOOXXXXXXXXXXXXXXGOOXXXXXXXXXXXXXXXXXGOOOOOOXXXXXXXXXXXXXGOOOOOOXXXXXXXXXXXXXGOOOOOOOOOXXXXXXXXXXGOOOOOOOOOOOXXXXXXXXGOOXXXXXXXXXXXXXXXXXGOOOOOXXXXXXXXXXXXXXGOOOOXXXXXXXXXXXXXXXGOOOOOOOOXXXXXXXXXXX,0,600,0
35154,87,0,87,12,401,0,0,408,391,17,GOOXXXXXXXXXXXXXXXXXGOOOOOXXXXXXXXXXXXXXGOOOOOOOOOXXXXXXXXXXGOOOOOXXXXXXXXXXXXXXGOOXXXXXXXXXXXXXXXXXGOOOOOOXXXXXXXXXXXXXGOOOOOOXXXXXXXXXXXXXGOOOOOOOOOXXXXXXXXXXGOOOOOOOOOOOXXXXXXXXGOOXXXXXXXXXXXXXXXXXGOOOOOXXXXXXXXXXXXXXGOOOOXXXXXXXXXXXXXXXGOOOOOOOOXXXXXXXXXXX,0,600,0

35175,87,0,87,11,402,0,0,409,391,18,GOOXXXXXXXXXXXXXXXXXGOOOOOXXXXXXXXXXXXXXGOOOOOOOOOXXXXXXXXXXGOOOOOXXXXXXXXXXXXXXGOOXXXXXXXXXXXXXXXXXGOOOOOOXXXXXXXXXXXXXGOOOOOOXXXXXXXXXXXXXGOOOOOOOOOXXXXXXXXXXGOOOOOOOOOOOXXXXXXXXGOOXXXXXXXXXXXXXXXXXGOOOOOXXXXXXXXXXXXXXGOOOOXXXXXXXXXXXXXXXGOOOOOOOOXXXXXXXXXXX,0,600,0
35196,87,0,87,9,404,0,0,411,390,21,GOOXXXXXXXXXXXXXXXXXGOOOOOXXXXXXXXXXXXXXGOOOOOOOOOXXXXXXXXXXGOOOOOXXXXXXXXXXXXXXGOOXXXXXXXXXXXXXXXXXGOOOOOOXXXXXXXXXXXXXGOOOOOOXXXXXXXXXXXXXGOOOOOOOOOXXXXXXXXXXGOOOOOOOOOOOXXXXXXXXGOOXXXXXXXXXXXXXXXXXGOOOOOXXXXXXXXXXXXXXGOOOOXXXXXXXXXXXXXXXGOOOOOOOOXXXXXXXXXXX,0,600,0
35217,87,0,87,9,404,0,0,411,390,21,GOOXXXXXXXXXXXXXXXXXGOOOOOXXXXXXXXXXXXXXGOOOOOOOOOXXXXXXXXXXGOOOOOXXXXXXXXXXXXXXGOOXXXXXXXXXXXXXXXXXGOOOOOOXXXXXXXXXXXXXGOOOOOOXXXXXXXXXXXXXGOOOOOOOOOXXXXXXXXXXGOOOOOOOOOOOXXXXXXXXGOOXXXXXXXXXXXXXXXXXGOOOOOXXXXXXXXXXXXXXGOOOOXXXXXXXXXXXXXXXGOOOOOOOOXXXXXXXXXXX,0,600,0
35238,87,0,87,7,406,0,0,413,391,22,GOOXXXXXXXXXXXXXXXXXGOOOOOXXXXXXXXXXXXXXGOOOOOOOOOXXXXXXXXXXGOOOOOXXXXXXXXXXXXXXGOOXXXXXXXXXXXXXXXXXGOOOOOOXXXXXXXXXXXXXGOOOOOOXXXXXXXXXXXXXGOOOOOOOOOXXXXXXXXXXGOOOOOOOOOOOXXXXXXXXGOOXXXXXXXXXXXXXXXXXGOOOOOXXXXXXXXXXXXXXGOOOOXXXXXXXXXXXXXXXGOOOOOOOOXXXXXXXXXXX,0,600,0
35259,87,0,87,7,406,0,0,413,391,22,GOOXXXXXXXXXXXXXXXXXGOOOOOXXXXXXXXXXXXXXGOOOOOOOOOXXXXXXXXXXGOOOOOXXXXXXXXXXXXXXGOOXXXXXXXXXXXXXXXXXGOOOOOOXXXXXXXXXXXXXGOOOOOOXXXXXXXXXXXXXGOOOOOOOOOXXXXXXXXXXGOOOOOOOOOOOXXXXXXXXGOOXXXXXXXXXXXXXXXXXGOOOOOXXXXXXXXXXXXXXGOOOOXXXXXXXXXXXXXXXGOOOOOOOOXXXXXXXXXXX,0,600,0

35280,87,0,87,8,405,0,0,412,393,19,GOOXXXXXXXXXXXXXXXXXGOOOOOXXXXXXXXXXXXXXGOOOOOOOOOXXXXXXXXXXGOOOOOXXXXXXXXXXXXXXGOOXXXXXXXXXXXXXXXXXGOOOOOOXXXXXXXXXXXXXGOOOOOOXXXXXXXXXXXXXGOOOOOOOOOXXXXXXXXXXGOOOOOOOOOOOXXXXXXXXGOOXXXXXXXXXXXXXXXXXGOOOOOXXXXXXXXXXXXXXGOOOOXXXXXXXXXXXXXXXGOOOOOOOOXXXXXXXXXXX,0,600,0
35301,87,0,87,11,402,0,0,409,393,16,GOOXXXXXXXXXXXXXXXXXGOOOOOXXXXXXXXXXXXXXGOOOOOOOOOXXXXXXXXXXGOOOOOXXXXXXXXXXXXXXGOOXXXXXXXXXXXXXXXXXGOOOOOOXXXXXXXXXXXXXGOOOOOOXXXXXXXXXXXXXGOOOOOOOOOXXXXXXXXXXGOOOOOOOOOOOXXXXXXXXGOOXXXXXXXXXXXXXXXXXGOOOOOXXXXXXXXXXXXXXGOOOOXXXXXXXXXXXXXXXGOOOOOOOOXXXXXXXXXXX,0,600,0
35322,87,0,87,11,402,0,0,409,393,16,GOOXXXXXXXXXXXXXXXXXGOOOOOXXXXXXXXXXXXXXGOOOOOOOOOXXXXXXXXXXGOOOOOXXXXXXXXXXXXXXGOOXXXXXXXXXXXXXXXXXGOOOOOOXXXXXXXXXXXXXGOOOOOOXXXXXXXXXXXXXGOOOOOOOOOXXXXXXXXXXGOOOOOOOOOOOXXXXXXXXGOOXXXXXXXXXXXXXXXXXGOOOOOXXXXXXXXXXXXXXGOOOOXXXXXXXXXXXXXXXGOOOOOOOOXXXXXXXXXXX,0,600,0
35343,87,0,87,11,402,0,0,409,393,16,GOOXXXXXXXXXXXXXXXXXGOOOOOXXXXXXXXXXXXXXGOOOOOOOOOXXXXXXXXXXGOOOOOXXXXXXXXXXXXXXGOOXXXXXXXXXXXXXXXXXGOOOOOOXXXXXXXXXXXXXGOOOOOOXXXXXXXXXXXXXGOOOOOOOOOXXXXXXXXXXGOOOOOOOOOOOXXXXXXXXGOOXXXXXXXXXXXXXXXXXGOOOOOXXXXXXXXXXXXXXGOOOOXXXXXXXXXXXXXXXGOOOOOOOOXXXXXXXXXXX,0,600,0
35364,87,0,87,13,400,0,0,407,392,15,GOOXXXXXXXXXXXXXXXXXGOOOOOXXXXXXXXXXXXXXGOOOOOOOOOXXXXXXXXXXGOOOOOXXXXXXXXXXXXXXGOOXXXXXXXXXXXXXXXXXGOOOOOOXXXXXXXXXXXXXGOOOOOOXXXXXXXXXXXXXGOOOOOOOOOXXXXXXXXXXGOOOOOOOOOOOXXXXXXXXGOOXXXXXXXXXXXXXXXXXGOOOOOXXXXXXXXXXXXXXGOOOOXXXXXXXXXXXXXXXGOOOOOOOOXXXXXXXXXXX,0,600,0

35385,87,0,87,14,399,0,0,406,391,15,GOOXXXXXXXXXXXXXXXXXGOOOOOXXXXXXXXXXXXXXGOOOOOOOOOXXXXXXXXXXGOOOOOXXXXXXXXXXXXXXGOOXXXXXXXXXXXXXXXXXGOOOOOOXXXXXXXXXXXXXGOOOOOOXXXXXXXXXXXXXGOOOOOOOOOXXXXXXXXXXGOOOOOOOOOOOXXXXXXXXGOOXXXXXXXXXXXXXXXXXGOOOOOXXXXXXXXXXXXXXGOOOOXXXXXXXXXXXXXXXGOOOOOOOOXXXXXXXXXXX,0,600,0
35406,87,0,87,15,398,0,0,405,391,14,GOOXXXXXXXXXXXXXXXXXGOOOOOXXXXXXXXXXXXXXGOOOOOOOOOXXXXXXXXXXGOOOOOXXXXXXXXXXXXXXGOOXXXXXXXXXXXXXXXXXGOOOOOOXXXXXXXXXXXXXGOOOOOOXXXXXXXXXXXXXGOOOOOOOOOXXXXXXXXXXGOOOOOOOOOOOXXXXXXXXGOOXXXXXXXXXXXXXXXXXGOOOOOXXXXXXXXXXXXXXGOOOOXXXXXXXXXXXXXXXGOOOOOOOOXXXXXXXXXXX,0,600,0
35427,87,0,87,13,400,0,0,407,391,16,GOOXXXXXXXXXXXXXXXXXGOOOOOXXXXXXXXXXXXXXGOOOOOOOOOXXXXXXXXXXGOOOOOXXXXXXXXXXXXXXGOOXXXXXXXXXXXXXXXXXGOOOOOOXXXXXXXXXXXXXGOOOOOOXXXXXXXXXXXXXGOOOOOOOOOXXXXXXXXXXGOOOOOOOOOOOXXXXXXXXGOOXXXXXXXXXXXXXXXXXGOOOOOXXXXXXXXXXXXXXGOOOOXXXXXXXXXXXXXXXGOOOOOOOOXXXXXXXXXXX,0,600,0
35448,87,0,87,12,401,0,0,408,392,16,GOOXXXXXXXXXXXXXXXXXGOOOOOXXXXXXXXXXXXXXGOOOOOOOOOXXXXXXXXXXGOOOOOXXXXXXXXXXXXXXGOOXXXXXXXXXXXXXXXXXGOOOOOOXXXXXXXXXXXXXGOOOOOOXXXXXXXXXXXXXGOOOOOOOOOXXXXXXXXXXGOOOOOOOOOOOXXXXXXXXGOOXXXXXXXXXXXXXXXXXGOOOOOXXXXXXXXXXXXXXGOOOOXXXXXXXXXXXXXXXGOOOOOOOOXXXXXXXXXXX,0,600,0
35469,87,0,87,12,401,0,0,408,391,17,GOOXXXXXXXXXXXXXXXXXGOOOOOXXXXXXXXXXXXXXGOOOOOOOOOXXXXXXXXXXGOOOOOXXXXXXXXXXXXXXGOOXXXXXXXXXXXXXXXXXGOOOOOOXXXXXXXXXXXXXGOOOOOOXXXXXXXXXXXXXGOOOOOOOOOXXXXXXXXXXGOOOOOOOOOOOXXXXXXXXGOOXXXXXXXXXXXXXXXXXGOOOOOXXXXXXXXXXXXXXGOOOOXXXXXXXXXXXXXXXGOOOOOOOOXXXXXXXXXXX,0,600,0

35490,87,0,87,11,402,0,0,409,390,19,GOOXXXXXXXXXXXXXXXXXGOOOOOXXXXXXXXXXXXXXGOOOOOOOOOXXXXXXXXXXGOOOOOXXXXXXXXXXXXXXGOOXXXXXXXXXXXXXXXXXGOOOOOOXXXXXXXXXXXXXGOOOOOOXXXXXXXXXXXXXGOOOOOOOOOXXXXXXXXXXGOOOOOOOOOOOXXXXXXXXGOOXXXXXXXXXXXXXXXXXGOOOOOXXXXXXXXXXXXXXGOOOOXXXXXXXXXXXXXXXGOOOOOOOOXXXXXXXXXXX,0,600,0
35511,87,0,87,10,403,0,0,410,390,20,GOOXXXXXXXXXXXXXXXXXGOOOOOXXXXXXXXXXXXXXGOOOOOOOOOXXXXXXXXXXGOOOOOXXXXXXXXXXXXXXGOOXXXXXXXXXXXXXXXXXGOOOOOOXXXXXXXXXXXXXGOOOOOOXXXXXXXXXXXXXGOOOOOOOOOXXXXXXXXXXGOOOOOOOOOOOXXXXXXXXGOOXXXXXXXXXXXXXXXXXGOOOOOXXXXXXXXXXXXXXGOOOOXXXXXXXXXXXXXXXGOOOOOOOOXXXXXXXXXXX,0,600,0
35532,87,0,87,10,403,0,0,410,390,20,GOOXXXXXXXXXXXXXXXXXGOOOOOXXXXXXXXXXXXXXGOOOOOOOOOXXXXXXXXXXGOOOOOXXXXXXXXXXXXXXGOOXXXXXXXXXXXXXXXXXGOOOOOOXXXXXXXXXXXXXGOOOOOOXXXXXXXXXXXXXGOOOOOOOOOXXXXXXXXXXGOOOOOOOOOOOXXXXXXXXGOOXXXXXXXXXXXXXXXXXGOOOOOXXXXXXXXXXXXXXGOOOOXXXXXXXXXXXXXXXGOOOOOOOOXXXXXXXXXXX,0,600,0
35553,87,0,87,7,406,0,0,413,390,23,GOOXXXXXXXXXXXXXXXXXGOOOOOXXXXXXXXXXXXXXGOOOOOOOOOXXXXXXXXXXGOOOOOXXXXXXXXXXXXXXGOOXXXXXXXXXXXXXXXXXGOOOOOOXXXXXXXXXXXXXGOOOOOOXXXXXXXXXXXXXGOOOOOOOOOXXXXXXXXXXGOOOOOOOOOOOXXXXXXXXGOOXXXXXXXXXXXXXXXXXGOOOOOXXXXXXXXXXXXXXGOOOOXXXXXXXXXXXXXXXGOOOOOOOOXXXXXXXXXXX,0,600,0
35574,87,0,87,8,405,0,0,412,390,22,GOOXXXXXXXXXXXXXXXXXGOOOOOXXXXXXXXXXXXXXGOOOOOOOOOXXXXXXXXXXGOOOOOXXXXXXXXXXXXXXGOOXXXXXXXXXXXXXXXXXGOOOOOOXXXXXXXXXXXXXGOOOOOOXXXXXXXXXXXXXGOOOOOOOOOXXXXXXXXXXGOOOOOOOOOOOXXXXXXXXGOOXXXXXXXXXXXXXXXXXGOOOOOXXXXXXXXXXXXXXGOOOOXXXXXXXXXXXXXXXGOOOOOOOOXXXXXXXXXXX,0,600,0

35595,87,0,87,6,407,0,0,413,390,23,GOOXXXXXXXXXXXXXXXXXGOOOOOXXXXXXXXXXXXXXGOOOOOOOOOXXXXXXXXXXGOOOOOXXXXXXXXXXXXXXGOOXXXXXXXXXXXXXXXXXGOOOOOOXXXXXXXXXXXXXGOOOOOOXXXXXXXXXXXXXGOOOOOOOOOXXXXXXXXXXGOOOOOOOOOOOXXXXXXXXGOOXXXXXXXXXXXXXXXXXGOOOOOXXXXXXXXXXXXXXGOOOOXXXXXXXXXXXXXXXGOOOOOOOOXXXXXXXXXXX,0,600,0
35616,87,0,87,6,407,0,0,414,391,23,GOOXXXXXXXXXXXXXXXXXGOOOOOXXXXXXXXXXXXXXGOOOOOOOOOXXXXXXXXXXGOOOOOXXXXXXXXXXXXXXGOOXXXXXXXXXXXXXXXXXGOOOOOOXXXXXXXXXXXXXGOOOOOOXXXXXXXXXXXXXGOOOOOOOOOXXXXXXXXXXGOOOOOOOOOOOXXXXXXXXGOOXXXXXXXXXXXXXXXXXGOOOOOXXXXXXXXXXXXXXGOOOOXXXXXXXXXXXXXXXGOOOOOOOOXXXXXXXXXXX,0,600,0
35637,87,0,87,6,407,0,0,414,392,22,GOOXXXXXXXXXXXXXXXXXGOOOOOXXXXXXXXXXXXXXGOOOOOOOOOXXXXXXXXXXGOOOOOXXXXXXXXXXXXXXGOOXXXXXXXXXXXXXXXXXGOOOOOOXXXXXXXXXXXXXGOOOOOOXXXXXXXXXXXXXGOOOOOOOOOXXXXXXXXXXGOOOOOOOOOOOXXXXXXXXGOOXXXXXXXXXXXXXXXXXGOOOOOXXXXXXXXXXXXXXGOOOOXXXXXXXXXXXXXXXGOOOOOOOOXXXXXXXXXXX,0,600,0
35658,87,0,87,6,407,0,0,414,392,22,GOOXXXXXXXXXXXXXXXXXGOOOOOXXXXXXXXXXXXXXGOOOOOOOOOXXXXXXXXXXGOOOOOXXXXXXXXXXXXXXGOOXXXXXXXXXXXXXXXXXGOOOOOOXXXXXXXXXXXXXGOOOOOOXXXXXXXXXXXXXGOOOOOOOOOXXXXXXXXXXGOOOOOOOOOOOXXXXXXXXGOOXXXXXXXXXXXXXXXXXGOOOOOXXXXXXXXXXXXXXGOOOOXXXXXXXXXXXXXXXGOOOOOOOOXXXXXXXXXXX,0,600,0
35679,87,0,87,8,405,0,0,412,391,21,GOOXXXXXXXXXXXXXXXXXGOOOOOXXXXXXXXXXXXXXGOOOOOOOOOXXXXXXXXXXGOOOOOXXXXXXXXXXXXXXGOOXXXXXXXXXXXXXXXXXGOOOOOOXXXXXXXXXXXXXGOOOOOOXXXXXXXXXXXXXGOOOOOOOOOXXXXXXXXXXGOOOOOOOOOOOXXXXXXXXGOOXXXXXXXXXXXXXXXXXGOOOOOXXXXXXXXXXXXXXGOOOOXXXXXXXXXXXXXXXGOOOOOOOOXXXXXXXXXXX,0,600,0

35700,87,0,87,7,406,0,0,413,393,20,GOOXXXXXXXXXXXXXXXXXGOOOOOXXXXXXXXXXXXXXGOOOOOOOOOXXXXXXXXXXGOOOOOXXXXXXXXXXXXXXGOOXXXXXXXXXXXXXXXXXGOOOOOOXXXXXXXXXXXXXGOOOOOOXXXXXXXXXXXXXGOOOOOOOOOXXXXXXXXXXGOOOOOOOOOOOXXXXXXXXGOOXXXXXXXXXXXXXXXXXGOOOOOXXXXXXXXXXXXXXGOOOOXXXXXXXXXXXXXXXGOOOOOOOOXXXXXXXXXXX,0,600,0
35721,87,0,87,6,407,0,0,414,393,21,GOOXXXXXXXXXXXXXXXXXGOOOOOXXXXXXXXXXXXXXGOOOOOOOOOXXXXXXXXXXGOOOOOXXXXXXXXXXXXXXGOOXXXXXXXXXXXXXXXXXGOOOOOOXXXXXXXXXXXXXGOOOOOOXXXXXXXXXXXXXGOOOOOOOOOXXXXXXXXXXGOOOOOOOOOOOXXXXXXXXGOOXXXXXXXXXXXXXXXXXGOOOOOXXXXXXXXXXXXXXGOOOOXXXXXXXXXXXXXXXGOOOOOOOOXXXXXXXXXXX,0,600,0
35742,87,0,87,6,407,0,0,414,392,22,GOOXXXXXXXXXXXXXXXXXGOOOOOXXXXXXXXXXXXXXGOOOOOOOOOXXXXXXXXXXGOOOOOXXXXXXXXXXXXXXGOOXXXXXXXXXXXXXXXXXGOOOOOOXXXXXXXXXXXXXGOOOOOOXXXXXXXXXXXXXGOOOOOOOOOXXXXXXXXXXGOOOOOOOOOOOXXXXXXXXGOOXXXXXXXXXXXXXXXXXGOOOOOXXXXXXXXXXXXXXGOOOOXXXXXXXXXXXXXXXGOOOOOOOOXXXXXXXXXXX,0,600,0
35763,87,0,87,4,409,0,0,416,392,24,GOOXXXXXXXXXXXXXXXXXGOOOOOXXXXXXXXXXXXXXGOOOOOOOOOXXXXXXXXXXGOOOOOXXXXXXXXXXXXXXGOOXXXXXXXXXXXXXXXXXGOOOOOOXXXXXXXXXXXXXGOOOOOOXXXXXXXXXXXXXGOOOOOOOOOXXXXXXXXXXGOOOOOOOOOOOXXXXXXXXGOOXXXXXXXXXXXXXXXXXGOOOOOXXXXXXXXXXXXXXGOOOOXXXXXXXXXXXXXXXGOOOOOOOOXXXXXXXXXXX,0,600,0
35784,88,1,87,2,410,0,0,417,394,23,GOOXXXXXXXXXXXXXXXXXGOOOOOXXXXXXXXXXXXXXGOOOOOOOOOXXXXXXXXXXGOOOOOXXXXXXXXXXXXXXGOOXXXXXXXXXXXXXXXXXGOOOOOOXXXXXXXXXXXXXGOOOOOOXXXXXXXXXXXXXGOOOOOOOOOXXXXXXXXXXGOOOOOOOOOOOXXXXXXXXGOOXXXXXXXXXXXXXXXXXGOOOOOXXXXXXXXXXXXXXGOOOOAXXXXXXXXXXXXXXGOOOOOOOOXXXXXXXXXXX,0,600,0

35805,88,1,87,5,407,0,0,414,394,20,GOOXXXXXXXXXXXXXXXXXGOOOOOXXXXXXXXXXXXXXGOOOOOOOOOXXXXXXXXXXGOOOOOXXXXXXXXXXXXXXGOOXXXXXXXXXXXXXXXXXGOOOOOOXXXXXXXXXXXXXGOOOOOOXXXXXXXXXXXXXGOOOOOOOOOXXXXXXXXXXGOOOOOOOOOOOXXXXXXXXGOOXXXXXXXXXXXXXXXXXGOOOOOXXXXXXXXXXXXXXGOOOOAXXXXXXXXXXXXXXGOOOOOOOOXXXXXXXXXXX,0,600,0
35826,88,1,87,2,410,0,0,417,394,23,GOOXXXXXXXXXXXXXXXXXGOOOOOXXXXXXXXXXXXXXGOOOOOOOOOXXXXXXXXXXGOOOOOXXXXXXXXXXXXXXGOOXXXXXXXXXXXXXXXXXGOOOOOOXXXXXXXXXXXXXGOOOOOOXXXXXXXXXXXXXGOOOOOOOOOXXXXXXXXXXGOOOOOOOOOOOXXXXXXXXGOOXXXXXXXXXXXXXXXXXGOOOOOXXXXXXXXXXXXXXGOOOOAXXXXXXXXXXXXXXGOOOOOOOOXXXXXXXXXXX,0,600,0
35847,88,1,87,4,408,0,0,415,393,22,GOOXXXXXXXXXXXXXXXXXGOOOOOXXXXXXXXXXXXXXGOOOOOOOOOXXXXXXXXXXGOOOOOXXXXXXXXXXXXXXGOOXXXXXXXXXXXXXXXXXGOOOOOOXXXXXXXXXXXXXGOOOOOOXXXXXXXXXXXXXGOOOOOOOOOXXXXXXXXXXGOOOOOOOOOOOXXXXXXXXGOOXXXXXXXXXXXXXXXXXGOOOOOXXXXXXXXXXXXXXGOOOOAXXXXXXXXXXXXXXGOOOOOOOOXXXXXXXXXXX,0,600,0
35868,88,1,87,6,406,0,0,413,393,20,GOOXXXXXXXXXXXXXXXXXGOOOOOXXXXXXXXXXXXXXGOOOOOOOOOXXXXXXXXXXGOOOOOXXXXXXXXXXXXXXGOOXXXXXXXXXXXXXXXXXGOOOOOOXXXXXXXXXXXXXGOOOOOOXXXXXXXXXXXXXGOOOOOOOOOXXXXXXXXXXGOOOOOOOOOOOXXXXXXXXGOOXXXXXXXXXXXXXXXXXGOOOOOXXXXXXXXXXXXXXGOOOOAXXXXXXXXXXXXXXGOOOOOOOOXXXXXXXXXXX,0,600,0
35889,88,1,87,6,406,0,0,413,393,20,GOOXXXXXXXXXXXXXXXXXGOOOOOXXXXXXXXXXXXXXGOOOOOOOOOXXXXXXXXXXGOOOOOXXXXXXXXXXXXXXGOOXXXXXXXXXXXXXXXXXGOOOOOOXXXXXXXXXXXXXGOOOOOOXXXXXXXXXXXXXGOOOOOOOOOXXXXXXXXXXGOOOOOOOOOOOXXXXXXXXGOOXXXXXXXXXXXXXXXXXGOOOOOXXXXXXXXXXXXXXGOOOOAXXXXXXXXXXXXXXGOOOOOOOOXXXXXXXXXXX,0,600,0

35910,88,1,87,7,405,0,0,412,393,19,GOOXXXXXXXXXXXXXXXXXGOOOOOXXXXXXXXXXXXXXGOOOOOOOOOXXXXXXXXXXGOOOOOXXXXXXXXXXXXXXGOOXXXXXXXXXXXXXXXXXGOOOOOOXXXXXXXXXXXXXGOOOOOOXXXXXXXXXXXXXGOOOOOOOOOXXXXXXXXXXGOOOOOOOOOOOXXXXXXXXGOOXXXXXXXXXXXXXXXXXGOOOOOXXXXXXXXXXXXXXGOOOOAXXXXXXXXXXXXXXGOOOOOOOOXXXXXXXXXXX,0,600,0
35931,88,1,87,7,405,0,0,412,394,18,GOOXXXXXXXXXXXXXXXXXGOOOOOXXXXXXXXXXXXXXGOOOOOOOOOXXXXXXXXXXGOOOOOXXXXXXXXXXXXXXGOOXXXXXXXXXXXXXXXXXGOOOOOOXXXXXXXXXXXXXGOOOOOOXXXXXXXXXXXXXGOOOOOOOOOXXXXXXXXXXGOOOOOOOOOOOXXXXXXXXGOOXXXXXXXXXXXXXXXXXGOOOOOXXXXXXXXXXXXXXGOOOOAXXXXXXXXXXXXXXGOOOOOOOOXXXXXXXXXXX,0,600,0
35952,88,0,88,9,403,0,0,410,394,16,GOOXXXXXXXXXXXXXXXXXGOOOOOXXXXXXXXXXXXXXGOOOOOOOOOXXXXXXXXXXGOOOOOXXXXXXXXXXXXXXGOOXXXXXXXXXXXXXXXXXGOOOOOOXXXXXXXXXXXXXGOOOOOOXXXXXXXXXXXXXGOOOOOOOOOXXXXXXXXXXGOOOOOOOOOOOXXXXXXXXGOOXXXXXXXXXXXXXXXXXGOOOOOXXXXXXXXXXXXXXGOOOOOXXXXXXXXXXXXXXGOOOOOOOOXXXXXXXXXXX,0,600,0
35973,88,0,88,11,401,0,0,408,394,14,GOOXXXXXXXXXXXXXXXXXGOOOOOXXXXXXXXXXXXXXGOOOOOOOOOXXXXXXXXXXGOOOOOXXXXXXXXXXXXXXGOOXXXXXXXXXXXXXXXXXGOOOOOOXXXXXXXXXXXXXGOOOOOOXXXXXXXXXXXXXGOOOOOOOOOXXXXXXXXXXGOOOOOOOOOOOXXXXXXXXGOOXXXXXXXXXXXXXXXXXGOOOOOXXXXXXXXXXXXXXGOOOOOXXXXXXXXXXXXXXGOOOOOOOOXXXXXXXXXXX,0,600,0
35994,88,0,88,13,399,0,0,406,393,13,GOOXXXXXXXXXXXXXXXXXGOOOOOXXXXXXXXXXXXXXGOOOOOOOOOXXXXXXXXXXGOOOOOXXXXXXXXXXXXXXGOOXXXXXXXXXXXXXXXXXGOOOOOOXXXXXXXXXXXXXGOOOOOOXXXXXXXXXXXXXGOOOOOOOOOXXXXXXXXXXGOOOOOOOOOOOXXXXXXXXGOOXXXXXXXXXXXXXXXXXGOOOOOXXXXXXXXXXXXXXGOOOOOXXXXXXXXXXXXXXGOOOOOOOOXXXXXXXXXXX,0,600,0

36015,88,0,88,13,399,0,0,406,393,13,GOOXXXXXXXXXXXXXXXXXGOOOOOXXXXXXXXXXXXXXGOOOOOOOOOXXXXXXXXXXGOOOOOXXXXXXXXXXXXXXGOOXXXXXXXXXXXXXXXXXGOOOOOOXXXXXXXXXXXXXGOOOOOOXXXXXXXXXXXXXGOOOOOOOOOXXXXXXXXXXGOOOOOOOOOOOXXXXXXXXGOOXXXXXXXXXXXXXXXXXGOOOOOXXXXXXXXXXXXXXGOOOOOXXXXXXXXXXXXXXGOOOOOOOOXXXXXXXXXXX,0,600,0
36036,88,0,88,14,398,0,0,405,393,12,GOOXXXXXXXXXXXXXXXXXGOOOOOXXXXXXXXXXXXXXGOOOOOOOOOXXXXXXXXXXGOOOOOXXXXXXXXXXXXXXGOOXXXXXXXXXXXXXXXXXGOOOOOOXXXXXXXXXXXXXGOOOOOOXXXXXXXXXXXXXGOOOOOOOOOXXXXXXXXXXGOOOOOOOOOOOXXXXXXXXGOOXXXXXXXXXXXXXXXXXGOOOOOXXXXXXXXXXXXXXGOOOOOXXXXXXXXXXXXXXGOOOOOOOOXXXXXXXXXXX,0,600,0
36057,88,0,88,12,400,0,0,407,393,14,GOOXXXXXXXXXXXXXXXXXGOOOOOXXXXXXXXXXXXXXGOOOOOOOOOXXXXXXXXXXGOOOOOXXXXXXXXXXXXXXGOOXXXXXXXXXXXXXXXXXGOOOOOOXXXXXXXXXXXXXGOOOOOOXXXXXXXXXXXXXGOOOOOOOOOXXXXXXXXXXGOOOOOOOOOOOXXXXXXXXGOOXXXXXXXXXXXXXXXXXGOOOOOXXXXXXXXXXXXXXGOOOOOXXXXXXXXXXXXXXGOOOOOOOOXXXXXXXXXXX,0,600,0
36078,88,0,88,11,401,0,0,408,392,16,GOOXXXXXXXXXXXXXXXXXGOOOOOXXXXXXXXXXXXXXGOOOOOOOOOXXXXXXXXXXGOOOOOXXXXXXXXXXXXXXGOOXXXXXXXXXXXXXXXXXGOOOOOOXXXXXXXXXXXXXGOOOOOOXXXXXXXXXXXXXGOOOOOOOOOXXXXXXXXXXGOOOOOOOOOOOXXXXXXXXGOOXXXXXXXXXXXXXXXXXGOOOOOXXXXXXXXXXXXXXGOOOOOXXXXXXXXXXXXXXGOOOOOOOOXXXXXXXXXXX,0,600,0
36099,88,0,88,8,404,0,0,411,392,19,GOOXXXXXXXXXXXXXXXXXGOOOOOXXXXXXXXXXXXXXGOOOOOOOOOXXXXXXXXXXGOOOOOXXXXXXXXXXXXXXGOOXXXXXXXXXXXXXXXXXGOOOOOOXXXXXXXXXXXXXGOOOOOOXXXXXXXXXXXXXGOOOOOOOOOXXXXXXXXXXGOOOOOOOOOOOXXXXXXXXGOOXXXXXXXXXXXXXXXXXGOOOOOXXXXXXXXXXXXXXGOOOOOXXXXXXXXXXXXXXGOOOOOOOOXXXXXXXXXXX,0,600,0

36120,88,0,88,9,403,0,0,410,393,17,GOOXXXXXXXXXXXXXXXXXGOOOOOXXXXXXXXXXXXXXGOOOOOOOOOXXXXXXXXXXGOOOOOXXXXXXXXXXXXXXGOOXXXXXXXXXXXXXXXXXGOOOOOOXXXXXXXXXXXXXGOOOOOOXXXXXXXXXXXXXGOOOOOOOOOXXXXXXXXXXGOOOOOOOOOOOXXXXXXXXGOOXXXXXXXXXXXXXXXXXGOOOOOXXXXXXXXXXXXXXGOOOOOXXXXXXXXXXXXXXGOOOOOOOOXXXXXXXXXXX,0,600,0
36141,88,0,88,9,403,0,0,410,392,18,GOOXXXXXXXXXXXXXXXXXGOOOOOXXXXXXXXXXXXXXGOOOOOOOOOXXXXXXXXXXGOOOOOXXXXXXXXXXXXXXGOOXXXXXXXXXXXXXXXXXGOOOOOOXXXXXXXXXXXXXGOOOOOOXXXXXXXXXXXXXGOOOOOOOOOXXXXXXXXXXGOOOOOOOOOOOXXXXXXXXGOOXXXXXXXXXXXXXXXXXGOOOOOXXXXXXXXXXXXXXGOOOOOXXXXXXXXXXXXXXGOOOOOOOOXXXXXXXXXXX,0,600,0
36162,88,0,88,9,403,0,0,410,393,17,GOOXXXXXXXXXXXXXXXXXGOOOOOXXXXXXXXXXXXXXGOOOOOOOOOXXXXXXXXXXGOOOOOXXXXXXXXXXXXXXGOOXXXXXXXXXXXXXXXXXGOOOOOOXXXXXXXXXXXXXGOOOOOOXXXXXXXXXXXXXGOOOOOOOOOXXXXXXXXXXGOOOOOOOOOOOXXXXXXXXGOOXXXXXXXXXXXXXXXXXGOOOOOXXXXXXXXXXXXXXGOOOOOXXXXXXXXXXXXXXGOOOOOOOOXXXXXXXXXXX,0,600,0
36183,88,0,88,7,405,0,0,412,393,19,GOOXXXXXXXXXXXXXXXXXGOOOOOXXXXXXXXXXXXXXGOOOOOOOOOXXXXXXXXXXGOOOOOXXXXXXXXXXXXXXGOOXXXXXXXXXXXXXXXXXGOOOOOOXXXXXXXXXXXXXGOOOOOOXXXXXXXXXXXXXGOOOOOOOOOXXXXXXXXXXGOOOOOOOOOOOXXXXXXXXGOOXXXXXXXXXXXXXXXXXGOOOOOXXXXXXXXXXXXXXGOOOOOXXXXXXXXXXXXXXGOOOOOOOOXXXXXXXXXXX,0,600,0
36204,88,0,88,9,403,0,0,410,392,18,GOOXXXXXXXXXXXXXXXXXGOOOOOXXXXXXXXXXXXXXGOOOOOOOOOXXXXXXXXXXGOOOOOXXXXXXXXXXXXXXGOOXXXXXXXXXXXXXXXXXGOOOOOOXXXXXXXXXXXXXGOOOOOOXXXXXXXXXXXXXGOOOOOOOOOXXXXXXXXXXGOOOOOOOOOOOXXXXXXXXGOOXXXXXXXXXXXXXXXXXGOOOOOXXXXXXXXXXXXXXGOOOOOXXXXXXXXXXXXXXGOOOOOOOOXXXXXXXXXXX,0,600,0

36225,88,0,88,9,403,0,0,410,392,18,GOOXXXXXXXXXXXXXXXXXGOOOOOXXXXXXXXXXXXXXGOOOOOOOOOXXXXXXXXXXGOOOOOXXXXXXXXXXXXXXGOOXXXXXXXXXXXXXXXXXGOOOOOOXXXXXXXXXXXXXGOOOOOOXXXXXXXXXXXXXGOOOOOOOOOXXXXXXXXXXGOOOOOOOOOOOXXXXXXXXGOOXXXXXXXXXXXXXXXXXGOOOOOXXXXXXXXXXXXXXGOOOOOXXXXXXXXXXXXXXGOOOOOOOOXXXXXXXXXXX,0,600,0
36246,88,0,88,10,402,0,0,409,391,18,GOOXXXXXXXXXXXXXXXXXGOOOOOXXXXXXXXXXXXXXGOOOOOOOOOXXXXXXXXXXGOOOOOXXXXXXXXXXXXXXGOOXXXXXXXXXXXXXXXXXGOOOOOOXXXXXXXXXXXXXGOOOOOOXXXXXXXXXXXXXGOOOOOOOOOXXXXXXXXXXGOOOOOOOOOOOXXXXXXXXGOOXXXXXXXXXXXXXXXXXGOOOOOXXXXXXXXXXXXXXGOOOOOXXXXXXXXXXXXXXGOOOOOOOOXXXXXXXXXXX,0,600,0
36267,88,0,88,11,401,0,0,408,391,17,GOOXXXXXXXXXXXXXXXXXGOOOOOXXXXXXXXXXXXXXGOOOOOOOOOXXXXXXXXXXGOOOOOXXXXXXXXXXXXXXGOOXXXXXXXXXXXXXXXXXGOOOOOOXXXXXXXXXXXXXGOOOOOOXXXXXXXXXXXXXGOOOOOOOOOXXXXXXXXXXGOOOOOOOOOOOXXXXXXXXGOOXXXXXXXXXXXXXXXXXGOOOOOXXXXXXXXXXXXXXGOOOOOXXXXXXXXXXXXXXGOOOOOOOOXXXXXXXXXXX,0,600,0
36288,88,0,88,9,403,0,0,410,392,18,GOOXXXXXXXXXXXXXXXXXGOOOOOXXXXXXXXXXXXXXGOOOOOOOOOXXXXXXXXXXGOOOOOXXXXXXXXXXXXXXGOOXXXXXXXXXXXXXXXXXGOOOOOOXXXXXXXXXXXXXGOOOOOOXXXXXXXXXXXXXGOOOOOOOOOXXXXXXXXXXGOOOOOOOOOOOXXXXXXXXGOOXXXXXXXXXXXXXXXXXGOOOOOXXXXXXXXXXXXXXGOOOOOXXXXXXXXXXXXXXGOOOOOOOOXXXXXXXXXXX,0,600,0
36309,88,0,88,9,403,0,0,410,391,19,GOOXXXXXXXXXXXXXXXXXGOOOOOXXXXXXXXXXXXXXGOOOOOOOOOXXXXXXXXXXGOOOOOXXXXXXXXXXXXXXGOOXXXXXXXXXXXXXXXXXGOOOOOOXXXXXXXXXXXXXGOOOOOOXXXXXXXXXXXXXGOOOOOOOOOXXXXXXXXXXGOOOOOOOOOOOXXXXXXXXGOOXXXXXXXXXXXXXXXXXGOOOOOXXXXXXXXXXXXXXGOOOOOXXXXXXXXXXXXXXGOOOOOOOOXXXXXXXXXXX,0,600,0

36330,88,0,88,7,405,0,0,412,391,21,GOOXXXXXXXXXXXXXXXXXGOOOOOXXXXXXXXXXXXXXGOOOOOOOOOXXXXXXXXXXGOOOOOXXXXXXXXXXXXXXGOOXXXXXXXXXXXXXXXXXGOOOOOOXXXXXXXXXXXXXGOOOOOOXXXXXXXXXXXXXGOOOOOOOOOXXXXXXXXXXGOOOOOOOOOOOXXXXXXXXGOOXXXXXXXXXXXXXXXXXGOOOOOXXXXXXXXXXXXXXGOOOOOXXXXXXXXXXXXXXGOOOOOOOOXXXXXXXXXXX,0,600,0
36351,88,0,88,6,406,0,0,412,393,19,GOOXXXXXXXXXXXXXXXXXGOOOOOXXXXXXXXXXXXXXGOOOOOOOOOXXXXXXXXXXGOOOOOXXXXXXXXXXXXXXGOOXXXXXXXXXXXXXXXXXGOOOOOOXXXXXXXXXXXXXGOOOOOOXXXXXXXXXXXXXGOOOOOOOOOXXXXXXXXXXGOOOOOOOOOOOXXXXXXXXGOOXXXXXXXXXXXXXXXXXGOOOOOXXXXXXXXXXXXXXGOOOOOXXXXXXXXXXXXXXGOOOOOOOOXXXXXXXXXXX,0,600,0
36372,88,0,88,7,405,0,0,412,392,20,GOOXXXXXXXXXXXXXXXXXGOOOOOXXXXXXXXXXXXXXGOOOOOOOOOXXXXXXXXXXGOOOOOXXXXXXXXXXXXXXGOOXXXXXXXXXXXXXXXXXGOOOOOOXXXXXXXXXXXXXGOOOOOOXXXXXXXXXXXXXGOOOOOOOOOXXXXXXXXXXGOOOOOOOOOOOXXXXXXXXGOOXXXXXXXXXXXXXXXXXGOOOOOXXXXXXXXXXXXXXGOOOOOXXXXXXXXXXXXXXGOOOOOOOOXXXXXXXXXXX,0,600,0
36393,88,0,88,8,404,0,0,411,391,20,GOOXXXXXXXXXXXXXXXXXGOOOOOXXXXXXXXXXXXXXGOOOOOOOOOXXXXXXXXXXGOOOOOXXXXXXXXXXXXXXGOOXXXXXXXXXXXXXXXXXGOOOOOOXXXXXXXXXXXXXGOOOOOOXXXXXXXXXXXXXGOOOOOOOOOXXXXXXXXXXGOOOOOOOOOOOXXXXXXXXGOOXXXXXXXXXXXXXXXXXGOOOOOXXXXXXXXXXXXXXGOOOOOXXXXXXXXXXXXXXGOOOOOOOOXXXXXXXXXXX,0,600,0
36414,88,0,88,6,406,0,0,413,391,22,GOOXXXXXXXXXXXXXXXXXGOOOOOXXXXXXXXXXXXXXGOOOOOOOOOXXXXXXXXXXGOOOOOXXXXXXXXXXXXXXGOOXXXXXXXXXXXXXXXXXGOOOOOOXXXXXXXXXXXXXGOOOOOOXXXXXXXXXXXXXGOOOOOOOOOXXXXXXXXXXGOOOOOOOOOOOXXXXXXXXGOOXXXXXXXXXXXXXXXXXGOOOOOXXXXXXXXXXXXXXGOOOOOXXXXXXXXXXXXXXGOOOOOOOOXXXXXXXXXXX,0,600,0

36435,88,0,88,6,406,0,0,414,392,22,GOOXXXXXXXXXXXXXXXXXGOOOOOXXXXXXXXXXXXXXGOOOOOOOOOXXXXXXXXXXGOOOOOXXXXXXXXXXXXXXGOOXXXXXXXXXXXXXXXXXGOOOOOOXXXXXXXXXXXXXGOOOOOOXXXXXXXXXXXXXGOOOOOOOOOXXXXXXXXXXGOOOOOOOOOOOXXXXXXXXGOOXXXXXXXXXXXXXXXXXGOOOOOXXXXXXXXXXXXXXGOOOOOXXXXXXXXXXXXXXGOOOOOOOOXXXXXXXXXXX,0,600,0
36456,88,0,88,6,406,0,0,414,391,23,GOOXXXXXXXXXXXXXXXXXGOOOOOXXXXXXXXXXXXXXGOOOOOOOOOXXXXXXXXXXGOOOOOXXXXXXXXXXXXXXGOOXXXXXXXXXXXXXXXXXGOOOOOOXXXXXXXXXXXXXGOOOOOOXXXXXXXXXXXXXGOOOOOOOOOXXXXXXXXXXGOOOOOOOOOOOXXXXXXXXGOOXXXXXXXXXXXXXXXXXGOOOOOXXXXXXXXXXXXXXGOOOOOXXXXXXXXXXXXXXGOOOOOOOOXXXXXXXXXXX,0,600,0
36477,88,0,88,6,406,0,0,414,393,21,GOOXXXXXXXXXXXXXXXXXGOOOOOXXXXXXXXXXXXXXGOOOOOOOOOXXXXXXXXXXGOOOOOXXXXXXXXXXXXXXGOOXXXXXXXXXXXXXXXXXGOOOOOOXXXXXXXXXXXXXGOOOOOOXXXXXXXXXXXXXGOOOOOOOOOXXXXXXXXXXGOOOOOOOOOOOXXXXXXXXGOOXXXXXXXXXXXXXXXXXGOOOOOXXXXXXXXXXXXXXGOOOOOXXXXXXXXXXXXXXGOOOOOOOOXXXXXXXXXXX,0,600,0
36498,88,0,88,8,404,0,0,412,392,20,GOOXXXXXXXXXXXXXXXXXGOOOOOXXXXXXXXXXXXXXGOOOOOOOOOXXXXXXXXXXGOOOOOXXXXXXXXXXXXXXGOOXXXXXXXXXXXXXXXXXGOOOOOOXXXXXXXXXXXXXGOOOOOOXXXXXXXXXXXXXGOOOOOOOOOXXXXXXXXXXGOOOOOOOOOOOXXXXXXXXGOOXXXXXXXXXXXXXXXXXGOOOOOXXXXXXXXXXXXXXGOOOOOXXXXXXXXXXXXXXGOOOOOOOOXXXXXXXXXXX,0,600,0
36519,88,0,88,8,404,0,0,412,393,19,GOOXXXXXXXXXXXXXXXXXGOOOOOXXXXXXXXXXXXXXGOOOOOOOOOXXXXXXXXXXGOOOOOXXXXXXXXXXXXXXGOOXXXXXXXXXXXXXXXXXGOOOOOOXXXXXXXXXXXXXGOOOOOOXXXXXXXXXXXXXGOOOOOOOOOXXXXXXXXXXGOOOOOOOOOOOXXXXXXXXGOOXXXXXXXXXXXXXXXXXGOOOOOXXXXXXXXXXXXXXGOOOOOXXXXXXXXXXXXXXGOOOOOOOOXXXXXXXXXXX,0,600,0

36540,88,0,88,9,403,0,0,411,393,18,GOOXXXXXXXXXXXXXXXXXGOOOOOXXXXXXXXXXXXXXGOOOOOOOOOXXXXXXXXXXGOOOOOXXXXXXXXXXXXXXGOOXXXXXXXXXXXXXXXXXGOOOOOOXXXXXXXXXXXXXGOOOOOOXXXXXXXXXXXXXGOOOOOOOOOXXXXXXXXXXGOOOOOOOOOOOXXXXXXXXGOOXXXXXXXXXXXXXXXXXGOOOOOXXXXXXXXXXXXXXGOOOOOXXXXXXXXXXXXXXGOOOOOOOOXXXXXXXXXXX,0,600,0
36561,88,0,88,9,403,0,0,411,393,18,GOOXXXXXXXXXXXXXXXXXGOOOOOXXXXXXXXXXXXXXGOOOOOOOOOXXXXXXXXXXGOOOOOXXXXXXXXXXXXXXGOOXXXXXXXXXXXXXXXXXGOOOOOOXXXXXXXXXXXXXGOOOOOOXXXXXXXXXXXXXGOOOOOOOOOXXXXXXXXXXGOOOOOOOOOOOXXXXXXXXGOOXXXXXXXXXXXXXXXXXGOOOOOXXXXXXXXXXXXXXGOOOOOXXXXXXXXXXXXXXGOOOOOOOOXXXXXXXXXXX,0,600,0
36582,88,0,88,8,404,0,0,411,393,18,GOOXXXXXXXXXXXXXXXXXGOOOOOXXXXXXXXXXXXXXGOOOOOOOOOXXXXXXXXXXGOOOOOXXXXXXXXXXXXXXGOOXXXXXXXXXXXXXXXXXGOOOOOOXXXXXXXXXXXXXGOOOOOOXXXXXXXXXXXXXGOOOOOOOOOXXXXXXXXXXGOOOOOOOOOOOXXXXXXXXGOOXXXXXXXXXXXXXXXXXGOOOOOXXXXXXXXXXXXXXGOOOOOXXXXXXXXXXXXXXGOOOOOOOOXXXXXXXXXXX,0,600,0
36603,88,0,88,6,406,0,0,414,394,20,GOOXXXXXXXXXXXXXXXXXGOOOOOXXXXXXXXXXXXXXGOOOOOOOOOXXXXXXXXXXGOOOOOXXXXXXXXXXXXXXGOOXXXXXXXXXXXXXXXXXGOOOOOOXXXXXXXXXXXXXGOOOOOOXXXXXXXXXXXXXGOOOOOOOOOXXXXXXXXXXGOOOOOOOOOOOXXXXXXXXGOOXXXXXXXXXXXXXXXXXGOOOOOXXXXXXXXXXXXXXGOOOOOXXXXXXXXXXXXXXGOOOOOOOOXXXXXXXXXXX,0,600,0
36624,88,0,88,7,405,0,0,413,394,19,GOOXXXXXXXXXXXXXXXXXGOOOOOXXXXXXXXXXXXXXGOOOOOOOOOXXXXXXXXXXGOOOOOXXXXXXXXXXXXXXGOOXXXXXXXXXXXXXXXXXGOOOOOOXXXXXXXXXXXXXGOOOOOOXXXXXXXXXXXXXGOOOOOOOOOXXXXXXXXXXGOOOOOOOOOOOXXXXXXXXGOOXXXXXXXXXXXXXXXXXGOOOOOXXXXXXXXXXXXXXGOOOOOXXXXXXXXXXXXXXGOOOOOOOOXXXXXXXXXXX,0,600,0

36645,88,0,88,7,405,0,0,413,393,20,GOOXXXXXXXXXXXXXXXXXGOOOOOXXXXXXXXXXXXXXGOOOOOOOOOXXXXXXXXXXGOOOOOXXXXXXXXXXXXXXGOOXXXXXXXXXXXXXXXXXGOOOOOOXXXXXXXXXXXXXGOOOOOOXXXXXXXXXXXXXGOOOOOOOOOXXXXXXXXXXGOOOOOOOOOOOXXXXXXXXGOOXXXXXXXXXXXXXXXXXGOOOOOXXXXXXXXXXXXXXGOOOOOXXXXXXXXXXXXXXGOOOOOOOOXXXXXXXXXXX,0,600,0
36666,88,0,88,5,407,0,0,415,394,21,GOOXXXXXXXXXXXXXXXXXGOOOOOXXXXXXXXXXXXXXGOOOOOOOOOXXXXXXXXXXGOOOOOXXXXXXXXXXXXXXGOOXXXXXXXXXXXXXXXXXGOOOOOOXXXXXXXXXXXXXGOOOOOOXXXXXXXXXXXXXGOOOOOOOOOXXXXXXXXXXGOOOOOOOOOOOXXXXXXXXGOOXXXXXXXXXXXXXXXXXGOOOOOXXXXXXXXXXXXXXGOOOOOXXXXXXXXXXXXXXGOOOOOOOOXXXXXXXXXXX,0,600,0
36687,88,0,88,7,405,0,0,413,393,20,GOOXXXXXXXXXXXXXXXXXGOOOOOXXXXXXXXXXXXXXGOOOOOOOOOXXXXXXXXXXGOOOOOXXXXXXXXXXXXXXGOOXXXXXXXXXXXXXXXXXGOOOOOOXXXXXXXXXXXXXGOOOOOOXXXXXXXXXXXXXGOOOOOOOOOXXXXXXXXXXGOOOOOOOOOOOXXXXXXXXGOOXXXXXXXXXXXXXXXXXGOOOOOXXXXXXXXXXXXXXGOOOOOXXXXXXXXXXXXXXGOOOOOOOOXXXXXXXXXXX,0,600,0
36708,88,0,88,9,403,0,0,411,393,18,GOOXXXXXXXXXXXXXXXXXGOOOOOXXXXXXXXXXXXXXGOOOOOOOOOXXXXXXXXXXGOOOOOXXXXXXXXXXXXXXGOOXXXXXXXXXXXXXXXXXGOOOOOOXXXXXXXXXXXXXGOOOOOOXXXXXXXXXXXXXGOOOOOOOOOXXXXXXXXXXGOOOOOOOOOOOXXXXXXXXGOOXXXXXXXXXXXXXXXXXGOOOOOXXXXXXXXXXXXXXGOOOOOXXXXXXXXXXXXXXGOOOOOOOOXXXXXXXXXXX,0,600,0
36729,88,0,88,8,404,0,0,412,393,19,GOOXXXXXXXXXXXXXXXXXGOOOOOXXXXXXXXXXXXXXGOOOOOOOOOXXXXXXXXXXGOOOOOXXXXXXXXXXXXXXGOOXXXXXXXXXXXXXXXXXGOOOOOOXXXXXXXXXXXXXGOOOOOOXXXXXXXXXXXXXGOOOOOOOOOXXXXXXXXXXGOOOOOOOOOOOXXXXXXXXGOOXXXXXXXXXXXXXXXXXGOOOOOXXXXXXXXXXXXXXGOOOOOXXXXXXXXXXXXXXGOOOOOOOOXXXXXXXXXXX,0,600,0

36750,88,0,88,6,406,0,0,414,393,21,GOOXXXXXXXXXXXXXXXXXGOOOOOXXXXXXXXXXXXXXGOOOOOOOOOXXXXXXXXXXGOOOOOXXXXXXXXXXXXXXGOOXXXXXXXXXXXXXXXXXGOOOOOOXXXXXXXXXXXXXGOOOOOOXXXXXXXXXXXXXGOOOOOOOOOXXXXXXXXXXGOOOOOOOOOOOXXXXXXXXGOOXXXXXXXXXXXXXXXXXGOOOOOXXXXXXXXXXXXXXGOOOOOXXXXXXXXXXXXXXGOOOOOOOOXXXXXXXXXXX,0,600,0
36771,88,0,88,5,407,0,0,415,394,21,GOOXXXXXXXXXXXXXXXXXGOOOOOXXXXXXXXXXXXXXGOOOOOOOOOXXXXXXXXXXGOOOOOXXXXXXXXXXXXXXGOOXXXXXXXXXXXXXXXXXGOOOOOOXXXXXXXXXXXXXGOOOOOOXXXXXXXXXXXXXGOOOOOOOOOXXXXXXXXXXGOOOOOOOOOOOXXXXXXXXGOOXXXXXXXXXXXXXXXXXGOOOOOXXXXXXXXXXXXXXGOOOOOXXXXXXXXXXXXXXGOOOOOOOOXXXXXXXXXXX,0,600,0
36792,88,0,88,5,407,0,0,415,395,20,GOOXXXXXXXXXXXXXXXXXGOOOOOXXXXXXXXXXXXXXGOOOOOOOOOXXXXXXXXXXGOOOOOXXXXXXXXXXXXXXGOOXXXXXXXXXXXXXXXXXGOOOOOOXXXXXXXXXXXXXGOOOOOOXXXXXXXXXXXXXGOOOOOOOOOXXXXXXXXXXGOOOOOOOOOOOXXXXXXXXGOOXXXXXXXXXXXXXXXXXGOOOOOXXXXXXXXXXXXXXGOOOOOXXXXXXXXXXXXXXGOOOOOOOOXXXXXXXXXXX,0,600,0
36813,88,0,88,6,406,0,0,414,395,19,GOOXXXXXXXXXXXXXXXXXGOOOOOXXXXXXXXXXXXXXGOOOOOOOOOXXXXXXXXXXGOOOOOXXXXXXXXXXXXXXGOOXXXXXXXXXXXXXXXXXGOOOOOOXXXXXXXXXXXXXGOOOOOOXXXXXXXXXXXXXGOOOOOOOOOXXXXXXXXXXGOOOOOOOOOOOXXXXXXXXGOOXXXXXXXXXXXXXXXXXGOOOOOXXXXXXXXXXXXXXGOOOOOXXXXXXXXXXXXXXGOOOOOOOOXXXXXXXXXXX,0,600,0
36834,88,0,88,6,406,0,0,414,396,18,GOOXXXXXXXXXXXXXXXXXGOOOOOXXXXXXXXXXXXXXGOOOOOOOOOXXXXXXXXXXGOOOOOXXXXXXXXXXXXXXGOOXXXXXXXXXXXXXXXXXGOOOOOOXXXXXXXXXXXXXGOOOOOOXXXXXXXXXXXXXGOOOOOOOOOXXXXXXXXXXGOOOOOOOOOOOXXXXXXXXGOOXXXXXXXXXXXXXXXXXGOOOOOXXXXXXXXXXXXXXGOOOOOXXXXXXXXXXXXXXGOOOOOOOOXXXXXXXXXXX,0,600,0

36855,88,0,88,6,406,0,0,414,395,19,GOOXXXXXXXXXXXXXXXXXGOOOOOXXXXXXXXXXXXXXGOOOOOOOOOXXXXXXXXXXGOOOOOXXXXXXXXXXXXXXGOOXXXXXXXXXXXXXXXXXGOOOOOOXXXXXXXXXXXXXGOOOOOOXXXXXXXXXXXXXGOOOOOOOOOXXXXXXXXXXGOOOOOOOOOOOXXXXXXXXGOOXXXXXXXXXXXXXXXXXGOOOOOXXXXXXXXXXXXXXGOOOOOXXXXXXXXXXXXXXGOOOOOOOOXXXXXXXXXXX,0,600,0
36876,88,0,88,8,404,0,0,412,395,17,GOOXXXXXXXXXXXXXXXXXGOOOOOXXXXXXXXXXXXXXGOOOOOOOOOXXXXXXXXXXGOOOOOXXXXXXXXXXXXXXGOOXXXXXXXXXXXXXXXXXGOOOOOOXXXXXXXXXXXXXGOOOOOOXXXXXXXXXXXXXGOOOOOOOOOXXXXXXXXXXGOOOOOOOOOOOXXXXXXXXGOOXXXXXXXXXXXXXXXXXGOOOOOXXXXXXXXXXXXXXGOOOOOXXXXXXXXXXXXXXGOOOOOOOOXXXXXXXXXXX,0,600,0
36897,88,0,88,9,403,0,0,411,395,16,GOOXXXXXXXXXXXXXXXXXGOOOOOXXXXXXXXXXXXXXGOOOOOOOOOXXXXXXXXXXGOOOOOXXXXXXXXXXXXXXGOOXXXXXXXXXXXXXXXXXGOOOOOOXXXXXXXXXXXXXGOOOOOOXXXXXXXXXXXXXGOOOOOOOOOXXXXXXXXXXGOOOOOOOOOOOXXXXXXXXGOOXXXXXXXXXXXXXXXXXGOOOOOXXXXXXXXXXXXXXGOOOOOXXXXXXXXXXXXXXGOOOOOOOOXXXXXXXXXXX,0,600,0
36918,88,0,88,7,405,0,0,414,395,19,GOOXXXXXXXXXXXXXXXXXGOOOOOXXXXXXXXXXXXXXGOOOOOOOOOXXXXXXXXXXGOOOOOXXXXXXXXXXXXXXGOOXXXXXXXXXXXXXXXXXGOOOOOOXXXXXXXXXXXXXGOOOOOOXXXXXXXXXXXXXGOOOOOOOOOXXXXXXXXXXGOOOOOOOOOOOXXXXXXXXGOOXXXXXXXXXXXXXXXXXGOOOOOXXXXXXXXXXXXXXGOOOOOXXXXXXXXXXXXXXGOOOOOOOOXXXXXXXXXXX,0,600,0
36939,88,0,88,8,404,0,0,413,395,18,GOOXXXXXXXXXXXXXXXXXGOOOOOXXXXXXXXXXXXXXGOOOOOOOOOXXXXXXXXXXGOOOOOXXXXXXXXXXXXXXGOOXXXXXXXXXXXXXXXXXGOOOOOOXXXXXXXXXXXXXGOOOOOOXXXXXXXXXXXXXGOOOOOOOOOXXXXXXXXXXGOOOOOOOOOOOXXXXXXXXGOOXXXXXXXXXXXXXXXXXGOOOOOXXXXXXXXXXXXXXGOOOOOXXXXXXXXXXXXXXGOOOOOOOOXXXXXXXXXXX,0,600,0

36960,88,0,88,11,401,0,0,410,394,16,GOOXXXXXXXXXXXXXXXXXGOOOOOXXXXXXXXXXXXXXGOOOOOOOOOXXXXXXXXXXGOOOOOXXXXXXXXXXXXXXGOOXXXXXXXXXXXXXXXXXGOOOOOOXXXXXXXXXXXXXGOOOOOOXXXXXXXXXXXXXGOOOOOOOOOXXXXXXXXXXGOOOOOOOOOOOXXXXXXXXGOOXXXXXXXXXXXXXXXXXGOOOOOXXXXXXXXXXXXXXGOOOOOXXXXXXXXXXXXXXGOOOOOOOOXXXXXXXXXXX,0,600,0
36981,88,0,88,12,400,0,0,409,394,15,GOOXXXXXXXXXXXXXXXXXGOOOOOXXXXXXXXXXXXXXGOOOOOOOOOXXXXXXXXXXGOOOOOXXXXXXXXXXXXXXGOOXXXXXXXXXXXXXXXXXGOOOOOOXXXXXXXXXXXXXGOOOOOOXXXXXXXXXXXXXGOOOOOOOOOXXXXXXXXXXGOOOOOOOOOOOXXXXXXXXGOOXXXXXXXXXXXXXXXXXGOOOOOXXXXXXXXXXXXXXGOOOOOXXXXXXXXXXXXXXGOOOOOOOOXXXXXXXXXXX,0,600,0
37002,88,0,88,13,399,0,0,408,394,14,GOOXXXXXXXXXXXXXXXXXGOOOOOXXXXXXXXXXXXXXGOOOOOOOOOXXXXXXXXXXGOOOOOXXXXXXXXXXXXXXGOOXXXXXXXXXXXXXXXXXGOOOOOOXXXXXXXXXXXXXGOOOOOOXXXXXXXXXXXXXGOOOOOOOOOXXXXXXXXXXGOOOOOOOOOOOXXXXXXXXGOOXXXXXXXXXXXXXXXXXGOOOOOXXXXXXXXXXXXXXGOOOOOXXXXXXXXXXXXXXGOOOOOOOOXXXXXXXXXXX,0,600,0
37023,88,0,88,13,399,0,0,408,394,14,GOOXXXXXXXXXXXXXXXXXGOOOOOXXXXXXXXXXXXXXGOOOOOOOOOXXXXXXXXXXGOOOOOXXXXXXXXXXXXXXGOOXXXXXXXXXXXXXXXXXGOOOOOOXXXXXXXXXXXXXGOOOOOOXXXXXXXXXXXXXGOOOOOOOOOXXXXXXXXXXGOOOOOOOOOOOXXXXXXXXGOOXXXXXXXXXXXXXXXXXGOOOOOXXXXXXXXXXXXXXGOOOOOXXXXXXXXXXXXXXGOOOOOOOOXXXXXXXXXXX,0,600,0
37044,88,0,88,11,401,0,0,410,394,16,GOOXXXXXXXXXXXXXXXXXGOOOOOXXXXXXXXXXXXXXGOOOOOOOOOXXXXXXXXXXGOOOOOXXXXXXXXXXXXXXGOOXXXXXXXXXXXXXXXXXGOOOOOOXXXXXXXXXXXXXGOOOOOOXXXXXXXXXXXXXGOOOOOOOOOXXXXXXXXXXGOOOOOOOOOOOXXXXXXXXGOOXXXXXXXXXXXXXXXXXGOOOOOXXXXXXXXXXXXXXGOOOOOXXXXXXXXXXXXXXGOOOOOOOOXXXXXXXXXXX,0,600,0

37065,88,0,88,13,399,0,0,408,394,14,GOOXXXXXXXXXXXXXXXXXGOOOOOXXXXXXXXXXXXXXGOOOOOOOOOXXXXXXXXXXGOOOOOXXXXXXXXXXXXXXGOOXXXXXXXXXXXXXXXXXGOOOOOOXXXXXXXXXXXXXGOOOOOOXXXXXXXXXXXXXGOOOOOOOOOXXXXXXXXXXGOOOOOOOOOOOXXXXXXXXGOOXXXXXXXXXXXXXXXXXGOOOOOXXXXXXXXXXXXXXGOOOOOXXXXXXXXXXXXXXGOOOOOOOOXXXXXXXXXXX,0,600,0
37086,88,0,88,12,400,0,0,409,394,15,GOOXXXXXXXXXXXXXXXXXGOOOOOXXXXXXXXXXXXXXGOOOOOOOOOXXXXXXXXXXGOOOOOXXXXXXXXXXXXXXGOOXXXXXXXXXXXXXXXXXGOOOOOOXXXXXXXXXXXXXGOOOOOOXXXXXXXXXXXXXGOOOOOOOOOXXXXXXXXXXGOOOOOOOOOOOXXXXXXXXGOOXXXXXXXXXXXXXXXXXGOOOOOXXXXXXXXXXXXXXGOOOOOXXXXXXXXXXXXXXGOOOOOOOOXXXXXXXXXXX,0,600,0
37107,88,0,88,11,401,0,0,410,395,15,GOOXXXXXXXXXXXXXXXXXGOOOOOXXXXXXXXXXXXXXGOOOOOOOOOXXXXXXXXXXGOOOOOXXXXXXXXXXXXXXGOOXXXXXXXXXXXXXXXXXGOOOOOOXXXXXXXXXXXXXGOOOOOOXXXXXXXXXXXXXGOOOOOOOOOXXXXXXXXXXGOOOOOOOOOOOXXXXXXXXGOOXXXXXXXXXXXXXXXXXGOOOOOXXXXXXXXXXXXXXGOOOOOXXXXXXXXXXXXXXGOOOOOOOOXXXXXXXXXXX,0,600,0
37128,88,0,88,11,401,0,0,410,395,15,GOOXXXXXXXXXXXXXXXXXGOOOOOXXXXXXXXXXXXXXGOOOOOOOOOXXXXXXXXXXGOOOOOXXXXXXXXXXXXXXGOOXXXXXXXXXXXXXXXXXGOOOOOOXXXXXXXXXXXXXGOOOOOOXXXXXXXXXXXXXGOOOOOOOOOXXXXXXXXXXGOOOOOOOOOOOXXXXXXXXGOOXXXXXXXXXXXXXXXXXGOOOOOXXXXXXXXXXXXXXGOOOOOXXXXXXXXXXXXXXGOOOOOOOOXXXXXXXXXXX,0,600,0
37149,88,0,88,12,400,0,0,409,395,14,GOOXXXXXXXXXXXXXXXXXGOOOOOXXXXXXXXXXXXXXGOOOOOOOOOXXXXXXXXXXGOOOOOXXXXXXXXXXXXXXGOOXXXXXXXXXXXXXXXXXGOOOOOOXXXXXXXXXXXXXGOOOOOOXXXXXXXXXXXXXGOOOOOOOOOXXXXXXXXXXGOOOOOOOOOOOXXXXXXXXGOOXXXXXXXXXXXXXXXXXGOOOOOXXXXXXXXXXXXXXGOOOOOXXXXXXXXXXXXXXGOOOOOOOOXXXXXXXXXXX,0,600,0

37170,88,0,88,11,401,0,0,409,395,14,GOOXXXXXXXXXXXXXXXXXGOOOOOXXXXXXXXXXXXXXGOOOOOOOOOXXXXXXXXXXGOOOOOXXXXXXXXXXXXXXGOOXXXXXXXXXXXXXXXXXGOOOOOOXXXXXXXXXXXXXGOOOOOOXXXXXXXXXXXXXGOOOOOOOOOXXXXXXXXXXGOOOOOOOOOOOXXXXXXXXGOOXXXXXXXXXXXXXXXXXGOOOOOXXXXXXXXXXXXXXGOOOOOXXXXXXXXXXXXXXGOOOOOOOOXXXXXXXXXXX,0,600,0
37191,88,0,88,9,403,0,0,410,395,15,GOOXXXXXXXXXXXXXXXXXGOOOOOXXXXXXXXXXXXXXGOOOOOOOOOXXXXXXXXXXGOOOOOXXXXXXXXXXXXXXGOOXXXXXXXXXXXXXXXXXGOOOOOOXXXXXXXXXXXXXGOOOOOOXXXXXXXXXXXXXGOOOOOOOOOXXXXXXXXXXGOOOOOOOOOOOXXXXXXXXGOOXXXXXXXXXXXXXXXXXGOOOOOXXXXXXXXXXXXXXGOOOOOXXXXXXXXXXXXXXGOOOOOOOOXXXXXXXXXXX,0,600,0
37212,88,0,88,8,404,0,0,412,395,17,GOOXXXXXXXXXXXXXXXXXGOOOOOXXXXXXXXXXXXXXGOOOOOOOOOXXXXXXXXXXGOOOOOXXXXXXXXXXXXXXGOOXXXXXXXXXXXXXXXXXGOOOOOOXXXXXXXXXXXXXGOOOOOOXXXXXXXXXXXXXGOOOOOOOOOXXXXXXXXXXGOOOOOOOOOOOXXXXXXXXGOOXXXXXXXXXXXXXXXXXGOOOOOXXXXXXXXXXXXXXGOOOOOXXXXXXXXXXXXXXGOOOOOOOOXXXXXXXXXXX,0,600,0
37233,88,0,88,8,404,0,0,412,394,18,GOOXXXXXXXXXXXXXXXXXGOOOOOXXXXXXXXXXXXXXGOOOOOOOOOXXXXXXXXXXGOOOOOXXXXXXXXXXXXXXGOOXXXXXXXXXXXXXXXXXGOOOOOOXXXXXXXXXXXXXGOOOOOOXXXXXXXXXXXXXGOOOOOOOOOXXXXXXXXXXGOOOOOOOOOOOXXXXXXXXGOOXXXXXXXXXXXXXXXXXGOOOOOXXXXXXXXXXXXXXGOOOOOXXXXXXXXXXXXXXGOOOOOOOOXXXXXXXXXXX,0,600,0
37254,88,0,88,8,404,0,0,412,395,17,GOOXXXXXXXXXXXXXXXXXGOOOOOXXXXXXXXXXXXXXGOOOOOOOOOXXXXXXXXXXGOOOOOXXXXXXXXXXXXXXGOOXXXXXXXXXXXXXXXXXGOOOOOOXXXXXXXXXXXXXGOOOOOOXXXXXXXXXXXXXGOOOOOOOOOXXXXXXXXXXGOOOOOOOOOOOXXXXXXXXGOOXXXXXXXXXXXXXXXXXGOOOOOXXXXXXXXXXXXXXGOOOOOXXXXXXXXXXXXXXGOOOOOOOOXXXXXXXXXXX,0,600,0

37275,88,0,88,8,404,0,0,412,394,18,GOOXXXXXXXXXXXXXXXXXGOOOOOXXXXXXXXXXXXXXGOOOOOOOOOXXXXXXXXXXGOOOOOXXXXXXXXXXXXXXGOOXXXXXXXXXXXXXXXXXGOOOOOOXXXXXXXXXXXXXGOOOOOOXXXXXXXXXXXXXGOOOOOOOOOXXXXXXXXXXGOOOOOOOOOOOXXXXXXXXGOOXXXXXXXXXXXXXXXXXGOOOOOXXXXXXXXXXXXXXGOOOOOXXXXXXXXXXXXXXGOOOOOOOOXXXXXXXXXXX,0,600,0
37296,88,0,88,8,404,0,0,412,394,18,GOOXXXXXXXXXXXXXXXXXGOOOOOXXXXXXXXXXXXXXGOOOOOOOOOXXXXXXXXXXGOOOOOXXXXXXXXXXXXXXGOOXXXXXXXXXXXXXXXXXGOOOOOOXXXXXXXXXXXXXGOOOOOOXXXXXXXXXXXXXGOOOOOOOOOXXXXXXXXXXGOOOOOOOOOOOXXXXXXXXGOOXXXXXXXXXXXXXXXXXGOOOOOXXXXXXXXXXXXXXGOOOOOXXXXXXXXXXXXXXGOOOOOOOOXXXXXXXXXXX,0,600,0
37317,88,0,88,8,404,0,0,412,395,17,GOOXXXXXXXXXXXXXXXXXGOOOOOXXXXXXXXXXXXXXGOOOOOOOOOXXXXXXXXXXGOOOOOXXXXXXXXXXXXXXGOOXXXXXXXXXXXXXXXXXGOOOOOOXXXXXXXXXXXXXGOOOOOOXXXXXXXXXXXXXGOOOOOOOOOXXXXXXXXXXGOOOOOOOOOOOXXXXXXXXGOOXXXXXXXXXXXXXXXXXGOOOOOXXXXXXXXXXXXXXGOOOOOXXXXXXXXXXXXXXGOOOOOOOOXXXXXXXXXXX,0,600,0
37338,88,0,88,6,406,0,0,414,394,20,GOOXXXXXXXXXXXXXXXXXGOOOOOXXXXXXXXXXXXXXGOOOOOOOOOXXXXXXXXXXGOOOOOXXXXXXXXXXXXXXGOOXXXXXXXXXXXXXXXXXGOOOOOOXXXXXXXXXXXXXGOOOOOOXXXXXXXXXXXXXGOOOOOOOOOXXXXXXXXXXGOOOOOOOOOOOXXXXXXXXGOOXXXXXXXXXXXXXXXXXGOOOOOXXXXXXXXXXXXXXGOOOOOXXXXXXXXXXXXXXGOOOOOOOOXXXXXXXXXXX,0,600,0
37359,88,0,88,5,407,0,0,415,395,20,GOOXXXXXXXXXXXXXXXXXGOOOOOXXXXXXXXXXXXXXGOOOOOOOOOXXXXXXXXXXGOOOOOXXXXXXXXXXXXXXGOOXXXXXXXXXXXXXXXXXGOOOOOOXXXXXXXXXXXXXGOOOOOOXXXXXXXXXXXXXGOOOOOOOOOXXXXXXXXXXGOOOOOOOOOOOXXXXXXXXGOOXXXXXXXXXXXXXXXXXGOOOOOXXXXXXXXXXXXXXGOOOOOXXXXXXXXXXXXXXGOOOOOOOOXXXXXXXXXXX,0,600,0

37380,88,0,88,4,408,0,0,416,393,23,GOOXXXXXXXXXXXXXXXXXGOOOOOXXXXXXXXXXXXXXGOOOOOOOOOXXXXXXXXXXGOOOOOXXXXXXXXXXXXXXGOOXXXXXXXXXXXXXXXXXGOOOOOOXXXXXXXXXXXXXGOOOOOOXXXXXXXXXXXXXGOOOOOOOOOXXXXXXXXXXGOOOOOOOOOOOXXXXXXXXGOOXXXXXXXXXXXXXXXXXGOOOOOXXXXXXXXXXXXXXGOOOOOXXXXXXXXXXXXXXGOOOOOOOOXXXXXXXXXXX,0,600,0
37401,88,0,88,5,407,0,0,415,394,21,GOOXXXXXXXXXXXXXXXXXGOOOOOXXXXXXXXXXXXXXGOOOOOOOOOXXXXXXXXXXGOOOOOXXXXXXXXXXXXXXGOOXXXXXXXXXXXXXXXXXGOOOOOOXXXXXXXXXXXXXGOOOOOOXXXXXXXXXXXXXGOOOOOOOOOXXXXXXXXXXGOOOOOOOOOOOXXXXXXXXGOOXXXXXXXXXXXXXXXXXGOOOOOXXXXXXXXXXXXXXGOOOOOXXXXXXXXXXXXXXGOOOOOOOOXXXXXXXXXXX,0,600,0
37422,88,0,88,7,405,0,0,413,393,20,GOOXXXXXXXXXXXXXXXXXGOOOOOXXXXXXXXXXXXXXGOOOOOOOOOXXXXXXXXXXGOOOOOXXXXXXXXXXXXXXGOOXXXXXXXXXXXXXXXXXGOOOOOOXXXXXXXXXXXXXGOOOOOOXXXXXXXXXXXXXGOOOOOOOOOXXXXXXXXXXGOOOOOOOOOOOXXXXXXXXGOOXXXXXXXXXXXXXXXXXGOOOOOXXXXXXXXXXXXXXGOOOOOXXXXXXXXXXXXXXGOOOOOOOOXXXXXXXXXXX,0,600,0
37443,88,0,88,6,406,0,0,414,395,19,GOOXXXXXXXXXXXXXXXXXGOOOOOXXXXXXXXXXXXXXGOOOOOOOOOXXXXXXXXXXGOOOOOXXXXXXXXXXXXXXGOOXXXXXXXXXXXXXXXXXGOOOOOOXXXXXXXXXXXXXGOOOOOOXXXXXXXXXXXXXGOOOOOOOOOXXXXXXXXXXGOOOOOOOOOOOXXXXXXXXGOOXXXXXXXXXXXXXXXXXGOOOOOXXXXXXXXXXXXXXGOOOOOXXXXXXXXXXXXXXGOOOOOOOOXXXXXXXXXXX,0,600,0
37464,88,0,88,7,405,0,0,413,393,20,GOOXXXXXXXXXXXXXXXXXGOOOOOXXXXXXXXXXXXXXGOOOOOOOOOXXXXXXXXXXGOOOOOXXXXXXXXXXXXXXGOOXXXXXXXXXXXXXXXXXGOOOOOOXXXXXXXXXXXXXGOOOOOOXXXXXXXXXXXXXGOOOOOOOOOXXXXXXXXXXGOOOOOOOOOOOXXXXXXXXGOOXXXXXXXXXXXXXXXXXGOOOOOXXXXXXXXXXXXXXGOOOOOXXXXXXXXXXXXXXGOOOOOOOOXXXXXXXXXXX,0,600,0

37485,88,0,88,7,405,0,0,413,393,20,GOOXXXXXXXXXXXXXXXXXGOOOOOXXXXXXXXXXXXXXGOOOOOOOOOXXXXXXXXXXGOOOOOXXXXXXXXXXXXXXGOOXXXXXXXXXXXXXXXXXGOOOOOOXXXXXXXXXXXXXGOOOOOOXXXXXXXXXXXXXGOOOOOOOOOXXXXXXXXXXGOOOOOOOOOOOXXXXXXXXGOOXXXXXXXXXXXXXXXXXGOOOOOXXXXXXXXXXXXXXGOOOOOXXXXXXXXXXXXXXGOOOOOOOOXXXXXXXXXXX,0,600,0
37506,88,0,88,6,406,0,0,415,394,21,GOOXXXXXXXXXXXXXXXXXGOOOOOXXXXXXXXXXXXXXGOOOOOOOOOXXXXXXXXXXGOOOOOXXXXXXXXXXXXXXGOOXXXXXXXXXXXXXXXXXGOOOOOOXXXXXXXXXXXXXGOOOOOOXXXXXXXXXXXXXGOOOOOOOOOXXXXXXXXXXGOOOOOOOOOOOXXXXXXXXGOOXXXXXXXXXXXXXXXXXGOOOOOXXXXXXXXXXXXXXGOOOOOXXXXXXXXXXXXXXGOOOOOOOOXXXXXXXXXXX,0,600,0
37527,88,0,88,7,405,0,0,414,397,17,GOOXXXXXXXXXXXXXXXXXGOOOOOXXXXXXXXXXXXXXGOOOOOOOOOXXXXXXXXXXGOOOOOXXXXXXXXXXXXXXGOOXXXXXXXXXXXXXXXXXGOOOOOOXXXXXXXXXXXXXGOOOOOOXXXXXXXXXXXXXGOOOOOOOOOXXXXXXXXXXGOOOOOOOOOOOXXXXXXXXGOOXXXXXXXXXXXXXXXXXGOOOOOXXXXXXXXXXXXXXGOOOOOXXXXXXXXXXXXXXGOOOOOOOOXXXXXXXXXXX,0,600,0
37548,88,0,88,10,402,0,0,411,394,17,GOOXXXXXXXXXXXXXXXXXGOOOOOXXXXXXXXXXXXXXGOOOOOOOOOXXXXXXXXXXGOOOOOXXXXXXXXXXXXXXGOOXXXXXXXXXXXXXXXXXGOOOOOOXXXXXXXXXXXXXGOOOOOOXXXXXXXXXXXXXGOOOOOOOOOXXXXXXXXXXGOOOOOOOOOOOXXXXXXXXGOOXXXXXXXXXXXXXXXXXGOOOOOXXXXXXXXXXXXXXGOOOOOXXXXXXXXXXXXXXGOOOOOOOOXXXXXXXXXXX,0,600,0
37569,88,0,88,10,402,0,0,410,393,17,GOOXXXXXXXXXXXXXXXXXGOOOOOXXXXXXXXXXXXXXGOOOOOOOOOXXXXXXXXXXGOOOOOXXXXXXXXXXXXXXGOOXXXXXXXXXXXXXXXXXGOOOOOOXXXXXXXXXXXXXGOOOOOOXXXXXXXXXXXXXGOOOOOOOOOXXXXXXXXXXGOOOOOOOOOOOXXXXXXXXGOOXXXXXXXXXXXXXXXXXGOOOOOXXXXXXXXXXXXXXGOOOOOXXXXXXXXXXXXXXGOOOOOOOOXXXXXXXXXXX,0,600,0

37590,88,0,88,10,402,0,0,411,393,18,GOOXXXXXXXXXXXXXXXXXGOOOOOXXXXXXXXXXXXXXGOOOOOOOOOXXXXXXXXXXGOOOOOXXXXXXXXXXXXXXGOOXXXXXXXXXXXXXXXXXGOOOOOOXXXXXXXXXXXXXGOOOOOOXXXXXXXXXXXXXGOOOOOOOOOXXXXXXXXXXGOOOOOOOOOOOXXXXXXXXGOOXXXXXXXXXXXXXXXXXGOOOOOXXXXXXXXXXXXXXGOOOOOXXXXXXXXXXXXXXGOOOOOOOOXXXXXXXXXXX,0,600,0
37611,88,0,88,9,403,0,0,411,396,15,GOOXXXXXXXXXXXXXXXXXGOOOOOXXXXXXXXXXXXXXGOOOOOOOOOXXXXXXXXXXGOOOOOXXXXXXXXXXXXXXGOOXXXXXXXXXXXXXXXXXGOOOOOOXXXXXXXXXXXXXGOOOOOOXXXXXXXXXXXXXGOOOOOOOOOXXXXXXXXXXGOOOOOOOOOOOXXXXXXXXGOOXXXXXXXXXXXXXXXXXGOOOOOXXXXXXXXXXXXXXGOOOOOXXXXXXXXXXXXXXGOOOOOOOOXXXXXXXXXXX,0,600,0
37632,88,0,88,12,400,0,0,408,395,13,GOOXXXXXXXXXXXXXXXXXGOOOOOXXXXXXXXXXXXXXGOOOOOOOOOXXXXXXXXXXGOOOOOXXXXXXXXXXXXXXGOOXXXXXXXXXXXXXXXXXGOOOOOOXXXXXXXXXXXXXGOOOOOOXXXXXXXXXXXXXGOOOOOOOOOXXXXXXXXXXGOOOOOOOOOOOXXXXXXXXGOOXXXXXXXXXXXXXXXXXGOOOOOXXXXXXXXXXXXXXGOOOOOXXXXXXXXXXXXXXGOOOOOOOOXXXXXXXXXXX,0,600,0
37653,88,0,88,14,398,0,0,406,394,12,GOOXXXXXXXXXXXXXXXXXGOOOOOXXXXXXXXXXXXXXGOOOOOOOOOXXXXXXXXXXGOOOOOXXXXXXXXXXXXXXGOOXXXXXXXXXXXXXXXXXGOOOOOOXXXXXXXXXXXXXGOOOOOOXXXXXXXXXXXXXGOOOOOOOOOXXXXXXXXXXGOOOOOOOOOOOXXXXXXXXGOOXXXXXXXXXXXXXXXXXGOOOOOXXXXXXXXXXXXXXGOOOOOXXXXXXXXXXXXXXGOOOOOOOOXXXXXXXXXXX,0,600,0
37674,88,0,88,14,398,0,0,406,396,10,GOOXXXXXXXXXXXXXXXXXGOOOOOXXXXXXXXXXXXXXGOOOOOOOOOXXXXXXXXXXGOOOOOXXXXXXXXXXXXXXGOOXXXXXXXXXXXXXXXXXGOOOOOOXXXXXXXXXXXXXGOOOOOOXXXXXXXXXXXXXGOOOOOOOOOXXXXXXXXXXGOOOOOOOOOOOXXXXXXXXGOOXXXXXXXXXXXXXXXXXGOOOOOXXXXXXXXXXXXXXGOOOOOXXXXXXXXXXXXXXGOOOOOOOOXXXXXXXXXXX,0,600,0

37695,88,0,88,15,397,0,0,405,395,10,GOOXXXXXXXXXXXXXXXXXGOOOOOXXXXXXXXXXXXXXGOOOOOOOOOXXXXXXXXXXGOOOOOXXXXXXXXXXXXXXGOOXXXXXXXXXXXXXXXXXGOOOOOOXXXXXXXXXXXXXGOOOOOOXXXXXXXXXXXXXGOOOOOOOOOXXXXXXXXXXGOOOOOOOOOOOXXXXXXXXGOOXXXXXXXXXXXXXXXXXGOOOOOXXXXXXXXXXXXXXGOOOOOXXXXXXXXXXXXXXGOOOOOOOOXXXXXXXXXXX,0,600,0
37716,88,0,88,15,397,0,0,405,395,10,GOOXXXXXXXXXXXXXXXXXGOOOOOXXXXXXXXXXXXXXGOOOOOOOOOXXXXXXXXXXGOOOOOXXXXXXXXXXXXXXGOOXXXXXXXXXXXXXXXXXGOOOOOOXXXXXXXXXXXXXGOOOOOOXXXXXXXXXXXXXGOOOOOOOOOXXXXXXXXXXGOOOOOOOOOOOXXXXXXXXGOOXXXXXXXXXXXXXXXXXGOOOOOXXXXXXXXXXXXXXGOOOOOXXXXXXXXXXXXXXGOOOOOOOOXXXXXXXXXXX,0,600,0
37737,88,0,88,15,397,0,0,405,394,11,GOOXXXXXXXXXXXXXXXXXGOOOOOXXXXXXXXXXXXXXGOOOOOOOOOXXXXXXXXXXGOOOOOXXXXXXXXXXXXXXGOOXXXXXXXXXXXXXXXXXGOOOOOOXXXXXXXXXXXXXGOOOOOOXXXXXXXXXXXXXGOOOOOOOOOXXXXXXXXXXGOOOOOOOOOOOXXXXXXXXGOOXXXXXXXXXXXXXXXXXGOOOOOXXXXXXXXXXXXXXGOOOOOXXXXXXXXXXXXXXGOOOOOOOOXXXXXXXXXXX,0,600,0
37758,88,0,88,13,399,0,0,407,394,13,GOOXXXXXXXXXXXXXXXXXGOOOOOXXXXXXXXXXXXXXGOOOOOOOOOXXXXXXXXXXGOOOOOXXXXXXXXXXXXXXGOOXXXXXXXXXXXXXXXXXGOOOOOOXXXXXXXXXXXXXGOOOOOOXXXXXXXXXXXXXGOOOOOOOOOXXXXXXXXXXGOOOOOOOOOOOXXXXXXXXGOOXXXXXXXXXXXXXXXXXGOOOOOXXXXXXXXXXXXXXGOOOOOXXXXXXXXXXXXXXGOOOOOOOOXXXXXXXXXXX,0,600,0
37779,88,0,88,13,399,0,0,407,394,13,GOOXXXXXXXXXXXXXXXXXGOOOOOXXXXXXXXXXXXXXGOOOOOOOOOXXXXXXXXXXGOOOOOXXXXXXXXXXXXXXGOOXXXXXXXXXXXXXXXXXGOOOOOOXXXXXXXXXXXXXGOOOOOOXXXXXXXXXXXXXGOOOOOOOOOXXXXXXXXXXGOOOOOOOOOOOXXXXXXXXGOOXXXXXXXXXXXXXXXXXGOOOOOXXXXXXXXXXXXXXGOOOOOXXXXXXXXXXXXXXGOOOOOOOOXXXXXXXXXXX,0,600,0

37800,88,0,88,12,400,0,0,408,394,14,GOOXXXXXXXXXXXXXXXXXGOOOOOXXXXXXXXXXXXXXGOOOOOOOOOXXXXXXXXXXGOOOOOXXXXXXXXXXXXXXGOOXXXXXXXXXXXXXXXXXGOOOOOOXXXXXXXXXXXXXGOOOOOOXXXXXXXXXXXXXGOOOOOOOOOXXXXXXXXXXGOOOOOOOOOOOXXXXXXXXGOOXXXXXXXXXXXXXXXXXGOOOOOXXXXXXXXXXXXXXGOOOOOXXXXXXXXXXXXXXGOOOOOOOOXXXXXXXXXXX,0,600,0
37821,88,0,88,8,404,0,0,412,395,17,GOOXXXXXXXXXXXXXXXXXGOOOOOXXXXXXXXXXXXXXGOOOOOOOOOXXXXXXXXXXGOOOOOXXXXXXXXXXXXXXGOOXXXXXXXXXXXXXXXXXGOOOOOOXXXXXXXXXXXXXGOOOOOOXXXXXXXXXXXXXGOOOOOOOOOXXXXXXXXXXGOOOOOOOOOOOXXXXXXXXGOOXXXXXXXXXXXXXXXXXGOOOOOXXXXXXXXXXXXXXGOOOOOXXXXXXXXXXXXXXGOOOOOOOOXXXXXXXXXXX,0,600,0
37842,88,0,88,11,401,0,0,409,395,14,GOOXXXXXXXXXXXXXXXXXGOOOOOXXXXXXXXXXXXXXGOOOOOOOOOXXXXXXXXXXGOOOOOXXXXXXXXXXXXXXGOOXXXXXXXXXXXXXXXXXGOOOOOOXXXXXXXXXXXXXGOOOOOOXXXXXXXXXXXXXGOOOOOOOOOXXXXXXXXXXGOOOOOOOOOOOXXXXXXXXGOOXXXXXXXXXXXXXXXXXGOOOOOXXXXXXXXXXXXXXGOOOOOXXXXXXXXXXXXXXGOOOOOOOOXXXXXXXXXXX,0,600,0
37863,88,0,88,8,404,0,0,412,394,18,GOOXXXXXXXXXXXXXXXXXGOOOOOXXXXXXXXXXXXXXGOOOOOOOOOXXXXXXXXXXGOOOOOXXXXXXXXXXXXXXGOOXXXXXXXXXXXXXXXXXGOOOOOOXXXXXXXXXXXXXGOOOOOOXXXXXXXXXXXXXGOOOOOOOOOXXXXXXXXXXGOOOOOOOOOOOXXXXXXXXGOOXXXXXXXXXXXXXXXXXGOOOOOXXXXXXXXXXXXXXGOOOOOXXXXXXXXXXXXXXGOOOOOOOOXXXXXXXXXXX,0,600,0
37884,88,0,88,7,405,0,0,412,394,18,GOOXXXXXXXXXXXXXXXXXGOOOOOXXXXXXXXXXXXXXGOOOOOOOOOXXXXXXXXXXGOOOOOXXXXXXXXXXXXXXGOOXXXXXXXXXXXXXXXXXGOOOOOOXXXXXXXXXXXXXGOOOOOOXXXXXXXXXXXXXGOOOOOOOOOXXXXXXXXXXGOOOOOOOOOOOXXXXXXXXGOOXXXXXXXXXXXXXXXXXGOOOOOXXXXXXXXXXXXXXGOOOOOXXXXXXXXXXXXXXGOOOOOOOOXXXXXXXXXXX,0,600,0

37905,88,0,88,7,405,0,0,413,395,18,GOOXXXXXXXXXXXXXXXXXGOOOOOXXXXXXXXXXXXXXGOOOOOOOOOXXXXXXXXXXGOOOOOXXXXXXXXXXXXXXGOOXXXXXXXXXXXXXXXXXGOOOOOOXXXXXXXXXXXXXGOOOOOOXXXXXXXXXXXXXGOOOOOOOOOXXXXXXXXXXGOOOOOOOOOOOXXXXXXXXGOOXXXXXXXXXXXXXXXXXGOOOOOXXXXXXXXXXXXXXGOOOOOXXXXXXXXXXXXXXGOOOOOOOOXXXXXXXXXXX,0,600,0
37926,88,0,88,7,405,0,0,413,394,19,GOOXXXXXXXXXXXXXXXXXGOOOOOXXXXXXXXXXXXXXGOOOOOOOOOXXXXXXXXXXGOOOOOXXXXXXXXXXXXXXGOOXXXXXXXXXXXXXXXXXGOOOOOOXXXXXXXXXXXXXGOOOOOOXXXXXXXXXXXXXGOOOOOOOOOXXXXXXXXXXGOOOOOOOOOOOXXXXXXXXGOOXXXXXXXXXXXXXXXXXGOOOOOXXXXXXXXXXXXXXGOOOOOXXXXXXXXXXXXXXGOOOOOOOOXXXXXXXXXXX,0,600,0
37947,88,0,88,6,406,0,0,414,395,19,GOOXXXXXXXXXXXXXXXXXGOOOOOXXXXXXXXXXXXXXGOOOOOOOOOXXXXXXXXXXGOOOOOXXXXXXXXXXXXXXGOOXXXXXXXXXXXXXXXXXGOOOOOOXXXXXXXXXXXXXGOOOOOOXXXXXXXXXXXXXGOOOOOOOOOXXXXXXXXXXGOOOOOOOOOOOXXXXXXXXGOOXXXXXXXXXXXXXXXXXGOOOOOXXXXXXXXXXXXXXGOOOOOXXXXXXXXXXXXXXGOOOOOOOOXXXXXXXXXXX,0,600,0
37968,88,0,88,5,407,0,0,415,394,21,GOOXXXXXXXXXXXXXXXXXGOOOOOXXXXXXXXXXXXXXGOOOOOOOOOXXXXXXXXXXGOOOOOXXXXXXXXXXXXXXGOOXXXXXXXXXXXXXXXXXGOOOOOOXXXXXXXXXXXXXGOOOOOOXXXXXXXXXXXXXGOOOOOOOOOXXXXXXXXXXGOOOOOOOOOOOXXXXXXXXGOOXXXXXXXXXXXXXXXXXGOOOOOXXXXXXXXXXXXXXGOOOOOXXXXXXXXXXXXXXGOOOOOOOOXXXXXXXXXXX,0,600,0
37989,88,0,88,4,408,0,0,416,395,21,GOOXXXXXXXXXXXXXXXXXGOOOOOXXXXXXXXXXXXXXGOOOOOOOOOXXXXXXXXXXGOOOOOXXXXXXXXXXXXXXGOOXXXXXXXXXXXXXXXXXGOOOOOOXXXXXXXXXXXXXGOOOOOOXXXXXXXXXXXXXGOOOOOOOOOXXXXXXXXXXGOOOOOOOOOOOXXXXXXXXGOOXXXXXXXXXXXXXXXXXGOOOOOXXXXXXXXXXXXXXGOOOOOXXXXXXXXXXXXXXGOOOOOOOOXXXXXXXXXXX,0,600,0

38010,88,0,88,4,408,0,0,416,395,21,GOOXXXXXXXXXXXXXXXXXGOOOOOXXXXXXXXXXXXXXGOOOOOOOOOXXXXXXXXXXGOOOOOXXXXXXXXXXXXXXGOOXXXXXXXXXXXXXXXXXGOOOOOOXXXXXXXXXXXXXGOOOOOOXXXXXXXXXXXXXGOOOOOOOOOXXXXXXXXXXGOOOOOOOOOOOXXXXXXXXGOOXXXXXXXXXXXXXXXXXGOOOOOXXXXXXXXXXXXXXGOOOOOXXXXXXXXXXXXXXGOOOOOOOOXXXXXXXXXXX,0,600,0
38031,88,0,88,2,410,0,0,418,395,23,GOOXXXXXXXXXXXXXXXXXGOOOOOXXXXXXXXXXXXXXGOOOOOOOOOXXXXXXXXXXGOOOOOXXXXXXXXXXXXXXGOOXXXXXXXXXXXXXXXXXGOOOOOOXXXXXXXXXXXXXGOOOOOOXXXXXXXXXXXXXGOOOOOOOOOXXXXXXXXXXGOOOOOOOOOOOXXXXXXXXGOOXXXXXXXXXXXXXXXXXGOOOOOXXXXXXXXXXXXXXGOOOOOXXXXXXXXXXXXXXGOOOOOOOOXXXXXXXXXXX,0,600,0
38052,88,0,88,3,409,0,0,417,397,20,GOOXXXXXXXXXXXXXXXXXGOOOOOXXXXXXXXXXXXXXGOOOOOOOOOXXXXXXXXXXGOOOOOXXXXXXXXXXXXXXGOOXXXXXXXXXXXXXXXXXGOOOOOOXXXXXXXXXXXXXGOOOOOOXXXXXXXXXXXXXGOOOOOOOOOXXXXXXXXXXGOOOOOOOOOOOXXXXXXXXGOOXXXXXXXXXXXXXXXXXGOOOOOXXXXXXXXXXXXXXGOOOOOXXXXXXXXXXXXXXGOOOOOOOOXXXXXXXXXXX,0,600,0
38073,88,0,88,5,407,0,0,415,395,20,GOOXXXXXXXXXXXXXXXXXGOOOOOXXXXXXXXXXXXXXGOOOOOOOOOXXXXXXXXXXGOOOOOXXXXXXXXXXXXXXGOOXXXXXXXXXXXXXXXXXGOOOOOOXXXXXXXXXXXXXGOOOOOOXXXXXXXXXXXXXGOOOOOOOOOXXXXXXXXXXGOOOOOOOOOOOXXXXXXXXGOOXXXXXXXXXXXXXXXXXGOOOOOXXXXXXXXXXXXXXGOOOOOXXXXXXXXXXXXXXGOOOOOOOOXXXXXXXXXXX,0,600,0
38094,88,0,88,6,406,0,0,414,396,18,GOOXXXXXXXXXXXXXXXXXGOOOOOXXXXXXXXXXXXXXGOOOOOOOOOXXXXXXXXXXGOOOOOXXXXXXXXXXXXXXGOOXXXXXXXXXXXXXXXXXGOOOOOOXXXXXXXXXXXXXGOOOOOOXXXXXXXXXXXXXGOOOOOOOOOXXXXXXXXXXGOOOOOOOOOOOXXXXXXXXGOOXXXXXXXXXXXXXXXXXGOOOOOXXXXXXXXXXXXXXGOOOOOXXXXXXXXXXXXXXGOOOOOOOOXXXXXXXXXXX,0,600,0

38115,88,0,88,8,404,0,0,412,396,16,GOOXXXXXXXXXXXXXXXXXGOOOOOXXXXXXXXXXXXXXGOOOOOOOOOXXXXXXXXXXGOOOOOXXXXXXXXXXXXXXGOOXXXXXXXXXXXXXXXXXGOOOOOOXXXXXXXXXXXXXGOOOOOOXXXXXXXXXXXXXGOOOOOOOOOXXXXXXXXXXGOOOOOOOOOOOXXXXXXXXGOOXXXXXXXXXXXXXXXXXGOOOOOXXXXXXXXXXXXXXGOOOOOXXXXXXXXXXXXXXGOOOOOOOOXXXXXXXXXXX,0,600,0
38136,88,0,88,6,406,0,0,414,397,17,GOOXXXXXXXXXXXXXXXXXGOOOOOXXXXXXXXXXXXXXGOOOOOOOOOXXXXXXXXXXGOOOOOXXXXXXXXXXXXXXGOOXXXXXXXXXXXXXXXXXGOOOOOOXXXXXXXXXXXXXGOOOOOOXXXXXXXXXXXXXGOOOOOOOOOXXXXXXXXXXGOOOOOOOOOOOXXXXXXXXGOOXXXXXXXXXXXXXXXXXGOOOOOXXXXXXXXXXXXXXGOOOOOXXXXXXXXXXXXXXGOOOOOOOOXXXXXXXXXXX,0,600,0
38157,88,0,88,8,404,0,0,412,396,16,GOOXXXXXXXXXXXXXXXXXGOOOOOXXXXXXXXXXXXXXGOOOOOOOOOXXXXXXXXXXGOOOOOXXXXXXXXXXXXXXGOOXXXXXXXXXXXXXXXXXGOOOOOOXXXXXXXXXXXXXGOOOOOOXXXXXXXXXXXXXGOOOOOOOOOXXXXXXXXXXGOOOOOOOOOOOXXXXXXXXGOOXXXXXXXXXXXXXXXXXGOOOOOXXXXXXXXXXXXXXGOOOOOXXXXXXXXXXXXXXGOOOOOOOOXXXXXXXXXXX,0,600,0
38178,88,0,88,9,403,0,0,411,395,16,GOOXXXXXXXXXXXXXXXXXGOOOOOXXXXXXXXXXXXXXGOOOOOOOOOXXXXXXXXXXGOOOOOXXXXXXXXXXXXXXGOOXXXXXXXXXXXXXXXXXGOOOOOOXXXXXXXXXXXXXGOOOOOOXXXXXXXXXXXXXGOOOOOOOOOXXXXXXXXXXGOOOOOOOOOOOXXXXXXXXGOOXXXXXXXXXXXXXXXXXGOOOOOXXXXXXXXXXXXXXGOOOOOXXXXXXXXXXXXXXGOOOOOOOOXXXXXXXXXXX,0,600,0
38199,88,0,88,7,405,0,0,413,395,18,GOOXXXXXXXXXXXXXXXXXGOOOOOXXXXXXXXXXXXXXGOOOOOOOOOXXXXXXXXXXGOOOOOXXXXXXXXXXXXXXGOOXXXXXXXXXXXXXXXXXGOOOOOOXXXXXXXXXXXXXGOOOOOOXXXXXXXXXXXXXGOOOOOOOOOXXXXXXXXXXGOOOOOOOOOOOXXXXXXXXGOOXXXXXXXXXXXXXXXXXGOOOOOXXXXXXXXXXXXXXGOOOOOXXXXXXXXXXXXXXGOOOOOOOOXXXXXXXXXXX,0,600,0

38220,88,0,88,10,402,0,0,410,396,14,GOOXXXXXXXXXXXXXXXXXGOOOOOXXXXXXXXXXXXXXGOOOOOOOOOXXXXXXXXXXGOOOOOXXXXXXXXXXXXXXGOOXXXXXXXXXXXXXXXXXGOOOOOOXXXXXXXXXXXXXGOOOOOOXXXXXXXXXXXXXGOOOOOOOOOXXXXXXXXXXGOOOOOOOOOOOXXXXXXXXGOOXXXXXXXXXXXXXXXXXGOOOOOXXXXXXXXXXXXXXGOOOOOXXXXXXXXXXXXXXGOOOOOOOOXXXXXXXXXXX,0,600,0
38241,88,0,88,11,401,0,0,409,395,14,GOOXXXXXXXXXXXXXXXXXGOOOOOXXXXXXXXXXXXXXGOOOOOOOOOXXXXXXXXXXGOOOOOXXXXXXXXXXXXXXGOOXXXXXXXXXXXXXXXXXGOOOOOOXXXXXXXXXXXXXGOOOOOOXXXXXXXXXXXXXGOOOOOOOOOXXXXXXXXXXGOOOOOOOOOOOXXXXXXXXGOOXXXXXXXXXXXXXXXXXGOOOOOXXXXXXXXXXXXXXGOOOOOXXXXXXXXXXXXXXGOOOOOOOOXXXXXXXXXXX,0,600,0
38262,88,0,88,11,401,0,0,409,395,14,GOOXXXXXXXXXXXXXXXXXGOOOOOXXXXXXXXXXXXXXGOOOOOOOOOXXXXXXXXXXGOOOOOXXXXXXXXXXXXXXGOOXXXXXXXXXXXXXXXXXGOOOOOOXXXXXXXXXXXXXGOOOOOOXXXXXXXXXXXXXGOOOOOOOOOXXXXXXXXXXGOOOOOOOOOOOXXXXXXXXGOOXXXXXXXXXXXXXXXXXGOOOOOXXXXXXXXXXXXXXGOOOOOXXXXXXXXXXXXXXGOOOOOOOOXXXXXXXXXXX,0,600,0
38283,88,0,88,9,403,0,0,411,396,15,GOOXXXXXXXXXXXXXXXXXGOOOOOXXXXXXXXXXXXXXGOOOOOOOOOXXXXXXXXXXGOOOOOXXXXXXXXXXXXXXGOOXXXXXXXXXXXXXXXXXGOOOOOOXXXXXXXXXXXXXGOOOOOOXXXXXXXXXXXXXGOOOOOOOOOXXXXXXXXXXGOOOOOOOOOOOXXXXXXXXGOOXXXXXXXXXXXXXXXXXGOOOOOXXXXXXXXXXXXXXGOOOOOXXXXXXXXXXXXXXGOOOOOOOOXXXXXXXXXXX,0,600,0
38304,88,0,88,8,404,0,0,413,396,17,GOOXXXXXXXXXXXXXXXXXGOOOOOXXXXXXXXXXXXXXGOOOOOOOOOXXXXXXXXXXGOOOOOXXXXXXXXXXXXXXGOOXXXXXXXXXXXXXXXXXGOOOOOOXXXXXXXXXXXXXGOOOOOOXXXXXXXXXXXXXGOOOOOOOOOXXXXXXXXXXGOOOOOOOOOOOXXXXXXXXGOOXXXXXXXXXXXXXXXXXGOOOOOXXXXXXXXXXXXXXGOOOOOXXXXXXXXXXXXXXGOOOOOOOOXXXXXXXXXXX,0,600,0

38325,88,0,88,9,403,0,0,412,395,17,GOOXXXXXXXXXXXXXXXXXGOOOOOXXXXXXXXXXXXXXGOOOOOOOOOXXXXXXXXXXGOOOOOXXXXXXXXXXXXXXGOOXXXXXXXXXXXXXXXXXGOOOOOOXXXXXXXXXXXXXGOOOOOOXXXXXXXXXXXXXGOOOOOOOOOXXXXXXXXXXGOOOOOOOOOOOXXXXXXXXGOOXXXXXXXXXXXXXXXXXGOOOOOXXXXXXXXXXXXXXGOOOOOXXXXXXXXXXXXXXGOOOOOOOOXXXXXXXXXXX,0,600,0
38346,88,0,88,10,402,0,0,411,395,16,GOOXXXXXXXXXXXXXXXXXGOOOOOXXXXXXXXXXXXXXGOOOOOOOOOXXXXXXXXXXGOOOOOXXXXXXXXXXXXXXGOOXXXXXXXXXXXXXXXXXGOOOOOOXXXXXXXXXXXXXGOOOOOOXXXXXXXXXXXXXGOOOOOOOOOXXXXXXXXXXGOOOOOOOOOOOXXXXXXXXGOOXXXXXXXXXXXXXXXXXGOOOOOXXXXXXXXXXXXXXGOOOOOXXXXXXXXXXXXXXGOOOOOOOOXXXXXXXXXXX,0,600,0
38367,88,0,88,9,403,0,0,412,396,16,GOOXXXXXXXXXXXXXXXXXGOOOOOXXXXXXXXXXXXXXGOOOOOOOOOXXXXXXXXXXGOOOOOXXXXXXXXXXXXXXGOOXXXXXXXXXXXXXXXXXGOOOOOOXXXXXXXXXXXXXGOOOOOOXXXXXXXXXXXXXGOOOOOOOOOXXXXXXXXXXGOOOOOOOOOOOXXXXXXXXGOOXXXXXXXXXXXXXXXXXGOOOOOXXXXXXXXXXXXXXGOOOOOXXXXXXXXXXXXXXGOOOOOOOOXXXXXXXXXXX,0,600,0
38388,88,0,88,8,404,0,0,412,396,16,GOOXXXXXXXXXXXXXXXXXGOOOOOXXXXXXXXXXXXXXGOOOOOOOOOXXXXXXXXXXGOOOOOXXXXXXXXXXXXXXGOOXXXXXXXXXXXXXXXXXGOOOOOOXXXXXXXXXXXXXGOOOOOOXXXXXXXXXXXXXGOOOOOOOOOXXXXXXXXXXGOOOOOOOOOOOXXXXXXXXGOOXXXXXXXXXXXXXXXXXGOOOOOXXXXXXXXXXXXXXGOOOOOXXXXXXXXXXXXXXGOOOOOOOOXXXXXXXXXXX,0,600,0
38409,88,0,88,10,402,0,0,410,394,16,GOOXXXXXXXXXXXXXXXXXGOOOOOXXXXXXXXXXXXXXGOOOOOOOOOXXXXXXXXXXGOOOOOXXXXXXXXXXXXXXGOOXXXXXXXXXXXXXXXXXGOOOOOOXXXXXXXXXXXXXGOOOOOOXXXXXXXXXXXXXGOOOOOOOOOXXXXXXXXXXGOOOOOOOOOOOXXXXXXXXGOOXXXXXXXXXXXXXXXXXGOOOOOXXXXXXXXXXXXXXGOOOOOXXXXXXXXXXXXXXGOOOOOOOOXXXXXXXXXXX,0,600,0

38430,88,0,88,9,403,0,0,410,394,16,GOOXXXXXXXXXXXXXXXXXGOOOOOXXXXXXXXXXXXXXGOOOOOOOOOXXXXXXXXXXGOOOOOXXXXXXXXXXXXXXGOOXXXXXXXXXXXXXXXXXGOOOOOOXXXXXXXXXXXXXGOOOOOOXXXXXXXXXXXXXGOOOOOOOOOXXXXXXXXXXGOOOOOOOOOOOXXXXXXXXGOOXXXXXXXXXXXXXXXXXGOOOOOXXXXXXXXXXXXXXGOOOOOXXXXXXXXXXXXXXGOOOOOOOOXXXXXXXXXXX,0,600,0
38451,88,0,88,7,405,0,0,413,394,19,GOOXXXXXXXXXXXXXXXXXGOOOOOXXXXXXXXXXXXXXGOOOOOOOOOXXXXXXXXXXGOOOOOXXXXXXXXXXXXXXGOOXXXXXXXXXXXXXXXXXGOOOOOOXXXXXXXXXXXXXGOOOOOOXXXXXXXXXXXXXGOOOOOOOOOXXXXXXXXXXGOOOOOOOOOOOXXXXXXXXGOOXXXXXXXXXXXXXXXXXGOOOOOXXXXXXXXXXXXXXGOOOOOXXXXXXXXXXXXXXGOOOOOOOOXXXXXXXXXXX,0,600,0
38472,88,0,88,8,404,0,0,412,394,18,GOOXXXXXXXXXXXXXXXXXGOOOOOXXXXXXXXXXXXXXGOOOOOOOOOXXXXXXXXXXGOOOOOXXXXXXXXXXXXXXGOOXXXXXXXXXXXXXXXXXGOOOOOOXXXXXXXXXXXXXGOOOOOOXXXXXXXXXXXXXGOOOOOOOOOXXXXXXXXXXGOOOOOOOOOOOXXXXXXXXGOOXXXXXXXXXXXXXXXXXGOOOOOXXXXXXXXXXXXXXGOOOOOXXXXXXXXXXXXXXGOOOOOOOOXXXXXXXXXXX,0,600,0
38493,88,0,88,6,406,0,0,414,395,19,GOOXXXXXXXXXXXXXXXXXGOOOOOXXXXXXXXXXXXXXGOOOOOOOOOXXXXXXXXXXGOOOOOXXXXXXXXXXXXXXGOOXXXXXXXXXXXXXXXXXGOOOOOOXXXXXXXXXXXXXGOOOOOOXXXXXXXXXXXXXGOOOOOOOOOXXXXXXXXXXGOOOOOOOOOOOXXXXXXXXGOOXXXXXXXXXXXXXXXXXGOOOOOXXXXXXXXXXXXXXGOOOOOXXXXXXXXXXXXXXGOOOOOOOOXXXXXXXXXXX,0,600,0
38514,88,0,88,6,406,0,0,414,395,19,GOOXXXXXXXXXXXXXXXXXGOOOOOXXXXXXXXXXXXXXGOOOOOOOOOXXXXXXXXXXGOOOOOXXXXXXXXXXXXXXGOOXXXXXXXXXXXXXXXXXGOOOOOOXXXXXXXXXXXXXGOOOOOOXXXXXXXXXXXXXGOOOOOOOOOXXXXXXXXXXGOOOOOOOOOOOXXXXXXXXGOOXXXXXXXXXXXXXXXXXGOOOOOXXXXXXXXXXXXXXGOOOOOXXXXXXXXXXXXXXGOOOOOOOOXXXXXXXXXXX,0,600,0

38535,88,0,88,6,406,0,0,414,395,19,GOOXXXXXXXXXXXXXXXXXGOOOOOXXXXXXXXXXXXXXGOOOOOOOOOXXXXXXXXXXGOOOOOXXXXXXXXXXXXXXGOOXXXXXXXXXXXXXXXXXGOOOOOOXXXXXXXXXXXXXGOOOOOOXXXXXXXXXXXXXGOOOOOOOOOXXXXXXXXXXGOOOOOOOOOOOXXXXXXXXGOOXXXXXXXXXXXXXXXXXGOOOOOXXXXXXXXXXXXXXGOOOOOXXXXXXXXXXXXXXGOOOOOOOOXXXXXXXXXXX,0,600,0
38556,88,0,88,8,404,0,0,412,394,18,GOOXXXXXXXXXXXXXXXXXGOOOOOXXXXXXXXXXXXXXGOOOOOOOOOXXXXXXXXXXGOOOOOXXXXXXXXXXXXXXGOOXXXXXXXXXXXXXXXXXGOOOOOOXXXXXXXXXXXXXGOOOOOOXXXXXXXXXXXXXGOOOOOOOOOXXXXXXXXXXGOOOOOOOOOOOXXXXXXXXGOOXXXXXXXXXXXXXXXXXGOOOOOXXXXXXXXXXXXXXGOOOOOXXXXXXXXXXXXXXGOOOOOOOOXXXXXXXXXXX,0,600,0
38577,88,0,88,7,405,0,0,413,394,19,GOOXXXXXXXXXXXXXXXXXGOOOOOXXXXXXXXXXXXXXGOOOOOOOOOXXXXXXXXXXGOOOOOXXXXXXXXXXXXXXGOOXXXXXXXXXXXXXXXXXGOOOOOOXXXXXXXXXXXXXGOOOOOOXXXXXXXXXXXXXGOOOOOOOOOXXXXXXXXXXGOOOOOOOOOOOXXXXXXXXGOOXXXXXXXXXXXXXXXXXGOOOOOXXXXXXXXXXXXXXGOOOOOXXXXXXXXXXXXXXGOOOOOOOOXXXXXXXXXXX,0,600,0
38598,88,0,88,7,405,0,0,413,394,19,GOOXXXXXXXXXXXXXXXXXGOOOOOXXXXXXXXXXXXXXGOOOOOOOOOXXXXXXXXXXGOOOOOXXXXXXXXXXXXXXGOOXXXXXXXXXXXXXXXXXGOOOOOOXXXXXXXXXXXXXGOOOOOOXXXXXXXXXXXXXGOOOOOOOOOXXXXXXXXXXGOOOOOOOOOOOXXXXXXXXGOOXXXXXXXXXXXXXXXXXGOOOOOXXXXXXXXXXXXXXGOOOOOXXXXXXXXXXXXXXGOOOOOOOOXXXXXXXXXXX,0,600,0
38619,88,0,88,7,405,0,0,413,395,18,GOOXXXXXXXXXXXXXXXXXGOOOOOXXXXXXXXXXXXXXGOOOOOOOOOXXXXXXXXXXGOOOOOXXXXXXXXXXXXXXGOOXXXXXXXXXXXXXXXXXGOOOOOOXXXXXXXXXXXXXGOOOOOOXXXXXXXXXXXXXGOOOOOOOOOXXXXXXXXXXGOOOOOOOOOOOXXXXXXXXGOOXXXXXXXXXXXXXXXXXGOOOOOXXXXXXXXXXXXXXGOOOOOXXXXXXXXXXXXXXGOOOOOOOOXXXXXXXXXXX,0,600,0

38640,88,0,88,9,403,0,0,411,394,17,GOOXXXXXXXXXXXXXXXXXGOOOOOXXXXXXXXXXXXXXGOOOOOOOOOXXXXXXXXXXGOOOOOXXXXXXXXXXXXXXGOOXXXXXXXXXXXXXXXXXGOOOOOOXXXXXXXXXXXXXGOOOOOOXXXXXXXXXXXXXGOOOOOOOOOXXXXXXXXXXGOOOOOOOOOOOXXXXXXXXGOOXXXXXXXXXXXXXXXXXGOOOOOXXXXXXXXXXXXXXGOOOOOXXXXXXXXXXXXXXGOOOOOOOOXXXXXXXXXXX,0,600,0
38661,88,0,88,10,402,0,0,410,396,14,GOOXXXXXXXXXXXXXXXXXGOOOOOXXXXXXXXXXXXXXGOOOOOOOOOXXXXXXXXXXGOOOOOXXXXXXXXXXXXXXGOOXXXXXXXXXXXXXXXXXGOOOOOOXXXXXXXXXXXXXGOOOOOOXXXXXXXXXXXXXGOOOOOOOOOXXXXXXXXXXGOOOOOOOOOOOXXXXXXXXGOOXXXXXXXXXXXXXXXXXGOOOOOXXXXXXXXXXXXXXGOOOOOXXXXXXXXXXXXXXGOOOOOOOOXXXXXXXXXXX,0,600,0
38682,88,0,88,10,402,0,0,410,396,14,GOOXXXXXXXXXXXXXXXXXGOOOOOXXXXXXXXXXXXXXGOOOOOOOOOXXXXXXXXXXGOOOOOXXXXXXXXXXXXXXGOOXXXXXXXXXXXXXXXXXGOOOOOOXXXXXXXXXXXXXGOOOOOOXXXXXXXXXXXXXGOOOOOOOOOXXXXXXXXXXGOOOOOOOOOOOXXXXXXXXGOOXXXXXXXXXXXXXXXXXGOOOOOXXXXXXXXXXXXXXGOOOOOXXXXXXXXXXXXXXGOOOOOOOOXXXXXXXXXXX,0,600,0
38703,88,0,88,10,402,0,0,411,395,16,GOOXXXXXXXXXXXXXXXXXGOOOOOXXXXXXXXXXXXXXGOOOOOOOOOXXXXXXXXXXGOOOOOXXXXXXXXXXXXXXGOOXXXXXXXXXXXXXXXXXGOOOOOOXXXXXXXXXXXXXGOOOOOOXXXXXXXXXXXXXGOOOOOOOOOXXXXXXXXXXGOOOOOOOOOOOXXXXXXXXGOOXXXXXXXXXXXXXXXXXGOOOOOXXXXXXXXXXXXXXGOOOOOXXXXXXXXXXXXXXGOOOOOOOOXXXXXXXXXXX,0,600,0
38724,88,0,88,11,401,0,0,411,396,15,GOOXXXXXXXXXXXXXXXXXGOOOOOXXXXXXXXXXXXXXGOOOOOOOOOXXXXXXXXXXGOOOOOXXXXXXXXXXXXXXGOOXXXXXXXXXXXXXXXXXGOOOOOOXXXXXXXXXXXXXGOOOOOOXXXXXXXXXXXXXGOOOOOOOOOXXXXXXXXXXGOOOOOOOOOOOXXXXXXXXGOOXXXXXXXXXXXXXXXXXGOOOOOXXXXXXXXXXXXXXGOOOOOXXXXXXXXXXXXXXGOOOOOOOOXXXXXXXXXXX,0,600,0

38745,88,0,88,10,402,0,0,412,395,17,GOOXXXXXXXXXXXXXXXXXGOOOOOXXXXXXXXXXXXXXGOOOOOOOOOXXXXXXXXXXGOOOOOXXXXXXXXXXXXXXGOOXXXXXXXXXXXXXXXXXGOOOOOOXXXXXXXXXXXXXGOOOOOOXXXXXXXXXXXXXGOOOOOOOOOXXXXXXXXXXGOOOOOOOOOOOXXXXXXXXGOOXXXXXXXXXXXXXXXXXGOOOOOXXXXXXXXXXXXXXGOOOOOXXXXXXXXXXXXXXGOOOOOOOOXXXXXXXXXXX,0,600,0
38766,88,0,88,9,403,0,0,413,395,18,GOOXXXXXXXXXXXXXXXXXGOOOOOXXXXXXXXXXXXXXGOOOOOOOOOXXXXXXXXXXGOOOOOXXXXXXXXXXXXXXGOOXXXXXXXXXXXXXXXXXGOOOOOOXXXXXXXXXXXXXGOOOOOOXXXXXXXXXXXXXGOOOOOOOOOXXXXXXXXXXGOOOOOOOOOOOXXXXXXXXGOOXXXXXXXXXXXXXXXXXGOOOOOXXXXXXXXXXXXXXGOOOOOXXXXXXXXXXXXXXGOOOOOOOOXXXXXXXXXXX,0,600,0
38787,88,0,88,7,405,0,0,415,396,19,GOOXXXXXXXXXXXXXXXXXGOOOOOXXXXXXXXXXXXXXGOOOOOOOOOXXXXXXXXXXGOOOOOXXXXXXXXXXXXXXGOOXXXXXXXXXXXXXXXXXGOOOOOOXXXXXXXXXXXXXGOOOOOOXXXXXXXXXXXXXGOOOOOOOOOXXXXXXXXXXGOOOOOOOOOOOXXXXXXXXGOOXXXXXXXXXXXXXXXXXGOOOOOXXXXXXXXXXXXXXGOOOOOXXXXXXXXXXXXXXGOOOOOOOOXXXXXXXXXXX,0,600,0
38808,88,0,88,8,404,0,0,414,395,19,GOOXXXXXXXXXXXXXXXXXGOOOOOXXXXXXXXXXXXXXGOOOOOOOOOXXXXXXXXXXGOOOOOXXXXXXXXXXXXXXGOOXXXXXXXXXXXXXXXXXGOOOOOOXXXXXXXXXXXXXGOOOOOOXXXXXXXXXXXXXGOOOOOOOOOXXXXXXXXXXGOOOOOOOOOOOXXXXXXXXGOOXXXXXXXXXXXXXXXXXGOOOOOXXXXXXXXXXXXXXGOOOOOXXXXXXXXXXXXXXGOOOOOOOOXXXXXXXXXXX,0,600,0
38829,88,0,88,7,405,0,0,415,395,20,GOOXXXXXXXXXXXXXXXXXGOOOOOXXXXXXXXXXXXXXGOOOOOOOOOXXXXXXXXXXGOOOOOXXXXXXXXXXXXXXGOOXXXXXXXXXXXXXXXXXGOOOOOOXXXXXXXXXXXXXGOOOOOOXXXXXXXXXXXXXGOOOOOOOOOXXXXXXXXXXGOOOOOOOOOOOXXXXXXXXGOOXXXXXXXXXXXXXXXXXGOOOOOXXXXXXXXXXXXXXGOOOOOXXXXXXXXXXXXXXGOOOOOOOOXXXXXXXXXXX,0,600,0

38850,88,0,88,7,405,0,0,415,396,19,GOOXXXXXXXXXXXXXXXXXGOOOOOXXXXXXXXXXXXXXGOOOOOOOOOXXXXXXXXXXGOOOOOXXXXXXXXXXXXXXGOOXXXXXXXXXXXXXXXXXGOOOOOOXXXXXXXXXXXXXGOOOOOOXXXXXXXXXXXXXGOOOOOOOOOXXXXXXXXXXGOOOOOOOOOOOXXXXXXXXGOOXXXXXXXXXXXXXXXXXGOOOOOXXXXXXXXXXXXXXGOOOOOXXXXXXXXXXXXXXGOOOOOOOOXXXXXXXXXXX,0,600,0
38871,88,0,88,7,405,0,0,415,396,19,GOOXXXXXXXXXXXXXXXXXGOOOOOXXXXXXXXXXXXXXGOOOOOOOOOXXXXXXXXXXGOOOOOXXXXXXXXXXXXXXGOOXXXXXXXXXXXXXXXXXGOOOOOOXXXXXXXXXXXXXGOOOOOOXXXXXXXXXXXXXGOOOOOOOOOXXXXXXXXXXGOOOOOOOOOOOXXXXXXXXGOOXXXXXXXXXXXXXXXXXGOOOOOXXXXXXXXXXXXXXGOOOOOXXXXXXXXXXXXXXGOOOOOOOOXXXXXXXXXXX,0,600,0
38892,88,0,88,6,406,0,0,416,396,20,GOOXXXXXXXXXXXXXXXXXGOOOOOXXXXXXXXXXXXXXGOOOOOOOOOXXXXXXXXXXGOOOOOXXXXXXXXXXXXXXGOOXXXXXXXXXXXXXXXXXGOOOOOOXXXXXXXXXXXXXGOOOOOOXXXXXXXXXXXXXGOOOOOOOOOXXXXXXXXXXGOOOOOOOOOOOXXXXXXXXGOOXXXXXXXXXXXXXXXXXGOOOOOXXXXXXXXXXXXXXGOOOOOXXXXXXXXXXXXXXGOOOOOOOOXXXXXXXXXXX,0,600,0
38913,88,0,88,5,407,0,0,417,396,21,GOOXXXXXXXXXXXXXXXXXGOOOOOXXXXXXXXXXXXXXGOOOOOOOOOXXXXXXXXXXGOOOOOXXXXXXXXXXXXXXGOOXXXXXXXXXXXXXXXXXGOOOOOOXXXXXXXXXXXXXGOOOOOOXXXXXXXXXXXXXGOOOOOOOOOXXXXXXXXXXGOOOOOOOOOOOXXXXXXXXGOOXXXXXXXXXXXXXXXXXGOOOOOXXXXXXXXXXXXXXGOOOOOXXXXXXXXXXXXXXGOOOOOOOOXXXXXXXXXXX,0,600,0
38934,88,0,88,5,407,0,0,417,397,20,GOOXXXXXXXXXXXXXXXXXGOOOOOXXXXXXXXXXXXXXGOOOOOOOOOXXXXXXXXXXGOOOOOXXXXXXXXXXXXXXGOOXXXXXXXXXXXXXXXXXGOOOOOOXXXXXXXXXXXXXGOOOOOOXXXXXXXXXXXXXGOOOOOOOOOXXXXXXXXXXGOOOOOOOOOOOXXXXXXXXGOOXXXXXXXXXXXXXXXXXGOOOOOXXXXXXXXXXXXXXGOOOOOXXXXXXXXXXXXXXGOOOOOOOOXXXXXXXXXXX,0,600,0

38955,88,0,88,5,407,0,0,416,398,18,GOOXXXXXXXXXXXXXXXXXGOOOOOXXXXXXXXXXXXXXGOOOOOOOOOXXXXXXXXXXGOOOOOXXXXXXXXXXXXXXGOOXXXXXXXXXXXXXXXXXGOOOOOOXXXXXXXXXXXXXGOOOOOOXXXXXXXXXXXXXGOOOOOOOOOXXXXXXXXXXGOOOOOOOOOOOXXXXXXXXGOOXXXXXXXXXXXXXXXXXGOOOOOXXXXXXXXXXXXXXGOOOOOXXXXXXXXXXXXXXGOOOOOOOOXXXXXXXXXXX,0,600,0
38976,88,0,88,6,406,0,0,415,396,19,GOOXXXXXXXXXXXXXXXXXGOOOOOXXXXXXXXXXXXXXGOOOOOOOOOXXXXXXXXXXGOOOOOXXXXXXXXXXXXXXGOOXXXXXXXXXXXXXXXXXGOOOOOOXXXXXXXXXXXXXGOOOOOOXXXXXXXXXXXXXGOOOOOOOOOXXXXXXXXXXGOOOOOOOOOOOXXXXXXXXGOOXXXXXXXXXXXXXXXXXGOOOOOXXXXXXXXXXXXXXGOOOOOXXXXXXXXXXXXXXGOOOOOOOOXXXXXXXXXXX,0,600,0
38997,88,0,88,5,407,0,0,416,396,20,GOOXXXXXXXXXXXXXXXXXGOOOOOXXXXXXXXXXXXXXGOOOOOOOOOXXXXXXXXXXGOOOOOXXXXXXXXXXXXXXGOOXXXXXXXXXXXXXXXXXGOOOOOOXXXXXXXXXXXXXGOOOOOOXXXXXXXXXXXXXGOOOOOOOOOXXXXXXXXXXGOOOOOOOOOOOXXXXXXXXGOOXXXXXXXXXXXXXXXXXGOOOOOXXXXXXXXXXXXXXGOOOOOXXXXXXXXXXXXXXGOOOOOOOOXXXXXXXXXXX,0,600,0
39018,88,0,88,5,407,0,0,416,396,20,GOOXXXXXXXXXXXXXXXXXGOOOOOXXXXXXXXXXXXXXGOOOOOOOOOXXXXXXXXXXGOOOOOXXXXXXXXXXXXXXGOOXXXXXXXXXXXXXXXXXGOOOOOOXXXXXXXXXXXXXGOOOOOOXXXXXXXXXXXXXGOOOOOOOOOXXXXXXXXXXGOOOOOOOOOOOXXXXXXXXGOOXXXXXXXXXXXXXXXXXGOOOOOXXXXXXXXXXXXXXGOOOOOXXXXXXXXXXXXXXGOOOOOOOOXXXXXXXXXXX,0,600,0
39039,88,0,88,5,407,0,0,416,396,20,GOOXXXXXXXXXXXXXXXXXGOOOOOXXXXXXXXXXXXXXGOOOOOOOOOXXXXXXXXXXGOOOOOXXXXXXXXXXXXXXGOOXXXXXXXXXXXXXXXXXGOOOOOOXXXXXXXXXXXXXGOOOOOOXXXXXXXXXXXXXGOOOOOOOOOXXXXXXXXXXGOOOOOOOOOOOXXXXXXXXGOOXXXXXXXXXXXXXXXXXGOOOOOXXXXXXXXXXXXXXGOOOOOXXXXXXXXXXXXXXGOOOOOOOOXXXXXXXXXXX,0,600,0

39060,88,0,88,4,408,0,0,417,396,21,GOOXXXXXXXXXXXXXXXXXGOOOOOXXXXXXXXXXXXXXGOOOOOOOOOXXXXXXXXXXGOOOOOXXXXXXXXXXXXXXGOOXXXXXXXXXXXXXXXXXGOOOOOOXXXXXXXXXXXXXGOOOOOOXXXXXXXXXXXXXGOOOOOOOOOXXXXXXXXXXGOOOOOOOOOOOXXXXXXXXGOOXXXXXXXXXXXXXXXXXGOOOOOXXXXXXXXXXXXXXGOOOOOXXXXXXXXXXXXXXGOOOOOOOOXXXXXXXXXXX,0,600,0
39081,88,0,88,3,409,0,0,418,397,21,GOOXXXXXXXXXXXXXXXXXGOOOOOXXXXXXXXXXXXXXGOOOOOOOOOXXXXXXXXXXGOOOOOXXXXXXXXXXXXXXGOOXXXXXXXXXXXXXXXXXGOOOOOOXXXXXXXXXXXXXGOOOOOOXXXXXXXXXXXXXGOOOOOOOOOXXXXXXXXXXGOOOOOOOOOOOXXXXXXXXGOOXXXXXXXXXXXXXXXXXGOOOOOXXXXXXXXXXXXXXGOOOOOXXXXXXXXXXXXXXGOOOOOOOOXXXXXXXXXXX,0,600,0
39102,88,0,88,4,408,0,0,417,397,20,GOOXXXXXXXXXXXXXXXXXGOOOOOXXXXXXXXXXXXXXGOOOOOOOOOXXXXXXXXXXGOOOOOXXXXXXXXXXXXXXGOOXXXXXXXXXXXXXXXXXGOOOOOOXXXXXXXXXXXXXGOOOOOOXXXXXXXXXXXXXGOOOOOOOOOXXXXXXXXXXGOOOOOOOOOOOXXXXXXXXGOOXXXXXXXXXXXXXXXXXGOOOOOXXXXXXXXXXXXXXGOOOOOXXXXXXXXXXXXXXGOOOOOOOOXXXXXXXXXXX,0,600,0
39123,88,0,88,5,407,0,0,416,396,20,GOOXXXXXXXXXXXXXXXXXGOOOOOXXXXXXXXXXXXXXGOOOOOOOOOXXXXXXXXXXGOOOOOXXXXXXXXXXXXXXGOOXXXXXXXXXXXXXXXXXGOOOOOOXXXXXXXXXXXXXGOOOOOOXXXXXXXXXXXXXGOOOOOOOOOXXXXXXXXXXGOOOOOOOOOOOXXXXXXXXGOOXXXXXXXXXXXXXXXXXGOOOOOXXXXXXXXXXXXXXGOOOOOXXXXXXXXXXXXXXGOOOOOOOOXXXXXXXXXXX,0,600,0
39144,88,0,88,4,408,0,0,417,397,20,GOOXXXXXXXXXXXXXXXXXGOOOOOXXXXXXXXXXXXXXGOOOOOOOOOXXXXXXXXXXGOOOOOXXXXXXXXXXXXXXGOOXXXXXXXXXXXXXXXXXGOOOOOOXXXXXXXXXXXXXGOOOOOOXXXXXXXXXXXXXGOOOOOOOOOXXXXXXXXXXGOOOOOOOOOOOXXXXXXXXGOOXXXXXXXXXXXXXXXXXGOOOOOXXXXXXXXXXXXXXGOOOOOXXXXXXXXXXXXXXGOOOOOOOOXXXXXXXXXXX,0,600,0

39165,88,0,88,5,407,0,0,416,399,17,GOOXXXXXXXXXXXXXXXXXGOOOOOXXXXXXXXXXXXXXGOOOOOOOOOXXXXXXXXXXGOOOOOXXXXXXXXXXXXXXGOOXXXXXXXXXXXXXXXXXGOOOOOOXXXXXXXXXXXXXGOOOOOOXXXXXXXXXXXXXGOOOOOOOOOXXXXXXXXXXGOOOOOOOOOOOXXXXXXXXGOOXXXXXXXXXXXXXXXXXGOOOOOXXXXXXXXXXXXXXGOOOOOXXXXXXXXXXXXXXGOOOOOOOOXXXXXXXXXXX,0,600,0
39186,88,0,88,9,403,0,0,412,397,15,GOOXXXXXXXXXXXXXXXXXGOOOOOXXXXXXXXXXXXXXGOOOOOOOOOXXXXXXXXXXGOOOOOXXXXXXXXXXXXXXGOOXXXXXXXXXXXXXXXXXGOOOOOOXXXXXXXXXXXXXGOOOOOOXXXXXXXXXXXXXGOOOOOOOOOXXXXXXXXXXGOOOOOOOOOOOXXXXXXXXGOOXXXXXXXXXXXXXXXXXGOOOOOXXXXXXXXXXXXXXGOOOOOXXXXXXXXXXXXXXGOOOOOOOOXXXXXXXXXXX,0,600,0
39207,88,0,88,9,403,0,0,412,398,14,GOOXXXXXXXXXXXXXXXXXGOOOOOXXXXXXXXXXXXXXGOOOOOOOOOXXXXXXXXXXGOOOOOXXXXXXXXXXXXXXGOOXXXXXXXXXXXXXXXXXGOOOOOOXXXXXXXXXXXXXGOOOOOOXXXXXXXXXXXXXGOOOOOOOOOXXXXXXXXXXGOOOOOOOOOOOXXXXXXXXGOOXXXXXXXXXXXXXXXXXGOOOOOXXXXXXXXXXXXXXGOOOOOXXXXXXXXXXXXXXGOOOOOOOOXXXXXXXXXXX,0,600,0
39228,88,0,88,11,401,0,0,410,397,13,GOOXXXXXXXXXXXXXXXXXGOOOOOXXXXXXXXXXXXXXGOOOOOOOOOXXXXXXXXXXGOOOOOXXXXXXXXXXXXXXGOOXXXXXXXXXXXXXXXXXGOOOOOOXXXXXXXXXXXXXGOOOOOOXXXXXXXXXXXXXGOOOOOOOOOXXXXXXXXXXGOOOOOOOOOOOXXXXXXXXGOOXXXXXXXXXXXXXXXXXGOOOOOXXXXXXXXXXXXXXGOOOOOXXXXXXXXXXXXXXGOOOOOOOOXXXXXXXXXXX,0,600,0
39249,88,0,88,10,402,0,0,411,397,14,GOOXXXXXXXXXXXXXXXXXGOOOOOXXXXXXXXXXXXXXGOOOOOOOOOXXXXXXXXXXGOOOOOXXXXXXXXXXXXXXGOOXXXXXXXXXXXXXXXXXGOOOOOOXXXXXXXXXXXXXGOOOOOOXXXXXXXXXXXXXGOOOOOOOOOXXXXXXXXXXGOOOOOOOOOOOXXXXXXXXGOOXXXXXXXXXXXXXXXXXGOOOOOXXXXXXXXXXXXXXGOOOOOXXXXXXXXXXXXXXGOOOOOOOOXXXXXXXXXXX,0,600,0

39270,88,0,88,9,403,0,0,412,398,14,GOOXXXXXXXXXXXXXXXXXGOOOOOXXXXXXXXXXXXXXGOOOOOOOOOXXXXXXXXXXGOOOOOXXXXXXXXXXXXXXGOOXXXXXXXXXXXXXXXXXGOOOOOOXXXXXXXXXXXXXGOOOOOOXXXXXXXXXXXXXGOOOOOOOOOXXXXXXXXXXGOOOOOOOOOOOXXXXXXXXGOOXXXXXXXXXXXXXXXXXGOOOOOXXXXXXXXXXXXXXGOOOOOXXXXXXXXXXXXXXGOOOOOOOOXXXXXXXXXXX,0,600,0
39291,88,0,88,6,406,0,0,415,399,16,GOOXXXXXXXXXXXXXXXXXGOOOOOXXXXXXXXXXXXXXGOOOOOOOOOXXXXXXXXXXGOOOOOXXXXXXXXXXXXXXGOOXXXXXXXXXXXXXXXXXGOOOOOOXXXXXXXXXXXXXGOOOOOOXXXXXXXXXXXXXGOOOOOOOOOXXXXXXXXXXGOOOOOOOOOOOXXXXXXXXGOOXXXXXXXXXXXXXXXXXGOOOOOXXXXXXXXXXXXXXGOOOOOXXXXXXXXXXXXXXGOOOOOOOOXXXXXXXXXXX,0,600,0
39312,88,0,88,8,404,0,0,413,397,16,GOOXXXXXXXXXXXXXXXXXGOOOOOXXXXXXXXXXXXXXGOOOOOOOOOXXXXXXXXXXGOOOOOXXXXXXXXXXXXXXGOOXXXXXXXXXXXXXXXXXGOOOOOOXXXXXXXXXXXXXGOOOOOOXXXXXXXXXXXXXGOOOOOOOOOXXXXXXXXXXGOOOOOOOOOOOXXXXXXXXGOOXXXXXXXXXXXXXXXXXGOOOOOXXXXXXXXXXXXXXGOOOOOXXXXXXXXXXXXXXGOOOOOOOOXXXXXXXXXXX,0,600,0
39333,88,0,88,8,404,0,0,413,397,16,GOOXXXXXXXXXXXXXXXXXGOOOOOXXXXXXXXXXXXXXGOOOOOOOOOXXXXXXXXXXGOOOOOXXXXXXXXXXXXXXGOOXXXXXXXXXXXXXXXXXGOOOOOOXXXXXXXXXXXXXGOOOOOOXXXXXXXXXXXXXGOOOOOOOOOXXXXXXXXXXGOOOOOOOOOOOXXXXXXXXGOOXXXXXXXXXXXXXXXXXGOOOOOXXXXXXXXXXXXXXGOOOOOXXXXXXXXXXXXXXGOOOOOOOOXXXXXXXXXXX,0,600,0
39354,88,0,88,7,405,0,0,413,397,16,GOOXXXXXXXXXXXXXXXXXGOOOOOXXXXXXXXXXXXXXGOOOOOOOOOXXXXXXXXXXGOOOOOXXXXXXXXXXXXXXGOOXXXXXXXXXXXXXXXXXGOOOOOOXXXXXXXXXXXXXGOOOOOOXXXXXXXXXXXXXGOOOOOOOOOXXXXXXXXXXGOOOOOOOOOOOXXXXXXXXGOOXXXXXXXXXXXXXXXXXGOOOOOXXXXXXXXXXXXXXGOOOOOXXXXXXXXXXXXXXGOOOOOOOOXXXXXXXXXXX,0,600,0

39375,88,0,88,7,405,0,0,414,397,17,GOOXXXXXXXXXXXXXXXXXGOOOOOXXXXXXXXXXXXXXGOOOOOOOOOXXXXXXXXXXGOOOOOXXXXXXXXXXXXXXGOOXXXXXXXXXXXXXXXXXGOOOOOOXXXXXXXXXXXXXGOOOOOOXXXXXXXXXXXXXGOOOOOOOOOXXXXXXXXXXGOOOOOOOOOOOXXXXXXXXGOOXXXXXXXXXXXXXXXXXGOOOOOXXXXXXXXXXXXXXGOOOOOXXXXXXXXXXXXXXGOOOOOOOOXXXXXXXXXXX,0,600,0
39396,88,0,88,7,405,0,0,414,398,16,GOOXXXXXXXXXXXXXXXXXGOOOOOXXXXXXXXXXXXXXGOOOOOOOOOXXXXXXXXXXGOOOOOXXXXXXXXXXXXXXGOOXXXXXXXXXXXXXXXXXGOOOOOOXXXXXXXXXXXXXGOOOOOOXXXXXXXXXXXXXGOOOOOOOOOXXXXXXXXXXGOOOOOOOOOOOXXXXXXXXGOOXXXXXXXXXXXXXXXXXGOOOOOXXXXXXXXXXXXXXGOOOOOXXXXXXXXXXXXXXGOOOOOOOOXXXXXXXXXXX,0,600,0
39417,88,0,88,8,404,0,0,413,397,16,GOOXXXXXXXXXXXXXXXXXGOOOOOXXXXXXXXXXXXXXGOOOOOOOOOXXXXXXXXXXGOOOOOXXXXXXXXXXXXXXGOOXXXXXXXXXXXXXXXXXGOOOOOOXXXXXXXXXXXXXGOOOOOOXXXXXXXXXXXXXGOOOOOOOOOXXXXXXXXXXGOOOOOOOOOOOXXXXXXXXGOOXXXXXXXXXXXXXXXXXGOOOOOXXXXXXXXXXXXXXGOOOOOXXXXXXXXXXXXXXGOOOOOOOOXXXXXXXXXXX,0,600,0
39438,88,0,88,8,404,0,0,413,399,14,GOOXXXXXXXXXXXXXXXXXGOOOOOXXXXXXXXXXXXXXGOOOOOOOOOXXXXXXXXXXGOOOOOXXXXXXXXXXXXXXGOOXXXXXXXXXXXXXXXXXGOOOOOOXXXXXXXXXXXXXGOOOOOOXXXXXXXXXXXXXGOOOOOOOOOXXXXXXXXXXGOOOOOOOOOOOXXXXXXXXGOOXXXXXXXXXXXXXXXXXGOOOOOXXXXXXXXXXXXXXGOOOOOXXXXXXXXXXXXXXGOOOOOOOOXXXXXXXXXXX,0,600,0
39459,88,0,88,8,404,0,0,413,398,15,GOOXXXXXXXXXXXXXXXXXGOOOOOXXXXXXXXXXXXXXGOOOOOOOOOXXXXXXXXXXGOOOOOXXXXXXXXXXXXXXGOOXXXXXXXXXXXXXXXXXGOOOOOOXXXXXXXXXXXXXGOOOOOOXXXXXXXXXXXXXGOOOOOOOOOXXXXXXXXXXGOOOOOOOOOOOXXXXXXXXGOOXXXXXXXXXXXXXXXXXGOOOOOXXXXXXXXXXXXXXGOOOOOXXXXXXXXXXXXXXGOOOOOOOOXXXXXXXXXXX,0,600,0

39480,88,0,88,8,404,0,0,413,398,15,GOOXXXXXXXXXXXXXXXXXGOOOOOXXXXXXXXXXXXXXGOOOOOOOOOXXXXXXXXXXGOOOOOXXXXXXXXXXXXXXGOOXXXXXXXXXXXXXXXXXGOOOOOOXXXXXXXXXXXXXGOOOOOOXXXXXXXXXXXXXGOOOOOOOOOXXXXXXXXXXGOOOOOOOOOOOXXXXXXXXGOOXXXXXXXXXXXXXXXXXGOOOOOXXXXXXXXXXXXXXGOOOOOXXXXXXXXXXXXXXGOOOOOOOOXXXXXXXXXXX,0,600,0
39501,88,0,88,8,404,0,0,413,397,16,GOOXXXXXXXXXXXXXXXXXGOOOOOXXXXXXXXXXXXXXGOOOOOOOOOXXXXXXXXXXGOOOOOXXXXXXXXXXXXXXGOOXXXXXXXXXXXXXXXXXGOOOOOOXXXXXXXXXXXXXGOOOOOOXXXXXXXXXXXXXGOOOOOOOOOXXXXXXXXXXGOOOOOOOOOOOXXXXXXXXGOOXXXXXXXXXXXXXXXXXGOOOOOXXXXXXXXXXXXXXGOOOOOXXXXXXXXXXXXXXGOOOOOOOOXXXXXXXXXXX,0,600,0
39522,88,0,88,7,405,0,0,414,397,17,GOOXXXXXXXXXXXXXXXXXGOOOOOXXXXXXXXXXXXXXGOOOOOOOOOXXXXXXXXXXGOOOOOXXXXXXXXXXXXXXGOOXXXXXXXXXXXXXXXXXGOOOOOOXXXXXXXXXXXXXGOOOOOOXXXXXXXXXXXXXGOOOOOOOOOXXXXXXXXXXGOOOOOOOOOOOXXXXXXXXGOOXXXXXXXXXXXXXXXXXGOOOOOXXXXXXXXXXXXXXGOOOOOXXXXXXXXXXXXXXGOOOOOOOOXXXXXXXXXXX,0,600,0
39543,88,0,88,6,406,0,0,415,397,18,GOOXXXXXXXXXXXXXXXXXGOOOOOXXXXXXXXXXXXXXGOOOOOOOOOXXXXXXXXXXGOOOOOXXXXXXXXXXXXXXGOOXXXXXXXXXXXXXXXXXGOOOOOOXXXXXXXXXXXXXGOOOOOOXXXXXXXXXXXXXGOOOOOOOOOXXXXXXXXXXGOOOOOOOOOOOXXXXXXXXGOOXXXXXXXXXXXXXXXXXGOOOOOXXXXXXXXXXXXXXGOOOOOXXXXXXXXXXXXXXGOOOOOOOOXXXXXXXXXXX,0,600,0
39564,88,0,88,6,406,0,0,415,398,17,GOOXXXXXXXXXXXXXXXXXGOOOOOXXXXXXXXXXXXXXGOOOOOOOOOXXXXXXXXXXGOOOOOXXXXXXXXXXXXXXGOOXXXXXXXXXXXXXXXXXGOOOOOOXXXXXXXXXXXXXGOOOOOOXXXXXXXXXXXXXGOOOOOOOOOXXXXXXXXXXGOOOOOOOOOOOXXXXXXXXGOOXXXXXXXXXXXXXXXXXGOOOOOXXXXXXXXXXXXXXGOOOOOXXXXXXXXXXXXXXGOOOOOOOOXXXXXXXXXXX,0,600,0

39585,88,0,88,7,405,0,0,414,399,15,GOOXXXXXXXXXXXXXXXXXGOOOOOXXXXXXXXXXXXXXGOOOOOOOOOXXXXXXXXXXGOOOOOXXXXXXXXXXXXXXGOOXXXXXXXXXXXXXXXXXGOOOOOOXXXXXXXXXXXXXGOOOOOOXXXXXXXXXXXXXGOOOOOOOOOXXXXXXXXXXGOOOOOOOOOOOXXXXXXXXGOOXXXXXXXXXXXXXXXXXGOOOOOXXXXXXXXXXXXXXGOOOOOXXXXXXXXXXXXXXGOOOOOOOOXXXXXXXXXXX,0,600,0
39606,88,0,88,6,406,0,0,415,398,17,GOOXXXXXXXXXXXXXXXXXGOOOOOXXXXXXXXXXXXXXGOOOOOOOOOXXXXXXXXXXGOOOOOXXXXXXXXXXXXXXGOOXXXXXXXXXXXXXXXXXGOOOOOOXXXXXXXXXXXXXGOOOOOOXXXXXXXXXXXXXGOOOOOOOOOXXXXXXXXXXGOOOOOOOOOOOXXXXXXXXGOOXXXXXXXXXXXXXXXXXGOOOOOXXXXXXXXXXXXXXGOOOOOXXXXXXXXXXXXXXGOOOOOOOOXXXXXXXXXXX,0,600,0
39627,88,0,88,7,405,0,0,414,397,17,GOOXXXXXXXXXXXXXXXXXGOOOOOXXXXXXXXXXXXXXGOOOOOOOOOXXXXXXXXXXGOOOOOXXXXXXXXXXXXXXGOOXXXXXXXXXXXXXXXXXGOOOOOOXXXXXXXXXXXXXGOOOOOOXXXXXXXXXXXXXGOOOOOOOOOXXXXXXXXXXGOOOOOOOOOOOXXXXXXXXGOOXXXXXXXXXXXXXXXXXGOOOOOXXXXXXXXXXXXXXGOOOOOXXXXXXXXXXXXXXGOOOOOOOOXXXXXXXXXXX,0,600,0
39648,88,0,88,6,406,0,0,415,397,18,GOOXXXXXXXXXXXXXXXXXGOOOOOXXXXXXXXXXXXXXGOOOOOOOOOXXXXXXXXXXGOOOOOXXXXXXXXXXXXXXGOOXXXXXXXXXXXXXXXXXGOOOOOOXXXXXXXXXXXXXGOOOOOOXXXXXXXXXXXXXGOOOOOOOOOXXXXXXXXXXGOOOOOOOOOOOXXXXXXXXGOOXXXXXXXXXXXXXXXXXGOOOOOXXXXXXXXXXXXXXGOOOOOXXXXXXXXXXXXXXGOOOOOOOOXXXXXXXXXXX,0,600,0
39669,88,0,88,6,406,0,0,415,398,17,GOOXXXXXXXXXXXXXXXXXGOOOOOXXXXXXXXXXXXXXGOOOOOOOOOXXXXXXXXXXGOOOOOXXXXXXXXXXXXXXGOOXXXXXXXXXXXXXXXXXGOOOOOOXXXXXXXXXXXXXGOOOOOOXXXXXXXXXXXXXGOOOOOOOOOXXXXXXXXXXGOOOOOOOOOOOXXXXXXXXGOOXXXXXXXXXXXXXXXXXGOOOOOXXXXXXXXXXXXXXGOOOOOXXXXXXXXXXXXXXGOOOOOOOOXXXXXXXXXXX,0,600,0

39690,88,0,88,8,404,0,0,413,397,16,GOOXXXXXXXXXXXXXXXXXGOOOOOXXXXXXXXXXXXXXGOOOOOOOOOXXXXXXXXXXGOOOOOXXXXXXXXXXXXXXGOOXXXXXXXXXXXXXXXXXGOOOOOOXXXXXXXXXXXXXGOOOOOOXXXXXXXXXXXXXGOOOOOOOOOXXXXXXXXXXGOOOOOOOOOOOXXXXXXXXGOOXXXXXXXXXXXXXXXXXGOOOOOXXXXXXXXXXXXXXGOOOOOXXXXXXXXXXXXXXGOOOOOOOOXXXXXXXXXXX,0,600,0
39711,88,0,88,4,408,0,0,416,398,18,GOOXXXXXXXXXXXXXXXXXGOOOOOXXXXXXXXXXXXXXGOOOOOOOOOXXXXXXXXXXGOOOOOXXXXXXXXXXXXXXGOOXXXXXXXXXXXXXXXXXGOOOOOOXXXXXXXXXXXXXGOOOOOOXXXXXXXXXXXXXGOOOOOOOOOXXXXXXXXXXGOOOOOOOOOOOXXXXXXXXGOOXXXXXXXXXXXXXXXXXGOOOOOXXXXXXXXXXXXXXGOOOOOXXXXXXXXXXXXXXGOOOOOOOOXXXXXXXXXXX,0,600,0
39732,88,0,88,5,407,0,0,416,399,17,GOOXXXXXXXXXXXXXXXXXGOOOOOXXXXXXXXXXXXXXGOOOOOOOOOXXXXXXXXXXGOOOOOXXXXXXXXXXXXXXGOOXXXXXXXXXXXXXXXXXGOOOOOOXXXXXXXXXXXXXGOOOOOOXXXXXXXXXXXXXGOOOOOOOOOXXXXXXXXXXGOOOOOOOOOOOXXXXXXXXGOOXXXXXXXXXXXXXXXXXGOOOOOXXXXXXXXXXXXXXGOOOOOXXXXXXXXXXXXXXGOOOOOOOOXXXXXXXXXXX,0,600,0
39753,88,0,88,8,404,0,0,413,397,16,GOOXXXXXXXXXXXXXXXXXGOOOOOXXXXXXXXXXXXXXGOOOOOOOOOXXXXXXXXXXGOOOOOXXXXXXXXXXXXXXGOOXXXXXXXXXXXXXXXXXGOOOOOOXXXXXXXXXXXXXGOOOOOOXXXXXXXXXXXXXGOOOOOOOOOXXXXXXXXXXGOOOOOOOOOOOXXXXXXXXGOOXXXXXXXXXXXXXXXXXGOOOOOXXXXXXXXXXXXXXGOOOOOXXXXXXXXXXXXXXGOOOOOOOOXXXXXXXXXXX,0,600,0
39774,88,0,88,8,404,0,0,413,398,15,GOOXXXXXXXXXXXXXXXXXGOOOOOXXXXXXXXXXXXXXGOOOOOOOOOXXXXXXXXXXGOOOOOXXXXXXXXXXXXXXGOOXXXXXXXXXXXXXXXXXGOOOOOOXXXXXXXXXXXXXGOOOOOOXXXXXXXXXXXXXGOOOOOOOOOXXXXXXXXXXGOOOOOOOOOOOXXXXXXXXGOOXXXXXXXXXXXXXXXXXGOOOOOXXXXXXXXXXXXXXGOOOOOXXXXXXXXXXXXXXGOOOOOOOOXXXXXXXXXXX,0,600,0

39795,88,0,88,11,401,0,0,410,397,13,GOOXXXXXXXXXXXXXXXXXGOOOOOXXXXXXXXXXXXXXGOOOOOOOOOXXXXXXXXXXGOOOOOXXXXXXXXXXXXXXGOOXXXXXXXXXXXXXXXXXGOOOOOOXXXXXXXXXXXXXGOOOOOOXXXXXXXXXXXXXGOOOOOOOOOXXXXXXXXXXGOOOOOOOOOOOXXXXXXXXGOOXXXXXXXXXXXXXXXXXGOOOOOXXXXXXXXXXXXXXGOOOOOXXXXXXXXXXXXXXGOOOOOOOOXXXXXXXXXXX,0,600,0
39816,88,0,88,11,401,0,0,410,397,13,GOOXXXXXXXXXXXXXXXXXGOOOOOXXXXXXXXXXXXXXGOOOOOOOOOXXXXXXXXXXGOOOOOXXXXXXXXXXXXXXGOOXXXXXXXXXXXXXXXXXGOOOOOOXXXXXXXXXXXXXGOOOOOOXXXXXXXXXXXXXGOOOOOOOOOXXXXXXXXXXGOOOOOOOOOOOXXXXXXXXGOOXXXXXXXXXXXXXXXXXGOOOOOXXXXXXXXXXXXXXGOOOOOXXXXXXXXXXXXXXGOOOOOOOOXXXXXXXXXXX,0,600,0
39837,88,0,88,11,401,0,0,410,397,13,GOOXXXXXXXXXXXXXXXXXGOOOOOXXXXXXXXXXXXXXGOOOOOOOOOXXXXXXXXXXGOOOOOXXXXXXXXXXXXXXGOOXXXXXXXXXXXXXXXXXGOOOOOOXXXXXXXXXXXXXGOOOOOOXXXXXXXXXXXXXGOOOOOOOOOXXXXXXXXXXGOOOOOOOOOOOXXXXXXXXGOOXXXXXXXXXXXXXXXXXGOOOOOXXXXXXXXXXXXXXGOOOOOXXXXXXXXXXXXXXGOOOOOOOOXXXXXXXXXXX,0,600,0
39858,88,0,88,10,402,0,0,411,397,14,GOOXXXXXXXXXXXXXXXXXGOOOOOXXXXXXXXXXXXXXGOOOOOOOOOXXXXXXXXXXGOOOOOXXXXXXXXXXXXXXGOOXXXXXXXXXXXXXXXXXGOOOOOOXXXXXXXXXXXXXGOOOOOOXXXXXXXXXXXXXGOOOOOOOOOXXXXXXXXXXGOOOOOOOOOOOXXXXXXXXGOOXXXXXXXXXXXXXXXXXGOOOOOXXXXXXXXXXXXXXGOOOOOXXXXXXXXXXXXXXGOOOOOOOOXXXXXXXXXXX,0,600,0
39879,88,0,88,9,403,0,0,412,397,15,GOOXXXXXXXXXXXXXXXXXGOOOOOXXXXXXXXXXXXXXGOOOOOOOOOXXXXXXXXXXGOOOOOXXXXXXXXXXXXXXGOOXXXXXXXXXXXXXXXXXGOOOOOOXXXXXXXXXXXXXGOOOOOOXXXXXXXXXXXXXGOOOOOOOOOXXXXXXXXXXGOOOOOOOOOOOXXXXXXXXGOOXXXXXXXXXXXXXXXXXGOOOOOXXXXXXXXXXXXXXGOOOOOXXXXXXXXXXXXXXGOOOOOOOOXXXXXXXXXXX,0,600,0

39900,88,0,88,8,404,0,0,413,397,16,GOOXXXXXXXXXXXXXXXXXGOOOOOXXXXXXXXXXXXXXGOOOOOOOOOXXXXXXXXXXGOOOOOXXXXXXXXXXXXXXGOOXXXXXXXXXXXXXXXXXGOOOOOOXXXXXXXXXXXXXGOOOOOOXXXXXXXXXXXXXGOOOOOOOOOXXXXXXXXXXGOOOOOOOOOOOXXXXXXXXGOOXXXXXXXXXXXXXXXXXGOOOOOXXXXXXXXXXXXXXGOOOOOXXXXXXXXXXXXXXGOOOOOOOOXXXXXXXXXXX,0,600,0
39921,88,0,88,8,404,0,0,413,397,16,GOOXXXXXXXXXXXXXXXXXGOOOOOXXXXXXXXXXXXXXGOOOOOOOOOXXXXXXXXXXGOOOOOXXXXXXXXXXXXXXGOOXXXXXXXXXXXXXXXXXGOOOOOOXXXXXXXXXXXXXGOOOOOOXXXXXXXXXXXXXGOOOOOOOOOXXXXXXXXXXGOOOOOOOOOOOXXXXXXXXGOOXXXXXXXXXXXXXXXXXGOOOOOXXXXXXXXXXXXXXGOOOOOXXXXXXXXXXXXXXGOOOOOOOOXXXXXXXXXXX,0,600,0
39942,88,0,88,7,405,0,0,414,401,13,GOOXXXXXXXXXXXXXXXXXGOOOOOXXXXXXXXXXXXXXGOOOOOOOOOXXXXXXXXXXGOOOOOXXXXXXXXXXXXXXGOOXXXXXXXXXXXXXXXXXGOOOOOOXXXXXXXXXXXXXGOOOOOOXXXXXXXXXXXXXGOOOOOOOOOXXXXXXXXXXGOOOOOOOOOOOXXXXXXXXGOOXXXXXXXXXXXXXXXXXGOOOOOXXXXXXXXXXXXXXGOOOOOXXXXXXXXXXXXXXGOOOOOOOOXXXXXXXXXXX,0,600,0
39963,88,0,88,9,403,0,0,412,399,13,GOOXXXXXXXXXXXXXXXXXGOOOOOXXXXXXXXXXXXXXGOOOOOOOOOXXXXXXXXXXGOOOOOXXXXXXXXXXXXXXGOOXXXXXXXXXXXXXXXXXGOOOOOOXXXXXXXXXXXXXGOOOOOOXXXXXXXXXXXXXGOOOOOOOOOXXXXXXXXXXGOOOOOOOOOOOXXXXXXXXGOOXXXXXXXXXXXXXXXXXGOOOOOXXXXXXXXXXXXXXGOOOOOXXXXXXXXXXXXXXGOOOOOOOOXXXXXXXXXXX,0,600,0
39984,88,0,88,11,401,0,0,410,397,13,GOOXXXXXXXXXXXXXXXXXGOOOOOXXXXXXXXXXXXXXGOOOOOOOOOXXXXXXXXXXGOOOOOXXXXXXXXXXXXXXGOOXXXXXXXXXXXXXXXXXGOOOOOOXXXXXXXXXXXXXGOOOOOOXXXXXXXXXXXXXGOOOOOOOOOXXXXXXXXXXGOOOOOOOOOOOXXXXXXXXGOOXXXXXXXXXXXXXXXXXGOOOOOXXXXXXXXXXXXXXGOOOOOXXXXXXXXXXXXXXGOOOOOOOOXXXXXXXXXXX,0,600,0

40005,88,0,88,9,403,0,0,412,397,15,GOOXXXXXXXXXXXXXXXXXGOOOOOXXXXXXXXXXXXXXGOOOOOOOOOXXXXXXXXXXGOOOOOXXXXXXXXXXXXXXGOOXXXXXXXXXXXXXXXXXGOOOOOOXXXXXXXXXXXXXGOOOOOOXXXXXXXXXXXXXGOOOOOOOOOXXXXXXXXXXGOOOOOOOOOOOXXXXXXXXGOOXXXXXXXXXXXXXXXXXGOOOOOXXXXXXXXXXXXXXGOOOOOXXXXXXXXXXXXXXGOOOOOOOOXXXXXXXXXXX,0,600,0
40026,88,0,88,7,405,0,0,414,397,17,GOOXXXXXXXXXXXXXXXXXGOOOOOXXXXXXXXXXXXXXGOOOOOOOOOXXXXXXXXXXGOOOOOXXXXXXXXXXXXXXGOOXXXXXXXXXXXXXXXXXGOOOOOOXXXXXXXXXXXXXGOOOOOOXXXXXXXXXXXXXGOOOOOOOOOXXXXXXXXXXGOOOOOOOOOOOXXXXXXXXGOOXXXXXXXXXXXXXXXXXGOOOOOXXXXXXXXXXXXXXGOOOOOXXXXXXXXXXXXXXGOOOOOOOOXXXXXXXXXXX,0,600,0
40047,88,0,88,8,404,0,0,413,399,14,GOOXXXXXXXXXXXXXXXXXGOOOOOXXXXXXXXXXXXXXGOOOOOOOOOXXXXXXXXXXGOOOOOXXXXXXXXXXXXXXGOOXXXXXXXXXXXXXXXXXGOOOOOOXXXXXXXXXXXXXGOOOOOOXXXXXXXXXXXXXGOOOOOOOOOXXXXXXXXXXGOOOOOOOOOOOXXXXXXXXGOOXXXXXXXXXXXXXXXXXGOOOOOXXXXXXXXXXXXXXGOOOOOXXXXXXXXXXXXXXGOOOOOOOOXXXXXXXXXXX,0,600,0
40068,88,0,88,8,404,0,0,413,398,15,GOOXXXXXXXXXXXXXXXXXGOOOOOXXXXXXXXXXXXXXGOOOOOOOOOXXXXXXXXXXGOOOOOXXXXXXXXXXXXXXGOOXXXXXXXXXXXXXXXXXGOOOOOOXXXXXXXXXXXXXGOOOOOOXXXXXXXXXXXXXGOOOOOOOOOXXXXXXXXXXGOOOOOOOOOOOXXXXXXXXGOOXXXXXXXXXXXXXXXXXGOOOOOXXXXXXXXXXXXXXGOOOOOXXXXXXXXXXXXXXGOOOOOOOOXXXXXXXXXXX,0,600,0
40089,88,0,88,8,404,0,0,413,399,14,GOOXXXXXXXXXXXXXXXXXGOOOOOXXXXXXXXXXXXXXGOOOOOOOOOXXXXXXXXXXGOOOOOXXXXXXXXXXXXXXGOOXXXXXXXXXXXXXXXXXGOOOOOOXXXXXXXXXXXXXGOOOOOOXXXXXXXXXXXXXGOOOOOOOOOXXXXXXXXXXGOOOOOOOOOOOXXXXXXXXGOOXXXXXXXXXXXXXXXXXGOOOOOXXXXXXXXXXXXXXGOOOOOXXXXXXXXXXXXXXGOOOOOOOOXXXXXXXXXXX,0,600,0

40110,88,0,88,7,405,0,0,414,400,14,GOOXXXXXXXXXXXXXXXXXGOOOOOXXXXXXXXXXXXXXGOOOOOOOOOXXXXXXXXXXGOOOOOXXXXXXXXXXXXXXGOOXXXXXXXXXXXXXXXXXGOOOOOOXXXXXXXXXXXXXGOOOOOOXXXXXXXXXXXXXGOOOOOOOOOXXXXXXXXXXGOOOOOOOOOOOXXXXXXXXGOOXXXXXXXXXXXXXXXXXGOOOOOXXXXXXXXXXXXXXGOOOOOXXXXXXXXXXXXXXGOOOOOOOOXXXXXXXXXXX,0,600,0
40131,88,0,88,7,405,0,0,414,398,16,GOOXXXXXXXXXXXXXXXXXGOOOOOXXXXXXXXXXXXXXGOOOOOOOOOXXXXXXXXXXGOOOOOXXXXXXXXXXXXXXGOOXXXXXXXXXXXXXXXXXGOOOOOOXXXXXXXXXXXXXGOOOOOOXXXXXXXXXXXXXGOOOOOOOOOXXXXXXXXXXGOOOOOOOOOOOXXXXXXXXGOOXXXXXXXXXXXXXXXXXGOOOOOXXXXXXXXXXXXXXGOOOOOXXXXXXXXXXXXXXGOOOOOOOOXXXXXXXXXXX,0,600,0
40152,88,0,88,7,405,0,0,414,398,16,GOOXXXXXXXXXXXXXXXXXGOOOOOXXXXXXXXXXXXXXGOOOOOOOOOXXXXXXXXXXGOOOOOXXXXXXXXXXXXXXGOOXXXXXXXXXXXXXXXXXGOOOOOOXXXXXXXXXXXXXGOOOOOOXXXXXXXXXXXXXGOOOOOOOOOXXXXXXXXXXGOOOOOOOOOOOXXXXXXXXGOOXXXXXXXXXXXXXXXXXGOOOOOXXXXXXXXXXXXXXGOOOOOXXXXXXXXXXXXXXGOOOOOOOOXXXXXXXXXXX,0,600,0
40173,88,0,88,6,406,0,0,415,399,16,GOOXXXXXXXXXXXXXXXXXGOOOOOXXXXXXXXXXXXXXGOOOOOOOOOXXXXXXXXXXGOOOOOXXXXXXXXXXXXXXGOOXXXXXXXXXXXXXXXXXGOOOOOOXXXXXXXXXXXXXGOOOOOOXXXXXXXXXXXXXGOOOOOOOOOXXXXXXXXXXGOOOOOOOOOOOXXXXXXXXGOOXXXXXXXXXXXXXXXXXGOOOOOXXXXXXXXXXXXXXGOOOOOXXXXXXXXXXXXXXGOOOOOOOOXXXXXXXXXXX,0,600,0
40194,88,0,88,8,404,0,0,413,398,15,GOOXXXXXXXXXXXXXXXXXGOOOOOXXXXXXXXXXXXXXGOOOOOOOOOXXXXXXXXXXGOOOOOXXXXXXXXXXXXXXGOOXXXXXXXXXXXXXXXXXGOOOOOOXXXXXXXXXXXXXGOOOOOOXXXXXXXXXXXXXGOOOOOOOOOXXXXXXXXXXGOOOOOOOOOOOXXXXXXXXGOOXXXXXXXXXXXXXXXXXGOOOOOXXXXXXXXXXXXXXGOOOOOXXXXXXXXXXXXXXGOOOOOOOOXXXXXXXXXXX,0,600,0

40215,88,0,88,8,404,0,0,413,398,15,GOOXXXXXXXXXXXXXXXXXGOOOOOXXXXXXXXXXXXXXGOOOOOOOOOXXXXXXXXXXGOOOOOXXXXXXXXXXXXXXGOOXXXXXXXXXXXXXXXXXGOOOOOOXXXXXXXXXXXXXGOOOOOOXXXXXXXXXXXXXGOOOOOOOOOXXXXXXXXXXGOOOOOOOOOOOXXXXXXXXGOOXXXXXXXXXXXXXXXXXGOOOOOXXXXXXXXXXXXXXGOOOOOXXXXXXXXXXXXXXGOOOOOOOOXXXXXXXXXXX,0,600,0
40236,88,0,88,7,405,0,0,414,398,16,GOOXXXXXXXXXXXXXXXXXGOOOOOXXXXXXXXXXXXXXGOOOOOOOOOXXXXXXXXXXGOOOOOXXXXXXXXXXXXXXGOOXXXXXXXXXXXXXXXXXGOOOOOOXXXXXXXXXXXXXGOOOOOOXXXXXXXXXXXXXGOOOOOOOOOXXXXXXXXXXGOOOOOOOOOOOXXXXXXXXGOOXXXXXXXXXXXXXXXXXGOOOOOXXXXXXXXXXXXXXGOOOOOXXXXXXXXXXXXXXGOOOOOOOOXXXXXXXXXXX,0,600,0
40257,88,0,88,7,405,0,0,414,400,14,GOOXXXXXXXXXXXXXXXXXGOOOOOXXXXXXXXXXXXXXGOOOOOOOOOXXXXXXXXXXGOOOOOXXXXXXXXXXXXXXGOOXXXXXXXXXXXXXXXXXGOOOOOOXXXXXXXXXXXXXGOOOOOOXXXXXXXXXXXXXGOOOOOOOOOXXXXXXXXXXGOOOOOOOOOOOXXXXXXXXGOOXXXXXXXXXXXXXXXXXGOOOOOXXXXXXXXXXXXXXGOOOOOXXXXXXXXXXXXXXGOOOOOOOOXXXXXXXXXXX,0,600,0
40278,88,0,88,9,403,0,0,412,398,14,GOOXXXXXXXXXXXXXXXXXGOOOOOXXXXXXXXXXXXXXGOOOOOOOOOXXXXXXXXXXGOOOOOXXXXXXXXXXXXXXGOOXXXXXXXXXXXXXXXXXGOOOOOOXXXXXXXXXXXXXGOOOOOOXXXXXXXXXXXXXGOOOOOOOOOXXXXXXXXXXGOOOOOOOOOOOXXXXXXXXGOOXXXXXXXXXXXXXXXXXGOOOOOXXXXXXXXXXXXXXGOOOOOXXXXXXXXXXXXXXGOOOOOOOOXXXXXXXXXXX,0,600,0
40299,88,0,88,8,404,0,0,412,401,11,GOOXXXXXXXXXXXXXXXXXGOOOOOXXXXXXXXXXXXXXGOOOOOOOOOXXXXXXXXXXGOOOOOXXXXXXXXXXXXXXGOOXXXXXXXXXXXXXXXXXGOOOOOOXXXXXXXXXXXXXGOOOOOOXXXXXXXXXXXXXGOOOOOOOOOXXXXXXXXXXGOOOOOOOOOOOXXXXXXXXGOOXXXXXXXXXXXXXXXXXGOOOOOXXXXXXXXXXXXXXGOOOOOXXXXXXXXXXXXXXGOOOOOOOOXXXXXXXXXXX,0,600,0

40320,88,0,88,11,401,0,0,410,398,12,GOOXXXXXXXXXXXXXXXXXGOOOOOXXXXXXXXXXXXXXGOOOOOOOOOXXXXXXXXXXGOOOOOXXXXXXXXXXXXXXGOOXXXXXXXXXXXXXXXXXGOOOOOOXXXXXXXXXXXXXGOOOOOOXXXXXXXXXXXXXGOOOOOOOOOXXXXXXXXXXGOOOOOOOOOOOXXXXXXXXGOOXXXXXXXXXXXXXXXXXGOOOOOXXXXXXXXXXXXXXGOOOOOXXXXXXXXXXXXXXGOOOOOOOOXXXXXXXXXXX,0,600,0
40341,88,0,88,11,401,0,0,410,401,9,GOOXXXXXXXXXXXXXXXXXGOOOOOXXXXXXXXXXXXXXGOOOOOOOOOXXXXXXXXXXGOOOOOXXXXXXXXXXXXXXGOOXXXXXXXXXXXXXXXXXGOOOOOOXXXXXXXXXXXXXGOOOOOOXXXXXXXXXXXXXGOOOOOOOOOXXXXXXXXXXGOOOOOOOOOOOXXXXXXXXGOOXXXXXXXXXXXXXXXXXGOOOOOXXXXXXXXXXXXXXGOOOOOXXXXXXXXXXXXXXGOOOOOOOOXXXXXXXXXXX,0,600,0
40362,88,0,88,14,398,0,0,407,400,7,GOOXXXXXXXXXXXXXXXXXGOOOOOXXXXXXXXXXXXXXGOOOOOOOOOXXXXXXXXXXGOOOOOXXXXXXXXXXXXXXGOOXXXXXXXXXXXXXXXXXGOOOOOOXXXXXXXXXXXXXGOOOOOOXXXXXXXXXXXXXGOOOOOOOOOXXXXXXXXXXGOOOOOOOOOOOXXXXXXXXGOOXXXXXXXXXXXXXXXXXGOOOOOXXXXXXXXXXXXXXGOOOOOXXXXXXXXXXXXXXGOOOOOOOOXXXXXXXXXXX,0,600,0
40383,88,0,88,15,397,0,0,406,398,8,GOOXXXXXXXXXXXXXXXXXGOOOOOXXXXXXXXXXXXXXGOOOOOOOOOXXXXXXXXXXGOOOOOXXXXXXXXXXXXXXGOOXXXXXXXXXXXXXXXXXGOOOOOOXXXXXXXXXXXXXGOOOOOOXXXXXXXXXXXXXGOOOOOOOOOXXXXXXXXXXGOOOOOOOOOOOXXXXXXXXGOOXXXXXXXXXXXXXXXXXGOOOOOXXXXXXXXXXXXXXGOOOOOXXXXXXXXXXXXXXGOOOOOOOOXXXXXXXXXXX,0,600,0
40404,88,0,88,14,398,0,0,408,398,10,GOOXXXXXXXXXXXXXXXXXGOOOOOXXXXXXXXXXXXXXGOOOOOOOOOXXXXXXXXXXGOOOOOXXXXXXXXXXXXXXGOOXXXXXXXXXXXXXXXXXGOOOOOOXXXXXXXXXXXXXGOOOOOOXXXXXXXXXXXXXGOOOOOOOOOXXXXXXXXXXGOOOOOOOOOOOXXXXXXXXGOOXXXXXXXXXXXXXXXXXGOOOOOXXXXXXXXXXXXXXGOOOOOXXXXXXXXXXXXXXGOOOOOOOOXXXXXXXXXXX,0,600,0

40425,88,0,88,13,399,0,0,409,398,11,GOOXXXXXXXXXXXXXXXXXGOOOOOXXXXXXXXXXXXXXGOOOOOOOOOXXXXXXXXXXGOOOOOXXXXXXXXXXXXXXGOOXXXXXXXXXXXXXXXXXGOOOOOOXXXXXXXXXXXXXGOOOOOOXXXXXXXXXXXXXGOOOOOOOOOXXXXXXXXXXGOOOOOOOOOOOXXXXXXXXGOOXXXXXXXXXXXXXXXXXGOOOOOXXXXXXXXXXXXXXGOOOOOXXXXXXXXXXXXXXGOOOOOOOOXXXXXXXXXXX,0,600,0
40446,88,0,88,13,399,0,0,409,398,11,GOOXXXXXXXXXXXXXXXXXGOOOOOXXXXXXXXXXXXXXGOOOOOOOOOXXXXXXXXXXGOOOOOXXXXXXXXXXXXXXGOOXXXXXXXXXXXXXXXXXGOOOOOOXXXXXXXXXXXXXGOOOOOOXXXXXXXXXXXXXGOOOOOOOOOXXXXXXXXXXGOOOOOOOOOOOXXXXXXXXGOOXXXXXXXXXXXXXXXXXGOOOOOXXXXXXXXXXXXXXGOOOOOXXXXXXXXXXXXXXGOOOOOOOOXXXXXXXXXXX,0,600,0
40467,88,0,88,12,400,0,0,410,398,12,GOOXXXXXXXXXXXXXXXXXGOOOOOXXXXXXXXXXXXXXGOOOOOOOOOXXXXXXXXXXGOOOOOXXXXXXXXXXXXXXGOOXXXXXXXXXXXXXXXXXGOOOOOOXXXXXXXXXXXXXGOOOOOOXXXXXXXXXXXXXGOOOOOOOOOXXXXXXXXXXGOOOOOOOOOOOXXXXXXXXGOOXXXXXXXXXXXXXXXXXGOOOOOXXXXXXXXXXXXXXGOOOOOXXXXXXXXXXXXXXGOOOOOOOOXXXXXXXXXXX,0,600,0
40488,88,0,88,7,405,0,0,414,398,16,GOOXXXXXXXXXXXXXXXXXGOOOOOXXXXXXXXXXXXXXGOOOOOOOOOXXXXXXXXXXGOOOOOXXXXXXXXXXXXXXGOOXXXXXXXXXXXXXXXXXGOOOOOOXXXXXXXXXXXXXGOOOOOOXXXXXXXXXXXXXGOOOOOOOOOXXXXXXXXXXGOOOOOOOOOOOXXXXXXXXGOOXXXXXXXXXXXXXXXXXGOOOOOXXXXXXXXXXXXXXGOOOOOXXXXXXXXXXXXXXGOOOOOOOOXXXXXXXXXXX,0,600,0
40509,88,0,88,8,404,0,0,413,398,15,GOOXXXXXXXXXXXXXXXXXGOOOOOXXXXXXXXXXXXXXGOOOOOOOOOXXXXXXXXXXGOOOOOXXXXXXXXXXXXXXGOOXXXXXXXXXXXXXXXXXGOOOOOOXXXXXXXXXXXXXGOOOOOOXXXXXXXXXXXXXGOOOOOOOOOXXXXXXXXXXGOOOOOOOOOOOXXXXXXXXGOOXXXXXXXXXXXXXXXXXGOOOOOXXXXXXXXXXXXXXGOOOOOXXXXXXXXXXXXXXGOOOOOOOOXXXXXXXXXXX,0,600,0

40530,88,0,88,8,404,0,0,413,398,15,GOOXXXXXXXXXXXXXXXXXGOOOOOXXXXXXXXXXXXXXGOOOOOOOOOXXXXXXXXXXGOOOOOXXXXXXXXXXXXXXGOOXXXXXXXXXXXXXXXXXGOOOOOOXXXXXXXXXXXXXGOOOOOOXXXXXXXXXXXXXGOOOOOOOOOXXXXXXXXXXGOOOOOOOOOOOXXXXXXXXGOOXXXXXXXXXXXXXXXXXGOOOOOXXXXXXXXXXXXXXGOOOOOXXXXXXXXXXXXXXGOOOOOOOOXXXXXXXXXXX,0,600,0
40551,88,0,88,9,403,0,0,412,399,13,GOOXXXXXXXXXXXXXXXXXGOOOOOXXXXXXXXXXXXXXGOOOOOOOOOXXXXXXXXXXGOOOOOXXXXXXXXXXXXXXGOOXXXXXXXXXXXXXXXXXGOOOOOOXXXXXXXXXXXXXGOOOOOOXXXXXXXXXXXXXGOOOOOOOOOXXXXXXXXXXGOOOOOOOOOOOXXXXXXXXGOOXXXXXXXXXXXXXXXXXGOOOOOXXXXXXXXXXXXXXGOOOOOXXXXXXXXXXXXXXGOOOOOOOOXXXXXXXXXXX,0,600,0
40572,88,0,88,8,404,0,0,413,399,14,GOOXXXXXXXXXXXXXXXXXGOOOOOXXXXXXXXXXXXXXGOOOOOOOOOXXXXXXXXXXGOOOOOXXXXXXXXXXXXXXGOOXXXXXXXXXXXXXXXXXGOOOOOOXXXXXXXXXXXXXGOOOOOOXXXXXXXXXXXXXGOOOOOOOOOXXXXXXXXXXGOOOOOOOOOOOXXXXXXXXGOOXXXXXXXXXXXXXXXXXGOOOOOXXXXXXXXXXXXXXGOOOOOXXXXXXXXXXXXXXGOOOOOOOOXXXXXXXXXXX,0,600,0
40593,88,0,88,8,404,0,0,413,398,15,GOOXXXXXXXXXXXXXXXXXGOOOOOXXXXXXXXXXXXXXGOOOOOOOOOXXXXXXXXXXGOOOOOXXXXXXXXXXXXXXGOOXXXXXXXXXXXXXXXXXGOOOOOOXXXXXXXXXXXXXGOOOOOOXXXXXXXXXXXXXGOOOOOOOOOXXXXXXXXXXGOOOOOOOOOOOXXXXXXXXGOOXXXXXXXXXXXXXXXXXGOOOOOXXXXXXXXXXXXXXGOOOOOXXXXXXXXXXXXXXGOOOOOOOOXXXXXXXXXXX,0,600,0
40614,88,0,88,7,405,0,0,414,398,16,GOOXXXXXXXXXXXXXXXXXGOOOOOXXXXXXXXXXXXXXGOOOOOOOOOXXXXXXXXXXGOOOOOXXXXXXXXXXXXXXGOOXXXXXXXXXXXXXXXXXGOOOOOOXXXXXXXXXXXXXGOOOOOOXXXXXXXXXXXXXGOOOOOOOOOXXXXXXXXXXGOOOOOOOOOOOXXXXXXXXGOOXXXXXXXXXXXXXXXXXGOOOOOXXXXXXXXXXXXXXGOOOOOXXXXXXXXXXXXXXGOOOOOOOOXXXXXXXXXXX,0,600,0

40635,88,0,88,7,405,0,0,414,399,15,GOOXXXXXXXXXXXXXXXXXGOOOOOXXXXXXXXXXXXXXGOOOOOOOOOXXXXXXXXXXGOOOOOXXXXXXXXXXXXXXGOOXXXXXXXXXXXXXXXXXGOOOOOOXXXXXXXXXXXXXGOOOOOOXXXXXXXXXXXXXGOOOOOOOOOXXXXXXXXXXGOOOOOOOOOOOXXXXXXXXGOOXXXXXXXXXXXXXXXXXGOOOOOXXXXXXXXXXXXXXGOOOOOXXXXXXXXXXXXXXGOOOOOOOOXXXXXXXXXXX,0,600,0
40656,88,0,88,8,404,0,0,413,398,15,GOOXXXXXXXXXXXXXXXXXGOOOOOXXXXXXXXXXXXXXGOOOOOOOOOXXXXXXXXXXGOOOOOXXXXXXXXXXXXXXGOOXXXXXXXXXXXXXXXXXGOOOOOOXXXXXXXXXXXXXGOOOOOOXXXXXXXXXXXXXGOOOOOOOOOXXXXXXXXXXGOOOOOOOOOOOXXXXXXXXGOOXXXXXXXXXXXXXXXXXGOOOOOXXXXXXXXXXXXXXGOOOOOXXXXXXXXXXXXXXGOOOOOOOOXXXXXXXXXXX,0,600,0
40677,88,0,88,7,405,0,0,414,399,15,GOOXXXXXXXXXXXXXXXXXGOOOOOXXXXXXXXXXXXXXGOOOOOOOOOXXXXXXXXXXGOOOOOXXXXXXXXXXXXXXGOOXXXXXXXXXXXXXXXXXGOOOOOOXXXXXXXXXXXXXGOOOOOOXXXXXXXXXXXXXGOOOOOOOOOXXXXXXXXXXGOOOOOOOOOOOXXXXXXXXGOOXXXXXXXXXXXXXXXXXGOOOOOXXXXXXXXXXXXXXGOOOOOXXXXXXXXXXXXXXGOOOOOOOOXXXXXXXXXXX,0,600,0
40698,88,0,88,6,406,0,0,415,399,16,GOOXXXXXXXXXXXXXXXXXGOOOOOXXXXXXXXXXXXXXGOOOOOOOOOXXXXXXXXXXGOOOOOXXXXXXXXXXXXXXGOOXXXXXXXXXXXXXXXXXGOOOOOOXXXXXXXXXXXXXGOOOOOOXXXXXXXXXXXXXGOOOOOOOOOXXXXXXXXXXGOOOOOOOOOOOXXXXXXXXGOOXXXXXXXXXXXXXXXXXGOOOOOXXXXXXXXXXXXXXGOOOOOXXXXXXXXXXXXXXGOOOOOOOOXXXXXXXXXXX,0,600,0
40719,88,0,88,5,407,0,0,416,400,16,GOOXXXXXXXXXXXXXXXXXGOOOOOXXXXXXXXXXXXXXGOOOOOOOOOXXXXXXXXXXGOOOOOXXXXXXXXXXXXXXGOOXXXXXXXXXXXXXXXXXGOOOOOOXXXXXXXXXXXXXGOOOOOOXXXXXXXXXXXXXGOOOOOOOOOXXXXXXXXXXGOOOOOOOOOOOXXXXXXXXGOOXXXXXXXXXXXXXXXXXGOOOOOXXXXXXXXXXXXXXGOOOOOXXXXXXXXXXXXXXGOOOOOOOOXXXXXXXXXXX,0,600,0

40740,88,0,88,4,408,0,0,417,401,16,GOOXXXXXXXXXXXXXXXXXGOOOOOXXXXXXXXXXXXXXGOOOOOOOOOXXXXXXXXXXGOOOOOXXXXXXXXXXXXXXGOOXXXXXXXXXXXXXXXXXGOOOOOOXXXXXXXXXXXXXGOOOOOOXXXXXXXXXXXXXGOOOOOOOOOXXXXXXXXXXGOOOOOOOOOOOXXXXXXXXGOOXXXXXXXXXXXXXXXXXGOOOOOXXXXXXXXXXXXXXGOOOOOXXXXXXXXXXXXXXGOOOOOOOOXXXXXXXXXXX,0,600,0
40761,88,0,88,7,405,0,0,414,400,14,GOOXXXXXXXXXXXXXXXXXGOOOOOXXXXXXXXXXXXXXGOOOOOOOOOXXXXXXXXXXGOOOOOXXXXXXXXXXXXXXGOOXXXXXXXXXXXXXXXXXGOOOOOOXXXXXXXXXXXXXGOOOOOOXXXXXXXXXXXXXGOOOOOOOOOXXXXXXXXXXGOOOOOOOOOOOXXXXXXXXGOOXXXXXXXXXXXXXXXXXGOOOOOXXXXXXXXXXXXXXGOOOOOXXXXXXXXXXXXXXGOOOOOOOOXXXXXXXXXXX,0,600,0
40782,88,0,88,8,404,0,0,413,398,15,GOOXXXXXXXXXXXXXXXXXGOOOOOXXXXXXXXXXXXXXGOOOOOOOOOXXXXXXXXXXGOOOOOXXXXXXXXXXXXXXGOOXXXXXXXXXXXXXXXXXGOOOOOOXXXXXXXXXXXXXGOOOOOOXXXXXXXXXXXXXGOOOOOOOOOXXXXXXXXXXGOOOOOOOOOOOXXXXXXXXGOOXXXXXXXXXXXXXXXXXGOOOOOXXXXXXXXXXXXXXGOOOOOXXXXXXXXXXXXXXGOOOOOOOOXXXXXXXXXXX,0,600,0
40803,88,0,88,7,405,0,0,414,398,16,GOOXXXXXXXXXXXXXXXXXGOOOOOXXXXXXXXXXXXXXGOOOOOOOOOXXXXXXXXXXGOOOOOXXXXXXXXXXXXXXGOOXXXXXXXXXXXXXXXXXGOOOOOOXXXXXXXXXXXXXGOOOOOOXXXXXXXXXXXXXGOOOOOOOOOXXXXXXXXXXGOOOOOOOOOOOXXXXXXXXGOOXXXXXXXXXXXXXXXXXGOOOOOXXXXXXXXXXXXXXGOOOOOXXXXXXXXXXXXXXGOOOOOOOOXXXXXXXXXXX,0,600,0
40824,88,0,88,8,404,0,0,413,398,15,GOOXXXXXXXXXXXXXXXXXGOOOOOXXXXXXXXXXXXXXGOOOOOOOOOXXXXXXXXXXGOOOOOXXXXXXXXXXXXXXGOOXXXXXXXXXXXXXXXXXGOOOOOOXXXXXXXXXXXXXGOOOOOOXXXXXXXXXXXXXGOOOOOOOOOXXXXXXXXXXGOOOOOOOOOOOXXXXXXXXGOOXXXXXXXXXXXXXXXXXGOOOOOXXXXXXXXXXXXXXGOOOOOXXXXXXXXXXXXXXGOOOOOOOOXXXXXXXXXXX,0,600,0

40845,88,0,88,5,407,0,0,416,398,18,GOOXXXXXXXXXXXXXXXXXGOOOOOXXXXXXXXXXXXXXGOOOOOOOOOXXXXXXXXXXGOOOOOXXXXXXXXXXXXXXGOOXXXXXXXXXXXXXXXXXGOOOOOOXXXXXXXXXXXXXGOOOOOOXXXXXXXXXXXXXGOOOOOOOOOXXXXXXXXXXGOOOOOOOOOOOXXXXXXXXGOOXXXXXXXXXXXXXXXXXGOOOOOXXXXXXXXXXXXXXGOOOOOXXXXXXXXXXXXXXGOOOOOOOOXXXXXXXXXXX,0,600,0
40866,88,0,88,6,406,0,0,415,398,17,GOOXXXXXXXXXXXXXXXXXGOOOOOXXXXXXXXXXXXXXGOOOOOOOOOXXXXXXXXXXGOOOOOXXXXXXXXXXXXXXGOOXXXXXXXXXXXXXXXXXGOOOOOOXXXXXXXXXXXXXGOOOOOOXXXXXXXXXXXXXGOOOOOOOOOXXXXXXXXXXGOOOOOOOOOOOXXXXXXXXGOOXXXXXXXXXXXXXXXXXGOOOOOXXXXXXXXXXXXXXGOOOOOXXXXXXXXXXXXXXGOOOOOOOOXXXXXXXXXXX,0,600,0
40887,88,0,88,6,406,0,0,415,398,17,GOOXXXXXXXXXXXXXXXXXGOOOOOXXXXXXXXXXXXXXGOOOOOOOOOXXXXXXXXXXGOOOOOXXXXXXXXXXXXXXGOOXXXXXXXXXXXXXXXXXGOOOOOOXXXXXXXXXXXXXGOOOOOOXXXXXXXXXXXXXGOOOOOOOOOXXXXXXXXXXGOOOOOOOOOOOXXXXXXXXGOOXXXXXXXXXXXXXXXXXGOOOOOXXXXXXXXXXXXXXGOOOOOXXXXXXXXXXXXXXGOOOOOOOOXXXXXXXXXXX,0,600,0
40908,88,0,88,6,406,0,0,415,399,16,GOOXXXXXXXXXXXXXXXXXGOOOOOXXXXXXXXXXXXXXGOOOOOOOOOXXXXXXXXXXGOOOOOXXXXXXXXXXXXXXGOOXXXXXXXXXXXXXXXXXGOOOOOOXXXXXXXXXXXXXGOOOOOOXXXXXXXXXXXXXGOOOOOOOOOXXXXXXXXXXGOOOOOOOOOOOXXXXXXXXGOOXXXXXXXXXXXXXXXXXGOOOOOXXXXXXXXXXXXXXGOOOOOXXXXXXXXXXXXXXGOOOOOOOOXXXXXXXXXXX,0,600,0
40929,88,0,88,9,403,0,0,412,400,12,GOOXXXXXXXXXXXXXXXXXGOOOOOXXXXXXXXXXXXXXGOOOOOOOOOXXXXXXXXXXGOOOOOXXXXXXXXXXXXXXGOOXXXXXXXXXXXXXXXXXGOOOOOOXXXXXXXXXXXXXGOOOOOOXXXXXXXXXXXXXGOOOOOOOOOXXXXXXXXXXGOOOOOOOOOOOXXXXXXXXGOOXXXXXXXXXXXXXXXXXGOOOOOXXXXXXXXXXXXXXGOOOOOXXXXXXXXXXXXXXGOOOOOOOOXXXXXXXXXXX,0,600,0

40950,88,0,88,10,402,0,0,411,399,12,GOOXXXXXXXXXXXXXXXXXGOOOOOXXXXXXXXXXXXXXGOOOOOOOOOXXXXXXXXXXGOOOOOXXXXXXXXXXXXXXGOOXXXXXXXXXXXXXXXXXGOOOOOOXXXXXXXXXXXXXGOOOOOOXXXXXXXXXXXXXGOOOOOOOOOXXXXXXXXXXGOOOOOOOOOOOXXXXXXXXGOOXXXXXXXXXXXXXXXXXGOOOOOXXXXXXXXXXXXXXGOOOOOXXXXXXXXXXXXXXGOOOOOOOOXXXXXXXXXXX,0,600,0
40971,88,0,88,9,403,0,0,411,399,12,GOOXXXXXXXXXXXXXXXXXGOOOOOXXXXXXXXXXXXXXGOOOOOOOOOXXXXXXXXXXGOOOOOXXXXXXXXXXXXXXGOOXXXXXXXXXXXXXXXXXGOOOOOOXXXXXXXXXXXXXGOOOOOOXXXXXXXXXXXXXGOOOOOOOOOXXXXXXXXXXGOOOOOOOOOOOXXXXXXXXGOOXXXXXXXXXXXXXXXXXGOOOOOXXXXXXXXXXXXXXGOOOOOXXXXXXXXXXXXXXGOOOOOOOOXXXXXXXXXXX,0,600,0
40992,88,0,88,9,403,0,0,412,398,14,GOOXXXXXXXXXXXXXXXXXGOOOOOXXXXXXXXXXXXXXGOOOOOOOOOXXXXXXXXXXGOOOOOXXXXXXXXXXXXXXGOOXXXXXXXXXXXXXXXXXGOOOOOOXXXXXXXXXXXXXGOOOOOOXXXXXXXXXXXXXGOOOOOOOOOXXXXXXXXXXGOOOOOOOOOOOXXXXXXXXGOOXXXXXXXXXXXXXXXXXGOOOOOXXXXXXXXXXXXXXGOOOOOXXXXXXXXXXXXXXGOOOOOOOOXXXXXXXXXXX,0,600,0
41013,88,0,88,9,403,0,0,412,398,14,GOOXXXXXXXXXXXXXXXXXGOOOOOXXXXXXXXXXXXXXGOOOOOOOOOXXXXXXXXXXGOOOOOXXXXXXXXXXXXXXGOOXXXXXXXXXXXXXXXXXGOOOOOOXXXXXXXXXXXXXGOOOOOOXXXXXXXXXXXXXGOOOOOOOOOXXXXXXXXXXGOOOOOOOOOOOXXXXXXXXGOOXXXXXXXXXXXXXXXXXGOOOOOXXXXXXXXXXXXXXGOOOOOXXXXXXXXXXXXXXGOOOOOOOOXXXXXXXXXXX,0,600,0
41034,88,0,88,7,405,0,0,414,398,16,GOOXXXXXXXXXXXXXXXXXGOOOOOXXXXXXXXXXXXXXGOOOOOOOOOXXXXXXXXXXGOOOOOXXXXXXXXXXXXXXGOOXXXXXXXXXXXXXXXXXGOOOOOOXXXXXXXXXXXXXGOOOOOOXXXXXXXXXXXXXGOOOOOOOOOXXXXXXXXXXGOOOOOOOOOOOXXXXXXXXGOOXXXXXXXXXXXXXXXXXGOOOOOXXXXXXXXXXXXXXGOOOOOXXXXXXXXXXXXXXGOOOOOOOOXXXXXXXXXXX,0,600,0

41055,88,0,88,6,406,0,0,415,398,17,GOOXXXXXXXXXXXXXXXXXGOOOOOXXXXXXXXXXXXXXGOOOOOOOOOXXXXXXXXXXGOOOOOXXXXXXXXXXXXXXGOOXXXXXXXXXXXXXXXXXGOOOOOOXXXXXXXXXXXXXGOOOOOOXXXXXXXXXXXXXGOOOOOOOOOXXXXXXXXXXGOOOOOOOOOOOXXXXXXXXGOOXXXXXXXXXXXXXXXXXGOOOOOXXXXXXXXXXXXXXGOOOOOXXXXXXXXXXXXXXGOOOOOOOOXXXXXXXXXXX,0,600,0
41076,88,0,88,7,405,0,0,414,398,16,GOOXXXXXXXXXXXXXXXXXGOOOOOXXXXXXXXXXXXXXGOOOOOOOOOXXXXXXXXXXGOOOOOXXXXXXXXXXXXXXGOOXXXXXXXXXXXXXXXXXGOOOOOOXXXXXXXXXXXXXGOOOOOOXXXXXXXXXXXXXGOOOOOOOOOXXXXXXXXXXGOOOOOOOOOOOXXXXXXXXGOOXXXXXXXXXXXXXXXXXGOOOOOXXXXXXXXXXXXXXGOOOOOXXXXXXXXXXXXXXGOOOOOOOOXXXXXXXXXXX,0,600,0
41097,88,0,88,6,406,0,0,415,398,17,GOOXXXXXXXXXXXXXXXXXGOOOOOXXXXXXXXXXXXXXGOOOOOOOOOXXXXXXXXXXGOOOOOXXXXXXXXXXXXXXGOOXXXXXXXXXXXXXXXXXGOOOOOOXXXXXXXXXXXXXGOOOOOOXXXXXXXXXXXXXGOOOOOOOOOXXXXXXXXXXGOOOOOOOOOOOXXXXXXXXGOOXXXXXXXXXXXXXXXXXGOOOOOXXXXXXXXXXXXXXGOOOOOXXXXXXXXXXXXXXGOOOOOOOOXXXXXXXXXXX,0,600,0
41118,88,0,88,5,407,0,0,416,400,16,GOOXXXXXXXXXXXXXXXXXGOOOOOXXXXXXXXXXXXXXGOOOOOOOOOXXXXXXXXXXGOOOOOXXXXXXXXXXXXXXGOOXXXXXXXXXXXXXXXXXGOOOOOOXXXXXXXXXXXXXGOOOOOOXXXXXXXXXXXXXGOOOOOOOOOXXXXXXXXXXGOOOOOOOOOOOXXXXXXXXGOOXXXXXXXXXXXXXXXXXGOOOOOXXXXXXXXXXXXXXGOOOOOXXXXXXXXXXXXXXGOOOOOOOOXXXXXXXXXXX,0,600,0
41139,88,0,88,6,406,0,0,415,398,17,GOOXXXXXXXXXXXXXXXXXGOOOOOXXXXXXXXXXXXXXGOOOOOOOOOXXXXXXXXXXGOOOOOXXXXXXXXXXXXXXGOOXXXXXXXXXXXXXXXXXGOOOOOOXXXXXXXXXXXXXGOOOOOOXXXXXXXXXXXXXGOOOOOOOOOXXXXXXXXXXGOOOOOOOOOOOXXXXXXXXGOOXXXXXXXXXXXXXXXXXGOOOOOXXXXXXXXXXXXXXGOOOOOXXXXXXXXXXXXXXGOOOOOOOOXXXXXXXXXXX,0,600,0

41160,88,0,88,5,407,0,0,416,399,17,GOOXXXXXXXXXXXXXXXXXGOOOOOXXXXXXXXXXXXXXGOOOOOOOOOXXXXXXXXXXGOOOOOXXXXXXXXXXXXXXGOOXXXXXXXXXXXXXXXXXGOOOOOOXXXXXXXXXXXXXGOOOOOOXXXXXXXXXXXXXGOOOOOOOOOXXXXXXXXXXGOOOOOOOOOOOXXXXXXXXGOOXXXXXXXXXXXXXXXXXGOOOOOXXXXXXXXXXXXXXGOOOOOXXXXXXXXXXXXXXGOOOOOOOOXXXXXXXXXXX,0,600,0
41181,88,0,88,8,404,0,0,413,400,13,GOOXXXXXXXXXXXXXXXXXGOOOOOXXXXXXXXXXXXXXGOOOOOOOOOXXXXXXXXXXGOOOOOXXXXXXXXXXXXXXGOOXXXXXXXXXXXXXXXXXGOOOOOOXXXXXXXXXXXXXGOOOOOOXXXXXXXXXXXXXGOOOOOOOOOXXXXXXXXXXGOOOOOOOOOOOXXXXXXXXGOOXXXXXXXXXXXXXXXXXGOOOOOXXXXXXXXXXXXXXGOOOOOXXXXXXXXXXXXXXGOOOOOOOOXXXXXXXXXXX,0,600,0
41202,88,0,88,10,402,0,0,411,400,11,GOOXXXXXXXXXXXXXXXXXGOOOOOXXXXXXXXXXXXXXGOOOOOOOOOXXXXXXXXXXGOOOOOXXXXXXXXXXXXXXGOOXXXXXXXXXXXXXXXXXGOOOOOOXXXXXXXXXXXXXGOOOOOOXXXXXXXXXXXXXGOOOOOOOOOXXXXXXXXXXGOOOOOOOOOOOXXXXXXXXGOOXXXXXXXXXXXXXXXXXGOOOOOXXXXXXXXXXXXXXGOOOOOXXXXXXXXXXXXXXGOOOOOOOOXXXXXXXXXXX,0,600,0
41223,88,0,88,13,399,0,0,408,398,10,GOOXXXXXXXXXXXXXXXXXGOOOOOXXXXXXXXXXXXXXGOOOOOOOOOXXXXXXXXXXGOOOOOXXXXXXXXXXXXXXGOOXXXXXXXXXXXXXXXXXGOOOOOOXXXXXXXXXXXXXGOOOOOOXXXXXXXXXXXXXGOOOOOOOOOXXXXXXXXXXGOOOOOOOOOOOXXXXXXXXGOOXXXXXXXXXXXXXXXXXGOOOOOXXXXXXXXXXXXXXGOOOOOXXXXXXXXXXXXXXGOOOOOOOOXXXXXXXXXXX,0,600,0
41244,88,0,88,10,402,0,0,411,398,13,GOOXXXXXXXXXXXXXXXXXGOOOOOXXXXXXXXXXXXXXGOOOOOOOOOXXXXXXXXXXGOOOOOXXXXXXXXXXXXXXGOOXXXXXXXXXXXXXXXXXGOOOOOOXXXXXXXXXXXXXGOOOOOOXXXXXXXXXXXXXGOOOOOOOOOXXXXXXXXXXGOOOOOOOOOOOXXXXXXXXGOOXXXXXXXXXXXXXXXXXGOOOOOXXXXXXXXXXXXXXGOOOOOXXXXXXXXXXXXXXGOOOOOOOOXXXXXXXXXXX,0,600,0

41265,88,0,88,11,401,0,0,411,398,13,GOOXXXXXXXXXXXXXXXXXGOOOOOXXXXXXXXXXXXXXGOOOOOOOOOXXXXXXXXXXGOOOOOXXXXXXXXXXXXXXGOOXXXXXXXXXXXXXXXXXGOOOOOOXXXXXXXXXXXXXGOOOOOOXXXXXXXXXXXXXGOOOOOOOOOXXXXXXXXXXGOOOOOOOOOOOXXXXXXXXGOOXXXXXXXXXXXXXXXXXGOOOOOXXXXXXXXXXXXXXGOOOOOXXXXXXXXXXXXXXGOOOOOOOOXXXXXXXXXXX,0,600,0
41286,88,0,88,11,401,0,0,411,398,13,GOOXXXXXXXXXXXXXXXXXGOOOOOXXXXXXXXXXXXXXGOOOOOOOOOXXXXXXXXXXGOOOOOXXXXXXXXXXXXXXGOOXXXXXXXXXXXXXXXXXGOOOOOOXXXXXXXXXXXXXGOOOOOOXXXXXXXXXXXXXGOOOOOOOOOXXXXXXXXXXGOOOOOOOOOOOXXXXXXXXGOOXXXXXXXXXXXXXXXXXGOOOOOXXXXXXXXXXXXXXGOOOOOXXXXXXXXXXXXXXGOOOOOOOOXXXXXXXXXXX,0,600,0
41307,88,0,88,10,402,0,0,412,398,14,GOOXXXXXXXXXXXXXXXXXGOOOOOXXXXXXXXXXXXXXGOOOOOOOOOXXXXXXXXXXGOOOOOXXXXXXXXXXXXXXGOOXXXXXXXXXXXXXXXXXGOOOOOOXXXXXXXXXXXXXGOOOOOOXXXXXXXXXXXXXGOOOOOOOOOXXXXXXXXXXGOOOOOOOOOOOXXXXXXXXGOOXXXXXXXXXXXXXXXXXGOOOOOXXXXXXXXXXXXXXGOOOOOXXXXXXXXXXXXXXGOOOOOOOOXXXXXXXXXXX,0,600,0
41328,88,0,88,11,401,0,0,411,399,12,GOOXXXXXXXXXXXXXXXXXGOOOOOXXXXXXXXXXXXXXGOOOOOOOOOXXXXXXXXXXGOOOOOXXXXXXXXXXXXXXGOOXXXXXXXXXXXXXXXXXGOOOOOOXXXXXXXXXXXXXGOOOOOOXXXXXXXXXXXXXGOOOOOOOOOXXXXXXXXXXGOOOOOOOOOOOXXXXXXXXGOOXXXXXXXXXXXXXXXXXGOOOOOXXXXXXXXXXXXXXGOOOOOXXXXXXXXXXXXXXGOOOOOOOOXXXXXXXXXXX,0,600,0
41349,88,0,88,10,402,0,0,412,399,13,GOOXXXXXXXXXXXXXXXXXGOOOOOXXXXXXXXXXXXXXGOOOOOOOOOXXXXXXXXXXGOOOOOXXXXXXXXXXXXXXGOOXXXXXXXXXXXXXXXXXGOOOOOOXXXXXXXXXXXXXGOOOOOOXXXXXXXXXXXXXGOOOOOOOOOXXXXXXXXXXGOOOOOOOOOOOXXXXXXXXGOOXXXXXXXXXXXXXXXXXGOOOOOXXXXXXXXXXXXXXGOOOOOXXXXXXXXXXXXXXGOOOOOOOOXXXXXXXXXXX,0,600,0

41370,88,0,88,11,401,0,0,411,398,13,GOOXXXXXXXXXXXXXXXXXGOOOOOXXXXXXXXXXXXXXGOOOOOOOOOXXXXXXXXXXGOOOOOXXXXXXXXXXXXXXGOOXXXXXXXXXXXXXXXXXGOOOOOOXXXXXXXXXXXXXGOOOOOOXXXXXXXXXXXXXGOOOOOOOOOXXXXXXXXXXGOOOOOOOOOOOXXXXXXXXGOOXXXXXXXXXXXXXXXXXGOOOOOXXXXXXXXXXXXXXGOOOOOXXXXXXXXXXXXXXGOOOOOOOOXXXXXXXXXXX,0,600,0
41391,88,0,88,9,403,0,0,413,398,15,GOOXXXXXXXXXXXXXXXXXGOOOOOXXXXXXXXXXXXXXGOOOOOOOOOXXXXXXXXXXGOOOOOXXXXXXXXXXXXXXGOOXXXXXXXXXXXXXXXXXGOOOOOOXXXXXXXXXXXXXGOOOOOOXXXXXXXXXXXXXGOOOOOOOOOXXXXXXXXXXGOOOOOOOOOOOXXXXXXXXGOOXXXXXXXXXXXXXXXXXGOOOOOXXXXXXXXXXXXXXGOOOOOXXXXXXXXXXXXXXGOOOOOOOOXXXXXXXXXXX,0,600,0
41412,88,0,88,7,405,0,0,414,398,16,GOOXXXXXXXXXXXXXXXXXGOOOOOXXXXXXXXXXXXXXGOOOOOOOOOXXXXXXXXXXGOOOOOXXXXXXXXXXXXXXGOOXXXXXXXXXXXXXXXXXGOOOOOOXXXXXXXXXXXXXGOOOOOOXXXXXXXXXXXXXGOOOOOOOOOXXXXXXXXXXGOOOOOOOOOOOXXXXXXXXGOOXXXXXXXXXXXXXXXXXGOOOOOXXXXXXXXXXXXXXGOOOOOXXXXXXXXXXXXXXGOOOOOOOOXXXXXXXXXXX,0,600,0
41433,88,0,88,7,405,0,0,414,398,16,GOOXXXXXXXXXXXXXXXXXGOOOOOXXXXXXXXXXXXXXGOOOOOOOOOXXXXXXXXXXGOOOOOXXXXXXXXXXXXXXGOOXXXXXXXXXXXXXXXXXGOOOOOOXXXXXXXXXXXXXGOOOOOOXXXXXXXXXXXXXGOOOOOOOOOXXXXXXXXXXGOOOOOOOOOOOXXXXXXXXGOOXXXXXXXXXXXXXXXXXGOOOOOXXXXXXXXXXXXXXGOOOOOXXXXXXXXXXXXXXGOOOOOOOOXXXXXXXXXXX,0,600,0
41454,88,0,88,7,405,0,0,414,398,16,GOOXXXXXXXXXXXXXXXXXGOOOOOXXXXXXXXXXXXXXGOOOOOOOOOXXXXXXXXXXGOOOOOXXXXXXXXXXXXXXGOOXXXXXXXXXXXXXXXXXGOOOOOOXXXXXXXXXXXXXGOOOOOOXXXXXXXXXXXXXGOOOOOOOOOXXXXXXXXXXGOOOOOOOOOOOXXXXXXXXGOOXXXXXXXXXXXXXXXXXGOOOOOXXXXXXXXXXXXXXGOOOOOXXXXXXXXXXXXXXGOOOOOOOOXXXXXXXXXXX,0,600,0

41475,88,0,88,7,405,0,0,414,398,16,GOOXXXXXXXXXXXXXXXXXGOOOOOXXXXXXXXXXXXXXGOOOOOOOOOXXXXXXXXXXGOOOOOXXXXXXXXXXXXXXGOOXXXXXXXXXXXXXXXXXGOOOOOOXXXXXXXXXXXXXGOOOOOOXXXXXXXXXXXXXGOOOOOOOOOXXXXXXXXXXGOOOOOOOOOOOXXXXXXXXGOOXXXXXXXXXXXXXXXXXGOOOOOXXXXXXXXXXXXXXGOOOOOXXXXXXXXXXXXXXGOOOOOOOOXXXXXXXXXXX,0,600,0
41496,88,0,88,6,406,0,0,415,398,17,GOOXXXXXXXXXXXXXXXXXGOOOOOXXXXXXXXXXXXXXGOOOOOOOOOXXXXXXXXXXGOOOOOXXXXXXXXXXXXXXGOOXXXXXXXXXXXXXXXXXGOOOOOOXXXXXXXXXXXXXGOOOOOOXXXXXXXXXXXXXGOOOOOOOOOXXXXXXXXXXGOOOOOOOOOOOXXXXXXXXGOOXXXXXXXXXXXXXXXXXGOOOOOXXXXXXXXXXXXXXGOOOOOXXXXXXXXXXXXXXGOOOOOOOOXXXXXXXXXXX,0,600,0
41517,88,0,88,6,406,0,0,415,399,16,GOOXXXXXXXXXXXXXXXXXGOOOOOXXXXXXXXXXXXXXGOOOOOOOOOXXXXXXXXXXGOOOOOXXXXXXXXXXXXXXGOOXXXXXXXXXXXXXXXXXGOOOOOOXXXXXXXXXXXXXGOOOOOOXXXXXXXXXXXXXGOOOOOOOOOXXXXXXXXXXGOOOOOOOOOOOXXXXXXXXGOOXXXXXXXXXXXXXXXXXGOOOOOXXXXXXXXXXXXXXGOOOOOXXXXXXXXXXXXXXGOOOOOOOOXXXXXXXXXXX,0,600,0
41538,88,0,88,6,406,0,0,415,399,16,GOOXXXXXXXXXXXXXXXXXGOOOOOXXXXXXXXXXXXXXGOOOOOOOOOXXXXXXXXXXGOOOOOXXXXXXXXXXXXXXGOOXXXXXXXXXXXXXXXXXGOOOOOOXXXXXXXXXXXXXGOOOOOOXXXXXXXXXXXXXGOOOOOOOOOXXXXXXXXXXGOOOOOOOOOOOXXXXXXXXGOOXXXXXXXXXXXXXXXXXGOOOOOXXXXXXXXXXXXXXGOOOOOXXXXXXXXXXXXXXGOOOOOOOOXXXXXXXXXXX,0,600,0
41559,88,0,88,7,405,0,0,414,399,15,GOOXXXXXXXXXXXXXXXXXGOOOOOXXXXXXXXXXXXXXGOOOOOOOOOXXXXXXXXXXGOOOOOXXXXXXXXXXXXXXGOOXXXXXXXXXXXXXXXXXGOOOOOOXXXXXXXXXXXXXGOOOOOOXXXXXXXXXXXXXGOOOOOOOOOXXXXXXXXXXGOOOOOOOOOOOXXXXXXXXGOOXXXXXXXXXXXXXXXXXGOOOOOXXXXXXXXXXXXXXGOOOOOXXXXXXXXXXXXXXGOOOOOOOOXXXXXXXXXXX,0,600,0

41580,88,0,88,9,403,0,0,412,399,13,GOOXXXXXXXXXXXXXXXXXGOOOOOXXXXXXXXXXXXXXGOOOOOOOOOXXXXXXXXXXGOOOOOXXXXXXXXXXXXXXGOOXXXXXXXXXXXXXXXXXGOOOOOOXXXXXXXXXXXXXGOOOOOOXXXXXXXXXXXXXGOOOOOOOOOXXXXXXXXXXGOOOOOOOOOOOXXXXXXXXGOOXXXXXXXXXXXXXXXXXGOOOOOXXXXXXXXXXXXXXGOOOOOXXXXXXXXXXXXXXGOOOOOOOOXXXXXXXXXXX,0,600,0
41601,88,0,88,8,404,0,0,413,399,14,GOOXXXXXXXXXXXXXXXXXGOOOOOXXXXXXXXXXXXXXGOOOOOOOOOXXXXXXXXXXGOOOOOXXXXXXXXXXXXXXGOOXXXXXXXXXXXXXXXXXGOOOOOOXXXXXXXXXXXXXGOOOOOOXXXXXXXXXXXXXGOOOOOOOOOXXXXXXXXXXGOOOOOOOOOOOXXXXXXXXGOOXXXXXXXXXXXXXXXXXGOOOOOXXXXXXXXXXXXXXGOOOOOXXXXXXXXXXXXXXGOOOOOOOOXXXXXXXXXXX,0,600,0
41622,88,0,88,9,403,0,0,412,400,12,GOOXXXXXXXXXXXXXXXXXGOOOOOXXXXXXXXXXXXXXGOOOOOOOOOXXXXXXXXXXGOOOOOXXXXXXXXXXXXXXGOOXXXXXXXXXXXXXXXXXGOOOOOOXXXXXXXXXXXXXGOOOOOOXXXXXXXXXXXXXGOOOOOOOOOXXXXXXXXXXGOOOOOOOOOOOXXXXXXXXGOOXXXXXXXXXXXXXXXXXGOOOOOXXXXXXXXXXXXXXGOOOOOXXXXXXXXXXXXXXGOOOOOOOOXXXXXXXXXXX,0,600,0
41643,88,0,88,10,402,0,0,411,400,11,GOOXXXXXXXXXXXXXXXXXGOOOOOXXXXXXXXXXXXXXGOOOOOOOOOXXXXXXXXXXGOOOOOXXXXXXXXXXXXXXGOOXXXXXXXXXXXXXXXXXGOOOOOOXXXXXXXXXXXXXGOOOOOOXXXXXXXXXXXXXGOOOOOOOOOXXXXXXXXXXGOOOOOOOOOOOXXXXXXXXGOOXXXXXXXXXXXXXXXXXGOOOOOXXXXXXXXXXXXXXGOOOOOXXXXXXXXXXXXXXGOOOOOOOOXXXXXXXXXXX,0,600,0
41664,88,0,88,10,402,0,0,411,400,11,GOOXXXXXXXXXXXXXXXXXGOOOOOXXXXXXXXXXXXXXGOOOOOOOOOXXXXXXXXXXGOOOOOXXXXXXXXXXXXXXGOOXXXXXXXXXXXXXXXXXGOOOOOOXXXXXXXXXXXXXGOOOOOOXXXXXXXXXXXXXGOOOOOOOOOXXXXXXXXXXGOOOOOOOOOOOXXXXXXXXGOOXXXXXXXXXXXXXXXXXGOOOOOXXXXXXXXXXXXXXGOOOOOXXXXXXXXXXXXXXGOOOOOOOOXXXXXXXXXXX,0,600,0

41685,88,0,88,12,400,0,0,409,399,10,GOOXXXXXXXXXXXXXXXXXGOOOOOXXXXXXXXXXXXXXGOOOOOOOOOXXXXXXXXXXGOOOOOXXXXXXXXXXXXXXGOOXXXXXXXXXXXXXXXXXGOOOOOOXXXXXXXXXXXXXGOOOOOOXXXXXXXXXXXXXGOOOOOOOOOXXXXXXXXXXGOOOOOOOOOOOXXXXXXXXGOOXXXXXXXXXXXXXXXXXGOOOOOXXXXXXXXXXXXXXGOOOOOXXXXXXXXXXXXXXGOOOOOOOOXXXXXXXXXXX,0,600,0
41706,88,0,88,10,402,0,0,411,399,12,GOOXXXXXXXXXXXXXXXXXGOOOOOXXXXXXXXXXXXXXGOOOOOOOOOXXXXXXXXXXGOOOOOXXXXXXXXXXXXXXGOOXXXXXXXXXXXXXXXXXGOOOOOOXXXXXXXXXXXXXGOOOOOOXXXXXXXXXXXXXGOOOOOOOOOXXXXXXXXXXGOOOOOOOOOOOXXXXXXXXGOOXXXXXXXXXXXXXXXXXGOOOOOXXXXXXXXXXXXXXGOOOOOXXXXXXXXXXXXXXGOOOOOOOOXXXXXXXXXXX,0,600,0
41727,88,0,88,7,405,0,0,414,399,15,GOOXXXXXXXXXXXXXXXXXGOOOOOXXXXXXXXXXXXXXGOOOOOOOOOXXXXXXXXXXGOOOOOXXXXXXXXXXXXXXGOOXXXXXXXXXXXXXXXXXGOOOOOOXXXXXXXXXXXXXGOOOOOOXXXXXXXXXXXXXGOOOOOOOOOXXXXXXXXXXGOOOOOOOOOOOXXXXXXXXGOOXXXXXXXXXXXXXXXXXGOOOOOXXXXXXXXXXXXXXGOOOOOXXXXXXXXXXXXXXGOOOOOOOOXXXXXXXXXXX,0,600,0
41748,88,0,88,5,407,0,0,416,399,17,GOOXXXXXXXXXXXXXXXXXGOOOOOXXXXXXXXXXXXXXGOOOOOOOOOXXXXXXXXXXGOOOOOXXXXXXXXXXXXXXGOOXXXXXXXXXXXXXXXXXGOOOOOOXXXXXXXXXXXXXGOOOOOOXXXXXXXXXXXXXGOOOOOOOOOXXXXXXXXXXGOOOOOOOOOOOXXXXXXXXGOOXXXXXXXXXXXXXXXXXGOOOOOXXXXXXXXXXXXXXGOOOOOXXXXXXXXXXXXXXGOOOOOOOOXXXXXXXXXXX,0,600,0
41769,88,0,88,4,408,0,0,417,400,17,GOOXXXXXXXXXXXXXXXXXGOOOOOXXXXXXXXXXXXXXGOOOOOOOOOXXXXXXXXXXGOOOOOXXXXXXXXXXXXXXGOOXXXXXXXXXXXXXXXXXGOOOOOOXXXXXXXXXXXXXGOOOOOOXXXXXXXXXXXXXGOOOOOOOOOXXXXXXXXXXGOOOOOOOOOOOXXXXXXXXGOOXXXXXXXXXXXXXXXXXGOOOOOXXXXXXXXXXXXXXGOOOOOXXXXXXXXXXXXXXGOOOOOOOOXXXXXXXXXXX,0,600,0

41790,88,0,88,3,409,0,0,418,401,17,GOOXXXXXXXXXXXXXXXXXGOOOOOXXXXXXXXXXXXXXGOOOOOOOOOXXXXXXXXXXGOOOOOXXXXXXXXXXXXXXGOOXXXXXXXXXXXXXXXXXGOOOOOOXXXXXXXXXXXXXGOOOOOOXXXXXXXXXXXXXGOOOOOOOOOXXXXXXXXXXGOOOOOOOOOOOXXXXXXXXGOOXXXXXXXXXXXXXXXXXGOOOOOXXXXXXXXXXXXXXGOOOOOXXXXXXXXXXXXXXGOOOOOOOOXXXXXXXXXXX,0,600,0
41811,88,0,88,5,407,0,0,416,401,15,GOOXXXXXXXXXXXXXXXXXGOOOOOXXXXXXXXXXXXXXGOOOOOOOOOXXXXXXXXXXGOOOOOXXXXXXXXXXXXXXGOOXXXXXXXXXXXXXXXXXGOOOOOOXXXXXXXXXXXXXGOOOOOOXXXXXXXXXXXXXGOOOOOOOOOXXXXXXXXXXGOOOOOOOOOOOXXXXXXXXGOOXXXXXXXXXXXXXXXXXGOOOOOXXXXXXXXXXXXXXGOOOOOXXXXXXXXXXXXXXGOOOOOOOOXXXXXXXXXXX,0,600,0
41832,88,0,88,6,406,0,0,416,400,16,GOOXXXXXXXXXXXXXXXXXGOOOOOXXXXXXXXXXXXXXGOOOOOOOOOXXXXXXXXXXGOOOOOXXXXXXXXXXXXXXGOOXXXXXXXXXXXXXXXXXGOOOOOOXXXXXXXXXXXXXGOOOOOOXXXXXXXXXXXXXGOOOOOOOOOXXXXXXXXXXGOOOOOOOOOOOXXXXXXXXGOOXXXXXXXXXXXXXXXXXGOOOOOXXXXXXXXXXXXXXGOOOOOXXXXXXXXXXXXXXGOOOOOOOOXXXXXXXXXXX,0,600,0
41853,88,0,88,6,406,0,0,416,400,16,GOOXXXXXXXXXXXXXXXXXGOOOOOXXXXXXXXXXXXXXGOOOOOOOOOXXXXXXXXXXGOOOOOXXXXXXXXXXXXXXGOOXXXXXXXXXXXXXXXXXGOOOOOOXXXXXXXXXXXXXGOOOOOOXXXXXXXXXXXXXGOOOOOOOOOXXXXXXXXXXGOOOOOOOOOOOXXXXXXXXGOOXXXXXXXXXXXXXXXXXGOOOOOXXXXXXXXXXXXXXGOOOOOXXXXXXXXXXXXXXGOOOOOOOOXXXXXXXXXXX,0,600,0
41874,88,0,88,6,406,0,0,416,401,15,GOOXXXXXXXXXXXXXXXXXGOOOOOXXXXXXXXXXXXXXGOOOOOOOOOXXXXXXXXXXGOOOOOXXXXXXXXXXXXXXGOOXXXXXXXXXXXXXXXXXGOOOOOOXXXXXXXXXXXXXGOOOOOOXXXXXXXXXXXXXGOOOOOOOOOXXXXXXXXXXGOOOOOOOOOOOXXXXXXXXGOOXXXXXXXXXXXXXXXXXGOOOOOXXXXXXXXXXXXXXGOOOOOXXXXXXXXXXXXXXGOOOOOOOOXXXXXXXXXXX,0,600,0

41895,88,0,88,6,406,0,0,416,400,16,GOOXXXXXXXXXXXXXXXXXGOOOOOXXXXXXXXXXXXXXGOOOOOOOOOXXXXXXXXXXGOOOOOXXXXXXXXXXXXXXGOOXXXXXXXXXXXXXXXXXGOOOOOOXXXXXXXXXXXXXGOOOOOOXXXXXXXXXXXXXGOOOOOOOOOXXXXXXXXXXGOOOOOOOOOOOXXXXXXXXGOOXXXXXXXXXXXXXXXXXGOOOOOXXXXXXXXXXXXXXGOOOOOXXXXXXXXXXXXXXGOOOOOOOOXXXXXXXXXXX,0,600,0
41916,88,0,88,6,406,0,0,415,400,15,GOOXXXXXXXXXXXXXXXXXGOOOOOXXXXXXXXXXXXXXGOOOOOOOOOXXXXXXXXXXGOOOOOXXXXXXXXXXXXXXGOOXXXXXXXXXXXXXXXXXGOOOOOOXXXXXXXXXXXXXGOOOOOOXXXXXXXXXXXXXGOOOOOOOOOXXXXXXXXXXGOOOOOOOOOOOXXXXXXXXGOOXXXXXXXXXXXXXXXXXGOOOOOXXXXXXXXXXXXXXGOOOOOXXXXXXXXXXXXXXGOOOOOOOOXXXXXXXXXXX,0,600,0
41937,88,0,88,6,406,0,0,415,401,14,GOOXXXXXXXXXXXXXXXXXGOOOOOXXXXXXXXXXXXXXGOOOOOOOOOXXXXXXXXXXGOOOOOXXXXXXXXXXXXXXGOOXXXXXXXXXXXXXXXXXGOOOOOOXXXXXXXXXXXXXGOOOOOOXXXXXXXXXXXXXGOOOOOOOOOXXXXXXXXXXGOOOOOOOOOOOXXXXXXXXGOOXXXXXXXXXXXXXXXXXGOOOOOXXXXXXXXXXXXXXGOOOOOXXXXXXXXXXXXXXGOOOOOOOOXXXXXXXXXXX,0,600,0
41958,88,0,88,7,405,0,0,414,400,14,GOOXXXXXXXXXXXXXXXXXGOOOOOXXXXXXXXXXXXXXGOOOOOOOOOXXXXXXXXXXGOOOOOXXXXXXXXXXXXXXGOOXXXXXXXXXXXXXXXXXGOOOOOOXXXXXXXXXXXXXGOOOOOOXXXXXXXXXXXXXGOOOOOOOOOXXXXXXXXXXGOOOOOOOOOOOXXXXXXXXGOOXXXXXXXXXXXXXXXXXGOOOOOXXXXXXXXXXXXXXGOOOOOXXXXXXXXXXXXXXGOOOOOOOOXXXXXXXXXXX,0,600,0
41979,88,0,88,7,405,0,0,414,401,13,GOOXXXXXXXXXXXXXXXXXGOOOOOXXXXXXXXXXXXXXGOOOOOOOOOXXXXXXXXXXGOOOOOXXXXXXXXXXXXXXGOOXXXXXXXXXXXXXXXXXGOOOOOOXXXXXXXXXXXXXGOOOOOOXXXXXXXXXXXXXGOOOOOOOOOXXXXXXXXXXGOOOOOOOOOOOXXXXXXXXGOOXXXXXXXXXXXXXXXXXGOOOOOXXXXXXXXXXXXXXGOOOOOXXXXXXXXXXXXXXGOOOOOOOOXXXXXXXXXXX,0,600,0

42000,88,0,88,6,406,0,0,415,400,15,GOOXXXXXXXXXXXXXXXXXGOOOOOXXXXXXXXXXXXXXGOOOOOOOOOXXXXXXXXXXGOOOOOXXXXXXXXXXXXXXGOOXXXXXXXXXXXXXXXXXGOOOOOOXXXXXXXXXXXXXGOOOOOOXXXXXXXXXXXXXGOOOOOOOOOXXXXXXXXXXGOOOOOOOOOOOXXXXXXXXGOOXXXXXXXXXXXXXXXXXGOOOOOXXXXXXXXXXXXXXGOOOOOXXXXXXXXXXXXXXGOOOOOOOOXXXXXXXXXXX,0,600,0
42021,88,0,88,6,406,0,0,415,401,14,GOOXXXXXXXXXXXXXXXXXGOOOOOXXXXXXXXXXXXXXGOOOOOOOOOXXXXXXXXXXGOOOOOXXXXXXXXXXXXXXGOOXXXXXXXXXXXXXXXXXGOOOOOOXXXXXXXXXXXXXGOOOOOOXXXXXXXXXXXXXGOOOOOOOOOXXXXXXXXXXGOOOOOOOOOOOXXXXXXXXGOOXXXXXXXXXXXXXXXXXGOOOOOXXXXXXXXXXXXXXGOOOOOXXXXXXXXXXXXXXGOOOOOOOOXXXXXXXXXXX,0,600,0
42042,88,0,88,5,407,0,0,416,400,16,GOOXXXXXXXXXXXXXXXXXGOOOOOXXXXXXXXXXXXXXGOOOOOOOOOXXXXXXXXXXGOOOOOXXXXXXXXXXXXXXGOOXXXXXXXXXXXXXXXXXGOOOOOOXXXXXXXXXXXXXGOOOOOOXXXXXXXXXXXXXGOOOOOOOOOXXXXXXXXXXGOOOOOOOOOOOXXXXXXXXGOOXXXXXXXXXXXXXXXXXGOOOOOXXXXXXXXXXXXXXGOOOOOXXXXXXXXXXXXXXGOOOOOOOOXXXXXXXXXXX,0,600,0
42063,88,0,88,5,407,0,0,416,400,16,GOOXXXXXXXXXXXXXXXXXGOOOOOXXXXXXXXXXXXXXGOOOOOOOOOXXXXXXXXXXGOOOOOXXXXXXXXXXXXXXGOOXXXXXXXXXXXXXXXXXGOOOOOOXXXXXXXXXXXXXGOOOOOOXXXXXXXXXXXXXGOOOOOOOOOXXXXXXXXXXGOOOOOOOOOOOXXXXXXXXGOOXXXXXXXXXXXXXXXXXGOOOOOXXXXXXXXXXXXXXGOOOOOXXXXXXXXXXXXXXGOOOOOOOOXXXXXXXXXXX,0,600,0
42084,88,0,88,5,407,0,0,416,401,15,GOOXXXXXXXXXXXXXXXXXGOOOOOXXXXXXXXXXXXXXGOOOOOOOOOXXXXXXXXXXGOOOOOXXXXXXXXXXXXXXGOOXXXXXXXXXXXXXXXXXGOOOOOOXXXXXXXXXXXXXGOOOOOOXXXXXXXXXXXXXGOOOOOOOOOXXXXXXXXXXGOOOOOOOOOOOXXXXXXXXGOOXXXXXXXXXXXXXXXXXGOOOOOXXXXXXXXXXXXXXGOOOOOXXXXXXXXXXXXXXGOOOOOOOOXXXXXXXXXXX,0,600,0

42105,88,0,88,5,407,0,0,416,400,16,GOOXXXXXXXXXXXXXXXXXGOOOOOXXXXXXXXXXXXXXGOOOOOOOOOXXXXXXXXXXGOOOOOXXXXXXXXXXXXXXGOOXXXXXXXXXXXXXXXXXGOOOOOOXXXXXXXXXXXXXGOOOOOOXXXXXXXXXXXXXGOOOOOOOOOXXXXXXXXXXGOOOOOOOOOOOXXXXXXXXGOOXXXXXXXXXXXXXXXXXGOOOOOXXXXXXXXXXXXXXGOOOOOXXXXXXXXXXXXXXGOOOOOOOOXXXXXXXXXXX,0,600,0
42126,88,0,88,4,408,0,0,417,400,17,GOOXXXXXXXXXXXXXXXXXGOOOOOXXXXXXXXXXXXXXGOOOOOOOOOXXXXXXXXXXGOOOOOXXXXXXXXXXXXXXGOOXXXXXXXXXXXXXXXXXGOOOOOOXXXXXXXXXXXXXGOOOOOOXXXXXXXXXXXXXGOOOOOOOOOXXXXXXXXXXGOOOOOOOOOOOXXXXXXXXGOOXXXXXXXXXXXXXXXXXGOOOOOXXXXXXXXXXXXXXGOOOOOXXXXXXXXXXXXXXGOOOOOOOOXXXXXXXXXXX,0,600,0
42147,88,0,88,4,408,0,0,417,401,16,GOOXXXXXXXXXXXXXXXXXGOOOOOXXXXXXXXXXXXXXGOOOOOOOOOXXXXXXXXXXGOOOOOXXXXXXXXXXXXXXGOOXXXXXXXXXXXXXXXXXGOOOOOOXXXXXXXXXXXXXGOOOOOOXXXXXXXXXXXXXGOOOOOOOOOXXXXXXXXXXGOOOOOOOOOOOXXXXXXXXGOOXXXXXXXXXXXXXXXXXGOOOOOXXXXXXXXXXXXXXGOOOOOXXXXXXXXXXXXXXGOOOOOOOOXXXXXXXXXXX,0,600,0
42168,88,0,88,4,408,0,0,417,400,17,GOOXXXXXXXXXXXXXXXXXGOOOOOXXXXXXXXXXXXXXGOOOOOOOOOXXXXXXXXXXGOOOOOXXXXXXXXXXXXXXGOOXXXXXXXXXXXXXXXXXGOOOOOOXXXXXXXXXXXXXGOOOOOOXXXXXXXXXXXXXGOOOOOOOOOXXXXXXXXXXGOOOOOOOOOOOXXXXXXXXGOOXXXXXXXXXXXXXXXXXGOOOOOXXXXXXXXXXXXXXGOOOOOXXXXXXXXXXXXXXGOOOOOOOOXXXXXXXXXXX,0,600,0
42189,88,0,88,5,407,0,0,416,400,16,GOOXXXXXXXXXXXXXXXXXGOOOOOXXXXXXXXXXXXXXGOOOOOOOOOXXXXXXXXXXGOOOOOXXXXXXXXXXXXXXGOOXXXXXXXXXXXXXXXXXGOOOOOOXXXXXXXXXXXXXGOOOOOOXXXXXXXXXXXXXGOOOOOOOOOXXXXXXXXXXGOOOOOOOOOOOXXXXXXXXGOOXXXXXXXXXXXXXXXXXGOOOOOXXXXXXXXXXXXXXGOOOOOXXXXXXXXXXXXXXGOOOOOOOOXXXXXXXXXXX,0,600,0

42210,88,0,88,6,406,0,0,415,400,15,GOOXXXXXXXXXXXXXXXXXGOOOOOXXXXXXXXXXXXXXGOOOOOOOOOXXXXXXXXXXGOOOOOXXXXXXXXXXXXXXGOOXXXXXXXXXXXXXXXXXGOOOOOOXXXXXXXXXXXXXGOOOOOOXXXXXXXXXXXXXGOOOOOOOOOXXXXXXXXXXGOOOOOOOOOOOXXXXXXXXGOOXXXXXXXXXXXXXXXXXGOOOOOXXXXXXXXXXXXXXGOOOOOXXXXXXXXXXXXXXGOOOOOOOOXXXXXXXXXXX,0,600,0
42231,88,0,88,5,407,0,0,416,402,14,GOOXXXXXXXXXXXXXXXXXGOOOOOXXXXXXXXXXXXXXGOOOOOOOOOXXXXXXXXXXGOOOOOXXXXXXXXXXXXXXGOOXXXXXXXXXXXXXXXXXGOOOOOOXXXXXXXXXXXXXGOOOOOOXXXXXXXXXXXXXGOOOOOOOOOXXXXXXXXXXGOOOOOOOOOOOXXXXXXXXGOOXXXXXXXXXXXXXXXXXGOOOOOXXXXXXXXXXXXXXGOOOOOXXXXXXXXXXXXXXGOOOOOOOOXXXXXXXXXXX,0,600,0
42252,88,0,88,4,408,0,0,417,402,15,GOOXXXXXXXXXXXXXXXXXGOOOOOXXXXXXXXXXXXXXGOOOOOOOOOXXXXXXXXXXGOOOOOXXXXXXXXXXXXXXGOOXXXXXXXXXXXXXXXXXGOOOOOOXXXXXXXXXXXXXGOOOOOOXXXXXXXXXXXXXGOOOOOOOOOXXXXXXXXXXGOOOOOOOOOOOXXXXXXXXGOOXXXXXXXXXXXXXXXXXGOOOOOXXXXXXXXXXXXXXGOOOOOXXXXXXXXXXXXXXGOOOOOOOOXXXXXXXXXXX,0,600,0
42273,88,0,88,4,408,0,0,417,403,14,GOOXXXXXXXXXXXXXXXXXGOOOOOXXXXXXXXXXXXXXGOOOOOOOOOXXXXXXXXXXGOOOOOXXXXXXXXXXXXXXGOOXXXXXXXXXXXXXXXXXGOOOOOOXXXXXXXXXXXXXGOOOOOOXXXXXXXXXXXXXGOOOOOOOOOXXXXXXXXXXGOOOOOOOOOOOXXXXXXXXGOOXXXXXXXXXXXXXXXXXGOOOOOXXXXXXXXXXXXXXGOOOOOXXXXXXXXXXXXXXGOOOOOOOOXXXXXXXXXXX,0,600,0
42294,88,0,88,5,407,0,0,416,403,13,GOOXXXXXXXXXXXXXXXXXGOOOOOXXXXXXXXXXXXXXGOOOOOOOOOXXXXXXXXXXGOOOOOXXXXXXXXXXXXXXGOOXXXXXXXXXXXXXXXXXGOOOOOOXXXXXXXXXXXXXGOOOOOOXXXXXXXXXXXXXGOOOOOOOOOXXXXXXXXXXGOOOOOOOOOOOXXXXXXXXGOOXXXXXXXXXXXXXXXXXGOOOOOXXXXXXXXXXXXXXGOOOOOXXXXXXXXXXXXXXGOOOOOOOOXXXXXXXXXXX,0,600,0

42315,88,0,88,6,406,0,0,415,402,13,GOOXXXXXXXXXXXXXXXXXGOOOOOXXXXXXXXXXXXXXGOOOOOOOOOXXXXXXXXXXGOOOOOXXXXXXXXXXXXXXGOOXXXXXXXXXXXXXXXXXGOOOOOOXXXXXXXXXXXXXGOOOOOOXXXXXXXXXXXXXGOOOOOOOOOXXXXXXXXXXGOOOOOOOOOOOXXXXXXXXGOOXXXXXXXXXXXXXXXXXGOOOOOXXXXXXXXXXXXXXGOOOOOXXXXXXXXXXXXXXGOOOOOOOOXXXXXXXXXXX,0,600,0
42336,88,0,88,7,405,0,0,414,402,12,GOOXXXXXXXXXXXXXXXXXGOOOOOXXXXXXXXXXXXXXGOOOOOOOOOXXXXXXXXXXGOOOOOXXXXXXXXXXXXXXGOOXXXXXXXXXXXXXXXXXGOOOOOOXXXXXXXXXXXXXGOOOOOOXXXXXXXXXXXXXGOOOOOOOOOXXXXXXXXXXGOOOOOOOOOOOXXXXXXXXGOOXXXXXXXXXXXXXXXXXGOOOOOXXXXXXXXXXXXXXGOOOOOXXXXXXXXXXXXXXGOOOOOOOOXXXXXXXXXXX,0,600,0
42357,88,0,88,6,406,0,0,414,403,11,GOOXXXXXXXXXXXXXXXXXGOOOOOXXXXXXXXXXXXXXGOOOOOOOOOXXXXXXXXXXGOOOOOXXXXXXXXXXXXXXGOOXXXXXXXXXXXXXXXXXGOOOOOOXXXXXXXXXXXXXGOOOOOOXXXXXXXXXXXXXGOOOOOOOOOXXXXXXXXXXGOOOOOOOOOOOXXXXXXXXGOOXXXXXXXXXXXXXXXXXGOOOOOXXXXXXXXXXXXXXGOOOOOXXXXXXXXXXXXXXGOOOOOOOOXXXXXXXXXXX,0,600,0
42378,88,0,88,8,404,0,0,413,402,11,GOOXXXXXXXXXXXXXXXXXGOOOOOXXXXXXXXXXXXXXGOOOOOOOOOXXXXXXXXXXGOOOOOXXXXXXXXXXXXXXGOOXXXXXXXXXXXXXXXXXGOOOOOOXXXXXXXXXXXXXGOOOOOOXXXXXXXXXXXXXGOOOOOOOOOXXXXXXXXXXGOOOOOOOOOOOXXXXXXXXGOOXXXXXXXXXXXXXXXXXGOOOOOXXXXXXXXXXXXXXGOOOOOXXXXXXXXXXXXXXGOOOOOOOOXXXXXXXXXXX,0,600,0
42399,88,0,88,8,404,0,0,413,403,10,GOOXXXXXXXXXXXXXXXXXGOOOOOXXXXXXXXXXXXXXGOOOOOOOOOXXXXXXXXXXGOOOOOXXXXXXXXXXXXXXGOOXXXXXXXXXXXXXXXXXGOOOOOOXXXXXXXXXXXXXGOOOOOOXXXXXXXXXXXXXGOOOOOOOOOXXXXXXXXXXGOOOOOOOOOOOXXXXXXXXGOOXXXXXXXXXXXXXXXXXGOOOOOXXXXXXXXXXXXXXGOOOOOXXXXXXXXXXXXXXGOOOOOOOOXXXXXXXXXXX,0,600,0

42420,88,0,88,10,402,0,0,411,401,10,GOOXXXXXXXXXXXXXXXXXGOOOOOXXXXXXXXXXXXXXGOOOOOOOOOXXXXXXXXXXGOOOOOXXXXXXXXXXXXXXGOOXXXXXXXXXXXXXXXXXGOOOOOOXXXXXXXXXXXXXGOOOOOOXXXXXXXXXXXXXGOOOOOOOOOXXXXXXXXXXGOOOOOOOOOOOXXXXXXXXGOOXXXXXXXXXXXXXXXXXGOOOOOXXXXXXXXXXXXXXGOOOOOXXXXXXXXXXXXXXGOOOOOOOOXXXXXXXXXXX,0,600,0
42441,88,0,88,9,403,0,0,412,401,11,GOOXXXXXXXXXXXXXXXXXGOOOOOXXXXXXXXXXXXXXGOOOOOOOOOXXXXXXXXXXGOOOOOXXXXXXXXXXXXXXGOOXXXXXXXXXXXXXXXXXGOOOOOOXXXXXXXXXXXXXGOOOOOOXXXXXXXXXXXXXGOOOOOOOOOXXXXXXXXXXGOOOOOOOOOOOXXXXXXXXGOOXXXXXXXXXXXXXXXXXGOOOOOXXXXXXXXXXXXXXGOOOOOXXXXXXXXXXXXXXGOOOOOOOOXXXXXXXXXXX,0,600,0
42462,88,0,88,9,403,0,0,412,401,11,GOOXXXXXXXXXXXXXXXXXGOOOOOXXXXXXXXXXXXXXGOOOOOOOOOXXXXXXXXXXGOOOOOXXXXXXXXXXXXXXGOOXXXXXXXXXXXXXXXXXGOOOOOOXXXXXXXXXXXXXGOOOOOOXXXXXXXXXXXXXGOOOOOOOOOXXXXXXXXXXGOOOOOOOOOOOXXXXXXXXGOOXXXXXXXXXXXXXXXXXGOOOOOXXXXXXXXXXXXXXGOOOOOXXXXXXXXXXXXXXGOOOOOOOOXXXXXXXXXXX,0,600,0
42483,88,0,88,9,403,0,0,412,401,11,GOOXXXXXXXXXXXXXXXXXGOOOOOXXXXXXXXXXXXXXGOOOOOOOOOXXXXXXXXXXGOOOOOXXXXXXXXXXXXXXGOOXXXXXXXXXXXXXXXXXGOOOOOOXXXXXXXXXXXXXGOOOOOOXXXXXXXXXXXXXGOOOOOOOOOXXXXXXXXXXGOOOOOOOOOOOXXXXXXXXGOOXXXXXXXXXXXXXXXXXGOOOOOXXXXXXXXXXXXXXGOOOOOXXXXXXXXXXXXXXGOOOOOOOOXXXXXXXXXXX,0,600,0
42504,88,0,88,9,403,0,0,412,401,11,GOOXXXXXXXXXXXXXXXXXGOOOOOXXXXXXXXXXXXXXGOOOOOOOOOXXXXXXXXXXGOOOOOXXXXXXXXXXXXXXGOOXXXXXXXXXXXXXXXXXGOOOOOOXXXXXXXXXXXXXGOOOOOOXXXXXXXXXXXXXGOOOOOOOOOXXXXXXXXXXGOOOOOOOOOOOXXXXXXXXGOOXXXXXXXXXXXXXXXXXGOOOOOXXXXXXXXXXXXXXGOOOOOXXXXXXXXXXXXXXGOOOOOOOOXXXXXXXXXXX,0,600,0

42525,88,0,88,9,403,0,0,412,401,11,GOOXXXXXXXXXXXXXXXXXGOOOOOXXXXXXXXXXXXXXGOOOOOOOOOXXXXXXXXXXGOOOOOXXXXXXXXXXXXXXGOOXXXXXXXXXXXXXXXXXGOOOOOOXXXXXXXXXXXXXGOOOOOOXXXXXXXXXXXXXGOOOOOOOOOXXXXXXXXXXGOOOOOOOOOOOXXXXXXXXGOOXXXXXXXXXXXXXXXXXGOOOOOXXXXXXXXXXXXXXGOOOOOXXXXXXXXXXXXXXGOOOOOOOOXXXXXXXXXXX,0,600,0
42546,88,0,88,8,404,0,0,412,401,11,GOOXXXXXXXXXXXXXXXXXGOOOOOXXXXXXXXXXXXXXGOOOOOOOOOXXXXXXXXXXGOOOOOXXXXXXXXXXXXXXGOOXXXXXXXXXXXXXXXXXGOOOOOOXXXXXXXXXXXXXGOOOOOOXXXXXXXXXXXXXGOOOOOOOOOXXXXXXXXXXGOOOOOOOOOOOXXXXXXXXGOOXXXXXXXXXXXXXXXXXGOOOOOXXXXXXXXXXXXXXGOOOOOXXXXXXXXXXXXXXGOOOOOOOOXXXXXXXXXXX,0,600,0
42567,88,0,88,6,406,0,0,415,402,13,GOOXXXXXXXXXXXXXXXXXGOOOOOXXXXXXXXXXXXXXGOOOOOOOOOXXXXXXXXXXGOOOOOXXXXXXXXXXXXXXGOOXXXXXXXXXXXXXXXXXGOOOOOOXXXXXXXXXXXXXGOOOOOOXXXXXXXXXXXXXGOOOOOOOOOXXXXXXXXXXGOOOOOOOOOOOXXXXXXXXGOOXXXXXXXXXXXXXXXXXGOOOOOXXXXXXXXXXXXXXGOOOOOXXXXXXXXXXXXXXGOOOOOOOOXXXXXXXXXXX,0,600,0
42588,88,0,88,7,405,0,0,414,401,13,GOOXXXXXXXXXXXXXXXXXGOOOOOXXXXXXXXXXXXXXGOOOOOOOOOXXXXXXXXXXGOOOOOXXXXXXXXXXXXXXGOOXXXXXXXXXXXXXXXXXGOOOOOOXXXXXXXXXXXXXGOOOOOOXXXXXXXXXXXXXGOOOOOOOOOXXXXXXXXXXGOOOOOOOOOOOXXXXXXXXGOOXXXXXXXXXXXXXXXXXGOOOOOXXXXXXXXXXXXXXGOOOOOXXXXXXXXXXXXXXGOOOOOOOOXXXXXXXXXXX,0,600,0
42609,88,0,88,8,404,0,0,413,401,12,GOOXXXXXXXXXXXXXXXXXGOOOOOXXXXXXXXXXXXXXGOOOOOOOOOXXXXXXXXXXGOOOOOXXXXXXXXXXXXXXGOOXXXXXXXXXXXXXXXXXGOOOOOOXXXXXXXXXXXXXGOOOOOOXXXXXXXXXXXXXGOOOOOOOOOXXXXXXXXXXGOOOOOOOOOOOXXXXXXXXGOOXXXXXXXXXXXXXXXXXGOOOOOXXXXXXXXXXXXXXGOOOOOXXXXXXXXXXXXXXGOOOOOOOOXXXXXXXXXXX,0,600,0

42630,88,0,88,7,405,0,0,412,401,11,GOOXXXXXXXXXXXXXXXXXGOOOOOXXXXXXXXXXXXXXGOOOOOOOOOXXXXXXXXXXGOOOOOXXXXXXXXXXXXXXGOOXXXXXXXXXXXXXXXXXGOOOOOOXXXXXXXXXXXXXGOOOOOOXXXXXXXXXXXXXGOOOOOOOOOXXXXXXXXXXGOOOOOOOOOOOXXXXXXXXGOOXXXXXXXXXXXXXXXXXGOOOOOXXXXXXXXXXXXXXGOOOOOXXXXXXXXXXXXXXGOOOOOOOOXXXXXXXXXXX,0,600,0
42651,88,0,88,5,407,0,0,415,401,14,GOOXXXXXXXXXXXXXXXXXGOOOOOXXXXXXXXXXXXXXGOOOOOOOOOXXXXXXXXXXGOOOOOXXXXXXXXXXXXXXGOOXXXXXXXXXXXXXXXXXGOOOOOOXXXXXXXXXXXXXGOOOOOOXXXXXXXXXXXXXGOOOOOOOOOXXXXXXXXXXGOOOOOOOOOOOXXXXXXXXGOOXXXXXXXXXXXXXXXXXGOOOOOXXXXXXXXXXXXXXGOOOOOXXXXXXXXXXXXXXGOOOOOOOOXXXXXXXXXXX,0,600,0
42672,88,0,88,4,408,0,0,417,401,16,GOOXXXXXXXXXXXXXXXXXGOOOOOXXXXXXXXXXXXXXGOOOOOOOOOXXXXXXXXXXGOOOOOXXXXXXXXXXXXXXGOOXXXXXXXXXXXXXXXXXGOOOOOOXXXXXXXXXXXXXGOOOOOOXXXXXXXXXXXXXGOOOOOOOOOXXXXXXXXXXGOOOOOOOOOOOXXXXXXXXGOOXXXXXXXXXXXXXXXXXGOOOOOXXXXXXXXXXXXXXGOOOOOXXXXXXXXXXXXXXGOOOOOOOOXXXXXXXXXXX,0,600,0
42693,88,0,88,3,409,0,0,418,401,17,GOOXXXXXXXXXXXXXXXXXGOOOOOXXXXXXXXXXXXXXGOOOOOOOOOXXXXXXXXXXGOOOOOXXXXXXXXXXXXXXGOOXXXXXXXXXXXXXXXXXGOOOOOOXXXXXXXXXXXXXGOOOOOOXXXXXXXXXXXXXGOOOOOOOOOXXXXXXXXXXGOOOOOOOOOOOXXXXXXXXGOOXXXXXXXXXXXXXXXXXGOOOOOXXXXXXXXXXXXXXGOOOOOXXXXXXXXXXXXXXGOOOOOOOOXXXXXXXXXXX,0,600,0
42714,88,0,88,4,408,0,0,417,401,16,GOOXXXXXXXXXXXXXXXXXGOOOOOXXXXXXXXXXXXXXGOOOOOOOOOXXXXXXXXXXGOOOOOXXXXXXXXXXXXXXGOOXXXXXXXXXXXXXXXXXGOOOOOOXXXXXXXXXXXXXGOOOOOOXXXXXXXXXXXXXGOOOOOOOOOXXXXXXXXXXGOOOOOOOOOOOXXXXXXXXGOOXXXXXXXXXXXXXXXXXGOOOOOXXXXXXXXXXXXXXGOOOOOXXXXXXXXXXXXXXGOOOOOOOOXXXXXXXXXXX,0,600,0

42735,88,0,88,3,409,0,0,418,401,17,GOOXXXXXXXXXXXXXXXXXGOOOOOXXXXXXXXXXXXXXGOOOOOOOOOXXXXXXXXXXGOOOOOXXXXXXXXXXXXXXGOOXXXXXXXXXXXXXXXXXGOOOOOOXXXXXXXXXXXXXGOOOOOOXXXXXXXXXXXXXGOOOOOOOOOXXXXXXXXXXGOOOOOOOOOOOXXXXXXXXGOOXXXXXXXXXXXXXXXXXGOOOOOXXXXXXXXXXXXXXGOOOOOXXXXXXXXXXXXXXGOOOOOOOOXXXXXXXXXXX,0,600,0
42756,88,0,88,3,409,0,0,418,401,17,GOOXXXXXXXXXXXXXXXXXGOOOOOXXXXXXXXXXXXXXGOOOOOOOOOXXXXXXXXXXGOOOOOXXXXXXXXXXXXXXGOOXXXXXXXXXXXXXXXXXGOOOOOOXXXXXXXXXXXXXGOOOOOOXXXXXXXXXXXXXGOOOOOOOOOXXXXXXXXXXGOOOOOOOOOOOXXXXXXXXGOOXXXXXXXXXXXXXXXXXGOOOOOXXXXXXXXXXXXXXGOOOOOXXXXXXXXXXXXXXGOOOOOOOOXXXXXXXXXXX,0,600,0
42777,88,0,88,3,409,0,0,418,403,15,GOOXXXXXXXXXXXXXXXXXGOOOOOXXXXXXXXXXXXXXGOOOOOOOOOXXXXXXXXXXGOOOOOXXXXXXXXXXXXXXGOOXXXXXXXXXXXXXXXXXGOOOOOOXXXXXXXXXXXXXGOOOOOOXXXXXXXXXXXXXGOOOOOOOOOXXXXXXXXXXGOOOOOOOOOOOXXXXXXXXGOOXXXXXXXXXXXXXXXXXGOOOOOXXXXXXXXXXXXXXGOOOOOXXXXXXXXXXXXXXGOOOOOOOOXXXXXXXXXXX,0,600,0
42798,88,0,88,4,408,0,0,417,402,15,GOOXXXXXXXXXXXXXXXXXGOOOOOXXXXXXXXXXXXXXGOOOOOOOOOXXXXXXXXXXGOOOOOXXXXXXXXXXXXXXGOOXXXXXXXXXXXXXXXXXGOOOOOOXXXXXXXXXXXXXGOOOOOOXXXXXXXXXXXXXGOOOOOOOOOXXXXXXXXXXGOOOOOOOOOOOXXXXXXXXGOOXXXXXXXXXXXXXXXXXGOOOOOXXXXXXXXXXXXXXGOOOOOXXXXXXXXXXXXXXGOOOOOOOOXXXXXXXXXXX,0,600,0
42819,88,0,88,4,408,0,0,417,403,14,GOOXXXXXXXXXXXXXXXXXGOOOOOXXXXXXXXXXXXXXGOOOOOOOOOXXXXXXXXXXGOOOOOXXXXXXXXXXXXXXGOOXXXXXXXXXXXXXXXXXGOOOOOOXXXXXXXXXXXXXGOOOOOOXXXXXXXXXXXXXGOOOOOOOOOXXXXXXXXXXGOOOOOOOOOOOXXXXXXXXGOOXXXXXXXXXXXXXXXXXGOOOOOXXXXXXXXXXXXXXGOOOOOXXXXXXXXXXXXXXGOOOOOOOOXXXXXXXXXXX,0,600,0

42840,88,0,88,6,406,0,0,415,405,10,GOOXXXXXXXXXXXXXXXXXGOOOOOXXXXXXXXXXXXXXGOOOOOOOOOXXXXXXXXXXGOOOOOXXXXXXXXXXXXXXGOOXXXXXXXXXXXXXXXXXGOOOOOOXXXXXXXXXXXXXGOOOOOOXXXXXXXXXXXXXGOOOOOOOOOXXXXXXXXXXGOOOOOOOOOOOXXXXXXXXGOOXXXXXXXXXXXXXXXXXGOOOOOXXXXXXXXXXXXXXGOOOOOXXXXXXXXXXXXXXGOOOOOOOOXXXXXXXXXXX,0,600,0
42861,88,0,88,9,403,0,0,412,402,10,GOOXXXXXXXXXXXXXXXXXGOOOOOXXXXXXXXXXXXXXGOOOOOOOOOXXXXXXXXXXGOOOOOXXXXXXXXXXXXXXGOOXXXXXXXXXXXXXXXXXGOOOOOOXXXXXXXXXXXXXGOOOOOOXXXXXXXXXXXXXGOOOOOOOOOXXXXXXXXXXGOOOOOOOOOOOXXXXXXXXGOOXXXXXXXXXXXXXXXXXGOOOOOXXXXXXXXXXXXXXGOOOOOXXXXXXXXXXXXXXGOOOOOOOOXXXXXXXXXXX,0,600,0
42882,88,0,88,9,403,0,0,412,403,9,GOOXXXXXXXXXXXXXXXXXGOOOOOXXXXXXXXXXXXXXGOOOOOOOOOXXXXXXXXXXGOOOOOXXXXXXXXXXXXXXGOOXXXXXXXXXXXXXXXXXGOOOOOOXXXXXXXXXXXXXGOOOOOOXXXXXXXXXXXXXGOOOOOOOOOXXXXXXXXXXGOOOOOOOOOOOXXXXXXXXGOOXXXXXXXXXXXXXXXXXGOOOOOXXXXXXXXXXXXXXGOOOOOXXXXXXXXXXXXXXGOOOOOOOOXXXXXXXXXXX,0,600,0
42903,88,0,88,10,402,0,0,411,403,8,GOOXXXXXXXXXXXXXXXXXGOOOOOXXXXXXXXXXXXXXGOOOOOOOOOXXXXXXXXXXGOOOOOXXXXXXXXXXXXXXGOOXXXXXXXXXXXXXXXXXGOOOOOOXXXXXXXXXXXXXGOOOOOOXXXXXXXXXXXXXGOOOOOOOOOXXXXXXXXXXGOOOOOOOOOOOXXXXXXXXGOOXXXXXXXXXXXXXXXXXGOOOOOXXXXXXXXXXXXXXGOOOOOXXXXXXXXXXXXXXGOOOOOOOOXXXXXXXXXXX,0,600,0
42924,88,0,88,11,401,0,0,410,402,8,GOOXXXXXXXXXXXXXXXXXGOOOOOXXXXXXXXXXXXXXGOOOOOOOOOXXXXXXXXXXGOOOOOXXXXXXXXXXXXXXGOOXXXXXXXXXXXXXXXXXGOOOOOOXXXXXXXXXXXXXGOOOOOOXXXXXXXXXXXXXGOOOOOOOOOXXXXXXXXXXGOOOOOOOOOOOXXXXXXXXGOOXXXXXXXXXXXXXXXXXGOOOOOXXXXXXXXXXXXXXGOOOOOXXXXXXXXXXXXXXGOOOOOOOOXXXXXXXXXXX,0,600,0

42945,88,0,88,11,401,0,0,410,403,7,GOOXXXXXXXXXXXXXXXXXGOOOOOXXXXXXXXXXXXXXGOOOOOOOOOXXXXXXXXXXGOOOOOXXXXXXXXXXXXXXGOOXXXXXXXXXXXXXXXXXGOOOOOOXXXXXXXXXXXXXGOOOOOOXXXXXXXXXXXXXGOOOOOOOOOXXXXXXXXXXGOOOOOOOOOOOXXXXXXXXGOOXXXXXXXXXXXXXXXXXGOOOOOXXXXXXXXXXXXXXGOOOOOXXXXXXXXXXXXXXGOOOOOOOOXXXXXXXXXXX,0,600,0
42966,88,0,88,11,401,0,0,410,402,8,GOOXXXXXXXXXXXXXXXXXGOOOOOXXXXXXXXXXXXXXGOOOOOOOOOXXXXXXXXXXGOOOOOXXXXXXXXXXXXXXGOOXXXXXXXXXXXXXXXXXGOOOOOOXXXXXXXXXXXXXGOOOOOOXXXXXXXXXXXXXGOOOOOOOOOXXXXXXXXXXGOOOOOOOOOOOXXXXXXXXGOOXXXXXXXXXXXXXXXXXGOOOOOXXXXXXXXXXXXXXGOOOOOXXXXXXXXXXXXXXGOOOOOOOOXXXXXXXXXXX,0,600,0
42987,88,0,88,10,402,0,0,411,403,8,GOOXXXXXXXXXXXXXXXXXGOOOOOXXXXXXXXXXXXXXGOOOOOOOOOXXXXXXXXXXGOOOOOXXXXXXXXXXXXXXGOOXXXXXXXXXXXXXXXXXGOOOOOOXXXXXXXXXXXXXGOOOOOOXXXXXXXXXXXXXGOOOOOOOOOXXXXXXXXXXGOOOOOOOOOOOXXXXXXXXGOOXXXXXXXXXXXXXXXXXGOOOOOXXXXXXXXXXXXXXGOOOOOXXXXXXXXXXXXXXGOOOOOOOOXXXXXXXXXXX,0,600,0
43008,88,0,88,9,403,0,0,412,402,10,GOOXXXXXXXXXXXXXXXXXGOOOOOXXXXXXXXXXXXXXGOOOOOOOOOXXXXXXXXXXGOOOOOXXXXXXXXXXXXXXGOOXXXXXXXXXXXXXXXXXGOOOOOOXXXXXXXXXXXXXGOOOOOOXXXXXXXXXXXXXGOOOOOOOOOXXXXXXXXXXGOOOOOOOOOOOXXXXXXXXGOOXXXXXXXXXXXXXXXXXGOOOOOXXXXXXXXXXXXXXGOOOOOXXXXXXXXXXXXXXGOOOOOOOOXXXXXXXXXXX,0,600,0
43029,88,0,88,8,404,0,0,413,402,11,GOOXXXXXXXXXXXXXXXXXGOOOOOXXXXXXXXXXXXXXGOOOOOOOOOXXXXXXXXXXGOOOOOXXXXXXXXXXXXXXGOOXXXXXXXXXXXXXXXXXGOOOOOOXXXXXXXXXXXXXGOOOOOOXXXXXXXXXXXXXGOOOOOOOOOXXXXXXXXXXGOOOOOOOOOOOXXXXXXXXGOOXXXXXXXXXXXXXXXXXGOOOOOXXXXXXXXXXXXXXGOOOOOXXXXXXXXXXXXXXGOOOOOOOOXXXXXXXXXXX,0,600,0

43050,88,0,88,6,406,0,0,415,402,13,GOOXXXXXXXXXXXXXXXXXGOOOOOXXXXXXXXXXXXXXGOOOOOOOOOXXXXXXXXXXGOOOOOXXXXXXXXXXXXXXGOOXXXXXXXXXXXXXXXXXGOOOOOOXXXXXXXXXXXXXGOOOOOOXXXXXXXXXXXXXGOOOOOOOOOXXXXXXXXXXGOOOOOOOOOOOXXXXXXXXGOOXXXXXXXXXXXXXXXXXGOOOOOXXXXXXXXXXXXXXGOOOOOXXXXXXXXXXXXXXGOOOOOOOOXXXXXXXXXXX,0,600,0
43071,88,0,88,6,406,0,0,415,402,13,GOOXXXXXXXXXXXXXXXXXGOOOOOXXXXXXXXXXXXXXGOOOOOOOOOXXXXXXXXXXGOOOOOXXXXXXXXXXXXXXGOOXXXXXXXXXXXXXXXXXGOOOOOOXXXXXXXXXXXXXGOOOOOOXXXXXXXXXXXXXGOOOOOOOOOXXXXXXXXXXGOOOOOOOOOOOXXXXXXXXGOOXXXXXXXXXXXXXXXXXGOOOOOXXXXXXXXXXXXXXGOOOOOXXXXXXXXXXXXXXGOOOOOOOOXXXXXXXXXXX,0,600,0
43092,88,0,88,5,407,0,0,416,402,14,GOOXXXXXXXXXXXXXXXXXGOOOOOXXXXXXXXXXXXXXGOOOOOOOOOXXXXXXXXXXGOOOOOXXXXXXXXXXXXXXGOOXXXXXXXXXXXXXXXXXGOOOOOOXXXXXXXXXXXXXGOOOOOOXXXXXXXXXXXXXGOOOOOOOOOXXXXXXXXXXGOOOOOOOOOOOXXXXXXXXGOOXXXXXXXXXXXXXXXXXGOOOOOXXXXXXXXXXXXXXGOOOOOXXXXXXXXXXXXXXGOOOOOOOOXXXXXXXXXXX,0,600,0
43113,88,0,88,5,407,0,0,416,402,14,GOOXXXXXXXXXXXXXXXXXGOOOOOXXXXXXXXXXXXXXGOOOOOOOOOXXXXXXXXXXGOOOOOXXXXXXXXXXXXXXGOOXXXXXXXXXXXXXXXXXGOOOOOOXXXXXXXXXXXXXGOOOOOOXXXXXXXXXXXXXGOOOOOOOOOXXXXXXXXXXGOOOOOOOOOOOXXXXXXXXGOOXXXXXXXXXXXXXXXXXGOOOOOXXXXXXXXXXXXXXGOOOOOXXXXXXXXXXXXXXGOOOOOOOOXXXXXXXXXXX,0,600,0
43134,88,0,88,5,407,0,0,416,402,14,GOOXXXXXXXXXXXXXXXXXGOOOOOXXXXXXXXXXXXXXGOOOOOOOOOXXXXXXXXXXGOOOOOXXXXXXXXXXXXXXGOOXXXXXXXXXXXXXXXXXGOOOOOOXXXXXXXXXXXXXGOOOOOOXXXXXXXXXXXXXGOOOOOOOOOXXXXXXXXXXGOOOOOOOOOOOXXXXXXXXGOOXXXXXXXXXXXXXXXXXGOOOOOXXXXXXXXXXXXXXGOOOOOXXXXXXXXXXXXXXGOOOOOOOOXXXXXXXXXXX,0,600,0

43155,88,0,88,4,408,0,0,417,402,15,GOOXXXXXXXXXXXXXXXXXGOOOOOXXXXXXXXXXXXXXGOOOOOOOOOXXXXXXXXXXGOOOOOXXXXXXXXXXXXXXGOOXXXXXXXXXXXXXXXXXGOOOOOOXXXXXXXXXXXXXGOOOOOOXXXXXXXXXXXXXGOOOOOOOOOXXXXXXXXXXGOOOOOOOOOOOXXXXXXXXGOOXXXXXXXXXXXXXXXXXGOOOOOXXXXXXXXXXXXXXGOOOOOXXXXXXXXXXXXXXGOOOOOOOOXXXXXXXXXXX,0,600,0
43176,88,0,88,4,408,0,0,417,403,14,GOOXXXXXXXXXXXXXXXXXGOOOOOXXXXXXXXXXXXXXGOOOOOOOOOXXXXXXXXXXGOOOOOXXXXXXXXXXXXXXGOOXXXXXXXXXXXXXXXXXGOOOOOOXXXXXXXXXXXXXGOOOOOOXXXXXXXXXXXXXGOOOOOOOOOXXXXXXXXXXGOOOOOOOOOOOXXXXXXXXGOOXXXXXXXXXXXXXXXXXGOOOOOXXXXXXXXXXXXXXGOOOOOXXXXXXXXXXXXXXGOOOOOOOOXXXXXXXXXXX,0,600,0
43197,88,0,88,5,407,0,0,416,402,14,GOOXXXXXXXXXXXXXXXXXGOOOOOXXXXXXXXXXXXXXGOOOOOOOOOXXXXXXXXXXGOOOOOXXXXXXXXXXXXXXGOOXXXXXXXXXXXXXXXXXGOOOOOOXXXXXXXXXXXXXGOOOOOOXXXXXXXXXXXXXGOOOOOOOOOXXXXXXXXXXGOOOOOOOOOOOXXXXXXXXGOOXXXXXXXXXXXXXXXXXGOOOOOXXXXXXXXXXXXXXGOOOOOXXXXXXXXXXXXXXGOOOOOOOOXXXXXXXXXXX,0,600,0
43218,88,0,88,5,407,0,0,416,403,13,GOOXXXXXXXXXXXXXXXXXGOOOOOXXXXXXXXXXXXXXGOOOOOOOOOXXXXXXXXXXGOOOOOXXXXXXXXXXXXXXGOOXXXXXXXXXXXXXXXXXGOOOOOOXXXXXXXXXXXXXGOOOOOOXXXXXXXXXXXXXGOOOOOOOOOXXXXXXXXXXGOOOOOOOOOOOXXXXXXXXGOOXXXXXXXXXXXXXXXXXGOOOOOXXXXXXXXXXXXXXGOOOOOXXXXXXXXXXXXXXGOOOOOOOOXXXXXXXXXXX,0,600,0
43239,88,0,88,4,408,0,0,417,403,14,GOOXXXXXXXXXXXXXXXXXGOOOOOXXXXXXXXXXXXXXGOOOOOOOOOXXXXXXXXXXGOOOOOXXXXXXXXXXXXXXGOOXXXXXXXXXXXXXXXXXGOOOOOOXXXXXXXXXXXXXGOOOOOOXXXXXXXXXXXXXGOOOOOOOOOXXXXXXXXXXGOOOOOOOOOOOXXXXXXXXGOOXXXXXXXXXXXXXXXXXGOOOOOXXXXXXXXXXXXXXGOOOOOXXXXXXXXXXXXXXGOOOOOOOOXXXXXXXXXXX,0,600,0

43260,88,0,88,4,408,0,0,417,403,14,GOOXXXXXXXXXXXXXXXXXGOOOOOXXXXXXXXXXXXXXGOOOOOOOOOXXXXXXXXXXGOOOOOXXXXXXXXXXXXXXGOOXXXXXXXXXXXXXXXXXGOOOOOOXXXXXXXXXXXXXGOOOOOOXXXXXXXXXXXXXGOOOOOOOOOXXXXXXXXXXGOOOOOOOOOOOXXXXXXXXGOOXXXXXXXXXXXXXXXXXGOOOOOXXXXXXXXXXXXXXGOOOOOXXXXXXXXXXXXXXGOOOOOOOOXXXXXXXXXXX,0,600,0
43281,88,0,88,4,408,0,0,417,402,15,GOOXXXXXXXXXXXXXXXXXGOOOOOXXXXXXXXXXXXXXGOOOOOOOOOXXXXXXXXXXGOOOOOXXXXXXXXXXXXXXGOOXXXXXXXXXXXXXXXXXGOOOOOOXXXXXXXXXXXXXGOOOOOOXXXXXXXXXXXXXGOOOOOOOOOXXXXXXXXXXGOOOOOOOOOOOXXXXXXXXGOOXXXXXXXXXXXXXXXXXGOOOOOXXXXXXXXXXXXXXGOOOOOXXXXXXXXXXXXXXGOOOOOOOOXXXXXXXXXXX,0,600,0
43302,88,0,88,5,407,0,0,416,402,14,GOOXXXXXXXXXXXXXXXXXGOOOOOXXXXXXXXXXXXXXGOOOOOOOOOXXXXXXXXXXGOOOOOXXXXXXXXXXXXXXGOOXXXXXXXXXXXXXXXXXGOOOOOOXXXXXXXXXXXXXGOOOOOOXXXXXXXXXXXXXGOOOOOOOOOXXXXXXXXXXGOOOOOOOOOOOXXXXXXXXGOOXXXXXXXXXXXXXXXXXGOOOOOXXXXXXXXXXXXXXGOOOOOXXXXXXXXXXXXXXGOOOOOOOOXXXXXXXXXXX,0,600,0
43323,88,0,88,8,404,0,0,413,402,11,GOOXXXXXXXXXXXXXXXXXGOOOOOXXXXXXXXXXXXXXGOOOOOOOOOXXXXXXXXXXGOOOOOXXXXXXXXXXXXXXGOOXXXXXXXXXXXXXXXXXGOOOOOOXXXXXXXXXXXXXGOOOOOOXXXXXXXXXXXXXGOOOOOOOOOXXXXXXXXXXGOOOOOOOOOOOXXXXXXXXGOOXXXXXXXXXXXXXXXXXGOOOOOXXXXXXXXXXXXXXGOOOOOXXXXXXXXXXXXXXGOOOOOOOOXXXXXXXXXXX,0,600,0
43344,88,0,88,9,403,0,0,412,402,10,GOOXXXXXXXXXXXXXXXXXGOOOOOXXXXXXXXXXXXXXGOOOOOOOOOXXXXXXXXXXGOOOOOXXXXXXXXXXXXXXGOOXXXXXXXXXXXXXXXXXGOOOOOOXXXXXXXXXXXXXGOOOOOOXXXXXXXXXXXXXGOOOOOOOOOXXXXXXXXXXGOOOOOOOOOOOXXXXXXXXGOOXXXXXXXXXXXXXXXXXGOOOOOXXXXXXXXXXXXXXGOOOOOXXXXXXXXXXXXXXGOOOOOOOOXXXXXXXXXXX,0,600,0

43365,88,0,88,10,402,0,0,411,401,10,GOOXXXXXXXXXXXXXXXXXGOOOOOXXXXXXXXXXXXXXGOOOOOOOOOXXXXXXXXXXGOOOOOXXXXXXXXXXXXXXGOOXXXXXXXXXXXXXXXXXGOOOOOOXXXXXXXXXXXXXGOOOOOOXXXXXXXXXXXXXGOOOOOOOOOXXXXXXXXXXGOOOOOOOOOOOXXXXXXXXGOOXXXXXXXXXXXXXXXXXGOOOOOXXXXXXXXXXXXXXGOOOOOXXXXXXXXXXXXXXGOOOOOOOOXXXXXXXXXXX,0,600,0
43386,88,0,88,9,403,0,0,412,401,11,GOOXXXXXXXXXXXXXXXXXGOOOOOXXXXXXXXXXXXXXGOOOOOOOOOXXXXXXXXXXGOOOOOXXXXXXXXXXXXXXGOOXXXXXXXXXXXXXXXXXGOOOOOOXXXXXXXXXXXXXGOOOOOOXXXXXXXXXXXXXGOOOOOOOOOXXXXXXXXXXGOOOOOOOOOOOXXXXXXXXGOOXXXXXXXXXXXXXXXXXGOOOOOXXXXXXXXXXXXXXGOOOOOXXXXXXXXXXXXXXGOOOOOOOOXXXXXXXXXXX,0,600,0
43407,88,0,88,9,403,0,0,412,401,11,GOOXXXXXXXXXXXXXXXXXGOOOOOXXXXXXXXXXXXXXGOOOOOOOOOXXXXXXXXXXGOOOOOXXXXXXXXXXXXXXGOOXXXXXXXXXXXXXXXXXGOOOOOOXXXXXXXXXXXXXGOOOOOOXXXXXXXXXXXXXGOOOOOOOOOXXXXXXXXXXGOOOOOOOOOOOXXXXXXXXGOOXXXXXXXXXXXXXXXXXGOOOOOXXXXXXXXXXXXXXGOOOOOXXXXXXXXXXXXXXGOOOOOOOOXXXXXXXXXXX,0,600,0
43428,88,0,88,10,402,0,0,411,401,10,GOOXXXXXXXXXXXXXXXXXGOOOOOXXXXXXXXXXXXXXGOOOOOOOOOXXXXXXXXXXGOOOOOXXXXXXXXXXXXXXGOOXXXXXXXXXXXXXXXXXGOOOOOOXXXXXXXXXXXXXGOOOOOOXXXXXXXXXXXXXGOOOOOOOOOXXXXXXXXXXGOOOOOOOOOOOXXXXXXXXGOOXXXXXXXXXXXXXXXXXGOOOOOXXXXXXXXXXXXXXGOOOOOXXXXXXXXXXXXXXGOOOOOOOOXXXXXXXXXXX,0,600,0
43449,88,0,88,9,403,0,0,412,401,11,GOOXXXXXXXXXXXXXXXXXGOOOOOXXXXXXXXXXXXXXGOOOOOOOOOXXXXXXXXXXGOOOOOXXXXXXXXXXXXXXGOOXXXXXXXXXXXXXXXXXGOOOOOOXXXXXXXXXXXXXGOOOOOOXXXXXXXXXXXXXGOOOOOOOOOXXXXXXXXXXGOOOOOOOOOOOXXXXXXXXGOOXXXXXXXXXXXXXXXXXGOOOOOXXXXXXXXXXXXXXGOOOOOXXXXXXXXXXXXXXGOOOOOOOOXXXXXXXXXXX,0,600,0

43470,88,0,88,9,403,0,0,412,401,11,GOOXXXXXXXXXXXXXXXXXGOOOOOXXXXXXXXXXXXXXGOOOOOOOOOXXXXXXXXXXGOOOOOXXXXXXXXXXXXXXGOOXXXXXXXXXXXXXXXXXGOOOOOOXXXXXXXXXXXXXGOOOOOOXXXXXXXXXXXXXGOOOOOOOOOXXXXXXXXXXGOOOOOOOOOOOXXXXXXXXGOOXXXXXXXXXXXXXXXXXGOOOOOXXXXXXXXXXXXXXGOOOOOXXXXXXXXXXXXXXGOOOOOOOOXXXXXXXXXXX,0,600,0
43491,88,0,88,9,403,0,0,412,401,11,GOOXXXXXXXXXXXXXXXXXGOOOOOXXXXXXXXXXXXXXGOOOOOOOOOXXXXXXXXXXGOOOOOXXXXXXXXXXXXXXGOOXXXXXXXXXXXXXXXXXGOOOOOOXXXXXXXXXXXXXGOOOOOOXXXXXXXXXXXXXGOOOOOOOOOXXXXXXXXXXGOOOOOOOOOOOXXXXXXXXGOOXXXXXXXXXXXXXXXXXGOOOOOXXXXXXXXXXXXXXGOOOOOXXXXXXXXXXXXXXGOOOOOOOOXXXXXXXXXXX,0,600,0
43512,88,0,88,7,405,0,0,414,400,14,GOOXXXXXXXXXXXXXXXXXGOOOOOXXXXXXXXXXXXXXGOOOOOOOOOXXXXXXXXXXGOOOOOXXXXXXXXXXXXXXGOOXXXXXXXXXXXXXXXXXGOOOOOOXXXXXXXXXXXXXGOOOOOOXXXXXXXXXXXXXGOOOOOOOOOXXXXXXXXXXGOOOOOOOOOOOXXXXXXXXGOOXXXXXXXXXXXXXXXXXGOOOOOXXXXXXXXXXXXXXGOOOOOXXXXXXXXXXXXXXGOOOOOOOOXXXXXXXXXXX,0,600,0
43533,88,0,88,8,404,0,0,413,400,13,GOOXXXXXXXXXXXXXXXXXGOOOOOXXXXXXXXXXXXXXGOOOOOOOOOXXXXXXXXXXGOOOOOXXXXXXXXXXXXXXGOOXXXXXXXXXXXXXXXXXGOOOOOOXXXXXXXXXXXXXGOOOOOOXXXXXXXXXXXXXGOOOOOOOOOXXXXXXXXXXGOOOOOOOOOOOXXXXXXXXGOOXXXXXXXXXXXXXXXXXGOOOOOXXXXXXXXXXXXXXGOOOOOXXXXXXXXXXXXXXGOOOOOOOOXXXXXXXXXXX,0,600,0
43554,88,0,88,8,404,0,0,413,400,13,GOOXXXXXXXXXXXXXXXXXGOOOOOXXXXXXXXXXXXXXGOOOOOOOOOXXXXXXXXXXGOOOOOXXXXXXXXXXXXXXGOOXXXXXXXXXXXXXXXXXGOOOOOOXXXXXXXXXXXXXGOOOOOOXXXXXXXXXXXXXGOOOOOOOOOXXXXXXXXXXGOOOOOOOOOOOXXXXXXXXGOOXXXXXXXXXXXXXXXXXGOOOOOXXXXXXXXXXXXXXGOOOOOXXXXXXXXXXXXXXGOOOOOOOOXXXXXXXXXXX,0,600,0

43575,88,0,88,8,404,0,0,413,400,13,GOOXXXXXXXXXXXXXXXXXGOOOOOXXXXXXXXXXXXXXGOOOOOOOOOXXXXXXXXXXGOOOOOXXXXXXXXXXXXXXGOOXXXXXXXXXXXXXXXXXGOOOOOOXXXXXXXXXXXXXGOOOOOOXXXXXXXXXXXXXGOOOOOOOOOXXXXXXXXXXGOOOOOOOOOOOXXXXXXXXGOOXXXXXXXXXXXXXXXXXGOOOOOXXXXXXXXXXXXXXGOOOOOXXXXXXXXXXXXXXGOOOOOOOOXXXXXXXXXXX,0,600,0
43596,88,0,88,5,407,0,0,415,400,15,GOOXXXXXXXXXXXXXXXXXGOOOOOXXXXXXXXXXXXXXGOOOOOOOOOXXXXXXXXXXGOOOOOXXXXXXXXXXXXXXGOOXXXXXXXXXXXXXXXXXGOOOOOOXXXXXXXXXXXXXGOOOOOOXXXXXXXXXXXXXGOOOOOOOOOXXXXXXXXXXGOOOOOOOOOOOXXXXXXXXGOOXXXXXXXXXXXXXXXXXGOOOOOXXXXXXXXXXXXXXGOOOOOXXXXXXXXXXXXXXGOOOOOOOOXXXXXXXXXXX,0,600,0
43617,88,0,88,3,409,0,0,418,400,18,GOOXXXXXXXXXXXXXXXXXGOOOOOXXXXXXXXXXXXXXGOOOOOOOOOXXXXXXXXXXGOOOOOXXXXXXXXXXXXXXGOOXXXXXXXXXXXXXXXXXGOOOOOOXXXXXXXXXXXXXGOOOOOOXXXXXXXXXXXXXGOOOOOOOOOXXXXXXXXXXGOOOOOOOOOOOXXXXXXXXGOOXXXXXXXXXXXXXXXXXGOOOOOXXXXXXXXXXXXXXGOOOOOXXXXXXXXXXXXXXGOOOOOOOOXXXXXXXXXXX,0,600,0
43638,88,0,88,3,409,0,0,418,401,17,GOOXXXXXXXXXXXXXXXXXGOOOOOXXXXXXXXXXXXXXGOOOOOOOOOXXXXXXXXXXGOOOOOXXXXXXXXXXXXXXGOOXXXXXXXXXXXXXXXXXGOOOOOOXXXXXXXXXXXXXGOOOOOOXXXXXXXXXXXXXGOOOOOOOOOXXXXXXXXXXGOOOOOOOOOOOXXXXXXXXGOOXXXXXXXXXXXXXXXXXGOOOOOXXXXXXXXXXXXXXGOOOOOXXXXXXXXXXXXXXGOOOOOOOOXXXXXXXXXXX,0,600,0
43659,88,0,88,4,408,0,0,417,401,16,GOOXXXXXXXXXXXXXXXXXGOOOOOXXXXXXXXXXXXXXGOOOOOOOOOXXXXXXXXXXGOOOOOXXXXXXXXXXXXXXGOOXXXXXXXXXXXXXXXXXGOOOOOOXXXXXXXXXXXXXGOOOOOOXXXXXXXXXXXXXGOOOOOOOOOXXXXXXXXXXGOOOOOOOOOOOXXXXXXXXGOOXXXXXXXXXXXXXXXXXGOOOOOXXXXXXXXXXXXXXGOOOOOXXXXXXXXXXXXXXGOOOOOOOOXXXXXXXXXXX,0,600,0

43680,88,0,88,3,409,0,0,418,401,17,GOOXXXXXXXXXXXXXXXXXGOOOOOXXXXXXXXXXXXXXGOOOOOOOOOXXXXXXXXXXGOOOOOXXXXXXXXXXXXXXGOOXXXXXXXXXXXXXXXXXGOOOOOOXXXXXXXXXXXXXGOOOOOOXXXXXXXXXXXXXGOOOOOOOOOXXXXXXXXXXGOOOOOOOOOOOXXXXXXXXGOOXXXXXXXXXXXXXXXXXGOOOOOXXXXXXXXXXXXXXGOOOOOXXXXXXXXXXXXXXGOOOOOOOOXXXXXXXXXXX,0,600,0
43701,88,0,88,3,409,0,0,418,402,16,GOOXXXXXXXXXXXXXXXXXGOOOOOXXXXXXXXXXXXXXGOOOOOOOOOXXXXXXXXXXGOOOOOXXXXXXXXXXXXXXGOOXXXXXXXXXXXXXXXXXGOOOOOOXXXXXXXXXXXXXGOOOOOOXXXXXXXXXXXXXGOOOOOOOOOXXXXXXXXXXGOOOOOOOOOOOXXXXXXXXGOOXXXXXXXXXXXXXXXXXGOOOOOXXXXXXXXXXXXXXGOOOOOXXXXXXXXXXXXXXGOOOOOOOOXXXXXXXXXXX,0,600,0
43722,88,0,88,5,407,0,0,416,402,14,GOOXXXXXXXXXXXXXXXXXGOOOOOXXXXXXXXXXXXXXGOOOOOOOOOXXXXXXXXXXGOOOOOXXXXXXXXXXXXXXGOOXXXXXXXXXXXXXXXXXGOOOOOOXXXXXXXXXXXXXGOOOOOOXXXXXXXXXXXXXGOOOOOOOOOXXXXXXXXXXGOOOOOOOOOOOXXXXXXXXGOOXXXXXXXXXXXXXXXXXGOOOOOXXXXXXXXXXXXXXGOOOOOXXXXXXXXXXXXXXGOOOOOOOOXXXXXXXXXXX,0,600,0
43743,88,0,88,7,405,0,0,414,401,13,GOOXXXXXXXXXXXXXXXXXGOOOOOXXXXXXXXXXXXXXGOOOOOOOOOXXXXXXXXXXGOOOOOXXXXXXXXXXXXXXGOOXXXXXXXXXXXXXXXXXGOOOOOOXXXXXXXXXXXXXGOOOOOOXXXXXXXXXXXXXGOOOOOOOOOXXXXXXXXXXGOOOOOOOOOOOXXXXXXXXGOOXXXXXXXXXXXXXXXXXGOOOOOXXXXXXXXXXXXXXGOOOOOXXXXXXXXXXXXXXGOOOOOOOOXXXXXXXXXXX,0,600,0
43764,88,0,88,6,406,0,0,415,401,14,GOOXXXXXXXXXXXXXXXXXGOOOOOXXXXXXXXXXXXXXGOOOOOOOOOXXXXXXXXXXGOOOOOXXXXXXXXXXXXXXGOOXXXXXXXXXXXXXXXXXGOOOOOOXXXXXXXXXXXXXGOOOOOOXXXXXXXXXXXXXGOOOOOOOOOXXXXXXXXXXGOOOOOOOOOOOXXXXXXXXGOOXXXXXXXXXXXXXXXXXGOOOOOXXXXXXXXXXXXXXGOOOOOXXXXXXXXXXXXXXGOOOOOOOOXXXXXXXXXXX,0,600,0

43785,88,0,88,4,408,0,0,417,404,13,GOOXXXXXXXXXXXXXXXXXGOOOOOXXXXXXXXXXXXXXGOOOOOOOOOXXXXXXXXXXGOOOOOXXXXXXXXXXXXXXGOOXXXXXXXXXXXXXXXXXGOOOOOOXXXXXXXXXXXXXGOOOOOOXXXXXXXXXXXXXGOOOOOOOOOXXXXXXXXXXGOOOOOOOOOOOXXXXXXXXGOOXXXXXXXXXXXXXXXXXGOOOOOXXXXXXXXXXXXXXGOOOOOXXXXXXXXXXXXXXGOOOOOOOOXXXXXXXXXXX,0,600,0
43806,88,0,88,7,405,0,0,414,402,12,GOOXXXXXXXXXXXXXXXXXGOOOOOXXXXXXXXXXXXXXGOOOOOOOOOXXXXXXXXXXGOOOOOXXXXXXXXXXXXXXGOOXXXXXXXXXXXXXXXXXGOOOOOOXXXXXXXXXXXXXGOOOOOOXXXXXXXXXXXXXGOOOOOOOOOXXXXXXXXXXGOOOOOOOOOOOXXXXXXXXGOOXXXXXXXXXXXXXXXXXGOOOOOXXXXXXXXXXXXXXGOOOOOXXXXXXXXXXXXXXGOOOOOOOOXXXXXXXXXXX,0,600,0
43827,88,0,88,8,404,0,0,413,401,12,GOOXXXXXXXXXXXXXXXXXGOOOOOXXXXXXXXXXXXXXGOOOOOOOOOXXXXXXXXXXGOOOOOXXXXXXXXXXXXXXGOOXXXXXXXXXXXXXXXXXGOOOOOOXXXXXXXXXXXXXGOOOOOOXXXXXXXXXXXXXGOOOOOOOOOXXXXXXXXXXGOOOOOOOOOOOXXXXXXXXGOOXXXXXXXXXXXXXXXXXGOOOOOXXXXXXXXXXXXXXGOOOOOXXXXXXXXXXXXXXGOOOOOOOOXXXXXXXXXXX,0,600,0
43848,88,0,88,8,404,0,0,413,401,12,GOOXXXXXXXXXXXXXXXXXGOOOOOXXXXXXXXXXXXXXGOOOOOOOOOXXXXXXXXXXGOOOOOXXXXXXXXXXXXXXGOOXXXXXXXXXXXXXXXXXGOOOOOOXXXXXXXXXXXXXGOOOOOOXXXXXXXXXXXXXGOOOOOOOOOXXXXXXXXXXGOOOOOOOOOOOXXXXXXXXGOOXXXXXXXXXXXXXXXXXGOOOOOXXXXXXXXXXXXXXGOOOOOXXXXXXXXXXXXXXGOOOOOOOOXXXXXXXXXXX,0,600,0
43869,88,0,88,7,405,0,0,414,401,13,GOOXXXXXXXXXXXXXXXXXGOOOOOXXXXXXXXXXXXXXGOOOOOOOOOXXXXXXXXXXGOOOOOXXXXXXXXXXXXXXGOOXXXXXXXXXXXXXXXXXGOOOOOOXXXXXXXXXXXXXGOOOOOOXXXXXXXXXXXXXGOOOOOOOOOXXXXXXXXXXGOOOOOOOOOOOXXXXXXXXGOOXXXXXXXXXXXXXXXXXGOOOOOXXXXXXXXXXXXXXGOOOOOXXXXXXXXXXXXXXGOOOOOOOOXXXXXXXXXXX,0,600,0

43890,88,0,88,8,404,0,0,413,401,12,GOOXXXXXXXXXXXXXXXXXGOOOOOXXXXXXXXXXXXXXGOOOOOOOOOXXXXXXXXXXGOOOOOXXXXXXXXXXXXXXGOOXXXXXXXXXXXXXXXXXGOOOOOOXXXXXXXXXXXXXGOOOOOOXXXXXXXXXXXXXGOOOOOOOOOXXXXXXXXXXGOOOOOOOOOOOXXXXXXXXGOOXXXXXXXXXXXXXXXXXGOOOOOXXXXXXXXXXXXXXGOOOOOXXXXXXXXXXXXXXGOOOOOOOOXXXXXXXXXXX,0,600,0
43911,88,0,88,8,404,0,0,413,402,11,GOOXXXXXXXXXXXXXXXXXGOOOOOXXXXXXXXXXXXXXGOOOOOOOOOXXXXXXXXXXGOOOOOXXXXXXXXXXXXXXGOOXXXXXXXXXXXXXXXXXGOOOOOOXXXXXXXXXXXXXGOOOOOOXXXXXXXXXXXXXGOOOOOOOOOXXXXXXXXXXGOOOOOOOOOOOXXXXXXXXGOOXXXXXXXXXXXXXXXXXGOOOOOXXXXXXXXXXXXXXGOOOOOXXXXXXXXXXXXXXGOOOOOOOOXXXXXXXXXXX,0,600,0
43932,88,0,88,10,402,0,0,411,401,10,GOOXXXXXXXXXXXXXXXXXGOOOOOXXXXXXXXXXXXXXGOOOOOOOOOXXXXXXXXXXGOOOOOXXXXXXXXXXXXXXGOOXXXXXXXXXXXXXXXXXGOOOOOOXXXXXXXXXXXXXGOOOOOOXXXXXXXXXXXXXGOOOOOOOOOXXXXXXXXXXGOOOOOOOOOOOXXXXXXXXGOOXXXXXXXXXXXXXXXXXGOOOOOXXXXXXXXXXXXXXGOOOOOXXXXXXXXXXXXXXGOOOOOOOOXXXXXXXXXXX,0,600,0
43953,88,0,88,11,401,0,0,410,401,9,GOOXXXXXXXXXXXXXXXXXGOOOOOXXXXXXXXXXXXXXGOOOOOOOOOXXXXXXXXXXGOOOOOXXXXXXXXXXXXXXGOOXXXXXXXXXXXXXXXXXGOOOOOOXXXXXXXXXXXXXGOOOOOOXXXXXXXXXXXXXGOOOOOOOOOXXXXXXXXXXGOOOOOOOOOOOXXXXXXXXGOOXXXXXXXXXXXXXXXXXGOOOOOXXXXXXXXXXXXXXGOOOOOXXXXXXXXXXXXXXGOOOOOOOOXXXXXXXXXXX,0,600,0
43974,88,0,88,9,403,0,0,412,402,10,GOOXXXXXXXXXXXXXXXXXGOOOOOXXXXXXXXXXXXXXGOOOOOOOOOXXXXXXXXXXGOOOOOXXXXXXXXXXXXXXGOOXXXXXXXXXXXXXXXXXGOOOOOOXXXXXXXXXXXXXGOOOOOOXXXXXXXXXXXXXGOOOOOOOOOXXXXXXXXXXGOOOOOOOOOOOXXXXXXXXGOOXXXXXXXXXXXXXXXXXGOOOOOXXXXXXXXXXXXXXGOOOOOXXXXXXXXXXXXXXGOOOOOOOOXXXXXXXXXXX,0,600,0

43995,88,0,88,8,404,0,0,413,402,11,GOOXXXXXXXXXXXXXXXXXGOOOOOXXXXXXXXXXXXXXGOOOOOOOOOXXXXXXXXXXGOOOOOXXXXXXXXXXXXXXGOOXXXXXXXXXXXXXXXXXGOOOOOOXXXXXXXXXXXXXGOOOOOOXXXXXXXXXXXXXGOOOOOOOOOXXXXXXXXXXGOOOOOOOOOOOXXXXXXXXGOOXXXXXXXXXXXXXXXXXGOOOOOXXXXXXXXXXXXXXGOOOOOXXXXXXXXXXXXXXGOOOOOOOOXXXXXXXXXXX,0,600,0
44016,88,0,88,7,405,0,0,414,402,12,GOOXXXXXXXXXXXXXXXXXGOOOOOXXXXXXXXXXXXXXGOOOOOOOOOXXXXXXXXXXGOOOOOXXXXXXXXXXXXXXGOOXXXXXXXXXXXXXXXXXGOOOOOOXXXXXXXXXXXXXGOOOOOOXXXXXXXXXXXXXGOOOOOOOOOXXXXXXXXXXGOOOOOOOOOOOXXXXXXXXGOOXXXXXXXXXXXXXXXXXGOOOOOXXXXXXXXXXXXXXGOOOOOXXXXXXXXXXXXXXGOOOOOOOOXXXXXXXXXXX,0,600,0
44037,88,0,88,6,406,0,0,415,402,13,GOOXXXXXXXXXXXXXXXXXGOOOOOXXXXXXXXXXXXXXGOOOOOOOOOXXXXXXXXXXGOOOOOXXXXXXXXXXXXXXGOOXXXXXXXXXXXXXXXXXGOOOOOOXXXXXXXXXXXXXGOOOOOOXXXXXXXXXXXXXGOOOOOOOOOXXXXXXXXXXGOOOOOOOOOOOXXXXXXXXGOOXXXXXXXXXXXXXXXXXGOOOOOXXXXXXXXXXXXXXGOOOOOXXXXXXXXXXXXXXGOOOOOOOOXXXXXXXXXXX,0,600,0
44058,88,0,88,6,406,0,0,415,402,13,GOOXXXXXXXXXXXXXXXXXGOOOOOXXXXXXXXXXXXXXGOOOOOOOOOXXXXXXXXXXGOOOOOXXXXXXXXXXXXXXGOOXXXXXXXXXXXXXXXXXGOOOOOOXXXXXXXXXXXXXGOOOOOOXXXXXXXXXXXXXGOOOOOOOOOXXXXXXXXXXGOOOOOOOOOOOXXXXXXXXGOOXXXXXXXXXXXXXXXXXGOOOOOXXXXXXXXXXXXXXGOOOOOXXXXXXXXXXXXXXGOOOOOOOOXXXXXXXXXXX,0,600,0
44079,88,0,88,5,407,0,0,416,402,14,GOOXXXXXXXXXXXXXXXXXGOOOOOXXXXXXXXXXXXXXGOOOOOOOOOXXXXXXXXXXGOOOOOXXXXXXXXXXXXXXGOOXXXXXXXXXXXXXXXXXGOOOOOOXXXXXXXXXXXXXGOOOOOOXXXXXXXXXXXXXGOOOOOOOOOXXXXXXXXXXGOOOOOOOOOOOXXXXXXXXGOOXXXXXXXXXXXXXXXXXGOOOOOXXXXXXXXXXXXXXGOOOOOXXXXXXXXXXXXXXGOOOOOOOOXXXXXXXXXXX,0,600,0

44100,88,0,88,5,407,0,0,416,402,14,GOOXXXXXXXXXXXXXXXXXGOOOOOXXXXXXXXXXXXXXGOOOOOOOOOXXXXXXXXXXGOOOOOXXXXXXXXXXXXXXGOOXXXXXXXXXXXXXXXXXGOOOOOOXXXXXXXXXXXXXGOOOOOOXXXXXXXXXXXXXGOOOOOOOOOXXXXXXXXXXGOOOOOOOOOOOXXXXXXXXGOOXXXXXXXXXXXXXXXXXGOOOOOXXXXXXXXXXXXXXGOOOOOXXXXXXXXXXXXXXGOOOOOOOOXXXXXXXXXXX,0,600,0
44121,88,0,88,3,409,0,0,417,402,15,GOOXXXXXXXXXXXXXXXXXGOOOOOXXXXXXXXXXXXXXGOOOOOOOOOXXXXXXXXXXGOOOOOXXXXXXXXXXXXXXGOOXXXXXXXXXXXXXXXXXGOOOOOOXXXXXXXXXXXXXGOOOOOOXXXXXXXXXXXXXGOOOOOOOOOXXXXXXXXXXGOOOOOOOOOOOXXXXXXXXGOOXXXXXXXXXXXXXXXXXGOOOOOXXXXXXXXXXXXXXGOOOOOXXXXXXXXXXXXXXGOOOOOOOOXXXXXXXXXXX,0,600,0
44142,88,0,88,2,410,0,0,419,403,16,GOOXXXXXXXXXXXXXXXXXGOOOOOXXXXXXXXXXXXXXGOOOOOOOOOXXXXXXXXXXGOOOOOXXXXXXXXXXXXXXGOOXXXXXXXXXXXXXXXXXGOOOOOOXXXXXXXXXXXXXGOOOOOOXXXXXXXXXXXXXGOOOOOOOOOXXXXXXXXXXGOOOOOOOOOOOXXXXXXXXGOOXXXXXXXXXXXXXXXXXGOOOOOXXXXXXXXXXXXXXGOOOOOXXXXXXXXXXXXXXGOOOOOOOOXXXXXXXXXXX,0,600,0
44163,88,0,88,3,409,0,0,418,402,16,GOOXXXXXXXXXXXXXXXXXGOOOOOXXXXXXXXXXXXXXGOOOOOOOOOXXXXXXXXXXGOOOOOXXXXXXXXXXXXXXGOOXXXXXXXXXXXXXXXXXGOOOOOOXXXXXXXXXXXXXGOOOOOOXXXXXXXXXXXXXGOOOOOOOOOXXXXXXXXXXGOOOOOOOOOOOXXXXXXXXGOOXXXXXXXXXXXXXXXXXGOOOOOXXXXXXXXXXXXXXGOOOOOXXXXXXXXXXXXXXGOOOOOOOOXXXXXXXXXXX,0,600,0
44184,88,0,88,2,410,0,0,418,403,15,GOOXXXXXXXXXXXXXXXXXGOOOOOXXXXXXXXXXXXXXGOOOOOOOOOXXXXXXXXXXGOOOOOXXXXXXXXXXXXXXGOOXXXXXXXXXXXXXXXXXGOOOOOOXXXXXXXXXXXXXGOOOOOOXXXXXXXXXXXXXGOOOOOOOOOXXXXXXXXXXGOOOOOOOOOOOXXXXXXXXGOOXXXXXXXXXXXXXXXXXGOOOOOXXXXXXXXXXXXXXGOOOOOXXXXXXXXXXXXXXGOOOOOOOOXXXXXXXXXXX,0,600,0

44205,88,0,88,4,408,0,0,417,403,14,GOOXXXXXXXXXXXXXXXXXGOOOOOXXXXXXXXXXXXXXGOOOOOOOOOXXXXXXXXXXGOOOOOXXXXXXXXXXXXXXGOOXXXXXXXXXXXXXXXXXGOOOOOOXXXXXXXXXXXXXGOOOOOOXXXXXXXXXXXXXGOOOOOOOOOXXXXXXXXXXGOOOOOOOOOOOXXXXXXXXGOOXXXXXXXXXXXXXXXXXGOOOOOXXXXXXXXXXXXXXGOOOOOXXXXXXXXXXXXXXGOOOOOOOOXXXXXXXXXXX,0,600,0
44226,88,0,88,5,407,0,0,416,403,13,GOOXXXXXXXXXXXXXXXXXGOOOOOXXXXXXXXXXXXXXGOOOOOOOOOXXXXXXXXXXGOOOOOXXXXXXXXXXXXXXGOOXXXXXXXXXXXXXXXXXGOOOOOOXXXXXXXXXXXXXGOOOOOOXXXXXXXXXXXXXGOOOOOOOOOXXXXXXXXXXGOOOOOOOOOOOXXXXXXXXGOOXXXXXXXXXXXXXXXXXGOOOOOXXXXXXXXXXXXXXGOOOOOXXXXXXXXXXXXXXGOOOOOOOOXXXXXXXXXXX,0,600,0
44247,88,0,88,4,408,0,0,417,403,14,GOOXXXXXXXXXXXXXXXXXGOOOOOXXXXXXXXXXXXXXGOOOOOOOOOXXXXXXXXXXGOOOOOXXXXXXXXXXXXXXGOOXXXXXXXXXXXXXXXXXGOOOOOOXXXXXXXXXXXXXGOOOOOOXXXXXXXXXXXXXGOOOOOOOOOXXXXXXXXXXGOOOOOOOOOOOXXXXXXXXGOOXXXXXXXXXXXXXXXXXGOOOOOXXXXXXXXXXXXXXGOOOOOXXXXXXXXXXXXXXGOOOOOOOOXXXXXXXXXXX,0,600,0
44268,88,0,88,4,408,0,0,417,403,14,GOOXXXXXXXXXXXXXXXXXGOOOOOXXXXXXXXXXXXXXGOOOOOOOOOXXXXXXXXXXGOOOOOXXXXXXXXXXXXXXGOOXXXXXXXXXXXXXXXXXGOOOOOOXXXXXXXXXXXXXGOOOOOOXXXXXXXXXXXXXGOOOOOOOOOXXXXXXXXXXGOOOOOOOOOOOXXXXXXXXGOOXXXXXXXXXXXXXXXXXGOOOOOXXXXXXXXXXXXXXGOOOOOXXXXXXXXXXXXXXGOOOOOOOOXXXXXXXXXXX,0,600,0
44289,88,0,88,4,408,0,0,417,403,14,GOOXXXXXXXXXXXXXXXXXGOOOOOXXXXXXXXXXXXXXGOOOOOOOOOXXXXXXXXXXGOOOOOXXXXXXXXXXXXXXGOOXXXXXXXXXXXXXXXXXGOOOOOOXXXXXXXXXXXXXGOOOOOOXXXXXXXXXXXXXGOOOOOOOOOXXXXXXXXXXGOOOOOOOOOOOXXXXXXXXGOOXXXXXXXXXXXXXXXXXGOOOOOXXXXXXXXXXXXXXGOOOOOXXXXXXXXXXXXXXGOOOOOOOOXXXXXXXXXXX,0,600,0

44310,88,0,88,4,408,0,0,417,403,14,GOOXXXXXXXXXXXXXXXXXGOOOOOXXXXXXXXXXXXXXGOOOOOOOOOXXXXXXXXXXGOOOOOXXXXXXXXXXXXXXGOOXXXXXXXXXXXXXXXXXGOOOOOOXXXXXXXXXXXXXGOOOOOOXXXXXXXXXXXXXGOOOOOOOOOXXXXXXXXXXGOOOOOOOOOOOXXXXXXXXGOOXXXXXXXXXXXXXXXXXGOOOOOXXXXXXXXXXXXXXGOOOOOXXXXXXXXXXXXXXGOOOOOOOOXXXXXXXXXXX,0,600,0
44331,88,0,88,4,408,0,0,417,404,13,GOOXXXXXXXXXXXXXXXXXGOOOOOXXXXXXXXXXXXXXGOOOOOOOOOXXXXXXXXXXGOOOOOXXXXXXXXXXXXXXGOOXXXXXXXXXXXXXXXXXGOOOOOOXXXXXXXXXXXXXGOOOOOOXXXXXXXXXXXXXGOOOOOOOOOXXXXXXXXXXGOOOOOOOOOOOXXXXXXXXGOOXXXXXXXXXXXXXXXXXGOOOOOXXXXXXXXXXXXXXGOOOOOXXXXXXXXXXXXXXGOOOOOOOOXXXXXXXXXXX,0,600,0
44352,88,0,88,7,405,0,0,414,404,10,GOOXXXXXXXXXXXXXXXXXGOOOOOXXXXXXXXXXXXXXGOOOOOOOOOXXXXXXXXXXGOOOOOXXXXXXXXXXXXXXGOOXXXXXXXXXXXXXXXXXGOOOOOOXXXXXXXXXXXXXGOOOOOOXXXXXXXXXXXXXGOOOOOOOOOXXXXXXXXXXGOOOOOOOOOOOXXXXXXXXGOOXXXXXXXXXXXXXXXXXGOOOOOXXXXXXXXXXXXXXGOOOOOXXXXXXXXXXXXXXGOOOOOOOOXXXXXXXXXXX,0,600,0
44373,88,0,88,8,404,0,0,413,403,10,GOOXXXXXXXXXXXXXXXXXGOOOOOXXXXXXXXXXXXXXGOOOOOOOOOXXXXXXXXXXGOOOOOXXXXXXXXXXXXXXGOOXXXXXXXXXXXXXXXXXGOOOOOOXXXXXXXXXXXXXGOOOOOOXXXXXXXXXXXXXGOOOOOOOOOXXXXXXXXXXGOOOOOOOOOOOXXXXXXXXGOOXXXXXXXXXXXXXXXXXGOOOOOXXXXXXXXXXXXXXGOOOOOXXXXXXXXXXXXXXGOOOOOOOOXXXXXXXXXXX,0,600,0
44394,88,0,88,6,406,0,0,415,403,12,GOOXXXXXXXXXXXXXXXXXGOOOOOXXXXXXXXXXXXXXGOOOOOOOOOXXXXXXXXXXGOOOOOXXXXXXXXXXXXXXGOOXXXXXXXXXXXXXXXXXGOOOOOOXXXXXXXXXXXXXGOOOOOOXXXXXXXXXXXXXGOOOOOOOOOXXXXXXXXXXGOOOOOOOOOOOXXXXXXXXGOOXXXXXXXXXXXXXXXXXGOOOOOXXXXXXXXXXXXXXGOOOOOXXXXXXXXXXXXXXGOOOOOOOOXXXXXXXXXXX,0,600,0

44415,88,0,88,6,406,0,0,415,403,12,GOOXXXXXXXXXXXXXXXXXGOOOOOXXXXXXXXXXXXXXGOOOOOOOOOXXXXXXXXXXGOOOOOXXXXXXXXXXXXXXGOOXXXXXXXXXXXXXXXXXGOOOOOOXXXXXXXXXXXXXGOOOOOOXXXXXXXXXXXXXGOOOOOOOOOXXXXXXXXXXGOOOOOOOOOOOXXXXXXXXGOOXXXXXXXXXXXXXXXXXGOOOOOXXXXXXXXXXXXXXGOOOOOXXXXXXXXXXXXXXGOOOOOOOOXXXXXXXXXXX,0,600,0
44436,88,0,88,5,407,0,0,416,403,13,GOOXXXXXXXXXXXXXXXXXGOOOOOXXXXXXXXXXXXXXGOOOOOOOOOXXXXXXXXXXGOOOOOXXXXXXXXXXXXXXGOOXXXXXXXXXXXXXXXXXGOOOOOOXXXXXXXXXXXXXGOOOOOOXXXXXXXXXXXXXGOOOOOOOOOXXXXXXXXXXGOOOOOOOOOOOXXXXXXXXGOOXXXXXXXXXXXXXXXXXGOOOOOXXXXXXXXXXXXXXGOOOOOXXXXXXXXXXXXXXGOOOOOOOOXXXXXXXXXXX,0,600,0
44457,88,0,88,5,407,0,0,416,403,13,GOOXXXXXXXXXXXXXXXXXGOOOOOXXXXXXXXXXXXXXGOOOOOOOOOXXXXXXXXXXGOOOOOXXXXXXXXXXXXXXGOOXXXXXXXXXXXXXXXXXGOOOOOOXXXXXXXXXXXXXGOOOOOOXXXXXXXXXXXXXGOOOOOOOOOXXXXXXXXXXGOOOOOOOOOOOXXXXXXXXGOOXXXXXXXXXXXXXXXXXGOOOOOXXXXXXXXXXXXXXGOOOOOXXXXXXXXXXXXXXGOOOOOOOOXXXXXXXXXXX,0,600,0
44478,88,0,88,6,406,0,0,415,404,11,GOOXXXXXXXXXXXXXXXXXGOOOOOXXXXXXXXXXXXXXGOOOOOOOOOXXXXXXXXXXGOOOOOXXXXXXXXXXXXXXGOOXXXXXXXXXXXXXXXXXGOOOOOOXXXXXXXXXXXXXGOOOOOOXXXXXXXXXXXXXGOOOOOOOOOXXXXXXXXXXGOOOOOOOOOOOXXXXXXXXGOOXXXXXXXXXXXXXXXXXGOOOOOXXXXXXXXXXXXXXGOOOOOXXXXXXXXXXXXXXGOOOOOOOOXXXXXXXXXXX,0,600,0
44499,88,0,88,5,407,0,0,415,403,12,GOOXXXXXXXXXXXXXXXXXGOOOOOXXXXXXXXXXXXXXGOOOOOOOOOXXXXXXXXXXGOOOOOXXXXXXXXXXXXXXGOOXXXXXXXXXXXXXXXXXGOOOOOOXXXXXXXXXXXXXGOOOOOOXXXXXXXXXXXXXGOOOOOOOOOXXXXXXXXXXGOOOOOOOOOOOXXXXXXXXGOOXXXXXXXXXXXXXXXXXGOOOOOXXXXXXXXXXXXXXGOOOOOXXXXXXXXXXXXXXGOOOOOOOOXXXXXXXXXXX,0,600,0

44520,88,0,88,5,407,0,0,416,403,13,GOOXXXXXXXXXXXXXXXXXGOOOOOXXXXXXXXXXXXXXGOOOOOOOOOXXXXXXXXXXGOOOOOXXXXXXXXXXXXXXGOOXXXXXXXXXXXXXXXXXGOOOOOOXXXXXXXXXXXXXGOOOOOOXXXXXXXXXXXXXGOOOOOOOOOXXXXXXXXXXGOOOOOOOOOOOXXXXXXXXGOOXXXXXXXXXXXXXXXXXGOOOOOXXXXXXXXXXXXXXGOOOOOXXXXXXXXXXXXXXGOOOOOOOOXXXXXXXXXXX,0,600,0
44541,88,0,88,5,407,0,0,416,403,13,GOOXXXXXXXXXXXXXXXXXGOOOOOXXXXXXXXXXXXXXGOOOOOOOOOXXXXXXXXXXGOOOOOXXXXXXXXXXXXXXGOOXXXXXXXXXXXXXXXXXGOOOOOOXXXXXXXXXXXXXGOOOOOOXXXXXXXXXXXXXGOOOOOOOOOXXXXXXXXXXGOOOOOOOOOOOXXXXXXXXGOOXXXXXXXXXXXXXXXXXGOOOOOXXXXXXXXXXXXXXGOOOOOXXXXXXXXXXXXXXGOOOOOOOOXXXXXXXXXXX,0,600,0
44562,88,0,88,5,407,0,0,416,403,13,GOOXXXXXXXXXXXXXXXXXGOOOOOXXXXXXXXXXXXXXGOOOOOOOOOXXXXXXXXXXGOOOOOXXXXXXXXXXXXXXGOOXXXXXXXXXXXXXXXXXGOOOOOOXXXXXXXXXXXXXGOOOOOOXXXXXXXXXXXXXGOOOOOOOOOXXXXXXXXXXGOOOOOOOOOOOXXXXXXXXGOOXXXXXXXXXXXXXXXXXGOOOOOXXXXXXXXXXXXXXGOOOOOXXXXXXXXXXXXXXGOOOOOOOOXXXXXXXXXXX,0,600,0
44583,88,0,88,5,407,0,0,416,404,12,GOOXXXXXXXXXXXXXXXXXGOOOOOXXXXXXXXXXXXXXGOOOOOOOOOXXXXXXXXXXGOOOOOXXXXXXXXXXXXXXGOOXXXXXXXXXXXXXXXXXGOOOOOOXXXXXXXXXXXXXGOOOOOOXXXXXXXXXXXXXGOOOOOOOOOXXXXXXXXXXGOOOOOOOOOOOXXXXXXXXGOOXXXXXXXXXXXXXXXXXGOOOOOXXXXXXXXXXXXXXGOOOOOXXXXXXXXXXXXXXGOOOOOOOOXXXXXXXXXXX,0,600,0
44604,88,0,88,6,406,0,0,415,404,11,GOOXXXXXXXXXXXXXXXXXGOOOOOXXXXXXXXXXXXXXGOOOOOOOOOXXXXXXXXXXGOOOOOXXXXXXXXXXXXXXGOOXXXXXXXXXXXXXXXXXGOOOOOOXXXXXXXXXXXXXGOOOOOOXXXXXXXXXXXXXGOOOOOOOOOXXXXXXXXXXGOOOOOOOOOOOXXXXXXXXGOOXXXXXXXXXXXXXXXXXGOOOOOXXXXXXXXXXXXXXGOOOOOXXXXXXXXXXXXXXGOOOOOOOOXXXXXXXXXXX,0,600,0

44625,88,0,88,6,406,0,0,415,403,12,GOOXXXXXXXXXXXXXXXXXGOOOOOXXXXXXXXXXXXXXGOOOOOOOOOXXXXXXXXXXGOOOOOXXXXXXXXXXXXXXGOOXXXXXXXXXXXXXXXXXGOOOOOOXXXXXXXXXXXXXGOOOOOOXXXXXXXXXXXXXGOOOOOOOOOXXXXXXXXXXGOOOOOOOOOOOXXXXXXXXGOOXXXXXXXXXXXXXXXXXGOOOOOXXXXXXXXXXXXXXGOOOOOXXXXXXXXXXXXXXGOOOOOOOOXXXXXXXXXXX,0,600,0
44646,88,0,88,5,407,0,0,416,404,12,GOOXXXXXXXXXXXXXXXXXGOOOOOXXXXXXXXXXXXXXGOOOOOOOOOXXXXXXXXXXGOOOOOXXXXXXXXXXXXXXGOOXXXXXXXXXXXXXXXXXGOOOOOOXXXXXXXXXXXXXGOOOOOOXXXXXXXXXXXXXGOOOOOOOOOXXXXXXXXXXGOOOOOOOOOOOXXXXXXXXGOOXXXXXXXXXXXXXXXXXGOOOOOXXXXXXXXXXXXXXGOOOOOXXXXXXXXXXXXXXGOOOOOOOOXXXXXXXXXXX,0,600,0
44667,88,0,88,8,404,0,0,413,404,9,GOOXXXXXXXXXXXXXXXXXGOOOOOXXXXXXXXXXXXXXGOOOOOOOOOXXXXXXXXXXGOOOOOXXXXXXXXXXXXXXGOOXXXXXXXXXXXXXXXXXGOOOOOOXXXXXXXXXXXXXGOOOOOOXXXXXXXXXXXXXGOOOOOOOOOXXXXXXXXXXGOOOOOOOOOOOXXXXXXXXGOOXXXXXXXXXXXXXXXXXGOOOOOXXXXXXXXXXXXXXGOOOOOXXXXXXXXXXXXXXGOOOOOOOOXXXXXXXXXXX,0,600,0
44688,88,0,88,9,403,0,0,412,404,8,GOOXXXXXXXXXXXXXXXXXGOOOOOXXXXXXXXXXXXXXGOOOOOOOOOXXXXXXXXXXGOOOOOXXXXXXXXXXXXXXGOOXXXXXXXXXXXXXXXXXGOOOOOOXXXXXXXXXXXXXGOOOOOOXXXXXXXXXXXXXGOOOOOOOOOXXXXXXXXXXGOOOOOOOOOOOXXXXXXXXGOOXXXXXXXXXXXXXXXXXGOOOOOXXXXXXXXXXXXXXGOOOOOXXXXXXXXXXXXXXGOOOOOOOOXXXXXXXXXXX,0,600,0
44709,88,0,88,10,402,0,0,411,403,8,GOOXXXXXXXXXXXXXXXXXGOOOOOXXXXXXXXXXXXXXGOOOOOOOOOXXXXXXXXXXGOOOOOXXXXXXXXXXXXXXGOOXXXXXXXXXXXXXXXXXGOOOOOOXXXXXXXXXXXXXGOOOOOOXXXXXXXXXXXXXGOOOOOOOOOXXXXXXXXXXGOOOOOOOOOOOXXXXXXXXGOOXXXXXXXXXXXXXXXXXGOOOOOXXXXXXXXXXXXXXGOOOOOXXXXXXXXXXXXXXGOOOOOOOOXXXXXXXXXXX,0,600,0

44730,88,0,88,10,402,0,0,411,403,8,GOOXXXXXXXXXXXXXXXXXGOOOOOXXXXXXXXXXXXXXGOOOOOOOOOXXXXXXXXXXGOOOOOXXXXXXXXXXXXXXGOOXXXXXXXXXXXXXXXXXGOOOOOOXXXXXXXXXXXXXGOOOOOOXXXXXXXXXXXXXGOOOOOOOOOXXXXXXXXXXGOOOOOOOOOOOXXXXXXXXGOOXXXXXXXXXXXXXXXXXGOOOOOXXXXXXXXXXXXXXGOOOOOXXXXXXXXXXXXXXGOOOOOOOOXXXXXXXXXXX,0,600,0
44751,88,0,88,10,402,0,0,411,404,7,GOOXXXXXXXXXXXXXXXXXGOOOOOXXXXXXXXXXXXXXGOOOOOOOOOXXXXXXXXXXGOOOOOXXXXXXXXXXXXXXGOOXXXXXXXXXXXXXXXXXGOOOOOOXXXXXXXXXXXXXGOOOOOOXXXXXXXXXXXXXGOOOOOOOOOXXXXXXXXXXGOOOOOOOOOOOXXXXXXXXGOOXXXXXXXXXXXXXXXXXGOOOOOXXXXXXXXXXXXXXGOOOOOXXXXXXXXXXXXXXGOOOOOOOOXXXXXXXXXXX,0,600,0
44772,88,0,88,11,401,0,0,410,403,7,GOOXXXXXXXXXXXXXXXXXGOOOOOXXXXXXXXXXXXXXGOOOOOOOOOXXXXXXXXXXGOOOOOXXXXXXXXXXXXXXGOOXXXXXXXXXXXXXXXXXGOOOOOOXXXXXXXXXXXXXGOOOOOOXXXXXXXXXXXXXGOOOOOOOOOXXXXXXXXXXGOOOOOOOOOOOXXXXXXXXGOOXXXXXXXXXXXXXXXXXGOOOOOXXXXXXXXXXXXXXGOOOOOXXXXXXXXXXXXXXGOOOOOOOOXXXXXXXXXXX,0,600,0
44793,88,0,88,10,402,0,0,411,403,8,GOOXXXXXXXXXXXXXXXXXGOOOOOXXXXXXXXXXXXXXGOOOOOOOOOXXXXXXXXXXGOOOOOXXXXXXXXXXXXXXGOOXXXXXXXXXXXXXXXXXGOOOOOOXXXXXXXXXXXXXGOOOOOOXXXXXXXXXXXXXGOOOOOOOOOXXXXXXXXXXGOOOOOOOOOOOXXXXXXXXGOOXXXXXXXXXXXXXXXXXGOOOOOXXXXXXXXXXXXXXGOOOOOXXXXXXXXXXXXXXGOOOOOOOOXXXXXXXXXXX,0,600,0
44814,88,0,88,10,402,0,0,411,403,8,GOOXXXXXXXXXXXXXXXXXGOOOOOXXXXXXXXXXXXXXGOOOOOOOOOXXXXXXXXXXGOOOOOXXXXXXXXXXXXXXGOOXXXXXXXXXXXXXXXXXGOOOOOOXXXXXXXXXXXXXGOOOOOOXXXXXXXXXXXXXGOOOOOOOOOXXXXXXXXXXGOOOOOOOOOOOXXXXXXXXGOOXXXXXXXXXXXXXXXXXGOOOOOXXXXXXXXXXXXXXGOOOOOXXXXXXXXXXXXXXGOOOOOOOOXXXXXXXXXXX,0,600,0

44835,88,0,88,8,404,0,0,413,404,9,GOOXXXXXXXXXXXXXXXXXGOOOOOXXXXXXXXXXXXXXGOOOOOOOOOXXXXXXXXXXGOOOOOXXXXXXXXXXXXXXGOOXXXXXXXXXXXXXXXXXGOOOOOOXXXXXXXXXXXXXGOOOOOOXXXXXXXXXXXXXGOOOOOOOOOXXXXXXXXXXGOOOOOOOOOOOXXXXXXXXGOOXXXXXXXXXXXXXXXXXGOOOOOXXXXXXXXXXXXXXGOOOOOXXXXXXXXXXXXXXGOOOOOOOOXXXXXXXXXXX,0,600,0
44856,88,0,88,8,404,0,0,412,403,9,GOOXXXXXXXXXXXXXXXXXGOOOOOXXXXXXXXXXXXXXGOOOOOOOOOXXXXXXXXXXGOOOOOXXXXXXXXXXXXXXGOOXXXXXXXXXXXXXXXXXGOOOOOOXXXXXXXXXXXXXGOOOOOOXXXXXXXXXXXXXGOOOOOOOOOXXXXXXXXXXGOOOOOOOOOOOXXXXXXXXGOOXXXXXXXXXXXXXXXXXGOOOOOXXXXXXXXXXXXXXGOOOOOXXXXXXXXXXXXXXGOOOOOOOOXXXXXXXXXXX,0,600,0
44877,88,0,88,7,405,0,0,414,404,10,GOOXXXXXXXXXXXXXXXXXGOOOOOXXXXXXXXXXXXXXGOOOOOOOOOXXXXXXXXXXGOOOOOXXXXXXXXXXXXXXGOOXXXXXXXXXXXXXXXXXGOOOOOOXXXXXXXXXXXXXGOOOOOOXXXXXXXXXXXXXGOOOOOOOOOXXXXXXXXXXGOOOOOOOOOOOXXXXXXXXGOOXXXXXXXXXXXXXXXXXGOOOOOXXXXXXXXXXXXXXGOOOOOXXXXXXXXXXXXXXGOOOOOOOOXXXXXXXXXXX,0,600,0
44898,88,0,88,6,406,0,0,415,403,12,GOOXXXXXXXXXXXXXXXXXGOOOOOXXXXXXXXXXXXXXGOOOOOOOOOXXXXXXXXXXGOOOOOXXXXXXXXXXXXXXGOOXXXXXXXXXXXXXXXXXGOOOOOOXXXXXXXXXXXXXGOOOOOOXXXXXXXXXXXXXGOOOOOOOOOXXXXXXXXXXGOOOOOOOOOOOXXXXXXXXGOOXXXXXXXXXXXXXXXXXGOOOOOXXXXXXXXXXXXXXGOOOOOXXXXXXXXXXXXXXGOOOOOOOOXXXXXXXXXXX,0,600,0
44919,88,0,88,6,406,0,0,415,403,12,GOOXXXXXXXXXXXXXXXXXGOOOOOXXXXXXXXXXXXXXGOOOOOOOOOXXXXXXXXXXGOOOOOXXXXXXXXXXXXXXGOOXXXXXXXXXXXXXXXXXGOOOOOOXXXXXXXXXXXXXGOOOOOOXXXXXXXXXXXXXGOOOOOOOOOXXXXXXXXXXGOOOOOOOOOOOXXXXXXXXGOOXXXXXXXXXXXXXXXXXGOOOOOXXXXXXXXXXXXXXGOOOOOXXXXXXXXXXXXXXGOOOOOOOOXXXXXXXXXXX,0,600,0

44940,88,0,88,4,408,0,0,417,403,14,GOOXXXXXXXXXXXXXXXXXGOOOOOXXXXXXXXXXXXXXGOOOOOOOOOXXXXXXXXXXGOOOOOXXXXXXXXXXXXXXGOOXXXXXXXXXXXXXXXXXGOOOOOOXXXXXXXXXXXXXGOOOOOOXXXXXXXXXXXXXGOOOOOOOOOXXXXXXXXXXGOOOOOOOOOOOXXXXXXXXGOOXXXXXXXXXXXXXXXXXGOOOOOXXXXXXXXXXXXXXGOOOOOXXXXXXXXXXXXXXGOOOOOOOOXXXXXXXXXXX,0,600,0
44961,88,0,88,3,409,0,0,418,403,15,GOOXXXXXXXXXXXXXXXXXGOOOOOXXXXXXXXXXXXXXGOOOOOOOOOXXXXXXXXXXGOOOOOXXXXXXXXXXXXXXGOOXXXXXXXXXXXXXXXXXGOOOOOOXXXXXXXXXXXXXGOOOOOOXXXXXXXXXXXXXGOOOOOOOOOXXXXXXXXXXGOOOOOOOOOOOXXXXXXXXGOOXXXXXXXXXXXXXXXXXGOOOOOXXXXXXXXXXXXXXGOOOOOXXXXXXXXXXXXXXGOOOOOOOOXXXXXXXXXXX,0,600,0
44982,88,0,88,2,410,0,0,419,404,15,GOOXXXXXXXXXXXXXXXXXGOOOOOXXXXXXXXXXXXXXGOOOOOOOOOXXXXXXXXXXGOOOOOXXXXXXXXXXXXXXGOOXXXXXXXXXXXXXXXXXGOOOOOOXXXXXXXXXXXXXGOOOOOOXXXXXXXXXXXXXGOOOOOOOOOXXXXXXXXXXGOOOOOOOOOOOXXXXXXXXGOOXXXXXXXXXXXXXXXXXGOOOOOXXXXXXXXXXXXXXGOOOOOXXXXXXXXXXXXXXGOOOOOOOOXXXXXXXXXXX,0,600,0
45003,88,0,88,3,409,0,0,418,404,14,GOOXXXXXXXXXXXXXXXXXGOOOOOXXXXXXXXXXXXXXGOOOOOOOOOXXXXXXXXXXGOOOOOXXXXXXXXXXXXXXGOOXXXXXXXXXXXXXXXXXGOOOOOOXXXXXXXXXXXXXGOOOOOOXXXXXXXXXXXXXGOOOOOOOOOXXXXXXXXXXGOOOOOOOOOOOXXXXXXXXGOOXXXXXXXXXXXXXXXXXGOOOOOXXXXXXXXXXXXXXGOOOOOXXXXXXXXXXXXXXGOOOOOOOOXXXXXXXXXXX,0,600,0
45024,88,0,88,3,409,0,0,418,404,14,GOOXXXXXXXXXXXXXXXXXGOOOOOXXXXXXXXXXXXXXGOOOOOOOOOXXXXXXXXXXGOOOOOXXXXXXXXXXXXXXGOOXXXXXXXXXXXXXXXXXGOOOOOOXXXXXXXXXXXXXGOOOOOOXXXXXXXXXXXXXGOOOOOOOOOXXXXXXXXXXGOOOOOOOOOOOXXXXXXXXGOOXXXXXXXXXXXXXXXXXGOOOOOXXXXXXXXXXXXXXGOOOOOXXXXXXXXXXXXXXGOOOOOOOOXXXXXXXXXXX,0,600,0

45045,88,0,88,3,409,0,0,418,404,14,GOOXXXXXXXXXXXXXXXXXGOOOOOXXXXXXXXXXXXXXGOOOOOOOOOXXXXXXXXXXGOOOOOXXXXXXXXXXXXXXGOOXXXXXXXXXXXXXXXXXGOOOOOOXXXXXXXXXXXXXGOOOOOOXXXXXXXXXXXXXGOOOOOOOOOXXXXXXXXXXGOOOOOOOOOOOXXXXXXXXGOOXXXXXXXXXXXXXXXXXGOOOOOXXXXXXXXXXXXXXGOOOOOXXXXXXXXXXXXXXGOOOOOOOOXXXXXXXXXXX,0,600,0
45066,88,0,88,2,410,0,0,419,404,15,GOOXXXXXXXXXXXXXXXXXGOOOOOXXXXXXXXXXXXXXGOOOOOOOOOXXXXXXXXXXGOOOOOXXXXXXXXXXXXXXGOOXXXXXXXXXXXXXXXXXGOOOOOOXXXXXXXXXXXXXGOOOOOOXXXXXXXXXXXXXGOOOOOOOOOXXXXXXXXXXGOOOOOOOOOOOXXXXXXXXGOOXXXXXXXXXXXXXXXXXGOOOOOXXXXXXXXXXXXXXGOOOOOXXXXXXXXXXXXXXGOOOOOOOOXXXXXXXXXXX,0,600,0
45087,88,0,88,2,410,0,0,419,404,15,GOOXXXXXXXXXXXXXXXXXGOOOOOXXXXXXXXXXXXXXGOOOOOOOOOXXXXXXXXXXGOOOOOXXXXXXXXXXXXXXGOOXXXXXXXXXXXXXXXXXGOOOOOOXXXXXXXXXXXXXGOOOOOOXXXXXXXXXXXXXGOOOOOOOOOXXXXXXXXXXGOOOOOOOOOOOXXXXXXXXGOOXXXXXXXXXXXXXXXXXGOOOOOXXXXXXXXXXXXXXGOOOOOXXXXXXXXXXXXXXGOOOOOOOOXXXXXXXXXXX,0,600,0
45108,88,0,88,2,410,0,0,419,405,14,GOOXXXXXXXXXXXXXXXXXGOOOOOXXXXXXXXXXXXXXGOOOOOOOOOXXXXXXXXXXGOOOOOXXXXXXXXXXXXXXGOOXXXXXXXXXXXXXXXXXGOOOOOOXXXXXXXXXXXXXGOOOOOOXXXXXXXXXXXXXGOOOOOOOOOXXXXXXXXXXGOOOOOOOOOOOXXXXXXXXGOOXXXXXXXXXXXXXXXXXGOOOOOXXXXXXXXXXXXXXGOOOOOXXXXXXXXXXXXXXGOOOOOOOOXXXXXXXXXXX,0,600,0
45129,88,0,88,4,408,0,0,417,404,13,GOOXXXXXXXXXXXXXXXXXGOOOOOXXXXXXXXXXXXXXGOOOOOOOOOXXXXXXXXXXGOOOOOXXXXXXXXXXXXXXGOOXXXXXXXXXXXXXXXXXGOOOOOOXXXXXXXXXXXXXGOOOOOOXXXXXXXXXXXXXGOOOOOOOOOXXXXXXXXXXGOOOOOOOOOOOXXXXXXXXGOOXXXXXXXXXXXXXXXXXGOOOOOXXXXXXXXXXXXXXGOOOOOXXXXXXXXXXXXXXGOOOOOOOOXXXXXXXXXXX,0,600,0

45150,88,0,88,2,410,0,0,419,404,15,GOOXXXXXXXXXXXXXXXXXGOOOOOXXXXXXXXXXXXXXGOOOOOOOOOXXXXXXXXXXGOOOOOXXXXXXXXXXXXXXGOOXXXXXXXXXXXXXXXXXGOOOOOOXXXXXXXXXXXXXGOOOOOOXXXXXXXXXXXXXGOOOOOOOOOXXXXXXXXXXGOOOOOOOOOOOXXXXXXXXGOOXXXXXXXXXXXXXXXXXGOOOOOXXXXXXXXXXXXXXGOOOOOXXXXXXXXXXXXXXGOOOOOOOOXXXXXXXXXXX,0,600,0
45171,88,0,88,2,410,0,0,419,404,15,GOOXXXXXXXXXXXXXXXXXGOOOOOXXXXXXXXXXXXXXGOOOOOOOOOXXXXXXXXXXGOOOOOXXXXXXXXXXXXXXGOOXXXXXXXXXXXXXXXXXGOOOOOOXXXXXXXXXXXXXGOOOOOOXXXXXXXXXXXXXGOOOOOOOOOXXXXXXXXXXGOOOOOOOOOOOXXXXXXXXGOOXXXXXXXXXXXXXXXXXGOOOOOXXXXXXXXXXXXXXGOOOOOXXXXXXXXXXXXXXGOOOOOOOOXXXXXXXXXXX,0,600,0
45192,88,0,88,2,410,0,0,419,404,15,GOOXXXXXXXXXXXXXXXXXGOOOOOXXXXXXXXXXXXXXGOOOOOOOOOXXXXXXXXXXGOOOOOXXXXXXXXXXXXXXGOOXXXXXXXXXXXXXXXXXGOOOOOOXXXXXXXXXXXXXGOOOOOOXXXXXXXXXXXXXGOOOOOOOOOXXXXXXXXXXGOOOOOOOOOOOXXXXXXXXGOOXXXXXXXXXXXXXXXXXGOOOOOXXXXXXXXXXXXXXGOOOOOXXXXXXXXXXXXXXGOOOOOOOOXXXXXXXXXXX,0,600,0
45213,88,0,88,2,410,0,0,419,404,15,GOOXXXXXXXXXXXXXXXXXGOOOOOXXXXXXXXXXXXXXGOOOOOOOOOXXXXXXXXXXGOOOOOXXXXXXXXXXXXXXGOOXXXXXXXXXXXXXXXXXGOOOOOOXXXXXXXXXXXXXGOOOOOOXXXXXXXXXXXXXGOOOOOOOOOXXXXXXXXXXGOOOOOOOOOOOXXXXXXXXGOOXXXXXXXXXXXXXXXXXGOOOOOXXXXXXXXXXXXXXGOOOOOXXXXXXXXXXXXXXGOOOOOOOOXXXXXXXXXXX,0,600,0
45234,88,0,88,3,409,0,0,418,405,13,GOOXXXXXXXXXXXXXXXXXGOOOOOXXXXXXXXXXXXXXGOOOOOOOOOXXXXXXXXXXGOOOOOXXXXXXXXXXXXXXGOOXXXXXXXXXXXXXXXXXGOOOOOOXXXXXXXXXXXXXGOOOOOOXXXXXXXXXXXXXGOOOOOOOOOXXXXXXXXXXGOOOOOOOOOOOXXXXXXXXGOOXXXXXXXXXXXXXXXXXGOOOOOXXXXXXXXXXXXXXGOOOOOXXXXXXXXXXXXXXGOOOOOOOOXXXXXXXXXXX,0,600,0

45255,88,0,88,3,409,0,0,418,406,12,GOOXXXXXXXXXXXXXXXXXGOOOOOXXXXXXXXXXXXXXGOOOOOOOOOXXXXXXXXXXGOOOOOXXXXXXXXXXXXXXGOOXXXXXXXXXXXXXXXXXGOOOOOOXXXXXXXXXXXXXGOOOOOOXXXXXXXXXXXXXGOOOOOOOOOXXXXXXXXXXGOOOOOOOOOOOXXXXXXXXGOOXXXXXXXXXXXXXXXXXGOOOOOXXXXXXXXXXXXXXGOOOOOXXXXXXXXXXXXXXGOOOOOOOOXXXXXXXXXXX,0,600,0
45276,88,0,88,3,409,0,0,418,405,13,GOOXXXXXXXXXXXXXXXXXGOOOOOXXXXXXXXXXXXXXGOOOOOOOOOXXXXXXXXXXGOOOOOXXXXXXXXXXXXXXGOOXXXXXXXXXXXXXXXXXGOOOOOOXXXXXXXXXXXXXGOOOOOOXXXXXXXXXXXXXGOOOOOOOOOXXXXXXXXXXGOOOOOOOOOOOXXXXXXXXGOOXXXXXXXXXXXXXXXXXGOOOOOXXXXXXXXXXXXXXGOOOOOXXXXXXXXXXXXXXGOOOOOOOOXXXXXXXXXXX,0,600,0
45297,88,0,88,5,407,0,0,416,408,8,GOOXXXXXXXXXXXXXXXXXGOOOOOXXXXXXXXXXXXXXGOOOOOOOOOXXXXXXXXXXGOOOOOXXXXXXXXXXXXXXGOOXXXXXXXXXXXXXXXXXGOOOOOOXXXXXXXXXXXXXGOOOOOOXXXXXXXXXXXXXGOOOOOOOOOXXXXXXXXXXGOOOOOOOOOOOXXXXXXXXGOOXXXXXXXXXXXXXXXXXGOOOOOXXXXXXXXXXXXXXGOOOOOXXXXXXXXXXXXXXGOOOOOOOOXXXXXXXXXXX,0,600,0
45318,88,0,88,7,405,0,0,414,405,9,GOOXXXXXXXXXXXXXXXXXGOOOOOXXXXXXXXXXXXXXGOOOOOOOOOXXXXXXXXXXGOOOOOXXXXXXXXXXXXXXGOOXXXXXXXXXXXXXXXXXGOOOOOOXXXXXXXXXXXXXGOOOOOOXXXXXXXXXXXXXGOOOOOOOOOXXXXXXXXXXGOOOOOOOOOOOXXXXXXXXGOOXXXXXXXXXXXXXXXXXGOOOOOXXXXXXXXXXXXXXGOOOOOXXXXXXXXXXXXXXGOOOOOOOOXXXXXXXXXXX,0,600,0
45339,88,0,88,8,404,0,0,413,404,9,GOOXXXXXXXXXXXXXXXXXGOOOOOXXXXXXXXXXXXXXGOOOOOOOOOXXXXXXXXXXGOOOOOXXXXXXXXXXXXXXGOOXXXXXXXXXXXXXXXXXGOOOOOOXXXXXXXXXXXXXGOOOOOOXXXXXXXXXXXXXGOOOOOOOOOXXXXXXXXXXGOOOOOOOOOOOXXXXXXXXGOOXXXXXXXXXXXXXXXXXGOOOOOXXXXXXXXXXXXXXGOOOOOXXXXXXXXXXXXXXGOOOOOOOOXXXXXXXXXXX,0,600,0

45360,88,0,88,7,405,0,0,414,405,9,GOOXXXXXXXXXXXXXXXXXGOOOOOXXXXXXXXXXXXXXGOOOOOOOOOXXXXXXXXXXGOOOOOXXXXXXXXXXXXXXGOOXXXXXXXXXXXXXXXXXGOOOOOOXXXXXXXXXXXXXGOOOOOOXXXXXXXXXXXXXGOOOOOOOOOXXXXXXXXXXGOOOOOOOOOOOXXXXXXXXGOOXXXXXXXXXXXXXXXXXGOOOOOXXXXXXXXXXXXXXGOOOOOXXXXXXXXXXXXXXGOOOOOOOOXXXXXXXXXXX,0,600,0
45381,88,0,88,6,406,0,0,414,406,8,GOOXXXXXXXXXXXXXXXXXGOOOOOXXXXXXXXXXXXXXGOOOOOOOOOXXXXXXXXXXGOOOOOXXXXXXXXXXXXXXGOOXXXXXXXXXXXXXXXXXGOOOOOOXXXXXXXXXXXXXGOOOOOOXXXXXXXXXXXXXGOOOOOOOOOXXXXXXXXXXGOOOOOOOOOOOXXXXXXXXGOOXXXXXXXXXXXXXXXXXGOOOOOXXXXXXXXXXXXXXGOOOOOXXXXXXXXXXXXXXGOOOOOOOOXXXXXXXXXXX,0,600,0
45402,88,0,88,8,404,0,0,413,405,8,GOOXXXXXXXXXXXXXXXXXGOOOOOXXXXXXXXXXXXXXGOOOOOOOOOXXXXXXXXXXGOOOOOXXXXXXXXXXXXXXGOOXXXXXXXXXXXXXXXXXGOOOOOOXXXXXXXXXXXXXGOOOOOOXXXXXXXXXXXXXGOOOOOOOOOXXXXXXXXXXGOOOOOOOOOOOXXXXXXXXGOOXXXXXXXXXXXXXXXXXGOOOOOXXXXXXXXXXXXXXGOOOOOXXXXXXXXXXXXXXGOOOOOOOOXXXXXXXXXXX,0,600,0
45423,88,0,88,7,405,0,0,414,404,10,GOOXXXXXXXXXXXXXXXXXGOOOOOXXXXXXXXXXXXXXGOOOOOOOOOXXXXXXXXXXGOOOOOXXXXXXXXXXXXXXGOOXXXXXXXXXXXXXXXXXGOOOOOOXXXXXXXXXXXXXGOOOOOOXXXXXXXXXXXXXGOOOOOOOOOXXXXXXXXXXGOOOOOOOOOOOXXXXXXXXGOOXXXXXXXXXXXXXXXXXGOOOOOXXXXXXXXXXXXXXGOOOOOXXXXXXXXXXXXXXGOOOOOOOOXXXXXXXXXXX,0,600,0
45444,88,0,88,7,405,0,0,414,404,10,GOOXXXXXXXXXXXXXXXXXGOOOOOXXXXXXXXXXXXXXGOOOOOOOOOXXXXXXXXXXGOOOOOXXXXXXXXXXXXXXGOOXXXXXXXXXXXXXXXXXGOOOOOOXXXXXXXXXXXXXGOOOOOOXXXXXXXXXXXXXGOOOOOOOOOXXXXXXXXXXGOOOOOOOOOOOXXXXXXXXGOOXXXXXXXXXXXXXXXXXGOOOOOXXXXXXXXXXXXXXGOOOOOXXXXXXXXXXXXXXGOOOOOOOOXXXXXXXXXXX,0,600,0

45465,88,0,88,6,406,0,0,415,404,11,GOOXXXXXXXXXXXXXXXXXGOOOOOXXXXXXXXXXXXXXGOOOOOOOOOXXXXXXXXXXGOOOOOXXXXXXXXXXXXXXGOOXXXXXXXXXXXXXXXXXGOOOOOOXXXXXXXXXXXXXGOOOOOOXXXXXXXXXXXXXGOOOOOOOOOXXXXXXXXXXGOOOOOOOOOOOXXXXXXXXGOOXXXXXXXXXXXXXXXXXGOOOOOXXXXXXXXXXXXXXGOOOOOXXXXXXXXXXXXXXGOOOOOOOOXXXXXXXXXXX,0,600,0
45486,88,0,88,7,405,0,0,414,404,10,GOOXXXXXXXXXXXXXXXXXGOOOOOXXXXXXXXXXXXXXGOOOOOOOOOXXXXXXXXXXGOOOOOXXXXXXXXXXXXXXGOOXXXXXXXXXXXXXXXXXGOOOOOOXXXXXXXXXXXXXGOOOOOOXXXXXXXXXXXXXGOOOOOOOOOXXXXXXXXXXGOOOOOOOOOOOXXXXXXXXGOOXXXXXXXXXXXXXXXXXGOOOOOXXXXXXXXXXXXXXGOOOOOXXXXXXXXXXXXXXGOOOOOOOOXXXXXXXXXXX,0,600,0
45507,88,0,88,7,405,0,0,414,404,10,GOOXXXXXXXXXXXXXXXXXGOOOOOXXXXXXXXXXXXXXGOOOOOOOOOXXXXXXXXXXGOOOOOXXXXXXXXXXXXXXGOOXXXXXXXXXXXXXXXXXGOOOOOOXXXXXXXXXXXXXGOOOOOOXXXXXXXXXXXXXGOOOOOOOOOXXXXXXXXXXGOOOOOOOOOOOXXXXXXXXGOOXXXXXXXXXXXXXXXXXGOOOOOXXXXXXXXXXXXXXGOOOOOXXXXXXXXXXXXXXGOOOOOOOOXXXXXXXXXXX,0,600,0
45528,88,0,88,8,404,0,0,413,404,9,GOOXXXXXXXXXXXXXXXXXGOOOOOXXXXXXXXXXXXXXGOOOOOOOOOXXXXXXXXXXGOOOOOXXXXXXXXXXXXXXGOOXXXXXXXXXXXXXXXXXGOOOOOOXXXXXXXXXXXXXGOOOOOOXXXXXXXXXXXXXGOOOOOOOOOXXXXXXXXXXGOOOOOOOOOOOXXXXXXXXGOOXXXXXXXXXXXXXXXXXGOOOOOXXXXXXXXXXXXXXGOOOOOXXXXXXXXXXXXXXGOOOOOOOOXXXXXXXXXXX,0,600,0
45549,88,0,88,8,404,0,0,413,404,9,GOOXXXXXXXXXXXXXXXXXGOOOOOXXXXXXXXXXXXXXGOOOOOOOOOXXXXXXXXXXGOOOOOXXXXXXXXXXXXXXGOOXXXXXXXXXXXXXXXXXGOOOOOOXXXXXXXXXXXXXGOOOOOOXXXXXXXXXXXXXGOOOOOOOOOXXXXXXXXXXGOOOOOOOOOOOXXXXXXXXGOOXXXXXXXXXXXXXXXXXGOOOOOXXXXXXXXXXXXXXGOOOOOXXXXXXXXXXXXXXGOOOOOOOOXXXXXXXXXXX,0,600,0

45570,88,0,88,8,404,0,0,413,404,9,GOOXXXXXXXXXXXXXXXXXGOOOOOXXXXXXXXXXXXXXGOOOOOOOOOXXXXXXXXXXGOOOOOXXXXXXXXXXXXXXGOOXXXXXXXXXXXXXXXXXGOOOOOOXXXXXXXXXXXXXGOOOOOOXXXXXXXXXXXXXGOOOOOOOOOXXXXXXXXXXGOOOOOOOOOOOXXXXXXXXGOOXXXXXXXXXXXXXXXXXGOOOOOXXXXXXXXXXXXXXGOOOOOXXXXXXXXXXXXXXGOOOOOOOOXXXXXXXXXXX,0,600,0
45591,88,0,88,7,405,0,0,414,405,9,GOOXXXXXXXXXXXXXXXXXGOOOOOXXXXXXXXXXXXXXGOOOOOOOOOXXXXXXXXXXGOOOOOXXXXXXXXXXXXXXGOOXXXXXXXXXXXXXXXXXGOOOOOOXXXXXXXXXXXXXGOOOOOOXXXXXXXXXXXXXGOOOOOOOOOXXXXXXXXXXGOOOOOOOOOOOXXXXXXXXGOOXXXXXXXXXXXXXXXXXGOOOOOXXXXXXXXXXXXXXGOOOOOXXXXXXXXXXXXXXGOOOOOOOOXXXXXXXXXXX,0,600,0
45612,88,0,88,8,404,0,0,413,404,9,GOOXXXXXXXXXXXXXXXXXGOOOOOXXXXXXXXXXXXXXGOOOOOOOOOXXXXXXXXXXGOOOOOXXXXXXXXXXXXXXGOOXXXXXXXXXXXXXXXXXGOOOOOOXXXXXXXXXXXXXGOOOOOOXXXXXXXXXXXXXGOOOOOOOOOXXXXXXXXXXGOOOOOOOOOOOXXXXXXXXGOOXXXXXXXXXXXXXXXXXGOOOOOXXXXXXXXXXXXXXGOOOOOXXXXXXXXXXXXXXGOOOOOOOOXXXXXXXXXXX,0,600,0
45633,88,0,88,7,405,0,0,414,405,9,GOOXXXXXXXXXXXXXXXXXGOOOOOXXXXXXXXXXXXXXGOOOOOOOOOXXXXXXXXXXGOOOOOXXXXXXXXXXXXXXGOOXXXXXXXXXXXXXXXXXGOOOOOOXXXXXXXXXXXXXGOOOOOOXXXXXXXXXXXXXGOOOOOOOOOXXXXXXXXXXGOOOOOOOOOOOXXXXXXXXGOOXXXXXXXXXXXXXXXXXGOOOOOXXXXXXXXXXXXXXGOOOOOXXXXXXXXXXXXXXGOOOOOOOOXXXXXXXXXXX,0,600,0
45654,88,0,88,8,404,0,0,413,405,8,GOOXXXXXXXXXXXXXXXXXGOOOOOXXXXXXXXXXXXXXGOOOOOOOOOXXXXXXXXXXGOOOOOXXXXXXXXXXXXXXGOOXXXXXXXXXXXXXXXXXGOOOOOOXXXXXXXXXXXXXGOOOOOOXXXXXXXXXXXXXGOOOOOOOOOXXXXXXXXXXGOOOOOOOOOOOXXXXXXXXGOOXXXXXXXXXXXXXXXXXGOOOOOXXXXXXXXXXXXXXGOOOOOXXXXXXXXXXXXXXGOOOOOOOOXXXXXXXXXXX,0,600,0

45675,88,0,88,8,404,0,0,413,405,8,GOOXXXXXXXXXXXXXXXXXGOOOOOXXXXXXXXXXXXXXGOOOOOOOOOXXXXXXXXXXGOOOOOXXXXXXXXXXXXXXGOOXXXXXXXXXXXXXXXXXGOOOOOOXXXXXXXXXXXXXGOOOOOOXXXXXXXXXXXXXGOOOOOOOOOXXXXXXXXXXGOOOOOOOOOOOXXXXXXXXGOOXXXXXXXXXXXXXXXXXGOOOOOXXXXXXXXXXXXXXGOOOOOXXXXXXXXXXXXXXGOOOOOOOOXXXXXXXXXXX,0,600,0
45696,88,0,88,8,404,0,0,413,405,8,GOOXXXXXXXXXXXXXXXXXGOOOOOXXXXXXXXXXXXXXGOOOOOOOOOXXXXXXXXXXGOOOOOXXXXXXXXXXXXXXGOOXXXXXXXXXXXXXXXXXGOOOOOOXXXXXXXXXXXXXGOOOOOOXXXXXXXXXXXXXGOOOOOOOOOXXXXXXXXXXGOOOOOOOOOOOXXXXXXXXGOOXXXXXXXXXXXXXXXXXGOOOOOXXXXXXXXXXXXXXGOOOOOXXXXXXXXXXXXXXGOOOOOOOOXXXXXXXXXXX,0,600,0
45717,88,0,88,8,404,0,0,413,405,8,GOOXXXXXXXXXXXXXXXXXGOOOOOXXXXXXXXXXXXXXGOOOOOOOOOXXXXXXXXXXGOOOOOXXXXXXXXXXXXXXGOOXXXXXXXXXXXXXXXXXGOOOOOOXXXXXXXXXXXXXGOOOOOOXXXXXXXXXXXXXGOOOOOOOOOXXXXXXXXXXGOOOOOOOOOOOXXXXXXXXGOOXXXXXXXXXXXXXXXXXGOOOOOXXXXXXXXXXXXXXGOOOOOXXXXXXXXXXXXXXGOOOOOOOOXXXXXXXXXXX,0,600,0
45738,88,0,88,7,405,0,0,414,405,9,GOOXXXXXXXXXXXXXXXXXGOOOOOXXXXXXXXXXXXXXGOOOOOOOOOXXXXXXXXXXGOOOOOXXXXXXXXXXXXXXGOOXXXXXXXXXXXXXXXXXGOOOOOOXXXXXXXXXXXXXGOOOOOOXXXXXXXXXXXXXGOOOOOOOOOXXXXXXXXXXGOOOOOOOOOOOXXXXXXXXGOOXXXXXXXXXXXXXXXXXGOOOOOXXXXXXXXXXXXXXGOOOOOXXXXXXXXXXXXXXGOOOOOOOOXXXXXXXXXXX,0,600,0
45759,88,0,88,6,406,0,0,415,405,10,GOOXXXXXXXXXXXXXXXXXGOOOOOXXXXXXXXXXXXXXGOOOOOOOOOXXXXXXXXXXGOOOOOXXXXXXXXXXXXXXGOOXXXXXXXXXXXXXXXXXGOOOOOOXXXXXXXXXXXXXGOOOOOOXXXXXXXXXXXXXGOOOOOOOOOXXXXXXXXXXGOOOOOOOOOOOXXXXXXXXGOOXXXXXXXXXXXXXXXXXGOOOOOXXXXXXXXXXXXXXGOOOOOXXXXXXXXXXXXXXGOOOOOOOOXXXXXXXXXXX,0,600,0

45780,88,0,88,7,405,0,0,414,405,9,GOOXXXXXXXXXXXXXXXXXGOOOOOXXXXXXXXXXXXXXGOOOOOOOOOXXXXXXXXXXGOOOOOXXXXXXXXXXXXXXGOOXXXXXXXXXXXXXXXXXGOOOOOOXXXXXXXXXXXXXGOOOOOOXXXXXXXXXXXXXGOOOOOOOOOXXXXXXXXXXGOOOOOOOOOOOXXXXXXXXGOOXXXXXXXXXXXXXXXXXGOOOOOXXXXXXXXXXXXXXGOOOOOXXXXXXXXXXXXXXGOOOOOOOOXXXXXXXXXXX,0,600,0
45801,88,0,88,7,405,0,0,414,406,8,GOOXXXXXXXXXXXXXXXXXGOOOOOXXXXXXXXXXXXXXGOOOOOOOOOXXXXXXXXXXGOOOOOXXXXXXXXXXXXXXGOOXXXXXXXXXXXXXXXXXGOOOOOOXXXXXXXXXXXXXGOOOOOOXXXXXXXXXXXXXGOOOOOOOOOXXXXXXXXXXGOOOOOOOOOOOXXXXXXXXGOOXXXXXXXXXXXXXXXXXGOOOOOXXXXXXXXXXXXXXGOOOOOXXXXXXXXXXXXXXGOOOOOOOOXXXXXXXXXXX,0,600,0
45822,88,0,88,7,405,0,0,414,405,9,GOOXXXXXXXXXXXXXXXXXGOOOOOXXXXXXXXXXXXXXGOOOOOOOOOXXXXXXXXXXGOOOOOXXXXXXXXXXXXXXGOOXXXXXXXXXXXXXXXXXGOOOOOOXXXXXXXXXXXXXGOOOOOOXXXXXXXXXXXXXGOOOOOOOOOXXXXXXXXXXGOOOOOOOOOOOXXXXXXXXGOOXXXXXXXXXXXXXXXXXGOOOOOXXXXXXXXXXXXXXGOOOOOXXXXXXXXXXXXXXGOOOOOOOOXXXXXXXXXXX,0,600,0
45843,88,0,88,7,405,0,0,414,405,9,GOOXXXXXXXXXXXXXXXXXGOOOOOXXXXXXXXXXXXXXGOOOOOOOOOXXXXXXXXXXGOOOOOXXXXXXXXXXXXXXGOOXXXXXXXXXXXXXXXXXGOOOOOOXXXXXXXXXXXXXGOOOOOOXXXXXXXXXXXXXGOOOOOOOOOXXXXXXXXXXGOOOOOOOOOOOXXXXXXXXGOOXXXXXXXXXXXXXXXXXGOOOOOXXXXXXXXXXXXXXGOOOOOXXXXXXXXXXXXXXGOOOOOOOOXXXXXXXXXXX,0,600,0
45864,88,0,88,6,406,0,0,415,405,10,GOOXXXXXXXXXXXXXXXXXGOOOOOXXXXXXXXXXXXXXGOOOOOOOOOXXXXXXXXXXGOOOOOXXXXXXXXXXXXXXGOOXXXXXXXXXXXXXXXXXGOOOOOOXXXXXXXXXXXXXGOOOOOOXXXXXXXXXXXXXGOOOOOOOOOXXXXXXXXXXGOOOOOOOOOOOXXXXXXXXGOOXXXXXXXXXXXXXXXXXGOOOOOXXXXXXXXXXXXXXGOOOOOXXXXXXXXXXXXXXGOOOOOOOOXXXXXXXXXXX,0,600,0

45885,88,0,88,5,407,0,0,416,405,11,GOOXXXXXXXXXXXXXXXXXGOOOOOXXXXXXXXXXXXXXGOOOOOOOOOXXXXXXXXXXGOOOOOXXXXXXXXXXXXXXGOOXXXXXXXXXXXXXXXXXGOOOOOOXXXXXXXXXXXXXGOOOOOOXXXXXXXXXXXXXGOOOOOOOOOXXXXXXXXXXGOOOOOOOOOOOXXXXXXXXGOOXXXXXXXXXXXXXXXXXGOOOOOXXXXXXXXXXXXXXGOOOOOXXXXXXXXXXXXXXGOOOOOOOOXXXXXXXXXXX,0,600,0
45906,89,1,88,5,406,0,0,415,405,10,GOOXXXXXXXXXXXXXXXXXGOOOOOXXXXXXXXXXXXXXGOOOOOOOOOXXXXXXXXXXGOOOOOXXXXXXXXXXXXXXGOOXXXXXXXXXXXXXXXXXGOOOOOOXXXXXXXXXXXXXGOOOOOOXXXXXXXXXXXXXGOOOOOOOOOXXXXXXXXXXGOOOOOOOOOOOXXXXXXXXGOOXXXXXXXXXXXXXXXXXGOOOOOAXXXXXXXXXXXXXGOOOOOXXXXXXXXXXXXXXGOOOOOOOOXXXXXXXXXXX,0,600,0
45927,89,1,88,7,404,0,0,413,405,8,GOOXXXXXXXXXXXXXXXXXGOOOOOXXXXXXXXXXXXXXGOOOOOOOOOXXXXXXXXXXGOOOOOXXXXXXXXXXXXXXGOOXXXXXXXXXXXXXXXXXGOOOOOOXXXXXXXXXXXXXGOOOOOOXXXXXXXXXXXXXGOOOOOOOOOXXXXXXXXXXGOOOOOOOOOOOXXXXXXXXGOOXXXXXXXXXXXXXXXXXGOOOOOAXXXXXXXXXXXXXGOOOOOXXXXXXXXXXXXXXGOOOOOOOOXXXXXXXXXXX,0,600,0
45948,89,1,88,5,406,0,0,415,405,10,GOOXXXXXXXXXXXXXXXXXGOOOOOXXXXXXXXXXXXXXGOOOOOOOOOXXXXXXXXXXGOOOOOXXXXXXXXXXXXXXGOOXXXXXXXXXXXXXXXXXGOOOOOOXXXXXXXXXXXXXGOOOOOOXXXXXXXXXXXXXGOOOOOOOOOXXXXXXXXXXGOOOOOOOOOOOXXXXXXXXGOOXXXXXXXXXXXXXXXXXGOOOOOAXXXXXXXXXXXXXGOOOOOXXXXXXXXXXXXXXGOOOOOOOOXXXXXXXXXXX,0,600,0
45969,89,1,88,4,407,0,0,416,405,11,GOOXXXXXXXXXXXXXXXXXGOOOOOXXXXXXXXXXXXXXGOOOOOOOOOXXXXXXXXXXGOOOOOXXXXXXXXXXXXXXGOOXXXXXXXXXXXXXXXXXGOOOOOOXXXXXXXXXXXXXGOOOOOOXXXXXXXXXXXXXGOOOOOOOOOXXXXXXXXXXGOOOOOOOOOOOXXXXXXXXGOOXXXXXXXXXXXXXXXXXGOOOOOAXXXXXXXXXXXXXGOOOOOXXXXXXXXXXXXXXGOOOOOOOOXXXXXXXXXXX,0,600,0

45990,89,1,88,4,407,0,0,416,405,11,GOOXXXXXXXXXXXXXXXXXGOOOOOXXXXXXXXXXXXXXGOOOOOOOOOXXXXXXXXXXGOOOOOXXXXXXXXXXXXXXGOOXXXXXXXXXXXXXXXXXGOOOOOOXXXXXXXXXXXXXGOOOOOOXXXXXXXXXXXXXGOOOOOOOOOXXXXXXXXXXGOOOOOOOOOOOXXXXXXXXGOOXXXXXXXXXXXXXXXXXGOOOOOAXXXXXXXXXXXXXGOOOOOXXXXXXXXXXXXXXGOOOOOOOOXXXXXXXXXXX,0,600,0
46011,89,1,88,4,407,0,0,416,405,11,GOOXXXXXXXXXXXXXXXXXGOOOOOXXXXXXXXXXXXXXGOOOOOOOOOXXXXXXXXXXGOOOOOXXXXXXXXXXXXXXGOOXXXXXXXXXXXXXXXXXGOOOOOOXXXXXXXXXXXXXGOOOOOOXXXXXXXXXXXXXGOOOOOOOOOXXXXXXXXXXGOOOOOOOOOOOXXXXXXXXGOOXXXXXXXXXXXXXXXXXGOOOOOAXXXXXXXXXXXXXGOOOOOXXXXXXXXXXXXXXGOOOOOOOOXXXXXXXXXXX,0,600,0
46032,89,1,88,4,407,0,0,416,405,11,GOOXXXXXXXXXXXXXXXXXGOOOOOXXXXXXXXXXXXXXGOOOOOOOOOXXXXXXXXXXGOOOOOXXXXXXXXXXXXXXGOOXXXXXXXXXXXXXXXXXGOOOOOOXXXXXXXXXXXXXGOOOOOOXXXXXXXXXXXXXGOOOOOOOOOXXXXXXXXXXGOOOOOOOOOOOXXXXXXXXGOOXXXXXXXXXXXXXXXXXGOOOOOAXXXXXXXXXXXXXGOOOOOXXXXXXXXXXXXXXGOOOOOOOOXXXXXXXXXXX,0,600,0
46053,89,1,88,4,407,0,0,416,406,10,GOOXXXXXXXXXXXXXXXXXGOOOOOXXXXXXXXXXXXXXGOOOOOOOOOXXXXXXXXXXGOOOOOXXXXXXXXXXXXXXGOOXXXXXXXXXXXXXXXXXGOOOOOOXXXXXXXXXXXXXGOOOOOOXXXXXXXXXXXXXGOOOOOOOOOXXXXXXXXXXGOOOOOOOOOOOXXXXXXXXGOOXXXXXXXXXXXXXXXXXGOOOOOAXXXXXXXXXXXXXGOOOOOXXXXXXXXXXXXXXGOOOOOOOOXXXXXXXXXXX,0,600,0
46074,89,1,88,5,406,0,0,415,406,9,GOOXXXXXXXXXXXXXXXXXGOOOOOXXXXXXXXXXXXXXGOOOOOOOOOXXXXXXXXXXGOOOOOXXXXXXXXXXXXXXGOOXXXXXXXXXXXXXXXXXGOOOOOOXXXXXXXXXXXXXGOOOOOOXXXXXXXXXXXXXGOOOOOOOOOXXXXXXXXXXGOOOOOOOOOOOXXXXXXXXGOOXXXXXXXXXXXXXXXXXGOOOOOAXXXXXXXXXXXXXGOOOOOXXXXXXXXXXXXXXGOOOOOOOOXXXXXXXXXXX,0,600,0

46095,89,1,88,6,405,0,0,414,405,9,GOOXXXXXXXXXXXXXXXXXGOOOOOXXXXXXXXXXXXXXGOOOOOOOOOXXXXXXXXXXGOOOOOXXXXXXXXXXXXXXGOOXXXXXXXXXXXXXXXXXGOOOOOOXXXXXXXXXXXXXGOOOOOOXXXXXXXXXXXXXGOOOOOOOOOXXXXXXXXXXGOOOOOOOOOOOXXXXXXXXGOOXXXXXXXXXXXXXXXXXGOOOOOAXXXXXXXXXXXXXGOOOOOXXXXXXXXXXXXXXGOOOOOOOOXXXXXXXXXXX,0,600,0
46116,89,1,88,7,404,0,0,413,405,8,GOOXXXXXXXXXXXXXXXXXGOOOOOXXXXXXXXXXXXXXGOOOOOOOOOXXXXXXXXXXGOOOOOXXXXXXXXXXXXXXGOOXXXXXXXXXXXXXXXXXGOOOOOOXXXXXXXXXXXXXGOOOOOOXXXXXXXXXXXXXGOOOOOOOOOXXXXXXXXXXGOOOOOOOOOOOXXXXXXXXGOOXXXXXXXXXXXXXXXXXGOOOOOAXXXXXXXXXXXXXGOOOOOXXXXXXXXXXXXXXGOOOOOOOOXXXXXXXXXXX,0,600,0
46137,89,0,89,7,404,0,0,413,405,8,GOOXXXXXXXXXXXXXXXXXGOOOOOXXXXXXXXXXXXXXGOOOOOOOOOXXXXXXXXXXGOOOOOXXXXXXXXXXXXXXGOOXXXXXXXXXXXXXXXXXGOOOOOOXXXXXXXXXXXXXGOOOOOOXXXXXXXXXXXXXGOOOOOOOOOXXXXXXXXXXGOOOOOOOOOOOXXXXXXXXGOOXXXXXXXXXXXXXXXXXGOOOOOOXXXXXXXXXXXXXGOOOOOXXXXXXXXXXXXXXGOOOOOOOOXXXXXXXXXXX,0,600,0
46158,89,0,89,6,405,0,0,413,406,7,GOOXXXXXXXXXXXXXXXXXGOOOOOXXXXXXXXXXXXXXGOOOOOOOOOXXXXXXXXXXGOOOOOXXXXXXXXXXXXXXGOOXXXXXXXXXXXXXXXXXGOOOOOOXXXXXXXXXXXXXGOOOOOOXXXXXXXXXXXXXGOOOOOOOOOXXXXXXXXXXGOOOOOOOOOOOXXXXXXXXGOOXXXXXXXXXXXXXXXXXGOOOOOOXXXXXXXXXXXXXGOOOOOXXXXXXXXXXXXXXGOOOOOOOOXXXXXXXXXXX,0,600,0
46179,89,0,89,7,404,0,0,413,405,8,GOOXXXXXXXXXXXXXXXXXGOOOOOXXXXXXXXXXXXXXGOOOOOOOOOXXXXXXXXXXGOOOOOXXXXXXXXXXXXXXGOOXXXXXXXXXXXXXXXXXGOOOOOOXXXXXXXXXXXXXGOOOOOOXXXXXXXXXXXXXGOOOOOOOOOXXXXXXXXXXGOOOOOOOOOOOXXXXXXXXGOOXXXXXXXXXXXXXXXXXGOOOOOOXXXXXXXXXXXXXGOOOOOXXXXXXXXXXXXXXGOOOOOOOOXXXXXXXXXXX,0,600,0

46200,89,0,89,8,403,0,0,412,406,6,GOOXXXXXXXXXXXXXXXXXGOOOOOXXXXXXXXXXXXXXGOOOOOOOOOXXXXXXXXXXGOOOOOXXXXXXXXXXXXXXGOOXXXXXXXXXXXXXXXXXGOOOOOOXXXXXXXXXXXXXGOOOOOOXXXXXXXXXXXXXGOOOOOOOOOXXXXXXXXXXGOOOOOOOOOOOXXXXXXXXGOOXXXXXXXXXXXXXXXXXGOOOOOOXXXXXXXXXXXXXGOOOOOXXXXXXXXXXXXXXGOOOOOOOOXXXXXXXXXXX,0,600,0
46221,89,0,89,6,405,0,0,413,406,7,GOOXXXXXXXXXXXXXXXXXGOOOOOXXXXXXXXXXXXXXGOOOOOOOOOXXXXXXXXXXGOOOOOXXXXXXXXXXXXXXGOOXXXXXXXXXXXXXXXXXGOOOOOOXXXXXXXXXXXXXGOOOOOOXXXXXXXXXXXXXGOOOOOOOOOXXXXXXXXXXGOOOOOOOOOOOXXXXXXXXGOOXXXXXXXXXXXXXXXXXGOOOOOOXXXXXXXXXXXXXGOOOOOXXXXXXXXXXXXXXGOOOOOOOOXXXXXXXXXXX,0,600,0
46242,89,0,89,6,405,0,0,414,406,8,GOOXXXXXXXXXXXXXXXXXGOOOOOXXXXXXXXXXXXXXGOOOOOOOOOXXXXXXXXXXGOOOOOXXXXXXXXXXXXXXGOOXXXXXXXXXXXXXXXXXGOOOOOOXXXXXXXXXXXXXGOOOOOOXXXXXXXXXXXXXGOOOOOOOOOXXXXXXXXXXGOOOOOOOOOOOXXXXXXXXGOOXXXXXXXXXXXXXXXXXGOOOOOOXXXXXXXXXXXXXGOOOOOXXXXXXXXXXXXXXGOOOOOOOOXXXXXXXXXXX,0,600,0
46263,89,0,89,7,404,0,0,413,405,8,GOOXXXXXXXXXXXXXXXXXGOOOOOXXXXXXXXXXXXXXGOOOOOOOOOXXXXXXXXXXGOOOOOXXXXXXXXXXXXXXGOOXXXXXXXXXXXXXXXXXGOOOOOOXXXXXXXXXXXXXGOOOOOOXXXXXXXXXXXXXGOOOOOOOOOXXXXXXXXXXGOOOOOOOOOOOXXXXXXXXGOOXXXXXXXXXXXXXXXXXGOOOOOOXXXXXXXXXXXXXGOOOOOXXXXXXXXXXXXXXGOOOOOOOOXXXXXXXXXXX,0,600,0
46284,89,0,89,6,405,0,0,414,405,9,GOOXXXXXXXXXXXXXXXXXGOOOOOXXXXXXXXXXXXXXGOOOOOOOOOXXXXXXXXXXGOOOOOXXXXXXXXXXXXXXGOOXXXXXXXXXXXXXXXXXGOOOOOOXXXXXXXXXXXXXGOOOOOOXXXXXXXXXXXXXGOOOOOOOOOXXXXXXXXXXGOOOOOOOOOOOXXXXXXXXGOOXXXXXXXXXXXXXXXXXGOOOOOOXXXXXXXXXXXXXGOOOOOXXXXXXXXXXXXXXGOOOOOOOOXXXXXXXXXXX,0,600,0

46305,89,0,89,5,406,0,0,415,406,9,GOOXXXXXXXXXXXXXXXXXGOOOOOXXXXXXXXXXXXXXGOOOOOOOOOXXXXXXXXXXGOOOOOXXXXXXXXXXXXXXGOOXXXXXXXXXXXXXXXXXGOOOOOOXXXXXXXXXXXXXGOOOOOOXXXXXXXXXXXXXGOOOOOOOOOXXXXXXXXXXGOOOOOOOOOOOXXXXXXXXGOOXXXXXXXXXXXXXXXXXGOOOOOOXXXXXXXXXXXXXGOOOOOXXXXXXXXXXXXXXGOOOOOOOOXXXXXXXXXXX,0,600,0
46326,89,0,89,6,405,0,0,414,405,9,GOOXXXXXXXXXXXXXXXXXGOOOOOXXXXXXXXXXXXXXGOOOOOOOOOXXXXXXXXXXGOOOOOXXXXXXXXXXXXXXGOOXXXXXXXXXXXXXXXXXGOOOOOOXXXXXXXXXXXXXGOOOOOOXXXXXXXXXXXXXGOOOOOOOOOXXXXXXXXXXGOOOOOOOOOOOXXXXXXXXGOOXXXXXXXXXXXXXXXXXGOOOOOOXXXXXXXXXXXXXGOOOOOXXXXXXXXXXXXXXGOOOOOOOOXXXXXXXXXXX,0,600,0
46347,89,0,89,5,406,0,0,415,405,10,GOOXXXXXXXXXXXXXXXXXGOOOOOXXXXXXXXXXXXXXGOOOOOOOOOXXXXXXXXXXGOOOOOXXXXXXXXXXXXXXGOOXXXXXXXXXXXXXXXXXGOOOOOOXXXXXXXXXXXXXGOOOOOOXXXXXXXXXXXXXGOOOOOOOOOXXXXXXXXXXGOOOOOOOOOOOXXXXXXXXGOOXXXXXXXXXXXXXXXXXGOOOOOOXXXXXXXXXXXXXGOOOOOXXXXXXXXXXXXXXGOOOOOOOOXXXXXXXXXXX,0,600,0
46368,89,0,89,5,406,0,0,415,405,10,GOOXXXXXXXXXXXXXXXXXGOOOOOXXXXXXXXXXXXXXGOOOOOOOOOXXXXXXXXXXGOOOOOXXXXXXXXXXXXXXGOOXXXXXXXXXXXXXXXXXGOOOOOOXXXXXXXXXXXXXGOOOOOOXXXXXXXXXXXXXGOOOOOOOOOXXXXXXXXXXGOOOOOOOOOOOXXXXXXXXGOOXXXXXXXXXXXXXXXXXGOOOOOOXXXXXXXXXXXXXGOOOOOXXXXXXXXXXXXXXGOOOOOOOOXXXXXXXXXXX,0,600,0
46389,89,0,89,4,407,0,0,415,405,10,GOOXXXXXXXXXXXXXXXXXGOOOOOXXXXXXXXXXXXXXGOOOOOOOOOXXXXXXXXXXGOOOOOXXXXXXXXXXXXXXGOOXXXXXXXXXXXXXXXXXGOOOOOOXXXXXXXXXXXXXGOOOOOOXXXXXXXXXXXXXGOOOOOOOOOXXXXXXXXXXGOOOOOOOOOOOXXXXXXXXGOOXXXXXXXXXXXXXXXXXGOOOOOOXXXXXXXXXXXXXGOOOOOXXXXXXXXXXXXXXGOOOOOOOOXXXXXXXXXXX,0,600,0

46410,89,0,89,4,407,0,0,416,405,11,GOOXXXXXXXXXXXXXXXXXGOOOOOXXXXXXXXXXXXXXGOOOOOOOOOXXXXXXXXXXGOOOOOXXXXXXXXXXXXXXGOOXXXXXXXXXXXXXXXXXGOOOOOOXXXXXXXXXXXXXGOOOOOOXXXXXXXXXXXXXGOOOOOOOOOXXXXXXXXXXGOOOOOOOOOOOXXXXXXXXGOOXXXXXXXXXXXXXXXXXGOOOOOOXXXXXXXXXXXXXGOOOOOXXXXXXXXXXXXXXGOOOOOOOOXXXXXXXXXXX,0,600,0
46431,89,0,89,6,405,0,0,414,406,8,GOOXXXXXXXXXXXXXXXXXGOOOOOXXXXXXXXXXXXXXGOOOOOOOOOXXXXXXXXXXGOOOOOXXXXXXXXXXXXXXGOOXXXXXXXXXXXXXXXXXGOOOOOOXXXXXXXXXXXXXGOOOOOOXXXXXXXXXXXXXGOOOOOOOOOXXXXXXXXXXGOOOOOOOOOOOXXXXXXXXGOOXXXXXXXXXXXXXXXXXGOOOOOOXXXXXXXXXXXXXGOOOOOXXXXXXXXXXXXXXGOOOOOOOOXXXXXXXXXXX,0,600,0
46452,89,0,89,7,404,0,0,413,405,8,GOOXXXXXXXXXXXXXXXXXGOOOOOXXXXXXXXXXXXXXGOOOOOOOOOXXXXXXXXXXGOOOOOXXXXXXXXXXXXXXGOOXXXXXXXXXXXXXXXXXGOOOOOOXXXXXXXXXXXXXGOOOOOOXXXXXXXXXXXXXGOOOOOOOOOXXXXXXXXXXGOOOOOOOOOOOXXXXXXXXGOOXXXXXXXXXXXXXXXXXGOOOOOOXXXXXXXXXXXXXGOOOOOXXXXXXXXXXXXXXGOOOOOOOOXXXXXXXXXXX,0,600,0
46473,89,0,89,4,407,0,0,416,405,11,GOOXXXXXXXXXXXXXXXXXGOOOOOXXXXXXXXXXXXXXGOOOOOOOOOXXXXXXXXXXGOOOOOXXXXXXXXXXXXXXGOOXXXXXXXXXXXXXXXXXGOOOOOOXXXXXXXXXXXXXGOOOOOOXXXXXXXXXXXXXGOOOOOOOOOXXXXXXXXXXGOOOOOOOOOOOXXXXXXXXGOOXXXXXXXXXXXXXXXXXGOOOOOOXXXXXXXXXXXXXGOOOOOXXXXXXXXXXXXXXGOOOOOOOOXXXXXXXXXXX,0,600,0
46494,89,0,89,3,408,0,0,417,406,11,GOOXXXXXXXXXXXXXXXXXGOOOOOXXXXXXXXXXXXXXGOOOOOOOOOXXXXXXXXXXGOOOOOXXXXXXXXXXXXXXGOOXXXXXXXXXXXXXXXXXGOOOOOOXXXXXXXXXXXXXGOOOOOOXXXXXXXXXXXXXGOOOOOOOOOXXXXXXXXXXGOOOOOOOOOOOXXXXXXXXGOOXXXXXXXXXXXXXXXXXGOOOOOOXXXXXXXXXXXXXGOOOOOXXXXXXXXXXXXXXGOOOOOOOOXXXXXXXXXXX,0,600,0

46515,89,0,89,4,407,0,0,416,406,10,GOOXXXXXXXXXXXXXXXXXGOOOOOXXXXXXXXXXXXXXGOOOOOOOOOXXXXXXXXXXGOOOOOXXXXXXXXXXXXXXGOOXXXXXXXXXXXXXXXXXGOOOOOOXXXXXXXXXXXXXGOOOOOOXXXXXXXXXXXXXGOOOOOOOOOXXXXXXXXXXGOOOOOOOOOOOXXXXXXXXGOOXXXXXXXXXXXXXXXXXGOOOOOOXXXXXXXXXXXXXGOOOOOXXXXXXXXXXXXXXGOOOOOOOOXXXXXXXXXXX,0,600,0
46536,89,0,89,3,408,0,0,417,405,12,GOOXXXXXXXXXXXXXXXXXGOOOOOXXXXXXXXXXXXXXGOOOOOOOOOXXXXXXXXXXGOOOOOXXXXXXXXXXXXXXGOOXXXXXXXXXXXXXXXXXGOOOOOOXXXXXXXXXXXXXGOOOOOOXXXXXXXXXXXXXGOOOOOOOOOXXXXXXXXXXGOOOOOOOOOOOXXXXXXXXGOOXXXXXXXXXXXXXXXXXGOOOOOOXXXXXXXXXXXXXGOOOOOXXXXXXXXXXXXXXGOOOOOOOOXXXXXXXXXXX,0,600,0
46557,89,0,89,2,409,0,0,418,405,13,GOOXXXXXXXXXXXXXXXXXGOOOOOXXXXXXXXXXXXXXGOOOOOOOOOXXXXXXXXXXGOOOOOXXXXXXXXXXXXXXGOOXXXXXXXXXXXXXXXXXGOOOOOOXXXXXXXXXXXXXGOOOOOOXXXXXXXXXXXXXGOOOOOOOOOXXXXXXXXXXGOOOOOOOOOOOXXXXXXXXGOOXXXXXXXXXXXXXXXXXGOOOOOOXXXXXXXXXXXXXGOOOOOXXXXXXXXXXXXXXGOOOOOOOOXXXXXXXXXXX,0,600,0
46578,89,0,89,2,409,0,0,418,405,13,GOOXXXXXXXXXXXXXXXXXGOOOOOXXXXXXXXXXXXXXGOOOOOOOOOXXXXXXXXXXGOOOOOXXXXXXXXXXXXXXGOOXXXXXXXXXXXXXXXXXGOOOOOOXXXXXXXXXXXXXGOOOOOOXXXXXXXXXXXXXGOOOOOOOOOXXXXXXXXXXGOOOOOOOOOOOXXXXXXXXGOOXXXXXXXXXXXXXXXXXGOOOOOOXXXXXXXXXXXXXGOOOOOXXXXXXXXXXXXXXGOOOOOOOOXXXXXXXXXXX,0,600,0
46599,89,0,89,2,409,0,0,418,405,13,GOOXXXXXXXXXXXXXXXXXGOOOOOXXXXXXXXXXXXXXGOOOOOOOOOXXXXXXXXXXGOOOOOXXXXXXXXXXXXXXGOOXXXXXXXXXXXXXXXXXGOOOOOOXXXXXXXXXXXXXGOOOOOOXXXXXXXXXXXXXGOOOOOOOOOXXXXXXXXXXGOOOOOOOOOOOXXXXXXXXGOOXXXXXXXXXXXXXXXXXGOOOOOOXXXXXXXXXXXXXGOOOOOXXXXXXXXXXXXXXGOOOOOOOOXXXXXXXXXXX,0,600,0

46620,89,0,89,2,409,0,0,418,405,13,GOOXXXXXXXXXXXXXXXXXGOOOOOXXXXXXXXXXXXXXGOOOOOOOOOXXXXXXXXXXGOOOOOXXXXXXXXXXXXXXGOOXXXXXXXXXXXXXXXXXGOOOOOOXXXXXXXXXXXXXGOOOOOOXXXXXXXXXXXXXGOOOOOOOOOXXXXXXXXXXGOOOOOOOOOOOXXXXXXXXGOOXXXXXXXXXXXXXXXXXGOOOOOOXXXXXXXXXXXXXGOOOOOXXXXXXXXXXXXXXGOOOOOOOOXXXXXXXXXXX,0,600,0
46641,89,0,89,2,409,0,0,418,406,12,GOOXXXXXXXXXXXXXXXXXGOOOOOXXXXXXXXXXXXXXGOOOOOOOOOXXXXXXXXXXGOOOOOXXXXXXXXXXXXXXGOOXXXXXXXXXXXXXXXXXGOOOOOOXXXXXXXXXXXXXGOOOOOOXXXXXXXXXXXXXGOOOOOOOOOXXXXXXXXXXGOOOOOOOOOOOXXXXXXXXGOOXXXXXXXXXXXXXXXXXGOOOOOOXXXXXXXXXXXXXGOOOOOXXXXXXXXXXXXXXGOOOOOOOOXXXXXXXXXXX,0,600,0
46662,89,0,89,3,408,0,0,417,406,11,GOOXXXXXXXXXXXXXXXXXGOOOOOXXXXXXXXXXXXXXGOOOOOOOOOXXXXXXXXXXGOOOOOXXXXXXXXXXXXXXGOOXXXXXXXXXXXXXXXXXGOOOOOOXXXXXXXXXXXXXGOOOOOOXXXXXXXXXXXXXGOOOOOOOOOXXXXXXXXXXGOOOOOOOOOOOXXXXXXXXGOOXXXXXXXXXXXXXXXXXGOOOOOOXXXXXXXXXXXXXGOOOOOXXXXXXXXXXXXXXGOOOOOOOOXXXXXXXXXXX,0,600,0
46683,89,0,89,4,407,0,0,416,406,10,GOOXXXXXXXXXXXXXXXXXGOOOOOXXXXXXXXXXXXXXGOOOOOOOOOXXXXXXXXXXGOOOOOXXXXXXXXXXXXXXGOOXXXXXXXXXXXXXXXXXGOOOOOOXXXXXXXXXXXXXGOOOOOOXXXXXXXXXXXXXGOOOOOOOOOXXXXXXXXXXGOOOOOOOOOOOXXXXXXXXGOOXXXXXXXXXXXXXXXXXGOOOOOOXXXXXXXXXXXXXGOOOOOXXXXXXXXXXXXXXGOOOOOOOOXXXXXXXXXXX,0,600,0
46704,89,0,89,5,406,0,0,414,406,8,GOOXXXXXXXXXXXXXXXXXGOOOOOXXXXXXXXXXXXXXGOOOOOOOOOXXXXXXXXXXGOOOOOXXXXXXXXXXXXXXGOOXXXXXXXXXXXXXXXXXGOOOOOOXXXXXXXXXXXXXGOOOOOOXXXXXXXXXXXXXGOOOOOOOOOXXXXXXXXXXGOOOOOOOOOOOXXXXXXXXGOOXXXXXXXXXXXXXXXXXGOOOOOOXXXXXXXXXXXXXGOOOOOXXXXXXXXXXXXXXGOOOOOOOOXXXXXXXXXXX,0,600,0

46725,89,0,89,7,404,0,0,413,405,8,GOOXXXXXXXXXXXXXXXXXGOOOOOXXXXXXXXXXXXXXGOOOOOOOOOXXXXXXXXXXGOOOOOXXXXXXXXXXXXXXGOOXXXXXXXXXXXXXXXXXGOOOOOOXXXXXXXXXXXXXGOOOOOOXXXXXXXXXXXXXGOOOOOOOOOXXXXXXXXXXGOOOOOOOOOOOXXXXXXXXGOOXXXXXXXXXXXXXXXXXGOOOOOOXXXXXXXXXXXXXGOOOOOXXXXXXXXXXXXXXGOOOOOOOOXXXXXXXXXXX,0,600,0
46746,89,0,89,7,404,0,0,413,405,8,GOOXXXXXXXXXXXXXXXXXGOOOOOXXXXXXXXXXXXXXGOOOOOOOOOXXXXXXXXXXGOOOOOXXXXXXXXXXXXXXGOOXXXXXXXXXXXXXXXXXGOOOOOOXXXXXXXXXXXXXGOOOOOOXXXXXXXXXXXXXGOOOOOOOOOXXXXXXXXXXGOOOOOOOOOOOXXXXXXXXGOOXXXXXXXXXXXXXXXXXGOOOOOOXXXXXXXXXXXXXGOOOOOXXXXXXXXXXXXXXGOOOOOOOOXXXXXXXXXXX,0,600,0
46767,89,0,89,6,405,0,0,414,406,8,GOOXXXXXXXXXXXXXXXXXGOOOOOXXXXXXXXXXXXXXGOOOOOOOOOXXXXXXXXXXGOOOOOXXXXXXXXXXXXXXGOOXXXXXXXXXXXXXXXXXGOOOOOOXXXXXXXXXXXXXGOOOOOOXXXXXXXXXXXXXGOOOOOOOOOXXXXXXXXXXGOOOOOOOOOOOXXXXXXXXGOOXXXXXXXXXXXXXXXXXGOOOOOOXXXXXXXXXXXXXGOOOOOXXXXXXXXXXXXXXGOOOOOOOOXXXXXXXXXXX,0,600,0
46788,89,0,89,6,405,0,0,414,406,8,GOOXXXXXXXXXXXXXXXXXGOOOOOXXXXXXXXXXXXXXGOOOOOOOOOXXXXXXXXXXGOOOOOXXXXXXXXXXXXXXGOOXXXXXXXXXXXXXXXXXGOOOOOOXXXXXXXXXXXXXGOOOOOOXXXXXXXXXXXXXGOOOOOOOOOXXXXXXXXXXGOOOOOOOOOOOXXXXXXXXGOOXXXXXXXXXXXXXXXXXGOOOOOOXXXXXXXXXXXXXGOOOOOXXXXXXXXXXXXXXGOOOOOOOOXXXXXXXXXXX,0,600,0
46809,89,0,89,5,406,0,0,415,405,10,GOOXXXXXXXXXXXXXXXXXGOOOOOXXXXXXXXXXXXXXGOOOOOOOOOXXXXXXXXXXGOOOOOXXXXXXXXXXXXXXGOOXXXXXXXXXXXXXXXXXGOOOOOOXXXXXXXXXXXXXGOOOOOOXXXXXXXXXXXXXGOOOOOOOOOXXXXXXXXXXGOOOOOOOOOOOXXXXXXXXGOOXXXXXXXXXXXXXXXXXGOOOOOOXXXXXXXXXXXXXGOOOOOXXXXXXXXXXXXXXGOOOOOOOOXXXXXXXXXXX,0,600,0

46830,89,0,89,5,406,0,0,415,405,10,GOOXXXXXXXXXXXXXXXXXGOOOOOXXXXXXXXXXXXXXGOOOOOOOOOXXXXXXXXXXGOOOOOXXXXXXXXXXXXXXGOOXXXXXXXXXXXXXXXXXGOOOOOOXXXXXXXXXXXXXGOOOOOOXXXXXXXXXXXXXGOOOOOOOOOXXXXXXXXXXGOOOOOOOOOOOXXXXXXXXGOOXXXXXXXXXXXXXXXXXGOOOOOOXXXXXXXXXXXXXGOOOOOXXXXXXXXXXXXXXGOOOOOOOOXXXXXXXXXXX,0,600,0
46851,89,0,89,4,407,0,0,416,405,11,GOOXXXXXXXXXXXXXXXXXGOOOOOXXXXXXXXXXXXXXGOOOOOOOOOXXXXXXXXXXGOOOOOXXXXXXXXXXXXXXGOOXXXXXXXXXXXXXXXXXGOOOOOOXXXXXXXXXXXXXGOOOOOOXXXXXXXXXXXXXGOOOOOOOOOXXXXXXXXXXGOOOOOOOOOOOXXXXXXXXGOOXXXXXXXXXXXXXXXXXGOOOOOOXXXXXXXXXXXXXGOOOOOXXXXXXXXXXXXXXGOOOOOOOOXXXXXXXXXXX,0,600,0
46872,89,0,89,4,407,0,0,416,406,10,GOOXXXXXXXXXXXXXXXXXGOOOOOXXXXXXXXXXXXXXGOOOOOOOOOXXXXXXXXXXGOOOOOXXXXXXXXXXXXXXGOOXXXXXXXXXXXXXXXXXGOOOOOOXXXXXXXXXXXXXGOOOOOOXXXXXXXXXXXXXGOOOOOOOOOXXXXXXXXXXGOOOOOOOOOOOXXXXXXXXGOOXXXXXXXXXXXXXXXXXGOOOOOOXXXXXXXXXXXXXGOOOOOXXXXXXXXXXXXXXGOOOOOOOOXXXXXXXXXXX,0,600,0
46893,89,0,89,5,406,0,0,415,405,10,GOOXXXXXXXXXXXXXXXXXGOOOOOXXXXXXXXXXXXXXGOOOOOOOOOXXXXXXXXXXGOOOOOXXXXXXXXXXXXXXGOOXXXXXXXXXXXXXXXXXGOOOOOOXXXXXXXXXXXXXGOOOOOOXXXXXXXXXXXXXGOOOOOOOOOXXXXXXXXXXGOOOOOOOOOOOXXXXXXXXGOOXXXXXXXXXXXXXXXXXGOOOOOOXXXXXXXXXXXXXGOOOOOXXXXXXXXXXXXXXGOOOOOOOOXXXXXXXXXXX,0,600,0
46914,89,0,89,6,405,0,0,414,405,9,GOOXXXXXXXXXXXXXXXXXGOOOOOXXXXXXXXXXXXXXGOOOOOOOOOXXXXXXXXXXGOOOOOXXXXXXXXXXXXXXGOOXXXXXXXXXXXXXXXXXGOOOOOOXXXXXXXXXXXXXGOOOOOOXXXXXXXXXXXXXGOOOOOOOOOXXXXXXXXXXGOOOOOOOOOOOXXXXXXXXGOOXXXXXXXXXXXXXXXXXGOOOOOOXXXXXXXXXXXXXGOOOOOXXXXXXXXXXXXXXGOOOOOOOOXXXXXXXXXXX,0,600,0

46935,89,0,89,7,404,0,0,413,405,8,GOOXXXXXXXXXXXXXXXXXGOOOOOXXXXXXXXXXXXXXGOOOOOOOOOXXXXXXXXXXGOOOOOXXXXXXXXXXXXXXGOOXXXXXXXXXXXXXXXXXGOOOOOOXXXXXXXXXXXXXGOOOOOOXXXXXXXXXXXXXGOOOOOOOOOXXXXXXXXXXGOOOOOOOOOOOXXXXXXXXGOOXXXXXXXXXXXXXXXXXGOOOOOOXXXXXXXXXXXXXGOOOOOXXXXXXXXXXXXXXGOOOOOOOOXXXXXXXXXXX,0,600,0
46956,89,0,89,7,404,0,0,413,405,8,GOOXXXXXXXXXXXXXXXXXGOOOOOXXXXXXXXXXXXXXGOOOOOOOOOXXXXXXXXXXGOOOOOXXXXXXXXXXXXXXGOOXXXXXXXXXXXXXXXXXGOOOOOOXXXXXXXXXXXXXGOOOOOOXXXXXXXXXXXXXGOOOOOOOOOXXXXXXXXXXGOOOOOOOOOOOXXXXXXXXGOOXXXXXXXXXXXXXXXXXGOOOOOOXXXXXXXXXXXXXGOOOOOXXXXXXXXXXXXXXGOOOOOOOOXXXXXXXXXXX,0,600,0
46977,89,0,89,6,405,0,0,415,405,10,GOOXXXXXXXXXXXXXXXXXGOOOOOXXXXXXXXXXXXXXGOOOOOOOOOXXXXXXXXXXGOOOOOXXXXXXXXXXXXXXGOOXXXXXXXXXXXXXXXXXGOOOOOOXXXXXXXXXXXXXGOOOOOOXXXXXXXXXXXXXGOOOOOOOOOXXXXXXXXXXGOOOOOOOOOOOXXXXXXXXGOOXXXXXXXXXXXXXXXXXGOOOOOOXXXXXXXXXXXXXGOOOOOXXXXXXXXXXXXXXGOOOOOOOOXXXXXXXXXXX,0,600,0
46998,89,0,89,5,406,0,0,416,405,11,GOOXXXXXXXXXXXXXXXXXGOOOOOXXXXXXXXXXXXXXGOOOOOOOOOXXXXXXXXXXGOOOOOXXXXXXXXXXXXXXGOOXXXXXXXXXXXXXXXXXGOOOOOOXXXXXXXXXXXXXGOOOOOOXXXXXXXXXXXXXGOOOOOOOOOXXXXXXXXXXGOOOOOOOOOOOXXXXXXXXGOOXXXXXXXXXXXXXXXXXGOOOOOOXXXXXXXXXXXXXGOOOOOXXXXXXXXXXXXXXGOOOOOOOOXXXXXXXXXXX,0,600,0
47019,89,0,89,6,405,0,0,415,406,9,GOOXXXXXXXXXXXXXXXXXGOOOOOXXXXXXXXXXXXXXGOOOOOOOOOXXXXXXXXXXGOOOOOXXXXXXXXXXXXXXGOOXXXXXXXXXXXXXXXXXGOOOOOOXXXXXXXXXXXXXGOOOOOOXXXXXXXXXXXXXGOOOOOOOOOXXXXXXXXXXGOOOOOOOOOOOXXXXXXXXGOOXXXXXXXXXXXXXXXXXGOOOOOOXXXXXXXXXXXXXGOOOOOXXXXXXXXXXXXXXGOOOOOOOOXXXXXXXXXXX,0,600,0

47040,89,0,89,7,404,0,0,414,406,8,GOOXXXXXXXXXXXXXXXXXGOOOOOXXXXXXXXXXXXXXGOOOOOOOOOXXXXXXXXXXGOOOOOXXXXXXXXXXXXXXGOOXXXXXXXXXXXXXXXXXGOOOOOOXXXXXXXXXXXXXGOOOOOOXXXXXXXXXXXXXGOOOOOOOOOXXXXXXXXXXGOOOOOOOOOOOXXXXXXXXGOOXXXXXXXXXXXXXXXXXGOOOOOOXXXXXXXXXXXXXGOOOOOXXXXXXXXXXXXXXGOOOOOOOOXXXXXXXXXXX,0,600,0
47061,89,0,89,6,405,0,0,415,405,10,GOOXXXXXXXXXXXXXXXXXGOOOOOXXXXXXXXXXXXXXGOOOOOOOOOXXXXXXXXXXGOOOOOXXXXXXXXXXXXXXGOOXXXXXXXXXXXXXXXXXGOOOOOOXXXXXXXXXXXXXGOOOOOOXXXXXXXXXXXXXGOOOOOOOOOXXXXXXXXXXGOOOOOOOOOOOXXXXXXXXGOOXXXXXXXXXXXXXXXXXGOOOOOOXXXXXXXXXXXXXGOOOOOXXXXXXXXXXXXXXGOOOOOOOOXXXXXXXXXXX,0,600,0
47082,89,0,89,6,405,0,0,415,406,9,GOOXXXXXXXXXXXXXXXXXGOOOOOXXXXXXXXXXXXXXGOOOOOOOOOXXXXXXXXXXGOOOOOXXXXXXXXXXXXXXGOOXXXXXXXXXXXXXXXXXGOOOOOOXXXXXXXXXXXXXGOOOOOOXXXXXXXXXXXXXGOOOOOOOOOXXXXXXXXXXGOOOOOOOOOOOXXXXXXXXGOOXXXXXXXXXXXXXXXXXGOOOOOOXXXXXXXXXXXXXGOOOOOXXXXXXXXXXXXXXGOOOOOOOOXXXXXXXXXXX,0,600,0
47103,89,0,89,7,404,0,0,414,406,8,GOOXXXXXXXXXXXXXXXXXGOOOOOXXXXXXXXXXXXXXGOOOOOOOOOXXXXXXXXXXGOOOOOXXXXXXXXXXXXXXGOOXXXXXXXXXXXXXXXXXGOOOOOOXXXXXXXXXXXXXGOOOOOOXXXXXXXXXXXXXGOOOOOOOOOXXXXXXXXXXGOOOOOOOOOOOXXXXXXXXGOOXXXXXXXXXXXXXXXXXGOOOOOOXXXXXXXXXXXXXGOOOOOXXXXXXXXXXXXXXGOOOOOOOOXXXXXXXXXXX,0,600,0
47124,90,1,89,6,404,0,0,414,405,9,GOOXXXXXXXXXXXXXXXXXGOOOOOXXXXXXXXXXXXXXGOOOOOOOOOXXXXXXXXXXGOOOOOXXXXXXXXXXXXXXGOOXXXXXXXXXXXXXXXXXGOOOOOOAXXXXXXXXXXXXGOOOOOOXXXXXXXXXXXXXGOOOOOOOOOXXXXXXXXXXGOOOOOOOOOOOXXXXXXXXGOOXXXXXXXXXXXXXXXXXGOOOOOOXXXXXXXXXXXXXGOOOOOXXXXXXXXXXXXXXGOOOOOOOOXXXXXXXXXXX,0,600,0

47145,90,1,89,5,405,0,0,415,405,10,GOOXXXXXXXXXXXXXXXXXGOOOOOXXXXXXXXXXXXXXGOOOOOOOOOXXXXXXXXXXGOOOOOXXXXXXXXXXXXXXGOOXXXXXXXXXXXXXXXXXGOOOOOOAXXXXXXXXXXXXGOOOOOOXXXXXXXXXXXXXGOOOOOOOOOXXXXXXXXXXGOOOOOOOOOOOXXXXXXXXGOOXXXXXXXXXXXXXXXXXGOOOOOOXXXXXXXXXXXXXGOOOOOXXXXXXXXXXXXXXGOOOOOOOOXXXXXXXXXXX,0,600,0
47166,90,1,89,4,406,0,0,415,405,10,GOOXXXXXXXXXXXXXXXXXGOOOOOXXXXXXXXXXXXXXGOOOOOOOOOXXXXXXXXXXGOOOOOXXXXXXXXXXXXXXGOOXXXXXXXXXXXXXXXXXGOOOOOOAXXXXXXXXXXXXGOOOOOOXXXXXXXXXXXXXGOOOOOOOOOXXXXXXXXXXGOOOOOOOOOOOXXXXXXXXGOOXXXXXXXXXXXXXXXXXGOOOOOOXXXXXXXXXXXXXGOOOOOXXXXXXXXXXXXXXGOOOOOOOOXXXXXXXXXXX,0,600,0
47187,90,1,89,4,406,0,0,415,405,10,GOOXXXXXXXXXXXXXXXXXGOOOOOXXXXXXXXXXXXXXGOOOOOOOOOXXXXXXXXXXGOOOOOXXXXXXXXXXXXXXGOOXXXXXXXXXXXXXXXXXGOOOOOOAXXXXXXXXXXXXGOOOOOOXXXXXXXXXXXXXGOOOOOOOOOXXXXXXXXXXGOOOOOOOOOOOXXXXXXXXGOOXXXXXXXXXXXXXXXXXGOOOOOOXXXXXXXXXXXXXGOOOOOXXXXXXXXXXXXXXGOOOOOOOOXXXXXXXXXXX,0,600,0
47208,90,1,89,5,405,0,0,414,405,9,GOOXXXXXXXXXXXXXXXXXGOOOOOXXXXXXXXXXXXXXGOOOOOOOOOXXXXXXXXXXGOOOOOXXXXXXXXXXXXXXGOOXXXXXXXXXXXXXXXXXGOOOOOOAXXXXXXXXXXXXGOOOOOOXXXXXXXXXXXXXGOOOOOOOOOXXXXXXXXXXGOOOOOOOOOOOXXXXXXXXGOOXXXXXXXXXXXXXXXXXGOOOOOOXXXXXXXXXXXXXGOOOOOXXXXXXXXXXXXXXGOOOOOOOOXXXXXXXXXXX,0,600,0
47229,90,1,89,5,405,0,0,414,405,9,GOOXXXXXXXXXXXXXXXXXGOOOOOXXXXXXXXXXXXXXGOOOOOOOOOXXXXXXXXXXGOOOOOXXXXXXXXXXXXXXGOOXXXXXXXXXXXXXXXXXGOOOOOOAXXXXXXXXXXXXGOOOOOOXXXXXXXXXXXXXGOOOOOOOOOXXXXXXXXXXGOOOOOOOOOOOXXXXXXXXGOOXXXXXXXXXXXXXXXXXGOOOOOOXXXXXXXXXXXXXGOOOOOXXXXXXXXXXXXXXGOOOOOOOOXXXXXXXXXXX,0,600,0

47250,90,1,89,5,405,0,0,414,405,9,GOOXXXXXXXXXXXXXXXXXGOOOOOXXXXXXXXXXXXXXGOOOOOOOOOXXXXXXXXXXGOOOOOXXXXXXXXXXXXXXGOOXXXXXXXXXXXXXXXXXGOOOOOOAXXXXXXXXXXXXGOOOOOOXXXXXXXXXXXXXGOOOOOOOOOXXXXXXXXXXGOOOOOOOOOOOXXXXXXXXGOOXXXXXXXXXXXXXXXXXGOOOOOOXXXXXXXXXXXXXGOOOOOXXXXXXXXXXXXXXGOOOOOOOOXXXXXXXXXXX,0,600,0
47271,90,0,90,5,405,0,0,414,407,7,GOOXXXXXXXXXXXXXXXXXGOOOOOXXXXXXXXXXXXXXGOOOOOOOOOXXXXXXXXXXGOOOOOXXXXXXXXXXXXXXGOOXXXXXXXXXXXXXXXXXGOOOOOOOXXXXXXXXXXXXGOOOOOOXXXXXXXXXXXXXGOOOOOOOOOXXXXXXXXXXGOOOOOOOOOOOXXXXXXXXGOOXXXXXXXXXXXXXXXXXGOOOOOOXXXXXXXXXXXXXGOOOOOXXXXXXXXXXXXXXGOOOOOOOOXXXXXXXXXXX,0,600,0
47292,90,0,90,6,404,0,0,412,405,7,GOOXXXXXXXXXXXXXXXXXGOOOOOXXXXXXXXXXXXXXGOOOOOOOOOXXXXXXXXXXGOOOOOXXXXXXXXXXXXXXGOOXXXXXXXXXXXXXXXXXGOOOOOOOXXXXXXXXXXXXGOOOOOOXXXXXXXXXXXXXGOOOOOOOOOXXXXXXXXXXGOOOOOOOOOOOXXXXXXXXGOOXXXXXXXXXXXXXXXXXGOOOOOOXXXXXXXXXXXXXGOOOOOXXXXXXXXXXXXXXGOOOOOOOOXXXXXXXXXXX,0,600,0
47313,90,0,90,6,404,0,0,413,405,8,GOOXXXXXXXXXXXXXXXXXGOOOOOXXXXXXXXXXXXXXGOOOOOOOOOXXXXXXXXXXGOOOOOXXXXXXXXXXXXXXGOOXXXXXXXXXXXXXXXXXGOOOOOOOXXXXXXXXXXXXGOOOOOOXXXXXXXXXXXXXGOOOOOOOOOXXXXXXXXXXGOOOOOOOOOOOXXXXXXXXGOOXXXXXXXXXXXXXXXXXGOOOOOOXXXXXXXXXXXXXGOOOOOXXXXXXXXXXXXXXGOOOOOOOOXXXXXXXXXXX,0,600,0
47334,90,0,90,4,406,0,0,415,405,10,GOOXXXXXXXXXXXXXXXXXGOOOOOXXXXXXXXXXXXXXGOOOOOOOOOXXXXXXXXXXGOOOOOXXXXXXXXXXXXXXGOOXXXXXXXXXXXXXXXXXGOOOOOOOXXXXXXXXXXXXGOOOOOOXXXXXXXXXXXXXGOOOOOOOOOXXXXXXXXXXGOOOOOOOOOOOXXXXXXXXGOOXXXXXXXXXXXXXXXXXGOOOOOOXXXXXXXXXXXXXGOOOOOXXXXXXXXXXXXXXGOOOOOOOOXXXXXXXXXXX,0,600,0

47355,90,0,90,3,407,0,0,416,407,9,GOOXXXXXXXXXXXXXXXXXGOOOOOXXXXXXXXXXXXXXGOOOOOOOOOXXXXXXXXXXGOOOOOXXXXXXXXXXXXXXGOOXXXXXXXXXXXXXXXXXGOOOOOOOXXXXXXXXXXXXGOOOOOOXXXXXXXXXXXXXGOOOOOOOOOXXXXXXXXXXGOOOOOOOOOOOXXXXXXXXGOOXXXXXXXXXXXXXXXXXGOOOOOOXXXXXXXXXXXXXGOOOOOXXXXXXXXXXXXXXGOOOOOOOOXXXXXXXXXXX,0,600,0
47376,90,0,90,5,405,0,0,414,405,9,GOOXXXXXXXXXXXXXXXXXGOOOOOXXXXXXXXXXXXXXGOOOOOOOOOXXXXXXXXXXGOOOOOXXXXXXXXXXXXXXGOOXXXXXXXXXXXXXXXXXGOOOOOOOXXXXXXXXXXXXGOOOOOOXXXXXXXXXXXXXGOOOOOOOOOXXXXXXXXXXGOOOOOOOOOOOXXXXXXXXGOOXXXXXXXXXXXXXXXXXGOOOOOOXXXXXXXXXXXXXGOOOOOXXXXXXXXXXXXXXGOOOOOOOOXXXXXXXXXXX,0,600,0
47397,90,0,90,5,405,0,0,414,405,9,GOOXXXXXXXXXXXXXXXXXGOOOOOXXXXXXXXXXXXXXGOOOOOOOOOXXXXXXXXXXGOOOOOXXXXXXXXXXXXXXGOOXXXXXXXXXXXXXXXXXGOOOOOOOXXXXXXXXXXXXGOOOOOOXXXXXXXXXXXXXGOOOOOOOOOXXXXXXXXXXGOOOOOOOOOOOXXXXXXXXGOOXXXXXXXXXXXXXXXXXGOOOOOOXXXXXXXXXXXXXGOOOOOXXXXXXXXXXXXXXGOOOOOOOOXXXXXXXXXXX,0,600,0
47418,90,0,90,5,405,0,0,414,406,8,GOOXXXXXXXXXXXXXXXXXGOOOOOXXXXXXXXXXXXXXGOOOOOOOOOXXXXXXXXXXGOOOOOXXXXXXXXXXXXXXGOOXXXXXXXXXXXXXXXXXGOOOOOOOXXXXXXXXXXXXGOOOOOOXXXXXXXXXXXXXGOOOOOOOOOXXXXXXXXXXGOOOOOOOOOOOXXXXXXXXGOOXXXXXXXXXXXXXXXXXGOOOOOOXXXXXXXXXXXXXGOOOOOXXXXXXXXXXXXXXGOOOOOOOOXXXXXXXXXXX,0,600,0
47439,90,0,90,4,406,0,0,414,407,7,GOOXXXXXXXXXXXXXXXXXGOOOOOXXXXXXXXXXXXXXGOOOOOOOOOXXXXXXXXXXGOOOOOXXXXXXXXXXXXXXGOOXXXXXXXXXXXXXXXXXGOOOOOOOXXXXXXXXXXXXGOOOOOOXXXXXXXXXXXXXGOOOOOOOOOXXXXXXXXXXGOOOOOOOOOOOXXXXXXXXGOOXXXXXXXXXXXXXXXXXGOOOOOOXXXXXXXXXXXXXGOOOOOXXXXXXXXXXXXXXGOOOOOOOOXXXXXXXXXXX,0,600,0

47460,90,0,90,5,405,0,0,414,406,8,GOOXXXXXXXXXXXXXXXXXGOOOOOXXXXXXXXXXXXXXGOOOOOOOOOXXXXXXXXXXGOOOOOXXXXXXXXXXXXXXGOOXXXXXXXXXXXXXXXXXGOOOOOOOXXXXXXXXXXXXGOOOOOOXXXXXXXXXXXXXGOOOOOOOOOXXXXXXXXXXGOOOOOOOOOOOXXXXXXXXGOOXXXXXXXXXXXXXXXXXGOOOOOOXXXXXXXXXXXXXGOOOOOXXXXXXXXXXXXXXGOOOOOOOOXXXXXXXXXXX,0,600,0
47481,90,0,90,6,404,0,0,413,405,8,GOOXXXXXXXXXXXXXXXXXGOOOOOXXXXXXXXXXXXXXGOOOOOOOOOXXXXXXXXXXGOOOOOXXXXXXXXXXXXXXGOOXXXXXXXXXXXXXXXXXGOOOOOOOXXXXXXXXXXXXGOOOOOOXXXXXXXXXXXXXGOOOOOOOOOXXXXXXXXXXGOOOOOOOOOOOXXXXXXXXGOOXXXXXXXXXXXXXXXXXGOOOOOOXXXXXXXXXXXXXGOOOOOXXXXXXXXXXXXXXGOOOOOOOOXXXXXXXXXXX,0,600,0
47502,90,0,90,5,405,0,0,413,406,7,GOOXXXXXXXXXXXXXXXXXGOOOOOXXXXXXXXXXXXXXGOOOOOOOOOXXXXXXXXXXGOOOOOXXXXXXXXXXXXXXGOOXXXXXXXXXXXXXXXXXGOOOOOOOXXXXXXXXXXXXGOOOOOOXXXXXXXXXXXXXGOOOOOOOOOXXXXXXXXXXGOOOOOOOOOOOXXXXXXXXGOOXXXXXXXXXXXXXXXXXGOOOOOOXXXXXXXXXXXXXGOOOOOXXXXXXXXXXXXXXGOOOOOOOOXXXXXXXXXXX,0,600,0
47523,90,0,90,5,405,0,0,414,406,8,GOOXXXXXXXXXXXXXXXXXGOOOOOXXXXXXXXXXXXXXGOOOOOOOOOXXXXXXXXXXGOOOOOXXXXXXXXXXXXXXGOOXXXXXXXXXXXXXXXXXGOOOOOOOXXXXXXXXXXXXGOOOOOOXXXXXXXXXXXXXGOOOOOOOOOXXXXXXXXXXGOOOOOOOOOOOXXXXXXXXGOOXXXXXXXXXXXXXXXXXGOOOOOOXXXXXXXXXXXXXGOOOOOXXXXXXXXXXXXXXGOOOOOOOOXXXXXXXXXXX,0,600,0
47544,90,0,90,5,405,0,0,414,405,9,GOOXXXXXXXXXXXXXXXXXGOOOOOXXXXXXXXXXXXXXGOOOOOOOOOXXXXXXXXXXGOOOOOXXXXXXXXXXXXXXGOOXXXXXXXXXXXXXXXXXGOOOOOOOXXXXXXXXXXXXGOOOOOOXXXXXXXXXXXXXGOOOOOOOOOXXXXXXXXXXGOOOOOOOOOOOXXXXXXXXGOOXXXXXXXXXXXXXXXXXGOOOOOOXXXXXXXXXXXXXGOOOOOXXXXXXXXXXXXXXGOOOOOOOOXXXXXXXXXXX,0,600,0

47565,90,0,90,5,405,0,0,414,405,9,GOOXXXXXXXXXXXXXXXXXGOOOOOXXXXXXXXXXXXXXGOOOOOOOOOXXXXXXXXXXGOOOOOXXXXXXXXXXXXXXGOOXXXXXXXXXXXXXXXXXGOOOOOOOXXXXXXXXXXXXGOOOOOOXXXXXXXXXXXXXGOOOOOOOOOXXXXXXXXXXGOOOOOOOOOOOXXXXXXXXGOOXXXXXXXXXXXXXXXXXGOOOOOOXXXXXXXXXXXXXGOOOOOXXXXXXXXXXXXXXGOOOOOOOOXXXXXXXXXXX,0,600,0
47586,90,0,90,5,405,0,0,414,405,9,GOOXXXXXXXXXXXXXXXXXGOOOOOXXXXXXXXXXXXXXGOOOOOOOOOXXXXXXXXXXGOOOOOXXXXXXXXXXXXXXGOOXXXXXXXXXXXXXXXXXGOOOOOOOXXXXXXXXXXXXGOOOOOOXXXXXXXXXXXXXGOOOOOOOOOXXXXXXXXXXGOOOOOOOOOOOXXXXXXXXGOOXXXXXXXXXXXXXXXXXGOOOOOOXXXXXXXXXXXXXGOOOOOXXXXXXXXXXXXXXGOOOOOOOOXXXXXXXXXXX,0,600,0
47607,90,0,90,4,406,0,0,415,405,10,GOOXXXXXXXXXXXXXXXXXGOOOOOXXXXXXXXXXXXXXGOOOOOOOOOXXXXXXXXXXGOOOOOXXXXXXXXXXXXXXGOOXXXXXXXXXXXXXXXXXGOOOOOOOXXXXXXXXXXXXGOOOOOOXXXXXXXXXXXXXGOOOOOOOOOXXXXXXXXXXGOOOOOOOOOOOXXXXXXXXGOOXXXXXXXXXXXXXXXXXGOOOOOOXXXXXXXXXXXXXGOOOOOXXXXXXXXXXXXXXGOOOOOOOOXXXXXXXXXXX,0,600,0
47628,90,0,90,4,406,0,0,415,406,9,GOOXXXXXXXXXXXXXXXXXGOOOOOXXXXXXXXXXXXXXGOOOOOOOOOXXXXXXXXXXGOOOOOXXXXXXXXXXXXXXGOOXXXXXXXXXXXXXXXXXGOOOOOOOXXXXXXXXXXXXGOOOOOOXXXXXXXXXXXXXGOOOOOOOOOXXXXXXXXXXGOOOOOOOOOOOXXXXXXXXGOOXXXXXXXXXXXXXXXXXGOOOOOOXXXXXXXXXXXXXGOOOOOXXXXXXXXXXXXXXGOOOOOOOOXXXXXXXXXXX,0,600,0
47649,90,0,90,6,404,0,0,413,405,8,GOOXXXXXXXXXXXXXXXXXGOOOOOXXXXXXXXXXXXXXGOOOOOOOOOXXXXXXXXXXGOOOOOXXXXXXXXXXXXXXGOOXXXXXXXXXXXXXXXXXGOOOOOOOXXXXXXXXXXXXGOOOOOOXXXXXXXXXXXXXGOOOOOOOOOXXXXXXXXXXGOOOOOOOOOOOXXXXXXXXGOOXXXXXXXXXXXXXXXXXGOOOOOOXXXXXXXXXXXXXGOOOOOXXXXXXXXXXXXXXGOOOOOOOOXXXXXXXXXXX,0,600,0

47670,90,0,90,6,404,0,0,413,405,8,GOOXXXXXXXXXXXXXXXXXGOOOOOXXXXXXXXXXXXXXGOOOOOOOOOXXXXXXXXXXGOOOOOXXXXXXXXXXXXXXGOOXXXXXXXXXXXXXXXXXGOOOOOOOXXXXXXXXXXXXGOOOOOOXXXXXXXXXXXXXGOOOOOOOOOXXXXXXXXXXGOOOOOOOOOOOXXXXXXXXGOOXXXXXXXXXXXXXXXXXGOOOOOOXXXXXXXXXXXXXGOOOOOXXXXXXXXXXXXXXGOOOOOOOOXXXXXXXXXXX,0,600,0
47691,90,0,90,6,404,0,0,413,406,7,GOOXXXXXXXXXXXXXXXXXGOOOOOXXXXXXXXXXXXXXGOOOOOOOOOXXXXXXXXXXGOOOOOXXXXXXXXXXXXXXGOOXXXXXXXXXXXXXXXXXGOOOOOOOXXXXXXXXXXXXGOOOOOOXXXXXXXXXXXXXGOOOOOOOOOXXXXXXXXXXGOOOOOOOOOOOXXXXXXXXGOOXXXXXXXXXXXXXXXXXGOOOOOOXXXXXXXXXXXXXGOOOOOXXXXXXXXXXXXXXGOOOOOOOOXXXXXXXXXXX,0,600,0
47712,90,0,90,5,405,0,0,414,405,9,GOOXXXXXXXXXXXXXXXXXGOOOOOXXXXXXXXXXXXXXGOOOOOOOOOXXXXXXXXXXGOOOOOXXXXXXXXXXXXXXGOOXXXXXXXXXXXXXXXXXGOOOOOOOXXXXXXXXXXXXGOOOOOOXXXXXXXXXXXXXGOOOOOOOOOXXXXXXXXXXGOOOOOOOOOOOXXXXXXXXGOOXXXXXXXXXXXXXXXXXGOOOOOOXXXXXXXXXXXXXGOOOOOXXXXXXXXXXXXXXGOOOOOOOOXXXXXXXXXXX,0,600,0
47733,90,0,90,5,405,0,0,414,405,9,GOOXXXXXXXXXXXXXXXXXGOOOOOXXXXXXXXXXXXXXGOOOOOOOOOXXXXXXXXXXGOOOOOXXXXXXXXXXXXXXGOOXXXXXXXXXXXXXXXXXGOOOOOOOXXXXXXXXXXXXGOOOOOOXXXXXXXXXXXXXGOOOOOOOOOXXXXXXXXXXGOOOOOOOOOOOXXXXXXXXGOOXXXXXXXXXXXXXXXXXGOOOOOOXXXXXXXXXXXXXGOOOOOXXXXXXXXXXXXXXGOOOOOOOOXXXXXXXXXXX,0,600,0
47754,90,0,90,5,405,0,0,414,405,9,GOOXXXXXXXXXXXXXXXXXGOOOOOXXXXXXXXXXXXXXGOOOOOOOOOXXXXXXXXXXGOOOOOXXXXXXXXXXXXXXGOOXXXXXXXXXXXXXXXXXGOOOOOOOXXXXXXXXXXXXGOOOOOOXXXXXXXXXXXXXGOOOOOOOOOXXXXXXXXXXGOOOOOOOOOOOXXXXXXXXGOOXXXXXXXXXXXXXXXXXGOOOOOOXXXXXXXXXXXXXGOOOOOXXXXXXXXXXXXXXGOOOOOOOOXXXXXXXXXXX,0,600,0

47775,90,0,90,5,405,0,0,414,406,8,GOOXXXXXXXXXXXXXXXXXGOOOOOXXXXXXXXXXXXXXGOOOOOOOOOXXXXXXXXXXGOOOOOXXXXXXXXXXXXXXGOOXXXXXXXXXXXXXXXXXGOOOOOOOXXXXXXXXXXXXGOOOOOOXXXXXXXXXXXXXGOOOOOOOOOXXXXXXXXXXGOOOOOOOOOOOXXXXXXXXGOOXXXXXXXXXXXXXXXXXGOOOOOOXXXXXXXXXXXXXGOOOOOXXXXXXXXXXXXXXGOOOOOOOOXXXXXXXXXXX,0,600,0
47796,90,0,90,5,405,0,0,413,405,8,GOOXXXXXXXXXXXXXXXXXGOOOOOXXXXXXXXXXXXXXGOOOOOOOOOXXXXXXXXXXGOOOOOXXXXXXXXXXXXXXGOOXXXXXXXXXXXXXXXXXGOOOOOOOXXXXXXXXXXXXGOOOOOOXXXXXXXXXXXXXGOOOOOOOOOXXXXXXXXXXGOOOOOOOOOOOXXXXXXXXGOOXXXXXXXXXXXXXXXXXGOOOOOOXXXXXXXXXXXXXGOOOOOXXXXXXXXXXXXXXGOOOOOOOOXXXXXXXXXXX,0,600,0
47817,90,0,90,5,405,0,0,414,405,9,GOOXXXXXXXXXXXXXXXXXGOOOOOXXXXXXXXXXXXXXGOOOOOOOOOXXXXXXXXXXGOOOOOXXXXXXXXXXXXXXGOOXXXXXXXXXXXXXXXXXGOOOOOOOXXXXXXXXXXXXGOOOOOOXXXXXXXXXXXXXGOOOOOOOOOXXXXXXXXXXGOOOOOOOOOOOXXXXXXXXGOOXXXXXXXXXXXXXXXXXGOOOOOOXXXXXXXXXXXXXGOOOOOXXXXXXXXXXXXXXGOOOOOOOOXXXXXXXXXXX,0,600,0
47838,90,0,90,4,406,0,0,415,405,10,GOOXXXXXXXXXXXXXXXXXGOOOOOXXXXXXXXXXXXXXGOOOOOOOOOXXXXXXXXXXGOOOOOXXXXXXXXXXXXXXGOOXXXXXXXXXXXXXXXXXGOOOOOOOXXXXXXXXXXXXGOOOOOOXXXXXXXXXXXXXGOOOOOOOOOXXXXXXXXXXGOOOOOOOOOOOXXXXXXXXGOOXXXXXXXXXXXXXXXXXGOOOOOOXXXXXXXXXXXXXGOOOOOXXXXXXXXXXXXXXGOOOOOOOOXXXXXXXXXXX,0,600,0
47859,90,0,90,4,406,0,0,415,406,9,GOOXXXXXXXXXXXXXXXXXGOOOOOXXXXXXXXXXXXXXGOOOOOOOOOXXXXXXXXXXGOOOOOXXXXXXXXXXXXXXGOOXXXXXXXXXXXXXXXXXGOOOOOOOXXXXXXXXXXXXGOOOOOOXXXXXXXXXXXXXGOOOOOOOOOXXXXXXXXXXGOOOOOOOOOOOXXXXXXXXGOOXXXXXXXXXXXXXXXXXGOOOOOOXXXXXXXXXXXXXGOOOOOXXXXXXXXXXXXXXGOOOOOOOOXXXXXXXXXXX,0,600,0

47880,90,0,90,5,405,0,0,414,405,9,GOOXXXXXXXXXXXXXXXXXGOOOOOXXXXXXXXXXXXXXGOOOOOOOOOXXXXXXXXXXGOOOOOXXXXXXXXXXXXXXGOOXXXXXXXXXXXXXXXXXGOOOOOOOXXXXXXXXXXXXGOOOOOOXXXXXXXXXXXXXGOOOOOOOOOXXXXXXXXXXGOOOOOOOOOOOXXXXXXXXGOOXXXXXXXXXXXXXXXXXGOOOOOOXXXXXXXXXXXXXGOOOOOXXXXXXXXXXXXXXGOOOOOOOOXXXXXXXXXXX,0,600,0
47901,90,0,90,4,406,0,0,415,405,10,GOOXXXXXXXXXXXXXXXXXGOOOOOXXXXXXXXXXXXXXGOOOOOOOOOXXXXXXXXXXGOOOOOXXXXXXXXXXXXXXGOOXXXXXXXXXXXXXXXXXGOOOOOOOXXXXXXXXXXXXGOOOOOOXXXXXXXXXXXXXGOOOOOOOOOXXXXXXXXXXGOOOOOOOOOOOXXXXXXXXGOOXXXXXXXXXXXXXXXXXGOOOOOOXXXXXXXXXXXXXGOOOOOXXXXXXXXXXXXXXGOOOOOOOOXXXXXXXXXXX,0,600,0
47922,90,0,90,4,406,0,0,415,405,10,GOOXXXXXXXXXXXXXXXXXGOOOOOXXXXXXXXXXXXXXGOOOOOOOOOXXXXXXXXXXGOOOOOXXXXXXXXXXXXXXGOOXXXXXXXXXXXXXXXXXGOOOOOOOXXXXXXXXXXXXGOOOOOOXXXXXXXXXXXXXGOOOOOOOOOXXXXXXXXXXGOOOOOOOOOOOXXXXXXXXGOOXXXXXXXXXXXXXXXXXGOOOOOOXXXXXXXXXXXXXGOOOOOXXXXXXXXXXXXXXGOOOOOOOOXXXXXXXXXXX,0,600,0
47943,90,0,90,4,406,0,0,415,405,10,GOOXXXXXXXXXXXXXXXXXGOOOOOXXXXXXXXXXXXXXGOOOOOOOOOXXXXXXXXXXGOOOOOXXXXXXXXXXXXXXGOOXXXXXXXXXXXXXXXXXGOOOOOOOXXXXXXXXXXXXGOOOOOOXXXXXXXXXXXXXGOOOOOOOOOXXXXXXXXXXGOOOOOOOOOOOXXXXXXXXGOOXXXXXXXXXXXXXXXXXGOOOOOOXXXXXXXXXXXXXGOOOOOXXXXXXXXXXXXXXGOOOOOOOOXXXXXXXXXXX,0,600,0
47964,90,0,90,4,406,0,0,415,405,10,GOOXXXXXXXXXXXXXXXXXGOOOOOXXXXXXXXXXXXXXGOOOOOOOOOXXXXXXXXXXGOOOOOXXXXXXXXXXXXXXGOOXXXXXXXXXXXXXXXXXGOOOOOOOXXXXXXXXXXXXGOOOOOOXXXXXXXXXXXXXGOOOOOOOOOXXXXXXXXXXGOOOOOOOOOOOXXXXXXXXGOOXXXXXXXXXXXXXXXXXGOOOOOOXXXXXXXXXXXXXGOOOOOXXXXXXXXXXXXXXGOOOOOOOOXXXXXXXXXXX,0,600,0

47985,90,0,90,5,405,0,0,414,405,9,GOOXXXXXXXXXXXXXXXXXGOOOOOXXXXXXXXXXXXXXGOOOOOOOOOXXXXXXXXXXGOOOOOXXXXXXXXXXXXXXGOOXXXXXXXXXXXXXXXXXGOOOOOOOXXXXXXXXXXXXGOOOOOOXXXXXXXXXXXXXGOOOOOOOOOXXXXXXXXXXGOOOOOOOOOOOXXXXXXXXGOOXXXXXXXXXXXXXXXXXGOOOOOOXXXXXXXXXXXXXGOOOOOXXXXXXXXXXXXXXGOOOOOOOOXXXXXXXXXXX,0,600,0
48006,90,0,90,4,406,0,0,415,406,9,GOOXXXXXXXXXXXXXXXXXGOOOOOXXXXXXXXXXXXXXGOOOOOOOOOXXXXXXXXXXGOOOOOXXXXXXXXXXXXXXGOOXXXXXXXXXXXXXXXXXGOOOOOOOXXXXXXXXXXXXGOOOOOOXXXXXXXXXXXXXGOOOOOOOOOXXXXXXXXXXGOOOOOOOOOOOXXXXXXXXGOOXXXXXXXXXXXXXXXXXGOOOOOOXXXXXXXXXXXXXGOOOOOXXXXXXXXXXXXXXGOOOOOOOOXXXXXXXXXXX,0,600,0
48027,90,0,90,4,406,0,0,415,405,10,GOOXXXXXXXXXXXXXXXXXGOOOOOXXXXXXXXXXXXXXGOOOOOOOOOXXXXXXXXXXGOOOOOXXXXXXXXXXXXXXGOOXXXXXXXXXXXXXXXXXGOOOOOOOXXXXXXXXXXXXGOOOOOOXXXXXXXXXXXXXGOOOOOOOOOXXXXXXXXXXGOOOOOOOOOOOXXXXXXXXGOOXXXXXXXXXXXXXXXXXGOOOOOOXXXXXXXXXXXXXGOOOOOXXXXXXXXXXXXXXGOOOOOOOOXXXXXXXXXXX,0,600,0
48048,90,0,90,3,407,0,0,416,405,11,GOOXXXXXXXXXXXXXXXXXGOOOOOXXXXXXXXXXXXXXGOOOOOOOOOXXXXXXXXXXGOOOOOXXXXXXXXXXXXXXGOOXXXXXXXXXXXXXXXXXGOOOOOOOXXXXXXXXXXXXGOOOOOOXXXXXXXXXXXXXGOOOOOOOOOXXXXXXXXXXGOOOOOOOOOOOXXXXXXXXGOOXXXXXXXXXXXXXXXXXGOOOOOOXXXXXXXXXXXXXGOOOOOXXXXXXXXXXXXXXGOOOOOOOOXXXXXXXXXXX,0,600,0
48069,90,0,90,4,406,0,0,415,405,10,GOOXXXXXXXXXXXXXXXXXGOOOOOXXXXXXXXXXXXXXGOOOOOOOOOXXXXXXXXXXGOOOOOXXXXXXXXXXXXXXGOOXXXXXXXXXXXXXXXXXGOOOOOOOXXXXXXXXXXXXGOOOOOOXXXXXXXXXXXXXGOOOOOOOOOXXXXXXXXXXGOOOOOOOOOOOXXXXXXXXGOOXXXXXXXXXXXXXXXXXGOOOOOOXXXXXXXXXXXXXGOOOOOXXXXXXXXXXXXXXGOOOOOOOOXXXXXXXXXXX,0,600,0

48090,90,0,90,2,408,0,0,417,406,11,GOOXXXXXXXXXXXXXXXXXGOOOOOXXXXXXXXXXXXXXGOOOOOOOOOXXXXXXXXXXGOOOOOXXXXXXXXXXXXXXGOOXXXXXXXXXXXXXXXXXGOOOOOOOXXXXXXXXXXXXGOOOOOOXXXXXXXXXXXXXGOOOOOOOOOXXXXXXXXXXGOOOOOOOOOOOXXXXXXXXGOOXXXXXXXXXXXXXXXXXGOOOOOOXXXXXXXXXXXXXGOOOOOXXXXXXXXXXXXXXGOOOOOOOOXXXXXXXXXXX,0,600,0
48111,90,0,90,3,407,0,0,416,405,11,GOOXXXXXXXXXXXXXXXXXGOOOOOXXXXXXXXXXXXXXGOOOOOOOOOXXXXXXXXXXGOOOOOXXXXXXXXXXXXXXGOOXXXXXXXXXXXXXXXXXGOOOOOOOXXXXXXXXXXXXGOOOOOOXXXXXXXXXXXXXGOOOOOOOOOXXXXXXXXXXGOOOOOOOOOOOXXXXXXXXGOOXXXXXXXXXXXXXXXXXGOOOOOOXXXXXXXXXXXXXGOOOOOXXXXXXXXXXXXXXGOOOOOOOOXXXXXXXXXXX,0,600,0
48132,90,0,90,3,407,0,0,416,405,11,GOOXXXXXXXXXXXXXXXXXGOOOOOXXXXXXXXXXXXXXGOOOOOOOOOXXXXXXXXXXGOOOOOXXXXXXXXXXXXXXGOOXXXXXXXXXXXXXXXXXGOOOOOOOXXXXXXXXXXXXGOOOOOOXXXXXXXXXXXXXGOOOOOOOOOXXXXXXXXXXGOOOOOOOOOOOXXXXXXXXGOOXXXXXXXXXXXXXXXXXGOOOOOOXXXXXXXXXXXXXGOOOOOXXXXXXXXXXXXXXGOOOOOOOOXXXXXXXXXXX,0,600,0
48153,90,0,90,4,406,0,0,415,406,9,GOOXXXXXXXXXXXXXXXXXGOOOOOXXXXXXXXXXXXXXGOOOOOOOOOXXXXXXXXXXGOOOOOXXXXXXXXXXXXXXGOOXXXXXXXXXXXXXXXXXGOOOOOOOXXXXXXXXXXXXGOOOOOOXXXXXXXXXXXXXGOOOOOOOOOXXXXXXXXXXGOOOOOOOOOOOXXXXXXXXGOOXXXXXXXXXXXXXXXXXGOOOOOOXXXXXXXXXXXXXGOOOOOXXXXXXXXXXXXXXGOOOOOOOOXXXXXXXXXXX,0,600,0
48174,90,0,90,4,406,0,0,415,406,9,GOOXXXXXXXXXXXXXXXXXGOOOOOXXXXXXXXXXXXXXGOOOOOOOOOXXXXXXXXXXGOOOOOXXXXXXXXXXXXXXGOOXXXXXXXXXXXXXXXXXGOOOOOOOXXXXXXXXXXXXGOOOOOOXXXXXXXXXXXXXGOOOOOOOOOXXXXXXXXXXGOOOOOOOOOOOXXXXXXXXGOOXXXXXXXXXXXXXXXXXGOOOOOOXXXXXXXXXXXXXGOOOOOXXXXXXXXXXXXXXGOOOOOOOOXXXXXXXXXXX,0,600,0

48195,90,0,90,3,407,0,0,416,407,9,GOOXXXXXXXXXXXXXXXXXGOOOOOXXXXXXXXXXXXXXGOOOOOOOOOXXXXXXXXXXGOOOOOXXXXXXXXXXXXXXGOOXXXXXXXXXXXXXXXXXGOOOOOOOXXXXXXXXXXXXGOOOOOOXXXXXXXXXXXXXGOOOOOOOOOXXXXXXXXXXGOOOOOOOOOOOXXXXXXXXGOOXXXXXXXXXXXXXXXXXGOOOOOOXXXXXXXXXXXXXGOOOOOXXXXXXXXXXXXXXGOOOOOOOOXXXXXXXXXXX,0,600,0
48216,90,0,90,2,408,0,0,417,407,10,GOOXXXXXXXXXXXXXXXXXGOOOOOXXXXXXXXXXXXXXGOOOOOOOOOXXXXXXXXXXGOOOOOXXXXXXXXXXXXXXGOOXXXXXXXXXXXXXXXXXGOOOOOOOXXXXXXXXXXXXGOOOOOOXXXXXXXXXXXXXGOOOOOOOOOXXXXXXXXXXGOOOOOOOOOOOXXXXXXXXGOOXXXXXXXXXXXXXXXXXGOOOOOOXXXXXXXXXXXXXGOOOOOXXXXXXXXXXXXXXGOOOOOOOOXXXXXXXXXXX,0,600,0
48237,90,0,90,3,407,0,0,416,406,10,GOOXXXXXXXXXXXXXXXXXGOOOOOXXXXXXXXXXXXXXGOOOOOOOOOXXXXXXXXXXGOOOOOXXXXXXXXXXXXXXGOOXXXXXXXXXXXXXXXXXGOOOOOOOXXXXXXXXXXXXGOOOOOOXXXXXXXXXXXXXGOOOOOOOOOXXXXXXXXXXGOOOOOOOOOOOXXXXXXXXGOOXXXXXXXXXXXXXXXXXGOOOOOOXXXXXXXXXXXXXGOOOOOXXXXXXXXXXXXXXGOOOOOOOOXXXXXXXXXXX,0,600,0
48258,90,0,90,4,406,0,0,415,406,9,GOOXXXXXXXXXXXXXXXXXGOOOOOXXXXXXXXXXXXXXGOOOOOOOOOXXXXXXXXXXGOOOOOXXXXXXXXXXXXXXGOOXXXXXXXXXXXXXXXXXGOOOOOOOXXXXXXXXXXXXGOOOOOOXXXXXXXXXXXXXGOOOOOOOOOXXXXXXXXXXGOOOOOOOOOOOXXXXXXXXGOOXXXXXXXXXXXXXXXXXGOOOOOOXXXXXXXXXXXXXGOOOOOXXXXXXXXXXXXXXGOOOOOOOOXXXXXXXXXXX,0,600,0
48279,90,0,90,4,406,0,0,415,406,9,GOOXXXXXXXXXXXXXXXXXGOOOOOXXXXXXXXXXXXXXGOOOOOOOOOXXXXXXXXXXGOOOOOXXXXXXXXXXXXXXGOOXXXXXXXXXXXXXXXXXGOOOOOOOXXXXXXXXXXXXGOOOOOOXXXXXXXXXXXXXGOOOOOOOOOXXXXXXXXXXGOOOOOOOOOOOXXXXXXXXGOOXXXXXXXXXXXXXXXXXGOOOOOOXXXXXXXXXXXXXGOOOOOXXXXXXXXXXXXXXGOOOOOOOOXXXXXXXXXXX,0,600,0

48300,90,0,90,5,405,0,0,414,406,8,GOOXXXXXXXXXXXXXXXXXGOOOOOXXXXXXXXXXXXXXGOOOOOOOOOXXXXXXXXXXGOOOOOXXXXXXXXXXXXXXGOOXXXXXXXXXXXXXXXXXGOOOOOOOXXXXXXXXXXXXGOOOOOOXXXXXXXXXXXXXGOOOOOOOOOXXXXXXXXXXGOOOOOOOOOOOXXXXXXXXGOOXXXXXXXXXXXXXXXXXGOOOOOOXXXXXXXXXXXXXGOOOOOXXXXXXXXXXXXXXGOOOOOOOOXXXXXXXXXXX,0,600,0
48321,90,0,90,4,406,0,0,415,406,9,GOOXXXXXXXXXXXXXXXXXGOOOOOXXXXXXXXXXXXXXGOOOOOOOOOXXXXXXXXXXGOOOOOXXXXXXXXXXXXXXGOOXXXXXXXXXXXXXXXXXGOOOOOOOXXXXXXXXXXXXGOOOOOOXXXXXXXXXXXXXGOOOOOOOOOXXXXXXXXXXGOOOOOOOOOOOXXXXXXXXGOOXXXXXXXXXXXXXXXXXGOOOOOOXXXXXXXXXXXXXGOOOOOXXXXXXXXXXXXXXGOOOOOOOOXXXXXXXXXXX,0,600,0
48342,90,0,90,5,405,0,0,414,407,7,GOOXXXXXXXXXXXXXXXXXGOOOOOXXXXXXXXXXXXXXGOOOOOOOOOXXXXXXXXXXGOOOOOXXXXXXXXXXXXXXGOOXXXXXXXXXXXXXXXXXGOOOOOOOXXXXXXXXXXXXGOOOOOOXXXXXXXXXXXXXGOOOOOOOOOXXXXXXXXXXGOOOOOOOOOOOXXXXXXXXGOOXXXXXXXXXXXXXXXXXGOOOOOOXXXXXXXXXXXXXGOOOOOXXXXXXXXXXXXXXGOOOOOOOOXXXXXXXXXXX,0,600,0
48363,90,0,90,6,404,0,0,413,406,7,GOOXXXXXXXXXXXXXXXXXGOOOOOXXXXXXXXXXXXXXGOOOOOOOOOXXXXXXXXXXGOOOOOXXXXXXXXXXXXXXGOOXXXXXXXXXXXXXXXXXGOOOOOOOXXXXXXXXXXXXGOOOOOOXXXXXXXXXXXXXGOOOOOOOOOXXXXXXXXXXGOOOOOOOOOOOXXXXXXXXGOOXXXXXXXXXXXXXXXXXGOOOOOOXXXXXXXXXXXXXGOOOOOXXXXXXXXXXXXXXGOOOOOOOOXXXXXXXXXXX,0,600,0
48384,90,0,90,6,404,0,0,413,406,7,GOOXXXXXXXXXXXXXXXXXGOOOOOXXXXXXXXXXXXXXGOOOOOOOOOXXXXXXXXXXGOOOOOXXXXXXXXXXXXXXGOOXXXXXXXXXXXXXXXXXGOOOOOOOXXXXXXXXXXXXGOOOOOOXXXXXXXXXXXXXGOOOOOOOOOXXXXXXXXXXGOOOOOOOOOOOXXXXXXXXGOOXXXXXXXXXXXXXXXXXGOOOOOOXXXXXXXXXXXXXGOOOOOXXXXXXXXXXXXXXGOOOOOOOOXXXXXXXXXXX,0,600,0

48405,90,0,90,5,405,0,0,414,406,8,GOOXXXXXXXXXXXXXXXXXGOOOOOXXXXXXXXXXXXXXGOOOOOOOOOXXXXXXXXXXGOOOOOXXXXXXXXXXXXXXGOOXXXXXXXXXXXXXXXXXGOOOOOOOXXXXXXXXXXXXGOOOOOOXXXXXXXXXXXXXGOOOOOOOOOXXXXXXXXXXGOOOOOOOOOOOXXXXXXXXGOOXXXXXXXXXXXXXXXXXGOOOOOOXXXXXXXXXXXXXGOOOOOXXXXXXXXXXXXXXGOOOOOOOOXXXXXXXXXXX,0,600,0
48426,90,0,90,5,405,0,0,414,406,8,GOOXXXXXXXXXXXXXXXXXGOOOOOXXXXXXXXXXXXXXGOOOOOOOOOXXXXXXXXXXGOOOOOXXXXXXXXXXXXXXGOOXXXXXXXXXXXXXXXXXGOOOOOOOXXXXXXXXXXXXGOOOOOOXXXXXXXXXXXXXGOOOOOOOOOXXXXXXXXXXGOOOOOOOOOOOXXXXXXXXGOOXXXXXXXXXXXXXXXXXGOOOOOOXXXXXXXXXXXXXGOOOOOXXXXXXXXXXXXXXGOOOOOOOOXXXXXXXXXXX,0,600,0
48447,90,0,90,5,405,0,0,414,406,8,GOOXXXXXXXXXXXXXXXXXGOOOOOXXXXXXXXXXXXXXGOOOOOOOOOXXXXXXXXXXGOOOOOXXXXXXXXXXXXXXGOOXXXXXXXXXXXXXXXXXGOOOOOOOXXXXXXXXXXXXGOOOOOOXXXXXXXXXXXXXGOOOOOOOOOXXXXXXXXXXGOOOOOOOOOOOXXXXXXXXGOOXXXXXXXXXXXXXXXXXGOOOOOOXXXXXXXXXXXXXGOOOOOXXXXXXXXXXXXXXGOOOOOOOOXXXXXXXXXXX,0,600,0
48468,90,0,90,3,407,0,0,416,408,8,GOOXXXXXXXXXXXXXXXXXGOOOOOXXXXXXXXXXXXXXGOOOOOOOOOXXXXXXXXXXGOOOOOXXXXXXXXXXXXXXGOOXXXXXXXXXXXXXXXXXGOOOOOOOXXXXXXXXXXXXGOOOOOOXXXXXXXXXXXXXGOOOOOOOOOXXXXXXXXXXGOOOOOOOOOOOXXXXXXXXGOOXXXXXXXXXXXXXXXXXGOOOOOOXXXXXXXXXXXXXGOOOOOXXXXXXXXXXXXXXGOOOOOOOOXXXXXXXXXXX,0,600,0
48489,90,0,90,3,407,0,0,416,407,9,GOOXXXXXXXXXXXXXXXXXGOOOOOXXXXXXXXXXXXXXGOOOOOOOOOXXXXXXXXXXGOOOOOXXXXXXXXXXXXXXGOOXXXXXXXXXXXXXXXXXGOOOOOOOXXXXXXXXXXXXGOOOOOOXXXXXXXXXXXXXGOOOOOOOOOXXXXXXXXXXGOOOOOOOOOOOXXXXXXXXGOOXXXXXXXXXXXXXXXXXGOOOOOOXXXXXXXXXXXXXGOOOOOXXXXXXXXXXXXXXGOOOOOOOOXXXXXXXXXXX,0,600,0

48510,90,0,90,6,404,0,0,413,406,7,GOOXXXXXXXXXXXXXXXXXGOOOOOXXXXXXXXXXXXXXGOOOOOOOOOXXXXXXXXXXGOOOOOXXXXXXXXXXXXXXGOOXXXXXXXXXXXXXXXXXGOOOOOOOXXXXXXXXXXXXGOOOOOOXXXXXXXXXXXXXGOOOOOOOOOXXXXXXXXXXGOOOOOOOOOOOXXXXXXXXGOOXXXXXXXXXXXXXXXXXGOOOOOOXXXXXXXXXXXXXGOOOOOXXXXXXXXXXXXXXGOOOOOOOOXXXXXXXXXXX,0,600,0
48531,90,0,90,6,404,0,0,413,406,7,GOOXXXXXXXXXXXXXXXXXGOOOOOXXXXXXXXXXXXXXGOOOOOOOOOXXXXXXXXXXGOOOOOXXXXXXXXXXXXXXGOOXXXXXXXXXXXXXXXXXGOOOOOOOXXXXXXXXXXXXGOOOOOOXXXXXXXXXXXXXGOOOOOOOOOXXXXXXXXXXGOOOOOOOOOOOXXXXXXXXGOOXXXXXXXXXXXXXXXXXGOOOOOOXXXXXXXXXXXXXGOOOOOXXXXXXXXXXXXXXGOOOOOOOOXXXXXXXXXXX,0,600,0
48552,90,0,90,5,405,0,0,414,406,8,GOOXXXXXXXXXXXXXXXXXGOOOOOXXXXXXXXXXXXXXGOOOOOOOOOXXXXXXXXXXGOOOOOXXXXXXXXXXXXXXGOOXXXXXXXXXXXXXXXXXGOOOOOOOXXXXXXXXXXXXGOOOOOOXXXXXXXXXXXXXGOOOOOOOOOXXXXXXXXXXGOOOOOOOOOOOXXXXXXXXGOOXXXXXXXXXXXXXXXXXGOOOOOOXXXXXXXXXXXXXGOOOOOXXXXXXXXXXXXXXGOOOOOOOOXXXXXXXXXXX,0,600,0
48573,90,0,90,5,405,0,0,414,406,8,GOOXXXXXXXXXXXXXXXXXGOOOOOXXXXXXXXXXXXXXGOOOOOOOOOXXXXXXXXXXGOOOOOXXXXXXXXXXXXXXGOOXXXXXXXXXXXXXXXXXGOOOOOOOXXXXXXXXXXXXGOOOOOOXXXXXXXXXXXXXGOOOOOOOOOXXXXXXXXXXGOOOOOOOOOOOXXXXXXXXGOOXXXXXXXXXXXXXXXXXGOOOOOOXXXXXXXXXXXXXGOOOOOXXXXXXXXXXXXXXGOOOOOOOOXXXXXXXXXXX,0,600,0
48594,90,0,90,3,407,0,0,416,407,9,GOOXXXXXXXXXXXXXXXXXGOOOOOXXXXXXXXXXXXXXGOOOOOOOOOXXXXXXXXXXGOOOOOXXXXXXXXXXXXXXGOOXXXXXXXXXXXXXXXXXGOOOOOOOXXXXXXXXXXXXGOOOOOOXXXXXXXXXXXXXGOOOOOOOOOXXXXXXXXXXGOOOOOOOOOOOXXXXXXXXGOOXXXXXXXXXXXXXXXXXGOOOOOOXXXXXXXXXXXXXGOOOOOXXXXXXXXXXXXXXGOOOOOOOOXXXXXXXXXXX,0,600,0

48615,90,0,90,5,405,0,0,414,406,8,GOOXXXXXXXXXXXXXXXXXGOOOOOXXXXXXXXXXXXXXGOOOOOOOOOXXXXXXXXXXGOOOOOXXXXXXXXXXXXXXGOOXXXXXXXXXXXXXXXXXGOOOOOOOXXXXXXXXXXXXGOOOOOOXXXXXXXXXXXXXGOOOOOOOOOXXXXXXXXXXGOOOOOOOOOOOXXXXXXXXGOOXXXXXXXXXXXXXXXXXGOOOOOOXXXXXXXXXXXXXGOOOOOXXXXXXXXXXXXXXGOOOOOOOOXXXXXXXXXXX,0,600,0
48636,90,0,90,5,405,0,0,414,406,8,GOOXXXXXXXXXXXXXXXXXGOOOOOXXXXXXXXXXXXXXGOOOOOOOOOXXXXXXXXXXGOOOOOXXXXXXXXXXXXXXGOOXXXXXXXXXXXXXXXXXGOOOOOOOXXXXXXXXXXXXGOOOOOOXXXXXXXXXXXXXGOOOOOOOOOXXXXXXXXXXGOOOOOOOOOOOXXXXXXXXGOOXXXXXXXXXXXXXXXXXGOOOOOOXXXXXXXXXXXXXGOOOOOXXXXXXXXXXXXXXGOOOOOOOOXXXXXXXXXXX,0,600,0
48657,90,0,90,5,405,0,0,414,406,8,GOOXXXXXXXXXXXXXXXXXGOOOOOXXXXXXXXXXXXXXGOOOOOOOOOXXXXXXXXXXGOOOOOXXXXXXXXXXXXXXGOOXXXXXXXXXXXXXXXXXGOOOOOOOXXXXXXXXXXXXGOOOOOOXXXXXXXXXXXXXGOOOOOOOOOXXXXXXXXXXGOOOOOOOOOOOXXXXXXXXGOOXXXXXXXXXXXXXXXXXGOOOOOOXXXXXXXXXXXXXGOOOOOXXXXXXXXXXXXXXGOOOOOOOOXXXXXXXXXXX,0,600,0
48678,90,0,90,5,405,0,0,414,406,8,GOOXXXXXXXXXXXXXXXXXGOOOOOXXXXXXXXXXXXXXGOOOOOOOOOXXXXXXXXXXGOOOOOXXXXXXXXXXXXXXGOOXXXXXXXXXXXXXXXXXGOOOOOOOXXXXXXXXXXXXGOOOOOOXXXXXXXXXXXXXGOOOOOOOOOXXXXXXXXXXGOOOOOOOOOOOXXXXXXXXGOOXXXXXXXXXXXXXXXXXGOOOOOOXXXXXXXXXXXXXGOOOOOXXXXXXXXXXXXXXGOOOOOOOOXXXXXXXXXXX,0,600,0
48699,90,0,90,4,406,0,0,415,407,8,GOOXXXXXXXXXXXXXXXXXGOOOOOXXXXXXXXXXXXXXGOOOOOOOOOXXXXXXXXXXGOOOOOXXXXXXXXXXXXXXGOOXXXXXXXXXXXXXXXXXGOOOOOOOXXXXXXXXXXXXGOOOOOOXXXXXXXXXXXXXGOOOOOOOOOXXXXXXXXXXGOOOOOOOOOOOXXXXXXXXGOOXXXXXXXXXXXXXXXXXGOOOOOOXXXXXXXXXXXXXGOOOOOXXXXXXXXXXXXXXGOOOOOOOOXXXXXXXXXXX,0,600,0

48720,90,0,90,4,406,0,0,415,406,9,GOOXXXXXXXXXXXXXXXXXGOOOOOXXXXXXXXXXXXXXGOOOOOOOOOXXXXXXXXXXGOOOOOXXXXXXXXXXXXXXGOOXXXXXXXXXXXXXXXXXGOOOOOOOXXXXXXXXXXXXGOOOOOOXXXXXXXXXXXXXGOOOOOOOOOXXXXXXXXXXGOOOOOOOOOOOXXXXXXXXGOOXXXXXXXXXXXXXXXXXGOOOOOOXXXXXXXXXXXXXGOOOOOXXXXXXXXXXXXXXGOOOOOOOOXXXXXXXXXXX,0,600,0
48741,90,0,90,4,406,0,0,415,406,9,GOOXXXXXXXXXXXXXXXXXGOOOOOXXXXXXXXXXXXXXGOOOOOOOOOXXXXXXXXXXGOOOOOXXXXXXXXXXXXXXGOOXXXXXXXXXXXXXXXXXGOOOOOOOXXXXXXXXXXXXGOOOOOOXXXXXXXXXXXXXGOOOOOOOOOXXXXXXXXXXGOOOOOOOOOOOXXXXXXXXGOOXXXXXXXXXXXXXXXXXGOOOOOOXXXXXXXXXXXXXGOOOOOXXXXXXXXXXXXXXGOOOOOOOOXXXXXXXXXXX,0,600,0
48762,90,0,90,3,407,0,0,416,406,10,GOOXXXXXXXXXXXXXXXXXGOOOOOXXXXXXXXXXXXXXGOOOOOOOOOXXXXXXXXXXGOOOOOXXXXXXXXXXXXXXGOOXXXXXXXXXXXXXXXXXGOOOOOOOXXXXXXXXXXXXGOOOOOOXXXXXXXXXXXXXGOOOOOOOOOXXXXXXXXXXGOOOOOOOOOOOXXXXXXXXGOOXXXXXXXXXXXXXXXXXGOOOOOOXXXXXXXXXXXXXGOOOOOXXXXXXXXXXXXXXGOOOOOOOOXXXXXXXXXXX,0,600,0
48783,90,0,90,4,406,0,0,415,406,9,GOOXXXXXXXXXXXXXXXXXGOOOOOXXXXXXXXXXXXXXGOOOOOOOOOXXXXXXXXXXGOOOOOXXXXXXXXXXXXXXGOOXXXXXXXXXXXXXXXXXGOOOOOOOXXXXXXXXXXXXGOOOOOOXXXXXXXXXXXXXGOOOOOOOOOXXXXXXXXXXGOOOOOOOOOOOXXXXXXXXGOOXXXXXXXXXXXXXXXXXGOOOOOOXXXXXXXXXXXXXGOOOOOXXXXXXXXXXXXXXGOOOOOOOOXXXXXXXXXXX,0,600,0
48804,90,0,90,5,405,0,0,414,406,8,GOOXXXXXXXXXXXXXXXXXGOOOOOXXXXXXXXXXXXXXGOOOOOOOOOXXXXXXXXXXGOOOOOXXXXXXXXXXXXXXGOOXXXXXXXXXXXXXXXXXGOOOOOOOXXXXXXXXXXXXGOOOOOOXXXXXXXXXXXXXGOOOOOOOOOXXXXXXXXXXGOOOOOOOOOOOXXXXXXXXGOOXXXXXXXXXXXXXXXXXGOOOOOOXXXXXXXXXXXXXGOOOOOXXXXXXXXXXXXXXGOOOOOOOOXXXXXXXXXXX,0,600,0

48825,90,0,90,4,406,0,0,415,406,9,GOOXXXXXXXXXXXXXXXXXGOOOOOXXXXXXXXXXXXXXGOOOOOOOOOXXXXXXXXXXGOOOOOXXXXXXXXXXXXXXGOOXXXXXXXXXXXXXXXXXGOOOOOOOXXXXXXXXXXXXGOOOOOOXXXXXXXXXXXXXGOOOOOOOOOXXXXXXXXXXGOOOOOOOOOOOXXXXXXXXGOOXXXXXXXXXXXXXXXXXGOOOOOOXXXXXXXXXXXXXGOOOOOXXXXXXXXXXXXXXGOOOOOOOOXXXXXXXXXXX,0,600,0
48846,90,0,90,4,406,0,0,415,406,9,GOOXXXXXXXXXXXXXXXXXGOOOOOXXXXXXXXXXXXXXGOOOOOOOOOXXXXXXXXXXGOOOOOXXXXXXXXXXXXXXGOOXXXXXXXXXXXXXXXXXGOOOOOOOXXXXXXXXXXXXGOOOOOOXXXXXXXXXXXXXGOOOOOOOOOXXXXXXXXXXGOOOOOOOOOOOXXXXXXXXGOOXXXXXXXXXXXXXXXXXGOOOOOOXXXXXXXXXXXXXGOOOOOXXXXXXXXXXXXXXGOOOOOOOOXXXXXXXXXXX,0,600,0
48867,90,0,90,4,406,0,0,415,407,8,GOOXXXXXXXXXXXXXXXXXGOOOOOXXXXXXXXXXXXXXGOOOOOOOOOXXXXXXXXXXGOOOOOXXXXXXXXXXXXXXGOOXXXXXXXXXXXXXXXXXGOOOOOOOXXXXXXXXXXXXGOOOOOOXXXXXXXXXXXXXGOOOOOOOOOXXXXXXXXXXGOOOOOOOOOOOXXXXXXXXGOOXXXXXXXXXXXXXXXXXGOOOOOOXXXXXXXXXXXXXGOOOOOXXXXXXXXXXXXXXGOOOOOOOOXXXXXXXXXXX,0,600,0
48888,90,0,90,5,405,0,0,414,406,8,GOOXXXXXXXXXXXXXXXXXGOOOOOXXXXXXXXXXXXXXGOOOOOOOOOXXXXXXXXXXGOOOOOXXXXXXXXXXXXXXGOOXXXXXXXXXXXXXXXXXGOOOOOOOXXXXXXXXXXXXGOOOOOOXXXXXXXXXXXXXGOOOOOOOOOXXXXXXXXXXGOOOOOOOOOOOXXXXXXXXGOOXXXXXXXXXXXXXXXXXGOOOOOOXXXXXXXXXXXXXGOOOOOXXXXXXXXXXXXXXGOOOOOOOOXXXXXXXXXXX,0,600,0
48909,90,0,90,4,406,0,0,414,406,8,GOOXXXXXXXXXXXXXXXXXGOOOOOXXXXXXXXXXXXXXGOOOOOOOOOXXXXXXXXXXGOOOOOXXXXXXXXXXXXXXGOOXXXXXXXXXXXXXXXXXGOOOOOOOXXXXXXXXXXXXGOOOOOOXXXXXXXXXXXXXGOOOOOOOOOXXXXXXXXXXGOOOOOOOOOOOXXXXXXXXGOOXXXXXXXXXXXXXXXXXGOOOOOOXXXXXXXXXXXXXGOOOOOXXXXXXXXXXXXXXGOOOOOOOOXXXXXXXXXXX,0,600,0

48930,90,0,90,4,406,0,0,415,406,9,GOOXXXXXXXXXXXXXXXXXGOOOOOXXXXXXXXXXXXXXGOOOOOOOOOXXXXXXXXXXGOOOOOXXXXXXXXXXXXXXGOOXXXXXXXXXXXXXXXXXGOOOOOOOXXXXXXXXXXXXGOOOOOOXXXXXXXXXXXXXGOOOOOOOOOXXXXXXXXXXGOOOOOOOOOOOXXXXXXXXGOOXXXXXXXXXXXXXXXXXGOOOOOOXXXXXXXXXXXXXGOOOOOXXXXXXXXXXXXXXGOOOOOOOOXXXXXXXXXXX,0,600,0
48951,90,0,90,3,407,0,0,416,407,9,GOOXXXXXXXXXXXXXXXXXGOOOOOXXXXXXXXXXXXXXGOOOOOOOOOXXXXXXXXXXGOOOOOXXXXXXXXXXXXXXGOOXXXXXXXXXXXXXXXXXGOOOOOOOXXXXXXXXXXXXGOOOOOOXXXXXXXXXXXXXGOOOOOOOOOXXXXXXXXXXGOOOOOOOOOOOXXXXXXXXGOOXXXXXXXXXXXXXXXXXGOOOOOOXXXXXXXXXXXXXGOOOOOXXXXXXXXXXXXXXGOOOOOOOOXXXXXXXXXXX,0,600,0
48972,90,0,90,3,407,0,0,416,406,10,GOOXXXXXXXXXXXXXXXXXGOOOOOXXXXXXXXXXXXXXGOOOOOOOOOXXXXXXXXXXGOOOOOXXXXXXXXXXXXXXGOOXXXXXXXXXXXXXXXXXGOOOOOOOXXXXXXXXXXXXGOOOOOOXXXXXXXXXXXXXGOOOOOOOOOXXXXXXXXXXGOOOOOOOOOOOXXXXXXXXGOOXXXXXXXXXXXXXXXXXGOOOOOOXXXXXXXXXXXXXGOOOOOXXXXXXXXXXXXXXGOOOOOOOOXXXXXXXXXXX,0,600,0
48993,90,0,90,3,407,0,0,416,406,10,GOOXXXXXXXXXXXXXXXXXGOOOOOXXXXXXXXXXXXXXGOOOOOOOOOXXXXXXXXXXGOOOOOXXXXXXXXXXXXXXGOOXXXXXXXXXXXXXXXXXGOOOOOOOXXXXXXXXXXXXGOOOOOOXXXXXXXXXXXXXGOOOOOOOOOXXXXXXXXXXGOOOOOOOOOOOXXXXXXXXGOOXXXXXXXXXXXXXXXXXGOOOOOOXXXXXXXXXXXXXGOOOOOXXXXXXXXXXXXXXGOOOOOOOOXXXXXXXXXXX,0,600,0
49014,90,0,90,3,407,0,0,416,408,8,GOOXXXXXXXXXXXXXXXXXGOOOOOXXXXXXXXXXXXXXGOOOOOOOOOXXXXXXXXXXGOOOOOXXXXXXXXXXXXXXGOOXXXXXXXXXXXXXXXXXGOOOOOOOXXXXXXXXXXXXGOOOOOOXXXXXXXXXXXXXGOOOOOOOOOXXXXXXXXXXGOOOOOOOOOOOXXXXXXXXGOOXXXXXXXXXXXXXXXXXGOOOOOOXXXXXXXXXXXXXGOOOOOXXXXXXXXXXXXXXGOOOOOOOOXXXXXXXXXXX,0,600,0

49035,90,0,90,5,405,0,0,414,407,7,GOOXXXXXXXXXXXXXXXXXGOOOOOXXXXXXXXXXXXXXGOOOOOOOOOXXXXXXXXXXGOOOOOXXXXXXXXXXXXXXGOOXXXXXXXXXXXXXXXXXGOOOOOOOXXXXXXXXXXXXGOOOOOOXXXXXXXXXXXXXGOOOOOOOOOXXXXXXXXXXGOOOOOOOOOOOXXXXXXXXGOOXXXXXXXXXXXXXXXXXGOOOOOOXXXXXXXXXXXXXGOOOOOXXXXXXXXXXXXXXGOOOOOOOOXXXXXXXXXXX,0,600,0
49056,90,0,90,4,406,0,0,415,408,7,GOOXXXXXXXXXXXXXXXXXGOOOOOXXXXXXXXXXXXXXGOOOOOOOOOXXXXXXXXXXGOOOOOXXXXXXXXXXXXXXGOOXXXXXXXXXXXXXXXXXGOOOOOOOXXXXXXXXXXXXGOOOOOOXXXXXXXXXXXXXGOOOOOOOOOXXXXXXXXXXGOOOOOOOOOOOXXXXXXXXGOOXXXXXXXXXXXXXXXXXGOOOOOOXXXXXXXXXXXXXGOOOOOXXXXXXXXXXXXXXGOOOOOOOOXXXXXXXXXXX,0,600,0
49077,90,0,90,5,405,0,0,414,408,6,GOOXXXXXXXXXXXXXXXXXGOOOOOXXXXXXXXXXXXXXGOOOOOOOOOXXXXXXXXXXGOOOOOXXXXXXXXXXXXXXGOOXXXXXXXXXXXXXXXXXGOOOOOOOXXXXXXXXXXXXGOOOOOOXXXXXXXXXXXXXGOOOOOOOOOXXXXXXXXXXGOOOOOOOOOOOXXXXXXXXGOOXXXXXXXXXXXXXXXXXGOOOOOOXXXXXXXXXXXXXGOOOOOXXXXXXXXXXXXXXGOOOOOOOOXXXXXXXXXXX,0,600,0
49098,90,0,90,5,405,0,0,414,407,7,GOOXXXXXXXXXXXXXXXXXGOOOOOXXXXXXXXXXXXXXGOOOOOOOOOXXXXXXXXXXGOOOOOXXXXXXXXXXXXXXGOOXXXXXXXXXXXXXXXXXGOOOOOOOXXXXXXXXXXXXGOOOOOOXXXXXXXXXXXXXGOOOOOOOOOXXXXXXXXXXGOOOOOOOOOOOXXXXXXXXGOOXXXXXXXXXXXXXXXXXGOOOOOOXXXXXXXXXXXXXGOOOOOXXXXXXXXXXXXXXGOOOOOOOOXXXXXXXXXXX,0,600,0
49119,90,0,90,4,406,0,0,414,407,7,GOOXXXXXXXXXXXXXXXXXGOOOOOXXXXXXXXXXXXXXGOOOOOOOOOXXXXXXXXXXGOOOOOXXXXXXXXXXXXXXGOOXXXXXXXXXXXXXXXXXGOOOOOOOXXXXXXXXXXXXGOOOOOOXXXXXXXXXXXXXGOOOOOOOOOXXXXXXXXXXGOOOOOOOOOOOXXXXXXXXGOOXXXXXXXXXXXXXXXXXGOOOOOOXXXXXXXXXXXXXGOOOOOXXXXXXXXXXXXXXGOOOOOOOOXXXXXXXXXXX,0,600,0

49140,90,0,90,4,406,0,0,415,407,8,GOOXXXXXXXXXXXXXXXXXGOOOOOXXXXXXXXXXXXXXGOOOOOOOOOXXXXXXXXXXGOOOOOXXXXXXXXXXXXXXGOOXXXXXXXXXXXXXXXXXGOOOOOOOXXXXXXXXXXXXGOOOOOOXXXXXXXXXXXXXGOOOOOOOOOXXXXXXXXXXGOOOOOOOOOOOXXXXXXXXGOOXXXXXXXXXXXXXXXXXGOOOOOOXXXXXXXXXXXXXGOOOOOXXXXXXXXXXXXXXGOOOOOOOOXXXXXXXXXXX,0,600,0
49161,90,0,90,3,407,0,0,416,408,8,GOOXXXXXXXXXXXXXXXXXGOOOOOXXXXXXXXXXXXXXGOOOOOOOOOXXXXXXXXXXGOOOOOXXXXXXXXXXXXXXGOOXXXXXXXXXXXXXXXXXGOOOOOOOXXXXXXXXXXXXGOOOOOOXXXXXXXXXXXXXGOOOOOOOOOXXXXXXXXXXGOOOOOOOOOOOXXXXXXXXGOOXXXXXXXXXXXXXXXXXGOOOOOOXXXXXXXXXXXXXGOOOOOXXXXXXXXXXXXXXGOOOOOOOOXXXXXXXXXXX,0,600,0
49182,90,0,90,4,406,0,0,415,407,8,GOOXXXXXXXXXXXXXXXXXGOOOOOXXXXXXXXXXXXXXGOOOOOOOOOXXXXXXXXXXGOOOOOXXXXXXXXXXXXXXGOOXXXXXXXXXXXXXXXXXGOOOOOOOXXXXXXXXXXXXGOOOOOOXXXXXXXXXXXXXGOOOOOOOOOXXXXXXXXXXGOOOOOOOOOOOXXXXXXXXGOOXXXXXXXXXXXXXXXXXGOOOOOOXXXXXXXXXXXXXGOOOOOXXXXXXXXXXXXXXGOOOOOOOOXXXXXXXXXXX,0,600,0
49203,90,0,90,3,407,0,0,416,407,9,GOOXXXXXXXXXXXXXXXXXGOOOOOXXXXXXXXXXXXXXGOOOOOOOOOXXXXXXXXXXGOOOOOXXXXXXXXXXXXXXGOOXXXXXXXXXXXXXXXXXGOOOOOOOXXXXXXXXXXXXGOOOOOOXXXXXXXXXXXXXGOOOOOOOOOXXXXXXXXXXGOOOOOOOOOOOXXXXXXXXGOOXXXXXXXXXXXXXXXXXGOOOOOOXXXXXXXXXXXXXGOOOOOXXXXXXXXXXXXXXGOOOOOOOOXXXXXXXXXXX,0,600,0
49224,90,0,90,3,407,0,0,416,407,9,GOOXXXXXXXXXXXXXXXXXGOOOOOXXXXXXXXXXXXXXGOOOOOOOOOXXXXXXXXXXGOOOOOXXXXXXXXXXXXXXGOOXXXXXXXXXXXXXXXXXGOOOOOOOXXXXXXXXXXXXGOOOOOOXXXXXXXXXXXXXGOOOOOOOOOXXXXXXXXXXGOOOOOOOOOOOXXXXXXXXGOOXXXXXXXXXXXXXXXXXGOOOOOOXXXXXXXXXXXXXGOOOOOXXXXXXXXXXXXXXGOOOOOOOOXXXXXXXXXXX,0,600,0

49245,90,0,90,3,407,0,0,416,407,9,GOOXXXXXXXXXXXXXXXXXGOOOOOXXXXXXXXXXXXXXGOOOOOOOOOXXXXXXXXXXGOOOOOXXXXXXXXXXXXXXGOOXXXXXXXXXXXXXXXXXGOOOOOOOXXXXXXXXXXXXGOOOOOOXXXXXXXXXXXXXGOOOOOOOOOXXXXXXXXXXGOOOOOOOOOOOXXXXXXXXGOOXXXXXXXXXXXXXXXXXGOOOOOOXXXXXXXXXXXXXGOOOOOXXXXXXXXXXXXXXGOOOOOOOOXXXXXXXXXXX,0,600,0
49266,90,0,90,3,407,0,0,416,407,9,GOOXXXXXXXXXXXXXXXXXGOOOOOXXXXXXXXXXXXXXGOOOOOOOOOXXXXXXXXXXGOOOOOXXXXXXXXXXXXXXGOOXXXXXXXXXXXXXXXXXGOOOOOOOXXXXXXXXXXXXGOOOOOOXXXXXXXXXXXXXGOOOOOOOOOXXXXXXXXXXGOOOOOOOOOOOXXXXXXXXGOOXXXXXXXXXXXXXXXXXGOOOOOOXXXXXXXXXXXXXGOOOOOXXXXXXXXXXXXXXGOOOOOOOOXXXXXXXXXXX,0,600,0
49287,90,0,90,3,407,0,0,416,407,9,GOOXXXXXXXXXXXXXXXXXGOOOOOXXXXXXXXXXXXXXGOOOOOOOOOXXXXXXXXXXGOOOOOXXXXXXXXXXXXXXGOOXXXXXXXXXXXXXXXXXGOOOOOOOXXXXXXXXXXXXGOOOOOOXXXXXXXXXXXXXGOOOOOOOOOXXXXXXXXXXGOOOOOOOOOOOXXXXXXXXGOOXXXXXXXXXXXXXXXXXGOOOOOOXXXXXXXXXXXXXGOOOOOXXXXXXXXXXXXXXGOOOOOOOOXXXXXXXXXXX,0,600,0
49308,90,0,90,2,408,0,0,417,407,10,GOOXXXXXXXXXXXXXXXXXGOOOOOXXXXXXXXXXXXXXGOOOOOOOOOXXXXXXXXXXGOOOOOXXXXXXXXXXXXXXGOOXXXXXXXXXXXXXXXXXGOOOOOOOXXXXXXXXXXXXGOOOOOOXXXXXXXXXXXXXGOOOOOOOOOXXXXXXXXXXGOOOOOOOOOOOXXXXXXXXGOOXXXXXXXXXXXXXXXXXGOOOOOOXXXXXXXXXXXXXGOOOOOXXXXXXXXXXXXXXGOOOOOOOOXXXXXXXXXXX,0,600,0
49329,90,0,90,3,407,0,0,416,407,9,GOOXXXXXXXXXXXXXXXXXGOOOOOXXXXXXXXXXXXXXGOOOOOOOOOXXXXXXXXXXGOOOOOXXXXXXXXXXXXXXGOOXXXXXXXXXXXXXXXXXGOOOOOOOXXXXXXXXXXXXGOOOOOOXXXXXXXXXXXXXGOOOOOOOOOXXXXXXXXXXGOOOOOOOOOOOXXXXXXXXGOOXXXXXXXXXXXXXXXXXGOOOOOOXXXXXXXXXXXXXGOOOOOXXXXXXXXXXXXXXGOOOOOOOOXXXXXXXXXXX,0,600,0

49350,90,0,90,3,407,0,0,416,408,8,GOOXXXXXXXXXXXXXXXXXGOOOOOXXXXXXXXXXXXXXGOOOOOOOOOXXXXXXXXXXGOOOOOXXXXXXXXXXXXXXGOOXXXXXXXXXXXXXXXXXGOOOOOOOXXXXXXXXXXXXGOOOOOOXXXXXXXXXXXXXGOOOOOOOOOXXXXXXXXXXGOOOOOOOOOOOXXXXXXXXGOOXXXXXXXXXXXXXXXXXGOOOOOOXXXXXXXXXXXXXGOOOOOXXXXXXXXXXXXXXGOOOOOOOOXXXXXXXXXXX,0,600,0
49371,90,0,90,4,406,0,0,415,408,7,GOOXXXXXXXXXXXXXXXXXGOOOOOXXXXXXXXXXXXXXGOOOOOOOOOXXXXXXXXXXGOOOOOXXXXXXXXXXXXXXGOOXXXXXXXXXXXXXXXXXGOOOOOOOXXXXXXXXXXXXGOOOOOOXXXXXXXXXXXXXGOOOOOOOOOXXXXXXXXXXGOOOOOOOOOOOXXXXXXXXGOOXXXXXXXXXXXXXXXXXGOOOOOOXXXXXXXXXXXXXGOOOOOXXXXXXXXXXXXXXGOOOOOOOOXXXXXXXXXXX,0,600,0
49392,90,0,90,4,406,0,0,415,408,7,GOOXXXXXXXXXXXXXXXXXGOOOOOXXXXXXXXXXXXXXGOOOOOOOOOXXXXXXXXXXGOOOOOXXXXXXXXXXXXXXGOOXXXXXXXXXXXXXXXXXGOOOOOOOXXXXXXXXXXXXGOOOOOOXXXXXXXXXXXXXGOOOOOOOOOXXXXXXXXXXGOOOOOOOOOOOXXXXXXXXGOOXXXXXXXXXXXXXXXXXGOOOOOOXXXXXXXXXXXXXGOOOOOXXXXXXXXXXXXXXGOOOOOOOOXXXXXXXXXXX,0,600,0
49413,90,0,90,5,405,0,0,414,409,5,GOOXXXXXXXXXXXXXXXXXGOOOOOXXXXXXXXXXXXXXGOOOOOOOOOXXXXXXXXXXGOOOOOXXXXXXXXXXXXXXGOOXXXXXXXXXXXXXXXXXGOOOOOOOXXXXXXXXXXXXGOOOOOOXXXXXXXXXXXXXGOOOOOOOOOXXXXXXXXXXGOOOOOOOOOOOXXXXXXXXGOOXXXXXXXXXXXXXXXXXGOOOOOOXXXXXXXXXXXXXGOOOOOXXXXXXXXXXXXXXGOOOOOOOOXXXXXXXXXXX,0,600,0
49434,90,0,90,6,404,0,0,413,408,5,GOOXXXXXXXXXXXXXXXXXGOOOOOXXXXXXXXXXXXXXGOOOOOOOOOXXXXXXXXXXGOOOOOXXXXXXXXXXXXXXGOOXXXXXXXXXXXXXXXXXGOOOOOOOXXXXXXXXXXXXGOOOOOOXXXXXXXXXXXXXGOOOOOOOOOXXXXXXXXXXGOOOOOOOOOOOXXXXXXXXGOOXXXXXXXXXXXXXXXXXGOOOOOOXXXXXXXXXXXXXGOOOOOXXXXXXXXXXXXXXGOOOOOOOOXXXXXXXXXXX,0,600,0

49455,90,0,90,6,404,0,0,413,408,5,GOOXXXXXXXXXXXXXXXXXGOOOOOXXXXXXXXXXXXXXGOOOOOOOOOXXXXXXXXXXGOOOOOXXXXXXXXXXXXXXGOOXXXXXXXXXXXXXXXXXGOOOOOOOXXXXXXXXXXXXGOOOOOOXXXXXXXXXXXXXGOOOOOOOOOXXXXXXXXXXGOOOOOOOOOOOXXXXXXXXGOOXXXXXXXXXXXXXXXXXGOOOOOOXXXXXXXXXXXXXGOOOOOXXXXXXXXXXXXXXGOOOOOOOOXXXXXXXXXXX,0,600,0
49476,90,0,90,6,404,0,0,412,409,3,GOOXXXXXXXXXXXXXXXXXGOOOOOXXXXXXXXXXXXXXGOOOOOOOOOXXXXXXXXXXGOOOOOXXXXXXXXXXXXXXGOOXXXXXXXXXXXXXXXXXGOOOOOOOXXXXXXXXXXXXGOOOOOOXXXXXXXXXXXXXGOOOOOOOOOXXXXXXXXXXGOOOOOOOOOOOXXXXXXXXGOOXXXXXXXXXXXXXXXXXGOOOOOOXXXXXXXXXXXXXGOOOOOXXXXXXXXXXXXXXGOOOOOOOOXXXXXXXXXXX,0,600,0
49497,90,0,90,6,404,0,0,413,409,4,GOOXXXXXXXXXXXXXXXXXGOOOOOXXXXXXXXXXXXXXGOOOOOOOOOXXXXXXXXXXGOOOOOXXXXXXXXXXXXXXGOOXXXXXXXXXXXXXXXXXGOOOOOOOXXXXXXXXXXXXGOOOOOOXXXXXXXXXXXXXGOOOOOOOOOXXXXXXXXXXGOOOOOOOOOOOXXXXXXXXGOOXXXXXXXXXXXXXXXXXGOOOOOOXXXXXXXXXXXXXGOOOOOXXXXXXXXXXXXXXGOOOOOOOOXXXXXXXXXXX,0,600,0
49518,90,0,90,6,404,0,0,413,409,4,GOOXXXXXXXXXXXXXXXXXGOOOOOXXXXXXXXXXXXXXGOOOOOOOOOXXXXXXXXXXGOOOOOXXXXXXXXXXXXXXGOOXXXXXXXXXXXXXXXXXGOOOOOOOXXXXXXXXXXXXGOOOOOOXXXXXXXXXXXXXGOOOOOOOOOXXXXXXXXXXGOOOOOOOOOOOXXXXXXXXGOOXXXXXXXXXXXXXXXXXGOOOOOOXXXXXXXXXXXXXGOOOOOXXXXXXXXXXXXXXGOOOOOOOOXXXXXXXXXXX,0,600,0
49539,90,0,90,7,403,0,0,412,408,4,GOOXXXXXXXXXXXXXXXXXGOOOOOXXXXXXXXXXXXXXGOOOOOOOOOXXXXXXXXXXGOOOOOXXXXXXXXXXXXXXGOOXXXXXXXXXXXXXXXXXGOOOOOOOXXXXXXXXXXXXGOOOOOOXXXXXXXXXXXXXGOOOOOOOOOXXXXXXXXXXGOOOOOOOOOOOXXXXXXXXGOOXXXXXXXXXXXXXXXXXGOOOOOOXXXXXXXXXXXXXGOOOOOXXXXXXXXXXXXXXGOOOOOOOOXXXXXXXXXXX,0,600,0

49560,90,0,90,6,404,0,0,413,408,5,GOOXXXXXXXXXXXXXXXXXGOOOOOXXXXXXXXXXXXXXGOOOOOOOOOXXXXXXXXXXGOOOOOXXXXXXXXXXXXXXGOOXXXXXXXXXXXXXXXXXGOOOOOOOXXXXXXXXXXXXGOOOOOOXXXXXXXXXXXXXGOOOOOOOOOXXXXXXXXXXGOOOOOOOOOOOXXXXXXXXGOOXXXXXXXXXXXXXXXXXGOOOOOOXXXXXXXXXXXXXGOOOOOXXXXXXXXXXXXXXGOOOOOOOOXXXXXXXXXXX,0,600,0
49581,90,0,90,4,406,0,0,415,408,7,GOOXXXXXXXXXXXXXXXXXGOOOOOXXXXXXXXXXXXXXGOOOOOOOOOXXXXXXXXXXGOOOOOXXXXXXXXXXXXXXGOOXXXXXXXXXXXXXXXXXGOOOOOOOXXXXXXXXXXXXGOOOOOOXXXXXXXXXXXXXGOOOOOOOOOXXXXXXXXXXGOOOOOOOOOOOXXXXXXXXGOOXXXXXXXXXXXXXXXXXGOOOOOOXXXXXXXXXXXXXGOOOOOXXXXXXXXXXXXXXGOOOOOOOOXXXXXXXXXXX,0,600,0
49602,90,0,90,4,406,0,0,415,408,7,GOOXXXXXXXXXXXXXXXXXGOOOOOXXXXXXXXXXXXXXGOOOOOOOOOXXXXXXXXXXGOOOOOXXXXXXXXXXXXXXGOOXXXXXXXXXXXXXXXXXGOOOOOOOXXXXXXXXXXXXGOOOOOOXXXXXXXXXXXXXGOOOOOOOOOXXXXXXXXXXGOOOOOOOOOOOXXXXXXXXGOOXXXXXXXXXXXXXXXXXGOOOOOOXXXXXXXXXXXXXGOOOOOXXXXXXXXXXXXXXGOOOOOOOOXXXXXXXXXXX,0,600,0
49623,90,0,90,3,407,0,0,416,409,7,GOOXXXXXXXXXXXXXXXXXGOOOOOXXXXXXXXXXXXXXGOOOOOOOOOXXXXXXXXXXGOOOOOXXXXXXXXXXXXXXGOOXXXXXXXXXXXXXXXXXGOOOOOOOXXXXXXXXXXXXGOOOOOOXXXXXXXXXXXXXGOOOOOOOOOXXXXXXXXXXGOOOOOOOOOOOXXXXXXXXGOOXXXXXXXXXXXXXXXXXGOOOOOOXXXXXXXXXXXXXGOOOOOXXXXXXXXXXXXXXGOOOOOOOOXXXXXXXXXXX,0,600,0
49644,90,0,90,2,408,0,0,417,408,9,GOOXXXXXXXXXXXXXXXXXGOOOOOXXXXXXXXXXXXXXGOOOOOOOOOXXXXXXXXXXGOOOOOXXXXXXXXXXXXXXGOOXXXXXXXXXXXXXXXXXGOOOOOOOXXXXXXXXXXXXGOOOOOOXXXXXXXXXXXXXGOOOOOOOOOXXXXXXXXXXGOOOOOOOOOOOXXXXXXXXGOOXXXXXXXXXXXXXXXXXGOOOOOOXXXXXXXXXXXXXGOOOOOXXXXXXXXXXXXXXGOOOOOOOOXXXXXXXXXXX,0,600,0

49665,90,0,90,1,409,0,0,418,408,10,GOOXXXXXXXXXXXXXXXXXGOOOOOXXXXXXXXXXXXXXGOOOOOOOOOXXXXXXXXXXGOOOOOXXXXXXXXXXXXXXGOOXXXXXXXXXXXXXXXXXGOOOOOOOXXXXXXXXXXXXGOOOOOOXXXXXXXXXXXXXGOOOOOOOOOXXXXXXXXXXGOOOOOOOOOOOXXXXXXXXGOOXXXXXXXXXXXXXXXXXGOOOOOOXXXXXXXXXXXXXGOOOOOXXXXXXXXXXXXXXGOOOOOOOOXXXXXXXXXXX,0,600,0
49686,90,0,90,1,409,0,0,418,408,10,GOOXXXXXXXXXXXXXXXXXGOOOOOXXXXXXXXXXXXXXGOOOOOOOOOXXXXXXXXXXGOOOOOXXXXXXXXXXXXXXGOOXXXXXXXXXXXXXXXXXGOOOOOOOXXXXXXXXXXXXGOOOOOOXXXXXXXXXXXXXGOOOOOOOOOXXXXXXXXXXGOOOOOOOOOOOXXXXXXXXGOOXXXXXXXXXXXXXXXXXGOOOOOOXXXXXXXXXXXXXGOOOOOXXXXXXXXXXXXXXGOOOOOOOOXXXXXXXXXXX,0,600,0
49707,90,0,90,1,409,0,0,418,408,10,GOOXXXXXXXXXXXXXXXXXGOOOOOXXXXXXXXXXXXXXGOOOOOOOOOXXXXXXXXXXGOOOOOXXXXXXXXXXXXXXGOOXXXXXXXXXXXXXXXXXGOOOOOOOXXXXXXXXXXXXGOOOOOOXXXXXXXXXXXXXGOOOOOOOOOXXXXXXXXXXGOOOOOOOOOOOXXXXXXXXGOOXXXXXXXXXXXXXXXXXGOOOOOOXXXXXXXXXXXXXGOOOOOXXXXXXXXXXXXXXGOOOOOOOOXXXXXXXXXXX,0,600,0
49728,90,0,90,2,408,0,0,417,408,9,GOOXXXXXXXXXXXXXXXXXGOOOOOXXXXXXXXXXXXXXGOOOOOOOOOXXXXXXXXXXGOOOOOXXXXXXXXXXXXXXGOOXXXXXXXXXXXXXXXXXGOOOOOOOXXXXXXXXXXXXGOOOOOOXXXXXXXXXXXXXGOOOOOOOOOXXXXXXXXXXGOOOOOOOOOOOXXXXXXXXGOOXXXXXXXXXXXXXXXXXGOOOOOOXXXXXXXXXXXXXGOOOOOXXXXXXXXXXXXXXGOOOOOOOOXXXXXXXXXXX,0,600,0
49749,90,0,90,1,409,0,0,418,408,10,GOOXXXXXXXXXXXXXXXXXGOOOOOXXXXXXXXXXXXXXGOOOOOOOOOXXXXXXXXXXGOOOOOXXXXXXXXXXXXXXGOOXXXXXXXXXXXXXXXXXGOOOOOOOXXXXXXXXXXXXGOOOOOOXXXXXXXXXXXXXGOOOOOOOOOXXXXXXXXXXGOOOOOOOOOOOXXXXXXXXGOOXXXXXXXXXXXXXXXXXGOOOOOOXXXXXXXXXXXXXGOOOOOXXXXXXXXXXXXXXGOOOOOOOOXXXXXXXXXXX,0,600,0

49770,90,0,90,1,409,0,0,418,408,10,GOOXXXXXXXXXXXXXXXXXGOOOOOXXXXXXXXXXXXXXGOOOOOOOOOXXXXXXXXXXGOOOOOXXXXXXXXXXXXXXGOOXXXXXXXXXXXXXXXXXGOOOOOOOXXXXXXXXXXXXGOOOOOOXXXXXXXXXXXXXGOOOOOOOOOXXXXXXXXXXGOOOOOOOOOOOXXXXXXXXGOOXXXXXXXXXXXXXXXXXGOOOOOOXXXXXXXXXXXXXGOOOOOXXXXXXXXXXXXXXGOOOOOOOOXXXXXXXXXXX,0,600,0
49791,90,0,90,1,409,0,0,418,409,9,GOOXXXXXXXXXXXXXXXXXGOOOOOXXXXXXXXXXXXXXGOOOOOOOOOXXXXXXXXXXGOOOOOXXXXXXXXXXXXXXGOOXXXXXXXXXXXXXXXXXGOOOOOOOXXXXXXXXXXXXGOOOOOOXXXXXXXXXXXXXGOOOOOOOOOXXXXXXXXXXGOOOOOOOOOOOXXXXXXXXGOOXXXXXXXXXXXXXXXXXGOOOOOOXXXXXXXXXXXXXGOOOOOXXXXXXXXXXXXXXGOOOOOOOOXXXXXXXXXXX,0,600,0
49812,90,0,90,1,409,0,0,418,409,9,GOOXXXXXXXXXXXXXXXXXGOOOOOXXXXXXXXXXXXXXGOOOOOOOOOXXXXXXXXXXGOOOOOXXXXXXXXXXXXXXGOOXXXXXXXXXXXXXXXXXGOOOOOOOXXXXXXXXXXXXGOOOOOOXXXXXXXXXXXXXGOOOOOOOOOXXXXXXXXXXGOOOOOOOOOOOXXXXXXXXGOOXXXXXXXXXXXXXXXXXGOOOOOOXXXXXXXXXXXXXGOOOOOXXXXXXXXXXXXXXGOOOOOOOOXXXXXXXXXXX,0,600,0
49833,90,0,90,3,407,0,0,416,408,8,GOOXXXXXXXXXXXXXXXXXGOOOOOXXXXXXXXXXXXXXGOOOOOOOOOXXXXXXXXXXGOOOOOXXXXXXXXXXXXXXGOOXXXXXXXXXXXXXXXXXGOOOOOOOXXXXXXXXXXXXGOOOOOOXXXXXXXXXXXXXGOOOOOOOOOXXXXXXXXXXGOOOOOOOOOOOXXXXXXXXGOOXXXXXXXXXXXXXXXXXGOOOOOOXXXXXXXXXXXXXGOOOOOXXXXXXXXXXXXXXGOOOOOOOOXXXXXXXXXXX,0,600,0
49854,90,0,90,4,406,0,0,415,409,6,GOOXXXXXXXXXXXXXXXXXGOOOOOXXXXXXXXXXXXXXGOOOOOOOOOXXXXXXXXXXGOOOOOXXXXXXXXXXXXXXGOOXXXXXXXXXXXXXXXXXGOOOOOOOXXXXXXXXXXXXGOOOOOOXXXXXXXXXXXXXGOOOOOOOOOXXXXXXXXXXGOOOOOOOOOOOXXXXXXXXGOOXXXXXXXXXXXXXXXXXGOOOOOOXXXXXXXXXXXXXGOOOOOXXXXXXXXXXXXXXGOOOOOOOOXXXXXXXXXXX,0,600,0

49875,90,0,90,5,405,0,0,414,408,6,GOOXXXXXXXXXXXXXXXXXGOOOOOXXXXXXXXXXXXXXGOOOOOOOOOXXXXXXXXXXGOOOOOXXXXXXXXXXXXXXGOOXXXXXXXXXXXXXXXXXGOOOOOOOXXXXXXXXXXXXGOOOOOOXXXXXXXXXXXXXGOOOOOOOOOXXXXXXXXXXGOOOOOOOOOOOXXXXXXXXGOOXXXXXXXXXXXXXXXXXGOOOOOOXXXXXXXXXXXXXGOOOOOXXXXXXXXXXXXXXGOOOOOOOOXXXXXXXXXXX,0,600,0
49896,90,0,90,5,405,0,0,414,409,5,GOOXXXXXXXXXXXXXXXXXGOOOOOXXXXXXXXXXXXXXGOOOOOOOOOXXXXXXXXXXGOOOOOXXXXXXXXXXXXXXGOOXXXXXXXXXXXXXXXXXGOOOOOOOXXXXXXXXXXXXGOOOOOOXXXXXXXXXXXXXGOOOOOOOOOXXXXXXXXXXGOOOOOOOOOOOXXXXXXXXGOOXXXXXXXXXXXXXXXXXGOOOOOOXXXXXXXXXXXXXGOOOOOXXXXXXXXXXXXXXGOOOOOOOOXXXXXXXXXXX,0,600,0
49917,90,0,90,6,404,0,0,413,408,5,GOOXXXXXXXXXXXXXXXXXGOOOOOXXXXXXXXXXXXXXGOOOOOOOOOXXXXXXXXXXGOOOOOXXXXXXXXXXXXXXGOOXXXXXXXXXXXXXXXXXGOOOOOOOXXXXXXXXXXXXGOOOOOOXXXXXXXXXXXXXGOOOOOOOOOXXXXXXXXXXGOOOOOOOOOOOXXXXXXXXGOOXXXXXXXXXXXXXXXXXGOOOOOOXXXXXXXXXXXXXGOOOOOXXXXXXXXXXXXXXGOOOOOOOOXXXXXXXXXXX,0,600,0
49938,90,0,90,7,403,0,0,412,408,4,GOOXXXXXXXXXXXXXXXXXGOOOOOXXXXXXXXXXXXXXGOOOOOOOOOXXXXXXXXXXGOOOOOXXXXXXXXXXXXXXGOOXXXXXXXXXXXXXXXXXGOOOOOOOXXXXXXXXXXXXGOOOOOOXXXXXXXXXXXXXGOOOOOOOOOXXXXXXXXXXGOOOOOOOOOOOXXXXXXXXGOOXXXXXXXXXXXXXXXXXGOOOOOOXXXXXXXXXXXXXGOOOOOXXXXXXXXXXXXXXGOOOOOOOOXXXXXXXXXXX,0,600,0
49959,90,0,90,7,403,0,0,412,409,3,GOOXXXXXXXXXXXXXXXXXGOOOOOXXXXXXXXXXXXXXGOOOOOOOOOXXXXXXXXXXGOOOOOXXXXXXXXXXXXXXGOOXXXXXXXXXXXXXXXXXGOOOOOOOXXXXXXXXXXXXGOOOOOOXXXXXXXXXXXXXGOOOOOOOOOXXXXXXXXXXGOOOOOOOOOOOXXXXXXXXGOOXXXXXXXXXXXXXXXXXGOOOOOOXXXXXXXXXXXXXGOOOOOXXXXXXXXXXXXXXGOOOOOOOOXXXXXXXXXXX,0,600,0

